,name,realm,rating,cls,spec,play,win,lose
0,Phearbunny,bleeding-hollow,1547,deathknight,blood,114,59,55
1,Pagumon,moon-guard,1421,deathknight,blood,126,65,61
2,Warlôck,chogall,1399,deathknight,blood,36,19,17
3,Réndwarchièf,garrosh,1227,deathknight,blood,51,23,28
4,Tiumau,goldrinn,1121,deathknight,blood,66,30,36
5,Nbayoungboy,kiljaeden,1088,deathknight,blood,46,18,28
6,Corndead,area-52,1045,deathknight,blood,30,11,19
7,Tragül,sargeras,1042,deathknight,blood,42,20,22
8,Bloodbukkaky,bleeding-hollow,946,deathknight,blood,61,16,45
9,Valind,eredar,854,deathknight,blood,18,9,9
10,Kult,azralon,841,deathknight,blood,12,9,3
11,Insonne,dalaran,837,deathknight,blood,18,9,9
12,Yafa,bonechewer,795,deathknight,blood,36,14,22
13,Kayn,malganis,767,deathknight,blood,18,8,10
14,Jakeboyswag,shandris,767,deathknight,blood,24,8,16
15,He,echo-isles,668,deathknight,blood,12,7,5
16,Eremeir,moon-guard,576,deathknight,blood,12,6,6
17,Blasphemus,malganis,575,deathknight,blood,12,6,6
18,Kaîne,dalaran,480,deathknight,blood,12,5,7
19,Belfknightt,area-52,479,deathknight,blood,15,5,10
20,Humber,area-52,384,deathknight,blood,6,4,2
21,Tristam,area-52,384,deathknight,blood,6,4,2
22,Pride,ragnaros,384,deathknight,blood,12,4,8
23,ßläzë,baelgun,288,deathknight,blood,15,4,11
24,Kimbøslîce,area-52,288,deathknight,blood,12,3,9
25,Kaloesh,drenden,288,deathknight,blood,12,3,9
26,Aborblood,hyjal,286,deathknight,blood,12,3,9
27,Neroxzdvm,area-52,192,deathknight,blood,6,2,4
28,Cerbeefquake,wyrmrest-accord,192,deathknight,blood,12,2,10
29,Eteson,tichondrius,191,deathknight,blood,6,2,4
30,Unhølydøøm,misha,191,deathknight,blood,12,2,10
31,Cosmiclord,sargeras,191,deathknight,blood,18,2,16
32,Killteam,tichondrius,96,deathknight,blood,6,1,5
33,Cozzasad,barthilas,96,deathknight,blood,6,1,5
34,Gnargnarr,firetree,96,deathknight,blood,6,1,5
35,Wowattorney,tichondrius,96,deathknight,blood,6,1,5
36,Determinate,deathwing,96,deathknight,blood,6,1,5
37,Ðrift,azralon,96,deathknight,blood,6,1,5
38,Lunatick,darkspear,96,deathknight,blood,6,1,5
39,Boneherr,sargeras,96,deathknight,blood,6,1,5
40,Zerhistran,proudmoore,64,deathknight,blood,4,1,3
41,Hulmorr,bleeding-hollow,64,deathknight,blood,4,1,3
42,Partywaffles,illidan,2179,deathknight,unholy,288,149,139
43,Pwaff,illidan,2125,deathknight,unholy,89,45,44
44,Neroxz,area-52,2105,deathknight,unholy,83,43,40
45,Qipara,zuljin,2104,deathknight,unholy,163,87,76
46,Graphics,moon-guard,2104,deathknight,unholy,388,196,192
47,Níngjìng,tichondrius,2074,deathknight,unholy,84,43,41
48,Veilsidé,kelthuzad,2058,deathknight,unholy,294,152,142
49,Thorediks,stormrage,2049,deathknight,unholy,138,67,71
50,Spaidzz,malganis,2035,deathknight,unholy,252,125,127
51,Búddy,zuljin,2022,deathknight,unholy,100,49,51
52,Gutterboy,malganis,2018,deathknight,unholy,87,41,46
53,Flarkness,area-52,2010,deathknight,unholy,78,37,41
54,Renaming,area-52,1985,deathknight,unholy,99,51,48
55,Achílles,sargeras,1979,deathknight,unholy,175,85,90
56,Scriptløl,sargeras,1975,deathknight,unholy,138,66,72
57,Ningjinglol,tichondrius,1969,deathknight,unholy,72,40,32
58,Pookr,area-52,1959,deathknight,unholy,156,73,83
59,Roidboy,illidan,1954,deathknight,unholy,115,57,58
60,Darkdj,kelthuzad,1944,deathknight,unholy,127,62,65
61,Vineyard,area-52,1943,deathknight,unholy,299,149,150
62,Toxicwaste,malganis,1942,deathknight,unholy,82,39,43
63,Juelzjerk,tichondrius,1940,deathknight,unholy,151,80,71
64,Nixonxx,tichondrius,1933,deathknight,unholy,126,78,48
65,Ceomdae,tichondrius,1927,deathknight,unholy,72,34,38
66,Mårlbørø,tichondrius,1915,deathknight,unholy,41,21,20
67,Éternalnight,tichondrius,1913,deathknight,unholy,76,32,44
68,Zynyzter,malganis,1912,deathknight,unholy,72,41,31
69,Barakhenaku,illidan,1911,deathknight,unholy,63,33,30
70,Killinois,tichondrius,1910,deathknight,unholy,47,21,26
71,Thotiannaqt,area-52,1909,deathknight,unholy,100,51,49
72,Cardii,area-52,1908,deathknight,unholy,142,73,69
73,Geomdae,tichondrius,1901,deathknight,unholy,71,31,40
74,Barelyviable,tichondrius,1898,deathknight,unholy,72,32,40
75,Steamerboy,stormrage,1887,deathknight,unholy,60,28,32
76,Serwestley,stormrage,1884,deathknight,unholy,83,41,42
77,Malhandir,bleeding-hollow,1880,deathknight,unholy,41,23,18
78,Harókz,azralon,1877,deathknight,unholy,95,48,47
79,Keetor,tichondrius,1875,deathknight,unholy,48,32,16
80,Kilohotel,stormrage,1873,deathknight,unholy,42,25,17
81,Dkya,tichondrius,1871,deathknight,unholy,310,156,154
82,Ilceses,area-52,1870,deathknight,unholy,66,29,37
83,Catarïa,tichondrius,1869,deathknight,unholy,90,44,46
84,Iato,sargeras,1868,deathknight,unholy,60,39,21
85,Evilduck,ragnaros,1866,deathknight,unholy,90,51,39
86,Goonaa,tichondrius,1861,deathknight,unholy,66,33,33
87,Exaar,tichondrius,1861,deathknight,unholy,81,39,42
88,Cavaliers,ragnaros,1860,deathknight,unholy,66,32,34
89,Lattè,area-52,1859,deathknight,unholy,55,30,25
90,Pradas,area-52,1857,deathknight,unholy,184,92,92
91,Xiaodabaolol,tichondrius,1855,deathknight,unholy,66,32,34
92,Bloodbruh,blackrock,1854,deathknight,unholy,60,34,26
93,Brutos,thrall,1851,deathknight,unholy,104,56,48
94,Tduggylolz,tichondrius,1851,deathknight,unholy,60,26,34
95,Daoniancc,tichondrius,1850,deathknight,unholy,375,197,178
96,Morbiddesire,stormrage,1849,deathknight,unholy,87,49,38
97,Didri,quelthalas,1846,deathknight,unholy,72,34,38
98,Keomdae,tichondrius,1844,deathknight,unholy,65,32,33
99,Tokyotimxx,malganis,1842,deathknight,unholy,48,30,18
100,Cloüd,wyrmrest-accord,1841,deathknight,unholy,64,31,33
101,Bicepsüal,zuljin,1840,deathknight,unholy,36,28,8
102,Nevermore,hyjal,1840,deathknight,unholy,125,67,58
103,Bruceleedk,tichondrius,1839,deathknight,unholy,100,51,49
104,Siêgfriëd,ragnaros,1839,deathknight,unholy,72,33,39
105,Milleh,bleeding-hollow,1838,deathknight,unholy,78,35,43
106,Annoyed,wyrmrest-accord,1837,deathknight,unholy,119,64,55
107,Blackfyré,sargeras,1837,deathknight,unholy,62,32,30
108,Skippee,tichondrius,1837,deathknight,unholy,60,29,31
109,Aidsbenedict,malganis,1837,deathknight,unholy,126,59,67
110,Vigarst,azralon,1835,deathknight,unholy,60,30,30
111,Haldevarik,doomhammer,1834,deathknight,unholy,78,43,35
112,Dazarune,burning-blade,1832,deathknight,unholy,46,25,21
113,Orphanmakerx,area-52,1832,deathknight,unholy,123,60,63
114,Zerhistran,proudmoore,1831,deathknight,unholy,254,136,118
115,Goonà,tichondrius,1831,deathknight,unholy,63,29,34
116,Aurious,lightnings-blade,1830,deathknight,unholy,84,47,37
117,Kortingert,nagrand,1830,deathknight,unholy,59,33,26
118,Wøund,black-dragonflight,1830,deathknight,unholy,226,115,111
119,Drauguss,azralon,1830,deathknight,unholy,124,61,63
120,Sinell,kargath,1829,deathknight,unholy,186,101,85
121,Slîckhuman,spinebreaker,1829,deathknight,unholy,60,27,33
122,Anatøly,ragnaros,1827,deathknight,unholy,42,21,21
123,Soulhand,tichondrius,1826,deathknight,unholy,104,57,47
124,Arthez,frostmourne,1824,deathknight,unholy,72,38,34
125,Sadboy,grizzly-hills,1822,deathknight,unholy,65,27,38
126,Zerøimperial,quelthalas,1821,deathknight,unholy,209,111,98
127,Goldênboy,blades-edge,1820,deathknight,unholy,66,42,24
128,Altareon,ragnaros,1820,deathknight,unholy,150,79,71
129,Einherjiar,tichondrius,1820,deathknight,unholy,48,25,23
130,Volyant,frostmourne,1820,deathknight,unholy,60,30,30
131,Kciktep,tichondrius,1819,deathknight,unholy,36,19,17
132,Datnai,barthilas,1819,deathknight,unholy,54,25,29
133,Hrsb,tichondrius,1817,deathknight,unholy,124,68,56
134,Sussybakadk,sargeras,1817,deathknight,unholy,70,34,36
135,Skideroth,kelthuzad,1817,deathknight,unholy,60,28,32
136,Flizzycash,malganis,1816,deathknight,unholy,56,27,29
137,Õdin,area-52,1815,deathknight,unholy,203,103,100
138,Wowattorney,tichondrius,1815,deathknight,unholy,82,33,49
139,Poesoul,tichondrius,1812,deathknight,unholy,285,143,142
140,Ravindrannor,saurfang,1812,deathknight,unholy,65,32,33
141,Dahnga,frostmourne,1811,deathknight,unholy,54,32,22
142,Plagueflavor,tichondrius,1811,deathknight,unholy,306,152,154
143,Muspel,sargeras,1811,deathknight,unholy,65,32,33
144,Fatzilla,tichondrius,1811,deathknight,unholy,66,26,40
145,Darkcata,tichondrius,1810,deathknight,unholy,42,19,23
146,Warrcc,steamwheedle-cartel,1809,deathknight,unholy,48,24,24
147,Floreon,tichondrius,1808,deathknight,unholy,65,34,31
148,Infectik,tichondrius,1807,deathknight,unholy,59,35,24
149,Chillbaynê,the-scryers,1807,deathknight,unholy,119,62,57
150,Brocigar,tichondrius,1806,deathknight,unholy,84,43,41
151,Sagadk,hyjal,1806,deathknight,unholy,70,33,37
152,Necrôtic,area-52,1806,deathknight,unholy,76,35,41
153,Twindleroot,aggramar,1804,deathknight,unholy,77,45,32
154,Mûs,tichondrius,1804,deathknight,unholy,66,36,30
155,Asukka,tichondrius,1804,deathknight,unholy,78,32,46
156,Chimps,illidan,1803,deathknight,unholy,52,29,23
157,Kaeligh,ragnaros,1803,deathknight,unholy,66,29,37
158,Ziskon,illidan,1802,deathknight,unholy,100,53,47
159,Dtcfasd,tichondrius,1801,deathknight,unholy,32,20,12
160,Zìlêán,tichondrius,1800,deathknight,unholy,70,39,31
161,Starshopping,proudmoore,1800,deathknight,unholy,91,44,47
162,Azre,tichondrius,1800,deathknight,unholy,160,74,86
163,Avengering,tichondrius,1794,deathknight,unholy,75,40,35
164,Sithdog,blackrock,1794,deathknight,unholy,84,37,47
165,Ðomìnus,moon-guard,1792,deathknight,unholy,128,76,52
166,Bukum,zuljin,1792,deathknight,unholy,71,30,41
167,Muspellheim,azralon,1791,deathknight,unholy,54,29,25
168,Aerd,sargeras,1789,deathknight,unholy,343,172,171
169,Attack,grizzly-hills,1787,deathknight,unholy,60,28,32
170,Stankybreath,bleeding-hollow,1786,deathknight,unholy,76,37,39
171,Ddibb,tichondrius,1782,deathknight,unholy,63,30,33
172,Lighostx,tichondrius,1782,deathknight,unholy,117,54,63
173,Áethros,malganis,1778,deathknight,unholy,96,44,52
174,Loongdk,kiljaeden,1777,deathknight,unholy,195,102,93
175,Grimiz,tichondrius,1774,deathknight,unholy,145,71,74
176,Vad,skullcrusher,1771,deathknight,unholy,52,22,30
177,Jakeboyswag,shandris,1770,deathknight,unholy,155,77,78
178,Azhid,tichondrius,1769,deathknight,unholy,136,70,66
179,Demonboyjr,tichondrius,1766,deathknight,unholy,75,31,44
180,Apøçálýpsé,firetree,1765,deathknight,unholy,97,50,47
181,Doombeast,area-52,1760,deathknight,unholy,108,51,57
182,Lagérthâ,ragnaros,1756,deathknight,unholy,60,28,32
183,Ålastor,stormrage,1754,deathknight,unholy,63,35,28
184,Hwml,barthilas,1754,deathknight,unholy,141,76,65
185,Nabbiby,tichondrius,1753,deathknight,unholy,84,38,46
186,Linyive,malganis,1750,deathknight,unholy,54,30,24
187,Anhedonía,illidan,1749,deathknight,unholy,168,87,81
188,Cesaroo,aegwynn,1749,deathknight,unholy,130,64,66
189,Standalizer,gilneas,1745,deathknight,unholy,72,40,32
190,Deadsamurai,illidan,1745,deathknight,unholy,69,36,33
191,Ermanotruta,azralon,1744,deathknight,unholy,77,37,40
192,Carryme,quelthalas,1742,deathknight,unholy,92,45,47
193,Xibbas,illidan,1741,deathknight,unholy,48,27,21
194,Frozenkappa,hyjal,1737,deathknight,unholy,35,21,14
195,Nh,malganis,1737,deathknight,unholy,54,28,26
196,Teksurugi,korgath,1734,deathknight,unholy,60,32,28
197,Howdoulose,illidan,1732,deathknight,unholy,54,25,29
198,Zìlêáns,tichondrius,1730,deathknight,unholy,84,50,34
199,Infection,steamwheedle-cartel,1729,deathknight,unholy,42,20,22
200,Xebane,frostmourne,1727,deathknight,unholy,372,191,181
201,Hatrèd,quelthalas,1724,deathknight,unholy,71,36,35
202,Hhasaki,area-52,1722,deathknight,unholy,210,110,100
203,Properterps,bonechewer,1714,deathknight,unholy,140,78,62
204,Bellum,moon-guard,1713,deathknight,unholy,111,64,47
205,Lazarise,area-52,1713,deathknight,unholy,71,34,37
206,Tkyo,tichondrius,1712,deathknight,unholy,47,22,25
207,Brß,tichondrius,1711,deathknight,unholy,54,29,25
208,Bedstains,thunderlord,1708,deathknight,unholy,155,80,75
209,Nalz,drakkari,1705,deathknight,unholy,158,82,76
210,Bannedforevr,dalaran,1704,deathknight,unholy,59,26,33
211,Muscleface,moon-guard,1701,deathknight,unholy,80,45,35
212,Brandonsdk,tichondrius,1701,deathknight,unholy,164,78,86
213,Koda,thrall,1701,deathknight,unholy,77,36,41
214,Boneyards,bleeding-hollow,1701,deathknight,unholy,108,46,62
215,Justafkdk,gorefiend,1700,deathknight,unholy,84,43,41
216,Arroyo,borean-tundra,1700,deathknight,unholy,102,52,50
217,Kinkysgnome,tichondrius,1696,deathknight,unholy,131,61,70
218,Bbidd,tichondrius,1690,deathknight,unholy,30,18,12
219,Bigdekay,illidan,1687,deathknight,unholy,30,18,12
220,Mephostophel,sargeras,1687,deathknight,unholy,204,106,98
221,Khaíne,wyrmrest-accord,1687,deathknight,unholy,264,136,128
222,Bagul,azralon,1686,deathknight,unholy,48,23,25
223,Ayooplaguez,guldan,1684,deathknight,unholy,48,24,24
224,Azynks,azralon,1683,deathknight,unholy,117,55,62
225,Hanung,tichondrius,1681,deathknight,unholy,35,18,17
226,Onefire,illidan,1680,deathknight,unholy,59,29,30
227,Fakiez,kelthuzad,1679,deathknight,unholy,68,30,38
228,Krätos,zuljin,1677,deathknight,unholy,42,25,17
229,Dâki,blades-edge,1675,deathknight,unholy,114,63,51
230,Fasterjake,sargeras,1675,deathknight,unholy,122,67,55
231,Blacklabel,andorhal,1675,deathknight,unholy,72,31,41
232,Supblood,tichondrius,1673,deathknight,unholy,48,23,25
233,Noik,azralon,1673,deathknight,unholy,88,42,46
234,Giveretms,azralon,1672,deathknight,unholy,42,19,23
235,Ligmagooch,tichondrius,1671,deathknight,unholy,93,49,44
236,Cantmove,area-52,1669,deathknight,unholy,50,22,28
237,Dreadrend,sargeras,1668,deathknight,unholy,72,35,37
238,Malhandir,azgalor,1668,deathknight,unholy,54,20,34
239,Boofcigars,stormrage,1667,deathknight,unholy,39,25,14
240,Spacealien,malganis,1667,deathknight,unholy,60,32,28
241,Xhoul,sargeras,1666,deathknight,unholy,249,134,115
242,Darktone,tichondrius,1665,deathknight,unholy,35,18,17
243,Slty,tichondrius,1664,deathknight,unholy,42,18,24
244,Lichtborne,illidan,1662,deathknight,unholy,73,33,40
245,Nevmic,emerald-dream,1661,deathknight,unholy,184,88,96
246,Krargosh,quelthalas,1660,deathknight,unholy,185,96,89
247,Ståtìc,tichondrius,1659,deathknight,unholy,84,43,41
248,Imadkloldie,frostmourne,1659,deathknight,unholy,90,46,44
249,Dunduner,tichondrius,1657,deathknight,unholy,144,71,73
250,Bopalop,malganis,1657,deathknight,unholy,69,28,41
251,Kakarotó,azralon,1656,deathknight,unholy,65,37,28
252,Kjarnda,malganis,1653,deathknight,unholy,48,21,27
253,Skynyght,area-52,1652,deathknight,unholy,42,26,16
254,Pooseunpoose,velen,1652,deathknight,unholy,86,41,45
255,Jacklinn,ysondre,1651,deathknight,unholy,36,24,12
256,Ullísés,ragnaros,1651,deathknight,unholy,45,24,21
257,Kwolve,proudmoore,1651,deathknight,unholy,243,122,121
258,Jeremiahe,hyjal,1650,deathknight,unholy,90,49,41
259,Trumps,stormrage,1649,deathknight,unholy,48,27,21
260,Komplex,kelthuzad,1649,deathknight,unholy,76,40,36
261,Ludgan,stormrage,1649,deathknight,unholy,180,86,94
262,Falkorn,korgath,1648,deathknight,unholy,99,47,52
263,Justtaki,zuljin,1648,deathknight,unholy,48,20,28
264,Lickblood,sargeras,1646,deathknight,unholy,36,20,16
265,Deuter,quelthalas,1646,deathknight,unholy,243,125,118
266,Merados,quelthalas,1646,deathknight,unholy,79,30,49
267,Libitina,tichondrius,1645,deathknight,unholy,36,22,14
268,Tråuma,uther,1645,deathknight,unholy,48,25,23
269,Vexxan,thrall,1644,deathknight,unholy,41,23,18
270,Shadow,ragnaros,1643,deathknight,unholy,73,41,32
271,Galarick,area-52,1643,deathknight,unholy,41,22,19
272,Beanboyx,tichondrius,1642,deathknight,unholy,34,18,16
273,Boofcigars,sargeras,1642,deathknight,unholy,52,27,25
274,Kurnoth,barthilas,1641,deathknight,unholy,110,53,57
275,Tailm,ragnaros,1639,deathknight,unholy,36,20,16
276,Killìan,kelthuzad,1638,deathknight,unholy,54,25,29
277,Dkdanim,tichondrius,1637,deathknight,unholy,130,71,59
278,Vynox,frostmourne,1637,deathknight,unholy,56,27,29
279,Goonazz,tichondrius,1635,deathknight,unholy,54,38,16
280,Virulous,zuljin,1634,deathknight,unholy,47,26,21
281,Rycerzfrost,ragnaros,1634,deathknight,unholy,113,59,54
282,Grimmdreamer,stormrage,1634,deathknight,unholy,76,37,39
283,Azibar,moon-guard,1632,deathknight,unholy,47,24,23
284,Raps,frostmourne,1632,deathknight,unholy,56,23,33
285,Reizu,ragnaros,1631,deathknight,unholy,45,27,18
286,Lùcius,garrosh,1631,deathknight,unholy,154,82,72
287,Zedsdead,mannoroth,1630,deathknight,unholy,42,24,18
288,Zerochillz,sargeras,1628,deathknight,unholy,30,17,13
289,Kenishii,kiljaeden,1627,deathknight,unholy,48,30,18
290,Asastac,tichondrius,1627,deathknight,unholy,42,24,18
291,Landez,ragnaros,1627,deathknight,unholy,66,37,29
292,Elyxoxo,tichondrius,1627,deathknight,unholy,84,44,40
293,Littlekims,emerald-dream,1627,deathknight,unholy,46,24,22
294,Wastethis,sargeras,1626,deathknight,unholy,71,40,31
295,Banjingquan,tichondrius,1625,deathknight,unholy,88,53,35
296,Paratekdk,thrall,1625,deathknight,unholy,71,39,32
297,Megatroun,stormreaver,1625,deathknight,unholy,42,23,19
298,Bladê,tichondrius,1624,deathknight,unholy,61,26,35
299,Pettyk,tichondrius,1624,deathknight,unholy,42,17,25
300,Auniel,gorefiend,1622,deathknight,unholy,54,22,32
301,Puppykiss,perenolde,1622,deathknight,unholy,57,22,35
302,Fadedlight,zuljin,1621,deathknight,unholy,108,57,51
303,Billieeilish,sargeras,1621,deathknight,unholy,80,42,38
304,Asterend,proudmoore,1621,deathknight,unholy,52,23,29
305,Xraduky,dawnbringer,1620,deathknight,unholy,38,26,12
306,Raíndrop,tichondrius,1620,deathknight,unholy,150,81,69
307,Yubell,barthilas,1620,deathknight,unholy,353,176,177
308,Arcticc,area-52,1620,deathknight,unholy,54,24,30
309,Struggler,velen,1619,deathknight,unholy,60,34,26
310,Wheatasil,garona,1618,deathknight,unholy,70,36,34
311,Reapsouls,stormrage,1617,deathknight,unholy,42,30,12
312,Lichanis,bonechewer,1617,deathknight,unholy,102,50,52
313,Søad,quelthalas,1615,deathknight,unholy,135,72,63
314,Yamanji,wyrmrest-accord,1614,deathknight,unholy,110,61,49
315,Nøsfferatus,azralon,1613,deathknight,unholy,77,41,36
316,Kterrorblade,sargeras,1613,deathknight,unholy,180,92,88
317,Døømhøund,tichondrius,1612,deathknight,unholy,98,48,50
318,Rezøk,ragnaros,1612,deathknight,unholy,54,20,34
319,Alistra,frostmourne,1611,deathknight,unholy,42,20,22
320,Ðogmá,vashj,1610,deathknight,unholy,35,22,13
321,Mikoaa,bladefist,1610,deathknight,unholy,30,17,13
322,Regiknight,stormrage,1610,deathknight,unholy,239,135,104
323,Puppykisses,perenolde,1610,deathknight,unholy,101,45,56
324,Lichkong,dalaran,1609,deathknight,unholy,76,43,33
325,Aldebamuu,ragnaros,1609,deathknight,unholy,156,81,75
326,Lagmasterx,sargeras,1609,deathknight,unholy,42,20,22
327,Ousted,daggerspine,1608,deathknight,unholy,36,20,16
328,Lemuriön,nemesis,1607,deathknight,unholy,43,20,23
329,Bulí,barthilas,1607,deathknight,unholy,42,19,23
330,Gripd,area-52,1606,deathknight,unholy,48,26,22
331,Ultimatdeath,jubeithos,1606,deathknight,unholy,66,30,36
332,Ædolph,barthilas,1605,deathknight,unholy,30,17,13
333,Takeurcheeks,tichondrius,1605,deathknight,unholy,101,49,52
334,Ãstaroth,stormrage,1605,deathknight,unholy,48,22,26
335,Notorious,garrosh,1605,deathknight,unholy,42,18,24
336,Boofcigars,kelthuzad,1604,deathknight,unholy,77,41,36
337,Unholykevin,sargeras,1604,deathknight,unholy,42,21,21
338,Dominos,tichondrius,1604,deathknight,unholy,42,20,22
339,Idodamn,tichondrius,1603,deathknight,unholy,84,45,39
340,Wednesdæ,moon-guard,1603,deathknight,unholy,54,28,26
341,Wisdôm,frostmourne,1603,deathknight,unholy,59,30,29
342,Nymppho,kelthuzad,1603,deathknight,unholy,337,160,177
343,Kranaz,frostmourne,1603,deathknight,unholy,36,17,19
344,Malsedius,kelthuzad,1603,deathknight,unholy,87,36,51
345,Voncleaver,tichondrius,1603,deathknight,unholy,70,23,47
346,Gargoylepowa,nemesis,1602,deathknight,unholy,42,20,22
347,Nofoamlattes,thrall,1602,deathknight,unholy,42,19,23
348,Originalcimm,stormrage,1601,deathknight,unholy,66,28,38
349,Promotheseis,sargeras,1600,deathknight,unholy,66,41,25
350,Giznator,malganis,1598,deathknight,unholy,108,50,58
351,Ilikelydead,tichondrius,1592,deathknight,unholy,126,61,65
352,Wittlewanka,zuljin,1592,deathknight,unholy,112,51,61
353,Ulísés,ragnaros,1591,deathknight,unholy,58,20,38
354,Gripyourhoe,tichondrius,1589,deathknight,unholy,48,28,20
355,Earthican,bleeding-hollow,1589,deathknight,unholy,36,20,16
356,Eyir,thaurissan,1588,deathknight,unholy,104,50,54
357,Morrticia,malganis,1587,deathknight,unholy,55,35,20
358,Orkky,jubeithos,1587,deathknight,unholy,139,68,71
359,Onlyfunss,moon-guard,1584,deathknight,unholy,119,58,61
360,Fuzzknight,ravenholdt,1583,deathknight,unholy,54,27,27
361,Raahjx,sargeras,1582,deathknight,unholy,36,20,16
362,Toophus,sargeras,1581,deathknight,unholy,80,39,41
363,Jongro,tichondrius,1580,deathknight,unholy,42,25,17
364,Emopalli,tichondrius,1579,deathknight,unholy,152,77,75
365,Divinium,bleeding-hollow,1579,deathknight,unholy,42,18,24
366,Frostbite,the-venture-co,1577,deathknight,unholy,84,48,36
367,Orcsexual,azralon,1575,deathknight,unholy,42,20,22
368,Daethiel,demon-soul,1574,deathknight,unholy,77,36,41
369,Kaaizer,azralon,1572,deathknight,unholy,120,68,52
370,Fydedk,stormrage,1572,deathknight,unholy,90,44,46
371,Yikk,illidan,1569,deathknight,unholy,42,19,23
372,Evilbot,tichondrius,1564,deathknight,unholy,60,40,20
373,Grimnuts,thrall,1564,deathknight,unholy,92,49,43
374,Howlex,barthilas,1563,deathknight,unholy,48,24,24
375,Allianknight,windrunner,1561,deathknight,unholy,42,21,21
376,Axeldrion,tichondrius,1561,deathknight,unholy,58,27,31
377,Feej,malganis,1557,deathknight,unholy,36,21,15
378,Burbash,moon-guard,1555,deathknight,unholy,181,92,89
379,Drpepp,bleeding-hollow,1554,deathknight,unholy,161,85,76
380,Claudio,tichondrius,1554,deathknight,unholy,51,18,33
381,Jacklynn,ragnaros,1553,deathknight,unholy,30,19,11
382,Icytoast,tichondrius,1553,deathknight,unholy,42,19,23
383,Gottajuice,moonrunner,1551,deathknight,unholy,81,45,36
384,Siphilusxo,dalaran,1551,deathknight,unholy,36,20,16
385,Arc,maiev,1551,deathknight,unholy,93,39,54
386,Kalgor,illidan,1550,deathknight,unholy,138,71,67
387,Tuicca,frostmane,1550,deathknight,unholy,79,34,45
388,Obedient,firetree,1549,deathknight,unholy,132,76,56
389,Kuwarerubana,proudmoore,1549,deathknight,unholy,74,41,33
390,Drfauci,boulderfist,1544,deathknight,unholy,36,18,18
391,Läskö,area-52,1541,deathknight,unholy,67,39,28
392,Agohnim,moon-guard,1541,deathknight,unholy,55,29,26
393,Zzdk,thrall,1541,deathknight,unholy,57,27,30
394,Rixin,agamaggan,1538,deathknight,unholy,66,28,38
395,Deathwavez,cenarius,1537,deathknight,unholy,42,21,21
396,Rhors,nemesis,1536,deathknight,unholy,58,30,28
397,Pue,hyjal,1536,deathknight,unholy,36,17,19
398,Asheravon,moon-guard,1535,deathknight,unholy,330,160,170
399,Zukcho,tichondrius,1534,deathknight,unholy,48,19,29
400,Garht,azralon,1533,deathknight,unholy,40,22,18
401,Huuzzha,tichondrius,1533,deathknight,unholy,166,84,82
402,Althamon,tanaris,1533,deathknight,unholy,96,44,52
403,Chachio,kiljaeden,1532,deathknight,unholy,30,16,14
404,Telrenaur,proudmoore,1532,deathknight,unholy,72,35,37
405,Arktoz,tichondrius,1531,deathknight,unholy,30,16,14
406,Biefeile,tichondrius,1531,deathknight,unholy,46,21,25
407,Clearlol,bleeding-hollow,1531,deathknight,unholy,36,16,20
408,Eldavò,quelthalas,1530,deathknight,unholy,78,39,39
409,Dialysis,emerald-dream,1530,deathknight,unholy,137,68,69
410,Kindaholy,malganis,1528,deathknight,unholy,23,17,6
411,Deezwaz,draka,1526,deathknight,unholy,46,25,21
412,Kellydean,moon-guard,1524,deathknight,unholy,99,50,49
413,Deathbloss,illidan,1523,deathknight,unholy,32,17,15
414,Tigs,proudmoore,1522,deathknight,unholy,126,65,61
415,Urp,aggramar,1520,deathknight,unholy,39,17,22
416,Hooterzqt,tichondrius,1518,deathknight,unholy,106,47,59
417,Takeoverr,ragnaros,1515,deathknight,unholy,90,53,37
418,Deathzpeckt,tichondrius,1513,deathknight,unholy,36,17,19
419,Plagueghoul,wyrmrest-accord,1510,deathknight,unholy,149,80,69
420,Devillele,proudmoore,1509,deathknight,unholy,78,36,42
421,Sandrexx,tichondrius,1506,deathknight,unholy,46,22,24
422,Dexarax,norgannon,1505,deathknight,unholy,87,49,38
423,Urieen,gorefiend,1505,deathknight,unholy,77,43,34
424,Coldsleeps,saurfang,1503,deathknight,unholy,30,16,14
425,Neaz,moon-guard,1503,deathknight,unholy,30,16,14
426,Unfórgíven,arthas,1501,deathknight,unholy,48,17,31
427,Cammy,frostmourne,1500,deathknight,unholy,29,16,13
428,Degrease,bonechewer,1500,deathknight,unholy,61,28,33
429,Revvun,tichondrius,1499,deathknight,unholy,36,17,19
430,Abroham,arthas,1498,deathknight,unholy,59,30,29
431,Hooker,dragonmaw,1497,deathknight,unholy,61,35,26
432,Irreversible,zuljin,1497,deathknight,unholy,41,16,25
433,Stoicïsm,tichondrius,1496,deathknight,unholy,114,63,51
434,Naxn,tichondrius,1495,deathknight,unholy,54,25,29
435,Fugs,ghostlands,1494,deathknight,unholy,86,48,38
436,Buttrfingrz,cenarius,1494,deathknight,unholy,78,35,43
437,Zaluster,malganis,1491,deathknight,unholy,233,120,113
438,Apocxo,lightnings-blade,1491,deathknight,unholy,119,58,61
439,Zaxrree,malganis,1490,deathknight,unholy,66,39,27
440,Ghoulslasher,bleeding-hollow,1490,deathknight,unholy,62,28,34
441,Kcorides,tichondrius,1488,deathknight,unholy,49,28,21
442,Laxatives,tichondrius,1488,deathknight,unholy,45,19,26
443,Thenin,crushridge,1487,deathknight,unholy,54,32,22
444,Blackary,emerald-dream,1486,deathknight,unholy,47,30,17
445,Madmaxxy,barthilas,1484,deathknight,unholy,176,92,84
446,Typhøn,illidan,1484,deathknight,unholy,157,78,79
447,Akilol,tichondrius,1484,deathknight,unholy,36,16,20
448,Saighast,illidan,1482,deathknight,unholy,72,39,33
449,Unholyfish,malganis,1482,deathknight,unholy,145,75,70
450,Rhaeisxalnym,sargeras,1480,deathknight,unholy,160,79,81
451,Alexeous,wyrmrest-accord,1479,deathknight,unholy,178,94,84
452,Deadspellz,bleeding-hollow,1479,deathknight,unholy,58,17,41
453,Brounlyii,drakkari,1478,deathknight,unholy,54,35,19
454,Tiansama,ragnaros,1478,deathknight,unholy,30,18,12
455,Ellipsoro,onyxia,1478,deathknight,unholy,66,26,40
456,Nialich,kelthuzad,1476,deathknight,unholy,41,16,25
457,Holsey,moon-guard,1473,deathknight,unholy,48,26,22
458,Papalich,stormrage,1473,deathknight,unholy,198,94,104
459,Tracyminaj,tichondrius,1472,deathknight,unholy,78,37,41
460,Garù,ragnaros,1471,deathknight,unholy,62,33,29
461,Grayfoxx,twisting-nether,1469,deathknight,unholy,41,18,23
462,Brisblade,shattered-hand,1468,deathknight,unholy,54,29,25
463,Reinhartlol,sargeras,1468,deathknight,unholy,99,49,50
464,Joeyxdk,tichondrius,1467,deathknight,unholy,29,16,13
465,Tenóry,nemesis,1466,deathknight,unholy,102,49,53
466,Xlive,tichondrius,1466,deathknight,unholy,42,17,25
467,Câpîrota,nemesis,1465,deathknight,unholy,52,25,27
468,Böffa,dalaran,1465,deathknight,unholy,59,21,38
469,Rognarash,emerald-dream,1464,deathknight,unholy,48,25,23
470,Tronnie,kelthuzad,1464,deathknight,unholy,78,40,38
471,Dazerl,stormrage,1463,deathknight,unholy,54,27,27
472,Dóm,proudmoore,1463,deathknight,unholy,78,33,45
473,Catena,blood-furnace,1461,deathknight,unholy,83,35,48
474,Fallen,nazjatar,1460,deathknight,unholy,36,23,13
475,Vamplyz,kelthuzad,1460,deathknight,unholy,39,22,17
476,Darthsydius,azralon,1460,deathknight,unholy,51,26,25
477,Släke,azralon,1460,deathknight,unholy,166,81,85
478,Witdk,illidan,1460,deathknight,unholy,85,39,46
479,Mordumi,stormrage,1459,deathknight,unholy,61,26,35
480,Rk,blackhand,1457,deathknight,unholy,97,58,39
481,Jaxxftw,azralon,1457,deathknight,unholy,70,38,32
482,Grizzdk,blackrock,1457,deathknight,unholy,36,18,18
483,Aundethell,moon-guard,1453,deathknight,unholy,51,16,35
484,Wryu,malganis,1451,deathknight,unholy,47,27,20
485,Deathsatan,barthilas,1451,deathknight,unholy,90,50,40
486,Ams,moon-guard,1450,deathknight,unholy,60,32,28
487,Unholyreap,arthas,1449,deathknight,unholy,46,29,17
488,Allhejluya,illidan,1449,deathknight,unholy,199,101,98
489,Balboskina,shattered-hand,1448,deathknight,unholy,76,39,37
490,Dûsk,thunderlord,1442,deathknight,unholy,64,28,36
491,Risottonero,kelthuzad,1440,deathknight,unholy,203,103,100
492,Gerometal,ragnaros,1440,deathknight,unholy,42,18,24
493,Breadtruck,area-52,1440,deathknight,unholy,75,31,44
494,Dreadfang,the-venture-co,1438,deathknight,unholy,24,15,9
495,Corrpsse,tichondrius,1438,deathknight,unholy,157,81,76
496,Redbr,tichondrius,1437,deathknight,unholy,78,37,41
497,Flavorchops,kelthuzad,1437,deathknight,unholy,48,16,32
498,Paíín,illidan,1433,deathknight,unholy,78,39,39
499,Greenduck,malganis,1433,deathknight,unholy,30,15,15
500,Nokenoke,illidan,1433,deathknight,unholy,263,130,133
501,Unknowndk,kul-tiras,1433,deathknight,unholy,52,24,28
502,Demonnation,illidan,1433,deathknight,unholy,144,60,84
503,Exin,cenarion-circle,1432,deathknight,unholy,24,15,9
504,Moonjae,illidan,1432,deathknight,unholy,24,15,9
505,Cliffdk,kelthuzad,1431,deathknight,unholy,51,15,36
506,Chainsawmàn,tichondrius,1430,deathknight,unholy,98,50,48
507,Unrealzrotz,tichondrius,1429,deathknight,unholy,76,48,28
508,Happynaru,tichondrius,1427,deathknight,unholy,72,34,38
509,Nawis,quelthalas,1426,deathknight,unholy,41,19,22
510,Coffeebagel,bleeding-hollow,1426,deathknight,unholy,149,65,84
511,Clapt,kelthuzad,1425,deathknight,unholy,30,15,15
512,Lazenca,malganis,1424,deathknight,unholy,32,22,10
513,Mortarion,icecrown,1424,deathknight,unholy,190,91,99
514,Anexdk,korgath,1423,deathknight,unholy,24,15,9
515,Seiyokú,ragnaros,1422,deathknight,unholy,103,53,50
516,Jarah,destromath,1422,deathknight,unholy,54,25,29
517,Nightskull,malganis,1421,deathknight,unholy,48,23,25
518,Sannistus,ysera,1420,deathknight,unholy,97,43,54
519,Asana,illidan,1419,deathknight,unholy,53,24,29
520,Viràlyourz,bleeding-hollow,1418,deathknight,unholy,30,19,11
521,Sgtdead,thrall,1418,deathknight,unholy,63,35,28
522,Hornpipe,borean-tundra,1418,deathknight,unholy,126,61,65
523,Aradorn,azralon,1418,deathknight,unholy,191,90,101
524,Fellenn,stormrage,1417,deathknight,unholy,144,78,66
525,Yareyare,tichondrius,1417,deathknight,unholy,54,29,25
526,Pmpfrmdwntwn,stormrage,1417,deathknight,unholy,67,28,39
527,Deathofchaos,smolderthorn,1417,deathknight,unholy,65,25,40
528,Seranta,wyrmrest-accord,1417,deathknight,unholy,54,19,35
529,Rongkhun,proudmoore,1417,deathknight,unholy,48,15,33
530,Sniperlord,uldaman,1415,deathknight,unholy,90,51,39
531,Gêralt,darkspear,1414,deathknight,unholy,36,18,18
532,Subparatbest,chogall,1414,deathknight,unholy,30,15,15
533,Fanggrief,proudmoore,1414,deathknight,unholy,121,57,64
534,Knownkilla,hyjal,1413,deathknight,unholy,83,47,36
535,Bloodramen,dalaran,1413,deathknight,unholy,357,182,175
536,Ganancïa,nemesis,1412,deathknight,unholy,51,28,23
537,Deathpool,shadowmoon,1409,deathknight,unholy,54,19,35
538,Desen,arthas,1408,deathknight,unholy,39,15,24
539,Rimothedk,illidan,1407,deathknight,unholy,36,17,19
540,Dezmond,quelthalas,1404,deathknight,unholy,48,21,27
541,Arkhän,ragnaros,1404,deathknight,unholy,52,18,34
542,Hatreon,sargeras,1401,deathknight,unholy,30,20,10
543,Hipower,moon-guard,1401,deathknight,unholy,138,72,66
544,Sílthree,barthilas,1401,deathknight,unholy,42,17,25
545,Yadaddy,hydraxis,1400,deathknight,unholy,42,23,19
546,Ventuss,bleeding-hollow,1399,deathknight,unholy,60,31,29
547,Gankstagrip,anvilmar,1399,deathknight,unholy,108,52,56
548,Vazarus,darrowmere,1397,deathknight,unholy,66,30,36
549,Wndypefrcorn,sargeras,1394,deathknight,unholy,59,35,24
550,Ðaz,zuljin,1394,deathknight,unholy,48,26,22
551,Fzero,frostmourne,1392,deathknight,unholy,66,23,43
552,Paulpatine,tichondrius,1391,deathknight,unholy,60,22,38
553,Coolk,tichondrius,1389,deathknight,unholy,96,52,44
554,Starms,ragnaros,1388,deathknight,unholy,71,30,41
555,Sammåel,malganis,1387,deathknight,unholy,36,18,18
556,Xènia,exodar,1387,deathknight,unholy,34,16,18
557,Mehithee,kiljaeden,1387,deathknight,unholy,110,40,70
558,Wrothgarr,stormreaver,1386,deathknight,unholy,48,27,21
559,Frosstbeach,hyjal,1384,deathknight,unholy,59,25,34
560,Egirlgripper,area-52,1382,deathknight,unholy,30,15,15
561,Anonymousix,kelthuzad,1381,deathknight,unholy,41,21,20
562,Dkfenix,ragnaros,1380,deathknight,unholy,89,39,50
563,Silanvia,wyrmrest-accord,1377,deathknight,unholy,66,30,36
564,Mèrc,ragnaros,1376,deathknight,unholy,89,38,51
565,Any,the-venture-co,1376,deathknight,unholy,60,25,35
566,Sparklekitty,illidan,1374,deathknight,unholy,24,16,8
567,Greeasy,bleeding-hollow,1374,deathknight,unholy,41,23,18
568,Volcolm,kelthuzad,1373,deathknight,unholy,54,26,28
569,Feorlar,dalaran,1373,deathknight,unholy,42,19,23
570,Midway,drakkari,1372,deathknight,unholy,48,27,21
571,Flo,ghostlands,1371,deathknight,unholy,45,26,19
572,Pacedd,silvermoon,1370,deathknight,unholy,30,15,15
573,Zuly,moon-guard,1369,deathknight,unholy,113,54,59
574,Putrefactive,frostmourne,1368,deathknight,unholy,174,85,89
575,Earador,dalaran,1365,deathknight,unholy,61,30,31
576,Darkunral,stormrage,1365,deathknight,unholy,80,33,47
577,Zeban,area-52,1364,deathknight,unholy,84,40,44
578,Warstompgød,tichondrius,1364,deathknight,unholy,36,16,20
579,Waremoto,ragnaros,1361,deathknight,unholy,81,47,34
580,Dredrikbane,moon-guard,1361,deathknight,unholy,35,20,15
581,Necrósy,azralon,1360,deathknight,unholy,54,23,31
582,Cimitiere,stormrage,1360,deathknight,unholy,49,19,30
583,Krixia,ragnaros,1359,deathknight,unholy,52,25,27
584,Awzy,azralon,1358,deathknight,unholy,48,26,22
585,Hydree,bleeding-hollow,1358,deathknight,unholy,42,17,25
586,Luckyson,tichondrius,1357,deathknight,unholy,40,19,21
587,Dravoc,kelthuzad,1355,deathknight,unholy,66,26,40
588,Shélly,ragnaros,1354,deathknight,unholy,83,41,42
589,Unhøøly,nemesis,1351,deathknight,unholy,71,40,31
590,Humber,area-52,1350,deathknight,unholy,107,56,51
591,Bumbleton,blackrock,1349,deathknight,unholy,45,24,21
592,Seíver,ragnaros,1346,deathknight,unholy,29,15,14
593,Atrahazis,quelthalas,1343,deathknight,unholy,29,19,10
594,Dethcro,shandris,1343,deathknight,unholy,93,47,46
595,Deathwardenn,ghostlands,1343,deathknight,unholy,36,17,19
596,Shadowsdk,tichondrius,1342,deathknight,unholy,36,14,22
597,Vaizard,malganis,1341,deathknight,unholy,24,14,10
598,Afterdeath,frostmourne,1340,deathknight,unholy,42,19,23
599,Lücìfër,illidan,1340,deathknight,unholy,55,23,32
600,Koltíra,azralon,1339,deathknight,unholy,50,26,24
601,Tragdore,thrall,1339,deathknight,unholy,31,16,15
602,Golurun,tichondrius,1338,deathknight,unholy,31,19,12
603,Níce,tichondrius,1338,deathknight,unholy,36,14,22
604,Tötenkaiser,quelthalas,1337,deathknight,unholy,30,14,16
605,Monstrosìty,bleeding-hollow,1336,deathknight,unholy,18,14,4
606,Kkoduck,tichondrius,1336,deathknight,unholy,32,17,15
607,Cswildwind,aerie-peak,1336,deathknight,unholy,48,21,27
608,Oomak,bonechewer,1336,deathknight,unholy,36,14,22
609,Ântipaladin,arthas,1335,deathknight,unholy,46,19,27
610,Bhyrnam,ragnaros,1335,deathknight,unholy,42,14,28
611,Fiddleop,thrall,1333,deathknight,unholy,24,14,10
612,Mëgazørd,azralon,1333,deathknight,unholy,66,36,30
613,Beeftip,area-52,1333,deathknight,unholy,209,99,110
614,Scorpíøn,azralon,1332,deathknight,unholy,30,18,12
615,Negril,tichondrius,1332,deathknight,unholy,78,38,40
616,Gromhal,azralon,1331,deathknight,unholy,24,14,10
617,Erodin,moon-guard,1330,deathknight,unholy,30,14,16
618,Zxy,hyjal,1327,deathknight,unholy,23,17,6
619,Vynkys,shadow-council,1327,deathknight,unholy,59,33,26
620,Zifandel,tichondrius,1326,deathknight,unholy,30,14,16
621,Rekbari,sargeras,1325,deathknight,unholy,24,15,9
622,Ñovacaine,moon-guard,1325,deathknight,unholy,83,40,43
623,Menethiljr,boulderfist,1324,deathknight,unholy,30,14,16
624,Unholychillz,ghostlands,1324,deathknight,unholy,44,20,24
625,Kordrâk,quelthalas,1322,deathknight,unholy,41,20,21
626,Esquinência,azralon,1322,deathknight,unholy,36,17,19
627,Stangz,bonechewer,1322,deathknight,unholy,36,14,22
628,Asylïthcc,sargeras,1321,deathknight,unholy,60,34,26
629,Mords,area-52,1321,deathknight,unholy,30,14,16
630,Nappão,azralon,1321,deathknight,unholy,85,29,56
631,Darknessice,tichondrius,1320,deathknight,unholy,78,40,38
632,Zetarexia,area-52,1318,deathknight,unholy,61,27,34
633,Gilden,malfurion,1317,deathknight,unholy,80,34,46
634,Belegos,quelthalas,1314,deathknight,unholy,93,42,51
635,Demona,ragnaros,1312,deathknight,unholy,58,22,36
636,Maligned,uldum,1312,deathknight,unholy,49,18,31
637,Zevrynn,barthilas,1311,deathknight,unholy,36,18,18
638,Frðst,executus,1310,deathknight,unholy,24,14,10
639,Aretos,dreadmaul,1308,deathknight,unholy,56,27,29
640,Shhnitzle,stormrage,1305,deathknight,unholy,36,14,22
641,Gwiffhm,tichondrius,1304,deathknight,unholy,40,14,26
642,Rottenwiener,sargeras,1303,deathknight,unholy,35,22,13
643,Shezoe,drakkari,1302,deathknight,unholy,36,14,22
644,Darkàn,lightnings-blade,1301,deathknight,unholy,42,20,22
645,Arcainian,tichondrius,1300,deathknight,unholy,147,65,82
646,Deephideblue,proudmoore,1300,deathknight,unholy,43,14,29
647,Rhaenyrà,tichondrius,1299,deathknight,unholy,33,19,14
648,Killerundead,area-52,1299,deathknight,unholy,39,17,22
649,Kallgìn,emerald-dream,1299,deathknight,unholy,36,15,21
650,Skppee,tichondrius,1295,deathknight,unholy,27,14,13
651,Sabotdk,tichondrius,1291,deathknight,unholy,42,23,19
652,Unholycube,zuljin,1290,deathknight,unholy,35,14,21
653,Cripticknigt,spinebreaker,1289,deathknight,unholy,48,22,26
654,Muffinstomp,eredar,1288,deathknight,unholy,71,40,31
655,Bloodserfer,sargeras,1286,deathknight,unholy,54,25,29
656,Coldrhelx,quelthalas,1283,deathknight,unholy,60,21,39
657,Mainxx,stormrage,1282,deathknight,unholy,29,14,15
658,Sheipadinho,nemesis,1280,deathknight,unholy,51,34,17
659,Isaarid,proudmoore,1275,deathknight,unholy,34,20,14
660,Harlthas,ragnaros,1274,deathknight,unholy,30,17,13
661,Magipierrot,ragnaros,1274,deathknight,unholy,92,47,45
662,Ometecuhtli,kelthuzad,1273,deathknight,unholy,60,35,25
663,Kromgarath,stormrage,1271,deathknight,unholy,60,28,32
664,Genjírou,frostwolf,1269,deathknight,unholy,294,143,151
665,Tëte,quelthalas,1269,deathknight,unholy,35,14,21
666,Ahrímán,illidan,1263,deathknight,unholy,116,52,64
667,Déká,tichondrius,1261,deathknight,unholy,42,19,23
668,Nukydoe,azralon,1260,deathknight,unholy,42,19,23
669,Tonylin,tichondrius,1258,deathknight,unholy,32,14,18
670,Abruptdk,bonechewer,1254,deathknight,unholy,61,29,32
671,Leiry,darkspear,1253,deathknight,unholy,32,20,12
672,Xtador,quelthalas,1252,deathknight,unholy,29,15,14
673,Unleud,tichondrius,1251,deathknight,unholy,54,30,24
674,Shargan,tichondrius,1251,deathknight,unholy,90,46,44
675,Ownaron,moon-guard,1249,deathknight,unholy,45,24,21
676,Resumen,steamwheedle-cartel,1249,deathknight,unholy,32,15,17
677,Pugnation,uther,1247,deathknight,unholy,30,19,11
678,Shxtlørdx,stormrage,1247,deathknight,unholy,24,13,11
679,Clowngodx,illidan,1247,deathknight,unholy,24,13,11
680,Darktonelol,tichondrius,1247,deathknight,unholy,30,13,17
681,Artyboy,icecrown,1247,deathknight,unholy,30,13,17
682,Buldrokastee,tichondrius,1247,deathknight,unholy,36,13,23
683,Hotdk,thrall,1247,deathknight,unholy,36,13,23
684,Apoz,tichondrius,1246,deathknight,unholy,18,13,5
685,Bloodyloco,malganis,1246,deathknight,unholy,64,32,32
686,Metinchaff,shadowmoon,1245,deathknight,unholy,18,13,5
687,Daixks,proudmoore,1245,deathknight,unholy,42,22,20
688,Aisö,bleeding-hollow,1244,deathknight,unholy,36,13,23
689,Lovedaddy,frostmourne,1242,deathknight,unholy,30,13,17
690,Bubblesdk,whisperwind,1242,deathknight,unholy,66,27,39
691,Youngmoneyyd,illidan,1241,deathknight,unholy,18,13,5
692,Deliriioh,ragnaros,1241,deathknight,unholy,198,100,98
693,Deathstrikex,tichondrius,1240,deathknight,unholy,24,13,11
694,Omegaseven,gorgonnash,1240,deathknight,unholy,184,98,86
695,Frostyclaws,blackrock,1237,deathknight,unholy,24,13,11
696,Janco,runetotem,1236,deathknight,unholy,18,13,5
697,Lebrônjames,tichondrius,1236,deathknight,unholy,24,13,11
698,Quiet,darkspear,1236,deathknight,unholy,30,13,17
699,Neipum,stormrage,1234,deathknight,unholy,18,13,5
700,Voldrezhul,area-52,1234,deathknight,unholy,36,17,19
701,Rarum,bleeding-hollow,1233,deathknight,unholy,24,13,11
702,Hellzkknight,tichondrius,1231,deathknight,unholy,34,16,18
703,Latroz,gundrak,1231,deathknight,unholy,54,22,32
704,Treikorh,quelthalas,1230,deathknight,unholy,148,66,82
705,Deathdra,illidan,1229,deathknight,unholy,24,16,8
706,Soulhuntress,doomhammer,1227,deathknight,unholy,114,58,56
707,Dkjs,anetheron,1227,deathknight,unholy,42,17,25
708,Unhølydøøm,misha,1226,deathknight,unholy,78,39,39
709,Sokthr,proudmoore,1224,deathknight,unholy,38,17,21
710,Potatobob,dalaran,1222,deathknight,unholy,30,13,17
711,Gatrars,sargeras,1221,deathknight,unholy,84,39,45
712,Terracundo,quelthalas,1217,deathknight,unholy,30,17,13
713,Lockstocked,dathremar,1215,deathknight,unholy,31,18,13
714,Mazey,moon-guard,1209,deathknight,unholy,199,98,101
715,Nevarro,lightbringer,1209,deathknight,unholy,234,114,120
716,Heärt,bleeding-hollow,1208,deathknight,unholy,86,40,46
717,Lieyanyanwan,tichondrius,1207,deathknight,unholy,48,19,29
718,Frostbytez,barthilas,1204,deathknight,unholy,29,13,16
719,Enjal,stormrage,1203,deathknight,unholy,71,30,41
720,Deathafter,tichondrius,1202,deathknight,unholy,63,28,35
721,Tugs,nathrezim,1202,deathknight,unholy,36,16,20
722,Yosemithe,quelthalas,1201,deathknight,unholy,24,13,11
723,Lorð,malganis,1195,deathknight,unholy,48,24,24
724,Masochrist,baelgun,1192,deathknight,unholy,33,14,19
725,Möchi,ragnaros,1190,deathknight,unholy,75,36,39
726,Dkzote,quelthalas,1187,deathknight,unholy,66,23,43
727,Leviiathan,tichondrius,1185,deathknight,unholy,30,14,16
728,Toroandmoi,area-52,1184,deathknight,unholy,36,16,20
729,Edhral,ragnaros,1184,deathknight,unholy,36,16,20
730,Sne,dragonmaw,1180,deathknight,unholy,30,17,13
731,Byres,kelthuzad,1178,deathknight,unholy,28,13,15
732,Coffïnfeeder,dalaran,1178,deathknight,unholy,78,31,47
733,Darthblade,darkspear,1177,deathknight,unholy,66,43,23
734,Drowhd,nemesis,1177,deathknight,unholy,60,27,33
735,Deadwait,rivendare,1175,deathknight,unholy,22,13,9
736,Jhiv,tichondrius,1172,deathknight,unholy,28,14,14
737,Blightrish,icecrown,1172,deathknight,unholy,66,32,34
738,Thedarksoul,agamaggan,1172,deathknight,unholy,57,25,32
739,Volardan,trollbane,1171,deathknight,unholy,27,16,11
740,Hanmayuziro,tichondrius,1171,deathknight,unholy,23,13,10
741,Furcht,gundrak,1171,deathknight,unholy,26,13,13
742,Mmrhostage,kelthuzad,1165,deathknight,unholy,30,14,16
743,Jukpark,tichondrius,1158,deathknight,unholy,60,36,24
744,Umbranox,arthas,1158,deathknight,unholy,60,21,39
745,Zeeroo,moon-guard,1157,deathknight,unholy,52,25,27
746,Hobdk,malganis,1156,deathknight,unholy,33,13,20
747,Trüppen,area-52,1153,deathknight,unholy,58,31,27
748,Oql,tichondrius,1152,deathknight,unholy,24,12,12
749,Diviniumx,bleeding-hollow,1152,deathknight,unholy,27,13,14
750,Andeadx,tichondrius,1152,deathknight,unholy,30,12,18
751,Méthmonster,stormrage,1150,deathknight,unholy,39,23,16
752,Balakk,tichondrius,1150,deathknight,unholy,34,15,19
753,Nihlan,sargeras,1150,deathknight,unholy,30,12,18
754,Kryptikkyt,blackrock,1150,deathknight,unholy,30,12,18
755,Vesel,tichondrius,1149,deathknight,unholy,36,12,24
756,Bazzingaxd,hyjal,1148,deathknight,unholy,54,34,20
757,Exequias,zuljin,1148,deathknight,unholy,42,24,18
758,Azgaroth,dathremar,1148,deathknight,unholy,38,20,18
759,Migwel,emerald-dream,1147,deathknight,unholy,24,12,12
760,Zebastion,amanthul,1147,deathknight,unholy,36,15,21
761,Vaseline,zangarmarsh,1146,deathknight,unholy,113,58,55
762,Oldskul,sargeras,1146,deathknight,unholy,34,17,17
763,Dkbunny,thaurissan,1146,deathknight,unholy,24,12,12
764,Chalamander,tichondrius,1146,deathknight,unholy,24,12,12
765,Iamthedanger,aerie-peak,1145,deathknight,unholy,24,12,12
766,Kehin,azralon,1144,deathknight,unholy,70,29,41
767,Vaske,azjolnerub,1144,deathknight,unholy,61,25,36
768,Dravix,azshara,1143,deathknight,unholy,18,12,6
769,Fruitvender,kelthuzad,1143,deathknight,unholy,30,12,18
770,Trentus,illidan,1142,deathknight,unholy,72,36,36
771,Skeleton,lightnings-blade,1141,deathknight,unholy,33,13,20
772,Skellig,wyrmrest-accord,1137,deathknight,unholy,60,24,36
773,Deadlyforce,sargeras,1136,deathknight,unholy,18,12,6
774,Galaxrz,bonechewer,1136,deathknight,unholy,24,14,10
775,Noahmelo,nemesis,1136,deathknight,unholy,25,13,12
776,Araris,stormrage,1135,deathknight,unholy,36,12,24
777,Shinici,kelthuzad,1132,deathknight,unholy,24,12,12
778,Kel,stormreaver,1132,deathknight,unholy,35,12,23
779,Darktrinnity,nemesis,1130,deathknight,unholy,71,36,35
780,Deathsmog,quelthalas,1127,deathknight,unholy,37,22,15
781,Vampirecarti,tichondrius,1122,deathknight,unholy,38,18,20
782,Nicrack,malganis,1120,deathknight,unholy,24,13,11
783,Carecaa,azralon,1119,deathknight,unholy,44,19,25
784,Frostcleave,emerald-dream,1115,deathknight,unholy,24,16,8
785,Druncker,blackrock,1114,deathknight,unholy,53,20,33
786,Mordeo,bleeding-hollow,1114,deathknight,unholy,34,12,22
787,Pántera,darkspear,1113,deathknight,unholy,24,12,12
788,Mandrágor,quelthalas,1111,deathknight,unholy,52,20,32
789,Dankbro,tichondrius,1101,deathknight,unholy,36,15,21
790,Moxtexd,drakkari,1100,deathknight,unholy,30,21,9
791,Morghulas,moon-guard,1098,deathknight,unholy,30,12,18
792,Maripaula,ragnaros,1097,deathknight,unholy,35,14,21
793,Scaista,tichondrius,1095,deathknight,unholy,24,13,11
794,Polydeuces,queldorei,1091,deathknight,unholy,66,26,40
795,Mercysparx,thrall,1090,deathknight,unholy,120,57,63
796,Jinus,earthen-ring,1087,deathknight,unholy,30,14,16
797,Logann,azralon,1085,deathknight,unholy,28,13,15
798,Kanthrix,illidan,1084,deathknight,unholy,32,12,20
799,Fuzzyrump,eitrigg,1080,deathknight,unholy,36,21,15
800,Plaguebreak,darrowmere,1080,deathknight,unholy,84,48,36
801,Zillachilla,azshara,1079,deathknight,unholy,21,13,8
802,Honustustere,stormrage,1076,deathknight,unholy,29,12,17
803,Frostkane,stormrage,1071,deathknight,unholy,36,17,19
804,Froznorbs,tichondrius,1068,deathknight,unholy,26,13,13
805,Zaelize,sargeras,1065,deathknight,unholy,54,24,30
806,Zebirock,stormrage,1061,deathknight,unholy,36,12,24
807,Kayzark,tichondrius,1060,deathknight,unholy,54,30,24
808,Mordekaiseer,azralon,1057,deathknight,unholy,148,74,74
809,Ragsec,bleeding-hollow,1056,deathknight,unholy,18,11,7
810,Mossó,tichondrius,1056,deathknight,unholy,18,11,7
811,Neroxzdvm,area-52,1056,deathknight,unholy,30,11,19
812,Dreâmer,tichondrius,1056,deathknight,unholy,30,11,19
813,Cptsäveähöe,tichondrius,1056,deathknight,unholy,30,11,19
814,Vleryan,ragnaros,1055,deathknight,unholy,18,11,7
815,Darione,twisting-nether,1055,deathknight,unholy,30,11,19
816,Troyy,sargeras,1055,deathknight,unholy,30,11,19
817,Rytex,moon-guard,1055,deathknight,unholy,30,11,19
818,Saltank,frostmourne,1054,deathknight,unholy,18,11,7
819,Sommeliergg,stormrage,1053,deathknight,unholy,18,11,7
820,Xaldalas,kelthuzad,1053,deathknight,unholy,24,11,13
821,Nwnqt,frostmourne,1053,deathknight,unholy,27,12,15
822,Deathboost,stormrage,1053,deathknight,unholy,36,11,25
823,Polpop,zuljin,1051,deathknight,unholy,18,11,7
824,Acidirin,tichondrius,1049,deathknight,unholy,18,11,7
825,Draenor,shadowmoon,1049,deathknight,unholy,18,11,7
826,Runicblade,jaedenar,1048,deathknight,unholy,18,11,7
827,Salahzar,stormrage,1048,deathknight,unholy,24,11,13
828,Chad,ysondre,1048,deathknight,unholy,30,11,19
829,Rulord,wyrmrest-accord,1047,deathknight,unholy,24,11,13
830,Horîzon,sargeras,1047,deathknight,unholy,30,11,19
831,Atheion,the-underbog,1046,deathknight,unholy,24,11,13
832,Alphabro,zuluhed,1045,deathknight,unholy,54,26,28
833,Kreandria,dalaran,1045,deathknight,unholy,57,15,42
834,Lazta,azralon,1044,deathknight,unholy,40,17,23
835,Orphnoch,illidan,1043,deathknight,unholy,30,11,19
836,Arthureon,kelthuzad,1041,deathknight,unholy,38,14,24
837,Alayka,stormrage,1040,deathknight,unholy,24,11,13
838,Tandarilada,shadowmoon,1037,deathknight,unholy,54,28,26
839,Croaker,gurubashi,1035,deathknight,unholy,24,13,11
840,Gothywaifu,thunderhorn,1032,deathknight,unholy,24,11,13
841,Deathcometh,tichondrius,1027,deathknight,unholy,30,11,19
842,Jman,kaelthas,1026,deathknight,unholy,63,31,32
843,Annerito,area-52,1023,deathknight,unholy,29,11,18
844,Bloopdabloop,sargeras,1015,deathknight,unholy,55,31,24
845,Modok,malganis,1006,deathknight,unholy,17,11,6
846,Mëllowhypë,sargeras,1000,deathknight,unholy,44,17,27
847,Sübzerö,quelthalas,1000,deathknight,unholy,42,13,29
848,Raizzhít,ragnaros,989,deathknight,unholy,22,11,11
849,Dàndàn,lightbringer,983,deathknight,unholy,30,12,18
850,Shadowzombie,lethon,975,deathknight,unholy,28,11,17
851,Hansmclroy,trollbane,970,deathknight,unholy,24,14,10
852,Fendos,turalyon,963,deathknight,unholy,24,14,10
853,Delamuerte,ragnaros,962,deathknight,unholy,30,13,17
854,Wölf,durotan,960,deathknight,unholy,12,10,2
855,Bernaldino,illidan,960,deathknight,unholy,12,10,2
856,Ragrek,bleeding-hollow,960,deathknight,unholy,24,10,14
857,Rängi,caelestrasz,960,deathknight,unholy,78,26,52
858,Rxzo,frostmourne,960,deathknight,unholy,30,10,20
859,Immadkx,area-52,960,deathknight,unholy,30,10,20
860,Wolfsnight,frostmourne,960,deathknight,unholy,36,10,26
861,Aryêl,ragnaros,959,deathknight,unholy,18,10,8
862,Turbokitten,tichondrius,959,deathknight,unholy,18,10,8
863,Gurnok,barthilas,959,deathknight,unholy,18,10,8
864,Awshuks,illidan,959,deathknight,unholy,18,10,8
865,Distorted,emerald-dream,959,deathknight,unholy,24,10,14
866,Emarose,illidan,959,deathknight,unholy,24,10,14
867,Galaxyboom,tichondrius,958,deathknight,unholy,12,10,2
868,Khørne,area-52,958,deathknight,unholy,18,10,8
869,Ghouldruis,barthilas,958,deathknight,unholy,18,10,8
870,Polepounder,malganis,957,deathknight,unholy,12,10,2
871,Iðûnn,barthilas,957,deathknight,unholy,18,10,8
872,Aldoraenna,illidan,957,deathknight,unholy,24,10,14
873,Biukanon,ragnaros,956,deathknight,unholy,24,10,14
874,Arthyius,kiljaeden,956,deathknight,unholy,30,10,20
875,Gobaiakun,proudmoore,955,deathknight,unholy,18,10,8
876,Mëlødy,quelthalas,955,deathknight,unholy,18,10,8
877,Dreadcowpie,dalaran,955,deathknight,unholy,18,10,8
878,Bigdollars,eredar,954,deathknight,unholy,18,10,8
879,Noolore,firetree,952,deathknight,unholy,12,10,2
880,Sylneria,elune,952,deathknight,unholy,24,10,14
881,Hyondeath,tichondrius,952,deathknight,unholy,24,10,14
882,Attackondude,illidan,951,deathknight,unholy,18,10,8
883,Vërmilliøn,ragnaros,951,deathknight,unholy,24,10,14
884,Xijiñpiñg,hyjal,948,deathknight,unholy,24,10,14
885,Thaylenaar,eredar,947,deathknight,unholy,18,10,8
886,Bahtman,hakkar,946,deathknight,unholy,30,15,15
887,Niennahh,sargeras,946,deathknight,unholy,24,10,14
888,Ghorzul,thrall,945,deathknight,unholy,24,10,14
889,Morhtzen,moon-guard,944,deathknight,unholy,13,10,3
890,Cishei,quelthalas,939,deathknight,unholy,33,19,14
891,Hentaideath,kiljaeden,934,deathknight,unholy,24,10,14
892,Draxsos,quelthalas,931,deathknight,unholy,54,25,29
893,Digitalsammy,area-52,923,deathknight,unholy,29,10,19
894,Deathnorris,zuljin,919,deathknight,unholy,146,68,78
895,Soulfarm,tichondrius,908,deathknight,unholy,18,11,7
896,Jaydkx,tichondrius,906,deathknight,unholy,28,11,17
897,Càsshêrn,lightbringer,893,deathknight,unholy,14,10,4
898,Dragoroth,zuluhed,893,deathknight,unholy,31,15,16
899,Carmii,wyrmrest-accord,879,deathknight,unholy,25,10,15
900,Zareon,zuluhed,876,deathknight,unholy,24,12,12
901,Dandandor,muradin,876,deathknight,unholy,38,17,21
902,Nerfdklul,illidan,864,deathknight,unholy,12,9,3
903,Zakka,korgath,864,deathknight,unholy,18,9,9
904,Richiex,tichondrius,864,deathknight,unholy,18,9,9
905,Utthrity,ysera,864,deathknight,unholy,18,9,9
906,Sickly,arthas,864,deathknight,unholy,18,9,9
907,Skullash,stormrage,864,deathknight,unholy,18,9,9
908,Methyldk,frostmourne,864,deathknight,unholy,21,10,11
909,Shinukishin,stormrage,864,deathknight,unholy,24,9,15
910,Drneroxz,area-52,864,deathknight,unholy,24,9,15
911,Dill,madoran,864,deathknight,unholy,24,9,15
912,Fortissax,area-52,864,deathknight,unholy,30,9,21
913,Anaksunamooñ,sargeras,863,deathknight,unholy,18,9,9
914,Annubarak,malganis,863,deathknight,unholy,18,9,9
915,Bmminitian,illidan,863,deathknight,unholy,18,9,9
916,Azzandraza,wyrmrest-accord,863,deathknight,unholy,18,9,9
917,Kasteny,frostmourne,863,deathknight,unholy,18,9,9
918,Spurzilla,emerald-dream,863,deathknight,unholy,18,9,9
919,Valandiel,jubeithos,863,deathknight,unholy,18,9,9
920,Sbplaysdk,akama,863,deathknight,unholy,30,9,21
921,Vynlerran,skullcrusher,862,deathknight,unholy,18,9,9
922,Binicius,tichondrius,862,deathknight,unholy,18,9,9
923,Àrchøn,kelthuzad,862,deathknight,unholy,18,9,9
924,Killos,proudmoore,862,deathknight,unholy,18,9,9
925,Tharegorn,azralon,862,deathknight,unholy,18,9,9
926,Maiatsu,illidan,862,deathknight,unholy,18,9,9
927,Friezen,illidan,862,deathknight,unholy,18,9,9
928,Artous,stormrage,862,deathknight,unholy,36,9,27
929,Monglord,arthas,861,deathknight,unholy,18,9,9
930,Runeswanson,area-52,861,deathknight,unholy,18,9,9
931,Dmtdeaths,kelthuzad,861,deathknight,unholy,18,9,9
932,Exur,stormrage,861,deathknight,unholy,24,9,15
933,Cosanostrá,malganis,860,deathknight,unholy,12,9,3
934,Cadavr,tichondrius,860,deathknight,unholy,12,9,3
935,Rinthosaka,ragnaros,860,deathknight,unholy,18,9,9
936,Velyssiah,stormrage,860,deathknight,unholy,24,9,15
937,Smerknight,proudmoore,860,deathknight,unholy,24,9,15
938,Felerin,kiljaeden,859,deathknight,unholy,18,9,9
939,Ðerion,stormrage,859,deathknight,unholy,18,9,9
940,Sidbane,kalecgos,859,deathknight,unholy,19,9,10
941,Kaórii,stormrage,858,deathknight,unholy,30,9,21
942,Tinytanx,aerie-peak,856,deathknight,unholy,30,9,21
943,Kentolos,proudmoore,855,deathknight,unholy,12,9,3
944,Zathog,lightbringer,853,deathknight,unholy,30,9,21
945,Revendra,emerald-dream,852,deathknight,unholy,20,10,10
946,Ulyssess,jubeithos,851,deathknight,unholy,76,35,41
947,Pwnface,aerie-peak,851,deathknight,unholy,25,9,16
948,Ulerin,illidan,850,deathknight,unholy,18,9,9
949,Acerbus,mannoroth,846,deathknight,unholy,23,9,14
950,Plaza,thorium-brotherhood,844,deathknight,unholy,18,9,9
951,Maverax,executus,841,deathknight,unholy,24,10,14
952,Grimmtidings,dentarg,839,deathknight,unholy,42,17,25
953,Destruktion,uldaman,838,deathknight,unholy,12,9,3
954,Handler,nemesis,830,deathknight,unholy,20,10,10
955,Stygiansiix,draenor,822,deathknight,unholy,24,9,15
956,Vynjonc,drenden,820,deathknight,unholy,18,9,9
957,Alderma,zuljin,814,deathknight,unholy,29,10,19
958,Dreekon,bleeding-hollow,797,deathknight,unholy,30,15,15
959,Festers,burning-legion,794,deathknight,unholy,26,9,17
960,Wuhán,proudmoore,787,deathknight,unholy,38,9,29
961,Maalevolent,thunderlord,783,deathknight,unholy,25,9,16
962,Mesx,illidan,768,deathknight,unholy,12,8,4
963,Imrealgày,zuljin,768,deathknight,unholy,12,8,4
964,Vitad,tichondrius,768,deathknight,unholy,12,8,4
965,Liqùid,moon-guard,768,deathknight,unholy,12,8,4
966,Poderrosodk,azralon,768,deathknight,unholy,12,8,4
967,Jamjae,tichondrius,768,deathknight,unholy,12,8,4
968,Dendra,barthilas,768,deathknight,unholy,12,8,4
969,Dicromick,illidan,768,deathknight,unholy,15,9,6
970,Maltendis,malganis,768,deathknight,unholy,18,8,10
971,Sinnan,turalyon,768,deathknight,unholy,18,8,10
972,Slissy,hyjal,768,deathknight,unholy,18,8,10
973,Piratehookah,sargeras,768,deathknight,unholy,18,8,10
974,Longlnus,malganis,768,deathknight,unholy,24,8,16
975,Thraximundar,stormrage,768,deathknight,unholy,24,8,16
976,Novädk,ragnaros,768,deathknight,unholy,24,8,16
977,Loomoros,sargeras,768,deathknight,unholy,24,8,16
978,Darkathås,tichondrius,768,deathknight,unholy,24,8,16
979,Deathsloot,sargeras,767,deathknight,unholy,12,8,4
980,Ørcrist,area-52,767,deathknight,unholy,12,8,4
981,Akrylo,ragnaros,767,deathknight,unholy,12,8,4
982,Bojaçk,stormrage,767,deathknight,unholy,12,8,4
983,Darik,the-venture-co,767,deathknight,unholy,12,8,4
984,Trydeath,azralon,767,deathknight,unholy,13,8,5
985,Sujudk,emerald-dream,767,deathknight,unholy,18,8,10
986,Bloodygrip,bleeding-hollow,767,deathknight,unholy,18,8,10
987,Nattór,dalaran,767,deathknight,unholy,18,8,10
988,Fluffymoo,frostmourne,767,deathknight,unholy,18,8,10
989,Gorillagrip,sargeras,767,deathknight,unholy,18,8,10
990,Traitre,onyxia,767,deathknight,unholy,18,8,10
991,Apocalipsis,bleeding-hollow,767,deathknight,unholy,18,8,10
992,Hædës,area-52,767,deathknight,unholy,18,8,10
993,Zuckdk,illidan,767,deathknight,unholy,18,8,10
994,Skulm,emerald-dream,767,deathknight,unholy,20,8,12
995,Sicklecell,laughing-skull,767,deathknight,unholy,24,8,16
996,Sahaile,moon-guard,767,deathknight,unholy,30,8,22
997,Ðrëssa,azralon,766,deathknight,unholy,12,8,4
998,Redcancer,tichondrius,766,deathknight,unholy,12,8,4
999,Tragül,sargeras,766,deathknight,unholy,12,8,4
1000,Raynorr,dawnbringer,766,deathknight,unholy,12,8,4
1001,Olblueyes,hyjal,766,deathknight,unholy,18,8,10
1002,Archaná,stormrage,766,deathknight,unholy,18,8,10
1003,Hellhämmer,ragnaros,766,deathknight,unholy,18,8,10
1004,Katakuri,azralon,766,deathknight,unholy,18,8,10
1005,Riparonii,illidan,766,deathknight,unholy,21,8,13
1006,Ltoblivious,thrall,766,deathknight,unholy,24,8,16
1007,Shadowghast,saurfang,765,deathknight,unholy,12,8,4
1008,Hildolfr,shattered-hand,765,deathknight,unholy,18,8,10
1009,Bloodydebt,malganis,765,deathknight,unholy,18,8,10
1010,Dalrin,emerald-dream,765,deathknight,unholy,24,8,16
1011,Wickedknîght,kelthuzad,765,deathknight,unholy,24,8,16
1012,Abadena,illidan,765,deathknight,unholy,27,8,19
1013,Maggotmulch,zuljin,764,deathknight,unholy,30,8,22
1014,Azombie,burning-blade,762,deathknight,unholy,18,8,10
1015,Kowell,drakkari,762,deathknight,unholy,18,8,10
1016,Primoverdino,azralon,762,deathknight,unholy,18,8,10
1017,Spotsdk,hyjal,761,deathknight,unholy,18,8,10
1018,Iamlrr,maelstrom,761,deathknight,unholy,24,8,16
1019,Jojomcdeath,senjin,760,deathknight,unholy,18,8,10
1020,Liltinktink,stormreaver,760,deathknight,unholy,18,8,10
1021,Kaciann,dalaran,758,deathknight,unholy,12,8,4
1022,Lepanda,skywall,758,deathknight,unholy,18,8,10
1023,Rinngar,quelthalas,751,deathknight,unholy,14,8,6
1024,Silvorus,moon-guard,735,deathknight,unholy,17,8,9
1025,Poonen,area-52,735,deathknight,unholy,17,8,9
1026,Starset,burning-legion,728,deathknight,unholy,24,9,15
1027,Somethingdum,sargeras,703,deathknight,unholy,16,8,8
1028,Lolcàtxo,tichondrius,703,deathknight,unholy,17,8,9
1029,Ekirei,daggerspine,702,deathknight,unholy,11,8,3
1030,Beforelunch,tichondrius,672,deathknight,unholy,12,7,5
1031,Plag,bleeding-hollow,672,deathknight,unholy,12,7,5
1032,Ripcrawford,proudmoore,672,deathknight,unholy,12,7,5
1033,Cgg,tichondrius,672,deathknight,unholy,12,7,5
1034,Donrhythmic,ysera,672,deathknight,unholy,12,7,5
1035,Liverkick,zuljin,672,deathknight,unholy,12,7,5
1036,Penguinlolx,sargeras,672,deathknight,unholy,12,7,5
1037,Mcdeathturds,tichondrius,672,deathknight,unholy,12,7,5
1038,Bkb,sargeras,672,deathknight,unholy,12,7,5
1039,Karthayne,area-52,672,deathknight,unholy,12,7,5
1040,Bukumo,zuljin,672,deathknight,unholy,12,7,5
1041,Jbert,sargeras,672,deathknight,unholy,12,7,5
1042,Inemia,wyrmrest-accord,672,deathknight,unholy,16,7,9
1043,Kûri,runetotem,672,deathknight,unholy,18,7,11
1044,Umbramane,tichondrius,672,deathknight,unholy,18,7,11
1045,Dxssxe,tichondrius,672,deathknight,unholy,18,7,11
1046,Meisterdeath,stormrage,672,deathknight,unholy,18,7,11
1047,Mmaximus,darkspear,672,deathknight,unholy,18,7,11
1048,Bellybuster,malganis,672,deathknight,unholy,18,7,11
1049,Notiniquity,tichondrius,672,deathknight,unholy,18,7,11
1050,Worgenracist,tichondrius,672,deathknight,unholy,18,7,11
1051,Bryku,tichondrius,672,deathknight,unholy,18,7,11
1052,Xarielle,tichondrius,672,deathknight,unholy,18,7,11
1053,Mightyfails,frostmourne,672,deathknight,unholy,18,7,11
1054,Ebolaxd,area-52,672,deathknight,unholy,18,7,11
1055,Deathup,sargeras,672,deathknight,unholy,18,7,11
1056,Zoomoth,illidan,672,deathknight,unholy,24,7,17
1057,Zenan,area-52,672,deathknight,unholy,24,7,17
1058,Xenocrates,illidan,672,deathknight,unholy,24,7,17
1059,Ceedog,crushridge,672,deathknight,unholy,30,7,23
1060,Gâbriel,cairne,671,deathknight,unholy,12,7,5
1061,Samsoníte,illidan,671,deathknight,unholy,12,7,5
1062,Sevexi,moon-guard,671,deathknight,unholy,12,7,5
1063,Tiller,mannoroth,671,deathknight,unholy,12,7,5
1064,Rihàn,drakkari,671,deathknight,unholy,12,7,5
1065,Deatheey,area-52,671,deathknight,unholy,12,7,5
1066,Fligdeath,llane,671,deathknight,unholy,12,7,5
1067,Woahwtf,area-52,671,deathknight,unholy,18,7,11
1068,Noitrox,azralon,671,deathknight,unholy,18,7,11
1069,Mfknight,archimonde,671,deathknight,unholy,18,7,11
1070,Kidek,proudmoore,671,deathknight,unholy,18,7,11
1071,Deadlungs,area-52,671,deathknight,unholy,20,7,13
1072,Demonstalker,boulderfist,671,deathknight,unholy,24,7,17
1073,Kralos,khadgar,670,deathknight,unholy,12,7,5
1074,Onslàught,sargeras,670,deathknight,unholy,12,7,5
1075,Emberwarden,stormrage,670,deathknight,unholy,18,7,11
1076,Adralin,sargeras,670,deathknight,unholy,18,7,11
1077,Libramontes,ragnaros,670,deathknight,unholy,24,7,17
1078,Irokthefrost,frostmourne,669,deathknight,unholy,12,7,5
1079,Thaladius,emerald-dream,669,deathknight,unholy,18,7,11
1080,Boneguard,stormrage,668,deathknight,unholy,18,7,11
1081,Grtmisdirect,illidan,666,deathknight,unholy,21,8,13
1082,Arthasnet,quelthalas,666,deathknight,unholy,24,7,17
1083,Zëb,sargeras,665,deathknight,unholy,12,7,5
1084,Thepanzer,elune,665,deathknight,unholy,12,7,5
1085,Zàkgor,moon-guard,665,deathknight,unholy,12,7,5
1086,Argar,crushridge,664,deathknight,unholy,12,7,5
1087,Runíc,demon-soul,664,deathknight,unholy,18,7,11
1088,Heldwynd,bonechewer,664,deathknight,unholy,24,7,17
1089,Garshna,ragnaros,658,deathknight,unholy,12,7,5
1090,Hadianton,stormrage,654,deathknight,unholy,15,8,7
1091,Papparoach,ysera,641,deathknight,unholy,24,7,17
1092,Dbg,frostmane,639,deathknight,unholy,11,7,4
1093,Hardtoplaydk,chogall,639,deathknight,unholy,17,7,10
1094,Tasila,tichondrius,622,deathknight,unholy,11,7,4
1095,Ghostdeath,blackhand,622,deathknight,unholy,15,7,8
1096,Bonalumë,azralon,620,deathknight,unholy,17,7,10
1097,Soulkiti,blackwater-raiders,608,deathknight,unholy,16,7,9
1098,Nekrosys,eitrigg,608,deathknight,unholy,22,7,15
1099,Bingoez,frostmourne,607,deathknight,unholy,11,7,4
1100,Arcänn,drenden,576,deathknight,unholy,6,6,0
1101,Tyrsfaith,tichondrius,576,deathknight,unholy,12,6,6
1102,Surkk,tichondrius,576,deathknight,unholy,12,6,6
1103,Bøoth,area-52,576,deathknight,unholy,12,6,6
1104,Delwrath,proudmoore,576,deathknight,unholy,12,6,6
1105,Bébøp,malganis,576,deathknight,unholy,12,6,6
1106,Zyzz,frostmourne,576,deathknight,unholy,12,6,6
1107,Zeenki,ragnaros,576,deathknight,unholy,12,6,6
1108,Palliote,frostmane,576,deathknight,unholy,12,6,6
1109,Sweatynation,tichondrius,576,deathknight,unholy,12,6,6
1110,Svlla,doomhammer,576,deathknight,unholy,12,6,6
1111,Beby,wyrmrest-accord,576,deathknight,unholy,12,6,6
1112,Cali,bladefist,576,deathknight,unholy,12,6,6
1113,Chubingus,the-venture-co,576,deathknight,unholy,12,6,6
1114,Salusx,area-52,576,deathknight,unholy,12,6,6
1115,Bossdk,tichondrius,576,deathknight,unholy,12,6,6
1116,Xhan,tichondrius,576,deathknight,unholy,12,6,6
1117,Remõrse,moon-guard,576,deathknight,unholy,12,6,6
1118,Sanezarro,bleeding-hollow,576,deathknight,unholy,12,6,6
1119,Chainsharder,stormrage,576,deathknight,unholy,12,6,6
1120,Nøzawkolypse,area-52,576,deathknight,unholy,12,6,6
1121,Lilwayne,archimonde,576,deathknight,unholy,12,6,6
1122,Mizzri,frostmourne,576,deathknight,unholy,12,6,6
1123,Hickish,tichondrius,576,deathknight,unholy,12,6,6
1124,Càvic,malganis,576,deathknight,unholy,12,6,6
1125,Demonicrunes,windrunner,576,deathknight,unholy,12,6,6
1126,Jonahdk,sargeras,576,deathknight,unholy,12,6,6
1127,Saco,malganis,576,deathknight,unholy,12,6,6
1128,Ridesatenspd,caelestrasz,576,deathknight,unholy,12,6,6
1129,Raaizz,ragnaros,576,deathknight,unholy,12,6,6
1130,Lainmortal,ragnaros,576,deathknight,unholy,18,6,12
1131,Cirillan,bleeding-hollow,576,deathknight,unholy,18,6,12
1132,Joystickwrld,silvermoon,576,deathknight,unholy,18,6,12
1133,Nethaar,tichondrius,576,deathknight,unholy,18,6,12
1134,Boltman,malganis,576,deathknight,unholy,18,6,12
1135,Blackùla,tichondrius,576,deathknight,unholy,18,6,12
1136,Poubelle,malganis,576,deathknight,unholy,18,6,12
1137,Icycrazy,azralon,576,deathknight,unholy,18,6,12
1138,Bøngripx,tichondrius,576,deathknight,unholy,18,6,12
1139,Monesy,tichondrius,576,deathknight,unholy,24,6,18
1140,Baldlord,tichondrius,576,deathknight,unholy,24,6,18
1141,Conquest,drenden,576,deathknight,unholy,24,6,18
1142,Granknight,azralon,576,deathknight,unholy,24,6,18
1143,Abombinator,stormrage,575,deathknight,unholy,6,6,0
1144,Christophe,skullcrusher,575,deathknight,unholy,12,6,6
1145,Iceclaw,bleeding-hollow,575,deathknight,unholy,12,6,6
1146,Åkatsukii,uther,575,deathknight,unholy,12,6,6
1147,Agamoth,ragnaros,575,deathknight,unholy,12,6,6
1148,Galthro,tichondrius,575,deathknight,unholy,12,6,6
1149,Bnasty,arthas,575,deathknight,unholy,12,6,6
1150,Sephirott,boulderfist,575,deathknight,unholy,12,6,6
1151,Peteargryphn,illidan,575,deathknight,unholy,12,6,6
1152,Ksoldier,illidan,575,deathknight,unholy,12,6,6
1153,Isaiahstolt,area-52,575,deathknight,unholy,12,6,6
1154,Corpsepetal,muradin,575,deathknight,unholy,18,6,12
1155,Vicentão,tichondrius,574,deathknight,unholy,12,6,6
1156,Hordbadia,garrosh,574,deathknight,unholy,12,6,6
1157,Robacalzónes,ragnaros,574,deathknight,unholy,12,6,6
1158,Fraänrisco,ragnaros,574,deathknight,unholy,18,6,12
1159,Vapelounge,darkspear,574,deathknight,unholy,18,6,12
1160,Juggérnaút,bonechewer,572,deathknight,unholy,12,6,6
1161,Tormentsoul,ragnaros,572,deathknight,unholy,12,6,6
1162,Waterboy,malganis,566,deathknight,unholy,12,6,6
1163,Lowan,stormrage,566,deathknight,unholy,12,6,6
1164,Droko,thunderlord,563,deathknight,unholy,21,7,14
1165,Syzurp,barthilas,558,deathknight,unholy,13,7,6
1166,Janoh,the-scryers,553,deathknight,unholy,23,6,17
1167,Athropos,sargeras,543,deathknight,unholy,8,7,1
1168,Caohiyan,tichondrius,542,deathknight,unholy,11,6,5
1169,Herstôry,kelthuzad,527,deathknight,unholy,11,6,5
1170,Gkdm,tichondrius,522,deathknight,unholy,21,8,13
1171,Chës,tichondrius,522,deathknight,unholy,22,7,15
1172,Abømination,zuljin,510,deathknight,unholy,20,6,14
1173,Kalëndar,drakkari,503,deathknight,unholy,25,12,13
1174,Bawlsauce,area-52,496,deathknight,unholy,13,6,7
1175,Lastboyscout,silvermoon,480,deathknight,unholy,6,5,1
1176,Wâggies,moon-guard,480,deathknight,unholy,6,5,1
1177,Mopglad,tichondrius,480,deathknight,unholy,6,5,1
1178,Andariel,ragnaros,480,deathknight,unholy,6,5,1
1179,Devilwarship,daggerspine,480,deathknight,unholy,6,5,1
1180,Depthknight,barthilas,480,deathknight,unholy,6,5,1
1181,Solø,proudmoore,480,deathknight,unholy,6,5,1
1182,Superzach,muradin,480,deathknight,unholy,6,5,1
1183,Bànished,moon-guard,480,deathknight,unholy,7,5,2
1184,Defaultz,turalyon,480,deathknight,unholy,12,5,7
1185,Schreit,zuljin,480,deathknight,unholy,12,5,7
1186,Andem,elune,480,deathknight,unholy,12,5,7
1187,Cammykickbot,frostmourne,480,deathknight,unholy,12,5,7
1188,Qberks,elune,480,deathknight,unholy,12,5,7
1189,Lilpootie,tichondrius,480,deathknight,unholy,12,5,7
1190,Initiative,moon-guard,480,deathknight,unholy,12,5,7
1191,Deathpair,bleeding-hollow,480,deathknight,unholy,12,5,7
1192,Gatitos,ragnaros,480,deathknight,unholy,12,5,7
1193,Bot,icecrown,480,deathknight,unholy,12,5,7
1194,Lîch,azralon,480,deathknight,unholy,12,5,7
1195,Sindragosa,dragonmaw,480,deathknight,unholy,12,5,7
1196,Coachclaudio,tichondrius,480,deathknight,unholy,12,5,7
1197,Defekaite,kiljaeden,480,deathknight,unholy,12,5,7
1198,Rayzuul,queldorei,480,deathknight,unholy,12,5,7
1199,Wapman,bloodhoof,480,deathknight,unholy,12,5,7
1200,Nordiin,stormrage,480,deathknight,unholy,12,5,7
1201,Skotch,lightninghoof,480,deathknight,unholy,12,5,7
1202,Serathai,tichondrius,480,deathknight,unholy,12,5,7
1203,Deathlyvoid,sargeras,480,deathknight,unholy,12,5,7
1204,Clovermoon,tichondrius,480,deathknight,unholy,12,5,7
1205,Hemorrhoids,blackrock,480,deathknight,unholy,12,5,7
1206,Ghrat,bleeding-hollow,480,deathknight,unholy,12,5,7
1207,Zaratose,area-52,480,deathknight,unholy,12,5,7
1208,Vläad,ragnaros,480,deathknight,unholy,12,5,7
1209,Darkfög,sargeras,480,deathknight,unholy,12,5,7
1210,Birnolan,proudmoore,480,deathknight,unholy,12,5,7
1211,Xariuz,quelthalas,480,deathknight,unholy,12,5,7
1212,Darkwraith,illidan,480,deathknight,unholy,12,5,7
1213,Cosmicrune,turalyon,480,deathknight,unholy,12,5,7
1214,Römney,stormrage,480,deathknight,unholy,12,5,7
1215,Aoshië,area-52,480,deathknight,unholy,12,5,7
1216,Akmy,illidan,480,deathknight,unholy,12,5,7
1217,Pathæs,bleeding-hollow,480,deathknight,unholy,12,5,7
1218,Raull,ragnaros,480,deathknight,unholy,12,5,7
1219,Deadntaxes,thunderlord,480,deathknight,unholy,12,5,7
1220,Drakkala,silvermoon,480,deathknight,unholy,12,5,7
1221,Dreadwraith,malganis,480,deathknight,unholy,12,5,7
1222,Darthkeefers,zuljin,480,deathknight,unholy,12,5,7
1223,Gneanderthal,bloodscalp,480,deathknight,unholy,12,5,7
1224,Laboön,stormrage,480,deathknight,unholy,12,5,7
1225,Yeahgood,frostmourne,480,deathknight,unholy,12,5,7
1226,Menethïl,quelthalas,480,deathknight,unholy,12,5,7
1227,Swänsz,stormrage,480,deathknight,unholy,12,5,7
1228,Gusabio,drakkari,480,deathknight,unholy,12,5,7
1229,Maskofwintrs,zuljin,480,deathknight,unholy,18,5,13
1230,Sevendeadly,frostmourne,480,deathknight,unholy,18,5,13
1231,Gazco,frostmourne,480,deathknight,unholy,18,5,13
1232,Nurglet,proudmoore,480,deathknight,unholy,18,5,13
1233,Dkinaboxx,hyjal,480,deathknight,unholy,18,5,13
1234,Sylèss,tichondrius,480,deathknight,unholy,18,5,13
1235,Chainsadeath,stormrage,480,deathknight,unholy,18,5,13
1236,Deathgimbo,hellscream,480,deathknight,unholy,18,5,13
1237,Dementrius,zuljin,480,deathknight,unholy,25,5,20
1238,Extremepvp,aegwynn,479,deathknight,unholy,6,5,1
1239,Wolfsdeath,shattered-hand,479,deathknight,unholy,6,5,1
1240,Valkzy,malganis,479,deathknight,unholy,6,5,1
1241,Ahwooh,kelthuzad,479,deathknight,unholy,6,5,1
1242,Mefistô,quelthalas,479,deathknight,unholy,10,6,4
1243,Joelfromuber,stormrage,479,deathknight,unholy,12,5,7
1244,Xadrisill,winterhoof,479,deathknight,unholy,12,5,7
1245,Dijkstrap,tichondrius,479,deathknight,unholy,12,5,7
1246,Borgin,emerald-dream,479,deathknight,unholy,12,5,7
1247,Deathfearsme,kiljaeden,479,deathknight,unholy,12,5,7
1248,Stemen,quelthalas,479,deathknight,unholy,12,5,7
1249,Jessefur,undermine,479,deathknight,unholy,12,5,7
1250,Kramy,barthilas,479,deathknight,unholy,12,5,7
1251,Itired,tichondrius,479,deathknight,unholy,12,5,7
1252,Caqw,akama,479,deathknight,unholy,12,5,7
1253,Nekrofeelyak,kelthuzad,479,deathknight,unholy,12,5,7
1254,Vorlakesh,boulderfist,479,deathknight,unholy,12,5,7
1255,Amaethyst,kelthuzad,479,deathknight,unholy,12,5,7
1256,Baracka,sargeras,479,deathknight,unholy,18,5,13
1257,Futurism,shadowmoon,478,deathknight,unholy,6,5,1
1258,Henritoxic,azralon,478,deathknight,unholy,10,7,3
1259,Aborter,arthas,478,deathknight,unholy,12,5,7
1260,Jonnii,area-52,477,deathknight,unholy,12,5,7
1261,Yafa,bonechewer,474,deathknight,unholy,27,6,21
1262,Headbustr,sargeras,473,deathknight,unholy,12,5,7
1263,Fishtouching,illidan,463,deathknight,unholy,17,5,12
1264,Megatrôn,malganis,463,deathknight,unholy,17,5,12
1265,Faelmo,malganis,447,deathknight,unholy,11,5,6
1266,Prettyliched,area-52,447,deathknight,unholy,11,5,6
1267,Lenos,tichondrius,447,deathknight,unholy,11,5,6
1268,Iloveenzley,tichondrius,447,deathknight,unholy,11,5,6
1269,Fearfull,hyjal,447,deathknight,unholy,16,5,11
1270,Sorry,ysera,432,deathknight,unholy,9,6,3
1271,Furiel,mugthol,430,deathknight,unholy,9,6,3
1272,Spôôn,aggramar,430,deathknight,unholy,11,5,6
1273,Dtrayn,tichondrius,416,deathknight,unholy,10,5,5
1274,Reighart,kiljaeden,415,deathknight,unholy,8,5,3
1275,Testifier,illidan,415,deathknight,unholy,8,5,3
1276,Higeki,area-52,415,deathknight,unholy,8,5,3
1277,Shiminy,chogall,415,deathknight,unholy,10,5,5
1278,Bosleigor,elune,400,deathknight,unholy,13,5,8
1279,Frostology,echo-isles,399,deathknight,unholy,5,5,0
1280,Sleezyfbaby,sargeras,384,deathknight,unholy,6,4,2
1281,Frøstfinger,azralon,384,deathknight,unholy,6,4,2
1282,Zèro,moonrunner,384,deathknight,unholy,6,4,2
1283,Shargan,illidan,384,deathknight,unholy,6,4,2
1284,Nbahooper,area-52,384,deathknight,unholy,6,4,2
1285,Lxsol,illidan,384,deathknight,unholy,6,4,2
1286,Whaleofwales,ysondre,384,deathknight,unholy,6,4,2
1287,Vampygeizt,zuljin,384,deathknight,unholy,6,4,2
1288,Cheliä,quelthalas,384,deathknight,unholy,6,4,2
1289,Darkswar,barthilas,384,deathknight,unholy,6,4,2
1290,Hiki,ragnaros,384,deathknight,unholy,6,4,2
1291,Asthenophoba,bloodscalp,384,deathknight,unholy,6,4,2
1292,Keator,tichondrius,384,deathknight,unholy,6,4,2
1293,Futruth,khaz-modan,384,deathknight,unholy,6,4,2
1294,Icecreamlife,chogall,384,deathknight,unholy,6,4,2
1295,Chooksknight,tichondrius,384,deathknight,unholy,6,4,2
1296,Zeathial,moon-guard,384,deathknight,unholy,6,4,2
1297,Janaru,bloodscalp,384,deathknight,unholy,6,4,2
1298,Chillbruh,garrosh,384,deathknight,unholy,6,4,2
1299,Ragnarøs,stormrage,384,deathknight,unholy,6,4,2
1300,Easyunholy,tichondrius,384,deathknight,unholy,6,4,2
1301,Murphu,stormrage,384,deathknight,unholy,6,4,2
1302,Assidik,dathremar,384,deathknight,unholy,6,4,2
1303,Ðrift,azralon,384,deathknight,unholy,6,4,2
1304,Tibocourtois,tichondrius,384,deathknight,unholy,6,4,2
1305,Hlw,tichondrius,384,deathknight,unholy,6,4,2
1306,Peacebringer,frostmourne,384,deathknight,unholy,6,4,2
1307,Alzenth,quelthalas,384,deathknight,unholy,6,4,2
1308,Koreandk,tichondrius,384,deathknight,unholy,6,4,2
1309,Mistmoorex,stormscale,384,deathknight,unholy,6,4,2
1310,Søldier,proudmoore,384,deathknight,unholy,6,4,2
1311,Pleasecakes,blood-furnace,384,deathknight,unholy,9,5,4
1312,Kárd,tichondrius,384,deathknight,unholy,12,4,8
1313,Hounura,dathremar,384,deathknight,unholy,12,4,8
1314,Sandooñ,tichondrius,384,deathknight,unholy,12,4,8
1315,Almostdead,proudmoore,384,deathknight,unholy,12,4,8
1316,Bealzabub,sargeras,384,deathknight,unholy,12,4,8
1317,Ambagrips,frostmourne,384,deathknight,unholy,12,4,8
1318,Shehanshah,area-52,384,deathknight,unholy,12,4,8
1319,Noiksnow,azralon,384,deathknight,unholy,12,4,8
1320,Deathscyythe,illidan,384,deathknight,unholy,12,4,8
1321,Threehunned,frostmourne,384,deathknight,unholy,12,4,8
1322,Wúhan,moon-guard,384,deathknight,unholy,12,4,8
1323,Eightamdk,tichondrius,384,deathknight,unholy,12,4,8
1324,Danteloki,proudmoore,384,deathknight,unholy,12,4,8
1325,Sonoftwodads,thrall,384,deathknight,unholy,12,4,8
1326,Dalka,laughing-skull,384,deathknight,unholy,12,4,8
1327,Raakaa,ghostlands,384,deathknight,unholy,12,4,8
1328,Çorn,sargeras,384,deathknight,unholy,12,4,8
1329,Pharoahx,gurubashi,384,deathknight,unholy,12,4,8
1330,Mardrank,stormrage,384,deathknight,unholy,12,4,8
1331,Kìrìtó,malygos,384,deathknight,unholy,12,4,8
1332,Grýmm,bonechewer,384,deathknight,unholy,12,4,8
1333,Dkekk,illidan,384,deathknight,unholy,12,4,8
1334,Cäin,dreadmaul,384,deathknight,unholy,12,4,8
1335,Deathhimself,moonrunner,384,deathknight,unholy,12,4,8
1336,Yeetmaster,area-52,384,deathknight,unholy,12,4,8
1337,Tinylich,arthas,384,deathknight,unholy,12,4,8
1338,Froztknight,anubarak,384,deathknight,unholy,12,4,8
1339,Mournehowl,stormrage,384,deathknight,unholy,12,4,8
1340,Cald,bonechewer,384,deathknight,unholy,12,4,8
1341,Bjorstad,moon-guard,384,deathknight,unholy,12,4,8
1342,Annuvyz,darkspear,384,deathknight,unholy,12,4,8
1343,Coronä,malfurion,384,deathknight,unholy,12,4,8
1344,Nolderosdk,nemesis,384,deathknight,unholy,12,4,8
1345,Daellius,ragnaros,384,deathknight,unholy,12,4,8
1346,Tyrien,frostmane,384,deathknight,unholy,12,4,8
1347,Cokedrip,bleeding-hollow,384,deathknight,unholy,12,4,8
1348,Wankekong,zuljin,384,deathknight,unholy,12,4,8
1349,Capergrip,tichondrius,384,deathknight,unholy,12,4,8
1350,Testamentxx,thunderlord,384,deathknight,unholy,12,4,8
1351,Tirdinn,madoran,384,deathknight,unholy,12,4,8
1352,Lho,caelestrasz,384,deathknight,unholy,18,4,14
1353,Avengis,bleeding-hollow,384,deathknight,unholy,18,4,14
1354,Golgothic,sargeras,384,deathknight,unholy,18,4,14
1355,Keralius,stormrage,384,deathknight,unholy,18,4,14
1356,Drzièglér,tichondrius,384,deathknight,unholy,18,4,14
1357,Flazzul,kiljaeden,383,deathknight,unholy,6,4,2
1358,Turbotoxic,illidan,383,deathknight,unholy,6,4,2
1359,Hitsüyi,quelthalas,383,deathknight,unholy,11,6,5
1360,Maligolde,nemesis,383,deathknight,unholy,12,4,8
1361,Demher,ragnaros,383,deathknight,unholy,12,4,8
1362,Plaguedoctor,moon-guard,383,deathknight,unholy,12,4,8
1363,Optics,bleeding-hollow,383,deathknight,unholy,12,4,8
1364,Ziona,archimonde,383,deathknight,unholy,18,4,14
1365,Hobyrt,bleeding-hollow,382,deathknight,unholy,6,4,2
1366,Jinxtar,wyrmrest-accord,382,deathknight,unholy,6,4,2
1367,Eyedeas,emerald-dream,382,deathknight,unholy,12,4,8
1368,Ghoulorama,illidan,380,deathknight,unholy,12,4,8
1369,Brantodne,galakrond,379,deathknight,unholy,12,4,8
1370,Atakan,burning-blade,367,deathknight,unholy,11,4,7
1371,Gankhiss,emerald-dream,351,deathknight,unholy,11,4,7
1372,Azupo,aerie-peak,351,deathknight,unholy,14,5,9
1373,Zuum,kelthuzad,351,deathknight,unholy,17,4,13
1374,Zygon,thrall,336,deathknight,unholy,9,4,5
1375,Ahirek,quelthalas,320,deathknight,unholy,10,4,6
1376,Ekaj,azuremyst,319,deathknight,unholy,5,4,1
1377,Rodeon,azgalor,291,deathknight,unholy,13,5,8
1378,Mts,thunderhorn,288,deathknight,unholy,6,3,3
1379,Smokeyjoe,aegwynn,288,deathknight,unholy,6,3,3
1380,Blitzcreig,sargeras,288,deathknight,unholy,6,3,3
1381,Northwing,sargeras,288,deathknight,unholy,6,3,3
1382,Mindflayers,area-52,288,deathknight,unholy,6,3,3
1383,Trant,tichondrius,288,deathknight,unholy,6,3,3
1384,Ego,blackrock,288,deathknight,unholy,6,3,3
1385,Mýrrh,wyrmrest-accord,288,deathknight,unholy,6,3,3
1386,Dlaron,ragnaros,288,deathknight,unholy,6,3,3
1387,Lr,hyjal,288,deathknight,unholy,6,3,3
1388,Matea,ragnaros,288,deathknight,unholy,6,3,3
1389,Lafourche,sargeras,288,deathknight,unholy,6,3,3
1390,Kossero,thunderlord,288,deathknight,unholy,6,3,3
1391,Forgos,ragnaros,288,deathknight,unholy,6,3,3
1392,Frostdest,kiljaeden,288,deathknight,unholy,6,3,3
1393,Vcadk,ragnaros,288,deathknight,unholy,6,3,3
1394,Plaguewar,thrall,288,deathknight,unholy,6,3,3
1395,Indraz,jubeithos,288,deathknight,unholy,6,3,3
1396,Scursy,tichondrius,288,deathknight,unholy,6,3,3
1397,Marash,moon-guard,288,deathknight,unholy,6,3,3
1398,Drippedout,illidan,288,deathknight,unholy,6,3,3
1399,Mendoh,tichondrius,288,deathknight,unholy,6,3,3
1400,Anderius,tichondrius,288,deathknight,unholy,6,3,3
1401,Elrog,nemesis,288,deathknight,unholy,6,3,3
1402,Viscerus,stormrage,288,deathknight,unholy,6,3,3
1403,Disritmia,stormrage,288,deathknight,unholy,6,3,3
1404,Jorich,ragnaros,288,deathknight,unholy,6,3,3
1405,Adavynn,darkspear,288,deathknight,unholy,6,3,3
1406,Vinaroth,kiljaeden,288,deathknight,unholy,6,3,3
1407,Pizy,frostmourne,288,deathknight,unholy,6,3,3
1408,Leinandk,illidan,288,deathknight,unholy,6,3,3
1409,Frenzza,frostmourne,288,deathknight,unholy,6,3,3
1410,Legendåryx,sargeras,288,deathknight,unholy,6,3,3
1411,Chrønnøz,nemesis,288,deathknight,unholy,6,3,3
1412,Petkick,tichondrius,288,deathknight,unholy,6,3,3
1413,Nifftybear,tichondrius,288,deathknight,unholy,6,3,3
1414,Ödens,dalaran,288,deathknight,unholy,6,3,3
1415,Ariacy,sargeras,288,deathknight,unholy,6,3,3
1416,Syringe,bloodhoof,288,deathknight,unholy,6,3,3
1417,Céle,area-52,288,deathknight,unholy,6,3,3
1418,Vexmaw,twisting-nether,288,deathknight,unholy,6,3,3
1419,Krumpous,tichondrius,288,deathknight,unholy,6,3,3
1420,Shookdnation,suramar,288,deathknight,unholy,6,3,3
1421,Alivaron,lothar,288,deathknight,unholy,6,3,3
1422,Mikeoxmaul,frostmourne,288,deathknight,unholy,6,3,3
1423,Barricus,stonemaul,288,deathknight,unholy,6,3,3
1424,Válak,stormrage,288,deathknight,unholy,6,3,3
1425,Pepecoomer,frostmourne,288,deathknight,unholy,6,3,3
1426,Ðecaying,area-52,288,deathknight,unholy,6,3,3
1427,Feki,frostmourne,288,deathknight,unholy,6,3,3
1428,Necrotictko,tichondrius,288,deathknight,unholy,6,3,3
1429,Icefrost,ghostlands,288,deathknight,unholy,6,3,3
1430,Dizzyswiftz,tichondrius,288,deathknight,unholy,6,3,3
1431,Graciemacie,area-52,288,deathknight,unholy,6,3,3
1432,Outbrèak,sargeras,288,deathknight,unholy,6,3,3
1433,Nalec,tichondrius,288,deathknight,unholy,6,3,3
1434,Martinnash,emerald-dream,288,deathknight,unholy,6,3,3
1435,Chibalaloca,quelthalas,288,deathknight,unholy,6,3,3
1436,Mawvac,quelthalas,288,deathknight,unholy,6,3,3
1437,Llok,area-52,288,deathknight,unholy,6,3,3
1438,Almatafh,azralon,288,deathknight,unholy,6,3,3
1439,Rizzchimp,tichondrius,288,deathknight,unholy,6,3,3
1440,Sherank,akama,288,deathknight,unholy,6,3,3
1441,Xhín,bleeding-hollow,288,deathknight,unholy,6,3,3
1442,Greizul,area-52,288,deathknight,unholy,6,3,3
1443,Laeroth,zuluhed,288,deathknight,unholy,6,3,3
1444,Redrox,tichondrius,288,deathknight,unholy,6,3,3
1445,Xathrrid,stormrage,288,deathknight,unholy,6,3,3
1446,Jerkin,area-52,288,deathknight,unholy,6,3,3
1447,Malairia,area-52,288,deathknight,unholy,6,3,3
1448,Micteca,moonrunner,288,deathknight,unholy,7,3,4
1449,Oroborus,korgath,288,deathknight,unholy,8,3,5
1450,Boomxic,shuhalo,288,deathknight,unholy,11,4,7
1451,Boneherr,sargeras,288,deathknight,unholy,16,4,12
1452,Chosenhero,stormrage,288,deathknight,unholy,12,3,9
1453,Zerky,stormrage,288,deathknight,unholy,12,3,9
1454,Torsophuk,stormrage,288,deathknight,unholy,12,3,9
1455,Bloodemperor,malfurion,288,deathknight,unholy,12,3,9
1456,Chosenrune,stormrage,288,deathknight,unholy,12,3,9
1457,Kaspbrak,destromath,288,deathknight,unholy,12,3,9
1458,Garonse,wyrmrest-accord,288,deathknight,unholy,12,3,9
1459,Gersinhu,azralon,288,deathknight,unholy,12,3,9
1460,Angerforge,illidan,288,deathknight,unholy,12,3,9
1461,Coldmilk,wyrmrest-accord,288,deathknight,unholy,12,3,9
1462,Morbo,proudmoore,288,deathknight,unholy,12,3,9
1463,Emotionaldam,area-52,288,deathknight,unholy,12,3,9
1464,Belfknightt,area-52,288,deathknight,unholy,12,3,9
1465,Shmoe,auchindoun,288,deathknight,unholy,12,3,9
1466,Danlorinis,moon-guard,288,deathknight,unholy,12,3,9
1467,Mongomongo,malganis,288,deathknight,unholy,12,3,9
1468,Inigomontana,moon-guard,288,deathknight,unholy,12,3,9
1469,Techneeq,tichondrius,288,deathknight,unholy,12,3,9
1470,Gigabone,tichondrius,288,deathknight,unholy,12,3,9
1471,Rottenqunt,tichondrius,288,deathknight,unholy,12,3,9
1472,Lolgriped,tichondrius,288,deathknight,unholy,12,3,9
1473,Shmeckla,tichondrius,288,deathknight,unholy,12,3,9
1474,Römulus,area-52,288,deathknight,unholy,12,3,9
1475,Fokit,barthilas,288,deathknight,unholy,12,3,9
1476,Bultek,sargeras,288,deathknight,unholy,12,3,9
1477,Supermane,jubeithos,288,deathknight,unholy,12,3,9
1478,Hynzst,barthilas,288,deathknight,unholy,12,3,9
1479,Malthis,antonidas,288,deathknight,unholy,12,3,9
1480,Coffeemilk,kiljaeden,288,deathknight,unholy,13,3,10
1481,Deathsent,malganis,288,deathknight,unholy,18,3,15
1482,Malovv,nemesis,287,deathknight,unholy,6,3,3
1483,Deadmedic,quelthalas,287,deathknight,unholy,6,3,3
1484,Chanskey,stormrage,287,deathknight,unholy,9,3,6
1485,Zedknight,emerald-dream,287,deathknight,unholy,15,4,11
1486,Morthul,tol-barad,287,deathknight,unholy,12,3,9
1487,Kreachuer,lightbringer,287,deathknight,unholy,12,3,9
1488,Trukutruu,drakkari,286,deathknight,unholy,6,3,3
1489,Orthason,moon-guard,286,deathknight,unholy,6,3,3
1490,Soulgrinder,earthen-ring,286,deathknight,unholy,6,3,3
1491,Copy,suramar,271,deathknight,unholy,11,3,8
1492,Milkdrugs,daggerspine,256,deathknight,unholy,10,3,7
1493,Guffles,tichondrius,256,deathknight,unholy,16,3,13
1494,Baskel,frostmane,255,deathknight,unholy,11,3,8
1495,Cryodemic,illidan,240,deathknight,unholy,9,3,6
1496,Deathrowe,blackhand,240,deathknight,unholy,9,3,6
1497,Leoprime,area-52,239,deathknight,unholy,5,3,2
1498,Dairboi,sargeras,239,deathknight,unholy,5,3,2
1499,Originalsin,tichondrius,239,deathknight,unholy,11,3,8
1500,Rompeimën,ragnaros,234,deathknight,unholy,11,6,5
1501,Ðëthbringër,jubeithos,223,deathknight,unholy,14,3,11
1502,Crypton,tichondrius,208,deathknight,unholy,13,3,10
1503,Charabone,ragnaros,192,deathknight,unholy,4,3,1
1504,Chunkdk,stormrage,192,deathknight,unholy,4,3,1
1505,Socalaj,malorne,192,deathknight,unholy,6,2,4
1506,Tèrok,stormrage,192,deathknight,unholy,6,2,4
1507,Ohia,baelgun,192,deathknight,unholy,6,2,4
1508,Disturbedtwo,azralon,192,deathknight,unholy,6,2,4
1509,Eastcoast,azuremyst,192,deathknight,unholy,6,2,4
1510,Junepí,stormrage,192,deathknight,unholy,6,2,4
1511,Moonkhink,stormrage,192,deathknight,unholy,6,2,4
1512,Zzed,azralon,192,deathknight,unholy,6,2,4
1513,Doomdk,azralon,192,deathknight,unholy,6,2,4
1514,Bogoraptor,emerald-dream,192,deathknight,unholy,6,2,4
1515,Orcazmic,area-52,192,deathknight,unholy,6,2,4
1516,Geliòn,quelthalas,192,deathknight,unholy,6,2,4
1517,Rakelan,area-52,192,deathknight,unholy,6,2,4
1518,Grimreminder,zuljin,192,deathknight,unholy,6,2,4
1519,Otr,wyrmrest-accord,192,deathknight,unholy,6,2,4
1520,Menalise,moon-guard,192,deathknight,unholy,6,2,4
1521,Spaxz,illidan,192,deathknight,unholy,6,2,4
1522,Balstan,tichondrius,192,deathknight,unholy,6,2,4
1523,Corscadden,zuljin,192,deathknight,unholy,6,2,4
1524,Kookx,tichondrius,192,deathknight,unholy,6,2,4
1525,Blooddisease,frostmourne,192,deathknight,unholy,6,2,4
1526,Mesx,tichondrius,192,deathknight,unholy,6,2,4
1527,Dkb,drakthul,192,deathknight,unholy,6,2,4
1528,Gooré,ragnaros,192,deathknight,unholy,6,2,4
1529,Dkgrrick,bleeding-hollow,192,deathknight,unholy,6,2,4
1530,Twocolors,gilneas,192,deathknight,unholy,6,2,4
1531,Mistake,ragnaros,192,deathknight,unholy,6,2,4
1532,Supfam,tichondrius,192,deathknight,unholy,6,2,4
1533,Nightdaddyy,laughing-skull,192,deathknight,unholy,6,2,4
1534,Chandsformer,tichondrius,192,deathknight,unholy,6,2,4
1535,Orbo,elune,192,deathknight,unholy,6,2,4
1536,Questíonable,arthas,192,deathknight,unholy,6,2,4
1537,Teedk,drakthul,192,deathknight,unholy,6,2,4
1538,Cailras,argent-dawn,192,deathknight,unholy,6,2,4
1539,Benweth,dalaran,192,deathknight,unholy,6,2,4
1540,Kangsewooks,tichondrius,192,deathknight,unholy,6,2,4
1541,Boogers,cenarion-circle,192,deathknight,unholy,6,2,4
1542,Daddyspankme,frostmane,192,deathknight,unholy,6,2,4
1543,Dkdkdkdkdk,chromaggus,192,deathknight,unholy,6,2,4
1544,Lubmuscle,illidan,192,deathknight,unholy,6,2,4
1545,Fizzease,illidan,192,deathknight,unholy,6,2,4
1546,Rockadeath,sargeras,192,deathknight,unholy,6,2,4
1547,Lìlith,dreadmaul,192,deathknight,unholy,6,2,4
1548,Mako,garithos,192,deathknight,unholy,6,2,4
1549,Hastë,proudmoore,192,deathknight,unholy,6,2,4
1550,Zilli,blackrock,192,deathknight,unholy,6,2,4
1551,Berodox,malganis,192,deathknight,unholy,6,2,4
1552,Uncoachablex,illidan,192,deathknight,unholy,6,2,4
1553,Astaxstaria,bladefist,192,deathknight,unholy,6,2,4
1554,Afkftwok,illidan,192,deathknight,unholy,6,2,4
1555,Reizü,ragnaros,192,deathknight,unholy,6,2,4
1556,Ralphpootawn,illidan,192,deathknight,unholy,6,2,4
1557,Weedseagull,dragonmaw,192,deathknight,unholy,6,2,4
1558,Saraphdk,area-52,192,deathknight,unholy,6,2,4
1559,Válhállá,ragnaros,192,deathknight,unholy,6,2,4
1560,Tbop,ragnaros,192,deathknight,unholy,6,2,4
1561,Kniightdkk,kelthuzad,192,deathknight,unholy,6,2,4
1562,Sieg,goldrinn,192,deathknight,unholy,6,2,4
1563,Havasu,proudmoore,192,deathknight,unholy,6,2,4
1564,Izanagidk,nemesis,192,deathknight,unholy,6,2,4
1565,Dustknight,sargeras,192,deathknight,unholy,6,2,4
1566,Mortorum,skullcrusher,192,deathknight,unholy,6,2,4
1567,Zacharya,nemesis,192,deathknight,unholy,6,2,4
1568,Kranaz,barthilas,192,deathknight,unholy,6,2,4
1569,Fatmamma,ragnaros,192,deathknight,unholy,6,2,4
1570,Onsslaught,sargeras,192,deathknight,unholy,6,2,4
1571,Bealzabubb,sargeras,192,deathknight,unholy,6,2,4
1572,Kmardk,area-52,192,deathknight,unholy,6,2,4
1573,Vlladimir,kelthuzad,192,deathknight,unholy,6,2,4
1574,Dhaarok,malganis,192,deathknight,unholy,6,2,4
1575,Deathscythè,barthilas,192,deathknight,unholy,6,2,4
1576,Semisoftbody,malganis,192,deathknight,unholy,6,2,4
1577,Mythandour,shandris,192,deathknight,unholy,6,2,4
1578,Tristam,area-52,192,deathknight,unholy,6,2,4
1579,Geth,sargeras,192,deathknight,unholy,6,2,4
1580,Superjessdk,area-52,192,deathknight,unholy,6,2,4
1581,Pandauh,proudmoore,192,deathknight,unholy,6,2,4
1582,Tanskeey,sargeras,192,deathknight,unholy,6,2,4
1583,Wheybolic,quelthalas,192,deathknight,unholy,6,2,4
1584,Ahmisu,tichondrius,192,deathknight,unholy,6,2,4
1585,Lunatick,darkspear,192,deathknight,unholy,6,2,4
1586,Lòthlòria,mannoroth,192,deathknight,unholy,8,2,6
1587,Maliceborn,stormrage,192,deathknight,unholy,12,2,10
1588,Cow,sargeras,192,deathknight,unholy,12,2,10
1589,Mystery,wyrmrest-accord,192,deathknight,unholy,12,2,10
1590,Ðìvíne,illidan,192,deathknight,unholy,12,2,10
1591,Corzmaen,illidan,192,deathknight,unholy,12,2,10
1592,Giraldus,stormrage,192,deathknight,unholy,12,2,10
1593,Víní,azralon,192,deathknight,unholy,12,2,10
1594,Stteve,proudmoore,192,deathknight,unholy,12,2,10
1595,Chachea,kiljaeden,192,deathknight,unholy,12,2,10
1596,Nubsz,zuljin,192,deathknight,unholy,12,2,10
1597,Nightrose,skullcrusher,192,deathknight,unholy,12,2,10
1598,Kzen,skullcrusher,192,deathknight,unholy,12,2,10
1599,Scythê,barthilas,192,deathknight,unholy,12,2,10
1600,Tacofoxlol,tichondrius,192,deathknight,unholy,12,2,10
1601,Rykard,hyjal,192,deathknight,unholy,12,2,10
1602,Zerodk,kelthuzad,192,deathknight,unholy,12,2,10
1603,Ovulating,malganis,192,deathknight,unholy,12,2,10
1604,Dixqt,deathwing,192,deathknight,unholy,12,2,10
1605,Lunaxx,ragnaros,192,deathknight,unholy,12,2,10
1606,Ðreak,azralon,192,deathknight,unholy,12,2,10
1607,Dxn,nemesis,192,deathknight,unholy,18,2,16
1608,Katiaany,quelthalas,192,deathknight,unholy,18,2,16
1609,Larrisey,illidan,191,deathknight,unholy,6,2,4
1610,Mormonpest,illidan,191,deathknight,unholy,6,2,4
1611,Drdeathz,sargeras,191,deathknight,unholy,6,2,4
1612,Kaýlea,azralon,191,deathknight,unholy,6,2,4
1613,Malkiss,kirin-tor,191,deathknight,unholy,6,2,4
1614,Glacíuss,ragnaros,138,deathknight,unholy,9,4,5
1615,Patchi,area-52,138,deathknight,unholy,14,4,10
1616,Plutonyus,stonemaul,128,deathknight,unholy,4,2,2
1617,Caotix,bleeding-hollow,96,deathknight,unholy,3,2,1
1618,Dethklòk,area-52,96,deathknight,unholy,6,1,5
1619,Amö,emerald-dream,96,deathknight,unholy,6,1,5
1620,Alexanderz,quelthalas,96,deathknight,unholy,6,1,5
1621,Drip,whisperwind,96,deathknight,unholy,6,1,5
1622,Zenin,emerald-dream,96,deathknight,unholy,6,1,5
1623,Raicoron,zuljin,96,deathknight,unholy,6,1,5
1624,Zalåel,area-52,96,deathknight,unholy,6,1,5
1625,Calabrass,mannoroth,96,deathknight,unholy,6,1,5
1626,Axiom,nemesis,96,deathknight,unholy,6,1,5
1627,Dheyqu,quelthalas,96,deathknight,unholy,6,1,5
1628,Azryull,perenolde,96,deathknight,unholy,6,1,5
1629,Karmakulaz,wildhammer,96,deathknight,unholy,6,1,5
1630,Stormsick,ragnaros,96,deathknight,unholy,6,1,5
1631,Lazynome,azshara,96,deathknight,unholy,6,1,5
1632,Apeirøn,quelthalas,96,deathknight,unholy,6,1,5
1633,Ziedrich,sargeras,96,deathknight,unholy,6,1,5
1634,Requísition,barthilas,96,deathknight,unholy,6,1,5
1635,Dontbanmepls,zuljin,96,deathknight,unholy,6,1,5
1636,ßlazedkush,kelthuzad,96,deathknight,unholy,6,1,5
1637,Lichhbanne,doomhammer,96,deathknight,unholy,6,1,5
1638,Tìtø,ragnaros,96,deathknight,unholy,6,1,5
1639,Hunwild,emerald-dream,96,deathknight,unholy,6,1,5
1640,Krw,stormrage,96,deathknight,unholy,6,1,5
1641,Snipestrike,area-52,96,deathknight,unholy,6,1,5
1642,Neofrank,drakkari,96,deathknight,unholy,6,1,5
1643,Rgn,deathwing,96,deathknight,unholy,6,1,5
1644,Sandolorian,area-52,96,deathknight,unholy,6,1,5
1645,Terrethess,illidan,96,deathknight,unholy,6,1,5
1646,Report,dathremar,96,deathknight,unholy,6,1,5
1647,Testitickler,gurubashi,96,deathknight,unholy,6,1,5
1648,Abake,illidan,96,deathknight,unholy,6,1,5
1649,Tarone,zuljin,96,deathknight,unholy,6,1,5
1650,Wacktony,illidan,96,deathknight,unholy,6,1,5
1651,Gnargnarr,firetree,96,deathknight,unholy,6,1,5
1652,Percy,thaurissan,96,deathknight,unholy,6,1,5
1653,Dknightor,dalaran,96,deathknight,unholy,6,1,5
1654,Plaguedoctor,thrall,96,deathknight,unholy,6,1,5
1655,Andivh,hydraxis,96,deathknight,unholy,6,1,5
1656,Vicedro,arthas,96,deathknight,unholy,6,1,5
1657,Nachohands,laughing-skull,96,deathknight,unholy,6,1,5
1658,Agrithomqt,frostmourne,96,deathknight,unholy,6,1,5
1659,Heavic,skywall,96,deathknight,unholy,6,1,5
1660,Apocalypsis,uldum,96,deathknight,unholy,6,1,5
1661,Ishamaael,tichondrius,96,deathknight,unholy,6,1,5
1662,Rotfang,elune,96,deathknight,unholy,6,1,5
1663,Diviniums,bleeding-hollow,96,deathknight,unholy,6,1,5
1664,Istery,thrall,96,deathknight,unholy,6,1,5
1665,Grimorra,bleeding-hollow,96,deathknight,unholy,6,1,5
1666,Sever,demon-soul,96,deathknight,unholy,6,1,5
1667,Bealzabbub,sargeras,96,deathknight,unholy,6,1,5
1668,Argy,zuljin,96,deathknight,unholy,6,1,5
1669,Distrolldk,zuljin,96,deathknight,unholy,6,1,5
1670,Dekadart,quelthalas,96,deathknight,unholy,6,1,5
1671,Otarin,tichondrius,96,deathknight,unholy,6,1,5
1672,Alayssia,darkspear,96,deathknight,unholy,6,1,5
1673,Râzôr,korgath,96,deathknight,unholy,6,1,5
1674,Fantabanana,azralon,96,deathknight,unholy,6,1,5
1675,Poefather,tichondrius,96,deathknight,unholy,6,1,5
1676,Veslemes,tichondrius,96,deathknight,unholy,6,1,5
1677,Beedamoniv,tichondrius,96,deathknight,unholy,6,1,5
1678,Hushima,lightbringer,96,deathknight,unholy,6,1,5
1679,Vicesquad,tichondrius,96,deathknight,unholy,6,1,5
1680,Warraxe,draka,96,deathknight,unholy,6,1,5
1681,Bulltille,azralon,96,deathknight,unholy,6,1,5
1682,Iluvbooty,blackrock,96,deathknight,unholy,6,1,5
1683,Moldremover,frostmourne,96,deathknight,unholy,6,1,5
1684,Bein,frostmourne,96,deathknight,unholy,6,1,5
1685,Gröxxigor,azralon,96,deathknight,unholy,6,1,5
1686,Perculës,sargeras,96,deathknight,unholy,7,1,6
1687,Aqs,sargeras,96,deathknight,unholy,9,1,8
1688,Wkxx,tichondrius,96,deathknight,unholy,12,1,11
1689,Dípero,azralon,96,deathknight,unholy,12,1,11
1690,Yorishomi,sargeras,96,deathknight,unholy,12,1,11
1691,Skadattle,emerald-dream,96,deathknight,unholy,12,1,11
1692,Klàssy,stormrage,96,deathknight,unholy,12,1,11
1693,Blowout,barthilas,96,deathknight,unholy,12,1,11
1694,Vinsval,tichondrius,96,deathknight,unholy,12,1,11
1695,Xeroxoxo,khadgar,96,deathknight,unholy,12,1,11
1696,Darnkiller,kelthuzad,96,deathknight,unholy,18,1,17
1697,Funerall,azralon,95,deathknight,unholy,12,1,11
1698,Explorer,kelthuzad,64,deathknight,unholy,4,1,3
1699,Asfaq,frostmourne,63,deathknight,unholy,2,2,0
1700,Deanz,stormrage,63,deathknight,unholy,2,2,0
1701,Weebfiend,moon-guard,63,deathknight,unholy,8,2,6
1702,Ayçe,proudmoore,58,deathknight,unholy,10,3,7
1703,Spleem,stormrage,48,deathknight,unholy,3,1,2
1704,Lördd,moon-guard,42,deathknight,unholy,11,3,8
1705,Harrypottr,darrowmere,42,deathknight,unholy,8,2,6
1706,Ryannë,azshara,42,deathknight,unholy,12,2,10
1707,Doomstrike,azuremyst,16,deathknight,unholy,1,1,0
1708,Pookr,area-52,2214,deathknight,frost,355,180,175
1709,Yoinkzz,illidan,2167,deathknight,frost,113,58,55
1710,Runtasticxz,tichondrius,1949,deathknight,frost,83,40,43
1711,Sylèss,tichondrius,1945,deathknight,frost,120,64,56
1712,Thânätos,nemesis,1935,deathknight,frost,108,54,54
1713,Xelonith,sargeras,1901,deathknight,frost,54,30,24
1714,Ksmc,tichondrius,1893,deathknight,frost,78,40,38
1715,Axiomqt,tichondrius,1889,deathknight,frost,102,52,50
1716,Raiekko,dalaran,1888,deathknight,frost,68,33,35
1717,Duranteh,illidan,1881,deathknight,frost,60,32,28
1718,Mikeycal,stormrage,1873,deathknight,frost,90,47,43
1719,Venvicta,tichondrius,1850,deathknight,frost,44,31,13
1720,Saco,malganis,1845,deathknight,frost,110,62,48
1721,Mikepinkdk,illidan,1839,deathknight,frost,105,60,45
1722,Fastapii,tichondrius,1838,deathknight,frost,47,27,20
1723,Scareth,proudmoore,1823,deathknight,frost,46,27,19
1724,Iccyhottie,stormrage,1823,deathknight,frost,322,170,152
1725,Deaddubya,illidan,1815,deathknight,frost,63,40,23
1726,Gràkk,illidan,1810,deathknight,frost,78,44,34
1727,Gladiaturd,hellscream,1809,deathknight,frost,88,45,43
1728,Dunduner,tichondrius,1803,deathknight,frost,36,23,13
1729,Chillbaynê,the-scryers,1754,deathknight,frost,36,22,14
1730,Grippygarý,illidan,1754,deathknight,frost,54,26,28
1731,Unhappyvelic,tichondrius,1751,deathknight,frost,63,32,31
1732,Fastapi,tichondrius,1737,deathknight,frost,90,41,49
1733,Dkyeico,ragnaros,1735,deathknight,frost,96,46,50
1734,Sober,destromath,1712,deathknight,frost,95,48,47
1735,Devcoil,sargeras,1706,deathknight,frost,54,22,32
1736,Kryptikkyt,blackrock,1694,deathknight,frost,24,18,6
1737,Whytedk,illidan,1685,deathknight,frost,48,21,27
1738,Skullash,stormrage,1676,deathknight,frost,54,33,21
1739,Frosthana,illidan,1671,deathknight,frost,120,58,62
1740,Jykupajr,proudmoore,1669,deathknight,frost,66,29,37
1741,Remanent,tichondrius,1664,deathknight,frost,77,39,38
1742,Crink,sargeras,1658,deathknight,frost,47,24,23
1743,Onsslaught,sargeras,1658,deathknight,frost,48,18,30
1744,Menalise,moon-guard,1650,deathknight,frost,42,22,20
1745,Børeas,quelthalas,1645,deathknight,frost,96,43,53
1746,Gkdm,tichondrius,1643,deathknight,frost,42,21,21
1747,Tzepesci,hyjal,1626,deathknight,frost,58,26,32
1748,Deathboost,stormrage,1617,deathknight,frost,81,35,46
1749,Sinizster,kelthuzad,1615,deathknight,frost,31,18,13
1750,Ebolaxd,area-52,1614,deathknight,frost,42,21,21
1751,Rekktless,aerie-peak,1613,deathknight,frost,72,37,35
1752,Legendåryx,sargeras,1609,deathknight,frost,42,28,14
1753,Darkwraith,illidan,1606,deathknight,frost,72,39,33
1754,Vãl,sargeras,1601,deathknight,frost,296,149,147
1755,Blooddisease,frostmourne,1600,deathknight,frost,59,30,29
1756,Dromidon,darkspear,1590,deathknight,frost,71,39,32
1757,Percy,thaurissan,1589,deathknight,frost,271,131,140
1758,Azhid,tichondrius,1574,deathknight,frost,30,19,11
1759,Gordiie,stormrage,1570,deathknight,frost,98,55,43
1760,Fußuky,quelthalas,1566,deathknight,frost,88,44,44
1761,Worgenracist,tichondrius,1566,deathknight,frost,59,24,35
1762,Zemzil,tichondrius,1557,deathknight,frost,74,34,40
1763,Zenin,emerald-dream,1543,deathknight,frost,62,31,31
1764,Grakth,quelthalas,1527,deathknight,frost,66,37,29
1765,Imfrozone,stormrage,1527,deathknight,frost,65,31,34
1766,Deadspellz,bleeding-hollow,1520,deathknight,frost,48,19,29
1767,Uzgard,zuljin,1517,deathknight,frost,65,38,27
1768,Xhín,bleeding-hollow,1506,deathknight,frost,30,16,14
1769,Iriwa,tichondrius,1498,deathknight,frost,42,16,26
1770,Report,dathremar,1494,deathknight,frost,75,38,37
1771,Rembrandtdk,gorefiend,1481,deathknight,frost,99,52,47
1772,Emanuels,quelthalas,1478,deathknight,frost,116,59,57
1773,Trødz,tichondrius,1468,deathknight,frost,87,42,45
1774,Plaw,kiljaeden,1467,deathknight,frost,29,16,13
1775,Corrpsse,tichondrius,1467,deathknight,frost,129,67,62
1776,Lho,caelestrasz,1465,deathknight,frost,107,54,53
1777,Tangarang,dalaran,1457,deathknight,frost,92,45,47
1778,Algeross,dalaran,1457,deathknight,frost,166,78,88
1779,Jimmyjohnson,illidan,1453,deathknight,frost,107,58,49
1780,Dekanok,korgath,1452,deathknight,frost,30,16,14
1781,Vuldy,blackhand,1448,deathknight,frost,45,25,20
1782,Jazh,tichondrius,1441,deathknight,frost,59,23,36
1783,Freshzzk,azralon,1440,deathknight,frost,118,62,56
1784,Umbramane,tichondrius,1438,deathknight,frost,39,19,20
1785,Gkdl,tichondrius,1437,deathknight,frost,30,15,15
1786,Iskandàr,ragnaros,1435,deathknight,frost,32,16,16
1787,Rylas,destromath,1432,deathknight,frost,120,62,58
1788,Vust,malganis,1427,deathknight,frost,48,25,23
1789,Abrahams,tichondrius,1427,deathknight,frost,100,48,52
1790,Deathzpeckt,tichondrius,1419,deathknight,frost,84,34,50
1791,Icewalløw,darkspear,1417,deathknight,frost,24,15,9
1792,Ðerion,stormrage,1414,deathknight,frost,140,62,78
1793,Sandooñ,tichondrius,1402,deathknight,frost,150,75,75
1794,Sécret,tichondrius,1394,deathknight,frost,36,21,15
1795,Eldavò,quelthalas,1393,deathknight,frost,60,25,35
1796,Biggil,tichondrius,1389,deathknight,frost,32,20,12
1797,Dkbunny,thaurissan,1388,deathknight,frost,42,15,27
1798,Shubertx,tichondrius,1385,deathknight,frost,48,21,27
1799,Khalid,azgalor,1376,deathknight,frost,54,23,31
1800,Clongeus,tichondrius,1374,deathknight,frost,54,25,29
1801,Sinyay,tichondrius,1370,deathknight,frost,82,48,34
1802,Theronguard,area-52,1370,deathknight,frost,60,28,32
1803,Nevermor,malganis,1362,deathknight,frost,104,53,51
1804,Ellipsoro,onyxia,1362,deathknight,frost,78,35,43
1805,Gwab,stormrage,1354,deathknight,frost,48,20,28
1806,Janzano,deathwing,1350,deathknight,frost,32,18,14
1807,Eloton,daggerspine,1350,deathknight,frost,35,18,17
1808,Thetalis,moon-guard,1346,deathknight,frost,78,38,40
1809,Tekc,nemesis,1345,deathknight,frost,168,83,85
1810,Clapdat,malganis,1335,deathknight,frost,114,56,58
1811,Bizdale,frostmourne,1330,deathknight,frost,24,14,10
1812,Ântipaladin,arthas,1328,deathknight,frost,36,19,17
1813,Panthir,darkspear,1325,deathknight,frost,42,16,26
1814,Kruspy,area-52,1324,deathknight,frost,53,27,26
1815,Dontbanmepls,zuljin,1318,deathknight,frost,30,14,16
1816,Demønnation,illidan,1312,deathknight,frost,44,21,23
1817,Himanshu,emerald-dream,1310,deathknight,frost,69,33,36
1818,Alexeous,wyrmrest-accord,1304,deathknight,frost,127,57,70
1819,Bridenbrad,quelthalas,1299,deathknight,frost,27,17,10
1820,Iceice,emerald-dream,1293,deathknight,frost,114,53,61
1821,Lichborn,azralon,1293,deathknight,frost,71,30,41
1822,Bossk,emerald-dream,1283,deathknight,frost,36,14,22
1823,Spoon,sargeras,1282,deathknight,frost,118,60,58
1824,Friggintough,tichondrius,1281,deathknight,frost,74,35,39
1825,Sporkdk,illidan,1277,deathknight,frost,53,20,33
1826,Estali,kelthuzad,1272,deathknight,frost,110,51,59
1827,Abake,illidan,1267,deathknight,frost,62,30,32
1828,Parksy,kelthuzad,1264,deathknight,frost,53,26,27
1829,Alexanderz,quelthalas,1264,deathknight,frost,36,15,21
1830,Lókhä,thrall,1262,deathknight,frost,30,14,16
1831,Darketvam,illidan,1261,deathknight,frost,46,28,18
1832,Mexe,ragnaros,1242,deathknight,frost,56,28,28
1833,Bâttalion,illidan,1237,deathknight,frost,30,13,17
1834,Rayden,frostmourne,1235,deathknight,frost,24,13,11
1835,Yödä,barthilas,1235,deathknight,frost,36,14,22
1836,Jackofblades,veknilash,1225,deathknight,frost,84,42,42
1837,Ðëthbringër,jubeithos,1220,deathknight,frost,30,13,17
1838,Soulfang,nemesis,1218,deathknight,frost,66,34,32
1839,Darkdeviliv,darkspear,1214,deathknight,frost,59,29,30
1840,Flins,nemesis,1212,deathknight,frost,487,244,243
1841,Verhangnis,azjolnerub,1210,deathknight,frost,31,16,15
1842,Zeró,wyrmrest-accord,1204,deathknight,frost,30,13,17
1843,Seeyoudiebr,gallywix,1190,deathknight,frost,42,17,25
1844,Zefdk,illidan,1186,deathknight,frost,48,27,21
1845,Barrodir,tichondrius,1183,deathknight,frost,81,40,41
1846,Lospollos,tichondrius,1181,deathknight,frost,60,23,37
1847,Úndead,barthilas,1180,deathknight,frost,24,14,10
1848,Darfik,sargeras,1177,deathknight,frost,120,65,55
1849,Nocreed,illidan,1175,deathknight,frost,54,18,36
1850,Dkptador,azralon,1174,deathknight,frost,166,81,85
1851,Darkreígn,tichondrius,1171,deathknight,frost,71,33,38
1852,Renathâ,ragnaros,1167,deathknight,frost,42,15,27
1853,Jordankg,tanaris,1165,deathknight,frost,41,16,25
1854,Lîch,azralon,1157,deathknight,frost,63,24,39
1855,Tìtø,ragnaros,1151,deathknight,frost,24,12,12
1856,Beliath,crushridge,1150,deathknight,frost,29,12,17
1857,Lxsol,illidan,1149,deathknight,frost,18,12,6
1858,Kodokuna,bleeding-hollow,1149,deathknight,frost,24,12,12
1859,Dkapocalypse,azralon,1149,deathknight,frost,38,13,25
1860,Tambaknight,nemesis,1146,deathknight,frost,44,15,29
1861,Laumuelden,ragnaros,1143,deathknight,frost,48,17,31
1862,Janco,runetotem,1141,deathknight,frost,24,12,12
1863,Frostunholy,tichondrius,1140,deathknight,frost,24,12,12
1864,Gripnpull,tichondrius,1137,deathknight,frost,24,12,12
1865,Carecaa,azralon,1135,deathknight,frost,48,19,29
1866,Hiki,ragnaros,1134,deathknight,frost,30,12,18
1867,Kace,amanthul,1130,deathknight,frost,66,34,32
1868,Tarknok,moon-guard,1123,deathknight,frost,24,12,12
1869,Metaphysicsx,amanthul,1119,deathknight,frost,54,29,25
1870,Achilleo,quelthalas,1115,deathknight,frost,24,12,12
1871,Rohdey,madoran,1114,deathknight,frost,129,54,75
1872,Pembadk,tichondrius,1110,deathknight,frost,33,14,19
1873,Panddemonio,gallywix,1107,deathknight,frost,30,12,18
1874,Jawyn,area-52,1096,deathknight,frost,30,12,18
1875,Ârtas,uldum,1090,deathknight,frost,39,16,23
1876,Moonnwater,frostmourne,1087,deathknight,frost,84,43,41
1877,Dantte,stormscale,1080,deathknight,frost,59,31,28
1878,Garryxz,quelthalas,1077,deathknight,frost,22,12,10
1879,Ryugetzu,drakkari,1074,deathknight,frost,36,12,24
1880,Griswold,windrunner,1069,deathknight,frost,34,18,16
1881,Darkdevilvii,tichondrius,1069,deathknight,frost,66,33,33
1882,Mawvac,quelthalas,1069,deathknight,frost,72,33,39
1883,Wap,bloodhoof,1056,deathknight,frost,18,11,7
1884,Zephyx,lightbringer,1056,deathknight,frost,18,11,7
1885,Toxismall,zuljin,1056,deathknight,frost,24,11,13
1886,Vigasick,azralon,1056,deathknight,frost,24,11,13
1887,Ariacy,sargeras,1056,deathknight,frost,24,11,13
1888,Mörrigham,stormrage,1055,deathknight,frost,18,11,7
1889,Puppykisses,perenolde,1055,deathknight,frost,24,11,13
1890,Bikfrostyboi,barthilas,1053,deathknight,frost,18,11,7
1891,Jhonnsnow,frostmourne,1051,deathknight,frost,24,11,13
1892,Ruggair,proudmoore,1051,deathknight,frost,24,11,13
1893,Nalz,drakkari,1050,deathknight,frost,30,11,19
1894,Dregdar,emerald-dream,1049,deathknight,frost,18,11,7
1895,Ixiefin,sargeras,1048,deathknight,frost,18,13,5
1896,Tightann,stormrage,1047,deathknight,frost,24,11,13
1897,Malovv,nemesis,1042,deathknight,frost,18,12,6
1898,Roarbane,muradin,1030,deathknight,frost,54,29,25
1899,Sephirott,boulderfist,1029,deathknight,frost,41,20,21
1900,Janoh,the-scryers,1021,deathknight,frost,44,19,25
1901,Vanyor,wyrmrest-accord,1009,deathknight,frost,62,21,41
1902,Zarathraz,ragnaros,1004,deathknight,frost,23,11,12
1903,Eliagianluca,caelestrasz,1003,deathknight,frost,71,32,39
1904,Icedmilk,zuluhed,996,deathknight,frost,30,16,14
1905,ßlazedkush,kelthuzad,989,deathknight,frost,36,18,18
1906,Tarone,zuljin,981,deathknight,frost,27,14,13
1907,Vorlakesh,boulderfist,979,deathknight,frost,22,11,11
1908,Sakaarr,bleeding-hollow,974,deathknight,frost,48,21,27
1909,Khorvusfel,frostmourne,972,deathknight,frost,22,11,11
1910,Whoopsies,sargeras,968,deathknight,frost,66,27,39
1911,Skittsdk,thrall,966,deathknight,frost,24,12,12
1912,Ciputra,blood-furnace,962,deathknight,frost,53,27,26
1913,Stormitt,illidan,959,deathknight,frost,24,10,14
1914,Tokyotimxx,malganis,958,deathknight,frost,18,10,8
1915,Thetissuebox,emerald-dream,958,deathknight,frost,18,10,8
1916,Frosqt,queldorei,957,deathknight,frost,12,10,2
1917,Toothstick,stormrage,957,deathknight,frost,18,10,8
1918,Amarlana,mannoroth,957,deathknight,frost,18,10,8
1919,Serwestley,stormrage,956,deathknight,frost,18,10,8
1920,Necrósy,azralon,955,deathknight,frost,18,10,8
1921,Axylus,kelthuzad,953,deathknight,frost,18,10,8
1922,Bullbanger,runetotem,953,deathknight,frost,42,22,20
1923,Raegywn,blood-furnace,952,deathknight,frost,24,10,14
1924,Larrisey,illidan,940,deathknight,frost,33,18,15
1925,Kraige,tichondrius,933,deathknight,frost,30,10,20
1926,Aztecka,illidan,915,deathknight,frost,36,18,18
1927,Grimmr,tichondrius,912,deathknight,frost,23,10,13
1928,Ðreak,azralon,907,deathknight,frost,23,10,13
1929,Fokit,barthilas,897,deathknight,frost,58,28,30
1930,Sandolorian,area-52,892,deathknight,frost,24,10,14
1931,Kallugrax,kelthuzad,885,deathknight,frost,42,16,26
1932,Onsllaught,stormrage,864,deathknight,frost,12,9,3
1933,Lokitabeso,ragnaros,864,deathknight,frost,12,9,3
1934,Wahpow,frostwolf,864,deathknight,frost,12,9,3
1935,Lazenca,malganis,863,deathknight,frost,18,9,9
1936,Garbage,sargeras,863,deathknight,frost,18,9,9
1937,Zarakas,sargeras,863,deathknight,frost,24,9,15
1938,Kekkijutsu,bleeding-hollow,862,deathknight,frost,12,9,3
1939,Zivz,borean-tundra,862,deathknight,frost,12,9,3
1940,Thesseo,quelthalas,862,deathknight,frost,18,9,9
1941,Surcäfauces,ragnaros,862,deathknight,frost,21,10,11
1942,Chicnchsteak,tichondrius,862,deathknight,frost,30,9,21
1943,Jasmíne,vashj,861,deathknight,frost,12,9,3
1944,Urieen,gorefiend,861,deathknight,frost,18,9,9
1945,Sllice,aegwynn,858,deathknight,frost,24,9,15
1946,Neowolf,azgalor,857,deathknight,frost,53,16,37
1947,Helguarde,dragonblight,853,deathknight,frost,30,13,17
1948,Madorderog,stormrage,846,deathknight,frost,40,18,22
1949,Frrost,earthen-ring,845,deathknight,frost,25,10,15
1950,Wartodeath,illidan,843,deathknight,frost,18,9,9
1951,Dreekon,bleeding-hollow,842,deathknight,frost,22,12,10
1952,Krowl,nagrand,834,deathknight,frost,18,9,9
1953,Loverianed,aerie-peak,832,deathknight,frost,182,79,103
1954,Pizzathehutt,nordrassil,832,deathknight,frost,24,9,15
1955,Dèadpool,blackhand,828,deathknight,frost,18,9,9
1956,Uncfester,onyxia,823,deathknight,frost,18,9,9
1957,Ztrain,proudmoore,814,deathknight,frost,17,9,8
1958,Ron,spirestone,811,deathknight,frost,17,9,8
1959,Neofrank,drakkari,802,deathknight,frost,60,16,44
1960,Xslaught,maiev,798,deathknight,frost,22,10,12
1961,Incanis,moon-guard,782,deathknight,frost,19,9,10
1962,Lokitaßesos,ragnaros,768,deathknight,frost,12,8,4
1963,Lokítabesos,ragnaros,768,deathknight,frost,12,8,4
1964,Shobiz,barthilas,768,deathknight,frost,12,8,4
1965,Havince,drenden,768,deathknight,frost,12,8,4
1966,Skidmarks,whisperwind,768,deathknight,frost,12,8,4
1967,Denale,darkspear,768,deathknight,frost,18,8,10
1968,Satisie,eitrigg,767,deathknight,frost,18,8,10
1969,Kerigann,moon-guard,766,deathknight,frost,12,8,4
1970,Acg,tichondrius,766,deathknight,frost,12,8,4
1971,Artourias,wyrmrest-accord,766,deathknight,frost,12,8,4
1972,Freemoney,wyrmrest-accord,766,deathknight,frost,12,8,4
1973,Gypo,scilla,766,deathknight,frost,12,8,4
1974,Deweybrown,smolderthorn,765,deathknight,frost,12,8,4
1975,Dhrogar,moon-guard,762,deathknight,frost,12,8,4
1976,Amauqsun,bleeding-hollow,762,deathknight,frost,18,8,10
1977,Dyingwolf,ragnaros,761,deathknight,frost,18,8,10
1978,Jyantdeck,area-52,760,deathknight,frost,13,8,5
1979,Zarolden,tichondrius,759,deathknight,frost,24,8,16
1980,Ryannë,azshara,759,deathknight,frost,37,8,29
1981,Twicecursed,kelthuzad,758,deathknight,frost,18,8,10
1982,Fexon,queldorei,758,deathknight,frost,33,10,23
1983,Nagaizao,nemesis,757,deathknight,frost,18,8,10
1984,Hansmclroy,trollbane,738,deathknight,frost,24,8,16
1985,Monglord,arthas,733,deathknight,frost,27,9,18
1986,Russkivolk,frostmourne,688,deathknight,frost,19,8,11
1987,Dumbledore,deathwing,672,deathknight,frost,12,7,5
1988,Brutos,thrall,672,deathknight,frost,12,7,5
1989,Frøzèñintïmê,tichondrius,672,deathknight,frost,12,7,5
1990,Footodor,bleeding-hollow,672,deathknight,frost,12,7,5
1991,Bigfatdkk,illidan,672,deathknight,frost,12,7,5
1992,Insanity,boulderfist,672,deathknight,frost,12,7,5
1993,Anexdk,korgath,672,deathknight,frost,18,7,11
1994,Chillpills,stormrage,672,deathknight,frost,18,7,11
1995,Bersolgens,illidan,671,deathknight,frost,12,7,5
1996,Pandauh,proudmoore,671,deathknight,frost,18,7,11
1997,Mordekeiser,wyrmrest-accord,671,deathknight,frost,18,7,11
1998,Khutuzun,tichondrius,671,deathknight,frost,18,7,11
1999,Unintended,barthilas,671,deathknight,frost,24,7,17
2000,Unholycube,zuljin,671,deathknight,frost,30,7,23
2001,Thwap,sargeras,670,deathknight,frost,18,7,11
2002,Zulomón,area-52,670,deathknight,frost,18,7,11
2003,Fåîrÿdûst,skullcrusher,670,deathknight,frost,20,7,13
2004,Elwoodblooz,stormrage,669,deathknight,frost,15,8,7
2005,Alzenth,quelthalas,669,deathknight,frost,15,8,7
2006,Winterstone,moon-guard,669,deathknight,frost,18,7,11
2007,Rottenqunt,tichondrius,668,deathknight,frost,12,7,5
2008,Helvegum,tichondrius,668,deathknight,frost,12,7,5
2009,Caravante,azralon,668,deathknight,frost,18,7,11
2010,Bigdkk,thaurissan,666,deathknight,frost,27,10,17
2011,Cryptgore,moon-guard,665,deathknight,frost,18,7,11
2012,Varrine,hyjal,659,deathknight,frost,12,7,5
2013,Iiedown,stormrage,623,deathknight,frost,11,7,4
2014,Dreadmoore,wyrmrest-accord,607,deathknight,frost,16,7,9
2015,Lindrayëda,moon-guard,581,deathknight,frost,13,7,6
2016,Dementrius,zuljin,576,deathknight,frost,12,6,6
2017,Xangrim,emerald-dream,576,deathknight,frost,12,6,6
2018,Rotfang,proudmoore,576,deathknight,frost,12,6,6
2019,Otarin,tichondrius,576,deathknight,frost,12,6,6
2020,Soulbone,wyrmrest-accord,576,deathknight,frost,12,6,6
2021,Sparklekitty,illidan,576,deathknight,frost,12,6,6
2022,Riglros,tichondrius,576,deathknight,frost,12,6,6
2023,Darkxavros,stormrage,576,deathknight,frost,12,6,6
2024,Arnagal,drakkari,576,deathknight,frost,12,6,6
2025,Piratehookah,sargeras,576,deathknight,frost,12,6,6
2026,Aldrey,bonechewer,576,deathknight,frost,12,6,6
2027,Billclintonn,sargeras,576,deathknight,frost,12,6,6
2028,Ironslaught,moon-guard,576,deathknight,frost,12,6,6
2029,Rennoc,emerald-dream,576,deathknight,frost,12,6,6
2030,Hunrune,emerald-dream,576,deathknight,frost,12,6,6
2031,Dreadlight,moon-guard,576,deathknight,frost,12,6,6
2032,Cozzasad,barthilas,576,deathknight,frost,12,6,6
2033,Xhoul,sargeras,576,deathknight,frost,18,6,12
2034,Crimsondk,stormrage,576,deathknight,frost,18,6,12
2035,Chilivibes,boulderfist,576,deathknight,frost,18,6,12
2036,Neaz,moon-guard,576,deathknight,frost,18,6,12
2037,Whosurbobby,area-52,576,deathknight,frost,18,6,12
2038,Dairboi,sargeras,576,deathknight,frost,18,6,12
2039,Siouxsiie,nemesis,575,deathknight,frost,12,6,6
2040,Astanddra,wyrmrest-accord,575,deathknight,frost,12,6,6
2041,Flûffÿ,thrall,575,deathknight,frost,12,6,6
2042,Tooe,darrowmere,575,deathknight,frost,12,6,6
2043,Zamerz,malganis,575,deathknight,frost,12,6,6
2044,Davenn,stormrage,575,deathknight,frost,12,6,6
2045,Enobrah,proudmoore,575,deathknight,frost,24,6,18
2046,Bootyclapztv,tichondrius,574,deathknight,frost,12,6,6
2047,Nezareth,sargeras,574,deathknight,frost,12,6,6
2048,Bloodbanne,darkspear,573,deathknight,frost,12,6,6
2049,Ikaris,wildhammer,569,deathknight,frost,12,6,6
2050,Cailras,argent-dawn,566,deathknight,frost,12,6,6
2051,Ergoth,darkspear,564,deathknight,frost,30,6,24
2052,Busynas,thrall,559,deathknight,frost,11,6,5
2053,Vayk,bleeding-hollow,544,deathknight,frost,10,6,4
2054,Werebuddy,lightnings-blade,528,deathknight,frost,15,6,9
2055,Válhállá,ragnaros,523,deathknight,frost,17,6,11
2056,Bellum,moon-guard,511,deathknight,frost,20,6,14
2057,Kookx,tichondrius,489,deathknight,frost,13,6,7
2058,Vett,antonidas,480,deathknight,frost,6,5,1
2059,Necrôtic,area-52,480,deathknight,frost,6,5,1
2060,Lokitaßeso,ragnaros,480,deathknight,frost,6,5,1
2061,Sathanazz,ragnaros,480,deathknight,frost,6,5,1
2062,Hyondeath,tichondrius,480,deathknight,frost,12,5,7
2063,Rumblepuppy,hyjal,480,deathknight,frost,12,5,7
2064,Deadbeards,zuluhed,480,deathknight,frost,12,5,7
2065,Flashofdark,proudmoore,480,deathknight,frost,12,5,7
2066,Satalas,tichondrius,480,deathknight,frost,12,5,7
2067,Stevegates,tichondrius,480,deathknight,frost,12,5,7
2068,Dknightkofwa,tichondrius,480,deathknight,frost,12,5,7
2069,Bluex,silvermoon,480,deathknight,frost,12,5,7
2070,Subparatbest,chogall,480,deathknight,frost,12,5,7
2071,Biglimb,area-52,480,deathknight,frost,12,5,7
2072,Sinistarz,area-52,480,deathknight,frost,12,5,7
2073,Withered,area-52,480,deathknight,frost,12,5,7
2074,Martinnash,emerald-dream,480,deathknight,frost,12,5,7
2075,Deathrey,kargath,480,deathknight,frost,12,5,7
2076,Frozenhawk,lothar,480,deathknight,frost,12,5,7
2077,Drzièglér,tichondrius,480,deathknight,frost,18,5,13
2078,Kelistros,moon-guard,480,deathknight,frost,18,5,13
2079,Saighast,illidan,480,deathknight,frost,18,5,13
2080,Bëlzëbü,stormrage,479,deathknight,frost,6,5,1
2081,Bulltille,azralon,479,deathknight,frost,6,5,1
2082,Moovement,illidan,479,deathknight,frost,6,5,1
2083,Biotics,barthilas,479,deathknight,frost,12,5,7
2084,Nalec,tichondrius,479,deathknight,frost,12,5,7
2085,Jessaminne,nordrassil,479,deathknight,frost,24,5,19
2086,Adjudicated,darkspear,477,deathknight,frost,12,5,7
2087,Ðecimate,muradin,476,deathknight,frost,12,5,7
2088,Rogoroth,stormrage,475,deathknight,frost,12,5,7
2089,Killa,maiev,475,deathknight,frost,12,5,7
2090,Frostyclaws,blackrock,447,deathknight,frost,17,5,12
2091,Greeasy,bleeding-hollow,446,deathknight,frost,17,5,12
2092,Bluemanikin,area-52,416,deathknight,frost,10,5,5
2093,Drizzth,ragnaros,413,deathknight,frost,8,5,3
2094,Khaíne,wyrmrest-accord,400,deathknight,frost,16,5,11
2095,Dìs,frostmourne,399,deathknight,frost,5,5,0
2096,Tontan,cairne,384,deathknight,frost,6,4,2
2097,Gurrikhog,proudmoore,384,deathknight,frost,6,4,2
2098,Sauranak,bleeding-hollow,384,deathknight,frost,6,4,2
2099,Well,archimonde,384,deathknight,frost,6,4,2
2100,Ärlo,frostmourne,384,deathknight,frost,6,4,2
2101,Khazgrim,chogall,384,deathknight,frost,6,4,2
2102,Orbo,elune,384,deathknight,frost,6,4,2
2103,Cesarz,tichondrius,384,deathknight,frost,6,4,2
2104,Aldebamuu,ragnaros,384,deathknight,frost,6,4,2
2105,Beanboyx,tichondrius,384,deathknight,frost,6,4,2
2106,Bigdooks,area-52,384,deathknight,frost,6,4,2
2107,Tanjus,kelthuzad,384,deathknight,frost,6,4,2
2108,Laxatives,tichondrius,384,deathknight,frost,6,4,2
2109,Anatøly,ragnaros,384,deathknight,frost,6,4,2
2110,Xnightmàre,wildhammer,384,deathknight,frost,6,4,2
2111,Nabreus,ragnaros,384,deathknight,frost,6,4,2
2112,Teakillah,zuljin,384,deathknight,frost,6,4,2
2113,Riseup,area-52,384,deathknight,frost,6,4,2
2114,Pyradine,amanthul,384,deathknight,frost,12,4,8
2115,Thikness,tichondrius,384,deathknight,frost,12,4,8
2116,Almostdead,proudmoore,384,deathknight,frost,12,4,8
2117,Hooterzqt,tichondrius,384,deathknight,frost,12,4,8
2118,Lichhbanne,doomhammer,384,deathknight,frost,12,4,8
2119,Shmacmiller,stormrage,384,deathknight,frost,12,4,8
2120,Deathrowe,blackhand,384,deathknight,frost,12,4,8
2121,Noplug,area-52,384,deathknight,frost,12,4,8
2122,Aradorn,azralon,384,deathknight,frost,12,4,8
2123,Silanvia,wyrmrest-accord,384,deathknight,frost,12,4,8
2124,Maxymillion,thrall,384,deathknight,frost,12,4,8
2125,Zaddix,whisperwind,384,deathknight,frost,12,4,8
2126,Bellybuster,malganis,384,deathknight,frost,12,4,8
2127,Exiledknight,area-52,384,deathknight,frost,12,4,8
2128,Nefarion,nathrezim,384,deathknight,frost,15,4,11
2129,Ðaz,zuljin,384,deathknight,frost,18,4,14
2130,Gerardkyx,drakkari,384,deathknight,frost,18,4,14
2131,Wãrson,bleeding-hollow,383,deathknight,frost,6,4,2
2132,Shinici,kelthuzad,383,deathknight,frost,9,5,4
2133,Vithael,stormrage,383,deathknight,frost,12,4,8
2134,Getmad,anvilmar,383,deathknight,frost,12,4,8
2135,Adoran,turalyon,383,deathknight,frost,12,4,8
2136,Sindragos,stormrage,382,deathknight,frost,12,4,8
2137,Shioms,quelthalas,379,deathknight,frost,12,4,8
2138,Deathvortex,nemesis,379,deathknight,frost,12,4,8
2139,Brumaks,quelthalas,367,deathknight,frost,11,4,7
2140,Oilasslover,illidan,361,deathknight,frost,15,6,9
2141,Enjal,stormrage,352,deathknight,frost,10,4,6
2142,Lokitakisses,ragnaros,351,deathknight,frost,11,4,7
2143,Eltillible,ragnaros,336,deathknight,frost,15,4,11
2144,Xaldeth,moon-guard,319,deathknight,frost,14,4,10
2145,Bunghoolio,nerzhul,315,deathknight,frost,16,4,12
2146,Gunga,skullcrusher,288,deathknight,frost,6,3,3
2147,Störmrünner,kelthuzad,288,deathknight,frost,6,3,3
2148,Tofurious,barthilas,288,deathknight,frost,6,3,3
2149,Noobender,burning-blade,288,deathknight,frost,6,3,3
2150,ßlacklìsted,kelthuzad,288,deathknight,frost,6,3,3
2151,Dalka,laughing-skull,288,deathknight,frost,6,3,3
2152,Trant,tichondrius,288,deathknight,frost,6,3,3
2153,Clizforden,kelthuzad,288,deathknight,frost,6,3,3
2154,Laboön,stormrage,288,deathknight,frost,6,3,3
2155,Sorenbjerg,zuljin,288,deathknight,frost,6,3,3
2156,Ghouldruis,barthilas,288,deathknight,frost,6,3,3
2157,Zügzug,chogall,288,deathknight,frost,6,3,3
2158,Supermane,jubeithos,288,deathknight,frost,6,3,3
2159,Zygon,thrall,288,deathknight,frost,6,3,3
2160,Yamanji,wyrmrest-accord,288,deathknight,frost,6,3,3
2161,Gorsz,tichondrius,288,deathknight,frost,6,3,3
2162,Jughéad,thrall,288,deathknight,frost,6,3,3
2163,Drpepp,bleeding-hollow,288,deathknight,frost,6,3,3
2164,Frostybones,guldan,288,deathknight,frost,6,3,3
2165,Plaugedone,lightbringer,288,deathknight,frost,6,3,3
2166,Egirlgripper,area-52,288,deathknight,frost,6,3,3
2167,Atheion,the-underbog,288,deathknight,frost,6,3,3
2168,Cgg,tichondrius,288,deathknight,frost,6,3,3
2169,Alujin,arthas,288,deathknight,frost,6,3,3
2170,Víní,azralon,288,deathknight,frost,6,3,3
2171,Avantee,moon-guard,288,deathknight,frost,6,3,3
2172,Millariel,stormrage,288,deathknight,frost,6,3,3
2173,Démise,malganis,288,deathknight,frost,6,3,3
2174,Iröñ,baelgun,288,deathknight,frost,6,3,3
2175,Saraphdk,area-52,288,deathknight,frost,6,3,3
2176,Kalevesicant,nesingwary,288,deathknight,frost,6,3,3
2177,Doomdk,azralon,288,deathknight,frost,6,3,3
2178,Infadelias,stormrage,288,deathknight,frost,6,3,3
2179,Malthis,antonidas,288,deathknight,frost,6,3,3
2180,Yungdooks,area-52,288,deathknight,frost,6,3,3
2181,Fearfull,hyjal,288,deathknight,frost,10,4,6
2182,Dkpeter,quelthalas,288,deathknight,frost,12,3,9
2183,Deathscyythe,illidan,288,deathknight,frost,12,3,9
2184,Flarkness,area-52,288,deathknight,frost,12,3,9
2185,Nenó,illidan,288,deathknight,frost,12,3,9
2186,Janus,illidan,288,deathknight,frost,12,3,9
2187,Toxicant,zuljin,288,deathknight,frost,12,3,9
2188,Freyjani,moon-guard,288,deathknight,frost,12,3,9
2189,Biukanon,ragnaros,288,deathknight,frost,12,3,9
2190,Paíín,illidan,288,deathknight,frost,12,3,9
2191,Bloodmourne,barthilas,288,deathknight,frost,12,3,9
2192,Kendøll,sargeras,288,deathknight,frost,12,3,9
2193,Moyjô,aggramar,288,deathknight,frost,15,3,12
2194,Kalahari,perenolde,288,deathknight,frost,18,3,15
2195,Thebigknight,deathwing,287,deathknight,frost,6,3,3
2196,Letum,lightbringer,287,deathknight,frost,6,3,3
2197,Sinfulvoid,darkspear,287,deathknight,frost,6,3,3
2198,Páthøgen,ravencrest,287,deathknight,frost,12,3,9
2199,Dragoroth,zuluhed,286,deathknight,frost,6,3,3
2200,Gnomey,area-52,255,deathknight,frost,8,4,4
2201,Crukashongal,zuljin,240,deathknight,frost,9,4,5
2202,Icycrazy,azralon,239,deathknight,frost,5,3,2
2203,Hamze,stormrage,239,deathknight,frost,5,3,2
2204,Unwantedgrab,sargeras,239,deathknight,frost,5,3,2
2205,Rakutengirls,tichondrius,239,deathknight,frost,5,3,2
2206,Onìì,aegwynn,234,deathknight,frost,10,5,5
2207,Bbcobliterat,proudmoore,234,deathknight,frost,22,4,18
2208,Dkswaag,malganis,192,deathknight,frost,6,2,4
2209,Lichkong,dalaran,192,deathknight,frost,6,2,4
2210,Ndz,quelthalas,192,deathknight,frost,6,2,4
2211,Dahaaka,malganis,192,deathknight,frost,6,2,4
2212,Arthureon,kelthuzad,192,deathknight,frost,6,2,4
2213,Khørne,area-52,192,deathknight,frost,6,2,4
2214,Deadlyforce,sargeras,192,deathknight,frost,6,2,4
2215,Sayga,ragnaros,192,deathknight,frost,6,2,4
2216,Hiverssalt,stormrage,192,deathknight,frost,6,2,4
2217,Unholyreap,arthas,192,deathknight,frost,6,2,4
2218,Froxe,sargeras,192,deathknight,frost,6,2,4
2219,Chrønnøz,nemesis,192,deathknight,frost,6,2,4
2220,Oldskul,sargeras,192,deathknight,frost,6,2,4
2221,Envisage,kelthuzad,192,deathknight,frost,6,2,4
2222,Alderollar,stormrage,192,deathknight,frost,6,2,4
2223,Deathbringèr,tichondrius,192,deathknight,frost,6,2,4
2224,Lazynome,azshara,192,deathknight,frost,6,2,4
2225,Azibar,moon-guard,192,deathknight,frost,6,2,4
2226,Frozenjuice,sargeras,192,deathknight,frost,6,2,4
2227,Demise,stormrage,192,deathknight,frost,6,2,4
2228,Crakdos,illidan,192,deathknight,frost,6,2,4
2229,Inarius,caelestrasz,192,deathknight,frost,6,2,4
2230,Nethaar,tichondrius,192,deathknight,frost,6,2,4
2231,Rotfang,elune,192,deathknight,frost,6,2,4
2232,Noik,azralon,192,deathknight,frost,6,2,4
2233,Dego,tichondrius,192,deathknight,frost,6,2,4
2234,Martufe,sargeras,192,deathknight,frost,6,2,4
2235,Rulord,wyrmrest-accord,192,deathknight,frost,6,2,4
2236,Oreodeath,sargeras,192,deathknight,frost,6,2,4
2237,Yourunigrip,tichondrius,192,deathknight,frost,6,2,4
2238,Fraýja,tichondrius,192,deathknight,frost,6,2,4
2239,Edek,frostmourne,192,deathknight,frost,6,2,4
2240,Hunwild,emerald-dream,192,deathknight,frost,6,2,4
2241,Nebuchadnezz,darkspear,192,deathknight,frost,6,2,4
2242,Hadeon,boulderfist,192,deathknight,frost,6,2,4
2243,Kreyun,bleeding-hollow,192,deathknight,frost,6,2,4
2244,Zëb,sargeras,192,deathknight,frost,6,2,4
2245,Superlast,blackrock,192,deathknight,frost,6,2,4
2246,Pofokut,bleeding-hollow,192,deathknight,frost,6,2,4
2247,Soutennizase,azralon,192,deathknight,frost,6,2,4
2248,Bonusman,sargeras,192,deathknight,frost,6,2,4
2249,Sayâ,frostmane,192,deathknight,frost,6,2,4
2250,Serberiss,barthilas,192,deathknight,frost,12,2,10
2251,Kóssak,black-dragonflight,192,deathknight,frost,12,2,10
2252,Appledog,ragnaros,192,deathknight,frost,12,2,10
2253,Melyrc,quelthalas,192,deathknight,frost,12,2,10
2254,Shadar,muradin,192,deathknight,frost,12,2,10
2255,Lillylilly,bleeding-hollow,192,deathknight,frost,12,2,10
2256,Selasia,malygos,192,deathknight,frost,12,2,10
2257,Záiiko,quelthalas,192,deathknight,frost,12,2,10
2258,Evangelina,antonidas,192,deathknight,frost,12,2,10
2259,Xepherto,ragnaros,191,deathknight,frost,6,2,4
2260,Deathmike,bonechewer,191,deathknight,frost,6,2,4
2261,Edhral,ragnaros,191,deathknight,frost,6,2,4
2262,Sübzerö,quelthalas,191,deathknight,frost,6,2,4
2263,Ulyssess,jubeithos,191,deathknight,frost,6,2,4
2264,Akmy,illidan,175,deathknight,frost,11,2,9
2265,Nickolas,dalvengyr,159,deathknight,frost,5,2,3
2266,Ryudeus,lothar,159,deathknight,frost,11,2,9
2267,Telrenaur,proudmoore,96,deathknight,frost,3,2,1
2268,Littlenisman,ragnaros,96,deathknight,frost,6,1,5
2269,Icejagan,stormrage,96,deathknight,frost,6,1,5
2270,Grimmosh,daggerspine,96,deathknight,frost,6,1,5
2271,Lücìfër,illidan,96,deathknight,frost,6,1,5
2272,Ophin,silver-hand,96,deathknight,frost,6,1,5
2273,Siphilusxo,dalaran,96,deathknight,frost,6,1,5
2274,Puppykiss,perenolde,96,deathknight,frost,6,1,5
2275,Kakaih,azralon,96,deathknight,frost,6,1,5
2276,Frostpanda,dalaran,96,deathknight,frost,6,1,5
2277,Druath,proudmoore,96,deathknight,frost,6,1,5
2278,Mako,garithos,96,deathknight,frost,6,1,5
2279,Kireek,stormrage,96,deathknight,frost,6,1,5
2280,Heboriç,stormrage,96,deathknight,frost,6,1,5
2281,Inertìa,malganis,96,deathknight,frost,6,1,5
2282,Ricedisease,emerald-dream,96,deathknight,frost,6,1,5
2283,Denkot,stormrage,96,deathknight,frost,6,1,5
2284,Necrotic,greymane,96,deathknight,frost,6,1,5
2285,Hadianton,stormrage,96,deathknight,frost,6,1,5
2286,Grimorra,bleeding-hollow,96,deathknight,frost,6,1,5
2287,Krargosh,quelthalas,96,deathknight,frost,6,1,5
2288,Gooré,ragnaros,96,deathknight,frost,6,1,5
2289,Varraeda,stonemaul,96,deathknight,frost,6,1,5
2290,Teksurugi,korgath,96,deathknight,frost,6,1,5
2291,Vrolock,quelthalas,96,deathknight,frost,6,1,5
2292,Grayfoxx,twisting-nether,96,deathknight,frost,6,1,5
2293,Guffles,tichondrius,96,deathknight,frost,6,1,5
2294,Xakri,kelthuzad,96,deathknight,frost,6,1,5
2295,Cellebrok,bleeding-hollow,96,deathknight,frost,6,1,5
2296,Bingoez,frostmourne,96,deathknight,frost,6,1,5
2297,Icecreamlife,chogall,96,deathknight,frost,6,1,5
2298,Koltíra,azralon,96,deathknight,frost,6,1,5
2299,Bubblesdk,whisperwind,96,deathknight,frost,6,1,5
2300,Davyjonescx,moon-guard,96,deathknight,frost,6,1,5
2301,Dotted,tichondrius,96,deathknight,frost,6,1,5
2302,Einherjiar,tichondrius,96,deathknight,frost,6,1,5
2303,Owenjak,moon-guard,96,deathknight,frost,6,1,5
2304,Mephostophel,sargeras,96,deathknight,frost,6,1,5
2305,Cruzx,tichondrius,96,deathknight,frost,6,1,5
2306,Ann,spirestone,96,deathknight,frost,6,1,5
2307,Sindragosa,dragonmaw,96,deathknight,frost,6,1,5
2308,Skadattle,emerald-dream,96,deathknight,frost,12,1,11
2309,Xninjakiller,korgath,95,deathknight,frost,12,1,11
2310,Magipierrot,ragnaros,64,deathknight,frost,4,1,3
2311,Agasuko,ghostlands,48,deathknight,frost,3,1,2
2312,Frøstbeard,hyjal,42,deathknight,frost,9,2,7
2313,Twindleroot,aggramar,31,deathknight,frost,2,1,1
2314,Philyaliora,moon-guard,31,deathknight,frost,2,1,1
2315,Schwaffles,stormrage,31,deathknight,frost,2,1,1
2316,Sharnathos,stormrage,16,deathknight,frost,1,1,0
2317,Jerric,skullcrusher,16,deathknight,frost,7,1,6
2318,Xiaosu,tichondrius,2270,demonhunter,havoc,710,356,354
2319,Mvqdh,illidan,2212,demonhunter,havoc,77,46,31
2320,Demoncouch,malganis,2191,demonhunter,havoc,102,54,48
2321,Ehtend,malganis,2136,demonhunter,havoc,354,177,177
2322,Seorae,tichondrius,2126,demonhunter,havoc,84,45,39
2323,Lighost,tichondrius,2117,demonhunter,havoc,382,192,190
2324,Sadgirlx,area-52,2114,demonhunter,havoc,96,48,48
2325,Zetara,malganis,2112,demonhunter,havoc,137,78,59
2326,Ehtend,sargeras,2106,demonhunter,havoc,78,42,36
2327,Yaboiswift,stormrage,2104,demonhunter,havoc,60,34,26
2328,Insomniaq,sargeras,2102,demonhunter,havoc,115,62,53
2329,Kohî,sargeras,2102,demonhunter,havoc,79,39,40
2330,Tendiës,tichondrius,2086,demonhunter,havoc,104,50,54
2331,Dhcn,tichondrius,2073,demonhunter,havoc,64,35,29
2332,Brbpetmycat,zuljin,2058,demonhunter,havoc,88,44,44
2333,Fellhamer,malganis,2054,demonhunter,havoc,123,69,54
2334,Nézuko,eldrethalas,2045,demonhunter,havoc,129,68,61
2335,Medrathis,wyrmrest-accord,2042,demonhunter,havoc,60,34,26
2336,Nasadh,tichondrius,2035,demonhunter,havoc,96,54,42
2337,Badhábits,sargeras,2032,demonhunter,havoc,78,45,33
2338,Calpoot,stormscale,2028,demonhunter,havoc,89,48,41
2339,Glaivezx,stormreaver,2014,demonhunter,havoc,90,46,44
2340,Reps,hydraxis,2011,demonhunter,havoc,126,70,56
2341,Cyrøcryphä,quelthalas,2009,demonhunter,havoc,167,83,84
2342,ßöb,aggramar,2004,demonhunter,havoc,102,55,47
2343,Ordorll,area-52,1998,demonhunter,havoc,114,59,55
2344,Lademon,tichondrius,1997,demonhunter,havoc,84,46,38
2345,Xtickles,frostmourne,1992,demonhunter,havoc,154,79,75
2346,Ìke,quelthalas,1979,demonhunter,havoc,121,64,57
2347,Bløødyrøse,illidan,1978,demonhunter,havoc,66,40,26
2348,Taegos,tichondrius,1970,demonhunter,havoc,617,301,316
2349,Sleepyjoeb,illidan,1967,demonhunter,havoc,74,43,31
2350,Bippy,durotan,1964,demonhunter,havoc,149,78,71
2351,Felz,illidan,1964,demonhunter,havoc,95,48,47
2352,Lifting,illidan,1960,demonhunter,havoc,84,40,44
2353,Xxann,tichondrius,1955,demonhunter,havoc,61,30,31
2354,Tømåtøgøðx,sargeras,1953,demonhunter,havoc,180,95,85
2355,Frostchaos,ragnaros,1944,demonhunter,havoc,48,28,20
2356,Sypï,malganis,1944,demonhunter,havoc,84,45,39
2357,Bigbadmad,stormrage,1944,demonhunter,havoc,239,124,115
2358,Boonchu,frostmourne,1935,demonhunter,havoc,86,45,41
2359,Jøsem,ragnaros,1930,demonhunter,havoc,94,48,46
2360,Mamazboy,area-52,1921,demonhunter,havoc,46,25,21
2361,Blasphemus,illidan,1908,demonhunter,havoc,63,34,29
2362,Cromega,malganis,1906,demonhunter,havoc,108,50,58
2363,Oddblindguy,area-52,1903,demonhunter,havoc,42,30,12
2364,Lemilion,wyrmrest-accord,1903,demonhunter,havoc,53,27,26
2365,Maverzz,area-52,1902,demonhunter,havoc,65,35,30
2366,Solit,illidan,1901,demonhunter,havoc,66,33,33
2367,Askvivian,sargeras,1900,demonhunter,havoc,127,76,51
2368,Zoenin,illidan,1900,demonhunter,havoc,144,73,71
2369,Mèw,bleeding-hollow,1899,demonhunter,havoc,78,43,35
2370,Terrorsong,tichondrius,1898,demonhunter,havoc,83,48,35
2371,Boos,moon-guard,1893,demonhunter,havoc,172,84,88
2372,Anihilum,zuljin,1891,demonhunter,havoc,99,64,35
2373,Cerebro,stormrage,1890,demonhunter,havoc,54,31,23
2374,Dangerspud,frostmourne,1885,demonhunter,havoc,102,48,54
2375,Felluser,sargeras,1882,demonhunter,havoc,53,32,21
2376,Stellitas,ragnaros,1881,demonhunter,havoc,72,38,34
2377,Xch,aegwynn,1881,demonhunter,havoc,166,87,79
2378,Dayvenie,area-52,1879,demonhunter,havoc,125,70,55
2379,Rosinanta,malygos,1878,demonhunter,havoc,110,60,50
2380,Junma,tichondrius,1874,demonhunter,havoc,84,47,37
2381,Busting,tichondrius,1872,demonhunter,havoc,48,24,24
2382,Mvqqdh,tichondrius,1872,demonhunter,havoc,42,20,22
2383,Blode,tichondrius,1870,demonhunter,havoc,231,120,111
2384,Nåxah,bleeding-hollow,1869,demonhunter,havoc,78,38,40
2385,Amorielel,tichondrius,1867,demonhunter,havoc,50,23,27
2386,Asdazanis,nemesis,1865,demonhunter,havoc,92,47,45
2387,Doejah,stormrage,1865,demonhunter,havoc,80,40,40
2388,Airmax,tichondrius,1864,demonhunter,havoc,84,44,40
2389,Leothero,area-52,1863,demonhunter,havoc,54,28,26
2390,Hatréd,quelthalas,1859,demonhunter,havoc,54,29,25
2391,Lamorty,tichondrius,1859,demonhunter,havoc,150,73,77
2392,Rlycoolclass,zuljin,1858,demonhunter,havoc,65,30,35
2393,Dwilk,sargeras,1856,demonhunter,havoc,154,73,81
2394,Azrethec,wyrmrest-accord,1855,demonhunter,havoc,108,62,46
2395,Loadingdh,tichondrius,1854,demonhunter,havoc,47,20,27
2396,Nb,silvermoon,1853,demonhunter,havoc,59,32,27
2397,Ystkz,tichondrius,1852,demonhunter,havoc,213,110,103
2398,Promitto,tichondrius,1851,demonhunter,havoc,101,49,52
2399,Mizaru,moon-guard,1849,demonhunter,havoc,35,24,11
2400,Flykzuwu,azralon,1848,demonhunter,havoc,89,53,36
2401,Daía,ragnaros,1846,demonhunter,havoc,59,31,28
2402,Joshallen,malganis,1846,demonhunter,havoc,141,73,68
2403,Wowcoldcold,barthilas,1845,demonhunter,havoc,59,30,29
2404,Griphunt,tichondrius,1840,demonhunter,havoc,222,115,107
2405,Sacredtree,tichondrius,1839,demonhunter,havoc,116,65,51
2406,Tiristra,cenarion-circle,1839,demonhunter,havoc,65,35,30
2407,Ouru,area-52,1839,demonhunter,havoc,108,52,56
2408,Ökìtycoón,proudmoore,1833,demonhunter,havoc,78,45,33
2409,Bllackclover,zuljin,1831,demonhunter,havoc,59,34,25
2410,Akurawrath,area-52,1830,demonhunter,havoc,120,84,36
2411,Raiinier,sargeras,1830,demonhunter,havoc,78,48,30
2412,Hasbeen,tichondrius,1830,demonhunter,havoc,39,23,16
2413,Divide,tichondrius,1830,demonhunter,havoc,106,58,48
2414,Soliit,illidan,1830,demonhunter,havoc,60,30,30
2415,Pythongodx,azralon,1829,demonhunter,havoc,96,54,42
2416,Brackmagik,barthilas,1828,demonhunter,havoc,36,27,9
2417,Takagi,kirin-tor,1828,demonhunter,havoc,221,120,101
2418,Càrnagex,tichondrius,1826,demonhunter,havoc,309,153,156
2419,Devotio,emerald-dream,1825,demonhunter,havoc,102,60,42
2420,Migey,thrall,1825,demonhunter,havoc,112,65,47
2421,Vanarion,area-52,1825,demonhunter,havoc,84,36,48
2422,Beerdash,area-52,1825,demonhunter,havoc,66,28,38
2423,Chulakels,tichondrius,1824,demonhunter,havoc,75,45,30
2424,Ninetalesx,sargeras,1823,demonhunter,havoc,81,48,33
2425,Darkrai,area-52,1823,demonhunter,havoc,132,73,59
2426,Nolabb,tichondrius,1822,demonhunter,havoc,128,72,56
2427,Írís,blackrock,1820,demonhunter,havoc,124,75,49
2428,Karonisam,dalaran,1820,demonhunter,havoc,61,32,29
2429,Dannyolo,hyjal,1820,demonhunter,havoc,78,32,46
2430,Mvpdh,area-52,1819,demonhunter,havoc,242,121,121
2431,Failtimeboat,terenas,1817,demonhunter,havoc,60,34,26
2432,Drachyn,darkspear,1817,demonhunter,havoc,71,34,37
2433,Garbage,illidan,1816,demonhunter,havoc,84,44,40
2434,Helenquinn,kelthuzad,1815,demonhunter,havoc,72,46,26
2435,Mirriana,thunderlord,1815,demonhunter,havoc,98,52,46
2436,Brotherz,tichondrius,1815,demonhunter,havoc,113,56,57
2437,Skyez,moon-guard,1814,demonhunter,havoc,115,54,61
2438,Nadlli,bleeding-hollow,1813,demonhunter,havoc,223,116,107
2439,Kázeshini,frostmourne,1813,demonhunter,havoc,143,71,72
2440,Rufio,nesingwary,1813,demonhunter,havoc,54,25,29
2441,Coa,nazjatar,1812,demonhunter,havoc,100,54,46
2442,Eldiablaso,malganis,1812,demonhunter,havoc,36,19,17
2443,Lucifèr,uther,1812,demonhunter,havoc,59,28,31
2444,Ferano,frostmourne,1811,demonhunter,havoc,211,109,102
2445,Vowz,sargeras,1811,demonhunter,havoc,66,34,32
2446,Tyskeram,bleeding-hollow,1810,demonhunter,havoc,81,47,34
2447,Syrio,frostmourne,1809,demonhunter,havoc,236,129,107
2448,Felswamp,zuljin,1809,demonhunter,havoc,126,65,61
2449,Dãnishroll,illidan,1809,demonhunter,havoc,108,54,54
2450,Bitcoingodx,tichondrius,1808,demonhunter,havoc,120,68,52
2451,Feldarath,sargeras,1807,demonhunter,havoc,133,76,57
2452,Fenomeno,tichondrius,1807,demonhunter,havoc,58,32,26
2453,Fruitbatx,tichondrius,1807,demonhunter,havoc,138,68,70
2454,Xcf,area-52,1807,demonhunter,havoc,48,22,26
2455,Landorus,barthilas,1806,demonhunter,havoc,155,83,72
2456,Raenorion,kelthuzad,1805,demonhunter,havoc,54,33,21
2457,Dewkee,ghostlands,1805,demonhunter,havoc,42,24,18
2458,Niuzimeile,illidan,1805,demonhunter,havoc,77,33,44
2459,Smqkepvrpp,zuljin,1804,demonhunter,havoc,64,41,23
2460,Fellenkellar,stormrage,1804,demonhunter,havoc,144,80,64
2461,Shadë,stormrage,1802,demonhunter,havoc,60,31,29
2462,Winsforgold,area-52,1801,demonhunter,havoc,86,47,39
2463,Dhkyun,tichondrius,1801,demonhunter,havoc,54,29,25
2464,Wompo,wyrmrest-accord,1801,demonhunter,havoc,36,19,17
2465,Plumkin,kiljaeden,1800,demonhunter,havoc,54,32,22
2466,Icecokelime,black-dragonflight,1800,demonhunter,havoc,38,20,18
2467,Deathbladezx,tichondrius,1800,demonhunter,havoc,47,23,24
2468,Tendies,tichondrius,1800,demonhunter,havoc,60,28,32
2469,Juiced,thunderhorn,1799,demonhunter,havoc,95,50,45
2470,Donaldjr,area-52,1798,demonhunter,havoc,69,42,27
2471,Potspoon,tichondrius,1798,demonhunter,havoc,162,82,80
2472,Basedmf,emerald-dream,1797,demonhunter,havoc,65,30,35
2473,Chainsawz,zuljin,1796,demonhunter,havoc,80,35,45
2474,Hogmandh,illidan,1794,demonhunter,havoc,54,27,27
2475,Dawgzo,thunderhorn,1793,demonhunter,havoc,126,71,55
2476,Andthrx,area-52,1791,demonhunter,havoc,260,130,130
2477,Nuktukdh,moon-guard,1791,demonhunter,havoc,68,30,38
2478,Nips,lightnings-blade,1790,demonhunter,havoc,66,43,23
2479,Erasér,area-52,1786,demonhunter,havoc,48,26,22
2480,Thundiir,area-52,1786,demonhunter,havoc,113,58,55
2481,Madepp,tichondrius,1782,demonhunter,havoc,54,27,27
2482,Dewk,ghostlands,1781,demonhunter,havoc,63,30,33
2483,Aryapudding,tichondrius,1779,demonhunter,havoc,58,28,30
2484,Deathsweep,tichondrius,1773,demonhunter,havoc,54,29,25
2485,Demonsob,illidan,1772,demonhunter,havoc,59,22,37
2486,Xøtourlife,malganis,1771,demonhunter,havoc,64,33,31
2487,Nephxz,tichondrius,1771,demonhunter,havoc,54,26,28
2488,Mevadow,bleeding-hollow,1768,demonhunter,havoc,126,57,69
2489,Hueylucifer,ravencrest,1768,demonhunter,havoc,43,19,24
2490,Bbteaa,frostmourne,1765,demonhunter,havoc,206,107,99
2491,Zatharas,stormrage,1764,demonhunter,havoc,122,61,61
2492,Beyondjerky,malganis,1763,demonhunter,havoc,40,23,17
2493,Soyboycuck,emerald-dream,1760,demonhunter,havoc,42,21,21
2494,Sucio,khaz-modan,1760,demonhunter,havoc,54,26,28
2495,Tylersdh,illidan,1758,demonhunter,havoc,151,87,64
2496,Ahsref,stormrage,1757,demonhunter,havoc,60,30,30
2497,Ubetterun,azralon,1755,demonhunter,havoc,219,113,106
2498,Antamoris,sargeras,1753,demonhunter,havoc,64,32,32
2499,Saaldh,zuljin,1753,demonhunter,havoc,65,27,38
2500,Purplekuush,bleeding-hollow,1752,demonhunter,havoc,84,44,40
2501,Dhwhat,stormrage,1750,demonhunter,havoc,125,70,55
2502,Gubydal,frostmourne,1750,demonhunter,havoc,53,29,24
2503,Remh,bleeding-hollow,1749,demonhunter,havoc,272,140,132
2504,Immortalsinz,dalaran,1747,demonhunter,havoc,112,48,64
2505,Noobstaa,area-52,1745,demonhunter,havoc,48,34,14
2506,Decoherence,sargeras,1745,demonhunter,havoc,54,33,21
2507,Ðavid,firetree,1745,demonhunter,havoc,96,48,48
2508,Oshinoko,area-52,1742,demonhunter,havoc,63,34,29
2509,Lazydeamon,frostmourne,1740,demonhunter,havoc,60,26,34
2510,Tundies,tichondrius,1738,demonhunter,havoc,48,25,23
2511,Monfel,dalaran,1737,demonhunter,havoc,108,63,45
2512,Furious,tichondrius,1737,demonhunter,havoc,48,23,25
2513,Tichóndrius,tichondrius,1735,demonhunter,havoc,173,95,78
2514,Hoochee,lightnings-blade,1735,demonhunter,havoc,73,39,34
2515,Baka,grizzly-hills,1735,demonhunter,havoc,48,22,26
2516,Firstsol,stormrage,1734,demonhunter,havoc,60,36,24
2517,Wherwelandin,zuljin,1734,demonhunter,havoc,51,24,27
2518,Xylëm,tichondrius,1734,demonhunter,havoc,60,25,35
2519,Axalark,nemesis,1733,demonhunter,havoc,54,26,28
2520,Cromosh,quelthalas,1733,demonhunter,havoc,90,38,52
2521,Raahjxz,sargeras,1730,demonhunter,havoc,108,61,47
2522,Felnipz,tichondrius,1729,demonhunter,havoc,67,39,28
2523,Lilise,kiljaeden,1728,demonhunter,havoc,102,50,52
2524,Azexion,malganis,1727,demonhunter,havoc,114,59,55
2525,Okuzén,tichondrius,1723,demonhunter,havoc,29,21,8
2526,Diequickly,tichondrius,1722,demonhunter,havoc,58,29,29
2527,Croches,tichondrius,1721,demonhunter,havoc,36,18,18
2528,Ðrogö,emerald-dream,1719,demonhunter,havoc,42,24,18
2529,Fardyhole,illidan,1719,demonhunter,havoc,36,18,18
2530,Sikarnix,stormrage,1719,demonhunter,havoc,84,38,46
2531,Zcarfacee,frostmourne,1715,demonhunter,havoc,32,18,14
2532,Ibdl,tichondrius,1714,demonhunter,havoc,30,18,12
2533,Irisand,ragnaros,1714,demonhunter,havoc,83,40,43
2534,Doeja,illidan,1713,demonhunter,havoc,30,18,12
2535,Thehonor,tichondrius,1713,demonhunter,havoc,65,36,29
2536,Obsidians,korgath,1709,demonhunter,havoc,89,51,38
2537,Hundredeye,malganis,1709,demonhunter,havoc,64,31,33
2538,Aetheris,bleeding-hollow,1709,demonhunter,havoc,78,34,44
2539,Pokemibut,frostmourne,1708,demonhunter,havoc,36,18,18
2540,Tenthslayer,frostmourne,1707,demonhunter,havoc,48,28,20
2541,Harríson,tichondrius,1707,demonhunter,havoc,108,52,56
2542,Scylus,tichondrius,1706,demonhunter,havoc,102,59,43
2543,Sheldoncoop,emerald-dream,1706,demonhunter,havoc,36,18,18
2544,Asheng,cairne,1706,demonhunter,havoc,63,30,33
2545,Rôsè,tichondrius,1704,demonhunter,havoc,88,49,39
2546,Dêspacito,tichondrius,1704,demonhunter,havoc,42,18,24
2547,Xeylin,sargeras,1703,demonhunter,havoc,54,34,20
2548,Gamernation,area-52,1703,demonhunter,havoc,57,29,28
2549,Isev,illidan,1702,demonhunter,havoc,30,18,12
2550,Wildh,stormrage,1702,demonhunter,havoc,78,41,37
2551,Felgobbler,zuljin,1701,demonhunter,havoc,72,38,34
2552,Ethhunter,proudmoore,1700,demonhunter,havoc,78,39,39
2553,Nopohunter,burning-blade,1699,demonhunter,havoc,47,31,16
2554,Dyllen,tichondrius,1698,demonhunter,havoc,194,104,90
2555,Vendeem,moonrunner,1697,demonhunter,havoc,104,56,48
2556,Johnconnor,tichondrius,1696,demonhunter,havoc,53,20,33
2557,Chiesa,sargeras,1695,demonhunter,havoc,34,27,7
2558,Busta,dethecus,1693,demonhunter,havoc,65,28,37
2559,Munyanyô,moon-guard,1691,demonhunter,havoc,41,26,15
2560,Tubaki,tichondrius,1691,demonhunter,havoc,35,19,16
2561,Speedh,area-52,1691,demonhunter,havoc,36,18,18
2562,Deaforalive,malganis,1690,demonhunter,havoc,96,54,42
2563,Cöcainë,stormrage,1689,demonhunter,havoc,36,24,12
2564,Idontfaced,area-52,1689,demonhunter,havoc,52,32,20
2565,Souliz,tichondrius,1689,demonhunter,havoc,66,37,29
2566,Sarÿnrae,malganis,1687,demonhunter,havoc,48,29,19
2567,Kìed,kiljaeden,1687,demonhunter,havoc,48,24,24
2568,Glaivediggar,barthilas,1686,demonhunter,havoc,178,86,92
2569,Boatsnhoze,tichondrius,1686,demonhunter,havoc,50,21,29
2570,Ídunno,kiljaeden,1685,demonhunter,havoc,54,26,28
2571,Crittic,thrall,1685,demonhunter,havoc,102,44,58
2572,Wickbeams,barthilas,1684,demonhunter,havoc,59,28,31
2573,Blúr,tichondrius,1683,demonhunter,havoc,41,23,18
2574,Praxx,veknilash,1682,demonhunter,havoc,48,23,25
2575,Ihuntmufasa,tichondrius,1679,demonhunter,havoc,48,28,20
2576,Demabrak,azralon,1677,demonhunter,havoc,53,25,28
2577,Icrazedcruxl,gnomeregan,1676,demonhunter,havoc,54,27,27
2578,Namaga,illidan,1675,demonhunter,havoc,60,41,19
2579,Buddyyguy,illidan,1675,demonhunter,havoc,102,45,57
2580,Folkmagic,proudmoore,1673,demonhunter,havoc,30,18,12
2581,Yaety,tichondrius,1671,demonhunter,havoc,58,36,22
2582,Dingowango,illidan,1671,demonhunter,havoc,66,33,33
2583,Jcosta,tichondrius,1670,demonhunter,havoc,97,45,52
2584,Mamadorx,azralon,1668,demonhunter,havoc,29,18,11
2585,Bloodhunter,exodar,1668,demonhunter,havoc,92,53,39
2586,Imaginedmg,illidan,1668,demonhunter,havoc,60,28,32
2587,Gamgeum,tichondrius,1667,demonhunter,havoc,36,23,13
2588,Hisso,nordrassil,1666,demonhunter,havoc,54,31,23
2589,Vynthar,wyrmrest-accord,1666,demonhunter,havoc,183,92,91
2590,Ravana,khaz-modan,1664,demonhunter,havoc,112,60,52
2591,Taylordem,tichondrius,1662,demonhunter,havoc,42,23,19
2592,Xanthalos,wyrmrest-accord,1661,demonhunter,havoc,161,78,83
2593,Boagz,area-52,1660,demonhunter,havoc,84,48,36
2594,Allidox,tichondrius,1660,demonhunter,havoc,54,26,28
2595,Kioka,khaz-modan,1659,demonhunter,havoc,34,20,14
2596,Churchpls,stormrage,1659,demonhunter,havoc,58,23,35
2597,Dragonÿx,ragnaros,1658,demonhunter,havoc,157,83,74
2598,Gtåte,azjolnerub,1658,demonhunter,havoc,66,23,43
2599,Achemedåche,dalaran,1657,demonhunter,havoc,33,22,11
2600,Joric,dalaran,1657,demonhunter,havoc,66,40,26
2601,Ilìdarì,zuljin,1657,demonhunter,havoc,33,20,13
2602,Deathlex,sargeras,1656,demonhunter,havoc,78,40,38
2603,Torments,area-52,1655,demonhunter,havoc,60,34,26
2604,Icantseelol,sargeras,1655,demonhunter,havoc,78,41,37
2605,Çhan,tichondrius,1655,demonhunter,havoc,281,142,139
2606,Getpoodon,sargeras,1655,demonhunter,havoc,36,18,18
2607,Evaxaxx,tichondrius,1655,demonhunter,havoc,54,22,32
2608,Sáìto,arthas,1654,demonhunter,havoc,30,19,11
2609,Zikzlol,tichondrius,1654,demonhunter,havoc,44,21,23
2610,Whysoospicy,wyrmrest-accord,1653,demonhunter,havoc,48,29,19
2611,Baikudyn,darkspear,1651,demonhunter,havoc,30,19,11
2612,Billmcawsom,proudmoore,1651,demonhunter,havoc,66,33,33
2613,Ðaredevil,azralon,1650,demonhunter,havoc,36,22,14
2614,Giselah,malganis,1650,demonhunter,havoc,48,22,26
2615,Chîsäki,quelthalas,1649,demonhunter,havoc,75,40,35
2616,Shadöw,emerald-dream,1649,demonhunter,havoc,45,22,23
2617,Demonfused,illidan,1647,demonhunter,havoc,61,34,27
2618,Vapegodxqt,aegwynn,1647,demonhunter,havoc,50,25,25
2619,Skyfly,stormscale,1647,demonhunter,havoc,66,31,35
2620,Shyisback,area-52,1645,demonhunter,havoc,138,77,61
2621,Balancedtoon,tichondrius,1645,demonhunter,havoc,66,36,30
2622,Ironsightsdh,dalaran,1645,demonhunter,havoc,89,47,42
2623,Sarynrae,malganis,1644,demonhunter,havoc,52,24,28
2624,Valerrias,area-52,1643,demonhunter,havoc,42,21,21
2625,Entropics,tichondrius,1642,demonhunter,havoc,41,29,12
2626,Junmà,tichondrius,1642,demonhunter,havoc,72,42,30
2627,Alast,emerald-dream,1642,demonhunter,havoc,54,28,26
2628,Rune,dathremar,1642,demonhunter,havoc,48,23,25
2629,Flyudzhin,azgalor,1642,demonhunter,havoc,143,68,75
2630,Biognosis,ragnaros,1642,demonhunter,havoc,102,46,56
2631,Malthazaan,stormrage,1641,demonhunter,havoc,38,22,16
2632,Demoncastx,tichondrius,1641,demonhunter,havoc,95,54,41
2633,Jpdh,frostmourne,1641,demonhunter,havoc,80,44,36
2634,Jelleh,frostmourne,1640,demonhunter,havoc,35,21,14
2635,Demonhunter,kirin-tor,1639,demonhunter,havoc,102,53,49
2636,Snózberry,illidan,1639,demonhunter,havoc,81,37,44
2637,Xenore,emerald-dream,1638,demonhunter,havoc,71,31,40
2638,Viio,proudmoore,1637,demonhunter,havoc,36,21,15
2639,Flirtyscythe,illidan,1637,demonhunter,havoc,58,28,30
2640,Randomdh,zuljin,1636,demonhunter,havoc,43,23,20
2641,Jaauk,ragnaros,1636,demonhunter,havoc,58,25,33
2642,Mewmewkitty,tichondrius,1635,demonhunter,havoc,34,18,16
2643,Blurblurblur,frostmourne,1635,demonhunter,havoc,60,25,35
2644,Synthwäve,area-52,1634,demonhunter,havoc,36,23,13
2645,Killuaqt,frostmourne,1633,demonhunter,havoc,53,28,25
2646,Hròðvitnir,quelthalas,1632,demonhunter,havoc,86,53,33
2647,Bremdh,thrall,1632,demonhunter,havoc,44,25,19
2648,Accidcleaves,sargeras,1632,demonhunter,havoc,48,26,22
2649,Seraphïel,khaz-modan,1631,demonhunter,havoc,36,23,13
2650,Cezkia,hyjal,1629,demonhunter,havoc,72,36,36
2651,Iliillii,emerald-dream,1629,demonhunter,havoc,75,31,44
2652,Trilidan,proudmoore,1627,demonhunter,havoc,37,21,16
2653,Stefdh,tichondrius,1627,demonhunter,havoc,51,23,28
2654,Felontis,sargeras,1627,demonhunter,havoc,48,21,27
2655,Thelor,frostmourne,1626,demonhunter,havoc,48,28,20
2656,Xday,tichondrius,1626,demonhunter,havoc,258,132,126
2657,Sicknizzle,area-52,1626,demonhunter,havoc,126,63,63
2658,Bloodgash,tichondrius,1625,demonhunter,havoc,30,17,13
2659,Rekttx,area-52,1625,demonhunter,havoc,64,34,30
2660,Doomtower,tichondrius,1624,demonhunter,havoc,135,70,65
2661,Gymnast,thaurissan,1624,demonhunter,havoc,54,23,31
2662,Calmbefore,tichondrius,1623,demonhunter,havoc,29,22,7
2663,Cuper,tichondrius,1623,demonhunter,havoc,72,41,31
2664,Perspirant,malganis,1623,demonhunter,havoc,41,23,18
2665,Sivà,tichondrius,1622,demonhunter,havoc,69,35,34
2666,Zeroheaven,stormrage,1621,demonhunter,havoc,48,19,29
2667,Hehehaha,wyrmrest-accord,1620,demonhunter,havoc,30,20,10
2668,Amanthx,tichondrius,1620,demonhunter,havoc,54,27,27
2669,Danloesh,silver-hand,1619,demonhunter,havoc,42,22,20
2670,Ktsoulhunter,azralon,1619,demonhunter,havoc,114,58,56
2671,Ohanadh,ragnaros,1618,demonhunter,havoc,48,19,29
2672,Larandaa,sargeras,1617,demonhunter,havoc,72,35,37
2673,Zachfortnite,emerald-dream,1616,demonhunter,havoc,30,19,11
2674,Fingersdh,malganis,1616,demonhunter,havoc,96,45,51
2675,Draenkz,ragnaros,1616,demonhunter,havoc,58,19,39
2676,Glaivia,bleeding-hollow,1615,demonhunter,havoc,36,17,19
2677,Cococat,tichondrius,1615,demonhunter,havoc,80,30,50
2678,Velana,tichondrius,1614,demonhunter,havoc,30,21,9
2679,Ptsdh,bloodhoof,1614,demonhunter,havoc,78,43,35
2680,Gumeasy,tichondrius,1614,demonhunter,havoc,42,19,23
2681,Taszyn,blackrock,1613,demonhunter,havoc,92,51,41
2682,Karmakula,tichondrius,1613,demonhunter,havoc,77,39,38
2683,Neodin,tichondrius,1612,demonhunter,havoc,61,35,26
2684,Anathørn,ragnaros,1612,demonhunter,havoc,42,23,19
2685,Littlewolfie,illidan,1611,demonhunter,havoc,42,23,19
2686,Azinoht,ragnaros,1611,demonhunter,havoc,198,94,104
2687,Ossariss,moon-guard,1610,demonhunter,havoc,30,17,13
2688,Mazakein,tichondrius,1610,demonhunter,havoc,66,37,29
2689,Cots,stormrage,1610,demonhunter,havoc,148,82,66
2690,Bitskii,kelthuzad,1610,demonhunter,havoc,47,21,26
2691,Sadpepe,bleeding-hollow,1610,demonhunter,havoc,48,21,27
2692,Nistrin,area-52,1609,demonhunter,havoc,72,40,32
2693,Diablitaa,sargeras,1609,demonhunter,havoc,36,17,19
2694,Crixxus,zuljin,1609,demonhunter,havoc,48,20,28
2695,Henry,tichondrius,1608,demonhunter,havoc,165,95,70
2696,Yiptaw,area-52,1608,demonhunter,havoc,55,29,26
2697,Feníxx,ragnaros,1608,demonhunter,havoc,88,45,43
2698,Omygaud,tichondrius,1607,demonhunter,havoc,48,32,16
2699,Beastbringer,proudmoore,1607,demonhunter,havoc,147,86,61
2700,Stellartv,tichondrius,1607,demonhunter,havoc,156,73,83
2701,Turecdh,illidan,1607,demonhunter,havoc,56,19,37
2702,Énchantress,thrall,1606,demonhunter,havoc,42,22,20
2703,Zeane,tichondrius,1605,demonhunter,havoc,51,29,22
2704,Abigëil,quelthalas,1605,demonhunter,havoc,56,31,25
2705,Chäos,proudmoore,1605,demonhunter,havoc,108,48,60
2706,Mavrush,malganis,1604,demonhunter,havoc,54,31,23
2707,Pragma,thrall,1604,demonhunter,havoc,231,124,107
2708,Tychondrius,earthen-ring,1603,demonhunter,havoc,202,107,95
2709,Daymanhunter,bleeding-hollow,1603,demonhunter,havoc,103,53,50
2710,Kaedri,burning-blade,1603,demonhunter,havoc,141,68,73
2711,Sìlençe,illidan,1602,demonhunter,havoc,29,19,10
2712,Shale,gilneas,1602,demonhunter,havoc,70,35,35
2713,Ariodh,area-52,1602,demonhunter,havoc,36,17,19
2714,Gjoat,tichondrius,1600,demonhunter,havoc,42,19,23
2715,Sävage,zuljin,1599,demonhunter,havoc,37,22,15
2716,Gesture,malganis,1599,demonhunter,havoc,166,91,75
2717,Ruffolina,azralon,1599,demonhunter,havoc,187,97,90
2718,Dadoftheyear,destromath,1598,demonhunter,havoc,72,41,31
2719,Coaa,dalaran,1598,demonhunter,havoc,47,23,24
2720,Arête,malganis,1595,demonhunter,havoc,67,31,36
2721,Darkrasta,ragnaros,1594,demonhunter,havoc,102,47,55
2722,Animepfp,shadowsong,1594,demonhunter,havoc,42,19,23
2723,Rennae,zuljin,1593,demonhunter,havoc,41,18,23
2724,Netherbane,azgalor,1592,demonhunter,havoc,96,44,52
2725,Shadowmoonz,frostmourne,1591,demonhunter,havoc,47,23,24
2726,Dhyzz,proudmoore,1590,demonhunter,havoc,43,25,18
2727,Eugenyackle,bleeding-hollow,1589,demonhunter,havoc,54,38,16
2728,Reito,ragnaros,1589,demonhunter,havoc,53,29,24
2729,Nándÿ,tichondrius,1589,demonhunter,havoc,67,36,31
2730,Malefisentt,firetree,1589,demonhunter,havoc,45,22,23
2731,Jk,dreadmaul,1588,demonhunter,havoc,81,45,36
2732,Wsickformula,gilneas,1588,demonhunter,havoc,119,66,53
2733,Mood,stonemaul,1587,demonhunter,havoc,60,36,24
2734,Watsinthebox,thrall,1586,demonhunter,havoc,30,20,10
2735,Progenji,azralon,1585,demonhunter,havoc,36,21,15
2736,Knuckifubuck,frostwolf,1582,demonhunter,havoc,142,77,65
2737,Beniesdh,frostmourne,1581,demonhunter,havoc,36,20,16
2738,Chinadh,tichondrius,1581,demonhunter,havoc,35,17,18
2739,Supadupä,stormrage,1580,demonhunter,havoc,30,17,13
2740,Nuggetx,lightnings-blade,1580,demonhunter,havoc,54,29,25
2741,Kaelclaira,dalvengyr,1580,demonhunter,havoc,60,29,31
2742,Ossivil,ragnaros,1580,demonhunter,havoc,132,62,70
2743,Jaybeezy,balnazzar,1580,demonhunter,havoc,42,18,24
2744,Phaintx,tichondrius,1579,demonhunter,havoc,60,29,31
2745,Yuppx,tichondrius,1578,demonhunter,havoc,48,29,19
2746,Mcspicyy,tichondrius,1578,demonhunter,havoc,42,22,20
2747,Stochastic,ragnaros,1578,demonhunter,havoc,103,52,51
2748,Corngodx,sargeras,1578,demonhunter,havoc,102,50,52
2749,Hoonjojjyana,tichondrius,1578,demonhunter,havoc,46,20,26
2750,Dammitbôbby,tichondrius,1577,demonhunter,havoc,121,66,55
2751,Kssmee,korgath,1576,demonhunter,havoc,90,48,42
2752,Sternhunt,khadgar,1575,demonhunter,havoc,66,33,33
2753,Baalböski,tichondrius,1574,demonhunter,havoc,88,41,47
2754,Brútalgore,area-52,1573,demonhunter,havoc,188,99,89
2755,Sineex,illidan,1572,demonhunter,havoc,36,22,14
2756,Diiecrux,bleeding-hollow,1571,demonhunter,havoc,36,20,16
2757,Scoplyn,malfurion,1571,demonhunter,havoc,66,34,32
2758,Poogzzig,tichondrius,1571,demonhunter,havoc,108,52,56
2759,Fleetop,tichondrius,1570,demonhunter,havoc,66,37,29
2760,Demonfarter,tichondrius,1570,demonhunter,havoc,120,61,59
2761,Pubelice,draenor,1569,demonhunter,havoc,68,38,30
2762,Narandra,malganis,1569,demonhunter,havoc,48,19,29
2763,Kenmu,ragnaros,1566,demonhunter,havoc,74,32,42
2764,Nichousha,tichondrius,1565,demonhunter,havoc,36,19,17
2765,Vândel,kelthuzad,1565,demonhunter,havoc,84,37,47
2766,Theprodigy,malganis,1565,demonhunter,havoc,96,42,54
2767,Sheepone,tichondrius,1564,demonhunter,havoc,24,19,5
2768,Luribel,tichondrius,1564,demonhunter,havoc,42,23,19
2769,Warlasher,zuljin,1563,demonhunter,havoc,234,119,115
2770,Taatted,emerald-dream,1562,demonhunter,havoc,36,18,18
2771,Redkin,moon-guard,1561,demonhunter,havoc,80,45,35
2772,Nomfries,malganis,1560,demonhunter,havoc,52,27,25
2773,Wikkidd,thrall,1560,demonhunter,havoc,47,22,25
2774,Imwhack,frostmane,1559,demonhunter,havoc,73,39,34
2775,Çummins,malganis,1558,demonhunter,havoc,86,53,33
2776,Dankhuntér,zuljin,1558,demonhunter,havoc,54,20,34
2777,Subieshift,sargeras,1557,demonhunter,havoc,39,20,19
2778,Darknezzl,ragnaros,1557,demonhunter,havoc,98,48,50
2779,Nocturnale,ragnaros,1555,demonhunter,havoc,100,49,51
2780,Gorillidan,kelthuzad,1553,demonhunter,havoc,30,18,12
2781,Mustardtigër,bleeding-hollow,1553,demonhunter,havoc,29,17,12
2782,Rytesx,moon-guard,1552,demonhunter,havoc,75,53,22
2783,Kaelthys,nordrassil,1552,demonhunter,havoc,33,21,12
2784,Knshy,azralon,1552,demonhunter,havoc,62,31,31
2785,Devirador,ragnaros,1549,demonhunter,havoc,83,34,49
2786,Dantesabyss,proudmoore,1548,demonhunter,havoc,48,22,26
2787,Kuramou,area-52,1547,demonhunter,havoc,36,22,14
2788,Bromosapien,tichondrius,1547,demonhunter,havoc,36,19,17
2789,Needlepoint,illidan,1547,demonhunter,havoc,65,34,31
2790,Magenie,korgath,1544,demonhunter,havoc,41,25,16
2791,Dealer,frostmourne,1542,demonhunter,havoc,114,51,63
2792,Karmadh,malganis,1539,demonhunter,havoc,42,21,21
2793,Blackmvp,tichondrius,1537,demonhunter,havoc,24,17,7
2794,Cäldo,tichondrius,1537,demonhunter,havoc,36,21,15
2795,Jaysavage,eitrigg,1536,demonhunter,havoc,113,59,54
2796,Furiel,quelthalas,1534,demonhunter,havoc,44,26,18
2797,Nuredmyy,illidan,1534,demonhunter,havoc,48,27,21
2798,Jhinskui,drakkari,1533,demonhunter,havoc,113,55,58
2799,Doxdevil,tichondrius,1533,demonhunter,havoc,57,19,38
2800,Thêdràïñgáñg,jubeithos,1530,demonhunter,havoc,30,16,14
2801,Cavell,tichondrius,1529,demonhunter,havoc,30,16,14
2802,Rôrônôâzôrô,stormrage,1529,demonhunter,havoc,59,30,29
2803,Velravyn,moon-guard,1529,demonhunter,havoc,67,34,33
2804,Surå,tichondrius,1529,demonhunter,havoc,106,49,57
2805,Papaelf,thunderlord,1528,demonhunter,havoc,48,33,15
2806,Coohiyan,tichondrius,1527,demonhunter,havoc,49,30,19
2807,Khaito,illidan,1527,demonhunter,havoc,38,17,21
2808,Dirtylatin,ragnaros,1526,demonhunter,havoc,54,31,23
2809,Crayoz,tichondrius,1525,demonhunter,havoc,131,73,58
2810,Emopidgeon,dalaran,1525,demonhunter,havoc,30,16,14
2811,Bogdan,azjolnerub,1525,demonhunter,havoc,66,35,31
2812,Mattdizzle,illidan,1524,demonhunter,havoc,24,17,7
2813,Ilydos,emerald-dream,1523,demonhunter,havoc,118,61,57
2814,Luminesce,tichondrius,1523,demonhunter,havoc,36,16,20
2815,Raith,khazgoroth,1522,demonhunter,havoc,67,39,28
2816,Chungîe,frostmourne,1522,demonhunter,havoc,54,26,28
2817,Papazaraki,tichondrius,1521,demonhunter,havoc,42,23,19
2818,Yqpro,tichondrius,1521,demonhunter,havoc,131,67,64
2819,Wormli,moon-guard,1519,demonhunter,havoc,46,28,18
2820,Noztak,area-52,1519,demonhunter,havoc,48,16,32
2821,Hëll,spirestone,1518,demonhunter,havoc,24,16,8
2822,Rêliç,sargeras,1516,demonhunter,havoc,30,18,12
2823,Eyecandyxo,grizzly-hills,1514,demonhunter,havoc,79,43,36
2824,Hàuntress,saurfang,1513,demonhunter,havoc,78,45,33
2825,Sikäria,malganis,1513,demonhunter,havoc,48,27,21
2826,Mileze,area-52,1513,demonhunter,havoc,96,39,57
2827,Deadpixellz,illidan,1511,demonhunter,havoc,76,39,37
2828,Vlääd,ragnaros,1511,demonhunter,havoc,174,87,87
2829,Ylydary,ragnaros,1509,demonhunter,havoc,93,52,41
2830,Gittgudd,area-52,1507,demonhunter,havoc,81,42,39
2831,Xionas,moon-guard,1507,demonhunter,havoc,148,75,73
2832,Radamanthysi,azralon,1506,demonhunter,havoc,90,56,34
2833,Iluvboóty,blackrock,1505,demonhunter,havoc,42,17,25
2834,Dirtbag,tichondrius,1503,demonhunter,havoc,30,16,14
2835,Enfirok,duskwood,1501,demonhunter,havoc,300,153,147
2836,Kakster,tichondrius,1500,demonhunter,havoc,84,49,35
2837,Demodorn,frostmane,1499,demonhunter,havoc,30,19,11
2838,Spasmodiic,illidan,1499,demonhunter,havoc,51,27,24
2839,Macacøbrr,azralon,1498,demonhunter,havoc,76,37,39
2840,Alli,bleeding-hollow,1494,demonhunter,havoc,69,39,30
2841,Ralløszek,illidan,1494,demonhunter,havoc,48,26,22
2842,Træt,emerald-dream,1494,demonhunter,havoc,83,42,41
2843,Hemmerdainz,kelthuzad,1492,demonhunter,havoc,66,30,36
2844,Scriptyscrip,dark-iron,1491,demonhunter,havoc,192,86,106
2845,Croisoi,ragnaros,1490,demonhunter,havoc,78,38,40
2846,Bigflopper,malganis,1489,demonhunter,havoc,84,42,42
2847,Gazza,eldrethalas,1488,demonhunter,havoc,42,23,19
2848,Îllîdàn,tichondrius,1488,demonhunter,havoc,45,22,23
2849,Hellmetal,quelthalas,1488,demonhunter,havoc,36,17,19
2850,Dashxo,tichondrius,1487,demonhunter,havoc,36,17,19
2851,Dmonslayer,daggerspine,1487,demonhunter,havoc,60,23,37
2852,Apõz,tichondrius,1486,demonhunter,havoc,30,16,14
2853,Emeress,illidan,1486,demonhunter,havoc,57,26,31
2854,Orgasmia,tichondrius,1486,demonhunter,havoc,106,32,74
2855,Demontrue,tichondrius,1483,demonhunter,havoc,62,32,30
2856,Kimjonguun,tichondrius,1481,demonhunter,havoc,32,22,10
2857,Órph,sargeras,1481,demonhunter,havoc,48,26,22
2858,Halleblurry,dalaran,1481,demonhunter,havoc,66,34,32
2859,Häruun,quelthalas,1480,demonhunter,havoc,53,29,24
2860,Aiapaec,wyrmrest-accord,1479,demonhunter,havoc,119,60,59
2861,Wowomg,tichondrius,1477,demonhunter,havoc,36,20,16
2862,Gaìjîn,barthilas,1477,demonhunter,havoc,144,77,67
2863,Steeler,shandris,1475,demonhunter,havoc,42,18,24
2864,Cocomeld,tichondrius,1474,demonhunter,havoc,24,16,8
2865,Vegêta,malganis,1473,demonhunter,havoc,36,20,16
2866,Nooksuh,bleeding-hollow,1473,demonhunter,havoc,29,16,13
2867,Eazyrat,stormrage,1472,demonhunter,havoc,48,33,15
2868,Businessmaam,malganis,1472,demonhunter,havoc,30,17,13
2869,Vilal,dalaran,1469,demonhunter,havoc,32,24,8
2870,Røllnautløw,aegwynn,1469,demonhunter,havoc,32,22,10
2871,Kegu,stormrage,1469,demonhunter,havoc,54,20,34
2872,Greent,stormrage,1468,demonhunter,havoc,60,39,21
2873,Jiujitsuu,bleeding-hollow,1468,demonhunter,havoc,37,17,20
2874,Gomesdhunter,azralon,1466,demonhunter,havoc,88,47,41
2875,Sätyr,bleeding-hollow,1466,demonhunter,havoc,54,19,35
2876,Bjj,bonechewer,1465,demonhunter,havoc,100,58,42
2877,Exequion,ragnaros,1465,demonhunter,havoc,188,102,86
2878,Zunfooki,stormrage,1464,demonhunter,havoc,30,17,13
2879,Ðarkone,ragnaros,1464,demonhunter,havoc,42,17,25
2880,Derelikte,shadowmoon,1462,demonhunter,havoc,34,20,14
2881,Nepzz,stormrage,1461,demonhunter,havoc,78,44,34
2882,Creãtuss,area-52,1461,demonhunter,havoc,72,36,36
2883,Eery,tichondrius,1461,demonhunter,havoc,71,35,36
2884,Doomtots,kelthuzad,1460,demonhunter,havoc,30,17,13
2885,Mamif,korgath,1460,demonhunter,havoc,68,31,37
2886,Hellnkeller,tichondrius,1459,demonhunter,havoc,36,16,20
2887,Somethingstu,sargeras,1458,demonhunter,havoc,28,18,10
2888,Bofxo,sargeras,1458,demonhunter,havoc,53,25,28
2889,Gohamx,illidan,1457,demonhunter,havoc,110,54,56
2890,Felseal,frostmourne,1456,demonhunter,havoc,53,34,19
2891,Tyredris,kelthuzad,1456,demonhunter,havoc,50,27,23
2892,Kushidari,tichondrius,1455,demonhunter,havoc,126,71,55
2893,Nekrosdaeva,zuljin,1455,demonhunter,havoc,73,40,33
2894,Telmordrin,azralon,1455,demonhunter,havoc,68,36,32
2895,Mysteryastor,tichondrius,1455,demonhunter,havoc,48,22,26
2896,Sciatic,area-52,1454,demonhunter,havoc,68,33,35
2897,Wangasaurus,emerald-dream,1452,demonhunter,havoc,54,26,28
2898,Metabeam,tichondrius,1451,demonhunter,havoc,54,34,20
2899,Xillidan,area-52,1450,demonhunter,havoc,112,70,42
2900,Sëlene,antonidas,1449,demonhunter,havoc,83,40,43
2901,Wokeaf,malganis,1448,demonhunter,havoc,35,16,19
2902,Bucx,barthilas,1445,demonhunter,havoc,60,36,24
2903,Nicodine,tichondrius,1445,demonhunter,havoc,63,34,29
2904,Ragiidh,tichondrius,1443,demonhunter,havoc,45,19,26
2905,Netherbird,malganis,1442,demonhunter,havoc,24,16,8
2906,Faphunter,illidan,1441,demonhunter,havoc,87,50,37
2907,Gwendanzig,zangarmarsh,1440,demonhunter,havoc,72,37,35
2908,Vellestia,argent-dawn,1440,demonhunter,havoc,71,31,40
2909,Absinith,jubeithos,1439,demonhunter,havoc,46,29,17
2910,Allyrian,sargeras,1439,demonhunter,havoc,174,93,81
2911,Ragiixoxo,tichondrius,1438,demonhunter,havoc,24,15,9
2912,Huntoneshot,bleeding-hollow,1438,demonhunter,havoc,55,29,26
2913,Haades,proudmoore,1438,demonhunter,havoc,73,38,35
2914,Molchamp,kelthuzad,1438,demonhunter,havoc,60,27,33
2915,Feelmybush,barthilas,1438,demonhunter,havoc,72,29,43
2916,Elidani,area-52,1437,demonhunter,havoc,66,31,35
2917,Yåkuza,daggerspine,1436,demonhunter,havoc,164,79,85
2918,Lravanal,quelthalas,1435,demonhunter,havoc,24,17,7
2919,Fametrap,tichondrius,1435,demonhunter,havoc,24,15,9
2920,ßlurr,moon-guard,1435,demonhunter,havoc,114,63,51
2921,Genruis,area-52,1435,demonhunter,havoc,67,34,33
2922,Broneill,blood-furnace,1435,demonhunter,havoc,60,27,33
2923,Jfangio,moon-guard,1434,demonhunter,havoc,24,15,9
2924,Derperhunter,kiljaeden,1434,demonhunter,havoc,66,33,33
2925,Beastsburdun,zuljin,1433,demonhunter,havoc,24,15,9
2926,Backtolumby,bleeding-hollow,1433,demonhunter,havoc,65,36,29
2927,Kyuno,eitrigg,1431,demonhunter,havoc,48,22,26
2928,Remuko,tichondrius,1430,demonhunter,havoc,30,15,15
2929,Dridri,quelthalas,1430,demonhunter,havoc,44,21,23
2930,Glaivez,korgath,1429,demonhunter,havoc,24,15,9
2931,Unjusthunt,magtheridon,1429,demonhunter,havoc,30,15,15
2932,Egirlhunter,echo-isles,1429,demonhunter,havoc,30,15,15
2933,Qixoni,emerald-dream,1429,demonhunter,havoc,36,15,21
2934,Trillidan,mugthol,1429,demonhunter,havoc,36,15,21
2935,Chimpers,illidan,1429,demonhunter,havoc,42,15,27
2936,Iim,tichondrius,1428,demonhunter,havoc,87,35,52
2937,Lonelydusk,zangarmarsh,1427,demonhunter,havoc,54,28,26
2938,Crankbaz,malganis,1426,demonhunter,havoc,24,15,9
2939,Pigmah,malganis,1426,demonhunter,havoc,28,16,12
2940,Rhadê,ragnaros,1426,demonhunter,havoc,30,16,14
2941,Stalkdemon,azralon,1426,demonhunter,havoc,30,15,15
2942,Goldsgym,boulderfist,1424,demonhunter,havoc,28,17,11
2943,Sloôtybag,tichondrius,1424,demonhunter,havoc,42,21,21
2944,Postodesaúde,azralon,1424,demonhunter,havoc,36,15,21
2945,Superlative,area-52,1423,demonhunter,havoc,24,15,9
2946,Alwaysin,zuljin,1423,demonhunter,havoc,26,16,10
2947,Thebojanglz,frostmourne,1421,demonhunter,havoc,25,16,9
2948,Italoo,ragnaros,1421,demonhunter,havoc,30,16,14
2949,Nupx,frostmourne,1420,demonhunter,havoc,39,20,19
2950,Anatema,illidan,1420,demonhunter,havoc,104,53,51
2951,Moylecrumbs,stormrage,1420,demonhunter,havoc,102,50,52
2952,Devastation,tichondrius,1420,demonhunter,havoc,72,34,38
2953,Thgyjufdgh,smolderthorn,1420,demonhunter,havoc,50,23,27
2954,Creamboi,stormrage,1419,demonhunter,havoc,34,19,15
2955,Falachio,tichondrius,1419,demonhunter,havoc,129,66,63
2956,Adhdh,haomarush,1418,demonhunter,havoc,24,15,9
2957,Vespherie,moon-guard,1418,demonhunter,havoc,85,51,34
2958,Viismoke,thaurissan,1418,demonhunter,havoc,48,28,20
2959,Talyethsam,shadowsong,1418,demonhunter,havoc,32,16,16
2960,Bezmon,silvermoon,1416,demonhunter,havoc,30,19,11
2961,Layli,azralon,1416,demonhunter,havoc,48,30,18
2962,Dèmonhuntèr,tichondrius,1415,demonhunter,havoc,134,64,70
2963,Ikilldemonz,thrall,1415,demonhunter,havoc,42,19,23
2964,Valka,emerald-dream,1414,demonhunter,havoc,112,59,53
2965,Tharzadan,quelthalas,1414,demonhunter,havoc,63,33,30
2966,Tickelfist,zuljin,1413,demonhunter,havoc,115,59,56
2967,Varthalos,thrall,1412,demonhunter,havoc,96,54,42
2968,Grizzop,sargeras,1411,demonhunter,havoc,102,50,52
2969,Mavèrick,thrall,1411,demonhunter,havoc,63,29,34
2970,Oxyoxy,illidan,1410,demonhunter,havoc,37,23,14
2971,Colinn,illidan,1409,demonhunter,havoc,42,25,17
2972,Mintjoa,tichondrius,1409,demonhunter,havoc,30,15,15
2973,Bijix,area-52,1408,demonhunter,havoc,55,35,20
2974,Cybertrax,tichondrius,1408,demonhunter,havoc,24,15,9
2975,Salomesalvi,proudmoore,1405,demonhunter,havoc,36,24,12
2976,Zigzagrat,sargeras,1404,demonhunter,havoc,30,15,15
2977,Grumblepuppy,hyjal,1404,demonhunter,havoc,41,18,23
2978,Narchis,malganis,1403,demonhunter,havoc,30,17,13
2979,Zackfair,burning-legion,1403,demonhunter,havoc,123,60,63
2980,Ralrdh,ragnaros,1402,demonhunter,havoc,54,30,24
2981,Loreney,quelthalas,1402,demonhunter,havoc,120,55,65
2982,Rem,stormrage,1401,demonhunter,havoc,75,42,33
2983,Yodiegang,nazgrel,1400,demonhunter,havoc,24,15,9
2984,Demonicfish,malganis,1400,demonhunter,havoc,72,40,32
2985,Refractx,illidan,1400,demonhunter,havoc,83,45,38
2986,Noxon,stormrage,1400,demonhunter,havoc,98,50,48
2987,Ehrapist,kelthuzad,1399,demonhunter,havoc,30,16,14
2988,Illusiondh,tichondrius,1398,demonhunter,havoc,99,58,41
2989,Plasticbagel,frostmourne,1397,demonhunter,havoc,48,25,23
2990,Phoébé,drakkari,1394,demonhunter,havoc,36,19,17
2991,Softkyll,area-52,1394,demonhunter,havoc,369,191,178
2992,Cherlas,blood-furnace,1393,demonhunter,havoc,99,52,47
2993,Ranir,doomhammer,1393,demonhunter,havoc,72,32,40
2994,Freyvin,emerald-dream,1392,demonhunter,havoc,78,35,43
2995,Yaakee,tichondrius,1391,demonhunter,havoc,54,33,21
2996,Hoein,eldrethalas,1390,demonhunter,havoc,137,76,61
2997,Swarlee,kiljaeden,1389,demonhunter,havoc,89,49,40
2998,Siksix,bleeding-hollow,1389,demonhunter,havoc,54,27,27
2999,Maisus,illidan,1388,demonhunter,havoc,36,16,20
3000,Dejay,thunderhorn,1386,demonhunter,havoc,54,33,21
3001,Thunderray,ragnaros,1386,demonhunter,havoc,42,25,17
3002,Kúrama,tichondrius,1385,demonhunter,havoc,78,46,32
3003,Rolecheck,tichondrius,1385,demonhunter,havoc,50,25,25
3004,Snaped,tichondrius,1384,demonhunter,havoc,42,28,14
3005,Jackk,nordrassil,1384,demonhunter,havoc,41,21,20
3006,Lostsoulzz,tichondrius,1383,demonhunter,havoc,45,28,17
3007,Véñom,area-52,1383,demonhunter,havoc,60,18,42
3008,Vegan,magtheridon,1382,demonhunter,havoc,48,29,19
3009,Tøwers,aegwynn,1382,demonhunter,havoc,102,51,51
3010,Allenqt,azralon,1381,demonhunter,havoc,42,22,20
3011,Onií,bleeding-hollow,1379,demonhunter,havoc,35,17,18
3012,Yukisyn,proudmoore,1376,demonhunter,havoc,114,61,53
3013,Violegrace,area-52,1376,demonhunter,havoc,106,51,55
3014,Blomi,stormrage,1376,demonhunter,havoc,48,21,27
3015,Villumninati,tichondrius,1375,demonhunter,havoc,48,27,21
3016,Catastrophis,tichondrius,1375,demonhunter,havoc,48,25,23
3017,Omgshesocute,hyjal,1375,demonhunter,havoc,36,18,18
3018,Kellox,ragnaros,1372,demonhunter,havoc,36,15,21
3019,Petty,moon-guard,1371,demonhunter,havoc,48,28,20
3020,Fugabag,thrall,1371,demonhunter,havoc,58,28,30
3021,Erandrida,frostmourne,1370,demonhunter,havoc,39,16,23
3022,Kazdh,sargeras,1367,demonhunter,havoc,48,25,23
3023,Chaz,blood-furnace,1366,demonhunter,havoc,36,16,20
3024,Jellous,rivendare,1366,demonhunter,havoc,42,17,25
3025,Cresslina,tichondrius,1365,demonhunter,havoc,78,38,40
3026,Xiaochicken,tichondrius,1365,demonhunter,havoc,61,29,32
3027,Nubishe,jubeithos,1364,demonhunter,havoc,42,18,24
3028,Methany,saurfang,1362,demonhunter,havoc,105,48,57
3029,Ronkasprince,thunderlord,1361,demonhunter,havoc,92,41,51
3030,Felbreak,stormrage,1358,demonhunter,havoc,72,35,37
3031,Celestiel,cenarion-circle,1357,demonhunter,havoc,30,17,13
3032,Kalmor,barthilas,1357,demonhunter,havoc,69,33,36
3033,Mybus,tichondrius,1357,demonhunter,havoc,78,32,46
3034,Foxdie,bonechewer,1356,demonhunter,havoc,96,47,49
3035,Báléríón,area-52,1355,demonhunter,havoc,59,34,25
3036,Muerdun,tichondrius,1355,demonhunter,havoc,36,20,16
3037,Hornedelf,frostmourne,1355,demonhunter,havoc,41,22,19
3038,Telrindyl,moon-guard,1352,demonhunter,havoc,120,68,52
3039,Rizzaarrdd,tichondrius,1352,demonhunter,havoc,134,70,64
3040,Metagoblin,tichondrius,1352,demonhunter,havoc,30,15,15
3041,Xlash,malganis,1350,demonhunter,havoc,33,15,18
3042,Krizo,frostmourne,1348,demonhunter,havoc,37,19,18
3043,Duhan,tichondrius,1346,demonhunter,havoc,251,130,121
3044,Rânkle,darkspear,1345,demonhunter,havoc,46,25,21
3045,Imrealgez,wyrmrest-accord,1345,demonhunter,havoc,30,16,14
3046,Exzyo,area-52,1344,demonhunter,havoc,18,14,4
3047,Onewhoknox,mannoroth,1344,demonhunter,havoc,126,64,62
3048,Soupwoup,moon-guard,1344,demonhunter,havoc,75,36,39
3049,Ergzydh,frostmourne,1344,demonhunter,havoc,72,30,42
3050,Aethrys,amanthul,1343,demonhunter,havoc,54,28,26
3051,Kokushiibo,frostwolf,1342,demonhunter,havoc,24,14,10
3052,Riskerdog,tichondrius,1342,demonhunter,havoc,30,14,16
3053,Chromatïc,jubeithos,1342,demonhunter,havoc,78,34,44
3054,Theflurry,tichondrius,1342,demonhunter,havoc,36,14,22
3055,Beerbreak,area-52,1342,demonhunter,havoc,42,14,28
3056,Çópê,sargeras,1340,demonhunter,havoc,24,14,10
3057,Leesu,tichondrius,1340,demonhunter,havoc,24,14,10
3058,Deviljane,illidan,1340,demonhunter,havoc,24,14,10
3059,Skace,jubeithos,1340,demonhunter,havoc,108,57,51
3060,Bobbyhill,nordrassil,1340,demonhunter,havoc,30,14,16
3061,Demondubya,illidan,1339,demonhunter,havoc,28,15,13
3062,Malviciouss,tichondrius,1339,demonhunter,havoc,84,40,44
3063,Kellytgt,perenolde,1338,demonhunter,havoc,78,40,38
3064,Xaneuma,nemesis,1335,demonhunter,havoc,24,14,10
3065,Mudßutt,malganis,1335,demonhunter,havoc,36,14,22
3066,Dakro,blackrock,1334,demonhunter,havoc,28,17,11
3067,Ghótam,quelthalas,1334,demonhunter,havoc,30,15,15
3068,Alganoth,malfurion,1332,demonhunter,havoc,79,40,39
3069,Smilingbomb,tichondrius,1332,demonhunter,havoc,30,14,16
3070,Melantharia,wyrmrest-accord,1331,demonhunter,havoc,30,14,16
3071,Majnun,moon-guard,1330,demonhunter,havoc,65,30,35
3072,Intensè,proudmoore,1330,demonhunter,havoc,36,15,21
3073,Demonaco,tichondrius,1329,demonhunter,havoc,40,15,25
3074,Soulsteall,tichondrius,1327,demonhunter,havoc,36,24,12
3075,Xein,khazgoroth,1327,demonhunter,havoc,66,30,36
3076,Mördredd,quelthalas,1327,demonhunter,havoc,40,16,24
3077,Elevateztko,stormrage,1326,demonhunter,havoc,36,16,20
3078,Kêrbydh,frostmourne,1325,demonhunter,havoc,36,22,14
3079,Ðemonix,tichondrius,1325,demonhunter,havoc,42,14,28
3080,Intensìve,illidan,1324,demonhunter,havoc,89,36,53
3081,Creamin,thrall,1323,demonhunter,havoc,24,15,9
3082,Verméil,tichondrius,1323,demonhunter,havoc,36,17,19
3083,Akiirus,azralon,1322,demonhunter,havoc,30,15,15
3084,Zévron,area-52,1322,demonhunter,havoc,54,26,28
3085,Chaosfienddh,bleeding-hollow,1322,demonhunter,havoc,36,14,22
3086,Hyjixer,stormrage,1321,demonhunter,havoc,36,14,22
3087,Kitnix,proudmoore,1319,demonhunter,havoc,43,21,22
3088,Margerie,bleeding-hollow,1319,demonhunter,havoc,43,21,22
3089,Antaris,stonemaul,1319,demonhunter,havoc,30,14,16
3090,Aleira,frostwolf,1318,demonhunter,havoc,58,32,26
3091,Gigavlad,area-52,1317,demonhunter,havoc,30,14,16
3092,Jotalejandro,quelthalas,1317,demonhunter,havoc,60,27,33
3093,Kaelidan,kelthuzad,1316,demonhunter,havoc,111,58,53
3094,Litzilla,thrall,1315,demonhunter,havoc,42,20,22
3095,Nolights,area-52,1315,demonhunter,havoc,90,37,53
3096,Sicklyslick,frostmourne,1313,demonhunter,havoc,25,15,10
3097,Valdiran,duskwood,1312,demonhunter,havoc,71,30,41
3098,Nurzal,malganis,1310,demonhunter,havoc,30,14,16
3099,Nisea,malganis,1310,demonhunter,havoc,36,15,21
3100,Sillyslayadk,moon-guard,1309,demonhunter,havoc,124,69,55
3101,Thêpunisher,ragnaros,1309,demonhunter,havoc,124,61,63
3102,Jibaiye,tichondrius,1309,demonhunter,havoc,30,14,16
3103,Noctemdh,tichondrius,1309,demonhunter,havoc,69,29,40
3104,Sashasilver,frostmourne,1308,demonhunter,havoc,33,15,18
3105,Dömönic,illidan,1306,demonhunter,havoc,30,18,12
3106,Ashtyr,emerald-dream,1306,demonhunter,havoc,28,16,12
3107,Loadedtruck,frostmourne,1305,demonhunter,havoc,30,17,13
3108,Vizionz,emerald-dream,1305,demonhunter,havoc,88,46,42
3109,Aeonys,stormrage,1304,demonhunter,havoc,60,33,27
3110,Tekkamanevil,tichondrius,1304,demonhunter,havoc,210,104,106
3111,Powertaco,tichondrius,1304,demonhunter,havoc,67,31,36
3112,Rosamune,kelthuzad,1304,demonhunter,havoc,47,18,29
3113,Christensen,illidan,1303,demonhunter,havoc,90,50,40
3114,Felshiv,azralon,1302,demonhunter,havoc,42,19,23
3115,Darthmah,illidan,1300,demonhunter,havoc,42,25,17
3116,Belial,haomarush,1299,demonhunter,havoc,54,28,26
3117,Artemisleto,tichondrius,1299,demonhunter,havoc,42,19,23
3118,Litan,ragnaros,1298,demonhunter,havoc,30,16,14
3119,Halftruth,stormrage,1298,demonhunter,havoc,46,22,24
3120,Nrpx,stormrage,1298,demonhunter,havoc,34,14,20
3121,Thechaz,bleeding-hollow,1297,demonhunter,havoc,54,34,20
3122,Spicywings,arthas,1297,demonhunter,havoc,60,30,30
3123,Evros,tichondrius,1294,demonhunter,havoc,74,44,30
3124,Revvup,tichondrius,1294,demonhunter,havoc,71,33,38
3125,Alaron,wildhammer,1293,demonhunter,havoc,99,53,46
3126,Naelaksa,tichondrius,1293,demonhunter,havoc,36,14,22
3127,Thèflurry,tichondrius,1292,demonhunter,havoc,29,14,15
3128,Silvs,illidan,1291,demonhunter,havoc,244,131,113
3129,Mursiless,drenden,1290,demonhunter,havoc,24,15,9
3130,Itachiix,sargeras,1289,demonhunter,havoc,36,23,13
3131,Szei,tichondrius,1289,demonhunter,havoc,27,16,11
3132,Chungg,laughing-skull,1287,demonhunter,havoc,30,15,15
3133,Hawkowicz,tichondrius,1286,demonhunter,havoc,199,99,100
3134,Amdusias,darkspear,1285,demonhunter,havoc,55,26,29
3135,Diversityabc,bleeding-hollow,1285,demonhunter,havoc,98,44,54
3136,Vaxs,moon-guard,1284,demonhunter,havoc,97,54,43
3137,Durello,stormrage,1284,demonhunter,havoc,60,29,31
3138,Siicknote,frostmourne,1284,demonhunter,havoc,29,14,15
3139,Vwap,tichondrius,1284,demonhunter,havoc,29,14,15
3140,Adryr,eredar,1283,demonhunter,havoc,46,27,19
3141,Yedeme,tichondrius,1283,demonhunter,havoc,76,31,45
3142,Killmongeer,tichondrius,1282,demonhunter,havoc,27,16,11
3143,Facerollfel,tichondrius,1280,demonhunter,havoc,30,14,16
3144,Onlypain,korgath,1280,demonhunter,havoc,50,22,28
3145,Roughins,chogall,1278,demonhunter,havoc,51,28,23
3146,Cleår,kelthuzad,1276,demonhunter,havoc,26,15,11
3147,Sylenah,hyjal,1273,demonhunter,havoc,30,14,16
3148,Revean,darkspear,1270,demonhunter,havoc,126,67,59
3149,Whataboutbob,korgath,1268,demonhunter,havoc,36,14,22
3150,Mortiria,dalaran,1267,demonhunter,havoc,67,30,37
3151,Dakkemon,zuljin,1267,demonhunter,havoc,62,24,38
3152,Tattedandfab,stormrage,1265,demonhunter,havoc,102,44,58
3153,Yønkou,stormrage,1264,demonhunter,havoc,143,70,73
3154,Fiziokratdh,ghostlands,1263,demonhunter,havoc,67,30,37
3155,Devilspawnss,barthilas,1263,demonhunter,havoc,43,17,26
3156,Skilla,frostmourne,1262,demonhunter,havoc,85,42,43
3157,Wíkkihx,emerald-dream,1262,demonhunter,havoc,67,30,37
3158,Howller,azralon,1261,demonhunter,havoc,39,18,21
3159,Sekiro,illidan,1260,demonhunter,havoc,29,15,14
3160,Eullz,skullcrusher,1257,demonhunter,havoc,31,14,17
3161,Twodxoxo,kelthuzad,1256,demonhunter,havoc,24,14,10
3162,Xà,sargeras,1256,demonhunter,havoc,36,14,22
3163,Miroir,silvermoon,1250,demonhunter,havoc,125,58,67
3164,Blinddh,bleeding-hollow,1249,demonhunter,havoc,32,14,18
3165,Gosrend,durotan,1249,demonhunter,havoc,43,14,29
3166,Mårth,caelestrasz,1248,demonhunter,havoc,48,25,23
3167,Ilovenina,sargeras,1247,demonhunter,havoc,24,13,11
3168,Gènji,tichondrius,1246,demonhunter,havoc,24,13,11
3169,Raylêy,tichondrius,1246,demonhunter,havoc,24,13,11
3170,Inkubuz,sargeras,1246,demonhunter,havoc,160,78,82
3171,Kalikanzar,sargeras,1245,demonhunter,havoc,24,13,11
3172,Demonthorne,illidan,1245,demonhunter,havoc,24,13,11
3173,Demonlord,shattered-hand,1245,demonhunter,havoc,61,27,34
3174,Rykidh,tichondrius,1245,demonhunter,havoc,30,13,17
3175,Äòégämîñg,stormrage,1245,demonhunter,havoc,36,13,23
3176,Alizqt,ragnaros,1244,demonhunter,havoc,24,13,11
3177,Serb,chogall,1244,demonhunter,havoc,24,13,11
3178,Kereses,bonechewer,1244,demonhunter,havoc,51,27,24
3179,Mitsûri,quelthalas,1244,demonhunter,havoc,51,27,24
3180,Hoguriders,tichondrius,1244,demonhunter,havoc,30,13,17
3181,Baejuhyun,kiljaeden,1243,demonhunter,havoc,24,16,8
3182,Odio,chromaggus,1243,demonhunter,havoc,24,13,11
3183,Angelawhite,illidan,1243,demonhunter,havoc,42,20,22
3184,Tomhenk,blackrock,1242,demonhunter,havoc,30,13,17
3185,Decoi,tichondrius,1241,demonhunter,havoc,24,13,11
3186,Nightwisty,azralon,1241,demonhunter,havoc,24,13,11
3187,Kimochinchin,ragnaros,1241,demonhunter,havoc,24,13,11
3188,Schrute,bonechewer,1241,demonhunter,havoc,36,15,21
3189,Miltonpickle,tichondrius,1240,demonhunter,havoc,54,24,30
3190,Cheriste,malganis,1240,demonhunter,havoc,32,14,18
3191,Tydriedian,dalaran,1239,demonhunter,havoc,18,13,5
3192,Missjotab,tichondrius,1239,demonhunter,havoc,24,13,11
3193,Harû,tichondrius,1239,demonhunter,havoc,30,13,17
3194,Zétta,area-52,1236,demonhunter,havoc,24,13,11
3195,Thegudgud,stormrage,1236,demonhunter,havoc,24,13,11
3196,Demonbane,moon-guard,1236,demonhunter,havoc,54,27,27
3197,Láskó,area-52,1235,demonhunter,havoc,21,16,5
3198,Diëgo,gallywix,1235,demonhunter,havoc,19,13,6
3199,Strickdaddy,hyjal,1234,demonhunter,havoc,66,30,36
3200,Maddummy,tichondrius,1234,demonhunter,havoc,30,13,17
3201,Aflex,zuljin,1232,demonhunter,havoc,35,19,16
3202,Mázoku,shuhalo,1232,demonhunter,havoc,32,15,17
3203,Madblader,tichondrius,1232,demonhunter,havoc,30,13,17
3204,Lixthing,ragnaros,1231,demonhunter,havoc,62,40,22
3205,Sorrybadgas,illidan,1231,demonhunter,havoc,36,13,23
3206,Chris,dreadmaul,1230,demonhunter,havoc,24,13,11
3207,Narene,mannoroth,1230,demonhunter,havoc,51,22,29
3208,Asmoday,warsong,1229,demonhunter,havoc,149,82,67
3209,Inntty,barthilas,1229,demonhunter,havoc,76,38,38
3210,Felraven,scarlet-crusade,1227,demonhunter,havoc,39,19,20
3211,Hellrunner,magtheridon,1225,demonhunter,havoc,36,16,20
3212,Superbug,quelthalas,1224,demonhunter,havoc,78,38,40
3213,Trituone,ragnaros,1224,demonhunter,havoc,85,40,45
3214,Rorac,ragnaros,1223,demonhunter,havoc,30,13,17
3215,Pilyn,ragnaros,1222,demonhunter,havoc,110,54,56
3216,Tezrian,earthen-ring,1221,demonhunter,havoc,24,13,11
3217,Pokoloko,twisting-nether,1219,demonhunter,havoc,38,15,23
3218,Raradane,illidan,1218,demonhunter,havoc,24,15,9
3219,Shandras,dathremar,1218,demonhunter,havoc,24,13,11
3220,Lachesix,tichondrius,1217,demonhunter,havoc,30,13,17
3221,Devwillhuntu,barthilas,1216,demonhunter,havoc,80,42,38
3222,Axyy,area-52,1215,demonhunter,havoc,24,14,10
3223,Syrena,mugthol,1214,demonhunter,havoc,30,15,15
3224,Keelin,ragnaros,1212,demonhunter,havoc,28,13,15
3225,Joegamer,illidan,1211,demonhunter,havoc,36,17,19
3226,Eraticdh,illidan,1211,demonhunter,havoc,30,13,17
3227,Scarshine,frostmourne,1210,demonhunter,havoc,127,57,70
3228,Pressinghunt,tichondrius,1209,demonhunter,havoc,23,13,10
3229,Cursesoul,area-52,1206,demonhunter,havoc,60,31,29
3230,Furxi,illidan,1206,demonhunter,havoc,63,28,35
3231,Zématador,azralon,1205,demonhunter,havoc,112,57,55
3232,Demonkratoz,ragnaros,1203,demonhunter,havoc,61,24,37
3233,Pupupoo,tichondrius,1202,demonhunter,havoc,78,37,41
3234,Hellspawnn,malganis,1200,demonhunter,havoc,44,24,20
3235,Zetsuwaffles,area-52,1198,demonhunter,havoc,29,13,16
3236,Etherëäl,stormrage,1194,demonhunter,havoc,53,32,21
3237,Bastaghor,stormrage,1194,demonhunter,havoc,42,19,23
3238,Fellight,bonechewer,1193,demonhunter,havoc,42,27,15
3239,Kêydën,ragnaros,1193,demonhunter,havoc,46,27,19
3240,Ixix,proudmoore,1192,demonhunter,havoc,62,30,32
3241,Illidice,tichondrius,1189,demonhunter,havoc,30,13,17
3242,Erazuz,stormrage,1188,demonhunter,havoc,30,13,17
3243,Thelada,illidan,1187,demonhunter,havoc,33,16,17
3244,Hævenlysinz,tichondrius,1186,demonhunter,havoc,42,15,27
3245,Brunoqt,azralon,1185,demonhunter,havoc,29,13,16
3246,Cyberpsycho,illidan,1184,demonhunter,havoc,30,14,16
3247,Sleepyjobe,sargeras,1183,demonhunter,havoc,16,13,3
3248,Tyrelara,durotan,1179,demonhunter,havoc,23,13,10
3249,Falsewave,sargeras,1178,demonhunter,havoc,30,18,12
3250,Glayve,emerald-dream,1178,demonhunter,havoc,85,41,44
3251,Spamsamich,stormscale,1177,demonhunter,havoc,89,49,40
3252,Tyindorin,gurubashi,1176,demonhunter,havoc,30,15,15
3253,Neecro,frostmourne,1175,demonhunter,havoc,84,38,46
3254,Aroncruel,area-52,1172,demonhunter,havoc,77,41,36
3255,Saelila,emerald-dream,1172,demonhunter,havoc,30,13,17
3256,Dyingslow,stormrage,1172,demonhunter,havoc,72,27,45
3257,Buzzmezaddy,bleeding-hollow,1170,demonhunter,havoc,63,28,35
3258,Ënky,ragnaros,1170,demonhunter,havoc,54,23,31
3259,Gouge,hakkar,1167,demonhunter,havoc,55,30,25
3260,Daiks,proudmoore,1166,demonhunter,havoc,48,22,26
3261,Atsudadh,illidan,1166,demonhunter,havoc,36,13,23
3262,Xxsozin,skullcrusher,1164,demonhunter,havoc,39,17,22
3263,Sucubus,eredar,1161,demonhunter,havoc,48,26,22
3264,Bzrp,stormrage,1161,demonhunter,havoc,46,24,22
3265,Zoruv,quelthalas,1160,demonhunter,havoc,27,14,13
3266,Twistéd,gorefiend,1158,demonhunter,havoc,24,14,10
3267,Thedaz,frostmourne,1158,demonhunter,havoc,143,66,77
3268,Hiddenblade,coilfang,1158,demonhunter,havoc,67,29,38
3269,Larayedia,illidan,1156,demonhunter,havoc,24,17,7
3270,Ozark,barthilas,1156,demonhunter,havoc,48,29,19
3271,Xragii,kelthuzad,1152,demonhunter,havoc,24,12,12
3272,Medusarri,frostmourne,1152,demonhunter,havoc,71,35,36
3273,Lazygågå,zuljin,1151,demonhunter,havoc,18,12,6
3274,Kolthis,tichondrius,1151,demonhunter,havoc,27,13,14
3275,Adhdhdh,bloodhoof,1151,demonhunter,havoc,30,12,18
3276,Insomdh,sargeras,1150,demonhunter,havoc,18,12,6
3277,Painkiiller,kelthuzad,1150,demonhunter,havoc,58,32,26
3278,Fasnk,tichondrius,1150,demonhunter,havoc,24,12,12
3279,Nåx,bleeding-hollow,1150,demonhunter,havoc,24,12,12
3280,Àku,area-52,1149,demonhunter,havoc,24,12,12
3281,Elenamarth,kiljaeden,1149,demonhunter,havoc,72,31,41
3282,Lovedem,area-52,1149,demonhunter,havoc,60,21,39
3283,Devilkon,tichondrius,1148,demonhunter,havoc,18,12,6
3284,Openhard,stormrage,1148,demonhunter,havoc,24,12,12
3285,Imlikethat,gorefiend,1147,demonhunter,havoc,24,12,12
3286,Demónio,tichondrius,1146,demonhunter,havoc,18,12,6
3287,Luana,stormscale,1145,demonhunter,havoc,24,12,12
3288,Aeezus,tichondrius,1145,demonhunter,havoc,30,12,18
3289,Deemoogorgon,goldrinn,1144,demonhunter,havoc,18,12,6
3290,Koodachicken,kul-tiras,1144,demonhunter,havoc,24,12,12
3291,Orsova,area-52,1144,demonhunter,havoc,24,12,12
3292,Aliniron,illidan,1143,demonhunter,havoc,32,19,13
3293,Skinnrd,malganis,1142,demonhunter,havoc,24,12,12
3294,Valàk,bleeding-hollow,1142,demonhunter,havoc,24,12,12
3295,Vandeste,tichondrius,1142,demonhunter,havoc,30,12,18
3296,Kagraxxis,stormrage,1141,demonhunter,havoc,21,13,8
3297,Blazed,thrall,1141,demonhunter,havoc,136,66,70
3298,Swoffordsr,tichondrius,1141,demonhunter,havoc,48,23,25
3299,Magoroth,ragnaros,1139,demonhunter,havoc,30,20,10
3300,Timeryus,ragnaros,1139,demonhunter,havoc,41,21,20
3301,Irezumi,icecrown,1139,demonhunter,havoc,24,12,12
3302,Torophz,azralon,1139,demonhunter,havoc,30,12,18
3303,Fourbuttonsx,sargeras,1137,demonhunter,havoc,27,15,12
3304,Këÿz,earthen-ring,1136,demonhunter,havoc,24,12,12
3305,Vivas,tichondrius,1136,demonhunter,havoc,24,12,12
3306,Endyr,area-52,1136,demonhunter,havoc,25,12,13
3307,Ovèrrated,area-52,1134,demonhunter,havoc,90,40,50
3308,Tayel,emerald-dream,1133,demonhunter,havoc,34,19,15
3309,Dameon,wildhammer,1133,demonhunter,havoc,90,48,42
3310,Keigna,tichondrius,1132,demonhunter,havoc,18,12,6
3311,Worcraf,ragnaros,1132,demonhunter,havoc,38,16,22
3312,Dandreb,draenor,1130,demonhunter,havoc,29,15,14
3313,Diddlemethis,nagrand,1127,demonhunter,havoc,24,13,11
3314,Jennesis,tichondrius,1126,demonhunter,havoc,78,36,42
3315,Momysimpypoo,tichondrius,1125,demonhunter,havoc,18,12,6
3316,Ibeatrix,malorne,1124,demonhunter,havoc,24,18,6
3317,Flyingsky,tichondrius,1121,demonhunter,havoc,24,14,10
3318,Elfofura,azralon,1121,demonhunter,havoc,76,30,46
3319,Attritionx,sargeras,1118,demonhunter,havoc,23,13,10
3320,Zizi,ghostlands,1117,demonhunter,havoc,62,33,29
3321,Llrebelionll,stormrage,1113,demonhunter,havoc,18,12,6
3322,Overwatch,gundrak,1112,demonhunter,havoc,27,15,12
3323,Akalitethi,moon-guard,1110,demonhunter,havoc,48,17,31
3324,Demonslaier,dragonblight,1109,demonhunter,havoc,38,20,18
3325,Weedeaterr,arthas,1109,demonhunter,havoc,48,14,34
3326,Dennfear,skullcrusher,1104,demonhunter,havoc,30,17,13
3327,Jënesis,illidan,1104,demonhunter,havoc,92,44,48
3328,Proserpinâ,bleeding-hollow,1103,demonhunter,havoc,60,23,37
3329,Minar,tichondrius,1102,demonhunter,havoc,21,13,8
3330,Annabow,moon-guard,1098,demonhunter,havoc,138,76,62
3331,Lovekills,tichondrius,1098,demonhunter,havoc,24,12,12
3332,Foodtruck,hellscream,1095,demonhunter,havoc,23,13,10
3333,Imjustbad,malganis,1091,demonhunter,havoc,48,27,21
3334,Bogged,emerald-dream,1091,demonhunter,havoc,27,12,15
3335,Sätän,malganis,1089,demonhunter,havoc,24,13,11
3336,Nemoj,hellscream,1088,demonhunter,havoc,30,18,12
3337,Feltini,whisperwind,1085,demonhunter,havoc,23,12,11
3338,Lilliåna,kiljaeden,1085,demonhunter,havoc,56,24,32
3339,Kelmar,stormreaver,1084,demonhunter,havoc,32,12,20
3340,Moxí,ragnaros,1082,demonhunter,havoc,36,19,17
3341,Spicyblades,stormrage,1081,demonhunter,havoc,59,28,31
3342,Xonu,sargeras,1077,demonhunter,havoc,22,12,10
3343,Bhuppz,frostmourne,1076,demonhunter,havoc,22,12,10
3344,Nixsa,area-52,1073,demonhunter,havoc,84,37,47
3345,Dirtyvitus,gorefiend,1072,demonhunter,havoc,36,24,12
3346,Kazadin,azralon,1072,demonhunter,havoc,76,33,43
3347,Portgaes,ragnaros,1071,demonhunter,havoc,53,15,38
3348,Esomet,stormrage,1070,demonhunter,havoc,27,15,12
3349,Gravelot,quelthalas,1066,demonhunter,havoc,71,31,40
3350,Skógarmaðr,garrosh,1060,demonhunter,havoc,38,19,19
3351,Faalleen,quelthalas,1059,demonhunter,havoc,18,12,6
3352,Syrine,veknilash,1059,demonhunter,havoc,72,41,31
3353,Illadra,fizzcrank,1058,demonhunter,havoc,23,12,11
3354,Shakah,dragonmaw,1056,demonhunter,havoc,18,11,7
3355,Thegoph,bleeding-hollow,1056,demonhunter,havoc,24,11,13
3356,Fiveiq,malganis,1055,demonhunter,havoc,18,11,7
3357,Fëlla,tanaris,1055,demonhunter,havoc,18,11,7
3358,Zztzz,illidan,1055,demonhunter,havoc,18,11,7
3359,Qualitycaulk,tichondrius,1055,demonhunter,havoc,18,11,7
3360,Feliodas,tichondrius,1055,demonhunter,havoc,24,11,13
3361,Íllidan,stormrage,1055,demonhunter,havoc,24,11,13
3362,Gogungho,tichondrius,1055,demonhunter,havoc,24,11,13
3363,Ravack,stormrage,1054,demonhunter,havoc,18,11,7
3364,Ariaxy,sargeras,1054,demonhunter,havoc,18,11,7
3365,Thumôss,malganis,1054,demonhunter,havoc,18,11,7
3366,Koverage,frostmourne,1054,demonhunter,havoc,18,11,7
3367,Bümb,moon-guard,1054,demonhunter,havoc,24,11,13
3368,Behemod,thrall,1054,demonhunter,havoc,24,11,13
3369,Babahorns,dalaran,1054,demonhunter,havoc,30,11,19
3370,Hávok,sargeras,1054,demonhunter,havoc,31,11,20
3371,Agsakim,tichondrius,1053,demonhunter,havoc,18,11,7
3372,Xavid,bleeding-hollow,1053,demonhunter,havoc,24,11,13
3373,Cedicdh,illidan,1053,demonhunter,havoc,24,11,13
3374,Thedee,emerald-dream,1053,demonhunter,havoc,30,11,19
3375,Batorr,sargeras,1053,demonhunter,havoc,36,11,25
3376,Trindh,thrall,1052,demonhunter,havoc,18,11,7
3377,Tywín,illidan,1052,demonhunter,havoc,24,11,13
3378,Shinitakunai,area-52,1052,demonhunter,havoc,30,11,19
3379,Messenoire,area-52,1051,demonhunter,havoc,26,11,15
3380,Loathy,tichondrius,1050,demonhunter,havoc,18,11,7
3381,Sammyvicious,tichondrius,1049,demonhunter,havoc,16,12,4
3382,Ønsen,tichondrius,1049,demonhunter,havoc,29,11,18
3383,Zergedh,kiljaeden,1049,demonhunter,havoc,30,11,19
3384,Vuse,moon-guard,1048,demonhunter,havoc,24,11,13
3385,Covoth,bleeding-hollow,1048,demonhunter,havoc,27,12,15
3386,Faster,tichondrius,1048,demonhunter,havoc,30,11,19
3387,Winlegend,gallywix,1048,demonhunter,havoc,32,11,21
3388,Ogmon,tichondrius,1047,demonhunter,havoc,18,11,7
3389,Legäult,bleeding-hollow,1047,demonhunter,havoc,33,17,16
3390,Hugehogger,boulderfist,1047,demonhunter,havoc,24,11,13
3391,Madatya,black-dragonflight,1047,demonhunter,havoc,24,11,13
3392,Cðnstantine,barthilas,1047,demonhunter,havoc,24,11,13
3393,Callux,black-dragonflight,1047,demonhunter,havoc,30,11,19
3394,Rewyle,magtheridon,1047,demonhunter,havoc,36,11,25
3395,Midewdh,proudmoore,1046,demonhunter,havoc,24,11,13
3396,Taters,gorefiend,1045,demonhunter,havoc,18,11,7
3397,Jámès,area-52,1045,demonhunter,havoc,24,11,13
3398,Throniren,stormrage,1044,demonhunter,havoc,24,11,13
3399,Xanthee,drakkari,1043,demonhunter,havoc,81,41,40
3400,Darkglaive,ragnaros,1042,demonhunter,havoc,24,11,13
3401,Misfortune,bloodscalp,1042,demonhunter,havoc,72,32,40
3402,Rickinmorty,lightnings-blade,1041,demonhunter,havoc,19,11,8
3403,Misriah,sargeras,1039,demonhunter,havoc,30,11,19
3404,Aedice,gurubashi,1038,demonhunter,havoc,24,11,13
3405,Rauwèrs,azralon,1037,demonhunter,havoc,18,11,7
3406,Ghostzface,sargeras,1037,demonhunter,havoc,73,37,36
3407,Rhaast,executus,1035,demonhunter,havoc,79,35,44
3408,Blckreaper,area-52,1032,demonhunter,havoc,24,11,13
3409,Mindburn,shadowmoon,1031,demonhunter,havoc,29,19,10
3410,Felbòy,korgath,1029,demonhunter,havoc,24,11,13
3411,Hentaidemon,kiljaeden,1023,demonhunter,havoc,36,18,18
3412,Darkweast,dalaran,1021,demonhunter,havoc,24,11,13
3413,Veridax,quelthalas,1014,demonhunter,havoc,18,11,7
3414,Pegásus,kiljaeden,1010,demonhunter,havoc,16,11,5
3415,Eikichi,bleeding-hollow,1009,demonhunter,havoc,54,26,28
3416,Chronicsmoke,blood-furnace,1008,demonhunter,havoc,36,16,20
3417,Catfood,icecrown,1008,demonhunter,havoc,27,11,16
3418,Chirõn,moonrunner,1007,demonhunter,havoc,23,11,12
3419,Quinny,runetotem,1006,demonhunter,havoc,21,12,9
3420,Seamenhunter,garrosh,1004,demonhunter,havoc,24,12,12
3421,Blops,emerald-dream,1001,demonhunter,havoc,51,27,24
3422,Sourlime,stormrage,1001,demonhunter,havoc,29,11,18
3423,Cuint,barthilas,999,demonhunter,havoc,42,22,20
3424,Midnightlord,tichondrius,996,demonhunter,havoc,24,16,8
3425,Funspunk,nagrand,995,demonhunter,havoc,42,11,31
3426,Atomicsorrow,tichondrius,991,demonhunter,havoc,22,11,11
3427,Nécô,tichondrius,987,demonhunter,havoc,26,11,15
3428,Lüky,malganis,986,demonhunter,havoc,22,11,11
3429,Suhui,sargeras,983,demonhunter,havoc,29,11,18
3430,Ethelric,frostmourne,982,demonhunter,havoc,83,30,53
3431,Doomhead,burning-legion,981,demonhunter,havoc,24,15,9
3432,Keeblerself,tichondrius,979,demonhunter,havoc,30,16,14
3433,Dbljump,kiljaeden,979,demonhunter,havoc,32,11,21
3434,Grûnt,sargeras,978,demonhunter,havoc,30,12,18
3435,Andarïel,bleeding-hollow,977,demonhunter,havoc,25,12,13
3436,Clorhídrico,quelthalas,975,demonhunter,havoc,98,48,50
3437,Purpsquirter,stormscale,974,demonhunter,havoc,39,20,19
3438,Jerrickah,skullcrusher,967,demonhunter,havoc,26,11,15
3439,Cercius,dalaran,966,demonhunter,havoc,36,11,25
3440,Vladdtepes,cairne,964,demonhunter,havoc,113,60,53
3441,Hypetraindh,kelthuzad,960,demonhunter,havoc,12,10,2
3442,Slayup,area-52,960,demonhunter,havoc,12,10,2
3443,Doomsday,kargath,960,demonhunter,havoc,12,10,2
3444,Noopstop,tichondrius,960,demonhunter,havoc,18,10,8
3445,Lancee,zuljin,960,demonhunter,havoc,24,10,14
3446,Roesh,amanthul,960,demonhunter,havoc,24,10,14
3447,Ntts,tichondrius,960,demonhunter,havoc,24,10,14
3448,Theownz,stormrage,959,demonhunter,havoc,18,10,8
3449,Demonleap,proudmoore,959,demonhunter,havoc,18,10,8
3450,Sourapple,barthilas,959,demonhunter,havoc,18,10,8
3451,Lakedemon,sargeras,959,demonhunter,havoc,18,10,8
3452,Myelvénlady,shattered-hand,959,demonhunter,havoc,18,10,8
3453,Thrania,lothar,959,demonhunter,havoc,24,10,14
3454,Misakidh,sargeras,959,demonhunter,havoc,24,10,14
3455,Dhuck,nemesis,959,demonhunter,havoc,27,11,16
3456,Khaodemus,kaelthas,958,demonhunter,havoc,12,10,2
3457,Cyånan,bleeding-hollow,958,demonhunter,havoc,23,14,9
3458,Çherrii,moon-guard,958,demonhunter,havoc,36,21,15
3459,Planeinsky,malganis,958,demonhunter,havoc,18,10,8
3460,Bronaanas,tichondrius,958,demonhunter,havoc,18,10,8
3461,Nightshadeia,tichondrius,958,demonhunter,havoc,30,10,20
3462,Krelious,barthilas,957,demonhunter,havoc,18,10,8
3463,Mybraintiny,illidan,957,demonhunter,havoc,21,11,10
3464,Randôm,kelthuzad,957,demonhunter,havoc,21,11,10
3465,Giantryhard,tichondrius,957,demonhunter,havoc,24,10,14
3466,Gilberte,stormrage,957,demonhunter,havoc,24,10,14
3467,Vishì,thrall,957,demonhunter,havoc,30,10,20
3468,Finelsite,area-52,956,demonhunter,havoc,18,10,8
3469,Tangoh,burning-legion,955,demonhunter,havoc,18,10,8
3470,Adycatt,illidan,955,demonhunter,havoc,18,10,8
3471,Sorrenta,ragnaros,955,demonhunter,havoc,21,11,10
3472,Jagidan,area-52,955,demonhunter,havoc,24,10,14
3473,Khatary,ragnaros,954,demonhunter,havoc,24,10,14
3474,Xibir,amanthul,953,demonhunter,havoc,24,10,14
3475,Onigirix,area-52,953,demonhunter,havoc,27,11,16
3476,Larnol,moon-guard,952,demonhunter,havoc,18,10,8
3477,Nerco,bleeding-hollow,952,demonhunter,havoc,24,10,14
3478,Vognum,quelthalas,951,demonhunter,havoc,21,11,10
3479,Airaxx,moon-guard,949,demonhunter,havoc,21,11,10
3480,Bukwheat,thunderhorn,949,demonhunter,havoc,84,41,43
3481,Letzgobrandn,silvermoon,948,demonhunter,havoc,18,10,8
3482,Kwoop,tichondrius,946,demonhunter,havoc,24,10,14
3483,Halfprepared,kelthuzad,946,demonhunter,havoc,30,10,20
3484,Demonizhe,thrall,944,demonhunter,havoc,43,22,21
3485,Elurandre,moon-guard,944,demonhunter,havoc,23,10,13
3486,Swansong,norgannon,944,demonhunter,havoc,30,13,17
3487,Rissélys,thrall,942,demonhunter,havoc,36,20,16
3488,Lingnafoxy,tichondrius,939,demonhunter,havoc,27,11,16
3489,Deegsdh,sargeras,932,demonhunter,havoc,27,10,17
3490,Clairconctla,spirestone,929,demonhunter,havoc,81,34,47
3491,Gozer,korialstrasz,929,demonhunter,havoc,36,12,24
3492,Lillidum,azralon,927,demonhunter,havoc,47,22,25
3493,Demonshep,proudmoore,925,demonhunter,havoc,22,10,12
3494,Frenchtoast,bonechewer,925,demonhunter,havoc,30,10,20
3495,Allukya,azralon,924,demonhunter,havoc,17,10,7
3496,Shawnchad,blood-furnace,923,demonhunter,havoc,181,90,91
3497,Lanathir,kirin-tor,919,demonhunter,havoc,30,11,19
3498,Troigh,thunderlord,912,demonhunter,havoc,60,29,31
3499,Aleymar,tichondrius,909,demonhunter,havoc,24,12,12
3500,Lory,eldrethalas,909,demonhunter,havoc,72,33,39
3501,Kslicedevil,dalaran,909,demonhunter,havoc,72,31,41
3502,Sitarok,drakkari,899,demonhunter,havoc,28,11,17
3503,Falaszun,aegwynn,889,demonhunter,havoc,20,10,10
3504,Tygerion,emerald-dream,885,demonhunter,havoc,22,10,12
3505,Creta,frostmourne,882,demonhunter,havoc,24,13,11
3506,Callmerebel,dragonblight,881,demonhunter,havoc,38,17,21
3507,Ripchimmii,illidan,880,demonhunter,havoc,25,10,15
3508,Andyhunter,emerald-dream,879,demonhunter,havoc,90,45,45
3509,Blacktocki,barthilas,878,demonhunter,havoc,22,10,12
3510,Äshês,blackhand,876,demonhunter,havoc,20,10,10
3511,Mikiller,thrall,873,demonhunter,havoc,127,62,65
3512,Lrianna,senjin,870,demonhunter,havoc,23,10,13
3513,Riicardo,ragnaros,870,demonhunter,havoc,28,12,16
3514,Faarkyou,barthilas,868,demonhunter,havoc,26,10,16
3515,Plsbegood,area-52,864,demonhunter,havoc,12,9,3
3516,Ravevê,area-52,864,demonhunter,havoc,12,9,3
3517,Cynthadra,frostmourne,864,demonhunter,havoc,12,9,3
3518,Banaphel,hellscream,864,demonhunter,havoc,12,9,3
3519,Pennyx,barthilas,864,demonhunter,havoc,12,9,3
3520,Dzdh,stormrage,864,demonhunter,havoc,18,9,9
3521,Tarro,whisperwind,864,demonhunter,havoc,18,9,9
3522,Benová,tichondrius,864,demonhunter,havoc,18,9,9
3523,Bammski,tichondrius,864,demonhunter,havoc,18,9,9
3524,Vandämn,barthilas,864,demonhunter,havoc,18,9,9
3525,Emicruz,quelthalas,864,demonhunter,havoc,18,9,9
3526,Artee,illidan,864,demonhunter,havoc,22,10,12
3527,Gameoverz,tichondrius,864,demonhunter,havoc,21,9,12
3528,Kronicz,frostmourne,864,demonhunter,havoc,24,9,15
3529,Paypaldh,malganis,864,demonhunter,havoc,24,9,15
3530,Noobender,malganis,864,demonhunter,havoc,30,9,21
3531,Mcgurty,illidan,864,demonhunter,havoc,30,9,21
3532,Ripidan,stormrage,864,demonhunter,havoc,30,9,21
3533,Furíøus,tichondrius,863,demonhunter,havoc,12,9,3
3534,Ottie,kelthuzad,863,demonhunter,havoc,12,9,3
3535,Luthianna,amanthul,863,demonhunter,havoc,12,9,3
3536,Rothdh,tichondrius,863,demonhunter,havoc,15,10,5
3537,Llivid,area-52,863,demonhunter,havoc,18,9,9
3538,Jiawen,barthilas,863,demonhunter,havoc,18,9,9
3539,Lördvïngadør,azralon,863,demonhunter,havoc,18,9,9
3540,Mondwin,kelthuzad,863,demonhunter,havoc,18,9,9
3541,Orosz,bleeding-hollow,863,demonhunter,havoc,18,9,9
3542,Dogcleave,area-52,863,demonhunter,havoc,18,9,9
3543,Nismoos,daggerspine,863,demonhunter,havoc,18,9,9
3544,Worldahmelee,illidan,863,demonhunter,havoc,18,9,9
3545,Shaydh,frostmourne,863,demonhunter,havoc,18,9,9
3546,Soñic,frostmourne,863,demonhunter,havoc,18,9,9
3547,Checkmate,bleeding-hollow,863,demonhunter,havoc,24,9,15
3548,Dragynfíst,malganis,863,demonhunter,havoc,30,9,21
3549,Vareon,nesingwary,862,demonhunter,havoc,12,9,3
3550,Trenbolognie,illidan,862,demonhunter,havoc,18,9,9
3551,Lucipur,thrall,862,demonhunter,havoc,18,9,9
3552,Rizzle,malganis,862,demonhunter,havoc,18,9,9
3553,Dishdash,agamaggan,862,demonhunter,havoc,18,9,9
3554,Vida,winterhoof,862,demonhunter,havoc,18,9,9
3555,Moranah,tichondrius,862,demonhunter,havoc,18,9,9
3556,Valeriya,frostmourne,862,demonhunter,havoc,24,9,15
3557,Kickabout,deathwing,862,demonhunter,havoc,24,9,15
3558,Felhunt,ragnaros,861,demonhunter,havoc,24,9,15
3559,Psicxs,ragnaros,861,demonhunter,havoc,24,9,15
3560,Frostidan,sargeras,861,demonhunter,havoc,24,9,15
3561,Hellboss,dalaran,860,demonhunter,havoc,12,9,3
3562,Zirrey,stormrage,860,demonhunter,havoc,18,9,9
3563,Bodemön,stormrage,860,demonhunter,havoc,18,9,9
3564,Unóhana,drakkari,860,demonhunter,havoc,18,9,9
3565,Rèlentless,moon-guard,860,demonhunter,havoc,18,9,9
3566,Successful,area-52,860,demonhunter,havoc,24,9,15
3567,Alphmega,malganis,859,demonhunter,havoc,18,9,9
3568,Smokahontas,eredar,859,demonhunter,havoc,18,9,9
3569,Bigbubbaa,azgalor,859,demonhunter,havoc,24,9,15
3570,Diizy,illidan,858,demonhunter,havoc,18,9,9
3571,Itsskaa,illidan,858,demonhunter,havoc,24,9,15
3572,Dartanyn,tichondrius,853,demonhunter,havoc,24,9,15
3573,Drackista,stormrage,852,demonhunter,havoc,18,9,9
3574,Tdmturbo,zuluhed,849,demonhunter,havoc,18,9,9
3575,Sharinne,frostmourne,849,demonhunter,havoc,24,9,15
3576,Jakodh,sargeras,848,demonhunter,havoc,18,9,9
3577,Kellndore,emerald-dream,848,demonhunter,havoc,54,26,28
3578,Aussiepleb,nagrand,846,demonhunter,havoc,87,37,50
3579,Ryutt,illidan,845,demonhunter,havoc,18,9,9
3580,Dalmandra,arthas,841,demonhunter,havoc,17,9,8
3581,Syldaeya,silvermoon,838,demonhunter,havoc,22,11,11
3582,Abusedchild,dalaran,837,demonhunter,havoc,36,16,20
3583,Funky,draenor,832,demonhunter,havoc,36,18,18
3584,Fckyouscott,illidan,830,demonhunter,havoc,14,10,4
3585,Toteschatte,quelthalas,829,demonhunter,havoc,30,10,20
3586,Necrødh,tichondrius,828,demonhunter,havoc,16,9,7
3587,Amneshia,ragnaros,828,demonhunter,havoc,18,9,9
3588,Romïna,quelthalas,827,demonhunter,havoc,24,10,14
3589,Negraxo,ragnaros,818,demonhunter,havoc,29,9,20
3590,Myname,aggramar,818,demonhunter,havoc,62,15,47
3591,Chabashira,tichondrius,815,demonhunter,havoc,24,9,15
3592,Cassiedemonh,tichondrius,815,demonhunter,havoc,27,10,17
3593,Healinfubar,stormrage,814,demonhunter,havoc,15,10,5
3594,Pariah,saurfang,813,demonhunter,havoc,17,9,8
3595,Antistar,emerald-dream,799,demonhunter,havoc,26,9,17
3596,Demonci,stormrage,795,demonhunter,havoc,20,11,9
3597,Anaríel,quelthalas,788,demonhunter,havoc,30,9,21
3598,Jellehx,frostmourne,784,demonhunter,havoc,13,9,4
3599,Grolschen,proudmoore,784,demonhunter,havoc,42,16,26
3600,Nasolar,illidan,783,demonhunter,havoc,17,9,8
3601,Wut,nemesis,777,demonhunter,havoc,101,47,54
3602,Rza,dreadmaul,774,demonhunter,havoc,28,11,17
3603,Msbadass,demon-soul,773,demonhunter,havoc,25,9,16
3604,Neshaan,stormreaver,770,demonhunter,havoc,48,24,24
3605,Ðamageinc,emerald-dream,768,demonhunter,havoc,12,8,4
3606,Revzxy,dalaran,768,demonhunter,havoc,12,8,4
3607,Thickgary,illidan,768,demonhunter,havoc,12,8,4
3608,Deuzz,arthas,768,demonhunter,havoc,12,8,4
3609,Mesidan,illidan,768,demonhunter,havoc,12,8,4
3610,Helltaker,blood-furnace,768,demonhunter,havoc,12,8,4
3611,Surkkdh,tichondrius,768,demonhunter,havoc,12,8,4
3612,Squaller,tichondrius,768,demonhunter,havoc,12,8,4
3613,Dulcibella,tichondrius,768,demonhunter,havoc,12,8,4
3614,Liarsenics,tichondrius,768,demonhunter,havoc,12,8,4
3615,Humanitydh,sargeras,768,demonhunter,havoc,12,8,4
3616,Thugonomicz,tichondrius,768,demonhunter,havoc,12,8,4
3617,Doomanone,sargeras,768,demonhunter,havoc,12,8,4
3618,Vàin,ragnaros,768,demonhunter,havoc,12,8,4
3619,Ùnlucky,tichondrius,768,demonhunter,havoc,12,8,4
3620,Cálýpsó,tichondrius,768,demonhunter,havoc,12,8,4
3621,Kalachiquez,sargeras,768,demonhunter,havoc,12,8,4
3622,Lxg,kelthuzad,768,demonhunter,havoc,12,8,4
3623,Odemy,area-52,768,demonhunter,havoc,12,8,4
3624,Hollowxo,tichondrius,768,demonhunter,havoc,12,8,4
3625,Cegocruel,sargeras,768,demonhunter,havoc,13,8,5
3626,Pub,the-scryers,768,demonhunter,havoc,15,9,6
3627,Sero,malganis,768,demonhunter,havoc,18,8,10
3628,Veilmaya,arthas,768,demonhunter,havoc,18,8,10
3629,Everdh,barthilas,768,demonhunter,havoc,18,8,10
3630,Gilarian,stormrage,768,demonhunter,havoc,18,8,10
3631,Devssimpspec,sargeras,768,demonhunter,havoc,18,8,10
3632,Fingól,ragnaros,768,demonhunter,havoc,18,8,10
3633,Zuppashi,area-52,768,demonhunter,havoc,18,8,10
3634,Neverblurx,kirin-tor,768,demonhunter,havoc,18,8,10
3635,Doomantwo,sargeras,768,demonhunter,havoc,24,8,16
3636,Bdwxxnmm,tichondrius,768,demonhunter,havoc,24,8,16
3637,Xorothia,moon-guard,768,demonhunter,havoc,24,8,16
3638,Fuujiin,tol-barad,768,demonhunter,havoc,24,8,16
3639,Diemonic,drakkari,767,demonhunter,havoc,12,8,4
3640,Blackblades,blackhand,767,demonhunter,havoc,12,8,4
3641,Prazethesun,emerald-dream,767,demonhunter,havoc,12,8,4
3642,Friel,magtheridon,767,demonhunter,havoc,12,8,4
3643,Myspyhu,malganis,767,demonhunter,havoc,12,8,4
3644,Zaelos,tichondrius,767,demonhunter,havoc,12,8,4
3645,Badwurd,sargeras,767,demonhunter,havoc,12,8,4
3646,Ziyàl,vashj,767,demonhunter,havoc,12,8,4
3647,Hellrazer,area-52,767,demonhunter,havoc,12,8,4
3648,Iyren,sargeras,767,demonhunter,havoc,12,8,4
3649,Lethalblows,darkspear,767,demonhunter,havoc,15,9,6
3650,Linedori,destromath,767,demonhunter,havoc,16,9,7
3651,Devî,ragnaros,767,demonhunter,havoc,18,8,10
3652,Demonqt,blackrock,767,demonhunter,havoc,18,8,10
3653,Oddlysimple,korgath,767,demonhunter,havoc,18,8,10
3654,Ozaiï,tichondrius,767,demonhunter,havoc,18,8,10
3655,ßonècrushèr,tichondrius,767,demonhunter,havoc,18,8,10
3656,Crtiicosdh,madoran,767,demonhunter,havoc,18,8,10
3657,Feldumper,illidan,767,demonhunter,havoc,18,8,10
3658,Xenosa,kiljaeden,767,demonhunter,havoc,18,8,10
3659,Acclimate,aggramar,767,demonhunter,havoc,18,8,10
3660,Eithelyrana,moon-guard,767,demonhunter,havoc,18,8,10
3661,Dhfaceguy,agamaggan,767,demonhunter,havoc,18,8,10
3662,Blurnomnom,bleeding-hollow,767,demonhunter,havoc,18,8,10
3663,Hellrazer,azgalor,767,demonhunter,havoc,18,8,10
3664,Chkclapper,kelthuzad,767,demonhunter,havoc,18,8,10
3665,Kruptikos,tichondrius,767,demonhunter,havoc,18,8,10
3666,Draagee,lothar,767,demonhunter,havoc,21,9,12
3667,Zradda,zuljin,767,demonhunter,havoc,24,8,16
3668,Andein,dalaran,766,demonhunter,havoc,12,8,4
3669,Wólff,azralon,766,demonhunter,havoc,12,8,4
3670,Thunderrbolt,illidan,766,demonhunter,havoc,12,8,4
3671,Hyperaids,sargeras,766,demonhunter,havoc,18,8,10
3672,Thalkituun,sargeras,766,demonhunter,havoc,18,8,10
3673,Touchofchaos,dragonblight,766,demonhunter,havoc,18,8,10
3674,Ezuna,proudmoore,766,demonhunter,havoc,18,8,10
3675,Accipiter,ragnaros,766,demonhunter,havoc,24,8,16
3676,Shadowdark,aggramar,766,demonhunter,havoc,24,8,16
3677,Moorzans,malganis,765,demonhunter,havoc,12,8,4
3678,Bholez,illidan,765,demonhunter,havoc,18,8,10
3679,Detrox,ragnaros,765,demonhunter,havoc,18,8,10
3680,Uchulu,quelthalas,765,demonhunter,havoc,24,8,16
3681,Lû,arthas,765,demonhunter,havoc,24,8,16
3682,Schishkabob,archimonde,764,demonhunter,havoc,18,8,10
3683,Sodiaksd,quelthalas,762,demonhunter,havoc,18,8,10
3684,Gentlesoap,blackrock,762,demonhunter,havoc,18,8,10
3685,Ceried,moon-guard,761,demonhunter,havoc,19,9,10
3686,Wargeneral,illidan,760,demonhunter,havoc,18,8,10
3687,Breezoo,tichondrius,759,demonhunter,havoc,12,8,4
3688,Akumahanta,aegwynn,759,demonhunter,havoc,12,8,4
3689,Felbottom,tichondrius,759,demonhunter,havoc,14,8,6
3690,Illhuntya,bonechewer,758,demonhunter,havoc,18,8,10
3691,Suyu,ragnaros,758,demonhunter,havoc,21,8,13
3692,Maydemon,ragnaros,757,demonhunter,havoc,30,8,22
3693,Teethdaggers,wyrmrest-accord,756,demonhunter,havoc,12,8,4
3694,Eksorcism,muradin,755,demonhunter,havoc,12,8,4
3695,Rrochy,tichondrius,755,demonhunter,havoc,18,8,10
3696,Covidneitor,drakkari,752,demonhunter,havoc,24,8,16
3697,Bckzy,malygos,751,demonhunter,havoc,18,8,10
3698,Sammblorqt,illidan,751,demonhunter,havoc,36,8,28
3699,Menadori,madoran,748,demonhunter,havoc,18,8,10
3700,Ottonashii,ragnaros,741,demonhunter,havoc,32,8,24
3701,Leg,scilla,736,demonhunter,havoc,22,8,14
3702,Elena,the-underbog,735,demonhunter,havoc,16,8,8
3703,Ryoga,malganis,734,demonhunter,havoc,15,9,6
3704,Wuya,thrall,734,demonhunter,havoc,22,8,14
3705,Valeriann,thunderlord,721,demonhunter,havoc,22,11,11
3706,Hiresol,emerald-dream,719,demonhunter,havoc,11,8,3
3707,Sephmilli,azralon,713,demonhunter,havoc,27,9,18
3708,Pupariuh,illidan,706,demonhunter,havoc,25,9,16
3709,Rivent,dethecus,702,demonhunter,havoc,26,8,18
3710,Memoryleaky,proudmoore,696,demonhunter,havoc,11,8,3
3711,Verå,tichondrius,672,demonhunter,havoc,12,7,5
3712,Zanoxis,tichondrius,672,demonhunter,havoc,12,7,5
3713,Ocão,azralon,672,demonhunter,havoc,12,7,5
3714,Danyohl,kelthuzad,672,demonhunter,havoc,12,7,5
3715,Evelynee,illidan,672,demonhunter,havoc,12,7,5
3716,Hydrocodeine,moon-guard,672,demonhunter,havoc,12,7,5
3717,Smallsuper,azralon,672,demonhunter,havoc,12,7,5
3718,Nichidah,illidan,672,demonhunter,havoc,12,7,5
3719,Endofdaysx,tichondrius,672,demonhunter,havoc,12,7,5
3720,Xenious,terokkar,672,demonhunter,havoc,12,7,5
3721,Dæl,quelthalas,672,demonhunter,havoc,12,7,5
3722,Solbiz,tichondrius,672,demonhunter,havoc,12,7,5
3723,Warassassin,stormrage,672,demonhunter,havoc,12,7,5
3724,Levail,wyrmrest-accord,672,demonhunter,havoc,12,7,5
3725,Dimônio,stormrage,672,demonhunter,havoc,12,7,5
3726,Dryback,illidan,672,demonhunter,havoc,12,7,5
3727,Reddh,bleeding-hollow,672,demonhunter,havoc,12,7,5
3728,Dabsfordayz,zuluhed,672,demonhunter,havoc,12,7,5
3729,Stalaias,madoran,672,demonhunter,havoc,12,7,5
3730,Slaarky,malganis,672,demonhunter,havoc,12,7,5
3731,Vichopan,tichondrius,672,demonhunter,havoc,12,7,5
3732,Deeploss,malganis,672,demonhunter,havoc,12,7,5
3733,Uncledonnie,tanaris,672,demonhunter,havoc,12,7,5
3734,Darthwhorë,frostmane,672,demonhunter,havoc,12,7,5
3735,Nightcráwler,malganis,672,demonhunter,havoc,12,7,5
3736,Bq,feathermoon,672,demonhunter,havoc,12,7,5
3737,Igotdc,tichondrius,672,demonhunter,havoc,13,7,6
3738,Flamehunter,durotan,672,demonhunter,havoc,13,7,6
3739,Darkterrôr,sargeras,672,demonhunter,havoc,15,8,7
3740,Phillswift,tichondrius,672,demonhunter,havoc,18,7,11
3741,Vorlimornd,illidan,672,demonhunter,havoc,18,7,11
3742,Foxfighter,thrall,672,demonhunter,havoc,18,7,11
3743,Elchapotko,tichondrius,672,demonhunter,havoc,18,7,11
3744,Machx,illidan,672,demonhunter,havoc,18,7,11
3745,Emodan,moon-guard,672,demonhunter,havoc,18,7,11
3746,Dgj,kelthuzad,672,demonhunter,havoc,18,7,11
3747,Cheezitzz,tichondrius,672,demonhunter,havoc,18,7,11
3748,Yasuo,moon-guard,672,demonhunter,havoc,18,7,11
3749,Louferrigno,zuljin,672,demonhunter,havoc,18,7,11
3750,Zózo,bleeding-hollow,672,demonhunter,havoc,18,7,11
3751,Blanky,shadowmoon,672,demonhunter,havoc,18,7,11
3752,Moistybreeze,frostmourne,672,demonhunter,havoc,18,7,11
3753,Pantyogurt,frostmourne,672,demonhunter,havoc,18,7,11
3754,Faceurdemons,frostmourne,672,demonhunter,havoc,18,7,11
3755,Dumbledor,stonemaul,672,demonhunter,havoc,18,7,11
3756,Boonchux,frostmourne,672,demonhunter,havoc,18,7,11
3757,Demonchild,azralon,672,demonhunter,havoc,18,7,11
3758,Dartro,tichondrius,672,demonhunter,havoc,20,7,13
3759,Logixdh,tichondrius,672,demonhunter,havoc,30,7,23
3760,Ellguindh,malganis,672,demonhunter,havoc,30,7,23
3761,Fiebzz,queldorei,671,demonhunter,havoc,12,7,5
3762,Wìnchester,durotan,671,demonhunter,havoc,12,7,5
3763,Wheytoohigh,area-52,671,demonhunter,havoc,12,7,5
3764,Cascadingeye,emerald-dream,671,demonhunter,havoc,12,7,5
3765,Alycina,wyrmrest-accord,671,demonhunter,havoc,12,7,5
3766,Jolty,stormrage,671,demonhunter,havoc,12,7,5
3767,Wìtchblades,tichondrius,671,demonhunter,havoc,12,7,5
3768,Relaxnerdss,bleeding-hollow,671,demonhunter,havoc,12,7,5
3769,Moredread,sargeras,671,demonhunter,havoc,12,7,5
3770,Mavrii,executus,671,demonhunter,havoc,12,7,5
3771,Ivalerà,thrall,671,demonhunter,havoc,12,7,5
3772,Seabisciut,silvermoon,671,demonhunter,havoc,12,7,5
3773,Zarroe,stormrage,671,demonhunter,havoc,12,7,5
3774,Dhameer,tichondrius,671,demonhunter,havoc,12,7,5
3775,Stormville,illidan,671,demonhunter,havoc,12,7,5
3776,Starianor,proudmoore,671,demonhunter,havoc,16,9,7
3777,Furfur,undermine,671,demonhunter,havoc,16,7,9
3778,Sreedhar,stormrage,671,demonhunter,havoc,18,7,11
3779,Causinghavoc,dalaran,671,demonhunter,havoc,18,7,11
3780,Haax,azralon,671,demonhunter,havoc,18,7,11
3781,Älönë,thrall,671,demonhunter,havoc,18,7,11
3782,Nicòrobin,dalaran,671,demonhunter,havoc,18,7,11
3783,Sektõr,dalaran,671,demonhunter,havoc,18,7,11
3784,Hyphonìc,area-52,671,demonhunter,havoc,18,7,11
3785,Asamir,ragnaros,671,demonhunter,havoc,19,7,12
3786,Veryaverage,kelthuzad,671,demonhunter,havoc,24,7,17
3787,Ãstoreth,quelthalas,670,demonhunter,havoc,12,7,5
3788,Renshear,cenarius,670,demonhunter,havoc,12,7,5
3789,Shwagxnugz,area-52,670,demonhunter,havoc,12,7,5
3790,Aphy,thunderhorn,670,demonhunter,havoc,18,7,11
3791,Mattdaemun,korgath,670,demonhunter,havoc,18,7,11
3792,Zanaiahs,sargeras,670,demonhunter,havoc,21,7,14
3793,Claudija,frostmourne,669,demonhunter,havoc,12,7,5
3794,Kylíejennêr,gilneas,669,demonhunter,havoc,12,7,5
3795,Stepbroseph,kiljaeden,669,demonhunter,havoc,15,8,7
3796,Spikehed,area-52,669,demonhunter,havoc,24,7,17
3797,Denjii,malganis,669,demonhunter,havoc,24,7,17
3798,Demonbanter,emerald-dream,668,demonhunter,havoc,15,8,7
3799,Irìs,blood-furnace,668,demonhunter,havoc,24,7,17
3800,Pimm,kelthuzad,667,demonhunter,havoc,12,7,5
3801,Bgeames,area-52,667,demonhunter,havoc,12,7,5
3802,Snòòp,uldaman,667,demonhunter,havoc,12,7,5
3803,Haterad,bonechewer,667,demonhunter,havoc,24,7,17
3804,Gretadumberg,area-52,666,demonhunter,havoc,12,7,5
3805,Onoky,cairne,666,demonhunter,havoc,18,7,11
3806,Rahgoul,garrosh,666,demonhunter,havoc,18,7,11
3807,Sanllish,illidan,666,demonhunter,havoc,18,7,11
3808,Endoshiva,icecrown,666,demonhunter,havoc,18,7,11
3809,Genifer,norgannon,665,demonhunter,havoc,12,7,5
3810,Pvpchump,malygos,665,demonhunter,havoc,18,7,11
3811,Pradaboi,tichondrius,665,demonhunter,havoc,30,7,23
3812,Turbochadbro,spirestone,663,demonhunter,havoc,15,8,7
3813,Chohpz,silvermoon,662,demonhunter,havoc,19,8,11
3814,Rhydonx,korgath,662,demonhunter,havoc,18,7,11
3815,Whitexheart,illidan,661,demonhunter,havoc,12,7,5
3816,Eckerstrom,tichondrius,659,demonhunter,havoc,12,7,5
3817,Supremetaco,stormrage,659,demonhunter,havoc,12,7,5
3818,Malrax,drakkari,658,demonhunter,havoc,18,7,11
3819,Luzev,thrall,657,demonhunter,havoc,12,7,5
3820,Veierax,azralon,656,demonhunter,havoc,18,7,11
3821,Ripperxx,zuljin,653,demonhunter,havoc,18,7,11
3822,Lëif,stormrage,652,demonhunter,havoc,18,7,11
3823,Forzaken,darkspear,647,demonhunter,havoc,18,7,11
3824,Gwîlym,area-52,644,demonhunter,havoc,14,9,5
3825,Darkrais,sargeras,635,demonhunter,havoc,17,7,10
3826,Bliqué,emerald-dream,633,demonhunter,havoc,17,7,10
3827,Bigtitiemilk,tichondrius,623,demonhunter,havoc,11,7,4
3828,Ïtzpåpåløtl,tichondrius,623,demonhunter,havoc,11,7,4
3829,Gebblemon,aerie-peak,623,demonhunter,havoc,17,7,10
3830,Hidan,velen,621,demonhunter,havoc,14,8,6
3831,Triplex,moknathal,620,demonhunter,havoc,24,7,17
3832,Highpower,area-52,618,demonhunter,havoc,26,9,17
3833,Mqvdh,area-52,618,demonhunter,havoc,39,8,31
3834,Galaxezz,bonechewer,612,demonhunter,havoc,15,8,7
3835,Soure,azralon,607,demonhunter,havoc,20,7,13
3836,Wualicho,ragnaros,603,demonhunter,havoc,24,8,16
3837,Demonicway,stormrage,592,demonhunter,havoc,16,7,9
3838,Runecaster,anvilmar,587,demonhunter,havoc,11,7,4
3839,Ghostatlas,tichondrius,576,demonhunter,havoc,6,6,0
3840,Solriel,malganis,576,demonhunter,havoc,12,6,6
3841,Minhzie,moon-guard,576,demonhunter,havoc,12,6,6
3842,Deathschosen,malganis,576,demonhunter,havoc,12,6,6
3843,Aertillian,ragnaros,576,demonhunter,havoc,12,6,6
3844,Venmora,argent-dawn,576,demonhunter,havoc,12,6,6
3845,Felraiser,stormrage,576,demonhunter,havoc,12,6,6
3846,Gameoverdh,tichondrius,576,demonhunter,havoc,12,6,6
3847,Abadina,illidan,576,demonhunter,havoc,12,6,6
3848,Discos,frostmourne,576,demonhunter,havoc,12,6,6
3849,Yikari,stormrage,576,demonhunter,havoc,12,6,6
3850,Slapxy,illidan,576,demonhunter,havoc,12,6,6
3851,Fanc,sargeras,576,demonhunter,havoc,12,6,6
3852,Audara,sargeras,576,demonhunter,havoc,12,6,6
3853,Seya,tichondrius,576,demonhunter,havoc,12,6,6
3854,Bossdh,zuljin,576,demonhunter,havoc,12,6,6
3855,Evelynvc,illidan,576,demonhunter,havoc,12,6,6
3856,Whatdagoof,tichondrius,576,demonhunter,havoc,12,6,6
3857,Qvibes,tichondrius,576,demonhunter,havoc,12,6,6
3858,Ânubîs,quelthalas,576,demonhunter,havoc,12,6,6
3859,Soloqisthefu,blackrock,576,demonhunter,havoc,12,6,6
3860,Gommademon,illidan,576,demonhunter,havoc,12,6,6
3861,Nowaifai,tichondrius,576,demonhunter,havoc,12,6,6
3862,Daggertooth,tichondrius,576,demonhunter,havoc,12,6,6
3863,Carlosjr,stormrage,576,demonhunter,havoc,12,6,6
3864,Twotrucks,kelthuzad,576,demonhunter,havoc,12,6,6
3865,Hunttblacke,ragnaros,576,demonhunter,havoc,12,6,6
3866,Teleai,kaelthas,576,demonhunter,havoc,12,6,6
3867,Demontoid,azgalor,576,demonhunter,havoc,12,6,6
3868,Morgoph,burning-legion,576,demonhunter,havoc,12,6,6
3869,Weskerz,illidan,576,demonhunter,havoc,12,6,6
3870,Pabloh,trollbane,576,demonhunter,havoc,12,6,6
3871,Zyer,mannoroth,576,demonhunter,havoc,12,6,6
3872,Shinigameez,proudmoore,576,demonhunter,havoc,12,6,6
3873,Reenah,exodar,576,demonhunter,havoc,12,6,6
3874,Merzinator,korgath,576,demonhunter,havoc,12,6,6
3875,Chicletim,azralon,576,demonhunter,havoc,12,6,6
3876,Thunderlor,malganis,576,demonhunter,havoc,12,6,6
3877,Stets,emerald-dream,576,demonhunter,havoc,12,6,6
3878,Manmilker,bleeding-hollow,576,demonhunter,havoc,12,6,6
3879,Numrasiel,drakkari,576,demonhunter,havoc,12,6,6
3880,Lettüceprey,sargeras,576,demonhunter,havoc,12,6,6
3881,Metakigai,hyjal,576,demonhunter,havoc,12,6,6
3882,Tomglaiven,hyjal,576,demonhunter,havoc,12,6,6
3883,Niteclawla,illidan,576,demonhunter,havoc,12,6,6
3884,Siqx,arthas,576,demonhunter,havoc,12,6,6
3885,Kürosh,kalecgos,576,demonhunter,havoc,12,6,6
3886,Grümb,earthen-ring,576,demonhunter,havoc,12,6,6
3887,Trampstampz,darkspear,576,demonhunter,havoc,12,6,6
3888,Basdminority,bleeding-hollow,576,demonhunter,havoc,12,6,6
3889,Zenage,area-52,576,demonhunter,havoc,12,6,6
3890,Ahsoka,arygos,576,demonhunter,havoc,15,7,8
3891,Kelan,borean-tundra,576,demonhunter,havoc,18,6,12
3892,Tresbotones,kelthuzad,576,demonhunter,havoc,18,6,12
3893,Pikächú,stormrage,576,demonhunter,havoc,18,6,12
3894,Kungfudh,illidan,576,demonhunter,havoc,18,6,12
3895,Kålî,kiljaeden,576,demonhunter,havoc,18,6,12
3896,Gayrio,sargeras,576,demonhunter,havoc,18,6,12
3897,Mavrel,moon-guard,576,demonhunter,havoc,18,6,12
3898,Xyntel,tichondrius,576,demonhunter,havoc,18,6,12
3899,Vyrai,lightbringer,576,demonhunter,havoc,18,6,12
3900,Sailtheskys,tichondrius,576,demonhunter,havoc,18,6,12
3901,Zümanity,zangarmarsh,576,demonhunter,havoc,18,6,12
3902,Kyndrellesa,illidan,576,demonhunter,havoc,18,6,12
3903,Icanseeyou,aerie-peak,576,demonhunter,havoc,18,6,12
3904,Abscarnage,ragnaros,576,demonhunter,havoc,18,6,12
3905,Djkelly,tichondrius,576,demonhunter,havoc,24,6,18
3906,Lysol,darrowmere,575,demonhunter,havoc,12,6,6
3907,Eyesyk,bonechewer,575,demonhunter,havoc,12,6,6
3908,Gurthbrookz,tichondrius,575,demonhunter,havoc,12,6,6
3909,Cholula,korgath,575,demonhunter,havoc,12,6,6
3910,Smoothtaco,azshara,575,demonhunter,havoc,12,6,6
3911,Veladoria,malorne,575,demonhunter,havoc,12,6,6
3912,Hootyeahbou,shattered-hand,575,demonhunter,havoc,12,6,6
3913,Hottacos,stormrage,575,demonhunter,havoc,12,6,6
3914,Deepde,tichondrius,575,demonhunter,havoc,12,6,6
3915,Tugï,tichondrius,575,demonhunter,havoc,12,6,6
3916,Liquidblaze,elune,575,demonhunter,havoc,12,6,6
3917,ßatmañ,barthilas,575,demonhunter,havoc,18,6,12
3918,Finnanutt,tichondrius,575,demonhunter,havoc,18,6,12
3919,Jalet,azralon,575,demonhunter,havoc,18,6,12
3920,Ýizl,ragnaros,575,demonhunter,havoc,18,6,12
3921,Whezka,ragnaros,575,demonhunter,havoc,18,6,12
3922,Salveya,stormrage,575,demonhunter,havoc,20,6,14
3923,Toxicimpulse,aegwynn,574,demonhunter,havoc,12,6,6
3924,Solorialorth,shadowsong,574,demonhunter,havoc,12,6,6
3925,Touched,guldan,574,demonhunter,havoc,12,6,6
3926,Casualdemon,emerald-dream,574,demonhunter,havoc,12,6,6
3927,Haikal,proudmoore,574,demonhunter,havoc,12,6,6
3928,Ðruh,kelthuzad,574,demonhunter,havoc,18,6,12
3929,Kunitsuna,thunderlord,574,demonhunter,havoc,18,6,12
3930,Trekt,blades-edge,574,demonhunter,havoc,18,6,12
3931,Firesworn,zuljin,573,demonhunter,havoc,12,6,6
3932,Kimchiman,tichondrius,573,demonhunter,havoc,16,7,9
3933,Adayinthelif,proudmoore,573,demonhunter,havoc,18,6,12
3934,Slaytan,darkspear,573,demonhunter,havoc,18,6,12
3935,Eggandpotato,saurfang,571,demonhunter,havoc,12,6,6
3936,Darckside,sargeras,571,demonhunter,havoc,12,6,6
3937,Lanistus,bloodhoof,570,demonhunter,havoc,18,6,12
3938,Rampyr,terokkar,569,demonhunter,havoc,12,6,6
3939,Kreel,ghostlands,568,demonhunter,havoc,12,6,6
3940,Thjoannys,illidan,567,demonhunter,havoc,12,6,6
3941,Roderika,amanthul,566,demonhunter,havoc,12,6,6
3942,Elpis,tanaris,565,demonhunter,havoc,14,6,8
3943,Byzzel,barthilas,559,demonhunter,havoc,17,6,11
3944,Thendoral,ragnaros,543,demonhunter,havoc,22,6,16
3945,Junsa,darkspear,527,demonhunter,havoc,11,6,5
3946,Pumppimp,stormrage,527,demonhunter,havoc,11,6,5
3947,Shizune,boulderfist,525,demonhunter,havoc,11,6,5
3948,Gulios,azralon,522,demonhunter,havoc,20,7,13
3949,Fifteentolyf,illidan,520,demonhunter,havoc,11,6,5
3950,Wickedlurker,sargeras,519,demonhunter,havoc,17,9,8
3951,Tosilia,tichondrius,511,demonhunter,havoc,8,6,2
3952,Xytonic,bleeding-hollow,511,demonhunter,havoc,11,6,5
3953,Cloudzzy,illidan,511,demonhunter,havoc,14,6,8
3954,Isedelica,area-52,510,demonhunter,havoc,11,6,5
3955,Vessarin,madoran,510,demonhunter,havoc,20,6,14
3956,Ryemortis,malganis,510,demonhunter,havoc,20,6,14
3957,Ljevilin,gilneas,480,demonhunter,havoc,6,5,1
3958,Twobuttonszz,tichondrius,480,demonhunter,havoc,6,5,1
3959,Isabellaluna,illidan,480,demonhunter,havoc,6,5,1
3960,Remix,draka,480,demonhunter,havoc,6,5,1
3961,Plecoptera,wyrmrest-accord,480,demonhunter,havoc,6,5,1
3962,Med,wyrmrest-accord,480,demonhunter,havoc,6,5,1
3963,Ryntx,moon-guard,480,demonhunter,havoc,6,5,1
3964,Pumpñdump,echo-isles,480,demonhunter,havoc,6,5,1
3965,Damador,malganis,480,demonhunter,havoc,6,5,1
3966,Tîtø,quelthalas,480,demonhunter,havoc,6,5,1
3967,Kyndh,illidan,480,demonhunter,havoc,6,5,1
3968,Kyndris,ghostlands,480,demonhunter,havoc,6,5,1
3969,Lumh,quelthalas,480,demonhunter,havoc,6,5,1
3970,Stunnashades,hellscream,480,demonhunter,havoc,6,5,1
3971,Milfhuñter,sargeras,480,demonhunter,havoc,6,5,1
3972,Twistedways,tichondrius,480,demonhunter,havoc,6,5,1
3973,Pristager,tichondrius,480,demonhunter,havoc,6,5,1
3974,Densewench,stormrage,480,demonhunter,havoc,12,5,7
3975,Photuris,moon-guard,480,demonhunter,havoc,12,5,7
3976,Wwdh,stormrage,480,demonhunter,havoc,12,5,7
3977,Rizalo,frostmane,480,demonhunter,havoc,12,5,7
3978,Muffjuice,emerald-dream,480,demonhunter,havoc,12,5,7
3979,Untouchèd,bleeding-hollow,480,demonhunter,havoc,12,5,7
3980,Bellysniffer,illidan,480,demonhunter,havoc,12,5,7
3981,Delaían,drakkari,480,demonhunter,havoc,12,5,7
3982,Illidam,arthas,480,demonhunter,havoc,12,5,7
3983,Borekkarxqt,emerald-dream,480,demonhunter,havoc,12,5,7
3984,Anthvedroth,area-52,480,demonhunter,havoc,12,5,7
3985,Cosbied,area-52,480,demonhunter,havoc,12,5,7
3986,Revzdh,illidan,480,demonhunter,havoc,12,5,7
3987,Touchmeweird,area-52,480,demonhunter,havoc,12,5,7
3988,Hyptonique,queldorei,480,demonhunter,havoc,12,5,7
3989,Tyrele,drakkari,480,demonhunter,havoc,12,5,7
3990,Onbloodfam,kelthuzad,480,demonhunter,havoc,12,5,7
3991,Azuki,lightbringer,480,demonhunter,havoc,12,5,7
3992,Lìttlê,runetotem,480,demonhunter,havoc,12,5,7
3993,Zlr,bleeding-hollow,480,demonhunter,havoc,12,5,7
3994,Domeemommy,moon-guard,480,demonhunter,havoc,12,5,7
3995,Bátmañ,stormrage,480,demonhunter,havoc,12,5,7
3996,Roughcut,blackrock,480,demonhunter,havoc,12,5,7
3997,Chewyd,illidan,480,demonhunter,havoc,12,5,7
3998,Goodrink,tichondrius,480,demonhunter,havoc,12,5,7
3999,Waos,maelstrom,480,demonhunter,havoc,12,5,7
4000,Dontplanahea,tichondrius,480,demonhunter,havoc,12,5,7
4001,Slapxy,kelthuzad,480,demonhunter,havoc,12,5,7
4002,Izruul,tichondrius,480,demonhunter,havoc,12,5,7
4003,Feka,darkspear,480,demonhunter,havoc,12,5,7
4004,Zarosong,illidan,480,demonhunter,havoc,12,5,7
4005,Besoween,tichondrius,480,demonhunter,havoc,12,5,7
4006,Slashdh,stormrage,480,demonhunter,havoc,12,5,7
4007,Hippygamer,frostmourne,480,demonhunter,havoc,12,5,7
4008,Zelfyrã,malganis,480,demonhunter,havoc,12,5,7
4009,Axldh,tichondrius,480,demonhunter,havoc,12,5,7
4010,Dhworm,azralon,480,demonhunter,havoc,12,5,7
4011,Køugami,azralon,480,demonhunter,havoc,12,5,7
4012,Doomanthree,sargeras,480,demonhunter,havoc,12,5,7
4013,Laillwina,amanthul,480,demonhunter,havoc,12,5,7
4014,Chandrian,gorefiend,480,demonhunter,havoc,12,5,7
4015,Fabbris,stormrage,480,demonhunter,havoc,12,5,7
4016,Wartornx,tichondrius,480,demonhunter,havoc,12,5,7
4017,Harahmbae,moon-guard,480,demonhunter,havoc,12,5,7
4018,Slumberz,tichondrius,480,demonhunter,havoc,12,5,7
4019,Demondurk,illidan,480,demonhunter,havoc,12,5,7
4020,Cabedh,tichondrius,480,demonhunter,havoc,12,5,7
4021,Cupernacus,tichondrius,480,demonhunter,havoc,12,5,7
4022,Obîtox,illidan,480,demonhunter,havoc,12,5,7
4023,Billmurray,skullcrusher,480,demonhunter,havoc,12,5,7
4024,Foozelol,thrall,480,demonhunter,havoc,12,5,7
4025,Chupillidan,tichondrius,480,demonhunter,havoc,12,5,7
4026,Finagel,destromath,480,demonhunter,havoc,12,5,7
4027,Dheria,barthilas,480,demonhunter,havoc,12,5,7
4028,Nazeiro,shadowsong,480,demonhunter,havoc,12,5,7
4029,Drathothian,moon-guard,480,demonhunter,havoc,12,5,7
4030,Uneasydh,tichondrius,480,demonhunter,havoc,12,5,7
4031,Jarenjackson,area-52,480,demonhunter,havoc,12,5,7
4032,Ahurock,ragnaros,480,demonhunter,havoc,12,5,7
4033,Mjin,tichondrius,480,demonhunter,havoc,12,5,7
4034,Khelt,dalaran,480,demonhunter,havoc,12,5,7
4035,Sailtheskies,tichondrius,480,demonhunter,havoc,12,5,7
4036,Xiaodudh,tichondrius,480,demonhunter,havoc,12,5,7
4037,Efficacious,zuljin,480,demonhunter,havoc,15,6,9
4038,Keairà,bleeding-hollow,480,demonhunter,havoc,14,5,9
4039,Dàrk,zuljin,480,demonhunter,havoc,23,7,16
4040,Dracxus,sargeras,480,demonhunter,havoc,18,5,13
4041,Thedh,ragnaros,480,demonhunter,havoc,18,5,13
4042,Soulrending,stormrage,480,demonhunter,havoc,18,5,13
4043,Eyebeamtowin,stormrage,480,demonhunter,havoc,18,5,13
4044,Blakhaurt,tichondrius,480,demonhunter,havoc,18,5,13
4045,Imissgushing,area-52,480,demonhunter,havoc,18,5,13
4046,Brokendh,ragnaros,480,demonhunter,havoc,18,5,13
4047,Dèvistate,kelthuzad,480,demonhunter,havoc,18,5,13
4048,Robvyn,tichondrius,480,demonhunter,havoc,18,5,13
4049,Barael,tichondrius,480,demonhunter,havoc,18,5,13
4050,Roozi,tichondrius,480,demonhunter,havoc,24,5,19
4051,Jizzidan,blackhand,479,demonhunter,havoc,6,5,1
4052,Pwnagextreme,area-52,479,demonhunter,havoc,6,5,1
4053,Creaminbeavr,twisting-nether,479,demonhunter,havoc,10,6,4
4054,Felmilk,demon-soul,479,demonhunter,havoc,12,5,7
4055,Pocahotnes,stormrage,479,demonhunter,havoc,12,5,7
4056,Denathrion,moon-guard,479,demonhunter,havoc,12,5,7
4057,Elfdiablo,bonechewer,479,demonhunter,havoc,12,5,7
4058,Fliar,black-dragonflight,479,demonhunter,havoc,12,5,7
4059,Felvanora,amanthul,479,demonhunter,havoc,12,5,7
4060,Terruz,arathor,479,demonhunter,havoc,12,5,7
4061,Cantreborn,destromath,479,demonhunter,havoc,12,5,7
4062,Epicfront,darkspear,479,demonhunter,havoc,12,5,7
4063,Horndawgg,zuljin,479,demonhunter,havoc,12,5,7
4064,ßoobiemiles,area-52,479,demonhunter,havoc,12,5,7
4065,Ezymode,stormrage,479,demonhunter,havoc,12,5,7
4066,Kattsparrow,stormrage,479,demonhunter,havoc,18,5,13
4067,Idemonl,barthilas,479,demonhunter,havoc,18,5,13
4068,Bonebtwo,area-52,479,demonhunter,havoc,18,5,13
4069,Illidunk,tichondrius,479,demonhunter,havoc,18,5,13
4070,Kritik,goldrinn,478,demonhunter,havoc,12,5,7
4071,Cheernobyl,emerald-dream,478,demonhunter,havoc,18,5,13
4072,Devc,stormrage,477,demonhunter,havoc,12,5,7
4073,Zilham,tichondrius,477,demonhunter,havoc,19,5,14
4074,Skydemond,tichondrius,475,demonhunter,havoc,18,5,13
4075,Rouzk,ragnaros,474,demonhunter,havoc,12,5,7
4076,Mentoes,tichondrius,473,demonhunter,havoc,12,5,7
4077,Shadevon,wyrmrest-accord,448,demonhunter,havoc,10,5,5
4078,Raum,elune,443,demonhunter,havoc,8,6,2
4079,Bituhvic,stormrage,431,demonhunter,havoc,11,5,6
4080,Roosterhead,azjolnerub,430,demonhunter,havoc,11,5,6
4081,Annxyìng,tichondrius,426,demonhunter,havoc,14,6,8
4082,Wheredyougo,proudmoore,416,demonhunter,havoc,10,5,5
4083,Blinddude,sargeras,415,demonhunter,havoc,14,5,9
4084,Bladezues,tichondrius,415,demonhunter,havoc,14,5,9
4085,Teenis,malygos,412,demonhunter,havoc,14,5,9
4086,Florks,area-52,400,demonhunter,havoc,7,5,2
4087,Nèzúko,stormrage,384,demonhunter,havoc,6,4,2
4088,Galgy,ragnaros,384,demonhunter,havoc,6,4,2
4089,Doublepenn,tichondrius,384,demonhunter,havoc,6,4,2
4090,Nihilist,kaelthas,384,demonhunter,havoc,6,4,2
4091,Vyndrestan,dalaran,384,demonhunter,havoc,6,4,2
4092,Vynrage,trollbane,384,demonhunter,havoc,6,4,2
4093,Trilldh,illidan,384,demonhunter,havoc,6,4,2
4094,Whudaz,tichondrius,384,demonhunter,havoc,6,4,2
4095,Keepr,tichondrius,384,demonhunter,havoc,6,4,2
4096,Yågåmist,dalaran,384,demonhunter,havoc,6,4,2
4097,Dylle,tichondrius,384,demonhunter,havoc,6,4,2
4098,Déörwine,quelthalas,384,demonhunter,havoc,6,4,2
4099,Doomkaiser,aerie-peak,384,demonhunter,havoc,6,4,2
4100,Epicfc,bleeding-hollow,384,demonhunter,havoc,6,4,2
4101,Slyblitz,bleeding-hollow,384,demonhunter,havoc,6,4,2
4102,Bopersdh,drakkari,384,demonhunter,havoc,6,4,2
4103,Khaosx,ragnaros,384,demonhunter,havoc,6,4,2
4104,Skeethunter,tichondrius,384,demonhunter,havoc,6,4,2
4105,Deezhuntz,anvilmar,384,demonhunter,havoc,6,4,2
4106,Unkiteable,malganis,384,demonhunter,havoc,6,4,2
4107,Fov,crushridge,384,demonhunter,havoc,6,4,2
4108,Elfro,kelthuzad,384,demonhunter,havoc,6,4,2
4109,Fluoroh,frostmourne,384,demonhunter,havoc,6,4,2
4110,Domoredamage,sargeras,384,demonhunter,havoc,6,4,2
4111,Tragedydh,sargeras,384,demonhunter,havoc,6,4,2
4112,Parabolicc,illidan,384,demonhunter,havoc,6,4,2
4113,Abduragozik,stormrage,384,demonhunter,havoc,6,4,2
4114,Tiriøsh,area-52,384,demonhunter,havoc,6,4,2
4115,Hordesback,illidan,384,demonhunter,havoc,6,4,2
4116,Lucaria,sargeras,384,demonhunter,havoc,6,4,2
4117,Jinsha,emerald-dream,384,demonhunter,havoc,6,4,2
4118,Cyphre,tichondrius,384,demonhunter,havoc,6,4,2
4119,Bigdingding,area-52,384,demonhunter,havoc,6,4,2
4120,Cwrld,area-52,384,demonhunter,havoc,6,4,2
4121,Cesilette,frostmourne,384,demonhunter,havoc,6,4,2
4122,Extínctíon,moon-guard,384,demonhunter,havoc,6,4,2
4123,Darkah,icecrown,384,demonhunter,havoc,6,4,2
4124,Wogarg,sargeras,384,demonhunter,havoc,6,4,2
4125,Intrusive,kelthuzad,384,demonhunter,havoc,6,4,2
4126,Fellsoulz,area-52,384,demonhunter,havoc,6,4,2
4127,Monteego,stormrage,384,demonhunter,havoc,6,4,2
4128,Rynus,tichondrius,384,demonhunter,havoc,6,4,2
4129,Ultear,the-venture-co,384,demonhunter,havoc,6,4,2
4130,Kasseater,stormrage,384,demonhunter,havoc,6,4,2
4131,Krament,ragnaros,384,demonhunter,havoc,6,4,2
4132,Jeeprcreeprs,sargeras,384,demonhunter,havoc,6,4,2
4133,Dareassassin,tichondrius,384,demonhunter,havoc,6,4,2
4134,Kormraven,moon-guard,384,demonhunter,havoc,6,4,2
4135,Tyindron,exodar,384,demonhunter,havoc,6,4,2
4136,Jizzy,shadowmoon,384,demonhunter,havoc,6,4,2
4137,Verasu,kiljaeden,384,demonhunter,havoc,6,4,2
4138,Ineptbb,frostmourne,384,demonhunter,havoc,6,4,2
4139,Darkrëaper,azralon,384,demonhunter,havoc,6,4,2
4140,Uncleruckus,bloodscalp,384,demonhunter,havoc,6,4,2
4141,Savetar,thrall,384,demonhunter,havoc,6,4,2
4142,Heygriffin,proudmoore,384,demonhunter,havoc,6,4,2
4143,Kottàs,area-52,384,demonhunter,havoc,6,4,2
4144,Gødzîllå,moon-guard,384,demonhunter,havoc,6,4,2
4145,Servilletas,spirestone,384,demonhunter,havoc,6,4,2
4146,Doras,kelthuzad,384,demonhunter,havoc,6,4,2
4147,Abakkio,kelthuzad,384,demonhunter,havoc,6,4,2
4148,Tußlur,kelthuzad,384,demonhunter,havoc,6,4,2
4149,Tristanzx,sargeras,384,demonhunter,havoc,6,4,2
4150,Kâirn,area-52,384,demonhunter,havoc,6,4,2
4151,Bleaster,malganis,384,demonhunter,havoc,12,4,8
4152,Adhdh,bloodhoof,384,demonhunter,havoc,12,4,8
4153,Lìnc,sargeras,384,demonhunter,havoc,12,4,8
4154,Vallar,bleeding-hollow,384,demonhunter,havoc,12,4,8
4155,Blackclóver,drakkari,384,demonhunter,havoc,12,4,8
4156,Mommafingers,illidan,384,demonhunter,havoc,12,4,8
4157,Mikemyoffice,illidan,384,demonhunter,havoc,12,4,8
4158,Zoomie,durotan,384,demonhunter,havoc,12,4,8
4159,Zurg,wyrmrest-accord,384,demonhunter,havoc,12,4,8
4160,Reapersauce,illidan,384,demonhunter,havoc,12,4,8
4161,Zephim,area-52,384,demonhunter,havoc,12,4,8
4162,Kelprii,emerald-dream,384,demonhunter,havoc,12,4,8
4163,Heallscrean,drakkari,384,demonhunter,havoc,12,4,8
4164,Ralphie,ysera,384,demonhunter,havoc,12,4,8
4165,Separate,stormrage,384,demonhunter,havoc,12,4,8
4166,Dystopik,area-52,384,demonhunter,havoc,12,4,8
4167,Sinhful,darkspear,384,demonhunter,havoc,12,4,8
4168,Dhtimes,ragnaros,384,demonhunter,havoc,12,4,8
4169,Temporarý,bleeding-hollow,384,demonhunter,havoc,12,4,8
4170,Fraxxured,proudmoore,384,demonhunter,havoc,12,4,8
4171,Butterfinger,greymane,384,demonhunter,havoc,12,4,8
4172,Sathsong,tichondrius,384,demonhunter,havoc,12,4,8
4173,Bazul,tichondrius,384,demonhunter,havoc,12,4,8
4174,Bättousai,kiljaeden,384,demonhunter,havoc,12,4,8
4175,Anomander,khazgoroth,384,demonhunter,havoc,12,4,8
4176,Inssurgent,nagrand,384,demonhunter,havoc,12,4,8
4177,Ahernn,tichondrius,384,demonhunter,havoc,12,4,8
4178,Ragastan,queldorei,384,demonhunter,havoc,12,4,8
4179,Shallah,barthilas,384,demonhunter,havoc,12,4,8
4180,Sawsin,illidan,384,demonhunter,havoc,12,4,8
4181,Fenthras,thrall,384,demonhunter,havoc,12,4,8
4182,Overcrisis,quelthalas,384,demonhunter,havoc,12,4,8
4183,Noliaclap,sargeras,384,demonhunter,havoc,12,4,8
4184,Thetim,kelthuzad,384,demonhunter,havoc,12,4,8
4185,Contactfront,whisperwind,384,demonhunter,havoc,12,4,8
4186,Baalzadreth,bleeding-hollow,384,demonhunter,havoc,12,4,8
4187,Zzatmikaze,area-52,384,demonhunter,havoc,12,4,8
4188,Namthar,quelthalas,384,demonhunter,havoc,12,4,8
4189,Dhibjorf,destromath,384,demonhunter,havoc,12,4,8
4190,Dkdakìng,thrall,384,demonhunter,havoc,12,4,8
4191,Dhsoop,tichondrius,384,demonhunter,havoc,12,4,8
4192,Zerotwox,thrall,384,demonhunter,havoc,12,4,8
4193,Drîp,moon-guard,384,demonhunter,havoc,12,4,8
4194,Weetbreadsux,illidan,384,demonhunter,havoc,12,4,8
4195,Mëñâçë,tichondrius,384,demonhunter,havoc,13,4,9
4196,Alphatoo,area-52,384,demonhunter,havoc,15,4,11
4197,Noyan,tichondrius,384,demonhunter,havoc,17,4,13
4198,Ravesx,illidan,384,demonhunter,havoc,18,4,14
4199,Trystenn,nagrand,384,demonhunter,havoc,18,4,14
4200,Roodblurz,zuljin,384,demonhunter,havoc,18,4,14
4201,Felsa,wyrmrest-accord,384,demonhunter,havoc,18,4,14
4202,Leonardovg,quelthalas,384,demonhunter,havoc,30,4,26
4203,Severon,stormrage,383,demonhunter,havoc,6,4,2
4204,Dämonjäger,dragonmaw,383,demonhunter,havoc,6,4,2
4205,Handael,illidan,383,demonhunter,havoc,6,4,2
4206,Demondrëad,lightbringer,383,demonhunter,havoc,9,5,4
4207,Ahzalor,azralon,383,demonhunter,havoc,12,4,8
4208,Deathslice,azgalor,383,demonhunter,havoc,12,4,8
4209,Felieda,malfurion,383,demonhunter,havoc,12,4,8
4210,Døffy,area-52,383,demonhunter,havoc,12,4,8
4211,Qtee,cairne,383,demonhunter,havoc,12,4,8
4212,Righton,black-dragonflight,383,demonhunter,havoc,12,4,8
4213,Moongaria,greymane,383,demonhunter,havoc,12,4,8
4214,Themurderer,area-52,383,demonhunter,havoc,12,4,8
4215,Flearemedy,moon-guard,383,demonhunter,havoc,12,4,8
4216,Rarespawnjon,tichondrius,383,demonhunter,havoc,12,4,8
4217,Ayestar,tichondrius,383,demonhunter,havoc,12,4,8
4218,Vellinaris,zuljin,383,demonhunter,havoc,12,4,8
4219,Draktyl,bronzebeard,383,demonhunter,havoc,12,4,8
4220,Ilitía,area-52,382,demonhunter,havoc,6,4,2
4221,Xàsthur,darkspear,382,demonhunter,havoc,12,4,8
4222,Xiin,cenarion-circle,382,demonhunter,havoc,12,4,8
4223,Saladuoduo,illidan,382,demonhunter,havoc,12,4,8
4224,Apaantuh,sargeras,382,demonhunter,havoc,12,4,8
4225,Samirr,proudmoore,382,demonhunter,havoc,13,4,9
4226,Anguloke,wyrmrest-accord,381,demonhunter,havoc,10,5,5
4227,Agramun,ragnaros,381,demonhunter,havoc,12,4,8
4228,Killercooter,area-52,381,demonhunter,havoc,12,4,8
4229,Lúcy,malganis,367,demonhunter,havoc,11,4,7
4230,Rustyanchor,malganis,367,demonhunter,havoc,17,4,13
4231,Yogo,tichondrius,352,demonhunter,havoc,10,4,6
4232,Polunochnaya,area-52,352,demonhunter,havoc,16,4,12
4233,Selenerose,stormrage,351,demonhunter,havoc,8,5,3
4234,Viølance,area-52,351,demonhunter,havoc,8,5,3
4235,Findoratoqc,darrowmere,351,demonhunter,havoc,11,4,7
4236,Xiruu,area-52,336,demonhunter,havoc,15,5,10
4237,Unjust,darkspear,336,demonhunter,havoc,15,4,11
4238,Deadlysin,dragonmaw,336,demonhunter,havoc,15,4,11
4239,Fingerjamsx,area-52,335,demonhunter,havoc,11,4,7
4240,Cherrycrüsh,sargeras,335,demonhunter,havoc,11,4,7
4241,Lehvi,kiljaeden,335,demonhunter,havoc,11,4,7
4242,Dearborn,frostmourne,330,demonhunter,havoc,16,5,11
4243,Criyn,kelthuzad,330,demonhunter,havoc,17,5,12
4244,Ivexia,blackrock,320,demonhunter,havoc,10,4,6
4245,Acelolzz,illidan,320,demonhunter,havoc,10,4,6
4246,Rákdos,illidan,319,demonhunter,havoc,8,4,4
4247,Draxíus,tichondrius,304,demonhunter,havoc,7,4,3
4248,Gibbz,wyrmrest-accord,304,demonhunter,havoc,11,5,6
4249,Tenth,draka,288,demonhunter,havoc,6,3,3
4250,Asukaxox,illidan,288,demonhunter,havoc,6,3,3
4251,Onedigitiq,thrall,288,demonhunter,havoc,6,3,3
4252,Kawaiiakitty,tichondrius,288,demonhunter,havoc,6,3,3
4253,Sitchenn,stormrage,288,demonhunter,havoc,6,3,3
4254,Nen,illidan,288,demonhunter,havoc,6,3,3
4255,ßeelzëbub,icecrown,288,demonhunter,havoc,6,3,3
4256,Stacheaction,sargeras,288,demonhunter,havoc,6,3,3
4257,Xxân,tichondrius,288,demonhunter,havoc,6,3,3
4258,Grevdawg,barthilas,288,demonhunter,havoc,6,3,3
4259,Cäncèr,area-52,288,demonhunter,havoc,6,3,3
4260,Illipo,illidan,288,demonhunter,havoc,6,3,3
4261,Celestez,kelthuzad,288,demonhunter,havoc,6,3,3
4262,Çreme,tichondrius,288,demonhunter,havoc,6,3,3
4263,Âsmodeus,laughing-skull,288,demonhunter,havoc,6,3,3
4264,Walluped,malganis,288,demonhunter,havoc,6,3,3
4265,Warglaîve,illidan,288,demonhunter,havoc,6,3,3
4266,Wingsofhavoc,darkspear,288,demonhunter,havoc,6,3,3
4267,Fracxures,area-52,288,demonhunter,havoc,6,3,3
4268,Treyydh,illidan,288,demonhunter,havoc,6,3,3
4269,Meliodàs,ragnaros,288,demonhunter,havoc,6,3,3
4270,Râkê,malganis,288,demonhunter,havoc,6,3,3
4271,Quiksilverv,khazgoroth,288,demonhunter,havoc,6,3,3
4272,Lyrndrial,wildhammer,288,demonhunter,havoc,6,3,3
4273,Gilidar,terenas,288,demonhunter,havoc,6,3,3
4274,Mèrlyn,sargeras,288,demonhunter,havoc,6,3,3
4275,Blingtrön,malganis,288,demonhunter,havoc,6,3,3
4276,Totheglaive,sargeras,288,demonhunter,havoc,6,3,3
4277,Teufelhundn,tichondrius,288,demonhunter,havoc,6,3,3
4278,Ziyutomioka,moon-guard,288,demonhunter,havoc,6,3,3
4279,Gonpanchirow,moon-guard,288,demonhunter,havoc,6,3,3
4280,Kamakhasi,bleeding-hollow,288,demonhunter,havoc,6,3,3
4281,Sxzure,frostmourne,288,demonhunter,havoc,6,3,3
4282,Aslowbust,tichondrius,288,demonhunter,havoc,6,3,3
4283,Demønical,dalaran,288,demonhunter,havoc,6,3,3
4284,Felform,area-52,288,demonhunter,havoc,6,3,3
4285,Racktor,tichondrius,288,demonhunter,havoc,6,3,3
4286,Bkeight,dalaran,288,demonhunter,havoc,6,3,3
4287,Danthedh,illidan,288,demonhunter,havoc,6,3,3
4288,Velerolas,area-52,288,demonhunter,havoc,6,3,3
4289,Fferchu,ragnaros,288,demonhunter,havoc,6,3,3
4290,Inphamy,chogall,288,demonhunter,havoc,6,3,3
4291,Zeppelìn,stormrage,288,demonhunter,havoc,6,3,3
4292,Aventear,wyrmrest-accord,288,demonhunter,havoc,6,3,3
4293,Careestal,stormrage,288,demonhunter,havoc,6,3,3
4294,Sofedon,kargath,288,demonhunter,havoc,6,3,3
4295,Walk,kul-tiras,288,demonhunter,havoc,6,3,3
4296,Singueta,stormrage,288,demonhunter,havoc,6,3,3
4297,Noóve,area-52,288,demonhunter,havoc,6,3,3
4298,Zaveen,kelthuzad,288,demonhunter,havoc,6,3,3
4299,Neutrophilia,area-52,288,demonhunter,havoc,6,3,3
4300,Tink,kilrogg,288,demonhunter,havoc,6,3,3
4301,Safiyya,proudmoore,288,demonhunter,havoc,6,3,3
4302,Dhunterkofwa,tichondrius,288,demonhunter,havoc,6,3,3
4303,Slodeath,zuljin,288,demonhunter,havoc,6,3,3
4304,Zïlly,blackrock,288,demonhunter,havoc,6,3,3
4305,Arlequhin,ragnaros,288,demonhunter,havoc,6,3,3
4306,Talsaris,drakthul,288,demonhunter,havoc,6,3,3
4307,Shamock,aggramar,288,demonhunter,havoc,6,3,3
4308,Inva,stormrage,288,demonhunter,havoc,6,3,3
4309,Rhynóe,illidan,288,demonhunter,havoc,6,3,3
4310,Dettlaff,sentinels,288,demonhunter,havoc,6,3,3
4311,Songtwo,frostmourne,288,demonhunter,havoc,6,3,3
4312,Namiisann,terenas,288,demonhunter,havoc,6,3,3
4313,Treeüs,sargeras,288,demonhunter,havoc,6,3,3
4314,Smokepurppx,zuljin,288,demonhunter,havoc,6,3,3
4315,Krendron,malganis,288,demonhunter,havoc,6,3,3
4316,Elgreezy,sargeras,288,demonhunter,havoc,6,3,3
4317,Zalenn,whisperwind,288,demonhunter,havoc,6,3,3
4318,Gnatman,skywall,288,demonhunter,havoc,6,3,3
4319,Suddensky,sargeras,288,demonhunter,havoc,6,3,3
4320,Riodh,area-52,288,demonhunter,havoc,6,3,3
4321,Cantc,moon-guard,288,demonhunter,havoc,6,3,3
4322,Shacco,bleeding-hollow,288,demonhunter,havoc,6,3,3
4323,Imissher,dalaran,288,demonhunter,havoc,6,3,3
4324,Cassadega,sargeras,288,demonhunter,havoc,6,3,3
4325,Yunjiia,stormrage,288,demonhunter,havoc,6,3,3
4326,Darkstein,nathrezim,288,demonhunter,havoc,6,3,3
4327,Inpain,ysera,288,demonhunter,havoc,9,4,5
4328,Eeresh,argent-dawn,288,demonhunter,havoc,11,4,7
4329,Hisokafreecs,azralon,288,demonhunter,havoc,10,3,7
4330,Félmoose,moon-guard,288,demonhunter,havoc,12,3,9
4331,Occula,moon-guard,288,demonhunter,havoc,12,3,9
4332,Çløûdïx,tichondrius,288,demonhunter,havoc,12,3,9
4333,Itsplague,tichondrius,288,demonhunter,havoc,12,3,9
4334,Mvrda,area-52,288,demonhunter,havoc,12,3,9
4335,Katsuucurry,tichondrius,288,demonhunter,havoc,12,3,9
4336,Kraky,nemesis,288,demonhunter,havoc,12,3,9
4337,Daso,the-forgotten-coast,288,demonhunter,havoc,12,3,9
4338,Denadiirx,area-52,288,demonhunter,havoc,12,3,9
4339,Nayton,frostmourne,288,demonhunter,havoc,12,3,9
4340,Atriax,kelthuzad,288,demonhunter,havoc,12,3,9
4341,Albinohobo,emerald-dream,288,demonhunter,havoc,12,3,9
4342,Shidz,frostmourne,288,demonhunter,havoc,12,3,9
4343,Rasgon,azralon,288,demonhunter,havoc,12,3,9
4344,Lawimmortal,tichondrius,288,demonhunter,havoc,12,3,9
4345,Skrimpi,dalaran,288,demonhunter,havoc,12,3,9
4346,Abrams,tichondrius,288,demonhunter,havoc,12,3,9
4347,Wotlkdh,area-52,288,demonhunter,havoc,12,3,9
4348,Elflerri,area-52,288,demonhunter,havoc,12,3,9
4349,Dirtyd,dragonmaw,288,demonhunter,havoc,12,3,9
4350,Nightsatan,stormrage,288,demonhunter,havoc,12,3,9
4351,Felfloozy,illidan,288,demonhunter,havoc,12,3,9
4352,Zudo,amanthul,288,demonhunter,havoc,12,3,9
4353,Missbhavin,kelthuzad,288,demonhunter,havoc,12,3,9
4354,Tentacruelzz,area-52,288,demonhunter,havoc,12,3,9
4355,Demonichoov,thrall,288,demonhunter,havoc,12,3,9
4356,Mirante,illidan,288,demonhunter,havoc,12,3,9
4357,Klàus,quelthalas,288,demonhunter,havoc,12,3,9
4358,Icanmove,area-52,288,demonhunter,havoc,12,3,9
4359,Reflexin,tichondrius,288,demonhunter,havoc,12,3,9
4360,Dmfeetpics,dalaran,288,demonhunter,havoc,12,3,9
4361,Azziria,aerie-peak,288,demonhunter,havoc,12,3,9
4362,Jxda,tichondrius,288,demonhunter,havoc,15,3,12
4363,Hpmaxin,tichondrius,288,demonhunter,havoc,18,3,15
4364,Vellassa,stormscale,288,demonhunter,havoc,18,3,15
4365,Lavantora,tichondrius,288,demonhunter,havoc,23,3,20
4366,Devilina,khadgar,287,demonhunter,havoc,6,3,3
4367,Shar,jaedenar,287,demonhunter,havoc,6,3,3
4368,Kratox,senjin,287,demonhunter,havoc,6,3,3
4369,Haydet,stormrage,287,demonhunter,havoc,6,3,3
4370,Illa,dunemaul,287,demonhunter,havoc,6,3,3
4371,Holescrewer,tichondrius,287,demonhunter,havoc,6,3,3
4372,Ariluci,destromath,287,demonhunter,havoc,6,3,3
4373,Slixxk,sargeras,287,demonhunter,havoc,9,4,5
4374,Villoria,kul-tiras,287,demonhunter,havoc,12,3,9
4375,Dynastyblade,area-52,287,demonhunter,havoc,12,3,9
4376,Lsnusnul,illidan,286,demonhunter,havoc,6,3,3
4377,Psythe,undermine,286,demonhunter,havoc,12,3,9
4378,Dannaris,maelstrom,285,demonhunter,havoc,12,3,9
4379,Pekkora,illidan,284,demonhunter,havoc,12,3,9
4380,Elrr,drakkari,255,demonhunter,havoc,11,3,8
4381,Nikator,emerald-dream,255,demonhunter,havoc,11,3,8
4382,Juantty,area-52,240,demonhunter,havoc,15,3,12
4383,Hoppygofast,darkspear,239,demonhunter,havoc,5,3,2
4384,Vickyvette,illidan,239,demonhunter,havoc,5,3,2
4385,Azàzel,quelthalas,239,demonhunter,havoc,5,3,2
4386,Divinehorse,tichondrius,234,demonhunter,havoc,10,5,5
4387,Kryzthed,drakkari,233,demonhunter,havoc,13,4,9
4388,Bushwacker,azralon,223,demonhunter,havoc,8,3,5
4389,Phaeton,zuluhed,222,demonhunter,havoc,10,3,7
4390,Onihunter,zangarmarsh,208,demonhunter,havoc,7,3,4
4391,Cobra,quelthalas,208,demonhunter,havoc,7,3,4
4392,Critxclutch,tichondrius,192,demonhunter,havoc,4,3,1
4393,Syrendris,moon-guard,192,demonhunter,havoc,8,3,5
4394,Thedhdream,frostmourne,192,demonhunter,havoc,9,3,6
4395,Iøst,stormrage,192,demonhunter,havoc,6,2,4
4396,Azshada,shadowmoon,192,demonhunter,havoc,6,2,4
4397,Varaedra,stormreaver,192,demonhunter,havoc,6,2,4
4398,Zethh,drakkari,192,demonhunter,havoc,6,2,4
4399,Vyrthur,area-52,192,demonhunter,havoc,6,2,4
4400,Gogiban,tichondrius,192,demonhunter,havoc,6,2,4
4401,Zusi,frostmane,192,demonhunter,havoc,6,2,4
4402,Lilyanie,stormrage,192,demonhunter,havoc,6,2,4
4403,Bark,dalvengyr,192,demonhunter,havoc,6,2,4
4404,Daracu,aerie-peak,192,demonhunter,havoc,6,2,4
4405,Frino,steamwheedle-cartel,192,demonhunter,havoc,6,2,4
4406,Serberius,stormrage,192,demonhunter,havoc,6,2,4
4407,Riot,nazgrel,192,demonhunter,havoc,6,2,4
4408,Imleu,stormrage,192,demonhunter,havoc,6,2,4
4409,Sparklepunch,stormrage,192,demonhunter,havoc,6,2,4
4410,Chamuki,greymane,192,demonhunter,havoc,6,2,4
4411,Xannaa,illidan,192,demonhunter,havoc,6,2,4
4412,Ratcnt,barthilas,192,demonhunter,havoc,6,2,4
4413,Øxxy,azralon,192,demonhunter,havoc,6,2,4
4414,Arandë,earthen-ring,192,demonhunter,havoc,6,2,4
4415,Demonlee,jubeithos,192,demonhunter,havoc,6,2,4
4416,Devilweef,whisperwind,192,demonhunter,havoc,6,2,4
4417,Kzdh,illidan,192,demonhunter,havoc,6,2,4
4418,Zach,muradin,192,demonhunter,havoc,6,2,4
4419,Ragath,bonechewer,192,demonhunter,havoc,6,2,4
4420,Impaledurgf,tichondrius,192,demonhunter,havoc,6,2,4
4421,String,tanaris,192,demonhunter,havoc,6,2,4
4422,Skol,andorhal,192,demonhunter,havoc,6,2,4
4423,Swagidan,khaz-modan,192,demonhunter,havoc,6,2,4
4424,Zarraessa,trollbane,192,demonhunter,havoc,6,2,4
4425,Metha,kiljaeden,192,demonhunter,havoc,6,2,4
4426,Showaitie,thrall,192,demonhunter,havoc,6,2,4
4427,Moxy,kaelthas,192,demonhunter,havoc,6,2,4
4428,Aleta,firetree,192,demonhunter,havoc,6,2,4
4429,Blynx,destromath,192,demonhunter,havoc,6,2,4
4430,Justinthomas,khaz-modan,192,demonhunter,havoc,6,2,4
4431,Badalandabad,nemesis,192,demonhunter,havoc,6,2,4
4432,Genobreaker,drenden,192,demonhunter,havoc,6,2,4
4433,Rkakda,thunderlord,192,demonhunter,havoc,6,2,4
4434,Lloxly,skullcrusher,192,demonhunter,havoc,6,2,4
4435,Freddiedread,bladefist,192,demonhunter,havoc,6,2,4
4436,Gyutaro,frostmourne,192,demonhunter,havoc,6,2,4
4437,Naresaris,proudmoore,192,demonhunter,havoc,6,2,4
4438,Clîzzy,tichondrius,192,demonhunter,havoc,6,2,4
4439,Brokendh,frostmourne,192,demonhunter,havoc,6,2,4
4440,Kayanson,azralon,192,demonhunter,havoc,6,2,4
4441,Theenemesis,wildhammer,192,demonhunter,havoc,6,2,4
4442,Krador,wyrmrest-accord,192,demonhunter,havoc,6,2,4
4443,Kyndlia,wyrmrest-accord,192,demonhunter,havoc,6,2,4
4444,Carlibeth,illidan,192,demonhunter,havoc,6,2,4
4445,Downbadsimp,tichondrius,192,demonhunter,havoc,6,2,4
4446,Sarithos,frostmourne,192,demonhunter,havoc,6,2,4
4447,Daabsdh,thrall,192,demonhunter,havoc,6,2,4
4448,Mäläk,zuluhed,192,demonhunter,havoc,6,2,4
4449,Narilna,stormrage,192,demonhunter,havoc,6,2,4
4450,Jadyne,frostmourne,192,demonhunter,havoc,6,2,4
4451,Illidanmello,proudmoore,192,demonhunter,havoc,6,2,4
4452,Renoshan,wyrmrest-accord,192,demonhunter,havoc,6,2,4
4453,Kezzaku,frostmourne,192,demonhunter,havoc,6,2,4
4454,Lustsama,ragnaros,192,demonhunter,havoc,6,2,4
4455,Berquondh,tichondrius,192,demonhunter,havoc,6,2,4
4456,Ramrodd,nazgrel,192,demonhunter,havoc,6,2,4
4457,Xanthrodril,illidan,192,demonhunter,havoc,6,2,4
4458,Heptabase,tichondrius,192,demonhunter,havoc,6,2,4
4459,Annmílls,quelthalas,192,demonhunter,havoc,6,2,4
4460,Cursedemon,vashj,192,demonhunter,havoc,6,2,4
4461,Lilvetis,thrall,192,demonhunter,havoc,6,2,4
4462,Righetto,barthilas,192,demonhunter,havoc,6,2,4
4463,Illimare,tichondrius,192,demonhunter,havoc,6,2,4
4464,Sendingit,vashj,192,demonhunter,havoc,6,2,4
4465,Throtegoat,illidan,192,demonhunter,havoc,6,2,4
4466,Badservice,frostwolf,192,demonhunter,havoc,6,2,4
4467,Cocopapa,tichondrius,192,demonhunter,havoc,6,2,4
4468,Lvqp,barthilas,192,demonhunter,havoc,6,2,4
4469,Wïldside,tichondrius,192,demonhunter,havoc,6,2,4
4470,Demonslayyer,saurfang,192,demonhunter,havoc,6,2,4
4471,Cbt,grizzly-hills,192,demonhunter,havoc,6,2,4
4472,Lookatdishoe,tichondrius,192,demonhunter,havoc,6,2,4
4473,Trackamp,emerald-dream,192,demonhunter,havoc,6,2,4
4474,Felbarrah,barthilas,192,demonhunter,havoc,6,2,4
4475,Yhell,darkspear,192,demonhunter,havoc,6,2,4
4476,Glaíve,anvilmar,192,demonhunter,havoc,6,2,4
4477,Cirillas,illidan,192,demonhunter,havoc,6,2,4
4478,Frøppy,illidan,192,demonhunter,havoc,6,2,4
4479,Kraazi,thrall,192,demonhunter,havoc,6,2,4
4480,Cordianx,area-52,192,demonhunter,havoc,6,2,4
4481,Jozeez,emerald-dream,192,demonhunter,havoc,6,2,4
4482,Vulgøre,illidan,192,demonhunter,havoc,6,2,4
4483,Frøstdh,area-52,192,demonhunter,havoc,6,2,4
4484,Lillidanss,the-forgotten-coast,192,demonhunter,havoc,6,2,4
4485,Valerethis,steamwheedle-cartel,192,demonhunter,havoc,6,2,4
4486,Ambitiòn,moon-guard,192,demonhunter,havoc,6,2,4
4487,Dlone,sargeras,192,demonhunter,havoc,6,2,4
4488,Ausä,ragnaros,192,demonhunter,havoc,6,2,4
4489,Buhnana,stormscale,192,demonhunter,havoc,6,2,4
4490,Subsfordubs,illidan,192,demonhunter,havoc,6,2,4
4491,Sodí,moon-guard,192,demonhunter,havoc,6,2,4
4492,Demonwaffle,draka,192,demonhunter,havoc,6,2,4
4493,Gopump,area-52,192,demonhunter,havoc,6,2,4
4494,Illdaira,windrunner,192,demonhunter,havoc,6,2,4
4495,Texts,norgannon,192,demonhunter,havoc,6,2,4
4496,Shadynãsty,drakthul,192,demonhunter,havoc,6,2,4
4497,Hoagiedevil,moon-guard,192,demonhunter,havoc,6,2,4
4498,Imagoon,sargeras,192,demonhunter,havoc,6,2,4
4499,Leeröy,area-52,192,demonhunter,havoc,6,2,4
4500,Shankszs,sargeras,192,demonhunter,havoc,6,2,4
4501,Zeldris,duskwood,192,demonhunter,havoc,6,2,4
4502,Cryolite,sargeras,192,demonhunter,havoc,6,2,4
4503,Renatha,ragnaros,192,demonhunter,havoc,6,2,4
4504,Slaymore,sargeras,192,demonhunter,havoc,6,2,4
4505,Nhoxell,ragnaros,192,demonhunter,havoc,6,2,4
4506,Koogleblitz,sargeras,192,demonhunter,havoc,6,2,4
4507,Falan,drakthul,192,demonhunter,havoc,6,2,4
4508,Rykko,borean-tundra,192,demonhunter,havoc,6,2,4
4509,Arkynth,dalaran,192,demonhunter,havoc,6,2,4
4510,Dirtydone,area-52,192,demonhunter,havoc,6,2,4
4511,Thesituatíon,sargeras,192,demonhunter,havoc,6,2,4
4512,Wreckforce,blades-edge,192,demonhunter,havoc,6,2,4
4513,Hellishunter,illidan,192,demonhunter,havoc,6,2,4
4514,Elaurenne,sargeras,192,demonhunter,havoc,6,2,4
4515,Qlmm,stormrage,192,demonhunter,havoc,7,2,5
4516,Politic,area-52,192,demonhunter,havoc,11,2,9
4517,Âduka,illidan,192,demonhunter,havoc,12,2,10
4518,Catastroz,ragnaros,192,demonhunter,havoc,12,2,10
4519,Hollownight,area-52,192,demonhunter,havoc,12,2,10
4520,Gyop,azralon,192,demonhunter,havoc,12,2,10
4521,Asharian,wyrmrest-accord,192,demonhunter,havoc,12,2,10
4522,Cidolem,area-52,192,demonhunter,havoc,12,2,10
4523,Denel,laughing-skull,192,demonhunter,havoc,12,2,10
4524,Chell,stormscale,192,demonhunter,havoc,12,2,10
4525,Ôdh,area-52,192,demonhunter,havoc,12,2,10
4526,Kushz,dalaran,192,demonhunter,havoc,12,2,10
4527,Kyska,tichondrius,192,demonhunter,havoc,12,2,10
4528,Boofdh,illidan,192,demonhunter,havoc,12,2,10
4529,Smokinops,stormrage,192,demonhunter,havoc,12,2,10
4530,Tempésts,tichondrius,192,demonhunter,havoc,12,2,10
4531,Garfizzle,grizzly-hills,192,demonhunter,havoc,12,2,10
4532,Cola,illidan,192,demonhunter,havoc,12,2,10
4533,Reikune,tichondrius,192,demonhunter,havoc,12,2,10
4534,Bazér,frostmourne,192,demonhunter,havoc,12,2,10
4535,Ticó,stormrage,192,demonhunter,havoc,12,2,10
4536,Lauriale,moon-guard,192,demonhunter,havoc,12,2,10
4537,Halaena,moon-guard,192,demonhunter,havoc,12,2,10
4538,Daeth,skullcrusher,192,demonhunter,havoc,12,2,10
4539,Beastforlife,sargeras,192,demonhunter,havoc,12,2,10
4540,Spacéphoenix,stormrage,192,demonhunter,havoc,12,2,10
4541,Pholly,altar-of-storms,191,demonhunter,havoc,6,2,4
4542,Nomakk,greymane,191,demonhunter,havoc,6,2,4
4543,Yesnah,emerald-dream,191,demonhunter,havoc,7,2,5
4544,Tarasam,burning-blade,191,demonhunter,havoc,12,2,10
4545,Feilixx,moon-guard,190,demonhunter,havoc,12,2,10
4546,Ferunye,stormrage,159,demonhunter,havoc,5,2,3
4547,Crustorbust,tichondrius,159,demonhunter,havoc,5,2,3
4548,Theweektwo,drakkari,159,demonhunter,havoc,11,2,9
4549,Raycharlés,sargeras,138,demonhunter,havoc,6,3,3
4550,Refused,nesingwary,138,demonhunter,havoc,11,4,7
4551,Criolex,stormrage,138,demonhunter,havoc,9,3,6
4552,Shanjara,sargeras,138,demonhunter,havoc,15,3,12
4553,Zanecksbinge,skullcrusher,128,demonhunter,havoc,4,2,2
4554,Xeil,zuljin,128,demonhunter,havoc,4,2,2
4555,Xwingpilot,arthas,127,demonhunter,havoc,8,2,6
4556,Bottleofbirb,tichondrius,127,demonhunter,havoc,8,2,6
4557,Tättø,area-52,96,demonhunter,havoc,3,2,1
4558,Litball,stormrage,96,demonhunter,havoc,3,2,1
4559,Kümï,quelthalas,96,demonhunter,havoc,3,2,1
4560,Icewings,tichondrius,96,demonhunter,havoc,3,2,1
4561,Blaamy,magtheridon,96,demonhunter,havoc,3,2,1
4562,Llörne,moon-guard,96,demonhunter,havoc,6,1,5
4563,Treblig,nerzhul,96,demonhunter,havoc,6,1,5
4564,Demønvil,onyxia,96,demonhunter,havoc,6,1,5
4565,Mythundorn,burning-blade,96,demonhunter,havoc,6,1,5
4566,Solcon,exodar,96,demonhunter,havoc,6,1,5
4567,Painqtxo,area-52,96,demonhunter,havoc,6,1,5
4568,Chris,nordrassil,96,demonhunter,havoc,6,1,5
4569,Memslaw,tichondrius,96,demonhunter,havoc,6,1,5
4570,Thêworld,azralon,96,demonhunter,havoc,6,1,5
4571,Roat,malganis,96,demonhunter,havoc,6,1,5
4572,Theysuffer,scilla,96,demonhunter,havoc,6,1,5
4573,Mazïkeen,uther,96,demonhunter,havoc,6,1,5
4574,Vaestl,zuljin,96,demonhunter,havoc,6,1,5
4575,Xänäx,azralon,96,demonhunter,havoc,6,1,5
4576,Siegfridemon,ragnaros,96,demonhunter,havoc,6,1,5
4577,Phosphora,dalaran,96,demonhunter,havoc,6,1,5
4578,Aithusadh,barthilas,96,demonhunter,havoc,6,1,5
4579,Vëngêåncé,tichondrius,96,demonhunter,havoc,6,1,5
4580,Wubloadz,bleeding-hollow,96,demonhunter,havoc,6,1,5
4581,Hausecat,aegwynn,96,demonhunter,havoc,6,1,5
4582,Snazzyy,kelthuzad,96,demonhunter,havoc,6,1,5
4583,Lostpvp,blackrock,96,demonhunter,havoc,6,1,5
4584,Skylinetime,sargeras,96,demonhunter,havoc,6,1,5
4585,Pighe,tichondrius,96,demonhunter,havoc,6,1,5
4586,Musewine,tichondrius,96,demonhunter,havoc,6,1,5
4587,Gil,moonrunner,96,demonhunter,havoc,6,1,5
4588,Glimpsê,tichondrius,96,demonhunter,havoc,6,1,5
4589,Chad,anvilmar,96,demonhunter,havoc,6,1,5
4590,Safikins,tichondrius,96,demonhunter,havoc,6,1,5
4591,Suzuha,illidan,96,demonhunter,havoc,6,1,5
4592,Glaivee,dalaran,96,demonhunter,havoc,6,1,5
4593,Ðemonhunterx,frostmourne,96,demonhunter,havoc,6,1,5
4594,Constantwood,sargeras,96,demonhunter,havoc,6,1,5
4595,Slycerr,illidan,96,demonhunter,havoc,6,1,5
4596,Anabolicbro,tichondrius,96,demonhunter,havoc,6,1,5
4597,Nomedi,aggramar,96,demonhunter,havoc,6,1,5
4598,Chakan,burning-legion,96,demonhunter,havoc,6,1,5
4599,Reezi,sargeras,96,demonhunter,havoc,6,1,5
4600,Demonfuji,proudmoore,96,demonhunter,havoc,6,1,5
4601,Demonleàf,area-52,96,demonhunter,havoc,6,1,5
4602,Akammy,proudmoore,96,demonhunter,havoc,6,1,5
4603,Scarolol,malganis,96,demonhunter,havoc,6,1,5
4604,Arkfall,proudmoore,96,demonhunter,havoc,6,1,5
4605,Projectalice,malganis,96,demonhunter,havoc,6,1,5
4606,Jekyldh,tichondrius,96,demonhunter,havoc,6,1,5
4607,Varanidae,kelthuzad,96,demonhunter,havoc,6,1,5
4608,Marxefel,ragnaros,96,demonhunter,havoc,6,1,5
4609,Sado,proudmoore,96,demonhunter,havoc,6,1,5
4610,Bensonlove,tichondrius,96,demonhunter,havoc,6,1,5
4611,Elillidan,emerald-dream,96,demonhunter,havoc,6,1,5
4612,Kurotoo,ragnaros,96,demonhunter,havoc,6,1,5
4613,Brgkuma,sargeras,96,demonhunter,havoc,6,1,5
4614,Terpenese,chogall,96,demonhunter,havoc,6,1,5
4615,Eibizoudh,sargeras,96,demonhunter,havoc,6,1,5
4616,Carrîôn,tichondrius,96,demonhunter,havoc,6,1,5
4617,Lokydh,tichondrius,96,demonhunter,havoc,6,1,5
4618,Dhrongor,drakkari,96,demonhunter,havoc,6,1,5
4619,Felblood,saurfang,96,demonhunter,havoc,6,1,5
4620,Esøteric,area-52,96,demonhunter,havoc,6,1,5
4621,Jerry,emerald-dream,96,demonhunter,havoc,6,1,5
4622,Vidêl,stormrage,96,demonhunter,havoc,6,1,5
4623,Ulfhednarxz,illidan,96,demonhunter,havoc,6,1,5
4624,Zaythan,quelthalas,96,demonhunter,havoc,6,1,5
4625,Majindemon,dragonmaw,96,demonhunter,havoc,6,1,5
4626,Clutch,spirestone,96,demonhunter,havoc,6,1,5
4627,Lantherin,sargeras,96,demonhunter,havoc,11,1,10
4628,Gnocchis,thrall,96,demonhunter,havoc,12,1,11
4629,Pursephone,bonechewer,96,demonhunter,havoc,12,1,11
4630,Moonsocks,proudmoore,96,demonhunter,havoc,12,1,11
4631,Chirøn,darkspear,96,demonhunter,havoc,12,1,11
4632,Ichigoo,arthas,96,demonhunter,havoc,12,1,11
4633,Aríes,dreadmaul,94,demonhunter,havoc,4,3,1
4634,Arlén,frostmourne,79,demonhunter,havoc,5,1,4
4635,Fellchapo,illidan,79,demonhunter,havoc,5,1,4
4636,Miskiiv,malganis,79,demonhunter,havoc,5,1,4
4637,Demonbluntzz,tichondrius,79,demonhunter,havoc,11,1,10
4638,Mcthiccyy,moon-guard,64,demonhunter,havoc,4,1,3
4639,Blackpøwér,sargeras,64,demonhunter,havoc,5,1,4
4640,Raptorjèsus,azjolnerub,48,demonhunter,havoc,3,1,2
4641,Jizzidari,frostmourne,48,demonhunter,havoc,3,1,2
4642,Quoates,dalaran,48,demonhunter,havoc,3,1,2
4643,Aryía,stormrage,48,demonhunter,havoc,3,1,2
4644,Lifefery,quelthalas,48,demonhunter,havoc,3,1,2
4645,Xaryic,stormrage,42,demonhunter,havoc,16,5,11
4646,Kersplack,tichondrius,42,demonhunter,havoc,14,3,11
4647,Mavlck,azralon,42,demonhunter,havoc,10,2,8
4648,Pooterjuice,shadowmoon,31,demonhunter,havoc,2,1,1
4649,Bladeset,moonrunner,31,demonhunter,havoc,2,1,1
4650,Lathazar,darkspear,16,demonhunter,havoc,1,1,0
4651,Iwasright,stonemaul,1488,demonhunter,vengeance,72,35,37
4652,Slippedinfel,tichondrius,1335,demonhunter,vengeance,47,22,25
4653,Jersey,proudmoore,1091,demonhunter,vengeance,29,17,12
4654,Agricornia,tichondrius,826,demonhunter,vengeance,18,9,9
4655,Nights,greymane,566,demonhunter,vengeance,12,6,6
4656,Kysaerix,stormrage,479,demonhunter,vengeance,18,5,13
4657,Narilis,illidan,384,demonhunter,vengeance,6,4,2
4658,Sinfulpariah,bladefist,288,demonhunter,vengeance,6,3,3
4659,Ferano,frostmourne,288,demonhunter,vengeance,6,3,3
4660,Irisand,ragnaros,288,demonhunter,vengeance,6,3,3
4661,Çherrii,moon-guard,286,demonhunter,vengeance,6,3,3
4662,Tilltheend,illidan,239,demonhunter,vengeance,5,3,2
4663,Asderel,zuljin,192,demonhunter,vengeance,6,2,4
4664,Meliødaz,ragnaros,192,demonhunter,vengeance,12,2,10
4665,Shiningvenus,stormrage,192,demonhunter,vengeance,12,2,10
4666,Dameon,wildhammer,191,demonhunter,vengeance,6,2,4
4667,Daymanhunter,bleeding-hollow,96,demonhunter,vengeance,6,1,5
4668,Foodtruck,hellscream,96,demonhunter,vengeance,6,1,5
4669,Aleymar,tichondrius,96,demonhunter,vengeance,6,1,5
4670,Nubishe,jubeithos,96,demonhunter,vengeance,6,1,5
4671,Gentlesoap,blackrock,96,demonhunter,vengeance,6,1,5
4672,Mooneh,emerald-dream,96,demonhunter,vengeance,6,1,5
4673,Supersaiyan,sargeras,64,demonhunter,vengeance,4,1,3
4674,Grovetenderx,tichondrius,2238,druid,restoration,86,53,33
4675,Flóp,dalaran,2238,druid,restoration,90,53,37
4676,Linful,tichondrius,2193,druid,restoration,251,131,120
4677,Renner,zuljin,2192,druid,restoration,109,57,52
4678,Garbagedruid,scilla,2177,druid,restoration,229,118,111
4679,Angrygochux,tichondrius,2170,druid,restoration,154,84,70
4680,Liangpibro,illidan,2149,druid,restoration,103,65,38
4681,Kobaishome,tichondrius,2148,druid,restoration,119,70,49
4682,Omkin,tichondrius,2137,druid,restoration,120,62,58
4683,Couragé,ragnaros,2137,druid,restoration,153,78,75
4684,Andrwceo,stormrage,2129,druid,restoration,78,48,30
4685,Bemelerberg,sargeras,2117,druid,restoration,113,60,53
4686,Bestrun,tichondrius,2116,druid,restoration,108,58,50
4687,Iån,dalaran,2055,druid,restoration,47,28,19
4688,Commercii,tichondrius,2043,druid,restoration,72,42,30
4689,Vers,dathremar,2037,druid,restoration,90,43,47
4690,Shaylyne,moonrunner,2026,druid,restoration,69,41,28
4691,Dannycarry,tichondrius,2025,druid,restoration,59,32,27
4692,Gotheelsx,illidan,2020,druid,restoration,208,103,105
4693,Racialmotive,illidan,2017,druid,restoration,134,76,58
4694,Szwlol,tichondrius,2011,druid,restoration,381,200,181
4695,Guqingshuang,tichondrius,2004,druid,restoration,109,62,47
4696,Bigtimers,illidan,2000,druid,restoration,70,37,33
4697,Leafynymph,tichondrius,1998,druid,restoration,61,39,22
4698,Hchls,tichondrius,1996,druid,restoration,152,77,75
4699,Taiwanzz,tichondrius,1994,druid,restoration,79,40,39
4700,Druuná,kiljaeden,1985,druid,restoration,191,98,93
4701,Sanlunainiu,tichondrius,1976,druid,restoration,178,82,96
4702,Lenya,bleeding-hollow,1975,druid,restoration,87,49,38
4703,Davidqx,zuljin,1968,druid,restoration,120,68,52
4704,Gotheels,illidan,1967,druid,restoration,47,32,15
4705,Brenden,area-52,1958,druid,restoration,150,76,74
4706,Creamyfresh,tichondrius,1957,druid,restoration,87,44,43
4707,Lvse,tichondrius,1955,druid,restoration,84,53,31
4708,Rbavny,tichondrius,1954,druid,restoration,42,25,17
4709,Pornkkimi,tichondrius,1952,druid,restoration,48,29,19
4710,Psam,emerald-dream,1948,druid,restoration,95,54,41
4711,Mengniulol,tichondrius,1947,druid,restoration,179,100,79
4712,Plorenz,zuljin,1945,druid,restoration,125,70,55
4713,Sanitizer,tichondrius,1942,druid,restoration,72,41,31
4714,Flowen,spinebreaker,1940,druid,restoration,78,39,39
4715,Softpawz,kelthuzad,1937,druid,restoration,83,42,41
4716,Rorae,tichondrius,1936,druid,restoration,179,88,91
4717,Tizzyy,eredar,1921,druid,restoration,78,43,35
4718,Taaienberg,sargeras,1919,druid,restoration,114,54,60
4719,Disembles,illidan,1909,druid,restoration,78,40,38
4720,Shiftýx,tichondrius,1905,druid,restoration,77,38,39
4721,Bobd,proudmoore,1893,druid,restoration,60,32,28
4722,Ymy,tichondrius,1892,druid,restoration,60,30,30
4723,Dancesdru,area-52,1888,druid,restoration,36,20,16
4724,Treenleaves,stormrage,1888,druid,restoration,493,260,233
4725,Saxhouse,illidan,1881,druid,restoration,60,34,26
4726,Nikdruidne,tichondrius,1881,druid,restoration,60,29,31
4727,Darkenëd,dalaran,1880,druid,restoration,68,41,27
4728,Aryawilliams,area-52,1880,druid,restoration,65,36,29
4729,Wìms,malganis,1879,druid,restoration,72,38,34
4730,Eddí,illidan,1872,druid,restoration,64,32,32
4731,Bashthecat,tichondrius,1871,druid,restoration,59,39,20
4732,Nersepha,gurubashi,1871,druid,restoration,54,26,28
4733,Drøgbä,tichondrius,1870,druid,restoration,30,20,10
4734,Xijinfing,tichondrius,1870,druid,restoration,42,25,17
4735,Rindy,rexxar,1869,druid,restoration,72,37,35
4736,Ksz,stormrage,1867,druid,restoration,42,25,17
4737,Holydruid,tichondrius,1867,druid,restoration,83,43,40
4738,Udoyu,barthilas,1865,druid,restoration,84,39,45
4739,Represent,tichondrius,1864,druid,restoration,48,26,22
4740,Corbind,arthas,1860,druid,restoration,280,148,132
4741,Loudswords,barthilas,1858,druid,restoration,102,50,52
4742,Lotiononmyd,illidan,1853,druid,restoration,220,118,102
4743,Bexdru,area-52,1850,druid,restoration,284,151,133
4744,Drudma,shadowmoon,1848,druid,restoration,161,90,71
4745,Rèmix,bleeding-hollow,1847,druid,restoration,42,23,19
4746,Qdeb,akama,1844,druid,restoration,48,27,21
4747,Vesoween,tichondrius,1843,druid,restoration,55,37,18
4748,Esque,stormrage,1842,druid,restoration,48,24,24
4749,Tokesh,malganis,1840,druid,restoration,72,33,39
4750,Washedgodx,mugthol,1839,druid,restoration,59,34,25
4751,Mimidelol,tichondrius,1839,druid,restoration,66,36,30
4752,Clameo,barthilas,1839,druid,restoration,102,48,54
4753,Janzak,thrall,1837,druid,restoration,48,28,20
4754,Gluesmoka,icecrown,1836,druid,restoration,54,31,23
4755,Scätmän,ragnaros,1835,druid,restoration,54,35,19
4756,Caipirinha,tichondrius,1834,druid,restoration,47,27,20
4757,Reehz,stormrage,1834,druid,restoration,53,25,28
4758,Blueclàssxx,akama,1831,druid,restoration,64,48,16
4759,Soreze,kelthuzad,1831,druid,restoration,56,35,21
4760,Ziegey,tichondrius,1829,druid,restoration,60,34,26
4761,Spiritot,tichondrius,1829,druid,restoration,59,28,31
4762,Bodytwisting,tichondrius,1828,druid,restoration,48,29,19
4763,Floofi,kelthuzad,1828,druid,restoration,54,31,23
4764,Pvpgold,illidan,1827,druid,restoration,71,39,32
4765,Rerolldr,firetree,1826,druid,restoration,42,24,18
4766,Germlol,sargeras,1825,druid,restoration,51,30,21
4767,Heymeow,tichondrius,1825,druid,restoration,60,24,36
4768,Naturae,spirestone,1823,druid,restoration,200,112,88
4769,Brendenjr,area-52,1819,druid,restoration,45,32,13
4770,Thasta,blackrock,1818,druid,restoration,140,78,62
4771,Jegara,auchindoun,1818,druid,restoration,149,81,68
4772,Badtree,tichondrius,1816,druid,restoration,104,63,41
4773,Resto,crushridge,1816,druid,restoration,86,44,42
4774,Maen,kelthuzad,1816,druid,restoration,82,39,43
4775,Currants,lightbringer,1815,druid,restoration,138,64,74
4776,Jbdontplay,sargeras,1812,druid,restoration,59,37,22
4777,Oinkme,kiljaeden,1811,druid,restoration,90,42,48
4778,Tunnaris,ragnaros,1811,druid,restoration,71,33,38
4779,Kenái,nemesis,1810,druid,restoration,30,19,11
4780,Hlchs,tichondrius,1810,druid,restoration,36,22,14
4781,Corcovado,bleeding-hollow,1809,druid,restoration,66,31,35
4782,Xgodhands,sargeras,1808,druid,restoration,30,22,8
4783,Aljalladtv,bleeding-hollow,1805,druid,restoration,30,19,11
4784,Yggdrasil,ravencrest,1805,druid,restoration,65,31,34
4785,Kayorva,gurubashi,1804,druid,restoration,47,24,23
4786,Playstyle,stormrage,1801,druid,restoration,49,25,24
4787,Fruitberry,malganis,1801,druid,restoration,53,24,29
4788,Nayko,sargeras,1801,druid,restoration,72,30,42
4789,Ivý,shadowsong,1800,druid,restoration,41,28,13
4790,Mengyu,tichondrius,1800,druid,restoration,64,41,23
4791,Kobrah,twisting-nether,1800,druid,restoration,36,20,16
4792,Geddoff,stormrage,1800,druid,restoration,135,64,71
4793,Zyhsul,emerald-dream,1799,druid,restoration,173,94,79
4794,Dannypimp,tichondrius,1795,druid,restoration,47,28,19
4795,Reizzy,sargeras,1793,druid,restoration,72,35,37
4796,Ekr,tichondrius,1779,druid,restoration,54,29,25
4797,Pineappledûe,tichondrius,1774,druid,restoration,64,33,31
4798,Jdown,dalaran,1772,druid,restoration,76,43,33
4799,Kruisberg,sargeras,1769,druid,restoration,29,19,10
4800,Leafowl,tichondrius,1767,druid,restoration,60,32,28
4801,Kwd,stormrage,1766,druid,restoration,77,51,26
4802,Anaps,frostmourne,1764,druid,restoration,120,66,54
4803,Èmax,barthilas,1763,druid,restoration,55,36,19
4804,Sùlyvahn,tichondrius,1761,druid,restoration,57,30,27
4805,Tweeguy,malganis,1761,druid,restoration,78,33,45
4806,Dsheeps,tichondrius,1760,druid,restoration,48,27,21
4807,Ellystarry,stormrage,1758,druid,restoration,90,46,44
4808,Moldragon,crushridge,1758,druid,restoration,48,24,24
4809,Gloomster,tichondrius,1756,druid,restoration,64,37,27
4810,Héisénbérg,sargeras,1755,druid,restoration,192,99,93
4811,Kellogs,malganis,1752,druid,restoration,65,26,39
4812,Flowdruid,tichondrius,1751,druid,restoration,51,26,25
4813,Bigdockepoch,sargeras,1743,druid,restoration,35,21,14
4814,Surefacts,dathremar,1738,druid,restoration,40,21,19
4815,Gsex,nemesis,1738,druid,restoration,46,24,22
4816,Branchmanagr,dark-iron,1736,druid,restoration,54,23,31
4817,Gankstanerdz,tichondrius,1732,druid,restoration,178,85,93
4818,Facegotrake,stormrage,1730,druid,restoration,114,64,50
4819,Fattdiabetic,tichondrius,1726,druid,restoration,42,24,18
4820,Wëndell,tichondrius,1720,druid,restoration,48,24,24
4821,Zrobloom,stormrage,1720,druid,restoration,69,29,40
4822,Dirtdog,uther,1719,druid,restoration,53,25,28
4823,Lovenug,shadowsong,1715,druid,restoration,179,98,81
4824,Légz,area-52,1714,druid,restoration,187,98,89
4825,Airmeodaddy,barthilas,1714,druid,restoration,99,50,49
4826,Bigmoran,tichondrius,1708,druid,restoration,54,24,30
4827,Drjelly,tichondrius,1707,druid,restoration,76,32,44
4828,Huaxià,tichondrius,1705,druid,restoration,209,114,95
4829,Yungdoinkski,icecrown,1704,druid,restoration,28,19,9
4830,Rdruid,zuluhed,1703,druid,restoration,34,24,10
4831,Pizzatimex,zuluhed,1703,druid,restoration,120,61,59
4832,Hideurkidz,tichondrius,1699,druid,restoration,39,23,16
4833,Dmxx,kiljaeden,1696,druid,restoration,33,19,14
4834,Thundercast,quelthalas,1694,druid,restoration,164,82,82
4835,Stupidtree,antonidas,1693,druid,restoration,47,28,19
4836,Sooey,wyrmrest-accord,1690,druid,restoration,85,51,34
4837,Socialyst,area-52,1688,druid,restoration,35,21,14
4838,Bramii,illidan,1686,druid,restoration,69,35,34
4839,Ayalia,saurfang,1684,druid,restoration,48,25,23
4840,Relbedo,sargeras,1681,druid,restoration,174,95,79
4841,Cienza,proudmoore,1680,druid,restoration,264,136,128
4842,Polyester,frostmourne,1679,druid,restoration,54,25,29
4843,Poliage,moon-guard,1677,druid,restoration,230,117,113
4844,Dabloleu,illidan,1675,druid,restoration,24,19,5
4845,Roen,tichondrius,1672,druid,restoration,40,21,19
4846,Boonsogan,tichondrius,1672,druid,restoration,36,18,18
4847,Remus,hydraxis,1672,druid,restoration,66,31,35
4848,Hxa,emerald-dream,1669,druid,restoration,64,31,33
4849,Enrÿu,nemesis,1668,druid,restoration,42,21,21
4850,Afkhottedyou,suramar,1667,druid,restoration,46,24,22
4851,Arwëna,tichondrius,1663,druid,restoration,72,44,28
4852,Chevy,onyxia,1663,druid,restoration,82,33,49
4853,Treeofangels,nathrezim,1662,druid,restoration,36,22,14
4854,Zblmystic,tichondrius,1662,druid,restoration,78,43,35
4855,Legitonedge,zuljin,1662,druid,restoration,55,30,25
4856,Tondrai,malganis,1659,druid,restoration,54,30,24
4857,Jathel,area-52,1659,druid,restoration,42,22,20
4858,Zoteqt,kelthuzad,1657,druid,restoration,48,25,23
4859,Lubbeck,stormrage,1653,druid,restoration,157,87,70
4860,Chimnie,malganis,1652,druid,restoration,45,27,18
4861,Notpodruida,tichondrius,1649,druid,restoration,48,28,20
4862,Druidstin,tichondrius,1649,druid,restoration,162,84,78
4863,Dbk,suramar,1648,druid,restoration,170,102,68
4864,Klamediya,illidan,1648,druid,restoration,53,21,32
4865,Psyqobloom,dalaran,1647,druid,restoration,136,78,58
4866,Widescreen,burning-blade,1647,druid,restoration,398,209,189
4867,Defteras,illidan,1647,druid,restoration,42,21,21
4868,Animalge,sargeras,1643,druid,restoration,60,25,35
4869,Sixthsex,tichondrius,1642,druid,restoration,95,51,44
4870,Dendrix,area-52,1641,druid,restoration,90,46,44
4871,Gsëx,nemesis,1640,druid,restoration,47,22,25
4872,Tayriel,area-52,1640,druid,restoration,57,26,31
4873,Sosaformx,stormrage,1639,druid,restoration,47,21,26
4874,Convokíng,kelthuzad,1639,druid,restoration,53,20,33
4875,Images,kilrogg,1638,druid,restoration,54,37,17
4876,Pkgdbts,tichondrius,1637,druid,restoration,47,22,25
4877,Breaksilence,tichondrius,1636,druid,restoration,59,36,23
4878,Birdfromtree,dalaran,1636,druid,restoration,48,26,22
4879,Pootyleaf,daggerspine,1636,druid,restoration,60,28,32
4880,Lifeboomer,ragnaros,1634,druid,restoration,79,48,31
4881,Druinin,archimonde,1634,druid,restoration,122,59,63
4882,Pekazay,illidan,1632,druid,restoration,79,41,38
4883,Luckyslot,frostmourne,1631,druid,restoration,36,21,15
4884,Moomooheal,moon-guard,1631,druid,restoration,237,124,113
4885,Krevy,nazgrel,1631,druid,restoration,114,54,60
4886,Durintor,nemesis,1630,druid,restoration,135,72,63
4887,Dexlol,area-52,1629,druid,restoration,18,17,1
4888,Pawsbutton,stormrage,1629,druid,restoration,30,20,10
4889,Aiyouyou,tichondrius,1628,druid,restoration,219,123,96
4890,Cheddy,tichondrius,1628,druid,restoration,77,43,34
4891,Addiedru,zuljin,1627,druid,restoration,69,32,37
4892,Kamisamalee,tichondrius,1626,druid,restoration,41,25,16
4893,Viscentdd,illidan,1626,druid,restoration,36,17,19
4894,Acdru,tichondrius,1624,druid,restoration,54,26,28
4895,Venomgtz,laughing-skull,1623,druid,restoration,254,139,115
4896,Sarrati,emerald-dream,1623,druid,restoration,182,98,84
4897,Rapttors,zuljin,1623,druid,restoration,48,20,28
4898,Riiccflaiir,stormrage,1622,druid,restoration,78,45,33
4899,Wolfis,malganis,1622,druid,restoration,36,20,16
4900,Cybeé,sargeras,1621,druid,restoration,48,19,29
4901,Terkpla,ragnaros,1618,druid,restoration,118,64,54
4902,Suublime,ragnaros,1618,druid,restoration,72,34,38
4903,Tigerpaw,eonar,1618,druid,restoration,59,24,35
4904,Lobsterdruid,area-52,1617,druid,restoration,36,21,15
4905,Kaperij,sargeras,1617,druid,restoration,30,17,13
4906,Asmitar,illidan,1616,druid,restoration,36,22,14
4907,Muhu,frostmourne,1615,druid,restoration,60,35,25
4908,Gødriç,tichondrius,1614,druid,restoration,221,112,109
4909,Elyl,tichondrius,1614,druid,restoration,48,23,25
4910,Dkfm,thrall,1613,druid,restoration,546,284,262
4911,Gulperberg,sargeras,1612,druid,restoration,30,25,5
4912,Soheezy,illidan,1612,druid,restoration,198,111,87
4913,Drainean,sargeras,1611,druid,restoration,30,17,13
4914,Hxm,tichondrius,1611,druid,restoration,35,17,18
4915,Pigheaddru,tichondrius,1611,druid,restoration,54,22,32
4916,Hideurchickn,tichondrius,1609,druid,restoration,36,23,13
4917,Douwantoplay,tichondrius,1607,druid,restoration,60,32,28
4918,Fhiziod,kelthuzad,1606,druid,restoration,74,44,30
4919,Jathy,area-52,1606,druid,restoration,51,21,30
4920,Kurrious,frostmourne,1605,druid,restoration,40,18,22
4921,Kimdeokbae,tichondrius,1604,druid,restoration,30,22,8
4922,Binionsolboy,illidan,1604,druid,restoration,36,18,18
4923,Qidzerker,arathor,1602,druid,restoration,119,61,58
4924,Minisavage,proudmoore,1601,druid,restoration,36,17,19
4925,Yavannita,quelthalas,1600,druid,restoration,57,36,21
4926,Hehaw,kelthuzad,1600,druid,restoration,152,87,65
4927,Sanninx,barthilas,1600,druid,restoration,54,29,25
4928,Opiumheals,sargeras,1598,druid,restoration,74,42,32
4929,Manycyclones,zuluhed,1598,druid,restoration,60,32,28
4930,Erral,malganis,1597,druid,restoration,57,26,31
4931,Kaleaky,thrall,1595,druid,restoration,99,53,46
4932,Elven,frostmourne,1594,druid,restoration,54,20,34
4933,Kznels,tichondrius,1592,druid,restoration,43,27,16
4934,Shìfty,emerald-dream,1589,druid,restoration,44,23,21
4935,Imroot,tichondrius,1588,druid,restoration,54,32,22
4936,Morphiq,tichondrius,1588,druid,restoration,147,78,69
4937,Errane,eonar,1587,druid,restoration,199,110,89
4938,Calmd,sargeras,1585,druid,restoration,30,21,9
4939,Poscow,tichondrius,1583,druid,restoration,45,25,20
4940,Shinjis,tichondrius,1582,druid,restoration,108,51,57
4941,Silentbeer,frostmourne,1581,druid,restoration,218,112,106
4942,Chutney,windrunner,1581,druid,restoration,46,21,25
4943,Armorkits,area-52,1575,druid,restoration,33,17,16
4944,Boomtastik,frostmourne,1574,druid,restoration,108,46,62
4945,Møøncry,ragnaros,1571,druid,restoration,154,73,81
4946,Woshiyigede,frostmourne,1571,druid,restoration,98,43,55
4947,Nerfthedruid,blackrock,1569,druid,restoration,36,25,11
4948,Gìtgoodtrash,frostmourne,1569,druid,restoration,82,41,41
4949,Lauramavra,azralon,1568,druid,restoration,334,179,155
4950,Sombér,eitrigg,1568,druid,restoration,72,24,48
4951,Duragx,bleeding-hollow,1567,druid,restoration,100,62,38
4952,Manzar,illidan,1566,druid,restoration,42,22,20
4953,Moonpaws,frostmourne,1564,druid,restoration,36,22,14
4954,Zyzzema,frostmourne,1559,druid,restoration,174,82,92
4955,Staraborn,stormrage,1558,druid,restoration,409,217,192
4956,Ojotasesina,ragnaros,1557,druid,restoration,48,22,26
4957,Naturist,kelthuzad,1557,druid,restoration,53,19,34
4958,Dumberdruid,frostmourne,1553,druid,restoration,36,20,16
4959,Hayase,tichondrius,1551,druid,restoration,42,25,17
4960,Gunnymad,tichondrius,1549,druid,restoration,36,21,15
4961,Gonimydear,proudmoore,1549,druid,restoration,216,108,108
4962,Meniscus,arthas,1549,druid,restoration,59,25,34
4963,Druxe,zuljin,1546,druid,restoration,115,53,62
4964,Rasgabuxoh,azralon,1545,druid,restoration,41,21,20
4965,Bedlam,zuljin,1544,druid,restoration,60,25,35
4966,Moonyy,emerald-dream,1542,druid,restoration,42,20,22
4967,Leleoceo,azralon,1541,druid,restoration,30,19,11
4968,Maplêleaf,moon-guard,1539,druid,restoration,414,216,198
4969,Bruitzya,barthilas,1537,druid,restoration,45,30,15
4970,Frydaze,tichondrius,1535,druid,restoration,54,26,28
4971,Evokade,dalaran,1534,druid,restoration,42,28,14
4972,Hravan,dentarg,1534,druid,restoration,49,26,23
4973,Jrën,tichondrius,1533,druid,restoration,24,16,8
4974,Nikotser,dreadmaul,1531,druid,restoration,39,18,21
4975,Zhn,sargeras,1530,druid,restoration,35,21,14
4976,Utterhots,bleeding-hollow,1530,druid,restoration,174,98,76
4977,Rizzit,wyrmrest-accord,1530,druid,restoration,352,186,166
4978,Ourse,frostmourne,1528,druid,restoration,35,23,12
4979,Creamjr,tichondrius,1528,druid,restoration,30,16,14
4980,Unis,tichondrius,1528,druid,restoration,37,19,18
4981,Poscod,tichondrius,1528,druid,restoration,54,24,30
4982,Spurzky,emerald-dream,1526,druid,restoration,46,26,20
4983,Pilcosbie,stormrage,1526,druid,restoration,42,21,21
4984,Mortqt,tichondrius,1524,druid,restoration,96,44,52
4985,Swiftydel,frostmourne,1522,druid,restoration,109,61,48
4986,Madowl,tichondrius,1522,druid,restoration,48,22,26
4987,Seamandeman,sargeras,1520,druid,restoration,119,64,55
4988,Classydruid,spinebreaker,1520,druid,restoration,295,152,143
4989,Aberdare,tichondrius,1519,druid,restoration,141,78,63
4990,Buffdisc,darkspear,1518,druid,restoration,18,16,2
4991,Furrytorpedo,tichondrius,1518,druid,restoration,54,30,24
4992,Oneinchclaw,malganis,1518,druid,restoration,176,96,80
4993,Bfaboomy,stormrage,1517,druid,restoration,30,16,14
4994,Lilbigcow,gnomeregan,1515,druid,restoration,176,77,99
4995,Hotwolf,tichondrius,1510,druid,restoration,42,26,16
4996,Icehulk,kelthuzad,1510,druid,restoration,30,16,14
4997,Roachsan,tichondrius,1510,druid,restoration,103,54,49
4998,Cndistance,tichondrius,1509,druid,restoration,83,42,41
4999,Methyld,frostmourne,1508,druid,restoration,96,36,60
5000,Cokernut,tichondrius,1507,druid,restoration,30,16,14
5001,Sanitaizr,arthas,1506,druid,restoration,54,25,29
5002,Empcassi,wyrmrest-accord,1505,druid,restoration,95,59,36
5003,Baduret,dalaran,1505,druid,restoration,55,33,22
5004,Lolomas,proudmoore,1501,druid,restoration,48,22,26
5005,Redpigo,tichondrius,1497,druid,restoration,36,18,18
5006,Junjunxi,tichondrius,1496,druid,restoration,36,26,10
5007,Redo,zuluhed,1496,druid,restoration,30,16,14
5008,Mxlasthope,stormrage,1495,druid,restoration,47,26,21
5009,Overthink,daggerspine,1492,druid,restoration,24,16,8
5010,Barecow,tichondrius,1491,druid,restoration,105,58,47
5011,Akeven,illidan,1491,druid,restoration,68,31,37
5012,Berzz,frostmourne,1487,druid,restoration,229,112,117
5013,Dypx,tichondrius,1485,druid,restoration,172,85,87
5014,Rowlex,moon-guard,1483,druid,restoration,22,17,5
5015,Bodyluvlee,zuljin,1482,druid,restoration,80,44,36
5016,Hotemz,dragonmaw,1481,druid,restoration,78,43,35
5017,Knottywood,muradin,1481,druid,restoration,53,28,25
5018,Stonemonkey,sargeras,1480,druid,restoration,85,38,47
5019,Counsyl,silvermoon,1478,druid,restoration,30,18,12
5020,Varmint,bleeding-hollow,1477,druid,restoration,88,52,36
5021,Pëndulum,illidan,1477,druid,restoration,78,34,44
5022,Zoeishyper,sargeras,1477,druid,restoration,47,18,29
5023,Gizho,dark-iron,1476,druid,restoration,33,19,14
5024,Meruemoo,tichondrius,1476,druid,restoration,374,186,188
5025,Selling,moon-guard,1476,druid,restoration,60,27,33
5026,Growl,jubeithos,1476,druid,restoration,48,19,29
5027,Pancitas,quelthalas,1475,druid,restoration,108,57,51
5028,Ojdidnt,bleeding-hollow,1474,druid,restoration,33,17,16
5029,Sowo,sargeras,1474,druid,restoration,42,20,22
5030,Rlzdruid,tichondrius,1474,druid,restoration,70,31,39
5031,Lutein,tichondrius,1474,druid,restoration,77,31,46
5032,Bobx,kelthuzad,1467,druid,restoration,66,26,40
5033,Hdruid,tichondrius,1465,druid,restoration,160,79,81
5034,Spuncone,frostmourne,1463,druid,restoration,42,24,18
5035,Greylyth,moon-guard,1462,druid,restoration,66,33,33
5036,Tandrood,tichondrius,1462,druid,restoration,54,24,30
5037,Unpeelable,stormrage,1460,druid,restoration,24,16,8
5038,Gokki,zuljin,1459,druid,restoration,40,25,15
5039,Elliar,akama,1459,druid,restoration,78,38,40
5040,Léaf,velen,1457,druid,restoration,74,40,34
5041,Bitsandbobs,tichondrius,1457,druid,restoration,119,48,71
5042,Faramar,sargeras,1456,druid,restoration,35,16,19
5043,Fukwitmefamo,kelthuzad,1455,druid,restoration,64,36,28
5044,Lothail,windrunner,1454,druid,restoration,30,19,11
5045,Volktots,bleeding-hollow,1453,druid,restoration,102,55,47
5046,Chaníng,frostmourne,1452,druid,restoration,36,18,18
5047,Gypsysoul,barthilas,1450,druid,restoration,29,16,13
5048,Busanmilk,tichondrius,1445,druid,restoration,60,29,31
5049,Shapedance,sargeras,1445,druid,restoration,78,33,45
5050,Weedmunchies,kelthuzad,1443,druid,restoration,48,23,25
5051,Rikishi,executus,1441,druid,restoration,52,27,25
5052,Druidnim,tichondrius,1441,druid,restoration,72,34,38
5053,Fergsy,frostmourne,1440,druid,restoration,30,19,11
5054,Larissaelar,tichondrius,1438,druid,restoration,18,15,3
5055,Ÿozsh,azralon,1436,druid,restoration,58,36,22
5056,Lusam,korialstrasz,1435,druid,restoration,40,23,17
5057,Zaelos,proudmoore,1435,druid,restoration,60,23,37
5058,Hoebaz,tichondrius,1434,druid,restoration,24,15,9
5059,Rougaroux,andorhal,1434,druid,restoration,168,75,93
5060,Arkenix,velen,1433,druid,restoration,42,21,21
5061,Jonnygg,illidan,1433,druid,restoration,36,15,21
5062,Clubroot,sargeras,1433,druid,restoration,48,19,29
5063,Vuru,azralon,1432,druid,restoration,72,33,39
5064,Vakimumu,anubarak,1429,druid,restoration,96,46,50
5065,Sakpase,area-52,1428,druid,restoration,30,15,15
5066,Grimo,illidan,1427,druid,restoration,38,23,15
5067,Treelomilo,stormrage,1427,druid,restoration,85,49,36
5068,Thornblade,stormrage,1427,druid,restoration,30,15,15
5069,Strokingmyd,illidan,1427,druid,restoration,63,31,32
5070,Spoogel,area-52,1426,druid,restoration,37,17,20
5071,Hyne,emerald-dream,1425,druid,restoration,114,62,52
5072,Bruujz,moon-guard,1424,druid,restoration,54,33,21
5073,Blinxxy,bleeding-hollow,1423,druid,restoration,42,21,21
5074,Nestaballo,illidan,1422,druid,restoration,136,74,62
5075,Shirô,bleeding-hollow,1421,druid,restoration,115,59,56
5076,Prevail,nazgrel,1420,druid,restoration,127,66,61
5077,Saego,draktharon,1419,druid,restoration,30,18,12
5078,Haymade,sargeras,1419,druid,restoration,84,40,44
5079,Cakeinalake,bleeding-hollow,1417,druid,restoration,24,15,9
5080,Lucked,tichondrius,1415,druid,restoration,24,15,9
5081,Aristeus,kelthuzad,1414,druid,restoration,269,143,126
5082,Komaner,frostmourne,1414,druid,restoration,48,21,27
5083,Cinderellax,illidan,1412,druid,restoration,30,20,10
5084,Kaerrort,sargeras,1412,druid,restoration,26,15,11
5085,Hibernate,illidan,1411,druid,restoration,30,15,15
5086,Tippsyy,frostmane,1411,druid,restoration,100,42,58
5087,Brandonxerox,tichondrius,1410,druid,restoration,45,24,21
5088,Verkara,stormrage,1410,druid,restoration,94,42,52
5089,Eviltwín,frostmourne,1409,druid,restoration,42,22,20
5090,Meepø,mugthol,1409,druid,restoration,115,60,55
5091,Approx,tichondrius,1409,druid,restoration,145,68,77
5092,Tickman,altar-of-storms,1409,druid,restoration,48,22,26
5093,Cutely,tichondrius,1408,druid,restoration,171,84,87
5094,Ozanji,wyrmrest-accord,1406,druid,restoration,30,17,13
5095,Xhoz,tichondrius,1406,druid,restoration,213,113,100
5096,Isiliar,nerzhul,1405,druid,restoration,66,35,31
5097,Anotherstar,frostmourne,1403,druid,restoration,175,87,88
5098,Twentyfour,laughing-skull,1402,druid,restoration,72,30,42
5099,Gôdôfwow,tichondrius,1402,druid,restoration,77,31,46
5100,Pÿe,bleeding-hollow,1401,druid,restoration,30,15,15
5101,Biggucci,stonemaul,1399,druid,restoration,30,18,12
5102,Kybecruz,stormrage,1399,druid,restoration,103,52,51
5103,Ursiiday,sargeras,1399,druid,restoration,90,32,58
5104,Astrosapien,moon-guard,1397,druid,restoration,42,27,15
5105,Pouncing,sargeras,1397,druid,restoration,56,29,27
5106,Bobobear,proudmoore,1397,druid,restoration,66,28,38
5107,Cyclone,mugthol,1396,druid,restoration,24,19,5
5108,Seizuressld,stormrage,1395,druid,restoration,81,46,35
5109,Bridgerén,tichondrius,1395,druid,restoration,36,15,21
5110,Fryy,balnazzar,1394,druid,restoration,36,17,19
5111,Murkeÿ,frostmourne,1391,druid,restoration,24,15,9
5112,Onblue,tichondrius,1391,druid,restoration,44,27,17
5113,Lorern,eldrethalas,1390,druid,restoration,60,30,30
5114,Lexut,ragnaros,1388,druid,restoration,36,16,20
5115,Drchronic,boulderfist,1387,druid,restoration,59,32,27
5116,Kroshape,stormrage,1385,druid,restoration,49,22,27
5117,Darimmx,mannoroth,1384,druid,restoration,126,64,62
5118,Nanniel,tichondrius,1383,druid,restoration,54,24,30
5119,Mkat,illidan,1383,druid,restoration,48,19,29
5120,Haful,emerald-dream,1382,druid,restoration,45,23,22
5121,Icastsmells,tichondrius,1381,druid,restoration,57,36,21
5122,Maviç,hyjal,1380,druid,restoration,287,147,140
5123,Okiesmokied,proudmoore,1378,druid,restoration,30,17,13
5124,Clarice,shattered-halls,1376,druid,restoration,42,17,25
5125,Lostnsauce,tichondrius,1375,druid,restoration,72,30,42
5126,Maaui,sargeras,1374,druid,restoration,48,24,24
5127,Jimjab,stormreaver,1371,druid,restoration,66,39,27
5128,Fioryxd,bleeding-hollow,1370,druid,restoration,47,26,21
5129,Horymory,darkspear,1370,druid,restoration,216,109,107
5130,Pollished,kelthuzad,1369,druid,restoration,89,50,39
5131,Azshunara,moon-guard,1369,druid,restoration,84,43,41
5132,Deamondruidz,kaelthas,1367,druid,restoration,78,31,47
5133,Farmageddon,thunderhorn,1365,druid,restoration,58,33,25
5134,Poutyface,sargeras,1364,druid,restoration,152,67,85
5135,Vinnydruid,tichondrius,1364,druid,restoration,35,15,20
5136,Rawrl,illidan,1363,druid,restoration,36,16,20
5137,Edraen,zuljin,1362,druid,restoration,137,67,70
5138,Daku,moknathal,1362,druid,restoration,64,31,33
5139,Vondutch,tichondrius,1362,druid,restoration,60,24,36
5140,Sorrinn,tichondrius,1361,druid,restoration,36,17,19
5141,Skêet,tichondrius,1359,druid,restoration,49,28,21
5142,Santiagowski,ragnaros,1359,druid,restoration,52,26,26
5143,Shifftycent,trollbane,1359,druid,restoration,54,26,28
5144,Amandi,magtheridon,1358,druid,restoration,42,23,19
5145,Bloodshadez,tichondrius,1358,druid,restoration,38,20,18
5146,Lorca,stormrage,1357,druid,restoration,60,35,25
5147,Wythrim,quelthalas,1357,druid,restoration,30,17,13
5148,Silit,tichondrius,1355,druid,restoration,78,41,37
5149,Kergai,emerald-dream,1355,druid,restoration,102,53,49
5150,Muatigorn,blackrock,1354,druid,restoration,50,25,25
5151,Jungleakso,tichondrius,1354,druid,restoration,36,18,18
5152,Duckyy,garithos,1354,druid,restoration,60,24,36
5153,Bigrich,malorne,1352,druid,restoration,48,23,25
5154,Oobuck,kilrogg,1350,druid,restoration,123,63,60
5155,Kevarcen,dalaran,1350,druid,restoration,161,79,82
5156,Heniuhojia,tichondrius,1348,druid,restoration,24,15,9
5157,Malfurionis,tichondrius,1347,druid,restoration,42,17,25
5158,Branu,hyjal,1347,druid,restoration,42,15,27
5159,Corkybucek,frostmourne,1346,druid,restoration,56,32,24
5160,Izzabelle,deathwing,1344,druid,restoration,31,17,14
5161,Amanthw,tichondrius,1344,druid,restoration,77,34,43
5162,Delody,tichondrius,1343,druid,restoration,38,23,15
5163,Puzzlebox,illidan,1343,druid,restoration,24,14,10
5164,Kimnim,tichondrius,1343,druid,restoration,108,57,51
5165,Mandingodam,auchindoun,1341,druid,restoration,36,16,20
5166,Cantmeldthis,zuljin,1340,druid,restoration,30,14,16
5167,Bearthisnut,bonechewer,1340,druid,restoration,36,15,21
5168,Bleedhoof,frostmourne,1340,druid,restoration,48,19,29
5169,Hoeba,tichondrius,1339,druid,restoration,24,14,10
5170,Redness,daggerspine,1339,druid,restoration,37,19,18
5171,Groschats,area-52,1339,druid,restoration,42,14,28
5172,Ripberg,chogall,1338,druid,restoration,30,14,16
5173,Cznfik,area-52,1338,druid,restoration,78,32,46
5174,Eraticdruid,illidan,1338,druid,restoration,42,16,26
5175,Doglightning,illidan,1336,druid,restoration,25,15,10
5176,Kronik,jubeithos,1336,druid,restoration,79,25,54
5177,Beefyhealz,emerald-dream,1335,druid,restoration,91,56,35
5178,Petmydeadcow,illidan,1335,druid,restoration,157,78,79
5179,Vecuronium,tichondrius,1335,druid,restoration,30,14,16
5180,Joopsy,tichondrius,1332,druid,restoration,269,141,128
5181,Anchunlol,tichondrius,1332,druid,restoration,36,18,18
5182,Mudpi,illidan,1332,druid,restoration,71,34,37
5183,Turftiger,stormrage,1331,druid,restoration,30,16,14
5184,Bukbukboom,thunderlord,1331,druid,restoration,35,16,19
5185,Toslick,kelthuzad,1330,druid,restoration,183,98,85
5186,Girthture,tichondrius,1330,druid,restoration,130,63,67
5187,Dolwizz,tichondrius,1330,druid,restoration,126,54,72
5188,Kritscawk,sargeras,1329,druid,restoration,60,33,27
5189,Hynz,barthilas,1327,druid,restoration,36,15,21
5190,Dunedaddy,silvermoon,1326,druid,restoration,48,27,21
5191,Dokasaurus,lightbringer,1325,druid,restoration,36,17,19
5192,Phåtkid,darkspear,1322,druid,restoration,48,24,24
5193,Hippystick,tichondrius,1321,druid,restoration,52,24,28
5194,Puntcounder,sargeras,1320,druid,restoration,40,21,19
5195,Nxghtfall,tichondrius,1319,druid,restoration,122,65,57
5196,Feraldudu,illidan,1319,druid,restoration,97,49,48
5197,Undaunted,bloodhoof,1319,druid,restoration,30,14,16
5198,Youngteezy,barthilas,1319,druid,restoration,142,53,89
5199,Tîgerlily,proudmoore,1318,druid,restoration,42,16,26
5200,Áçxpërt,jubeithos,1316,druid,restoration,24,14,10
5201,Rwi,tichondrius,1316,druid,restoration,111,51,60
5202,Controlyolo,stormrage,1314,druid,restoration,48,22,26
5203,Zelyvia,moon-guard,1313,druid,restoration,24,14,10
5204,Freehealjob,lightnings-blade,1313,druid,restoration,30,14,16
5205,Gladelf,sargeras,1312,druid,restoration,282,141,141
5206,Kzinti,zuluhed,1312,druid,restoration,30,14,16
5207,Donnà,tichondrius,1310,druid,restoration,43,21,22
5208,Adaralia,tichondrius,1310,druid,restoration,64,27,37
5209,Ghirox,stormrage,1306,druid,restoration,54,26,28
5210,Minokawa,kargath,1305,druid,restoration,44,23,21
5211,Dgdruid,tichondrius,1305,druid,restoration,48,24,24
5212,Benjixx,proudmoore,1305,druid,restoration,48,20,28
5213,Dolanaar,stormrage,1304,druid,restoration,161,86,75
5214,Reyvin,illidan,1304,druid,restoration,79,32,47
5215,Gaawdx,illidan,1303,druid,restoration,54,25,29
5216,Taufik,azralon,1301,druid,restoration,42,15,27
5217,Needabandaid,arthas,1300,druid,restoration,54,26,28
5218,Yoshí,emerald-dream,1299,druid,restoration,51,22,29
5219,Purpleleaves,stormrage,1299,druid,restoration,119,51,68
5220,Bigherbo,zuljin,1298,druid,restoration,187,98,89
5221,Kittyboiz,illidan,1298,druid,restoration,72,37,35
5222,Haohomie,tichondrius,1297,druid,restoration,59,31,28
5223,Aaughh,sargeras,1297,druid,restoration,70,33,37
5224,Lighthoof,mannoroth,1296,druid,restoration,30,17,13
5225,Rooroo,ragnaros,1296,druid,restoration,28,15,13
5226,Pronewb,frostmourne,1295,druid,restoration,24,18,6
5227,Melbian,tichondrius,1295,druid,restoration,124,70,54
5228,Entydruid,khazgoroth,1295,druid,restoration,34,19,15
5229,Plagiarist,stormrage,1295,druid,restoration,44,20,24
5230,Ohhshiift,tichondrius,1295,druid,restoration,33,14,19
5231,Dankmids,hyjal,1294,druid,restoration,30,19,11
5232,Elvishchamp,mugthol,1294,druid,restoration,35,17,18
5233,Kuwä,proudmoore,1293,druid,restoration,274,135,139
5234,Feutrine,zuljin,1292,druid,restoration,24,14,10
5235,Caustìk,malganis,1291,druid,restoration,70,38,32
5236,Haneulso,tichondrius,1290,druid,restoration,55,30,25
5237,Standee,sargeras,1290,druid,restoration,48,18,30
5238,Magicrock,moon-guard,1285,druid,restoration,42,23,19
5239,Apoxi,arygos,1284,druid,restoration,42,24,18
5240,Quss,tichondrius,1283,druid,restoration,25,15,10
5241,Rígo,frostmourne,1282,druid,restoration,27,16,11
5242,Ananan,burning-blade,1282,druid,restoration,101,49,52
5243,Ravendar,moon-guard,1282,druid,restoration,89,39,50
5244,Shallowcat,tichondrius,1281,druid,restoration,65,28,37
5245,Däll,tichondrius,1280,druid,restoration,48,20,28
5246,Chyx,stormreaver,1280,druid,restoration,50,20,30
5247,Nogàrd,arygos,1279,druid,restoration,23,14,9
5248,Birdie,dalvengyr,1279,druid,restoration,37,20,17
5249,Morphios,barthilas,1279,druid,restoration,82,40,42
5250,Naseebo,frostmourne,1279,druid,restoration,67,25,42
5251,Zambyr,azralon,1278,druid,restoration,66,28,38
5252,Rawbacon,blackrock,1278,druid,restoration,50,18,32
5253,Whispurrz,tichondrius,1277,druid,restoration,391,200,191
5254,Elendriss,quelthalas,1277,druid,restoration,85,42,43
5255,Afonso,frostmourne,1276,druid,restoration,50,26,24
5256,Wp,proudmoore,1275,druid,restoration,80,42,38
5257,Odcerberus,azralon,1275,druid,restoration,42,21,21
5258,Juuru,stormreaver,1272,druid,restoration,36,27,9
5259,Thericebags,illidan,1272,druid,restoration,161,86,75
5260,Darksteak,tichondrius,1272,druid,restoration,214,111,103
5261,Tenhoteta,goldrinn,1272,druid,restoration,48,22,26
5262,Jruids,stormrage,1272,druid,restoration,54,23,31
5263,Hellahots,spinebreaker,1271,druid,restoration,29,18,11
5264,Drazibaz,thrall,1271,druid,restoration,42,24,18
5265,Sxlanderx,malganis,1271,druid,restoration,118,58,60
5266,Diglit,malganis,1271,druid,restoration,70,28,42
5267,Ephemere,emerald-dream,1268,druid,restoration,40,20,20
5268,Lynncheeks,spirestone,1267,druid,restoration,77,44,33
5269,Tallenzz,lightninghoof,1265,druid,restoration,96,53,43
5270,Cleptoresto,dalaran,1265,druid,restoration,46,16,30
5271,Elgatomarica,ragnaros,1264,druid,restoration,35,20,15
5272,Shanê,proudmoore,1263,druid,restoration,61,31,30
5273,Iambeefy,hyjal,1263,druid,restoration,233,116,117
5274,Slév,frostmourne,1263,druid,restoration,35,17,18
5275,Acexten,tichondrius,1262,druid,restoration,36,18,18
5276,Thõrr,tichondrius,1262,druid,restoration,42,16,26
5277,Aterra,ragnaros,1261,druid,restoration,92,44,48
5278,Asaphelps,stormrage,1260,druid,restoration,28,14,14
5279,Ceejaé,tichondrius,1259,druid,restoration,70,36,34
5280,Nanate,sargeras,1259,druid,restoration,47,24,23
5281,Vexcey,sargeras,1258,druid,restoration,29,16,13
5282,Greenvibes,drakkari,1257,druid,restoration,77,42,35
5283,Lindi,kelthuzad,1257,druid,restoration,78,42,36
5284,Bovindickus,tichondrius,1257,druid,restoration,66,28,38
5285,Kerrzo,frostmourne,1256,druid,restoration,36,17,19
5286,Filthyclaws,stormrage,1256,druid,restoration,35,14,21
5287,Crackheads,tichondrius,1255,druid,restoration,91,45,46
5288,Travys,sargeras,1255,druid,restoration,42,20,22
5289,Groõt,barthilas,1253,druid,restoration,177,82,95
5290,Skotty,hyjal,1253,druid,restoration,66,30,36
5291,Rockmeifucan,greymane,1253,druid,restoration,78,33,45
5292,Chowyunfats,proudmoore,1251,druid,restoration,331,170,161
5293,Katherine,moon-guard,1251,druid,restoration,132,62,70
5294,Yakuho,proudmoore,1250,druid,restoration,32,20,12
5295,Carlosd,tichondrius,1250,druid,restoration,58,33,25
5296,Romcom,demon-soul,1250,druid,restoration,48,27,21
5297,Jacknit,illidan,1250,druid,restoration,28,15,13
5298,Airmíd,illidan,1250,druid,restoration,68,22,46
5299,Saelyle,illidan,1248,druid,restoration,53,28,25
5300,Skymund,tichondrius,1247,druid,restoration,50,26,24
5301,Yaato,illidan,1247,druid,restoration,96,46,50
5302,Ninzor,tichondrius,1247,druid,restoration,30,13,17
5303,Cøkelol,zuljin,1246,druid,restoration,52,29,23
5304,Jnzid,area-52,1244,druid,restoration,29,13,16
5305,Hgoo,tichondrius,1244,druid,restoration,30,13,17
5306,Bunrack,nerzhul,1243,druid,restoration,57,30,27
5307,Krözjk,quelthalas,1243,druid,restoration,57,26,31
5308,Fórmérfáttý,kelthuzad,1242,druid,restoration,18,13,5
5309,Goosebümps,stormrage,1242,druid,restoration,24,13,11
5310,Perilous,malygos,1242,druid,restoration,24,13,11
5311,Sharkhotzlol,frostmourne,1242,druid,restoration,42,14,28
5312,Kasannaommi,sargeras,1241,druid,restoration,96,49,47
5313,Speaks,moon-guard,1240,druid,restoration,131,62,69
5314,Kendoboos,moon-guard,1240,druid,restoration,72,32,40
5315,Cuccii,sargeras,1240,druid,restoration,30,13,17
5316,Socktad,illidan,1240,druid,restoration,36,13,23
5317,Sarojna,malganis,1239,druid,restoration,18,13,5
5318,Kustumsdog,tichondrius,1239,druid,restoration,24,13,11
5319,Healingcute,tichondrius,1239,druid,restoration,131,70,61
5320,Lazza,blackhand,1239,druid,restoration,28,14,14
5321,Feldstarx,stormrage,1238,druid,restoration,24,13,11
5322,Larc,frostwolf,1238,druid,restoration,76,39,37
5323,Magzally,stormrage,1238,druid,restoration,30,13,17
5324,Kyndel,kiljaeden,1237,druid,restoration,44,22,22
5325,Amatxu,ragnaros,1237,druid,restoration,129,64,65
5326,Galadrielcn,tichondrius,1235,druid,restoration,42,15,27
5327,Lissette,thrall,1234,druid,restoration,24,13,11
5328,Veganz,moon-guard,1233,druid,restoration,145,71,74
5329,Svarne,kiljaeden,1232,druid,restoration,59,29,30
5330,Shekelsnätch,area-52,1231,druid,restoration,42,21,21
5331,Smilax,eonar,1231,druid,restoration,71,29,42
5332,Mhdd,tichondrius,1230,druid,restoration,54,25,29
5333,Slev,frostmourne,1229,druid,restoration,24,13,11
5334,Rahaab,sargeras,1229,druid,restoration,38,13,25
5335,Preachirr,lightbringer,1227,druid,restoration,18,13,5
5336,Kupos,lightbringer,1227,druid,restoration,27,13,14
5337,Bhagwan,area-52,1227,druid,restoration,48,18,30
5338,Imakitty,aerie-peak,1226,druid,restoration,121,62,59
5339,Carneluna,area-52,1226,druid,restoration,66,31,35
5340,Suye,tichondrius,1226,druid,restoration,66,30,36
5341,Xay,runetotem,1225,druid,restoration,36,20,16
5342,Wildwhisper,moon-guard,1225,druid,restoration,96,50,46
5343,Carllo,blackrock,1225,druid,restoration,48,23,25
5344,Junglefists,frostmourne,1223,druid,restoration,162,81,81
5345,Bumî,zuljin,1223,druid,restoration,30,13,17
5346,Yellowstone,drakthul,1222,druid,restoration,42,23,19
5347,Purrfact,frostmourne,1222,druid,restoration,30,13,17
5348,Torofarmeon,quelthalas,1221,druid,restoration,57,32,25
5349,Anothersalad,stormrage,1221,druid,restoration,66,32,34
5350,Beladrexx,stormrage,1221,druid,restoration,54,21,33
5351,Sneakysoren,kelthuzad,1219,druid,restoration,48,21,27
5352,Druidkingdk,stormrage,1218,druid,restoration,29,18,11
5353,Ännä,moon-guard,1217,druid,restoration,30,13,17
5354,Malice,undermine,1215,druid,restoration,54,24,30
5355,Mcriblet,illidan,1213,druid,restoration,46,23,23
5356,Greemer,sargeras,1213,druid,restoration,39,18,21
5357,Bunnyes,tichondrius,1212,druid,restoration,59,29,30
5358,Gryel,area-52,1211,druid,restoration,235,122,113
5359,Dalrei,jubeithos,1211,druid,restoration,30,13,17
5360,Tworax,frostmourne,1210,druid,restoration,36,14,22
5361,Ulfaren,frostmourne,1209,druid,restoration,24,15,9
5362,Gossìpgoat,frostmourne,1209,druid,restoration,86,42,44
5363,Pyrogenics,whisperwind,1209,druid,restoration,42,20,22
5364,Trolbearpig,malganis,1208,druid,restoration,24,13,11
5365,Beleraine,moon-guard,1208,druid,restoration,40,17,23
5366,Zoeyx,tichondrius,1207,druid,restoration,61,36,25
5367,Tìssuebox,malganis,1207,druid,restoration,75,32,43
5368,Madsewerslvt,stormrage,1206,druid,restoration,161,77,84
5369,Prudence,azralon,1205,druid,restoration,48,25,23
5370,Tuskdaddie,sargeras,1204,druid,restoration,30,17,13
5371,Bearuffinz,malganis,1204,druid,restoration,88,42,46
5372,Blürry,area-52,1203,druid,restoration,42,13,29
5373,Meôwmix,stormrage,1202,druid,restoration,24,13,11
5374,Lizzelune,drakkari,1202,druid,restoration,88,42,46
5375,Imrac,boulderfist,1202,druid,restoration,48,17,31
5376,Cuddles,moon-guard,1201,druid,restoration,137,67,70
5377,Driftwood,bonechewer,1201,druid,restoration,64,27,37
5378,Razakka,stormrage,1201,druid,restoration,47,13,34
5379,Bikacat,kelthuzad,1200,druid,restoration,24,13,11
5380,Dankcentral,frostwolf,1198,druid,restoration,106,57,49
5381,Dimzim,lightbringer,1198,druid,restoration,66,31,35
5382,Panorämix,nemesis,1197,druid,restoration,18,13,5
5383,Feanah,tichondrius,1197,druid,restoration,32,14,18
5384,Nugren,thrall,1195,druid,restoration,50,22,28
5385,Clawriander,barthilas,1192,druid,restoration,120,60,60
5386,Sweetcorn,malganis,1192,druid,restoration,40,16,24
5387,Jonculler,korgath,1190,druid,restoration,63,29,34
5388,Guislstwo,azralon,1190,druid,restoration,52,22,30
5389,Cheddastov,illidan,1189,druid,restoration,27,14,13
5390,Knowgo,tichondrius,1188,druid,restoration,54,28,26
5391,Longisland,quelthalas,1188,druid,restoration,84,38,46
5392,Tarzzan,drakkari,1186,druid,restoration,24,18,6
5393,Adarindre,aerie-peak,1185,druid,restoration,93,46,47
5394,Alewild,quelthalas,1185,druid,restoration,54,26,28
5395,Dainehoof,area-52,1185,druid,restoration,66,28,38
5396,Panacaea,windrunner,1184,druid,restoration,48,27,21
5397,Pawpurrazzi,moon-guard,1183,druid,restoration,17,13,4
5398,Höneyfang,moon-guard,1183,druid,restoration,89,51,38
5399,Hadoriss,kelthuzad,1183,druid,restoration,48,18,30
5400,Edbtw,azralon,1182,druid,restoration,98,46,52
5401,Frames,area-52,1181,druid,restoration,246,122,124
5402,Worgbearpig,destromath,1180,druid,restoration,32,14,18
5403,Valeñtine,dalaran,1179,druid,restoration,78,39,39
5404,Julx,nordrassil,1178,druid,restoration,21,14,7
5405,Lewïs,stormrage,1178,druid,restoration,144,79,65
5406,Drexsabex,tichondrius,1176,druid,restoration,42,25,17
5407,Deximus,wyrmrest-accord,1173,druid,restoration,24,13,11
5408,Alastras,tichondrius,1173,druid,restoration,36,18,18
5409,Hruke,illidan,1173,druid,restoration,42,17,25
5410,Foxbear,garona,1172,druid,restoration,57,38,19
5411,Schlotzsky,skullcrusher,1171,druid,restoration,69,37,32
5412,Layala,sargeras,1171,druid,restoration,90,43,47
5413,Mf,stormscale,1171,druid,restoration,30,14,16
5414,Vantorsydmel,proudmoore,1167,druid,restoration,46,24,22
5415,Chixao,tichondrius,1166,druid,restoration,23,13,10
5416,Aramá,drakkari,1166,druid,restoration,43,21,22
5417,Fortnitburgr,tichondrius,1165,druid,restoration,24,13,11
5418,Matpd,norgannon,1165,druid,restoration,124,61,63
5419,Elylaylalar,moon-guard,1165,druid,restoration,66,31,35
5420,Yanga,malfurion,1163,druid,restoration,48,27,21
5421,Sodury,tichondrius,1161,druid,restoration,178,99,79
5422,Sarangzzang,tichondrius,1159,druid,restoration,37,22,15
5423,Pachacamac,dragonmaw,1159,druid,restoration,36,21,15
5424,Bäñgarang,tichondrius,1159,druid,restoration,78,41,37
5425,Lenori,vashj,1159,druid,restoration,48,24,24
5426,Smhyle,frostmourne,1158,druid,restoration,41,21,20
5427,Kitiano,thunderlord,1158,druid,restoration,66,25,41
5428,Crunchyleafs,thrall,1157,druid,restoration,23,18,5
5429,Lünaä,quelthalas,1155,druid,restoration,71,47,24
5430,Tardcakes,tichondrius,1155,druid,restoration,98,39,59
5431,Jabawockdeez,area-52,1152,druid,restoration,36,22,14
5432,Doah,kelthuzad,1152,druid,restoration,24,12,12
5433,Hoedrufroza,tichondrius,1152,druid,restoration,24,12,12
5434,Pekingcuckoo,illidan,1152,druid,restoration,24,12,12
5435,Rekelberg,sargeras,1151,druid,restoration,18,12,6
5436,Fanboy,magtheridon,1151,druid,restoration,18,12,6
5437,Beecammy,frostmourne,1151,druid,restoration,54,31,23
5438,Blackmoomba,kiljaeden,1150,druid,restoration,16,13,3
5439,Tiggor,ghostlands,1150,druid,restoration,18,12,6
5440,Ðruìd,gnomeregan,1150,druid,restoration,24,12,12
5441,Iheartpvp,tichondrius,1150,druid,restoration,63,30,33
5442,Nodab,tichondrius,1150,druid,restoration,30,12,18
5443,Concordya,tichondrius,1149,druid,restoration,59,29,30
5444,Mommymilkers,jubeithos,1149,druid,restoration,54,14,40
5445,Æpex,lightnings-blade,1148,druid,restoration,30,16,14
5446,Patada,sargeras,1148,druid,restoration,30,12,18
5447,Dampchamp,illidan,1148,druid,restoration,36,12,24
5448,Iloveweed,tichondrius,1147,druid,restoration,18,12,6
5449,Saltyzz,tichondrius,1147,druid,restoration,36,19,17
5450,Idoldeoz,quelthalas,1147,druid,restoration,36,18,18
5451,Treebag,frostmane,1147,druid,restoration,24,12,12
5452,Foxwit,jubeithos,1147,druid,restoration,24,12,12
5453,Dchizzle,tichondrius,1147,druid,restoration,45,20,25
5454,Kassyx,illidan,1147,druid,restoration,36,12,24
5455,Waxedchest,emerald-dream,1146,druid,restoration,24,12,12
5456,Fatshift,chogall,1145,druid,restoration,122,62,60
5457,Sêxcavator,thrall,1145,druid,restoration,24,12,12
5458,Lahsa,tichondrius,1145,druid,restoration,30,13,17
5459,Skibbidy,boulderfist,1145,druid,restoration,33,14,19
5460,Lunkz,tichondrius,1142,druid,restoration,278,132,146
5461,Kiraval,stormrage,1142,druid,restoration,66,29,37
5462,Tyrs,aggramar,1140,druid,restoration,35,15,20
5463,Älef,ragnaros,1140,druid,restoration,54,23,31
5464,Alphalemon,ragnaros,1139,druid,restoration,69,33,36
5465,Wildbite,tichondrius,1138,druid,restoration,20,13,7
5466,Adind,tanaris,1138,druid,restoration,60,32,28
5467,Jijunss,tichondrius,1137,druid,restoration,23,13,10
5468,Cear,proudmoore,1137,druid,restoration,45,16,29
5469,Miyeonly,dalaran,1137,druid,restoration,36,12,24
5470,Joya,stormrage,1136,druid,restoration,18,12,6
5471,Dummedruid,illidan,1135,druid,restoration,36,12,24
5472,Glenkair,lightnings-blade,1134,druid,restoration,36,17,19
5473,Pumma,darkspear,1134,druid,restoration,28,13,15
5474,Kagoz,darkspear,1134,druid,restoration,30,12,18
5475,Uttress,kalecgos,1132,druid,restoration,30,14,16
5476,Catlypso,tichondrius,1131,druid,restoration,72,43,29
5477,Mithaelar,moon-guard,1130,druid,restoration,36,13,23
5478,Ctarla,tichondrius,1128,druid,restoration,24,12,12
5479,Tensuen,boulderfist,1128,druid,restoration,51,21,30
5480,Duxz,tichondrius,1127,druid,restoration,23,13,10
5481,Drudax,kelthuzad,1127,druid,restoration,24,12,12
5482,Ateoate,stormscale,1127,druid,restoration,51,24,27
5483,Soxyeon,tichondrius,1127,druid,restoration,53,23,30
5484,Sneakydikns,tichondrius,1127,druid,restoration,36,12,24
5485,Boomfire,thaurissan,1126,druid,restoration,18,12,6
5486,Sloptoucher,barthilas,1126,druid,restoration,24,12,12
5487,Meonk,frostmourne,1124,druid,restoration,57,27,30
5488,Bubbashift,garona,1124,druid,restoration,60,25,35
5489,Gentlesoapp,blackrock,1122,druid,restoration,48,26,22
5490,Würzel,nemesis,1122,druid,restoration,93,45,48
5491,Brotø,nemesis,1122,druid,restoration,72,33,39
5492,Julyto,ragnaros,1120,druid,restoration,24,12,12
5493,Hotkage,tichondrius,1120,druid,restoration,24,12,12
5494,Hðthead,area-52,1118,druid,restoration,54,26,28
5495,Naturemagic,malganis,1117,druid,restoration,51,27,24
5496,Kastro,frostwolf,1117,druid,restoration,162,84,78
5497,Kandyshop,gorefiend,1116,druid,restoration,30,22,8
5498,Lawlz,aegwynn,1115,druid,restoration,120,67,53
5499,Cipozento,azralon,1115,druid,restoration,91,43,48
5500,Feralgodx,sargeras,1114,druid,restoration,23,12,11
5501,Sinseir,stormscale,1114,druid,restoration,111,47,64
5502,Fermata,aegwynn,1113,druid,restoration,28,15,13
5503,Lopper,hyjal,1113,druid,restoration,24,12,12
5504,Badferal,blackhand,1113,druid,restoration,55,25,30
5505,Rockcow,tichondrius,1113,druid,restoration,48,20,28
5506,Queiq,malganis,1112,druid,restoration,18,12,6
5507,Yourka,uther,1112,druid,restoration,50,27,23
5508,Mcy,nerzhul,1112,druid,restoration,25,13,12
5509,Gorillagloo,area-52,1112,druid,restoration,97,43,54
5510,Kuaite,azralon,1110,druid,restoration,72,25,47
5511,Katdog,warsong,1109,druid,restoration,33,22,11
5512,Löthnälar,ragnaros,1109,druid,restoration,48,24,24
5513,Scoobyshiftz,frostmourne,1108,druid,restoration,30,22,8
5514,Terokky,azralon,1107,druid,restoration,24,12,12
5515,Müfasä,azralon,1106,druid,restoration,54,25,29
5516,Maddoxi,stormrage,1106,druid,restoration,30,12,18
5517,Sharinna,andorhal,1106,druid,restoration,38,14,24
5518,Eredorn,darkspear,1105,druid,restoration,30,23,7
5519,Apox,zuljin,1105,druid,restoration,34,13,21
5520,Shroomkin,area-52,1104,druid,restoration,63,34,29
5521,Furfu,illidan,1104,druid,restoration,74,33,41
5522,Stupidranga,barthilas,1103,druid,restoration,54,19,35
5523,Astralyte,kiljaeden,1099,druid,restoration,24,13,11
5524,Carekoala,wyrmrest-accord,1098,druid,restoration,59,30,29
5525,Idracnine,sargeras,1098,druid,restoration,26,13,13
5526,Cannabull,echo-isles,1097,druid,restoration,33,17,16
5527,Dobidas,tichondrius,1097,druid,restoration,125,63,62
5528,Kymopexy,sargeras,1095,druid,restoration,41,14,27
5529,Battiatus,malganis,1093,druid,restoration,42,19,23
5530,Jabina,detheroc,1093,druid,restoration,54,16,38
5531,Vacablancá,tichondrius,1091,druid,restoration,34,14,20
5532,Barugaf,drakkari,1090,druid,restoration,49,28,21
5533,Agranock,nazgrel,1089,druid,restoration,107,55,52
5534,Kittne,hellscream,1089,druid,restoration,48,24,24
5535,Vollzar,sargeras,1089,druid,restoration,68,23,45
5536,Burdup,tichondrius,1088,druid,restoration,36,19,17
5537,Ayadel,moon-guard,1086,druid,restoration,118,54,64
5538,Berchwunden,ragnaros,1083,druid,restoration,58,27,31
5539,Quan,illidan,1082,druid,restoration,48,20,28
5540,Volgoro,thrall,1078,druid,restoration,60,25,35
5541,Mydira,stormrage,1071,druid,restoration,54,30,24
5542,Dehla,goldrinn,1071,druid,restoration,82,37,45
5543,Quarantinia,arathor,1070,druid,restoration,49,28,21
5544,Samerax,vashj,1070,druid,restoration,107,45,62
5545,Slleep,tichondrius,1069,druid,restoration,54,28,26
5546,Gimborion,stormrage,1066,druid,restoration,48,23,25
5547,Nöches,quelthalas,1065,druid,restoration,32,12,20
5548,Anasia,barthilas,1064,druid,restoration,81,43,38
5549,Cratose,runetotem,1064,druid,restoration,53,24,29
5550,Quaileggs,illidan,1064,druid,restoration,36,12,24
5551,Aarandiel,borean-tundra,1063,druid,restoration,30,17,13
5552,Lutzenberger,nemesis,1063,druid,restoration,53,23,30
5553,Buffalobillz,lethon,1062,druid,restoration,40,25,15
5554,Hallowbranch,moon-guard,1062,druid,restoration,44,17,27
5555,Rëroll,zuljin,1059,druid,restoration,17,12,5
5556,Spasmm,tichondrius,1059,druid,restoration,18,12,6
5557,Samuelceo,area-52,1056,druid,restoration,12,11,1
5558,Chinadruids,tichondrius,1056,druid,restoration,18,11,7
5559,Fracxx,area-52,1056,druid,restoration,18,11,7
5560,Whhm,burning-blade,1056,druid,restoration,24,11,13
5561,Slurpi,barthilas,1056,druid,restoration,30,11,19
5562,Mumblesd,emerald-dream,1055,druid,restoration,24,11,13
5563,Suekeys,frostmourne,1055,druid,restoration,24,11,13
5564,Momorabbitd,tichondrius,1055,druid,restoration,30,11,19
5565,Qkskill,nemesis,1055,druid,restoration,42,11,31
5566,Goodhealer,akama,1054,druid,restoration,42,26,16
5567,Etaurne,drakkari,1054,druid,restoration,18,11,7
5568,Krobz,bleeding-hollow,1054,druid,restoration,18,11,7
5569,Jethelium,illidan,1054,druid,restoration,190,103,87
5570,Qkdru,nemesis,1054,druid,restoration,30,11,19
5571,Careless,destromath,1053,druid,restoration,66,27,39
5572,Kitnip,proudmoore,1052,druid,restoration,24,16,8
5573,Maeo,drenden,1052,druid,restoration,18,11,7
5574,Israh,malygos,1052,druid,restoration,26,15,11
5575,Yorch,stormrage,1052,druid,restoration,60,28,32
5576,Deja,frostmourne,1052,druid,restoration,30,11,19
5577,Marminalade,stormrage,1051,druid,restoration,18,11,7
5578,Nastynancy,frostmourne,1051,druid,restoration,21,12,9
5579,Solisuu,frostmane,1051,druid,restoration,30,11,19
5580,Cres,moon-guard,1051,druid,restoration,42,11,31
5581,Tigranesia,proudmoore,1050,druid,restoration,18,11,7
5582,Acerolita,azralon,1050,druid,restoration,30,11,19
5583,Phxburn,illidan,1050,druid,restoration,30,11,19
5584,Catinthebox,illidan,1048,druid,restoration,18,11,7
5585,Dinglebops,stormrage,1047,druid,restoration,28,15,13
5586,Xzerhos,area-52,1047,druid,restoration,151,70,81
5587,Fatherbanger,blackrock,1047,druid,restoration,24,11,13
5588,Edorant,illidan,1047,druid,restoration,30,11,19
5589,Yimii,stormrage,1046,druid,restoration,18,11,7
5590,Zzizi,tichondrius,1046,druid,restoration,29,13,16
5591,Zoll,kelthuzad,1046,druid,restoration,66,26,40
5592,Dorzaku,ragnaros,1045,druid,restoration,47,27,20
5593,Battlecát,stormscale,1045,druid,restoration,24,11,13
5594,Zadayos,aerie-peak,1044,druid,restoration,30,16,14
5595,Duducows,tichondrius,1044,druid,restoration,59,23,36
5596,Druilicious,ghostlands,1043,druid,restoration,55,27,28
5597,Libel,korgath,1042,druid,restoration,18,11,7
5598,Realhötgirl,moon-guard,1042,druid,restoration,18,11,7
5599,Gairen,the-venture-co,1042,druid,restoration,20,12,8
5600,Twigleg,eonar,1042,druid,restoration,36,11,25
5601,Feaveldin,moon-guard,1041,druid,restoration,18,11,7
5602,Ahrilee,area-52,1040,druid,restoration,75,33,42
5603,Sbc,anvilmar,1040,druid,restoration,48,15,33
5604,Jimmycooks,tichondrius,1039,druid,restoration,18,11,7
5605,Chopleaf,khadgar,1039,druid,restoration,180,92,88
5606,Kanabat,drenden,1039,druid,restoration,24,11,13
5607,Leoha,stormrage,1037,druid,restoration,24,15,9
5608,Erû,ragnaros,1037,druid,restoration,18,11,7
5609,Iiliith,moon-guard,1037,druid,restoration,24,11,13
5610,Taydruid,stormrage,1037,druid,restoration,54,24,30
5611,Ulfaar,frostmourne,1036,druid,restoration,18,11,7
5612,Creasir,tichondrius,1035,druid,restoration,35,12,23
5613,Bearkîng,stormrage,1034,druid,restoration,18,11,7
5614,Duedad,gurubashi,1034,druid,restoration,39,22,17
5615,Cowtox,moon-guard,1033,druid,restoration,190,90,100
5616,Breezeys,tichondrius,1033,druid,restoration,35,16,19
5617,Toxicshift,malganis,1033,druid,restoration,39,13,26
5618,Beefcurtâins,aggramar,1032,druid,restoration,18,11,7
5619,Bonemaul,bonechewer,1032,druid,restoration,42,22,20
5620,Nohkotana,illidan,1032,druid,restoration,28,13,15
5621,Jimooin,tichondrius,1032,druid,restoration,30,12,18
5622,Bankinbäbe,illidan,1031,druid,restoration,98,53,45
5623,Delicioso,wyrmrest-accord,1030,druid,restoration,33,21,12
5624,Javoh,drakkari,1030,druid,restoration,25,13,12
5625,Skaidi,quelthalas,1030,druid,restoration,42,21,21
5626,Nytecrawler,bonechewer,1028,druid,restoration,18,11,7
5627,Boofndergz,area-52,1027,druid,restoration,24,15,9
5628,Minnysoda,area-52,1027,druid,restoration,24,12,12
5629,Mayarí,sargeras,1027,druid,restoration,50,15,35
5630,Seremap,frostmourne,1025,druid,restoration,48,29,19
5631,Polymorphos,mugthol,1025,druid,restoration,30,14,16
5632,Janaki,malygos,1024,druid,restoration,30,13,17
5633,Azyx,stormrage,1023,druid,restoration,92,40,52
5634,Imcop,tichondrius,1020,druid,restoration,18,11,7
5635,Troply,ragnaros,1020,druid,restoration,20,12,8
5636,Funnydruid,frostmourne,1020,druid,restoration,42,20,22
5637,Xarressian,moon-guard,1019,druid,restoration,24,11,13
5638,Sonrius,proudmoore,1017,druid,restoration,52,25,27
5639,Irushbots,tichondrius,1016,druid,restoration,30,11,19
5640,Pmsprone,tichondrius,1012,druid,restoration,84,40,44
5641,Milkmoneymeo,illidan,1011,druid,restoration,29,11,18
5642,Uwakka,hyjal,1009,druid,restoration,20,12,8
5643,Sunneater,azuremyst,1009,druid,restoration,37,18,19
5644,Rivetrix,azralon,1007,druid,restoration,103,49,54
5645,Agnala,drakkari,1007,druid,restoration,99,35,64
5646,Macdonah,tichondrius,1006,druid,restoration,66,33,33
5647,Sorio,area-52,1005,druid,restoration,58,21,37
5648,Keladria,bleeding-hollow,1002,druid,restoration,102,55,47
5649,Chloroforms,khazgoroth,1001,druid,restoration,52,30,22
5650,Guron,aegwynn,1001,druid,restoration,57,30,27
5651,Yeahhots,frostmourne,1000,druid,restoration,15,12,3
5652,Mainera,sargeras,1000,druid,restoration,26,12,14
5653,Dhannar,proudmoore,999,druid,restoration,18,13,5
5654,Habit,dragonmaw,998,druid,restoration,27,12,15
5655,Kataless,sargeras,997,druid,restoration,125,66,59
5656,Thicclesbean,tichondrius,996,druid,restoration,31,16,15
5657,Phyllostomus,quelthalas,996,druid,restoration,36,15,21
5658,Smorak,area-52,994,druid,restoration,14,12,2
5659,Alfurr,tichondrius,994,druid,restoration,85,43,42
5660,Illur,ragnaros,993,druid,restoration,34,13,21
5661,Krossus,drakkari,993,druid,restoration,38,13,25
5662,Hewozuoai,area-52,990,druid,restoration,35,11,24
5663,Vallk,area-52,990,druid,restoration,40,11,29
5664,Astharon,drakkari,989,druid,restoration,56,31,25
5665,Marrana,altar-of-storms,989,druid,restoration,24,13,11
5666,Ahylen,quelthalas,989,druid,restoration,53,22,31
5667,Cpttspitty,kelthuzad,988,druid,restoration,36,14,22
5668,Canche,arthas,986,druid,restoration,34,19,15
5669,Feralgød,tichondrius,985,druid,restoration,30,11,19
5670,Cowchicken,zuljin,982,druid,restoration,34,11,23
5671,Nerfmesoon,sargeras,978,druid,restoration,22,11,11
5672,Dwalk,moknathal,977,druid,restoration,109,53,56
5673,Santicow,ragnaros,975,druid,restoration,20,11,9
5674,Fionnbharr,ragnaros,974,druid,restoration,86,39,47
5675,Bindudream,frostmane,973,druid,restoration,72,35,37
5676,Locopewpew,malganis,969,druid,restoration,79,29,50
5677,Seceru,proudmoore,968,druid,restoration,58,31,27
5678,Boomshorts,blackrock,968,druid,restoration,29,14,15
5679,Sunyatsen,quelthalas,967,druid,restoration,58,25,33
5680,Jennafix,dathremar,966,druid,restoration,54,28,26
5681,Tiufill,nemesis,965,druid,restoration,30,16,14
5682,Vdubz,blackrock,965,druid,restoration,49,25,24
5683,Wiggle,stormscale,962,druid,restoration,44,21,23
5684,Vulgär,kiljaeden,961,druid,restoration,52,21,31
5685,Solushun,sargeras,960,druid,restoration,12,10,2
5686,Salzadruid,aggramar,960,druid,restoration,12,10,2
5687,Baruc,illidan,960,druid,restoration,12,10,2
5688,Aphroditezs,tichondrius,960,druid,restoration,18,10,8
5689,Kurohîme,illidan,960,druid,restoration,18,10,8
5690,Myovo,tichondrius,960,druid,restoration,18,10,8
5691,Jiywa,lightbringer,960,druid,restoration,18,10,8
5692,Smeekq,tichondrius,960,druid,restoration,24,10,14
5693,Nhin,ghostlands,960,druid,restoration,24,10,14
5694,Lindsanr,illidan,960,druid,restoration,30,10,20
5695,Xiaoyi,tichondrius,959,druid,restoration,12,10,2
5696,Slambeezy,emerald-dream,959,druid,restoration,18,10,8
5697,Montage,illidan,959,druid,restoration,18,10,8
5698,Ddi,frostmourne,959,druid,restoration,18,10,8
5699,Garbagebutt,burning-legion,959,druid,restoration,18,10,8
5700,Eldertroll,boulderfist,959,druid,restoration,18,10,8
5701,Hoonjojjyanx,tichondrius,959,druid,restoration,18,10,8
5702,Oblackbetty,illidan,959,druid,restoration,39,18,21
5703,Treesh,kelthuzad,959,druid,restoration,26,10,16
5704,Naturetazerr,sargeras,958,druid,restoration,18,10,8
5705,Uggadruid,malganis,958,druid,restoration,18,10,8
5706,Tlanquility,tichondrius,958,druid,restoration,18,10,8
5707,Tigd,alleria,958,druid,restoration,18,10,8
5708,Nachopuppet,kelthuzad,958,druid,restoration,51,21,30
5709,Percocetxo,malganis,958,druid,restoration,30,10,20
5710,Shrooming,frostmourne,958,druid,restoration,30,10,20
5711,Tayokou,zuljin,957,druid,restoration,12,10,2
5712,Dreamgaze,zuljin,957,druid,restoration,18,10,8
5713,Simina,kargath,957,druid,restoration,18,10,8
5714,Chenxguang,tichondrius,957,druid,restoration,42,22,20
5715,Iheartmushu,mannoroth,957,druid,restoration,91,47,44
5716,Ñoobdruid,tichondrius,956,druid,restoration,18,10,8
5717,Cranbérry,sargeras,956,druid,restoration,18,10,8
5718,Vêzpêr,kelthuzad,956,druid,restoration,24,10,14
5719,Jessbearly,kiljaeden,954,druid,restoration,18,10,8
5720,Rlie,quelthalas,954,druid,restoration,30,10,20
5721,Uttress,tichondrius,953,druid,restoration,18,10,8
5722,Joink,sargeras,952,druid,restoration,18,10,8
5723,Wildartform,malganis,952,druid,restoration,23,12,11
5724,Dietmilk,sargeras,952,druid,restoration,24,11,13
5725,Bainnê,ragnaros,952,druid,restoration,48,11,37
5726,Çura,tichondrius,951,druid,restoration,18,10,8
5727,Erisya,moon-guard,951,druid,restoration,18,10,8
5728,Wintarz,sargeras,951,druid,restoration,30,10,20
5729,Feckzd,blackhand,950,druid,restoration,18,10,8
5730,Honeymead,wyrmrest-accord,950,druid,restoration,65,36,29
5731,Judar,barthilas,950,druid,restoration,24,10,14
5732,Glenglooie,tichondrius,950,druid,restoration,30,10,20
5733,Nightwater,stormrage,949,druid,restoration,21,10,11
5734,Rhatir,stormrage,949,druid,restoration,138,61,77
5735,Noonoo,frostwolf,949,druid,restoration,24,10,14
5736,Alteraim,thrall,949,druid,restoration,30,10,20
5737,Immabot,tichondrius,949,druid,restoration,36,10,26
5738,Erykk,dalaran,948,druid,restoration,18,10,8
5739,Hpcorrection,bleeding-hollow,946,druid,restoration,18,10,8
5740,Moobees,arthas,946,druid,restoration,30,10,20
5741,Ihideuseek,bloodscalp,944,druid,restoration,36,10,26
5742,Xiaoddi,tichondrius,943,druid,restoration,17,10,7
5743,Ryx,llane,943,druid,restoration,24,10,14
5744,Muukair,ragnaros,943,druid,restoration,24,10,14
5745,Fatjoints,tichondrius,943,druid,restoration,60,21,39
5746,Maxobviously,stormrage,942,druid,restoration,18,10,8
5747,Devilsparda,frostmane,942,druid,restoration,24,10,14
5748,Cadekey,illidan,942,druid,restoration,42,13,29
5749,Anïtra,illidan,942,druid,restoration,48,10,38
5750,Kg,cenarion-circle,941,druid,restoration,28,13,15
5751,Tyrantha,emerald-dream,941,druid,restoration,24,10,14
5752,Shiftaholic,azgalor,940,druid,restoration,33,17,16
5753,Modiboom,arthas,940,druid,restoration,60,22,38
5754,Drucaicer,quelthalas,939,druid,restoration,71,38,33
5755,Chupaone,dalaran,937,druid,restoration,66,27,39
5756,Browolf,emerald-dream,934,druid,restoration,48,21,27
5757,Katochi,area-52,929,druid,restoration,54,24,30
5758,Blooddude,saurfang,927,druid,restoration,30,11,19
5759,Killari,malganis,926,druid,restoration,30,15,15
5760,Pathostos,dalaran,926,druid,restoration,104,43,61
5761,Treewik,emerald-dream,925,druid,restoration,113,60,53
5762,Movom,tichondrius,925,druid,restoration,23,10,13
5763,Goenytz,quelthalas,925,druid,restoration,62,20,42
5764,Blackdawgg,frostmourne,924,druid,restoration,71,26,45
5765,Cloudbreaker,duskwood,923,druid,restoration,18,10,8
5766,Chocoo,thaurissan,923,druid,restoration,20,11,9
5767,Dyfurion,stormrage,922,druid,restoration,18,10,8
5768,Breakthemm,bonechewer,922,druid,restoration,97,46,51
5769,Mielo,illidan,922,druid,restoration,146,67,79
5770,Bblloodd,magtheridon,921,druid,restoration,36,13,23
5771,Fongoons,kelthuzad,919,druid,restoration,59,26,33
5772,Bomme,zuljin,919,druid,restoration,52,21,31
5773,Sangsan,tichondrius,917,druid,restoration,36,10,26
5774,Marakar,nazjatar,917,druid,restoration,48,13,35
5775,Kkrunkk,khadgar,916,druid,restoration,36,17,19
5776,Fovoss,dalaran,914,druid,restoration,36,18,18
5777,Lazypandas,silvermoon,914,druid,restoration,41,17,24
5778,Aquesadilla,tichondrius,907,druid,restoration,108,36,72
5779,Kenzié,doomhammer,906,druid,restoration,48,22,26
5780,Gromdruid,azralon,905,druid,restoration,66,33,33
5781,Boomsläng,ghostlands,905,druid,restoration,25,12,13
5782,Diaks,proudmoore,900,druid,restoration,24,12,12
5783,Bethemarble,sargeras,900,druid,restoration,47,20,27
5784,Irishdoom,tichondrius,899,druid,restoration,20,11,9
5785,Merawr,area-52,896,druid,restoration,22,10,12
5786,Theboyz,zuljin,895,druid,restoration,36,15,21
5787,Hentaiboom,kiljaeden,893,druid,restoration,36,16,20
5788,Royjr,emerald-dream,892,druid,restoration,44,24,20
5789,Duderdude,tichondrius,892,druid,restoration,45,22,23
5790,Vengaul,amanthul,892,druid,restoration,24,10,14
5791,Lâvazza,tichondrius,890,druid,restoration,28,10,18
5792,Sliickrick,frostmourne,889,druid,restoration,30,10,20
5793,Kawanishi,stormrage,884,druid,restoration,24,12,12
5794,Treeoleo,stormrage,884,druid,restoration,36,16,20
5795,Kittyz,wyrmrest-accord,881,druid,restoration,36,18,18
5796,Midníght,drakkari,880,druid,restoration,34,18,16
5797,Bunrÿl,thorium-brotherhood,874,druid,restoration,54,24,30
5798,Augus,hyjal,870,druid,restoration,33,11,22
5799,Theboy,dalaran,869,druid,restoration,48,15,33
5800,Justforgame,sargeras,864,druid,restoration,12,9,3
5801,Aiteezy,illidan,864,druid,restoration,12,9,3
5802,Toonah,area-52,864,druid,restoration,12,9,3
5803,Restokinaja,dreadmaul,864,druid,restoration,12,9,3
5804,Duo,demon-soul,864,druid,restoration,12,9,3
5805,Spikeleaf,tichondrius,864,druid,restoration,12,9,3
5806,Bopplejr,tichondrius,864,druid,restoration,12,9,3
5807,Jockrock,thunderhorn,864,druid,restoration,19,10,9
5808,Ppbtw,illidan,864,druid,restoration,18,9,9
5809,Bigblackcroc,kiljaeden,864,druid,restoration,18,9,9
5810,Mmrborrower,icecrown,864,druid,restoration,18,9,9
5811,Ppb,illidan,864,druid,restoration,18,9,9
5812,Shwayshift,bleeding-hollow,864,druid,restoration,18,9,9
5813,Admoney,sargeras,864,druid,restoration,18,9,9
5814,Hellshifterr,tichondrius,864,druid,restoration,18,9,9
5815,Ppbdru,tichondrius,864,druid,restoration,18,9,9
5816,Razberriesz,stormrage,864,druid,restoration,18,9,9
5817,Lackzx,malganis,864,druid,restoration,24,9,15
5818,Persille,proudmoore,864,druid,restoration,24,9,15
5819,Proness,garithos,863,druid,restoration,12,9,3
5820,Ooh,stormreaver,863,druid,restoration,12,9,3
5821,Naturenugget,tichondrius,863,druid,restoration,12,9,3
5822,Ilovejuli,illidan,863,druid,restoration,12,9,3
5823,Rejuvenation,kaelthas,863,druid,restoration,12,9,3
5824,Dumpesito,frostmourne,863,druid,restoration,18,9,9
5825,Tricklein,tichondrius,863,druid,restoration,18,9,9
5826,Nyxlawl,azralon,863,druid,restoration,18,9,9
5827,Canek,ghostlands,863,druid,restoration,18,9,9
5828,Vernaar,laughing-skull,863,druid,restoration,18,9,9
5829,Guss,mannoroth,863,druid,restoration,24,9,15
5830,Opim,sargeras,863,druid,restoration,24,9,15
5831,Washeddruid,area-52,863,druid,restoration,24,9,15
5832,Mossin,sargeras,863,druid,restoration,24,9,15
5833,Canitöuchit,tichondrius,863,druid,restoration,24,9,15
5834,Tugginudders,illidan,863,druid,restoration,30,9,21
5835,Pawsh,tichondrius,862,druid,restoration,12,9,3
5836,Shuffleqlol,stormrage,862,druid,restoration,12,9,3
5837,Jentzull,tichondrius,862,druid,restoration,12,9,3
5838,Cenarius,frostmourne,862,druid,restoration,18,9,9
5839,Spicyx,moon-guard,862,druid,restoration,18,9,9
5840,Pawpa,daggerspine,862,druid,restoration,18,9,9
5841,Truidy,proudmoore,862,druid,restoration,18,9,9
5842,Elmez,thrall,862,druid,restoration,18,9,9
5843,Phylex,frostmourne,862,druid,restoration,18,9,9
5844,Imlordgumper,illidan,862,druid,restoration,24,9,15
5845,Seyvyurtoo,black-dragonflight,861,druid,restoration,12,9,3
5846,Dzone,tichondrius,861,druid,restoration,12,9,3
5847,Alindrä,moon-guard,861,druid,restoration,18,9,9
5848,Monkeyxo,kelthuzad,861,druid,restoration,18,9,9
5849,Alsei,quelthalas,861,druid,restoration,40,18,22
5850,Papichulo,hydraxis,861,druid,restoration,54,24,30
5851,Starkraven,firetree,861,druid,restoration,26,10,16
5852,Goodspeed,thrall,861,druid,restoration,42,11,31
5853,Loganski,korialstrasz,860,druid,restoration,30,14,16
5854,Topzet,azralon,860,druid,restoration,30,9,21
5855,Stetile,azralon,859,druid,restoration,18,9,9
5856,Feykurds,sargeras,859,druid,restoration,24,9,15
5857,Ragotø,azralon,858,druid,restoration,24,9,15
5858,Ilikan,ragnaros,857,druid,restoration,12,9,3
5859,Thorfir,gorefiend,854,druid,restoration,24,10,14
5860,Faroo,azralon,854,druid,restoration,24,9,15
5861,Leify,area-52,853,druid,restoration,24,10,14
5862,Onlypaws,azjolnerub,852,druid,restoration,24,9,15
5863,Earwën,ragnaros,852,druid,restoration,24,9,15
5864,Ddizz,cairne,850,druid,restoration,24,9,15
5865,Ilikecake,bloodscalp,849,druid,restoration,24,10,14
5866,Kvacco,kiljaeden,848,druid,restoration,24,9,15
5867,Encosan,azralon,848,druid,restoration,30,9,21
5868,Kanadae,thrall,846,druid,restoration,24,9,15
5869,Keyli,frostwolf,845,druid,restoration,18,9,9
5870,Érois,azralon,844,druid,restoration,18,9,9
5871,Amazingtom,magtheridon,842,druid,restoration,27,12,15
5872,Draycø,tichondrius,841,druid,restoration,18,9,9
5873,Fronkysilva,illidan,838,druid,restoration,48,19,29
5874,Dashíng,proudmoore,829,druid,restoration,40,17,23
5875,Rhondarootsy,zuljin,829,druid,restoration,24,10,14
5876,Uwupollo,ragnaros,829,druid,restoration,96,38,58
5877,Menapaws,arygos,828,druid,restoration,15,9,6
5878,Treetalker,drenden,827,druid,restoration,18,9,9
5879,Guerrillera,khadgar,827,druid,restoration,142,62,80
5880,Shalandrea,sargeras,824,druid,restoration,60,22,38
5881,Trôll,mannoroth,818,druid,restoration,26,10,16
5882,Dubya,illidan,809,druid,restoration,27,10,17
5883,Uniquexia,tichondrius,808,druid,restoration,45,10,35
5884,Onyayo,barthilas,807,druid,restoration,42,18,24
5885,Tricknicgg,illidan,805,druid,restoration,26,10,16
5886,Moolan,bleeding-hollow,804,druid,restoration,40,20,20
5887,Elauria,stormreaver,804,druid,restoration,42,17,25
5888,Atim,moon-guard,804,druid,restoration,96,28,68
5889,Restogodx,alexstrasza,799,druid,restoration,16,9,7
5890,Vulkur,illidan,799,druid,restoration,38,9,29
5891,Treesonn,kelthuzad,792,druid,restoration,24,11,13
5892,Cenariun,stormrage,790,druid,restoration,30,9,21
5893,Tftworldcham,blackrock,783,druid,restoration,11,9,2
5894,Judwen,grizzly-hills,779,druid,restoration,70,26,44
5895,Redharp,proudmoore,776,druid,restoration,43,17,26
5896,Stamynn,kelthuzad,772,druid,restoration,354,110,244
5897,Ppm,illidan,768,druid,restoration,12,8,4
5898,Bobxd,kelthuzad,768,druid,restoration,12,8,4
5899,Albafic,illidan,768,druid,restoration,12,8,4
5900,Chinadruides,tichondrius,768,druid,restoration,12,8,4
5901,Polarîs,stormrage,768,druid,restoration,12,8,4
5902,Xiaootong,tichondrius,768,druid,restoration,12,8,4
5903,Leilani,eredar,768,druid,restoration,12,8,4
5904,Cntomy,tichondrius,768,druid,restoration,12,8,4
5905,Mkong,tichondrius,768,druid,restoration,18,8,10
5906,Restobaby,tichondrius,768,druid,restoration,18,8,10
5907,Lindsay,moonrunner,768,druid,restoration,18,8,10
5908,Taledra,stormrage,768,druid,restoration,18,8,10
5909,Nemoo,tichondrius,768,druid,restoration,18,8,10
5910,Tyler,emerald-dream,768,druid,restoration,18,8,10
5911,Înfamous,thrall,767,druid,restoration,12,8,4
5912,Alend,alexstrasza,767,druid,restoration,12,8,4
5913,Kismet,andorhal,767,druid,restoration,12,8,4
5914,Ebyx,frostmourne,767,druid,restoration,12,8,4
5915,Bringo,executus,767,druid,restoration,21,10,11
5916,Lifebloomlol,area-52,767,druid,restoration,18,8,10
5917,Thetakeout,tichondrius,767,druid,restoration,18,8,10
5918,Junglez,shadowmoon,767,druid,restoration,18,8,10
5919,Grubbs,terenas,767,druid,restoration,18,8,10
5920,Kaboomy,moon-guard,767,druid,restoration,18,8,10
5921,Steeples,illidan,767,druid,restoration,18,8,10
5922,Hughcockman,tichondrius,766,druid,restoration,12,8,4
5923,Ortalen,spirestone,766,druid,restoration,12,8,4
5924,Purpyo,bleeding-hollow,766,druid,restoration,12,8,4
5925,Crapster,boulderfist,766,druid,restoration,18,8,10
5926,Bobochi,tichondrius,766,druid,restoration,18,8,10
5927,Wildsïde,tichondrius,766,druid,restoration,18,8,10
5928,Bumbleebee,azralon,766,druid,restoration,24,8,16
5929,Kyrieirving,illidan,766,druid,restoration,24,8,16
5930,Hedwíg,ragnaros,766,druid,restoration,24,8,16
5931,Kellykapore,area-52,766,druid,restoration,81,20,61
5932,Dmanrepus,sargeras,765,druid,restoration,12,8,4
5933,Louisvuittón,area-52,765,druid,restoration,12,8,4
5934,Imnotinhuman,tichondrius,765,druid,restoration,12,8,4
5935,Giuseppee,hyjal,765,druid,restoration,12,8,4
5936,Omelet,tichondrius,765,druid,restoration,18,8,10
5937,Bosscjp,tichondrius,765,druid,restoration,18,8,10
5938,Softgrizzly,auchindoun,765,druid,restoration,24,8,16
5939,Guybranch,illidan,765,druid,restoration,24,8,16
5940,Slee,eredar,764,druid,restoration,12,8,4
5941,Leatherpig,proudmoore,764,druid,restoration,18,8,10
5942,Aurajin,spinebreaker,764,druid,restoration,24,8,16
5943,Polánd,area-52,763,druid,restoration,12,8,4
5944,Studioghibli,bleeding-hollow,762,druid,restoration,12,8,4
5945,Atalìa,moon-guard,762,druid,restoration,18,8,10
5946,Dergmoo,moon-guard,762,druid,restoration,24,8,16
5947,Blitzÿ,lothar,761,druid,restoration,12,8,4
5948,Markóla,stormrage,761,druid,restoration,18,8,10
5949,Wortsnom,tol-barad,760,druid,restoration,12,8,4
5950,Tristanne,proudmoore,760,druid,restoration,12,8,4
5951,Cosmes,suramar,759,druid,restoration,12,8,4
5952,Rairven,stormrage,757,druid,restoration,42,8,34
5953,Bussincheeks,tichondrius,755,druid,restoration,18,8,10
5954,Xxuan,tichondrius,754,druid,restoration,68,18,50
5955,Breakertime,illidan,753,druid,restoration,18,8,10
5956,Salpicow,nagrand,752,druid,restoration,23,10,13
5957,Hydruidponic,aegwynn,752,druid,restoration,27,9,18
5958,Blazedorange,tichondrius,751,druid,restoration,17,8,9
5959,Friarpuck,nerzhul,747,druid,restoration,12,8,4
5960,Dytriax,ragnaros,746,druid,restoration,18,8,10
5961,Nodeathz,sargeras,743,druid,restoration,27,10,17
5962,Dragondruid,dawnbringer,742,druid,restoration,35,9,26
5963,Nattog,area-52,736,druid,restoration,52,12,40
5964,Ekj,tichondrius,735,druid,restoration,14,9,5
5965,Akanx,tichondrius,735,druid,restoration,16,9,7
5966,Kadry,ragnaros,733,druid,restoration,18,8,10
5967,Aludra,tol-barad,725,druid,restoration,30,10,20
5968,Kataoka,azralon,721,druid,restoration,23,11,12
5969,Rdruidchump,the-forgotten-coast,719,druid,restoration,15,9,6
5970,Ghostmonkey,hakkar,719,druid,restoration,23,8,15
5971,Basulto,tichondrius,718,druid,restoration,23,8,15
5972,Xîstance,barthilas,717,druid,restoration,23,8,15
5973,Asclepïus,tichondrius,716,druid,restoration,17,8,9
5974,Felinedreams,sargeras,714,druid,restoration,14,9,5
5975,Whiskeyblues,ursin,706,druid,restoration,24,8,16
5976,Itzreallyhim,kiljaeden,705,druid,restoration,27,9,18
5977,Finntann,moon-guard,704,druid,restoration,24,8,16
5978,Bigox,area-52,699,druid,restoration,118,46,72
5979,Drexldrood,cenarius,697,druid,restoration,15,9,6
5980,Zephiee,kelthuzad,692,druid,restoration,23,8,15
5981,Finkledurp,dalaran,687,druid,restoration,19,8,11
5982,Solbinn,nordrassil,683,druid,restoration,78,21,57
5983,Teamwork,moon-guard,681,druid,restoration,20,10,10
5984,Importedalc,zuljin,678,druid,restoration,36,8,28
5985,Cuzzidr,tichondrius,672,druid,restoration,12,7,5
5986,Carntko,sargeras,672,druid,restoration,12,7,5
5987,Cameltail,kelthuzad,672,druid,restoration,12,7,5
5988,Mymatejames,tichondrius,672,druid,restoration,12,7,5
5989,Restokinaka,dreadmaul,672,druid,restoration,12,7,5
5990,Shapelist,frostmourne,672,druid,restoration,12,7,5
5991,Fresh,earthen-ring,672,druid,restoration,12,7,5
5992,Skitzo,akama,672,druid,restoration,12,7,5
5993,Fujimufu,bleeding-hollow,672,druid,restoration,12,7,5
5994,Tmdogwater,sargeras,672,druid,restoration,12,7,5
5995,Scuzzin,zuljin,672,druid,restoration,12,7,5
5996,Sensations,moon-guard,672,druid,restoration,12,7,5
5997,Esqueue,stormrage,672,druid,restoration,12,7,5
5998,Cøsmiccow,illidan,672,druid,restoration,12,7,5
5999,Crusch,shattered-halls,672,druid,restoration,12,7,5
6000,Blacksimbá,area-52,672,druid,restoration,12,7,5
6001,Motate,malganis,672,druid,restoration,12,7,5
6002,Jurof,malganis,672,druid,restoration,12,7,5
6003,Cyrea,dalaran,672,druid,restoration,12,7,5
6004,Hmoobforshoz,wildhammer,672,druid,restoration,12,7,5
6005,Evolved,darkspear,672,druid,restoration,12,7,5
6006,Toketree,sargeras,672,druid,restoration,12,7,5
6007,Bcktobasics,emerald-dream,672,druid,restoration,18,7,11
6008,Greentoë,sargeras,672,druid,restoration,18,7,11
6009,Dotsbots,barthilas,672,druid,restoration,18,7,11
6010,Erogan,eitrigg,672,druid,restoration,18,7,11
6011,Restokina,dreadmaul,672,druid,restoration,18,7,11
6012,Calimei,bladefist,672,druid,restoration,18,7,11
6013,Suekey,frostmourne,672,druid,restoration,18,7,11
6014,Liloudadru,tichondrius,672,druid,restoration,18,7,11
6015,Wùúkìí,bleeding-hollow,672,druid,restoration,24,7,17
6016,Iâmkyle,darkspear,671,druid,restoration,12,7,5
6017,Hugharection,illidan,671,druid,restoration,12,7,5
6018,Jillferal,proudmoore,671,druid,restoration,12,7,5
6019,Drop,shadow-council,671,druid,restoration,12,7,5
6020,Sroyalbeast,sargeras,671,druid,restoration,12,7,5
6021,Cryel,sargeras,671,druid,restoration,12,7,5
6022,Vadeyr,illidan,671,druid,restoration,12,7,5
6023,Lolth,turalyon,671,druid,restoration,12,7,5
6024,Zthatchx,shadowmoon,671,druid,restoration,12,7,5
6025,Ophiophagus,nemesis,671,druid,restoration,12,7,5
6026,Lilgee,kelthuzad,671,druid,restoration,18,7,11
6027,Phéônix,zuljin,671,druid,restoration,18,7,11
6028,Boomchí,tichondrius,671,druid,restoration,18,7,11
6029,Wildarumqt,tichondrius,671,druid,restoration,18,7,11
6030,Kollective,sargeras,671,druid,restoration,18,7,11
6031,Finn,spinebreaker,671,druid,restoration,18,7,11
6032,Treebearman,thrall,671,druid,restoration,24,7,17
6033,Greenbones,frostmane,670,druid,restoration,12,7,5
6034,Queiq,kelthuzad,670,druid,restoration,12,7,5
6035,Dionysus,mannoroth,670,druid,restoration,12,7,5
6036,Scäpeqoat,sargeras,670,druid,restoration,12,7,5
6037,Cshafty,illidan,670,druid,restoration,18,7,11
6038,Flexxfurion,thrall,670,druid,restoration,18,7,11
6039,Wreckked,sargeras,670,druid,restoration,18,7,11
6040,Frave,dentarg,670,druid,restoration,24,7,17
6041,Hotpocketz,kiljaeden,670,druid,restoration,28,8,20
6042,Martymoo,bleeding-hollow,670,druid,restoration,30,7,23
6043,Dipset,khadgar,670,druid,restoration,30,7,23
6044,Notcovet,illidan,669,druid,restoration,12,7,5
6045,Dylonomancer,tichondrius,669,druid,restoration,12,7,5
6046,Nayelina,stormrage,669,druid,restoration,12,7,5
6047,Fandren,ravencrest,669,druid,restoration,12,7,5
6048,Zwind,nerzhul,669,druid,restoration,16,8,8
6049,Razorclaws,stormscale,669,druid,restoration,18,7,11
6050,Niensi,wyrmrest-accord,669,druid,restoration,18,7,11
6051,Briallyn,tichondrius,669,druid,restoration,18,7,11
6052,Maggiee,arthas,669,druid,restoration,24,7,17
6053,Bloomcrue,moon-guard,668,druid,restoration,12,7,5
6054,Migdrail,nemesis,668,druid,restoration,18,7,11
6055,Shiftyy,nordrassil,668,druid,restoration,19,7,12
6056,Mukay,stormrage,668,druid,restoration,24,7,17
6057,Esyiix,tichondrius,668,druid,restoration,24,7,17
6058,Mïms,area-52,667,druid,restoration,12,7,5
6059,Givemejuice,tichondrius,667,druid,restoration,18,7,11
6060,Flayde,barthilas,666,druid,restoration,12,7,5
6061,Transpecies,kelthuzad,666,druid,restoration,12,7,5
6062,Kobudo,frostwolf,666,druid,restoration,12,7,5
6063,Phanah,the-forgotten-coast,665,druid,restoration,12,7,5
6064,Darkstarfalz,bleeding-hollow,665,druid,restoration,12,7,5
6065,Megumixd,illidan,665,druid,restoration,12,7,5
6066,Swagbabe,sargeras,665,druid,restoration,18,7,11
6067,Lacarne,tichondrius,665,druid,restoration,30,7,23
6068,Bullshifftt,kelthuzad,664,druid,restoration,12,7,5
6069,Anakum,azshara,664,druid,restoration,16,8,8
6070,Happylilmoo,kiljaeden,664,druid,restoration,24,7,17
6071,Somars,cenarius,663,druid,restoration,12,7,5
6072,Madambuku,thrall,663,druid,restoration,12,7,5
6073,Inblooms,blackhand,663,druid,restoration,18,7,11
6074,Shilpá,stormrage,662,druid,restoration,18,7,11
6075,Donutjelly,moknathal,661,druid,restoration,12,7,5
6076,Oswalphis,moon-guard,660,druid,restoration,12,7,5
6077,Xkcc,perenolde,660,druid,restoration,18,7,11
6078,Snarl,blades-edge,657,druid,restoration,12,7,5
6079,Ikova,frostmourne,650,druid,restoration,18,7,11
6080,Gotdruid,sargeras,639,druid,restoration,14,8,6
6081,Riddickd,malfurion,639,druid,restoration,14,8,6
6082,Warmkitteh,kiljaeden,639,druid,restoration,17,7,10
6083,Breathe,ysera,639,druid,restoration,28,7,21
6084,Perems,bleeding-hollow,629,druid,restoration,24,7,17
6085,Guavajuice,stormrage,624,druid,restoration,19,8,11
6086,Wolfelord,sargeras,624,druid,restoration,21,7,14
6087,Morpheous,emerald-dream,624,druid,restoration,31,7,24
6088,Çuradora,tichondrius,617,druid,restoration,15,9,6
6089,Midoriiro,dentarg,612,druid,restoration,25,8,17
6090,Milkz,zuljin,607,druid,restoration,26,7,19
6091,Tofumation,gorgonnash,606,druid,restoration,19,8,11
6092,Ordono,emerald-dream,576,druid,restoration,6,6,0
6093,Solipsism,barthilas,576,druid,restoration,6,6,0
6094,Masan,burning-blade,576,druid,restoration,6,6,0
6095,Pacetwo,area-52,576,druid,restoration,6,6,0
6096,Nomilk,illidan,576,druid,restoration,12,6,6
6097,Juicecarton,thrall,576,druid,restoration,12,6,6
6098,Injections,kelthuzad,576,druid,restoration,12,6,6
6099,Barqskin,malganis,576,druid,restoration,12,6,6
6100,Bearys,area-52,576,druid,restoration,12,6,6
6101,Krisdu,kelthuzad,576,druid,restoration,12,6,6
6102,Larryjones,alleria,576,druid,restoration,12,6,6
6103,Maèstus,thrall,576,druid,restoration,12,6,6
6104,Mynameisfish,tichondrius,576,druid,restoration,12,6,6
6105,Onlyforms,illidan,576,druid,restoration,12,6,6
6106,Krunks,frostmourne,576,druid,restoration,12,6,6
6107,Cloneandbone,nerzhul,576,druid,restoration,12,6,6
6108,Dirtydrood,mugthol,576,druid,restoration,12,6,6
6109,Bobblespook,stormrage,576,druid,restoration,12,6,6
6110,Maolfurion,stormrage,576,druid,restoration,12,6,6
6111,Xingyejingmi,tichondrius,576,druid,restoration,12,6,6
6112,Torbock,zuljin,576,druid,restoration,12,6,6
6113,Brëed,tichondrius,576,druid,restoration,12,6,6
6114,Smeekqtwo,tichondrius,576,druid,restoration,12,6,6
6115,Forèst,sargeras,576,druid,restoration,12,6,6
6116,Afkifuthrow,ysera,576,druid,restoration,12,6,6
6117,Sawajirii,tichondrius,576,druid,restoration,12,6,6
6118,Floray,tichondrius,576,druid,restoration,12,6,6
6119,Hecaf,drakkari,576,druid,restoration,12,6,6
6120,Leomerchan,stormrage,576,druid,restoration,12,6,6
6121,Connection,emerald-dream,576,druid,restoration,12,6,6
6122,Gemo,tichondrius,576,druid,restoration,12,6,6
6123,Fwaffle,bleeding-hollow,576,druid,restoration,12,6,6
6124,Gizho,sargeras,576,druid,restoration,12,6,6
6125,Daddypompum,tichondrius,576,druid,restoration,12,6,6
6126,Naturenugget,sargeras,576,druid,restoration,12,6,6
6127,Solushunx,sargeras,576,druid,restoration,12,6,6
6128,Chinadruidss,tichondrius,576,druid,restoration,12,6,6
6129,Zux,drakkari,576,druid,restoration,12,6,6
6130,Restokin,dreadmaul,576,druid,restoration,15,7,8
6131,Shiftydon,borean-tundra,576,druid,restoration,15,6,9
6132,Hawtyforever,tichondrius,576,druid,restoration,18,6,12
6133,Ephemêral,stormrage,576,druid,restoration,18,6,12
6134,Sneakiez,tichondrius,576,druid,restoration,18,6,12
6135,Axtin,stormreaver,576,druid,restoration,18,6,12
6136,Fidelo,tichondrius,576,druid,restoration,18,6,12
6137,Mâckdâddy,kul-tiras,576,druid,restoration,18,6,12
6138,Bøo,frostmourne,576,druid,restoration,18,6,12
6139,Noctorius,ragnaros,576,druid,restoration,18,6,12
6140,Arútam,ragnaros,576,druid,restoration,18,6,12
6141,Shinoßi,area-52,576,druid,restoration,24,6,18
6142,Nerglet,aerie-peak,576,druid,restoration,24,6,18
6143,Fyrleaf,lightnings-blade,576,druid,restoration,24,6,18
6144,Hottietottie,laughing-skull,576,druid,restoration,24,6,18
6145,Gønkh,quelthalas,575,druid,restoration,6,6,0
6146,Arjác,jubeithos,575,druid,restoration,12,6,6
6147,Miraval,area-52,575,druid,restoration,12,6,6
6148,Nightnes,sargeras,575,druid,restoration,12,6,6
6149,Kokushe,burning-legion,575,druid,restoration,12,6,6
6150,Velauris,sargeras,575,druid,restoration,12,6,6
6151,Flôkey,tichondrius,575,druid,restoration,12,6,6
6152,Nrp,stormrage,575,druid,restoration,12,6,6
6153,Seralyo,quelthalas,575,druid,restoration,12,6,6
6154,Gosch,stormrage,575,druid,restoration,12,6,6
6155,Clawandørder,tichondrius,575,druid,restoration,12,6,6
6156,Spaceships,stormrage,575,druid,restoration,12,6,6
6157,Ulfvur,nagrand,575,druid,restoration,12,6,6
6158,Weltherion,guldan,575,druid,restoration,12,6,6
6159,Bamfferal,tichondrius,575,druid,restoration,12,6,6
6160,Jonoa,nagrand,575,druid,restoration,12,6,6
6161,Bearlielegal,stormrage,575,druid,restoration,12,6,6
6162,Keläia,quelthalas,575,druid,restoration,12,6,6
6163,Skullchief,barthilas,575,druid,restoration,16,7,9
6164,Sleepypaws,silvermoon,575,druid,restoration,18,6,12
6165,Dýreðaguð,gurubashi,575,druid,restoration,18,6,12
6166,Aligantor,thrall,575,druid,restoration,18,6,12
6167,Treynî,tichondrius,575,druid,restoration,18,6,12
6168,Elpako,ragnaros,574,druid,restoration,6,6,0
6169,Carther,korgath,574,druid,restoration,12,6,6
6170,Dibinha,azralon,574,druid,restoration,12,6,6
6171,Throatslash,thrall,574,druid,restoration,12,6,6
6172,Troky,drakkari,574,druid,restoration,12,6,6
6173,Aranuir,emerald-dream,574,druid,restoration,18,6,12
6174,Skishy,tichondrius,574,druid,restoration,18,6,12
6175,Brisketmre,dalaran,574,druid,restoration,36,6,30
6176,Lonewolfdrd,illidan,573,druid,restoration,6,6,0
6177,Kallinia,tichondrius,573,druid,restoration,6,6,0
6178,Quagsire,moon-guard,573,druid,restoration,18,6,12
6179,Glandalf,illidan,573,druid,restoration,18,6,12
6180,Vacagalo,azralon,572,druid,restoration,12,6,6
6181,Modification,eonar,572,druid,restoration,12,6,6
6182,Ahlekleklekk,azralon,572,druid,restoration,12,6,6
6183,Erourk,azralon,572,druid,restoration,12,6,6
6184,Juucifer,thrall,572,druid,restoration,12,6,6
6185,Nightshiver,bleeding-hollow,572,druid,restoration,12,6,6
6186,Guusx,bonechewer,572,druid,restoration,18,6,12
6187,Marisska,stormrage,571,druid,restoration,12,6,6
6188,Kupaloidzki,proudmoore,571,druid,restoration,12,6,6
6189,Budsmoke,stormrage,571,druid,restoration,18,6,12
6190,Mîløh,area-52,570,druid,restoration,12,6,6
6191,Aokseer,azralon,570,druid,restoration,12,6,6
6192,Nordway,alexstrasza,569,druid,restoration,12,6,6
6193,Healbott,lightnings-blade,569,druid,restoration,12,6,6
6194,Otixx,wyrmrest-accord,568,druid,restoration,18,6,12
6195,Naachocheeze,tichondrius,566,druid,restoration,12,6,6
6196,Lililililil,stormrage,552,druid,restoration,36,6,30
6197,Istishiã,tichondrius,543,druid,restoration,14,7,7
6198,Enyu,sargeras,542,druid,restoration,23,6,17
6199,Cudbacrakhed,tichondrius,541,druid,restoration,20,7,13
6200,Pahandan,bonechewer,528,druid,restoration,15,7,8
6201,Isalien,kelthuzad,521,druid,restoration,21,7,14
6202,Arthemisgodx,azralon,520,druid,restoration,17,10,7
6203,Rakins,arthas,496,druid,restoration,13,6,7
6204,Awkwarder,emerald-dream,494,druid,restoration,19,7,12
6205,Windù,azralon,488,druid,restoration,16,9,7
6206,Kascatm,area-52,480,druid,restoration,6,5,1
6207,Genghisßong,mannoroth,480,druid,restoration,6,5,1
6208,Jaspen,bleeding-hollow,480,druid,restoration,6,5,1
6209,Diggsterz,area-52,480,druid,restoration,6,5,1
6210,Flatdaddy,doomhammer,480,druid,restoration,6,5,1
6211,Dëmoníc,ragnaros,480,druid,restoration,6,5,1
6212,Roraex,tichondrius,480,druid,restoration,6,5,1
6213,Treehealage,sargeras,480,druid,restoration,6,5,1
6214,Sevend,tichondrius,480,druid,restoration,6,5,1
6215,Naakx,tichondrius,480,druid,restoration,6,5,1
6216,Buckmoon,area-52,480,druid,restoration,12,5,7
6217,Randoms,perenolde,480,druid,restoration,12,5,7
6218,Ashstarfall,barthilas,480,druid,restoration,12,5,7
6219,Brocolli,sargeras,480,druid,restoration,12,5,7
6220,Vêrâ,stormrage,480,druid,restoration,12,5,7
6221,Stormjammer,proudmoore,480,druid,restoration,12,5,7
6222,Furrari,baelgun,480,druid,restoration,12,5,7
6223,Cheeseface,bleeding-hollow,480,druid,restoration,12,5,7
6224,Skogsbruk,stormrage,480,druid,restoration,12,5,7
6225,Greeneguy,thrall,480,druid,restoration,12,5,7
6226,Tydruid,illidan,480,druid,restoration,12,5,7
6227,Moonfannia,malganis,480,druid,restoration,12,5,7
6228,Angryalyu,tichondrius,480,druid,restoration,12,5,7
6229,Tranqz,moon-guard,480,druid,restoration,12,5,7
6230,Whìtewölf,emerald-dream,480,druid,restoration,12,5,7
6231,Lukass,tichondrius,480,druid,restoration,12,5,7
6232,Stårrysky,illidan,480,druid,restoration,12,5,7
6233,Pigdd,tichondrius,480,druid,restoration,12,5,7
6234,Memoryleaks,proudmoore,480,druid,restoration,12,5,7
6235,Jaydog,emerald-dream,480,druid,restoration,12,5,7
6236,Teslabeam,illidan,480,druid,restoration,12,5,7
6237,Stamookee,area-52,480,druid,restoration,12,5,7
6238,Hotgoal,frostmourne,480,druid,restoration,12,5,7
6239,Hotgoose,malganis,480,druid,restoration,12,5,7
6240,Lookhowirun,emerald-dream,480,druid,restoration,12,5,7
6241,Yevenbother,tichondrius,480,druid,restoration,12,5,7
6242,Reconus,frostmourne,480,druid,restoration,12,5,7
6243,Afrogx,dalaran,480,druid,restoration,12,5,7
6244,Maxspeed,tichondrius,480,druid,restoration,12,5,7
6245,Zemul,ragnaros,480,druid,restoration,12,5,7
6246,Tygraz,alleria,480,druid,restoration,12,5,7
6247,Shartah,zuljin,480,druid,restoration,12,5,7
6248,Fastyhands,illidan,480,druid,restoration,12,5,7
6249,Noah,altar-of-storms,480,druid,restoration,12,5,7
6250,Hudada,emerald-dream,480,druid,restoration,12,5,7
6251,Blàtté,zuljin,480,druid,restoration,12,5,7
6252,Wizdùm,frostmourne,480,druid,restoration,13,5,8
6253,Duckbillby,bleeding-hollow,480,druid,restoration,14,5,9
6254,Djimbo,kelthuzad,480,druid,restoration,18,5,13
6255,Guacisextraa,thrall,480,druid,restoration,18,5,13
6256,Peakedinwod,sargeras,480,druid,restoration,18,5,13
6257,Jungledíff,ragnaros,480,druid,restoration,18,5,13
6258,Spacaa,kelthuzad,480,druid,restoration,24,5,19
6259,Offthemeters,mannoroth,480,druid,restoration,24,5,19
6260,Treezy,dalaran,480,druid,restoration,24,5,19
6261,Hornmenow,frostmourne,480,druid,restoration,24,5,19
6262,Brostoevski,khadgar,480,druid,restoration,24,5,19
6263,Murrmerly,moon-guard,479,druid,restoration,6,5,1
6264,Sønèca,azralon,479,druid,restoration,12,5,7
6265,Jamona,cenarius,479,druid,restoration,12,5,7
6266,Redfang,jaedenar,479,druid,restoration,12,5,7
6267,Forest,frostmourne,479,druid,restoration,12,5,7
6268,Jammi,skywall,479,druid,restoration,12,5,7
6269,Mvqxd,tichondrius,479,druid,restoration,12,5,7
6270,Murkkd,tichondrius,479,druid,restoration,12,5,7
6271,Mînîboss,ragnaros,479,druid,restoration,12,5,7
6272,Pingú,tichondrius,479,druid,restoration,14,5,9
6273,Sharialawl,stormreaver,479,druid,restoration,18,5,13
6274,Indicah,barthilas,479,druid,restoration,18,5,13
6275,Olegoatjames,darkspear,478,druid,restoration,13,6,7
6276,Rònaldò,drakthul,478,druid,restoration,12,5,7
6277,Fastafboy,stormrage,478,druid,restoration,12,5,7
6278,Bloodyhoofs,malganis,478,druid,restoration,12,5,7
6279,Treemendous,tichondrius,478,druid,restoration,12,5,7
6280,Beienus,ragnaros,478,druid,restoration,12,5,7
6281,Natruid,sargeras,478,druid,restoration,12,5,7
6282,Linbiba,area-52,478,druid,restoration,12,5,7
6283,Jíbóia,azralon,478,druid,restoration,12,5,7
6284,Scheppke,bleeding-hollow,477,druid,restoration,12,5,7
6285,Fiddy,kelthuzad,477,druid,restoration,12,5,7
6286,Beanslice,nazgrel,477,druid,restoration,18,5,13
6287,Byahh,shuhalo,477,druid,restoration,18,5,13
6288,Baha,azralon,477,druid,restoration,18,5,13
6289,Wraiven,elune,477,druid,restoration,18,5,13
6290,Swiftstrider,frostmourne,476,druid,restoration,10,6,4
6291,Béren,alterac-mountains,476,druid,restoration,12,5,7
6292,Kaldrago,detheroc,476,druid,restoration,12,5,7
6293,Phlap,zuljin,476,druid,restoration,12,5,7
6294,Ånxiety,skullcrusher,476,druid,restoration,12,5,7
6295,Muphausa,area-52,475,druid,restoration,12,5,7
6296,Apocalyptoe,proudmoore,474,druid,restoration,12,5,7
6297,Finubar,emerald-dream,472,druid,restoration,12,5,7
6298,Vuthryx,tichondrius,472,druid,restoration,18,5,13
6299,Curador,aegwynn,471,druid,restoration,18,5,13
6300,Bobruid,nagrand,469,druid,restoration,19,9,10
6301,Maerk,aerie-peak,469,druid,restoration,18,5,13
6302,Udroth,kelthuzad,468,druid,restoration,17,5,12
6303,Metaldruid,tichondrius,463,druid,restoration,11,5,6
6304,Druidkofwa,tichondrius,462,druid,restoration,11,5,6
6305,Semangarbage,tichondrius,457,druid,restoration,15,8,7
6306,Chopotron,ragnaros,447,druid,restoration,16,5,11
6307,Fuzzie,icecrown,447,druid,restoration,16,5,11
6308,Bigelbows,area-52,432,druid,restoration,15,6,9
6309,Qij,eonar,431,druid,restoration,11,5,6
6310,Gankstababy,tichondrius,426,druid,restoration,20,6,14
6311,Indicahigh,moon-guard,424,druid,restoration,16,7,9
6312,Persiancoco,area-52,422,druid,restoration,14,6,8
6313,Oongadunga,tichondrius,415,druid,restoration,14,5,9
6314,Luluid,tichondrius,399,druid,restoration,5,5,0
6315,Peazoepico,tichondrius,384,druid,restoration,6,4,2
6316,Crayolaa,barthilas,384,druid,restoration,6,4,2
6317,Lushÿ,tichondrius,384,druid,restoration,6,4,2
6318,Bambi,bleeding-hollow,384,druid,restoration,6,4,2
6319,Clydruid,blackrock,384,druid,restoration,6,4,2
6320,Shiftedonyou,blackrock,384,druid,restoration,6,4,2
6321,Thetbones,tichondrius,384,druid,restoration,6,4,2
6322,Deegawn,proudmoore,384,druid,restoration,6,4,2
6323,Relikd,dawnbringer,384,druid,restoration,6,4,2
6324,Gilysel,tichondrius,384,druid,restoration,6,4,2
6325,Êhurricane,dalaran,384,druid,restoration,6,4,2
6326,Koan,proudmoore,384,druid,restoration,6,4,2
6327,Johnnybigg,barthilas,384,druid,restoration,6,4,2
6328,Kushkilla,malganis,384,druid,restoration,6,4,2
6329,Tigresa,perenolde,384,druid,restoration,6,4,2
6330,Doomky,area-52,384,druid,restoration,6,4,2
6331,Toastsdruid,tichondrius,384,druid,restoration,6,4,2
6332,Lylek,azshara,384,druid,restoration,6,4,2
6333,Outcastmango,thrall,384,druid,restoration,6,4,2
6334,Metaindexqt,quelthalas,384,druid,restoration,6,4,2
6335,Someshta,sargeras,384,druid,restoration,6,4,2
6336,Clarityx,illidan,384,druid,restoration,6,4,2
6337,Ckàíne,stormrage,384,druid,restoration,6,4,2
6338,Music,magtheridon,384,druid,restoration,6,4,2
6339,Zoddyboy,tichondrius,384,druid,restoration,6,4,2
6340,Euwin,stormrage,384,druid,restoration,6,4,2
6341,Dpumba,azralon,384,druid,restoration,6,4,2
6342,Starshípx,tichondrius,384,druid,restoration,6,4,2
6343,Hottie,kelthuzad,384,druid,restoration,6,4,2
6344,Zbh,tichondrius,384,druid,restoration,6,4,2
6345,Nbendtner,tichondrius,384,druid,restoration,6,4,2
6346,Shroomdealer,kelthuzad,384,druid,restoration,6,4,2
6347,Nøbuchi,kelthuzad,384,druid,restoration,6,4,2
6348,Volayer,frostmourne,384,druid,restoration,6,4,2
6349,Druidlstrudl,moon-guard,384,druid,restoration,6,4,2
6350,Bandruid,tichondrius,384,druid,restoration,10,4,6
6351,Zerocoolx,illidan,384,druid,restoration,15,5,10
6352,Lillenan,illidan,384,druid,restoration,12,4,8
6353,Narlie,malfurion,384,druid,restoration,12,4,8
6354,Mastabtw,illidan,384,druid,restoration,12,4,8
6355,Bopple,tichondrius,384,druid,restoration,12,4,8
6356,Taysfriend,tichondrius,384,druid,restoration,12,4,8
6357,Ebrìthil,hyjal,384,druid,restoration,12,4,8
6358,Kinatsu,tichondrius,384,druid,restoration,12,4,8
6359,Metaphysìcs,kelthuzad,384,druid,restoration,12,4,8
6360,Mollytonasty,demon-soul,384,druid,restoration,12,4,8
6361,Figsurine,sargeras,384,druid,restoration,12,4,8
6362,Nocup,illidan,384,druid,restoration,12,4,8
6363,Flompstomper,skullcrusher,384,druid,restoration,12,4,8
6364,Ilmoonz,frostmane,384,druid,restoration,12,4,8
6365,Thebutterboy,stormrage,384,druid,restoration,12,4,8
6366,Ônlyyou,burning-legion,384,druid,restoration,12,4,8
6367,Stamaximdru,lightbringer,384,druid,restoration,12,4,8
6368,Hotrecki,kelthuzad,384,druid,restoration,12,4,8
6369,Ganizote,ragnaros,384,druid,restoration,12,4,8
6370,Chickenwings,ragnaros,384,druid,restoration,12,4,8
6371,Shadru,bleeding-hollow,384,druid,restoration,12,4,8
6372,Drstudmaster,skullcrusher,384,druid,restoration,12,4,8
6373,Djdontlose,stormrage,384,druid,restoration,12,4,8
6374,Catcat,dalaran,384,druid,restoration,12,4,8
6375,Bigshred,tichondrius,384,druid,restoration,12,4,8
6376,Flyshles,frostmourne,384,druid,restoration,12,4,8
6377,Guurgul,bleeding-hollow,384,druid,restoration,12,4,8
6378,Stephonxd,area-52,384,druid,restoration,12,4,8
6379,Brittanychan,sargeras,384,druid,restoration,12,4,8
6380,Py,stormscale,384,druid,restoration,12,4,8
6381,Ursu,nemesis,384,druid,restoration,12,4,8
6382,Delícíous,darkspear,384,druid,restoration,12,4,8
6383,Mittns,arthas,384,druid,restoration,12,4,8
6384,Tommyjimmy,andorhal,384,druid,restoration,12,4,8
6385,Mé,arthas,384,druid,restoration,12,4,8
6386,Spazer,darkspear,384,druid,restoration,12,4,8
6387,Karlmalone,thunderlord,384,druid,restoration,12,4,8
6388,Angercow,nordrassil,384,druid,restoration,12,4,8
6389,Gathmog,boulderfist,384,druid,restoration,12,4,8
6390,Ohioman,bleeding-hollow,384,druid,restoration,12,4,8
6391,Science,arthas,384,druid,restoration,12,4,8
6392,Awguseon,proudmoore,384,druid,restoration,12,4,8
6393,Chiikawa,tichondrius,384,druid,restoration,12,4,8
6394,Mastahskills,illidan,384,druid,restoration,12,4,8
6395,Bumbally,illidan,384,druid,restoration,12,4,8
6396,Moosesolini,chogall,384,druid,restoration,12,4,8
6397,Allevii,sargeras,384,druid,restoration,12,4,8
6398,Fartsicle,lightnings-blade,384,druid,restoration,12,4,8
6399,Synthesïs,malganis,384,druid,restoration,12,4,8
6400,Bwaccowi,sargeras,384,druid,restoration,12,4,8
6401,Odenmu,ragnaros,384,druid,restoration,12,4,8
6402,Harøs,stormrage,384,druid,restoration,13,4,9
6403,Read,eredar,384,druid,restoration,21,5,16
6404,Tarvosx,thrall,384,druid,restoration,18,4,14
6405,Renlion,malganis,384,druid,restoration,18,4,14
6406,Swagglefrag,zuljin,384,druid,restoration,18,4,14
6407,Silasel,sargeras,384,druid,restoration,18,4,14
6408,Ternkote,tichondrius,384,druid,restoration,21,4,17
6409,Calleguard,terenas,383,druid,restoration,6,4,2
6410,Bryle,kiljaeden,383,druid,restoration,6,4,2
6411,Nightflow,emerald-dream,383,druid,restoration,12,4,8
6412,Brazzar,kiljaeden,383,druid,restoration,12,4,8
6413,Pahrump,stormrage,383,druid,restoration,12,4,8
6414,Dadboody,sargeras,383,druid,restoration,12,4,8
6415,Ssuka,tichondrius,383,druid,restoration,12,4,8
6416,Norco,dentarg,383,druid,restoration,12,4,8
6417,Jonnyutaa,emerald-dream,383,druid,restoration,12,4,8
6418,Kurnon,shattered-hand,383,druid,restoration,12,4,8
6419,Zelara,kilrogg,383,druid,restoration,12,4,8
6420,Posmard,ragnaros,383,druid,restoration,12,4,8
6421,Elanni,illidan,383,druid,restoration,12,4,8
6422,Moonshire,boulderfist,383,druid,restoration,12,4,8
6423,Hazbekbek,area-52,383,druid,restoration,12,4,8
6424,Hajjima,blackrock,383,druid,restoration,12,4,8
6425,Linklan,bleeding-hollow,383,druid,restoration,12,4,8
6426,Chuckzilla,korgath,383,druid,restoration,12,4,8
6427,Madmandan,moon-guard,383,druid,restoration,18,4,14
6428,Lulerz,cenarius,383,druid,restoration,18,4,14
6429,Rikey,thaurissan,383,druid,restoration,18,4,14
6430,Morphiius,archimonde,383,druid,restoration,18,4,14
6431,Beôrn,mugthol,382,druid,restoration,6,4,2
6432,Solá,skywall,382,druid,restoration,12,4,8
6433,Alcoolânio,stormrage,382,druid,restoration,12,4,8
6434,Puzzlè,thrall,382,druid,restoration,12,4,8
6435,Guojue,tichondrius,382,druid,restoration,12,4,8
6436,Gardeni,emerald-dream,382,druid,restoration,12,4,8
6437,Infestador,tichondrius,382,druid,restoration,12,4,8
6438,Maldrake,quelthalas,381,druid,restoration,12,4,8
6439,Ceria,hellscream,381,druid,restoration,12,4,8
6440,Meowsz,malganis,381,druid,restoration,12,4,8
6441,Certzu,moon-guard,381,druid,restoration,18,4,14
6442,Bigbadcow,sargeras,380,druid,restoration,12,4,8
6443,Metamooseowl,crushridge,379,druid,restoration,12,4,8
6444,Yassi,earthen-ring,379,druid,restoration,12,4,8
6445,Nüg,frostmourne,379,druid,restoration,14,4,10
6446,Irumble,silver-hand,377,druid,restoration,17,4,13
6447,Sertroz,sargeras,351,druid,restoration,11,4,7
6448,Sndru,illidan,330,druid,restoration,12,5,7
6449,Harûko,moon-guard,330,druid,restoration,30,5,25
6450,Greythan,madoran,325,druid,restoration,42,5,37
6451,Alleae,stormrage,319,druid,restoration,5,4,1
6452,Fatloser,hyjal,319,druid,restoration,11,5,6
6453,Ugress,whisperwind,302,druid,restoration,13,4,9
6454,Lorandros,saurfang,288,druid,restoration,6,3,3
6455,Mädnhairy,zuljin,288,druid,restoration,6,3,3
6456,Istayfrawsty,darkspear,288,druid,restoration,6,3,3
6457,Rukins,frostmourne,288,druid,restoration,6,3,3
6458,Fungamezx,bleeding-hollow,288,druid,restoration,6,3,3
6459,Anthria,illidan,288,druid,restoration,6,3,3
6460,Zukrath,shadow-council,288,druid,restoration,6,3,3
6461,Drunner,lothar,288,druid,restoration,6,3,3
6462,Catahmine,thrall,288,druid,restoration,6,3,3
6463,Xötic,stormrage,288,druid,restoration,6,3,3
6464,Owaru,stormrage,288,druid,restoration,6,3,3
6465,Asian,moon-guard,288,druid,restoration,6,3,3
6466,Koratan,frostmourne,288,druid,restoration,6,3,3
6467,Yllercia,quelthalas,288,druid,restoration,6,3,3
6468,Kcazz,thorium-brotherhood,288,druid,restoration,6,3,3
6469,Ateup,dawnbringer,288,druid,restoration,6,3,3
6470,Emiyababmura,tichondrius,288,druid,restoration,6,3,3
6471,Eryon,nemesis,288,druid,restoration,6,3,3
6472,Lemonnz,illidan,288,druid,restoration,6,3,3
6473,Tziv,area-52,288,druid,restoration,6,3,3
6474,Idolizeme,skullcrusher,288,druid,restoration,6,3,3
6475,Ðeepsixx,burning-legion,288,druid,restoration,6,3,3
6476,Moex,illidan,288,druid,restoration,6,3,3
6477,Creamsoda,frostmane,288,druid,restoration,6,3,3
6478,Hotmuztard,sargeras,288,druid,restoration,6,3,3
6479,Sevensword,tichondrius,288,druid,restoration,6,3,3
6480,Bearforcetwo,lightbringer,288,druid,restoration,6,3,3
6481,Muffiñ,moon-guard,288,druid,restoration,6,3,3
6482,Stephenfurry,tichondrius,288,druid,restoration,6,3,3
6483,Geno,cenarius,288,druid,restoration,6,3,3
6484,Isunami,emerald-dream,288,druid,restoration,6,3,3
6485,Sonicphantom,kelthuzad,288,druid,restoration,6,3,3
6486,Wiskees,sargeras,288,druid,restoration,6,3,3
6487,Seekamp,khazgoroth,288,druid,restoration,6,3,3
6488,Anaho,korgath,288,druid,restoration,6,3,3
6489,Curze,maiev,288,druid,restoration,6,3,3
6490,Tronita,frostwolf,288,druid,restoration,6,3,3
6491,Thenog,arthas,288,druid,restoration,6,3,3
6492,Lotsoflovexo,illidan,288,druid,restoration,6,3,3
6493,Mythicdruid,ragnaros,288,druid,restoration,6,3,3
6494,Aidoh,kelthuzad,288,druid,restoration,6,3,3
6495,Wâggles,moon-guard,288,druid,restoration,6,3,3
6496,Hýovan,stormrage,288,druid,restoration,6,3,3
6497,Teancookies,tichondrius,288,druid,restoration,6,3,3
6498,Antonniel,azralon,288,druid,restoration,6,3,3
6499,Menapaws,muradin,288,druid,restoration,6,3,3
6500,Junglefevers,tichondrius,288,druid,restoration,6,3,3
6501,Càlthar,sargeras,288,druid,restoration,6,3,3
6502,Reptile,terenas,288,druid,restoration,6,3,3
6503,Obsesséd,aggramar,288,druid,restoration,6,3,3
6504,Bibliopole,tichondrius,288,druid,restoration,6,3,3
6505,Hashdxm,tichondrius,288,druid,restoration,6,3,3
6506,Panterarosa,ragnaros,288,druid,restoration,6,3,3
6507,Vadroid,dalaran,288,druid,restoration,6,3,3
6508,Ømí,quelthalas,288,druid,restoration,6,3,3
6509,Lahgit,frostmourne,288,druid,restoration,6,3,3
6510,Lðhnar,malganis,288,druid,restoration,6,3,3
6511,Catdruid,the-forgotten-coast,288,druid,restoration,6,3,3
6512,Imaoo,illidan,288,druid,restoration,6,3,3
6513,Flatnose,agamaggan,288,druid,restoration,6,3,3
6514,Cutefeetz,moon-guard,288,druid,restoration,6,3,3
6515,Tarlis,khazgoroth,288,druid,restoration,6,3,3
6516,Drmf,frostmourne,288,druid,restoration,6,3,3
6517,Azaran,bleeding-hollow,288,druid,restoration,6,3,3
6518,Zaddy,spinebreaker,288,druid,restoration,6,3,3
6519,Spinach,moon-guard,288,druid,restoration,6,3,3
6520,Nightz,icecrown,288,druid,restoration,6,3,3
6521,Ayra,sargeras,288,druid,restoration,6,3,3
6522,Veyx,malganis,288,druid,restoration,6,3,3
6523,Realá,kelthuzad,288,druid,restoration,6,3,3
6524,Gouzz,frostmourne,288,druid,restoration,6,3,3
6525,Nokash,tichondrius,288,druid,restoration,6,3,3
6526,Buffjungle,tichondrius,288,druid,restoration,6,3,3
6527,Zxxzy,tichondrius,288,druid,restoration,8,3,5
6528,Demitassie,wyrmrest-accord,288,druid,restoration,8,3,5
6529,Overgrowth,zuljin,288,druid,restoration,9,3,6
6530,Mysteec,bleeding-hollow,288,druid,restoration,11,3,8
6531,Shadøwshifta,kelthuzad,288,druid,restoration,12,3,9
6532,Anthren,garona,288,druid,restoration,12,3,9
6533,Bearlínwall,sargeras,288,druid,restoration,12,3,9
6534,Theømega,stormrage,288,druid,restoration,12,3,9
6535,Møth,anvilmar,288,druid,restoration,12,3,9
6536,Bigclapz,stormrage,288,druid,restoration,12,3,9
6537,Bewear,zangarmarsh,288,druid,restoration,12,3,9
6538,Solushuffle,sargeras,288,druid,restoration,12,3,9
6539,Endworldx,tichondrius,288,druid,restoration,12,3,9
6540,Biggié,bleeding-hollow,288,druid,restoration,12,3,9
6541,Qdrui,tichondrius,288,druid,restoration,12,3,9
6542,Wwkd,illidan,288,druid,restoration,12,3,9
6543,Oflodor,azralon,288,druid,restoration,12,3,9
6544,Theblind,korgath,288,druid,restoration,12,3,9
6545,Madtreé,bleeding-hollow,288,druid,restoration,12,3,9
6546,Concerneddog,malganis,288,druid,restoration,12,3,9
6547,Veejae,stormreaver,288,druid,restoration,12,3,9
6548,Noradn,malganis,288,druid,restoration,12,3,9
6549,Raptormotoo,lothar,288,druid,restoration,12,3,9
6550,Mattiu,area-52,288,druid,restoration,12,3,9
6551,Borbys,sargeras,288,druid,restoration,12,3,9
6552,Blacksimba,area-52,288,druid,restoration,12,3,9
6553,Quadrivium,stormrage,288,druid,restoration,12,3,9
6554,Nesterin,arathor,288,druid,restoration,12,3,9
6555,Nuantar,nemesis,288,druid,restoration,12,3,9
6556,Deyz,ysera,288,druid,restoration,12,3,9
6557,Otckillaa,boulderfist,288,druid,restoration,12,3,9
6558,Kanokoho,wyrmrest-accord,288,druid,restoration,12,3,9
6559,Garrodan,aerie-peak,288,druid,restoration,12,3,9
6560,Anthracnose,zuljin,288,druid,restoration,12,3,9
6561,Monicaduan,frostmourne,288,druid,restoration,12,3,9
6562,Soloqmenace,malganis,288,druid,restoration,12,3,9
6563,Krispies,eredar,288,druid,restoration,12,3,9
6564,Azngødz,tichondrius,288,druid,restoration,12,3,9
6565,Thundyrcat,tichondrius,288,druid,restoration,18,3,15
6566,Yuumura,stormrage,288,druid,restoration,18,3,15
6567,Soloqleaver,tichondrius,288,druid,restoration,18,3,15
6568,Friendly,wyrmrest-accord,288,druid,restoration,18,3,15
6569,Giddeonv,draenor,288,druid,restoration,18,3,15
6570,Killvious,kelthuzad,288,druid,restoration,24,3,21
6571,Rádágast,nemesis,287,druid,restoration,6,3,3
6572,Udala,durotan,287,druid,restoration,6,3,3
6573,Nightseekers,grizzly-hills,287,druid,restoration,6,3,3
6574,Glowstixz,tichondrius,287,druid,restoration,6,3,3
6575,Joxor,nordrassil,287,druid,restoration,6,3,3
6576,Harderplease,emerald-dream,287,druid,restoration,6,3,3
6577,Ayakuya,veknilash,287,druid,restoration,6,3,3
6578,Oldcktwist,garrosh,287,druid,restoration,6,3,3
6579,Sefestria,senjin,287,druid,restoration,6,3,3
6580,Temujin,shadow-council,287,druid,restoration,6,3,3
6581,Moonfires,senjin,287,druid,restoration,6,3,3
6582,Iamanoob,sargeras,287,druid,restoration,10,4,6
6583,Atillah,stormscale,287,druid,restoration,12,3,9
6584,Lêsly,thrall,287,druid,restoration,12,3,9
6585,Druishcat,dark-iron,287,druid,restoration,12,3,9
6586,Megara,dalaran,287,druid,restoration,12,3,9
6587,Cieran,senjin,287,druid,restoration,18,3,15
6588,Twoworldz,tichondrius,286,druid,restoration,6,3,3
6589,Dcdc,malganis,286,druid,restoration,6,3,3
6590,Bullshiftter,ursin,286,druid,restoration,6,3,3
6591,Andraste,queldorei,286,druid,restoration,12,3,9
6592,Taiyla,stormrage,286,druid,restoration,12,3,9
6593,Fortunecat,illidan,286,druid,restoration,12,3,9
6594,Cryptalas,tichondrius,286,druid,restoration,12,3,9
6595,Moonbootz,proudmoore,285,druid,restoration,12,3,9
6596,Sabari,area-52,285,druid,restoration,24,3,21
6597,Brbcatsonfir,malganis,270,druid,restoration,28,4,24
6598,Gloomy,andorhal,256,druid,restoration,10,3,7
6599,Anastasyiar,illidan,256,druid,restoration,10,3,7
6600,Mahjongg,stormrage,255,druid,restoration,14,4,10
6601,Dotdmage,tichondrius,255,druid,restoration,11,3,8
6602,Thrunirn,dalaran,254,druid,restoration,11,3,8
6603,Benngotit,magtheridon,240,druid,restoration,9,3,6
6604,Stive,nemesis,234,druid,restoration,6,4,2
6605,Yoona,kiljaeden,234,druid,restoration,7,4,3
6606,Restyblazed,sargeras,234,druid,restoration,8,4,4
6607,Sïmba,andorhal,234,druid,restoration,9,4,5
6608,Donaldsr,area-52,234,druid,restoration,9,4,5
6609,Stormwood,moonrunner,234,druid,restoration,21,4,17
6610,Stèvén,tichondrius,233,druid,restoration,13,4,9
6611,Tyrannicool,proudmoore,224,druid,restoration,10,3,7
6612,Aegys,medivh,224,druid,restoration,11,3,8
6613,Gavdru,tichondrius,223,druid,restoration,8,3,5
6614,Faentz,stormrage,192,druid,restoration,9,3,6
6615,Katesw,tichondrius,192,druid,restoration,6,2,4
6616,Gepardéx,ragnaros,192,druid,restoration,6,2,4
6617,Ambassador,kelthuzad,192,druid,restoration,6,2,4
6618,Hatricio,ragnaros,192,druid,restoration,6,2,4
6619,Five,the-underbog,192,druid,restoration,6,2,4
6620,Mcbeef,tichondrius,192,druid,restoration,6,2,4
6621,Psycloned,magtheridon,192,druid,restoration,6,2,4
6622,Relxlol,tichondrius,192,druid,restoration,6,2,4
6623,Crazywoodowl,tichondrius,192,druid,restoration,6,2,4
6624,Noonwalk,illidan,192,druid,restoration,6,2,4
6625,Tagliatélle,emerald-dream,192,druid,restoration,6,2,4
6626,Moolord,eonar,192,druid,restoration,6,2,4
6627,Tynsley,malganis,192,druid,restoration,6,2,4
6628,Marisco,malganis,192,druid,restoration,6,2,4
6629,Spongedaddy,tichondrius,192,druid,restoration,6,2,4
6630,Netflixnphil,sargeras,192,druid,restoration,6,2,4
6631,Violyte,tichondrius,192,druid,restoration,6,2,4
6632,Hawtzi,stormrage,192,druid,restoration,6,2,4
6633,Hchhi,ragnaros,192,druid,restoration,6,2,4
6634,Hotsoncrak,tichondrius,192,druid,restoration,6,2,4
6635,Niquil,hyjal,192,druid,restoration,6,2,4
6636,Nacur,bleeding-hollow,192,druid,restoration,6,2,4
6637,Cultnelf,illidan,192,druid,restoration,6,2,4
6638,Geycat,tichondrius,192,druid,restoration,6,2,4
6639,Nogardfan,tichondrius,192,druid,restoration,6,2,4
6640,Drulícinha,azralon,192,druid,restoration,6,2,4
6641,Megasteak,lightninghoof,192,druid,restoration,6,2,4
6642,Gorfrog,tichondrius,192,druid,restoration,6,2,4
6643,Runningback,emerald-dream,192,druid,restoration,6,2,4
6644,Tropikana,burning-legion,192,druid,restoration,6,2,4
6645,Kornaz,guldan,192,druid,restoration,6,2,4
6646,Bigtonkatruk,tichondrius,192,druid,restoration,6,2,4
6647,Gêrm,stormrage,192,druid,restoration,6,2,4
6648,Freemac,tichondrius,192,druid,restoration,6,2,4
6649,Sidechonies,tichondrius,192,druid,restoration,6,2,4
6650,Murpheey,sargeras,192,druid,restoration,6,2,4
6651,Loved,stormrage,192,druid,restoration,6,2,4
6652,Stratego,drenden,192,druid,restoration,6,2,4
6653,Whiplash,deathwing,192,druid,restoration,6,2,4
6654,Darinnia,lothar,192,druid,restoration,6,2,4
6655,Hipityhopity,bleeding-hollow,192,druid,restoration,6,2,4
6656,Feeoria,lothar,192,druid,restoration,6,2,4
6657,Cushionmaker,tichondrius,192,druid,restoration,6,2,4
6658,Shiftzy,thrall,192,druid,restoration,6,2,4
6659,Sandiegoo,destromath,192,druid,restoration,6,2,4
6660,Ellowei,earthen-ring,192,druid,restoration,6,2,4
6661,Droody,earthen-ring,192,druid,restoration,6,2,4
6662,Tadoo,tichondrius,192,druid,restoration,6,2,4
6663,Snugglin,kelthuzad,192,druid,restoration,6,2,4
6664,Kagekuma,bleeding-hollow,192,druid,restoration,6,2,4
6665,Zils,bleeding-hollow,192,druid,restoration,6,2,4
6666,Dustdruid,hakkar,192,druid,restoration,6,2,4
6667,Fixn,tichondrius,192,druid,restoration,6,2,4
6668,Epicbehr,kiljaeden,192,druid,restoration,6,2,4
6669,Vaelstrasz,skullcrusher,192,druid,restoration,6,2,4
6670,Cheesetouchy,illidan,192,druid,restoration,6,2,4
6671,Nightwinter,area-52,192,druid,restoration,6,2,4
6672,Bekroh,crushridge,192,druid,restoration,6,2,4
6673,Chasmata,malganis,192,druid,restoration,6,2,4
6674,Levincy,thrall,192,druid,restoration,6,2,4
6675,Bomp,malganis,192,druid,restoration,6,2,4
6676,Lilcocoxoxo,shadowmoon,192,druid,restoration,6,2,4
6677,Ghostti,stormrage,192,druid,restoration,6,2,4
6678,Firefireahh,sargeras,192,druid,restoration,6,2,4
6679,Terminatore,kelthuzad,192,druid,restoration,6,2,4
6680,Tatahe,zuljin,192,druid,restoration,6,2,4
6681,Jackdr,tichondrius,192,druid,restoration,6,2,4
6682,Hyperdryve,bonechewer,192,druid,restoration,6,2,4
6683,Kaisuckslol,stormrage,192,druid,restoration,6,2,4
6684,Akinetic,illidan,192,druid,restoration,6,2,4
6685,Boundless,skullcrusher,192,druid,restoration,6,2,4
6686,Bullbuddy,wyrmrest-accord,192,druid,restoration,6,2,4
6687,Leafthief,whisperwind,192,druid,restoration,6,2,4
6688,Koalla,frostmourne,192,druid,restoration,6,2,4
6689,Kassius,alleria,192,druid,restoration,6,2,4
6690,Clonkzy,area-52,192,druid,restoration,6,2,4
6691,Loveflowers,nemesis,192,druid,restoration,6,2,4
6692,Batshi,gorefiend,192,druid,restoration,6,2,4
6693,Zaddychulo,area-52,192,druid,restoration,6,2,4
6694,Gretatunberg,skywall,192,druid,restoration,6,2,4
6695,Barkcheeks,area-52,192,druid,restoration,6,2,4
6696,Sôlemn,barthilas,192,druid,restoration,6,2,4
6697,Owlgz,barthilas,192,druid,restoration,6,2,4
6698,Laesh,nemesis,192,druid,restoration,6,2,4
6699,Simperella,dalaran,192,druid,restoration,13,3,10
6700,Hotsx,frostmourne,192,druid,restoration,9,2,7
6701,Sleepyheals,tichondrius,192,druid,restoration,14,3,11
6702,Nakedllove,sargeras,192,druid,restoration,11,2,9
6703,Gradiluth,proudmoore,192,druid,restoration,12,2,10
6704,Fribbleog,korgath,192,druid,restoration,12,2,10
6705,Lunmoon,thrall,192,druid,restoration,12,2,10
6706,Fjv,laughing-skull,192,druid,restoration,12,2,10
6707,Urhero,sargeras,192,druid,restoration,12,2,10
6708,Chaarm,proudmoore,192,druid,restoration,12,2,10
6709,Trèè,frostmane,192,druid,restoration,12,2,10
6710,Pinchncheeks,bleeding-hollow,192,druid,restoration,12,2,10
6711,Daesdaddy,sargeras,192,druid,restoration,12,2,10
6712,Bboikha,quelthalas,192,druid,restoration,12,2,10
6713,Grullandur,hakkar,192,druid,restoration,12,2,10
6714,Moocka,ragnaros,192,druid,restoration,12,2,10
6715,Crunchieroll,illidan,192,druid,restoration,12,2,10
6716,Actioncat,emerald-dream,192,druid,restoration,12,2,10
6717,Kittysnuggle,emerald-dream,192,druid,restoration,12,2,10
6718,Glockenstien,proudmoore,192,druid,restoration,12,2,10
6719,Wonderhood,quelthalas,192,druid,restoration,12,2,10
6720,Goorybud,tichondrius,192,druid,restoration,12,2,10
6721,Jayto,frostmourne,192,druid,restoration,12,2,10
6722,Moonkay,tichondrius,192,druid,restoration,12,2,10
6723,Batlex,thrall,192,druid,restoration,12,2,10
6724,Iyrnae,zuljin,192,druid,restoration,12,2,10
6725,Sírius,stormrage,192,druid,restoration,12,2,10
6726,Kymolyia,sargeras,192,druid,restoration,12,2,10
6727,Aelena,whisperwind,192,druid,restoration,12,2,10
6728,Gahr,wyrmrest-accord,192,druid,restoration,12,2,10
6729,Jaaodalari,azralon,192,druid,restoration,12,2,10
6730,Dodozhou,illidan,192,druid,restoration,12,2,10
6731,Cpksdru,tichondrius,192,druid,restoration,12,2,10
6732,Bennedïct,tichondrius,192,druid,restoration,12,2,10
6733,Rootslayer,tichondrius,192,druid,restoration,12,2,10
6734,Devilzown,fenris,192,druid,restoration,18,2,16
6735,Brutalhealz,aegwynn,192,druid,restoration,18,2,16
6736,Irontree,dunemaul,192,druid,restoration,18,2,16
6737,Çarpentree,sargeras,192,druid,restoration,18,2,16
6738,Clonemunster,frostmourne,192,druid,restoration,18,2,16
6739,Samesaras,darkspear,191,druid,restoration,6,2,4
6740,Moonkinx,frostwolf,191,druid,restoration,6,2,4
6741,Inbreds,jubeithos,191,druid,restoration,6,2,4
6742,Flusky,moon-guard,191,druid,restoration,6,2,4
6743,Naxanax,stormrage,191,druid,restoration,6,2,4
6744,Äbÿss,tichondrius,191,druid,restoration,12,2,10
6745,Daweed,zuluhed,191,druid,restoration,12,2,10
6746,Calliecat,moon-guard,191,druid,restoration,12,2,10
6747,Denyou,aggramar,191,druid,restoration,12,2,10
6748,Ellarrya,moon-guard,191,druid,restoration,12,2,10
6749,Grimshifta,kelthuzad,191,druid,restoration,12,2,10
6750,Voodooshiftz,emerald-dream,191,druid,restoration,12,2,10
6751,Wantto,moknathal,190,druid,restoration,12,2,10
6752,Garritass,moon-guard,189,druid,restoration,29,2,27
6753,Dreamwalk,stormrage,175,druid,restoration,17,3,14
6754,Vzi,magtheridon,159,druid,restoration,5,2,3
6755,Pvptactician,tichondrius,159,druid,restoration,11,4,7
6756,Jeppcat,tichondrius,159,druid,restoration,14,3,11
6757,Frenzymoon,zuljin,144,druid,restoration,3,3,0
6758,Mimics,zuljin,144,druid,restoration,9,2,7
6759,Vìdá,tichondrius,138,druid,restoration,8,3,5
6760,Teddybëar,illidan,138,druid,restoration,9,3,6
6761,Pokieoaks,zuljin,138,druid,restoration,10,3,7
6762,Mojoforweeks,bleeding-hollow,138,druid,restoration,12,3,9
6763,Galind,rexxar,128,druid,restoration,4,2,2
6764,Alshari,proudmoore,128,druid,restoration,10,2,8
6765,Hille,sargeras,127,druid,restoration,14,2,12
6766,Crunkk,thunderlord,127,druid,restoration,14,2,12
6767,Forestmaster,area-52,96,druid,restoration,8,2,6
6768,Kzdubya,stormrage,96,druid,restoration,6,1,5
6769,Leoho,tichondrius,96,druid,restoration,6,1,5
6770,Zabartak,lightnings-blade,96,druid,restoration,6,1,5
6771,Ðjx,stormrage,96,druid,restoration,6,1,5
6772,Arthridas,wyrmrest-accord,96,druid,restoration,6,1,5
6773,Nutless,illidan,96,druid,restoration,6,1,5
6774,Natürëblÿät,illidan,96,druid,restoration,6,1,5
6775,Beldiin,khazgoroth,96,druid,restoration,6,1,5
6776,Robomexi,tichondrius,96,druid,restoration,6,1,5
6777,Raìñ,tichondrius,96,druid,restoration,6,1,5
6778,Djsummer,tichondrius,96,druid,restoration,6,1,5
6779,Diligent,dathremar,96,druid,restoration,6,1,5
6780,Kazamura,tichondrius,96,druid,restoration,6,1,5
6781,Smitebacklol,tichondrius,96,druid,restoration,6,1,5
6782,Feorb,azuremyst,96,druid,restoration,6,1,5
6783,Thiccybear,darkspear,96,druid,restoration,6,1,5
6784,Lokobah,wyrmrest-accord,96,druid,restoration,6,1,5
6785,Botdruid,hyjal,96,druid,restoration,6,1,5
6786,Krucífy,dark-iron,96,druid,restoration,6,1,5
6787,Berserkr,lethon,96,druid,restoration,6,1,5
6788,Kurzul,area-52,96,druid,restoration,6,1,5
6789,Zeelán,emerald-dream,96,druid,restoration,6,1,5
6790,Scorpitary,ysera,96,druid,restoration,6,1,5
6791,Bùgga,malfurion,96,druid,restoration,6,1,5
6792,Arienne,kelthuzad,96,druid,restoration,6,1,5
6793,Baconsniper,illidan,96,druid,restoration,6,1,5
6794,Boomtre,malganis,96,druid,restoration,6,1,5
6795,Moonshocka,tichondrius,96,druid,restoration,6,1,5
6796,Orakuru,barthilas,96,druid,restoration,6,1,5
6797,Gruulnir,antonidas,96,druid,restoration,6,1,5
6798,Kekepöp,illidan,96,druid,restoration,6,1,5
6799,Chomperz,tichondrius,96,druid,restoration,6,1,5
6800,Spatulas,malganis,96,druid,restoration,6,1,5
6801,Shiftycent,tichondrius,96,druid,restoration,6,1,5
6802,Atagoo,tichondrius,96,druid,restoration,6,1,5
6803,Sinistuhd,tichondrius,96,druid,restoration,6,1,5
6804,Rakroz,emerald-dream,96,druid,restoration,6,1,5
6805,Sily,frostmourne,96,druid,restoration,6,1,5
6806,Macfluff,emerald-dream,96,druid,restoration,6,1,5
6807,Róce,stormrage,96,druid,restoration,6,1,5
6808,Barrahjr,frostmourne,96,druid,restoration,6,1,5
6809,Alagorn,zangarmarsh,96,druid,restoration,6,1,5
6810,Kendra,barthilas,96,druid,restoration,6,1,5
6811,Ryhighd,sargeras,96,druid,restoration,6,1,5
6812,Kirato,ragnaros,96,druid,restoration,6,1,5
6813,Dsoul,tichondrius,96,druid,restoration,6,1,5
6814,Tyrander,tichondrius,96,druid,restoration,6,1,5
6815,Rastakant,malganis,96,druid,restoration,6,1,5
6816,Feralgo,tichondrius,96,druid,restoration,6,1,5
6817,Cowboyydan,malganis,96,druid,restoration,6,1,5
6818,Logyoh,tichondrius,96,druid,restoration,6,1,5
6819,Moocowbear,illidan,96,druid,restoration,6,1,5
6820,Nìck,the-scryers,96,druid,restoration,6,1,5
6821,Rezl,sargeras,96,druid,restoration,6,1,5
6822,Aimafengari,emerald-dream,96,druid,restoration,6,1,5
6823,Animalstylee,tichondrius,96,druid,restoration,6,1,5
6824,Samully,area-52,96,druid,restoration,6,1,5
6825,Gúdru,zuljin,96,druid,restoration,6,1,5
6826,Caminanube,quelthalas,96,druid,restoration,6,1,5
6827,Skéla,emerald-dream,96,druid,restoration,6,1,5
6828,Moonfart,zuljin,96,druid,restoration,6,1,5
6829,Whitehaze,proudmoore,96,druid,restoration,6,1,5
6830,Dedderita,bloodhoof,96,druid,restoration,6,1,5
6831,Mamazbear,area-52,96,druid,restoration,6,1,5
6832,Ttaure,ragnaros,96,druid,restoration,6,1,5
6833,Aelvalus,goldrinn,96,druid,restoration,6,1,5
6834,Peterdeleter,emerald-dream,96,druid,restoration,6,1,5
6835,Hurbd,frostmourne,96,druid,restoration,6,1,5
6836,Vikkileaks,aegwynn,96,druid,restoration,6,1,5
6837,Moonkingx,ragnaros,96,druid,restoration,6,1,5
6838,Wotermelon,moon-guard,96,druid,restoration,6,1,5
6839,Ayla,gorefiend,96,druid,restoration,6,1,5
6840,Fadingfast,frostmourne,96,druid,restoration,6,1,5
6841,Framess,area-52,96,druid,restoration,6,1,5
6842,Wrathmighty,frostmourne,96,druid,restoration,6,1,5
6843,Irl,frostmane,96,druid,restoration,6,1,5
6844,Sheeftah,illidan,96,druid,restoration,6,1,5
6845,Uzheals,zuljin,96,druid,restoration,6,1,5
6846,Suncintus,aggramar,96,druid,restoration,6,1,5
6847,Hammyaki,area-52,96,druid,restoration,6,1,5
6848,Juves,frostmourne,96,druid,restoration,6,1,5
6849,Nyanncat,frostmourne,96,druid,restoration,7,1,6
6850,Lirilith,shadowsong,96,druid,restoration,16,2,14
6851,Ikita,illidan,96,druid,restoration,8,1,7
6852,Taztoc,stormrage,96,druid,restoration,11,1,10
6853,Shebleeder,aegwynn,96,druid,restoration,11,1,10
6854,Foracus,sargeras,96,druid,restoration,11,1,10
6855,Kopidruid,barthilas,96,druid,restoration,12,1,11
6856,Florella,misha,96,druid,restoration,12,1,11
6857,Framling,sargeras,96,druid,restoration,12,1,11
6858,Morpheûs,bleeding-hollow,96,druid,restoration,12,1,11
6859,Flörence,drakkari,96,druid,restoration,12,1,11
6860,Bigjunk,boulderfist,96,druid,restoration,12,1,11
6861,Idontmoo,area-52,96,druid,restoration,12,1,11
6862,Adaeloth,hyjal,96,druid,restoration,12,1,11
6863,Daxximus,area-52,96,druid,restoration,12,1,11
6864,Whiteglade,moon-guard,96,druid,restoration,12,1,11
6865,Adanos,moon-guard,96,druid,restoration,12,1,11
6866,Tuurban,stormrage,96,druid,restoration,12,1,11
6867,Kaeliah,stormrage,96,druid,restoration,12,1,11
6868,Rebornwhisp,moon-guard,96,druid,restoration,12,1,11
6869,Durkanis,maelstrom,96,druid,restoration,12,1,11
6870,Morezby,frostmourne,96,druid,restoration,12,1,11
6871,Moonessence,fenris,96,druid,restoration,12,1,11
6872,Sinigang,duskwood,96,druid,restoration,12,1,11
6873,Carboz,jubeithos,96,druid,restoration,12,1,11
6874,Mofoogoo,laughing-skull,96,druid,restoration,13,1,12
6875,Thorsèn,sargeras,96,druid,restoration,15,1,14
6876,Grakzul,blood-furnace,95,druid,restoration,9,2,7
6877,Herbalife,stormrage,95,druid,restoration,6,1,5
6878,Huriel,blackrock,95,druid,restoration,6,1,5
6879,Bbabbi,tichondrius,89,druid,restoration,5,3,2
6880,Eliteshift,frostmourne,64,druid,restoration,4,1,3
6881,Pownage,kelthuzad,64,druid,restoration,16,1,15
6882,Bòmi,tichondrius,63,druid,restoration,2,2,0
6883,Valrathsx,arthas,31,druid,restoration,2,1,1
6884,Suwonhealer,tichondrius,31,druid,restoration,8,1,7
6885,Neferpitou,fenris,16,druid,restoration,6,1,5
6886,Landro,tichondrius,1373,druid,guardian,107,51,56
6887,Kobebeef,malganis,1203,druid,guardian,30,13,17
6888,Ashamang,emerald-dream,1135,druid,guardian,30,16,14
6889,Ntseebxoxoxg,gurubashi,1127,druid,guardian,60,26,34
6890,Haalls,gallywix,1110,druid,guardian,54,16,38
6891,Ürsus,quelthalas,1106,druid,guardian,72,32,40
6892,Yurius,kiljaeden,1102,druid,guardian,24,15,9
6893,Theme,frostwolf,1089,druid,guardian,48,18,30
6894,Crashägásm,proudmoore,1062,druid,guardian,30,15,15
6895,Muphasax,ragnaros,992,druid,guardian,44,14,30
6896,Kesagake,feathermoon,921,druid,guardian,18,10,8
6897,Manasmi,frostmourne,916,druid,guardian,47,20,27
6898,Firash,frostmourne,888,druid,guardian,21,11,10
6899,Maraliss,shadowsong,863,druid,guardian,30,14,16
6900,Gums,lightbringer,845,druid,guardian,89,28,61
6901,Mordu,rivendare,838,druid,guardian,25,9,16
6902,Inxert,tichondrius,792,druid,guardian,16,9,7
6903,Gifteddream,zuljin,759,druid,guardian,24,9,15
6904,Nerfmesoon,sargeras,734,druid,guardian,16,8,8
6905,Dalidielor,dalaran,671,druid,guardian,18,7,11
6906,Koan,proudmoore,671,druid,guardian,24,7,17
6907,Jacinty,saurfang,670,druid,guardian,18,7,11
6908,Multivar,burning-legion,669,druid,guardian,12,7,5
6909,Agmukar,wyrmrest-accord,659,druid,guardian,12,7,5
6910,Lycanthus,thrall,575,druid,guardian,12,6,6
6911,Rektx,area-52,574,druid,guardian,12,6,6
6912,Ishiftalot,bleeding-hollow,573,druid,guardian,15,7,8
6913,Bjørnen,thrall,570,druid,guardian,12,6,6
6914,Giddeonv,draenor,570,druid,guardian,12,6,6
6915,Aìón,emerald-dream,566,druid,guardian,12,6,6
6916,Caliwagon,dalaran,490,druid,guardian,13,6,7
6917,Agaxaido,azgalor,480,druid,guardian,12,5,7
6918,Ferio,moon-guard,480,druid,guardian,24,5,19
6919,Chärmin,area-52,479,druid,guardian,12,5,7
6920,Balanah,quelthalas,472,druid,guardian,15,6,9
6921,Maen,kelthuzad,384,druid,guardian,6,4,2
6922,Bigxworm,gurubashi,384,druid,guardian,12,4,8
6923,Druidd,moonrunner,384,druid,guardian,12,4,8
6924,Krylax,sargeras,384,druid,guardian,12,4,8
6925,Bleedhoof,frostmourne,384,druid,guardian,12,4,8
6926,Moistism,khazgoroth,384,druid,guardian,18,4,14
6927,Wraithman,madoran,383,druid,guardian,6,4,2
6928,Vennfox,illidan,383,druid,guardian,12,4,8
6929,Tankbareass,aerie-peak,382,druid,guardian,18,4,14
6930,Cléa,illidan,381,druid,guardian,12,4,8
6931,Deutschland,whisperwind,288,druid,guardian,12,3,9
6932,Read,boulderfist,288,druid,guardian,12,3,9
6933,Jüggernäut,area-52,288,druid,guardian,12,3,9
6934,Woozydruid,anetheron,288,druid,guardian,12,3,9
6935,Manwool,illidan,288,druid,guardian,12,3,9
6936,Cayinna,altar-of-storms,288,druid,guardian,12,3,9
6937,Mavren,uldaman,286,druid,guardian,6,3,3
6938,Classykitty,tichondrius,192,druid,guardian,4,3,1
6939,Lilgushy,area-52,192,druid,guardian,6,2,4
6940,Skrimshaw,burning-legion,192,druid,guardian,6,2,4
6941,Spacex,amanthul,192,druid,guardian,6,2,4
6942,Athious,moon-guard,192,druid,guardian,6,2,4
6943,Mommyh,duskwood,192,druid,guardian,6,2,4
6944,Avbox,proudmoore,192,druid,guardian,6,2,4
6945,Battlecát,stormscale,192,druid,guardian,6,2,4
6946,Fluff,gurubashi,192,druid,guardian,6,2,4
6947,Widedually,aegwynn,191,druid,guardian,6,2,4
6948,Eithelsa,frostmourne,191,druid,guardian,6,2,4
6949,Meliódás,area-52,191,druid,guardian,18,2,16
6950,Gornish,azralon,190,druid,guardian,12,2,10
6951,Kushtiger,ragnaros,96,druid,guardian,6,1,5
6952,Drur,zuljin,96,druid,guardian,6,1,5
6953,Weezydende,area-52,96,druid,guardian,6,1,5
6954,Malvolo,eredar,96,druid,guardian,6,1,5
6955,Funkbear,black-dragonflight,96,druid,guardian,6,1,5
6956,Vindecca,kelthuzad,96,druid,guardian,6,1,5
6957,Moonshocka,tichondrius,96,druid,guardian,6,1,5
6958,Gojen,stonemaul,96,druid,guardian,6,1,5
6959,Aurno,queldorei,96,druid,guardian,6,1,5
6960,Juicecarton,thrall,96,druid,guardian,6,1,5
6961,Flenser,frostmane,96,druid,guardian,6,1,5
6962,Sixfeetunder,shattered-halls,96,druid,guardian,6,1,5
6963,Cawkaw,frostwolf,96,druid,guardian,6,1,5
6964,Finntann,moon-guard,96,druid,guardian,6,1,5
6965,Wintarz,sargeras,96,druid,guardian,6,1,5
6966,Divax,proudmoore,96,druid,guardian,12,1,11
6967,Woowis,stormrage,96,druid,guardian,12,1,11
6968,Fulmerethine,emerald-dream,96,druid,guardian,12,1,11
6969,Kylysea,dalaran,96,druid,guardian,12,1,11
6970,Chathos,emerald-dream,96,druid,guardian,12,1,11
6971,Vineclaw,emerald-dream,96,druid,guardian,12,1,11
6972,Lakroz,zuljin,95,druid,guardian,6,1,5
6973,Sitruk,uldum,63,druid,guardian,10,1,9
6974,Ogdaugh,nagrand,48,druid,guardian,3,1,2
6975,Bawbe,lightbringer,2286,druid,feral,107,61,46
6976,Floppa,whisperwind,2243,druid,feral,102,56,46
6977,Evildooer,stormrage,2203,druid,feral,84,46,38
6978,Marvin,stormreaver,2201,druid,feral,94,49,45
6979,Loser,stormrage,2155,druid,feral,87,46,41
6980,Nyç,sargeras,2139,druid,feral,216,116,100
6981,Auntsusie,stormrage,2128,druid,feral,95,61,34
6982,Crunchyroll,sargeras,2126,druid,feral,168,91,77
6983,Iinkinbio,alleria,2124,druid,feral,84,50,34
6984,Bassy,whisperwind,2098,druid,feral,94,46,48
6985,Angryalyu,tichondrius,2080,druid,feral,150,72,78
6986,Formrage,jubeithos,2063,druid,feral,212,110,102
6987,Boomboombom,tichondrius,2054,druid,feral,119,72,47
6988,Jaguar,whisperwind,2050,druid,feral,69,40,29
6989,Yüxy,sargeras,2048,druid,feral,174,85,89
6990,Kynvi,moon-guard,2029,druid,feral,60,34,26
6991,Henikbite,zuljin,2018,druid,feral,125,65,60
6992,Amellies,quelthalas,2012,druid,feral,196,105,91
6993,Duzis,tichondrius,2006,druid,feral,170,89,81
6994,Boomboomboom,misha,1994,druid,feral,266,134,132
6995,Floorz,bleeding-hollow,1978,druid,feral,93,45,48
6996,Hypérion,dalaran,1977,druid,feral,83,41,42
6997,Abstractf,sargeras,1973,druid,feral,86,50,36
6998,Beomjun,tichondrius,1970,druid,feral,128,69,59
6999,Babekisser,stormrage,1961,druid,feral,130,69,61
7000,Vinjo,ragnaros,1955,druid,feral,90,42,48
7001,Pdfilewatch,stormrage,1943,druid,feral,42,30,12
7002,Trìckyz,tichondrius,1942,druid,feral,200,102,98
7003,Feeg,sargeras,1937,druid,feral,65,33,32
7004,Notapn,tichondrius,1926,druid,feral,96,54,42
7005,Cliodhna,kelthuzad,1914,druid,feral,78,40,38
7006,Chowxx,tichondrius,1910,druid,feral,96,45,51
7007,Alleae,stormrage,1908,druid,feral,54,32,22
7008,Cracked,vashj,1906,druid,feral,94,59,35
7009,Skrambles,mugthol,1906,druid,feral,75,36,39
7010,Samuel,ravencrest,1897,druid,feral,60,33,27
7011,Nèffex,sargeras,1897,druid,feral,90,49,41
7012,Floorz,firetree,1895,druid,feral,42,23,19
7013,Ripbot,sargeras,1894,druid,feral,59,31,28
7014,Duhfective,proudmoore,1887,druid,feral,65,33,32
7015,Kittendev,tichondrius,1881,druid,feral,66,30,36
7016,Porkonmyfork,frostmourne,1870,druid,feral,40,24,16
7017,Astrozxy,sargeras,1860,druid,feral,42,23,19
7018,Rwhatkr,tichondrius,1847,druid,feral,47,20,27
7019,Sammy,scilla,1842,druid,feral,84,40,44
7020,Lesliewj,proudmoore,1840,druid,feral,65,35,30
7021,Tyxi,bleeding-hollow,1839,druid,feral,46,31,15
7022,Hriiya,tichondrius,1838,druid,feral,101,46,55
7023,Zuljor,sargeras,1836,druid,feral,54,34,20
7024,Suedle,kelthuzad,1836,druid,feral,47,24,23
7025,Vebee,frostmourne,1833,druid,feral,89,49,40
7026,Darmari,quelthalas,1833,druid,feral,71,30,41
7027,Yayue,tichondrius,1830,druid,feral,72,37,35
7028,Kolbie,emerald-dream,1828,druid,feral,196,108,88
7029,Bpdferal,stormrage,1828,druid,feral,180,99,81
7030,Unfriendly,bleeding-hollow,1826,druid,feral,227,126,101
7031,Russiaguy,area-52,1826,druid,feral,271,141,130
7032,Icespicè,tichondrius,1825,druid,feral,96,46,50
7033,Sappora,illidan,1824,druid,feral,178,92,86
7034,Feignxd,emerald-dream,1823,druid,feral,60,43,17
7035,Chrye,tichondrius,1820,druid,feral,69,35,34
7036,Calikonger,spirestone,1819,druid,feral,48,23,25
7037,Kakaroot,tichondrius,1813,druid,feral,153,78,75
7038,Lemön,frostmourne,1812,druid,feral,66,34,32
7039,Hugecat,tichondrius,1812,druid,feral,60,26,34
7040,Stellar,steamwheedle-cartel,1811,druid,feral,138,66,72
7041,Yukjr,stormrage,1810,druid,feral,149,71,78
7042,Stêff,zuljin,1803,druid,feral,138,76,62
7043,Fappywapple,kiljaeden,1803,druid,feral,144,68,76
7044,Ryecoke,stormrage,1801,druid,feral,48,25,23
7045,Tyx,bleeding-hollow,1793,druid,feral,74,33,41
7046,Mocfernando,sargeras,1788,druid,feral,54,27,27
7047,Killuf,quelthalas,1784,druid,feral,101,39,62
7048,Meldzetzan,tichondrius,1782,druid,feral,31,20,11
7049,Brewdock,boulderfist,1780,druid,feral,75,36,39
7050,Ërebüs,emerald-dream,1774,druid,feral,59,24,35
7051,Save,aerie-peak,1769,druid,feral,54,27,27
7052,Tabbsy,frostmourne,1769,druid,feral,66,26,40
7053,Fuqet,kelthuzad,1766,druid,feral,156,79,77
7054,Proudfurryxo,dragonmaw,1765,druid,feral,50,27,23
7055,Raincloud,mannoroth,1763,druid,feral,58,35,23
7056,Yoruìchí,tichondrius,1759,druid,feral,36,23,13
7057,Idiotferal,tortheldrin,1754,druid,feral,59,37,22
7058,Porkloafed,illidan,1753,druid,feral,105,56,49
7059,Djdontlose,stormrage,1752,druid,feral,78,45,33
7060,Extic,sargeras,1752,druid,feral,78,45,33
7061,Kobez,bleeding-hollow,1748,druid,feral,84,46,38
7062,Mhdd,tichondrius,1739,druid,feral,66,38,28
7063,Kakagroot,tichondrius,1739,druid,feral,36,20,16
7064,Linkinbiox,alleria,1738,druid,feral,48,25,23
7065,Tompunch,tichondrius,1726,druid,feral,91,46,45
7066,Fangry,queldorei,1725,druid,feral,106,57,49
7067,Ferar,frostmourne,1723,druid,feral,77,40,37
7068,Akamu,nemesis,1715,druid,feral,60,24,36
7069,Wildfire,nesingwary,1714,druid,feral,117,62,55
7070,Fliip,barthilas,1711,druid,feral,53,27,26
7071,Addymeow,drenden,1709,druid,feral,54,30,24
7072,Thycamore,cenarius,1708,druid,feral,60,23,37
7073,Oroskii,bleeding-hollow,1705,druid,feral,66,34,32
7074,Brawleyx,tichondrius,1703,druid,feral,54,24,30
7075,Nicó,darkspear,1701,druid,feral,129,62,67
7076,Gabdruid,kiljaeden,1698,druid,feral,54,29,25
7077,Cjæ,bleeding-hollow,1693,druid,feral,40,26,14
7078,Turow,firetree,1690,druid,feral,53,25,28
7079,Bobochan,tichondrius,1688,druid,feral,48,18,30
7080,Loserceo,stormrage,1687,druid,feral,36,20,16
7081,Flowkie,illidan,1684,druid,feral,140,70,70
7082,Erykk,dalaran,1684,druid,feral,60,27,33
7083,Nrp,stormrage,1684,druid,feral,108,44,64
7084,Zwaski,thrall,1680,druid,feral,132,67,65
7085,Nitetree,thrall,1679,druid,feral,60,31,29
7086,Akanx,tichondrius,1677,druid,feral,36,21,15
7087,Ivangamaz,area-52,1675,druid,feral,41,22,19
7088,Blrr,sargeras,1674,druid,feral,120,56,64
7089,Lycanthrøpe,moon-guard,1672,druid,feral,80,35,45
7090,Bearlylegalz,kelthuzad,1671,druid,feral,48,23,25
7091,Dewfuss,tichondrius,1669,druid,feral,54,31,23
7092,Wowgamer,sargeras,1668,druid,feral,30,19,11
7093,Tenavï,stormrage,1668,druid,feral,42,20,22
7094,Yavà,tichondrius,1667,druid,feral,66,38,28
7095,Redhotbean,tichondrius,1665,druid,feral,40,23,17
7096,Yavann,tichondrius,1663,druid,feral,124,68,56
7097,Anxietyburns,stormrage,1660,druid,feral,66,40,26
7098,Feraly,malganis,1659,druid,feral,48,25,23
7099,Plux,illidan,1658,druid,feral,162,88,74
7100,Durwyn,sargeras,1654,druid,feral,207,100,107
7101,Nobruh,sargeras,1653,druid,feral,120,60,60
7102,Chasertv,tichondrius,1650,druid,feral,36,19,17
7103,Zlegacy,anvilmar,1650,druid,feral,54,21,33
7104,Rokaizu,dalaran,1649,druid,feral,65,30,35
7105,Kyoski,moon-guard,1645,druid,feral,34,19,15
7106,Kibbens,area-52,1643,druid,feral,196,98,98
7107,Bhen,tichondrius,1643,druid,feral,42,19,23
7108,Bigbite,tichondrius,1642,druid,feral,66,37,29
7109,Nuadris,azralon,1638,druid,feral,173,87,86
7110,Jihadibleeds,stormrage,1637,druid,feral,43,32,11
7111,Xyphor,bladefist,1637,druid,feral,40,22,18
7112,Atrumn,emerald-dream,1631,druid,feral,78,33,45
7113,Ging,azralon,1630,druid,feral,30,17,13
7114,Foxmeowz,blackwater-raiders,1627,druid,feral,36,20,16
7115,Jazzxs,proudmoore,1627,druid,feral,36,18,18
7116,Weedsmuggler,burning-legion,1626,druid,feral,284,149,135
7117,Fendiy,barthilas,1625,druid,feral,84,49,35
7118,Prille,tichondrius,1624,druid,feral,45,23,22
7119,Off,ravencrest,1622,druid,feral,172,86,86
7120,Phøënîx,tichondrius,1622,druid,feral,36,17,19
7121,Csinii,bleeding-hollow,1621,druid,feral,54,22,32
7122,Zyhsul,emerald-dream,1620,druid,feral,42,21,21
7123,Lakunahof,ragnaros,1620,druid,feral,51,25,26
7124,Bearoids,daggerspine,1619,druid,feral,60,35,25
7125,Enya,stormreaver,1618,druid,feral,66,31,35
7126,Hiddenfur,ragnaros,1617,druid,feral,36,19,17
7127,Poosnickety,kelthuzad,1617,druid,feral,49,21,28
7128,Ocêanus,sargeras,1616,druid,feral,25,21,4
7129,Conker,frostmourne,1616,druid,feral,222,112,110
7130,Jizzie,tichondrius,1615,druid,feral,108,64,44
7131,Wøs,area-52,1615,druid,feral,98,50,48
7132,Zirrie,stormrage,1614,druid,feral,68,36,32
7133,Dustin,moon-guard,1614,druid,feral,116,61,55
7134,Zenlonn,emerald-dream,1614,druid,feral,41,19,22
7135,Clutchtime,sentinels,1610,druid,feral,46,21,25
7136,Grizzlepaw,tichondrius,1608,druid,feral,168,90,78
7137,Xanybarz,stormrage,1608,druid,feral,131,65,66
7138,Ulcera,nemesis,1607,druid,feral,60,39,21
7139,Kdrumania,tichondrius,1606,druid,feral,239,127,112
7140,Chococrispis,quelthalas,1606,druid,feral,48,21,27
7141,Fyrkax,sargeras,1603,druid,feral,30,19,11
7142,Hapgood,archimonde,1602,druid,feral,42,17,25
7143,Kittycudi,hyjal,1601,druid,feral,28,18,10
7144,Prêdator,ragnaros,1601,druid,feral,161,88,73
7145,Oldtomcat,moon-guard,1601,druid,feral,90,42,48
7146,Feralgo,tichondrius,1600,druid,feral,36,17,19
7147,Tysandra,sargeras,1600,druid,feral,42,17,25
7148,Milkmoneymeo,illidan,1599,druid,feral,36,17,19
7149,Irontree,dunemaul,1598,druid,feral,48,23,25
7150,Jpegcollectr,tichondrius,1598,druid,feral,88,32,56
7151,Dahmu,malygos,1590,druid,feral,197,103,94
7152,Ursarius,skullcrusher,1590,druid,feral,53,25,28
7153,Rank,nerzhul,1588,druid,feral,126,59,67
7154,Amishal,stormrage,1588,druid,feral,78,33,45
7155,Sïmba,andorhal,1588,druid,feral,77,31,46
7156,Slanue,tichondrius,1585,druid,feral,76,33,43
7157,Beastbaby,eldrethalas,1582,druid,feral,42,17,25
7158,Shreds,kirin-tor,1581,druid,feral,55,19,36
7159,Meanbear,stormrage,1577,druid,feral,54,27,27
7160,Jaspurr,illidan,1574,druid,feral,60,33,27
7161,Skyde,sargeras,1571,druid,feral,93,42,51
7162,Nikola,dreadmaul,1566,druid,feral,63,30,33
7163,Faelonk,frostmourne,1565,druid,feral,96,50,46
7164,Luvgames,area-52,1559,druid,feral,100,49,51
7165,Poppynoff,barthilas,1552,druid,feral,42,18,24
7166,Darkosdruid,tichondrius,1551,druid,feral,30,18,12
7167,Darkombra,frostmourne,1548,druid,feral,54,27,27
7168,Goldferal,illidan,1545,druid,feral,48,31,17
7169,Kaisuckslol,stormrage,1543,druid,feral,150,76,74
7170,Houseboat,hellscream,1543,druid,feral,54,19,35
7171,Franksuba,windrunner,1541,druid,feral,126,61,65
7172,Rahxay,quelthalas,1539,druid,feral,71,32,39
7173,Jonio,tichondrius,1539,druid,feral,71,30,41
7174,Swindlestan,zuljin,1537,druid,feral,50,25,25
7175,Swolareclips,eitrigg,1537,druid,feral,179,88,91
7176,Surmise,tichondrius,1535,druid,feral,107,66,41
7177,Mxdi,tichondrius,1535,druid,feral,36,19,17
7178,Delorík,illidan,1534,druid,feral,66,32,34
7179,Waggs,illidan,1532,druid,feral,36,16,20
7180,Cawkaw,frostwolf,1528,druid,feral,122,62,60
7181,Welshblack,tichondrius,1528,druid,feral,40,18,22
7182,Galind,rexxar,1524,druid,feral,40,26,14
7183,Barnedruid,stormreaver,1521,druid,feral,30,17,13
7184,Senex,stormrage,1518,druid,feral,100,60,40
7185,Dobromar,quelthalas,1517,druid,feral,64,34,30
7186,Malfurionsto,moon-guard,1517,druid,feral,73,31,42
7187,Theømega,stormrage,1516,druid,feral,32,18,14
7188,Sugarbawls,area-52,1514,druid,feral,108,52,56
7189,Cätwälk,gnomeregan,1511,druid,feral,36,16,20
7190,Melez,kelthuzad,1509,druid,feral,205,104,101
7191,Hellodan,proudmoore,1509,druid,feral,72,32,40
7192,Kushtiger,ragnaros,1508,druid,feral,102,52,50
7193,Sheeyts,tichondrius,1507,druid,feral,96,51,45
7194,Gregondor,skullcrusher,1506,druid,feral,48,24,24
7195,Koducck,tichondrius,1502,druid,feral,60,32,28
7196,Wuby,tichondrius,1500,druid,feral,66,34,32
7197,Tree,lothar,1497,druid,feral,48,29,19
7198,Zazieraiel,moon-guard,1492,druid,feral,117,58,59
7199,Sloom,zuljin,1488,druid,feral,59,29,30
7200,Lunacore,illidan,1488,druid,feral,65,30,35
7201,Ozex,crushridge,1487,druid,feral,76,33,43
7202,Dimsump,zuljin,1483,druid,feral,48,16,32
7203,Luluid,tichondrius,1481,druid,feral,65,30,35
7204,Azrethyu,emerald-dream,1481,druid,feral,98,41,57
7205,Nomnomnomn,chogall,1480,druid,feral,28,18,10
7206,Csagan,spirestone,1478,druid,feral,60,31,29
7207,Revcow,malganis,1477,druid,feral,48,24,24
7208,Lucky,destromath,1474,druid,feral,198,90,108
7209,Duckystryker,tichondrius,1470,druid,feral,54,21,33
7210,Amanardra,wyrmrest-accord,1468,druid,feral,36,21,15
7211,Shiftalk,nerzhul,1468,druid,feral,61,29,32
7212,Dillywadz,tichondrius,1463,druid,feral,158,72,86
7213,Zivak,azshara,1460,druid,feral,66,32,34
7214,Hoffhoff,area-52,1458,druid,feral,36,22,14
7215,Jurasico,ragnaros,1458,druid,feral,294,147,147
7216,Pretzle,kelthuzad,1458,druid,feral,47,16,31
7217,Yobibit,terenas,1456,druid,feral,42,17,25
7218,Badferal,blackhand,1455,druid,feral,78,38,40
7219,Erwelz,quelthalas,1455,druid,feral,41,19,22
7220,Kwilli,tichondrius,1454,druid,feral,91,43,48
7221,Bullcritzz,saurfang,1453,druid,feral,118,66,52
7222,Hööper,illidan,1450,druid,feral,84,35,49
7223,Prowli,tichondrius,1449,druid,feral,158,82,76
7224,Bossdru,sargeras,1447,druid,feral,47,28,19
7225,Roots,anubarak,1445,druid,feral,98,53,45
7226,Kongquest,emerald-dream,1445,druid,feral,71,28,43
7227,Chomperz,tichondrius,1442,druid,feral,85,45,40
7228,Chambz,tichondrius,1441,druid,feral,127,68,59
7229,Fastcat,moon-guard,1441,druid,feral,60,31,29
7230,Freinnar,kiljaeden,1441,druid,feral,66,30,36
7231,Jayp,thrall,1436,druid,feral,67,28,39
7232,Soaring,moon-guard,1434,druid,feral,30,15,15
7233,Mysubrogue,veknilash,1432,druid,feral,24,15,9
7234,Käïïjü,tichondrius,1432,druid,feral,76,28,48
7235,Aldr,tichondrius,1431,druid,feral,60,27,33
7236,Feond,illidan,1430,druid,feral,94,49,45
7237,Féralis,sargeras,1429,druid,feral,24,15,9
7238,Bukybuky,tichondrius,1429,druid,feral,48,26,22
7239,Azuredreams,bleeding-hollow,1429,druid,feral,56,28,28
7240,Moonraker,caelestrasz,1427,druid,feral,83,44,39
7241,Chitára,ragnaros,1427,druid,feral,166,86,80
7242,Gnairda,sargeras,1426,druid,feral,198,104,94
7243,Makonis,tichondrius,1424,druid,feral,36,20,16
7244,Kaissara,nemesis,1420,druid,feral,32,17,15
7245,Bobmarli,kiljaeden,1420,druid,feral,30,15,15
7246,Oobuck,kilrogg,1415,druid,feral,54,29,25
7247,Treespec,stormrage,1414,druid,feral,29,18,11
7248,Ikkarus,nemesis,1414,druid,feral,121,60,61
7249,Traxxo,tichondrius,1414,druid,feral,48,20,28
7250,Gairen,the-venture-co,1413,druid,feral,48,25,23
7251,Neetform,zuljin,1413,druid,feral,65,30,35
7252,Silvshifter,frostmourne,1410,druid,feral,47,32,15
7253,Muwudred,stormrage,1410,druid,feral,36,15,21
7254,Clarice,shattered-halls,1409,druid,feral,24,15,9
7255,Eletto,stormrage,1409,druid,feral,54,26,28
7256,Oreganic,barthilas,1408,druid,feral,99,49,50
7257,Vakimumu,anubarak,1407,druid,feral,68,33,35
7258,Fugekî,zuljin,1405,druid,feral,71,39,32
7259,Classydruid,spinebreaker,1404,druid,feral,102,47,55
7260,Shïfty,tichondrius,1403,druid,feral,30,16,14
7261,Shiftex,arthas,1403,druid,feral,138,68,70
7262,Bênî,emerald-dream,1402,druid,feral,128,61,67
7263,Frostelles,stormrage,1401,druid,feral,182,91,91
7264,Flowke,illidan,1401,druid,feral,32,16,16
7265,Boofings,sargeras,1400,druid,feral,34,19,15
7266,Ðárk,ragnaros,1399,druid,feral,29,15,14
7267,Aquahektik,malganis,1398,druid,feral,48,15,33
7268,Gonjatusk,ravencrest,1397,druid,feral,54,30,24
7269,Sweetxtooth,area-52,1397,druid,feral,92,48,44
7270,Vaniedron,zuljin,1397,druid,feral,123,50,73
7271,Clawin,frostmourne,1395,druid,feral,24,15,9
7272,Duuj,illidan,1394,druid,feral,18,15,3
7273,Hoppus,icecrown,1393,druid,feral,87,35,52
7274,Wabbehkus,barthilas,1392,druid,feral,54,17,37
7275,Chin,ysera,1391,druid,feral,23,15,8
7276,Ytgamezoned,darkspear,1390,druid,feral,30,16,14
7277,Oneinchclaw,malganis,1389,druid,feral,84,41,43
7278,Lunarboy,tichondrius,1388,druid,feral,43,17,26
7279,Treeweed,tichondrius,1386,druid,feral,81,42,39
7280,Psychofeör,quelthalas,1386,druid,feral,100,49,51
7281,Hjerim,quelthalas,1386,druid,feral,50,24,26
7282,Snowfaerie,moon-guard,1380,druid,feral,374,195,179
7283,Darkasto,nemesis,1380,druid,feral,44,18,26
7284,Hroney,area-52,1379,druid,feral,54,22,32
7285,Raynark,azralon,1377,druid,feral,36,16,20
7286,Craak,tichondrius,1376,druid,feral,41,19,22
7287,Tommyjimmy,andorhal,1375,druid,feral,48,24,24
7288,Herbx,sargeras,1366,druid,feral,60,30,30
7289,Canlexd,moon-guard,1364,druid,feral,103,48,55
7290,Boll,akama,1361,druid,feral,34,15,19
7291,Niwßor,azralon,1359,druid,feral,54,26,28
7292,Kilohanno,alexstrasza,1356,druid,feral,42,19,23
7293,Iamnature,dalaran,1355,druid,feral,67,30,37
7294,Percefhone,azralon,1353,druid,feral,116,55,61
7295,Fugg,frostmourne,1350,druid,feral,84,34,50
7296,Darkdragoonz,barthilas,1344,druid,feral,43,20,23
7297,Cntomy,tichondrius,1343,druid,feral,24,14,10
7298,Azoth,hyjal,1342,druid,feral,24,14,10
7299,Catzetzan,tichondrius,1342,druid,feral,30,14,16
7300,Druidydruid,blackrock,1342,druid,feral,52,24,28
7301,Threeo,burning-blade,1341,druid,feral,28,18,10
7302,Malu,muradin,1341,druid,feral,58,33,25
7303,Hadox,azralon,1339,druid,feral,148,73,75
7304,Smeow,zuljin,1339,druid,feral,39,16,23
7305,Samirgodx,tichondrius,1337,druid,feral,36,16,20
7306,Riemannzeta,azgalor,1336,druid,feral,54,29,25
7307,Swornenemy,mugthol,1336,druid,feral,87,45,42
7308,Ribushe,stormrage,1336,druid,feral,60,27,33
7309,Datkittydoe,kiljaeden,1334,druid,feral,55,26,29
7310,Khyzan,illidan,1329,druid,feral,78,41,37
7311,Naturestouch,tichondrius,1327,druid,feral,30,14,16
7312,Freddiemerk,moon-guard,1326,druid,feral,36,21,15
7313,Blut,stormrage,1326,druid,feral,300,142,158
7314,Sharknado,haomarush,1326,druid,feral,30,14,16
7315,Kotau,azralon,1325,druid,feral,78,51,27
7316,Zuga,the-venture-co,1324,druid,feral,54,28,26
7317,Senorcholo,malganis,1323,druid,feral,42,20,22
7318,Pibily,sargeras,1323,druid,feral,48,15,33
7319,Bullboy,frostmourne,1320,druid,feral,30,17,13
7320,Bleedz,mugthol,1319,druid,feral,36,18,18
7321,Tardcakes,tichondrius,1318,druid,feral,92,44,48
7322,Kyrô,sargeras,1317,druid,feral,29,14,15
7323,Bigthirty,area-52,1315,druid,feral,36,20,16
7324,Toysruskyd,sargeras,1315,druid,feral,36,14,22
7325,Isalien,stormrage,1313,druid,feral,62,33,29
7326,Ninefeet,argent-dawn,1311,druid,feral,72,37,35
7327,Soupyhooves,dalaran,1311,druid,feral,30,14,16
7328,Fb,darkspear,1309,druid,feral,50,28,22
7329,Jasminonmars,zuluhed,1305,druid,feral,65,36,29
7330,Asteriel,stormrage,1305,druid,feral,52,25,27
7331,Malthen,quelthalas,1304,druid,feral,78,38,40
7332,Buhooki,tichondrius,1303,druid,feral,182,98,84
7333,Hoofin,blackwing-lair,1303,druid,feral,96,39,57
7334,Nyanncat,frostmourne,1302,druid,feral,30,14,16
7335,Nojiling,quelthalas,1301,druid,feral,55,24,31
7336,Bloodriot,wyrmrest-accord,1299,druid,feral,79,36,43
7337,Amdruid,bloodhoof,1297,druid,feral,26,15,11
7338,Raebies,dalaran,1297,druid,feral,99,53,46
7339,Sahksi,lothar,1297,druid,feral,60,30,30
7340,Mbarakaja,malganis,1297,druid,feral,149,70,79
7341,Anessan,silvermoon,1296,druid,feral,44,23,21
7342,Ðreadfang,tichondrius,1295,druid,feral,47,28,19
7343,Gapingloli,tichondrius,1295,druid,feral,51,25,26
7344,Riseagainst,ragnaros,1294,druid,feral,52,30,22
7345,Queiq,malganis,1292,druid,feral,30,15,15
7346,Panyot,kiljaeden,1291,druid,feral,66,33,33
7347,Awarz,drakkari,1291,druid,feral,36,14,22
7348,Servax,illidan,1290,druid,feral,30,14,16
7349,Zelyvia,moon-guard,1283,druid,feral,48,23,25
7350,Vintera,sargeras,1281,druid,feral,123,67,56
7351,Erahar,illidan,1281,druid,feral,46,24,22
7352,Dkkng,dalaran,1280,druid,feral,40,23,17
7353,Barbary,tichondrius,1279,druid,feral,36,16,20
7354,Cheshiire,moon-guard,1277,druid,feral,167,78,89
7355,Flufball,whisperwind,1274,druid,feral,42,17,25
7356,Súse,sargeras,1269,druid,feral,71,35,36
7357,Gotroadrash,azuremyst,1268,druid,feral,23,14,9
7358,Mariko,area-52,1268,druid,feral,71,33,38
7359,Mooseknuccle,tichondrius,1262,druid,feral,43,21,22
7360,Glockitty,tichondrius,1262,druid,feral,90,42,48
7361,Dätto,thrall,1261,druid,feral,54,25,29
7362,Feanah,tichondrius,1259,druid,feral,66,29,37
7363,Rekrasaur,emerald-dream,1259,druid,feral,40,14,26
7364,Freeonlyfns,stormrage,1255,druid,feral,38,16,22
7365,Tenedoors,ragnaros,1249,druid,feral,115,45,70
7366,Sporadiclive,sargeras,1247,druid,feral,30,13,17
7367,Aahx,thrall,1245,druid,feral,129,69,60
7368,Gorim,area-52,1245,druid,feral,72,34,38
7369,Enchiladacat,stormrage,1243,druid,feral,24,13,11
7370,Shmayba,malganis,1241,druid,feral,24,13,11
7371,Kellydacat,azuremyst,1241,druid,feral,24,13,11
7372,Pfheral,area-52,1240,druid,feral,30,13,17
7373,Hektuk,barthilas,1235,druid,feral,34,19,15
7374,Behrhart,stormrage,1234,druid,feral,24,16,8
7375,Ourse,aegwynn,1234,druid,feral,89,52,37
7376,Koochii,tichondrius,1234,druid,feral,27,14,13
7377,Nightshift,dalvengyr,1233,druid,feral,24,13,11
7378,Whitetigeris,tichondrius,1233,druid,feral,24,13,11
7379,Pixyls,bleeding-hollow,1233,druid,feral,29,15,14
7380,Beargodx,stormrage,1232,druid,feral,78,41,37
7381,Kleanxx,tichondrius,1232,druid,feral,223,111,112
7382,Hobbles,emerald-dream,1232,druid,feral,42,18,24
7383,Wildwhisper,moon-guard,1232,druid,feral,36,13,23
7384,Midnightmeat,tichondrius,1230,druid,feral,50,23,27
7385,Duckieheit,sargeras,1229,druid,feral,34,15,19
7386,Matpd,norgannon,1228,druid,feral,66,28,38
7387,Haneulso,tichondrius,1228,druid,feral,45,17,28
7388,Orthognathic,emerald-dream,1227,druid,feral,57,35,22
7389,Bâgheera,sargeras,1225,druid,feral,61,25,36
7390,Xanbàr,hyjal,1222,druid,feral,35,22,13
7391,Twistach,quelthalas,1222,druid,feral,24,13,11
7392,Beygatti,sargeras,1222,druid,feral,61,25,36
7393,Zolíath,tichondrius,1221,druid,feral,36,13,23
7394,Swappy,korgath,1220,druid,feral,69,31,38
7395,Zelazia,area-52,1219,druid,feral,30,16,14
7396,Udderchaos,dark-iron,1218,druid,feral,30,13,17
7397,Berd,whisperwind,1215,druid,feral,40,20,20
7398,Muidruid,thrall,1215,druid,feral,30,13,17
7399,Midnitex,illidan,1214,druid,feral,37,16,21
7400,Styli,tichondrius,1212,druid,feral,100,50,50
7401,Pusswhisperr,bleeding-hollow,1210,druid,feral,42,15,27
7402,Hermbott,proudmoore,1206,druid,feral,54,26,28
7403,Dorio,quelthalas,1197,druid,feral,30,14,16
7404,Spinach,moon-guard,1195,druid,feral,33,13,20
7405,Saelyle,illidan,1194,druid,feral,70,29,41
7406,Hctibrehtom,illidan,1193,druid,feral,24,20,4
7407,Ðrengr,quelthalas,1193,druid,feral,36,20,16
7408,Destrez,ragnaros,1188,druid,feral,27,13,14
7409,Hupod,proudmoore,1181,druid,feral,64,32,32
7410,Sansao,sargeras,1179,druid,feral,42,21,21
7411,Ursuur,drakkari,1178,druid,feral,86,38,48
7412,Bigmolii,quelthalas,1178,druid,feral,104,39,65
7413,Empathz,emerald-dream,1173,druid,feral,35,13,22
7414,Khione,dreadmaul,1172,druid,feral,68,38,30
7415,Zurker,mannoroth,1170,druid,feral,57,25,32
7416,Dehltax,stormrage,1169,druid,feral,54,29,25
7417,Xdkittyrawr,tichondrius,1168,druid,feral,94,46,48
7418,Zderhs,blackrock,1163,druid,feral,26,13,13
7419,Stríðsmaður,area-52,1159,druid,feral,60,25,35
7420,Scruffywolf,tichondrius,1157,druid,feral,155,67,88
7421,Borybuilder,azralon,1153,druid,feral,52,22,30
7422,Ishiftalot,bleeding-hollow,1153,druid,feral,63,26,37
7423,Europecat,stormrage,1152,druid,feral,24,12,12
7424,Sooey,wyrmrest-accord,1151,druid,feral,24,12,12
7425,Flayx,frostmourne,1151,druid,feral,30,12,18
7426,Kiwidru,frostmourne,1150,druid,feral,24,12,12
7427,Manbeartree,malganis,1150,druid,feral,36,12,24
7428,Getahfix,frostmourne,1149,druid,feral,24,12,12
7429,Susruth,area-52,1149,druid,feral,30,12,18
7430,Leight,whisperwind,1148,druid,feral,36,21,15
7431,Yukcyducky,tichondrius,1148,druid,feral,114,48,66
7432,Miviaris,alleria,1147,druid,feral,24,12,12
7433,Concordya,tichondrius,1146,druid,feral,30,13,17
7434,Doblun,nemesis,1146,druid,feral,36,12,24
7435,Werebruin,bleeding-hollow,1145,druid,feral,79,40,39
7436,Kittyboiz,illidan,1143,druid,feral,35,14,21
7437,Anastasyiar,illidan,1142,druid,feral,30,12,18
7438,Ÿùp,tichondrius,1141,druid,feral,18,12,6
7439,Kaya,hyjal,1141,druid,feral,66,22,44
7440,Bearjoo,kelthuzad,1140,druid,feral,30,13,17
7441,Khaoticklaw,stormrage,1137,druid,feral,33,14,19
7442,Daniin,azralon,1136,druid,feral,72,33,39
7443,Aligantor,thrall,1134,druid,feral,18,12,6
7444,Deadlykept,ragnaros,1134,druid,feral,36,18,18
7445,Wwf,thrall,1130,druid,feral,83,31,52
7446,Chëësëbürgër,illidan,1128,druid,feral,97,45,52
7447,Cooln,bleeding-hollow,1123,druid,feral,24,15,9
7448,Elunaya,illidan,1122,druid,feral,36,15,21
7449,Tonoshapepai,azralon,1122,druid,feral,36,13,23
7450,Nahtex,tichondrius,1121,druid,feral,30,12,18
7451,Shahahrazad,queldorei,1118,druid,feral,36,12,24
7452,Strikinina,azralon,1117,druid,feral,73,33,40
7453,Eyzie,stormrage,1115,druid,feral,36,13,23
7454,Vineclaw,emerald-dream,1114,druid,feral,36,14,22
7455,Nätural,bloodhoof,1113,druid,feral,23,12,11
7456,Ðementia,stormrage,1109,druid,feral,126,68,58
7457,Daisyôreo,tichondrius,1104,druid,feral,58,30,28
7458,Yobolsun,sargeras,1103,druid,feral,48,21,27
7459,Azakana,sargeras,1094,druid,feral,23,12,11
7460,Tastelikecat,kelthuzad,1093,druid,feral,45,17,28
7461,Druski,lightbringer,1089,druid,feral,23,14,9
7462,Kragma,zuluhed,1085,druid,feral,24,13,11
7463,Bernoboy,kelthuzad,1079,druid,feral,30,16,14
7464,Doubledówn,sargeras,1079,druid,feral,192,97,95
7465,Critthisbruh,stormrage,1078,druid,feral,27,15,12
7466,Kyrona,frostmourne,1078,druid,feral,42,22,20
7467,Skrillin,thrall,1076,druid,feral,35,19,16
7468,Trevvor,thrall,1070,druid,feral,36,12,24
7469,Anarad,dalaran,1068,druid,feral,42,22,20
7470,Pokémon,grizzly-hills,1064,druid,feral,33,15,18
7471,Bifë,ragnaros,1063,druid,feral,36,12,24
7472,Seraphim,lightnings-blade,1061,druid,feral,78,40,38
7473,Mordrynn,veknilash,1059,druid,feral,62,32,30
7474,Damnimal,caelestrasz,1058,druid,feral,22,13,9
7475,Drdanknugs,laughing-skull,1057,druid,feral,54,16,38
7476,Ohaa,sargeras,1056,druid,feral,12,11,1
7477,Glenn,norgannon,1056,druid,feral,18,11,7
7478,Birdy,proudmoore,1056,druid,feral,18,11,7
7479,Switchform,kiljaeden,1056,druid,feral,18,11,7
7480,Hatergodx,ravencrest,1056,druid,feral,24,11,13
7481,Lelobull,ragnaros,1056,druid,feral,48,19,29
7482,Dangersweg,frostmourne,1056,druid,feral,30,11,19
7483,Dawsonxo,proudmoore,1055,druid,feral,24,11,13
7484,Zoeishyper,sargeras,1055,druid,feral,24,11,13
7485,Orekinya,area-52,1055,druid,feral,24,11,13
7486,Kellydabear,azuremyst,1054,druid,feral,24,11,13
7487,Bearlyviable,stormrage,1054,druid,feral,33,12,21
7488,Myeow,illidan,1052,druid,feral,24,11,13
7489,Teddybear,medivh,1052,druid,feral,101,44,57
7490,Corv,drenden,1051,druid,feral,16,12,4
7491,Bloodynine,cairne,1050,druid,feral,24,11,13
7492,Looquitaa,ragnaros,1049,druid,feral,78,32,46
7493,Nyla,nemesis,1048,druid,feral,12,11,1
7494,Téddybéar,smolderthorn,1048,druid,feral,33,22,11
7495,Vykarux,suramar,1048,druid,feral,24,11,13
7496,Chernobiel,stormrage,1048,druid,feral,24,11,13
7497,Yám,tichondrius,1048,druid,feral,30,11,19
7498,Drbraino,sargeras,1046,druid,feral,24,11,13
7499,Fieryferal,kargath,1046,druid,feral,42,12,30
7500,Bananawaffle,proudmoore,1042,druid,feral,30,11,19
7501,Dròódles,barthilas,1035,druid,feral,18,11,7
7502,Jabiso,smolderthorn,1034,druid,feral,79,41,38
7503,Oxvxo,senjin,1033,druid,feral,42,25,17
7504,Dalinaìr,moon-guard,1033,druid,feral,24,13,11
7505,Wildbeasts,proudmoore,1030,druid,feral,182,91,91
7506,Meowzedon,sargeras,1029,druid,feral,24,11,13
7507,Kayday,bloodscalp,1027,druid,feral,18,11,7
7508,Greasemonkey,trollbane,1024,druid,feral,28,18,10
7509,Gece,dalaran,1022,druid,feral,35,15,20
7510,Screwdrivers,moon-guard,1022,druid,feral,29,11,18
7511,Reallysauce,zuljin,1019,druid,feral,30,16,14
7512,Liktak,perenolde,1018,druid,feral,30,11,19
7513,Fennel,korgath,1017,druid,feral,23,11,12
7514,Mojofoshobro,moonrunner,1017,druid,feral,72,29,43
7515,Framko,quelthalas,1011,druid,feral,78,24,54
7516,Lyndonww,frostmourne,1006,druid,feral,26,12,14
7517,Sisilo,bonechewer,1005,druid,feral,115,52,63
7518,Afrogx,dalaran,1001,druid,feral,24,11,13
7519,Superwrath,khaz-modan,1000,druid,feral,23,11,12
7520,Skufty,illidan,997,druid,feral,120,46,74
7521,Ruzkit,illidan,996,druid,feral,30,14,16
7522,Tt,akama,989,druid,feral,26,11,15
7523,Aeonás,tichondrius,988,druid,feral,25,13,12
7524,Catahmine,thrall,988,druid,feral,26,11,15
7525,Ediiann,cenarius,986,druid,feral,24,11,13
7526,Druidsling,mugthol,981,druid,feral,62,23,39
7527,Brurion,dalaran,973,druid,feral,30,13,17
7528,Dârkfang,moon-guard,972,druid,feral,24,13,11
7529,Twigz,illidan,971,druid,feral,148,72,76
7530,Tolldruid,chogall,967,druid,feral,30,15,15
7531,Pawprika,tichondrius,961,druid,feral,72,32,40
7532,Semveta,alleria,960,druid,feral,12,10,2
7533,Sweetpurple,elune,960,druid,feral,18,10,8
7534,Yukjr,tichondrius,960,druid,feral,24,10,14
7535,Buffjungle,tichondrius,960,druid,feral,26,10,16
7536,Juiceonlips,sargeras,959,druid,feral,18,10,8
7537,Kekepöp,illidan,959,druid,feral,24,10,14
7538,Yaboidakota,stormrage,959,druid,feral,24,10,14
7539,Lïberty,ragnaros,958,druid,feral,12,10,2
7540,Moonshady,zuljin,958,druid,feral,19,10,9
7541,Nearkoo,tichondrius,958,druid,feral,24,10,14
7542,Noet,ragnaros,957,druid,feral,18,10,8
7543,Pavel,aerie-peak,957,druid,feral,59,18,41
7544,Predatõr,malorne,956,druid,feral,35,17,18
7545,Hashmall,ragnaros,956,druid,feral,30,10,20
7546,Shiftingdean,sargeras,956,druid,feral,30,10,20
7547,Hoargar,senjin,955,druid,feral,18,12,6
7548,Munchausens,dalaran,955,druid,feral,24,10,14
7549,Høruss,azralon,955,druid,feral,27,11,16
7550,Pàntera,tichondrius,955,druid,feral,36,10,26
7551,Moonbow,frostmourne,954,druid,feral,18,10,8
7552,Yseraspawn,kelthuzad,954,druid,feral,30,10,20
7553,Stalfrus,area-52,952,druid,feral,12,10,2
7554,Thegrefgx,ragnaros,949,druid,feral,18,10,8
7555,Xform,jubeithos,946,druid,feral,18,10,8
7556,Bullshiftin,area-52,945,druid,feral,18,10,8
7557,Nokther,muradin,941,druid,feral,48,13,35
7558,Feraluwu,illidan,938,druid,feral,18,10,8
7559,Lusk,blades-edge,937,druid,feral,70,32,38
7560,Dinnerbone,echo-isles,926,druid,feral,24,10,14
7561,Arntu,malganis,924,druid,feral,17,10,7
7562,Soldadito,zuljin,924,druid,feral,27,12,15
7563,Ekkoh,sargeras,921,druid,feral,29,10,19
7564,Eglania,stormrage,920,druid,feral,42,22,20
7565,Lacrarola,nemesis,916,druid,feral,17,10,7
7566,Odesellena,moon-guard,913,druid,feral,48,23,25
7567,Àspên,moon-guard,908,druid,feral,42,20,22
7568,Blêêd,stormscale,904,druid,feral,13,12,1
7569,Muggsy,scilla,893,druid,feral,14,10,4
7570,Sjana,bleeding-hollow,893,druid,feral,36,17,19
7571,Chiknsketti,bleeding-hollow,892,druid,feral,26,10,16
7572,Koag,dalaran,891,druid,feral,29,13,16
7573,Fanaror,frostmourne,887,druid,feral,56,28,28
7574,Vácagada,ragnaros,885,druid,feral,30,10,20
7575,Taurenaught,aegwynn,881,druid,feral,37,17,20
7576,Syänn,thrall,879,druid,feral,24,10,14
7577,Bigherbo,zuljin,872,druid,feral,26,11,15
7578,Retzerbil,sargeras,864,druid,feral,12,9,3
7579,Funkattack,tichondrius,864,druid,feral,18,9,9
7580,Fuujinn,korgath,864,druid,feral,18,9,9
7581,Jaegerbombx,sargeras,864,druid,feral,18,9,9
7582,Unfunnyferal,kelthuzad,864,druid,feral,18,9,9
7583,Faithxo,stormrage,864,druid,feral,24,9,15
7584,Feorb,azuremyst,864,druid,feral,24,9,15
7585,Parallax,shadowsong,863,druid,feral,18,9,9
7586,Gz,icecrown,863,druid,feral,18,9,9
7587,Féèd,stormrage,863,druid,feral,18,9,9
7588,Thaherb,korgath,863,druid,feral,24,9,15
7589,Purplecat,frostmourne,862,druid,feral,12,9,3
7590,Lunchßox,emerald-dream,862,druid,feral,12,9,3
7591,Morphes,suramar,862,druid,feral,18,9,9
7592,Orizane,moon-guard,862,druid,feral,24,9,15
7593,Mogleyz,stormreaver,862,druid,feral,26,9,17
7594,Catten,barthilas,860,druid,feral,12,9,3
7595,Cadburycop,malganis,860,druid,feral,33,10,23
7596,Manlymanman,shandris,859,druid,feral,24,9,15
7597,Shiftyounot,shattered-hand,859,druid,feral,30,9,21
7598,Ruhgen,deathwing,858,druid,feral,26,10,16
7599,Furryboyxd,saurfang,858,druid,feral,24,9,15
7600,Jonoa,nagrand,858,druid,feral,24,9,15
7601,Wuarlo,moon-guard,857,druid,feral,91,43,48
7602,Rum,the-venture-co,857,druid,feral,36,14,22
7603,Hótlife,fizzcrank,856,druid,feral,18,9,9
7604,Maimsy,blackhand,855,druid,feral,18,9,9
7605,Snugglin,kelthuzad,855,druid,feral,18,9,9
7606,Wokoom,windrunner,855,druid,feral,54,20,34
7607,Bigravioli,ragnaros,854,druid,feral,24,9,15
7608,Mavren,uldaman,853,druid,feral,30,10,20
7609,Capson,darkspear,851,druid,feral,36,12,24
7610,Zauska,cenarion-circle,851,druid,feral,30,9,21
7611,Drulicious,tichondrius,849,druid,feral,27,13,14
7612,Sosd,kelthuzad,837,druid,feral,17,9,8
7613,Mooncatbear,malganis,831,druid,feral,22,9,13
7614,Fogboom,area-52,830,druid,feral,20,10,10
7615,Dreamfyre,kiljaeden,828,druid,feral,29,9,20
7616,Shartasm,anetheron,822,druid,feral,30,12,18
7617,Tatiannaa,stormreaver,815,druid,feral,15,10,5
7618,Feorelm,proudmoore,810,druid,feral,17,9,8
7619,Weezydende,area-52,806,druid,feral,53,16,37
7620,Nephdruid,stormrage,804,druid,feral,30,9,21
7621,Ðjangø,goldrinn,801,druid,feral,17,9,8
7622,Kuzigothigh,thunderhorn,795,druid,feral,53,27,26
7623,Sweetnippies,elune,768,druid,feral,12,8,4
7624,Batterydruid,silvermoon,768,druid,feral,12,8,4
7625,Kattles,frostmourne,768,druid,feral,12,8,4
7626,Griefs,emerald-dream,768,druid,feral,12,8,4
7627,Tostaø,ragnaros,768,druid,feral,12,8,4
7628,Jason,vashj,768,druid,feral,12,8,4
7629,Anìmorph,sargeras,768,druid,feral,12,8,4
7630,Thaddeusx,illidan,768,druid,feral,16,9,7
7631,Bitenscratch,tichondrius,768,druid,feral,18,8,10
7632,Owd,tichondrius,768,druid,feral,18,8,10
7633,Whittlekitty,anetheron,768,druid,feral,18,8,10
7634,Férállgødx,area-52,768,druid,feral,18,8,10
7635,Salemgomeow,sargeras,768,druid,feral,18,8,10
7636,Gouzz,frostmourne,768,druid,feral,24,8,16
7637,Sylvaster,stormrage,768,druid,feral,24,8,16
7638,Saltydru,illidan,768,druid,feral,24,8,16
7639,Germainee,shandris,768,druid,feral,24,8,16
7640,Pokeyouryolk,sargeras,767,druid,feral,12,8,4
7641,Jentzull,tichondrius,767,druid,feral,12,8,4
7642,Güar,area-52,767,druid,feral,12,8,4
7643,Ostley,moon-guard,767,druid,feral,12,8,4
7644,Nahelae,tichondrius,767,druid,feral,12,8,4
7645,Kìttykat,stormrage,767,druid,feral,18,8,10
7646,Mythienair,stormrage,767,druid,feral,18,8,10
7647,Pergutory,frostmourne,767,druid,feral,18,8,10
7648,Lazypaw,malganis,767,druid,feral,18,8,10
7649,Zascat,malganis,767,druid,feral,18,8,10
7650,Fullmoon,greymane,767,druid,feral,22,9,13
7651,Kals,burning-blade,767,druid,feral,24,8,16
7652,Bufusala,illidan,766,druid,feral,12,8,4
7653,Jpnerazim,quelthalas,766,druid,feral,16,8,8
7654,Angulus,darkspear,766,druid,feral,18,8,10
7655,Grumalzi,moon-guard,766,druid,feral,24,8,16
7656,Scratchh,darkspear,766,druid,feral,24,8,16
7657,Notoriouzßig,sargeras,765,druid,feral,18,8,10
7658,Deaddpool,ragnaros,764,druid,feral,12,8,4
7659,Zimah,illidan,764,druid,feral,18,8,10
7660,Davinchii,drakkari,764,druid,feral,18,8,10
7661,Raknary,kelthuzad,764,druid,feral,30,8,22
7662,Goorybud,tichondrius,762,druid,feral,12,8,4
7663,Bebechat,area-52,762,druid,feral,12,8,4
7664,Isleyy,tichondrius,760,druid,feral,18,8,10
7665,Gamble,the-underbog,760,druid,feral,24,8,16
7666,Darkemberrs,stormrage,757,druid,feral,36,8,28
7667,Garuharken,skullcrusher,754,druid,feral,30,8,22
7668,Flenser,frostmane,751,druid,feral,12,8,4
7669,Mychi,ragnaros,748,druid,feral,20,9,11
7670,Disdeus,bleeding-hollow,742,druid,feral,31,8,23
7671,Nodraent,quelthalas,741,druid,feral,18,8,10
7672,Snowlion,the-forgotten-coast,726,druid,feral,30,8,22
7673,Ashmila,ragnaros,716,druid,feral,17,8,9
7674,Notinsanity,proudmoore,714,druid,feral,20,9,11
7675,Mazoak,sargeras,703,druid,feral,28,8,20
7676,Byson,bleeding-hollow,702,druid,feral,17,8,9
7677,Psynix,zuljin,688,druid,feral,19,8,11
7678,Earlgrayl,kelthuzad,686,druid,feral,19,8,11
7679,Shakedru,stormrage,684,druid,feral,19,8,11
7680,Taiga,moon-guard,672,druid,feral,12,7,5
7681,Primalxd,area-52,672,druid,feral,12,7,5
7682,Dangerclaws,area-52,672,druid,feral,12,7,5
7683,Zðzð,zuljin,672,druid,feral,12,7,5
7684,Elyveen,proudmoore,672,druid,feral,12,7,5
7685,Hypê,tichondrius,672,druid,feral,12,7,5
7686,Isô,sargeras,672,druid,feral,12,7,5
7687,Venomsecho,vashj,672,druid,feral,12,7,5
7688,Austínd,sargeras,672,druid,feral,12,7,5
7689,Scuffedx,tichondrius,672,druid,feral,12,7,5
7690,Catculator,tichondrius,672,druid,feral,12,7,5
7691,Krobz,bleeding-hollow,672,druid,feral,12,7,5
7692,Shalaz,magtheridon,672,druid,feral,12,7,5
7693,Kistormx,tichondrius,672,druid,feral,12,7,5
7694,Dailydruid,illidan,672,druid,feral,12,7,5
7695,Tnvï,stormrage,672,druid,feral,12,7,5
7696,Druidman,mugthol,672,druid,feral,18,7,11
7697,Anaru,sisters-of-elune,672,druid,feral,18,7,11
7698,Psyraxus,moon-guard,672,druid,feral,18,7,11
7699,Islayne,moon-guard,672,druid,feral,18,7,11
7700,Selendis,tichondrius,672,druid,feral,18,7,11
7701,Meowny,area-52,672,druid,feral,18,7,11
7702,Muffbfloppn,zuljin,672,druid,feral,18,7,11
7703,Ronin,arthas,672,druid,feral,18,7,11
7704,Shiftage,frostmane,672,druid,feral,21,7,14
7705,Drywatter,tichondrius,671,druid,feral,12,7,5
7706,Meõw,tichondrius,671,druid,feral,12,7,5
7707,Ardelix,emerald-dream,671,druid,feral,12,7,5
7708,Happyhotter,proudmoore,671,druid,feral,12,7,5
7709,Carboz,jubeithos,671,druid,feral,12,7,5
7710,Pawsom,bleeding-hollow,671,druid,feral,12,7,5
7711,Zalmo,area-52,671,druid,feral,15,8,7
7712,Fürïous,tichondrius,671,druid,feral,15,8,7
7713,Aladelryth,malfurion,671,druid,feral,18,7,11
7714,Bearmuda,trollbane,671,druid,feral,18,7,11
7715,Ruckiz,stormrage,671,druid,feral,18,7,11
7716,Momoxchan,quelthalas,671,druid,feral,18,7,11
7717,Zallo,korgath,671,druid,feral,18,7,11
7718,Ännä,moon-guard,671,druid,feral,18,7,11
7719,Corym,frostmourne,671,druid,feral,18,7,11
7720,Wingus,smolderthorn,670,druid,feral,12,7,5
7721,Chaace,proudmoore,670,druid,feral,12,7,5
7722,Bocát,stormrage,669,druid,feral,12,7,5
7723,Curainfeliz,nemesis,669,druid,feral,12,7,5
7724,Redness,daggerspine,669,druid,feral,18,7,11
7725,Nanassa,spinebreaker,669,druid,feral,18,7,11
7726,Irontauren,drakkari,669,druid,feral,24,7,17
7727,Berall,bleeding-hollow,668,druid,feral,12,7,5
7728,Yokimo,amanthul,668,druid,feral,18,7,11
7729,Zeldriss,arthas,668,druid,feral,19,7,12
7730,Igneël,ragnaros,668,druid,feral,24,7,17
7731,Jordiët,dalaran,667,druid,feral,12,7,5
7732,Healorhell,azralon,660,druid,feral,40,7,33
7733,Hyperlite,bonechewer,643,druid,feral,18,7,11
7734,Injail,tichondrius,640,druid,feral,16,7,9
7735,Chadwickx,illidan,639,druid,feral,11,7,4
7736,Oldclive,frostmourne,637,druid,feral,17,7,10
7737,Jeanz,bonechewer,632,druid,feral,19,9,10
7738,Slapymilf,dentarg,623,druid,feral,11,7,4
7739,Meowzetzan,tichondrius,623,druid,feral,11,7,4
7740,Puzzykat,uldum,621,druid,feral,27,7,20
7741,Gutzzu,area-52,619,druid,feral,15,7,8
7742,Weedleaf,wyrmrest-accord,610,druid,feral,20,8,12
7743,Beaker,uldum,605,druid,feral,11,7,4
7744,Chucknöürish,dalaran,597,druid,feral,23,7,16
7745,Hotmomlover,malganis,576,druid,feral,12,6,6
7746,Bootayclappa,sargeras,576,druid,feral,12,6,6
7747,Bables,tichondrius,576,druid,feral,12,6,6
7748,Thontt,sargeras,576,druid,feral,12,6,6
7749,Honoriodruid,nemesis,576,druid,feral,12,6,6
7750,Wilddeity,tichondrius,576,druid,feral,12,6,6
7751,Daniverse,sargeras,576,druid,feral,12,6,6
7752,Ogversaucey,skullcrusher,576,druid,feral,12,6,6
7753,Alyxsandr,dalaran,576,druid,feral,12,6,6
7754,Hybridxo,kelthuzad,576,druid,feral,12,6,6
7755,Grimtreeper,illidan,576,druid,feral,12,6,6
7756,Zoehange,frostmourne,576,druid,feral,12,6,6
7757,Parabear,area-52,576,druid,feral,12,6,6
7758,Cíphenz,illidan,576,druid,feral,12,6,6
7759,Lilrichdps,sargeras,576,druid,feral,12,6,6
7760,Kurokyy,frostmourne,576,druid,feral,12,6,6
7761,Trottystwin,emerald-dream,576,druid,feral,12,6,6
7762,Nelfwaifú,area-52,576,druid,feral,12,6,6
7763,Spaléxgu,azralon,576,druid,feral,12,6,6
7764,Mommyshårk,tichondrius,576,druid,feral,12,6,6
7765,Kittysnuggle,emerald-dream,576,druid,feral,15,7,8
7766,Jinhova,stormrage,576,druid,feral,15,6,9
7767,Rebrrth,antonidas,576,druid,feral,18,6,12
7768,Mameseph,lightnings-blade,576,druid,feral,18,6,12
7769,Emotionally,illidan,576,druid,feral,18,6,12
7770,Gaday,malganis,576,druid,feral,18,6,12
7771,Kobebeef,malganis,576,druid,feral,24,6,18
7772,Clamchaddy,tichondrius,576,druid,feral,24,6,18
7773,Zazishi,zuljin,575,druid,feral,6,6,0
7774,Yesqt,dalaran,575,druid,feral,12,6,6
7775,Omnilul,zuljin,575,druid,feral,12,6,6
7776,Fireeloot,tichondrius,575,druid,feral,12,6,6
7777,Wulfjack,emerald-dream,575,druid,feral,12,6,6
7778,Amoru,moon-guard,575,druid,feral,12,6,6
7779,Eliteshift,frostmourne,575,druid,feral,12,6,6
7780,Chupaone,dalaran,575,druid,feral,12,6,6
7781,Tyriall,darkspear,575,druid,feral,12,6,6
7782,Austîn,moon-guard,575,druid,feral,12,6,6
7783,Druishcat,dark-iron,575,druid,feral,12,6,6
7784,Allenjunior,ragnaros,575,druid,feral,12,6,6
7785,Ursoc,muradin,575,druid,feral,18,6,12
7786,Pachacamac,dragonmaw,575,druid,feral,18,6,12
7787,Gush,echo-isles,575,druid,feral,18,6,12
7788,Thorñ,cenarius,575,druid,feral,18,6,12
7789,Peppapig,mugthol,575,druid,feral,18,6,12
7790,Andaror,azralon,575,druid,feral,24,6,18
7791,Volbourn,amanthul,575,druid,feral,24,6,18
7792,Beelzehog,whisperwind,574,druid,feral,12,6,6
7793,Swánn,firetree,574,druid,feral,18,6,12
7794,Imass,draka,573,druid,feral,18,6,12
7795,Nikozho,sargeras,573,druid,feral,18,6,12
7796,Udala,durotan,572,druid,feral,14,6,8
7797,Drewiid,stormrage,571,druid,feral,18,6,12
7798,Expells,nemesis,569,druid,feral,18,6,12
7799,Rhaines,moon-guard,569,druid,feral,18,6,12
7800,Oxentoes,sargeras,559,druid,feral,17,7,10
7801,Bigdeeza,frostmourne,552,druid,feral,19,8,11
7802,Dullbozer,thrall,543,druid,feral,11,6,5
7803,Druidcyber,stormrage,543,druid,feral,16,6,10
7804,Lémons,tichondrius,542,druid,feral,17,6,11
7805,Wtfimacat,area-52,527,druid,feral,11,6,5
7806,Fernés,proudmoore,526,druid,feral,11,6,5
7807,Wierdosaur,azralon,524,druid,feral,15,6,9
7808,Ripx,khadgar,522,druid,feral,16,7,9
7809,Kajla,sargeras,521,druid,feral,22,7,15
7810,Shadalor,frostmourne,512,druid,feral,16,6,10
7811,Kittyperry,kelthuzad,512,druid,feral,16,6,10
7812,Ashvir,wyrmrest-accord,511,druid,feral,11,6,5
7813,Cokanebear,garrosh,511,druid,feral,14,6,8
7814,Kilbys,nemesis,510,druid,feral,8,6,2
7815,Iamatomic,illidan,509,druid,feral,20,6,14
7816,Worgbearpig,destromath,496,druid,feral,13,6,7
7817,Idiotdruid,ragnaros,480,druid,feral,6,5,1
7818,Chrøniç,illidan,480,druid,feral,6,5,1
7819,Gloomcat,illidan,480,druid,feral,6,5,1
7820,Flompstomper,skullcrusher,480,druid,feral,6,5,1
7821,Exxh,tichondrius,480,druid,feral,6,5,1
7822,Nbnbnb,proudmoore,480,druid,feral,6,5,1
7823,Elgatomarica,ragnaros,480,druid,feral,9,6,3
7824,Choolah,area-52,480,druid,feral,12,5,7
7825,Klypz,tichondrius,480,druid,feral,12,5,7
7826,Shiftdeznutz,tichondrius,480,druid,feral,12,5,7
7827,Topangâ,lightninghoof,480,druid,feral,12,5,7
7828,Lurky,dalvengyr,480,druid,feral,12,5,7
7829,Zeratull,cenarius,480,druid,feral,12,5,7
7830,Softshirtxo,ragnaros,480,druid,feral,12,5,7
7831,Cudlybear,bleeding-hollow,480,druid,feral,12,5,7
7832,Lilrichdmg,sargeras,480,druid,feral,12,5,7
7833,Crendorides,bleeding-hollow,480,druid,feral,12,5,7
7834,Samuraicat,frostmourne,480,druid,feral,12,5,7
7835,Bloodyugly,area-52,480,druid,feral,12,5,7
7836,Gunnymad,tichondrius,480,druid,feral,12,5,7
7837,Veryhighrn,area-52,480,druid,feral,12,5,7
7838,Ezconvoke,sargeras,480,druid,feral,12,5,7
7839,Ferallash,sargeras,480,druid,feral,12,5,7
7840,Zululu,dalaran,480,druid,feral,12,5,7
7841,Frenzyirl,darkspear,480,druid,feral,12,5,7
7842,Wurow,firetree,480,druid,feral,12,5,7
7843,Honeybeam,moon-guard,480,druid,feral,12,5,7
7844,Marshanlynch,korgath,480,druid,feral,12,5,7
7845,Loamie,proudmoore,480,druid,feral,12,5,7
7846,Rairven,stormrage,480,druid,feral,12,5,7
7847,Duckseasonn,sargeras,480,druid,feral,12,5,7
7848,Cenarius,frostmourne,480,druid,feral,12,5,7
7849,Karizikat,tichondrius,480,druid,feral,12,5,7
7850,Ragingcloner,tichondrius,480,druid,feral,12,5,7
7851,Frizzle,onyxia,480,druid,feral,12,5,7
7852,Feralhearted,kelthuzad,480,druid,feral,12,5,7
7853,Fredolay,tichondrius,480,druid,feral,13,5,8
7854,Scorn,spirestone,480,druid,feral,13,5,8
7855,Caelüm,area-52,480,druid,feral,18,5,13
7856,Atreis,malganis,480,druid,feral,18,5,13
7857,Purrcat,tichondrius,480,druid,feral,18,5,13
7858,Lycanjungle,azralon,480,druid,feral,18,5,13
7859,Maplêleaf,moon-guard,480,druid,feral,18,5,13
7860,Bere,kul-tiras,480,druid,feral,18,5,13
7861,Funfunfrank,aegwynn,480,druid,feral,18,5,13
7862,Oneninesix,frostmourne,480,druid,feral,18,5,13
7863,Mawnster,drenden,479,druid,feral,9,6,3
7864,Icecrackin,bloodscalp,479,druid,feral,12,5,7
7865,Moozdormu,stormrage,479,druid,feral,12,5,7
7866,Hawthòrn,bloodscalp,479,druid,feral,12,5,7
7867,Omnisyst,burning-blade,479,druid,feral,12,5,7
7868,Calani,lightnings-blade,479,druid,feral,12,5,7
7869,Tootiebootie,bleeding-hollow,479,druid,feral,12,5,7
7870,Harrystun,hyjal,479,druid,feral,12,5,7
7871,Nisheon,wyrmrest-accord,479,druid,feral,12,5,7
7872,Balthøs,moon-guard,479,druid,feral,12,5,7
7873,Animalcade,area-52,479,druid,feral,12,5,7
7874,Elsancho,stormreaver,479,druid,feral,12,5,7
7875,Ysemia,drakkari,479,druid,feral,14,5,9
7876,Giatafix,whisperwind,479,druid,feral,18,5,13
7877,Treepiss,tichondrius,479,druid,feral,18,5,13
7878,Bigoldbear,moon-guard,479,druid,feral,24,5,19
7879,Madador,bleeding-hollow,478,druid,feral,12,5,7
7880,Ramso,skullcrusher,478,druid,feral,12,5,7
7881,Fbombzz,kalecgos,477,druid,feral,12,5,7
7882,Maaryjo,quelthalas,476,druid,feral,12,5,7
7883,Slymar,darkspear,474,druid,feral,12,5,7
7884,Feralhearted,tichondrius,463,druid,feral,17,5,12
7885,Dababÿ,frostmourne,447,druid,feral,11,5,6
7886,Kogti,malganis,446,druid,feral,10,6,4
7887,Maplesyrup,moonrunner,431,druid,feral,11,5,6
7888,Moonrg,stormrage,431,druid,feral,11,5,6
7889,Bjohns,bleeding-hollow,426,druid,feral,21,6,15
7890,Ninelivez,gorgonnash,426,druid,feral,22,6,16
7891,Yunekai,stormrage,415,druid,feral,11,5,6
7892,Vaelthunis,sargeras,400,druid,feral,13,5,8
7893,Slackoth,dalaran,384,druid,feral,6,4,2
7894,Torofarmeon,quelthalas,384,druid,feral,6,4,2
7895,Beastkong,dalaran,384,druid,feral,6,4,2
7896,Xrw,kelthuzad,384,druid,feral,6,4,2
7897,Rouxel,emerald-dream,384,druid,feral,6,4,2
7898,Srwow,elune,384,druid,feral,6,4,2
7899,Sneekykitty,malygos,384,druid,feral,6,4,2
7900,Reversflash,emerald-dream,384,druid,feral,6,4,2
7901,Coolguyzack,stormscale,384,druid,feral,6,4,2
7902,Pressuretd,frostmourne,384,druid,feral,6,4,2
7903,Kaldiel,ysera,384,druid,feral,6,4,2
7904,Cloneyourmom,sargeras,384,druid,feral,6,4,2
7905,Nâturê,dalaran,384,druid,feral,6,4,2
7906,Bearcathawk,sargeras,384,druid,feral,6,4,2
7907,Metamorfis,malorne,384,druid,feral,6,4,2
7908,Moondex,maelstrom,384,druid,feral,6,4,2
7909,Extacy,ragnaros,384,druid,feral,6,4,2
7910,Softkity,area-52,384,druid,feral,6,4,2
7911,Woshiyigede,frostmourne,384,druid,feral,6,4,2
7912,Cwonzocat,moon-guard,384,druid,feral,6,4,2
7913,Zxtreme,tichondrius,384,druid,feral,6,4,2
7914,Féràlgøðx,sargeras,384,druid,feral,6,4,2
7915,Titiica,azralon,384,druid,feral,6,4,2
7916,Cfab,tichondrius,384,druid,feral,6,4,2
7917,Menapaws,muradin,384,druid,feral,6,4,2
7918,Vecuronium,tichondrius,384,druid,feral,6,4,2
7919,Acés,shattered-halls,384,druid,feral,6,4,2
7920,Lharast,stormrage,384,druid,feral,6,4,2
7921,Curet,lightbringer,384,druid,feral,6,4,2
7922,Ñòpé,tichondrius,384,druid,feral,6,4,2
7923,Zoomchicken,stormrage,384,druid,feral,6,4,2
7924,Robomexi,tichondrius,384,druid,feral,6,4,2
7925,Olhosdlua,azralon,384,druid,feral,6,4,2
7926,Toiiz,malganis,384,druid,feral,9,4,5
7927,Genuine,guldan,384,druid,feral,11,4,7
7928,Sellîas,senjin,384,druid,feral,12,4,8
7929,Quiziato,burning-legion,384,druid,feral,12,4,8
7930,Moohok,bleeding-hollow,384,druid,feral,12,4,8
7931,Plantdaddy,bladefist,384,druid,feral,12,4,8
7932,Efflence,tichondrius,384,druid,feral,12,4,8
7933,Alaillais,moon-guard,384,druid,feral,12,4,8
7934,Kokujin,proudmoore,384,druid,feral,12,4,8
7935,Gatona,stormrage,384,druid,feral,12,4,8
7936,Yakir,kiljaeden,384,druid,feral,12,4,8
7937,Riec,kiljaeden,384,druid,feral,12,4,8
7938,Carnumoose,zuljin,384,druid,feral,12,4,8
7939,Auxl,tichondrius,384,druid,feral,12,4,8
7940,Sample,dark-iron,384,druid,feral,12,4,8
7941,Strixferal,zuljin,384,druid,feral,12,4,8
7942,Timthecatman,frostmourne,384,druid,feral,12,4,8
7943,Onewitnature,nordrassil,384,druid,feral,12,4,8
7944,Windded,area-52,384,druid,feral,12,4,8
7945,Feralgød,tichondrius,384,druid,feral,12,4,8
7946,Iamfynch,sargeras,384,druid,feral,12,4,8
7947,Zzkitty,stormreaver,384,druid,feral,12,4,8
7948,Bolthor,wyrmrest-accord,384,druid,feral,12,4,8
7949,Gernichora,barthilas,384,druid,feral,12,4,8
7950,Binjuicex,frostmourne,384,druid,feral,12,4,8
7951,Yakuho,proudmoore,384,druid,feral,12,4,8
7952,Pollykush,sargeras,384,druid,feral,12,4,8
7953,Thalvannas,nazjatar,384,druid,feral,12,4,8
7954,Actioncat,emerald-dream,384,druid,feral,12,4,8
7955,Weeñor,tichondrius,384,druid,feral,12,4,8
7956,Heìrophant,trollbane,384,druid,feral,12,4,8
7957,Freshzk,azralon,384,druid,feral,12,4,8
7958,Imnotinhuman,tichondrius,384,druid,feral,12,4,8
7959,Rêàgøñ,tichondrius,384,druid,feral,12,4,8
7960,Bomani,ragnaros,384,druid,feral,12,4,8
7961,Hellabanx,tichondrius,384,druid,feral,12,4,8
7962,Carlosd,tichondrius,384,druid,feral,12,4,8
7963,Bënzy,frostmourne,384,druid,feral,12,4,8
7964,Kollective,sargeras,384,druid,feral,12,4,8
7965,Anzoô,illidan,384,druid,feral,12,4,8
7966,Toetoetoete,darrowmere,384,druid,feral,12,4,8
7967,Nickarc,illidan,384,druid,feral,12,4,8
7968,Anniehall,stormrage,384,druid,feral,12,4,8
7969,Acdru,tichondrius,384,druid,feral,12,4,8
7970,Ferril,drenden,384,druid,feral,13,4,9
7971,Naastir,medivh,384,druid,feral,14,4,10
7972,Pereréka,azralon,384,druid,feral,14,4,10
7973,Startalons,area-52,384,druid,feral,18,4,14
7974,Apothe,emerald-dream,384,druid,feral,18,4,14
7975,Moçamba,azralon,384,druid,feral,18,4,14
7976,Ewok,vashj,384,druid,feral,18,4,14
7977,Bronaarr,nordrassil,384,druid,feral,18,4,14
7978,Riverthorne,moon-guard,384,druid,feral,18,4,14
7979,Ráhilk,quelthalas,384,druid,feral,18,4,14
7980,Nxndruid,tichondrius,384,druid,feral,18,4,14
7981,Droodkat,feathermoon,384,druid,feral,24,4,20
7982,Jamesbailey,sargeras,383,druid,feral,12,4,8
7983,Pröfëct,ragnaros,383,druid,feral,12,4,8
7984,Gotbleedz,illidan,383,druid,feral,12,4,8
7985,Porrosman,quelthalas,383,druid,feral,12,4,8
7986,Shoboski,quelthalas,383,druid,feral,12,4,8
7987,Bramth,quelthalas,383,druid,feral,12,4,8
7988,Mfgs,kelthuzad,383,druid,feral,12,4,8
7989,Ruwkia,stormrage,383,druid,feral,12,4,8
7990,Mogli,perenolde,383,druid,feral,30,4,26
7991,Pochaso,cenarius,382,druid,feral,6,4,2
7992,Cyder,thrall,382,druid,feral,10,5,5
7993,Ssimbaa,area-52,382,druid,feral,12,4,8
7994,Quaektem,bloodhoof,379,druid,feral,12,4,8
7995,Zyila,garithos,367,druid,feral,11,4,7
7996,Eightyhd,ravencrest,351,druid,feral,11,4,7
7997,Gorlammi,illidan,351,druid,feral,11,4,7
7998,Rainbowsix,sargeras,347,druid,feral,11,4,7
7999,Moocka,ragnaros,336,druid,feral,9,4,5
8000,Shyn,goldrinn,336,druid,feral,15,4,11
8001,Yizhiyuren,aegwynn,330,druid,feral,15,6,9
8002,Defku,quelthalas,330,druid,feral,28,6,22
8003,Niocin,daggerspine,326,druid,feral,18,5,13
8004,Itaiipava,azralon,288,druid,feral,6,3,3
8005,Ahhpalu,tichondrius,288,druid,feral,6,3,3
8006,Greemer,sargeras,288,druid,feral,6,3,3
8007,Insatiablé,azralon,288,druid,feral,6,3,3
8008,Balnara,cenarius,288,druid,feral,6,3,3
8009,Octeviia,illidan,288,druid,feral,6,3,3
8010,Feronnia,sargeras,288,druid,feral,6,3,3
8011,Mcnerd,sargeras,288,druid,feral,6,3,3
8012,Riddickd,malfurion,288,druid,feral,6,3,3
8013,Tigriss,malganis,288,druid,feral,6,3,3
8014,Frestydrul,stormrage,288,druid,feral,6,3,3
8015,Posmard,ragnaros,288,druid,feral,6,3,3
8016,Kardien,quelthalas,288,druid,feral,6,3,3
8017,Dramon,tichondrius,288,druid,feral,6,3,3
8018,Bleedinzqt,illidan,288,druid,feral,6,3,3
8019,Floridaman,moonrunner,288,druid,feral,6,3,3
8020,Steakjr,senjin,288,druid,feral,6,3,3
8021,Tasselhoof,hyjal,288,druid,feral,6,3,3
8022,Silit,tichondrius,288,druid,feral,6,3,3
8023,Injeckx,tichondrius,288,druid,feral,6,3,3
8024,Nichodameus,firetree,288,druid,feral,6,3,3
8025,Donutdruid,illidan,288,druid,feral,6,3,3
8026,Heretoleaf,tichondrius,288,druid,feral,6,3,3
8027,Enti,sargeras,288,druid,feral,6,3,3
8028,Rotclaws,stormrage,288,druid,feral,6,3,3
8029,Rígél,ragnaros,288,druid,feral,6,3,3
8030,Bigskeeve,sargeras,288,druid,feral,6,3,3
8031,Purrfact,frostmourne,288,druid,feral,6,3,3
8032,Opconvoke,illidan,288,druid,feral,6,3,3
8033,Datlogan,tichondrius,288,druid,feral,6,3,3
8034,Celetra,kiljaeden,288,druid,feral,6,3,3
8035,Pansensual,archimonde,288,druid,feral,6,3,3
8036,Jeperty,tichondrius,288,druid,feral,6,3,3
8037,Robbas,stormrage,288,druid,feral,6,3,3
8038,Arienne,kelthuzad,288,druid,feral,6,3,3
8039,Bubbleshiftz,area-52,288,druid,feral,6,3,3
8040,Øvernight,azralon,288,druid,feral,6,3,3
8041,Thecolortwoo,tichondrius,288,druid,feral,6,3,3
8042,Uag,emerald-dream,288,druid,feral,6,3,3
8043,Cwísp,dalaran,288,druid,feral,6,3,3
8044,Gâlaxy,sargeras,288,druid,feral,6,3,3
8045,Natureswang,bleeding-hollow,288,druid,feral,6,3,3
8046,Chopleaf,khadgar,288,druid,feral,6,3,3
8047,Dairycream,skullcrusher,288,druid,feral,6,3,3
8048,Pabag,chogall,288,druid,feral,6,3,3
8049,Ysero,area-52,288,druid,feral,6,3,3
8050,Svarun,jubeithos,288,druid,feral,6,3,3
8051,Katatafish,azralon,288,druid,feral,6,3,3
8052,Erbirus,proudmoore,288,druid,feral,6,3,3
8053,Elythria,hellscream,288,druid,feral,6,3,3
8054,Frrest,proudmoore,288,druid,feral,6,3,3
8055,Lahgit,frostmourne,288,druid,feral,6,3,3
8056,Jungledíff,ragnaros,288,druid,feral,6,3,3
8057,Rootchan,azralon,288,druid,feral,6,3,3
8058,Hyldru,stormrage,288,druid,feral,6,3,3
8059,Owlcapwn,stormreaver,288,druid,feral,6,3,3
8060,Fancyprance,dalaran,288,druid,feral,6,3,3
8061,Hitchslaps,tichondrius,288,druid,feral,6,3,3
8062,Sarenko,jubeithos,288,druid,feral,6,3,3
8063,Vico,azralon,288,druid,feral,6,3,3
8064,Blackmoose,lethon,288,druid,feral,6,3,3
8065,Espoir,azuremyst,288,druid,feral,6,3,3
8066,Taurenasarus,area-52,288,druid,feral,6,3,3
8067,Kíttypunch,bleeding-hollow,288,druid,feral,6,3,3
8068,Krishcat,azshara,288,druid,feral,6,3,3
8069,Askmeaboutmy,shattered-halls,288,druid,feral,6,3,3
8070,Benaveth,moon-guard,288,druid,feral,9,4,5
8071,Zadayos,aerie-peak,288,druid,feral,9,3,6
8072,Naebliss,arygos,288,druid,feral,12,3,9
8073,Lilnippy,stormscale,288,druid,feral,12,3,9
8074,Treezymeezy,proudmoore,288,druid,feral,12,3,9
8075,Snoww,moonrunner,288,druid,feral,12,3,9
8076,Oo,grizzly-hills,288,druid,feral,12,3,9
8077,Tchallå,tichondrius,288,druid,feral,12,3,9
8078,Näna,dalaran,288,druid,feral,12,3,9
8079,Hídde,quelthalas,288,druid,feral,12,3,9
8080,Zyrhek,quelthalas,288,druid,feral,12,3,9
8081,Vorare,tichondrius,288,druid,feral,12,3,9
8082,Solstice,frostmourne,288,druid,feral,12,3,9
8083,Uniquex,zuljin,288,druid,feral,12,3,9
8084,Haohomie,tichondrius,288,druid,feral,12,3,9
8085,Rivetrix,azralon,288,druid,feral,12,3,9
8086,Cattdog,tichondrius,288,druid,feral,12,3,9
8087,Treeguard,emerald-dream,288,druid,feral,12,3,9
8088,Xanjo,kiljaeden,288,druid,feral,12,3,9
8089,Sosorry,blackhand,288,druid,feral,12,3,9
8090,Flushi,nagrand,288,druid,feral,12,3,9
8091,Lovemakitty,sargeras,288,druid,feral,12,3,9
8092,Moobees,arthas,288,druid,feral,12,3,9
8093,Nighetager,uther,288,druid,feral,12,3,9
8094,Pawpaw,terenas,288,druid,feral,12,3,9
8095,Zetlolc,tichondrius,288,druid,feral,12,3,9
8096,Drailyo,ravenholdt,288,druid,feral,12,3,9
8097,Neksir,ragnaros,288,druid,feral,12,3,9
8098,Catorcow,aegwynn,288,druid,feral,13,3,10
8099,Denaye,tichondrius,288,druid,feral,18,3,15
8100,Mákeitnasty,tichondrius,288,druid,feral,18,3,15
8101,Iamthewambo,bloodhoof,288,druid,feral,30,3,27
8102,Extremeshift,dalaran,287,druid,feral,8,4,4
8103,Masilan,kelthuzad,287,druid,feral,6,3,3
8104,Twoworldz,tichondrius,287,druid,feral,6,3,3
8105,Kurodash,tichondrius,287,druid,feral,6,3,3
8106,Rawrii,nemesis,287,druid,feral,6,3,3
8107,Nast,dreadmaul,287,druid,feral,12,3,9
8108,Spartanlxl,zuljin,287,druid,feral,12,3,9
8109,Zalledori,thrall,287,druid,feral,12,3,9
8110,Schwiftea,skullcrusher,287,druid,feral,12,3,9
8111,Absoles,agamaggan,287,druid,feral,12,3,9
8112,Ethernal,burning-blade,287,druid,feral,18,3,15
8113,Pleomorpher,quelthalas,286,druid,feral,6,3,3
8114,Psychosis,kul-tiras,285,druid,feral,12,3,9
8115,Wardruidkvn,stormreaver,285,druid,feral,12,3,9
8116,Mightymërlin,stormrage,255,druid,feral,11,3,8
8117,Punderful,stormrage,254,druid,feral,10,4,6
8118,Trippykitty,tichondrius,240,druid,feral,9,3,6
8119,Yámï,stormrage,239,druid,feral,5,3,2
8120,Centimoose,area-52,234,druid,feral,7,4,3
8121,Pél,tichondrius,223,druid,feral,8,3,5
8122,Worldly,medivh,223,druid,feral,14,3,11
8123,Puiltraxs,ragnaros,192,druid,feral,4,3,1
8124,Feraldudu,illidan,192,druid,feral,4,3,1
8125,Catmóm,tichondrius,192,druid,feral,6,2,4
8126,Slimh,stormrage,192,druid,feral,6,2,4
8127,Dreadonly,tichondrius,192,druid,feral,6,2,4
8128,Taztoc,stormrage,192,druid,feral,6,2,4
8129,Pwoons,tichondrius,192,druid,feral,6,2,4
8130,Elmachina,tichondrius,192,druid,feral,6,2,4
8131,Numbkin,stormrage,192,druid,feral,6,2,4
8132,Tigerbalm,tichondrius,192,druid,feral,6,2,4
8133,Asmondruud,tichondrius,192,druid,feral,6,2,4
8134,Stolenrims,tichondrius,192,druid,feral,6,2,4
8135,Lavanca,azralon,192,druid,feral,6,2,4
8136,Omgapuddycat,stormrage,192,druid,feral,6,2,4
8137,Samsaralol,tichondrius,192,druid,feral,6,2,4
8138,Dankbite,doomhammer,192,druid,feral,6,2,4
8139,Metaldruid,tichondrius,192,druid,feral,6,2,4
8140,Teancookies,tichondrius,192,druid,feral,6,2,4
8141,ßleepßloop,tichondrius,192,druid,feral,6,2,4
8142,Evantheomni,tichondrius,192,druid,feral,6,2,4
8143,Apace,stonemaul,192,druid,feral,6,2,4
8144,Haegur,tichondrius,192,druid,feral,6,2,4
8145,Basichoe,bleeding-hollow,192,druid,feral,6,2,4
8146,Perlek,bleeding-hollow,192,druid,feral,6,2,4
8147,Fødaødruida,azralon,192,druid,feral,6,2,4
8148,Laymonath,elune,192,druid,feral,6,2,4
8149,Driftwood,bonechewer,192,druid,feral,6,2,4
8150,Prosperz,dalaran,192,druid,feral,6,2,4
8151,Thalerosa,tichondrius,192,druid,feral,6,2,4
8152,Majdomoterry,proudmoore,192,druid,feral,6,2,4
8153,Estuvez,twisting-nether,192,druid,feral,6,2,4
8154,Tauretari,tichondrius,192,druid,feral,6,2,4
8155,Pusscat,illidan,192,druid,feral,6,2,4
8156,Lemonnz,illidan,192,druid,feral,6,2,4
8157,Rigotakz,illidan,192,druid,feral,6,2,4
8158,Nabious,malganis,192,druid,feral,6,2,4
8159,Sadsex,illidan,192,druid,feral,6,2,4
8160,Robbieshift,emerald-dream,192,druid,feral,6,2,4
8161,Fulmerethine,emerald-dream,192,druid,feral,6,2,4
8162,Handolar,quelthalas,192,druid,feral,6,2,4
8163,Hotsoncrak,tichondrius,192,druid,feral,6,2,4
8164,Augus,hyjal,192,druid,feral,6,2,4
8165,Bdsurges,illidan,192,druid,feral,6,2,4
8166,Hehaw,kelthuzad,192,druid,feral,6,2,4
8167,Kanadae,thrall,192,druid,feral,6,2,4
8168,Apocalyptoe,proudmoore,192,druid,feral,6,2,4
8169,Klawzy,thrall,192,druid,feral,6,2,4
8170,Meaningfully,kelthuzad,192,druid,feral,6,2,4
8171,Lóríen,thrall,192,druid,feral,6,2,4
8172,Aethorax,hyjal,192,druid,feral,6,2,4
8173,Theliono,lightnings-blade,192,druid,feral,6,2,4
8174,Kikothecat,burning-blade,192,druid,feral,6,2,4
8175,Aurajin,spinebreaker,192,druid,feral,6,2,4
8176,Illr,laughing-skull,192,druid,feral,6,2,4
8177,Vctrphs,nemesis,192,druid,feral,6,2,4
8178,Anudi,whisperwind,192,druid,feral,6,2,4
8179,Therooster,whisperwind,192,druid,feral,6,2,4
8180,Ðjango,goldrinn,192,druid,feral,6,2,4
8181,Milezy,area-52,192,druid,feral,6,2,4
8182,Manwool,illidan,192,druid,feral,6,2,4
8183,Buyadoge,area-52,192,druid,feral,6,2,4
8184,Nyanyahoshi,proudmoore,192,druid,feral,6,2,4
8185,Snupy,area-52,192,druid,feral,6,2,4
8186,Aleksandér,ragnaros,192,druid,feral,6,2,4
8187,Uphine,area-52,192,druid,feral,6,2,4
8188,Varietypack,antonidas,192,druid,feral,6,2,4
8189,Karpin,area-52,192,druid,feral,6,2,4
8190,Timdillon,emerald-dream,192,druid,feral,6,2,4
8191,Nakte,area-52,192,druid,feral,6,2,4
8192,Keithmoonkin,area-52,192,druid,feral,6,2,4
8193,Shinoßi,area-52,192,druid,feral,6,2,4
8194,Kurakai,runetotem,192,druid,feral,6,2,4
8195,Lilstuped,tichondrius,192,druid,feral,6,2,4
8196,Yépp,sargeras,192,druid,feral,6,2,4
8197,Kai,spirestone,192,druid,feral,6,2,4
8198,Athious,moon-guard,192,druid,feral,6,2,4
8199,Evolute,sargeras,192,druid,feral,6,2,4
8200,Tilly,malorne,192,druid,feral,6,2,4
8201,Barrah,barthilas,192,druid,feral,6,2,4
8202,Vivinara,moon-guard,192,druid,feral,6,2,4
8203,Geno,cenarius,192,druid,feral,6,2,4
8204,Tedrithal,moon-guard,192,druid,feral,6,2,4
8205,Eliaris,rivendare,192,druid,feral,6,2,4
8206,Pawblems,sargeras,192,druid,feral,6,2,4
8207,Touchmyroot,frostmourne,192,druid,feral,6,2,4
8208,Hännibal,hydraxis,192,druid,feral,6,2,4
8209,Loadie,frostmourne,192,druid,feral,6,2,4
8210,Ikova,frostmourne,192,druid,feral,6,2,4
8211,Theliverklng,sargeras,192,druid,feral,6,2,4
8212,Bullbuddy,wyrmrest-accord,192,druid,feral,6,2,4
8213,Sunmoons,hydraxis,192,druid,feral,6,2,4
8214,Wreckked,sargeras,192,druid,feral,6,2,4
8215,Pecopeco,sargeras,192,druid,feral,6,2,4
8216,Katskratch,sargeras,192,druid,feral,6,2,4
8217,Unclebolty,frostmourne,192,druid,feral,6,2,4
8218,Rizzit,wyrmrest-accord,192,druid,feral,6,2,4
8219,Envasions,emerald-dream,192,druid,feral,12,2,10
8220,Àcid,stormreaver,192,druid,feral,12,2,10
8221,Drabo,boulderfist,192,druid,feral,12,2,10
8222,Èlunë,andorhal,192,druid,feral,12,2,10
8223,Nerfdemo,kiljaeden,192,druid,feral,12,2,10
8224,Moosesolini,chogall,192,druid,feral,12,2,10
8225,Faroo,azralon,192,druid,feral,12,2,10
8226,Seyala,moon-guard,192,druid,feral,12,2,10
8227,Happyc,bleeding-hollow,192,druid,feral,12,2,10
8228,Abene,tichondrius,192,druid,feral,12,2,10
8229,Ymirgore,zuljin,192,druid,feral,12,2,10
8230,Noktua,moon-guard,192,druid,feral,12,2,10
8231,Feathersnow,moon-guard,192,druid,feral,12,2,10
8232,Codieneme,blades-edge,192,druid,feral,12,2,10
8233,Acórn,frostmourne,192,druid,feral,12,2,10
8234,Pawz,windrunner,192,druid,feral,12,2,10
8235,Chaurli,hyjal,192,druid,feral,12,2,10
8236,Shadedmika,zuljin,192,druid,feral,12,2,10
8237,Meudayr,crushridge,192,druid,feral,12,2,10
8238,Jaydaprophet,azshara,192,druid,feral,12,2,10
8239,Alagorn,zangarmarsh,192,druid,feral,18,2,16
8240,Rorhenn,moon-guard,192,druid,feral,18,2,16
8241,Boomanon,illidan,191,druid,feral,6,2,4
8242,Importedalc,zuljin,191,druid,feral,12,2,10
8243,Baanell,kiljaeden,191,druid,feral,12,2,10
8244,Maxsonmaximo,sargeras,191,druid,feral,12,2,10
8245,Liightbite,illidan,191,druid,feral,12,2,10
8246,Blackcatvibe,sargeras,191,druid,feral,12,2,10
8247,Scaryy,kelthuzad,160,druid,feral,10,2,8
8248,Bowbaggins,bleeding-hollow,159,druid,feral,5,2,3
8249,Jdoozie,bleeding-hollow,159,druid,feral,5,2,3
8250,Kipsmiffly,darkspear,128,druid,feral,4,2,2
8251,Änimorph,emerald-dream,127,druid,feral,4,2,2
8252,Dobrman,sargeras,127,druid,feral,8,2,6
8253,Feles,darkspear,96,druid,feral,3,2,1
8254,Jumpjumpcat,tichondrius,96,druid,feral,3,2,1
8255,Slep,tichondrius,96,druid,feral,6,1,5
8256,Gamerdaddydd,tichondrius,96,druid,feral,6,1,5
8257,Kî,thunderlord,96,druid,feral,6,1,5
8258,Ciggy,maiev,96,druid,feral,6,1,5
8259,Feralhefty,stormrage,96,druid,feral,6,1,5
8260,Yungle,tichondrius,96,druid,feral,6,1,5
8261,Raigor,azralon,96,druid,feral,6,1,5
8262,Valdr,stormrage,96,druid,feral,6,1,5
8263,Shisha,mannoroth,96,druid,feral,6,1,5
8264,Terminated,tichondrius,96,druid,feral,6,1,5
8265,Yeyee,darkspear,96,druid,feral,6,1,5
8266,Kaldelar,emerald-dream,96,druid,feral,6,1,5
8267,Remeta,tichondrius,96,druid,feral,6,1,5
8268,Ottoro,azralon,96,druid,feral,6,1,5
8269,Whiplash,deathwing,96,druid,feral,6,1,5
8270,Gretatunberg,skywall,96,druid,feral,6,1,5
8271,Aigo,azralon,96,druid,feral,6,1,5
8272,Eurth,lightbringer,96,druid,feral,6,1,5
8273,Tuskdaddie,sargeras,96,druid,feral,6,1,5
8274,Shinova,darkspear,96,druid,feral,6,1,5
8275,Thebigcat,deathwing,96,druid,feral,6,1,5
8276,Yarmel,kaelthas,96,druid,feral,6,1,5
8277,Scarymon,tichondrius,96,druid,feral,6,1,5
8278,Lulerz,cenarius,96,druid,feral,6,1,5
8279,Samedo,sargeras,96,druid,feral,6,1,5
8280,Morizo,proudmoore,96,druid,feral,6,1,5
8281,Jawsbee,emerald-dream,96,druid,feral,6,1,5
8282,Roldanspet,sargeras,96,druid,feral,6,1,5
8283,Deelark,skywall,96,druid,feral,6,1,5
8284,Wreckingcrew,emerald-dream,96,druid,feral,6,1,5
8285,Droupy,proudmoore,96,druid,feral,6,1,5
8286,Gúdru,zuljin,96,druid,feral,6,1,5
8287,Avorah,tichondrius,96,druid,feral,6,1,5
8288,Doomkin,demon-soul,96,druid,feral,6,1,5
8289,Lakroz,zuljin,96,druid,feral,6,1,5
8290,Wodbisxpac,sargeras,96,druid,feral,6,1,5
8291,Crazypaddy,dark-iron,96,druid,feral,6,1,5
8292,Kagran,haomarush,96,druid,feral,6,1,5
8293,Captclaws,tichondrius,96,druid,feral,6,1,5
8294,Polyproof,emerald-dream,96,druid,feral,6,1,5
8295,Kelylea,the-underbog,96,druid,feral,6,1,5
8296,Noemofu,barthilas,96,druid,feral,6,1,5
8297,Scizor,lightninghoof,96,druid,feral,6,1,5
8298,Crowaar,moon-guard,96,druid,feral,6,1,5
8299,Ghostboy,zuljin,96,druid,feral,6,1,5
8300,Édzar,area-52,96,druid,feral,6,1,5
8301,Lithrian,stormrage,96,druid,feral,6,1,5
8302,Hynz,barthilas,96,druid,feral,6,1,5
8303,Ticømia,stormrage,96,druid,feral,6,1,5
8304,Harlisu,stormrage,96,druid,feral,6,1,5
8305,Krawnk,zuljin,96,druid,feral,6,1,5
8306,Sweetiefoxx,tichondrius,96,druid,feral,6,1,5
8307,Fuzzwuzzyqt,tichondrius,96,druid,feral,6,1,5
8308,Yuandi,tichondrius,96,druid,feral,6,1,5
8309,Shréd,blades-edge,96,druid,feral,6,1,5
8310,Ojira,moon-guard,96,druid,feral,6,1,5
8311,Garcia,feathermoon,96,druid,feral,6,1,5
8312,Battledruid,nagrand,96,druid,feral,6,1,5
8313,Guy,drakthul,96,druid,feral,6,1,5
8314,Ilikedôggy,saurfang,96,druid,feral,6,1,5
8315,Laynahri,moon-guard,96,druid,feral,6,1,5
8316,Shlümp,tichondrius,96,druid,feral,6,1,5
8317,Frëýá,bleeding-hollow,96,druid,feral,6,1,5
8318,Spacex,amanthul,96,druid,feral,6,1,5
8319,Purpyo,bleeding-hollow,96,druid,feral,6,1,5
8320,Alope,blades-edge,96,druid,feral,6,1,5
8321,Ahnsuk,bleeding-hollow,96,druid,feral,6,1,5
8322,Ärianagrande,stormrage,96,druid,feral,6,1,5
8323,Symbiøsis,zuljin,96,druid,feral,6,1,5
8324,Ban,chogall,96,druid,feral,6,1,5
8325,Healthy,auchindoun,96,druid,feral,6,1,5
8326,Vernaar,laughing-skull,96,druid,feral,6,1,5
8327,Glorp,blackwater-raiders,96,druid,feral,6,1,5
8328,Asaptom,frostmourne,96,druid,feral,6,1,5
8329,Furricane,ysondre,96,druid,feral,6,1,5
8330,Nyatarii,hakkar,96,druid,feral,6,1,5
8331,Furrycon,ysera,96,druid,feral,6,1,5
8332,Dotsgallore,garrosh,96,druid,feral,6,1,5
8333,Droody,earthen-ring,96,druid,feral,6,1,5
8334,Hasemilë,dalaran,96,druid,feral,6,1,5
8335,Mootality,area-52,96,druid,feral,6,1,5
8336,Shortskate,area-52,96,druid,feral,6,1,5
8337,Naztekk,dalaran,96,druid,feral,6,1,5
8338,Boundless,skullcrusher,96,druid,feral,6,1,5
8339,Barnabie,black-dragonflight,96,druid,feral,6,1,5
8340,Thonarian,vashj,96,druid,feral,6,1,5
8341,Fortunecat,illidan,96,druid,feral,6,1,5
8342,Nezrael,frostwolf,96,druid,feral,6,1,5
8343,Bootzs,kelthuzad,96,druid,feral,6,1,5
8344,Ashmíla,ragnaros,96,druid,feral,6,1,5
8345,Arôn,stormreaver,96,druid,feral,6,1,5
8346,Chumdrumrum,malganis,96,druid,feral,6,1,5
8347,Dééz,illidan,96,druid,feral,6,1,5
8348,Ballinthree,illidan,96,druid,feral,6,1,5
8349,Tartin,dragonmaw,96,druid,feral,6,1,5
8350,Colinferal,thrall,96,druid,feral,6,1,5
8351,Spunj,frostmourne,96,druid,feral,6,1,5
8352,Ausbie,garona,96,druid,feral,6,1,5
8353,Swippy,blackhand,96,druid,feral,6,1,5
8354,Byefren,darkspear,96,druid,feral,7,1,6
8355,Kâtniss,quelthalas,96,druid,feral,8,1,7
8356,Habras,alterac-mountains,96,druid,feral,12,1,11
8357,Backlazsh,illidan,96,druid,feral,12,1,11
8358,Ballsnack,zuljin,96,druid,feral,12,1,11
8359,Lonewolfdrd,illidan,96,druid,feral,12,1,11
8360,Owlcapwn,tichondrius,96,druid,feral,12,1,11
8361,Donkeepunch,archimonde,96,druid,feral,12,1,11
8362,Shawdoostorm,nemesis,96,druid,feral,12,1,11
8363,Versipex,emerald-dream,96,druid,feral,12,1,11
8364,Grovestalker,nemesis,96,druid,feral,12,1,11
8365,Wonderclam,sargeras,96,druid,feral,18,1,17
8366,Furiøsä,quelthalas,95,druid,feral,6,1,5
8367,Skwidrific,crushridge,95,druid,feral,12,1,11
8368,Gordisimo,sargeras,79,druid,feral,5,1,4
8369,Gitsnshigles,frostmourne,79,druid,feral,5,1,4
8370,Ebrìthil,hyjal,58,druid,feral,10,3,7
8371,Chubakea,kiljaeden,48,druid,feral,3,1,2
8372,Qouro,area-52,42,druid,feral,6,2,4
8373,Shiftwork,korgath,42,druid,feral,10,2,8
8374,Enderhero,illidan,42,druid,feral,14,2,12
8375,Ânhur,tichondrius,42,druid,feral,17,2,15
8376,Veloon,laughing-skull,41,druid,feral,8,3,5
8377,Mooncow,dalaran,31,druid,feral,2,1,1
8378,Wägÿü,tichondrius,31,druid,feral,2,1,1
8379,Laryfsherman,tichondrius,2324,druid,balance,83,54,29
8380,Aqulaíssaela,sargeras,2296,druid,balance,119,67,52
8381,Supatease,tichondrius,2293,druid,balance,147,84,63
8382,Hessenmèow,tichondrius,2279,druid,balance,102,57,45
8383,Xijînping,tichondrius,2275,druid,balance,104,62,42
8384,Jbz,balnazzar,2269,druid,balance,201,128,73
8385,Sonicphantom,kelthuzad,2267,druid,balance,174,104,70
8386,Owl,shadowsong,2261,druid,balance,120,69,51
8387,Fredagn,illidan,2253,druid,balance,126,73,53
8388,Soggykfc,illidan,2247,druid,balance,196,110,86
8389,Solareclipse,tichondrius,2242,druid,balance,89,51,38
8390,Catworm,sargeras,2211,druid,balance,130,80,50
8391,Flapz,illidan,2210,druid,balance,119,61,58
8392,Cti,tichondrius,2204,druid,balance,59,42,17
8393,Theforeigner,arathor,2194,druid,balance,59,46,13
8394,Gugukuaipao,tichondrius,2186,druid,balance,155,83,72
8395,Flowerboï,azralon,2180,druid,balance,96,69,27
8396,Bkqtpie,tichondrius,2176,druid,balance,106,59,47
8397,Legionsucks,tanaris,2156,druid,balance,168,90,78
8398,Impëria,quelthalas,2137,druid,balance,89,58,31
8399,Altoberano,azralon,2136,druid,balance,95,53,42
8400,Mewfasa,duskwood,2135,druid,balance,147,94,53
8401,Jimmypop,malganis,2135,druid,balance,181,103,78
8402,Houli,tichondrius,2134,druid,balance,96,50,46
8403,Ratspot,stormrage,2133,druid,balance,66,43,23
8404,Napes,tichondrius,2133,druid,balance,84,45,39
8405,Smëagol,zuljin,2133,druid,balance,114,59,55
8406,Nbadizzyboy,illidan,2130,druid,balance,53,43,10
8407,Celtaberano,illidan,2129,druid,balance,96,62,34
8408,Tanerno,illidan,2128,druid,balance,141,79,62
8409,Peterßigßeam,malganis,2127,druid,balance,117,60,57
8410,Elythria,hellscream,2125,druid,balance,48,42,6
8411,Firefirelol,proudmoore,2125,druid,balance,131,65,66
8412,Pisces,emerald-dream,2123,druid,balance,128,75,53
8413,Gspx,dalaran,2123,druid,balance,66,35,31
8414,Pushpop,frostmourne,2120,druid,balance,89,55,34
8415,Kidcudi,dentarg,2119,druid,balance,251,128,123
8416,Tranquilo,stormrage,2118,druid,balance,114,69,45
8417,Riskies,tichondrius,2116,druid,balance,252,133,119
8418,Brose,malganis,2115,druid,balance,66,43,23
8419,Babekisser,stormrage,2115,druid,balance,317,178,139
8420,Murkeÿ,frostmourne,2114,druid,balance,150,75,75
8421,Fergh,tichondrius,2109,druid,balance,83,45,38
8422,Spamclonewin,tichondrius,2107,druid,balance,177,106,71
8423,Trusyrusty,stormrage,2107,druid,balance,151,83,68
8424,Gritzxv,stormrage,2105,druid,balance,83,48,35
8425,Sqwippyd,tichondrius,2102,druid,balance,78,49,29
8426,Bigdiablo,frostmourne,2096,druid,balance,231,125,106
8427,Wnxmomthicc,tichondrius,2094,druid,balance,54,35,19
8428,Suen,tichondrius,2084,druid,balance,86,55,31
8429,Biophilic,moon-guard,2083,druid,balance,159,83,76
8430,Mortqt,tichondrius,2068,druid,balance,78,44,34
8431,Vertderferk,tichondrius,2065,druid,balance,86,50,36
8432,Treirus,sargeras,2064,druid,balance,142,96,46
8433,Hayase,tichondrius,2063,druid,balance,132,77,55
8434,Notes,sargeras,2062,druid,balance,158,76,82
8435,Boomçhicken,tichondrius,2056,druid,balance,112,58,54
8436,Sebastian,tichondrius,2054,druid,balance,83,52,31
8437,Houlix,stormrage,2048,druid,balance,372,184,188
8438,Dogwáter,tichondrius,2047,druid,balance,94,55,39
8439,John,azralon,2040,druid,balance,168,84,84
8440,Vengexd,sargeras,2031,druid,balance,55,38,17
8441,Locose,black-dragonflight,2029,druid,balance,60,42,18
8442,Kaid,malganis,2029,druid,balance,72,43,29
8443,Soulz,quelthalas,2026,druid,balance,96,53,43
8444,Ertuzi,tichondrius,2025,druid,balance,161,90,71
8445,Etherêal,stormrage,2024,druid,balance,132,78,54
8446,Megadruidx,stormrage,2022,druid,balance,81,55,26
8447,Lgpepperoni,tichondrius,2020,druid,balance,54,47,7
8448,Tygraz,alleria,2019,druid,balance,96,61,35
8449,Compléx,tichondrius,2016,druid,balance,78,41,37
8450,Boomkek,wyrmrest-accord,2014,druid,balance,62,40,22
8451,Ztraws,tichondrius,2013,druid,balance,112,70,42
8452,Hxzard,dalaran,2013,druid,balance,193,109,84
8453,Xantastic,area-52,2013,druid,balance,96,45,51
8454,Nokomanida,zuljin,2011,druid,balance,97,55,42
8455,Starfail,illidan,2009,druid,balance,66,32,34
8456,Tòmathy,tichondrius,2007,druid,balance,83,46,37
8457,Lazygaga,zuljin,2004,druid,balance,170,89,81
8458,Dízzen,bleeding-hollow,2003,druid,balance,108,62,46
8459,Snöwghost,aerie-peak,2000,druid,balance,227,118,109
8460,Bobthehefty,area-52,1999,druid,balance,64,38,26
8461,Balancex,tichondrius,1999,druid,balance,138,65,73
8462,Bables,tichondrius,1998,druid,balance,96,61,35
8463,Akuladonfana,tichondrius,1996,druid,balance,30,26,4
8464,Fhormations,area-52,1994,druid,balance,137,77,60
8465,Thugrose,blackrock,1993,druid,balance,54,28,26
8466,Lavlol,frostmourne,1992,druid,balance,394,205,189
8467,Lazershartz,cenarion-circle,1992,druid,balance,72,36,36
8468,Jaseyxxl,area-52,1989,druid,balance,58,41,17
8469,Catculator,tichondrius,1989,druid,balance,130,80,50
8470,Zneb,darkspear,1987,druid,balance,36,29,7
8471,Omends,thrall,1987,druid,balance,128,68,60
8472,Boyoboy,thrall,1985,druid,balance,42,29,13
8473,Burninmoon,tichondrius,1982,druid,balance,87,51,36
8474,Fracxx,area-52,1981,druid,balance,30,21,9
8475,Cultnelf,illidan,1976,druid,balance,131,69,62
8476,Uhnoheals,tichondrius,1974,druid,balance,68,41,27
8477,Mõoõoõoõoõoõ,tichondrius,1973,druid,balance,81,43,38
8478,Komacine,emerald-dream,1965,druid,balance,505,273,232
8479,Feralgo,tichondrius,1960,druid,balance,69,43,26
8480,Instar,tichondrius,1960,druid,balance,48,27,21
8481,Lazersnewch,kelthuzad,1955,druid,balance,78,44,34
8482,Geezbutt,tichondrius,1954,druid,balance,229,119,110
8483,Byk,tichondrius,1952,druid,balance,108,62,46
8484,Ezgamed,tichondrius,1950,druid,balance,69,46,23
8485,Ballinthree,illidan,1947,druid,balance,60,43,17
8486,Daspdruid,nagrand,1944,druid,balance,308,157,151
8487,Basedcatx,tichondrius,1940,druid,balance,82,52,30
8488,Murruk,darkspear,1936,druid,balance,159,86,73
8489,Toughshift,zuljin,1936,druid,balance,66,28,38
8490,Giantpanther,tichondrius,1932,druid,balance,132,76,56
8491,Pønchø,quelthalas,1931,druid,balance,86,47,39
8492,Wereocelot,firetree,1930,druid,balance,173,99,74
8493,Lovemakitty,sargeras,1922,druid,balance,78,46,32
8494,Davo,tichondrius,1920,druid,balance,148,91,57
8495,Mcv,tichondrius,1917,druid,balance,72,41,31
8496,Elyveen,proudmoore,1913,druid,balance,110,79,31
8497,Herpadruid,illidan,1912,druid,balance,102,48,54
8498,Treeheehee,frostmourne,1911,druid,balance,81,60,21
8499,Acdru,tichondrius,1911,druid,balance,67,37,30
8500,Chiikawa,tichondrius,1909,druid,balance,102,52,50
8501,Dilondru,area-52,1906,druid,balance,117,70,47
8502,Beefnudlsoup,tichondrius,1906,druid,balance,66,39,27
8503,Alpine,eldrethalas,1904,druid,balance,66,45,21
8504,Starbränd,azralon,1904,druid,balance,90,57,33
8505,Vengex,sargeras,1904,druid,balance,48,30,18
8506,Doomty,tichondrius,1904,druid,balance,90,53,37
8507,Dorizio,illidan,1902,druid,balance,82,49,33
8508,Fifty,ragnaros,1902,druid,balance,132,78,54
8509,Pigdd,tichondrius,1900,druid,balance,40,27,13
8510,Knotgiver,moon-guard,1899,druid,balance,52,31,21
8511,Lakermagik,moknathal,1899,druid,balance,61,36,25
8512,Johnieboy,azralon,1896,druid,balance,51,35,16
8513,Jakob,arygos,1895,druid,balance,168,94,74
8514,Oakwalker,moon-guard,1895,druid,balance,120,64,56
8515,Halrath,sargeras,1891,druid,balance,36,20,16
8516,Cousa,zuljin,1890,druid,balance,200,110,90
8517,Hogd,illidan,1884,druid,balance,66,38,28
8518,Druidstin,tichondrius,1883,druid,balance,66,33,33
8519,Hefkerd,tichondrius,1881,druid,balance,30,20,10
8520,Ethan,the-venture-co,1879,druid,balance,39,26,13
8521,Jojo,ysera,1879,druid,balance,148,81,67
8522,Jayelljaÿ,thrall,1874,druid,balance,141,83,58
8523,Çørrúptíøñzx,tichondrius,1873,druid,balance,42,31,11
8524,Purkins,barthilas,1872,druid,balance,47,30,17
8525,Psychotycxd,tichondrius,1870,druid,balance,126,69,57
8526,Çoach,tichondrius,1870,druid,balance,111,60,51
8527,Owlyfans,frostmourne,1869,druid,balance,60,39,21
8528,Crusch,shattered-halls,1869,druid,balance,36,23,13
8529,Sadboy,moon-guard,1869,druid,balance,167,90,77
8530,Fgsb,sargeras,1868,druid,balance,42,30,12
8531,Ràjeesh,frostmourne,1867,druid,balance,46,31,15
8532,Möshinòõb,proudmoore,1865,druid,balance,58,40,18
8533,Sarvi,zuljin,1864,druid,balance,33,24,9
8534,Astraldank,tichondrius,1863,druid,balance,166,90,76
8535,Vuru,azralon,1862,druid,balance,47,32,15
8536,Vernaar,laughing-skull,1862,druid,balance,114,61,53
8537,Nickyü,ragnaros,1862,druid,balance,90,48,42
8538,Djayolo,illidan,1861,druid,balance,66,46,20
8539,Nåpes,frostmourne,1861,druid,balance,62,31,31
8540,Fidgy,tichondrius,1858,druid,balance,36,29,7
8541,Yevenbother,tichondrius,1858,druid,balance,42,27,15
8542,Poliage,moon-guard,1858,druid,balance,155,89,66
8543,Yepz,tichondrius,1858,druid,balance,117,60,57
8544,Convokeopp,tichondrius,1856,druid,balance,149,78,71
8545,Lilbeam,sargeras,1855,druid,balance,42,27,15
8546,Ericzzdd,tichondrius,1854,druid,balance,60,44,16
8547,Thundoon,tichondrius,1854,druid,balance,36,23,13
8548,Daifuku,illidan,1854,druid,balance,54,32,22
8549,Beamed,thrall,1852,druid,balance,36,27,9
8550,Rizzit,wyrmrest-accord,1852,druid,balance,58,32,26
8551,Angryjo,tichondrius,1850,druid,balance,64,38,26
8552,Kyura,sargeras,1848,druid,balance,160,82,78
8553,Swaggu,kelthuzad,1847,druid,balance,72,44,28
8554,Deenut,sargeras,1847,druid,balance,66,40,26
8555,Irooftrellen,chogall,1847,druid,balance,107,59,48
8556,Foekinghobo,sargeras,1845,druid,balance,150,81,69
8557,Idolizeme,skullcrusher,1845,druid,balance,59,30,29
8558,Laser,bonechewer,1844,druid,balance,42,27,15
8559,Judar,barthilas,1844,druid,balance,71,36,35
8560,Johnnybeach,tichondrius,1842,druid,balance,49,34,15
8561,Pils,nemesis,1841,druid,balance,154,94,60
8562,Dreveron,bleeding-hollow,1840,druid,balance,72,36,36
8563,Lazerbeamz,tichondrius,1837,druid,balance,126,69,57
8564,Soar,destromath,1836,druid,balance,129,78,51
8565,Gèb,dalaran,1835,druid,balance,116,71,45
8566,Mverstapp,moon-guard,1835,druid,balance,54,28,26
8567,Elunegoddess,tichondrius,1834,druid,balance,46,27,19
8568,Formhub,malganis,1834,druid,balance,84,42,42
8569,Exxh,tichondrius,1833,druid,balance,58,41,17
8570,Moonflora,stormrage,1833,druid,balance,129,73,56
8571,Girthybeam,sargeras,1833,druid,balance,62,32,30
8572,Sawsaw,bleeding-hollow,1832,druid,balance,74,42,32
8573,Animlcracker,emerald-dream,1831,druid,balance,96,63,33
8574,Komaner,frostmourne,1831,druid,balance,66,32,34
8575,Ilovediegoxo,kelthuzad,1830,druid,balance,48,32,16
8576,Deloria,nemesis,1829,druid,balance,42,25,17
8577,Dontnerfmore,queldorei,1829,druid,balance,66,31,35
8578,Moozzash,azralon,1828,druid,balance,54,32,22
8579,Chernovax,kelthuzad,1828,druid,balance,87,47,40
8580,Bubalolz,quelthalas,1828,druid,balance,209,107,102
8581,Equinøxx,malganis,1827,druid,balance,47,30,17
8582,Evsn,tichondrius,1826,druid,balance,36,28,8
8583,Goochies,aerie-peak,1826,druid,balance,59,35,24
8584,Bcup,sargeras,1826,druid,balance,54,32,22
8585,Lekick,tichondrius,1826,druid,balance,72,40,32
8586,Oungan,illidan,1823,druid,balance,140,79,61
8587,Ebrìthil,hyjal,1823,druid,balance,96,50,46
8588,Clonemunster,frostmourne,1821,druid,balance,66,38,28
8589,Ilovediego,stormrage,1820,druid,balance,42,27,15
8590,Fleasy,wyrmrest-accord,1820,druid,balance,85,52,33
8591,Lunalai,bloodhoof,1820,druid,balance,96,55,41
8592,Kydro,sargeras,1820,druid,balance,80,44,36
8593,Catpoop,frostmourne,1819,druid,balance,54,37,17
8594,Sweatypapa,tichondrius,1819,druid,balance,126,82,44
8595,Dipii,proudmoore,1818,druid,balance,30,22,8
8596,Resorange,malganis,1818,druid,balance,48,29,19
8597,Partylord,malganis,1818,druid,balance,144,81,63
8598,Sueycide,tichondrius,1818,druid,balance,83,40,43
8599,Dorlingus,tichondrius,1817,druid,balance,48,29,19
8600,Rìniroo,area-52,1816,druid,balance,48,30,18
8601,Tratean,tichondrius,1816,druid,balance,90,53,37
8602,Xenny,chogall,1815,druid,balance,48,34,14
8603,Form,bleeding-hollow,1815,druid,balance,96,57,39
8604,Raïsin,moon-guard,1814,druid,balance,45,26,19
8605,Jacusias,stormrage,1814,druid,balance,188,102,86
8606,Bentøbøx,barthilas,1814,druid,balance,53,28,25
8607,Thatboiscrew,tichondrius,1813,druid,balance,104,74,30
8608,Haohomie,tichondrius,1813,druid,balance,78,52,26
8609,Animatronixz,area-52,1813,druid,balance,66,34,32
8610,Staystrongox,tichondrius,1812,druid,balance,82,51,31
8611,Donutdruid,illidan,1812,druid,balance,88,54,34
8612,Keylae,sargeras,1812,druid,balance,86,46,40
8613,Moongodx,stormrage,1811,druid,balance,36,26,10
8614,Kamero,tichondrius,1811,druid,balance,57,36,21
8615,Souress,shadowsong,1811,druid,balance,66,40,26
8616,Moonkay,tichondrius,1810,druid,balance,42,26,16
8617,Surfingbird,tichondrius,1810,druid,balance,236,143,93
8618,Likorit,azralon,1809,druid,balance,36,25,11
8619,Tôpdadwôrld,sargeras,1809,druid,balance,30,19,11
8620,Drcuy,ragnaros,1809,druid,balance,104,59,45
8621,Seyala,moon-guard,1809,druid,balance,175,99,76
8622,Kzinti,zuluhed,1809,druid,balance,113,60,53
8623,Ternkote,tichondrius,1808,druid,balance,36,24,12
8624,Smeow,zuljin,1808,druid,balance,146,82,64
8625,Wiredxd,illidan,1807,druid,balance,44,28,16
8626,Pào,tichondrius,1807,druid,balance,57,35,22
8627,Seilah,lightbringer,1807,druid,balance,54,30,24
8628,Sommerrays,kelthuzad,1807,druid,balance,90,47,43
8629,Cattdog,tichondrius,1806,druid,balance,82,55,27
8630,Dustydrx,area-52,1806,druid,balance,56,34,22
8631,Zeromoon,frostmourne,1806,druid,balance,59,29,30
8632,Harukai,azralon,1805,druid,balance,114,67,47
8633,Boomsquanch,emerald-dream,1804,druid,balance,54,32,22
8634,Bloomqt,tichondrius,1804,druid,balance,182,105,77
8635,Starsucceed,illidan,1804,druid,balance,48,25,23
8636,Xannê,tichondrius,1804,druid,balance,62,32,30
8637,Panansy,stormrage,1804,druid,balance,300,153,147
8638,Youngtree,tichondrius,1803,druid,balance,33,20,13
8639,Itachi,dragonmaw,1803,druid,balance,65,38,27
8640,Malfuria,tichondrius,1802,druid,balance,47,29,18
8641,Mythleaf,ragnaros,1802,druid,balance,120,70,50
8642,Enøsh,tichondrius,1802,druid,balance,102,52,50
8643,Felny,malganis,1802,druid,balance,54,26,28
8644,Buffjungle,tichondrius,1801,druid,balance,36,20,16
8645,Gordzak,illidan,1801,druid,balance,212,113,99
8646,Blazeikin,tichondrius,1801,druid,balance,75,39,36
8647,Treelah,tichondrius,1800,druid,balance,48,29,19
8648,Krahz,lightnings-blade,1800,druid,balance,415,219,196
8649,Rikishi,executus,1798,druid,balance,60,32,28
8650,Handhandb,tichondrius,1794,druid,balance,72,43,29
8651,Chal,illidan,1791,druid,balance,53,32,21
8652,Trollololkin,bleeding-hollow,1790,druid,balance,65,44,21
8653,Hypefull,tichondrius,1790,druid,balance,48,23,25
8654,Fungamezx,bleeding-hollow,1788,druid,balance,72,48,24
8655,Striix,ragnaros,1788,druid,balance,48,23,25
8656,Mittns,arthas,1787,druid,balance,42,26,16
8657,Krispz,area-52,1785,druid,balance,89,47,42
8658,Bunnykiss,tichondrius,1784,druid,balance,116,58,58
8659,Gsd,sargeras,1782,druid,balance,89,52,37
8660,Thottiie,hyjal,1782,druid,balance,66,38,28
8661,Chanimal,tichondrius,1781,druid,balance,60,40,20
8662,Drugdoer,tichondrius,1781,druid,balance,112,66,46
8663,Destromz,zuljin,1780,druid,balance,36,24,12
8664,Nasuu,bleeding-hollow,1780,druid,balance,125,76,49
8665,Ataraxie,illidan,1780,druid,balance,78,47,31
8666,Hydrahl,thrall,1779,druid,balance,78,44,34
8667,Thrage,sargeras,1777,druid,balance,60,36,24
8668,Lothail,windrunner,1777,druid,balance,95,52,43
8669,Fal,bloodscalp,1773,druid,balance,45,27,18
8670,Orollå,tichondrius,1771,druid,balance,50,29,21
8671,Boomybro,thrall,1768,druid,balance,140,84,56
8672,Davione,tichondrius,1767,druid,balance,64,37,27
8673,Dooruid,tichondrius,1766,druid,balance,71,38,33
8674,Olongjonsson,wyrmrest-accord,1766,druid,balance,36,19,17
8675,Nxf,sargeras,1764,druid,balance,59,33,26
8676,Lilkitty,tichondrius,1764,druid,balance,148,81,67
8677,Bathrobe,bloodscalp,1762,druid,balance,48,26,22
8678,Ailari,moon-guard,1761,druid,balance,91,52,39
8679,Bukkwild,stormrage,1759,druid,balance,72,50,22
8680,Líu,area-52,1757,druid,balance,102,63,39
8681,Daddyshift,proudmoore,1756,druid,balance,68,39,29
8682,Awguseon,proudmoore,1755,druid,balance,54,37,17
8683,Cocainebeär,tichondrius,1755,druid,balance,77,39,38
8684,Cynhawts,emerald-dream,1754,druid,balance,46,27,19
8685,Sappyroots,area-52,1754,druid,balance,36,19,17
8686,Gorgoncity,illidan,1753,druid,balance,34,19,15
8687,Threk,spirestone,1750,druid,balance,113,64,49
8688,Swayjizz,tichondrius,1750,druid,balance,114,64,50
8689,Deviperdruid,frostmourne,1748,druid,balance,51,35,16
8690,Jaxer,illidan,1747,druid,balance,129,77,52
8691,Bunnyes,tichondrius,1747,druid,balance,54,29,25
8692,Ottovonbird,tichondrius,1746,druid,balance,42,24,18
8693,Halenson,illidan,1745,druid,balance,82,45,37
8694,Mûû,tichondrius,1743,druid,balance,116,69,47
8695,Ayla,gorefiend,1741,druid,balance,47,30,17
8696,Sharialawl,stormreaver,1740,druid,balance,42,28,14
8697,Asenna,moon-guard,1740,druid,balance,35,19,16
8698,Bearyhallsjr,sargeras,1739,druid,balance,30,22,8
8699,Animaldoctor,illidan,1737,druid,balance,69,48,21
8700,Boome,blackrock,1737,druid,balance,168,94,74
8701,Whoopz,blackrock,1737,druid,balance,42,20,22
8702,Pizzaparties,tichondrius,1736,druid,balance,59,41,18
8703,Metroboomy,magtheridon,1736,druid,balance,80,44,36
8704,Kydralola,ragnaros,1735,druid,balance,36,21,15
8705,Weckxa,sargeras,1735,druid,balance,274,140,134
8706,Druidwhat,stormrage,1734,druid,balance,153,81,72
8707,Zoteqt,kelthuzad,1734,druid,balance,259,133,126
8708,Starz,arthas,1733,druid,balance,50,33,17
8709,Ghaal,tichondrius,1732,druid,balance,108,67,41
8710,Melloj,kelthuzad,1732,druid,balance,66,38,28
8711,Foxhoundlol,tichondrius,1731,druid,balance,78,48,30
8712,Jemima,auchindoun,1730,druid,balance,142,83,59
8713,Glickbear,illidan,1730,druid,balance,72,40,32
8714,Nyloke,kelthuzad,1729,druid,balance,66,44,22
8715,Choosegoose,area-52,1729,druid,balance,44,29,15
8716,Meowkit,blackrock,1729,druid,balance,54,35,19
8717,Wasabilol,tichondrius,1729,druid,balance,136,78,58
8718,Scene,frostmourne,1729,druid,balance,71,40,31
8719,Dextructive,tichondrius,1729,druid,balance,124,60,64
8720,Druidk,tichondrius,1729,druid,balance,90,43,47
8721,Cobal,goldrinn,1727,druid,balance,419,216,203
8722,Trapdoorboom,illidan,1726,druid,balance,96,51,45
8723,Sodapooping,azjolnerub,1725,druid,balance,156,93,63
8724,Stinkÿ,bleeding-hollow,1724,druid,balance,63,42,21
8725,Tinkeress,stormrage,1724,druid,balance,145,85,60
8726,Pipiwiwi,stormrage,1724,druid,balance,153,82,71
8727,Pannaxx,tichondrius,1723,druid,balance,36,24,12
8728,Brokenomega,area-52,1722,druid,balance,142,85,57
8729,Naakx,tichondrius,1722,druid,balance,52,30,22
8730,Bolthor,wyrmrest-accord,1721,druid,balance,108,58,50
8731,Wecksox,area-52,1721,druid,balance,246,119,127
8732,Wòót,stormreaver,1719,druid,balance,84,58,26
8733,Sahksi,lothar,1719,druid,balance,68,36,32
8734,Brainlessqt,tichondrius,1717,druid,balance,34,24,10
8735,Boosted,bloodscalp,1717,druid,balance,42,27,15
8736,Sym,zuljin,1716,druid,balance,30,19,11
8737,Droodaphobé,sargeras,1714,druid,balance,59,34,25
8738,Phurr,area-52,1714,druid,balance,60,34,26
8739,Cjæ,bleeding-hollow,1713,druid,balance,24,18,6
8740,Dànkness,frostwolf,1713,druid,balance,53,29,24
8741,Zils,bleeding-hollow,1713,druid,balance,55,29,26
8742,Frames,area-52,1712,druid,balance,89,45,44
8743,Nophysique,zuljin,1709,druid,balance,112,62,50
8744,Petruccius,nordrassil,1709,druid,balance,226,113,113
8745,Faerie,kaelthas,1708,druid,balance,82,44,38
8746,Slickitty,kelthuzad,1707,druid,balance,30,18,12
8747,Hateshinai,sargeras,1705,druid,balance,24,18,6
8748,Niroxic,frostmourne,1705,druid,balance,66,40,26
8749,Swiftroots,tichondrius,1705,druid,balance,36,21,15
8750,Yggdrasil,ravencrest,1705,druid,balance,54,29,25
8751,Myex,illidan,1703,druid,balance,54,36,18
8752,Mädnhairy,zuljin,1703,druid,balance,45,28,17
8753,Maligoz,nemesis,1703,druid,balance,95,49,46
8754,Rerob,aerie-peak,1702,druid,balance,50,26,24
8755,Doomdawn,sargeras,1701,druid,balance,123,65,58
8756,Comidru,tichondrius,1701,druid,balance,72,35,37
8757,Coompie,frostmourne,1700,druid,balance,24,19,5
8758,Delorík,illidan,1700,druid,balance,120,68,52
8759,Smeepy,bleeding-hollow,1700,druid,balance,48,26,22
8760,Binjuicex,frostmourne,1699,druid,balance,45,29,16
8761,Fätål,ysera,1699,druid,balance,72,45,27
8762,Chaossdruid,bleeding-hollow,1699,druid,balance,171,98,73
8763,Koratan,frostmourne,1699,druid,balance,53,28,25
8764,Themustafa,tichondrius,1698,druid,balance,48,31,17
8765,Quelarre,velen,1698,druid,balance,100,58,42
8766,Clarice,shattered-halls,1698,druid,balance,129,70,59
8767,Muunragery,illidan,1698,druid,balance,48,25,23
8768,Protagonist,zuluhed,1697,druid,balance,85,46,39
8769,Fancynut,kiljaeden,1697,druid,balance,80,42,38
8770,Tunaren,wyrmrest-accord,1696,druid,balance,42,21,21
8771,Boomfold,tichondrius,1696,druid,balance,36,18,18
8772,Chikinwing,illidan,1695,druid,balance,119,67,52
8773,Raquelitá,ragnaros,1694,druid,balance,28,19,9
8774,Muwudred,stormrage,1694,druid,balance,60,36,24
8775,Chengxiaopao,tichondrius,1693,druid,balance,44,29,15
8776,Glazinator,sargeras,1693,druid,balance,224,108,116
8777,Cyclone,darkspear,1693,druid,balance,48,21,27
8778,Sibby,barthilas,1691,druid,balance,90,48,42
8779,Meatbender,frostmourne,1691,druid,balance,110,55,55
8780,Boomybalboa,stormrage,1690,druid,balance,29,19,10
8781,Moonrg,stormrage,1689,druid,balance,66,35,31
8782,Reàsons,stormrage,1688,druid,balance,126,62,64
8783,Cirranis,moon-guard,1687,druid,balance,117,68,49
8784,Aule,frostmourne,1687,druid,balance,36,18,18
8785,Realmehji,wyrmrest-accord,1686,druid,balance,36,28,8
8786,Whodoüvoodoo,tichondrius,1686,druid,balance,30,21,9
8787,Kogas,hyjal,1686,druid,balance,44,28,16
8788,Spinach,moon-guard,1686,druid,balance,104,53,51
8789,Ripkinztko,stormrage,1685,druid,balance,24,19,5
8790,Aralix,zuljin,1684,druid,balance,184,101,83
8791,Chickenwings,ragnaros,1683,druid,balance,42,27,15
8792,Gwiffurry,tichondrius,1683,druid,balance,54,32,22
8793,Taurenasarus,area-52,1683,druid,balance,51,30,21
8794,Roofty,illidan,1681,druid,balance,34,22,12
8795,Stepbro,malorne,1681,druid,balance,240,133,107
8796,Cheezaygx,arthas,1680,druid,balance,30,18,12
8797,Dárách,malganis,1680,druid,balance,147,82,65
8798,Nurtures,sargeras,1680,druid,balance,60,33,27
8799,Readt,malganis,1680,druid,balance,204,109,95
8800,Justsidious,sargeras,1679,druid,balance,30,23,7
8801,Finkledurp,dalaran,1679,druid,balance,41,23,18
8802,Honeybeam,moon-guard,1679,druid,balance,72,36,36
8803,Realistik,kelthuzad,1678,druid,balance,60,39,21
8804,Ruthlessbro,sargeras,1677,druid,balance,85,45,40
8805,Abomasnow,turalyon,1675,druid,balance,60,35,25
8806,Cröòk,malganis,1675,druid,balance,48,24,24
8807,Ànìmàl,stormrage,1674,druid,balance,36,27,9
8808,Beamrooster,silvermoon,1672,druid,balance,50,33,17
8809,Oobuck,kilrogg,1672,druid,balance,36,23,13
8810,Pennytrate,barthilas,1672,druid,balance,110,60,50
8811,Buckwhêât,illidan,1672,druid,balance,76,36,40
8812,Mooseknukel,zuljin,1671,druid,balance,42,25,17
8813,Frostig,tichondrius,1670,druid,balance,36,22,14
8814,Lostnsauce,tichondrius,1669,druid,balance,60,43,17
8815,Boiledfrogs,zuljin,1669,druid,balance,30,19,11
8816,Softkiller,chogall,1669,druid,balance,72,44,28
8817,Mastabtw,illidan,1669,druid,balance,42,20,22
8818,Convoken,tichondrius,1668,druid,balance,52,29,23
8819,Halensen,illidan,1668,druid,balance,47,23,24
8820,Scurse,tichondrius,1667,druid,balance,114,60,54
8821,Wallower,malganis,1667,druid,balance,54,24,30
8822,Aethisra,moon-guard,1666,druid,balance,155,88,67
8823,Yipëë,moon-guard,1666,druid,balance,64,34,30
8824,Boattastic,terenas,1666,druid,balance,90,45,45
8825,Ðøomkinz,azjolnerub,1665,druid,balance,48,33,15
8826,Partybeast,malganis,1664,druid,balance,74,55,19
8827,Gumbawl,sargeras,1662,druid,balance,36,22,14
8828,Gallianö,frostmourne,1662,druid,balance,46,27,19
8829,Byte,ragnaros,1662,druid,balance,35,18,17
8830,Marutot,tichondrius,1660,druid,balance,42,30,12
8831,Gokki,zuljin,1660,druid,balance,77,53,24
8832,Spacedruidx,illidan,1659,druid,balance,91,49,42
8833,Maxspeed,tichondrius,1657,druid,balance,30,20,10
8834,Foafoa,illidan,1657,druid,balance,31,19,12
8835,Verbz,arthas,1656,druid,balance,54,26,28
8836,Entakkt,cenarius,1653,druid,balance,36,28,8
8837,Yazmawma,tichondrius,1653,druid,balance,42,24,18
8838,Aull,kelthuzad,1653,druid,balance,36,19,17
8839,Roar,moon-guard,1652,druid,balance,45,31,14
8840,Vergota,emerald-dream,1652,druid,balance,73,50,23
8841,Loudpax,zuljin,1652,druid,balance,53,36,17
8842,Renithen,trollbane,1652,druid,balance,42,28,14
8843,Înfamous,thrall,1652,druid,balance,36,24,12
8844,Starlyxo,malganis,1652,druid,balance,59,37,22
8845,Chernlyssayo,stormrage,1652,druid,balance,50,30,20
8846,Drmf,frostmourne,1652,druid,balance,42,25,17
8847,Ashstarfall,barthilas,1651,druid,balance,36,26,10
8848,Flapperz,sargeras,1651,druid,balance,92,45,47
8849,Druentia,tichondrius,1650,druid,balance,30,20,10
8850,Coldkill,burning-legion,1650,druid,balance,36,20,16
8851,Lyshani,thrall,1650,druid,balance,106,58,48
8852,Khryllx,tichondrius,1649,druid,balance,42,27,15
8853,Starsiee,drakkari,1649,druid,balance,59,27,32
8854,Rokk,baelgun,1648,druid,balance,122,73,49
8855,Nokitty,tichondrius,1647,druid,balance,48,37,11
8856,Yoglosmas,tichondrius,1647,druid,balance,48,32,16
8857,Epicworld,stormrage,1647,druid,balance,156,92,64
8858,Theboomkin,kelthuzad,1647,druid,balance,42,24,18
8859,Ironsightsdr,dalaran,1645,druid,balance,51,29,22
8860,Pankecito,ragnaros,1644,druid,balance,64,36,28
8861,Hennydru,dalaran,1644,druid,balance,36,20,16
8862,Midnitetoker,hyjal,1644,druid,balance,54,29,25
8863,Josepha,tichondrius,1643,druid,balance,30,20,10
8864,Wizdùm,frostmourne,1643,druid,balance,53,34,19
8865,Buckbumble,frostmourne,1643,druid,balance,72,45,27
8866,Convokeula,tichondrius,1643,druid,balance,132,76,56
8867,Rayzer,bleeding-hollow,1643,druid,balance,126,70,56
8868,Rezlur,tichondrius,1643,druid,balance,47,24,23
8869,Masan,burning-blade,1642,druid,balance,36,23,13
8870,Boomchickens,area-52,1642,druid,balance,60,33,27
8871,Knoxdog,illidan,1641,druid,balance,51,32,19
8872,Velyring,moon-guard,1641,druid,balance,79,46,33
8873,Irl,frostmane,1641,druid,balance,41,23,18
8874,Dcountts,area-52,1640,druid,balance,44,28,16
8875,Grapeful,frostmourne,1640,druid,balance,66,37,29
8876,Moanabluray,area-52,1640,druid,balance,48,21,27
8877,Rumorxo,illidan,1639,druid,balance,30,18,12
8878,Chøpstixs,bleeding-hollow,1639,druid,balance,48,28,20
8879,Sigure,zuljin,1638,druid,balance,44,29,15
8880,Killiamp,tichondrius,1636,druid,balance,41,27,14
8881,Supafat,thrall,1636,druid,balance,31,20,11
8882,Kïx,illidan,1636,druid,balance,38,23,15
8883,Shibbith,nordrassil,1636,druid,balance,30,18,12
8884,Thamoonsbak,aggramar,1635,druid,balance,35,18,17
8885,Ehleven,tichondrius,1634,druid,balance,48,29,19
8886,Dharmatra,quelthalas,1634,druid,balance,101,56,45
8887,Showmanship,tichondrius,1634,druid,balance,146,78,68
8888,Ahrilee,area-52,1634,druid,balance,90,47,43
8889,Taylorshift,misha,1633,druid,balance,27,23,4
8890,Lewïs,stormrage,1633,druid,balance,81,45,36
8891,Johnnydrip,malganis,1633,druid,balance,36,19,17
8892,Mayanardz,bleeding-hollow,1631,druid,balance,24,17,7
8893,Trapkin,tichondrius,1631,druid,balance,167,101,66
8894,Jokerdks,tichondrius,1631,druid,balance,38,22,16
8895,Bearyhalls,sargeras,1630,druid,balance,24,17,7
8896,Skeevz,darkspear,1630,druid,balance,74,38,36
8897,Relaeh,andorhal,1629,druid,balance,36,19,17
8898,Kekepöp,illidan,1628,druid,balance,36,25,11
8899,Fìlø,bleeding-hollow,1628,druid,balance,243,136,107
8900,Jimrobloxttv,emerald-dream,1627,druid,balance,36,24,12
8901,Woog,moon-guard,1627,druid,balance,96,57,39
8902,Oppose,akama,1627,druid,balance,65,37,28
8903,Boomchí,tichondrius,1627,druid,balance,54,29,25
8904,Dreamwalker,bleeding-hollow,1626,druid,balance,24,17,7
8905,Ripdimebag,frostmourne,1626,druid,balance,58,37,21
8906,Restorationz,tichondrius,1626,druid,balance,131,77,54
8907,Scrubrat,moon-guard,1625,druid,balance,52,40,12
8908,Scoon,aegwynn,1625,druid,balance,45,24,21
8909,Ablackdruid,moon-guard,1624,druid,balance,35,21,14
8910,Wattami,area-52,1623,druid,balance,30,18,12
8911,Moonra,malganis,1623,druid,balance,66,38,28
8912,Soonntkgo,ragnaros,1623,druid,balance,56,29,27
8913,Bhboom,tichondrius,1623,druid,balance,54,23,31
8914,Eseldra,area-52,1622,druid,balance,58,34,24
8915,Harryhotter,blackrock,1622,druid,balance,109,54,55
8916,Kickconvoke,sargeras,1621,druid,balance,66,39,27
8917,Còyot,stormrage,1621,druid,balance,66,34,32
8918,Padavore,wyrmrest-accord,1620,druid,balance,95,59,36
8919,Moonsliced,kiljaeden,1620,druid,balance,54,33,21
8920,Haymade,sargeras,1620,druid,balance,120,69,51
8921,Doomkiñ,darkspear,1620,druid,balance,35,18,17
8922,Kelagoat,kiljaeden,1620,druid,balance,54,26,28
8923,Muffbfloppn,zuljin,1619,druid,balance,36,22,14
8924,Cyclíze,sargeras,1619,druid,balance,42,25,17
8925,Taszy,blackrock,1619,druid,balance,58,34,24
8926,Contrololol,hyjal,1619,druid,balance,60,32,28
8927,Gatø,area-52,1619,druid,balance,90,42,48
8928,Cenariun,stormrage,1618,druid,balance,66,36,30
8929,Wildslash,proudmoore,1617,druid,balance,75,37,38
8930,Drufasa,tichondrius,1617,druid,balance,70,34,36
8931,Foxwit,jubeithos,1616,druid,balance,40,22,18
8932,Treeshift,tichondrius,1615,druid,balance,53,32,21
8933,Héisénbérg,sargeras,1615,druid,balance,60,33,27
8934,Starsurgeon,thrall,1615,druid,balance,155,85,70
8935,Dudur,zuljin,1615,druid,balance,113,60,53
8936,Furryswipe,proudmoore,1614,druid,balance,56,33,23
8937,Polánd,area-52,1614,druid,balance,75,43,32
8938,Yosuzume,thrall,1613,druid,balance,54,33,21
8939,Seyedo,sargeras,1613,druid,balance,77,45,32
8940,Schneidèr,quelthalas,1613,druid,balance,42,20,22
8941,Targareyen,sargeras,1613,druid,balance,53,25,28
8942,Auras,kelthuzad,1612,druid,balance,120,73,47
8943,Duglas,illidan,1612,druid,balance,91,55,36
8944,Yorkville,sargeras,1612,druid,balance,60,31,29
8945,Ellguin,malganis,1611,druid,balance,60,44,16
8946,Cócorosie,tichondrius,1611,druid,balance,36,26,10
8947,Twcrazyk,tichondrius,1611,druid,balance,79,38,41
8948,Lupintk,tichondrius,1610,druid,balance,96,57,39
8949,Snugglin,kelthuzad,1610,druid,balance,66,33,33
8950,Laradea,argent-dawn,1609,druid,balance,38,27,11
8951,Pänzerkin,sargeras,1609,druid,balance,30,21,9
8952,Fatsquid,tichondrius,1609,druid,balance,60,38,22
8953,Alaillais,moon-guard,1609,druid,balance,48,28,20
8954,Shafted,kelthuzad,1609,druid,balance,36,21,15
8955,Canek,ghostlands,1609,druid,balance,107,62,45
8956,Quaras,frostmourne,1609,druid,balance,241,129,112
8957,Rikezz,black-dragonflight,1608,druid,balance,48,34,14
8958,Tenhoteta,goldrinn,1608,druid,balance,48,25,23
8959,Kittyboy,emerald-dream,1607,druid,balance,30,21,9
8960,Kittiepurry,blackrock,1607,druid,balance,112,63,49
8961,Swiftydel,frostmourne,1607,druid,balance,54,29,25
8962,Flappyjacks,elune,1607,druid,balance,54,27,27
8963,Boys,bleeding-hollow,1606,druid,balance,42,24,18
8964,Galind,rexxar,1606,druid,balance,58,33,25
8965,Rígél,ragnaros,1606,druid,balance,243,132,111
8966,Signifies,tichondrius,1605,druid,balance,29,20,9
8967,Braviel,stormrage,1605,druid,balance,54,32,22
8968,Huggerino,stormrage,1605,druid,balance,88,52,36
8969,Raddosaurus,area-52,1605,druid,balance,89,48,41
8970,Baboongodx,frostmourne,1605,druid,balance,35,18,17
8971,Tummycummy,thrall,1604,druid,balance,30,20,10
8972,Yehaw,bloodhoof,1604,druid,balance,54,35,19
8973,Shumarina,mannoroth,1604,druid,balance,48,29,19
8974,Columpio,area-52,1604,druid,balance,42,23,19
8975,Nehrudruid,area-52,1603,druid,balance,24,17,7
8976,Dorobloom,sargeras,1603,druid,balance,54,36,18
8977,Torrox,tichondrius,1603,druid,balance,244,131,113
8978,Anchunlol,tichondrius,1603,druid,balance,36,19,17
8979,Jentlegiant,tichondrius,1602,druid,balance,36,21,15
8980,Mofan,tichondrius,1599,druid,balance,36,20,16
8981,Kletys,azralon,1599,druid,balance,113,57,56
8982,Sadsex,illidan,1598,druid,balance,107,63,44
8983,Stellar,steamwheedle-cartel,1597,druid,balance,24,19,5
8984,Dirtmaggot,barthilas,1597,druid,balance,31,21,10
8985,Inuyasha,sargeras,1597,druid,balance,59,34,25
8986,Infam,sargeras,1595,druid,balance,36,21,15
8987,Odirtytshirt,malganis,1595,druid,balance,55,27,28
8988,Dôcteurowl,zuljin,1595,druid,balance,119,55,64
8989,Skurts,tichondrius,1594,druid,balance,39,25,14
8990,Blackjésüs,kelthuzad,1594,druid,balance,153,86,67
8991,Junaleska,lightbringer,1593,druid,balance,24,17,7
8992,Drakemaster,aggramar,1593,druid,balance,30,20,10
8993,Twinscroll,tichondrius,1593,druid,balance,107,68,39
8994,Deed,korialstrasz,1593,druid,balance,34,19,15
8995,Swappy,korgath,1593,druid,balance,112,62,50
8996,Faelonk,frostmourne,1592,druid,balance,30,23,7
8997,Charmandxr,hyjal,1592,druid,balance,59,31,28
8998,Kittycleave,tichondrius,1591,druid,balance,30,20,10
8999,Quefemme,kelthuzad,1590,druid,balance,41,23,18
9000,Boompoizan,tichondrius,1590,druid,balance,81,45,36
9001,Tyapet,area-52,1590,druid,balance,160,85,75
9002,Brodda,sargeras,1590,druid,balance,202,105,97
9003,Abn,sargeras,1588,druid,balance,36,22,14
9004,Nodeathz,sargeras,1588,druid,balance,34,20,14
9005,Ånðrømæðå,sargeras,1588,druid,balance,48,26,22
9006,Skirts,area-52,1587,druid,balance,59,34,25
9007,Flowérz,illidan,1586,druid,balance,42,24,18
9008,Watchugonndo,tichondrius,1585,druid,balance,24,17,7
9009,Korbö,zuljin,1585,druid,balance,30,18,12
9010,Fastlife,drakkari,1585,druid,balance,42,22,20
9011,Druizzy,illidan,1585,druid,balance,54,21,33
9012,Zesto,nazjatar,1584,druid,balance,36,24,12
9013,Qelthalas,sargeras,1584,druid,balance,246,134,112
9014,Tereeke,moon-guard,1583,druid,balance,30,17,13
9015,Bigherbo,zuljin,1582,druid,balance,78,43,35
9016,Chedisdru,mugthol,1580,druid,balance,48,28,20
9017,Shîfty,ysondre,1580,druid,balance,65,35,30
9018,Trippyshift,hyjal,1580,druid,balance,60,30,30
9019,Jeanz,bonechewer,1579,druid,balance,36,22,14
9020,Druiddruid,daggerspine,1577,druid,balance,59,36,23
9021,Jillferal,proudmoore,1577,druid,balance,102,57,45
9022,Astrals,runetotem,1577,druid,balance,39,21,18
9023,Kuaite,azralon,1577,druid,balance,70,34,36
9024,Awazing,illidan,1576,druid,balance,65,30,35
9025,Darach,boulderfist,1575,druid,balance,30,21,9
9026,Xenöchrist,ragnaros,1575,druid,balance,104,65,39
9027,Hefe,terenas,1575,druid,balance,36,21,15
9028,Djsummer,tichondrius,1573,druid,balance,125,64,61
9029,Sombrien,stormrage,1573,druid,balance,90,46,44
9030,Nodadpullout,tichondrius,1572,druid,balance,51,25,26
9031,Beretta,rexxar,1571,druid,balance,84,48,36
9032,Offthezaza,tichondrius,1571,druid,balance,87,47,40
9033,Greenseed,nagrand,1570,druid,balance,36,27,9
9034,Saltydru,illidan,1570,druid,balance,44,25,19
9035,Bugbugz,tichondrius,1570,druid,balance,36,18,18
9036,Starsurgê,tichondrius,1569,druid,balance,66,42,24
9037,Fondra,sargeras,1567,druid,balance,55,32,23
9038,Âzn,tichondrius,1566,druid,balance,72,49,23
9039,Atagoo,tichondrius,1566,druid,balance,198,103,95
9040,Draide,dragonblight,1566,druid,balance,55,27,28
9041,Venkin,gnomeregan,1566,druid,balance,96,47,49
9042,Polvinhoo,azralon,1564,druid,balance,72,40,32
9043,Groggs,frostwolf,1564,druid,balance,39,20,19
9044,Swoopy,stormrage,1563,druid,balance,79,44,35
9045,Slumpxaddy,illidan,1562,druid,balance,35,21,14
9046,Xiaoshuaigê,illidan,1562,druid,balance,30,18,12
9047,Wildbloom,draenor,1562,druid,balance,72,42,30
9048,Soupbeandru,zuljin,1561,druid,balance,60,33,27
9049,Kitinglol,alexstrasza,1560,druid,balance,68,35,33
9050,Ocâ,cenarius,1558,druid,balance,60,36,24
9051,Indicamicah,tichondrius,1558,druid,balance,66,36,30
9052,Neytîrî,tichondrius,1554,druid,balance,101,55,46
9053,Syclonez,stormrage,1554,druid,balance,42,21,21
9054,Hasteley,khadgar,1554,druid,balance,71,34,37
9055,Empriona,wildhammer,1553,druid,balance,31,18,13
9056,Thespían,tichondrius,1553,druid,balance,369,193,176
9057,Midoo,proudmoore,1553,druid,balance,48,25,23
9058,Drdrulittle,darkspear,1553,druid,balance,78,40,38
9059,Darkombra,frostmourne,1552,druid,balance,60,28,32
9060,Starcastic,tichondrius,1548,druid,balance,120,63,57
9061,Boõsty,bleeding-hollow,1548,druid,balance,58,29,29
9062,Drognan,sargeras,1548,druid,balance,36,18,18
9063,Zetii,emerald-dream,1547,druid,balance,84,48,36
9064,Balanci,stormrage,1547,druid,balance,70,36,34
9065,Blitzkreigtv,area-52,1546,druid,balance,60,32,28
9066,Hitchslaps,tichondrius,1545,druid,balance,48,28,20
9067,Hayop,illidan,1543,druid,balance,60,28,32
9068,Hoagiecannon,moon-guard,1541,druid,balance,167,89,78
9069,Montrá,stormrage,1541,druid,balance,131,62,69
9070,Ihavehothots,kiljaeden,1540,druid,balance,38,26,12
9071,Almarasta,azralon,1539,druid,balance,94,55,39
9072,Zettka,tichondrius,1539,druid,balance,55,32,23
9073,Kyndel,kiljaeden,1539,druid,balance,36,20,16
9074,Donresantis,stormreaver,1539,druid,balance,90,46,44
9075,Qs,rivendare,1539,druid,balance,89,39,50
9076,November,wyrmrest-accord,1538,druid,balance,110,62,48
9077,Beyondbeef,sargeras,1537,druid,balance,67,43,24
9078,Hikoro,sargeras,1536,druid,balance,126,74,52
9079,Skum,bloodscalp,1536,druid,balance,69,30,39
9080,Velaana,tichondrius,1535,druid,balance,121,60,61
9081,Tanawak,tichondrius,1535,druid,balance,65,29,36
9082,Bippygucci,tichondrius,1534,druid,balance,30,17,13
9083,Jgb,dalaran,1534,druid,balance,30,16,14
9084,Slowreverb,silver-hand,1534,druid,balance,30,16,14
9085,Maplêleaf,moon-guard,1534,druid,balance,223,113,110
9086,Clense,tichondrius,1533,druid,balance,73,44,29
9087,Fironous,nerzhul,1532,druid,balance,36,20,16
9088,Withwind,dalaran,1530,druid,balance,30,16,14
9089,Boomfire,thaurissan,1529,druid,balance,33,18,15
9090,Sorh,stormrage,1529,druid,balance,33,18,15
9091,Waiv,area-52,1529,druid,balance,30,16,14
9092,Packinmeat,tichondrius,1529,druid,balance,30,16,14
9093,Treetard,altar-of-storms,1529,druid,balance,72,36,36
9094,Kg,cenarion-circle,1528,druid,balance,162,93,69
9095,Brockolini,tichondrius,1528,druid,balance,82,44,38
9096,Elliar,akama,1528,druid,balance,48,23,25
9097,Rabbithomas,malygos,1525,druid,balance,24,16,8
9098,Loraxx,bleeding-hollow,1524,druid,balance,24,16,8
9099,Sweatydruidx,tichondrius,1523,druid,balance,24,16,8
9100,Wakeenfiendx,sargeras,1522,druid,balance,24,16,8
9101,Afpak,sargeras,1522,druid,balance,66,35,31
9102,Wp,proudmoore,1521,druid,balance,37,26,11
9103,Paddywhacked,tichondrius,1521,druid,balance,42,28,14
9104,Thorothir,ragnaros,1520,druid,balance,110,62,48
9105,Druidlolwtf,area-52,1520,druid,balance,108,52,56
9106,Myeow,illidan,1520,druid,balance,74,35,39
9107,Swooped,emerald-dream,1519,druid,balance,53,29,24
9108,Gaawdx,illidan,1519,druid,balance,131,63,68
9109,Adaptivv,sargeras,1518,druid,balance,30,21,9
9110,Lowkie,llane,1518,druid,balance,68,34,34
9111,Rogsdruid,sargeras,1518,druid,balance,73,32,41
9112,Børing,sargeras,1517,druid,balance,81,44,37
9113,Musha,tichondrius,1517,druid,balance,57,30,27
9114,Hagatta,stormrage,1517,druid,balance,151,77,74
9115,Skyde,sargeras,1517,druid,balance,36,17,19
9116,Yorch,stormrage,1517,druid,balance,65,30,35
9117,Faruu,tichondrius,1516,druid,balance,24,16,8
9118,Ghostowl,thrall,1516,druid,balance,66,42,24
9119,Groovyroom,tichondrius,1516,druid,balance,42,23,19
9120,Pirira,quelthalas,1515,druid,balance,43,24,19
9121,Stinky,bleeding-hollow,1515,druid,balance,30,16,14
9122,Cfp,tichondrius,1515,druid,balance,64,31,33
9123,Pëps,emerald-dream,1514,druid,balance,48,27,21
9124,Lumala,drakkari,1514,druid,balance,48,27,21
9125,Kittygoboom,kiljaeden,1514,druid,balance,78,35,43
9126,Ganjácookies,stormrage,1513,druid,balance,40,26,14
9127,Piping,thunderlord,1513,druid,balance,30,17,13
9128,Cabek,malganis,1512,druid,balance,72,38,34
9129,Pavati,bleeding-hollow,1511,druid,balance,49,29,20
9130,Mk,caelestrasz,1511,druid,balance,30,17,13
9131,Gossìpgoat,frostmourne,1511,druid,balance,38,21,17
9132,Watchmecap,silvermoon,1510,druid,balance,30,22,8
9133,Luke,ghostlands,1510,druid,balance,24,16,8
9134,Zorn,lightnings-blade,1508,druid,balance,48,26,22
9135,Hudalu,wyrmrest-accord,1508,druid,balance,42,22,20
9136,Vyrrath,stormrage,1504,druid,balance,32,19,13
9137,Shebleeder,aegwynn,1503,druid,balance,54,30,24
9138,Bullquenepas,dalaran,1502,druid,balance,28,17,11
9139,Jxrx,malganis,1501,druid,balance,24,16,8
9140,Rootchan,azralon,1501,druid,balance,58,38,20
9141,Swampduck,saurfang,1500,druid,balance,30,18,12
9142,Enlil,the-underbog,1500,druid,balance,60,32,28
9143,Nuubmurph,stormrage,1499,druid,balance,33,20,13
9144,Nephdruid,stormrage,1499,druid,balance,98,57,41
9145,Cottonpaw,sargeras,1499,druid,balance,281,153,128
9146,Yuumura,stormrage,1499,druid,balance,139,74,65
9147,Thatscute,moon-guard,1499,druid,balance,368,190,178
9148,Kazamura,tichondrius,1499,druid,balance,88,38,50
9149,Meowmixx,frostmane,1498,druid,balance,83,42,41
9150,Dmtdruid,tichondrius,1497,druid,balance,41,21,20
9151,Awkwarder,emerald-dream,1497,druid,balance,189,96,93
9152,Clawriander,barthilas,1497,druid,balance,59,29,30
9153,Clonexlt,wyrmrest-accord,1496,druid,balance,46,28,18
9154,Swagdaddyjr,area-52,1496,druid,balance,42,24,18
9155,Tak,garrosh,1496,druid,balance,36,17,19
9156,Cyeq,blackrock,1494,druid,balance,289,149,140
9157,Yoloboomkin,tichondrius,1494,druid,balance,46,23,23
9158,Rashmi,kiljaeden,1494,druid,balance,36,18,18
9159,Wildsïde,tichondrius,1490,druid,balance,48,28,20
9160,Drunknoodles,stormrage,1489,druid,balance,35,20,15
9161,Lharast,stormrage,1488,druid,balance,28,17,11
9162,Deathkahn,lightninghoof,1487,druid,balance,90,49,41
9163,Cdroo,burning-blade,1486,druid,balance,24,16,8
9164,Boxtops,bleeding-hollow,1486,druid,balance,36,23,13
9165,Bäñgarang,tichondrius,1484,druid,balance,100,54,46
9166,Umadornahh,malganis,1484,druid,balance,54,28,26
9167,Xevão,nemesis,1484,druid,balance,62,32,30
9168,Milkman,mannoroth,1484,druid,balance,42,16,26
9169,Völsüng,tichondrius,1483,druid,balance,48,27,21
9170,Pawpurrazzi,darkspear,1482,druid,balance,53,27,26
9171,Owlgz,barthilas,1482,druid,balance,36,18,18
9172,Dreamkin,tichondrius,1481,druid,balance,84,43,41
9173,Boostgu,illidan,1478,druid,balance,41,24,17
9174,Gwub,illidan,1477,druid,balance,23,17,6
9175,Fahnir,ragnaros,1477,druid,balance,72,40,32
9176,Rakex,tichondrius,1477,druid,balance,104,50,54
9177,Ryügähidëki,tichondrius,1476,druid,balance,61,32,29
9178,Tickler,durotan,1476,druid,balance,36,17,19
9179,Harlisu,stormrage,1475,druid,balance,26,17,9
9180,Árès,frostmourne,1475,druid,balance,83,45,38
9181,Jawnfurry,tichondrius,1475,druid,balance,60,29,31
9182,Maimz,tichondrius,1474,druid,balance,103,60,43
9183,Kuwä,proudmoore,1474,druid,balance,72,36,36
9184,Gepardéx,ragnaros,1473,druid,balance,192,98,94
9185,Gummoo,tichondrius,1472,druid,balance,48,33,15
9186,Jaduss,thrall,1470,druid,balance,44,24,20
9187,Monsin,illidan,1470,druid,balance,168,87,81
9188,Surgingnews,sargeras,1470,druid,balance,48,21,27
9189,Zukru,malganis,1469,druid,balance,54,32,22
9190,Charnlok,thunderlord,1468,druid,balance,47,31,16
9191,Dupaface,stormrage,1468,druid,balance,29,16,13
9192,Suncintus,aggramar,1468,druid,balance,54,24,30
9193,Skrimshaw,burning-legion,1467,druid,balance,83,44,39
9194,Brettdadad,shandris,1465,druid,balance,36,23,13
9195,Feralownage,malorne,1465,druid,balance,36,22,14
9196,Moonfart,zuljin,1465,druid,balance,143,75,68
9197,Lavanis,stormrage,1465,druid,balance,235,121,114
9198,Hyperdryve,bonechewer,1464,druid,balance,54,30,24
9199,Hosehead,malganis,1463,druid,balance,80,50,30
9200,Scarymon,tichondrius,1463,druid,balance,79,45,34
9201,Unclenya,barthilas,1463,druid,balance,72,32,40
9202,Catahoula,lothar,1462,druid,balance,30,18,12
9203,Naurrog,tichondrius,1461,druid,balance,66,42,24
9204,Bruddahderpp,tichondrius,1460,druid,balance,42,28,14
9205,Rajionu,kiljaeden,1460,druid,balance,30,20,10
9206,Jruids,stormrage,1460,druid,balance,66,38,28
9207,Zhinger,tichondrius,1460,druid,balance,79,39,40
9208,Seyon,tichondrius,1459,druid,balance,33,17,16
9209,Shiftyn,proudmoore,1457,druid,balance,30,22,8
9210,Rizzdja,frostmourne,1456,druid,balance,24,16,8
9211,Lãzy,tichondrius,1456,druid,balance,96,53,43
9212,Jubeam,area-52,1456,druid,balance,36,19,17
9213,Metal,jaedenar,1456,druid,balance,61,30,31
9214,Bocephus,dark-iron,1455,druid,balance,36,20,16
9215,Sunmoonkong,area-52,1455,druid,balance,46,24,22
9216,Druuyid,jubeithos,1454,druid,balance,126,68,58
9217,Ereshkïgal,stormrage,1454,druid,balance,79,42,37
9218,Eyzie,stormrage,1454,druid,balance,80,39,41
9219,Tahunne,tichondrius,1452,druid,balance,106,63,43
9220,Aranuir,emerald-dream,1452,druid,balance,35,20,15
9221,Atmospherè,tichondrius,1452,druid,balance,108,57,51
9222,Queiq,kelthuzad,1452,druid,balance,42,22,20
9223,Shiftybiznes,black-dragonflight,1451,druid,balance,28,17,11
9224,Thunderhox,tichondrius,1451,druid,balance,67,36,31
9225,Sammio,emerald-dream,1451,druid,balance,104,55,49
9226,Stormmantlé,moon-guard,1451,druid,balance,35,18,17
9227,Ayelune,stormrage,1450,druid,balance,54,30,24
9228,Thetruetrue,sargeras,1450,druid,balance,72,33,39
9229,Cerest,kaelthas,1448,druid,balance,34,21,13
9230,Juicywap,proudmoore,1448,druid,balance,47,26,21
9231,Druidlow,azralon,1448,druid,balance,79,41,38
9232,Whiteseal,frostmourne,1447,druid,balance,49,31,18
9233,Instanodle,proudmoore,1447,druid,balance,36,20,16
9234,Windstag,korgath,1447,druid,balance,36,17,19
9235,Yaboydave,stonemaul,1446,druid,balance,30,16,14
9236,Fripp,stormrage,1446,druid,balance,54,28,26
9237,Sileda,nemesis,1445,druid,balance,25,18,7
9238,Isomer,kilrogg,1445,druid,balance,30,18,12
9239,Rdruidchump,the-forgotten-coast,1445,druid,balance,32,19,13
9240,Syntheris,kaelthas,1445,druid,balance,87,51,36
9241,Bighomïe,emerald-dream,1445,druid,balance,48,27,21
9242,Basulto,tichondrius,1445,druid,balance,108,57,51
9243,Enrÿu,nemesis,1444,druid,balance,39,22,17
9244,Clawandørder,tichondrius,1442,druid,balance,26,16,10
9245,Redhotbean,tichondrius,1442,druid,balance,95,45,50
9246,Lepolle,ragnaros,1441,druid,balance,31,21,10
9247,Formmaster,malganis,1441,druid,balance,76,38,38
9248,Mctree,cenarius,1440,druid,balance,120,72,48
9249,Nicotinefien,sargeras,1439,druid,balance,24,15,9
9250,Drubuzz,tichondrius,1439,druid,balance,102,56,46
9251,Armorkits,area-52,1438,druid,balance,24,15,9
9252,Markers,gorefiend,1438,druid,balance,24,15,9
9253,Lunarbalance,veknilash,1438,druid,balance,99,44,55
9254,Elvishrage,zuljin,1437,druid,balance,18,15,3
9255,Roundtummy,area-52,1437,druid,balance,90,45,45
9256,ßleepßloop,tichondrius,1436,druid,balance,33,22,11
9257,Wombatform,malganis,1436,druid,balance,24,15,9
9258,Softdog,stormrage,1436,druid,balance,70,38,32
9259,Kellydacat,azuremyst,1435,druid,balance,18,15,3
9260,Rouse,tichondrius,1435,druid,balance,36,27,9
9261,Reconus,frostmourne,1435,druid,balance,24,15,9
9262,Envoy,sargeras,1435,druid,balance,60,33,27
9263,Chonkykitty,frostmourne,1434,druid,balance,36,23,13
9264,Høt,thunderhorn,1434,druid,balance,28,17,11
9265,Alliess,aerie-peak,1434,druid,balance,111,56,55
9266,Moonowl,crushridge,1433,druid,balance,60,35,25
9267,Falkond,tichondrius,1433,druid,balance,35,18,17
9268,Squidwonk,sargeras,1433,druid,balance,48,23,25
9269,Arealdruid,moon-guard,1433,druid,balance,42,18,24
9270,Kallabaluwa,azralon,1433,druid,balance,59,25,34
9271,Shapedance,sargeras,1431,druid,balance,35,16,19
9272,Druiddreams,frostmourne,1430,druid,balance,30,23,7
9273,Dontfloodit,tichondrius,1430,druid,balance,128,61,67
9274,Catatonik,emerald-dream,1430,druid,balance,36,15,21
9275,Ðjx,stormrage,1429,druid,balance,37,28,9
9276,Ularda,bleeding-hollow,1428,druid,balance,48,28,20
9277,Zuice,thrall,1427,druid,balance,79,39,40
9278,Bearserk,rexxar,1427,druid,balance,78,36,42
9279,Alecxeon,tichondrius,1426,druid,balance,72,40,32
9280,Buyadoge,area-52,1426,druid,balance,40,18,22
9281,Livilla,sargeras,1425,druid,balance,53,29,24
9282,Therooster,whisperwind,1425,druid,balance,53,22,31
9283,Nokash,tichondrius,1425,druid,balance,43,17,26
9284,Squidrific,tichondrius,1424,druid,balance,71,47,24
9285,Nebulose,moon-guard,1424,druid,balance,59,26,33
9286,Jeezelouise,kelthuzad,1423,druid,balance,30,21,9
9287,Mèowcenaary,chogall,1423,druid,balance,60,35,25
9288,Genghisz,area-52,1422,druid,balance,95,47,48
9289,Narthurs,ragnaros,1422,druid,balance,48,23,25
9290,Meatcat,sargeras,1421,druid,balance,30,16,14
9291,Yaboidakota,stormrage,1420,druid,balance,172,89,83
9292,Knoxella,moon-guard,1419,druid,balance,146,78,68
9293,Slipprypickl,archimonde,1419,druid,balance,36,16,20
9294,Hornny,shattered-hand,1418,druid,balance,24,15,9
9295,Solarcannon,shuhalo,1418,druid,balance,195,105,90
9296,Seneshy,azralon,1417,druid,balance,36,26,10
9297,Raximus,moon-guard,1417,druid,balance,84,42,42
9298,Chakrabeam,kelthuzad,1417,druid,balance,48,22,26
9299,Faroo,azralon,1416,druid,balance,40,24,16
9300,Axiomisop,tichondrius,1416,druid,balance,59,35,24
9301,Daddymaple,tichondrius,1416,druid,balance,60,29,31
9302,Crocface,tichondrius,1415,druid,balance,66,38,28
9303,Dbanned,nemesis,1414,druid,balance,102,48,54
9304,Lightconvoke,norgannon,1413,druid,balance,38,19,19
9305,Bambooty,veknilash,1413,druid,balance,30,15,15
9306,Balverixqt,tichondrius,1413,druid,balance,42,20,22
9307,Swapclone,sargeras,1413,druid,balance,60,20,40
9308,Bluechew,bleeding-hollow,1412,druid,balance,32,18,14
9309,Gullmock,quelthalas,1412,druid,balance,78,35,43
9310,Jainzar,dreadmaul,1411,druid,balance,63,30,33
9311,Alucardxd,ragnaros,1411,druid,balance,35,16,19
9312,Seannybhoy,emerald-dream,1411,druid,balance,63,27,36
9313,Wiiee,darkspear,1410,druid,balance,80,48,32
9314,Dalsardirn,sargeras,1410,druid,balance,30,17,13
9315,Snailbeam,shattered-hand,1410,druid,balance,48,20,28
9316,Espoir,azuremyst,1409,druid,balance,24,15,9
9317,Feroz,frostmourne,1409,druid,balance,24,15,9
9318,Illilydan,tichondrius,1409,druid,balance,148,75,73
9319,Coorvinus,stormrage,1409,druid,balance,36,18,18
9320,Oo,grizzly-hills,1408,druid,balance,24,16,8
9321,Diligent,dathremar,1408,druid,balance,30,15,15
9322,Abzuri,kiljaeden,1408,druid,balance,36,17,19
9323,Kawshuhn,bleeding-hollow,1407,druid,balance,90,51,39
9324,Boombot,proudmoore,1407,druid,balance,32,17,15
9325,Côheed,bleeding-hollow,1407,druid,balance,30,15,15
9326,Schwenkyytv,sargeras,1407,druid,balance,30,15,15
9327,Maviç,hyjal,1407,druid,balance,123,59,64
9328,Ïny,emerald-dream,1404,druid,balance,30,15,15
9329,Alwind,alleria,1404,druid,balance,117,57,60
9330,Slyfoxx,stonemaul,1403,druid,balance,92,53,39
9331,Vicorin,illidan,1402,druid,balance,30,17,13
9332,Alshari,proudmoore,1402,druid,balance,72,39,33
9333,Ghoouul,tichondrius,1402,druid,balance,47,21,26
9334,Sallyshifts,area-52,1402,druid,balance,45,19,26
9335,Apex,terenas,1401,druid,balance,36,17,19
9336,Smokeytheelf,illidan,1400,druid,balance,36,22,14
9337,Øutcast,malganis,1400,druid,balance,41,22,19
9338,Timdillon,emerald-dream,1400,druid,balance,30,16,14
9339,Moorgasmic,tichondrius,1400,druid,balance,51,23,28
9340,Cudbacrakhed,tichondrius,1399,druid,balance,48,27,21
9341,Nightstalkr,kelthuzad,1397,druid,balance,210,110,100
9342,Justinheras,area-52,1396,druid,balance,100,55,45
9343,Ulcera,nemesis,1396,druid,balance,33,17,16
9344,Suist,moonrunner,1394,druid,balance,28,15,13
9345,Haneulso,tichondrius,1393,druid,balance,267,138,129
9346,Yseraspawn,kelthuzad,1392,druid,balance,42,21,21
9347,Trickatreyy,kelthuzad,1392,druid,balance,43,21,22
9348,Herbzlova,lightnings-blade,1392,druid,balance,102,49,53
9349,Dkat,malganis,1390,druid,balance,82,45,37
9350,Beastsworn,alexstrasza,1388,druid,balance,42,15,27
9351,Daddyfresh,ursin,1387,druid,balance,36,20,16
9352,Dahts,destromath,1383,druid,balance,36,24,12
9353,Bigbeugs,frostmourne,1382,druid,balance,36,19,17
9354,Driftwood,bonechewer,1381,druid,balance,53,30,23
9355,Envasions,emerald-dream,1380,druid,balance,24,15,9
9356,Shréd,blades-edge,1380,druid,balance,32,19,13
9357,Capybara,nerzhul,1380,druid,balance,29,15,14
9358,Notwhaaz,area-52,1379,druid,balance,42,15,27
9359,Nanashi,tichondrius,1378,druid,balance,30,15,15
9360,Nightshàdowz,barthilas,1377,druid,balance,30,16,14
9361,Huskars,tichondrius,1375,druid,balance,48,26,22
9362,Havôç,tichondrius,1375,druid,balance,42,16,26
9363,Milksquirts,thrall,1374,druid,balance,140,71,69
9364,Shemeus,malganis,1374,druid,balance,54,27,27
9365,Barrahjr,frostmourne,1373,druid,balance,63,34,29
9366,Starsaber,dalaran,1372,druid,balance,42,24,18
9367,Trollsmind,tichondrius,1372,druid,balance,46,26,20
9368,Indoee,mannoroth,1368,druid,balance,168,81,87
9369,Asteriel,stormrage,1367,druid,balance,54,24,30
9370,Airinsurgent,stormrage,1367,druid,balance,44,18,26
9371,Binnchook,barthilas,1366,druid,balance,31,19,12
9372,Prebark,sargeras,1366,druid,balance,27,16,11
9373,Graffsworth,emerald-dream,1366,druid,balance,134,68,66
9374,Skagakr,moon-guard,1366,druid,balance,131,65,66
9375,Repanda,proudmoore,1366,druid,balance,130,63,67
9376,Breynna,draenor,1364,druid,balance,47,24,23
9377,Throatjelly,blackrock,1363,druid,balance,42,23,19
9378,Leonardsby,tichondrius,1363,druid,balance,67,33,34
9379,Liñk,sargeras,1363,druid,balance,35,17,18
9380,Torrwin,area-52,1360,druid,balance,64,33,31
9381,Mommyx,stormrage,1357,druid,balance,60,27,33
9382,Nuppxx,frostmourne,1356,druid,balance,30,20,10
9383,Styless,azjolnerub,1356,druid,balance,72,37,35
9384,Katobe,tichondrius,1355,druid,balance,36,19,17
9385,Prismo,ravencrest,1354,druid,balance,54,28,26
9386,Sofereir,frostmourne,1353,druid,balance,167,81,86
9387,Gitsnshigles,frostmourne,1352,druid,balance,43,23,20
9388,Stärfäll,frostmourne,1351,druid,balance,24,17,7
9389,Tahnu,deathwing,1350,druid,balance,23,15,8
9390,Mythelian,icecrown,1348,druid,balance,60,34,26
9391,Jonoa,nagrand,1348,druid,balance,108,61,47
9392,Skêet,tichondrius,1348,druid,balance,54,21,33
9393,Rudar,sargeras,1344,druid,balance,24,14,10
9394,Jâykeup,lightbringer,1344,druid,balance,96,50,46
9395,Ironbark,azuremyst,1344,druid,balance,33,15,18
9396,Dekmdrui,quelthalas,1343,druid,balance,21,16,5
9397,Omnigrind,frostmourne,1343,druid,balance,24,14,10
9398,Ehloheim,stormrage,1342,druid,balance,24,14,10
9399,Ascension,emerald-dream,1341,druid,balance,48,27,21
9400,Flôkey,tichondrius,1341,druid,balance,48,25,23
9401,Hamïlton,ragnaros,1341,druid,balance,49,23,26
9402,Starfallgg,sargeras,1340,druid,balance,18,14,4
9403,Starboy,garona,1340,druid,balance,24,14,10
9404,Deegawn,proudmoore,1340,druid,balance,30,15,15
9405,Rongrong,kargath,1339,druid,balance,24,14,10
9406,Maulinyou,whisperwind,1339,druid,balance,36,20,16
9407,Tanguanota,quelthalas,1339,druid,balance,114,55,59
9408,Runhe,zuljin,1337,druid,balance,42,25,17
9409,Kïte,drakkari,1337,druid,balance,31,15,16
9410,Verelyris,nordrassil,1335,druid,balance,18,14,4
9411,Saturday,frostmourne,1335,druid,balance,35,24,11
9412,Audacities,bloodhoof,1335,druid,balance,58,30,28
9413,Wondercat,illidan,1334,druid,balance,24,14,10
9414,Mntra,emerald-dream,1334,druid,balance,24,14,10
9415,Ligerbomb,bleeding-hollow,1334,druid,balance,24,14,10
9416,Egotistic,tichondrius,1333,druid,balance,24,14,10
9417,Jáguar,frostmourne,1333,druid,balance,48,27,21
9418,Imnotinhuman,tichondrius,1333,druid,balance,41,22,19
9419,Thecovid,illidan,1333,druid,balance,131,68,63
9420,Droody,earthen-ring,1333,druid,balance,40,20,20
9421,Yungterp,zuljin,1332,druid,balance,18,14,4
9422,Eldenis,drakkari,1332,druid,balance,106,55,51
9423,Calfurion,stormscale,1331,druid,balance,18,14,4
9424,Deths,frostmourne,1331,druid,balance,36,22,14
9425,Bâzinga,bleeding-hollow,1331,druid,balance,47,24,23
9426,Jinglebells,kiljaeden,1330,druid,balance,36,23,13
9427,Kahpooya,tichondrius,1330,druid,balance,24,14,10
9428,Medibull,tichondrius,1330,druid,balance,24,14,10
9429,Birdmandaddy,bleeding-hollow,1329,druid,balance,24,14,10
9430,Koreanboom,tichondrius,1329,druid,balance,24,14,10
9431,Zùnma,tichondrius,1328,druid,balance,24,14,10
9432,Salvattor,stormrage,1327,druid,balance,44,30,14
9433,Noteff,illidan,1327,druid,balance,36,22,14
9434,Pecopeco,sargeras,1325,druid,balance,30,14,16
9435,Renamebdsm,cenarius,1324,druid,balance,30,14,16
9436,Kelrelyrare,kiljaeden,1324,druid,balance,30,14,16
9437,Durdern,barthilas,1323,druid,balance,75,47,28
9438,Datdruidrod,illidan,1322,druid,balance,108,56,52
9439,Quincunx,tichondrius,1321,druid,balance,94,55,39
9440,Moohok,bleeding-hollow,1321,druid,balance,33,14,19
9441,Zèrkz,tichondrius,1320,druid,balance,146,76,70
9442,Itchyrat,moon-guard,1319,druid,balance,30,15,15
9443,Lucidkiaru,moon-guard,1317,druid,balance,37,19,18
9444,Winekoolers,malganis,1317,druid,balance,54,27,27
9445,Limikeen,bleeding-hollow,1316,druid,balance,42,18,24
9446,Saeval,korgath,1314,druid,balance,93,47,46
9447,Lavenderowl,arthas,1313,druid,balance,60,33,27
9448,Rosalba,zuljin,1312,druid,balance,57,33,24
9449,Alagoano,azralon,1311,druid,balance,86,57,29
9450,Réko,sargeras,1311,druid,balance,46,26,20
9451,Evilakali,tichondrius,1311,druid,balance,49,27,22
9452,Ernest,goldrinn,1311,druid,balance,70,34,36
9453,Theirs,tichondrius,1310,druid,balance,176,97,79
9454,Stepdru,sargeras,1308,druid,balance,24,14,10
9455,Fugginskoden,twisting-nether,1305,druid,balance,23,14,9
9456,Duakx,malganis,1305,druid,balance,30,14,16
9457,Vallk,area-52,1304,druid,balance,26,15,11
9458,Deez,korgath,1304,druid,balance,56,23,33
9459,Bdsurges,illidan,1303,druid,balance,21,15,6
9460,Treemendous,nemesis,1303,druid,balance,30,14,16
9461,Thiccyiff,frostmourne,1302,druid,balance,48,28,20
9462,Annef,tichondrius,1302,druid,balance,44,21,23
9463,Nucleardruid,khadgar,1302,druid,balance,36,17,19
9464,Treezús,thrall,1300,druid,balance,64,32,32
9465,Iceingdeath,dalaran,1300,druid,balance,36,18,18
9466,Meekgrylls,frostmourne,1300,druid,balance,58,27,31
9467,Dobrman,sargeras,1299,druid,balance,35,14,21
9468,Mofoogoo,laughing-skull,1299,druid,balance,48,18,30
9469,Jynxy,sargeras,1296,druid,balance,41,18,23
9470,Smitenkiten,baelgun,1295,druid,balance,52,23,29
9471,Pneumashift,tichondrius,1294,druid,balance,18,14,4
9472,Slimeyjoe,moon-guard,1294,druid,balance,84,46,38
9473,Regnier,burning-blade,1293,druid,balance,71,32,39
9474,Finntröll,area-52,1292,druid,balance,40,18,22
9475,Lükê,tichondrius,1292,druid,balance,39,14,25
9476,Immortalwild,tichondrius,1290,druid,balance,140,72,68
9477,Craftdruid,tichondrius,1288,druid,balance,60,34,26
9478,Thickmoo,tichondrius,1288,druid,balance,93,43,50
9479,Uuli,area-52,1287,druid,balance,24,16,8
9480,Torhok,azralon,1287,druid,balance,30,17,13
9481,Stupidranga,barthilas,1286,druid,balance,54,29,25
9482,Minusdruid,dalaran,1286,druid,balance,117,57,60
9483,Rocee,illidan,1285,druid,balance,48,27,21
9484,Lokdu,area-52,1284,druid,balance,30,15,15
9485,Upps,kelthuzad,1283,druid,balance,24,16,8
9486,Yoshinorii,tichondrius,1283,druid,balance,36,15,21
9487,Xodz,sargeras,1282,druid,balance,42,21,21
9488,Töm,durotan,1282,druid,balance,84,30,54
9489,Shivlary,stormrage,1280,druid,balance,75,44,31
9490,Barrah,barthilas,1280,druid,balance,70,34,36
9491,Kasparhauser,illidan,1280,druid,balance,36,14,22
9492,Nimfaa,nemesis,1279,druid,balance,36,21,15
9493,Druidoy,tichondrius,1279,druid,balance,36,21,15
9494,Beal,azgalor,1279,druid,balance,93,41,52
9495,Orkinetvx,frostmourne,1278,druid,balance,49,32,17
9496,Sergat,stormreaver,1276,druid,balance,66,33,33
9497,Floote,thrall,1274,druid,balance,85,40,45
9498,Hanaak,illidan,1273,druid,balance,23,14,9
9499,Zeanasfaratu,spinebreaker,1273,druid,balance,45,19,26
9500,Softshirtxo,ragnaros,1271,druid,balance,24,14,10
9501,Odweaven,thunderlord,1270,druid,balance,76,35,41
9502,Jashyd,tichondrius,1269,druid,balance,33,22,11
9503,Zalothianx,thrall,1269,druid,balance,28,14,14
9504,Pooöòôp,kiljaeden,1268,druid,balance,47,27,20
9505,Solaress,moon-guard,1268,druid,balance,48,23,25
9506,Mercz,illidan,1267,druid,balance,48,29,19
9507,Shiffterzz,tichondrius,1267,druid,balance,24,14,10
9508,Sochin,nemesis,1267,druid,balance,90,49,41
9509,Kyabe,ragnaros,1267,druid,balance,73,30,43
9510,Goofyfoot,wyrmrest-accord,1266,druid,balance,76,40,36
9511,Scoobyshiftz,frostmourne,1265,druid,balance,47,26,21
9512,Lønewolf,sargeras,1265,druid,balance,77,38,39
9513,Hootie,arygos,1263,druid,balance,45,19,26
9514,Slingin,illidan,1263,druid,balance,48,20,28
9515,Lavanca,azralon,1262,druid,balance,36,16,20
9516,Spicydurid,tichondrius,1261,druid,balance,32,15,17
9517,Mukay,stormrage,1261,druid,balance,40,15,25
9518,Bouffecul,zuljin,1260,druid,balance,36,17,19
9519,Muscelmilk,tichondrius,1258,druid,balance,51,25,26
9520,Hugedumbcow,area-52,1257,druid,balance,65,37,28
9521,Nicenature,gilneas,1257,druid,balance,28,14,14
9522,Volddy,tichondrius,1255,druid,balance,53,32,21
9523,Furu,bonechewer,1254,druid,balance,78,36,42
9524,Fourthkind,illidan,1252,druid,balance,24,14,10
9525,Pãl,quelthalas,1251,druid,balance,42,24,18
9526,Stormaggedon,dalvengyr,1251,druid,balance,48,22,26
9527,Barekat,emerald-dream,1249,druid,balance,34,18,16
9528,Rigotakz,illidan,1249,druid,balance,51,24,27
9529,Jssy,tichondrius,1248,druid,balance,24,13,11
9530,Draden,moknathal,1248,druid,balance,30,15,15
9531,Édzar,area-52,1248,druid,balance,77,38,39
9532,Råstafart,tichondrius,1248,druid,balance,53,26,27
9533,Imshiftastic,area-52,1248,druid,balance,88,43,45
9534,Gatorskin,sargeras,1247,druid,balance,15,14,1
9535,Atherra,sargeras,1247,druid,balance,90,50,40
9536,Hugodruid,frostmourne,1247,druid,balance,24,13,11
9537,Ssantirap,quelthalas,1247,druid,balance,30,13,17
9538,Galeshift,stormrage,1246,druid,balance,18,13,5
9539,Jaegerbombx,sargeras,1246,druid,balance,18,13,5
9540,Lawlz,aegwynn,1246,druid,balance,51,28,23
9541,Dirtdog,uther,1246,druid,balance,24,13,11
9542,Daspd,tichondrius,1246,druid,balance,24,13,11
9543,Veganmom,zuluhed,1246,druid,balance,24,13,11
9544,Rslm,tichondrius,1246,druid,balance,43,21,22
9545,Panqwa,thrall,1246,druid,balance,45,19,26
9546,Xiaodlol,tichondrius,1245,druid,balance,18,13,5
9547,Slowbleeds,blood-furnace,1245,druid,balance,18,13,5
9548,Antiherø,sargeras,1245,druid,balance,18,13,5
9549,Hucklebeary,terokkar,1245,druid,balance,50,23,27
9550,Spudpatikins,barthilas,1243,druid,balance,30,14,16
9551,Brawndiboom,stormrage,1243,druid,balance,83,36,47
9552,Wrathmighty,frostmourne,1243,druid,balance,51,20,31
9553,Bbkingschair,tichondrius,1241,druid,balance,18,13,5
9554,Avishominem,magtheridon,1241,druid,balance,24,13,11
9555,Pissoutside,frostmourne,1240,druid,balance,18,13,5
9556,Nothanxx,dalaran,1240,druid,balance,18,13,5
9557,Critthisbruh,stormrage,1240,druid,balance,85,46,39
9558,Bigboðm,tichondrius,1239,druid,balance,48,24,24
9559,Monicaduan,frostmourne,1239,druid,balance,38,19,19
9560,Xornhxb,tichondrius,1238,druid,balance,18,13,5
9561,Girthygramps,sargeras,1238,druid,balance,24,13,11
9562,Erealana,tichondrius,1238,druid,balance,24,13,11
9563,Haxzr,sargeras,1237,druid,balance,42,23,19
9564,Guojue,tichondrius,1237,druid,balance,46,25,21
9565,Hawkk,azralon,1237,druid,balance,56,26,30
9566,Shuxz,sargeras,1235,druid,balance,60,32,28
9567,Astrixx,frostmourne,1233,druid,balance,18,13,5
9568,Miviaris,alleria,1233,druid,balance,30,13,17
9569,Exillïs,frostmourne,1231,druid,balance,39,19,20
9570,Tryrah,shattered-hand,1229,druid,balance,30,13,17
9571,Basilix,moon-guard,1226,druid,balance,63,30,33
9572,Vorare,tichondrius,1225,druid,balance,26,14,12
9573,Guitarsolos,nagrand,1225,druid,balance,30,13,17
9574,Zentabra,proudmoore,1225,druid,balance,42,18,24
9575,Kuroshizen,tichondrius,1224,druid,balance,94,39,55
9576,Ssïp,tichondrius,1223,druid,balance,31,14,17
9577,Amanara,echo-isles,1223,druid,balance,83,36,47
9578,Morphkow,sargeras,1222,druid,balance,69,36,33
9579,Sunboy,tichondrius,1221,druid,balance,73,36,37
9580,Partydip,stormrage,1221,druid,balance,30,13,17
9581,Apoc,bleeding-hollow,1220,druid,balance,18,13,5
9582,Mooing,azralon,1219,druid,balance,28,19,9
9583,Acidmoon,tichondrius,1219,druid,balance,52,22,30
9584,Pokémon,grizzly-hills,1218,druid,balance,24,13,11
9585,Strallà,illidan,1217,druid,balance,96,49,47
9586,Overfunk,ragnaros,1216,druid,balance,42,20,22
9587,Flatnose,agamaggan,1216,druid,balance,30,13,17
9588,Mutlèy,gundrak,1215,druid,balance,18,13,5
9589,Vuginas,bleeding-hollow,1215,druid,balance,62,33,29
9590,Worldbullguy,area-52,1215,druid,balance,36,16,20
9591,Feralchild,emerald-dream,1214,druid,balance,54,28,26
9592,Judgedruid,scilla,1213,druid,balance,36,22,14
9593,Cimanin,malganis,1213,druid,balance,24,13,11
9594,Crazystorm,ragnaros,1212,druid,balance,66,37,29
9595,Lindzy,moon-guard,1210,druid,balance,78,43,35
9596,Spawnolyonce,gorefiend,1210,druid,balance,34,14,20
9597,Elpako,ragnaros,1208,druid,balance,54,23,31
9598,Bayaba,tichondrius,1206,druid,balance,24,14,10
9599,Bobedroods,bonechewer,1205,druid,balance,30,16,14
9600,Lazerchicken,boulderfist,1204,druid,balance,30,13,17
9601,Tankbareass,aerie-peak,1203,druid,balance,42,16,26
9602,Huoxiaoying,tichondrius,1202,druid,balance,36,21,15
9603,Mufaasa,boulderfist,1202,druid,balance,90,47,43
9604,Pleasepime,stormrage,1202,druid,balance,84,35,49
9605,Dweralin,nemesis,1202,druid,balance,46,16,30
9606,Bobtail,moon-guard,1201,druid,balance,19,15,4
9607,Drßoom,stormrage,1201,druid,balance,89,38,51
9608,Firesun,quelthalas,1200,druid,balance,18,13,5
9609,Thehooligan,stormrage,1200,druid,balance,75,41,34
9610,Eintier,tichondrius,1200,druid,balance,35,19,16
9611,Kudro,garithos,1197,druid,balance,78,35,43
9612,Vaalser,frostmourne,1196,druid,balance,71,31,40
9613,Chillcat,illidan,1194,druid,balance,18,14,4
9614,Nolifer,sargeras,1192,druid,balance,30,17,13
9615,Crashägásm,proudmoore,1190,druid,balance,67,30,37
9616,Dampnr,tichondrius,1186,druid,balance,30,14,16
9617,Floridajoe,blackrock,1184,druid,balance,83,48,35
9618,Maxable,alleria,1184,druid,balance,27,14,13
9619,Gazwazluz,lothar,1183,druid,balance,51,31,20
9620,Cien,thrall,1182,druid,balance,117,53,64
9621,Zelyvia,moon-guard,1181,druid,balance,31,14,17
9622,Xvenusaur,bleeding-hollow,1179,druid,balance,24,16,8
9623,Stringbeáns,tanaris,1179,druid,balance,42,21,21
9624,Thorsèn,sargeras,1175,druid,balance,48,25,23
9625,Nobullshift,icecrown,1171,druid,balance,50,27,23
9626,Druisole,zuljin,1171,druid,balance,72,30,42
9627,Vicvc,tichondrius,1169,druid,balance,60,30,30
9628,Aberdare,tichondrius,1169,druid,balance,29,13,16
9629,Trythis,tichondrius,1167,druid,balance,61,28,33
9630,Blackmoons,thunderlord,1166,druid,balance,42,15,27
9631,Alphakatt,area-52,1165,druid,balance,84,38,46
9632,Dirtydot,ragnaros,1164,druid,balance,24,14,10
9633,Ryxu,emerald-dream,1161,druid,balance,26,15,11
9634,Simeron,silvermoon,1161,druid,balance,29,13,16
9635,Lydariel,tichondrius,1159,druid,balance,36,23,13
9636,Rahkaaga,kiljaeden,1158,druid,balance,36,21,15
9637,Mihnt,sargeras,1158,druid,balance,40,14,26
9638,Manglehornn,dalaran,1157,druid,balance,32,16,16
9639,Kattel,blackrock,1157,druid,balance,75,37,38
9640,Levincy,thrall,1156,druid,balance,60,33,27
9641,Mambuz,tichondrius,1154,druid,balance,66,35,31
9642,Dojacow,mannoroth,1154,druid,balance,34,16,18
9643,Hllw,tichondrius,1152,druid,balance,24,12,12
9644,Rougaroux,andorhal,1151,druid,balance,18,12,6
9645,Katbriel,zuljin,1151,druid,balance,18,12,6
9646,Ballnout,zuljin,1151,druid,balance,18,12,6
9647,Scraww,tichondrius,1151,druid,balance,29,14,15
9648,Suurik,blackhand,1151,druid,balance,28,13,15
9649,Hootiepie,hyjal,1150,druid,balance,18,12,6
9650,Mcy,nerzhul,1150,druid,balance,24,12,12
9651,Buckeye,tichondrius,1150,druid,balance,24,12,12
9652,Borrdru,arthas,1150,druid,balance,24,12,12
9653,Zebyn,tichondrius,1149,druid,balance,18,12,6
9654,Ralphrawr,barthilas,1149,druid,balance,24,12,12
9655,Numbkin,stormrage,1149,druid,balance,30,12,18
9656,Maserati,emerald-dream,1148,druid,balance,18,12,6
9657,Uckin,bleeding-hollow,1148,druid,balance,24,12,12
9658,Yoona,kiljaeden,1148,druid,balance,24,12,12
9659,Exxosd,tichondrius,1146,druid,balance,18,12,6
9660,Jocek,stormrage,1146,druid,balance,18,12,6
9661,Coppersnout,moon-guard,1146,druid,balance,66,37,29
9662,Sakurao,tichondrius,1146,druid,balance,24,12,12
9663,Cthulhuqt,kelthuzad,1145,druid,balance,18,12,6
9664,Roots,boulderfist,1144,druid,balance,30,13,17
9665,Gravshift,zuljin,1143,druid,balance,18,12,6
9666,Sjchicken,tichondrius,1143,druid,balance,24,12,12
9667,Ganh,demon-soul,1142,druid,balance,24,14,10
9668,Sìrfüzzy,proudmoore,1142,druid,balance,24,12,12
9669,Mørphea,darkspear,1141,druid,balance,30,12,18
9670,Redwallon,emerald-dream,1139,druid,balance,18,12,6
9671,Radagaste,stormrage,1139,druid,balance,24,12,12
9672,Serega,skywall,1138,druid,balance,24,12,12
9673,Slep,tichondrius,1138,druid,balance,24,12,12
9674,Leetpete,eitrigg,1138,druid,balance,24,12,12
9675,Jawsbar,tichondrius,1138,druid,balance,30,12,18
9676,Dodid,laughing-skull,1137,druid,balance,60,30,30
9677,Ungreed,tichondrius,1136,druid,balance,18,12,6
9678,Aozeh,kiljaeden,1136,druid,balance,18,12,6
9679,Furrycringe,stormrage,1135,druid,balance,30,12,18
9680,Sodapoopins,stormrage,1135,druid,balance,30,12,18
9681,Hootyhoot,illidan,1133,druid,balance,18,12,6
9682,Zoomchicken,stormrage,1132,druid,balance,18,12,6
9683,Ðementia,stormrage,1131,druid,balance,36,12,24
9684,Coggtron,uther,1130,druid,balance,24,16,8
9685,Redbbull,tichondrius,1129,druid,balance,73,42,31
9686,Meowfacebby,stormrage,1128,druid,balance,23,12,11
9687,Aolus,kaelthas,1128,druid,balance,74,36,38
9688,Treeteej,kelthuzad,1128,druid,balance,36,16,20
9689,Lunapuma,stonemaul,1127,druid,balance,18,12,6
9690,Iamatomic,illidan,1126,druid,balance,102,49,53
9691,Kuthian,moon-guard,1126,druid,balance,39,17,22
9692,Lacroix,wildhammer,1123,druid,balance,30,20,10
9693,Dennyyd,illidan,1118,druid,balance,18,13,5
9694,Burninmôön,tichondrius,1118,druid,balance,35,12,23
9695,Toofast,lightninghoof,1114,druid,balance,18,12,6
9696,Smashthatbox,illidan,1113,druid,balance,44,17,27
9697,Seytu,sargeras,1112,druid,balance,26,13,13
9698,Wïldmain,area-52,1111,druid,balance,20,13,7
9699,Bwokhanji,proudmoore,1111,druid,balance,24,12,12
9700,Naturlig,area-52,1109,druid,balance,24,13,11
9701,Ilgalsard,frostmourne,1109,druid,balance,36,16,20
9702,Pigmanbear,kelthuzad,1109,druid,balance,30,12,18
9703,Gavalle,khaz-modan,1107,druid,balance,120,66,54
9704,Nozgöth,quelthalas,1105,druid,balance,128,67,61
9705,Desiration,area-52,1104,druid,balance,21,12,9
9706,Ûñø,frostmourne,1101,druid,balance,42,24,18
9707,Elsombrak,onyxia,1095,druid,balance,24,14,10
9708,Krazykritz,illidan,1090,druid,balance,27,13,14
9709,Kniitvekitta,jubeithos,1088,druid,balance,30,16,14
9710,Moistcream,tichondrius,1087,druid,balance,21,12,9
9711,Zeromeme,frostmourne,1086,druid,balance,20,12,8
9712,Circadion,illidan,1084,druid,balance,59,23,36
9713,Bethemarble,sargeras,1084,druid,balance,57,22,35
9714,Møønscar,tichondrius,1081,druid,balance,70,29,41
9715,Minxminx,moon-guard,1080,druid,balance,46,13,33
9716,Dabomb,malorne,1077,druid,balance,23,12,11
9717,Wyldthangz,stormrage,1077,druid,balance,26,12,14
9718,Pilaufakka,zuljin,1074,druid,balance,36,19,17
9719,Blckyoungsta,illidan,1073,druid,balance,18,13,5
9720,Dumdumdugan,korgath,1068,druid,balance,131,61,70
9721,Bluechicken,sargeras,1065,druid,balance,30,17,13
9722,Klyadedfogud,trollbane,1063,druid,balance,41,22,19
9723,Pandajerk,tichondrius,1061,druid,balance,36,17,19
9724,Miggzii,draka,1061,druid,balance,45,19,26
9725,Bulldog,runetotem,1057,druid,balance,18,12,6
9726,Drdoomerkin,area-52,1056,druid,balance,12,11,1
9727,Roccko,illidan,1056,druid,balance,18,11,7
9728,Martians,laughing-skull,1056,druid,balance,18,11,7
9729,Owlbearthing,sargeras,1056,druid,balance,78,29,49
9730,Mastahskills,illidan,1055,druid,balance,18,11,7
9731,Piment,tichondrius,1055,druid,balance,18,11,7
9732,ßigfoot,darkspear,1055,druid,balance,18,11,7
9733,Slys,frostmourne,1055,druid,balance,18,11,7
9734,Docleave,tichondrius,1055,druid,balance,18,11,7
9735,Smwise,tichondrius,1055,druid,balance,18,11,7
9736,Ryannshiftz,proudmoore,1054,druid,balance,18,11,7
9737,Atreis,malganis,1054,druid,balance,18,11,7
9738,Cumvokinlol,sargeras,1054,druid,balance,18,11,7
9739,Buffclyde,blackrock,1054,druid,balance,18,11,7
9740,Ono,daggerspine,1054,druid,balance,18,11,7
9741,Chococrispis,quelthalas,1054,druid,balance,18,11,7
9742,Kimgurdian,tichondrius,1053,druid,balance,18,11,7
9743,Johnnybigg,barthilas,1053,druid,balance,18,11,7
9744,Jacinty,saurfang,1052,druid,balance,18,11,7
9745,Stennz,tichondrius,1052,druid,balance,18,11,7
9746,Fjblol,sargeras,1051,druid,balance,24,11,13
9747,Milkshift,demon-soul,1051,druid,balance,24,11,13
9748,Samsshifter,tichondrius,1050,druid,balance,24,11,13
9749,Arnlu,malganis,1050,druid,balance,24,11,13
9750,Msparker,illidan,1050,druid,balance,36,11,25
9751,Bearyhalls,frostmourne,1049,druid,balance,21,13,8
9752,Àbyss,moon-guard,1049,druid,balance,18,11,7
9753,Roshaka,shadowmoon,1049,druid,balance,24,11,13
9754,Ramannoodlr,tichondrius,1049,druid,balance,24,11,13
9755,Trashytrash,bleeding-hollow,1049,druid,balance,30,11,19
9756,Beastmanqq,kiljaeden,1048,druid,balance,18,11,7
9757,Zhuaraksha,kelthuzad,1048,druid,balance,24,11,13
9758,Fluff,gurubashi,1048,druid,balance,24,11,13
9759,Siberian,lightnings-blade,1048,druid,balance,24,11,13
9760,Nefnef,malganis,1048,druid,balance,24,11,13
9761,Shavedtaco,azshara,1047,druid,balance,12,11,1
9762,Sekzor,darkspear,1047,druid,balance,18,11,7
9763,Wídëwínkër,thrall,1047,druid,balance,18,11,7
9764,Chikenflu,tichondrius,1047,druid,balance,22,11,11
9765,Mäya,jubeithos,1047,druid,balance,24,11,13
9766,Karpin,area-52,1046,druid,balance,18,11,7
9767,Catrene,mannoroth,1045,druid,balance,45,28,17
9768,Coochi,sargeras,1044,druid,balance,18,11,7
9769,Bluethebull,lothar,1044,druid,balance,30,11,19
9770,Druihd,stormrage,1042,druid,balance,36,20,16
9771,Andrés,azralon,1041,druid,balance,18,11,7
9772,Nîghtcráwlér,tichondrius,1040,druid,balance,47,28,19
9773,Justwade,tichondrius,1037,druid,balance,24,11,13
9774,Jherrak,area-52,1035,druid,balance,18,11,7
9775,Bearhug,dragonmaw,1034,druid,balance,18,11,7
9776,Xoth,executus,1033,druid,balance,24,11,13
9777,Aton,frostwolf,1031,druid,balance,18,11,7
9778,Superhorsey,aggramar,1031,druid,balance,36,19,17
9779,Schmeatbawls,illidan,1031,druid,balance,23,11,12
9780,Balantina,tichondrius,1029,druid,balance,36,15,21
9781,Muhana,runetotem,1028,druid,balance,24,11,13
9782,Reeiyna,gallywix,1026,druid,balance,60,35,25
9783,Tuggmyudder,area-52,1026,druid,balance,43,21,22
9784,Thèbearjèw,tichondrius,1024,druid,balance,55,23,32
9785,Malamew,antonidas,1016,druid,balance,18,12,6
9786,Lumipawz,frostmourne,1014,druid,balance,19,12,7
9787,Riprip,tichondrius,1012,druid,balance,27,12,15
9788,Bloomsong,emerald-dream,1012,druid,balance,30,13,17
9789,Araminka,drakkari,1011,druid,balance,12,11,1
9790,Vapeculture,lightbringer,1004,druid,balance,54,31,23
9791,Shifterx,illidan,1002,druid,balance,28,15,13
9792,Arescarriess,shuhalo,1002,druid,balance,23,11,12
9793,ßrian,stormscale,1002,druid,balance,24,11,13
9794,Dustin,moon-guard,1000,druid,balance,22,12,10
9795,Naturae,spirestone,990,druid,balance,14,11,3
9796,Caminanube,quelthalas,989,druid,balance,30,13,17
9797,Warberton,moon-guard,988,druid,balance,25,13,12
9798,Smallrichard,bleeding-hollow,986,druid,balance,27,11,16
9799,Amigomel,emerald-dream,985,druid,balance,23,11,12
9800,Indy,rivendare,980,druid,balance,22,11,11
9801,Spazz,firetree,975,druid,balance,17,11,6
9802,Abzyplasm,sargeras,975,druid,balance,24,11,13
9803,Sever,ysera,974,druid,balance,36,16,20
9804,Cowel,tichondrius,969,druid,balance,25,11,14
9805,Azevedoo,nemesis,961,druid,balance,43,13,30
9806,Killy,nazjatar,960,druid,balance,12,10,2
9807,Soahclleh,sargeras,960,druid,balance,12,10,2
9808,Jubi,bleeding-hollow,960,druid,balance,12,10,2
9809,Fäncy,sargeras,960,druid,balance,12,10,2
9810,Ylanglang,sargeras,960,druid,balance,12,10,2
9811,Beamerboy,bleeding-hollow,960,druid,balance,18,10,8
9812,Sÿndru,illidan,960,druid,balance,18,10,8
9813,Arenamasterx,stormscale,960,druid,balance,18,10,8
9814,Roben,tichondrius,960,druid,balance,18,10,8
9815,Bfaboomy,stormrage,960,druid,balance,24,10,14
9816,Starfallz,illidan,960,druid,balance,24,10,14
9817,Jshwills,sargeras,959,druid,balance,12,10,2
9818,Hautheurel,illidan,959,druid,balance,12,10,2
9819,Feaveldin,moon-guard,959,druid,balance,12,10,2
9820,Rahwan,bleeding-hollow,959,druid,balance,12,10,2
9821,Ephwürd,malganis,959,druid,balance,18,10,8
9822,Jaz,jubeithos,959,druid,balance,18,10,8
9823,Kohru,moon-guard,959,druid,balance,18,10,8
9824,Sàbrè,darkspear,959,druid,balance,18,10,8
9825,Credd,zuljin,959,druid,balance,18,10,8
9826,Tankzsz,malganis,959,druid,balance,18,10,8
9827,Poshspise,nathrezim,959,druid,balance,18,10,8
9828,Hyzah,tichondrius,959,druid,balance,18,10,8
9829,Skaie,ragnaros,959,druid,balance,18,10,8
9830,Sill,illidan,959,druid,balance,18,10,8
9831,Furor,eonar,959,druid,balance,24,10,14
9832,Blàtté,zuljin,958,druid,balance,12,10,2
9833,Furocious,shadowsong,958,druid,balance,12,10,2
9834,Biggieclawz,tichondrius,958,druid,balance,12,10,2
9835,Swiftboom,stormrage,958,druid,balance,18,10,8
9836,Bumbleebee,azralon,958,druid,balance,18,10,8
9837,Immortalowl,illidan,958,druid,balance,18,10,8
9838,Psilo,kelthuzad,958,druid,balance,18,10,8
9839,Tensuen,boulderfist,958,druid,balance,22,10,12
9840,Kushidabs,tichondrius,958,druid,balance,34,11,23
9841,Messyboom,illidan,957,druid,balance,12,10,2
9842,Islayne,moon-guard,957,druid,balance,12,10,2
9843,Fugg,frostmourne,957,druid,balance,18,10,8
9844,Grymdruid,wyrmrest-accord,956,druid,balance,12,10,2
9845,Nøzopium,kelthuzad,956,druid,balance,18,10,8
9846,Drewpg,zuljin,955,druid,balance,18,10,8
9847,Fixn,tichondrius,955,druid,balance,18,10,8
9848,Giantmoobies,zuluhed,955,druid,balance,18,10,8
9849,Druidmf,sargeras,955,druid,balance,18,10,8
9850,Vashida,stormrage,955,druid,balance,24,10,14
9851,Bozart,stormrage,954,druid,balance,18,10,8
9852,Antagonist,burning-blade,954,druid,balance,18,10,8
9853,Maldobear,stormrage,954,druid,balance,24,10,14
9854,Dèrpin,thrall,954,druid,balance,33,11,22
9855,Ardelorfin,kargath,953,druid,balance,18,10,8
9856,Ridicules,cenarius,953,druid,balance,18,10,8
9857,Santogrial,blood-furnace,953,druid,balance,46,25,21
9858,Dethkight,area-52,953,druid,balance,22,11,11
9859,Jal,khazgoroth,953,druid,balance,20,10,10
9860,Wìtchdoctor,barthilas,953,druid,balance,24,10,14
9861,Crunkk,thunderlord,952,druid,balance,18,10,8
9862,Hadoriss,kelthuzad,952,druid,balance,24,10,14
9863,Barecowbear,bleeding-hollow,951,druid,balance,24,10,14
9864,Ohzú,ragnaros,950,druid,balance,18,10,8
9865,Ðarkscar,laughing-skull,943,druid,balance,50,18,32
9866,Skiouros,emerald-dream,943,druid,balance,36,10,26
9867,Gidam,moon-guard,941,druid,balance,18,10,8
9868,Soulhealer,quelthalas,940,druid,balance,18,10,8
9869,Rakelan,tichondrius,937,druid,balance,146,75,71
9870,Boatox,jubeithos,931,druid,balance,30,10,20
9871,Psychoboomi,bleeding-hollow,927,druid,balance,24,13,11
9872,Chrisclones,stormrage,925,druid,balance,29,10,19
9873,Beleraine,moon-guard,915,druid,balance,23,10,13
9874,Rennar,stormrage,911,druid,balance,17,10,7
9875,Maular,jubeithos,911,druid,balance,34,10,24
9876,Fancyprance,dalaran,910,druid,balance,29,10,19
9877,Athious,moon-guard,909,druid,balance,29,13,16
9878,Jokey,quelthalas,906,druid,balance,18,11,7
9879,Sennur,kelthuzad,905,druid,balance,18,10,8
9880,Aroxus,tichondrius,903,druid,balance,23,10,13
9881,Tinyypuppyy,sargeras,903,druid,balance,36,12,24
9882,Stretchhxd,tichondrius,900,druid,balance,21,10,11
9883,Bellä,nazjatar,900,druid,balance,37,11,26
9884,Meiling,spirestone,897,druid,balance,24,12,12
9885,Wantto,moknathal,894,druid,balance,54,26,28
9886,Weezydende,area-52,894,druid,balance,63,19,44
9887,Campdoctor,azralon,890,druid,balance,20,10,10
9888,Sneakichode,tichondrius,889,druid,balance,20,10,10
9889,Nalarin,kaelthas,878,druid,balance,72,35,37
9890,Redrocket,eldrethalas,876,druid,balance,19,10,9
9891,Tinwhiskerz,bleeding-hollow,864,druid,balance,12,9,3
9892,Erutan,malganis,864,druid,balance,12,9,3
9893,Foxxyroxxy,malganis,864,druid,balance,12,9,3
9894,Gerrt,bleeding-hollow,864,druid,balance,12,9,3
9895,Hëllchaos,sargeras,864,druid,balance,12,9,3
9896,Maen,kelthuzad,864,druid,balance,12,9,3
9897,Hännibal,hydraxis,864,druid,balance,12,9,3
9898,Mengniulol,tichondrius,864,druid,balance,12,9,3
9899,Ðraoï,stormrage,864,druid,balance,12,9,3
9900,Simperella,dalaran,864,druid,balance,12,9,3
9901,Stargrazing,tichondrius,864,druid,balance,12,9,3
9902,Toastsdruid,tichondrius,864,druid,balance,12,9,3
9903,Mvpps,thrall,864,druid,balance,18,9,9
9904,Kûramä,dalaran,864,druid,balance,18,9,9
9905,Oatmeals,fizzcrank,864,druid,balance,18,9,9
9906,Kittycatman,tichondrius,864,druid,balance,18,9,9
9907,Zydea,stormrage,864,druid,balance,18,9,9
9908,Gôdôfwow,tichondrius,864,druid,balance,18,9,9
9909,Lunartiç,kelthuzad,864,druid,balance,18,9,9
9910,Proudmom,barthilas,864,druid,balance,24,9,15
9911,Lesbianitax,stormrage,863,druid,balance,12,9,3
9912,Zmk,barthilas,863,druid,balance,12,9,3
9913,Purrfessorx,proudmoore,863,druid,balance,12,9,3
9914,Oldcreg,emerald-dream,863,druid,balance,12,9,3
9915,Cerberus,tanaris,863,druid,balance,12,9,3
9916,Jesterdru,area-52,863,druid,balance,12,9,3
9917,Flamejacker,tichondrius,863,druid,balance,12,9,3
9918,Hàchi,malganis,863,druid,balance,12,9,3
9919,Gladdz,tichondrius,863,druid,balance,12,9,3
9920,Flappyboí,proudmoore,863,druid,balance,15,10,5
9921,Wyldfire,azjolnerub,863,druid,balance,18,9,9
9922,Môônkîn,chogall,863,druid,balance,18,9,9
9923,Petitjeremy,zuljin,863,druid,balance,18,9,9
9924,Cösmic,anetheron,863,druid,balance,18,9,9
9925,Nerzert,sargeras,863,druid,balance,18,9,9
9926,Velaar,arthas,863,druid,balance,18,9,9
9927,Starkraven,firetree,863,druid,balance,18,9,9
9928,Supriix,moon-guard,863,druid,balance,18,9,9
9929,Céléstial,azralon,863,druid,balance,18,9,9
9930,Amookelia,tichondrius,863,druid,balance,18,9,9
9931,Bullcritzz,saurfang,863,druid,balance,18,9,9
9932,Furrysacks,sargeras,863,druid,balance,18,9,9
9933,Doots,aegwynn,863,druid,balance,18,9,9
9934,Galadriowl,dalaran,863,druid,balance,24,9,15
9935,Dolwizz,tichondrius,863,druid,balance,24,9,15
9936,Oreoshift,illidan,862,druid,balance,12,9,3
9937,Rootslayer,tichondrius,862,druid,balance,12,9,3
9938,Zugdruid,tichondrius,862,druid,balance,13,9,4
9939,Elydaria,destromath,862,druid,balance,24,12,12
9940,Muagor,tichondrius,862,druid,balance,18,9,9
9941,Hallthrok,stormrage,862,druid,balance,18,9,9
9942,Felløwship,nemesis,862,druid,balance,18,9,9
9943,Vèrsusapp,thrall,862,druid,balance,18,9,9
9944,Shack,alterac-mountains,862,druid,balance,18,9,9
9945,Furrmissile,area-52,862,druid,balance,18,9,9
9946,Tinkker,zuljin,861,druid,balance,12,9,3
9947,Newclear,tichondrius,861,druid,balance,12,9,3
9948,Actiad,stormrage,861,druid,balance,16,10,6
9949,Atsiri,tichondrius,861,druid,balance,17,10,7
9950,Thullian,stormrage,861,druid,balance,19,10,9
9951,Starslicer,vashj,861,druid,balance,18,9,9
9952,Goldentaint,tichondrius,861,druid,balance,24,9,15
9953,Blizdontcuur,area-52,860,druid,balance,12,9,3
9954,Sanleba,tichondrius,860,druid,balance,18,9,9
9955,Soviclol,malganis,859,druid,balance,18,9,9
9956,Goldzin,stormrage,859,druid,balance,21,10,11
9957,Bestik,quelthalas,859,druid,balance,24,9,15
9958,Moringo,azralon,858,druid,balance,12,9,3
9959,Stormrrage,demon-soul,858,druid,balance,18,9,9
9960,Amandi,magtheridon,858,druid,balance,24,9,15
9961,Kamionero,drakkari,856,druid,balance,12,9,3
9962,Twanheal,kiljaeden,856,druid,balance,12,9,3
9963,Elatheris,stormrage,855,druid,balance,18,9,9
9964,Dizzyshiftz,dalaran,852,druid,balance,30,9,21
9965,Tmoby,emerald-dream,850,druid,balance,24,9,15
9966,Sleek,illidan,850,druid,balance,24,9,15
9967,Everglim,azralon,847,druid,balance,24,9,15
9968,Dèmønblâckev,malganis,842,druid,balance,24,11,13
9969,Bulldohz,tichondrius,837,druid,balance,18,9,9
9970,Tyrana,bloodscalp,833,druid,balance,18,9,9
9971,Starsfall,tichondrius,831,druid,balance,16,9,7
9972,Nokther,muradin,830,druid,balance,28,9,19
9973,Dankasauras,tichondrius,830,druid,balance,42,13,29
9974,Taurenosorus,illidan,827,druid,balance,64,29,35
9975,Chicknfingaz,tichondrius,802,druid,balance,16,10,6
9976,Stetile,azralon,800,druid,balance,16,9,7
9977,Jieter,malganis,799,druid,balance,14,9,5
9978,Leeteracola,malganis,798,druid,balance,20,9,11
9979,Meliódás,area-52,795,druid,balance,204,84,120
9980,Grgcostanza,bleeding-hollow,793,druid,balance,14,9,5
9981,Vyntrix,kelthuzad,792,druid,balance,20,9,11
9982,Astroshift,emerald-dream,784,druid,balance,20,9,11
9983,Haallanna,thunderlord,774,druid,balance,16,9,7
9984,Elyiaida,emerald-dream,768,druid,balance,12,8,4
9985,Cabrøn,illidan,768,druid,balance,12,8,4
9986,Abelladañger,area-52,768,druid,balance,12,8,4
9987,Mikelovin,nemesis,768,druid,balance,12,8,4
9988,Clawyou,illidan,768,druid,balance,12,8,4
9989,Aenari,anvilmar,768,druid,balance,12,8,4
9990,Drakeowl,area-52,768,druid,balance,12,8,4
9991,Yøpìèrre,zuljin,768,druid,balance,12,8,4
9992,Bearlylegál,sargeras,768,druid,balance,12,8,4
9993,Notports,tichondrius,768,druid,balance,12,8,4
9994,Treesrlegal,area-52,768,druid,balance,12,8,4
9995,Ryanspeed,mugthol,768,druid,balance,12,8,4
9996,Moistism,tichondrius,768,druid,balance,12,8,4
9997,Sñìp,zuljin,768,druid,balance,12,8,4
9998,Argento,frostmourne,768,druid,balance,12,8,4
9999,Thallid,hydraxis,768,druid,balance,12,8,4
10000,Shînx,malganis,768,druid,balance,12,8,4
10001,Catmoomoo,tichondrius,768,druid,balance,12,8,4
10002,Jisoojwa,frostmourne,768,druid,balance,12,8,4
10003,Løk,sargeras,768,druid,balance,12,8,4
10004,Nothecia,sargeras,768,druid,balance,12,8,4
10005,Oopygoopy,bleeding-hollow,768,druid,balance,12,8,4
10006,Guuh,tichondrius,768,druid,balance,12,8,4
10007,Azakai,sargeras,768,druid,balance,12,8,4
10008,Eskimocowboy,sargeras,768,druid,balance,12,8,4
10009,Nyzear,bleeding-hollow,768,druid,balance,12,8,4
10010,Shiftytom,spirestone,768,druid,balance,12,8,4
10011,Hootforce,spirestone,768,druid,balance,12,8,4
10012,Laserxo,tichondrius,768,druid,balance,12,8,4
10013,Wizkd,tichondrius,768,druid,balance,12,8,4
10014,Ayyva,proudmoore,768,druid,balance,12,8,4
10015,Meesterwolf,tichondrius,768,druid,balance,12,8,4
10016,Aconcat,bleeding-hollow,768,druid,balance,12,8,4
10017,Mådge,frostmourne,768,druid,balance,12,8,4
10018,Shaney,zuljin,768,druid,balance,12,8,4
10019,Moonlitgrove,silvermoon,768,druid,balance,12,8,4
10020,Duckdie,moon-guard,768,druid,balance,12,8,4
10021,Chayten,bleeding-hollow,768,druid,balance,12,8,4
10022,Juhji,dalaran,768,druid,balance,12,8,4
10023,Chickenbeam,tichondrius,768,druid,balance,17,8,9
10024,Onsen,tichondrius,768,druid,balance,18,8,10
10025,Dotdmage,tichondrius,768,druid,balance,18,8,10
10026,Drop,shadow-council,767,druid,balance,10,9,1
10027,Bearmäntle,ragnaros,767,druid,balance,12,8,4
10028,Wizgarkin,area-52,767,druid,balance,12,8,4
10029,Arellea,uther,767,druid,balance,12,8,4
10030,Starbender,arygos,767,druid,balance,12,8,4
10031,Arntu,malganis,767,druid,balance,12,8,4
10032,Eøle,stormrage,767,druid,balance,12,8,4
10033,Koluna,stormrage,767,druid,balance,12,8,4
10034,Smokeheaters,dalaran,767,druid,balance,12,8,4
10035,Rootyou,frostmourne,767,druid,balance,12,8,4
10036,Notadopted,sargeras,767,druid,balance,12,8,4
10037,Neurotoxins,tichondrius,767,druid,balance,12,8,4
10038,Kimimàrø,illidan,767,druid,balance,12,8,4
10039,Harddeenball,area-52,767,druid,balance,15,9,6
10040,Gloomcat,illidan,767,druid,balance,18,8,10
10041,Snw,sargeras,767,druid,balance,18,8,10
10042,Ebonclaw,malganis,767,druid,balance,18,8,10
10043,Tomletrain,zuljin,767,druid,balance,18,8,10
10044,Ruckiz,stormrage,767,druid,balance,18,8,10
10045,Aesthetical,frostmourne,767,druid,balance,18,8,10
10046,Jiya,zuljin,767,druid,balance,18,8,10
10047,Whiteglade,moon-guard,767,druid,balance,18,8,10
10048,Khristine,spinebreaker,767,druid,balance,24,8,16
10049,Onidudu,frostmourne,766,druid,balance,12,8,4
10050,Volgoro,thrall,766,druid,balance,12,8,4
10051,Melizaa,stormrage,766,druid,balance,12,8,4
10052,Mornis,zuljin,766,druid,balance,12,8,4
10053,Museafour,tichondrius,766,druid,balance,12,8,4
10054,Shadowformer,kelthuzad,766,druid,balance,15,9,6
10055,Cloyer,stormrage,766,druid,balance,18,8,10
10056,Nxghtfall,tichondrius,766,druid,balance,18,8,10
10057,Kastro,frostwolf,766,druid,balance,18,8,10
10058,Jashrus,korgath,765,druid,balance,12,8,4
10059,Whitekongg,blackhand,765,druid,balance,15,9,6
10060,Sefestria,senjin,765,druid,balance,18,8,10
10061,Tegrizelle,cenarion-circle,765,druid,balance,18,8,10
10062,Motörcharge,bleeding-hollow,764,druid,balance,12,8,4
10063,Kelylea,the-underbog,764,druid,balance,18,8,10
10064,Crépes,bleeding-hollow,764,druid,balance,18,8,10
10065,Architech,bleeding-hollow,764,druid,balance,24,8,16
10066,Wabbehkus,barthilas,764,druid,balance,26,8,18
10067,Eiel,undermine,763,druid,balance,12,8,4
10068,Chewychips,malganis,763,druid,balance,12,8,4
10069,Anttfj,mannoroth,763,druid,balance,18,8,10
10070,Psnárf,area-52,763,druid,balance,18,8,10
10071,Herbirove,frostmourne,762,druid,balance,12,8,4
10072,Astromyles,tichondrius,762,druid,balance,25,8,17
10073,Krustyora,khazgoroth,761,druid,balance,18,11,7
10074,Baaksau,illidan,761,druid,balance,18,8,10
10075,Freyaborn,sargeras,760,druid,balance,17,9,8
10076,Jtogethendr,area-52,759,druid,balance,12,8,4
10077,Boneheir,proudmoore,757,druid,balance,21,9,12
10078,Seethert,quelthalas,751,druid,balance,12,8,4
10079,Undeadshammy,tichondrius,736,druid,balance,16,9,7
10080,Outclone,tichondrius,734,druid,balance,10,9,1
10081,Tarukke,azralon,734,druid,balance,20,9,11
10082,Outandy,quelthalas,727,druid,balance,17,8,9
10083,Druz,spirestone,703,druid,balance,11,8,3
10084,Iloveweed,tichondrius,703,druid,balance,11,8,3
10085,Jukebóx,stormrage,701,druid,balance,20,8,12
10086,Mooncry,wyrmrest-accord,700,druid,balance,26,9,17
10087,Alaskanimal,illidan,696,druid,balance,16,8,8
10088,Shiftness,nordrassil,679,druid,balance,11,8,3
10089,Xioqt,chogall,672,druid,balance,12,7,5
10090,Akiiragata,azralon,672,druid,balance,12,7,5
10091,Pantec,eredar,672,druid,balance,12,7,5
10092,Saltkin,frostmourne,672,druid,balance,12,7,5
10093,Taysfriend,tichondrius,672,druid,balance,12,7,5
10094,Bronnasaurus,tichondrius,672,druid,balance,12,7,5
10095,Riptin,kelthuzad,672,druid,balance,12,7,5
10096,Eizruk,tichondrius,672,druid,balance,12,7,5
10097,Slickthick,sargeras,672,druid,balance,12,7,5
10098,Omegablasted,tichondrius,672,druid,balance,12,7,5
10099,Alteraim,thrall,672,druid,balance,12,7,5
10100,Wascar,sargeras,672,druid,balance,12,7,5
10101,Delayedxd,bleeding-hollow,672,druid,balance,12,7,5
10102,Straitbeast,tichondrius,672,druid,balance,12,7,5
10103,Flapping,illidan,672,druid,balance,12,7,5
10104,Dsavart,stormrage,672,druid,balance,12,7,5
10105,Blamkin,tichondrius,672,druid,balance,12,7,5
10106,Notsofat,deathwing,672,druid,balance,12,7,5
10107,Nutbutterpie,stormrage,672,druid,balance,12,7,5
10108,Mar,misha,672,druid,balance,12,7,5
10109,Zoonkin,tichondrius,672,druid,balance,12,7,5
10110,Pepperpawz,emerald-dream,672,druid,balance,12,7,5
10111,Covidcarrier,thrall,672,druid,balance,12,7,5
10112,Nbnbnb,proudmoore,672,druid,balance,12,7,5
10113,Wildllama,moon-guard,672,druid,balance,12,7,5
10114,Qtkinzz,illidan,672,druid,balance,12,7,5
10115,Fixxitfelix,sargeras,672,druid,balance,12,7,5
10116,Kassadega,sargeras,672,druid,balance,12,7,5
10117,Redscyclone,dalaran,672,druid,balance,12,7,5
10118,Talinel,illidan,672,druid,balance,12,7,5
10119,Stacker,malganis,672,druid,balance,12,7,5
10120,Elithyra,area-52,672,druid,balance,12,7,5
10121,Moonkiin,sargeras,672,druid,balance,12,7,5
10122,Suedou,moon-guard,672,druid,balance,12,7,5
10123,Donaldsr,area-52,672,druid,balance,12,7,5
10124,Selvius,area-52,672,druid,balance,12,7,5
10125,Floofi,kelthuzad,672,druid,balance,12,7,5
10126,Boomypower,dalaran,672,druid,balance,12,7,5
10127,Lalalu,frostmourne,672,druid,balance,15,8,7
10128,Ogdöstitz,area-52,672,druid,balance,14,7,7
10129,Alastras,tichondrius,672,druid,balance,18,7,11
10130,Necromos,argent-dawn,672,druid,balance,18,7,11
10131,Sunspot,tichondrius,672,druid,balance,18,7,11
10132,Slaÿr,malganis,672,druid,balance,18,7,11
10133,Ginunaga,tichondrius,672,druid,balance,18,7,11
10134,Jalapenoz,wyrmrest-accord,672,druid,balance,18,7,11
10135,Avbox,proudmoore,672,druid,balance,18,7,11
10136,Purrfessor,proudmoore,672,druid,balance,18,7,11
10137,Shrubzilla,area-52,672,druid,balance,24,7,17
10138,Longstory,bonechewer,671,druid,balance,12,7,5
10139,Bambam,frostwolf,671,druid,balance,12,7,5
10140,Cashgame,malganis,671,druid,balance,12,7,5
10141,Mommybod,stormrage,671,druid,balance,12,7,5
10142,Bvó,stormrage,671,druid,balance,12,7,5
10143,Juicedkin,tichondrius,671,druid,balance,12,7,5
10144,Dgas,tichondrius,671,druid,balance,12,7,5
10145,Cleppy,korgath,671,druid,balance,12,7,5
10146,Iluvbae,bleeding-hollow,671,druid,balance,12,7,5
10147,Dobidas,tichondrius,671,druid,balance,12,7,5
10148,Trìckyz,tichondrius,671,druid,balance,12,7,5
10149,Ripx,khadgar,671,druid,balance,12,7,5
10150,Ayari,sargeras,671,druid,balance,12,7,5
10151,Stickyleavz,sargeras,671,druid,balance,12,7,5
10152,Feathergun,ragnaros,671,druid,balance,12,7,5
10153,Tubemagnet,tichondrius,671,druid,balance,12,7,5
10154,Jazzmaster,barthilas,671,druid,balance,12,7,5
10155,Catalytic,frostmourne,671,druid,balance,15,8,7
10156,Ioncannon,darrowmere,671,druid,balance,18,7,11
10157,Starsurged,moon-guard,671,druid,balance,18,7,11
10158,Barkcheeks,area-52,671,druid,balance,18,7,11
10159,Oakmont,darkspear,671,druid,balance,18,7,11
10160,Schnitter,thrall,671,druid,balance,18,7,11
10161,Ichangeabull,bleeding-hollow,671,druid,balance,18,7,11
10162,Ellysian,malganis,671,druid,balance,18,7,11
10163,Dashio,lightnings-blade,671,druid,balance,18,7,11
10164,Rabbismang,area-52,671,druid,balance,24,7,17
10165,Budtender,moon-guard,670,druid,balance,12,7,5
10166,Tabbo,uther,670,druid,balance,12,7,5
10167,Traxxo,tichondrius,670,druid,balance,12,7,5
10168,Oâk,farstriders,670,druid,balance,12,7,5
10169,Chukksz,nerzhul,670,druid,balance,12,7,5
10170,Brodinmmx,bleeding-hollow,670,druid,balance,18,7,11
10171,Runestar,malganis,670,druid,balance,18,7,11
10172,Joshuah,stormrage,670,druid,balance,18,7,11
10173,Teziq,sargeras,670,druid,balance,18,7,11
10174,Gilgorash,kiljaeden,670,druid,balance,24,7,17
10175,Bruddanature,dawnbringer,670,druid,balance,24,7,17
10176,Chillygraves,stormrage,670,druid,balance,24,7,17
10177,Aviendiana,thrall,669,druid,balance,12,7,5
10178,Eurotrance,frostmourne,669,druid,balance,12,7,5
10179,Hpcorrection,bleeding-hollow,669,druid,balance,18,7,11
10180,Flapjack,malganis,669,druid,balance,18,7,11
10181,Onecalf,tichondrius,668,druid,balance,12,7,5
10182,Rastafan,proudmoore,668,druid,balance,18,7,11
10183,Wresty,frostmourne,667,druid,balance,12,7,5
10184,Jackalman,tanaris,666,druid,balance,12,7,5
10185,Krunge,frostwolf,665,druid,balance,12,7,5
10186,Coqeh,frostwolf,664,druid,balance,12,7,5
10187,Beammz,stormrage,664,druid,balance,15,8,7
10188,Pao,nordrassil,664,druid,balance,18,7,11
10189,Kångåwalafox,sargeras,663,druid,balance,12,7,5
10190,Nazrelar,ragnaros,663,druid,balance,26,10,16
10191,Edrielin,quelthalas,657,druid,balance,12,7,5
10192,Bigolehoe,tichondrius,654,druid,balance,17,7,10
10193,Veraciouss,sargeras,652,druid,balance,18,10,8
10194,Dsoul,tichondrius,639,druid,balance,17,7,10
10195,Spacéchicken,stormrage,638,druid,balance,10,8,2
10196,Hancalimon,nemesis,634,druid,balance,26,8,18
10197,Ilovebutter,illidan,624,druid,balance,9,8,1
10198,Tumblr,terenas,624,druid,balance,9,7,2
10199,Neurologist,tichondrius,623,druid,balance,11,7,4
10200,Marakar,nazjatar,622,druid,balance,17,7,10
10201,Gutanamo,stormrage,620,druid,balance,14,8,6
10202,Chankletta,quelthalas,618,druid,balance,18,8,10
10203,Lawnkin,dalaran,608,druid,balance,16,7,9
10204,Murkdruid,frostmourne,607,druid,balance,14,7,7
10205,Feldstarx,stormrage,607,druid,balance,14,7,7
10206,Bleedsxd,tichondrius,606,druid,balance,14,7,7
10207,Instinctuals,sargeras,606,druid,balance,14,7,7
10208,Lunnæ,ragnaros,595,druid,balance,14,7,7
10209,Razzldazzle,thrall,590,druid,balance,13,7,6
10210,Fifthelement,tichondrius,587,druid,balance,11,8,3
10211,Juìcedbro,illidan,576,druid,balance,6,6,0
10212,Prev,arathor,576,druid,balance,6,6,0
10213,Ory,illidan,576,druid,balance,6,6,0
10214,Saltbae,velen,576,druid,balance,6,6,0
10215,Boogietease,frostmourne,576,druid,balance,6,6,0
10216,Nardwaur,tichondrius,576,druid,balance,6,6,0
10217,Theshy,tanaris,576,druid,balance,6,6,0
10218,Khayman,sargeras,576,druid,balance,6,6,0
10219,Cattpiss,tichondrius,576,druid,balance,6,6,0
10220,Starship,frostmourne,576,druid,balance,6,6,0
10221,Animatronz,area-52,576,druid,balance,6,6,0
10222,Dabshifter,tichondrius,576,druid,balance,6,6,0
10223,Trynayeet,area-52,576,druid,balance,6,6,0
10224,Claws,elune,576,druid,balance,6,6,0
10225,Starsùrge,moon-guard,576,druid,balance,6,6,0
10226,Shyn,goldrinn,576,druid,balance,12,6,6
10227,Zgg,ragnaros,576,druid,balance,12,6,6
10228,Jacknit,illidan,576,druid,balance,12,6,6
10229,Tone,illidan,576,druid,balance,12,6,6
10230,Juqzy,area-52,576,druid,balance,12,6,6
10231,Scykin,stormrage,576,druid,balance,12,6,6
10232,Jamuestus,illidan,576,druid,balance,12,6,6
10233,Peteybears,stormrage,576,druid,balance,12,6,6
10234,Kitem,tichondrius,576,druid,balance,12,6,6
10235,Bamfferal,tichondrius,576,druid,balance,12,6,6
10236,Amundruid,area-52,576,druid,balance,12,6,6
10237,Drulicious,tichondrius,576,druid,balance,12,6,6
10238,Treehard,malganis,576,druid,balance,12,6,6
10239,Nerfdemo,kiljaeden,576,druid,balance,12,6,6
10240,Zaaduu,tichondrius,576,druid,balance,12,6,6
10241,Dalaverrunis,tichondrius,576,druid,balance,12,6,6
10242,Cronosphere,stormrage,576,druid,balance,12,6,6
10243,Mkong,tichondrius,576,druid,balance,12,6,6
10244,Jonnytsunami,the-forgotten-coast,576,druid,balance,12,6,6
10245,Natureww,sargeras,576,druid,balance,12,6,6
10246,Maidah,malganis,576,druid,balance,12,6,6
10247,Dazedru,stormrage,576,druid,balance,12,6,6
10248,Chickenaeg,stormrage,576,druid,balance,12,6,6
10249,Cowchicken,zuljin,576,druid,balance,12,6,6
10250,Jaspen,bleeding-hollow,576,druid,balance,12,6,6
10251,Polyproof,emerald-dream,576,druid,balance,12,6,6
10252,Celetra,kiljaeden,576,druid,balance,12,6,6
10253,Brocooli,tichondrius,576,druid,balance,12,6,6
10254,Loadstar,burning-blade,576,druid,balance,12,6,6
10255,Gâlaxy,sargeras,576,druid,balance,12,6,6
10256,Fedidão,azralon,576,druid,balance,12,6,6
10257,Moonkid,barthilas,576,druid,balance,12,6,6
10258,Exiledruid,area-52,576,druid,balance,12,6,6
10259,Sorrytofaded,tichondrius,576,druid,balance,12,6,6
10260,Shwìftmend,area-52,576,druid,balance,12,6,6
10261,Skydín,stormrage,576,druid,balance,12,6,6
10262,Runforest,tichondrius,576,druid,balance,12,6,6
10263,Tewdee,magtheridon,576,druid,balance,12,6,6
10264,Grayfan,malganis,576,druid,balance,12,6,6
10265,Expatcow,tichondrius,576,druid,balance,12,6,6
10266,Toolboy,tichondrius,576,druid,balance,12,6,6
10267,Jmackd,frostmourne,576,druid,balance,12,6,6
10268,Pincho,hyjal,576,druid,balance,12,6,6
10269,Ggae,tichondrius,576,druid,balance,12,6,6
10270,Gigathicc,malganis,576,druid,balance,12,6,6
10271,Icancarryyou,darkspear,576,druid,balance,12,6,6
10272,Formz,nagrand,576,druid,balance,12,6,6
10273,Tylërðûrðên,sargeras,576,druid,balance,12,6,6
10274,Nýla,stormrage,576,druid,balance,12,6,6
10275,Hellabandzup,drakthul,576,druid,balance,12,6,6
10276,Còry,kiljaeden,576,druid,balance,12,6,6
10277,Bar,stormrage,576,druid,balance,12,6,6
10278,Cantheal,frostmourne,576,druid,balance,12,6,6
10279,Iefts,stormrage,576,druid,balance,12,6,6
10280,Nature,haomarush,576,druid,balance,12,6,6
10281,Cukld,tichondrius,576,druid,balance,12,6,6
10282,Slütcakes,tichondrius,576,druid,balance,12,6,6
10283,Beomjun,tichondrius,576,druid,balance,12,6,6
10284,Lolimatree,proudmoore,576,druid,balance,12,6,6
10285,Notpodruida,tichondrius,576,druid,balance,13,6,7
10286,Sample,dark-iron,576,druid,balance,18,6,12
10287,Faletra,eitrigg,576,druid,balance,18,6,12
10288,Doomky,area-52,576,druid,balance,18,6,12
10289,Kujo,bloodhoof,576,druid,balance,18,6,12
10290,Sooey,wyrmrest-accord,576,druid,balance,18,6,12
10291,Longnus,stormrage,576,druid,balance,18,6,12
10292,Droodad,mannoroth,576,druid,balance,18,6,12
10293,Gåiâ,malganis,576,druid,balance,18,6,12
10294,Drphilsmith,moon-guard,576,druid,balance,18,6,12
10295,Rejufang,sargeras,575,druid,balance,6,6,0
10296,Beamin,thunderlord,575,druid,balance,12,6,6
10297,Guybranch,illidan,575,druid,balance,12,6,6
10298,Chodkiewicz,echo-isles,575,druid,balance,12,6,6
10299,Macpoulet,aggramar,575,druid,balance,12,6,6
10300,Zieda,sisters-of-elune,575,druid,balance,12,6,6
10301,Miçangak,azralon,575,druid,balance,12,6,6
10302,Emolia,amanthul,575,druid,balance,12,6,6
10303,Dibinha,azralon,575,druid,balance,12,6,6
10304,Ebichu,fenris,575,druid,balance,12,6,6
10305,Runarok,ragnaros,575,druid,balance,12,6,6
10306,Tariksha,sargeras,575,druid,balance,12,6,6
10307,Turnpike,exodar,575,druid,balance,12,6,6
10308,Ahruan,stormrage,575,druid,balance,18,6,12
10309,Tiju,wyrmrest-accord,575,druid,balance,18,6,12
10310,Sokodruid,tichondrius,575,druid,balance,18,6,12
10311,Einraedon,dalaran,575,druid,balance,18,6,12
10312,Samelthios,proudmoore,575,druid,balance,20,6,14
10313,Mirialia,alexstrasza,574,druid,balance,12,6,6
10314,Painsbrook,thrall,574,druid,balance,12,6,6
10315,Idontknowbro,bonechewer,574,druid,balance,12,6,6
10316,Dradugun,hyjal,574,druid,balance,12,6,6
10317,Quagsire,moon-guard,574,druid,balance,18,6,12
10318,Xinnii,illidan,573,druid,balance,18,7,11
10319,Shorthorn,mannoroth,571,druid,balance,12,6,6
10320,Proñgs,tichondrius,566,druid,balance,12,6,6
10321,Æpex,zuljin,544,druid,balance,10,6,4
10322,Matock,malganis,543,druid,balance,11,6,5
10323,Casaran,anetheron,543,druid,balance,11,6,5
10324,Hchhi,ragnaros,543,druid,balance,14,7,7
10325,Boufa,dentarg,527,druid,balance,9,7,2
10326,Tzboo,stormrage,527,druid,balance,15,6,9
10327,Guron,aegwynn,526,druid,balance,27,6,21
10328,Imhealer,drakkari,522,druid,balance,17,8,9
10329,Nyxlie,stormrage,512,druid,balance,10,6,4
10330,Schlaankeyy,stormrage,512,druid,balance,16,6,10
10331,Velais,exodar,512,druid,balance,22,6,16
10332,Gemineye,stormrage,511,druid,balance,11,6,5
10333,Istayfrawsty,darkspear,511,druid,balance,14,6,8
10334,Tulkan,kelthuzad,508,druid,balance,15,7,8
10335,Rank,nerzhul,496,druid,balance,13,6,7
10336,Beestwithin,illidan,480,druid,balance,6,5,1
10337,Solju,farstriders,480,druid,balance,6,5,1
10338,Arwëna,tichondrius,480,druid,balance,6,5,1
10339,Daroot,spinebreaker,480,druid,balance,6,5,1
10340,Aoewynn,nerzhul,480,druid,balance,6,5,1
10341,Smitebacklol,tichondrius,480,druid,balance,6,5,1
10342,Ulfaar,frostmourne,480,druid,balance,6,5,1
10343,Babybite,frostmourne,480,druid,balance,6,5,1
10344,Joink,sargeras,480,druid,balance,6,5,1
10345,Alindrä,moon-guard,480,druid,balance,6,5,1
10346,Dtefy,ragnaros,480,druid,balance,6,5,1
10347,Yurself,feathermoon,480,druid,balance,6,5,1
10348,Iconicxz,malganis,480,druid,balance,6,5,1
10349,Wassupfoo,area-52,480,druid,balance,6,5,1
10350,Jokeclass,darkspear,480,druid,balance,6,5,1
10351,Galadon,tichondrius,480,druid,balance,6,5,1
10352,Biggié,bleeding-hollow,480,druid,balance,6,5,1
10353,Prøspect,moon-guard,480,druid,balance,6,5,1
10354,Chillaxin,gundrak,480,druid,balance,6,5,1
10355,Rastakant,malganis,480,druid,balance,6,5,1
10356,Swergz,tichondrius,480,druid,balance,6,5,1
10357,Dojacat,tichondrius,480,druid,balance,6,5,1
10358,Nephsis,kelthuzad,480,druid,balance,6,5,1
10359,Rowdie,area-52,480,druid,balance,6,5,1
10360,Azurehoof,earthen-ring,480,druid,balance,6,5,1
10361,Horizøns,gorefiend,480,druid,balance,6,5,1
10362,Tïgerpawz,stormrage,480,druid,balance,6,5,1
10363,Fattdiabetic,tichondrius,480,druid,balance,6,5,1
10364,Malafaïa,nemesis,480,druid,balance,6,5,1
10365,Beamlord,frostmourne,480,druid,balance,6,5,1
10366,Canuatemyrat,tichondrius,480,druid,balance,6,5,1
10367,Guår,tichondrius,480,druid,balance,6,5,1
10368,Yokux,thunderlord,480,druid,balance,6,5,1
10369,Chikojuan,tichondrius,480,druid,balance,6,5,1
10370,ßælot,quelthalas,480,druid,balance,6,5,1
10371,Psychosocîal,kiljaeden,480,druid,balance,6,5,1
10372,Ragiix,tichondrius,480,druid,balance,6,5,1
10373,Megåtron,kelthuzad,480,druid,balance,6,5,1
10374,Coramoor,mannoroth,480,druid,balance,6,5,1
10375,Sandriuzs,nemesis,480,druid,balance,6,5,1
10376,Mithroi,tichondrius,480,druid,balance,6,5,1
10377,Hooffy,emerald-dream,480,druid,balance,6,5,1
10378,Crazystarz,frostmourne,480,druid,balance,6,5,1
10379,Atrocitÿ,tichondrius,480,druid,balance,11,5,6
10380,Thebass,spinebreaker,480,druid,balance,12,5,7
10381,Ragerag,trollbane,480,druid,balance,12,5,7
10382,Intrinsiic,area-52,480,druid,balance,12,5,7
10383,Havócdh,tichondrius,480,druid,balance,12,5,7
10384,Zimah,illidan,480,druid,balance,12,5,7
10385,Helpmeimbad,stormrage,480,druid,balance,12,5,7
10386,Paintlicker,emerald-dream,480,druid,balance,12,5,7
10387,Sodacream,illidan,480,druid,balance,12,5,7
10388,Amarexf,stormrage,480,druid,balance,12,5,7
10389,Psycloned,undermine,480,druid,balance,12,5,7
10390,Trenboloone,area-52,480,druid,balance,12,5,7
10391,Môistman,tichondrius,480,druid,balance,12,5,7
10392,Stumphugger,tichondrius,480,druid,balance,12,5,7
10393,Bearwithit,sargeras,480,druid,balance,12,5,7
10394,Milkmoneymeo,illidan,480,druid,balance,12,5,7
10395,Clubs,sargeras,480,druid,balance,12,5,7
10396,Drufasä,sargeras,480,druid,balance,12,5,7
10397,Akay,bonechewer,480,druid,balance,12,5,7
10398,Deathprofit,thrall,480,druid,balance,12,5,7
10399,Salanzô,bleeding-hollow,480,druid,balance,12,5,7
10400,Bigtammy,moon-guard,480,druid,balance,12,5,7
10401,Bigdaddyferg,illidan,480,druid,balance,12,5,7
10402,Cynderellaa,proudmoore,480,druid,balance,12,5,7
10403,Nöches,quelthalas,480,druid,balance,12,5,7
10404,Zuga,the-venture-co,480,druid,balance,12,5,7
10405,Sharkfighter,sargeras,480,druid,balance,12,5,7
10406,Tugboat,saurfang,480,druid,balance,12,5,7
10407,Cloninglol,darkspear,480,druid,balance,12,5,7
10408,Hream,echo-isles,480,druid,balance,12,5,7
10409,Uggadruid,malganis,480,druid,balance,12,5,7
10410,Bubblybear,winterhoof,480,druid,balance,12,5,7
10411,Saucyy,malganis,480,druid,balance,12,5,7
10412,Beastin,queldorei,480,druid,balance,12,5,7
10413,Ornaaga,blackrock,480,druid,balance,12,5,7
10414,Toptrolls,illidan,480,druid,balance,12,5,7
10415,Voelcan,tichondrius,480,druid,balance,12,5,7
10416,Phatpat,illidan,480,druid,balance,12,5,7
10417,Fakechower,stormreaver,480,druid,balance,12,5,7
10418,Lickmypaws,sargeras,480,druid,balance,12,5,7
10419,Ripter,moon-guard,480,druid,balance,12,5,7
10420,Deergut,illidan,480,druid,balance,12,5,7
10421,Lutze,frostmourne,480,druid,balance,12,5,7
10422,Jujubeartank,darkspear,480,druid,balance,12,5,7
10423,Redness,daggerspine,480,druid,balance,12,5,7
10424,Trippykitty,tichondrius,480,druid,balance,12,5,7
10425,Cassatopia,zuljin,480,druid,balance,12,5,7
10426,Kumataku,emerald-dream,480,druid,balance,12,5,7
10427,Kushkilla,malganis,480,druid,balance,12,5,7
10428,Rokdx,barthilas,480,druid,balance,12,5,7
10429,Mikoxarekt,area-52,480,druid,balance,12,5,7
10430,Öomkinn,sargeras,480,druid,balance,12,5,7
10431,Stratego,drenden,480,druid,balance,12,5,7
10432,Coomlauncher,area-52,480,druid,balance,16,6,10
10433,Verdagris,skullcrusher,480,druid,balance,18,5,13
10434,Boomiè,tichondrius,480,druid,balance,18,5,13
10435,Tuppyboom,barthilas,480,druid,balance,24,5,19
10436,Bâgheera,sargeras,479,druid,balance,6,5,1
10437,Wtfiisthis,tichondrius,479,druid,balance,6,5,1
10438,Ðeepsixx,burning-legion,479,druid,balance,12,5,7
10439,Angelbigbutt,borean-tundra,479,druid,balance,12,5,7
10440,Raknary,kelthuzad,479,druid,balance,12,5,7
10441,Damallis,anubarak,479,druid,balance,12,5,7
10442,Palermo,aerie-peak,479,druid,balance,12,5,7
10443,Smhyle,frostmourne,479,druid,balance,12,5,7
10444,Cdrü,illidan,479,druid,balance,13,5,8
10445,Edinhalfhorn,bonechewer,479,druid,balance,18,5,13
10446,Loggoruk,illidan,479,druid,balance,18,5,13
10447,Darkdragoonz,barthilas,479,druid,balance,18,5,13
10448,Morphntime,blackrock,479,druid,balance,18,5,13
10449,Sunneater,azuremyst,478,druid,balance,12,5,7
10450,Nahlem,greymane,478,druid,balance,12,5,7
10451,Mantis,the-underbog,478,druid,balance,12,5,7
10452,Wardruidkvn,stormreaver,474,druid,balance,35,5,30
10453,Boomtre,malganis,463,druid,balance,11,5,6
10454,Twrixi,caelestrasz,463,druid,balance,17,5,12
10455,Formgodx,malganis,448,druid,balance,16,5,11
10456,Bearcathawk,sargeras,447,druid,balance,11,5,6
10457,Kyuub,barthilas,446,druid,balance,11,5,6
10458,Thunderwolf,malganis,432,druid,balance,9,6,3
10459,Féralis,sargeras,431,druid,balance,11,5,6
10460,Azshunara,moon-guard,431,druid,balance,11,5,6
10461,Shiftzy,thrall,426,druid,balance,10,6,4
10462,Krooksy,tichondrius,426,druid,balance,14,6,8
10463,Shuja,wyrmrest-accord,426,druid,balance,15,6,9
10464,Theriomorph,barthilas,424,druid,balance,28,6,22
10465,Feond,illidan,416,druid,balance,10,5,5
10466,Thebruiser,baelgun,415,druid,balance,14,5,9
10467,Gigajuiced,proudmoore,400,druid,balance,7,5,2
10468,Äbÿss,tichondrius,400,druid,balance,7,5,2
10469,Altha,proudmoore,400,druid,balance,13,5,8
10470,Lukass,tichondrius,384,druid,balance,6,4,2
10471,Goncko,ragnaros,384,druid,balance,6,4,2
10472,Tankyguy,ragnaros,384,druid,balance,6,4,2
10473,Selfplay,barthilas,384,druid,balance,6,4,2
10474,Tinishaker,ragnaros,384,druid,balance,6,4,2
10475,Mmbessa,tichondrius,384,druid,balance,6,4,2
10476,Trogshift,blackrock,384,druid,balance,6,4,2
10477,Astralboom,stormrage,384,druid,balance,6,4,2
10478,Sabretoóth,malganis,384,druid,balance,6,4,2
10479,Matinee,tichondrius,384,druid,balance,6,4,2
10480,Manbeartree,malganis,384,druid,balance,6,4,2
10481,Ðrood,bleeding-hollow,384,druid,balance,6,4,2
10482,Déi,malganis,384,druid,balance,6,4,2
10483,Blams,stormrage,384,druid,balance,6,4,2
10484,Boomkinbob,malganis,384,druid,balance,6,4,2
10485,Nicklul,llane,384,druid,balance,6,4,2
10486,Drmnheal,frostmourne,384,druid,balance,6,4,2
10487,Lyingcat,mannoroth,384,druid,balance,6,4,2
10488,Hbf,tichondrius,384,druid,balance,6,4,2
10489,Kiddohhz,tichondrius,384,druid,balance,6,4,2
10490,Spèèdy,illidan,384,druid,balance,6,4,2
10491,Nevershiftx,kirin-tor,384,druid,balance,6,4,2
10492,Tchalla,detheroc,384,druid,balance,6,4,2
10493,Beastboyy,tichondrius,384,druid,balance,6,4,2
10494,Socknsandals,tichondrius,384,druid,balance,6,4,2
10495,Xanybarz,stormrage,384,druid,balance,6,4,2
10496,Twostars,thrall,384,druid,balance,6,4,2
10497,Asharä,mannoroth,384,druid,balance,6,4,2
10498,Nahelae,tichondrius,384,druid,balance,6,4,2
10499,Nightshift,dalvengyr,384,druid,balance,6,4,2
10500,Sschakall,tol-barad,384,druid,balance,6,4,2
10501,Whitehaze,proudmoore,384,druid,balance,6,4,2
10502,Critkatbear,detheroc,384,druid,balance,6,4,2
10503,Medsurgdruid,emerald-dream,384,druid,balance,6,4,2
10504,Seekamp,khazgoroth,384,druid,balance,6,4,2
10505,Dokasaurus,lightbringer,384,druid,balance,6,4,2
10506,Fuzzytaco,stormrage,384,druid,balance,6,4,2
10507,Kunigami,malganis,384,druid,balance,6,4,2
10508,Germainee,shandris,384,druid,balance,6,4,2
10509,Silvshifter,frostmourne,384,druid,balance,6,4,2
10510,Bambozled,sargeras,384,druid,balance,6,4,2
10511,Stormbeef,tichondrius,384,druid,balance,6,4,2
10512,Cujjoh,tichondrius,384,druid,balance,6,4,2
10513,Kornobluss,azralon,384,druid,balance,6,4,2
10514,Küb,sargeras,384,druid,balance,6,4,2
10515,Leefman,tichondrius,384,druid,balance,6,4,2
10516,Grandsoleil,tichondrius,384,druid,balance,6,4,2
10517,Shinazugawa,maiev,384,druid,balance,6,4,2
10518,Mcdizzil,bloodscalp,384,druid,balance,6,4,2
10519,Orgnalf,area-52,384,druid,balance,6,4,2
10520,Givemethatcr,tichondrius,384,druid,balance,6,4,2
10521,Söökie,tichondrius,384,druid,balance,6,4,2
10522,Nidalie,frostmourne,384,druid,balance,6,4,2
10523,Deelark,skywall,384,druid,balance,6,4,2
10524,Lunchßox,emerald-dream,384,druid,balance,6,4,2
10525,Zxve,stormrage,384,druid,balance,6,4,2
10526,Korlstone,zuljin,384,druid,balance,6,4,2
10527,Sethfurian,magtheridon,384,druid,balance,6,4,2
10528,Joiczar,maelstrom,384,druid,balance,6,4,2
10529,Bäyter,tichondrius,384,druid,balance,6,4,2
10530,Kkamagwi,illidan,384,druid,balance,6,4,2
10531,Mesteno,proudmoore,384,druid,balance,6,4,2
10532,Gameisass,illidan,384,druid,balance,6,4,2
10533,Oscillater,illidan,384,druid,balance,6,4,2
10534,Duo,demon-soul,384,druid,balance,6,4,2
10535,Gønkh,quelthalas,384,druid,balance,6,4,2
10536,Qyuka,area-52,384,druid,balance,6,4,2
10537,Sxc,frostmourne,384,druid,balance,6,4,2
10538,Luvgames,area-52,384,druid,balance,6,4,2
10539,Bäldir,dalaran,384,druid,balance,6,4,2
10540,Somarythe,moon-guard,384,druid,balance,6,4,2
10541,Kiwidru,frostmourne,384,druid,balance,6,4,2
10542,Splintered,kelthuzad,384,druid,balance,6,4,2
10543,Shroudyroudy,dalaran,384,druid,balance,6,4,2
10544,Peterdeleter,emerald-dream,384,druid,balance,6,4,2
10545,Jherdugo,durotan,384,druid,balance,6,4,2
10546,Anamoorphicc,kelthuzad,384,druid,balance,6,4,2
10547,Elonmuskirl,illidan,384,druid,balance,6,4,2
10548,Domord,stormrage,384,druid,balance,6,4,2
10549,Yoshí,emerald-dream,384,druid,balance,6,4,2
10550,Hypernovax,tichondrius,384,druid,balance,10,5,5
10551,Forest,frostmourne,384,druid,balance,10,5,5
10552,Balancz,thrall,384,druid,balance,10,5,5
10553,Erwelz,quelthalas,384,druid,balance,10,5,5
10554,Stormclaw,elune,384,druid,balance,12,4,8
10555,Donti,laughing-skull,384,druid,balance,12,4,8
10556,Slottpocket,malganis,384,druid,balance,12,4,8
10557,Omnipaw,kelthuzad,384,druid,balance,12,4,8
10558,Aexs,kelthuzad,384,druid,balance,12,4,8
10559,Menlove,area-52,384,druid,balance,12,4,8
10560,Bowlpacka,malganis,384,druid,balance,12,4,8
10561,Altius,drakkari,384,druid,balance,12,4,8
10562,Lifeforcer,barthilas,384,druid,balance,12,4,8
10563,Bigsmurph,illidan,384,druid,balance,12,4,8
10564,Tasselhoof,hyjal,384,druid,balance,12,4,8
10565,Blipshift,tichondrius,384,druid,balance,12,4,8
10566,Shanadris,stormrage,384,druid,balance,12,4,8
10567,Siöux,kelthuzad,384,druid,balance,12,4,8
10568,Astería,sentinels,384,druid,balance,12,4,8
10569,Alexserina,dalaran,384,druid,balance,12,4,8
10570,Winmax,tichondrius,384,druid,balance,12,4,8
10571,Darkangle,ysera,384,druid,balance,12,4,8
10572,Zenowl,turalyon,384,druid,balance,12,4,8
10573,Bignosecow,illidan,384,druid,balance,12,4,8
10574,Toxyflex,tichondrius,384,druid,balance,12,4,8
10575,Skylightt,illidan,384,druid,balance,12,4,8
10576,Simo,kaelthas,384,druid,balance,12,4,8
10577,Shinoßi,area-52,384,druid,balance,12,4,8
10578,Veyrønn,stormrage,384,druid,balance,12,4,8
10579,Sinistuhd,tichondrius,384,druid,balance,12,4,8
10580,Lutein,tichondrius,384,druid,balance,12,4,8
10581,Soreze,kelthuzad,384,druid,balance,12,4,8
10582,Jakermans,area-52,384,druid,balance,12,4,8
10583,Laycan,azralon,384,druid,balance,12,4,8
10584,Dirtytiger,sargeras,384,druid,balance,12,4,8
10585,Wintarz,sargeras,384,druid,balance,12,4,8
10586,Amaryllis,the-underbog,384,druid,balance,12,4,8
10587,Lilrichdps,sargeras,384,druid,balance,12,4,8
10588,Greemer,sargeras,384,druid,balance,12,4,8
10589,Cathelyana,tichondrius,384,druid,balance,16,5,11
10590,ßullx,quelthalas,384,druid,balance,14,4,10
10591,Spatulas,malganis,384,druid,balance,18,4,14
10592,Katdog,warsong,384,druid,balance,18,4,14
10593,Plopperoo,caelestrasz,384,druid,balance,18,4,14
10594,Aessinawisp,frostmourne,383,druid,balance,6,4,2
10595,Kukulkann,tichondrius,383,druid,balance,6,4,2
10596,Chatdôux,zuljin,383,druid,balance,6,4,2
10597,Balthøs,moon-guard,383,druid,balance,6,4,2
10598,Papitank,drakkari,383,druid,balance,6,4,2
10599,Samesaras,darkspear,383,druid,balance,6,4,2
10600,Kornaz,guldan,383,druid,balance,6,4,2
10601,Bitechew,frostmourne,383,druid,balance,6,4,2
10602,Donokokiya,destromath,383,druid,balance,6,4,2
10603,Thiccybear,darkspear,383,druid,balance,6,4,2
10604,Xisloko,azralon,383,druid,balance,6,4,2
10605,Scienttific,malganis,383,druid,balance,12,4,8
10606,Ranchdußois,illidan,383,druid,balance,12,4,8
10607,Tïcks,illidan,383,druid,balance,12,4,8
10608,Skke,barthilas,383,druid,balance,12,4,8
10609,Boomanon,illidan,382,druid,balance,6,4,2
10610,Nukaboom,elune,382,druid,balance,6,4,2
10611,Korduroi,malygos,380,druid,balance,12,4,8
10612,Teladrizzle,dalaran,351,druid,balance,11,4,7
10613,Rahdek,azgalor,330,druid,balance,7,5,2
10614,Kimnim,tichondrius,330,druid,balance,9,6,3
10615,Ihjx,sargeras,330,druid,balance,11,6,5
10616,Yangrou,tichondrius,330,druid,balance,11,5,6
10617,Telvannì,sargeras,330,druid,balance,12,5,7
10618,Tugond,tichondrius,330,druid,balance,22,5,17
10619,Mythianan,aggramar,328,druid,balance,10,7,3
10620,Raquelíta,stormrage,319,druid,balance,5,4,1
10621,Tehnklox,malorne,319,druid,balance,5,4,1
10622,Riddickd,malfurion,288,druid,balance,11,6,5
10623,Jayroneowo,frostmourne,288,druid,balance,6,3,3
10624,Rhorr,frostmourne,288,druid,balance,6,3,3
10625,Papacard,stormrage,288,druid,balance,6,3,3
10626,Sypìí,stormrage,288,druid,balance,6,3,3
10627,Bhíkkhu,stormrage,288,druid,balance,6,3,3
10628,Çãñçèr,frostmourne,288,druid,balance,6,3,3
10629,Ferar,frostmourne,288,druid,balance,6,3,3
10630,Taztoc,stormrage,288,druid,balance,6,3,3
10631,Pergutory,frostmourne,288,druid,balance,6,3,3
10632,Kî,thunderlord,288,druid,balance,6,3,3
10633,Deimos,jubeithos,288,druid,balance,6,3,3
10634,Marcee,frostmourne,288,druid,balance,6,3,3
10635,Sáwá,frostmourne,288,druid,balance,6,3,3
10636,Haffö,gundrak,288,druid,balance,6,3,3
10637,Celestialife,frostmourne,288,druid,balance,6,3,3
10638,Alleae,stormrage,288,druid,balance,6,3,3
10639,Rektx,area-52,288,druid,balance,6,3,3
10640,Luuxia,tichondrius,288,druid,balance,6,3,3
10641,Woopsie,malfurion,288,druid,balance,6,3,3
10642,Sowo,sargeras,288,druid,balance,6,3,3
10643,Druidma,aegwynn,288,druid,balance,6,3,3
10644,Pawpa,daggerspine,288,druid,balance,6,3,3
10645,Hallwanted,area-52,288,druid,balance,6,3,3
10646,Ohsnapz,silvermoon,288,druid,balance,6,3,3
10647,Azoth,hyjal,288,druid,balance,6,3,3
10648,Artimedian,kiljaeden,288,druid,balance,6,3,3
10649,Tokyotimxoxx,area-52,288,druid,balance,6,3,3
10650,Jammi,skywall,288,druid,balance,6,3,3
10651,Revitalize,shadowsong,288,druid,balance,6,3,3
10652,Besto,moon-guard,288,druid,balance,6,3,3
10653,Nidalie,zuljin,288,druid,balance,6,3,3
10654,Ghostboy,zuljin,288,druid,balance,6,3,3
10655,Haaha,area-52,288,druid,balance,6,3,3
10656,Gorillavoke,tichondrius,288,druid,balance,6,3,3
10657,Teribad,area-52,288,druid,balance,6,3,3
10658,Icefang,tichondrius,288,druid,balance,6,3,3
10659,Tanakoi,zuljin,288,druid,balance,6,3,3
10660,Rykudruid,azuremyst,288,druid,balance,6,3,3
10661,Thumpb,bronzebeard,288,druid,balance,6,3,3
10662,Jabawockdeez,area-52,288,druid,balance,6,3,3
10663,Ÿùp,tichondrius,288,druid,balance,6,3,3
10664,Fengfeidruid,illidan,288,druid,balance,6,3,3
10665,Vykarux,suramar,288,druid,balance,6,3,3
10666,Shaftomatic,tichondrius,288,druid,balance,6,3,3
10667,Voodoopipe,tichondrius,288,druid,balance,6,3,3
10668,Iploopedyogf,bleeding-hollow,288,druid,balance,6,3,3
10669,Dauncy,sargeras,288,druid,balance,6,3,3
10670,Jerm,coilfang,288,druid,balance,6,3,3
10671,Tsochickenn,bleeding-hollow,288,druid,balance,6,3,3
10672,Superwrath,khaz-modan,288,druid,balance,6,3,3
10673,Kaldelar,emerald-dream,288,druid,balance,6,3,3
10674,Cbark,ravencrest,288,druid,balance,6,3,3
10675,Beörne,sargeras,288,druid,balance,6,3,3
10676,Spooser,proudmoore,288,druid,balance,6,3,3
10677,Loren,gorefiend,288,druid,balance,6,3,3
10678,Wuckfød,tichondrius,288,druid,balance,6,3,3
10679,Leafthief,whisperwind,288,druid,balance,6,3,3
10680,Alcorria,area-52,288,druid,balance,6,3,3
10681,Akiza,sargeras,288,druid,balance,6,3,3
10682,Shalaz,magtheridon,288,druid,balance,6,3,3
10683,Guidoanchovz,thrall,288,druid,balance,6,3,3
10684,Jpylm,ysera,288,druid,balance,6,3,3
10685,Bridgerén,tichondrius,288,druid,balance,6,3,3
10686,Eightozpatty,tichondrius,288,druid,balance,6,3,3
10687,Boomkinks,moon-guard,288,druid,balance,6,3,3
10688,Cutely,tichondrius,288,druid,balance,6,3,3
10689,Ménd,thrall,288,druid,balance,6,3,3
10690,Fauck,illidan,288,druid,balance,6,3,3
10691,Silynce,tichondrius,288,druid,balance,6,3,3
10692,Crotchlicker,bloodscalp,288,druid,balance,6,3,3
10693,Rúdo,quelthalas,288,druid,balance,6,3,3
10694,Yëeëeëeëehaw,illidan,288,druid,balance,6,3,3
10695,Druidnim,tichondrius,288,druid,balance,6,3,3
10696,Kalalana,illidan,288,druid,balance,6,3,3
10697,Xiaoguai,tichondrius,288,druid,balance,6,3,3
10698,Teddybëar,illidan,288,druid,balance,6,3,3
10699,Delrin,garona,288,druid,balance,6,3,3
10700,Bleedum,guldan,288,druid,balance,6,3,3
10701,Pacmaynè,illidan,288,druid,balance,6,3,3
10702,Sodah,tichondrius,288,druid,balance,6,3,3
10703,Silkyroad,tichondrius,288,druid,balance,6,3,3
10704,Targeted,sargeras,288,druid,balance,6,3,3
10705,Bearys,area-52,288,druid,balance,6,3,3
10706,Laazz,area-52,288,druid,balance,6,3,3
10707,Icastsmells,tichondrius,288,druid,balance,6,3,3
10708,Scudbomb,kelthuzad,288,druid,balance,6,3,3
10709,Sylvanna,tichondrius,288,druid,balance,6,3,3
10710,Levelboostx,tichondrius,288,druid,balance,6,3,3
10711,Noheárt,kelthuzad,288,druid,balance,6,3,3
10712,Endingitall,illidan,288,druid,balance,6,3,3
10713,Däll,tichondrius,288,druid,balance,6,3,3
10714,Healthycow,illidan,288,druid,balance,6,3,3
10715,Jxred,illidan,288,druid,balance,6,3,3
10716,Jyuaiai,tichondrius,288,druid,balance,6,3,3
10717,Krittykitkat,chogall,288,druid,balance,9,4,5
10718,Vawdka,proudmoore,288,druid,balance,9,4,5
10719,Bigswaag,malganis,288,druid,balance,7,3,4
10720,Xail,hyjal,288,druid,balance,8,3,5
10721,Retsarehard,illidan,288,druid,balance,8,3,5
10722,Wreckingcrew,emerald-dream,288,druid,balance,8,3,5
10723,Kitsurumi,ragnaros,288,druid,balance,12,3,9
10724,Hottiecake,bronzebeard,288,druid,balance,12,3,9
10725,Tsaß,bleeding-hollow,288,druid,balance,12,3,9
10726,Machinex,illidan,288,druid,balance,12,3,9
10727,Feyrien,dalaran,288,druid,balance,12,3,9
10728,Drchronic,boulderfist,288,druid,balance,12,3,9
10729,Nintrus,nazjatar,288,druid,balance,12,3,9
10730,Mulgorer,tichondrius,288,druid,balance,12,3,9
10731,Evarene,vashj,288,druid,balance,12,3,9
10732,Scythé,stormrage,288,druid,balance,12,3,9
10733,Cêania,moon-guard,288,druid,balance,12,3,9
10734,Alalletsa,destromath,288,druid,balance,12,3,9
10735,Koan,proudmoore,288,druid,balance,12,3,9
10736,Teyollocuani,sargeras,288,druid,balance,12,3,9
10737,Boomybum,bleeding-hollow,288,druid,balance,12,3,9
10738,Loathe,korialstrasz,288,druid,balance,12,3,9
10739,Plye,korgath,288,druid,balance,12,3,9
10740,Guusx,bonechewer,288,druid,balance,12,3,9
10741,Xalstarrot,sargeras,288,druid,balance,12,3,9
10742,Uezzon,tol-barad,288,druid,balance,12,3,9
10743,Nightnes,sargeras,288,druid,balance,12,3,9
10744,Meowzedon,sargeras,288,druid,balance,12,3,9
10745,Davelombardo,tichondrius,288,druid,balance,12,3,9
10746,Killersilent,quelthalas,288,druid,balance,18,3,15
10747,Ravii,nemesis,287,druid,balance,6,3,3
10748,Wweegyy,tichondrius,287,druid,balance,6,3,3
10749,Johnee,barthilas,287,druid,balance,6,3,3
10750,Guston,lightbringer,287,druid,balance,6,3,3
10751,Dainerysz,proudmoore,286,druid,balance,6,3,3
10752,Biig,stormreaver,275,druid,balance,11,9,2
10753,Teeball,tichondrius,271,druid,balance,17,3,14
10754,Clownprince,barthilas,256,druid,balance,10,3,7
10755,Daltius,illidan,256,druid,balance,10,3,7
10756,Vollzar,sargeras,255,druid,balance,11,3,8
10757,Trahfnahrumn,moon-guard,240,druid,balance,9,3,6
10758,Pixelface,frostmourne,239,druid,balance,5,3,2
10759,Oddclaw,stormrage,239,druid,balance,5,3,2
10760,Bigtoeess,tichondrius,239,druid,balance,5,3,2
10761,Verielda,skullcrusher,239,druid,balance,5,3,2
10762,Wintrader,zuljin,239,druid,balance,5,3,2
10763,Corym,frostmourne,239,druid,balance,11,3,8
10764,Dipdodge,illidan,224,druid,balance,10,3,7
10765,Mclarenz,frostmourne,223,druid,balance,8,3,5
10766,Variandruid,kelthuzad,223,druid,balance,8,3,5
10767,Mkat,illidan,223,druid,balance,8,3,5
10768,Jazzman,jubeithos,223,druid,balance,14,3,11
10769,Eden,thrall,223,druid,balance,14,3,11
10770,Flummoz,frostmourne,192,druid,balance,4,3,1
10771,Niwßor,azralon,192,druid,balance,10,4,6
10772,Zigh,azralon,192,druid,balance,6,2,4
10773,Saìyori,area-52,192,druid,balance,6,2,4
10774,Loodichriss,area-52,192,druid,balance,6,2,4
10775,Lilgushy,area-52,192,druid,balance,6,2,4
10776,Tansdruid,area-52,192,druid,balance,6,2,4
10777,Flarkage,area-52,192,druid,balance,6,2,4
10778,Crycloné,stormrage,192,druid,balance,6,2,4
10779,Bubblebraìn,area-52,192,druid,balance,6,2,4
10780,Hzu,kelthuzad,192,druid,balance,6,2,4
10781,Sydneey,kelthuzad,192,druid,balance,6,2,4
10782,Skig,stormreaver,192,druid,balance,6,2,4
10783,Moonhorn,kelthuzad,192,druid,balance,6,2,4
10784,Maélstrom,goldrinn,192,druid,balance,6,2,4
10785,Aquaarius,nemesis,192,druid,balance,6,2,4
10786,Alagorn,zangarmarsh,192,druid,balance,6,2,4
10787,Arienne,kelthuzad,192,druid,balance,6,2,4
10788,Mòónwhisper,moon-guard,192,druid,balance,6,2,4
10789,Isunami,emerald-dream,192,druid,balance,6,2,4
10790,Pleomorpher,quelthalas,192,druid,balance,6,2,4
10791,Hagenws,azralon,192,druid,balance,6,2,4
10792,Lilherb,azralon,192,druid,balance,6,2,4
10793,Lindsanr,illidan,192,druid,balance,6,2,4
10794,Aprendíz,azralon,192,druid,balance,6,2,4
10795,Srbestias,quelthalas,192,druid,balance,6,2,4
10796,Potus,illidan,192,druid,balance,6,2,4
10797,Deadpoóll,area-52,192,druid,balance,6,2,4
10798,Adonalsium,area-52,192,druid,balance,6,2,4
10799,Malffurryan,draktharon,192,druid,balance,6,2,4
10800,Jackdru,illidan,192,druid,balance,6,2,4
10801,Lappz,malganis,192,druid,balance,6,2,4
10802,Markóla,stormrage,192,druid,balance,6,2,4
10803,Sweetcat,malganis,192,druid,balance,6,2,4
10804,Spicyorange,dalaran,192,druid,balance,6,2,4
10805,Jitlit,malganis,192,druid,balance,6,2,4
10806,Hasemilë,dalaran,192,druid,balance,6,2,4
10807,Slavenhausen,azralon,192,druid,balance,6,2,4
10808,Luipu,elune,192,druid,balance,6,2,4
10809,Mythicdruid,ragnaros,192,druid,balance,6,2,4
10810,Laymonath,elune,192,druid,balance,6,2,4
10811,Hawgs,bleeding-hollow,192,druid,balance,6,2,4
10812,Guap,bleeding-hollow,192,druid,balance,6,2,4
10813,Lùna,barthilas,192,druid,balance,6,2,4
10814,Milkz,zuljin,192,druid,balance,6,2,4
10815,Feorb,azuremyst,192,druid,balance,6,2,4
10816,Wtfhommie,madoran,192,druid,balance,6,2,4
10817,Mäûled,fizzcrank,192,druid,balance,6,2,4
10818,Hoptimus,zuljin,192,druid,balance,6,2,4
10819,Absentteeth,stormrage,192,druid,balance,6,2,4
10820,Dedgame,malfurion,192,druid,balance,6,2,4
10821,Hawtzi,stormrage,192,druid,balance,6,2,4
10822,Criturpantz,garrosh,192,druid,balance,6,2,4
10823,Empowers,garrosh,192,druid,balance,6,2,4
10824,Octacer,malfurion,192,druid,balance,6,2,4
10825,Wokker,mannoroth,192,druid,balance,6,2,4
10826,Shredstitute,tichondrius,192,druid,balance,6,2,4
10827,Bigboomy,sargeras,192,druid,balance,6,2,4
10828,Katherine,moon-guard,192,druid,balance,6,2,4
10829,Chèétøhz,moon-guard,192,druid,balance,6,2,4
10830,Mosdu,tichondrius,192,druid,balance,6,2,4
10831,Treezyn,sargeras,192,druid,balance,6,2,4
10832,Enyu,sargeras,192,druid,balance,6,2,4
10833,Tp,dragonblight,192,druid,balance,6,2,4
10834,Glynistann,bladefist,192,druid,balance,6,2,4
10835,Xay,runetotem,192,druid,balance,6,2,4
10836,Bullwïnkle,uther,192,druid,balance,6,2,4
10837,Blassen,sargeras,192,druid,balance,6,2,4
10838,Neferpitou,fenris,192,druid,balance,6,2,4
10839,Speaks,moon-guard,192,druid,balance,6,2,4
10840,Lunarstone,tichondrius,192,druid,balance,6,2,4
10841,Meowed,sargeras,192,druid,balance,6,2,4
10842,Pawswap,tichondrius,192,druid,balance,6,2,4
10843,Centauri,shandris,192,druid,balance,6,2,4
10844,Stones,lightbringer,192,druid,balance,6,2,4
10845,Boomtastik,frostmourne,192,druid,balance,6,2,4
10846,Gulrahf,wyrmrest-accord,192,druid,balance,6,2,4
10847,Phatê,nerzhul,192,druid,balance,6,2,4
10848,Sloppysheila,sargeras,192,druid,balance,6,2,4
10849,Baankai,frostmourne,192,druid,balance,6,2,4
10850,Pepee,tichondrius,192,druid,balance,6,2,4
10851,Explicít,sargeras,192,druid,balance,6,2,4
10852,Totorostard,tichondrius,192,druid,balance,6,2,4
10853,Artaniss,tichondrius,192,druid,balance,6,2,4
10854,Linful,tichondrius,192,druid,balance,6,2,4
10855,Thriaror,proudmoore,192,druid,balance,6,2,4
10856,Satyrø,frostmourne,192,druid,balance,6,2,4
10857,Injeckx,tichondrius,192,druid,balance,6,2,4
10858,Bobobear,proudmoore,192,druid,balance,6,2,4
10859,Glowstixz,tichondrius,192,druid,balance,6,2,4
10860,Astroprof,bloodscalp,192,druid,balance,6,2,4
10861,Malcavelli,tichondrius,192,druid,balance,6,2,4
10862,Cbreezyy,tichondrius,192,druid,balance,6,2,4
10863,Blackchina,tichondrius,192,druid,balance,6,2,4
10864,Outofreach,tichondrius,192,druid,balance,6,2,4
10865,Hellabanx,tichondrius,192,druid,balance,6,2,4
10866,Bomme,zuljin,192,druid,balance,7,2,5
10867,Kångåwålafox,sargeras,192,druid,balance,8,2,6
10868,Panchuwuanky,sargeras,192,druid,balance,8,2,6
10869,Thundyrcat,tichondrius,192,druid,balance,12,2,10
10870,Papaland,tichondrius,192,druid,balance,12,2,10
10871,Unhappystill,tichondrius,192,druid,balance,12,2,10
10872,Murrmerly,moon-guard,192,druid,balance,12,2,10
10873,Trisinz,perenolde,192,druid,balance,12,2,10
10874,Shalkam,stormrage,192,druid,balance,12,2,10
10875,Gholdris,moon-guard,192,druid,balance,12,2,10
10876,Rakuath,zuljin,192,druid,balance,12,2,10
10877,Skaidi,quelthalas,192,druid,balance,12,2,10
10878,Alluminax,sargeras,192,druid,balance,12,2,10
10879,Daydaygo,illidan,192,druid,balance,12,2,10
10880,Visûcius,moon-guard,192,druid,balance,12,2,10
10881,Pusscat,illidan,192,druid,balance,18,2,16
10882,Thicchicken,emerald-dream,191,druid,balance,12,2,10
10883,Moonkingx,ragnaros,159,druid,balance,5,2,3
10884,Xylemcow,malganis,159,druid,balance,5,2,3
10885,Formality,kalecgos,159,druid,balance,5,2,3
10886,Sludgischonk,stormrage,159,druid,balance,5,2,3
10887,Stealthhero,lightbringer,159,druid,balance,5,2,3
10888,Irontree,dunemaul,159,druid,balance,5,2,3
10889,Mayarí,sargeras,159,druid,balance,16,3,13
10890,Ishalu,tichondrius,138,druid,balance,6,3,3
10891,Appitrap,emerald-dream,137,druid,balance,19,3,16
10892,Wiseoldman,jubeithos,136,druid,balance,8,3,5
10893,Nightruffles,moon-guard,128,druid,balance,4,2,2
10894,Hirtenweg,stormrage,127,druid,balance,14,2,12
10895,Aeo,frostmourne,112,druid,balance,7,2,5
10896,Highs,sargeras,112,druid,balance,7,2,5
10897,Stradamus,sargeras,96,druid,balance,3,2,1
10898,Moosesolini,chogall,96,druid,balance,3,2,1
10899,Yøpièrre,bleeding-hollow,96,druid,balance,3,2,1
10900,Ultracatx,tichondrius,96,druid,balance,6,1,5
10901,Feralmain,illidan,96,druid,balance,6,1,5
10902,Sneakydikns,tichondrius,96,druid,balance,6,1,5
10903,Caponetonejr,steamwheedle-cartel,96,druid,balance,6,1,5
10904,Aelena,whisperwind,96,druid,balance,6,1,5
10905,Zazinium,illidan,96,druid,balance,6,1,5
10906,Stalfrus,area-52,96,druid,balance,6,1,5
10907,Keithmoonkin,area-52,96,druid,balance,6,1,5
10908,Chalupà,illidan,96,druid,balance,6,1,5
10909,Sheeftah,illidan,96,druid,balance,6,1,5
10910,Sundae,khazgoroth,96,druid,balance,6,1,5
10911,Edorant,illidan,96,druid,balance,6,1,5
10912,Bullkkake,tichondrius,96,druid,balance,6,1,5
10913,Oyweklefga,kelthuzad,96,druid,balance,6,1,5
10914,Bpdferal,stormrage,96,druid,balance,6,1,5
10915,Slackoth,dalaran,96,druid,balance,6,1,5
10916,Faldrynn,sargeras,96,druid,balance,6,1,5
10917,Chulogringo,tichondrius,96,druid,balance,6,1,5
10918,Mirudru,stormrage,96,druid,balance,6,1,5
10919,Scarn,nathrezim,96,druid,balance,6,1,5
10920,Interfury,magtheridon,96,druid,balance,6,1,5
10921,Watchlady,thunderhorn,96,druid,balance,6,1,5
10922,Ggumy,tichondrius,96,druid,balance,6,1,5
10923,Breedable,elune,96,druid,balance,6,1,5
10924,Florgsgorgan,sargeras,96,druid,balance,6,1,5
10925,Furryluvr,tichondrius,96,druid,balance,6,1,5
10926,Sinapticc,proudmoore,96,druid,balance,6,1,5
10927,Hurloon,demon-soul,96,druid,balance,6,1,5
10928,Brucey,khadgar,96,druid,balance,6,1,5
10929,Rennan,cenarius,96,druid,balance,6,1,5
10930,Fioryxd,bleeding-hollow,96,druid,balance,6,1,5
10931,Travys,sargeras,96,druid,balance,6,1,5
10932,Torpina,malganis,96,druid,balance,6,1,5
10933,Twentypeice,tichondrius,96,druid,balance,6,1,5
10934,Klint,darkspear,96,druid,balance,6,1,5
10935,Stinkycrotch,malganis,96,druid,balance,6,1,5
10936,Invisakitty,demon-soul,96,druid,balance,6,1,5
10937,Kipsmiffly,darkspear,96,druid,balance,6,1,5
10938,Kirrel,frostmourne,96,druid,balance,6,1,5
10939,Harambetwo,quelthalas,96,druid,balance,6,1,5
10940,Zelø,zuljin,96,druid,balance,6,1,5
10941,Thissaene,sargeras,96,druid,balance,6,1,5
10942,Øvernight,azralon,96,druid,balance,6,1,5
10943,Jorkalak,zuljin,96,druid,balance,6,1,5
10944,Ravendawnn,tichondrius,96,druid,balance,6,1,5
10945,Elivacheth,zuljin,96,druid,balance,6,1,5
10946,Dendríta,ragnaros,96,druid,balance,6,1,5
10947,Aeoc,barthilas,96,druid,balance,6,1,5
10948,Anímorph,sargeras,96,druid,balance,6,1,5
10949,Drilnos,hyjal,96,druid,balance,6,1,5
10950,Walkdown,turalyon,96,druid,balance,6,1,5
10951,Gaìjin,barthilas,96,druid,balance,6,1,5
10952,Earthstalker,crushridge,96,druid,balance,6,1,5
10953,Oldcktwist,garrosh,96,druid,balance,6,1,5
10954,Omegabeast,frostmourne,96,druid,balance,6,1,5
10955,Notdev,grizzly-hills,96,druid,balance,6,1,5
10956,Youlived,aegwynn,96,druid,balance,6,1,5
10957,Scatpanties,moon-guard,96,druid,balance,6,1,5
10958,Shmooglite,emerald-dream,96,druid,balance,6,1,5
10959,Goodhealer,akama,96,druid,balance,6,1,5
10960,Selling,moon-guard,96,druid,balance,6,1,5
10961,Bernwolf,moon-guard,96,druid,balance,6,1,5
10962,Encosan,azralon,96,druid,balance,7,1,6
10963,Simbaa,blades-edge,96,druid,balance,10,1,9
10964,Grimmb,emerald-dream,96,druid,balance,12,1,11
10965,Kängawalafox,frostmourne,96,druid,balance,12,1,11
10966,Kodrän,stormrage,96,druid,balance,12,1,11
10967,Ranokaliki,tichondrius,89,druid,balance,10,3,7
10968,Gorfrog,tichondrius,84,druid,balance,13,6,7
10969,Drewcarriesu,arthas,79,druid,balance,5,2,3
10970,Lutzenberger,nemesis,79,druid,balance,5,1,4
10971,Hydraulick,tichondrius,79,druid,balance,5,1,4
10972,Zephiee,kelthuzad,79,druid,balance,5,1,4
10973,Foggie,spirestone,79,druid,balance,5,1,4
10974,Raahmirtah,illidan,79,druid,balance,5,1,4
10975,Manalune,firetree,79,druid,balance,5,1,4
10976,Doingo,destromath,79,druid,balance,11,1,10
10977,Morpheûs,bleeding-hollow,64,druid,balance,4,1,3
10978,Hughhefferr,illidan,63,druid,balance,2,2,0
10979,Guarbird,tichondrius,48,druid,balance,3,1,2
10980,Policë,skullcrusher,42,druid,balance,8,2,6
10981,Tsubakihara,azralon,16,druid,balance,1,1,0
10982,Garbagevoker,scilla,2242,evoker,preservation,192,99,93
10983,Dracob,sargeras,2180,evoker,preservation,252,140,112
10984,Sleepiihead,stormrage,2130,evoker,preservation,96,50,46
10985,Meraxes,moonrunner,2124,evoker,preservation,131,64,67
10986,Sleepiiheadx,stormrage,2112,evoker,preservation,114,63,51
10987,Dragocula,tichondrius,2106,evoker,preservation,109,55,54
10988,Sheepstealer,shuhalo,2104,evoker,preservation,133,69,64
10989,Jakedrake,stormrage,2062,evoker,preservation,235,117,118
10990,Mkabaka,tichondrius,2009,evoker,preservation,82,47,35
10991,Idk,proudmoore,2004,evoker,preservation,66,34,32
10992,Kallie,whisperwind,1997,evoker,preservation,515,257,258
10993,Eskrizzle,thrall,1991,evoker,preservation,78,38,40
10994,Storeypagoda,tichondrius,1983,evoker,preservation,155,80,75
10995,Eyjes,stormrage,1979,evoker,preservation,187,98,89
10996,Jdbthyr,malganis,1974,evoker,preservation,264,127,137
10997,Walf,stormrage,1971,evoker,preservation,403,207,196
10998,Lucardeht,illidan,1970,evoker,preservation,92,46,46
10999,Healpumper,kelthuzad,1950,evoker,preservation,76,44,32
11000,Kiry,emerald-dream,1934,evoker,preservation,114,54,60
11001,Idrinkurine,tichondrius,1918,evoker,preservation,88,45,43
11002,Ellafortnite,emerald-dream,1915,evoker,preservation,55,31,24
11003,Didy,tichondrius,1913,evoker,preservation,370,184,186
11004,Advancedonly,tichondrius,1912,evoker,preservation,54,26,28
11005,Soô,tichondrius,1900,evoker,preservation,36,20,16
11006,Sloane,dunemaul,1899,evoker,preservation,51,32,19
11007,Dracthyrfang,elune,1895,evoker,preservation,250,122,128
11008,Ravebae,frostmourne,1889,evoker,preservation,73,37,36
11009,Bimbus,illidan,1887,evoker,preservation,154,85,69
11010,Philmcracken,proudmoore,1883,evoker,preservation,34,24,10
11011,Joc,khazgoroth,1881,evoker,preservation,83,49,34
11012,Benym,tichondrius,1873,evoker,preservation,60,32,28
11013,Lieferant,area-52,1867,evoker,preservation,48,25,23
11014,Draconian,frostmourne,1866,evoker,preservation,76,36,40
11015,Drupy,tichondrius,1860,evoker,preservation,60,31,29
11016,Dragongunz,illidan,1853,evoker,preservation,48,21,27
11017,Selkisaurus,area-52,1852,evoker,preservation,114,53,61
11018,Dragonkok,stormrage,1848,evoker,preservation,48,28,20
11019,Thnake,zuljin,1839,evoker,preservation,72,38,34
11020,Driceses,area-52,1838,evoker,preservation,83,50,33
11021,Dracadukez,illidan,1836,evoker,preservation,84,35,49
11022,Ancalagøn,ragnaros,1833,evoker,preservation,70,35,35
11023,Ojigi,sargeras,1833,evoker,preservation,69,28,41
11024,Versezz,tichondrius,1829,evoker,preservation,42,28,14
11025,Iba,tichondrius,1828,evoker,preservation,96,54,42
11026,Draggin,barthilas,1828,evoker,preservation,48,24,24
11027,Neskor,moon-guard,1827,evoker,preservation,101,58,43
11028,Hamine,tichondrius,1825,evoker,preservation,113,52,61
11029,Cenchii,proudmoore,1822,evoker,preservation,54,28,26
11030,Voíd,sargeras,1814,evoker,preservation,45,29,16
11031,Dragboy,stormrage,1812,evoker,preservation,187,107,80
11032,Patzdormu,area-52,1812,evoker,preservation,73,32,41
11033,Mngxaltx,ragnaros,1810,evoker,preservation,96,42,54
11034,Zarref,sargeras,1809,evoker,preservation,48,26,22
11035,Hlaargh,illidan,1809,evoker,preservation,60,31,29
11036,Dragonclause,stormrage,1809,evoker,preservation,72,32,40
11037,Aymadragon,sargeras,1807,evoker,preservation,68,38,30
11038,Furegos,zuljin,1807,evoker,preservation,48,23,25
11039,Lodekiim,malganis,1806,evoker,preservation,66,30,36
11040,Usedbandage,sargeras,1805,evoker,preservation,271,144,127
11041,Mcdonovan,stormrage,1805,evoker,preservation,81,36,45
11042,Yoyke,tichondrius,1804,evoker,preservation,84,41,43
11043,Révoked,magtheridon,1802,evoker,preservation,323,179,144
11044,Velstrasza,stormrage,1802,evoker,preservation,54,29,25
11045,Dragonchip,bleeding-hollow,1801,evoker,preservation,101,46,55
11046,Obama,dragonmaw,1801,evoker,preservation,78,33,45
11047,Novustrasza,lightbringer,1800,evoker,preservation,66,43,23
11048,Petezra,ragnaros,1800,evoker,preservation,70,33,37
11049,Áäøxgød,ravencrest,1799,evoker,preservation,136,64,72
11050,Livesey,thunderhorn,1791,evoker,preservation,96,56,40
11051,Dreamfuego,tichondrius,1791,evoker,preservation,60,25,35
11052,Flybro,malganis,1787,evoker,preservation,30,19,11
11053,Basedfurry,dalaran,1786,evoker,preservation,48,25,23
11054,Dweamfuego,sargeras,1777,evoker,preservation,30,19,11
11055,Drerick,illidan,1772,evoker,preservation,104,53,51
11056,Evokethisdik,tichondrius,1768,evoker,preservation,43,25,18
11057,Fatsu,executus,1768,evoker,preservation,54,24,30
11058,Dragontrees,illidan,1765,evoker,preservation,54,28,26
11059,Enderal,stormrage,1765,evoker,preservation,48,24,24
11060,Ugg,stormrage,1756,evoker,preservation,171,76,95
11061,Elimi,tichondrius,1748,evoker,preservation,36,22,14
11062,Berquone,tichondrius,1747,evoker,preservation,72,31,41
11063,Starkiller,stormrage,1745,evoker,preservation,60,37,23
11064,Dunkinonem,black-dragonflight,1738,evoker,preservation,927,464,463
11065,Phooby,sargeras,1736,evoker,preservation,72,37,35
11066,Rosestrasza,silvermoon,1734,evoker,preservation,132,63,69
11067,Stønemonkey,sargeras,1730,evoker,preservation,147,73,74
11068,Thugzillah,tichondrius,1728,evoker,preservation,103,68,35
11069,Wimsx,malganis,1727,evoker,preservation,125,65,60
11070,Dracobys,area-52,1724,evoker,preservation,52,26,26
11071,Dirtydragon,uther,1724,evoker,preservation,54,22,32
11072,Kainalaz,moon-guard,1715,evoker,preservation,55,28,27
11073,Basherm,moon-guard,1711,evoker,preservation,96,47,49
11074,Lodedragon,tichondrius,1709,evoker,preservation,150,69,81
11075,Twizzthyr,bleeding-hollow,1705,evoker,preservation,168,85,83
11076,Moralies,area-52,1705,evoker,preservation,48,24,24
11077,Benbm,proudmoore,1703,evoker,preservation,36,18,18
11078,Deathdrake,jubeithos,1703,evoker,preservation,215,106,109
11079,Chronoloop,tichondrius,1699,evoker,preservation,32,21,11
11080,Siire,tichondrius,1697,evoker,preservation,36,19,17
11081,Chañïng,frostmourne,1695,evoker,preservation,36,18,18
11082,Redeyesblm,sargeras,1693,evoker,preservation,37,21,16
11083,Schmitty,hellscream,1689,evoker,preservation,100,48,52
11084,Flamedramon,bleeding-hollow,1689,evoker,preservation,247,117,130
11085,Ancalagðn,quelthalas,1687,evoker,preservation,66,26,40
11086,Mirandaxo,tichondrius,1684,evoker,preservation,161,73,88
11087,Skyheal,ragnaros,1683,evoker,preservation,42,22,20
11088,Yukiormi,sargeras,1677,evoker,preservation,36,18,18
11089,Halcyonxz,tichondrius,1677,evoker,preservation,48,23,25
11090,Seviant,tichondrius,1671,evoker,preservation,48,20,28
11091,Got,burning-blade,1668,evoker,preservation,45,25,20
11092,Dupastrasza,illidan,1664,evoker,preservation,60,25,35
11093,Gharkul,frostmourne,1663,evoker,preservation,48,25,23
11094,Tallcanman,kelthuzad,1660,evoker,preservation,42,20,22
11095,Stinkler,stormscale,1659,evoker,preservation,126,63,63
11096,Allevesh,shadow-council,1658,evoker,preservation,34,20,14
11097,Vulkerr,stormrage,1657,evoker,preservation,122,67,55
11098,Daegonz,lightbringer,1657,evoker,preservation,116,57,59
11099,Cannotjump,tichondrius,1653,evoker,preservation,60,27,33
11100,Flyboy,malganis,1649,evoker,preservation,42,23,19
11101,Redseal,tichondrius,1648,evoker,preservation,110,52,58
11102,Sandragon,ragnaros,1646,evoker,preservation,57,25,32
11103,Domavem,tichondrius,1642,evoker,preservation,66,28,38
11104,Sanninv,barthilas,1638,evoker,preservation,57,26,31
11105,Cycircle,proudmoore,1637,evoker,preservation,41,23,18
11106,Cokobra,haomarush,1636,evoker,preservation,36,21,15
11107,Trákanon,mugthol,1634,evoker,preservation,67,37,30
11108,Ðrac,bleeding-hollow,1633,evoker,preservation,53,30,23
11109,Neocellx,frostwolf,1633,evoker,preservation,91,43,48
11110,Modenzu,malganis,1629,evoker,preservation,66,33,33
11111,Dripdrop,stormscale,1627,evoker,preservation,94,49,45
11112,Junkstam,malganis,1627,evoker,preservation,75,34,41
11113,Wingsoflyfe,frostmourne,1625,evoker,preservation,48,20,28
11114,Pootylizard,daggerspine,1625,evoker,preservation,50,19,31
11115,Dragonman,twisting-nether,1624,evoker,preservation,47,26,21
11116,Yop,proudmoore,1624,evoker,preservation,108,45,63
11117,Briggsybear,malganis,1622,evoker,preservation,82,48,34
11118,Dragondikz,tichondrius,1622,evoker,preservation,48,25,23
11119,Congodragon,frostmourne,1620,evoker,preservation,48,28,20
11120,Dgevoker,tichondrius,1620,evoker,preservation,47,19,28
11121,Lucidreamx,tichondrius,1618,evoker,preservation,73,39,34
11122,Nyzara,emerald-dream,1618,evoker,preservation,180,92,88
11123,Seeyn,tichondrius,1618,evoker,preservation,78,33,45
11124,Grunkthyr,moon-guard,1614,evoker,preservation,47,25,22
11125,Egglayer,tichondrius,1611,evoker,preservation,196,91,105
11126,Leonilxd,tichondrius,1610,evoker,preservation,97,51,46
11127,Bigdwagon,stormrage,1608,evoker,preservation,36,17,19
11128,Triarcs,sargeras,1606,evoker,preservation,40,21,19
11129,Dragisha,gnomeregan,1604,evoker,preservation,184,103,81
11130,Emperör,quelthalas,1604,evoker,preservation,109,58,51
11131,Deadlybx,bleeding-hollow,1603,evoker,preservation,70,32,38
11132,Fxii,tichondrius,1602,evoker,preservation,101,53,48
11133,Layugos,azralon,1601,evoker,preservation,35,20,15
11134,Provokker,drakkari,1600,evoker,preservation,30,21,9
11135,Purrlynn,tichondrius,1600,evoker,preservation,72,42,30
11136,Jnitoscaly,tichondrius,1598,evoker,preservation,30,20,10
11137,Judra,barthilas,1598,evoker,preservation,98,48,50
11138,Zakaraki,bloodscalp,1597,evoker,preservation,171,99,72
11139,Kwebab,tichondrius,1595,evoker,preservation,48,19,29
11140,Chessyk,ragnaros,1594,evoker,preservation,53,33,20
11141,Jimmydragon,blackhand,1585,evoker,preservation,72,31,41
11142,Adragon,garithos,1585,evoker,preservation,77,30,47
11143,Thinprivlege,area-52,1583,evoker,preservation,60,26,34
11144,Trembulos,malganis,1582,evoker,preservation,78,41,37
11145,Jacm,fizzcrank,1582,evoker,preservation,123,63,60
11146,Vokr,area-52,1582,evoker,preservation,158,78,80
11147,Unidragon,malganis,1581,evoker,preservation,54,22,32
11148,Evokesyn,stormrage,1580,evoker,preservation,105,55,50
11149,Kozaraler,stormrage,1579,evoker,preservation,60,38,22
11150,Zenot,malganis,1575,evoker,preservation,46,34,12
11151,Drakjar,nemesis,1569,evoker,preservation,72,34,38
11152,Elcigala,ragnaros,1566,evoker,preservation,285,147,138
11153,Hotblower,tichondrius,1565,evoker,preservation,61,22,39
11154,Drepz,dalaran,1564,evoker,preservation,63,45,18
11155,Linkinloatr,tichondrius,1563,evoker,preservation,54,23,31
11156,Buttcrease,emerald-dream,1562,evoker,preservation,42,22,20
11157,Møritz,stormrage,1562,evoker,preservation,86,40,46
11158,Whethersmell,tichondrius,1559,evoker,preservation,194,90,104
11159,Xboy,tichondrius,1556,evoker,preservation,49,23,26
11160,Christína,tichondrius,1554,evoker,preservation,65,45,20
11161,Azarke,rivendare,1554,evoker,preservation,42,20,22
11162,Vhaegart,area-52,1553,evoker,preservation,141,66,75
11163,Dougreen,azralon,1552,evoker,preservation,38,18,20
11164,Shruikan,lightnings-blade,1552,evoker,preservation,42,19,23
11165,Bigbaojian,tichondrius,1550,evoker,preservation,65,31,34
11166,Spyrox,zuluhed,1549,evoker,preservation,54,32,22
11167,Dracore,firetree,1549,evoker,preservation,215,112,103
11168,Alitasbbq,malganis,1547,evoker,preservation,48,19,29
11169,Ffaarrvv,illidan,1545,evoker,preservation,108,63,45
11170,Ninereeds,malganis,1543,evoker,preservation,102,53,49
11171,Whelpling,cenarion-circle,1541,evoker,preservation,24,19,5
11172,Tonysaur,lethon,1537,evoker,preservation,30,19,11
11173,Prettycooll,dathremar,1537,evoker,preservation,36,17,19
11174,Kwitty,illidan,1535,evoker,preservation,48,27,21
11175,Tinine,frostmourne,1535,evoker,preservation,133,65,68
11176,Fláppÿbírd,bleeding-hollow,1533,evoker,preservation,24,16,8
11177,Stinkybussy,mannoroth,1533,evoker,preservation,65,37,28
11178,Corncrake,sargeras,1530,evoker,preservation,50,23,27
11179,Jlucks,wyrmrest-accord,1529,evoker,preservation,172,94,78
11180,Pauly,suramar,1525,evoker,preservation,100,53,47
11181,Velocîraptor,bleeding-hollow,1524,evoker,preservation,92,53,39
11182,Sineexe,illidan,1523,evoker,preservation,98,58,40
11183,Transmogplz,tichondrius,1522,evoker,preservation,66,27,39
11184,Nulldd,tichondrius,1521,evoker,preservation,59,21,38
11185,Gobananas,sargeras,1520,evoker,preservation,29,17,12
11186,Vormontis,azralon,1518,evoker,preservation,140,69,71
11187,Thevochr,area-52,1514,evoker,preservation,42,27,15
11188,Asschaps,area-52,1513,evoker,preservation,60,32,28
11189,Dragonsteppz,aegwynn,1512,evoker,preservation,30,16,14
11190,Mfka,dalaran,1512,evoker,preservation,83,39,44
11191,Earthshatter,lightbringer,1510,evoker,preservation,166,91,75
11192,Suffler,warsong,1509,evoker,preservation,267,139,128
11193,Dragdezenutz,bleeding-hollow,1508,evoker,preservation,112,45,67
11194,Veraxsys,wyrmrest-accord,1507,evoker,preservation,67,23,44
11195,Miliolievo,azralon,1506,evoker,preservation,313,161,152
11196,Waggon,moon-guard,1504,evoker,preservation,48,26,22
11197,Cyndragosa,dalvengyr,1503,evoker,preservation,119,54,65
11198,Youngyongdie,tichondrius,1499,evoker,preservation,52,25,27
11199,Handeezol,malganis,1498,evoker,preservation,71,43,28
11200,Kratheu,azralon,1494,evoker,preservation,53,26,27
11201,Zullavoker,bleeding-hollow,1493,evoker,preservation,30,18,12
11202,Beautylily,tichondrius,1492,evoker,preservation,311,172,139
11203,Masondragon,darkspear,1492,evoker,preservation,36,16,20
11204,Kaidagos,tichondrius,1491,evoker,preservation,60,32,28
11205,Snuggleboo,malganis,1490,evoker,preservation,24,16,8
11206,Emoker,magtheridon,1490,evoker,preservation,84,46,38
11207,Dragoncods,velen,1488,evoker,preservation,48,26,22
11208,Buttfinger,bladefist,1488,evoker,preservation,86,39,47
11209,Hepzibah,kelthuzad,1488,evoker,preservation,53,23,30
11210,Virtualcrush,sisters-of-elune,1486,evoker,preservation,94,49,45
11211,Quickshootin,tichondrius,1486,evoker,preservation,355,171,184
11212,Nfts,darkspear,1486,evoker,preservation,40,18,22
11213,Skrimbles,tichondrius,1486,evoker,preservation,54,24,30
11214,Nikholatrus,malganis,1483,evoker,preservation,106,52,54
11215,Longaot,tichondrius,1482,evoker,preservation,96,56,40
11216,Splendadaddy,kiljaeden,1482,evoker,preservation,30,16,14
11217,Ajiz,mannoroth,1479,evoker,preservation,48,23,25
11218,Darchomp,illidan,1478,evoker,preservation,42,17,25
11219,Ralzital,auchindoun,1476,evoker,preservation,68,29,39
11220,Yotus,illidan,1474,evoker,preservation,60,35,25
11221,Diavai,area-52,1471,evoker,preservation,93,41,52
11222,Qiblii,moon-guard,1470,evoker,preservation,48,24,24
11223,Monavoker,bleeding-hollow,1466,evoker,preservation,36,20,16
11224,Delivv,hyjal,1466,evoker,preservation,90,48,42
11225,Ponnukii,tichondrius,1466,evoker,preservation,184,93,91
11226,Runawayslave,frostmane,1466,evoker,preservation,233,110,123
11227,Venjolly,wyrmrest-accord,1465,evoker,preservation,63,33,30
11228,Madegood,tichondrius,1465,evoker,preservation,72,32,40
11229,Setalet,zuljin,1465,evoker,preservation,47,19,28
11230,Weagle,zuljin,1465,evoker,preservation,45,18,27
11231,Bucket,wyrmrest-accord,1464,evoker,preservation,44,17,27
11232,Necrathma,tichondrius,1461,evoker,preservation,169,84,85
11233,Enazen,kiljaeden,1460,evoker,preservation,83,45,38
11234,Bynaero,area-52,1460,evoker,preservation,42,16,26
11235,Uneedawhip,zuljin,1457,evoker,preservation,36,19,17
11236,Unknowndrago,kul-tiras,1457,evoker,preservation,36,18,18
11237,Giratina,area-52,1457,evoker,preservation,108,53,55
11238,Ycnpass,tichondrius,1456,evoker,preservation,158,89,69
11239,Stableboy,bleeding-hollow,1455,evoker,preservation,54,27,27
11240,Lalargata,azralon,1455,evoker,preservation,77,38,39
11241,Eyolker,kelthuzad,1455,evoker,preservation,82,39,43
11242,Cringilisk,kelthuzad,1454,evoker,preservation,126,82,44
11243,Caredormu,frostmourne,1449,evoker,preservation,47,23,24
11244,Suedeshoes,bleeding-hollow,1448,evoker,preservation,162,88,74
11245,Evoskunk,kelthuzad,1448,evoker,preservation,48,24,24
11246,Nyxtari,ragnaros,1447,evoker,preservation,108,57,51
11247,Nazzadormu,tichondrius,1445,evoker,preservation,70,30,40
11248,Squarter,kiljaeden,1443,evoker,preservation,60,34,26
11249,Hageiz,tichondrius,1441,evoker,preservation,60,27,33
11250,Ttvfòxyllamà,tichondrius,1439,evoker,preservation,30,15,15
11251,Linguistic,tichondrius,1439,evoker,preservation,42,18,24
11252,Xurota,proudmoore,1436,evoker,preservation,104,47,57
11253,Usedaspirin,sargeras,1435,evoker,preservation,30,15,15
11254,Aetherz,illidan,1434,evoker,preservation,36,15,21
11255,Dragonmyass,tichondrius,1434,evoker,preservation,43,17,26
11256,Kjerne,stormrage,1432,evoker,preservation,69,37,32
11257,Slither,terenas,1432,evoker,preservation,212,111,101
11258,Biggestbroie,frostmourne,1431,evoker,preservation,30,15,15
11259,Dragonkink,sargeras,1429,evoker,preservation,61,32,29
11260,Kymoxien,sargeras,1427,evoker,preservation,30,16,14
11261,Sovietønion,tichondrius,1425,evoker,preservation,83,38,45
11262,Macismighty,emerald-dream,1423,evoker,preservation,101,54,47
11263,Nandrolona,sargeras,1423,evoker,preservation,30,15,15
11264,Spyrodadrago,malganis,1423,evoker,preservation,113,50,63
11265,Annum,moon-guard,1423,evoker,preservation,60,22,38
11266,Nandrolona,malganis,1422,evoker,preservation,30,15,15
11267,Dracndanuts,draenor,1422,evoker,preservation,43,19,24
11268,Zka,nemesis,1421,evoker,preservation,55,28,27
11269,Bendover,proudmoore,1420,evoker,preservation,42,22,20
11270,Laggathaa,emerald-dream,1420,evoker,preservation,62,29,33
11271,Dmt,ravencrest,1419,evoker,preservation,24,15,9
11272,Epsilon,laughing-skull,1419,evoker,preservation,24,15,9
11273,Slimez,malganis,1418,evoker,preservation,188,84,104
11274,Evokeo,area-52,1417,evoker,preservation,30,15,15
11275,Nazatra,wyrmrest-accord,1417,evoker,preservation,125,60,65
11276,Zaedor,stormrage,1416,evoker,preservation,40,26,14
11277,Kephii,eonar,1415,evoker,preservation,42,22,20
11278,Nakyp,dalaran,1415,evoker,preservation,30,15,15
11279,Meiron,azralon,1413,evoker,preservation,78,39,39
11280,Garchamp,area-52,1412,evoker,preservation,48,20,28
11281,Gannsito,emerald-dream,1411,evoker,preservation,36,20,16
11282,Fusrodude,shuhalo,1411,evoker,preservation,98,53,45
11283,Kcwt,illidan,1411,evoker,preservation,113,55,58
11284,Vyndormu,moon-guard,1410,evoker,preservation,46,22,24
11285,Tørched,icecrown,1409,evoker,preservation,30,17,13
11286,Apollygos,malganis,1406,evoker,preservation,78,41,37
11287,Kigglypuff,illidan,1406,evoker,preservation,36,15,21
11288,Cyntheticdr,malganis,1404,evoker,preservation,54,30,24
11289,Velzelya,zuljin,1404,evoker,preservation,60,27,33
11290,Roogye,illidan,1403,evoker,preservation,96,49,47
11291,Sía,drakkari,1402,evoker,preservation,66,39,27
11292,Courtvoke,turalyon,1402,evoker,preservation,233,117,116
11293,Kaldobar,stormrage,1401,evoker,preservation,24,15,9
11294,Naykir,khazgoroth,1400,evoker,preservation,42,27,15
11295,Anthyrsia,zuljin,1400,evoker,preservation,47,24,23
11296,Coldspawn,nerzhul,1400,evoker,preservation,30,15,15
11297,Thicscales,tichondrius,1400,evoker,preservation,76,36,40
11298,Dylôn,tichondrius,1398,evoker,preservation,58,27,31
11299,Masquemeto,illidan,1396,evoker,preservation,49,25,24
11300,Ráigon,ragnaros,1394,evoker,preservation,142,64,78
11301,Ultis,tichondrius,1392,evoker,preservation,420,217,203
11302,Derazar,malganis,1391,evoker,preservation,288,128,160
11303,Darthjarjar,bloodscalp,1390,evoker,preservation,285,144,141
11304,Grousegamer,barthilas,1389,evoker,preservation,82,35,47
11305,Jmir,tichondrius,1389,evoker,preservation,59,24,35
11306,Eldenkingy,sargeras,1389,evoker,preservation,70,28,42
11307,Voithyr,moon-guard,1382,evoker,preservation,241,110,131
11308,Gogmagog,korgath,1381,evoker,preservation,95,43,52
11309,Quesodillas,stormreaver,1379,evoker,preservation,60,25,35
11310,Jamörant,tichondrius,1378,evoker,preservation,24,15,9
11311,Santokki,tichondrius,1378,evoker,preservation,158,76,82
11312,Tazarke,dawnbringer,1375,evoker,preservation,60,35,25
11313,Flowsmoke,tichondrius,1375,evoker,preservation,78,40,38
11314,Tigthyr,alleria,1375,evoker,preservation,30,15,15
11315,Bigdrag,blackhand,1373,evoker,preservation,103,56,47
11316,Mordrakhuul,chogall,1372,evoker,preservation,72,30,42
11317,Dragonpel,azralon,1371,evoker,preservation,124,62,62
11318,Chambea,kelthuzad,1370,evoker,preservation,77,40,37
11319,Errier,tichondrius,1370,evoker,preservation,33,17,16
11320,Cjin,tichondrius,1370,evoker,preservation,36,18,18
11321,Healmeta,sargeras,1369,evoker,preservation,308,154,154
11322,Vodkasauce,tichondrius,1369,evoker,preservation,30,15,15
11323,Tzindelor,illidan,1364,evoker,preservation,60,27,33
11324,Primshin,illidan,1363,evoker,preservation,117,59,58
11325,Glizzurd,proudmoore,1363,evoker,preservation,309,154,155
11326,Otsira,frostmourne,1359,evoker,preservation,60,37,23
11327,Friedwings,wyrmrest-accord,1359,evoker,preservation,27,16,11
11328,Greenscales,frostmourne,1358,evoker,preservation,105,43,62
11329,Enalen,azjolnerub,1357,evoker,preservation,86,42,44
11330,Misico,illidan,1355,evoker,preservation,78,46,32
11331,Growthyy,malganis,1354,evoker,preservation,57,32,25
11332,Thepplschamp,bloodhoof,1354,evoker,preservation,48,23,25
11333,Gavstarz,frostmourne,1354,evoker,preservation,86,40,46
11334,Cosmodrake,daggerspine,1352,evoker,preservation,54,24,30
11335,Lifewing,bleeding-hollow,1352,evoker,preservation,67,25,42
11336,Cynderrellaa,proudmoore,1351,evoker,preservation,164,81,83
11337,Bomber,frostwolf,1351,evoker,preservation,34,16,18
11338,Charbothyr,gorgonnash,1350,evoker,preservation,67,34,33
11339,Tigdragon,proudmoore,1348,evoker,preservation,36,16,20
11340,Biagi,proudmoore,1347,evoker,preservation,28,17,11
11341,Kikokosta,tichondrius,1346,evoker,preservation,281,140,141
11342,Garboker,area-52,1346,evoker,preservation,158,75,83
11343,Salusx,proudmoore,1345,evoker,preservation,42,18,24
11344,Sabledraco,stormrage,1344,evoker,preservation,18,14,4
11345,Kîñggïgàçhäð,stormrage,1343,evoker,preservation,24,14,10
11346,Feijiwang,aegwynn,1342,evoker,preservation,69,41,28
11347,Boseijwho,emerald-dream,1342,evoker,preservation,66,36,30
11348,Kalsit,emerald-dream,1341,evoker,preservation,64,30,34
11349,Originull,tichondrius,1340,evoker,preservation,24,14,10
11350,Deepbreather,sargeras,1338,evoker,preservation,30,18,12
11351,Actïoncat,emerald-dream,1338,evoker,preservation,69,26,43
11352,Fionyan,proudmoore,1337,evoker,preservation,36,14,22
11353,Gumbåll,bleeding-hollow,1335,evoker,preservation,192,93,99
11354,Altevoker,frostmourne,1334,evoker,preservation,89,51,38
11355,Bryagh,executus,1334,evoker,preservation,54,28,26
11356,Forsakentime,sargeras,1333,evoker,preservation,60,32,28
11357,Dawitchvoker,illidan,1333,evoker,preservation,324,166,158
11358,Caphe,nerzhul,1333,evoker,preservation,60,27,33
11359,Chunkè,moon-guard,1332,evoker,preservation,69,29,40
11360,Sylf,kiljaeden,1331,evoker,preservation,225,121,104
11361,Neffiie,dalaran,1331,evoker,preservation,106,50,56
11362,Léthée,zuljin,1331,evoker,preservation,30,14,16
11363,Nuunos,tichondrius,1330,evoker,preservation,41,17,24
11364,Mäverick,kelthuzad,1327,evoker,preservation,35,23,12
11365,Radragão,azralon,1326,evoker,preservation,48,28,20
11366,Kalikani,moon-guard,1326,evoker,preservation,99,45,54
11367,Norvoker,area-52,1325,evoker,preservation,58,31,27
11368,Sadeyes,dalaran,1323,evoker,preservation,113,62,51
11369,Gloamdream,cenarius,1321,evoker,preservation,344,179,165
11370,Dendywings,zuljin,1321,evoker,preservation,30,14,16
11371,Xerroh,area-52,1320,evoker,preservation,94,46,48
11372,Cadwaladr,frostmourne,1317,evoker,preservation,24,14,10
11373,Dracniel,illidan,1316,evoker,preservation,69,38,31
11374,Elurb,illidan,1316,evoker,preservation,66,30,36
11375,Velaryonhero,arthas,1313,evoker,preservation,74,40,34
11376,Nitalzith,area-52,1311,evoker,preservation,48,23,25
11377,Solong,sargeras,1310,evoker,preservation,67,38,29
11378,Inkdsy,detheroc,1310,evoker,preservation,30,16,14
11379,Jazzdragon,tichondrius,1310,evoker,preservation,51,24,27
11380,Verk,deathwing,1308,evoker,preservation,168,89,79
11381,Shudo,moon-guard,1308,evoker,preservation,119,62,57
11382,Whinks,zangarmarsh,1307,evoker,preservation,35,18,17
11383,Saviorkai,barthilas,1306,evoker,preservation,22,15,7
11384,Benjaminamin,stormrage,1306,evoker,preservation,30,20,10
11385,Wangasaur,emerald-dream,1302,evoker,preservation,55,26,29
11386,Matchamjölk,tichondrius,1302,evoker,preservation,53,23,30
11387,Zmaj,jubeithos,1301,evoker,preservation,36,23,13
11388,Fuoco,kiljaeden,1299,evoker,preservation,62,31,31
11389,Hamanv,tichondrius,1299,evoker,preservation,60,29,31
11390,Icthelestron,black-dragonflight,1297,evoker,preservation,44,30,14
11391,Zendrov,skywall,1297,evoker,preservation,84,41,43
11392,Lilacstrasza,moon-guard,1297,evoker,preservation,158,77,81
11393,Wtsgoldpst,tichondrius,1295,evoker,preservation,26,16,10
11394,Kraiz,frostmourne,1295,evoker,preservation,60,26,34
11395,Oogiewoogie,doomhammer,1294,evoker,preservation,23,14,9
11396,Frëëbîë,area-52,1294,evoker,preservation,42,21,21
11397,Lizzardload,stormreaver,1294,evoker,preservation,83,37,46
11398,Xmystique,area-52,1293,evoker,preservation,40,19,21
11399,Straxolotl,frostmourne,1293,evoker,preservation,81,33,48
11400,Crayonshinch,tichondrius,1291,evoker,preservation,30,15,15
11401,Amnemís,tichondrius,1288,evoker,preservation,38,22,16
11402,Hydrrax,dalaran,1288,evoker,preservation,255,126,129
11403,Moiraine,frostwolf,1288,evoker,preservation,48,17,31
11404,Gotbreath,dalaran,1287,evoker,preservation,90,46,44
11405,Rynntynn,blood-furnace,1286,evoker,preservation,30,15,15
11406,Nitalash,moon-guard,1286,evoker,preservation,29,14,15
11407,Paladinex,tichondrius,1284,evoker,preservation,47,27,20
11408,Thereptile,frostmourne,1284,evoker,preservation,90,41,49
11409,Dragûn,stormrage,1279,evoker,preservation,30,16,14
11410,Shellessturt,kelthuzad,1278,evoker,preservation,27,14,13
11411,Hotdawgin,korgath,1278,evoker,preservation,124,57,67
11412,Rayquazä,kelthuzad,1277,evoker,preservation,26,14,12
11413,Feelzz,illidan,1275,evoker,preservation,43,22,21
11414,Drgndeeznüts,tichondrius,1272,evoker,preservation,58,27,31
11415,Vgt,nemesis,1270,evoker,preservation,152,70,82
11416,Antirrhinum,zuljin,1268,evoker,preservation,48,32,16
11417,Dragonfruits,lightbringer,1268,evoker,preservation,90,46,44
11418,Selfhealzer,korgath,1268,evoker,preservation,92,43,49
11419,Akavoker,sargeras,1267,evoker,preservation,62,21,41
11420,Cronós,tichondrius,1266,evoker,preservation,90,38,52
11421,Bassblasterr,dalaran,1265,evoker,preservation,24,14,10
11422,Lickndragons,sargeras,1265,evoker,preservation,36,14,22
11423,Ayavi,illidan,1255,evoker,preservation,40,23,17
11424,Skailyx,zuljin,1254,evoker,preservation,30,14,16
11425,Brantley,stormscale,1253,evoker,preservation,86,41,45
11426,Agony,emerald-dream,1252,evoker,preservation,249,121,128
11427,Xhamon,quelthalas,1251,evoker,preservation,98,49,49
11428,Nicegirl,stormrage,1251,evoker,preservation,42,21,21
11429,Terpsy,area-52,1250,evoker,preservation,23,16,7
11430,Mãttyy,malganis,1250,evoker,preservation,42,23,19
11431,Xazxander,tichondrius,1249,evoker,preservation,78,37,41
11432,Stadman,illidan,1248,evoker,preservation,24,13,11
11433,Aoibae,frostmourne,1248,evoker,preservation,126,57,69
11434,Dreamvisage,silvermoon,1247,evoker,preservation,44,20,24
11435,Mikoriivoker,tichondrius,1247,evoker,preservation,30,13,17
11436,Wethotgarbee,tichondrius,1245,evoker,preservation,44,23,21
11437,Darkscalyboi,dalaran,1245,evoker,preservation,54,25,29
11438,Justbreathez,tichondrius,1245,evoker,preservation,35,13,22
11439,Fibonac,frostmourne,1243,evoker,preservation,78,48,30
11440,Miradrake,icecrown,1243,evoker,preservation,30,13,17
11441,Thendroz,aerie-peak,1242,evoker,preservation,95,54,41
11442,Valarakuu,illidan,1242,evoker,preservation,24,13,11
11443,Raykwaza,tichondrius,1242,evoker,preservation,42,20,22
11444,Rustty,bleeding-hollow,1242,evoker,preservation,89,37,52
11445,Dansauce,sargeras,1241,evoker,preservation,56,30,26
11446,Goonwing,frostmourne,1241,evoker,preservation,30,15,15
11447,Lilithlittle,daggerspine,1241,evoker,preservation,247,121,126
11448,Wildcard,shattered-hand,1241,evoker,preservation,35,16,19
11449,Allaston,tichondrius,1240,evoker,preservation,45,28,17
11450,Zandragosa,dalaran,1240,evoker,preservation,24,13,11
11451,Riz,blackhand,1239,evoker,preservation,114,56,58
11452,Rubellite,azralon,1238,evoker,preservation,71,36,35
11453,Nerfmeplsaoa,area-52,1236,evoker,preservation,24,13,11
11454,Zerath,frostmane,1236,evoker,preservation,30,13,17
11455,Lavagurl,stormscale,1235,evoker,preservation,30,13,17
11456,Xaxas,boulderfist,1234,evoker,preservation,30,13,17
11457,Everglow,the-forgotten-coast,1233,evoker,preservation,48,26,22
11458,Dragocser,drakkari,1233,evoker,preservation,30,13,17
11459,Tinyvoker,area-52,1232,evoker,preservation,72,26,46
11460,Irezfortips,tichondrius,1231,evoker,preservation,18,13,5
11461,Astoragosa,moon-guard,1231,evoker,preservation,61,38,23
11462,Verosria,area-52,1230,evoker,preservation,24,13,11
11463,Shenlong,malganis,1230,evoker,preservation,116,59,57
11464,Mythsvoker,barthilas,1229,evoker,preservation,61,33,28
11465,Zippityzoom,barthilas,1229,evoker,preservation,59,30,29
11466,Onornun,magtheridon,1229,evoker,preservation,66,32,34
11467,Draxyrawr,area-52,1228,evoker,preservation,29,18,11
11468,Macdrag,malganis,1228,evoker,preservation,24,13,11
11469,Mastadragndz,illidan,1228,evoker,preservation,42,13,29
11470,Kycaka,area-52,1228,evoker,preservation,46,14,32
11471,Lévocatrice,hakkar,1225,evoker,preservation,64,31,33
11472,Evokas,tichondrius,1224,evoker,preservation,252,128,124
11473,Abelldragon,tichondrius,1224,evoker,preservation,34,17,17
11474,Lebronjmz,kiljaeden,1224,evoker,preservation,127,58,69
11475,Mëleys,ragnaros,1224,evoker,preservation,53,24,29
11476,Scalesona,black-dragonflight,1222,evoker,preservation,31,14,17
11477,Barneydragon,stormrage,1220,evoker,preservation,24,14,10
11478,Milfwizard,tichondrius,1219,evoker,preservation,24,13,11
11479,Dkvastate,tichondrius,1216,evoker,preservation,118,58,60
11480,Dunkelzahn,gorgonnash,1214,evoker,preservation,30,15,15
11481,Amniotic,hyjal,1212,evoker,preservation,54,31,23
11482,Ysondrius,durotan,1212,evoker,preservation,48,26,22
11483,Naszeebo,frostmourne,1212,evoker,preservation,54,24,30
11484,Raptormoto,lothar,1211,evoker,preservation,32,14,18
11485,Zindrozarath,area-52,1210,evoker,preservation,161,81,80
11486,Deezdragon,stormrage,1209,evoker,preservation,47,24,23
11487,Sanaz,stormreaver,1208,evoker,preservation,54,28,26
11488,Balèrion,illidan,1207,evoker,preservation,60,33,27
11489,Ghidorah,sentinels,1207,evoker,preservation,59,32,27
11490,Gadiel,draka,1207,evoker,preservation,50,25,25
11491,Weirdclassx,tichondrius,1207,evoker,preservation,47,23,24
11492,Zinderal,thunderlord,1206,evoker,preservation,48,24,24
11493,Buttstough,aerie-peak,1206,evoker,preservation,41,20,21
11494,Frozanat,kelthuzad,1205,evoker,preservation,75,34,41
11495,Döublepenn,tichondrius,1204,evoker,preservation,90,46,44
11496,Deshandrov,bleeding-hollow,1203,evoker,preservation,24,13,11
11497,Doogiehowser,azshara,1202,evoker,preservation,162,78,84
11498,Dìnosaur,illidan,1201,evoker,preservation,36,18,18
11499,Nêwt,darkspear,1201,evoker,preservation,238,115,123
11500,Shook,baelgun,1200,evoker,preservation,202,102,100
11501,Assassasin,bonechewer,1200,evoker,preservation,60,27,33
11502,Partysnaxx,thrall,1199,evoker,preservation,72,35,37
11503,Çhara,illidan,1198,evoker,preservation,126,65,61
11504,Lamentation,area-52,1198,evoker,preservation,119,61,58
11505,Rayvoker,elune,1198,evoker,preservation,54,27,27
11506,Lazioo,frostmourne,1196,evoker,preservation,22,14,8
11507,Maldormu,stormrage,1196,evoker,preservation,37,16,21
11508,Karganos,darkspear,1195,evoker,preservation,48,27,21
11509,Shênlong,sargeras,1193,evoker,preservation,54,22,32
11510,Crowqt,frostmourne,1190,evoker,preservation,95,34,61
11511,Careflight,barthilas,1188,evoker,preservation,66,39,27
11512,Brôcôlînî,zuljin,1187,evoker,preservation,43,29,14
11513,Bahamut,magtheridon,1186,evoker,preservation,60,25,35
11514,Dmuzh,drakkari,1185,evoker,preservation,406,219,187
11515,Shockragosa,chogall,1184,evoker,preservation,42,13,29
11516,Wyldefire,senjin,1180,evoker,preservation,48,22,26
11517,Hakuroyime,ragnaros,1179,evoker,preservation,36,21,15
11518,Deralan,khaz-modan,1179,evoker,preservation,108,40,68
11519,Yozhz,ragnaros,1177,evoker,preservation,53,25,28
11520,Mungwings,area-52,1172,evoker,preservation,55,26,29
11521,Scalyhoe,alterac-mountains,1171,evoker,preservation,36,13,23
11522,Razerazenoth,tichondrius,1169,evoker,preservation,36,19,17
11523,Dandera,stormrage,1169,evoker,preservation,106,50,56
11524,Kaguax,tichondrius,1167,evoker,preservation,84,32,52
11525,Worldx,illidan,1166,evoker,preservation,24,13,11
11526,Lyingdragon,tichondrius,1166,evoker,preservation,60,26,34
11527,Mazalagon,trollbane,1165,evoker,preservation,29,15,14
11528,Detreshan,stormreaver,1163,evoker,preservation,164,87,77
11529,Dragonsama,area-52,1163,evoker,preservation,30,13,17
11530,Hlf,tichondrius,1162,evoker,preservation,44,24,20
11531,Draginnuts,illidan,1162,evoker,preservation,53,25,28
11532,Repairraptor,area-52,1159,evoker,preservation,81,37,44
11533,Vermitor,sargeras,1155,evoker,preservation,24,13,11
11534,Firebreather,quelthalas,1155,evoker,preservation,30,13,17
11535,Skithyrix,bleeding-hollow,1153,evoker,preservation,68,32,36
11536,Dzdv,stormrage,1151,evoker,preservation,18,12,6
11537,Mikoribreath,moknathal,1151,evoker,preservation,18,12,6
11538,Aspecto,area-52,1151,evoker,preservation,117,51,66
11539,Flyingmooie,frostmourne,1151,evoker,preservation,30,12,18
11540,Crsevencr,tichondrius,1150,evoker,preservation,18,12,6
11541,Kilawatt,barthilas,1150,evoker,preservation,23,15,8
11542,Djdavi,azralon,1150,evoker,preservation,132,77,55
11543,Raundur,ragnaros,1150,evoker,preservation,24,12,12
11544,Mysticenergy,tichondrius,1150,evoker,preservation,60,28,32
11545,Venitsu,malganis,1150,evoker,preservation,30,12,18
11546,Cycircle,tichondrius,1149,evoker,preservation,24,12,12
11547,Smokeflare,frostmane,1149,evoker,preservation,24,12,12
11548,Spyrotime,tichondrius,1149,evoker,preservation,33,12,21
11549,Yessirs,shadow-council,1148,evoker,preservation,18,12,6
11550,Emozoomer,malganis,1148,evoker,preservation,66,25,41
11551,Faffytwo,illidan,1147,evoker,preservation,24,12,12
11552,Héllfire,ghostlands,1147,evoker,preservation,54,25,29
11553,Derkscale,stormrage,1146,evoker,preservation,36,17,19
11554,Distortion,drakthul,1145,evoker,preservation,117,62,55
11555,Riizo,malganis,1144,evoker,preservation,86,51,35
11556,Xiwinnie,illidan,1144,evoker,preservation,36,14,22
11557,Visserion,sargeras,1143,evoker,preservation,25,14,11
11558,Readwise,tichondrius,1143,evoker,preservation,26,12,14
11559,Badbill,moon-guard,1142,evoker,preservation,18,12,6
11560,Satratren,moon-guard,1142,evoker,preservation,30,12,18
11561,Zitasanazen,tichondrius,1141,evoker,preservation,299,153,146
11562,Arcanasz,thrall,1137,evoker,preservation,24,12,12
11563,Zackxo,moon-guard,1136,evoker,preservation,38,24,14
11564,Vermax,akama,1133,evoker,preservation,45,17,28
11565,Zascar,stormrage,1132,evoker,preservation,24,13,11
11566,Rorie,farstriders,1131,evoker,preservation,30,14,16
11567,Treadcinder,tichondrius,1130,evoker,preservation,30,14,16
11568,Cindermint,mugthol,1130,evoker,preservation,38,17,21
11569,Blay,elune,1130,evoker,preservation,36,15,21
11570,Drokula,darkspear,1127,evoker,preservation,30,13,17
11571,Draczod,proudmoore,1123,evoker,preservation,59,23,36
11572,Saphfire,burning-legion,1122,evoker,preservation,24,16,8
11573,Kathendrov,sargeras,1121,evoker,preservation,54,29,25
11574,Caucasian,aegwynn,1121,evoker,preservation,88,35,53
11575,Dzracona,gorefiend,1120,evoker,preservation,26,13,13
11576,Cootietooter,icecrown,1120,evoker,preservation,36,16,20
11577,Endroz,tichondrius,1119,evoker,preservation,24,12,12
11578,Drathron,tichondrius,1118,evoker,preservation,28,13,15
11579,Smaaugg,area-52,1117,evoker,preservation,18,12,6
11580,Tryhard,wyrmrest-accord,1116,evoker,preservation,84,37,47
11581,Prevoker,kirin-tor,1115,evoker,preservation,42,25,17
11582,Kersava,frostmourne,1115,evoker,preservation,53,27,26
11583,Darksmoke,spirestone,1112,evoker,preservation,24,12,12
11584,Atpsuspect,nerzhul,1112,evoker,preservation,24,12,12
11585,Drozul,stormrage,1112,evoker,preservation,42,14,28
11586,Idingosa,moon-guard,1109,evoker,preservation,28,12,16
11587,Thegrinchh,malganis,1107,evoker,preservation,93,45,48
11588,Potfase,tichondrius,1106,evoker,preservation,66,28,38
11589,Dragonwench,sargeras,1101,evoker,preservation,22,13,9
11590,Geico,spinebreaker,1100,evoker,preservation,15,13,2
11591,Droggerdrago,stormreaver,1100,evoker,preservation,24,14,10
11592,Ilithiphobia,ghostlands,1100,evoker,preservation,38,16,22
11593,Ashandshadow,area-52,1099,evoker,preservation,68,30,38
11594,Daikis,proudmoore,1098,evoker,preservation,42,20,22
11595,Saintpablox,illidan,1097,evoker,preservation,40,13,27
11596,Krossbones,cenarion-circle,1096,evoker,preservation,80,47,33
11597,Djornmustman,sargeras,1094,evoker,preservation,36,12,24
11598,Rah,gurubashi,1093,evoker,preservation,47,28,19
11599,Vyraethel,wyrmrest-accord,1093,evoker,preservation,51,27,24
11600,Bayvoker,area-52,1093,evoker,preservation,56,29,27
11601,Mesamune,bonechewer,1090,evoker,preservation,121,58,63
11602,Abigaile,illidan,1088,evoker,preservation,24,17,7
11603,Seiros,garrosh,1088,evoker,preservation,50,21,29
11604,Mikkaelin,ragnaros,1086,evoker,preservation,67,31,36
11605,Niraz,dalaran,1085,evoker,preservation,24,12,12
11606,Emyhr,sargeras,1084,evoker,preservation,24,13,11
11607,Drimare,quelthalas,1084,evoker,preservation,42,14,28
11608,Draisin,zuljin,1083,evoker,preservation,24,13,11
11609,Dragndeez,garrosh,1083,evoker,preservation,46,12,34
11610,Setash,hyjal,1081,evoker,preservation,24,12,12
11611,Clubmetro,boulderfist,1081,evoker,preservation,39,18,21
11612,Lahfly,tichondrius,1079,evoker,preservation,54,33,21
11613,Dragoreo,illidan,1078,evoker,preservation,47,20,27
11614,Shenrøn,altar-of-storms,1076,evoker,preservation,50,28,22
11615,Qiuhan,tichondrius,1076,evoker,preservation,48,23,25
11616,Bronzus,ragnaros,1076,evoker,preservation,73,29,44
11617,Lilithà,kelthuzad,1075,evoker,preservation,30,20,10
11618,Stankywing,thrall,1075,evoker,preservation,34,17,17
11619,Deàthwing,proudmoore,1074,evoker,preservation,53,16,37
11620,Bobstrasz,tichondrius,1073,evoker,preservation,36,12,24
11621,Unscaleable,illidan,1072,evoker,preservation,18,13,5
11622,Bumbledragn,moon-guard,1071,evoker,preservation,37,23,14
11623,Maxyz,khadgar,1071,evoker,preservation,42,13,29
11624,Balmoze,tichondrius,1070,evoker,preservation,60,31,29
11625,Dragonknght,tichondrius,1066,evoker,preservation,30,16,14
11626,Draganoche,zuljin,1066,evoker,preservation,30,14,16
11627,Kharizard,moon-guard,1065,evoker,preservation,33,12,21
11628,Worldsdragon,area-52,1064,evoker,preservation,24,16,8
11629,Shyyvana,malganis,1062,evoker,preservation,18,12,6
11630,Sacrementus,tichondrius,1062,evoker,preservation,66,24,42
11631,Fenalysten,cenarius,1060,evoker,preservation,113,49,64
11632,Dragown,sargeras,1059,evoker,preservation,36,16,20
11633,Tëssarion,quelthalas,1059,evoker,preservation,32,14,18
11634,Binidragon,tichondrius,1055,evoker,preservation,12,11,1
11635,Whelp,shadow-council,1055,evoker,preservation,18,11,7
11636,Messyvok,illidan,1055,evoker,preservation,26,11,15
11637,Unclelroh,kelthuzad,1054,evoker,preservation,24,11,13
11638,Allaker,kargath,1054,evoker,preservation,40,17,23
11639,Pnse,perenolde,1054,evoker,preservation,30,11,19
11640,Dwagndeez,tichondrius,1054,evoker,preservation,30,11,19
11641,Fenroth,kelthuzad,1052,evoker,preservation,24,11,13
11642,Dragonfroot,darkspear,1052,evoker,preservation,24,11,13
11643,Slippee,mugthol,1051,evoker,preservation,12,11,1
11644,Imugee,sargeras,1051,evoker,preservation,24,11,13
11645,Swanzea,sargeras,1049,evoker,preservation,18,11,7
11646,Puraimaru,sargeras,1049,evoker,preservation,30,11,19
11647,Vxfire,sargeras,1047,evoker,preservation,24,11,13
11648,Chewykek,area-52,1047,evoker,preservation,24,11,13
11649,Scalethorne,illidan,1047,evoker,preservation,24,11,13
11650,Smögg,quelthalas,1046,evoker,preservation,42,19,23
11651,Jinuva,tichondrius,1045,evoker,preservation,18,11,7
11652,Draghyon,tichondrius,1044,evoker,preservation,42,11,31
11653,Drittles,illidan,1043,evoker,preservation,62,28,34
11654,Dragonarchy,draenor,1042,evoker,preservation,54,26,28
11655,Uniqqe,tichondrius,1041,evoker,preservation,18,11,7
11656,Dracoly,medivh,1041,evoker,preservation,24,12,12
11657,Bobbydracthy,illidan,1041,evoker,preservation,24,11,13
11658,Brovoker,darkspear,1039,evoker,preservation,24,11,13
11659,Jorlozthyr,ragnaros,1039,evoker,preservation,36,12,24
11660,Charadrius,zuljin,1038,evoker,preservation,41,23,18
11661,Strawdormu,ragnaros,1037,evoker,preservation,18,11,7
11662,Myxter,tichondrius,1035,evoker,preservation,49,25,24
11663,Cripcuhz,tichondrius,1035,evoker,preservation,72,36,36
11664,Carloxd,tichondrius,1035,evoker,preservation,34,12,22
11665,Boomlvx,frostmourne,1034,evoker,preservation,24,11,13
11666,Enzi,vashj,1033,evoker,preservation,24,11,13
11667,Fránky,ragnaros,1033,evoker,preservation,71,31,40
11668,Blankebr,gallywix,1032,evoker,preservation,36,24,12
11669,Proevoker,illidan,1031,evoker,preservation,24,11,13
11670,Skkuld,stormrage,1029,evoker,preservation,24,11,13
11671,Evohrker,area-52,1028,evoker,preservation,24,11,13
11672,Dracomedicus,frostmourne,1028,evoker,preservation,70,24,46
11673,Degghurtni,area-52,1026,evoker,preservation,18,11,7
11674,Mokkdala,blackrock,1026,evoker,preservation,40,12,28
11675,Evoke,boulderfist,1025,evoker,preservation,28,12,16
11676,Sïgrìd,tichondrius,1024,evoker,preservation,45,30,15
11677,Sophdrac,illidan,1024,evoker,preservation,43,25,18
11678,Karmakulax,wildhammer,1024,evoker,preservation,31,12,19
11679,Trillis,eldrethalas,1023,evoker,preservation,36,23,13
11680,Vandinus,stormrage,1023,evoker,preservation,50,23,27
11681,Draconys,shattered-hand,1020,evoker,preservation,42,23,19
11682,Adessa,lothar,1020,evoker,preservation,36,14,22
11683,Ownlyfans,silvermoon,1018,evoker,preservation,24,12,12
11684,Cunk,illidan,1018,evoker,preservation,24,11,13
11685,Prahvlord,shuhalo,1018,evoker,preservation,60,26,34
11686,Turukmakto,illidan,1017,evoker,preservation,29,14,15
11687,Tarnuss,skullcrusher,1017,evoker,preservation,42,14,28
11688,Eiselhuus,moon-guard,1015,evoker,preservation,59,21,38
11689,Toothless,garithos,1014,evoker,preservation,30,17,13
11690,Mightywings,skywall,1011,evoker,preservation,138,70,68
11691,Ohffs,malganis,1011,evoker,preservation,30,14,16
11692,Richviewrd,illidan,1010,evoker,preservation,42,22,20
11693,Esq,sargeras,1007,evoker,preservation,17,11,6
11694,Kaeszandrus,azralon,1007,evoker,preservation,64,29,35
11695,Boomon,blades-edge,1006,evoker,preservation,42,21,21
11696,Lightbeing,nazjatar,1001,evoker,preservation,48,29,19
11697,Wheyvern,malganis,1000,evoker,preservation,93,41,52
11698,Brahown,altar-of-storms,998,evoker,preservation,36,11,25
11699,Bizzstrasza,shadowsong,992,evoker,preservation,64,28,36
11700,Lawroadt,tichondrius,991,evoker,preservation,60,31,29
11701,Gemis,anvilmar,991,evoker,preservation,55,25,30
11702,Falsedaze,sargeras,990,evoker,preservation,43,20,23
11703,Ozmayzin,proudmoore,990,evoker,preservation,69,30,39
11704,Hover,vashj,989,evoker,preservation,27,13,14
11705,Items,frostmourne,987,evoker,preservation,22,11,11
11706,Vyreth,sargeras,987,evoker,preservation,81,38,43
11707,Sensandors,tichondrius,987,evoker,preservation,26,11,15
11708,Arazerazer,thrall,984,evoker,preservation,66,23,43
11709,Arazarion,mugthol,979,evoker,preservation,30,17,13
11710,Smaugett,zuljin,979,evoker,preservation,44,23,21
11711,Kivoke,proudmoore,974,evoker,preservation,42,18,24
11712,Curamil,azralon,973,evoker,preservation,26,11,15
11713,Echoker,destromath,968,evoker,preservation,55,26,29
11714,Milkspurt,tichondrius,962,evoker,preservation,52,23,29
11715,Rubyzz,illidan,960,evoker,preservation,18,10,8
11716,Goatkiller,lightbringer,960,evoker,preservation,18,10,8
11717,Syraxiez,sargeras,960,evoker,preservation,18,10,8
11718,Solryp,terokkar,960,evoker,preservation,149,72,77
11719,Uncleìroh,tichondrius,960,evoker,preservation,24,10,14
11720,Wamajam,area-52,960,evoker,preservation,24,10,14
11721,Gaslightqt,tichondrius,960,evoker,preservation,25,10,15
11722,Flyingkush,illidan,959,evoker,preservation,12,10,2
11723,Baldpython,area-52,959,evoker,preservation,18,10,8
11724,Dragoontekka,tichondrius,959,evoker,preservation,18,10,8
11725,Abevv,bonechewer,959,evoker,preservation,18,10,8
11726,Myspycanfly,malganis,958,evoker,preservation,12,10,2
11727,Slrepeat,frostmourne,958,evoker,preservation,18,10,8
11728,Puffthemagic,lightnings-blade,958,evoker,preservation,18,10,8
11729,Truffleßutta,tichondrius,958,evoker,preservation,18,10,8
11730,Dragonsand,area-52,958,evoker,preservation,62,30,32
11731,Meepslol,kiljaeden,958,evoker,preservation,24,10,14
11732,Drakthussey,illidan,957,evoker,preservation,18,10,8
11733,Dokthyr,lightbringer,956,evoker,preservation,12,10,2
11734,Erotheryx,gorgonnash,956,evoker,preservation,18,10,8
11735,Goonguy,gnomeregan,955,evoker,preservation,12,10,2
11736,Holdherhorn,area-52,955,evoker,preservation,18,10,8
11737,Dragy,bonechewer,954,evoker,preservation,24,10,14
11738,Hoverharder,stormrage,953,evoker,preservation,18,10,8
11739,Istaybrutal,malganis,953,evoker,preservation,18,10,8
11740,Soziin,skullcrusher,953,evoker,preservation,18,10,8
11741,Grievaxion,ragnaros,953,evoker,preservation,24,10,14
11742,Dragonblazer,illidan,952,evoker,preservation,18,10,8
11743,Ayoitspav,malganis,952,evoker,preservation,25,11,14
11744,Gemish,lethon,952,evoker,preservation,26,11,15
11745,Chue,quelthalas,952,evoker,preservation,24,10,14
11746,Rubyskye,tichondrius,950,evoker,preservation,18,10,8
11747,Surasi,frostmourne,948,evoker,preservation,18,10,8
11748,Frozonic,tichondrius,948,evoker,preservation,36,17,19
11749,Razen,silvermoon,946,evoker,preservation,28,13,15
11750,Tagritash,kelthuzad,946,evoker,preservation,24,10,14
11751,Dracthyrius,thunderlord,941,evoker,preservation,18,12,6
11752,Straightman,stormrage,940,evoker,preservation,68,32,36
11753,Dracalis,thrall,939,evoker,preservation,58,30,28
11754,Beerdragon,ragnaros,938,evoker,preservation,22,11,11
11755,Zeldaryel,azralon,934,evoker,preservation,12,10,2
11756,Gidury,tichondrius,934,evoker,preservation,96,44,52
11757,Faethana,thrall,929,evoker,preservation,23,11,12
11758,Azuril,wyrmrest-accord,929,evoker,preservation,90,29,61
11759,Furygos,stormrage,927,evoker,preservation,23,10,13
11760,Sheepdoll,icecrown,927,evoker,preservation,23,10,13
11761,Rilex,kelthuzad,927,evoker,preservation,30,11,19
11762,Dragonbro,spirestone,923,evoker,preservation,18,10,8
11763,Tribunalis,stormrage,915,evoker,preservation,18,11,7
11764,Lagartixa,kirin-tor,913,evoker,preservation,36,14,22
11765,Justbreathe,sargeras,911,evoker,preservation,17,10,7
11766,Kaelestian,ragnaros,910,evoker,preservation,36,18,18
11767,Saintetoile,tichondrius,905,evoker,preservation,48,24,24
11768,Aspects,dreadmaul,905,evoker,preservation,31,12,19
11769,Badvoker,area-52,902,evoker,preservation,71,26,45
11770,Cransvoker,illidan,902,evoker,preservation,30,10,20
11771,Bandel,tichondrius,896,evoker,preservation,22,12,10
11772,Kerlaan,illidan,895,evoker,preservation,18,10,8
11773,Spitdafire,tichondrius,894,evoker,preservation,27,10,17
11774,Medrathion,wyrmrest-accord,887,evoker,preservation,23,10,13
11775,Drewskie,malganis,885,evoker,preservation,78,29,49
11776,Dreezoo,tichondrius,881,evoker,preservation,62,33,29
11777,Mugenyan,ragnaros,879,evoker,preservation,41,21,20
11778,Pypokay,nemesis,877,evoker,preservation,48,17,31
11779,Drakthuul,icecrown,869,evoker,preservation,70,32,38
11780,Willowflight,illidan,867,evoker,preservation,50,23,27
11781,Viserion,wildhammer,865,evoker,preservation,44,10,34
11782,Toonahzy,area-52,864,evoker,preservation,12,9,3
11783,Mikorivoker,illidan,864,evoker,preservation,12,9,3
11784,Mewoker,sargeras,864,evoker,preservation,12,9,3
11785,Calvoker,moon-guard,864,evoker,preservation,18,9,9
11786,Yaaty,tichondrius,864,evoker,preservation,24,9,15
11787,Fkndragon,proudmoore,864,evoker,preservation,30,9,21
11788,Lizardfaith,tichondrius,863,evoker,preservation,12,9,3
11789,Smnsevoker,emerald-dream,863,evoker,preservation,12,9,3
11790,Wonderk,frostmourne,863,evoker,preservation,18,9,9
11791,Tonymanitoba,whisperwind,863,evoker,preservation,18,9,9
11792,Nuubvoker,stormrage,863,evoker,preservation,18,9,9
11793,Tadhg,mugthol,863,evoker,preservation,30,12,18
11794,Azngodz,tichondrius,863,evoker,preservation,24,9,15
11795,Flaemer,thaurissan,862,evoker,preservation,12,9,3
11796,Velocivraull,malganis,862,evoker,preservation,12,9,3
11797,Xerithious,bleeding-hollow,862,evoker,preservation,18,9,9
11798,Jesstrasza,quelthalas,862,evoker,preservation,96,42,54
11799,Kakanjutan,azralon,861,evoker,preservation,16,10,6
11800,Evvookkeerr,tichondrius,861,evoker,preservation,18,9,9
11801,Gravityblast,tichondrius,861,evoker,preservation,24,9,15
11802,Chewydragoon,kelthuzad,860,evoker,preservation,12,9,3
11803,Binxyboy,garrosh,860,evoker,preservation,16,10,6
11804,Arûmat,tichondrius,859,evoker,preservation,30,9,21
11805,Glamorousbra,tichondrius,857,evoker,preservation,18,9,9
11806,Aethrys,zuljin,856,evoker,preservation,12,9,3
11807,Salakhar,drakkari,856,evoker,preservation,18,9,9
11808,Bjason,tichondrius,855,evoker,preservation,18,9,9
11809,Linabeauty,ragnaros,854,evoker,preservation,24,9,15
11810,Dragonballer,trollbane,853,evoker,preservation,24,9,15
11811,Garrgle,sargeras,850,evoker,preservation,18,9,9
11812,Moxa,doomhammer,850,evoker,preservation,83,41,42
11813,Moiraine,kargath,850,evoker,preservation,24,9,15
11814,Hentaizilla,kiljaeden,850,evoker,preservation,55,19,36
11815,Lickyertits,tichondrius,849,evoker,preservation,24,9,15
11816,Lechonlechon,tichondrius,847,evoker,preservation,12,9,3
11817,Orïon,azralon,845,evoker,preservation,24,9,15
11818,Spliffdragon,sargeras,843,evoker,preservation,47,18,29
11819,Drákô,ragnaros,841,evoker,preservation,30,9,21
11820,Gdragons,tichondrius,838,evoker,preservation,22,11,11
11821,Aurastella,frostwolf,837,evoker,preservation,24,9,15
11822,Pinkponies,area-52,834,evoker,preservation,12,9,3
11823,Lisatallie,moon-guard,834,evoker,preservation,18,9,9
11824,Decyrion,bleeding-hollow,830,evoker,preservation,29,9,20
11825,Sandrozeria,wyrmrest-accord,822,evoker,preservation,14,10,4
11826,Dragginhealz,stormrage,821,evoker,preservation,120,56,64
11827,Falastrasza,dalaran,821,evoker,preservation,23,9,14
11828,Zaldraka,cairne,819,evoker,preservation,31,13,18
11829,Yaaj,black-dragonflight,808,evoker,preservation,23,10,13
11830,Risumon,uldum,802,evoker,preservation,156,60,96
11831,Darkspyro,area-52,799,evoker,preservation,11,9,2
11832,Icallthecops,tichondrius,798,evoker,preservation,16,9,7
11833,Rockzocain,area-52,798,evoker,preservation,24,9,15
11834,Lendren,sargeras,795,evoker,preservation,28,9,19
11835,Scourgewing,wyrmrest-accord,795,evoker,preservation,30,9,21
11836,Azuragon,illidan,793,evoker,preservation,71,23,48
11837,Itsac,daggerspine,792,evoker,preservation,30,13,17
11838,Drackaras,stormrage,790,evoker,preservation,18,9,9
11839,Slyfur,burning-legion,786,evoker,preservation,18,9,9
11840,Kaddyragon,mannoroth,768,evoker,preservation,12,8,4
11841,Dracostayout,sargeras,768,evoker,preservation,12,8,4
11842,Æsshayád,area-52,768,evoker,preservation,12,8,4
11843,Rvrbzv,stormrage,768,evoker,preservation,12,8,4
11844,Hasstle,tichondrius,768,evoker,preservation,12,8,4
11845,Evokeondeez,stormrage,768,evoker,preservation,12,8,4
11846,Babylons,area-52,768,evoker,preservation,18,8,10
11847,Treysongz,area-52,768,evoker,preservation,18,8,10
11848,Airschlong,tichondrius,768,evoker,preservation,18,8,10
11849,Ryóng,tichondrius,768,evoker,preservation,18,8,10
11850,Unclefarmer,illidan,768,evoker,preservation,18,8,10
11851,Djvoker,zuljin,767,evoker,preservation,12,8,4
11852,Dendedewd,sargeras,767,evoker,preservation,12,8,4
11853,Fluffelss,moon-guard,767,evoker,preservation,12,8,4
11854,Icecoldrink,suramar,767,evoker,preservation,12,8,4
11855,Walloper,malganis,767,evoker,preservation,12,8,4
11856,Baradad,frostmourne,767,evoker,preservation,12,8,4
11857,Xiaolongmei,frostmourne,767,evoker,preservation,18,8,10
11858,Liltj,tichondrius,767,evoker,preservation,18,8,10
11859,Innervoker,tichondrius,767,evoker,preservation,18,8,10
11860,Smurgma,frostmane,767,evoker,preservation,18,8,10
11861,Dracritzzx,ragnaros,767,evoker,preservation,18,8,10
11862,Shrimpshumai,malganis,767,evoker,preservation,18,8,10
11863,Dracthott,thrall,767,evoker,preservation,18,8,10
11864,Slèv,frostmourne,767,evoker,preservation,18,8,10
11865,Nowon,tichondrius,767,evoker,preservation,24,8,16
11866,Devilmanguy,bonechewer,767,evoker,preservation,24,8,16
11867,Dracarus,crushridge,767,evoker,preservation,30,8,22
11868,Talzindera,sargeras,766,evoker,preservation,18,8,10
11869,Rewind,draka,766,evoker,preservation,18,8,10
11870,Sunfyrion,sargeras,766,evoker,preservation,24,8,16
11871,Shworm,bleeding-hollow,764,evoker,preservation,12,8,4
11872,Snitx,stormrage,764,evoker,preservation,24,8,16
11873,Neewhad,malganis,764,evoker,preservation,24,8,16
11874,Nutsdragon,tichondrius,763,evoker,preservation,18,8,10
11875,Wrathiøn,sargeras,763,evoker,preservation,24,8,16
11876,Matsutake,kelthuzad,762,evoker,preservation,18,8,10
11877,Dandroz,kelthuzad,761,evoker,preservation,18,8,10
11878,Bitkoinz,tichondrius,760,evoker,preservation,24,8,16
11879,Draehgor,hyjal,758,evoker,preservation,18,8,10
11880,Crumbflaps,kelthuzad,758,evoker,preservation,24,8,16
11881,Drabbot,thunderlord,755,evoker,preservation,12,8,4
11882,Lervish,durotan,755,evoker,preservation,12,8,4
11883,Gamesruined,area-52,753,evoker,preservation,19,8,11
11884,Tooby,velen,751,evoker,preservation,12,8,4
11885,Cinderoz,moon-guard,751,evoker,preservation,12,8,4
11886,Drevoker,lightbringer,748,evoker,preservation,18,8,10
11887,Criteria,burning-legion,748,evoker,preservation,18,8,10
11888,Madvillin,stormrage,747,evoker,preservation,12,8,4
11889,Chaosrebørn,bleeding-hollow,746,evoker,preservation,36,8,28
11890,Shintrax,ragnaros,744,evoker,preservation,73,35,38
11891,Durtyvoker,illidan,735,evoker,preservation,22,8,14
11892,Butta,darkspear,734,evoker,preservation,17,8,9
11893,Enuzan,dalaran,734,evoker,preservation,32,8,24
11894,Polland,area-52,731,evoker,preservation,17,8,9
11895,Enoch,chogall,727,evoker,preservation,27,10,17
11896,Tailia,sargeras,718,evoker,preservation,23,8,15
11897,Geicovoker,tichondrius,714,evoker,preservation,28,9,19
11898,Scaleyboy,tichondrius,713,evoker,preservation,21,10,11
11899,Shardsnorta,chogall,708,evoker,preservation,17,8,9
11900,Kyrusic,tichondrius,705,evoker,preservation,27,11,16
11901,Lunadragon,spinebreaker,704,evoker,preservation,16,8,8
11902,Murozond,burning-blade,703,evoker,preservation,20,8,12
11903,Kleptomancy,moon-guard,702,evoker,preservation,11,8,3
11904,Kalswyrm,burning-blade,702,evoker,preservation,20,8,12
11905,Wilbog,moon-guard,700,evoker,preservation,44,10,34
11906,Letharrian,sargeras,698,evoker,preservation,12,10,2
11907,Jsb,moon-guard,696,evoker,preservation,54,10,44
11908,Orame,dalaran,685,evoker,preservation,25,8,17
11909,Venlormi,moon-guard,675,evoker,preservation,46,15,31
11910,Goursaud,malganis,672,evoker,preservation,12,7,5
11911,Beatxqt,area-52,672,evoker,preservation,12,7,5
11912,Whirlydirly,malganis,672,evoker,preservation,12,7,5
11913,Vekke,illidan,672,evoker,preservation,12,7,5
11914,Azurgos,proudmoore,672,evoker,preservation,12,7,5
11915,Arnoeryan,ragnaros,672,evoker,preservation,12,7,5
11916,Vroomby,area-52,672,evoker,preservation,12,7,5
11917,Iantern,dalaran,672,evoker,preservation,12,7,5
11918,Vroomby,sargeras,672,evoker,preservation,12,7,5
11919,Suekeysaurus,frostmourne,672,evoker,preservation,12,7,5
11920,Alithrya,illidan,672,evoker,preservation,12,7,5
11921,Lilrandal,emerald-dream,672,evoker,preservation,12,7,5
11922,Ruffee,frostmourne,672,evoker,preservation,12,7,5
11923,Hypetwo,bleeding-hollow,672,evoker,preservation,12,7,5
11924,Vrondiss,trollbane,672,evoker,preservation,12,7,5
11925,Dragondubya,illidan,672,evoker,preservation,12,7,5
11926,Clm,staghelm,672,evoker,preservation,12,7,5
11927,Soyum,sargeras,672,evoker,preservation,18,7,11
11928,Imwoker,illidan,672,evoker,preservation,18,7,11
11929,Orncen,emerald-dream,672,evoker,preservation,18,7,11
11930,Draikia,zuljin,672,evoker,preservation,18,7,11
11931,Roastdrake,tichondrius,672,evoker,preservation,18,7,11
11932,Golden,area-52,672,evoker,preservation,18,7,11
11933,Toastsevoker,tichondrius,672,evoker,preservation,18,7,11
11934,Draislyn,cenarion-circle,672,evoker,preservation,18,7,11
11935,Evoketage,malganis,672,evoker,preservation,18,7,11
11936,Iamg,stormscale,672,evoker,preservation,18,7,11
11937,Datinysmaug,stormrage,672,evoker,preservation,21,7,14
11938,Zalpx,sargeras,672,evoker,preservation,24,7,17
11939,Hdyl,tichondrius,672,evoker,preservation,24,7,17
11940,Kontaz,icecrown,672,evoker,preservation,24,7,17
11941,Vertorgon,proudmoore,671,evoker,preservation,12,7,5
11942,Flapthewap,illidan,671,evoker,preservation,12,7,5
11943,Squablebox,kul-tiras,671,evoker,preservation,12,7,5
11944,Doramifa,tichondrius,671,evoker,preservation,12,7,5
11945,Vaxilia,sargeras,671,evoker,preservation,12,7,5
11946,Forlornomens,area-52,671,evoker,preservation,12,7,5
11947,Tyrøs,illidan,671,evoker,preservation,12,7,5
11948,Mittnz,arthas,671,evoker,preservation,12,7,5
11949,Kaidough,tichondrius,671,evoker,preservation,12,7,5
11950,Spicypnuts,zuljin,671,evoker,preservation,12,7,5
11951,Reskue,burning-legion,671,evoker,preservation,12,7,5
11952,Toppedyouoff,thrall,671,evoker,preservation,15,7,8
11953,Jigsz,illidan,671,evoker,preservation,18,7,11
11954,Longxx,dalaran,671,evoker,preservation,18,7,11
11955,Likelybaked,kiljaeden,671,evoker,preservation,18,7,11
11956,Nunez,frostmourne,671,evoker,preservation,18,7,11
11957,Trogdør,illidan,671,evoker,preservation,18,7,11
11958,Tailup,sargeras,671,evoker,preservation,18,7,11
11959,Bookkoo,burning-legion,671,evoker,preservation,24,7,17
11960,Drøgon,sargeras,671,evoker,preservation,24,7,17
11961,Lampizard,bonechewer,671,evoker,preservation,24,7,17
11962,Nienze,wyrmrest-accord,670,evoker,preservation,12,7,5
11963,Mad,aerie-peak,670,evoker,preservation,19,9,10
11964,Zumanitÿ,zangarmarsh,670,evoker,preservation,18,7,11
11965,Dshiznit,sargeras,670,evoker,preservation,24,7,17
11966,Woozul,malganis,670,evoker,preservation,30,7,23
11967,Deezyroller,sargeras,669,evoker,preservation,12,7,5
11968,Auradraca,queldorei,669,evoker,preservation,13,7,6
11969,Retcondragon,sargeras,669,evoker,preservation,18,7,11
11970,Rhaènyra,sargeras,669,evoker,preservation,18,7,11
11971,Tazalth,uther,668,evoker,preservation,18,7,11
11972,Selden,boulderfist,668,evoker,preservation,18,7,11
11973,Shartzypoo,thrall,668,evoker,preservation,24,7,17
11974,Alexstrazaa,hyjal,667,evoker,preservation,12,7,5
11975,Drizzydrag,jubeithos,667,evoker,preservation,18,7,11
11976,Xdragon,lightbringer,667,evoker,preservation,18,7,11
11977,Rainwalkers,illidan,666,evoker,preservation,12,7,5
11978,Aceu,bloodhoof,665,evoker,preservation,12,7,5
11979,Azulnova,tichondrius,665,evoker,preservation,18,7,11
11980,Erso,hellscream,664,evoker,preservation,12,7,5
11981,Acidbreath,tichondrius,661,evoker,preservation,18,7,11
11982,Leralera,moon-guard,660,evoker,preservation,12,7,5
11983,Mulutlaser,frostmourne,659,evoker,preservation,18,7,11
11984,Densgone,aggramar,654,evoker,preservation,18,7,11
11985,Yiptondabs,emerald-dream,650,evoker,preservation,29,7,22
11986,Thenasath,sargeras,640,evoker,preservation,17,7,10
11987,Wizkmushu,tichondrius,639,evoker,preservation,14,8,6
11988,Ramas,burning-blade,638,evoker,preservation,32,8,24
11989,Elderdragon,nerzhul,629,evoker,preservation,16,8,8
11990,Kixxely,sargeras,623,evoker,preservation,12,8,4
11991,Bootymágic,tichondrius,621,evoker,preservation,15,8,7
11992,Tsuruda,illidan,618,evoker,preservation,21,8,13
11993,Soukizilla,sargeras,608,evoker,preservation,16,7,9
11994,Saxthyr,stormreaver,592,evoker,preservation,13,7,6
11995,Ambadragon,frostmourne,591,evoker,preservation,11,7,4
11996,Madzul,emerald-dream,590,evoker,preservation,13,7,6
11997,Hwansu,tichondrius,576,evoker,preservation,6,6,0
11998,Cheesedragon,tichondrius,576,evoker,preservation,6,6,0
11999,Tatsurai,tichondrius,576,evoker,preservation,10,7,3
12000,Jugemjugempe,icecrown,576,evoker,preservation,12,6,6
12001,Diregon,kelthuzad,576,evoker,preservation,12,6,6
12002,Thalzudormu,bleeding-hollow,576,evoker,preservation,12,6,6
12003,Kwaz,kelthuzad,576,evoker,preservation,12,6,6
12004,Localfemboy,area-52,576,evoker,preservation,12,6,6
12005,Mushuffle,malygos,576,evoker,preservation,12,6,6
12006,Ozvoker,area-52,576,evoker,preservation,12,6,6
12007,Whitesnow,korgath,576,evoker,preservation,12,6,6
12008,Dragondznuts,archimonde,576,evoker,preservation,12,6,6
12009,Teëst,malganis,576,evoker,preservation,12,6,6
12010,Thefish,tichondrius,576,evoker,preservation,12,6,6
12011,Oldgeorge,tichondrius,576,evoker,preservation,12,6,6
12012,Daylenx,thrall,576,evoker,preservation,12,6,6
12013,Bad,nerzhul,576,evoker,preservation,12,6,6
12014,Melvoker,tichondrius,576,evoker,preservation,12,6,6
12015,Theyevokbuda,kelthuzad,576,evoker,preservation,12,6,6
12016,Wtfhappen,tichondrius,576,evoker,preservation,12,6,6
12017,Thegoone,bleeding-hollow,576,evoker,preservation,12,6,6
12018,Bookwyrm,khadgar,576,evoker,preservation,12,6,6
12019,Ccguzzlerx,tichondrius,576,evoker,preservation,12,6,6
12020,Exrtj,stormrage,576,evoker,preservation,12,6,6
12021,Teddydarg,tichondrius,576,evoker,preservation,14,6,8
12022,Hicane,tichondrius,576,evoker,preservation,18,6,12
12023,Alerale,thunderlord,576,evoker,preservation,18,6,12
12024,Ablunxs,drakkari,576,evoker,preservation,18,6,12
12025,Phanthyr,tichondrius,576,evoker,preservation,18,6,12
12026,Westyvoker,arthas,576,evoker,preservation,18,6,12
12027,Murphymonsta,stormscale,576,evoker,preservation,18,6,12
12028,Dragonk,dragonblight,576,evoker,preservation,18,6,12
12029,Jumpmaster,black-dragonflight,576,evoker,preservation,24,6,18
12030,Ryloun,sargeras,576,evoker,preservation,24,6,18
12031,Toodllesz,stormrage,575,evoker,preservation,6,6,0
12032,Valeshkanyel,ragnaros,575,evoker,preservation,12,6,6
12033,Karuikei,proudmoore,575,evoker,preservation,12,6,6
12034,Tokeandvoke,haomarush,575,evoker,preservation,12,6,6
12035,Ygnizem,ysera,575,evoker,preservation,12,6,6
12036,Flameschosen,malganis,575,evoker,preservation,12,6,6
12037,Dragonpaws,illidan,575,evoker,preservation,12,6,6
12038,Nâpâlm,aggramar,575,evoker,preservation,12,6,6
12039,Bhfflove,area-52,575,evoker,preservation,12,6,6
12040,Valadrakth,tichondrius,575,evoker,preservation,12,6,6
12041,Drakistraz,draenor,575,evoker,preservation,12,6,6
12042,Magnito,thorium-brotherhood,575,evoker,preservation,12,6,6
12043,Tekath,altar-of-storms,575,evoker,preservation,12,6,6
12044,Shinryuu,warsong,575,evoker,preservation,12,6,6
12045,Quetzaluma,tichondrius,575,evoker,preservation,14,6,8
12046,Tanninim,sargeras,575,evoker,preservation,18,6,12
12047,Naùghtygames,area-52,575,evoker,preservation,18,6,12
12048,Sgtskip,blackrock,575,evoker,preservation,24,6,18
12049,Kyloflight,thrall,575,evoker,preservation,24,6,18
12050,Drippydragon,stormrage,574,evoker,preservation,12,6,6
12051,Amun,frostwolf,574,evoker,preservation,12,6,6
12052,Evalker,tichondrius,574,evoker,preservation,12,6,6
12053,Cinderazerat,moon-guard,574,evoker,preservation,18,6,12
12054,Karrykx,tichondrius,574,evoker,preservation,18,6,12
12055,Azalana,thrall,574,evoker,preservation,24,6,18
12056,Rzdrag,nemesis,574,evoker,preservation,36,6,30
12057,Moraise,bonechewer,573,evoker,preservation,12,6,6
12058,Ozsandlbs,tichondrius,573,evoker,preservation,12,6,6
12059,Siquitraki,illidan,573,evoker,preservation,18,6,12
12060,Zulidar,silvermoon,572,evoker,preservation,12,6,6
12061,Banevoker,tichondrius,570,evoker,preservation,17,7,10
12062,Lishalthen,frostmourne,569,evoker,preservation,12,6,6
12063,Rhaeynes,moon-guard,568,evoker,preservation,12,6,6
12064,Ankhalagor,ragnaros,567,evoker,preservation,12,6,6
12065,Preservant,stormrage,567,evoker,preservation,12,6,6
12066,Dragussy,illidan,548,evoker,preservation,28,10,18
12067,Hecklinheals,hyjal,544,evoker,preservation,13,7,6
12068,Hexavalent,tichondrius,542,evoker,preservation,11,6,5
12069,Galrend,firetree,542,evoker,preservation,17,6,11
12070,Dabdrake,illidan,539,evoker,preservation,14,7,7
12071,Arazen,frostmourne,539,evoker,preservation,23,6,17
12072,Fieros,area-52,527,evoker,preservation,13,6,7
12073,Imperialist,proudmoore,522,evoker,preservation,29,7,22
12074,Shenlòng,drakkari,521,evoker,preservation,15,7,8
12075,Supernovax,illidan,512,evoker,preservation,16,6,10
12076,Imaginedrgn,tichondrius,511,evoker,preservation,11,6,5
12077,Nwo,shattered-hand,494,evoker,preservation,11,6,5
12078,Brindletail,proudmoore,494,evoker,preservation,19,6,13
12079,Arzaria,stormrage,480,evoker,preservation,6,5,1
12080,Finnahorns,sargeras,480,evoker,preservation,6,5,1
12081,Chinadragon,balnazzar,480,evoker,preservation,6,5,1
12082,Timaeuz,malganis,480,evoker,preservation,6,5,1
12083,Deathwingjr,illidan,480,evoker,preservation,6,5,1
12084,Cutewing,tichondrius,480,evoker,preservation,12,5,7
12085,Oldmandrake,mannoroth,480,evoker,preservation,12,5,7
12086,Shazdrag,stormrage,480,evoker,preservation,12,5,7
12087,Ezarra,tichondrius,480,evoker,preservation,12,5,7
12088,Killaseabee,lightnings-blade,480,evoker,preservation,12,5,7
12089,Spaceox,tichondrius,480,evoker,preservation,12,5,7
12090,Spyroguts,thrall,480,evoker,preservation,12,5,7
12091,Berylhwit,emerald-dream,480,evoker,preservation,12,5,7
12092,Draktharl,tichondrius,480,evoker,preservation,12,5,7
12093,Chronocolter,thunderhorn,480,evoker,preservation,12,5,7
12094,Thedajjal,tichondrius,480,evoker,preservation,12,5,7
12095,Pyraxes,thunderhorn,480,evoker,preservation,12,5,7
12096,Cirroaltos,aerie-peak,480,evoker,preservation,12,5,7
12097,Proust,grizzly-hills,480,evoker,preservation,12,5,7
12098,Jejep,sargeras,480,evoker,preservation,12,5,7
12099,Supernamv,sargeras,480,evoker,preservation,12,5,7
12100,Jambiisauce,fenris,480,evoker,preservation,12,5,7
12101,Evizzar,zuljin,480,evoker,preservation,12,5,7
12102,Pinkoi,antonidas,480,evoker,preservation,12,5,7
12103,Zealantis,area-52,480,evoker,preservation,12,5,7
12104,Fazedd,tichondrius,480,evoker,preservation,12,5,7
12105,Wydbro,kiljaeden,480,evoker,preservation,12,5,7
12106,Minzur,illidan,480,evoker,preservation,21,6,15
12107,Olindoe,tichondrius,480,evoker,preservation,18,5,13
12108,Cruv,boulderfist,480,evoker,preservation,18,5,13
12109,Gdragon,sargeras,480,evoker,preservation,18,5,13
12110,Bronyflexy,sargeras,480,evoker,preservation,24,5,19
12111,Selenian,area-52,480,evoker,preservation,24,5,19
12112,Bvo,stormrage,479,evoker,preservation,6,5,1
12113,Kratostrasz,moon-guard,479,evoker,preservation,12,5,7
12114,Lazzarross,area-52,479,evoker,preservation,12,5,7
12115,Dragonsoup,frostmourne,479,evoker,preservation,12,5,7
12116,Flappeebird,area-52,479,evoker,preservation,12,5,7
12117,Rezpmpdragon,tichondrius,479,evoker,preservation,12,5,7
12118,Álln,sargeras,479,evoker,preservation,12,5,7
12119,Dracdeez,dreadmaul,479,evoker,preservation,12,5,7
12120,Drektar,the-scryers,479,evoker,preservation,12,5,7
12121,Vaeghar,anvilmar,479,evoker,preservation,12,5,7
12122,Wrathykos,thrall,479,evoker,preservation,12,5,7
12123,Psyydragon,azralon,479,evoker,preservation,18,5,13
12124,Lizardtrash,ragnaros,478,evoker,preservation,12,5,7
12125,Melbu,thunderlord,478,evoker,preservation,12,5,7
12126,Flymuch,illidan,478,evoker,preservation,18,5,13
12127,Wetsponge,kelthuzad,477,evoker,preservation,12,5,7
12128,Scaryðragon,akama,477,evoker,preservation,12,5,7
12129,Korvold,zuluhed,477,evoker,preservation,12,5,7
12130,Livemaximii,moon-guard,477,evoker,preservation,12,5,7
12131,Dracorblaq,bleeding-hollow,476,evoker,preservation,12,5,7
12132,Tazeneth,sargeras,476,evoker,preservation,12,5,7
12133,Astaro,area-52,476,evoker,preservation,24,5,19
12134,Interracial,stormscale,475,evoker,preservation,10,6,4
12135,Ruination,lightnings-blade,463,evoker,preservation,17,5,12
12136,Amoraz,tichondrius,460,evoker,preservation,23,5,18
12137,Digna,thrall,448,evoker,preservation,16,5,11
12138,Jcii,tichondrius,447,evoker,preservation,11,5,6
12139,Drakonyx,mugthol,439,evoker,preservation,17,5,12
12140,Meilokkttv,sargeras,432,evoker,preservation,13,5,8
12141,Temporal,mannoroth,431,evoker,preservation,9,6,3
12142,Gaserick,quelthalas,426,evoker,preservation,17,6,11
12143,Tealik,frostmourne,416,evoker,preservation,16,5,11
12144,Hutáo,tichondrius,415,evoker,preservation,20,5,15
12145,Prøøf,kelthuzad,414,evoker,preservation,14,5,9
12146,Monzydrake,emerald-dream,408,evoker,preservation,20,5,15
12147,Mtndewboy,illidan,384,evoker,preservation,6,4,2
12148,Jëthrø,illidan,384,evoker,preservation,6,4,2
12149,Nøzmosis,area-52,384,evoker,preservation,6,4,2
12150,Ctlajumma,frostmourne,384,evoker,preservation,6,4,2
12151,Wickedwings,tichondrius,384,evoker,preservation,6,4,2
12152,Blazedvoke,tichondrius,384,evoker,preservation,6,4,2
12153,Velahesa,sargeras,384,evoker,preservation,6,4,2
12154,Syneestra,nemesis,384,evoker,preservation,6,4,2
12155,Dyvyne,demon-soul,384,evoker,preservation,6,4,2
12156,Râïn,tichondrius,384,evoker,preservation,6,4,2
12157,Docevoker,tichondrius,384,evoker,preservation,6,4,2
12158,Tygor,arthas,384,evoker,preservation,6,4,2
12159,Pramhedax,tichondrius,384,evoker,preservation,6,4,2
12160,Blackdragôn,stormrage,384,evoker,preservation,6,4,2
12161,Odmehbb,tichondrius,384,evoker,preservation,6,4,2
12162,Murloc,shadowsong,384,evoker,preservation,6,4,2
12163,Taegon,area-52,384,evoker,preservation,6,4,2
12164,Atraxian,tichondrius,384,evoker,preservation,6,4,2
12165,Mvpjs,medivh,384,evoker,preservation,8,4,4
12166,Pensini,illidan,384,evoker,preservation,12,4,8
12167,Shoestrings,tichondrius,384,evoker,preservation,12,4,8
12168,Drawong,zuljin,384,evoker,preservation,12,4,8
12169,Williamjong,tichondrius,384,evoker,preservation,12,4,8
12170,Dragrenghost,illidan,384,evoker,preservation,12,4,8
12171,Bryágh,wyrmrest-accord,384,evoker,preservation,12,4,8
12172,Yujirohanma,frostmourne,384,evoker,preservation,12,4,8
12173,Dragonslut,kiljaeden,384,evoker,preservation,12,4,8
12174,Donresantis,tichondrius,384,evoker,preservation,12,4,8
12175,Blazedvoker,tichondrius,384,evoker,preservation,12,4,8
12176,Raphdragon,stormrage,384,evoker,preservation,12,4,8
12177,Khalio,hyjal,384,evoker,preservation,12,4,8
12178,Heidibibe,tichondrius,384,evoker,preservation,12,4,8
12179,Dragwyn,senjin,384,evoker,preservation,12,4,8
12180,Slaymedaddy,proudmoore,384,evoker,preservation,12,4,8
12181,Mignificent,sargeras,384,evoker,preservation,12,4,8
12182,Rawrexp,emerald-dream,384,evoker,preservation,12,4,8
12183,Crumbsock,thrall,384,evoker,preservation,12,4,8
12184,Livebate,tichondrius,384,evoker,preservation,12,4,8
12185,Oldui,frostmourne,384,evoker,preservation,12,4,8
12186,Dracynmana,perenolde,384,evoker,preservation,12,4,8
12187,Flipturn,illidan,384,evoker,preservation,12,4,8
12188,Samostrasza,illidan,384,evoker,preservation,12,4,8
12189,Imadargin,malganis,384,evoker,preservation,12,4,8
12190,Vanyalus,uldum,384,evoker,preservation,12,4,8
12191,Razenset,draktharon,384,evoker,preservation,12,4,8
12192,Gójira,jubeithos,384,evoker,preservation,12,4,8
12193,Hollowscale,emerald-dream,384,evoker,preservation,12,4,8
12194,Boppled,tichondrius,384,evoker,preservation,12,4,8
12195,Zandet,thunderlord,384,evoker,preservation,12,4,8
12196,Sekidrac,ragnaros,384,evoker,preservation,12,4,8
12197,Oatmealneil,bleeding-hollow,384,evoker,preservation,16,4,12
12198,Clawbear,kiljaeden,384,evoker,preservation,18,4,14
12199,Upsdriver,dentarg,384,evoker,preservation,18,4,14
12200,Tidehunter,chogall,384,evoker,preservation,18,4,14
12201,Trensetra,sargeras,384,evoker,preservation,18,4,14
12202,Hammylee,firetree,384,evoker,preservation,24,4,20
12203,Drakkar,elune,384,evoker,preservation,30,4,26
12204,Quesovoke,eldrethalas,383,evoker,preservation,12,4,8
12205,Freeblaze,blackhand,383,evoker,preservation,12,4,8
12206,Razhion,arathor,383,evoker,preservation,12,4,8
12207,Lunearia,stormrage,383,evoker,preservation,12,4,8
12208,Dombi,moon-guard,383,evoker,preservation,12,4,8
12209,Tihkal,spinebreaker,383,evoker,preservation,12,4,8
12210,Sylvee,bleeding-hollow,383,evoker,preservation,13,4,9
12211,Kyldarr,garithos,382,evoker,preservation,6,4,2
12212,Uwuspit,tichondrius,382,evoker,preservation,12,4,8
12213,Bigtoots,illidan,382,evoker,preservation,12,4,8
12214,Enlighteni,area-52,382,evoker,preservation,12,4,8
12215,Stroker,boulderfist,381,evoker,preservation,12,4,8
12216,Danatreseth,moon-guard,380,evoker,preservation,12,4,8
12217,Galaxiz,bonechewer,377,evoker,preservation,18,4,14
12218,Ragendragon,hellscream,377,evoker,preservation,18,4,14
12219,Daddyrp,tichondrius,372,evoker,preservation,26,9,17
12220,Nyxstrasza,moknathal,366,evoker,preservation,11,4,7
12221,Snailor,eldrethalas,351,evoker,preservation,10,4,6
12222,Annazara,stormrage,336,evoker,preservation,9,4,5
12223,Zathasar,tichondrius,333,evoker,preservation,28,4,24
12224,Rápturé,tichondrius,330,evoker,preservation,16,7,9
12225,Corlys,thunderhorn,330,evoker,preservation,17,5,12
12226,Zaraller,tichondrius,329,evoker,preservation,9,5,4
12227,Homiedraconi,nordrassil,329,evoker,preservation,12,5,7
12228,Jolynne,illidan,320,evoker,preservation,14,4,10
12229,Ccms,area-52,319,evoker,preservation,5,4,1
12230,Vlysage,dark-iron,319,evoker,preservation,5,4,1
12231,Lantur,perenolde,319,evoker,preservation,16,4,12
12232,Polyrhythmic,ysera,304,evoker,preservation,7,4,3
12233,Knowragretz,tichondrius,288,evoker,preservation,6,3,3
12234,Dalechance,tichondrius,288,evoker,preservation,6,3,3
12235,Thendetra,mannoroth,288,evoker,preservation,6,3,3
12236,Spyrä,moon-guard,288,evoker,preservation,6,3,3
12237,Redhorn,frostmourne,288,evoker,preservation,6,3,3
12238,Jakburnon,stormrage,288,evoker,preservation,6,3,3
12239,Rangä,caelestrasz,288,evoker,preservation,6,3,3
12240,Gvoker,nemesis,288,evoker,preservation,6,3,3
12241,Vokefuu,illidan,288,evoker,preservation,6,3,3
12242,Hopefire,zuljin,288,evoker,preservation,6,3,3
12243,Dragqueenx,hyjal,288,evoker,preservation,6,3,3
12244,Dimpulse,zuljin,288,evoker,preservation,6,3,3
12245,Tamagotchî,quelthalas,288,evoker,preservation,6,3,3
12246,Lìthium,frostmourne,288,evoker,preservation,6,3,3
12247,Flexlong,tichondrius,288,evoker,preservation,6,3,3
12248,Jokko,moon-guard,288,evoker,preservation,6,3,3
12249,Hakyou,tichondrius,288,evoker,preservation,6,3,3
12250,Swagdriver,moon-guard,288,evoker,preservation,6,3,3
12251,Paradïsso,tichondrius,288,evoker,preservation,6,3,3
12252,Bigtitsdrag,illidan,288,evoker,preservation,6,3,3
12253,Tournament,hakkar,288,evoker,preservation,6,3,3
12254,Dracoon,madoran,288,evoker,preservation,6,3,3
12255,Simplerules,zuljin,288,evoker,preservation,6,3,3
12256,Draseew,drakkari,288,evoker,preservation,6,3,3
12257,Æg,zuljin,288,evoker,preservation,6,3,3
12258,Dragonwagon,kelthuzad,288,evoker,preservation,6,3,3
12259,Powerfulman,drakthul,288,evoker,preservation,6,3,3
12260,Setren,antonidas,288,evoker,preservation,6,3,3
12261,Kheeleesi,illidan,288,evoker,preservation,6,3,3
12262,Beelzeyob,illidan,288,evoker,preservation,6,3,3
12263,Dragonleaves,sargeras,288,evoker,preservation,6,3,3
12264,Dragonberry,tichondrius,288,evoker,preservation,6,3,3
12265,Cambodian,whisperwind,288,evoker,preservation,6,3,3
12266,Drogôn,cairne,288,evoker,preservation,6,3,3
12267,Flapandclap,nerzhul,288,evoker,preservation,6,3,3
12268,Zenazen,sargeras,288,evoker,preservation,6,3,3
12269,Ðçßñÿåæéîùøð,tichondrius,288,evoker,preservation,6,3,3
12270,Iggyytv,area-52,288,evoker,preservation,6,3,3
12271,Predacious,draktharon,288,evoker,preservation,6,3,3
12272,Razdargon,kiljaeden,288,evoker,preservation,6,3,3
12273,Kñuj,illidan,288,evoker,preservation,6,3,3
12274,Drakush,tichondrius,288,evoker,preservation,6,3,3
12275,Chawp,tichondrius,288,evoker,preservation,6,3,3
12276,Lirøu,azralon,288,evoker,preservation,6,3,3
12277,Javoc,drakkari,288,evoker,preservation,6,3,3
12278,Kreutzhauser,tichondrius,288,evoker,preservation,6,3,3
12279,Shalanoth,proudmoore,288,evoker,preservation,6,3,3
12280,Raxdragon,sargeras,288,evoker,preservation,6,3,3
12281,Vygrax,nerzhul,288,evoker,preservation,6,3,3
12282,Cônflicted,emerald-dream,288,evoker,preservation,6,3,3
12283,Shenròn,kelthuzad,288,evoker,preservation,9,4,5
12284,Aethyrious,moon-guard,288,evoker,preservation,12,3,9
12285,Reflexd,malganis,288,evoker,preservation,12,3,9
12286,Fugginuhh,proudmoore,288,evoker,preservation,12,3,9
12287,Zulyia,moon-guard,288,evoker,preservation,12,3,9
12288,Scyyterr,azralon,288,evoker,preservation,12,3,9
12289,Ryuzaki,zuluhed,288,evoker,preservation,12,3,9
12290,Dragonbabu,area-52,288,evoker,preservation,12,3,9
12291,Galfiore,malganis,288,evoker,preservation,12,3,9
12292,Raegon,wyrmrest-accord,288,evoker,preservation,12,3,9
12293,Cøømbuya,sargeras,288,evoker,preservation,12,3,9
12294,Discussion,area-52,288,evoker,preservation,12,3,9
12295,Dwacawys,zuljin,288,evoker,preservation,12,3,9
12296,Stormdagger,proudmoore,288,evoker,preservation,12,3,9
12297,Teldormu,drenden,288,evoker,preservation,12,3,9
12298,Tyrannicull,sargeras,288,evoker,preservation,12,3,9
12299,Alevoker,ragnaros,288,evoker,preservation,12,3,9
12300,Drazongas,cenarius,288,evoker,preservation,12,3,9
12301,Ahahaa,frostmourne,288,evoker,preservation,12,3,9
12302,Ðrízzy,area-52,288,evoker,preservation,12,3,9
12303,Specscaly,hyjal,288,evoker,preservation,12,3,9
12304,Hel,stormrage,288,evoker,preservation,12,3,9
12305,Deathgos,stormscale,288,evoker,preservation,12,3,9
12306,Snáckbóx,alexstrasza,288,evoker,preservation,12,3,9
12307,Alysraa,moon-guard,288,evoker,preservation,12,3,9
12308,Phosphothel,moon-guard,288,evoker,preservation,12,3,9
12309,Explosives,blades-edge,288,evoker,preservation,12,3,9
12310,Jammstraza,skywall,288,evoker,preservation,12,3,9
12311,Fuzzievoker,tichondrius,288,evoker,preservation,12,3,9
12312,Vulpyre,ragnaros,288,evoker,preservation,12,3,9
12313,Vandornomu,illidan,288,evoker,preservation,12,3,9
12314,Tefari,dalaran,288,evoker,preservation,12,3,9
12315,Simmnyxia,area-52,288,evoker,preservation,12,3,9
12316,Mouthgorawr,tichondrius,288,evoker,preservation,13,3,10
12317,Wapowthion,blades-edge,288,evoker,preservation,18,3,15
12318,Windchaser,kelthuzad,288,evoker,preservation,18,3,15
12319,Rogir,zuljin,288,evoker,preservation,18,3,15
12320,Arkaan,malganis,288,evoker,preservation,18,3,15
12321,Rizzanomics,zuljin,287,evoker,preservation,8,4,4
12322,Killerdragon,darkspear,287,evoker,preservation,6,3,3
12323,Supereragon,area-52,287,evoker,preservation,6,3,3
12324,Retroo,dark-iron,287,evoker,preservation,6,3,3
12325,Arcaenae,moon-guard,287,evoker,preservation,6,3,3
12326,Notvez,bleeding-hollow,287,evoker,preservation,6,3,3
12327,Deralizrd,tichondrius,287,evoker,preservation,6,3,3
12328,Drakier,kelthuzad,287,evoker,preservation,6,3,3
12329,Tazen,bleeding-hollow,287,evoker,preservation,12,3,9
12330,Draktarion,ragnaros,287,evoker,preservation,12,3,9
12331,Kalestrasza,nathrezim,287,evoker,preservation,12,3,9
12332,Chenrong,sargeras,287,evoker,preservation,12,3,9
12333,Bilbodragons,stormreaver,287,evoker,preservation,12,3,9
12334,Toothlesz,draka,287,evoker,preservation,18,3,15
12335,Kalistro,quelthalas,286,evoker,preservation,6,3,3
12336,Sodre,illidan,285,evoker,preservation,24,3,21
12337,Gibvoke,icecrown,271,evoker,preservation,11,3,8
12338,Blargan,area-52,271,evoker,preservation,17,3,14
12339,Uskrait,tichondrius,255,evoker,preservation,14,4,10
12340,Stíckyj,tichondrius,255,evoker,preservation,11,3,8
12341,Slashprovoke,frostmourne,239,evoker,preservation,5,3,2
12342,Dragontamz,the-forgotten-coast,239,evoker,preservation,5,3,2
12343,Setrazen,illidan,234,evoker,preservation,9,4,5
12344,Saenys,ragnaros,234,evoker,preservation,16,4,12
12345,Avastra,blackrock,233,evoker,preservation,9,5,4
12346,Tugmapvpean,kelthuzad,208,evoker,preservation,7,3,4
12347,Zindrath,emerald-dream,192,evoker,preservation,6,2,4
12348,Tóòthless,senjin,192,evoker,preservation,6,2,4
12349,Emopidgey,dalaran,192,evoker,preservation,6,2,4
12350,Daemon,terokkar,192,evoker,preservation,6,2,4
12351,Topg,boulderfist,192,evoker,preservation,6,2,4
12352,Nil,malganis,192,evoker,preservation,6,2,4
12353,Jep,emerald-dream,192,evoker,preservation,6,2,4
12354,Sketchybum,tichondrius,192,evoker,preservation,6,2,4
12355,Ignicion,quelthalas,192,evoker,preservation,6,2,4
12356,Ewoked,tichondrius,192,evoker,preservation,6,2,4
12357,Alzuresh,illidan,192,evoker,preservation,6,2,4
12358,Kaaer,emerald-dream,192,evoker,preservation,6,2,4
12359,Raelennis,ragnaros,192,evoker,preservation,6,2,4
12360,Wse,illidan,192,evoker,preservation,6,2,4
12361,Jessefurr,undermine,192,evoker,preservation,6,2,4
12362,Stickvoker,sargeras,192,evoker,preservation,6,2,4
12363,Conorvokes,tichondrius,192,evoker,preservation,6,2,4
12364,Custipiu,azralon,192,evoker,preservation,6,2,4
12365,Invdkill,azralon,192,evoker,preservation,6,2,4
12366,Froky,stormrage,192,evoker,preservation,6,2,4
12367,Johka,tichondrius,192,evoker,preservation,6,2,4
12368,Syfen,burning-blade,192,evoker,preservation,6,2,4
12369,Dscim,zuljin,192,evoker,preservation,6,2,4
12370,Drugdoer,illidan,192,evoker,preservation,6,2,4
12371,Lexazule,bleeding-hollow,192,evoker,preservation,6,2,4
12372,Koopa,malygos,192,evoker,preservation,6,2,4
12373,Ndr,proudmoore,192,evoker,preservation,6,2,4
12374,Flappyboy,bleeding-hollow,192,evoker,preservation,6,2,4
12375,Alexevoker,tichondrius,192,evoker,preservation,6,2,4
12376,Carrnedge,area-52,192,evoker,preservation,6,2,4
12377,Dragonsand,stormrage,192,evoker,preservation,6,2,4
12378,Dröhkar,ragnaros,192,evoker,preservation,6,2,4
12379,Drakhaz,azralon,192,evoker,preservation,6,2,4
12380,Dwagonwage,zuljin,192,evoker,preservation,6,2,4
12381,Racovoker,zuljin,192,evoker,preservation,6,2,4
12382,Exiztx,tichondrius,192,evoker,preservation,6,2,4
12383,Lëåf,area-52,192,evoker,preservation,6,2,4
12384,Salamandra,malganis,192,evoker,preservation,6,2,4
12385,Kildormu,tichondrius,192,evoker,preservation,6,2,4
12386,Nite,lothar,192,evoker,preservation,6,2,4
12387,Baðìka,area-52,192,evoker,preservation,6,2,4
12388,Hochelaga,arthas,192,evoker,preservation,6,2,4
12389,Echowrath,tichondrius,192,evoker,preservation,6,2,4
12390,Asterfoor,stormrage,192,evoker,preservation,6,2,4
12391,Bloodydragon,firetree,192,evoker,preservation,6,2,4
12392,Todorokî,frostmourne,192,evoker,preservation,6,2,4
12393,Ineptqt,frostmourne,192,evoker,preservation,6,2,4
12394,Wonyoungx,frostmourne,192,evoker,preservation,6,2,4
12395,Blazor,sisters-of-elune,192,evoker,preservation,6,2,4
12396,Kalrid,sargeras,192,evoker,preservation,6,2,4
12397,Preserveluke,moon-guard,192,evoker,preservation,6,2,4
12398,Evokesaint,wyrmrest-accord,192,evoker,preservation,6,2,4
12399,Drapary,dathremar,192,evoker,preservation,6,2,4
12400,Melchior,suramar,192,evoker,preservation,6,2,4
12401,Ashgaar,sargeras,192,evoker,preservation,6,2,4
12402,Raphd,sargeras,192,evoker,preservation,12,2,10
12403,Huanglong,sargeras,192,evoker,preservation,12,2,10
12404,Toyatoki,stormrage,192,evoker,preservation,12,2,10
12405,Luxxa,bloodhoof,192,evoker,preservation,12,2,10
12406,Ceraxxes,tichondrius,192,evoker,preservation,12,2,10
12407,Pandavoke,kelthuzad,192,evoker,preservation,12,2,10
12408,Contractor,emerald-dream,192,evoker,preservation,12,2,10
12409,Archoni,kelthuzad,192,evoker,preservation,12,2,10
12410,Timecøp,zuljin,192,evoker,preservation,12,2,10
12411,Tightp,malganis,192,evoker,preservation,12,2,10
12412,Shellybelly,shadowmoon,192,evoker,preservation,12,2,10
12413,Slizards,area-52,192,evoker,preservation,12,2,10
12414,Drakthyrmonk,hyjal,192,evoker,preservation,12,2,10
12415,Takasaki,dalaran,192,evoker,preservation,12,2,10
12416,Olesmokey,tichondrius,192,evoker,preservation,12,2,10
12417,Olawd,azshara,192,evoker,preservation,12,2,10
12418,Moop,spinebreaker,192,evoker,preservation,12,2,10
12419,Nøøvè,area-52,192,evoker,preservation,12,2,10
12420,Drachenatem,skywall,192,evoker,preservation,15,2,13
12421,Dadydafather,sargeras,192,evoker,preservation,24,2,22
12422,Draxitar,blackrock,191,evoker,preservation,6,2,4
12423,Lacost,area-52,191,evoker,preservation,6,2,4
12424,Valethal,ragnaros,191,evoker,preservation,6,2,4
12425,Spyrð,emerald-dream,191,evoker,preservation,6,2,4
12426,Shtableboy,illidan,191,evoker,preservation,12,2,10
12427,Shadowyasuke,area-52,191,evoker,preservation,12,2,10
12428,Evooern,frostmourne,175,evoker,preservation,11,2,9
12429,Solekstraza,stormrage,160,evoker,preservation,10,3,7
12430,Devokerkofwa,tichondrius,159,evoker,preservation,5,2,3
12431,Jetthryx,emerald-dream,159,evoker,preservation,11,2,9
12432,Dragonbush,sargeras,138,evoker,preservation,10,3,7
12433,Scalendar,frostmourne,138,evoker,preservation,11,3,8
12434,Shíkyo,stormrage,138,evoker,preservation,20,3,17
12435,Winghoof,kiljaeden,128,evoker,preservation,10,2,8
12436,Dragoondeez,bleeding-hollow,96,evoker,preservation,3,2,1
12437,Hutterbut,malganis,96,evoker,preservation,3,2,1
12438,Beanflickher,tichondrius,96,evoker,preservation,6,1,5
12439,Deviantart,emerald-dream,96,evoker,preservation,6,1,5
12440,Ohmylanta,stormrage,96,evoker,preservation,6,1,5
12441,Pyrepeanut,tichondrius,96,evoker,preservation,6,1,5
12442,Myjewelshurt,stormrage,96,evoker,preservation,6,1,5
12443,Vvhip,tichondrius,96,evoker,preservation,6,1,5
12444,Tobee,stormrage,96,evoker,preservation,6,1,5
12445,Csodragon,sargeras,96,evoker,preservation,6,1,5
12446,Daraz,tichondrius,96,evoker,preservation,6,1,5
12447,Rekkcah,bloodscalp,96,evoker,preservation,6,1,5
12448,Spyroh,crushridge,96,evoker,preservation,6,1,5
12449,Henryvoker,moknathal,96,evoker,preservation,6,1,5
12450,Rojothyr,tichondrius,96,evoker,preservation,6,1,5
12451,Chrisbenoitx,illidan,96,evoker,preservation,6,1,5
12452,Ripdumpster,bonechewer,96,evoker,preservation,6,1,5
12453,Newclassop,emerald-dream,96,evoker,preservation,6,1,5
12454,Acvoker,tichondrius,96,evoker,preservation,6,1,5
12455,Dragondoh,frostmourne,96,evoker,preservation,6,1,5
12456,Gamerwords,barthilas,96,evoker,preservation,6,1,5
12457,Sobuker,wyrmrest-accord,96,evoker,preservation,6,1,5
12458,Iamthêt,sargeras,96,evoker,preservation,6,1,5
12459,Etereosthel,ragnaros,96,evoker,preservation,6,1,5
12460,Azurflame,tichondrius,96,evoker,preservation,6,1,5
12461,Talleraz,zuljin,96,evoker,preservation,6,1,5
12462,Daymanx,zuljin,96,evoker,preservation,6,1,5
12463,Patrdorasz,zuljin,96,evoker,preservation,6,1,5
12464,Nivekk,zuljin,96,evoker,preservation,6,1,5
12465,Xampusaurio,ragnaros,96,evoker,preservation,6,1,5
12466,Nändy,tichondrius,96,evoker,preservation,6,1,5
12467,Hausebat,moon-guard,96,evoker,preservation,6,1,5
12468,Atreign,blackwing-lair,96,evoker,preservation,6,1,5
12469,Omars,sargeras,96,evoker,preservation,6,1,5
12470,Caelïn,malganis,96,evoker,preservation,6,1,5
12471,Neroker,malganis,96,evoker,preservation,6,1,5
12472,Ðräco,quelthalas,96,evoker,preservation,6,1,5
12473,Dragostephen,nazjatar,96,evoker,preservation,6,1,5
12474,Tyson,frostmane,96,evoker,preservation,6,1,5
12475,Hardstuckirl,tichondrius,96,evoker,preservation,6,1,5
12476,Trrxx,tichondrius,96,evoker,preservation,6,1,5
12477,Rdrako,emerald-dream,96,evoker,preservation,6,1,5
12478,Dragnips,bleeding-hollow,96,evoker,preservation,6,1,5
12479,Ambium,dunemaul,96,evoker,preservation,6,1,5
12480,Backuphealer,bleeding-hollow,96,evoker,preservation,6,1,5
12481,Vermax,spirestone,96,evoker,preservation,6,1,5
12482,Azgrodragon,stonemaul,96,evoker,preservation,6,1,5
12483,Khaosdragona,proudmoore,96,evoker,preservation,6,1,5
12484,Simarity,thrall,96,evoker,preservation,6,1,5
12485,Tasdarallar,frostmourne,96,evoker,preservation,6,1,5
12486,Keedrori,thrall,96,evoker,preservation,6,1,5
12487,Saînt,thrall,96,evoker,preservation,6,1,5
12488,Banjee,hellscream,96,evoker,preservation,6,1,5
12489,Poatis,illidan,96,evoker,preservation,6,1,5
12490,Mookthyr,area-52,96,evoker,preservation,6,1,5
12491,Ashafi,area-52,96,evoker,preservation,6,1,5
12492,Jeeyell,malganis,96,evoker,preservation,12,1,11
12493,Dakotakek,illidan,96,evoker,preservation,12,1,11
12494,Holyshiip,tichondrius,96,evoker,preservation,12,1,11
12495,Eragon,feathermoon,96,evoker,preservation,12,1,11
12496,Nelphemuer,wyrmrest-accord,96,evoker,preservation,12,1,11
12497,Morkite,moon-guard,96,evoker,preservation,12,1,11
12498,Seamanstorm,area-52,96,evoker,preservation,12,1,11
12499,Shimshine,destromath,96,evoker,preservation,12,1,11
12500,Rhale,whisperwind,96,evoker,preservation,12,1,11
12501,Draghone,illidan,96,evoker,preservation,12,1,11
12502,Khorvin,proudmoore,96,evoker,preservation,12,1,11
12503,Derath,maelstrom,96,evoker,preservation,12,1,11
12504,Sashvoker,illidan,96,evoker,preservation,12,1,11
12505,Exilence,alleria,96,evoker,preservation,17,1,16
12506,Zenetar,area-52,96,evoker,preservation,18,1,17
12507,Sochen,kelthuzad,95,evoker,preservation,6,1,5
12508,Blowmiê,area-52,79,evoker,preservation,5,1,4
12509,Dragcules,thrall,42,evoker,preservation,11,2,9
12510,Zagze,stormrage,42,evoker,preservation,15,2,13
12511,Tenyeen,moonrunner,31,evoker,preservation,2,1,1
12512,Luøzheng,drakkari,16,evoker,preservation,1,1,0
12513,Sëverus,moon-guard,9,evoker,preservation,8,5,3
12514,Thiqc,zuluhed,9,evoker,preservation,9,3,6
12515,Nikthevoker,tichondrius,2207,evoker,devastation,176,96,80
12516,Caedalade,spirestone,2180,evoker,devastation,123,70,53
12517,Nikthevoker,area-52,2166,evoker,devastation,201,103,98
12518,Ocdgamer,malganis,2158,evoker,devastation,121,62,59
12519,Crappysmellz,tichondrius,2157,evoker,devastation,85,48,37
12520,Whilefalse,stormrage,2125,evoker,devastation,95,48,47
12521,Lizzimcguire,zuljin,2118,evoker,devastation,90,60,30
12522,Dametra,proudmoore,2100,evoker,devastation,108,62,46
12523,Chun,malganis,2096,evoker,devastation,54,32,22
12524,Shamblewing,arthas,2094,evoker,devastation,89,44,45
12525,Breathalizer,sargeras,2080,evoker,devastation,114,65,49
12526,Caedalade,proudmoore,2056,evoker,devastation,348,174,174
12527,Artemad,moon-guard,2048,evoker,devastation,108,64,44
12528,Eastwubz,norgannon,2035,evoker,devastation,202,106,96
12529,Rothvoker,tichondrius,2033,evoker,devastation,121,70,51
12530,Frequevoker,tichondrius,2020,evoker,devastation,65,30,35
12531,Somyr,area-52,2008,evoker,devastation,186,97,89
12532,Kinndyvoker,sargeras,2003,evoker,devastation,65,34,31
12533,Katadrak,area-52,1974,evoker,devastation,54,32,22
12534,Evokemedaddy,bleeding-hollow,1974,evoker,devastation,161,83,78
12535,Juicyjom,staghelm,1972,evoker,devastation,66,36,30
12536,Meltharian,frostmourne,1966,evoker,devastation,134,75,59
12537,Drogu,kelthuzad,1964,evoker,devastation,48,29,19
12538,Hutaothighs,illidan,1937,evoker,devastation,130,67,63
12539,Saryuja,thunderhorn,1927,evoker,devastation,64,42,22
12540,Dzrn,moon-guard,1922,evoker,devastation,144,72,72
12541,Wazgon,emerald-dream,1915,evoker,devastation,260,126,134
12542,Rõÿ,area-52,1903,evoker,devastation,42,25,17
12543,Ayavi,illidan,1890,evoker,devastation,96,61,35
12544,Trogdør,illidan,1887,evoker,devastation,159,79,80
12545,Quadude,illidan,1886,evoker,devastation,221,109,112
12546,Gôdzevoker,area-52,1879,evoker,devastation,129,73,56
12547,Arzaria,stormrage,1878,evoker,devastation,164,90,74
12548,Seldantria,dalaran,1875,evoker,devastation,71,36,35
12549,Azazél,borean-tundra,1868,evoker,devastation,257,136,121
12550,Anachronormu,mannoroth,1864,evoker,devastation,101,56,45
12551,Bigdrag,blackhand,1864,evoker,devastation,239,124,115
12552,Krashbandico,zangarmarsh,1863,evoker,devastation,61,30,31
12553,Mtndewboy,illidan,1856,evoker,devastation,126,67,59
12554,Thrawn,arygos,1855,evoker,devastation,59,37,22
12555,Strepo,proudmoore,1851,evoker,devastation,66,34,32
12556,Royquaza,illidan,1850,evoker,devastation,60,33,27
12557,Wheezee,emerald-dream,1850,evoker,devastation,46,25,21
12558,Coltist,elune,1848,evoker,devastation,42,29,13
12559,Rescued,wyrmrest-accord,1848,evoker,devastation,54,31,23
12560,Azradormu,zuljin,1847,evoker,devastation,198,94,104
12561,Tatsurai,tichondrius,1845,evoker,devastation,43,24,19
12562,Fores,tichondrius,1845,evoker,devastation,127,65,62
12563,Eshen,ragnaros,1843,evoker,devastation,298,158,140
12564,Koalaman,area-52,1843,evoker,devastation,324,164,160
12565,Draxarys,tichondrius,1841,evoker,devastation,315,155,160
12566,Plep,wyrmrest-accord,1836,evoker,devastation,51,30,21
12567,Laneva,moon-guard,1835,evoker,devastation,128,86,42
12568,Venarys,dalaran,1826,evoker,devastation,42,30,12
12569,Raxdragon,sargeras,1826,evoker,devastation,36,22,14
12570,Srb,chogall,1824,evoker,devastation,113,63,50
12571,Mcglizzy,stormrage,1824,evoker,devastation,167,92,75
12572,Krúnsh,ragnaros,1823,evoker,devastation,191,104,87
12573,Xxkimura,tichondrius,1820,evoker,devastation,292,152,140
12574,Mushugon,wyrmrest-accord,1819,evoker,devastation,71,44,27
12575,Zoomi,whisperwind,1819,evoker,devastation,35,20,15
12576,Komodolong,tichondrius,1819,evoker,devastation,53,26,27
12577,Azvanced,sargeras,1818,evoker,devastation,48,31,17
12578,Beatdownbill,sargeras,1818,evoker,devastation,194,101,93
12579,Evokes,moon-guard,1818,evoker,devastation,80,41,39
12580,Kyloflight,thrall,1817,evoker,devastation,50,33,17
12581,Nørbert,frostmourne,1815,evoker,devastation,54,32,22
12582,Dracaryz,blackhand,1814,evoker,devastation,60,35,25
12583,Puf,magtheridon,1814,evoker,devastation,346,185,161
12584,Gridskully,quelthalas,1814,evoker,devastation,81,38,43
12585,Teriarch,stormrage,1813,evoker,devastation,39,23,16
12586,Drakori,azralon,1812,evoker,devastation,80,49,31
12587,Milkymike,uldum,1811,evoker,devastation,72,44,28
12588,Gojirastraza,stormrage,1810,evoker,devastation,53,32,21
12589,Gwaelii,tichondrius,1809,evoker,devastation,105,62,43
12590,Pykan,skullcrusher,1809,evoker,devastation,47,24,23
12591,Ragedizzle,twisting-nether,1808,evoker,devastation,91,49,42
12592,Mil,lightnings-blade,1808,evoker,devastation,69,37,32
12593,Geicovoker,tichondrius,1806,evoker,devastation,52,30,22
12594,Tazriak,tichondrius,1803,evoker,devastation,83,52,31
12595,Thordak,drakkari,1801,evoker,devastation,72,40,32
12596,Fractalz,alterac-mountains,1800,evoker,devastation,169,92,77
12597,Airgordan,area-52,1796,evoker,devastation,83,39,44
12598,Ethalem,thrall,1790,evoker,devastation,301,162,139
12599,Obsidianimp,sargeras,1785,evoker,devastation,54,24,30
12600,Bugberry,illidan,1784,evoker,devastation,102,51,51
12601,Yrue,moon-guard,1779,evoker,devastation,36,19,17
12602,Mfquietus,illidan,1773,evoker,devastation,84,49,35
12603,Jwoker,malganis,1771,evoker,devastation,48,19,29
12604,Fizzlevoker,malganis,1767,evoker,devastation,59,29,30
12605,Drgua,tichondrius,1754,evoker,devastation,60,30,30
12606,Dilon,area-52,1750,evoker,devastation,72,41,31
12607,Vhagarius,tichondrius,1745,evoker,devastation,112,58,54
12608,Juicylizard,stormrage,1744,evoker,devastation,242,124,118
12609,Emiriss,thrall,1744,evoker,devastation,88,45,43
12610,Flapples,stormrage,1743,evoker,devastation,96,53,43
12611,Draxarys,area-52,1742,evoker,devastation,260,129,131
12612,Blowmiê,area-52,1736,evoker,devastation,164,88,76
12613,Theredmenace,barthilas,1734,evoker,devastation,41,26,15
12614,Cowboyydann,malganis,1733,evoker,devastation,29,19,10
12615,Stickvoker,sargeras,1733,evoker,devastation,66,40,26
12616,Golden,area-52,1733,evoker,devastation,46,24,22
12617,Rá,drenden,1728,evoker,devastation,84,37,47
12618,Zenasatral,sargeras,1726,evoker,devastation,37,27,10
12619,Derite,bonechewer,1723,evoker,devastation,40,29,11
12620,Axiomoixa,tichondrius,1722,evoker,devastation,42,23,19
12621,Millagosa,stormrage,1720,evoker,devastation,60,32,28
12622,Nunez,frostmourne,1713,evoker,devastation,41,22,19
12623,Betasoldier,kelthuzad,1708,evoker,devastation,95,56,39
12624,Æthyr,anubarak,1707,evoker,devastation,36,26,10
12625,Evokez,barthilas,1705,evoker,devastation,42,31,11
12626,Ðeepßreath,sargeras,1703,evoker,devastation,66,35,31
12627,Flippyflappy,zuljin,1702,evoker,devastation,45,29,16
12628,Zlyrax,moon-guard,1695,evoker,devastation,30,18,12
12629,Wonyoungx,frostmourne,1694,evoker,devastation,79,39,40
12630,Tagzy,tichondrius,1693,evoker,devastation,105,64,41
12631,Jase,gilneas,1691,evoker,devastation,74,45,29
12632,Nändy,tichondrius,1689,evoker,devastation,48,28,20
12633,Oldxdrake,sargeras,1689,evoker,devastation,156,77,79
12634,Qbgosa,malganis,1686,evoker,devastation,48,27,21
12635,Cløud,hellscream,1684,evoker,devastation,24,18,6
12636,Dragonborn,malganis,1684,evoker,devastation,33,20,13
12637,Dracthael,stormrage,1683,evoker,devastation,116,62,54
12638,Djvoker,zuljin,1681,evoker,devastation,62,32,30
12639,Darkwingz,icecrown,1680,evoker,devastation,44,25,19
12640,Caelïn,malganis,1680,evoker,devastation,204,108,96
12641,Izzythelizzy,tichondrius,1679,evoker,devastation,174,93,81
12642,Eszel,thunderlord,1679,evoker,devastation,184,98,86
12643,Catvoker,area-52,1678,evoker,devastation,114,58,56
12644,Alekoslol,area-52,1677,evoker,devastation,46,27,19
12645,Dooklord,shuhalo,1676,evoker,devastation,84,36,48
12646,Shoestrings,tichondrius,1675,evoker,devastation,108,51,57
12647,Nazaral,mannoroth,1674,evoker,devastation,84,45,39
12648,Lukamagik,boulderfist,1673,evoker,devastation,42,22,20
12649,Spyrodadrago,malganis,1672,evoker,devastation,72,40,32
12650,Garlicbreth,stormrage,1671,evoker,devastation,76,40,36
12651,Swolegarian,emerald-dream,1670,evoker,devastation,89,45,44
12652,Bucket,wyrmrest-accord,1665,evoker,devastation,48,24,24
12653,Shalander,proudmoore,1664,evoker,devastation,159,87,72
12654,Zenithria,thrall,1664,evoker,devastation,148,78,70
12655,Scaleychad,zuljin,1656,evoker,devastation,65,31,34
12656,Balrôg,malganis,1656,evoker,devastation,63,29,34
12657,Dovàhkin,moon-guard,1655,evoker,devastation,66,35,31
12658,Courtvoke,turalyon,1653,evoker,devastation,64,36,28
12659,Mindme,tichondrius,1652,evoker,devastation,53,30,23
12660,Haramcad,tichondrius,1652,evoker,devastation,165,89,76
12661,Whethersmell,tichondrius,1650,evoker,devastation,63,40,23
12662,Wingdeadly,tichondrius,1650,evoker,devastation,66,35,31
12663,Raller,malganis,1649,evoker,devastation,30,18,12
12664,Ycnpass,tichondrius,1649,evoker,devastation,42,22,20
12665,Nykhel,tichondrius,1648,evoker,devastation,42,21,21
12666,Mlboa,frostmourne,1647,evoker,devastation,36,20,16
12667,Koralia,moon-guard,1647,evoker,devastation,42,18,24
12668,Deralan,khaz-modan,1645,evoker,devastation,36,20,16
12669,Vizora,moon-guard,1645,evoker,devastation,154,81,73
12670,Zindraco,thrall,1645,evoker,devastation,48,23,25
12671,Psynister,illidan,1644,evoker,devastation,168,76,92
12672,Rotscale,proudmoore,1643,evoker,devastation,36,22,14
12673,Hmong,proudmoore,1643,evoker,devastation,48,20,28
12674,Erizcdraa,tichondrius,1642,evoker,devastation,46,26,20
12675,Blackdragôn,stormrage,1641,evoker,devastation,43,22,21
12676,Epollyon,sargeras,1639,evoker,devastation,42,25,17
12677,Dwagonwage,zuljin,1633,evoker,devastation,90,42,48
12678,Zeranthal,moon-guard,1632,evoker,devastation,32,21,11
12679,Averithel,moon-guard,1630,evoker,devastation,35,23,12
12680,Voithyr,moon-guard,1630,evoker,devastation,128,71,57
12681,Burnyxia,zuljin,1628,evoker,devastation,48,23,25
12682,Quickshootin,tichondrius,1628,evoker,devastation,65,28,37
12683,Aentharion,argent-dawn,1627,evoker,devastation,41,22,19
12684,Rizzanomics,zuljin,1626,evoker,devastation,76,32,44
12685,Evòker,tichondrius,1625,evoker,devastation,54,28,26
12686,Galakrønd,illidan,1624,evoker,devastation,116,63,53
12687,Bhanethyr,illidan,1624,evoker,devastation,36,17,19
12688,Draislyn,cenarion-circle,1622,evoker,devastation,36,23,13
12689,Hochenblume,proudmoore,1621,evoker,devastation,77,40,37
12690,Sofyon,dalaran,1621,evoker,devastation,64,31,33
12691,Mmrglmrglmr,stormrage,1620,evoker,devastation,65,37,28
12692,Naverdr,tichondrius,1619,evoker,devastation,54,30,24
12693,Quadarius,tichondrius,1617,evoker,devastation,147,82,65
12694,Lorb,icecrown,1616,evoker,devastation,170,94,76
12695,Kozukimomo,area-52,1616,evoker,devastation,125,63,62
12696,Lïzzy,tichondrius,1614,evoker,devastation,34,23,11
12697,Lizardik,lightnings-blade,1614,evoker,devastation,44,26,18
12698,Eternabeam,gilneas,1614,evoker,devastation,89,45,44
12699,Smoochies,emerald-dream,1614,evoker,devastation,72,36,36
12700,Zyzzy,icecrown,1613,evoker,devastation,80,48,32
12701,Embarasi,moon-guard,1613,evoker,devastation,60,36,24
12702,Ruination,lightnings-blade,1613,evoker,devastation,42,24,18
12703,Shortdargon,zuljin,1613,evoker,devastation,48,25,23
12704,Jòrmungandr,moon-guard,1613,evoker,devastation,56,24,32
12705,Endoveire,tichondrius,1613,evoker,devastation,54,23,31
12706,Âvalon,zuljin,1611,evoker,devastation,24,17,7
12707,Pewpowdragon,malganis,1609,evoker,devastation,40,24,16
12708,Bréáth,tichondrius,1608,evoker,devastation,48,33,15
12709,Youdig,nazjatar,1608,evoker,devastation,42,24,18
12710,Onysable,stormrage,1608,evoker,devastation,42,21,21
12711,Akajills,tichondrius,1607,evoker,devastation,124,70,54
12712,Pewnee,eonar,1607,evoker,devastation,83,40,43
12713,Madjeckyl,dalaran,1606,evoker,devastation,42,21,21
12714,Xhamon,quelthalas,1606,evoker,devastation,208,100,108
12715,Eshaybruh,barthilas,1605,evoker,devastation,34,20,14
12716,Dracomalfoyy,caelestrasz,1605,evoker,devastation,33,18,15
12717,Xplode,area-52,1605,evoker,devastation,206,108,98
12718,Dubskis,area-52,1603,evoker,devastation,122,63,59
12719,Jereico,stonemaul,1603,evoker,devastation,78,39,39
12720,Bently,bloodhoof,1603,evoker,devastation,48,21,27
12721,Marccuss,bleeding-hollow,1601,evoker,devastation,24,17,7
12722,Børedom,burning-legion,1601,evoker,devastation,54,36,18
12723,Ryuback,sargeras,1601,evoker,devastation,42,26,16
12724,Spicyrooster,area-52,1601,evoker,devastation,44,24,20
12725,Xhaal,tichondrius,1601,evoker,devastation,168,83,85
12726,Rengöku,skullcrusher,1600,evoker,devastation,54,27,27
12727,Imugee,sargeras,1598,evoker,devastation,54,27,27
12728,Kazooie,zuljin,1598,evoker,devastation,36,17,19
12729,Talent,deathwing,1597,evoker,devastation,30,17,13
12730,Juooun,tichondrius,1597,evoker,devastation,77,35,42
12731,Likelydevo,tichondrius,1596,evoker,devastation,24,19,5
12732,Potfase,tichondrius,1596,evoker,devastation,50,23,27
12733,Bombs,shattered-hand,1594,evoker,devastation,150,78,72
12734,Ackreshanaz,nagrand,1594,evoker,devastation,36,17,19
12735,Batwig,tichondrius,1590,evoker,devastation,71,39,32
12736,Cottoncandy,stormrage,1587,evoker,devastation,36,17,19
12737,Mcflý,sargeras,1586,evoker,devastation,42,30,12
12738,Linguistic,tichondrius,1585,evoker,devastation,54,29,25
12739,Devilmanguy,bonechewer,1585,evoker,devastation,102,51,51
12740,Terraxkhan,quelthalas,1585,evoker,devastation,66,29,37
12741,Mayhemvoker,rexxar,1584,evoker,devastation,54,32,22
12742,Rinstraza,thrall,1584,evoker,devastation,161,81,80
12743,Arkeryte,moon-guard,1583,evoker,devastation,150,74,76
12744,Flysokan,tichondrius,1582,evoker,devastation,63,32,31
12745,Puffthemagic,lightnings-blade,1582,evoker,devastation,42,20,22
12746,Algonir,wyrmrest-accord,1581,evoker,devastation,30,17,13
12747,Zona,moon-guard,1580,evoker,devastation,65,31,34
12748,Superscales,zuljin,1579,evoker,devastation,31,19,12
12749,Kalisee,skullcrusher,1579,evoker,devastation,85,46,39
12750,Envisioned,kelthuzad,1572,evoker,devastation,36,19,17
12751,Aarax,tichondrius,1570,evoker,devastation,89,45,44
12752,Ævoker,tichondrius,1569,evoker,devastation,111,54,57
12753,Hoodwings,stormrage,1561,evoker,devastation,91,53,38
12754,Rðsè,tichondrius,1558,evoker,devastation,162,76,86
12755,Hotdragon,zuljin,1557,evoker,devastation,84,47,37
12756,Gangbânk,tichondrius,1555,evoker,devastation,71,34,37
12757,Karox,moon-guard,1552,evoker,devastation,143,71,72
12758,Dractheseus,tichondrius,1551,evoker,devastation,36,18,18
12759,Drussyboy,illidan,1550,evoker,devastation,88,47,41
12760,Bryiona,proudmoore,1550,evoker,devastation,81,40,41
12761,Curtis,shadowmoon,1545,evoker,devastation,130,73,57
12762,Daydrac,thrall,1544,evoker,devastation,50,26,24
12763,Sintholo,sargeras,1544,evoker,devastation,104,52,52
12764,Kinto,stormrage,1544,evoker,devastation,42,17,25
12765,Agheel,firetree,1543,evoker,devastation,44,23,21
12766,Breezemordus,zuljin,1540,evoker,devastation,45,24,21
12767,Growthyy,malganis,1539,evoker,devastation,30,18,12
12768,Yakkin,kelthuzad,1538,evoker,devastation,38,21,17
12769,Dragnmÿballs,blackrock,1536,evoker,devastation,34,20,14
12770,Emoker,magtheridon,1535,evoker,devastation,54,31,23
12771,Rhÿu,quelthalas,1534,evoker,devastation,95,51,44
12772,Trákanon,mugthol,1534,evoker,devastation,75,40,35
12773,Deathwingtwo,sargeras,1533,evoker,devastation,61,34,27
12774,Hydrogenbomb,sargeras,1530,evoker,devastation,86,47,39
12775,Drachenatem,skywall,1529,evoker,devastation,42,24,18
12776,Soory,coilfang,1529,evoker,devastation,36,19,17
12777,Nxnevo,tichondrius,1529,evoker,devastation,36,19,17
12778,You,deathwing,1528,evoker,devastation,42,24,18
12779,Chànge,lothar,1527,evoker,devastation,71,36,35
12780,Zandrov,greymane,1526,evoker,devastation,51,29,22
12781,Meleyx,saurfang,1526,evoker,devastation,66,33,33
12782,Nishalethen,moon-guard,1517,evoker,devastation,74,35,39
12783,Bumbaclot,illidan,1516,evoker,devastation,31,16,15
12784,Vikings,madoran,1516,evoker,devastation,35,18,17
12785,Dragontales,stormrage,1515,evoker,devastation,119,63,56
12786,Netreset,illidan,1515,evoker,devastation,49,23,26
12787,Jurokiel,sargeras,1514,evoker,devastation,167,92,75
12788,Olesmokey,tichondrius,1513,evoker,devastation,86,45,41
12789,Mustardtiger,malorne,1512,evoker,devastation,103,56,47
12790,Fairstrider,tichondrius,1512,evoker,devastation,60,26,34
12791,Cmdragonbalz,sargeras,1511,evoker,devastation,60,33,27
12792,Galrend,firetree,1511,evoker,devastation,78,41,37
12793,Baigels,thrall,1510,evoker,devastation,36,18,18
12794,Zartolas,moon-guard,1510,evoker,devastation,124,60,64
12795,Polyrhythmic,ysera,1510,evoker,devastation,79,38,41
12796,Meepslol,kiljaeden,1506,evoker,devastation,27,17,10
12797,Topg,boulderfist,1505,evoker,devastation,39,23,16
12798,Deewey,sargeras,1504,evoker,devastation,50,30,20
12799,Tinine,frostmourne,1503,evoker,devastation,60,33,27
12800,Mythsvoker,barthilas,1503,evoker,devastation,37,18,19
12801,Bryágh,wyrmrest-accord,1502,evoker,devastation,165,85,80
12802,Atreign,blackwing-lair,1499,evoker,devastation,55,22,33
12803,Tezzyl,kiljaeden,1498,evoker,devastation,30,16,14
12804,Tealetaz,area-52,1495,evoker,devastation,49,32,17
12805,Famousdr,stormrage,1495,evoker,devastation,50,26,24
12806,Dunkinonem,black-dragonflight,1494,evoker,devastation,42,25,17
12807,Kylidon,garrosh,1494,evoker,devastation,53,28,25
12808,Kozara,trollbane,1494,evoker,devastation,35,17,18
12809,Ùwüdragon,tichondrius,1490,evoker,devastation,118,71,47
12810,Erling,duskwood,1490,evoker,devastation,84,46,38
12811,Jgdragon,sargeras,1489,evoker,devastation,36,18,18
12812,Taeloc,frostmourne,1488,evoker,devastation,36,16,20
12813,Dimatis,ragnaros,1488,evoker,devastation,42,17,25
12814,Dragonkings,tichondrius,1487,evoker,devastation,129,56,73
12815,Xaeradroz,area-52,1486,evoker,devastation,78,41,37
12816,Qfyre,frostmourne,1480,evoker,devastation,57,34,23
12817,Bellerion,proudmoore,1480,evoker,devastation,54,26,28
12818,Drayongari,tichondrius,1479,evoker,devastation,60,29,31
12819,Rangel,tol-barad,1479,evoker,devastation,45,21,24
12820,Phlegython,eredar,1478,evoker,devastation,42,21,21
12821,Encouraçado,stormrage,1477,evoker,devastation,71,37,34
12822,Jowtzprev,ragnaros,1476,evoker,devastation,66,35,31
12823,Dragonvore,moon-guard,1475,evoker,devastation,23,17,6
12824,Elurb,illidan,1475,evoker,devastation,50,30,20
12825,Narissian,wyrmrest-accord,1473,evoker,devastation,114,58,56
12826,Dreamtalons,area-52,1465,evoker,devastation,48,28,20
12827,Abaddragon,dalaran,1461,evoker,devastation,53,21,32
12828,Puffthemagiq,mugthol,1460,evoker,devastation,54,30,24
12829,Evoqz,stormrage,1459,evoker,devastation,36,22,14
12830,Dekux,elune,1459,evoker,devastation,36,16,20
12831,Grapthar,korgath,1456,evoker,devastation,108,57,51
12832,Unseenzblack,tichondrius,1453,evoker,devastation,30,19,11
12833,Kjerne,stormrage,1452,evoker,devastation,41,27,14
12834,Dragontrees,illidan,1450,evoker,devastation,36,19,17
12835,Amlug,illidan,1450,evoker,devastation,88,38,50
12836,Ýüp,tichondrius,1448,evoker,devastation,34,21,13
12837,Devdjinn,tichondrius,1447,evoker,devastation,234,121,113
12838,Drflame,quelthalas,1446,evoker,devastation,47,27,20
12839,Midi,boulderfist,1446,evoker,devastation,42,21,21
12840,Lilfootmommy,emerald-dream,1446,evoker,devastation,36,16,20
12841,Valentis,bleeding-hollow,1441,evoker,devastation,96,52,44
12842,Bloodwings,tichondrius,1441,evoker,devastation,48,23,25
12843,Serthius,darkspear,1439,evoker,devastation,24,17,7
12844,Peef,tichondrius,1439,evoker,devastation,24,15,9
12845,Veserion,azralon,1439,evoker,devastation,96,54,42
12846,Salakhar,drakkari,1438,evoker,devastation,38,24,14
12847,Kheeleesi,illidan,1438,evoker,devastation,113,55,58
12848,Monkeydrake,tichondrius,1438,evoker,devastation,72,31,41
12849,Drakoris,malganis,1436,evoker,devastation,146,79,67
12850,Chinesedragn,tichondrius,1436,evoker,devastation,100,51,49
12851,Daesired,moon-guard,1436,evoker,devastation,42,18,24
12852,Desiinger,tichondrius,1435,evoker,devastation,54,29,25
12853,Zalzin,agamaggan,1435,evoker,devastation,92,48,44
12854,Vexosza,moon-guard,1434,evoker,devastation,30,16,14
12855,Tabebuya,illidan,1432,evoker,devastation,63,25,38
12856,Favoredson,area-52,1431,evoker,devastation,54,29,25
12857,Joopydrake,tichondrius,1431,evoker,devastation,30,15,15
12858,Dracthyrius,thunderlord,1430,evoker,devastation,30,16,14
12859,Razistzegrlz,illidan,1430,evoker,devastation,36,15,21
12860,Valthenax,frostmourne,1430,evoker,devastation,94,39,55
12861,Brounno,area-52,1429,evoker,devastation,76,49,27
12862,Brendormu,moon-guard,1428,evoker,devastation,39,15,24
12863,Iamluck,kiljaeden,1425,evoker,devastation,34,16,18
12864,Neith,aerie-peak,1425,evoker,devastation,47,18,29
12865,Ragnagos,area-52,1424,evoker,devastation,24,15,9
12866,Dylawn,illidan,1424,evoker,devastation,54,31,23
12867,Dragonbic,illidan,1423,evoker,devastation,36,16,20
12868,Trenash,illidan,1418,evoker,devastation,76,32,44
12869,Nethenezoth,auchindoun,1414,evoker,devastation,30,15,15
12870,Dragondis,thrall,1412,evoker,devastation,64,30,34
12871,Talanoth,skullcrusher,1408,evoker,devastation,57,34,23
12872,Setash,kiljaeden,1407,evoker,devastation,72,39,33
12873,Toastragosa,cenarius,1406,evoker,devastation,149,66,83
12874,Thechadwasgr,bleeding-hollow,1403,evoker,devastation,62,31,31
12875,Dragoom,saurfang,1402,evoker,devastation,36,20,16
12876,Firkrag,bleeding-hollow,1402,evoker,devastation,60,28,32
12877,Jarzilla,illidan,1401,evoker,devastation,24,15,9
12878,Spicy,mannoroth,1400,evoker,devastation,40,22,18
12879,Valkalas,moon-guard,1400,evoker,devastation,63,30,33
12880,Tasoly,stormrage,1400,evoker,devastation,65,26,39
12881,Dillss,tichondrius,1397,evoker,devastation,66,31,35
12882,Rodgoesinya,blackrock,1392,evoker,devastation,54,30,24
12883,Blittlle,bleeding-hollow,1391,evoker,devastation,66,39,27
12884,Prevocker,sargeras,1387,evoker,devastation,85,37,48
12885,Zendrov,skywall,1386,evoker,devastation,79,41,38
12886,Dailon,stormreaver,1385,evoker,devastation,57,26,31
12887,Tyrvin,kiljaeden,1382,evoker,devastation,145,72,73
12888,Tinà,tichondrius,1377,evoker,devastation,48,27,21
12889,Howtew,jubeithos,1377,evoker,devastation,72,37,35
12890,Madashy,durotan,1377,evoker,devastation,71,34,37
12891,Ashenoth,antonidas,1376,evoker,devastation,42,23,19
12892,Devonstation,zuljin,1372,evoker,devastation,48,25,23
12893,Zeetash,illidan,1372,evoker,devastation,78,30,48
12894,Zayllaerth,illidan,1371,evoker,devastation,86,45,41
12895,Malygoz,frostmourne,1370,evoker,devastation,60,24,36
12896,Monyz,emerald-dream,1369,evoker,devastation,80,50,30
12897,Kosstro,thunderlord,1366,evoker,devastation,58,35,23
12898,Bvo,stormrage,1364,evoker,devastation,77,41,36
12899,Gutterskank,illidan,1362,evoker,devastation,35,22,13
12900,Navaji,tichondrius,1362,evoker,devastation,55,30,25
12901,Leapofagony,zuljin,1362,evoker,devastation,33,15,18
12902,Evokedx,area-52,1361,evoker,devastation,42,21,21
12903,Sidrasza,norgannon,1360,evoker,devastation,73,40,33
12904,Cròk,quelthalas,1360,evoker,devastation,33,15,18
12905,Ezarke,madoran,1359,evoker,devastation,35,17,18
12906,Thendroz,moon-guard,1357,evoker,devastation,30,18,12
12907,Valyrik,illidan,1356,evoker,devastation,110,54,56
12908,Lexgrossman,kelthuzad,1353,evoker,devastation,98,50,48
12909,Kêristrasza,wyrmrest-accord,1352,evoker,devastation,54,27,27
12910,Hugehorns,jubeithos,1349,evoker,devastation,24,15,9
12911,Klownfiesta,thrall,1344,evoker,devastation,123,69,54
12912,Trazana,wyrmrest-accord,1344,evoker,devastation,29,16,13
12913,Ironscale,dalaran,1344,evoker,devastation,36,19,17
12914,Aydetal,eonar,1343,evoker,devastation,42,20,22
12915,Grendalevo,tichondrius,1341,evoker,devastation,69,34,35
12916,Dragoness,azralon,1341,evoker,devastation,71,29,42
12917,Ilovepolpot,tichondrius,1340,evoker,devastation,18,14,4
12918,Kazrekan,moon-guard,1339,evoker,devastation,30,14,16
12919,Yuukee,thrall,1338,evoker,devastation,43,23,20
12920,Puffthemagik,doomhammer,1337,evoker,devastation,190,89,101
12921,Drêki,bleeding-hollow,1334,evoker,devastation,90,38,52
12922,Dîego,azralon,1333,evoker,devastation,40,24,16
12923,Rial,frostmourne,1331,evoker,devastation,30,14,16
12924,Acoldwall,illidan,1328,evoker,devastation,24,15,9
12925,Yiserion,sargeras,1328,evoker,devastation,187,100,87
12926,Koralia,wyrmrest-accord,1328,evoker,devastation,30,14,16
12927,Evokjoe,tortheldrin,1327,evoker,devastation,64,33,31
12928,Vaelikai,korgath,1326,evoker,devastation,18,14,4
12929,Zlandicaar,area-52,1325,evoker,devastation,84,40,44
12930,Derazar,malganis,1323,evoker,devastation,42,25,17
12931,Satanasx,illidan,1323,evoker,devastation,48,20,28
12932,Dovå,moon-guard,1322,evoker,devastation,32,16,16
12933,Narthraxion,destromath,1321,evoker,devastation,105,54,51
12934,Wackthyr,frostmourne,1320,evoker,devastation,36,18,18
12935,Emikothyr,thrall,1319,evoker,devastation,74,41,33
12936,Tekath,altar-of-storms,1317,evoker,devastation,56,26,30
12937,Ggcthulhu,area-52,1316,evoker,devastation,24,14,10
12938,Craterearth,moon-guard,1316,evoker,devastation,73,31,42
12939,Dragneel,wyrmrest-accord,1316,evoker,devastation,62,25,37
12940,Drahconne,illidan,1312,evoker,devastation,76,40,36
12941,Jabbawockeëz,drakkari,1310,evoker,devastation,97,51,46
12942,Skooby,drenden,1309,evoker,devastation,30,16,14
12943,Targaryenz,malganis,1306,evoker,devastation,54,28,26
12944,Galakraas,proudmoore,1306,evoker,devastation,93,46,47
12945,Notvez,bleeding-hollow,1305,evoker,devastation,43,18,25
12946,Raghnard,illidan,1303,evoker,devastation,70,37,33
12947,Senven,blackhand,1303,evoker,devastation,48,21,27
12948,Skykeeper,quelthalas,1300,evoker,devastation,130,67,63
12949,Alligatorz,sargeras,1300,evoker,devastation,54,27,27
12950,Drogan,demon-soul,1299,evoker,devastation,104,59,45
12951,Zlolykcir,malganis,1299,evoker,devastation,89,48,41
12952,Midnights,scarlet-crusade,1296,evoker,devastation,89,52,37
12953,Vahaerys,stormrage,1296,evoker,devastation,48,21,27
12954,Evokinator,zuljin,1295,evoker,devastation,24,14,10
12955,Dvrk,frostmourne,1295,evoker,devastation,53,25,28
12956,Slitherin,dalaran,1294,evoker,devastation,60,28,32
12957,Panicnodisco,zuljin,1292,evoker,devastation,23,14,9
12958,Darazen,scarlet-crusade,1290,evoker,devastation,36,17,19
12959,Sylnathaire,wyrmrest-accord,1288,evoker,devastation,104,49,55
12960,Obeahfire,tichondrius,1288,evoker,devastation,64,24,40
12961,Wrecketz,tichondrius,1284,evoker,devastation,100,53,47
12962,Vokeero,ysera,1284,evoker,devastation,72,36,36
12963,Friedsalmon,azshara,1284,evoker,devastation,29,14,15
12964,Layothyr,stormrage,1281,evoker,devastation,30,18,12
12965,Aktas,illidan,1280,evoker,devastation,40,19,21
12966,Cheaterz,area-52,1279,evoker,devastation,42,27,15
12967,Benares,zuljin,1279,evoker,devastation,91,43,48
12968,Vlåd,tichondrius,1279,evoker,devastation,42,19,23
12969,Sylverion,thrall,1277,evoker,devastation,70,35,35
12970,Zorashal,kiljaeden,1276,evoker,devastation,52,31,21
12971,Nið,moon-guard,1274,evoker,devastation,28,14,14
12972,Tralanoth,destromath,1270,evoker,devastation,30,16,14
12973,Døvahkiin,sargeras,1260,evoker,devastation,29,14,15
12974,Skizle,destromath,1259,evoker,devastation,35,16,19
12975,Nathenezital,frostmourne,1255,evoker,devastation,39,21,18
12976,Itwasntthis,tichondrius,1254,evoker,devastation,123,61,62
12977,Nephrites,area-52,1252,evoker,devastation,34,15,19
12978,Draginnutz,dunemaul,1252,evoker,devastation,36,15,21
12979,Nathx,drakkari,1251,evoker,devastation,48,31,17
12980,Crogosa,quelthalas,1251,evoker,devastation,36,14,22
12981,Dragonair,spinebreaker,1250,evoker,devastation,33,16,17
12982,Êsh,lightbringer,1249,evoker,devastation,24,14,10
12983,Ezgamedeez,tichondrius,1247,evoker,devastation,24,13,11
12984,Aoxila,proudmoore,1247,evoker,devastation,239,114,125
12985,Marknormand,area-52,1246,evoker,devastation,24,13,11
12986,Shanegillis,emerald-dream,1244,evoker,devastation,18,13,5
12987,Cmiygl,proudmoore,1243,evoker,devastation,18,13,5
12988,Sindraxx,stormrage,1242,evoker,devastation,57,30,27
12989,Seranis,sargeras,1242,evoker,devastation,36,13,23
12990,Skykeeper,dalaran,1241,evoker,devastation,30,16,14
12991,Dracfire,saurfang,1239,evoker,devastation,24,13,11
12992,Loganvkr,illidan,1237,evoker,devastation,36,18,18
12993,Azorian,vashj,1236,evoker,devastation,36,21,15
12994,Longxx,dalaran,1235,evoker,devastation,24,13,11
12995,Xm,emerald-dream,1235,evoker,devastation,31,14,17
12996,Billynobob,tichondrius,1235,evoker,devastation,30,13,17
12997,Bigbadfred,tichondrius,1234,evoker,devastation,24,13,11
12998,Nuttutted,emerald-dream,1232,evoker,devastation,24,13,11
12999,Taamyr,wyrmrest-accord,1230,evoker,devastation,126,69,57
13000,Dkvastate,tichondrius,1229,evoker,devastation,36,26,10
13001,Riyad,emerald-dream,1229,evoker,devastation,58,28,30
13002,Snowdragon,azralon,1226,evoker,devastation,53,28,25
13003,Dingermun,bleeding-hollow,1225,evoker,devastation,20,15,5
13004,Momonosuke,fizzcrank,1225,evoker,devastation,36,20,16
13005,Valakaztower,area-52,1225,evoker,devastation,36,19,17
13006,Chimo,laughing-skull,1225,evoker,devastation,30,14,16
13007,Dracthul,tichondrius,1222,evoker,devastation,42,22,20
13008,Puffsmoke,korgath,1220,evoker,devastation,24,13,11
13009,Emsli,moon-guard,1218,evoker,devastation,24,14,10
13010,Fáffy,kelthuzad,1218,evoker,devastation,42,15,27
13011,Kèrby,frostmourne,1213,evoker,devastation,30,15,15
13012,Jugzxs,frostmourne,1213,evoker,devastation,36,14,22
13013,Atrocion,wyrmrest-accord,1209,evoker,devastation,94,50,44
13014,Raygos,nemesis,1207,evoker,devastation,68,27,41
13015,Trenot,draenor,1202,evoker,devastation,42,21,21
13016,Aelvina,moon-guard,1201,evoker,devastation,30,13,17
13017,Tattleslug,illidan,1199,evoker,devastation,30,15,15
13018,Vahvan,sargeras,1197,evoker,devastation,54,21,33
13019,Clarkeboi,barthilas,1196,evoker,devastation,40,21,19
13020,Ejokerxx,tichondrius,1193,evoker,devastation,24,14,10
13021,Dragkon,azuremyst,1193,evoker,devastation,66,28,38
13022,Tealandrov,zuljin,1193,evoker,devastation,50,16,34
13023,Bumbledragn,moon-guard,1192,evoker,devastation,110,53,57
13024,Culture,khazgoroth,1191,evoker,devastation,21,13,8
13025,Dracky,deathwing,1190,evoker,devastation,17,13,4
13026,Paean,moon-guard,1183,evoker,devastation,32,18,14
13027,Nazanazar,wyrmrest-accord,1181,evoker,devastation,128,60,68
13028,Evooern,frostmourne,1181,evoker,devastation,84,39,45
13029,Huanglong,sargeras,1180,evoker,devastation,30,16,14
13030,Xampusaurio,ragnaros,1178,evoker,devastation,24,13,11
13031,Kaikisen,malganis,1178,evoker,devastation,41,19,22
13032,Climax,stormrage,1177,evoker,devastation,28,13,15
13033,Vaayu,moon-guard,1176,evoker,devastation,24,13,11
13034,Sethelys,tichondrius,1176,evoker,devastation,26,13,13
13035,Deàthwing,proudmoore,1175,evoker,devastation,181,82,99
13036,Loginplease,frostmourne,1171,evoker,devastation,86,40,46
13037,Midyr,nemesis,1169,evoker,devastation,48,28,20
13038,Teritwo,stormrage,1166,evoker,devastation,28,13,15
13039,Dragonpete,whisperwind,1161,evoker,devastation,48,23,25
13040,Drakhaz,azralon,1156,evoker,devastation,22,13,9
13041,Visron,stormrage,1153,evoker,devastation,65,41,24
13042,Asham,azralon,1152,evoker,devastation,63,36,27
13043,Tërminus,quelthalas,1151,evoker,devastation,18,12,6
13044,Devokerx,emerald-dream,1151,evoker,devastation,18,12,6
13045,Shwaydbz,zuljin,1151,evoker,devastation,24,12,12
13046,Drsgme,dentarg,1150,evoker,devastation,24,12,12
13047,Skylizard,illidan,1147,evoker,devastation,24,12,12
13048,Zervis,arthas,1147,evoker,devastation,30,12,18
13049,Draconicus,bonechewer,1146,evoker,devastation,166,79,87
13050,Thalyxia,azralon,1146,evoker,devastation,30,13,17
13051,Nessumsar,azralon,1145,evoker,devastation,24,12,12
13052,Drozul,stormrage,1145,evoker,devastation,30,12,18
13053,Ilovequiet,proudmoore,1142,evoker,devastation,24,12,12
13054,Skeedaddle,zuljin,1140,evoker,devastation,30,15,15
13055,Dragoceleste,ragnaros,1140,evoker,devastation,54,26,28
13056,Dinnkyion,dalaran,1138,evoker,devastation,24,12,12
13057,Stretonaught,dalaran,1137,evoker,devastation,33,15,18
13058,Slimyreptile,sargeras,1134,evoker,devastation,69,31,38
13059,Dragonbranch,area-52,1133,evoker,devastation,24,12,12
13060,Lorathyr,lothar,1128,evoker,devastation,24,12,12
13061,Enuzan,dalaran,1128,evoker,devastation,89,41,48
13062,Duamutef,wyrmrest-accord,1127,evoker,devastation,28,16,12
13063,Archion,azgalor,1127,evoker,devastation,35,13,22
13064,Fortwonty,thrall,1120,evoker,devastation,24,14,10
13065,Pyrepapi,thrall,1115,evoker,devastation,32,13,19
13066,Bhalaria,ragnaros,1113,evoker,devastation,69,25,44
13067,Paycussy,sargeras,1110,evoker,devastation,18,12,6
13068,Drakonyx,mugthol,1107,evoker,devastation,56,22,34
13069,Zitasanazen,tichondrius,1107,evoker,devastation,64,25,39
13070,Tïtäm,area-52,1106,evoker,devastation,26,13,13
13071,Drögón,stormrage,1100,evoker,devastation,42,27,15
13072,Crymor,lethon,1099,evoker,devastation,30,16,14
13073,Madelines,tichondrius,1097,evoker,devastation,24,13,11
13074,Ezath,zuljin,1089,evoker,devastation,56,29,27
13075,Zhannecgos,moon-guard,1087,evoker,devastation,28,12,16
13076,Byäkuyá,azralon,1085,evoker,devastation,113,57,56
13077,Rayomcquen,garrosh,1080,evoker,devastation,29,16,13
13078,Blazor,sisters-of-elune,1076,evoker,devastation,35,14,21
13079,Tiamaat,black-dragonflight,1073,evoker,devastation,28,12,16
13080,Bähamut,proudmoore,1072,evoker,devastation,41,16,25
13081,Gamerwords,barthilas,1070,evoker,devastation,30,13,17
13082,Durijus,tichondrius,1069,evoker,devastation,35,14,21
13083,Aratre,daggerspine,1066,evoker,devastation,108,55,53
13084,Ðarkwyrm,laughing-skull,1062,evoker,devastation,42,22,20
13085,Dracopium,tichondrius,1061,evoker,devastation,36,20,16
13086,Cunk,illidan,1056,evoker,devastation,35,24,11
13087,Thenderazen,sargeras,1056,evoker,devastation,81,46,35
13088,Devokèr,tichondrius,1056,evoker,devastation,24,11,13
13089,Talzindera,sargeras,1055,evoker,devastation,21,12,9
13090,Jwas,tichondrius,1055,evoker,devastation,24,11,13
13091,Hydroponicsz,bloodscalp,1055,evoker,devastation,24,11,13
13092,Kiry,emerald-dream,1055,evoker,devastation,24,11,13
13093,Taylordra,tichondrius,1055,evoker,devastation,24,11,13
13094,Dracnovae,emerald-dream,1055,evoker,devastation,35,14,21
13095,Kubus,emerald-dream,1054,evoker,devastation,18,11,7
13096,Gypgo,ragnaros,1054,evoker,devastation,18,11,7
13097,Tepaku,thrall,1054,evoker,devastation,18,11,7
13098,Yousurper,thunderlord,1054,evoker,devastation,27,14,13
13099,Hlnv,aegwynn,1053,evoker,devastation,18,11,7
13100,Eìdolon,sargeras,1049,evoker,devastation,18,11,7
13101,Dragostephen,nazjatar,1049,evoker,devastation,24,11,13
13102,Zirath,emerald-dream,1045,evoker,devastation,24,11,13
13103,Sübjugador,azralon,1042,evoker,devastation,30,20,10
13104,Flygor,quelthalas,1041,evoker,devastation,78,30,48
13105,Fpbafome,azralon,1038,evoker,devastation,42,13,29
13106,Bhristopher,wildhammer,1035,evoker,devastation,12,11,1
13107,Brunswichk,azralon,1033,evoker,devastation,24,11,13
13108,Lostplanet,drakkari,1030,evoker,devastation,42,13,29
13109,Byssrak,borean-tundra,1029,evoker,devastation,18,11,7
13110,Warhammerxx,tichondrius,1027,evoker,devastation,84,33,51
13111,Zippityzoom,barthilas,1026,evoker,devastation,43,18,25
13112,Razorwing,azgalor,1019,evoker,devastation,24,13,11
13113,Kaidô,illidan,1008,evoker,devastation,16,12,4
13114,Dracothyst,tichondrius,1007,evoker,devastation,29,15,14
13115,Jgxv,dalaran,1007,evoker,devastation,23,11,12
13116,Dragonbreaf,emerald-dream,1004,evoker,devastation,17,11,6
13117,Alnuin,stormrage,1004,evoker,devastation,102,42,60
13118,Danzick,sargeras,1003,evoker,devastation,24,11,13
13119,Toyatoki,stormrage,1000,evoker,devastation,47,20,27
13120,Stolesom,emerald-dream,994,evoker,devastation,65,32,33
13121,Azulagos,sargeras,992,evoker,devastation,22,14,8
13122,Sixjobs,area-52,990,evoker,devastation,29,11,18
13123,Evokatoke,proudmoore,989,evoker,devastation,37,16,21
13124,Acnøløgia,azralon,988,evoker,devastation,36,12,24
13125,Neofarian,lightbringer,986,evoker,devastation,20,11,9
13126,Dragongrim,silvermoon,986,evoker,devastation,30,14,16
13127,Popgoesurmom,tichondrius,981,evoker,devastation,24,13,11
13128,Pisslizard,stormrage,980,evoker,devastation,28,11,17
13129,Drapybaras,bleeding-hollow,963,evoker,devastation,54,26,28
13130,Miradrake,icecrown,960,evoker,devastation,12,10,2
13131,Iantern,dalaran,960,evoker,devastation,18,10,8
13132,Rizzlordx,bleeding-hollow,960,evoker,devastation,24,10,14
13133,Tjofscales,stormrage,960,evoker,devastation,24,10,14
13134,Moreleth,stormrage,959,evoker,devastation,18,10,8
13135,Nasdanot,zuljin,959,evoker,devastation,18,10,8
13136,Chime,dalaran,959,evoker,devastation,18,10,8
13137,Hausebat,moon-guard,959,evoker,devastation,18,10,8
13138,Xeerus,stormreaver,959,evoker,devastation,18,10,8
13139,Basiliskgodx,tichondrius,959,evoker,devastation,18,10,8
13140,Runescape,altar-of-storms,959,evoker,devastation,24,10,14
13141,Grafixx,sargeras,958,evoker,devastation,15,11,4
13142,Ryhu,sargeras,958,evoker,devastation,18,10,8
13143,Vokezuì,sargeras,958,evoker,devastation,30,10,20
13144,Jormungandre,wyrmrest-accord,957,evoker,devastation,18,10,8
13145,Dragocser,drakkari,957,evoker,devastation,18,10,8
13146,Galaxiz,bonechewer,957,evoker,devastation,24,12,12
13147,Oatmealneil,bleeding-hollow,955,evoker,devastation,24,10,14
13148,Sinepbreath,bleeding-hollow,954,evoker,devastation,18,10,8
13149,Finvoker,kalecgos,953,evoker,devastation,18,10,8
13150,Liekki,illidan,953,evoker,devastation,24,10,14
13151,Ecksdoom,sargeras,952,evoker,devastation,18,10,8
13152,Wizadsa,amanthul,951,evoker,devastation,12,10,2
13153,Takhysis,frostmourne,949,evoker,devastation,24,10,14
13154,Fìg,wyrmrest-accord,948,evoker,devastation,18,10,8
13155,Jorlozthyr,ragnaros,948,evoker,devastation,24,10,14
13156,Aegontargary,azralon,945,evoker,devastation,27,11,16
13157,Maximiliam,ragnaros,944,evoker,devastation,34,18,16
13158,Herikas,tichondrius,943,evoker,devastation,80,39,41
13159,Prolyfe,blood-furnace,942,evoker,devastation,15,11,4
13160,Toephotos,tichondrius,937,evoker,devastation,23,10,13
13161,Dethendrov,moon-guard,936,evoker,devastation,18,10,8
13162,Escanorr,ghostlands,936,evoker,devastation,20,11,9
13163,Ciana,black-dragonflight,936,evoker,devastation,50,26,24
13164,Báalboski,tichondrius,935,evoker,devastation,18,10,8
13165,Hicane,tichondrius,935,evoker,devastation,29,10,19
13166,Ryùtt,illidan,933,evoker,devastation,18,10,8
13167,Battledragon,illidan,918,evoker,devastation,18,10,8
13168,Fukhur,ragnaros,917,evoker,devastation,24,11,13
13169,Galgaldr,tichondrius,914,evoker,devastation,30,12,18
13170,Ezdrake,drakkari,900,evoker,devastation,36,11,25
13171,Arath,zangarmarsh,898,evoker,devastation,42,22,20
13172,Alextroxo,stormrage,888,evoker,devastation,17,10,7
13173,Tireoz,frostmourne,866,evoker,devastation,48,12,36
13174,Kiserys,suramar,864,evoker,devastation,12,9,3
13175,Áspect,aegwynn,864,evoker,devastation,12,9,3
13176,Gobananas,sargeras,864,evoker,devastation,12,9,3
13177,Oracle,duskwood,864,evoker,devastation,12,9,3
13178,Kaldesun,ragnaros,864,evoker,devastation,12,9,3
13179,Orncen,emerald-dream,864,evoker,devastation,16,10,6
13180,Todorøki,hyjal,864,evoker,devastation,18,9,9
13181,Thnake,zuljin,864,evoker,devastation,18,9,9
13182,Erokx,kelthuzad,864,evoker,devastation,18,9,9
13183,Brakkarion,wyrmrest-accord,864,evoker,devastation,18,9,9
13184,Creachy,kiljaeden,864,evoker,devastation,18,9,9
13185,Nyranblood,zuljin,864,evoker,devastation,42,18,24
13186,Raikori,ragnaros,863,evoker,devastation,12,9,3
13187,Weedi,tichondrius,863,evoker,devastation,12,9,3
13188,Novi,kaelthas,863,evoker,devastation,12,9,3
13189,Dragbod,korgath,863,evoker,devastation,18,9,9
13190,Missjenny,korgath,863,evoker,devastation,18,9,9
13191,Dâpper,queldorei,863,evoker,devastation,18,9,9
13192,Wse,illidan,863,evoker,devastation,18,9,9
13193,Thyatera,ragnaros,863,evoker,devastation,18,9,9
13194,Lardicønn,thrall,863,evoker,devastation,18,9,9
13195,Siatrend,moon-guard,863,evoker,devastation,18,9,9
13196,Misik,frostwolf,863,evoker,devastation,18,9,9
13197,Nelthendros,moon-guard,863,evoker,devastation,18,9,9
13198,Drazgarth,azshara,863,evoker,devastation,18,9,9
13199,Naraxus,thrall,863,evoker,devastation,18,9,9
13200,Dragonsteppz,aegwynn,863,evoker,devastation,18,9,9
13201,Gharscales,tichondrius,863,evoker,devastation,24,9,15
13202,Dracthyrwa,azralon,862,evoker,devastation,12,9,3
13203,Demidas,emerald-dream,862,evoker,devastation,13,9,4
13204,Serathrine,smolderthorn,862,evoker,devastation,18,9,9
13205,Disugaiza,tichondrius,861,evoker,devastation,12,9,3
13206,Sía,drakkari,861,evoker,devastation,12,9,3
13207,Nasath,arthas,861,evoker,devastation,18,9,9
13208,Teanie,tichondrius,861,evoker,devastation,18,9,9
13209,Gôdswrath,tichondrius,861,evoker,devastation,18,9,9
13210,Toxicspyro,frostmourne,861,evoker,devastation,24,9,15
13211,Karaxes,gorefiend,861,evoker,devastation,24,9,15
13212,Krokuzan,ragnaros,860,evoker,devastation,18,9,9
13213,Doombreath,ragnaros,859,evoker,devastation,18,9,9
13214,Keedrori,thrall,859,evoker,devastation,19,9,10
13215,Aoibae,frostmourne,859,evoker,devastation,24,9,15
13216,Atpsuspect,nerzhul,858,evoker,devastation,18,9,9
13217,Granolajin,ragnaros,857,evoker,devastation,24,9,15
13218,Azuria,lothar,855,evoker,devastation,12,9,3
13219,Furyíon,stormrage,855,evoker,devastation,12,9,3
13220,Acnølogia,stormrage,855,evoker,devastation,18,9,9
13221,Makiabelico,terenas,855,evoker,devastation,30,9,21
13222,Edivian,ragnaros,849,evoker,devastation,19,10,9
13223,Stormstryke,queldorei,848,evoker,devastation,41,10,31
13224,Azafs,azralon,847,evoker,devastation,26,10,16
13225,Rasec,moon-guard,843,evoker,devastation,20,9,11
13226,Mewclaw,tol-barad,841,evoker,devastation,12,9,3
13227,Rikfreedom,ragnaros,836,evoker,devastation,42,19,23
13228,Stylez,anetheron,830,evoker,devastation,42,19,23
13229,Dreampunk,tichondrius,784,evoker,devastation,13,9,4
13230,Rawrrxd,blackrock,768,evoker,devastation,12,8,4
13231,Frequentlee,illidan,768,evoker,devastation,12,8,4
13232,Jenovi,tichondrius,768,evoker,devastation,12,8,4
13233,Saînt,thrall,768,evoker,devastation,12,8,4
13234,Latria,malganis,768,evoker,devastation,12,8,4
13235,Toastsevoker,tichondrius,768,evoker,devastation,15,9,6
13236,Dragonfarts,frostmourne,768,evoker,devastation,18,8,10
13237,Crosis,azralon,768,evoker,devastation,18,8,10
13238,Grievaxion,ragnaros,767,evoker,devastation,12,8,4
13239,Gooliath,madoran,767,evoker,devastation,12,8,4
13240,Evokemon,hyjal,767,evoker,devastation,12,8,4
13241,Dragginballz,twisting-nether,767,evoker,devastation,12,8,4
13242,Vermax,akama,767,evoker,devastation,18,8,10
13243,Rïvé,tichondrius,767,evoker,devastation,24,8,16
13244,Arokh,frostmourne,767,evoker,devastation,30,8,22
13245,Dragonballer,trollbane,766,evoker,devastation,18,8,10
13246,Ghostfable,emerald-dream,766,evoker,devastation,18,8,10
13247,Dawitchvoker,illidan,766,evoker,devastation,18,8,10
13248,Glideoure,stonemaul,766,evoker,devastation,24,8,16
13249,Dracthylian,ragnaros,765,evoker,devastation,12,8,4
13250,Aaztra,whisperwind,765,evoker,devastation,12,8,4
13251,Skrillerv,frostmourne,765,evoker,devastation,18,8,10
13252,Muppetgronk,frostmourne,765,evoker,devastation,24,8,16
13253,Quêtzal,akama,764,evoker,devastation,12,8,4
13254,Riz,blackhand,764,evoker,devastation,18,8,10
13255,Gyirzkaag,illidan,764,evoker,devastation,18,8,10
13256,Historius,proudmoore,763,evoker,devastation,18,8,10
13257,Davidfesago,quelthalas,762,evoker,devastation,18,8,10
13258,Redeyés,area-52,761,evoker,devastation,12,8,4
13259,Zenithgar,aerie-peak,761,evoker,devastation,12,8,4
13260,Tessedract,bleeding-hollow,761,evoker,devastation,12,8,4
13261,Roksanda,azralon,761,evoker,devastation,24,8,16
13262,Seletgos,quelthalas,761,evoker,devastation,24,8,16
13263,Detraa,illidan,754,evoker,devastation,12,8,4
13264,Pouncer,proudmoore,754,evoker,devastation,48,18,30
13265,Daigrefn,echo-isles,751,evoker,devastation,18,8,10
13266,Reptyle,emerald-dream,743,evoker,devastation,24,8,16
13267,Liefarion,barthilas,734,evoker,devastation,22,8,14
13268,Littleripper,tichondrius,724,evoker,devastation,18,8,10
13269,Onornun,magtheridon,718,evoker,devastation,17,8,9
13270,Ammar,drakkari,716,evoker,devastation,17,8,9
13271,Ryü,silver-hand,704,evoker,devastation,16,8,8
13272,Drøgon,sargeras,703,evoker,devastation,20,8,12
13273,Zhyrouvion,stormrage,699,evoker,devastation,17,8,9
13274,Torakk,ravencrest,687,evoker,devastation,13,8,5
13275,Spryo,illidan,672,evoker,devastation,12,7,5
13276,Lizardgodtko,tichondrius,672,evoker,devastation,12,7,5
13277,Lacadabeef,tichondrius,672,evoker,devastation,12,7,5
13278,Dragzun,tichondrius,672,evoker,devastation,12,7,5
13279,Chewbigred,vashj,672,evoker,devastation,12,7,5
13280,Dragonherb,zuljin,672,evoker,devastation,12,7,5
13281,Dinohgos,area-52,672,evoker,devastation,12,7,5
13282,Evook,tichondrius,672,evoker,devastation,12,7,5
13283,Shambly,kelthuzad,672,evoker,devastation,12,7,5
13284,Dudeofdragon,illidan,672,evoker,devastation,12,7,5
13285,Rearcalzone,illidan,672,evoker,devastation,12,7,5
13286,Vokr,area-52,672,evoker,devastation,12,7,5
13287,Emberlyn,sargeras,672,evoker,devastation,12,7,5
13288,Spikeyboi,eonar,672,evoker,devastation,12,7,5
13289,Nysian,wyrmrest-accord,672,evoker,devastation,12,7,5
13290,Écaille,dalaran,672,evoker,devastation,15,8,7
13291,Deathstaind,tichondrius,672,evoker,devastation,16,8,8
13292,Dragonstonks,moon-guard,672,evoker,devastation,18,7,11
13293,Sådge,frostmourne,672,evoker,devastation,18,7,11
13294,Dragonshani,thrall,672,evoker,devastation,18,7,11
13295,Müshü,icecrown,672,evoker,devastation,18,7,11
13296,Emopidgey,dalaran,672,evoker,devastation,18,7,11
13297,Dragonballzx,kelthuzad,672,evoker,devastation,24,7,17
13298,Whiegrath,azralon,671,evoker,devastation,12,7,5
13299,Wekinball,tichondrius,671,evoker,devastation,12,7,5
13300,Boseijwho,emerald-dream,671,evoker,devastation,12,7,5
13301,Xeretas,bleeding-hollow,671,evoker,devastation,12,7,5
13302,Glaurungr,ragnaros,671,evoker,devastation,12,7,5
13303,Pågemaster,moon-guard,671,evoker,devastation,12,7,5
13304,Archalygos,moon-guard,671,evoker,devastation,12,7,5
13305,Garchamp,area-52,671,evoker,devastation,15,8,7
13306,Phatë,nerzhul,671,evoker,devastation,18,7,11
13307,Sizzlebird,darkspear,671,evoker,devastation,18,7,11
13308,Ackrenoth,emerald-dream,671,evoker,devastation,18,7,11
13309,Hemipenes,tichondrius,671,evoker,devastation,18,7,11
13310,Doomn,moon-guard,671,evoker,devastation,18,7,11
13311,Subject,kelthuzad,671,evoker,devastation,18,7,11
13312,Kluath,daggerspine,671,evoker,devastation,18,7,11
13313,Tikkaratika,nemesis,671,evoker,devastation,18,7,11
13314,Brothererik,hydraxis,671,evoker,devastation,18,7,11
13315,Saristrasza,moon-guard,671,evoker,devastation,18,7,11
13316,Drageyman,tichondrius,671,evoker,devastation,24,7,17
13317,Setchagos,emerald-dream,670,evoker,devastation,12,7,5
13318,Gulvoke,shattered-hand,670,evoker,devastation,12,7,5
13319,Beastlysoul,tichondrius,670,evoker,devastation,12,7,5
13320,Draecion,tichondrius,670,evoker,devastation,18,7,11
13321,Nikeze,kiljaeden,670,evoker,devastation,18,7,11
13322,Lamperr,illidan,670,evoker,devastation,54,10,44
13323,Pläid,azuremyst,668,evoker,devastation,12,7,5
13324,Sleepeasy,blackrock,667,evoker,devastation,18,7,11
13325,Mmanigoldo,quelthalas,667,evoker,devastation,18,7,11
13326,Evilsquirel,area-52,666,evoker,devastation,12,7,5
13327,Movoker,tichondrius,655,evoker,devastation,15,8,7
13328,Bàkèd,illidan,655,evoker,devastation,17,7,10
13329,Henscale,malganis,639,evoker,devastation,11,7,4
13330,Krefugee,tichondrius,637,evoker,devastation,17,7,10
13331,Drahkoo,azralon,623,evoker,devastation,15,7,8
13332,Yellowker,thrall,576,evoker,devastation,6,6,0
13333,Zérai,quelthalas,576,evoker,devastation,6,6,0
13334,Fuecoco,proudmoore,576,evoker,devastation,6,6,0
13335,Shanaynayae,area-52,576,evoker,devastation,12,6,6
13336,Vysenía,moon-guard,576,evoker,devastation,12,6,6
13337,Xurota,proudmoore,576,evoker,devastation,12,6,6
13338,Dafiya,thrall,576,evoker,devastation,12,6,6
13339,Actïoncat,emerald-dream,576,evoker,devastation,12,6,6
13340,Alucardragon,turalyon,576,evoker,devastation,12,6,6
13341,Glizard,firetree,576,evoker,devastation,12,6,6
13342,Yujirohanma,frostmourne,576,evoker,devastation,12,6,6
13343,Uncleìroh,tichondrius,576,evoker,devastation,12,6,6
13344,Nemenyah,emerald-dream,576,evoker,devastation,12,6,6
13345,Dragonage,stormrage,576,evoker,devastation,12,6,6
13346,Iamtrash,daggerspine,576,evoker,devastation,12,6,6
13347,Joyburn,tichondrius,576,evoker,devastation,12,6,6
13348,Bigdvoker,jubeithos,576,evoker,devastation,12,6,6
13349,Medusaan,tichondrius,576,evoker,devastation,12,6,6
13350,Wingjob,tichondrius,576,evoker,devastation,12,6,6
13351,Volksdragen,sargeras,576,evoker,devastation,12,6,6
13352,Comepancito,quelthalas,576,evoker,devastation,12,6,6
13353,Pÿthön,sargeras,576,evoker,devastation,12,6,6
13354,Sathregos,emerald-dream,576,evoker,devastation,12,6,6
13355,Lazarust,tichondrius,576,evoker,devastation,12,6,6
13356,Chadizard,tichondrius,576,evoker,devastation,12,6,6
13357,Daethwang,moon-guard,576,evoker,devastation,12,6,6
13358,Dragønbørne,blackrock,576,evoker,devastation,12,6,6
13359,Dragordito,drakkari,576,evoker,devastation,12,6,6
13360,Shrikethyr,chogall,576,evoker,devastation,12,6,6
13361,Deneryus,illidan,576,evoker,devastation,12,6,6
13362,Borpia,malganis,576,evoker,devastation,12,6,6
13363,Dukä,dalaran,576,evoker,devastation,15,7,8
13364,Chaosrebørn,bleeding-hollow,576,evoker,devastation,18,6,12
13365,Koopa,malygos,576,evoker,devastation,18,6,12
13366,Syvernius,khazgoroth,576,evoker,devastation,18,6,12
13367,Saxthyr,stormreaver,576,evoker,devastation,24,6,18
13368,Zeldir,ragnaros,575,evoker,devastation,6,6,0
13369,Dimpulse,zuljin,575,evoker,devastation,12,6,6
13370,Cøømbuya,sargeras,575,evoker,devastation,12,6,6
13371,Lòrdope,illidan,575,evoker,devastation,12,6,6
13372,Setasdan,illidan,575,evoker,devastation,12,6,6
13373,Amaryliss,kelthuzad,575,evoker,devastation,12,6,6
13374,Swagondragon,illidan,575,evoker,devastation,12,6,6
13375,Drãco,area-52,575,evoker,devastation,12,6,6
13376,Dumbodragon,bleeding-hollow,575,evoker,devastation,12,6,6
13377,Avastri,moon-guard,575,evoker,devastation,12,6,6
13378,Avithori,borean-tundra,575,evoker,devastation,12,6,6
13379,Koriaz,ragnaros,575,evoker,devastation,12,6,6
13380,Altri,lightnings-blade,575,evoker,devastation,12,6,6
13381,Sevariel,frostmane,575,evoker,devastation,12,6,6
13382,Vrtra,lightbringer,575,evoker,devastation,12,6,6
13383,Rykuvokr,azuremyst,575,evoker,devastation,12,6,6
13384,Tylexstranza,malganis,575,evoker,devastation,12,6,6
13385,Kazecgos,zuljin,575,evoker,devastation,12,6,6
13386,Taxfraudchad,sargeras,575,evoker,devastation,13,6,7
13387,Hopefire,zuljin,575,evoker,devastation,18,6,12
13388,Cinderelluh,area-52,575,evoker,devastation,18,6,12
13389,Alragos,ragnaros,575,evoker,devastation,18,6,12
13390,Lindrak,azralon,575,evoker,devastation,18,6,12
13391,Bazelgos,moon-guard,575,evoker,devastation,24,6,18
13392,Vermáx,caelestrasz,574,evoker,devastation,12,6,6
13393,Spyrofnir,stormrage,574,evoker,devastation,18,6,12
13394,Carloxd,tichondrius,574,evoker,devastation,24,6,18
13395,Deathb,chromaggus,573,evoker,devastation,12,6,6
13396,Syndue,malganis,573,evoker,devastation,12,6,6
13397,Silvèrr,tichondrius,573,evoker,devastation,12,6,6
13398,Noodleslut,stormrage,573,evoker,devastation,12,6,6
13399,Azuril,wyrmrest-accord,572,evoker,devastation,12,6,6
13400,Fafnirr,draenor,572,evoker,devastation,26,6,20
13401,Dragopnik,tichondrius,568,evoker,devastation,18,9,9
13402,Lightaurae,thunderlord,556,evoker,devastation,30,6,24
13403,Pzyko,ragnaros,551,evoker,devastation,17,6,11
13404,Zindrozarath,area-52,544,evoker,devastation,10,6,4
13405,Vyserion,turalyon,543,evoker,devastation,8,7,1
13406,Boadie,kilrogg,542,evoker,devastation,24,7,17
13407,Adorablexo,stormrage,527,evoker,devastation,11,6,5
13408,Zovaan,emerald-dream,526,evoker,devastation,11,6,5
13409,Kodeser,alleria,522,evoker,devastation,15,6,9
13410,Arnoeryan,ragnaros,512,evoker,devastation,16,6,10
13411,Carrnedge,area-52,511,evoker,devastation,11,6,5
13412,Nathrach,wyrmrest-accord,506,evoker,devastation,8,6,2
13413,Copevoker,black-dragonflight,480,evoker,devastation,6,5,1
13414,Schmitty,hellscream,480,evoker,devastation,6,5,1
13415,Solidusz,thrall,480,evoker,devastation,6,5,1
13416,Cheeriosvokr,tichondrius,480,evoker,devastation,6,5,1
13417,Kensar,drakkari,480,evoker,devastation,6,5,1
13418,Khalt,quelthalas,480,evoker,devastation,6,5,1
13419,Kharibdis,kul-tiras,480,evoker,devastation,6,5,1
13420,Vellony,kelthuzad,480,evoker,devastation,6,5,1
13421,Drakedrift,malganis,480,evoker,devastation,6,5,1
13422,Dragonhyde,stormrage,480,evoker,devastation,12,5,7
13423,Dhcb,tichondrius,480,evoker,devastation,12,5,7
13424,Deezdragon,stormrage,480,evoker,devastation,12,5,7
13425,Amplicon,stormrage,480,evoker,devastation,12,5,7
13426,Nardleberry,wyrmrest-accord,480,evoker,devastation,12,5,7
13427,Demikass,azralon,480,evoker,devastation,12,5,7
13428,Valkhar,illidan,480,evoker,devastation,12,5,7
13429,Rebuk,area-52,480,evoker,devastation,12,5,7
13430,Trillvoker,illidan,480,evoker,devastation,12,5,7
13431,Saìntgeorge,sargeras,480,evoker,devastation,12,5,7
13432,Vallath,zuljin,480,evoker,devastation,12,5,7
13433,Purplerocket,illidan,480,evoker,devastation,12,5,7
13434,Moltqt,tichondrius,480,evoker,devastation,12,5,7
13435,Stælthßømbèr,baelgun,480,evoker,devastation,12,5,7
13436,Asatrat,greymane,480,evoker,devastation,12,5,7
13437,Cerisoromis,stormrage,480,evoker,devastation,12,5,7
13438,Jevoker,area-52,480,evoker,devastation,12,5,7
13439,Draehgor,hyjal,480,evoker,devastation,12,5,7
13440,Galakrond,black-dragonflight,480,evoker,devastation,12,5,7
13441,Darkscale,haomarush,480,evoker,devastation,12,5,7
13442,Saintpablox,illidan,480,evoker,devastation,12,5,7
13443,Ventiev,tichondrius,480,evoker,devastation,12,5,7
13444,Ackresh,executus,480,evoker,devastation,12,5,7
13445,Dratonos,stormrage,480,evoker,devastation,12,5,7
13446,Eyedxl,magtheridon,480,evoker,devastation,12,5,7
13447,Faahrad,azralon,480,evoker,devastation,12,5,7
13448,Abath,quelthalas,480,evoker,devastation,14,5,9
13449,Nyldra,area-52,480,evoker,devastation,14,5,9
13450,Velahesa,sargeras,480,evoker,devastation,24,5,19
13451,Müshu,duskwood,479,evoker,devastation,12,5,7
13452,Dedderion,zuljin,479,evoker,devastation,12,5,7
13453,Lightbeing,nazjatar,479,evoker,devastation,12,5,7
13454,Scalesun,azralon,479,evoker,devastation,12,5,7
13455,Mattykanish,illidan,479,evoker,devastation,12,5,7
13456,Dracoi,illidan,479,evoker,devastation,12,5,7
13457,Zerodorez,zuljin,479,evoker,devastation,12,5,7
13458,Windylyrics,drakkari,479,evoker,devastation,18,5,13
13459,Adraell,illidan,478,evoker,devastation,13,6,7
13460,Niratrenn,area-52,478,evoker,devastation,12,5,7
13461,Nazervis,silver-hand,478,evoker,devastation,18,5,13
13462,Dracosofi,quelthalas,478,evoker,devastation,18,5,13
13463,Sandrov,kaelthas,477,evoker,devastation,12,5,7
13464,Saraphrodite,hakkar,477,evoker,devastation,12,5,7
13465,Althenot,emerald-dream,477,evoker,devastation,12,5,7
13466,Surezilla,malganis,477,evoker,devastation,24,5,19
13467,Odorf,duskwood,474,evoker,devastation,12,5,7
13468,Sammalone,burning-blade,474,evoker,devastation,12,5,7
13469,Shennron,darkspear,447,evoker,devastation,11,5,6
13470,Zzae,tichondrius,432,evoker,devastation,15,5,10
13471,Dazei,quelthalas,431,evoker,devastation,15,5,10
13472,Xfemboyqt,area-52,426,evoker,devastation,19,7,12
13473,Lifcleal,moon-guard,415,evoker,devastation,14,5,9
13474,Biscotti,illidan,384,evoker,devastation,6,4,2
13475,Dragonaria,illidan,384,evoker,devastation,6,4,2
13476,Awexstwaza,bleeding-hollow,384,evoker,devastation,6,4,2
13477,Dragonchip,bleeding-hollow,384,evoker,devastation,6,4,2
13478,Mushú,archimonde,384,evoker,devastation,6,4,2
13479,Atraxian,tichondrius,384,evoker,devastation,6,4,2
13480,Dragonsbgay,stormrage,384,evoker,devastation,6,4,2
13481,Zorlstisza,moon-guard,384,evoker,devastation,6,4,2
13482,Opsmybad,ragnaros,384,evoker,devastation,6,4,2
13483,Docevoker,tichondrius,384,evoker,devastation,6,4,2
13484,Machaflux,winterhoof,384,evoker,devastation,6,4,2
13485,Jammstraza,skywall,384,evoker,devastation,6,4,2
13486,Shenròn,kelthuzad,384,evoker,devastation,6,4,2
13487,Walmartshoes,tichondrius,384,evoker,devastation,6,4,2
13488,Shënrøn,tichondrius,384,evoker,devastation,6,4,2
13489,Kaidoxuchihv,ragnaros,384,evoker,devastation,6,4,2
13490,Whinks,zangarmarsh,384,evoker,devastation,6,4,2
13491,Deathraux,tichondrius,384,evoker,devastation,6,4,2
13492,Foxstrazagos,hellscream,384,evoker,devastation,6,4,2
13493,Konne,tichondrius,384,evoker,devastation,6,4,2
13494,Seaserpent,kelthuzad,384,evoker,devastation,6,4,2
13495,Vuldon,area-52,384,evoker,devastation,6,4,2
13496,Kusarí,moon-guard,384,evoker,devastation,6,4,2
13497,Bmbo,illidan,384,evoker,devastation,6,4,2
13498,Draisin,zuljin,384,evoker,devastation,6,4,2
13499,Daemon,detheroc,384,evoker,devastation,6,4,2
13500,Testzvoker,dalaran,384,evoker,devastation,6,4,2
13501,Skazz,emerald-dream,384,evoker,devastation,6,4,2
13502,Korvold,zuluhed,384,evoker,devastation,6,4,2
13503,Solazari,tichondrius,384,evoker,devastation,6,4,2
13504,Bodytypetwo,area-52,384,evoker,devastation,6,4,2
13505,Shenrõn,malganis,384,evoker,devastation,15,5,10
13506,Trazer,malfurion,384,evoker,devastation,12,4,8
13507,Nosrej,hyjal,384,evoker,devastation,12,4,8
13508,Cuarta,drakkari,384,evoker,devastation,12,4,8
13509,Kcwt,illidan,384,evoker,devastation,12,4,8
13510,Nitalzith,area-52,384,evoker,devastation,12,4,8
13511,Idiotlizard,stormrage,384,evoker,devastation,12,4,8
13512,Kurulol,ragnaros,384,evoker,devastation,12,4,8
13513,Usulamili,stormrage,384,evoker,devastation,12,4,8
13514,Magnito,thorium-brotherhood,384,evoker,devastation,12,4,8
13515,Baddrakthyr,moon-guard,384,evoker,devastation,12,4,8
13516,Uhlive,area-52,384,evoker,devastation,12,4,8
13517,Devåståtion,tichondrius,384,evoker,devastation,12,4,8
13518,Kendrac,wyrmrest-accord,384,evoker,devastation,12,4,8
13519,Smackthyr,thrall,384,evoker,devastation,12,4,8
13520,Kodeserath,hakkar,384,evoker,devastation,12,4,8
13521,Dracconic,sargeras,384,evoker,devastation,12,4,8
13522,Arkevo,tichondrius,384,evoker,devastation,12,4,8
13523,Butta,darkspear,384,evoker,devastation,12,4,8
13524,Bigsquirt,proudmoore,384,evoker,devastation,12,4,8
13525,Blay,elune,384,evoker,devastation,12,4,8
13526,Smacktoch,sargeras,384,evoker,devastation,12,4,8
13527,Munichho,spirestone,384,evoker,devastation,18,4,14
13528,Dadydafather,sargeras,384,evoker,devastation,30,4,26
13529,Deralizrd,tichondrius,383,evoker,devastation,6,4,2
13530,Dinossauro,stormrage,383,evoker,devastation,6,4,2
13531,Rysonda,tichondrius,383,evoker,devastation,6,4,2
13532,Bagelsaurus,tichondrius,383,evoker,devastation,12,4,8
13533,Zaland,whisperwind,383,evoker,devastation,12,4,8
13534,Odaa,moon-guard,383,evoker,devastation,12,4,8
13535,Jabberwockie,zuljin,383,evoker,devastation,12,4,8
13536,Broconian,zuljin,383,evoker,devastation,12,4,8
13537,Shenrøn,altar-of-storms,383,evoker,devastation,12,4,8
13538,Abodie,dalaran,383,evoker,devastation,12,4,8
13539,Gorby,tichondrius,383,evoker,devastation,12,4,8
13540,Gunship,moon-guard,383,evoker,devastation,12,4,8
13541,Mynameisjohn,hakkar,382,evoker,devastation,6,4,2
13542,Äpollo,frostmourne,382,evoker,devastation,12,4,8
13543,Dracalis,thrall,381,evoker,devastation,12,4,8
13544,Forte,terokkar,381,evoker,devastation,18,4,14
13545,Fearmybreath,stormrage,370,evoker,devastation,22,7,15
13546,Goongdi,tichondrius,351,evoker,devastation,11,4,7
13547,Vermicri,zuljin,351,evoker,devastation,11,4,7
13548,Serazenoth,area-52,336,evoker,devastation,9,4,5
13549,Acindor,stormrage,335,evoker,devastation,11,4,7
13550,Heizdrag,area-52,335,evoker,devastation,11,4,7
13551,Ackrs,tichondrius,335,evoker,devastation,11,4,7
13552,Draygaar,stormrage,330,evoker,devastation,15,5,10
13553,Baarss,tichondrius,288,evoker,devastation,6,3,3
13554,Blackrend,illidan,288,evoker,devastation,6,3,3
13555,Drackthyria,quelthalas,288,evoker,devastation,6,3,3
13556,Holdherhorn,area-52,288,evoker,devastation,6,3,3
13557,Skeye,malganis,288,evoker,devastation,6,3,3
13558,Hausebat,aegwynn,288,evoker,devastation,6,3,3
13559,Ráigon,ragnaros,288,evoker,devastation,6,3,3
13560,Yeda,barthilas,288,evoker,devastation,6,3,3
13561,Ceraxes,stormscale,288,evoker,devastation,6,3,3
13562,Lëåf,area-52,288,evoker,devastation,6,3,3
13563,Theomarz,nagrand,288,evoker,devastation,6,3,3
13564,Ripdumpster,bonechewer,288,evoker,devastation,6,3,3
13565,Baddrake,moon-guard,288,evoker,devastation,6,3,3
13566,Sovant,sargeras,288,evoker,devastation,6,3,3
13567,Dreamfyrexi,thrall,288,evoker,devastation,6,3,3
13568,Avasd,area-52,288,evoker,devastation,6,3,3
13569,Yousmokemids,frostwolf,288,evoker,devastation,6,3,3
13570,Royagon,draktharon,288,evoker,devastation,6,3,3
13571,Djvokey,area-52,288,evoker,devastation,6,3,3
13572,Kettor,kelthuzad,288,evoker,devastation,6,3,3
13573,Shenronda,moon-guard,288,evoker,devastation,6,3,3
13574,Soupywings,illidan,288,evoker,devastation,6,3,3
13575,Toenailstew,zuljin,288,evoker,devastation,6,3,3
13576,Burningwoe,tichondrius,288,evoker,devastation,6,3,3
13577,Koyra,illidan,288,evoker,devastation,6,3,3
13578,Sardonyx,dragonmaw,288,evoker,devastation,6,3,3
13579,Wickedwings,tichondrius,288,evoker,devastation,6,3,3
13580,Baeltas,blackrock,288,evoker,devastation,6,3,3
13581,Unisex,ragnaros,288,evoker,devastation,6,3,3
13582,Draggoh,bleeding-hollow,288,evoker,devastation,6,3,3
13583,Magicev,tichondrius,288,evoker,devastation,6,3,3
13584,Ecoera,tichondrius,288,evoker,devastation,6,3,3
13585,Brokenscales,nerzhul,288,evoker,devastation,6,3,3
13586,Zarazerath,tichondrius,288,evoker,devastation,6,3,3
13587,Jakarn,moon-guard,288,evoker,devastation,6,3,3
13588,Zindrath,emerald-dream,288,evoker,devastation,6,3,3
13589,Stewvoker,wyrmrest-accord,288,evoker,devastation,6,3,3
13590,Derkscale,stormrage,288,evoker,devastation,6,3,3
13591,Damo,skullcrusher,288,evoker,devastation,6,3,3
13592,Varandir,frostmane,288,evoker,devastation,6,3,3
13593,Dragonpel,azralon,288,evoker,devastation,6,3,3
13594,Breathkillsu,emerald-dream,288,evoker,devastation,6,3,3
13595,Scyyterr,azralon,288,evoker,devastation,6,3,3
13596,Crankxz,malganis,288,evoker,devastation,6,3,3
13597,Lamdyn,wyrmrest-accord,288,evoker,devastation,6,3,3
13598,Kaeszandrus,azralon,288,evoker,devastation,6,3,3
13599,Devastateme,frostmourne,288,evoker,devastation,6,3,3
13600,Koderalth,azralon,288,evoker,devastation,6,3,3
13601,Straykitty,moon-guard,288,evoker,devastation,6,3,3
13602,Kulrainor,drakkari,288,evoker,devastation,6,3,3
13603,Spyro,nazgrel,288,evoker,devastation,6,3,3
13604,Aomend,stormrage,288,evoker,devastation,6,3,3
13605,Skydragonlol,tichondrius,288,evoker,devastation,7,3,4
13606,Drakthaer,tichondrius,288,evoker,devastation,7,3,4
13607,Viverion,dalaran,288,evoker,devastation,10,4,6
13608,Taegon,area-52,288,evoker,devastation,10,4,6
13609,Grem,muradin,288,evoker,devastation,8,3,5
13610,Vandinus,stormrage,288,evoker,devastation,8,3,5
13611,Berylhwit,emerald-dream,288,evoker,devastation,11,3,8
13612,Marâjade,proudmoore,288,evoker,devastation,12,3,9
13613,Inferna,ysera,288,evoker,devastation,12,3,9
13614,Zafirina,proudmoore,288,evoker,devastation,12,3,9
13615,Murtharion,stormrage,288,evoker,devastation,12,3,9
13616,Freddragon,illidan,288,evoker,devastation,12,3,9
13617,Karmísh,quelthalas,288,evoker,devastation,12,3,9
13618,Draconis,onyxia,288,evoker,devastation,12,3,9
13619,Praac,illidan,288,evoker,devastation,12,3,9
13620,Lizardlee,stormrage,288,evoker,devastation,12,3,9
13621,Spyspyro,emerald-dream,288,evoker,devastation,12,3,9
13622,Healmeta,sargeras,288,evoker,devastation,12,3,9
13623,Talonsong,wyrmrest-accord,288,evoker,devastation,12,3,9
13624,Chriszilla,tichondrius,288,evoker,devastation,12,3,9
13625,Bjarne,hyjal,288,evoker,devastation,12,3,9
13626,Enserio,stormrage,288,evoker,devastation,12,3,9
13627,Dragndesnuts,scilla,288,evoker,devastation,18,3,15
13628,Vaegahr,tichondrius,287,evoker,devastation,6,3,3
13629,Zeralzin,aerie-peak,287,evoker,devastation,6,3,3
13630,Shaletresh,thrall,287,evoker,devastation,12,3,9
13631,Myvrth,windrunner,287,evoker,devastation,12,3,9
13632,Kilnarx,uldaman,286,evoker,devastation,6,3,3
13633,Brontez,malganis,286,evoker,devastation,6,3,3
13634,Ghorin,akama,240,evoker,devastation,9,3,6
13635,Draconiss,bonechewer,239,evoker,devastation,5,3,2
13636,Evoque,sargeras,239,evoker,devastation,15,3,12
13637,Reombarth,nemesis,234,evoker,devastation,12,6,6
13638,Trrxx,tichondrius,224,evoker,devastation,10,3,7
13639,Spectaclaw,crushridge,223,evoker,devastation,8,3,5
13640,Wydbro,kiljaeden,192,evoker,devastation,6,2,4
13641,Siatren,shadowmoon,192,evoker,devastation,6,2,4
13642,Dixb,illidan,192,evoker,devastation,6,2,4
13643,Acade,tichondrius,192,evoker,devastation,6,2,4
13644,Vermithõr,ragnaros,192,evoker,devastation,6,2,4
13645,Goreriders,area-52,192,evoker,devastation,6,2,4
13646,Puffed,frostmourne,192,evoker,devastation,6,2,4
13647,Lanati,veknilash,192,evoker,devastation,6,2,4
13648,Mâne,ragnaros,192,evoker,devastation,6,2,4
13649,Zuberion,wyrmrest-accord,192,evoker,devastation,6,2,4
13650,Yalena,illidan,192,evoker,devastation,6,2,4
13651,Vapegodx,proudmoore,192,evoker,devastation,6,2,4
13652,Nyaraoorun,uther,192,evoker,devastation,6,2,4
13653,Ilithiphobia,ghostlands,192,evoker,devastation,6,2,4
13654,Horusnight,drakkari,192,evoker,devastation,6,2,4
13655,Aralzit,tichondrius,192,evoker,devastation,6,2,4
13656,Shädòwçäsper,kilrogg,192,evoker,devastation,6,2,4
13657,Tasdaral,tichondrius,192,evoker,devastation,6,2,4
13658,Hoodoo,dark-iron,192,evoker,devastation,6,2,4
13659,Zattanik,ragnaros,192,evoker,devastation,6,2,4
13660,Mikaeza,tichondrius,192,evoker,devastation,6,2,4
13661,Xazxander,tichondrius,192,evoker,devastation,6,2,4
13662,Magikarpchan,ragnaros,192,evoker,devastation,6,2,4
13663,Dragonsand,area-52,192,evoker,devastation,6,2,4
13664,Umbrathel,tichondrius,192,evoker,devastation,6,2,4
13665,Ryüh,azralon,192,evoker,devastation,6,2,4
13666,Daikon,kaelthas,192,evoker,devastation,6,2,4
13667,Weirdclassx,tichondrius,192,evoker,devastation,6,2,4
13668,Pyrepeanut,tichondrius,192,evoker,devastation,6,2,4
13669,Tiyeal,thrall,192,evoker,devastation,6,2,4
13670,Olawd,azshara,192,evoker,devastation,6,2,4
13671,Slydawg,amanthul,192,evoker,devastation,6,2,4
13672,Daebruk,ragnaros,192,evoker,devastation,6,2,4
13673,Slyinx,area-52,192,evoker,devastation,6,2,4
13674,Draketyr,area-52,192,evoker,devastation,6,2,4
13675,Kaaer,emerald-dream,192,evoker,devastation,6,2,4
13676,Desdinova,tortheldrin,192,evoker,devastation,6,2,4
13677,Daraz,tichondrius,192,evoker,devastation,6,2,4
13678,Racovoker,zuljin,192,evoker,devastation,6,2,4
13679,Dokthyr,lightbringer,192,evoker,devastation,6,2,4
13680,Genderboy,tichondrius,192,evoker,devastation,6,2,4
13681,Paindragon,tol-barad,192,evoker,devastation,6,2,4
13682,Kazervish,wyrmrest-accord,192,evoker,devastation,6,2,4
13683,Joesount,frostmourne,192,evoker,devastation,6,2,4
13684,Kímbah,emerald-dream,192,evoker,devastation,6,2,4
13685,Swamper,emerald-dream,192,evoker,devastation,6,2,4
13686,Eggvoker,area-52,192,evoker,devastation,6,2,4
13687,Daemon,terokkar,192,evoker,devastation,6,2,4
13688,Grawlix,stormreaver,192,evoker,devastation,6,2,4
13689,Ralzital,auchindoun,192,evoker,devastation,6,2,4
13690,Scalendar,frostmourne,192,evoker,devastation,6,2,4
13691,Hiroshim,stormrage,192,evoker,devastation,6,2,4
13692,Frozanat,kelthuzad,192,evoker,devastation,6,2,4
13693,Álln,sargeras,192,evoker,devastation,6,2,4
13694,Critqueenx,destromath,192,evoker,devastation,6,2,4
13695,Nitalash,moon-guard,192,evoker,devastation,6,2,4
13696,Dragboy,stormrage,192,evoker,devastation,6,2,4
13697,Dracorblaq,bleeding-hollow,192,evoker,devastation,6,2,4
13698,Doldorrii,terenas,192,evoker,devastation,6,2,4
13699,Hellasketchy,sargeras,192,evoker,devastation,6,2,4
13700,Lillbigd,bleeding-hollow,192,evoker,devastation,6,2,4
13701,Moorozond,zuljin,192,evoker,devastation,6,2,4
13702,Parachutes,kelthuzad,192,evoker,devastation,6,2,4
13703,Noxidian,moon-guard,192,evoker,devastation,6,2,4
13704,Rezoth,malganis,192,evoker,devastation,6,2,4
13705,Selocky,bleeding-hollow,192,evoker,devastation,6,2,4
13706,Guavomango,moon-guard,192,evoker,devastation,6,2,4
13707,Theyevokbuda,kelthuzad,192,evoker,devastation,6,2,4
13708,Analogies,stormrage,192,evoker,devastation,6,2,4
13709,Pocketgiga,stormrage,192,evoker,devastation,6,2,4
13710,Cyromancerr,illidan,192,evoker,devastation,8,2,6
13711,Blueblack,proudmoore,192,evoker,devastation,12,2,10
13712,Chillistraza,tichondrius,192,evoker,devastation,12,2,10
13713,Dragonbornhd,tichondrius,192,evoker,devastation,12,2,10
13714,Detralan,draka,192,evoker,devastation,12,2,10
13715,Bitormu,scilla,192,evoker,devastation,12,2,10
13716,Valkarie,arygos,192,evoker,devastation,12,2,10
13717,Ragtharion,tichondrius,192,evoker,devastation,12,2,10
13718,Niraller,tichondrius,192,evoker,devastation,12,2,10
13719,Kuthar,barthilas,192,evoker,devastation,12,2,10
13720,Sørrøw,blades-edge,192,evoker,devastation,18,2,16
13721,Tevvez,moon-guard,159,evoker,devastation,5,2,3
13722,Skaylee,illidan,144,evoker,devastation,9,2,7
13723,Deshalth,dalaran,138,evoker,devastation,11,5,6
13724,Platypus,tichondrius,138,evoker,devastation,11,4,7
13725,Deathflamee,emerald-dream,138,evoker,devastation,12,3,9
13726,Eleechee,magtheridon,128,evoker,devastation,4,2,2
13727,Vïtmercon,frostmourne,128,evoker,devastation,4,2,2
13728,Shunkagosa,frostmourne,128,evoker,devastation,4,2,2
13729,Booniejimbob,illidan,128,evoker,devastation,4,2,2
13730,Vormontis,azralon,112,evoker,devastation,7,2,5
13731,Gavstarz,frostmourne,96,evoker,devastation,3,2,1
13732,Tugmapvpean,kelthuzad,96,evoker,devastation,3,2,1
13733,Warchad,stormrage,96,evoker,devastation,6,1,5
13734,Ackonstraza,frostmourne,96,evoker,devastation,6,1,5
13735,Asui,senjin,96,evoker,devastation,6,1,5
13736,Ojigi,sargeras,96,evoker,devastation,6,1,5
13737,Drakkar,elune,96,evoker,devastation,6,1,5
13738,Skithyrix,bleeding-hollow,96,evoker,devastation,6,1,5
13739,Nuppsy,frostmourne,96,evoker,devastation,6,1,5
13740,Selfhealzer,korgath,96,evoker,devastation,6,1,5
13741,Luceryz,drakkari,96,evoker,devastation,6,1,5
13742,Ocd,stormrage,96,evoker,devastation,6,1,5
13743,Erathiss,wyrmrest-accord,96,evoker,devastation,6,1,5
13744,Batterypowa,frostmourne,96,evoker,devastation,6,1,5
13745,Kazadon,icecrown,96,evoker,devastation,6,1,5
13746,Bløssom,malganis,96,evoker,devastation,6,1,5
13747,Trogs,emerald-dream,96,evoker,devastation,6,1,5
13748,Demobreath,sargeras,96,evoker,devastation,6,1,5
13749,Repd,sargeras,96,evoker,devastation,6,1,5
13750,Charrio,illidan,96,evoker,devastation,6,1,5
13751,Zinderaz,runetotem,96,evoker,devastation,6,1,5
13752,Myjewelshurt,stormrage,96,evoker,devastation,6,1,5
13753,Handb,tichondrius,96,evoker,devastation,6,1,5
13754,Zealagon,ragnaros,96,evoker,devastation,6,1,5
13755,Proust,grizzly-hills,96,evoker,devastation,6,1,5
13756,Leralan,illidan,96,evoker,devastation,6,1,5
13757,Modenzu,malganis,96,evoker,devastation,6,1,5
13758,Sneekysnekz,tichondrius,96,evoker,devastation,6,1,5
13759,Ðrac,bleeding-hollow,96,evoker,devastation,6,1,5
13760,Fígment,tichondrius,96,evoker,devastation,6,1,5
13761,Chocamocos,area-52,96,evoker,devastation,6,1,5
13762,Shintrax,ragnaros,96,evoker,devastation,6,1,5
13763,Rojothyr,tichondrius,96,evoker,devastation,6,1,5
13764,Happyevoker,tichondrius,96,evoker,devastation,6,1,5
13765,Lucià,thrall,96,evoker,devastation,6,1,5
13766,Sigroux,area-52,96,evoker,devastation,6,1,5
13767,Donormi,moon-guard,96,evoker,devastation,12,1,11
13768,Ysondrius,durotan,96,evoker,devastation,12,1,11
13769,Carnosaur,lightbringer,96,evoker,devastation,12,1,11
13770,Bigwurrm,illidan,96,evoker,devastation,12,1,11
13771,Icedmochaa,thrall,96,evoker,devastation,12,1,11
13772,Colloc,tichondrius,96,evoker,devastation,12,1,11
13773,Rathend,lothar,96,evoker,devastation,12,1,11
13774,Embeka,illidan,95,evoker,devastation,6,1,5
13775,Coped,stormrage,79,evoker,devastation,5,1,4
13776,Nwo,shattered-hand,64,evoker,devastation,4,1,3
13777,Starkiller,stormrage,64,evoker,devastation,4,1,3
13778,Alkden,azralon,63,evoker,devastation,2,2,0
13779,Nyxtari,ragnaros,48,evoker,devastation,3,1,2
13780,Charlestrasz,hyjal,42,evoker,devastation,11,3,8
13781,Ytq,tichondrius,42,evoker,devastation,10,2,8
13782,Remisha,emerald-dream,2136,hunter,marksmanship,82,44,38
13783,Darkshady,tichondrius,2108,hunter,marksmanship,84,44,40
13784,Chadsmanship,kelthuzad,2103,hunter,marksmanship,98,47,51
13785,Dobarantu,tichondrius,2044,hunter,marksmanship,175,90,85
13786,Rendel,drakkari,2035,hunter,marksmanship,201,102,99
13787,Abolick,area-52,2022,hunter,marksmanship,130,68,62
13788,Imvalence,area-52,2003,hunter,marksmanship,124,59,65
13789,Fuknhunter,kiljaeden,1905,hunter,marksmanship,110,56,54
13790,Wmsgs,tichondrius,1888,hunter,marksmanship,109,57,52
13791,Banshee,frostmourne,1886,hunter,marksmanship,40,24,16
13792,Rakan,spinebreaker,1884,hunter,marksmanship,54,33,21
13793,Bøl,ragnaros,1882,hunter,marksmanship,30,20,10
13794,Hokutox,tichondrius,1870,hunter,marksmanship,68,31,37
13795,Drupert,tichondrius,1869,hunter,marksmanship,36,20,16
13796,Blackjesu,blackrock,1868,hunter,marksmanship,72,33,39
13797,Zumago,tichondrius,1867,hunter,marksmanship,111,59,52
13798,Kensho,illidan,1864,hunter,marksmanship,77,45,32
13799,Hrafn,illidan,1859,hunter,marksmanship,60,31,29
13800,Babyhydra,frostmourne,1858,hunter,marksmanship,65,32,33
13801,Preze,moon-guard,1852,hunter,marksmanship,63,37,26
13802,Squawkers,sargeras,1848,hunter,marksmanship,78,43,35
13803,Astolenis,quelthalas,1847,hunter,marksmanship,60,29,31
13804,Moonwind,tichondrius,1836,hunter,marksmanship,65,31,34
13805,Takeiya,zuljin,1830,hunter,marksmanship,59,30,29
13806,Globalcake,illidan,1828,hunter,marksmanship,180,91,89
13807,Hâwkêyê,thrall,1827,hunter,marksmanship,48,22,26
13808,Iconvoked,sargeras,1816,hunter,marksmanship,214,110,104
13809,Ingrutamig,tichondrius,1814,hunter,marksmanship,66,32,34
13810,Colada,malganis,1813,hunter,marksmanship,72,34,38
13811,Bosshunter,tichondrius,1810,hunter,marksmanship,86,43,43
13812,Nishinos,tichondrius,1808,hunter,marksmanship,183,88,95
13813,Kristemis,thrall,1806,hunter,marksmanship,57,30,27
13814,Renaître,tichondrius,1806,hunter,marksmanship,126,58,68
13815,Tánsøxøxø,tichondrius,1805,hunter,marksmanship,60,30,30
13816,Czeroenjoyer,malganis,1803,hunter,marksmanship,66,33,33
13817,Lely,tichondrius,1800,hunter,marksmanship,72,38,34
13818,Trapordíe,tichondrius,1800,hunter,marksmanship,42,21,21
13819,Supersaiyan,antonidas,1797,hunter,marksmanship,60,28,32
13820,Comebacks,ragnaros,1789,hunter,marksmanship,64,34,30
13821,Drasen,deathwing,1778,hunter,marksmanship,48,27,21
13822,Khasu,ragnaros,1767,hunter,marksmanship,42,21,21
13823,Hagadinn,frostmourne,1765,hunter,marksmanship,48,21,27
13824,Landon,lightnings-blade,1759,hunter,marksmanship,42,24,18
13825,Alyywn,tichondrius,1758,hunter,marksmanship,143,70,73
13826,Dynith,sargeras,1756,hunter,marksmanship,39,21,18
13827,Undeadroach,tichondrius,1747,hunter,marksmanship,119,55,64
13828,Notnick,tichondrius,1747,hunter,marksmanship,84,37,47
13829,Shatterwax,area-52,1744,hunter,marksmanship,48,24,24
13830,Mapp,tichondrius,1736,hunter,marksmanship,30,20,10
13831,Overgnome,ragnaros,1736,hunter,marksmanship,66,32,34
13832,Deutêr,quelthalas,1734,hunter,marksmanship,78,39,39
13833,Boquiinha,stormrage,1732,hunter,marksmanship,114,57,57
13834,Trapstar,aggramar,1729,hunter,marksmanship,74,43,31
13835,Maximos,lightnings-blade,1720,hunter,marksmanship,150,75,75
13836,Dudemanyeah,skullcrusher,1720,hunter,marksmanship,66,26,40
13837,Primalus,tichondrius,1717,hunter,marksmanship,36,18,18
13838,Ladderpolice,tichondrius,1716,hunter,marksmanship,91,49,42
13839,Kkoduckk,tichondrius,1715,hunter,marksmanship,30,19,11
13840,Gohan,jubeithos,1713,hunter,marksmanship,39,22,17
13841,Dolcece,tichondrius,1713,hunter,marksmanship,48,24,24
13842,Nãmki,tichondrius,1710,hunter,marksmanship,48,32,16
13843,Stormjin,arthas,1703,hunter,marksmanship,60,32,28
13844,Quickitty,proudmoore,1703,hunter,marksmanship,148,73,75
13845,Heädshöt,malorne,1699,hunter,marksmanship,78,38,40
13846,Brewster,burning-legion,1692,hunter,marksmanship,42,22,20
13847,Doves,wyrmrest-accord,1685,hunter,marksmanship,66,38,28
13848,Onemoreshot,bleeding-hollow,1678,hunter,marksmanship,212,105,107
13849,Killatrap,malganis,1677,hunter,marksmanship,42,23,19
13850,Dracõ,proudmoore,1674,hunter,marksmanship,128,67,61
13851,Ekzoo,tichondrius,1672,hunter,marksmanship,34,21,13
13852,Petattack,barthilas,1668,hunter,marksmanship,42,20,22
13853,Tassili,illidan,1666,hunter,marksmanship,60,23,37
13854,Vitekz,illidan,1665,hunter,marksmanship,36,25,11
13855,Aueria,kiljaeden,1664,hunter,marksmanship,66,29,37
13856,Mhd,stormrage,1661,hunter,marksmanship,59,23,36
13857,Drivebymac,tichondrius,1660,hunter,marksmanship,90,47,43
13858,Tren,blackrock,1657,hunter,marksmanship,41,21,20
13859,Milae,frostmourne,1652,hunter,marksmanship,54,24,30
13860,Huntkiller,tichondrius,1651,hunter,marksmanship,40,29,11
13861,Gotchã,area-52,1650,hunter,marksmanship,42,27,15
13862,Yønkøu,azralon,1647,hunter,marksmanship,68,31,37
13863,Valdra,aegwynn,1646,hunter,marksmanship,36,23,13
13864,Aymas,sargeras,1646,hunter,marksmanship,125,65,60
13865,Beldhur,archimonde,1641,hunter,marksmanship,53,23,30
13866,Barelyknower,area-52,1639,hunter,marksmanship,90,44,46
13867,Wildder,area-52,1637,hunter,marksmanship,62,35,27
13868,Learn,sargeras,1635,hunter,marksmanship,54,31,23
13869,Surprisemfkr,emerald-dream,1635,hunter,marksmanship,78,39,39
13870,Venerer,tichondrius,1630,hunter,marksmanship,43,22,21
13871,Blaðe,kelthuzad,1629,hunter,marksmanship,206,95,111
13872,Bigpie,daggerspine,1628,hunter,marksmanship,59,37,22
13873,Neverhunter,azralon,1628,hunter,marksmanship,41,22,19
13874,Taylormadae,frostmourne,1627,hunter,marksmanship,66,37,29
13875,Elfymcelf,arthas,1626,hunter,marksmanship,102,52,50
13876,Shawtytraps,tichondrius,1626,hunter,marksmanship,155,64,91
13877,Arjunå,sargeras,1621,hunter,marksmanship,101,56,45
13878,Easynightjr,bleeding-hollow,1620,hunter,marksmanship,225,117,108
13879,Xcw,stormrage,1619,hunter,marksmanship,60,28,32
13880,Alansho,tichondrius,1618,hunter,marksmanship,53,20,33
13881,Tânsøxøxø,tichondrius,1617,hunter,marksmanship,30,17,13
13882,Latesummer,tichondrius,1616,hunter,marksmanship,48,25,23
13883,Blungo,azralon,1616,hunter,marksmanship,95,45,50
13884,Johaylon,sargeras,1616,hunter,marksmanship,42,19,23
13885,Bwaa,illidan,1614,hunter,marksmanship,119,62,57
13886,Dezertpower,sargeras,1613,hunter,marksmanship,36,20,16
13887,Junglejam,elune,1613,hunter,marksmanship,70,34,36
13888,Slantedshot,coilfang,1613,hunter,marksmanship,90,36,54
13889,Darance,sargeras,1612,hunter,marksmanship,40,22,18
13890,Snìpershot,sargeras,1612,hunter,marksmanship,61,33,28
13891,Shotashot,area-52,1612,hunter,marksmanship,36,17,19
13892,Hhappy,tichondrius,1612,hunter,marksmanship,66,27,39
13893,Headshoot,tichondrius,1611,hunter,marksmanship,65,35,30
13894,Toxarch,aggramar,1610,hunter,marksmanship,66,28,38
13895,Tommychong,shandris,1609,hunter,marksmanship,64,31,33
13896,Arrowslol,stormrage,1608,hunter,marksmanship,60,32,28
13897,Simbagrove,dalaran,1605,hunter,marksmanship,42,19,23
13898,Evaelfi,illidan,1605,hunter,marksmanship,40,17,23
13899,Tropic,proudmoore,1605,hunter,marksmanship,80,31,49
13900,Hyyz,proudmoore,1604,hunter,marksmanship,36,22,14
13901,Timmee,bleeding-hollow,1603,hunter,marksmanship,40,24,16
13902,Spunky,zuluhed,1597,hunter,marksmanship,48,23,25
13903,Deadshöt,bleeding-hollow,1597,hunter,marksmanship,59,26,33
13904,Gor,hyjal,1594,hunter,marksmanship,53,25,28
13905,Shootipie,hyjal,1593,hunter,marksmanship,28,20,8
13906,Itsgma,shandris,1591,hunter,marksmanship,36,21,15
13907,Tyrmaakk,emerald-dream,1581,hunter,marksmanship,46,25,21
13908,Freezetrap,proudmoore,1579,hunter,marksmanship,33,20,13
13909,Orber,stormrage,1579,hunter,marksmanship,36,20,16
13910,Mambothehunt,stormrage,1579,hunter,marksmanship,66,36,30
13911,Thebweh,ragnaros,1578,hunter,marksmanship,53,24,29
13912,Dienasty,zuljin,1577,hunter,marksmanship,36,23,13
13913,Wìkkihx,emerald-dream,1577,hunter,marksmanship,59,31,28
13914,Undien,area-52,1576,hunter,marksmanship,42,22,20
13915,Markymarc,tichondrius,1575,hunter,marksmanship,41,17,24
13916,Flämma,azralon,1573,hunter,marksmanship,90,40,50
13917,Huntonthic,korgath,1571,hunter,marksmanship,68,34,34
13918,Hämhunter,stormrage,1569,hunter,marksmanship,60,38,22
13919,Hmh,burning-legion,1569,hunter,marksmanship,269,135,134
13920,Stimpblimp,jubeithos,1563,hunter,marksmanship,48,19,29
13921,Ssdslol,bleeding-hollow,1561,hunter,marksmanship,145,86,59
13922,Onemøreshot,bleeding-hollow,1561,hunter,marksmanship,108,54,54
13923,Crounzz,sargeras,1558,hunter,marksmanship,51,23,28
13924,Jubiscleudo,azralon,1557,hunter,marksmanship,103,46,57
13925,Rampagez,tichondrius,1555,hunter,marksmanship,36,19,17
13926,Ryukuzen,tichondrius,1551,hunter,marksmanship,48,20,28
13927,Bacchantress,tichondrius,1550,hunter,marksmanship,42,21,21
13928,Mukbangbj,terenas,1546,hunter,marksmanship,76,40,36
13929,Luchadoris,malganis,1544,hunter,marksmanship,72,36,36
13930,Kimghak,tichondrius,1544,hunter,marksmanship,67,30,37
13931,Rubinaldo,azralon,1543,hunter,marksmanship,36,18,18
13932,Biubiubiubiu,proudmoore,1540,hunter,marksmanship,54,32,22
13933,Skybourne,nemesis,1539,hunter,marksmanship,108,63,45
13934,Swagprince,skullcrusher,1537,hunter,marksmanship,58,34,24
13935,Zasnar,malganis,1537,hunter,marksmanship,36,19,17
13936,Artemyzz,tichondrius,1537,hunter,marksmanship,48,22,26
13937,Huntncheekz,kelthuzad,1534,hunter,marksmanship,76,38,38
13938,Metalgear,icecrown,1533,hunter,marksmanship,66,34,32
13939,Kusz,bleeding-hollow,1533,hunter,marksmanship,77,38,39
13940,Hitts,barthilas,1532,hunter,marksmanship,59,30,29
13941,Odin,goldrinn,1531,hunter,marksmanship,157,75,82
13942,Smokabombom,eredar,1530,hunter,marksmanship,34,18,16
13943,Zugbrained,illidan,1529,hunter,marksmanship,48,26,22
13944,Papiskrill,staghelm,1526,hunter,marksmanship,97,44,53
13945,Dykbuht,area-52,1523,hunter,marksmanship,48,25,23
13946,Dummorogh,stormrage,1522,hunter,marksmanship,120,55,65
13947,Wockqt,kiljaeden,1522,hunter,marksmanship,49,21,28
13948,Guacmec,tichondrius,1521,hunter,marksmanship,48,28,20
13949,Richmond,lightnings-blade,1521,hunter,marksmanship,66,30,36
13950,Unravel,tichondrius,1520,hunter,marksmanship,99,55,44
13951,Deliond,moon-guard,1520,hunter,marksmanship,210,108,102
13952,Gretress,azralon,1520,hunter,marksmanship,66,28,38
13953,Grands,tortheldrin,1519,hunter,marksmanship,54,26,28
13954,Lsily,tichondrius,1519,hunter,marksmanship,36,16,20
13955,Maia,frostwolf,1518,hunter,marksmanship,66,30,36
13956,Bowflexen,illidan,1518,hunter,marksmanship,42,19,23
13957,Balaria,tichondrius,1515,hunter,marksmanship,35,19,16
13958,Insanedabz,tichondrius,1515,hunter,marksmanship,72,35,37
13959,Gnomorecum,kiljaeden,1514,hunter,marksmanship,99,58,41
13960,Bowreckage,malganis,1514,hunter,marksmanship,74,41,33
13961,Legeye,malganis,1514,hunter,marksmanship,54,26,28
13962,Fatehunter,bleeding-hollow,1511,hunter,marksmanship,44,17,27
13963,Mehontar,area-52,1509,hunter,marksmanship,42,20,22
13964,Plopslopper,frostmourne,1508,hunter,marksmanship,60,31,29
13965,Sagadegêmeos,stormrage,1508,hunter,marksmanship,91,35,56
13966,Lokuhzmarcus,goldrinn,1507,hunter,marksmanship,66,39,27
13967,Lilbang,thrall,1507,hunter,marksmanship,75,34,41
13968,Boggartt,ragnaros,1507,hunter,marksmanship,58,26,32
13969,Shotsphodays,sargeras,1506,hunter,marksmanship,90,45,45
13970,Lostfaith,tichondrius,1504,hunter,marksmanship,66,36,30
13971,Rïve,tichondrius,1504,hunter,marksmanship,36,17,19
13972,Adive,drakkari,1503,hunter,marksmanship,91,43,48
13973,Marshen,zuljin,1503,hunter,marksmanship,36,17,19
13974,Saloran,akama,1502,hunter,marksmanship,102,55,47
13975,Tup,guldan,1499,hunter,marksmanship,51,28,23
13976,Amyrkvothe,ragnaros,1499,hunter,marksmanship,60,25,35
13977,Lixniqua,tichondrius,1498,hunter,marksmanship,75,38,37
13978,Bertimus,sargeras,1498,hunter,marksmanship,42,17,25
13979,Tråppin,sargeras,1495,hunter,marksmanship,51,27,24
13980,Papacohen,stormrage,1495,hunter,marksmanship,45,22,23
13981,Swayshunt,area-52,1495,hunter,marksmanship,46,22,24
13982,Lildex,demon-soul,1494,hunter,marksmanship,30,18,12
13983,Föcker,emerald-dream,1492,hunter,marksmanship,25,19,6
13984,Stfd,illidan,1490,hunter,marksmanship,24,17,7
13985,Esler,quelthalas,1490,hunter,marksmanship,54,28,26
13986,Ocromiun,illidan,1490,hunter,marksmanship,57,19,38
13987,Larree,kelthuzad,1489,hunter,marksmanship,30,21,9
13988,Ðaybreâker,tichondrius,1489,hunter,marksmanship,49,29,20
13989,Yozsh,azralon,1485,hunter,marksmanship,47,32,15
13990,Pâl,quelthalas,1481,hunter,marksmanship,42,21,21
13991,Rudekeef,illidan,1478,hunter,marksmanship,36,17,19
13992,Boomphaque,ravencrest,1476,hunter,marksmanship,132,63,69
13993,Metalstorm,draenor,1476,hunter,marksmanship,41,19,22
13994,Booyakah,hyjal,1475,hunter,marksmanship,36,19,17
13995,Windrein,ysondre,1475,hunter,marksmanship,48,20,28
13996,Barrohunt,tichondrius,1473,hunter,marksmanship,49,31,18
13997,Somethinggo,tichondrius,1472,hunter,marksmanship,161,77,84
13998,Artois,tichondrius,1471,hunter,marksmanship,40,18,22
13999,Scourgesurge,kiljaeden,1470,hunter,marksmanship,42,21,21
14000,Cloudzbow,moon-guard,1470,hunter,marksmanship,40,18,22
14001,Kekkww,hyjal,1469,hunter,marksmanship,54,26,28
14002,Killshøtß,tichondrius,1466,hunter,marksmanship,54,25,29
14003,Infinitý,zuljin,1465,hunter,marksmanship,59,27,32
14004,Hötdôg,kiljaeden,1464,hunter,marksmanship,48,23,25
14005,Lowlore,moon-guard,1463,hunter,marksmanship,96,52,44
14006,Pwnagraphic,barthilas,1463,hunter,marksmanship,82,36,46
14007,Shadowhokage,zuljin,1461,hunter,marksmanship,56,30,26
14008,Zeenuts,sargeras,1461,hunter,marksmanship,47,24,23
14009,Renzô,sargeras,1459,hunter,marksmanship,88,51,37
14010,Angelickon,tichondrius,1459,hunter,marksmanship,62,29,33
14011,Bomomatic,zuljin,1457,hunter,marksmanship,42,24,18
14012,Valimhir,tichondrius,1457,hunter,marksmanship,57,25,32
14013,Tòxophilite,tichondrius,1456,hunter,marksmanship,74,28,46
14014,Nelosi,shadowmoon,1455,hunter,marksmanship,54,25,29
14015,Cyrsmen,ragnaros,1454,hunter,marksmanship,81,37,44
14016,Finaqua,sargeras,1452,hunter,marksmanship,38,17,21
14017,Grayføxx,twisting-nether,1451,hunter,marksmanship,60,34,26
14018,Rockenrique,nemesis,1451,hunter,marksmanship,60,28,32
14019,Pkn,chogall,1450,hunter,marksmanship,60,27,33
14020,Tóri,emerald-dream,1445,hunter,marksmanship,47,25,22
14021,Hemathios,drakkari,1442,hunter,marksmanship,50,21,29
14022,Rumzi,thrall,1441,hunter,marksmanship,102,57,45
14023,Backpedalftw,darrowmere,1440,hunter,marksmanship,42,16,26
14024,Katebishop,nemesis,1438,hunter,marksmanship,28,18,10
14025,Jotosalsa,blackrock,1438,hunter,marksmanship,60,30,30
14026,Stupidgodx,tichondrius,1437,hunter,marksmanship,48,25,23
14027,Klitz,lightninghoof,1436,hunter,marksmanship,30,18,12
14028,Pokcmvmxckm,senjin,1433,hunter,marksmanship,66,35,31
14029,Bootywhop,dalaran,1433,hunter,marksmanship,30,15,15
14030,Hunterlist,frostmourne,1433,hunter,marksmanship,36,15,21
14031,Allondra,proudmoore,1432,hunter,marksmanship,30,17,13
14032,Baixiaochu,area-52,1432,hunter,marksmanship,105,47,58
14033,Crazyeasy,azshara,1431,hunter,marksmanship,30,15,15
14034,Lewanker,zuljin,1429,hunter,marksmanship,42,23,19
14035,Vibøra,stormrage,1429,hunter,marksmanship,126,56,70
14036,Mèseeks,bleeding-hollow,1427,hunter,marksmanship,60,34,26
14037,Sï,anubarak,1425,hunter,marksmanship,42,19,23
14038,Cholohippie,blackrock,1424,hunter,marksmanship,55,30,25
14039,Vonkrieg,tichondrius,1424,hunter,marksmanship,42,15,27
14040,Chï,zuljin,1422,hunter,marksmanship,162,81,81
14041,Sleepyjoee,dalaran,1421,hunter,marksmanship,54,31,23
14042,Rorijii,tichondrius,1421,hunter,marksmanship,54,23,31
14043,Leucis,cenarius,1420,hunter,marksmanship,18,15,3
14044,Soljer,kiljaeden,1417,hunter,marksmanship,66,28,38
14045,Longshánks,stormrage,1416,hunter,marksmanship,30,15,15
14046,Cheetah,tichondrius,1415,hunter,marksmanship,30,15,15
14047,Boombob,sargeras,1415,hunter,marksmanship,59,27,32
14048,Shøtii,tichondrius,1414,hunter,marksmanship,40,21,19
14049,Hoboh,illidan,1414,hunter,marksmanship,117,58,59
14050,Vivaswan,tichondrius,1413,hunter,marksmanship,42,15,27
14051,Elendïr,tichondrius,1411,hunter,marksmanship,60,33,27
14052,Aimz,zuluhed,1411,hunter,marksmanship,73,29,44
14053,Feov,tichondrius,1410,hunter,marksmanship,24,15,9
14054,Vergillx,ragnaros,1409,hunter,marksmanship,74,45,29
14055,Toowizeë,barthilas,1409,hunter,marksmanship,59,27,32
14056,Klannis,quelthalas,1409,hunter,marksmanship,42,19,23
14057,Berkhof,tichondrius,1409,hunter,marksmanship,56,24,32
14058,Xcisiion,nagrand,1408,hunter,marksmanship,173,86,87
14059,Shootybooty,arygos,1407,hunter,marksmanship,42,15,27
14060,Lîvy,aerie-peak,1406,hunter,marksmanship,54,25,29
14061,Joshmckin,area-52,1406,hunter,marksmanship,116,53,63
14062,Mariaassjx,ragnaros,1406,hunter,marksmanship,102,46,56
14063,Javoj,drakkari,1405,hunter,marksmanship,30,15,15
14064,Automatic,illidan,1405,hunter,marksmanship,63,29,34
14065,Voidmarksman,whisperwind,1404,hunter,marksmanship,49,30,19
14066,Péppérmínt,korgath,1403,hunter,marksmanship,62,32,30
14067,Madsniper,thunderlord,1403,hunter,marksmanship,72,37,35
14068,Grànd,tortheldrin,1402,hunter,marksmanship,35,17,18
14069,Déadshot,thaurissan,1402,hunter,marksmanship,42,17,25
14070,Dsizzle,tichondrius,1400,hunter,marksmanship,44,18,26
14071,Audioannie,thrall,1395,hunter,marksmanship,36,18,18
14072,Jeezyxxii,shadowmoon,1395,hunter,marksmanship,86,40,46
14073,Nirika,moon-guard,1395,hunter,marksmanship,69,31,38
14074,Ashx,khazgoroth,1392,hunter,marksmanship,30,15,15
14075,Bodaki,proudmoore,1391,hunter,marksmanship,36,16,20
14076,Häydn,emerald-dream,1390,hunter,marksmanship,40,22,18
14077,Insulin,moonrunner,1390,hunter,marksmanship,36,17,19
14078,Littledougie,boulderfist,1388,hunter,marksmanship,90,47,43
14079,ßeãst,bladefist,1387,hunter,marksmanship,24,16,8
14080,Mù,frostmourne,1385,hunter,marksmanship,30,15,15
14081,Slayou,uldum,1383,hunter,marksmanship,69,37,32
14082,Lederniertra,gorefiend,1382,hunter,marksmanship,278,139,139
14083,Fuzzypjs,stormrage,1382,hunter,marksmanship,39,17,22
14084,Dnicee,stormrage,1380,hunter,marksmanship,42,30,12
14085,Tobroken,perenolde,1380,hunter,marksmanship,51,25,26
14086,Dreygar,dawnbringer,1379,hunter,marksmanship,36,15,21
14087,Gq,garona,1379,hunter,marksmanship,77,32,45
14088,Spacelandz,emerald-dream,1374,hunter,marksmanship,30,19,11
14089,Dominate,frostmourne,1374,hunter,marksmanship,48,23,25
14090,Hunsak,ragnaros,1373,hunter,marksmanship,30,20,10
14091,Húntingarrow,area-52,1373,hunter,marksmanship,72,36,36
14092,Precísion,malganis,1372,hunter,marksmanship,35,18,17
14093,Leshwi,ragnaros,1370,hunter,marksmanship,47,23,24
14094,Lookøut,moon-guard,1370,hunter,marksmanship,86,38,48
14095,Malebolick,ragnaros,1367,hunter,marksmanship,65,27,38
14096,Lukhas,moon-guard,1367,hunter,marksmanship,60,24,36
14097,Murderville,illidan,1366,hunter,marksmanship,54,27,27
14098,Chokemescara,stormrage,1364,hunter,marksmanship,36,16,20
14099,Worewolf,lightninghoof,1363,hunter,marksmanship,50,22,28
14100,Jumaanji,gurubashi,1362,hunter,marksmanship,70,36,34
14101,Amonerhunter,bleeding-hollow,1362,hunter,marksmanship,54,23,31
14102,Skelyeelegno,perenolde,1361,hunter,marksmanship,30,17,13
14103,Gorîlla,sargeras,1361,hunter,marksmanship,96,46,50
14104,Staticarrow,norgannon,1361,hunter,marksmanship,126,60,66
14105,Lotatinyfish,malganis,1360,hunter,marksmanship,54,32,22
14106,Glittergun,sargeras,1360,hunter,marksmanship,41,19,22
14107,Kronicbeast,bleeding-hollow,1360,hunter,marksmanship,96,42,54
14108,Phojuansixx,ghostlands,1359,hunter,marksmanship,50,28,22
14109,Trapshawty,darkspear,1359,hunter,marksmanship,54,19,35
14110,Chîll,frostmourne,1358,hunter,marksmanship,32,15,17
14111,Bowinc,greymane,1357,hunter,marksmanship,24,15,9
14112,Pleyadez,drakkari,1356,hunter,marksmanship,42,24,18
14113,Condorexe,illidan,1356,hunter,marksmanship,90,39,51
14114,Ghudi,moon-guard,1354,hunter,marksmanship,39,21,18
14115,Gothew,turalyon,1353,hunter,marksmanship,66,37,29
14116,Picaubica,kiljaeden,1353,hunter,marksmanship,53,24,29
14117,Acelol,proudmoore,1351,hunter,marksmanship,223,116,107
14118,Watchmanjoe,grizzly-hills,1350,hunter,marksmanship,54,30,24
14119,Kolosaltraps,tichondrius,1349,hunter,marksmanship,33,16,17
14120,Kyukon,illidan,1345,hunter,marksmanship,36,18,18
14121,Diisdik,tichondrius,1344,hunter,marksmanship,51,23,28
14122,Mizhu,ragnaros,1343,hunter,marksmanship,70,38,32
14123,Hurstt,kelthuzad,1341,hunter,marksmanship,56,27,29
14124,Fartingshot,proudmoore,1339,hunter,marksmanship,89,41,48
14125,Toniic,moon-guard,1337,hunter,marksmanship,54,33,21
14126,Dexteros,ragnaros,1337,hunter,marksmanship,66,33,33
14127,Wìllòw,khazgoroth,1337,hunter,marksmanship,48,18,30
14128,Misakilr,sargeras,1336,hunter,marksmanship,18,14,4
14129,Unclepez,barthilas,1336,hunter,marksmanship,18,14,4
14130,Orgpopeyes,illidan,1336,hunter,marksmanship,24,14,10
14131,Dvei,silvermoon,1336,hunter,marksmanship,57,25,32
14132,Cashhapp,zuljin,1335,hunter,marksmanship,201,100,101
14133,Cablok,moon-guard,1335,hunter,marksmanship,30,14,16
14134,Photos,moon-guard,1334,hunter,marksmanship,20,14,6
14135,Boradin,lightbringer,1333,hunter,marksmanship,24,18,6
14136,Thaden,akama,1332,hunter,marksmanship,65,34,31
14137,Blackhuntr,garona,1331,hunter,marksmanship,264,135,129
14138,Booffmeister,area-52,1329,hunter,marksmanship,30,14,16
14139,Dathunterr,azralon,1329,hunter,marksmanship,95,44,51
14140,Moktarg,archimonde,1328,hunter,marksmanship,53,23,30
14141,Sindain,bloodscalp,1327,hunter,marksmanship,36,20,16
14142,Tonnyfab,ragnaros,1326,hunter,marksmanship,34,19,15
14143,Bigolhippy,frostmourne,1326,hunter,marksmanship,36,18,18
14144,Uwuessy,illidan,1325,hunter,marksmanship,72,32,40
14145,Bojob,azgalor,1324,hunter,marksmanship,63,34,29
14146,Azaz,khaz-modan,1324,hunter,marksmanship,59,27,32
14147,Softhunter,tichondrius,1324,hunter,marksmanship,36,14,22
14148,Murza,korgath,1323,hunter,marksmanship,24,15,9
14149,Xhartanis,magtheridon,1323,hunter,marksmanship,63,31,32
14150,Purpurkle,area-52,1322,hunter,marksmanship,60,31,29
14151,Kä,blackhand,1321,hunter,marksmanship,66,28,38
14152,Ärtémisa,quelthalas,1320,hunter,marksmanship,41,22,19
14153,Tristiae,stormrage,1319,hunter,marksmanship,67,36,31
14154,Swolfp,tichondrius,1319,hunter,marksmanship,58,23,35
14155,Ilina,malorne,1317,hunter,marksmanship,24,14,10
14156,Benme,illidan,1317,hunter,marksmanship,251,116,135
14157,Dogezandalar,illidan,1317,hunter,marksmanship,40,18,22
14158,Explosief,area-52,1315,hunter,marksmanship,60,30,30
14159,Chuvug,quelthalas,1315,hunter,marksmanship,30,14,16
14160,Shooterzz,illidan,1314,hunter,marksmanship,24,16,8
14161,Zaheerz,sargeras,1312,hunter,marksmanship,36,16,20
14162,Smoothbrain,khadgar,1309,hunter,marksmanship,64,25,39
14163,Thirià,garona,1306,hunter,marksmanship,18,14,4
14164,Rekshot,amanthul,1306,hunter,marksmanship,150,73,77
14165,Grimcask,ragnaros,1305,hunter,marksmanship,33,15,18
14166,Wolverhino,thrall,1304,hunter,marksmanship,48,21,27
14167,Akomata,emerald-dream,1303,hunter,marksmanship,42,21,21
14168,Albe,azralon,1303,hunter,marksmanship,76,37,39
14169,Cocobread,stormreaver,1303,hunter,marksmanship,48,21,27
14170,Balun,sargeras,1303,hunter,marksmanship,66,28,38
14171,Oattes,daggerspine,1303,hunter,marksmanship,34,14,20
14172,Revo,darkspear,1301,hunter,marksmanship,30,14,16
14173,Snewboy,malganis,1299,hunter,marksmanship,24,14,10
14174,Celph,moon-guard,1299,hunter,marksmanship,48,20,28
14175,Cullowhee,proudmoore,1299,hunter,marksmanship,35,14,21
14176,Gunther,korgath,1296,hunter,marksmanship,30,14,16
14177,Ahegoface,frostmourne,1295,hunter,marksmanship,60,21,39
14178,Mensrea,illidan,1294,hunter,marksmanship,47,30,17
14179,Hukkx,kalecgos,1294,hunter,marksmanship,56,24,32
14180,Urtthel,stormrage,1293,hunter,marksmanship,28,17,11
14181,Krattøs,bleeding-hollow,1293,hunter,marksmanship,34,16,18
14182,Itryharder,stormrage,1289,hunter,marksmanship,30,18,12
14183,Glediator,tichondrius,1288,hunter,marksmanship,112,51,61
14184,Duruainn,zuljin,1286,hunter,marksmanship,88,42,46
14185,Ricas,malganis,1285,hunter,marksmanship,104,46,58
14186,Kalibah,azralon,1285,hunter,marksmanship,81,30,51
14187,Leeshaarrow,moon-guard,1284,hunter,marksmanship,36,17,19
14188,Juhyeon,tichondrius,1284,hunter,marksmanship,46,17,29
14189,Ripmytoast,chogall,1281,hunter,marksmanship,187,101,86
14190,Kìkìjiki,emerald-dream,1281,hunter,marksmanship,30,16,14
14191,Gromtheponch,area-52,1280,hunter,marksmanship,43,22,21
14192,Braxigarr,area-52,1280,hunter,marksmanship,229,108,121
14193,Vipermaster,azralon,1278,hunter,marksmanship,52,28,24
14194,Rawrzy,sargeras,1278,hunter,marksmanship,29,14,15
14195,Jenniekim,mugthol,1277,hunter,marksmanship,25,16,9
14196,Tîpz,stormrage,1275,hunter,marksmanship,29,17,12
14197,Clutchxx,tichondrius,1275,hunter,marksmanship,24,14,10
14198,Sniperarmy,dalaran,1274,hunter,marksmanship,103,52,51
14199,Spiketurtle,queldorei,1274,hunter,marksmanship,54,27,27
14200,Darylovejr,destromath,1274,hunter,marksmanship,38,16,22
14201,Microshotz,windrunner,1273,hunter,marksmanship,24,15,9
14202,Doug,illidan,1273,hunter,marksmanship,24,14,10
14203,Targetreaper,proudmoore,1273,hunter,marksmanship,90,44,46
14204,Nights,nemesis,1271,hunter,marksmanship,24,15,9
14205,Hunimi,elune,1270,hunter,marksmanship,38,16,22
14206,Escolhido,azralon,1269,hunter,marksmanship,71,36,35
14207,Kritsu,tichondrius,1266,hunter,marksmanship,53,28,25
14208,Spyhunter,malganis,1266,hunter,marksmanship,67,28,39
14209,Xephert,ragnaros,1265,hunter,marksmanship,48,22,26
14210,Birgite,stormrage,1265,hunter,marksmanship,54,21,33
14211,Cloudbuck,aegwynn,1262,hunter,marksmanship,58,22,36
14212,Deathhshott,area-52,1260,hunter,marksmanship,35,20,15
14213,Brokenstars,illidan,1254,hunter,marksmanship,72,35,37
14214,Ongorn,lightninghoof,1254,hunter,marksmanship,48,23,25
14215,Shuweet,moon-guard,1254,hunter,marksmanship,42,16,26
14216,Jerybery,gundrak,1253,hunter,marksmanship,29,18,11
14217,Igopew,firetree,1253,hunter,marksmanship,36,16,20
14218,Snaafu,duskwood,1252,hunter,marksmanship,42,17,25
14219,Ragnarlobkk,ragnaros,1251,hunter,marksmanship,107,54,53
14220,Infamousorc,chogall,1251,hunter,marksmanship,82,36,46
14221,Solomine,jubeithos,1251,hunter,marksmanship,36,15,21
14222,Rattrap,proudmoore,1250,hunter,marksmanship,41,18,23
14223,Eilleath,zuljin,1249,hunter,marksmanship,24,15,9
14224,Gstring,kelthuzad,1248,hunter,marksmanship,157,71,86
14225,Ëzy,frostmourne,1246,hunter,marksmanship,66,36,30
14226,Zota,frostmourne,1245,hunter,marksmanship,24,13,11
14227,Hoeswannafuk,stormrage,1243,hunter,marksmanship,24,13,11
14228,Hogshanks,moon-guard,1242,hunter,marksmanship,24,13,11
14229,Seenobody,stormrage,1242,hunter,marksmanship,106,54,52
14230,Loth,illidan,1239,hunter,marksmanship,28,15,13
14231,Lafleche,kiljaeden,1239,hunter,marksmanship,29,15,14
14232,Critaclyzm,moon-guard,1238,hunter,marksmanship,49,22,27
14233,Islachan,ragnaros,1238,hunter,marksmanship,30,13,17
14234,Imineore,stormrage,1238,hunter,marksmanship,36,15,21
14235,Sootgarbage,sargeras,1235,hunter,marksmanship,18,13,5
14236,Pokeyourbutt,hydraxis,1235,hunter,marksmanship,24,13,11
14237,Wincolt,stormrage,1235,hunter,marksmanship,30,13,17
14238,Tonichype,tichondrius,1235,hunter,marksmanship,30,13,17
14239,Aqurandris,moon-guard,1234,hunter,marksmanship,18,13,5
14240,Killz,skullcrusher,1234,hunter,marksmanship,44,21,23
14241,Drillklinton,tichondrius,1234,hunter,marksmanship,47,20,27
14242,Lolknocked,alexstrasza,1233,hunter,marksmanship,27,14,13
14243,Amsalja,tichondrius,1232,hunter,marksmanship,54,28,26
14244,Chikkynuggy,destromath,1228,hunter,marksmanship,33,14,19
14245,Mlzj,tichondrius,1225,hunter,marksmanship,24,13,11
14246,Idiiot,sargeras,1223,hunter,marksmanship,68,33,35
14247,Huntmeplz,proudmoore,1221,hunter,marksmanship,30,14,16
14248,Stoopkid,dunemaul,1219,hunter,marksmanship,24,13,11
14249,Netorip,azralon,1219,hunter,marksmanship,39,17,22
14250,Drjingajanga,zuluhed,1218,hunter,marksmanship,39,16,23
14251,Caylix,sargeras,1216,hunter,marksmanship,36,14,22
14252,Sukr,korgath,1215,hunter,marksmanship,98,37,61
14253,Bärney,frostmourne,1214,hunter,marksmanship,24,13,11
14254,Give,draktharon,1214,hunter,marksmanship,33,14,19
14255,Tandope,sargeras,1213,hunter,marksmanship,35,13,22
14256,Malkuri,medivh,1213,hunter,marksmanship,35,13,22
14257,Puresport,hyjal,1212,hunter,marksmanship,24,13,11
14258,Hyü,hyjal,1211,hunter,marksmanship,30,13,17
14259,Coolwhip,demon-soul,1209,hunter,marksmanship,46,22,24
14260,Calî,stormscale,1209,hunter,marksmanship,36,17,19
14261,Äce,khazgoroth,1208,hunter,marksmanship,30,13,17
14262,Rocroc,gurubashi,1205,hunter,marksmanship,72,33,39
14263,Volga,haomarush,1204,hunter,marksmanship,58,29,29
14264,Augus,eredar,1202,hunter,marksmanship,41,15,26
14265,Kalgorn,emerald-dream,1200,hunter,marksmanship,30,13,17
14266,Bowtech,kelthuzad,1198,hunter,marksmanship,37,17,20
14267,Wwing,frostwolf,1197,hunter,marksmanship,316,161,155
14268,Vinranya,sargeras,1194,hunter,marksmanship,75,34,41
14269,Lightweight,kelthuzad,1194,hunter,marksmanship,59,26,33
14270,Moonet,amanthul,1192,hunter,marksmanship,29,16,13
14271,Chaðs,amanthul,1190,hunter,marksmanship,39,21,18
14272,Moüserat,moon-guard,1190,hunter,marksmanship,138,68,70
14273,Kayzia,lightninghoof,1190,hunter,marksmanship,29,13,16
14274,Valieev,black-dragonflight,1188,hunter,marksmanship,42,25,17
14275,Ilovehippos,laughing-skull,1188,hunter,marksmanship,145,67,78
14276,Forthethrill,area-52,1187,hunter,marksmanship,45,24,21
14277,Oopsurtrappd,darkspear,1186,hunter,marksmanship,29,16,13
14278,Juicyjams,moon-guard,1186,hunter,marksmanship,24,13,11
14279,Lavaun,eredar,1185,hunter,marksmanship,36,17,19
14280,Trikshot,magtheridon,1183,hunter,marksmanship,30,15,15
14281,Hokutoxx,tichondrius,1182,hunter,marksmanship,32,13,19
14282,Myrfes,ragnaros,1182,hunter,marksmanship,58,21,37
14283,Zock,lothar,1181,hunter,marksmanship,158,76,82
14284,Ramdy,quelthalas,1180,hunter,marksmanship,30,14,16
14285,Fova,wyrmrest-accord,1179,hunter,marksmanship,19,14,5
14286,Doubletappz,stormreaver,1178,hunter,marksmanship,36,15,21
14287,Chïnchïlla,zuljin,1176,hunter,marksmanship,27,14,13
14288,Silverweaver,illidan,1174,hunter,marksmanship,30,15,15
14289,Ellishunter,frostmourne,1174,hunter,marksmanship,64,23,41
14290,Taynen,azralon,1173,hunter,marksmanship,29,13,16
14291,Tweak,ysera,1172,hunter,marksmanship,24,13,11
14292,Guarambare,ragnaros,1172,hunter,marksmanship,39,15,24
14293,Mathund,gurubashi,1171,hunter,marksmanship,173,83,90
14294,Aftërlyfe,tichondrius,1170,hunter,marksmanship,29,14,15
14295,Foxhe,hyjal,1167,hunter,marksmanship,54,29,25
14296,Patmypet,terenas,1167,hunter,marksmanship,30,14,16
14297,Mezmore,thrall,1167,hunter,marksmanship,54,24,30
14298,Jordanhunter,frostmourne,1167,hunter,marksmanship,35,14,21
14299,Papiquezo,nagrand,1165,hunter,marksmanship,27,14,13
14300,Clemenlemon,illidan,1162,hunter,marksmanship,36,19,17
14301,Richihunt,ragnaros,1161,hunter,marksmanship,44,16,28
14302,Mídnîght,azralon,1161,hunter,marksmanship,39,14,25
14303,Loathin,stormrage,1160,hunter,marksmanship,18,13,5
14304,Miscreant,kelthuzad,1160,hunter,marksmanship,32,13,19
14305,Cu,frostmourne,1159,hunter,marksmanship,19,13,6
14306,Sóny,area-52,1158,hunter,marksmanship,26,15,11
14307,Whatsleft,area-52,1155,hunter,marksmanship,34,17,17
14308,Enuk,nagrand,1155,hunter,marksmanship,109,51,58
14309,Tiofil,goldrinn,1154,hunter,marksmanship,42,23,19
14310,Rhaygon,arthas,1154,hunter,marksmanship,57,20,37
14311,Llachiip,zuljin,1153,hunter,marksmanship,29,14,15
14312,Chetta,ragnaros,1153,hunter,marksmanship,71,29,42
14313,Huntdawgg,illidan,1153,hunter,marksmanship,57,16,41
14314,Buckethole,doomhammer,1152,hunter,marksmanship,60,28,32
14315,Huataran,stormrage,1151,hunter,marksmanship,18,12,6
14316,Negãn,tichondrius,1151,hunter,marksmanship,24,12,12
14317,Sunnimuffens,deathwing,1150,hunter,marksmanship,53,25,28
14318,Summerrain,illidan,1149,hunter,marksmanship,18,12,6
14319,Floozyfairy,daggerspine,1149,hunter,marksmanship,65,32,33
14320,Zuuvuya,nemesis,1149,hunter,marksmanship,56,20,36
14321,Nes,azuremyst,1148,hunter,marksmanship,24,12,12
14322,Dsnowy,emerald-dream,1146,hunter,marksmanship,24,12,12
14323,Topshotx,tichondrius,1145,hunter,marksmanship,18,12,6
14324,Bullseated,nemesis,1145,hunter,marksmanship,24,12,12
14325,Sugarboyy,darkspear,1145,hunter,marksmanship,39,19,20
14326,Lilnatty,area-52,1143,hunter,marksmanship,33,13,20
14327,Desolater,bleeding-hollow,1143,hunter,marksmanship,36,12,24
14328,Brapdaddy,lightbringer,1142,hunter,marksmanship,30,12,18
14329,Inability,emerald-dream,1142,hunter,marksmanship,30,12,18
14330,Chainmaster,misha,1141,hunter,marksmanship,121,57,64
14331,Zachhunter,frostmourne,1141,hunter,marksmanship,54,20,34
14332,Òriòn,tichondrius,1141,hunter,marksmanship,36,12,24
14333,Zgabriel,azralon,1140,hunter,marksmanship,24,12,12
14334,Tenlbbow,illidan,1137,hunter,marksmanship,24,12,12
14335,Thundershots,tichondrius,1136,hunter,marksmanship,80,35,45
14336,Drewshot,sargeras,1134,hunter,marksmanship,18,12,6
14337,Nemmises,proudmoore,1134,hunter,marksmanship,24,12,12
14338,Mwprimus,darkspear,1134,hunter,marksmanship,25,12,13
14339,Vhan,azralon,1133,hunter,marksmanship,44,19,25
14340,Oqqo,tichondrius,1132,hunter,marksmanship,51,21,30
14341,Jarloo,madoran,1129,hunter,marksmanship,35,19,16
14342,Bumpf,malganis,1129,hunter,marksmanship,30,14,16
14343,Táká,quelthalas,1129,hunter,marksmanship,30,13,17
14344,Dandogg,tichondrius,1129,hunter,marksmanship,30,12,18
14345,Zøkøtrøkø,ragnaros,1128,hunter,marksmanship,39,17,22
14346,Abloodelf,zuljin,1128,hunter,marksmanship,30,12,18
14347,Minzuki,drakkari,1127,hunter,marksmanship,30,13,17
14348,Clockwörk,sargeras,1125,hunter,marksmanship,21,13,8
14349,Martlz,tichondrius,1125,hunter,marksmanship,24,12,12
14350,Amanazàra,tichondrius,1123,hunter,marksmanship,84,41,43
14351,Udietofast,illidan,1123,hunter,marksmanship,136,61,75
14352,Dest,azralon,1121,hunter,marksmanship,30,12,18
14353,Pikochon,illidan,1121,hunter,marksmanship,77,30,47
14354,Seyd,barthilas,1121,hunter,marksmanship,36,13,23
14355,Kanaká,moon-guard,1120,hunter,marksmanship,42,23,19
14356,Emeri,winterhoof,1119,hunter,marksmanship,60,31,29
14357,Linedalina,wyrmrest-accord,1119,hunter,marksmanship,30,14,16
14358,Bowdown,moon-guard,1118,hunter,marksmanship,60,30,30
14359,Starkmeister,stormrage,1118,hunter,marksmanship,30,12,18
14360,Onekz,ragnaros,1115,hunter,marksmanship,65,24,41
14361,Ackzar,ragnaros,1114,hunter,marksmanship,88,44,44
14362,Wixyy,aegwynn,1114,hunter,marksmanship,58,23,35
14363,Redskul,azralon,1113,hunter,marksmanship,36,19,17
14364,Yaboismokey,aerie-peak,1112,hunter,marksmanship,35,15,20
14365,Grimbleneep,emerald-dream,1111,hunter,marksmanship,40,16,24
14366,Ligmubhole,queldorei,1110,hunter,marksmanship,24,13,11
14367,Trìggered,dark-iron,1109,hunter,marksmanship,48,24,24
14368,Deadlyattack,barthilas,1108,hunter,marksmanship,24,12,12
14369,Repotro,drakkari,1108,hunter,marksmanship,42,14,28
14370,Aoolfs,stormrage,1107,hunter,marksmanship,72,32,40
14371,Raneldar,proudmoore,1107,hunter,marksmanship,167,70,97
14372,Halibut,quelthalas,1106,hunter,marksmanship,47,25,22
14373,Rykár,kiljaeden,1106,hunter,marksmanship,24,12,12
14374,Ryhew,emerald-dream,1106,hunter,marksmanship,36,15,21
14375,Benryats,area-52,1105,hunter,marksmanship,42,16,26
14376,Huuntard,proudmoore,1104,hunter,marksmanship,29,12,17
14377,Kánnah,ragnaros,1101,hunter,marksmanship,150,77,73
14378,Flacidhunter,kelthuzad,1101,hunter,marksmanship,36,16,20
14379,Týrak,illidan,1100,hunter,marksmanship,24,12,12
14380,Apaweclover,stormrage,1100,hunter,marksmanship,277,136,141
14381,Bentrick,altar-of-storms,1097,hunter,marksmanship,33,18,15
14382,Tanephar,proudmoore,1097,hunter,marksmanship,30,13,17
14383,Zombified,moon-guard,1094,hunter,marksmanship,23,12,11
14384,Killincrew,scilla,1093,hunter,marksmanship,50,23,27
14385,Returners,emerald-dream,1091,hunter,marksmanship,54,30,24
14386,Veranir,nemesis,1091,hunter,marksmanship,98,49,49
14387,Mikeangel,hydraxis,1091,hunter,marksmanship,27,12,15
14388,Malo,dragonmaw,1090,hunter,marksmanship,30,16,14
14389,Bluecoral,frostmourne,1088,hunter,marksmanship,129,56,73
14390,Angelacross,azralon,1087,hunter,marksmanship,54,26,28
14391,Deathwynd,malfurion,1085,hunter,marksmanship,24,13,11
14392,Alindra,zuluhed,1085,hunter,marksmanship,78,32,46
14393,Maxwel,sargeras,1082,hunter,marksmanship,175,86,89
14394,Ud,eldrethalas,1081,hunter,marksmanship,17,12,5
14395,Lezzbow,tichondrius,1081,hunter,marksmanship,61,32,29
14396,Zarely,frostmourne,1081,hunter,marksmanship,41,20,21
14397,Bemaa,frostmourne,1079,hunter,marksmanship,48,23,25
14398,Ramblin,ragnaros,1077,hunter,marksmanship,30,15,15
14399,Madogite,azralon,1075,hunter,marksmanship,84,48,36
14400,Aïmïng,tichondrius,1074,hunter,marksmanship,42,14,28
14401,Cßo,tichondrius,1073,hunter,marksmanship,96,43,53
14402,Pewpow,barthilas,1072,hunter,marksmanship,60,28,32
14403,Mynnokyr,gallywix,1070,hunter,marksmanship,59,28,31
14404,Towness,kelthuzad,1067,hunter,marksmanship,48,23,25
14405,Thoopered,korgath,1062,hunter,marksmanship,65,33,32
14406,Baldor,stormrage,1062,hunter,marksmanship,72,31,41
14407,Obsol,hyjal,1062,hunter,marksmanship,37,12,25
14408,Thunter,kiljaeden,1060,hunter,marksmanship,24,14,10
14409,Piloks,gallywix,1058,hunter,marksmanship,50,24,26
14410,Imperatrix,emerald-dream,1058,hunter,marksmanship,72,25,47
14411,Gvjellybeans,tichondrius,1056,hunter,marksmanship,18,11,7
14412,Runsfromcops,sargeras,1056,hunter,marksmanship,18,11,7
14413,Lexodream,bleeding-hollow,1056,hunter,marksmanship,18,11,7
14414,Ryutiz,fizzcrank,1056,hunter,marksmanship,30,11,19
14415,Shayelin,frostmourne,1055,hunter,marksmanship,18,11,7
14416,Thornshadow,steamwheedle-cartel,1055,hunter,marksmanship,24,12,12
14417,Daytrade,stormrage,1055,hunter,marksmanship,42,20,22
14418,Seyu,tichondrius,1055,hunter,marksmanship,24,11,13
14419,Eratichunt,illidan,1055,hunter,marksmanship,30,11,19
14420,Redzic,tichondrius,1054,hunter,marksmanship,18,11,7
14421,Tharlor,aegwynn,1054,hunter,marksmanship,30,11,19
14422,Inktray,durotan,1054,hunter,marksmanship,30,11,19
14423,Ezx,moon-guard,1053,hunter,marksmanship,18,11,7
14424,Enty,khazgoroth,1053,hunter,marksmanship,18,11,7
14425,Àlëxx,aegwynn,1053,hunter,marksmanship,54,21,33
14426,Kazzanval,sargeras,1052,hunter,marksmanship,30,15,15
14427,Falconex,azralon,1052,hunter,marksmanship,24,11,13
14428,Kimbaa,tichondrius,1052,hunter,marksmanship,24,11,13
14429,Dougv,stormrage,1052,hunter,marksmanship,24,11,13
14430,Guntrïx,stormrage,1052,hunter,marksmanship,36,11,25
14431,Callenna,zuljin,1051,hunter,marksmanship,18,11,7
14432,Scubby,anetheron,1050,hunter,marksmanship,18,11,7
14433,Blimpbooty,stormrage,1050,hunter,marksmanship,24,11,13
14434,Mensita,quelthalas,1049,hunter,marksmanship,30,11,19
14435,Exotichunter,the-underbog,1047,hunter,marksmanship,24,11,13
14436,Vansatih,azralon,1047,hunter,marksmanship,66,27,39
14437,Jakal,blackwater-raiders,1046,hunter,marksmanship,24,11,13
14438,Ladright,altar-of-storms,1046,hunter,marksmanship,24,11,13
14439,Lowk,stonemaul,1045,hunter,marksmanship,36,21,15
14440,Fëanora,quelthalas,1044,hunter,marksmanship,24,11,13
14441,Porkerr,black-dragonflight,1040,hunter,marksmanship,48,25,23
14442,Corruptid,moon-guard,1039,hunter,marksmanship,18,11,7
14443,Ansone,nazjatar,1039,hunter,marksmanship,24,11,13
14444,Tazent,moon-guard,1039,hunter,marksmanship,24,11,13
14445,Minihunter,onyxia,1039,hunter,marksmanship,36,16,20
14446,Deadalot,dalaran,1038,hunter,marksmanship,18,11,7
14447,Yoimiya,thunderlord,1036,hunter,marksmanship,41,18,23
14448,Iililillilii,tichondrius,1035,hunter,marksmanship,34,14,20
14449,Sartros,drakkari,1034,hunter,marksmanship,19,13,6
14450,Huntnfizzle,dethecus,1031,hunter,marksmanship,18,11,7
14451,Vendortrash,aggramar,1029,hunter,marksmanship,24,12,12
14452,Derenit,ragnaros,1028,hunter,marksmanship,48,17,31
14453,Delukzin,azralon,1028,hunter,marksmanship,38,13,25
14454,Silenciozzo,azralon,1026,hunter,marksmanship,42,17,25
14455,Soulbutter,malganis,1023,hunter,marksmanship,18,11,7
14456,Konar,nemesis,1018,hunter,marksmanship,78,34,44
14457,Shukucingjr,illidan,1015,hunter,marksmanship,39,23,16
14458,Secure,doomhammer,1015,hunter,marksmanship,66,30,36
14459,Kødran,stormrage,1013,hunter,marksmanship,54,26,28
14460,Jzander,ragnaros,1010,hunter,marksmanship,20,13,7
14461,Thyraza,proudmoore,1010,hunter,marksmanship,24,11,13
14462,Kuramax,senjin,1009,hunter,marksmanship,95,43,52
14463,Triggaplease,jubeithos,1008,hunter,marksmanship,67,37,30
14464,Killerxzxz,stormrage,1007,hunter,marksmanship,24,13,11
14465,Salsa,hakkar,1005,hunter,marksmanship,107,39,68
14466,Brenri,boulderfist,1003,hunter,marksmanship,30,15,15
14467,Zengrin,quelthalas,1003,hunter,marksmanship,23,11,12
14468,Koonorc,dalaran,998,hunter,marksmanship,46,22,24
14469,Sitaelh,quelthalas,994,hunter,marksmanship,48,23,25
14470,Balgair,hakkar,991,hunter,marksmanship,46,24,22
14471,Scottcrume,area-52,990,hunter,marksmanship,72,33,39
14472,Nelay,ragnaros,988,hunter,marksmanship,23,11,12
14473,Ritler,frostmourne,987,hunter,marksmanship,21,11,10
14474,Øparin,azralon,986,hunter,marksmanship,22,14,8
14475,Sumom,darrowmere,984,hunter,marksmanship,178,82,96
14476,Kalinor,cenarius,984,hunter,marksmanship,60,27,33
14477,Àbyss,shandris,982,hunter,marksmanship,48,18,30
14478,Yadír,quelthalas,978,hunter,marksmanship,126,56,70
14479,Galaxxis,bonechewer,974,hunter,marksmanship,51,26,25
14480,Iiwii,burning-legion,969,hunter,marksmanship,19,11,8
14481,Tiidkloul,illidan,968,hunter,marksmanship,18,12,6
14482,Reanivan,kiljaeden,968,hunter,marksmanship,66,24,42
14483,Silhouettes,barthilas,967,hunter,marksmanship,45,21,24
14484,Djpwnz,bladefist,967,hunter,marksmanship,54,18,36
14485,Broking,azralon,966,hunter,marksmanship,56,22,34
14486,Fleshfair,kiljaeden,965,hunter,marksmanship,45,21,24
14487,Scoundrella,sargeras,963,hunter,marksmanship,78,37,41
14488,Tungles,tichondrius,963,hunter,marksmanship,35,11,24
14489,Adjusted,frostmourne,960,hunter,marksmanship,12,10,2
14490,Hanabanana,wyrmrest-accord,960,hunter,marksmanship,12,10,2
14491,Goonsh,tichondrius,960,hunter,marksmanship,18,10,8
14492,Nainit,sargeras,960,hunter,marksmanship,18,10,8
14493,Kagaramar,hellscream,960,hunter,marksmanship,21,11,10
14494,Taumelz,sargeras,960,hunter,marksmanship,24,10,14
14495,Sylvaa,tichondrius,960,hunter,marksmanship,30,10,20
14496,Throre,bleeding-hollow,959,hunter,marksmanship,18,10,8
14497,Gnometoprace,illidan,959,hunter,marksmanship,24,10,14
14498,Nelandris,tichondrius,959,hunter,marksmanship,72,28,44
14499,Hunghang,frostmourne,959,hunter,marksmanship,30,10,20
14500,Ñðñdêsçrípt,frostmourne,959,hunter,marksmanship,30,10,20
14501,Austelos,moon-guard,958,hunter,marksmanship,18,10,8
14502,Shotfromhell,sargeras,958,hunter,marksmanship,27,10,17
14503,Searobot,kelthuzad,957,hunter,marksmanship,18,10,8
14504,Lanarhoades,firetree,957,hunter,marksmanship,18,10,8
14505,Chasseür,quelthalas,957,hunter,marksmanship,18,10,8
14506,Snipezone,kelthuzad,957,hunter,marksmanship,24,10,14
14507,Thunderox,tichondrius,957,hunter,marksmanship,36,11,25
14508,Starsworn,moon-guard,956,hunter,marksmanship,18,10,8
14509,Freshko,kiljaeden,956,hunter,marksmanship,18,10,8
14510,Aewyn,malganis,956,hunter,marksmanship,24,10,14
14511,Døubletap,gundrak,956,hunter,marksmanship,24,10,14
14512,Zulorion,the-forgotten-coast,956,hunter,marksmanship,24,10,14
14513,Dartháne,moon-guard,956,hunter,marksmanship,29,11,18
14514,Arcticwôlf,ragnaros,956,hunter,marksmanship,30,10,20
14515,Sparemeok,illidan,955,hunter,marksmanship,18,10,8
14516,Goatshots,lightninghoof,955,hunter,marksmanship,24,10,14
14517,Hawkeyë,ragnaros,954,hunter,marksmanship,18,10,8
14518,Gunshow,wyrmrest-accord,954,hunter,marksmanship,24,10,14
14519,Daymanaahh,malfurion,954,hunter,marksmanship,24,10,14
14520,Xaveco,gallywix,954,hunter,marksmanship,58,23,35
14521,Twist,burning-legion,953,hunter,marksmanship,12,10,2
14522,Damadar,tichondrius,953,hunter,marksmanship,24,10,14
14523,Valane,ragnaros,953,hunter,marksmanship,30,10,20
14524,Getnukedbud,emerald-dream,952,hunter,marksmanship,18,10,8
14525,Ragar,korialstrasz,952,hunter,marksmanship,24,10,14
14526,Jahir,tichondrius,952,hunter,marksmanship,30,10,20
14527,Verdao,stormrage,952,hunter,marksmanship,30,10,20
14528,Tinsho,drakkari,951,hunter,marksmanship,21,11,10
14529,Mailmann,skywall,948,hunter,marksmanship,18,12,6
14530,Kidofdeath,borean-tundra,947,hunter,marksmanship,18,10,8
14531,Vanhe,quelthalas,947,hunter,marksmanship,18,10,8
14532,Katnie,azralon,947,hunter,marksmanship,52,25,27
14533,Momomomo,draka,947,hunter,marksmanship,24,10,14
14534,Milktoker,tichondrius,947,hunter,marksmanship,24,10,14
14535,Globlauncher,tichondrius,946,hunter,marksmanship,18,10,8
14536,Adbéélitø,ragnaros,944,hunter,marksmanship,78,39,39
14537,Alorick,ragnaros,944,hunter,marksmanship,30,10,20
14538,Mirãbel,drakkari,944,hunter,marksmanship,48,14,34
14539,Arshuntica,blackrock,940,hunter,marksmanship,42,23,19
14540,Viciosa,bleeding-hollow,937,hunter,marksmanship,72,39,33
14541,Lazygnome,azshara,934,hunter,marksmanship,23,11,12
14542,Nachtcloverr,stormrage,931,hunter,marksmanship,63,27,36
14543,Jamzlol,frostmourne,930,hunter,marksmanship,23,14,9
14544,Franzkafka,azralon,930,hunter,marksmanship,72,34,38
14545,Heapstack,stormrage,930,hunter,marksmanship,30,12,18
14546,Caraméla,stormrage,927,hunter,marksmanship,22,10,12
14547,Sungold,dathremar,926,hunter,marksmanship,14,11,3
14548,Ontarget,cairne,926,hunter,marksmanship,81,37,44
14549,Torturekilla,bleeding-hollow,922,hunter,marksmanship,75,34,41
14550,Wael,perenolde,920,hunter,marksmanship,29,10,19
14551,Yamanashi,black-dragonflight,914,hunter,marksmanship,120,59,61
14552,Lauannÿ,gallywix,914,hunter,marksmanship,147,68,79
14553,Styles,thaurissan,907,hunter,marksmanship,54,22,32
14554,Brenogam,azralon,906,hunter,marksmanship,37,19,18
14555,Blaws,tichondrius,906,hunter,marksmanship,27,10,17
14556,Onehitrip,illidan,904,hunter,marksmanship,90,38,52
14557,Fourtwents,stormrage,901,hunter,marksmanship,25,10,15
14558,Flechá,illidan,900,hunter,marksmanship,17,10,7
14559,Cazadorelite,tichondrius,900,hunter,marksmanship,59,16,43
14560,Huntercotoco,azralon,896,hunter,marksmanship,48,25,23
14561,Bont,jubeithos,893,hunter,marksmanship,17,10,7
14562,Fourkayiv,azgalor,889,hunter,marksmanship,41,18,23
14563,Typh,saurfang,888,hunter,marksmanship,23,10,13
14564,Murozz,malganis,884,hunter,marksmanship,37,18,19
14565,Ashaelyn,wyrmrest-accord,884,hunter,marksmanship,26,10,16
14566,Motommotto,deathwing,883,hunter,marksmanship,24,12,12
14567,Alleessa,goldrinn,883,hunter,marksmanship,54,21,33
14568,Jetlinx,thrall,881,hunter,marksmanship,21,12,9
14569,Desolateone,nazgrel,880,hunter,marksmanship,50,24,26
14570,Nightwatch,kelthuzad,877,hunter,marksmanship,18,10,8
14571,Jvmr,azralon,877,hunter,marksmanship,56,27,29
14572,Rödrigö,azralon,876,hunter,marksmanship,30,14,16
14573,Dairoxd,drakkari,875,hunter,marksmanship,47,21,26
14574,Thaendra,moon-guard,865,hunter,marksmanship,23,11,12
14575,Karazuba,ragnaros,865,hunter,marksmanship,89,33,56
14576,Saltard,frostmourne,864,hunter,marksmanship,12,9,3
14577,Zulla,bleeding-hollow,864,hunter,marksmanship,12,9,3
14578,Ashx,nemesis,864,hunter,marksmanship,18,9,9
14579,Ðurostar,area-52,864,hunter,marksmanship,18,9,9
14580,Rangêr,frostmourne,864,hunter,marksmanship,18,9,9
14581,Deletedyou,tichondrius,864,hunter,marksmanship,18,9,9
14582,Keenz,frostmourne,864,hunter,marksmanship,24,9,15
14583,Singletap,barthilas,864,hunter,marksmanship,24,9,15
14584,Trapkeithx,frostmourne,864,hunter,marksmanship,24,9,15
14585,Scareder,malganis,864,hunter,marksmanship,24,9,15
14586,Xonios,frostwolf,864,hunter,marksmanship,24,9,15
14587,Sharpknife,dreadmaul,864,hunter,marksmanship,24,9,15
14588,Drãgenox,quelthalas,864,hunter,marksmanship,24,9,15
14589,Tetz,kelthuzad,864,hunter,marksmanship,30,9,21
14590,Demolitions,kelthuzad,864,hunter,marksmanship,30,9,21
14591,Rambot,bleeding-hollow,863,hunter,marksmanship,12,9,3
14592,Ggtooeasy,thrall,863,hunter,marksmanship,19,11,8
14593,Telånnas,illidan,863,hunter,marksmanship,18,9,9
14594,Ohifren,proudmoore,863,hunter,marksmanship,18,9,9
14595,Dôntlosmebro,stormrage,863,hunter,marksmanship,18,9,9
14596,Ultrasj,malfurion,863,hunter,marksmanship,18,9,9
14597,Torrthack,area-52,863,hunter,marksmanship,18,9,9
14598,Dayanier,ragnaros,863,hunter,marksmanship,18,9,9
14599,Nosmoke,kargath,863,hunter,marksmanship,24,9,15
14600,Candytoxic,quelthalas,863,hunter,marksmanship,24,9,15
14601,Ojmo,arthas,863,hunter,marksmanship,24,9,15
14602,Airpodpro,emerald-dream,862,hunter,marksmanship,12,9,3
14603,Fangs,arthas,862,hunter,marksmanship,12,9,3
14604,Bigvudu,illidan,862,hunter,marksmanship,18,9,9
14605,Syrach,area-52,862,hunter,marksmanship,18,9,9
14606,Diertz,area-52,862,hunter,marksmanship,24,9,15
14607,Varrinda,wyrmrest-accord,862,hunter,marksmanship,24,9,15
14608,Insgesicht,proudmoore,862,hunter,marksmanship,24,9,15
14609,Systane,mugthol,861,hunter,marksmanship,12,9,3
14610,Feltz,moon-guard,861,hunter,marksmanship,18,9,9
14611,Jagwaar,malganis,861,hunter,marksmanship,24,9,15
14612,Zarkul,tichondrius,861,hunter,marksmanship,24,9,15
14613,Snipastyle,twisting-nether,861,hunter,marksmanship,30,9,21
14614,Twistedtawl,area-52,860,hunter,marksmanship,18,9,9
14615,Junka,bleeding-hollow,860,hunter,marksmanship,18,9,9
14616,Illt,blackrock,860,hunter,marksmanship,18,9,9
14617,Tekkerz,tichondrius,860,hunter,marksmanship,19,9,10
14618,Jackrandall,frostmourne,860,hunter,marksmanship,24,9,15
14619,Kaeuljua,tichondrius,860,hunter,marksmanship,24,9,15
14620,Lánárhóádés,tichondrius,860,hunter,marksmanship,24,9,15
14621,Kluetus,sargeras,859,hunter,marksmanship,12,9,3
14622,Smokezy,barthilas,859,hunter,marksmanship,18,9,9
14623,Loyalrely,tichondrius,859,hunter,marksmanship,18,9,9
14624,Arzant,quelthalas,858,hunter,marksmanship,12,9,3
14625,Wolftracer,sargeras,858,hunter,marksmanship,18,9,9
14626,Coldhunger,uldum,857,hunter,marksmanship,12,9,3
14627,Wøllver,azralon,857,hunter,marksmanship,18,9,9
14628,Ëz,ragnaros,857,hunter,marksmanship,18,9,9
14629,Lahyanhou,azjolnerub,857,hunter,marksmanship,24,9,15
14630,Lws,ragnaros,856,hunter,marksmanship,12,9,3
14631,Hobbës,kelthuzad,856,hunter,marksmanship,18,9,9
14632,Lameshot,dalaran,856,hunter,marksmanship,24,9,15
14633,Panborikat,thaurissan,855,hunter,marksmanship,36,16,20
14634,Herroo,thrall,855,hunter,marksmanship,30,9,21
14635,Azx,tichondrius,851,hunter,marksmanship,18,9,9
14636,Lyssavirhus,azralon,850,hunter,marksmanship,18,9,9
14637,Avindal,greymane,850,hunter,marksmanship,18,9,9
14638,Westbrooke,illidan,850,hunter,marksmanship,24,9,15
14639,Ues,shuhalo,847,hunter,marksmanship,19,9,10
14640,Hideonpet,barthilas,845,hunter,marksmanship,23,9,14
14641,Zettl,eredar,841,hunter,marksmanship,148,65,83
14642,Arbeis,area-52,841,hunter,marksmanship,42,11,31
14643,Zievieda,hellscream,840,hunter,marksmanship,35,15,20
14644,Ramblinon,bloodhoof,840,hunter,marksmanship,30,11,19
14645,Apochuntz,greymane,839,hunter,marksmanship,24,11,13
14646,Zelanst,illidan,838,hunter,marksmanship,18,9,9
14647,Oorudun,hellscream,838,hunter,marksmanship,59,26,33
14648,Euphylesz,garrosh,836,hunter,marksmanship,22,9,13
14649,Vaelanor,destromath,831,hunter,marksmanship,24,11,13
14650,Squarë,ragnaros,831,hunter,marksmanship,23,9,14
14651,Cio,fizzcrank,831,hunter,marksmanship,24,9,15
14652,Mawlotov,barthilas,829,hunter,marksmanship,29,9,20
14653,Baruz,tichondrius,827,hunter,marksmanship,28,9,19
14654,Póra,stormrage,826,hunter,marksmanship,29,11,18
14655,Muggzzy,malygos,824,hunter,marksmanship,18,9,9
14656,Deejwithabow,frostmourne,815,hunter,marksmanship,18,9,9
14657,Déadlyshot,tichondrius,814,hunter,marksmanship,89,39,50
14658,Skyloss,illidan,811,hunter,marksmanship,48,15,33
14659,Iamtotoro,area-52,809,hunter,marksmanship,28,9,19
14660,Snäpträp,stormrage,807,hunter,marksmanship,15,9,6
14661,Diacachimbaa,ragnaros,807,hunter,marksmanship,21,9,12
14662,Hoarf,nemesis,799,hunter,marksmanship,14,9,5
14663,Ifeignalot,stormscale,799,hunter,marksmanship,16,9,7
14664,Ciils,sargeras,798,hunter,marksmanship,22,9,13
14665,Kazug,destromath,797,hunter,marksmanship,24,10,14
14666,Fian,lightnings-blade,797,hunter,marksmanship,22,9,13
14667,Qúin,frostmourne,797,hunter,marksmanship,29,10,19
14668,Ganeva,sargeras,776,hunter,marksmanship,64,24,40
14669,Getkited,tichondrius,773,hunter,marksmanship,22,10,12
14670,Wij,turalyon,770,hunter,marksmanship,36,12,24
14671,Tamsynn,stormreaver,769,hunter,marksmanship,54,15,39
14672,Shotpig,proudmoore,768,hunter,marksmanship,12,8,4
14673,Ragshunt,stormrage,768,hunter,marksmanship,12,8,4
14674,Entrapment,stormrage,768,hunter,marksmanship,12,8,4
14675,Songhammer,tichondrius,768,hunter,marksmanship,18,8,10
14676,Achillez,bleeding-hollow,768,hunter,marksmanship,18,8,10
14677,Roidbum,barthilas,768,hunter,marksmanship,22,8,14
14678,Woeisyou,stormrage,768,hunter,marksmanship,24,8,16
14679,Soul,sargeras,768,hunter,marksmanship,24,8,16
14680,Civvo,dalaran,768,hunter,marksmanship,24,8,16
14681,Bonquiesha,area-52,768,hunter,marksmanship,24,8,16
14682,Wolfmilkers,illidan,767,hunter,marksmanship,12,8,4
14683,Cimotsw,stormrage,767,hunter,marksmanship,12,8,4
14684,Hunterll,tichondrius,767,hunter,marksmanship,12,8,4
14685,Huntnmaster,thrall,767,hunter,marksmanship,12,8,4
14686,Melkmane,emerald-dream,767,hunter,marksmanship,12,8,4
14687,Arttemiss,zangarmarsh,767,hunter,marksmanship,12,8,4
14688,Handlez,gundrak,767,hunter,marksmanship,12,8,4
14689,Highershot,azralon,767,hunter,marksmanship,12,8,4
14690,Harlory,moon-guard,767,hunter,marksmanship,12,8,4
14691,Fhodhaz,nemesis,767,hunter,marksmanship,12,8,4
14692,Suyesh,tichondrius,767,hunter,marksmanship,12,8,4
14693,Côckblocked,tichondrius,767,hunter,marksmanship,12,8,4
14694,Connovar,nemesis,767,hunter,marksmanship,12,8,4
14695,Spiderham,tichondrius,767,hunter,marksmanship,12,8,4
14696,Wike,hyjal,767,hunter,marksmanship,15,9,6
14697,Vileplumè,stormrage,767,hunter,marksmanship,18,8,10
14698,Xtina,drakkari,767,hunter,marksmanship,18,8,10
14699,Ravanskull,burning-blade,767,hunter,marksmanship,18,8,10
14700,Runethkape,kelthuzad,767,hunter,marksmanship,18,8,10
14701,Rickshaw,frostmourne,767,hunter,marksmanship,18,8,10
14702,Fjdominador,azralon,767,hunter,marksmanship,18,8,10
14703,Siebee,tichondrius,767,hunter,marksmanship,18,8,10
14704,Yory,tol-barad,767,hunter,marksmanship,18,8,10
14705,Waqz,tichondrius,767,hunter,marksmanship,18,8,10
14706,Clo,illidan,767,hunter,marksmanship,18,8,10
14707,Cufless,proudmoore,767,hunter,marksmanship,18,8,10
14708,Thejessiah,tichondrius,767,hunter,marksmanship,18,8,10
14709,Zensuox,barthilas,767,hunter,marksmanship,18,8,10
14710,Tarah,lightbringer,767,hunter,marksmanship,24,8,16
14711,Rizzbow,dalvengyr,767,hunter,marksmanship,24,8,16
14712,Saltz,tichondrius,766,hunter,marksmanship,12,8,4
14713,Mööky,frostmourne,766,hunter,marksmanship,12,8,4
14714,Trochillidae,dragonmaw,766,hunter,marksmanship,18,8,10
14715,Deathspot,thrall,766,hunter,marksmanship,18,8,10
14716,Zèd,azralon,766,hunter,marksmanship,18,8,10
14717,Queldana,drakkari,766,hunter,marksmanship,18,8,10
14718,Blackbrute,nathrezim,766,hunter,marksmanship,18,8,10
14719,Uc,khadgar,766,hunter,marksmanship,18,8,10
14720,Noeffort,frostmourne,766,hunter,marksmanship,18,8,10
14721,Torvauk,bleeding-hollow,766,hunter,marksmanship,18,8,10
14722,Raiku,aggramar,766,hunter,marksmanship,18,8,10
14723,Zindula,malganis,766,hunter,marksmanship,19,8,11
14724,Tonyhunter,nemesis,766,hunter,marksmanship,24,8,16
14725,Kaelhim,warsong,766,hunter,marksmanship,24,8,16
14726,Basticus,blackwater-raiders,765,hunter,marksmanship,12,8,4
14727,Evilslaug,tichondrius,765,hunter,marksmanship,14,8,6
14728,Brosk,drakthul,765,hunter,marksmanship,18,8,10
14729,Ididntdoit,blackhand,765,hunter,marksmanship,24,8,16
14730,Youngpo,thunderlord,765,hunter,marksmanship,24,8,16
14731,Kòng,quelthalas,765,hunter,marksmanship,24,8,16
14732,Skillkiting,area-52,765,hunter,marksmanship,24,8,16
14733,Daahm,malganis,765,hunter,marksmanship,25,8,17
14734,Bionix,sargeras,764,hunter,marksmanship,18,8,10
14735,Myciri,proudmoore,764,hunter,marksmanship,18,8,10
14736,Gramaverde,kelthuzad,763,hunter,marksmanship,24,8,16
14737,Kluako,stormreaver,762,hunter,marksmanship,12,8,4
14738,Thisguÿ,arthas,762,hunter,marksmanship,18,8,10
14739,Sorid,medivh,761,hunter,marksmanship,12,8,4
14740,Emptypokcets,shattered-hand,761,hunter,marksmanship,24,8,16
14741,Enonoa,thunderlord,760,hunter,marksmanship,12,8,4
14742,Cruelhuntres,tichondrius,759,hunter,marksmanship,36,8,28
14743,Porta,zuljin,757,hunter,marksmanship,16,9,7
14744,Staudt,emerald-dream,757,hunter,marksmanship,18,8,10
14745,Aeclpysis,dark-iron,754,hunter,marksmanship,18,10,8
14746,Huntercry,ragnaros,751,hunter,marksmanship,12,8,4
14747,Niceshotboi,azgalor,751,hunter,marksmanship,24,8,16
14748,Lynnì,khadgar,750,hunter,marksmanship,18,8,10
14749,Darkmaximus,echo-isles,750,hunter,marksmanship,24,8,16
14750,Xshadowdemon,korgath,749,hunter,marksmanship,12,8,4
14751,Aksalaz,area-52,749,hunter,marksmanship,17,8,9
14752,Belieli,ragnaros,740,hunter,marksmanship,22,8,14
14753,Mackin,maelstrom,740,hunter,marksmanship,24,8,16
14754,Lennfear,frostmourne,739,hunter,marksmanship,24,8,16
14755,Tkrenshaw,proudmoore,735,hunter,marksmanship,11,8,3
14756,Setepalms,azralon,718,hunter,marksmanship,17,8,9
14757,Mayohater,sargeras,714,hunter,marksmanship,33,9,24
14758,Huntersuck,burning-blade,703,hunter,marksmanship,11,8,3
14759,Andalora,malganis,703,hunter,marksmanship,11,8,3
14760,Dainsleif,perenolde,703,hunter,marksmanship,16,8,8
14761,Dasvydanya,illidan,702,hunter,marksmanship,19,9,10
14762,Glokrag,ysera,702,hunter,marksmanship,20,8,12
14763,Sylanthia,sargeras,701,hunter,marksmanship,14,8,6
14764,Fizzleshot,malganis,699,hunter,marksmanship,18,8,10
14765,Jonsnow,lightnings-blade,693,hunter,marksmanship,21,8,13
14766,Felkrozzul,kalecgos,672,hunter,marksmanship,9,8,1
14767,Mörgoth,quelthalas,672,hunter,marksmanship,12,7,5
14768,Hyrus,shadowmoon,672,hunter,marksmanship,12,7,5
14769,Mms,frostmourne,672,hunter,marksmanship,12,7,5
14770,Relapse,dreadmaul,672,hunter,marksmanship,12,7,5
14771,Ehnub,stormrage,672,hunter,marksmanship,12,7,5
14772,Luoshi,proudmoore,672,hunter,marksmanship,12,7,5
14773,Raktama,proudmoore,672,hunter,marksmanship,12,7,5
14774,Winotah,barthilas,672,hunter,marksmanship,12,7,5
14775,Topgronk,tichondrius,672,hunter,marksmanship,12,7,5
14776,Kaznik,ragnaros,672,hunter,marksmanship,12,7,5
14777,Keboks,alleria,672,hunter,marksmanship,12,7,5
14778,Kookh,area-52,672,hunter,marksmanship,12,7,5
14779,Kaptincrunch,skywall,672,hunter,marksmanship,12,7,5
14780,Goosejuicer,emerald-dream,672,hunter,marksmanship,12,7,5
14781,Shotmaster,tichondrius,672,hunter,marksmanship,12,7,5
14782,Bárd,tichondrius,672,hunter,marksmanship,12,7,5
14783,Mochaxd,stormrage,672,hunter,marksmanship,14,7,7
14784,Segfault,korgath,672,hunter,marksmanship,16,7,9
14785,Tirrill,malganis,672,hunter,marksmanship,18,7,11
14786,Trappah,stormrage,672,hunter,marksmanship,18,7,11
14787,Lökeii,area-52,672,hunter,marksmanship,18,7,11
14788,Ping,tol-barad,672,hunter,marksmanship,18,7,11
14789,Focusfire,khazgoroth,672,hunter,marksmanship,18,7,11
14790,Phatshiet,anvilmar,672,hunter,marksmanship,18,7,11
14791,Mochigelato,kelthuzad,672,hunter,marksmanship,18,7,11
14792,Clawdio,ragnaros,672,hunter,marksmanship,18,7,11
14793,Jimryl,illidan,672,hunter,marksmanship,18,7,11
14794,Womdalekk,azralon,672,hunter,marksmanship,18,7,11
14795,Bombanodos,kelthuzad,672,hunter,marksmanship,18,7,11
14796,Bigkolache,zuljin,672,hunter,marksmanship,24,7,17
14797,Datbigbowdoe,illidan,672,hunter,marksmanship,24,7,17
14798,Bigzane,darkspear,672,hunter,marksmanship,24,7,17
14799,Kneecrippler,proudmoore,671,hunter,marksmanship,12,7,5
14800,Vatits,dalaran,671,hunter,marksmanship,12,7,5
14801,Sunyourmom,proudmoore,671,hunter,marksmanship,12,7,5
14802,Halford,tol-barad,671,hunter,marksmanship,12,7,5
14803,Texploto,area-52,671,hunter,marksmanship,12,7,5
14804,Geraldson,proudmoore,671,hunter,marksmanship,12,7,5
14805,Hannover,ragnaros,671,hunter,marksmanship,12,7,5
14806,Ethne,garithos,671,hunter,marksmanship,12,7,5
14807,Foxyevermew,tichondrius,671,hunter,marksmanship,12,7,5
14808,Xhare,stormrage,671,hunter,marksmanship,12,7,5
14809,Ocui,ragnaros,671,hunter,marksmanship,12,7,5
14810,Neoxbow,wyrmrest-accord,671,hunter,marksmanship,12,7,5
14811,Zelonas,emerald-dream,671,hunter,marksmanship,12,7,5
14812,Zhions,ragnaros,671,hunter,marksmanship,12,7,5
14813,Zhetsu,cenarius,671,hunter,marksmanship,18,7,11
14814,Bstic,quelthalas,671,hunter,marksmanship,18,7,11
14815,Kalizra,quelthalas,671,hunter,marksmanship,18,7,11
14816,Löbo,quelthalas,671,hunter,marksmanship,18,7,11
14817,Toesgoes,thrall,671,hunter,marksmanship,18,7,11
14818,Sáns,sargeras,671,hunter,marksmanship,18,7,11
14819,Atallstalker,sargeras,671,hunter,marksmanship,18,7,11
14820,Bowsbéforhos,stormrage,671,hunter,marksmanship,18,7,11
14821,Navagee,tichondrius,671,hunter,marksmanship,18,7,11
14822,Schbaltz,tichondrius,671,hunter,marksmanship,18,7,11
14823,Murderone,undermine,671,hunter,marksmanship,18,7,11
14824,Såvagehunter,malganis,671,hunter,marksmanship,18,7,11
14825,Lyricly,lightbringer,671,hunter,marksmanship,18,7,11
14826,Feignmilf,tichondrius,671,hunter,marksmanship,18,7,11
14827,Temara,icecrown,671,hunter,marksmanship,24,7,17
14828,Joogeenda,kaelthas,670,hunter,marksmanship,12,7,5
14829,Untermench,tichondrius,670,hunter,marksmanship,12,7,5
14830,Kìngjaybroni,sargeras,670,hunter,marksmanship,12,7,5
14831,Gemky,ragnaros,670,hunter,marksmanship,19,8,11
14832,Cócaine,tichondrius,670,hunter,marksmanship,19,8,11
14833,Ownshot,kiljaeden,670,hunter,marksmanship,18,7,11
14834,Wolfyyxx,stormrage,670,hunter,marksmanship,18,7,11
14835,Nellond,malganis,670,hunter,marksmanship,18,7,11
14836,Gagau,stormrage,670,hunter,marksmanship,18,7,11
14837,Bartolomeu,kirin-tor,669,hunter,marksmanship,12,7,5
14838,Johnwayne,alterac-mountains,669,hunter,marksmanship,22,8,14
14839,Lionnheart,wyrmrest-accord,668,hunter,marksmanship,12,7,5
14840,Lilzoomer,barthilas,668,hunter,marksmanship,12,7,5
14841,Niteynite,duskwood,668,hunter,marksmanship,12,7,5
14842,Roboputa,quelthalas,667,hunter,marksmanship,18,7,11
14843,Gundolf,kargath,667,hunter,marksmanship,18,7,11
14844,Mulnaaj,zuljin,666,hunter,marksmanship,24,7,17
14845,Mahty,stormrage,665,hunter,marksmanship,12,7,5
14846,Blåckhat,frostmourne,665,hunter,marksmanship,36,7,29
14847,Bowzo,emerald-dream,663,hunter,marksmanship,18,7,11
14848,Steelfeather,hellscream,662,hunter,marksmanship,12,7,5
14849,Jxoxex,wildhammer,662,hunter,marksmanship,18,7,11
14850,Lulaladraun,azralon,662,hunter,marksmanship,24,7,17
14851,Mayhunter,ragnaros,651,hunter,marksmanship,19,8,11
14852,Cassîdy,quelthalas,651,hunter,marksmanship,24,7,17
14853,Righthole,area-52,640,hunter,marksmanship,22,7,15
14854,Äzrael,elune,638,hunter,marksmanship,24,7,17
14855,Goldenblade,shadowmoon,624,hunter,marksmanship,21,7,14
14856,Atraksis,thrall,623,hunter,marksmanship,11,7,4
14857,Grukar,tichondrius,623,hunter,marksmanship,17,7,10
14858,Remak,barthilas,620,hunter,marksmanship,15,7,8
14859,Muerteaterry,ragnaros,618,hunter,marksmanship,18,8,10
14860,Mesiauzx,stormrage,618,hunter,marksmanship,22,9,13
14861,Maveraxx,executus,616,hunter,marksmanship,21,7,14
14862,Kushminion,zuljin,607,hunter,marksmanship,14,9,5
14863,Ròllinafatty,dark-iron,607,hunter,marksmanship,14,7,7
14864,Krossx,thrall,591,hunter,marksmanship,12,7,5
14865,Rednivrap,kelthuzad,576,hunter,marksmanship,6,6,0
14866,Skullcracker,azralon,576,hunter,marksmanship,12,6,6
14867,Ysoseriusg,area-52,576,hunter,marksmanship,12,6,6
14868,Aurzwraek,proudmoore,576,hunter,marksmanship,12,6,6
14869,Groomme,area-52,576,hunter,marksmanship,12,6,6
14870,Vårelse,sargeras,576,hunter,marksmanship,12,6,6
14871,Nerfmeplezz,area-52,576,hunter,marksmanship,12,6,6
14872,Gugubird,proudmoore,576,hunter,marksmanship,12,6,6
14873,Arenthius,lothar,576,hunter,marksmanship,12,6,6
14874,Aoti,nerzhul,576,hunter,marksmanship,12,6,6
14875,Talanar,ragnaros,576,hunter,marksmanship,12,6,6
14876,Xohzabu,wyrmrest-accord,576,hunter,marksmanship,12,6,6
14877,Klepa,illidan,576,hunter,marksmanship,12,6,6
14878,Juwannaaim,lethon,576,hunter,marksmanship,12,6,6
14879,Kangar,senjin,576,hunter,marksmanship,12,6,6
14880,Warblez,spinebreaker,576,hunter,marksmanship,12,6,6
14881,Jpynovisa,moon-guard,576,hunter,marksmanship,12,6,6
14882,Ticey,frostmourne,576,hunter,marksmanship,12,6,6
14883,Donotrunaway,ragnaros,576,hunter,marksmanship,12,6,6
14884,Ssds,sargeras,576,hunter,marksmanship,12,6,6
14885,Vigero,proudmoore,576,hunter,marksmanship,12,6,6
14886,Gritzix,frostmourne,576,hunter,marksmanship,12,6,6
14887,Elmozz,thrall,576,hunter,marksmanship,12,6,6
14888,Kyudo,moon-guard,576,hunter,marksmanship,12,6,6
14889,Spanerd,moon-guard,576,hunter,marksmanship,12,6,6
14890,Huntkillerx,illidan,576,hunter,marksmanship,12,6,6
14891,Nightgecko,elune,576,hunter,marksmanship,12,6,6
14892,Laurenx,illidan,576,hunter,marksmanship,12,6,6
14893,Grimdrakk,zuljin,576,hunter,marksmanship,12,6,6
14894,Cubecrawler,skullcrusher,576,hunter,marksmanship,12,6,6
14895,Êlautismo,wyrmrest-accord,576,hunter,marksmanship,12,6,6
14896,Ishootpeople,illidan,576,hunter,marksmanship,12,6,6
14897,Dranel,nordrassil,576,hunter,marksmanship,12,6,6
14898,Rockehm,frostmourne,576,hunter,marksmanship,12,6,6
14899,Pulso,illidan,576,hunter,marksmanship,12,6,6
14900,Mdizzly,zuljin,576,hunter,marksmanship,12,6,6
14901,Cù,frostmourne,576,hunter,marksmanship,12,6,6
14902,Zaamsa,ragnaros,576,hunter,marksmanship,12,6,6
14903,Küngen,zuljin,576,hunter,marksmanship,12,6,6
14904,Birbwatcher,moon-guard,576,hunter,marksmanship,12,6,6
14905,Skum,tichondrius,576,hunter,marksmanship,12,6,6
14906,Xernen,thrall,576,hunter,marksmanship,12,6,6
14907,Trapwiz,firetree,576,hunter,marksmanship,12,6,6
14908,Kynigi,bleeding-hollow,576,hunter,marksmanship,12,6,6
14909,Vicecheney,illidan,576,hunter,marksmanship,12,6,6
14910,Pandaslayr,garrosh,576,hunter,marksmanship,12,6,6
14911,Viralshot,tichondrius,576,hunter,marksmanship,12,6,6
14912,Tokez,moon-guard,576,hunter,marksmanship,14,6,8
14913,Lightbullet,kelthuzad,576,hunter,marksmanship,18,6,12
14914,Shcrimps,proudmoore,576,hunter,marksmanship,18,6,12
14915,Aaggros,sargeras,576,hunter,marksmanship,18,6,12
14916,Najmoira,area-52,576,hunter,marksmanship,24,6,18
14917,Jônathan,tichondrius,576,hunter,marksmanship,24,6,18
14918,Kazes,stormrage,575,hunter,marksmanship,12,6,6
14919,Cerrundan,icecrown,575,hunter,marksmanship,12,6,6
14920,Silentzkill,tichondrius,575,hunter,marksmanship,12,6,6
14921,Chipsncheese,korgath,575,hunter,marksmanship,12,6,6
14922,Alinûs,stormrage,575,hunter,marksmanship,12,6,6
14923,Chapushoot,ragnaros,575,hunter,marksmanship,12,6,6
14924,Projectilez,sargeras,575,hunter,marksmanship,12,6,6
14925,Wârhunt,frostmourne,575,hunter,marksmanship,12,6,6
14926,Tajo,sargeras,575,hunter,marksmanship,12,6,6
14927,Littlespike,queldorei,575,hunter,marksmanship,12,6,6
14928,Taphh,moon-guard,575,hunter,marksmanship,12,6,6
14929,Lagginwaggin,azgalor,575,hunter,marksmanship,12,6,6
14930,Thehunturd,dalaran,575,hunter,marksmanship,12,6,6
14931,Sylvaethas,lightninghoof,575,hunter,marksmanship,12,6,6
14932,Cobrag,tichondrius,575,hunter,marksmanship,12,6,6
14933,Badharexx,perenolde,575,hunter,marksmanship,12,6,6
14934,Aragörnn,azralon,575,hunter,marksmanship,12,6,6
14935,Gresga,dalaran,575,hunter,marksmanship,12,6,6
14936,Onlyfeìgns,frostmourne,575,hunter,marksmanship,12,6,6
14937,Muckenfoose,frostmourne,575,hunter,marksmanship,12,6,6
14938,Dirtbagchaz,illidan,575,hunter,marksmanship,12,6,6
14939,Smashfacehnt,tichondrius,575,hunter,marksmanship,18,6,12
14940,Tazmaniak,gorefiend,575,hunter,marksmanship,18,6,12
14941,Zugineer,tichondrius,575,hunter,marksmanship,18,6,12
14942,Arbclimbs,frostmane,575,hunter,marksmanship,18,6,12
14943,Zeddunn,stormrage,574,hunter,marksmanship,12,6,6
14944,Marcusrarnis,zuljin,574,hunter,marksmanship,12,6,6
14945,Hildihunt,stormrage,574,hunter,marksmanship,12,6,6
14946,Folgadoo,azralon,574,hunter,marksmanship,18,6,12
14947,Bigmommah,durotan,574,hunter,marksmanship,24,6,18
14948,Bunb,area-52,574,hunter,marksmanship,24,6,18
14949,Galfhord,ragnaros,574,hunter,marksmanship,24,6,18
14950,Arïya,azralon,573,hunter,marksmanship,12,6,6
14951,Recebaa,barthilas,572,hunter,marksmanship,12,6,6
14952,Jogoran,thunderlord,571,hunter,marksmanship,12,6,6
14953,Strelyatil,trollbane,571,hunter,marksmanship,18,6,12
14954,Zandrá,drakkari,570,hunter,marksmanship,12,6,6
14955,Drâgônâr,stormrage,570,hunter,marksmanship,18,6,12
14956,Beastmodeqt,blood-furnace,566,hunter,marksmanship,18,6,12
14957,Nickhell,azralon,565,hunter,marksmanship,12,6,6
14958,Axtlas,moonrunner,565,hunter,marksmanship,12,6,6
14959,Ikkare,dalaran,565,hunter,marksmanship,12,6,6
14960,Weirdjeff,alexstrasza,565,hunter,marksmanship,12,6,6
14961,Neef,mannoroth,564,hunter,marksmanship,24,6,18
14962,Ratspit,chogall,557,hunter,marksmanship,17,6,11
14963,Erudraugdin,quelthalas,545,hunter,marksmanship,24,6,18
14964,Elchavo,malganis,543,hunter,marksmanship,11,6,5
14965,Cloveth,wyrmrest-accord,543,hunter,marksmanship,11,6,5
14966,Gymli,destromath,543,hunter,marksmanship,11,6,5
14967,Stephkurryz,tichondrius,543,hunter,marksmanship,14,7,7
14968,Päinal,area-52,528,hunter,marksmanship,9,6,3
14969,Déadshøt,blackhand,527,hunter,marksmanship,17,6,11
14970,Jaydemo,thunderhorn,527,hunter,marksmanship,17,6,11
14971,Xtremesnipez,frostmourne,522,hunter,marksmanship,15,9,6
14972,Ayrelial,tichondrius,522,hunter,marksmanship,13,7,6
14973,Remixjy,burning-blade,522,hunter,marksmanship,16,7,9
14974,Cns,tichondrius,521,hunter,marksmanship,20,7,13
14975,Braddocky,azralon,518,hunter,marksmanship,15,7,8
14976,Greyk,moon-guard,511,hunter,marksmanship,11,6,5
14977,Pogcheddar,tichondrius,511,hunter,marksmanship,14,6,8
14978,Tracershot,malganis,511,hunter,marksmanship,14,6,8
14979,Cplski,kelthuzad,511,hunter,marksmanship,16,6,10
14980,Stepbroski,moon-guard,510,hunter,marksmanship,14,6,8
14981,Brainzz,emerald-dream,509,hunter,marksmanship,16,7,9
14982,Brody,eitrigg,508,hunter,marksmanship,16,6,10
14983,Kimchishotxo,tichondrius,480,hunter,marksmanship,6,5,1
14984,Rhunakk,emerald-dream,480,hunter,marksmanship,6,5,1
14985,Brienz,tichondrius,480,hunter,marksmanship,6,5,1
14986,Zmghost,nathrezim,480,hunter,marksmanship,6,5,1
14987,Thrandrial,smolderthorn,480,hunter,marksmanship,6,5,1
14988,Martminas,stormrage,480,hunter,marksmanship,6,5,1
14989,Shootandloot,zuljin,480,hunter,marksmanship,6,5,1
14990,Johhnweed,ragnaros,480,hunter,marksmanship,6,5,1
14991,Qthunterr,dalaran,480,hunter,marksmanship,6,5,1
14992,Knerf,silvermoon,480,hunter,marksmanship,6,5,1
14993,Chickenzzack,tichondrius,480,hunter,marksmanship,6,5,1
14994,Drup,dalaran,480,hunter,marksmanship,6,5,1
14995,Arimkal,area-52,480,hunter,marksmanship,6,5,1
14996,Taije,arthas,480,hunter,marksmanship,6,5,1
14997,Thekilla,ragnaros,480,hunter,marksmanship,6,5,1
14998,Bendotexe,stormrage,480,hunter,marksmanship,6,5,1
14999,Raevon,kelthuzad,480,hunter,marksmanship,9,6,3
15000,Idtrapthat,nordrassil,480,hunter,marksmanship,9,5,4
15001,Stingyshot,thrall,480,hunter,marksmanship,12,5,7
15002,Bullzeyê,kelthuzad,480,hunter,marksmanship,12,5,7
15003,Duckpow,frostmourne,480,hunter,marksmanship,12,5,7
15004,Partÿ,tichondrius,480,hunter,marksmanship,12,5,7
15005,Baehydra,frostmourne,480,hunter,marksmanship,12,5,7
15006,Xísa,proudmoore,480,hunter,marksmanship,12,5,7
15007,Soloshuffle,kelthuzad,480,hunter,marksmanship,12,5,7
15008,Kattarry,moon-guard,480,hunter,marksmanship,12,5,7
15009,Mickyluvin,emerald-dream,480,hunter,marksmanship,12,5,7
15010,Trapshootjk,area-52,480,hunter,marksmanship,12,5,7
15011,Lilbowbigdam,emerald-dream,480,hunter,marksmanship,12,5,7
15012,Snoplow,illidan,480,hunter,marksmanship,12,5,7
15013,Snipedown,bonechewer,480,hunter,marksmanship,12,5,7
15014,Cotoyo,sargeras,480,hunter,marksmanship,12,5,7
15015,Ellissniper,frostmourne,480,hunter,marksmanship,12,5,7
15016,Bowjoby,kelthuzad,480,hunter,marksmanship,12,5,7
15017,Lagshots,kelthuzad,480,hunter,marksmanship,12,5,7
15018,Lìlleth,thrall,480,hunter,marksmanship,12,5,7
15019,Qqshot,emerald-dream,480,hunter,marksmanship,12,5,7
15020,Jaywuz,tichondrius,480,hunter,marksmanship,12,5,7
15021,Scruffiebear,deathwing,480,hunter,marksmanship,12,5,7
15022,Smokabonbon,eredar,480,hunter,marksmanship,12,5,7
15023,Arraza,ragnaros,480,hunter,marksmanship,12,5,7
15024,Årcter,alexstrasza,480,hunter,marksmanship,12,5,7
15025,Hawkeyees,ragnaros,480,hunter,marksmanship,12,5,7
15026,Volarsomar,shattered-hand,480,hunter,marksmanship,12,5,7
15027,Josyv,quelthalas,480,hunter,marksmanship,12,5,7
15028,Slobon,tichondrius,480,hunter,marksmanship,12,5,7
15029,Snipeudead,sargeras,480,hunter,marksmanship,12,5,7
15030,Lorgor,eonar,480,hunter,marksmanship,12,5,7
15031,Furrhunter,tichondrius,480,hunter,marksmanship,12,5,7
15032,Eldotbrod,quelthalas,480,hunter,marksmanship,12,5,7
15033,Lianm,stormrage,480,hunter,marksmanship,12,5,7
15034,Connora,stormrage,480,hunter,marksmanship,12,5,7
15035,Humiliation,mugthol,480,hunter,marksmanship,12,5,7
15036,Orì,stormrage,480,hunter,marksmanship,12,5,7
15037,Splosiv,stormrage,480,hunter,marksmanship,12,5,7
15038,Shooked,area-52,480,hunter,marksmanship,12,5,7
15039,Hunt,the-underbog,480,hunter,marksmanship,12,5,7
15040,Aloa,nagrand,480,hunter,marksmanship,12,5,7
15041,Davidbowey,bonechewer,480,hunter,marksmanship,12,5,7
15042,Thewïld,tichondrius,480,hunter,marksmanship,12,5,7
15043,Trænquility,tichondrius,480,hunter,marksmanship,12,5,7
15044,Íkíte,zuljin,480,hunter,marksmanship,12,5,7
15045,Skedd,wyrmrest-accord,480,hunter,marksmanship,12,5,7
15046,Raeyy,area-52,480,hunter,marksmanship,12,5,7
15047,Kankuro,proudmoore,480,hunter,marksmanship,12,5,7
15048,Teaks,aggramar,480,hunter,marksmanship,12,5,7
15049,Boomheadshot,blood-furnace,480,hunter,marksmanship,12,5,7
15050,Omniquiver,sargeras,480,hunter,marksmanship,12,5,7
15051,Valro,hyjal,480,hunter,marksmanship,12,5,7
15052,Reys,bonechewer,480,hunter,marksmanship,15,6,9
15053,Regretful,kelthuzad,480,hunter,marksmanship,13,5,8
15054,Velinieron,norgannon,480,hunter,marksmanship,14,5,9
15055,Ikiteforfood,zuljin,480,hunter,marksmanship,18,5,13
15056,Vanir,stormscale,480,hunter,marksmanship,18,5,13
15057,Absinther,emerald-dream,480,hunter,marksmanship,18,5,13
15058,Msghunter,sargeras,480,hunter,marksmanship,18,5,13
15059,Blickys,area-52,480,hunter,marksmanship,18,5,13
15060,Eurekasl,ragnaros,480,hunter,marksmanship,18,5,13
15061,Stupid,arthas,480,hunter,marksmanship,18,5,13
15062,Shootybootìe,tichondrius,480,hunter,marksmanship,18,5,13
15063,Keelif,arthas,480,hunter,marksmanship,18,5,13
15064,Mohz,kiljaeden,480,hunter,marksmanship,18,5,13
15065,Ownyoufast,darkspear,480,hunter,marksmanship,24,5,19
15066,Ritrune,anvilmar,479,hunter,marksmanship,6,5,1
15067,Hishamo,aggramar,479,hunter,marksmanship,6,5,1
15068,Runimurder,zuljin,479,hunter,marksmanship,6,5,1
15069,Voujin,ragnaros,479,hunter,marksmanship,12,5,7
15070,Rykbad,area-52,479,hunter,marksmanship,12,5,7
15071,Ohhsnaapp,blood-furnace,479,hunter,marksmanship,12,5,7
15072,Globalhunter,emerald-dream,479,hunter,marksmanship,12,5,7
15073,Zaghoward,fenris,479,hunter,marksmanship,12,5,7
15074,Jazeath,tichondrius,479,hunter,marksmanship,12,5,7
15075,Pilk,daggerspine,479,hunter,marksmanship,12,5,7
15076,Peitowyn,illidan,479,hunter,marksmanship,12,5,7
15077,Pathius,uldaman,479,hunter,marksmanship,12,5,7
15078,Keyva,moon-guard,479,hunter,marksmanship,12,5,7
15079,Logonman,rexxar,479,hunter,marksmanship,12,5,7
15080,Alluminant,gilneas,479,hunter,marksmanship,12,5,7
15081,Banhunter,tichondrius,479,hunter,marksmanship,12,5,7
15082,Blurrí,area-52,479,hunter,marksmanship,12,5,7
15083,Hunchback,emerald-dream,479,hunter,marksmanship,12,5,7
15084,Diur,ragnaros,479,hunter,marksmanship,15,5,10
15085,Kiteftw,tichondrius,479,hunter,marksmanship,21,6,15
15086,Johar,nerzhul,479,hunter,marksmanship,18,5,13
15087,Enzym,archimonde,479,hunter,marksmanship,18,5,13
15088,Pucky,quelthalas,479,hunter,marksmanship,18,5,13
15089,Ensnare,wyrmrest-accord,478,hunter,marksmanship,12,5,7
15090,Drakkoniss,spinebreaker,478,hunter,marksmanship,12,5,7
15091,Ozzoty,tol-barad,478,hunter,marksmanship,12,5,7
15092,Damnnicebutt,borean-tundra,478,hunter,marksmanship,20,7,13
15093,Nobelscarlet,wildhammer,477,hunter,marksmanship,12,5,7
15094,Tularac,sentinels,477,hunter,marksmanship,12,5,7
15095,Survival,dentarg,477,hunter,marksmanship,12,5,7
15096,Puttry,stormrage,476,hunter,marksmanship,12,5,7
15097,Akbu,azralon,476,hunter,marksmanship,12,5,7
15098,Àrsha,gallywix,475,hunter,marksmanship,12,5,7
15099,Nubberton,sargeras,473,hunter,marksmanship,16,8,8
15100,Lanney,firetree,473,hunter,marksmanship,12,5,7
15101,Hartman,frostwolf,473,hunter,marksmanship,18,5,13
15102,Mazkeen,bonechewer,472,hunter,marksmanship,12,5,7
15103,Butimbutters,bleeding-hollow,467,hunter,marksmanship,23,8,15
15104,Raun,anvilmar,453,hunter,marksmanship,17,5,12
15105,Againzt,tichondrius,447,hunter,marksmanship,12,6,6
15106,Keedub,stormrage,447,hunter,marksmanship,11,5,6
15107,Diavál,area-52,447,hunter,marksmanship,11,5,6
15108,Ryonel,moon-guard,447,hunter,marksmanship,17,5,12
15109,Mukeru,stormrage,432,hunter,marksmanship,9,5,4
15110,Jud,thunderlord,432,hunter,marksmanship,21,5,16
15111,Wook,hyjal,431,hunter,marksmanship,11,5,6
15112,Irontoast,kelthuzad,431,hunter,marksmanship,11,5,6
15113,Noriee,destromath,431,hunter,marksmanship,15,5,10
15114,Ozarks,kiljaeden,426,hunter,marksmanship,17,6,11
15115,Onlyphanz,darkspear,415,hunter,marksmanship,8,5,3
15116,Rektarrow,area-52,384,hunter,marksmanship,6,4,2
15117,Nyxus,tichondrius,384,hunter,marksmanship,6,4,2
15118,Blamethenaga,sargeras,384,hunter,marksmanship,6,4,2
15119,Llhopital,ragnaros,384,hunter,marksmanship,6,4,2
15120,Zendarae,tichondrius,384,hunter,marksmanship,6,4,2
15121,Sylos,moon-guard,384,hunter,marksmanship,6,4,2
15122,Folf,turalyon,384,hunter,marksmanship,6,4,2
15123,Tdarknet,quelthalas,384,hunter,marksmanship,6,4,2
15124,Hitemup,bleeding-hollow,384,hunter,marksmanship,6,4,2
15125,Nenenhunt,ragnaros,384,hunter,marksmanship,6,4,2
15126,Shímmér,barthilas,384,hunter,marksmanship,6,4,2
15127,Moyria,quelthalas,384,hunter,marksmanship,6,4,2
15128,Swish,burning-legion,384,hunter,marksmanship,6,4,2
15129,Illine,azralon,384,hunter,marksmanship,6,4,2
15130,Beefcow,barthilas,384,hunter,marksmanship,6,4,2
15131,Maidán,azralon,384,hunter,marksmanship,6,4,2
15132,Emilysamuels,tichondrius,384,hunter,marksmanship,6,4,2
15133,Arteene,illidan,384,hunter,marksmanship,6,4,2
15134,Beatnass,cairne,384,hunter,marksmanship,6,4,2
15135,Frîck,bleeding-hollow,384,hunter,marksmanship,6,4,2
15136,Aimbôt,frostmourne,384,hunter,marksmanship,6,4,2
15137,Malcab,tichondrius,384,hunter,marksmanship,6,4,2
15138,Jojojobo,tichondrius,384,hunter,marksmanship,6,4,2
15139,Wellerman,firetree,384,hunter,marksmanship,6,4,2
15140,Shootyzenth,kiljaeden,384,hunter,marksmanship,6,4,2
15141,Jaganshot,tol-barad,384,hunter,marksmanship,6,4,2
15142,Karimysac,aggramar,384,hunter,marksmanship,6,4,2
15143,Goonlmao,hyjal,384,hunter,marksmanship,6,4,2
15144,Venj,proudmoore,384,hunter,marksmanship,6,4,2
15145,Zenkhi,quelthalas,384,hunter,marksmanship,6,4,2
15146,Shootbert,malganis,384,hunter,marksmanship,6,4,2
15147,Croift,stormrage,384,hunter,marksmanship,6,4,2
15148,Cashisabeast,zuljin,384,hunter,marksmanship,6,4,2
15149,Yamamasofat,proudmoore,384,hunter,marksmanship,6,4,2
15150,Gunstorms,dalaran,384,hunter,marksmanship,6,4,2
15151,Valtolimor,moon-guard,384,hunter,marksmanship,6,4,2
15152,Cornstalk,area-52,384,hunter,marksmanship,6,4,2
15153,Infatuatedx,moon-guard,384,hunter,marksmanship,6,4,2
15154,Krissiz,drakkari,384,hunter,marksmanship,6,4,2
15155,Goldensour,malganis,384,hunter,marksmanship,6,4,2
15156,Subdue,tichondrius,384,hunter,marksmanship,6,4,2
15157,Oromís,dalaran,384,hunter,marksmanship,6,4,2
15158,Elmerfuddx,terokkar,384,hunter,marksmanship,6,4,2
15159,Hyjix,stormrage,384,hunter,marksmanship,6,4,2
15160,Swoljashotxp,area-52,384,hunter,marksmanship,6,4,2
15161,Gogey,area-52,384,hunter,marksmanship,6,4,2
15162,Junmuxiao,ragnaros,384,hunter,marksmanship,6,4,2
15163,Silvertokay,ragnaros,384,hunter,marksmanship,6,4,2
15164,Cerakkaya,tichondrius,384,hunter,marksmanship,6,4,2
15165,Archetype,bladefist,384,hunter,marksmanship,6,4,2
15166,Déwi,tichondrius,384,hunter,marksmanship,6,4,2
15167,Anecko,zuljin,384,hunter,marksmanship,6,4,2
15168,Huumpoutine,burning-blade,384,hunter,marksmanship,6,4,2
15169,Raposo,nemesis,384,hunter,marksmanship,6,4,2
15170,Malthiz,antonidas,384,hunter,marksmanship,8,4,4
15171,Baydog,moon-guard,384,hunter,marksmanship,11,4,7
15172,Xeriife,stormrage,384,hunter,marksmanship,12,4,8
15173,Gotrap,saurfang,384,hunter,marksmanship,12,4,8
15174,Sucontheze,kelthuzad,384,hunter,marksmanship,12,4,8
15175,Robobop,stormrage,384,hunter,marksmanship,12,4,8
15176,Karev,area-52,384,hunter,marksmanship,12,4,8
15177,Artemisagro,greymane,384,hunter,marksmanship,12,4,8
15178,Bigclamz,dragonmaw,384,hunter,marksmanship,12,4,8
15179,Kanati,dunemaul,384,hunter,marksmanship,12,4,8
15180,Ohimissyou,emerald-dream,384,hunter,marksmanship,12,4,8
15181,Kyler,draka,384,hunter,marksmanship,12,4,8
15182,Percision,bonechewer,384,hunter,marksmanship,12,4,8
15183,Shottz,blackhand,384,hunter,marksmanship,12,4,8
15184,Bacigalupo,medivh,384,hunter,marksmanship,12,4,8
15185,Ganzilla,aerie-peak,384,hunter,marksmanship,12,4,8
15186,Dmasterbiter,zuljin,384,hunter,marksmanship,12,4,8
15187,Altte,proudmoore,384,hunter,marksmanship,12,4,8
15188,Emérr,drakkari,384,hunter,marksmanship,12,4,8
15189,Mabaku,tichondrius,384,hunter,marksmanship,12,4,8
15190,Junglar,eitrigg,384,hunter,marksmanship,12,4,8
15191,Ningiiwose,garona,384,hunter,marksmanship,12,4,8
15192,Saralli,thrall,384,hunter,marksmanship,12,4,8
15193,Ezpzx,sargeras,384,hunter,marksmanship,12,4,8
15194,Aaron,jubeithos,384,hunter,marksmanship,12,4,8
15195,Bunryl,thorium-brotherhood,384,hunter,marksmanship,12,4,8
15196,Gstygodx,frostmourne,384,hunter,marksmanship,12,4,8
15197,Joton,tichondrius,384,hunter,marksmanship,12,4,8
15198,Lithality,tichondrius,384,hunter,marksmanship,12,4,8
15199,Hywhan,stormrage,384,hunter,marksmanship,12,4,8
15200,Zipzyup,tichondrius,384,hunter,marksmanship,12,4,8
15201,Lilbic,bleeding-hollow,384,hunter,marksmanship,12,4,8
15202,Vion,mannoroth,384,hunter,marksmanship,12,4,8
15203,Limpnoodle,nerzhul,384,hunter,marksmanship,12,4,8
15204,Specops,illidan,384,hunter,marksmanship,12,4,8
15205,Revö,area-52,384,hunter,marksmanship,12,4,8
15206,Trippyhunter,akama,384,hunter,marksmanship,12,4,8
15207,Aquastasia,aegwynn,384,hunter,marksmanship,12,4,8
15208,Ðao,nazjatar,384,hunter,marksmanship,12,4,8
15209,Sogeki,kelthuzad,384,hunter,marksmanship,12,4,8
15210,Patroclo,azralon,384,hunter,marksmanship,12,4,8
15211,Crackshotzz,illidan,384,hunter,marksmanship,12,4,8
15212,Resonatorrob,illidan,384,hunter,marksmanship,12,4,8
15213,Rumnaheim,nemesis,384,hunter,marksmanship,12,4,8
15214,Sylvanâs,bleeding-hollow,384,hunter,marksmanship,12,4,8
15215,Kumari,lothar,384,hunter,marksmanship,12,4,8
15216,Whatalexa,tichondrius,384,hunter,marksmanship,12,4,8
15217,Hunterjahvek,area-52,384,hunter,marksmanship,12,4,8
15218,Sabo,nemesis,384,hunter,marksmanship,12,4,8
15219,Missnevamiss,skullcrusher,384,hunter,marksmanship,12,4,8
15220,Ðïanä,azralon,384,hunter,marksmanship,12,4,8
15221,Vélos,illidan,384,hunter,marksmanship,12,4,8
15222,Frankyy,frostmourne,384,hunter,marksmanship,12,4,8
15223,Hordworld,tichondrius,384,hunter,marksmanship,12,4,8
15224,Braindeadorc,illidan,384,hunter,marksmanship,12,4,8
15225,Crimsonmm,ragnaros,384,hunter,marksmanship,12,4,8
15226,Tsubakï,ragnaros,384,hunter,marksmanship,12,4,8
15227,Brotag,aggramar,384,hunter,marksmanship,12,4,8
15228,Enchantras,jaedenar,384,hunter,marksmanship,12,4,8
15229,Taurenseason,sargeras,384,hunter,marksmanship,12,4,8
15230,Dropflag,stormrage,384,hunter,marksmanship,12,4,8
15231,Skillvanas,stormrage,384,hunter,marksmanship,12,4,8
15232,Bleedwolf,tichondrius,384,hunter,marksmanship,12,4,8
15233,Samsin,sargeras,384,hunter,marksmanship,12,4,8
15234,Gotskill,lethon,384,hunter,marksmanship,18,4,14
15235,Peashooter,sargeras,384,hunter,marksmanship,19,4,15
15236,Dathronin,chogall,383,hunter,marksmanship,6,4,2
15237,Meriah,bleeding-hollow,383,hunter,marksmanship,6,4,2
15238,Essya,frostmourne,383,hunter,marksmanship,6,4,2
15239,Balanguxa,azralon,383,hunter,marksmanship,6,4,2
15240,Comtambisuon,frostmourne,383,hunter,marksmanship,6,4,2
15241,Aridan,area-52,383,hunter,marksmanship,12,4,8
15242,Shootingjaem,tichondrius,383,hunter,marksmanship,12,4,8
15243,Zérõ,area-52,383,hunter,marksmanship,12,4,8
15244,Rottinghood,hyjal,383,hunter,marksmanship,12,4,8
15245,Minibrö,tichondrius,383,hunter,marksmanship,12,4,8
15246,Juanita,laughing-skull,383,hunter,marksmanship,12,4,8
15247,Shootymcshot,vashj,383,hunter,marksmanship,12,4,8
15248,Fermra,dunemaul,383,hunter,marksmanship,12,4,8
15249,Zenwrath,illidan,383,hunter,marksmanship,12,4,8
15250,Cornbreadfed,gorgonnash,383,hunter,marksmanship,12,4,8
15251,Ytsejammer,eonar,383,hunter,marksmanship,12,4,8
15252,Lanamatt,azralon,383,hunter,marksmanship,12,4,8
15253,Nevon,azralon,383,hunter,marksmanship,18,4,14
15254,Hunternao,nemesis,383,hunter,marksmanship,18,4,14
15255,Rzan,fenris,382,hunter,marksmanship,6,4,2
15256,Oohuntsoo,emerald-dream,382,hunter,marksmanship,6,4,2
15257,Eaudelune,vashj,382,hunter,marksmanship,12,4,8
15258,Lovek,ragnaros,382,hunter,marksmanship,12,4,8
15259,Skatenos,tortheldrin,381,hunter,marksmanship,12,4,8
15260,Twofeathers,wyrmrest-accord,381,hunter,marksmanship,12,4,8
15261,Goofyfingers,illidan,380,hunter,marksmanship,18,4,14
15262,Venessie,moon-guard,379,hunter,marksmanship,12,4,8
15263,Arighthunt,frostmourne,367,hunter,marksmanship,17,4,13
15264,Roseandra,stormrage,366,hunter,marksmanship,17,4,13
15265,Hyesik,tichondrius,362,hunter,marksmanship,21,7,14
15266,Pérséús,ragnaros,351,hunter,marksmanship,12,5,7
15267,Tarkovs,area-52,351,hunter,marksmanship,11,4,7
15268,Bloodarrow,tichondrius,351,hunter,marksmanship,11,4,7
15269,Rnger,aerie-peak,350,hunter,marksmanship,12,5,7
15270,Trappxy,sargeras,336,hunter,marksmanship,9,4,5
15271,Tafer,quelthalas,336,hunter,marksmanship,9,4,5
15272,Brorc,kul-tiras,335,hunter,marksmanship,11,4,7
15273,Zucarita,tichondrius,330,hunter,marksmanship,9,5,4
15274,Nubcaks,nerzhul,330,hunter,marksmanship,21,5,16
15275,Misogynistaf,tichondrius,319,hunter,marksmanship,5,4,1
15276,Stupïd,tichondrius,319,hunter,marksmanship,5,4,1
15277,Aimian,frostmourne,319,hunter,marksmanship,8,4,4
15278,Ðeathßyarrøw,bloodscalp,319,hunter,marksmanship,10,4,6
15279,Streetcrime,stormrage,304,hunter,marksmanship,7,4,3
15280,Dahunterguy,illidan,304,hunter,marksmanship,7,4,3
15281,Peña,trollbane,304,hunter,marksmanship,13,4,9
15282,Dagre,the-forgotten-coast,304,hunter,marksmanship,13,4,9
15283,Tìnker,stormrage,288,hunter,marksmanship,6,3,3
15284,Quondo,boulderfist,288,hunter,marksmanship,6,3,3
15285,Deathshoôt,suramar,288,hunter,marksmanship,6,3,3
15286,Plastera,zuljin,288,hunter,marksmanship,6,3,3
15287,Wannakill,stormrage,288,hunter,marksmanship,6,3,3
15288,Zym,the-forgotten-coast,288,hunter,marksmanship,6,3,3
15289,Azairxd,tichondrius,288,hunter,marksmanship,6,3,3
15290,Halosucks,sargeras,288,hunter,marksmanship,6,3,3
15291,Canadïan,stormrage,288,hunter,marksmanship,6,3,3
15292,Mtuanwm,tichondrius,288,hunter,marksmanship,6,3,3
15293,Vinksy,sargeras,288,hunter,marksmanship,6,3,3
15294,Darforner,shandris,288,hunter,marksmanship,6,3,3
15295,Stupedhunter,tichondrius,288,hunter,marksmanship,6,3,3
15296,Zzackchicken,tichondrius,288,hunter,marksmanship,6,3,3
15297,Tugh,maiev,288,hunter,marksmanship,6,3,3
15298,Vashra,stormrage,288,hunter,marksmanship,6,3,3
15299,Triggamikê,tichondrius,288,hunter,marksmanship,6,3,3
15300,Daggétt,zuljin,288,hunter,marksmanship,6,3,3
15301,Getgaped,bronzebeard,288,hunter,marksmanship,6,3,3
15302,Rockendude,sargeras,288,hunter,marksmanship,6,3,3
15303,Kaitoo,tichondrius,288,hunter,marksmanship,6,3,3
15304,Rplover,malganis,288,hunter,marksmanship,6,3,3
15305,Starsabov,emerald-dream,288,hunter,marksmanship,6,3,3
15306,Bamfhunt,darkspear,288,hunter,marksmanship,6,3,3
15307,Krelas,eldrethalas,288,hunter,marksmanship,6,3,3
15308,Guncontrol,malganis,288,hunter,marksmanship,6,3,3
15309,Playnogames,moon-guard,288,hunter,marksmanship,6,3,3
15310,Mikey,exodar,288,hunter,marksmanship,6,3,3
15311,Brumbuh,tichondrius,288,hunter,marksmanship,6,3,3
15312,Sylvãnâs,tichondrius,288,hunter,marksmanship,6,3,3
15313,Rivs,detheroc,288,hunter,marksmanship,6,3,3
15314,Keliara,dunemaul,288,hunter,marksmanship,6,3,3
15315,Cyboreg,stormrage,288,hunter,marksmanship,6,3,3
15316,Casadora,dark-iron,288,hunter,marksmanship,6,3,3
15317,Perfectcrit,area-52,288,hunter,marksmanship,6,3,3
15318,Candîce,moon-guard,288,hunter,marksmanship,6,3,3
15319,Eatmybow,nemesis,288,hunter,marksmanship,6,3,3
15320,Waldrom,arathor,288,hunter,marksmanship,6,3,3
15321,Eforas,ragnaros,288,hunter,marksmanship,6,3,3
15322,Petmychode,illidan,288,hunter,marksmanship,6,3,3
15323,Iresa,bleeding-hollow,288,hunter,marksmanship,6,3,3
15324,Niche,jaedenar,288,hunter,marksmanship,6,3,3
15325,Boxpatrol,ravencrest,288,hunter,marksmanship,6,3,3
15326,Sosaho,sargeras,288,hunter,marksmanship,6,3,3
15327,Deepbowjob,sargeras,288,hunter,marksmanship,6,3,3
15328,Kallindo,sargeras,288,hunter,marksmanship,6,3,3
15329,Ropivacaine,illidan,288,hunter,marksmanship,6,3,3
15330,Racoon,spinebreaker,288,hunter,marksmanship,6,3,3
15331,Wasteyou,tichondrius,288,hunter,marksmanship,6,3,3
15332,Huerfyta,quelthalas,288,hunter,marksmanship,6,3,3
15333,Physical,destromath,288,hunter,marksmanship,6,3,3
15334,Innerhunt,aegwynn,288,hunter,marksmanship,6,3,3
15335,Exabyssus,bleeding-hollow,288,hunter,marksmanship,6,3,3
15336,Kong,tichondrius,288,hunter,marksmanship,6,3,3
15337,Internade,frostmourne,288,hunter,marksmanship,6,3,3
15338,Maxifier,tichondrius,288,hunter,marksmanship,6,3,3
15339,Odratnuh,bleeding-hollow,288,hunter,marksmanship,6,3,3
15340,Kansolly,tichondrius,288,hunter,marksmanship,6,3,3
15341,Clait,frostmourne,288,hunter,marksmanship,6,3,3
15342,Jackohun,quelthalas,288,hunter,marksmanship,6,3,3
15343,Adowsol,kiljaeden,288,hunter,marksmanship,6,3,3
15344,Wonshawt,tichondrius,288,hunter,marksmanship,6,3,3
15345,Sereom,frostmourne,288,hunter,marksmanship,6,3,3
15346,Chootembro,thunderlord,288,hunter,marksmanship,6,3,3
15347,Airchick,frostmourne,288,hunter,marksmanship,6,3,3
15348,Kormas,illidan,288,hunter,marksmanship,6,3,3
15349,Iapsux,bleeding-hollow,288,hunter,marksmanship,6,3,3
15350,Weegnomie,wyrmrest-accord,288,hunter,marksmanship,6,3,3
15351,Zestia,tichondrius,288,hunter,marksmanship,6,3,3
15352,Auset,aegwynn,288,hunter,marksmanship,6,3,3
15353,Alliestrasza,azralon,288,hunter,marksmanship,6,3,3
15354,Krane,alleria,288,hunter,marksmanship,6,3,3
15355,Bloodyman,korgath,288,hunter,marksmanship,6,3,3
15356,Rhovanni,ragnaros,288,hunter,marksmanship,6,3,3
15357,Luckynoodlle,frostmourne,288,hunter,marksmanship,6,3,3
15358,Laer,archimonde,288,hunter,marksmanship,6,3,3
15359,Fruitenveg,frostmourne,288,hunter,marksmanship,6,3,3
15360,Blakespace,area-52,288,hunter,marksmanship,6,3,3
15361,Kargathx,ragnaros,288,hunter,marksmanship,6,3,3
15362,Zeonas,tichondrius,288,hunter,marksmanship,6,3,3
15363,Sufferiñg,doomhammer,288,hunter,marksmanship,6,3,3
15364,Buzzkiller,sargeras,288,hunter,marksmanship,6,3,3
15365,Kogger,frostmourne,288,hunter,marksmanship,6,3,3
15366,Madjango,illidan,288,hunter,marksmanship,6,3,3
15367,Graid,azralon,288,hunter,marksmanship,6,3,3
15368,Bernelli,kelthuzad,288,hunter,marksmanship,6,3,3
15369,Inked,frostmourne,288,hunter,marksmanship,6,3,3
15370,Saphling,emerald-dream,288,hunter,marksmanship,6,3,3
15371,Maximuhm,vashj,288,hunter,marksmanship,6,3,3
15372,Bacin,tichondrius,288,hunter,marksmanship,6,3,3
15373,Antily,kelthuzad,288,hunter,marksmanship,6,3,3
15374,Iannieht,illidan,288,hunter,marksmanship,6,3,3
15375,Thugbeast,tichondrius,288,hunter,marksmanship,6,3,3
15376,Cloakedninja,illidan,288,hunter,marksmanship,6,3,3
15377,Strudelshot,tichondrius,288,hunter,marksmanship,6,3,3
15378,Arithrawn,area-52,288,hunter,marksmanship,6,3,3
15379,Silvershot,emerald-dream,288,hunter,marksmanship,6,3,3
15380,Gorhound,tichondrius,288,hunter,marksmanship,6,3,3
15381,Sabanna,proudmoore,288,hunter,marksmanship,6,3,3
15382,Tzoop,tichondrius,288,hunter,marksmanship,6,3,3
15383,Amazoness,tichondrius,288,hunter,marksmanship,6,3,3
15384,Carot,dalaran,288,hunter,marksmanship,6,3,3
15385,Ÿöskë,tichondrius,288,hunter,marksmanship,6,3,3
15386,Hitstickk,tichondrius,288,hunter,marksmanship,6,3,3
15387,Yeaheh,area-52,288,hunter,marksmanship,6,3,3
15388,Baoßun,thrall,288,hunter,marksmanship,6,3,3
15389,Arröws,area-52,288,hunter,marksmanship,6,3,3
15390,Traphouse,blackrock,288,hunter,marksmanship,6,3,3
15391,Chimpx,moon-guard,288,hunter,marksmanship,6,3,3
15392,Battleon,dalaran,288,hunter,marksmanship,6,3,3
15393,Tichong,tichondrius,288,hunter,marksmanship,6,3,3
15394,Muffhuntér,blackrock,288,hunter,marksmanship,6,3,3
15395,Razer,anvilmar,288,hunter,marksmanship,9,4,5
15396,Xpyroshot,area-52,288,hunter,marksmanship,9,4,5
15397,Royshot,stormrage,288,hunter,marksmanship,7,3,4
15398,Mojopojo,tichondrius,288,hunter,marksmanship,12,4,8
15399,Snigskytte,dreadmaul,288,hunter,marksmanship,11,3,8
15400,Konungr,zuljin,288,hunter,marksmanship,11,3,8
15401,Prpl,sargeras,288,hunter,marksmanship,15,4,11
15402,Surfbum,lightbringer,288,hunter,marksmanship,12,3,9
15403,Princssdaizy,zuljin,288,hunter,marksmanship,12,3,9
15404,Samloomis,ursin,288,hunter,marksmanship,12,3,9
15405,Drysst,tichondrius,288,hunter,marksmanship,12,3,9
15406,Ouchiies,barthilas,288,hunter,marksmanship,12,3,9
15407,Quackattack,arthas,288,hunter,marksmanship,12,3,9
15408,Davidböwie,stormreaver,288,hunter,marksmanship,12,3,9
15409,Beastcraft,emerald-dream,288,hunter,marksmanship,12,3,9
15410,Boltflux,nemesis,288,hunter,marksmanship,12,3,9
15411,Zeedii,dalaran,288,hunter,marksmanship,12,3,9
15412,Angelicarrow,area-52,288,hunter,marksmanship,12,3,9
15413,Strixx,emerald-dream,288,hunter,marksmanship,12,3,9
15414,Oua,queldorei,288,hunter,marksmanship,12,3,9
15415,Sparkco,area-52,288,hunter,marksmanship,12,3,9
15416,Xsparkys,kargath,288,hunter,marksmanship,12,3,9
15417,Lesley,illidan,288,hunter,marksmanship,12,3,9
15418,Skywrecker,bleeding-hollow,288,hunter,marksmanship,12,3,9
15419,Hatara,quelthalas,288,hunter,marksmanship,12,3,9
15420,Blarck,shattered-halls,288,hunter,marksmanship,12,3,9
15421,Shablagoosh,zuljin,288,hunter,marksmanship,12,3,9
15422,Heloran,maelstrom,288,hunter,marksmanship,12,3,9
15423,Gustavitch,executus,288,hunter,marksmanship,12,3,9
15424,Shifted,quelthalas,288,hunter,marksmanship,12,3,9
15425,Hefty,azuremyst,288,hunter,marksmanship,12,3,9
15426,Tmd,thrall,288,hunter,marksmanship,12,3,9
15427,Duaalipaa,malganis,288,hunter,marksmanship,12,3,9
15428,Sliperysaly,tichondrius,288,hunter,marksmanship,12,3,9
15429,Durbìn,sargeras,288,hunter,marksmanship,12,3,9
15430,Aerefix,frostmourne,288,hunter,marksmanship,12,3,9
15431,Blaisian,frostmourne,288,hunter,marksmanship,12,3,9
15432,Wadadly,malganis,288,hunter,marksmanship,12,3,9
15433,Uro,illidan,288,hunter,marksmanship,12,3,9
15434,Tastysauce,wyrmrest-accord,288,hunter,marksmanship,12,3,9
15435,Alyzza,sargeras,288,hunter,marksmanship,12,3,9
15436,Sásori,area-52,288,hunter,marksmanship,12,3,9
15437,Exiun,sargeras,288,hunter,marksmanship,12,3,9
15438,Lumbygoblin,illidan,288,hunter,marksmanship,13,3,10
15439,Zarknoth,cenarius,288,hunter,marksmanship,18,3,15
15440,Jgodsslayer,tichondrius,288,hunter,marksmanship,18,3,15
15441,Cerébro,illidan,288,hunter,marksmanship,24,3,21
15442,Ghazzghkuull,ragnaros,287,hunter,marksmanship,6,3,3
15443,Kahunå,area-52,287,hunter,marksmanship,6,3,3
15444,Talonwind,tanaris,287,hunter,marksmanship,6,3,3
15445,Downtimes,illidan,287,hunter,marksmanship,6,3,3
15446,Lapelada,ragnaros,287,hunter,marksmanship,6,3,3
15447,Multicereal,quelthalas,287,hunter,marksmanship,6,3,3
15448,Braindeadly,malganis,287,hunter,marksmanship,6,3,3
15449,Tarbabies,mannoroth,287,hunter,marksmanship,12,3,9
15450,Bumbow,tichondrius,287,hunter,marksmanship,12,3,9
15451,Dragonlandy,stormrage,287,hunter,marksmanship,12,3,9
15452,Darthwillie,cenarius,287,hunter,marksmanship,12,3,9
15453,Allready,stormrage,287,hunter,marksmanship,12,3,9
15454,Divinee,undermine,287,hunter,marksmanship,12,3,9
15455,Slayemz,barthilas,287,hunter,marksmanship,12,3,9
15456,Josthar,thrall,287,hunter,marksmanship,24,3,21
15457,Irishnia,bleeding-hollow,286,hunter,marksmanship,6,3,3
15458,Lorelåii,tichondrius,286,hunter,marksmanship,6,3,3
15459,Purplebeaver,gorgonnash,286,hunter,marksmanship,12,3,9
15460,Dashing,magtheridon,271,hunter,marksmanship,11,3,8
15461,Mythman,area-52,255,hunter,marksmanship,14,4,10
15462,Jamesmcgill,tichondrius,255,hunter,marksmanship,11,3,8
15463,Tanneritez,bleeding-hollow,240,hunter,marksmanship,17,3,14
15464,Yukiqtpie,barthilas,239,hunter,marksmanship,5,3,2
15465,Evilmoe,zuluhed,239,hunter,marksmanship,5,3,2
15466,Glôck,dalaran,239,hunter,marksmanship,11,3,8
15467,Knowtraps,area-52,234,hunter,marksmanship,7,4,3
15468,Druskritag,moon-guard,234,hunter,marksmanship,10,4,6
15469,Demongirl,arathor,231,hunter,marksmanship,25,4,21
15470,Almighty,trollbane,229,hunter,marksmanship,29,6,23
15471,Noscoped,wildhammer,224,hunter,marksmanship,16,3,13
15472,Downworlder,darkspear,223,hunter,marksmanship,8,3,5
15473,Andrømeda,frostmourne,208,hunter,marksmanship,7,3,4
15474,Lamb,undermine,202,hunter,marksmanship,11,4,7
15475,Farverr,area-52,192,hunter,marksmanship,4,3,1
15476,Traitorously,daggerspine,192,hunter,marksmanship,9,3,6
15477,Blowedazchit,bonechewer,192,hunter,marksmanship,6,2,4
15478,Hfn,stormrage,192,hunter,marksmanship,6,2,4
15479,Alssong,tichondrius,192,hunter,marksmanship,6,2,4
15480,Døctørmälitø,tichondrius,192,hunter,marksmanship,6,2,4
15481,Fkurrules,frostmourne,192,hunter,marksmanship,6,2,4
15482,Bôdon,illidan,192,hunter,marksmanship,6,2,4
15483,Pichsolika,frostmourne,192,hunter,marksmanship,6,2,4
15484,Firskin,frostmourne,192,hunter,marksmanship,6,2,4
15485,Yortrox,ragnaros,192,hunter,marksmanship,6,2,4
15486,Magvez,tichondrius,192,hunter,marksmanship,6,2,4
15487,Gokissmywolf,moknathal,192,hunter,marksmanship,6,2,4
15488,Noisetrader,illidan,192,hunter,marksmanship,6,2,4
15489,Mordriva,azjolnerub,192,hunter,marksmanship,6,2,4
15490,Jebote,frostmourne,192,hunter,marksmanship,6,2,4
15491,Petmydog,aegwynn,192,hunter,marksmanship,6,2,4
15492,Penelòpe,wyrmrest-accord,192,hunter,marksmanship,6,2,4
15493,Camorcaist,stormrage,192,hunter,marksmanship,6,2,4
15494,Anilora,wyrmrest-accord,192,hunter,marksmanship,6,2,4
15495,Cefla,illidan,192,hunter,marksmanship,6,2,4
15496,Tyraelias,kaelthas,192,hunter,marksmanship,6,2,4
15497,Valcyoneus,dragonmaw,192,hunter,marksmanship,6,2,4
15498,Léfty,nagrand,192,hunter,marksmanship,6,2,4
15499,Whitemàne,dalaran,192,hunter,marksmanship,6,2,4
15500,Huntugz,frostmourne,192,hunter,marksmanship,6,2,4
15501,Huntgar,earthen-ring,192,hunter,marksmanship,6,2,4
15502,Wartoz,dragonblight,192,hunter,marksmanship,6,2,4
15503,Bowzørx,tichondrius,192,hunter,marksmanship,6,2,4
15504,Fleshfeast,tichondrius,192,hunter,marksmanship,6,2,4
15505,Ïkite,zuljin,192,hunter,marksmanship,6,2,4
15506,Valdevenator,illidan,192,hunter,marksmanship,6,2,4
15507,Haki,gallywix,192,hunter,marksmanship,6,2,4
15508,Peppancini,wyrmrest-accord,192,hunter,marksmanship,6,2,4
15509,Hárd,illidan,192,hunter,marksmanship,6,2,4
15510,Lycanthropei,illidan,192,hunter,marksmanship,6,2,4
15511,Warsh,anubarak,192,hunter,marksmanship,6,2,4
15512,Ctrlaltdel,gundrak,192,hunter,marksmanship,6,2,4
15513,Jaigo,stormrage,192,hunter,marksmanship,6,2,4
15514,Shoccka,thrall,192,hunter,marksmanship,6,2,4
15515,Nord,draka,192,hunter,marksmanship,6,2,4
15516,Mtq,thrall,192,hunter,marksmanship,6,2,4
15517,Crownchild,illidan,192,hunter,marksmanship,6,2,4
15518,Voodoohunter,blood-furnace,192,hunter,marksmanship,6,2,4
15519,Justhunter,moknathal,192,hunter,marksmanship,6,2,4
15520,Lulafourdedo,stormrage,192,hunter,marksmanship,6,2,4
15521,Glockin,zuljin,192,hunter,marksmanship,6,2,4
15522,Aridias,mannoroth,192,hunter,marksmanship,6,2,4
15523,Faldran,earthen-ring,192,hunter,marksmanship,6,2,4
15524,Nixuis,stormrage,192,hunter,marksmanship,6,2,4
15525,Holytrap,destromath,192,hunter,marksmanship,6,2,4
15526,Salvatiel,stormrage,192,hunter,marksmanship,6,2,4
15527,Tus,tichondrius,192,hunter,marksmanship,6,2,4
15528,Áppóló,spinebreaker,192,hunter,marksmanship,6,2,4
15529,Dikbender,tichondrius,192,hunter,marksmanship,6,2,4
15530,Ezari,zuljin,192,hunter,marksmanship,6,2,4
15531,Vitae,shattered-halls,192,hunter,marksmanship,6,2,4
15532,Rëxx,moon-guard,192,hunter,marksmanship,6,2,4
15533,Ilîiìîìiilil,bleeding-hollow,192,hunter,marksmanship,6,2,4
15534,Angrypepe,bleeding-hollow,192,hunter,marksmanship,6,2,4
15535,Actimetohunt,gundrak,192,hunter,marksmanship,6,2,4
15536,Sleazyrider,azuremyst,192,hunter,marksmanship,6,2,4
15537,Huntingyou,destromath,192,hunter,marksmanship,6,2,4
15538,Lukara,darkspear,192,hunter,marksmanship,6,2,4
15539,Jathriel,zuljin,192,hunter,marksmanship,6,2,4
15540,Théw,tichondrius,192,hunter,marksmanship,6,2,4
15541,Huntbodom,drakkari,192,hunter,marksmanship,6,2,4
15542,Dreezzy,bleeding-hollow,192,hunter,marksmanship,6,2,4
15543,Arantir,drakkari,192,hunter,marksmanship,6,2,4
15544,Kïwwï,tichondrius,192,hunter,marksmanship,6,2,4
15545,Happyhunting,sargeras,192,hunter,marksmanship,6,2,4
15546,Xuxoo,nemesis,192,hunter,marksmanship,6,2,4
15547,Latherel,bleeding-hollow,192,hunter,marksmanship,6,2,4
15548,Kanta,bleeding-hollow,192,hunter,marksmanship,6,2,4
15549,Saveawp,stormrage,192,hunter,marksmanship,6,2,4
15550,Defacegg,illidan,192,hunter,marksmanship,6,2,4
15551,Zeaks,emerald-dream,192,hunter,marksmanship,6,2,4
15552,Namøscä,nemesis,192,hunter,marksmanship,6,2,4
15553,Ramchi,burning-blade,192,hunter,marksmanship,6,2,4
15554,Leaf,chromaggus,192,hunter,marksmanship,6,2,4
15555,Angelfern,sargeras,192,hunter,marksmanship,6,2,4
15556,Knator,area-52,192,hunter,marksmanship,6,2,4
15557,Illweedx,kiljaeden,192,hunter,marksmanship,6,2,4
15558,Geldyn,stormreaver,192,hunter,marksmanship,6,2,4
15559,Arbos,ragnaros,192,hunter,marksmanship,6,2,4
15560,Yembohi,queldorei,192,hunter,marksmanship,6,2,4
15561,Muscletooth,moon-guard,192,hunter,marksmanship,6,2,4
15562,Yonzo,area-52,192,hunter,marksmanship,6,2,4
15563,Bloodrainia,ravencrest,192,hunter,marksmanship,6,2,4
15564,Erebor,malganis,192,hunter,marksmanship,6,2,4
15565,Inurah,malganis,192,hunter,marksmanship,6,2,4
15566,Aimi,twisting-nether,192,hunter,marksmanship,6,2,4
15567,Kreaytion,sargeras,192,hunter,marksmanship,6,2,4
15568,Desdee,icecrown,192,hunter,marksmanship,6,2,4
15569,Sobala,azralon,192,hunter,marksmanship,6,2,4
15570,Amptx,tichondrius,192,hunter,marksmanship,6,2,4
15571,Isitrng,aggramar,192,hunter,marksmanship,6,2,4
15572,Pumpydumpy,malganis,192,hunter,marksmanship,6,2,4
15573,Nughunter,area-52,192,hunter,marksmanship,6,2,4
15574,Blury,tichondrius,192,hunter,marksmanship,6,2,4
15575,Ayrana,tichondrius,192,hunter,marksmanship,6,2,4
15576,Zhona,moon-guard,192,hunter,marksmanship,6,2,4
15577,Àngèl,malganis,192,hunter,marksmanship,6,2,4
15578,Regerts,sargeras,192,hunter,marksmanship,6,2,4
15579,Córnell,tichondrius,192,hunter,marksmanship,6,2,4
15580,Ðevil,ragnaros,192,hunter,marksmanship,6,2,4
15581,Geeshot,area-52,192,hunter,marksmanship,6,2,4
15582,Sergunter,area-52,192,hunter,marksmanship,6,2,4
15583,Tuanorz,proudmoore,192,hunter,marksmanship,6,2,4
15584,Percival,firetree,192,hunter,marksmanship,6,2,4
15585,Lemmiewînkzz,sargeras,192,hunter,marksmanship,6,2,4
15586,Zackmorris,kelthuzad,192,hunter,marksmanship,6,2,4
15587,Commonbuck,area-52,192,hunter,marksmanship,6,2,4
15588,Hideontrap,malganis,192,hunter,marksmanship,6,2,4
15589,Symz,ragnaros,192,hunter,marksmanship,6,2,4
15590,Ðecarlis,azralon,192,hunter,marksmanship,6,2,4
15591,Thiccshawts,moon-guard,192,hunter,marksmanship,6,2,4
15592,Kahtniss,quelthalas,192,hunter,marksmanship,6,2,4
15593,Cazaaires,quelthalas,192,hunter,marksmanship,6,2,4
15594,Fizzleegear,area-52,192,hunter,marksmanship,6,2,4
15595,Terapista,area-52,192,hunter,marksmanship,6,2,4
15596,Skolzero,azralon,192,hunter,marksmanship,6,2,4
15597,Xxunderoath,frostwolf,192,hunter,marksmanship,6,2,4
15598,Sinsix,akama,192,hunter,marksmanship,6,2,4
15599,Doopers,kiljaeden,192,hunter,marksmanship,6,2,4
15600,Thugio,sargeras,192,hunter,marksmanship,6,2,4
15601,Gangstashot,burning-legion,192,hunter,marksmanship,6,2,4
15602,Gadorim,kelthuzad,192,hunter,marksmanship,6,2,4
15603,Cuchulláin,area-52,192,hunter,marksmanship,6,2,4
15604,Rolandschitt,area-52,192,hunter,marksmanship,6,2,4
15605,Stormwardenx,turalyon,192,hunter,marksmanship,6,2,4
15606,Bendoon,sargeras,192,hunter,marksmanship,6,2,4
15607,Brindlë,kelthuzad,192,hunter,marksmanship,11,3,8
15608,Kîra,stormrage,192,hunter,marksmanship,16,3,13
15609,Gunnpowder,malganis,192,hunter,marksmanship,12,2,10
15610,Warrioress,illidan,192,hunter,marksmanship,12,2,10
15611,Hunterish,area-52,192,hunter,marksmanship,12,2,10
15612,Stïinck,azralon,192,hunter,marksmanship,12,2,10
15613,Xulag,tichondrius,192,hunter,marksmanship,12,2,10
15614,Jahvekhunter,area-52,192,hunter,marksmanship,12,2,10
15615,Dojaqat,frostmourne,192,hunter,marksmanship,12,2,10
15616,Sharpzy,jubeithos,192,hunter,marksmanship,12,2,10
15617,Warpedshots,malganis,192,hunter,marksmanship,12,2,10
15618,Littleagu,proudmoore,192,hunter,marksmanship,12,2,10
15619,Killdred,bonechewer,192,hunter,marksmanship,12,2,10
15620,Larts,fenris,192,hunter,marksmanship,12,2,10
15621,Jmonger,runetotem,192,hunter,marksmanship,12,2,10
15622,Hatros,stormrage,192,hunter,marksmanship,12,2,10
15623,Otirrub,deathwing,192,hunter,marksmanship,12,2,10
15624,Zumythriel,stormrage,192,hunter,marksmanship,12,2,10
15625,Seekem,destromath,192,hunter,marksmanship,12,2,10
15626,Luvtits,bonechewer,192,hunter,marksmanship,12,2,10
15627,Sevitham,dalaran,192,hunter,marksmanship,12,2,10
15628,Shafttrapper,queldorei,192,hunter,marksmanship,12,2,10
15629,Eaglesx,skullcrusher,192,hunter,marksmanship,12,2,10
15630,Findbind,altar-of-storms,192,hunter,marksmanship,12,2,10
15631,Luffzy,barthilas,192,hunter,marksmanship,12,2,10
15632,Chinchompas,bleeding-hollow,192,hunter,marksmanship,18,2,16
15633,Griffox,frostwolf,191,hunter,marksmanship,4,3,1
15634,Vaerromar,thunderlord,191,hunter,marksmanship,6,2,4
15635,Rorrnus,blackwing-lair,191,hunter,marksmanship,6,2,4
15636,Blindshotz,moon-guard,191,hunter,marksmanship,6,2,4
15637,Sylviannas,frostmourne,191,hunter,marksmanship,6,2,4
15638,Donchy,proudmoore,191,hunter,marksmanship,6,2,4
15639,Dorg,azjolnerub,191,hunter,marksmanship,6,2,4
15640,Wörg,elune,191,hunter,marksmanship,6,2,4
15641,Actaeom,area-52,191,hunter,marksmanship,12,2,10
15642,Ragehunter,scilla,191,hunter,marksmanship,12,2,10
15643,ßonßon,stormrage,160,hunter,marksmanship,10,2,8
15644,Hunntard,veknilash,159,hunter,marksmanship,5,2,3
15645,Dropitëns,nemesis,159,hunter,marksmanship,5,2,3
15646,Gonnujo,ragnaros,159,hunter,marksmanship,5,2,3
15647,Mhyalî,moon-guard,159,hunter,marksmanship,5,2,3
15648,Amorial,barthilas,159,hunter,marksmanship,5,2,3
15649,Clintbartun,shadowsong,159,hunter,marksmanship,5,2,3
15650,Thesloott,azshara,159,hunter,marksmanship,5,2,3
15651,Dusle,azralon,138,hunter,marksmanship,8,3,5
15652,Darthski,drenden,138,hunter,marksmanship,12,4,8
15653,Pvrisxoxo,frostmourne,138,hunter,marksmanship,9,3,6
15654,Huntersaul,dalvengyr,138,hunter,marksmanship,11,3,8
15655,Tinylegzz,illidan,138,hunter,marksmanship,14,3,11
15656,Winstônwolf,spinebreaker,138,hunter,marksmanship,19,4,15
15657,Plsnobanmee,frostmourne,137,hunter,marksmanship,9,5,4
15658,Swm,nazjatar,128,hunter,marksmanship,4,2,2
15659,Yarthax,illidan,128,hunter,marksmanship,4,2,2
15660,Mookvader,illidan,128,hunter,marksmanship,4,2,2
15661,Lúthiel,azralon,127,hunter,marksmanship,8,2,6
15662,Ïmprîsôñ,dalaran,96,hunter,marksmanship,3,2,1
15663,Cesz,ragnaros,96,hunter,marksmanship,3,2,1
15664,Shootr,darkspear,96,hunter,marksmanship,3,2,1
15665,Bensonlmn,tichondrius,96,hunter,marksmanship,9,2,7
15666,Htcrazykofwa,tichondrius,96,hunter,marksmanship,6,1,5
15667,Slaughterr,kelthuzad,96,hunter,marksmanship,6,1,5
15668,Ruvathir,wyrmrest-accord,96,hunter,marksmanship,6,1,5
15669,Arawnz,emerald-dream,96,hunter,marksmanship,6,1,5
15670,Coppersnout,wyrmrest-accord,96,hunter,marksmanship,6,1,5
15671,Zirstorm,altar-of-storms,96,hunter,marksmanship,6,1,5
15672,Zünma,tichondrius,96,hunter,marksmanship,6,1,5
15673,Siimmplicitz,area-52,96,hunter,marksmanship,6,1,5
15674,Rämbow,frostmourne,96,hunter,marksmanship,6,1,5
15675,Legoretzlas,durotan,96,hunter,marksmanship,6,1,5
15676,Blaptz,wyrmrest-accord,96,hunter,marksmanship,6,1,5
15677,Hyena,kelthuzad,96,hunter,marksmanship,6,1,5
15678,Samanta,blood-furnace,96,hunter,marksmanship,6,1,5
15679,Jaidev,nemesis,96,hunter,marksmanship,6,1,5
15680,Crazyshot,drakkari,96,hunter,marksmanship,6,1,5
15681,Boongtokes,illidan,96,hunter,marksmanship,6,1,5
15682,Gabitoqt,gallywix,96,hunter,marksmanship,6,1,5
15683,Desarus,archimonde,96,hunter,marksmanship,6,1,5
15684,Garkia,hyjal,96,hunter,marksmanship,6,1,5
15685,Nightfall,azshara,96,hunter,marksmanship,6,1,5
15686,Jumeog,stormscale,96,hunter,marksmanship,6,1,5
15687,Exitwoundz,hyjal,96,hunter,marksmanship,6,1,5
15688,Insönnia,azralon,96,hunter,marksmanship,6,1,5
15689,Elaestel,moon-guard,96,hunter,marksmanship,6,1,5
15690,Brutalhit,bonechewer,96,hunter,marksmanship,6,1,5
15691,Autaila,thunderlord,96,hunter,marksmanship,6,1,5
15692,Lemmetrap,illidan,96,hunter,marksmanship,6,1,5
15693,Ashner,illidan,96,hunter,marksmanship,6,1,5
15694,Seizedhunt,frostmourne,96,hunter,marksmanship,6,1,5
15695,Fritzy,nazjatar,96,hunter,marksmanship,6,1,5
15696,Hopsmatei,azralon,96,hunter,marksmanship,6,1,5
15697,Cocobage,destromath,96,hunter,marksmanship,6,1,5
15698,Laudion,quelthalas,96,hunter,marksmanship,6,1,5
15699,Feignqt,illidan,96,hunter,marksmanship,6,1,5
15700,Kkurama,area-52,96,hunter,marksmanship,6,1,5
15701,Anndaria,tichondrius,96,hunter,marksmanship,6,1,5
15702,Narukín,tichondrius,96,hunter,marksmanship,6,1,5
15703,Ethùg,area-52,96,hunter,marksmanship,6,1,5
15704,Dalzar,darkspear,96,hunter,marksmanship,6,1,5
15705,Sarutovy,kelthuzad,96,hunter,marksmanship,6,1,5
15706,Konflako,quelthalas,96,hunter,marksmanship,6,1,5
15707,Shortbow,nordrassil,96,hunter,marksmanship,6,1,5
15708,Shootdogg,mannoroth,96,hunter,marksmanship,6,1,5
15709,Nodar,quelthalas,96,hunter,marksmanship,6,1,5
15710,Fingamyquill,tichondrius,96,hunter,marksmanship,6,1,5
15711,Saeculorum,azralon,96,hunter,marksmanship,6,1,5
15712,Puppyghoul,malganis,96,hunter,marksmanship,6,1,5
15713,Vilguz,illidan,96,hunter,marksmanship,6,1,5
15714,Elknut,sargeras,96,hunter,marksmanship,6,1,5
15715,Kiatus,nesingwary,96,hunter,marksmanship,6,1,5
15716,Romro,norgannon,96,hunter,marksmanship,6,1,5
15717,Bowbaggins,stormrage,96,hunter,marksmanship,6,1,5
15718,Longshott,azralon,96,hunter,marksmanship,6,1,5
15719,Hovahdo,proudmoore,96,hunter,marksmanship,6,1,5
15720,Brändöncody,stormrage,96,hunter,marksmanship,6,1,5
15721,Fawn,moon-guard,96,hunter,marksmanship,6,1,5
15722,Rensv,frostmourne,96,hunter,marksmanship,6,1,5
15723,Smackadoodlé,illidan,96,hunter,marksmanship,6,1,5
15724,Darkarcher,hyjal,96,hunter,marksmanship,6,1,5
15725,Arrowenn,zuljin,96,hunter,marksmanship,6,1,5
15726,Solderboi,tichondrius,96,hunter,marksmanship,6,1,5
15727,Hyora,tichondrius,96,hunter,marksmanship,6,1,5
15728,Minnervva,malganis,96,hunter,marksmanship,6,1,5
15729,Lailyann,sargeras,96,hunter,marksmanship,6,1,5
15730,Clacktar,wyrmrest-accord,96,hunter,marksmanship,6,1,5
15731,Savageshot,daggerspine,96,hunter,marksmanship,6,1,5
15732,Wolfmastera,zuljin,96,hunter,marksmanship,6,1,5
15733,Artilleria,quelthalas,96,hunter,marksmanship,6,1,5
15734,Arin,suramar,96,hunter,marksmanship,6,1,5
15735,Ikiteforgold,zuljin,96,hunter,marksmanship,6,1,5
15736,Necroshotz,kul-tiras,96,hunter,marksmanship,6,1,5
15737,Faceshots,tichondrius,96,hunter,marksmanship,6,1,5
15738,Gunwalk,azjolnerub,96,hunter,marksmanship,6,1,5
15739,Qua,perenolde,96,hunter,marksmanship,6,1,5
15740,Maquire,tichondrius,96,hunter,marksmanship,6,1,5
15741,Allerios,alleria,96,hunter,marksmanship,6,1,5
15742,Staytrill,tichondrius,96,hunter,marksmanship,6,1,5
15743,Cowboytroy,exodar,96,hunter,marksmanship,6,1,5
15744,Hellcry,khadgar,96,hunter,marksmanship,6,1,5
15745,Wínchester,stormrage,96,hunter,marksmanship,6,1,5
15746,Wellfaír,area-52,96,hunter,marksmanship,6,1,5
15747,Barginmeal,undermine,96,hunter,marksmanship,6,1,5
15748,Lostkníght,ragnaros,96,hunter,marksmanship,6,1,5
15749,Evemae,sargeras,96,hunter,marksmanship,6,1,5
15750,Poizon,gorefiend,96,hunter,marksmanship,6,1,5
15751,Shootermgavn,frostmourne,96,hunter,marksmanship,6,1,5
15752,Luthairian,sargeras,96,hunter,marksmanship,6,1,5
15753,Panchovill,ragnaros,96,hunter,marksmanship,6,1,5
15754,Traxêx,nemesis,96,hunter,marksmanship,6,1,5
15755,Pinheira,nemesis,96,hunter,marksmanship,6,1,5
15756,Nikolov,proudmoore,96,hunter,marksmanship,6,1,5
15757,Citizen,dragonmaw,96,hunter,marksmanship,6,1,5
15758,Dogtagluke,stormrage,96,hunter,marksmanship,6,1,5
15759,Terezhunt,tichondrius,96,hunter,marksmanship,6,1,5
15760,Ruhak,windrunner,96,hunter,marksmanship,6,1,5
15761,Naturan,drakkari,96,hunter,marksmanship,6,1,5
15762,Zral,dragonmaw,96,hunter,marksmanship,6,1,5
15763,Biehuixin,tichondrius,96,hunter,marksmanship,6,1,5
15764,Prozerpine,tichondrius,96,hunter,marksmanship,6,1,5
15765,Clydebarro,sargeras,96,hunter,marksmanship,6,1,5
15766,Nickaz,frostmourne,96,hunter,marksmanship,8,1,7
15767,Missedshot,frostmourne,96,hunter,marksmanship,12,1,11
15768,Kofan,darkspear,96,hunter,marksmanship,12,1,11
15769,Lawyernickk,thrall,96,hunter,marksmanship,12,1,11
15770,Hawneyduo,skullcrusher,96,hunter,marksmanship,12,1,11
15771,Jacobsladder,illidan,96,hunter,marksmanship,12,1,11
15772,Tarapandas,kilrogg,96,hunter,marksmanship,12,1,11
15773,Gorthmog,daggerspine,96,hunter,marksmanship,12,1,11
15774,Bophadeaz,sargeras,96,hunter,marksmanship,12,1,11
15775,Xalmoinmybow,illidan,96,hunter,marksmanship,12,1,11
15776,Elanor,feathermoon,96,hunter,marksmanship,18,1,17
15777,Strixis,blood-furnace,95,hunter,marksmanship,6,1,5
15778,Trionias,malfurion,79,hunter,marksmanship,5,1,4
15779,Bownappetite,bleeding-hollow,79,hunter,marksmanship,5,1,4
15780,Setbackhunt,illidan,79,hunter,marksmanship,5,1,4
15781,Huntsmate,tichondrius,64,hunter,marksmanship,4,1,3
15782,Coffetaum,illidan,64,hunter,marksmanship,4,1,3
15783,Raymose,tichondrius,64,hunter,marksmanship,4,1,3
15784,Creatuuree,zuljin,64,hunter,marksmanship,4,1,3
15785,Nyloc,dalvengyr,64,hunter,marksmanship,4,1,3
15786,Archemp,stormrage,64,hunter,marksmanship,4,1,3
15787,Boyarsky,area-52,48,hunter,marksmanship,3,1,2
15788,Killarth,quelthalas,48,hunter,marksmanship,3,1,2
15789,Ahncheolsoo,tichondrius,42,hunter,marksmanship,11,2,9
15790,Lovedietdew,borean-tundra,42,hunter,marksmanship,15,2,13
15791,Dapoosyx,tichondrius,31,hunter,marksmanship,2,1,1
15792,Suntail,dalaran,2208,hunter,survival,111,58,53
15793,Saiiph,bleeding-hollow,2169,hunter,survival,144,74,70
15794,Cëb,stormrage,2157,hunter,survival,168,84,84
15795,Disciple,darkspear,2152,hunter,survival,74,43,31
15796,Buffmm,kelthuzad,2130,hunter,survival,90,46,44
15797,Cndavyjones,akama,2130,hunter,survival,138,68,70
15798,Hotmuscleman,tichondrius,2127,hunter,survival,74,45,29
15799,Malukaca,azralon,2121,hunter,survival,137,69,68
15800,Capncams,emerald-dream,2120,hunter,survival,130,68,62
15801,Missedmytrap,draenor,2109,hunter,survival,71,44,27
15802,Cadencex,stormrage,2101,hunter,survival,141,71,70
15803,Kansolly,tichondrius,2091,hunter,survival,111,59,52
15804,Aimbotmir,zuljin,2083,hunter,survival,86,40,46
15805,Bonquiesha,area-52,2074,hunter,survival,49,34,15
15806,Pridefulz,stormrage,2062,hunter,survival,170,85,85
15807,Gloomy,dark-iron,2054,hunter,survival,54,41,13
15808,Ferex,tichondrius,2048,hunter,survival,69,42,27
15809,Legoelass,emerald-dream,2040,hunter,survival,191,105,86
15810,Djtraphouse,stormrage,2013,hunter,survival,132,67,65
15811,Kubu,emerald-dream,2012,hunter,survival,133,83,50
15812,Ungrella,malganis,2001,hunter,survival,81,44,37
15813,Wmsgs,tichondrius,1998,hunter,survival,201,99,102
15814,Töxic,dalaran,1996,hunter,survival,73,43,30
15815,Dijhoni,moon-guard,1996,hunter,survival,137,72,65
15816,Survchris,bleeding-hollow,1994,hunter,survival,79,44,35
15817,Noimnotokay,tichondrius,1992,hunter,survival,113,57,56
15818,Pathofsexile,tichondrius,1989,hunter,survival,224,119,105
15819,Maxiam,frostmourne,1989,hunter,survival,71,37,34
15820,Nearly,wyrmrest-accord,1987,hunter,survival,79,40,39
15821,Queríde,emerald-dream,1982,hunter,survival,71,50,21
15822,Veyronnx,stormrage,1980,hunter,survival,108,62,46
15823,Budika,ragnaros,1973,hunter,survival,42,30,12
15824,Dyucol,tichondrius,1971,hunter,survival,172,98,74
15825,Hamslapper,shattered-hand,1971,hunter,survival,135,66,69
15826,Bicmex,sargeras,1970,hunter,survival,42,29,13
15827,Xyzv,tichondrius,1965,hunter,survival,81,41,40
15828,Coggenda,sargeras,1964,hunter,survival,264,145,119
15829,Hwslol,tichondrius,1964,hunter,survival,154,84,70
15830,Pokìmane,tichondrius,1961,hunter,survival,98,62,36
15831,Galavant,frostmourne,1960,hunter,survival,98,52,46
15832,Lèkïnhø,azralon,1953,hunter,survival,84,42,42
15833,Aurelx,tichondrius,1950,hunter,survival,48,32,16
15834,Koupon,tichondrius,1949,hunter,survival,131,65,66
15835,Briggsx,sargeras,1948,hunter,survival,54,29,25
15836,Endsnear,stormrage,1944,hunter,survival,126,61,65
15837,Sikhunt,frostmourne,1939,hunter,survival,60,35,25
15838,Ynoit,sargeras,1939,hunter,survival,94,49,45
15839,Robotwo,illidan,1937,hunter,survival,54,36,18
15840,Neverturtlex,tichondrius,1929,hunter,survival,42,24,18
15841,Anisphia,tichondrius,1928,hunter,survival,281,150,131
15842,Foxyhood,ragnaros,1927,hunter,survival,143,76,67
15843,Dirtysoap,sargeras,1918,hunter,survival,66,32,34
15844,Dwx,bleeding-hollow,1915,hunter,survival,84,44,40
15845,Leonilc,tichondrius,1907,hunter,survival,78,36,42
15846,Queride,area-52,1902,hunter,survival,66,31,35
15847,Fictìon,kelthuzad,1895,hunter,survival,58,32,26
15848,Stinkyfob,barthilas,1890,hunter,survival,72,41,31
15849,Møéÿsgïrîxø,tichondrius,1888,hunter,survival,31,20,11
15850,Otii,tichondrius,1880,hunter,survival,172,82,90
15851,Drasen,deathwing,1874,hunter,survival,54,30,24
15852,Bergy,thrall,1873,hunter,survival,54,30,24
15853,Kzmo,gnomeregan,1870,hunter,survival,30,23,7
15854,Chimeralol,area-52,1869,hunter,survival,126,79,47
15855,Nishinos,tichondrius,1868,hunter,survival,297,152,145
15856,Notnunca,tichondrius,1865,hunter,survival,66,34,32
15857,Jalinhabbei,azralon,1862,hunter,survival,53,28,25
15858,Dirtysoap,tichondrius,1861,hunter,survival,63,31,32
15859,Saltstream,tichondrius,1860,hunter,survival,114,53,61
15860,Gvoo,tichondrius,1858,hunter,survival,36,28,8
15861,Covlol,illidan,1857,hunter,survival,42,21,21
15862,Runecrossbow,barthilas,1855,hunter,survival,162,79,83
15863,Destrumz,zuljin,1855,hunter,survival,66,31,35
15864,Tyjes,stormrage,1851,hunter,survival,75,41,34
15865,Chiline,frostmourne,1849,hunter,survival,54,29,25
15866,Truckrsaurus,tichondrius,1849,hunter,survival,105,56,49
15867,Ikiteforfood,zuljin,1847,hunter,survival,32,20,12
15868,Kelarcia,moon-guard,1846,hunter,survival,65,29,36
15869,Cadenxr,bleeding-hollow,1844,hunter,survival,38,25,13
15870,Pylorih,area-52,1842,hunter,survival,51,35,16
15871,Neonjz,ragnaros,1841,hunter,survival,66,31,35
15872,Raef,azralon,1838,hunter,survival,72,38,34
15873,Ordius,azralon,1837,hunter,survival,60,33,27
15874,Ssds,sargeras,1834,hunter,survival,42,26,16
15875,Foxwalk,nemesis,1834,hunter,survival,70,33,37
15876,Mørødox,sargeras,1832,hunter,survival,30,23,7
15877,Fizzleegear,area-52,1831,hunter,survival,189,92,97
15878,Exhausted,blackrock,1829,hunter,survival,90,38,52
15879,Sobit,tichondrius,1827,hunter,survival,36,23,13
15880,Goonsh,tichondrius,1826,hunter,survival,48,32,16
15881,Mlemily,stormrage,1826,hunter,survival,47,31,16
15882,Éshen,illidan,1826,hunter,survival,101,53,48
15883,Effyh,emerald-dream,1825,hunter,survival,176,89,87
15884,Aaggros,sargeras,1825,hunter,survival,42,20,22
15885,Bjornwald,thrall,1824,hunter,survival,410,214,196
15886,Angrybow,ragnaros,1821,hunter,survival,36,25,11
15887,Misogynistaf,tichondrius,1821,hunter,survival,40,22,18
15888,Thoromel,wyrmrest-accord,1820,hunter,survival,66,33,33
15889,Shootin,frostmourne,1817,hunter,survival,60,34,26
15890,Pivott,wyrmrest-accord,1817,hunter,survival,307,167,140
15891,Alphaqt,dethecus,1816,hunter,survival,48,27,21
15892,Savagerko,illidan,1816,hunter,survival,75,42,33
15893,Concur,frostmourne,1816,hunter,survival,132,69,63
15894,Kisuke,khaz-modan,1815,hunter,survival,54,34,20
15895,Trapula,tichondrius,1814,hunter,survival,84,46,38
15896,Terapista,area-52,1813,hunter,survival,90,45,45
15897,Leaku,illidan,1810,hunter,survival,64,41,23
15898,Axezul,tichondrius,1810,hunter,survival,78,45,33
15899,Emart,bloodhoof,1810,hunter,survival,69,32,37
15900,Percival,firetree,1809,hunter,survival,48,25,23
15901,Joón,moon-guard,1808,hunter,survival,43,26,17
15902,Jagaerz,emerald-dream,1808,hunter,survival,42,23,19
15903,Krømatik,tichondrius,1807,hunter,survival,42,23,19
15904,Adjusted,frostmourne,1802,hunter,survival,36,21,15
15905,Ratonh,ragnaros,1801,hunter,survival,156,88,68
15906,Huntmon,nemesis,1800,hunter,survival,48,31,17
15907,Gabiña,tichondrius,1800,hunter,survival,311,154,157
15908,Jîñßæçhïñæ,sargeras,1800,hunter,survival,66,29,37
15909,Moroally,sargeras,1799,hunter,survival,42,25,17
15910,Kensho,illidan,1798,hunter,survival,73,33,40
15911,Carnidon,area-52,1796,hunter,survival,193,97,96
15912,Caiodluffy,malganis,1791,hunter,survival,78,41,37
15913,Hibyexo,illidan,1788,hunter,survival,42,27,15
15914,Lawyerpbj,tichondrius,1788,hunter,survival,42,21,21
15915,Skàdii,tichondrius,1778,hunter,survival,115,63,52
15916,Lenacraft,frostmourne,1776,hunter,survival,54,31,23
15917,Buffnac,tichondrius,1775,hunter,survival,54,25,29
15918,Sniffler,barthilas,1772,hunter,survival,42,19,23
15919,Acres,emerald-dream,1765,hunter,survival,66,32,34
15920,Sylvanne,sargeras,1762,hunter,survival,57,28,29
15921,Douggigadome,illidan,1761,hunter,survival,36,21,15
15922,Pathed,azralon,1761,hunter,survival,54,31,23
15923,Woriath,quelthalas,1761,hunter,survival,96,50,46
15924,Finito,bladefist,1760,hunter,survival,279,136,143
15925,Kimchishotxo,tichondrius,1756,hunter,survival,41,22,19
15926,Sensator,barthilas,1753,hunter,survival,58,33,25
15927,Vlf,tichondrius,1753,hunter,survival,60,30,30
15928,Ingridaniela,aegwynn,1749,hunter,survival,36,25,11
15929,Henroyer,quelthalas,1733,hunter,survival,48,30,18
15930,Envoltorio,ragnaros,1732,hunter,survival,54,30,24
15931,Svhunt,frostmourne,1727,hunter,survival,37,21,16
15932,Peppancini,wyrmrest-accord,1725,hunter,survival,53,34,19
15933,Vigon,stormrage,1725,hunter,survival,111,62,49
15934,Wvwvwvwvwvww,stormrage,1721,hunter,survival,42,24,18
15935,Buttercocoa,kelthuzad,1712,hunter,survival,36,18,18
15936,Stevemonday,stormrage,1711,hunter,survival,96,53,43
15937,Focús,laughing-skull,1711,hunter,survival,90,42,48
15938,Henhøuse,illidan,1710,hunter,survival,54,25,29
15939,Yeahimsad,tichondrius,1709,hunter,survival,24,18,6
15940,Limpingspoon,kelthuzad,1709,hunter,survival,144,83,61
15941,Garfieldbb,tichondrius,1709,hunter,survival,48,24,24
15942,Soyos,sargeras,1707,hunter,survival,116,64,52
15943,Sartel,tichondrius,1706,hunter,survival,190,93,97
15944,Názzul,area-52,1705,hunter,survival,30,18,12
15945,Partz,darkspear,1702,hunter,survival,56,35,21
15946,Poston,ragnaros,1701,hunter,survival,111,55,56
15947,Javlinz,thrall,1701,hunter,survival,44,20,24
15948,Trevyx,aegwynn,1700,hunter,survival,66,39,27
15949,Scytsbow,illidan,1700,hunter,survival,48,26,22
15950,Samcro,rivendare,1700,hunter,survival,65,33,32
15951,Toxarch,aggramar,1698,hunter,survival,48,26,22
15952,Yip,moon-guard,1698,hunter,survival,39,20,19
15953,Spinze,stormrage,1697,hunter,survival,35,23,12
15954,Xtralitê,tichondrius,1696,hunter,survival,50,38,12
15955,Bbaronsamedi,darkspear,1693,hunter,survival,51,27,24
15956,Plainrain,tichondrius,1691,hunter,survival,36,23,13
15957,Gnarwallz,stormrage,1691,hunter,survival,60,32,28
15958,Saelym,arthas,1690,hunter,survival,36,18,18
15959,Táká,quelthalas,1689,hunter,survival,60,38,22
15960,Knewbee,emerald-dream,1689,hunter,survival,69,37,32
15961,Noxtis,kiljaeden,1689,hunter,survival,36,18,18
15962,Arrów,duskwood,1688,hunter,survival,36,18,18
15963,Boogiemas,akama,1686,hunter,survival,30,20,10
15964,Zêrø,moon-guard,1685,hunter,survival,30,20,10
15965,Budgetben,stormrage,1682,hunter,survival,33,19,14
15966,Blåker,bleeding-hollow,1682,hunter,survival,96,49,47
15967,Nussyo,tichondrius,1679,hunter,survival,54,26,28
15968,Grandpopjim,illidan,1678,hunter,survival,36,20,16
15969,Snowynightt,proudmoore,1678,hunter,survival,174,86,88
15970,Mambothehunt,stormrage,1677,hunter,survival,60,25,35
15971,Róckzero,quelthalas,1675,hunter,survival,181,89,92
15972,Shablagoosh,zuljin,1672,hunter,survival,45,23,22
15973,Arsk,ragnaros,1670,hunter,survival,45,19,26
15974,Dju,stormrage,1665,hunter,survival,60,27,33
15975,Interleukin,frostwolf,1664,hunter,survival,244,132,112
15976,Crypy,illidan,1664,hunter,survival,48,24,24
15977,Trapgodxo,moon-guard,1658,hunter,survival,27,19,8
15978,Fleche,aggramar,1658,hunter,survival,30,20,10
15979,Wingclippin,stormrage,1656,hunter,survival,36,22,14
15980,Viólenc,tichondrius,1654,hunter,survival,48,25,23
15981,Reeiko,ragnaros,1653,hunter,survival,42,25,17
15982,Ganemdar,sargeras,1653,hunter,survival,57,22,35
15983,Frêäkk,ragnaros,1649,hunter,survival,39,21,18
15984,Ajacs,zuljin,1647,hunter,survival,35,24,11
15985,Undien,area-52,1647,hunter,survival,60,35,25
15986,Yolloswag,tichondrius,1645,hunter,survival,126,69,57
15987,Survïvalïst,bleeding-hollow,1643,hunter,survival,35,21,14
15988,Krøww,azralon,1642,hunter,survival,39,22,17
15989,Clawdio,ragnaros,1641,hunter,survival,114,60,54
15990,Krouno,ragnaros,1641,hunter,survival,48,25,23
15991,Ryukotsu,tichondrius,1641,hunter,survival,49,24,25
15992,Bendotexe,stormrage,1638,hunter,survival,36,21,15
15993,Iyne,stormrage,1635,hunter,survival,36,23,13
15994,Asarden,jubeithos,1635,hunter,survival,78,44,34
15995,Downer,antonidas,1635,hunter,survival,71,38,33
15996,Huntardadoo,nemesis,1634,hunter,survival,45,23,22
15997,Covloltrap,illidan,1633,hunter,survival,24,21,3
15998,Vhelkan,senjin,1632,hunter,survival,42,26,16
15999,Nimeer,tichondrius,1632,hunter,survival,82,45,37
16000,Moartraps,zuljin,1631,hunter,survival,42,24,18
16001,Nightarrows,area-52,1626,hunter,survival,41,24,17
16002,Fälke,stormrage,1626,hunter,survival,42,23,19
16003,Hazzeth,thrall,1625,hunter,survival,30,19,11
16004,Glockin,zuljin,1625,hunter,survival,30,17,13
16005,Bigbillx,tichondrius,1623,hunter,survival,30,17,13
16006,Shakeasaurus,sargeras,1622,hunter,survival,42,20,22
16007,Viòlenc,tichondrius,1621,hunter,survival,41,24,17
16008,Skyland,tichondrius,1621,hunter,survival,60,32,28
16009,Dazarrow,burning-blade,1621,hunter,survival,47,20,27
16010,Køjo,emerald-dream,1620,hunter,survival,50,31,19
16011,Mxabyycc,tichondrius,1619,hunter,survival,60,33,27
16012,Shinhyez,tichondrius,1618,hunter,survival,42,21,21
16013,Awârz,drakkari,1615,hunter,survival,44,27,17
16014,Cuddlestomp,magtheridon,1614,hunter,survival,46,24,22
16015,Kaitoo,tichondrius,1613,hunter,survival,59,32,27
16016,Huntingjutsu,kelthuzad,1612,hunter,survival,53,34,19
16017,Xenonviper,bleeding-hollow,1612,hunter,survival,114,59,55
16018,Blackdevil,magtheridon,1612,hunter,survival,54,25,29
16019,Mmx,whisperwind,1611,hunter,survival,67,40,27
16020,Swordshot,moon-guard,1611,hunter,survival,109,55,54
16021,Uhm,laughing-skull,1610,hunter,survival,106,59,47
16022,Fkurrules,frostmourne,1608,hunter,survival,109,59,50
16023,Haemøphilus,area-52,1606,hunter,survival,36,21,15
16024,Killshøtß,tichondrius,1604,hunter,survival,102,51,51
16025,Tøkÿöghøül,agamaggan,1603,hunter,survival,30,19,11
16026,Nicochan,senjin,1603,hunter,survival,76,34,42
16027,Schurk,illidan,1602,hunter,survival,120,64,56
16028,Adobo,garona,1600,hunter,survival,30,21,9
16029,Zakorai,thrall,1600,hunter,survival,146,85,61
16030,Imapacifist,barthilas,1600,hunter,survival,69,37,32
16031,Nandorius,proudmoore,1599,hunter,survival,78,38,40
16032,Rojpube,frostmourne,1596,hunter,survival,35,17,18
16033,Apokryph,stormrage,1595,hunter,survival,94,65,29
16034,Mckim,tichondrius,1595,hunter,survival,47,23,24
16035,Kukulkan,haomarush,1592,hunter,survival,132,71,61
16036,Arcobaleno,tichondrius,1592,hunter,survival,36,19,17
16037,Keelif,arthas,1588,hunter,survival,29,17,12
16038,Stylebende,tichondrius,1588,hunter,survival,42,22,20
16039,Noxickk,sargeras,1587,hunter,survival,30,19,11
16040,Squeakerx,sargeras,1585,hunter,survival,29,19,10
16041,Liekis,darkspear,1585,hunter,survival,66,27,39
16042,Wildoldman,stormrage,1583,hunter,survival,24,17,7
16043,Jésús,dalaran,1581,hunter,survival,33,17,16
16044,Wharble,illidan,1578,hunter,survival,60,35,25
16045,Arazian,stormrage,1578,hunter,survival,52,29,23
16046,Cybella,darkspear,1578,hunter,survival,53,26,27
16047,Xtina,drakkari,1577,hunter,survival,71,40,31
16048,Randël,nemesis,1576,hunter,survival,77,43,34
16049,Helïos,drakkari,1576,hunter,survival,54,29,25
16050,Hrywnn,azralon,1573,hunter,survival,236,125,111
16051,Bigiesmalls,moon-guard,1572,hunter,survival,54,28,26
16052,Titanaxis,tichondrius,1572,hunter,survival,266,136,130
16053,Lovethabeans,zangarmarsh,1571,hunter,survival,59,35,24
16054,Xebbec,sargeras,1571,hunter,survival,80,43,37
16055,Drifting,bleeding-hollow,1569,hunter,survival,66,37,29
16056,Warhog,wyrmrest-accord,1568,hunter,survival,67,35,32
16057,Dirtypolee,bleeding-hollow,1568,hunter,survival,46,24,22
16058,Fabfilter,tichondrius,1564,hunter,survival,40,21,19
16059,Pedropete,barthilas,1564,hunter,survival,42,17,25
16060,Vinnieone,kiljaeden,1561,hunter,survival,30,20,10
16061,Ryohlin,sargeras,1561,hunter,survival,54,32,22
16062,Mckennagrace,tichondrius,1558,hunter,survival,54,29,25
16063,Huntranger,malganis,1555,hunter,survival,53,28,25
16064,Réxon,quelthalas,1555,hunter,survival,117,53,64
16065,Ripsurvival,area-52,1554,hunter,survival,46,27,19
16066,Aheefeog,proudmoore,1553,hunter,survival,39,23,16
16067,Lfg,bleeding-hollow,1553,hunter,survival,53,31,22
16068,Kimbaa,tichondrius,1553,hunter,survival,83,41,42
16069,Huntasaurus,saurfang,1553,hunter,survival,66,32,34
16070,Hildebald,moon-guard,1549,hunter,survival,64,37,27
16071,Shooting,sargeras,1548,hunter,survival,111,59,52
16072,Demtings,dark-iron,1545,hunter,survival,50,21,29
16073,Equilibrium,tol-barad,1544,hunter,survival,147,76,71
16074,Prv,stormrage,1542,hunter,survival,36,23,13
16075,Dephobius,azralon,1540,hunter,survival,71,37,34
16076,Legalt,tichondrius,1539,hunter,survival,80,42,38
16077,Violénc,tichondrius,1538,hunter,survival,46,18,28
16078,Lyler,tichondrius,1535,hunter,survival,57,32,25
16079,Opsi,ragnaros,1535,hunter,survival,58,27,31
16080,Trapdaddyx,thrall,1534,hunter,survival,24,16,8
16081,Darkvicious,area-52,1532,hunter,survival,53,27,26
16082,Viiu,sargeras,1528,hunter,survival,24,16,8
16083,Arrowmatic,frostmourne,1527,hunter,survival,24,16,8
16084,Exh,tichondrius,1527,hunter,survival,107,52,55
16085,Holbrook,greymane,1526,hunter,survival,35,21,14
16086,Berenal,moon-guard,1525,hunter,survival,162,77,85
16087,Sativ,moknathal,1524,hunter,survival,54,27,27
16088,Offensive,dragonmaw,1522,hunter,survival,49,28,21
16089,Dorkins,azralon,1521,hunter,survival,75,35,40
16090,Meowtard,kaelthas,1520,hunter,survival,66,31,35
16091,Rhyzen,drenden,1519,hunter,survival,30,18,12
16092,Dooper,malfurion,1518,hunter,survival,99,47,52
16093,Brewster,burning-legion,1517,hunter,survival,30,16,14
16094,Ifoxs,bleeding-hollow,1517,hunter,survival,30,16,14
16095,Ronnïn,proudmoore,1517,hunter,survival,42,21,21
16096,Lilgayjared,kelthuzad,1513,hunter,survival,64,39,25
16097,Trap,vashj,1512,hunter,survival,36,21,15
16098,Ceejaee,tichondrius,1511,hunter,survival,66,31,35
16099,Mateko,amanthul,1510,hunter,survival,74,35,39
16100,Ajira,stormrage,1504,hunter,survival,63,34,29
16101,Jubulba,frostwolf,1502,hunter,survival,24,16,8
16102,Kurnos,hyjal,1500,hunter,survival,46,27,19
16103,Spromix,ragnaros,1500,hunter,survival,42,23,19
16104,Pfizershot,tichondrius,1496,hunter,survival,54,28,26
16105,Fâmôûs,tichondrius,1495,hunter,survival,36,19,17
16106,Tharoks,tichondrius,1495,hunter,survival,60,30,30
16107,Gilæd,kelthuzad,1493,hunter,survival,41,21,20
16108,Nigthunt,quelthalas,1491,hunter,survival,69,39,30
16109,Dogwoöd,emerald-dream,1488,hunter,survival,30,16,14
16110,Met,dentarg,1488,hunter,survival,56,26,30
16111,Fuzzypjs,stormrage,1486,hunter,survival,53,34,19
16112,Kekkww,hyjal,1486,hunter,survival,40,17,23
16113,Trumpmerica,illidan,1486,hunter,survival,58,20,38
16114,Woeisyou,stormrage,1484,hunter,survival,48,23,25
16115,Darkèlfo,azralon,1483,hunter,survival,64,39,25
16116,Crongar,magtheridon,1480,hunter,survival,36,18,18
16117,Bambii,fizzcrank,1479,hunter,survival,63,32,31
16118,Fangtreason,sargeras,1478,hunter,survival,42,22,20
16119,Rooman,ragnaros,1477,hunter,survival,48,24,24
16120,Triplethreat,bleeding-hollow,1475,hunter,survival,98,52,46
16121,Elmoon,zuljin,1474,hunter,survival,36,18,18
16122,Civvo,dalaran,1472,hunter,survival,81,42,39
16123,Rúdrá,area-52,1468,hunter,survival,145,76,69
16124,Eliandriss,quelthalas,1468,hunter,survival,70,33,37
16125,Liñcoln,sargeras,1467,hunter,survival,34,18,16
16126,Altarare,ragnaros,1467,hunter,survival,279,135,144
16127,Gadorim,kelthuzad,1465,hunter,survival,133,63,70
16128,Alby,deathwing,1459,hunter,survival,67,33,34
16129,Kaawhii,stormrage,1457,hunter,survival,24,18,6
16130,Kyoü,drakkari,1457,hunter,survival,64,41,23
16131,Dversive,nagrand,1452,hunter,survival,33,18,15
16132,Shadeckz,stormrage,1451,hunter,survival,80,36,44
16133,Volkr,bleeding-hollow,1450,hunter,survival,102,51,51
16134,Iol,blades-edge,1448,hunter,survival,67,31,36
16135,Platonium,stormrage,1445,hunter,survival,44,27,17
16136,Darkarrow,hyjal,1443,hunter,survival,67,38,29
16137,Fallacies,moon-guard,1443,hunter,survival,206,107,99
16138,Shtealo,ragnaros,1443,hunter,survival,60,31,29
16139,Mayamia,ragnaros,1442,hunter,survival,60,28,32
16140,Core,gorefiend,1442,hunter,survival,45,21,24
16141,Seanpennis,barthilas,1437,hunter,survival,24,15,9
16142,Soukken,ragnaros,1437,hunter,survival,36,18,18
16143,Yiyixx,tichondrius,1437,hunter,survival,30,15,15
16144,Petrà,tichondrius,1436,hunter,survival,30,15,15
16145,Rimjobranger,bleeding-hollow,1433,hunter,survival,48,23,25
16146,Jarhar,nesingwary,1432,hunter,survival,96,44,52
16147,Toozz,frostmourne,1431,hunter,survival,24,15,9
16148,Rayuwa,azralon,1431,hunter,survival,140,70,70
16149,Violenc,tichondrius,1428,hunter,survival,30,15,15
16150,That,tichondrius,1428,hunter,survival,46,20,26
16151,Daxar,ragnaros,1428,hunter,survival,42,18,24
16152,Raiku,aggramar,1427,hunter,survival,42,20,22
16153,Quepop,demon-soul,1426,hunter,survival,48,28,20
16154,Ivansotes,quelthalas,1426,hunter,survival,45,22,23
16155,Dudemanyeah,black-dragonflight,1426,hunter,survival,112,54,58
16156,Kula,haomarush,1424,hunter,survival,52,24,28
16157,Ophois,lightbringer,1424,hunter,survival,50,19,31
16158,Shytshot,dalaran,1423,hunter,survival,67,34,33
16159,Rvn,kelthuzad,1422,hunter,survival,30,15,15
16160,Grizzlydeath,stormrage,1421,hunter,survival,54,33,21
16161,Henesis,sargeras,1421,hunter,survival,54,28,26
16162,Anaebody,stormrage,1420,hunter,survival,24,16,8
16163,Soulwarden,haomarush,1417,hunter,survival,36,17,19
16164,Exxonerous,sargeras,1414,hunter,survival,72,37,35
16165,Krimzus,hyjal,1414,hunter,survival,71,35,36
16166,Audiofly,tichondrius,1413,hunter,survival,115,63,52
16167,Hankjr,thunderlord,1410,hunter,survival,167,94,73
16168,Tejodite,thrall,1407,hunter,survival,42,20,22
16169,Weedhoof,barthilas,1406,hunter,survival,66,36,30
16170,Evilfury,tichondrius,1406,hunter,survival,184,90,94
16171,Sukr,korgath,1406,hunter,survival,122,59,63
16172,Jawbreakër,tichondrius,1405,hunter,survival,56,27,29
16173,Ogamì,aegwynn,1404,hunter,survival,46,28,18
16174,Aniraza,ragnaros,1404,hunter,survival,33,18,15
16175,Htniss,tichondrius,1401,hunter,survival,60,28,32
16176,Hunterdemond,ragnaros,1397,hunter,survival,101,49,52
16177,Animityx,illidan,1396,hunter,survival,45,23,22
16178,Kenjipoo,tichondrius,1395,hunter,survival,30,15,15
16179,Gildthorn,frostmourne,1394,hunter,survival,60,31,29
16180,Azx,tichondrius,1389,hunter,survival,60,25,35
16181,Hawkethorn,moon-guard,1388,hunter,survival,92,42,50
16182,Zänich,tichondrius,1387,hunter,survival,36,18,18
16183,Sufutih,proudmoore,1385,hunter,survival,47,21,26
16184,Toross,stormscale,1379,hunter,survival,73,29,44
16185,Bolognã,tichondrius,1378,hunter,survival,29,15,14
16186,Vilguz,illidan,1378,hunter,survival,83,39,44
16187,Kelx,azralon,1372,hunter,survival,36,17,19
16188,Figurinet,sargeras,1369,hunter,survival,30,19,11
16189,Killconfirm,sargeras,1369,hunter,survival,59,24,35
16190,Xuxoo,nemesis,1368,hunter,survival,30,16,14
16191,Fìebs,queldorei,1368,hunter,survival,53,25,28
16192,Pokeahuntasz,frostmourne,1367,hunter,survival,42,24,18
16193,Pdg,ragnaros,1365,hunter,survival,66,35,31
16194,Navagee,tichondrius,1364,hunter,survival,47,25,22
16195,Vanthel,ragnaros,1363,hunter,survival,85,43,42
16196,Gichiwalrus,emerald-dream,1362,hunter,survival,72,40,32
16197,Thalrae,quelthalas,1361,hunter,survival,60,29,31
16198,Tuohnosaj,sargeras,1358,hunter,survival,126,57,69
16199,Wetpeach,frostmourne,1357,hunter,survival,58,29,29
16200,Gunka,illidan,1349,hunter,survival,35,17,18
16201,Lavo,borean-tundra,1348,hunter,survival,37,16,21
16202,Xfo,bleeding-hollow,1346,hunter,survival,42,25,17
16203,Lamerpvp,tichondrius,1343,hunter,survival,18,14,4
16204,Darkshady,tichondrius,1343,hunter,survival,24,14,10
16205,Zizzo,eonar,1343,hunter,survival,48,23,25
16206,Ickstab,illidan,1342,hunter,survival,18,14,4
16207,Tumerok,barthilas,1342,hunter,survival,24,14,10
16208,Adroi,tichondrius,1341,hunter,survival,36,14,22
16209,Champjones,senjin,1339,hunter,survival,24,14,10
16210,Riivali,quelthalas,1338,hunter,survival,66,32,34
16211,Jollycraze,spirestone,1337,hunter,survival,18,14,4
16212,Stepzback,malganis,1337,hunter,survival,24,14,10
16213,Anêmos,ragnaros,1337,hunter,survival,24,14,10
16214,Rirand,dalaran,1336,hunter,survival,59,27,32
16215,Crissy,crushridge,1335,hunter,survival,58,31,27
16216,Jyñ,malganis,1335,hunter,survival,36,15,21
16217,Åpe,illidan,1334,hunter,survival,24,14,10
16218,Clinteastwoo,ragnaros,1334,hunter,survival,30,14,16
16219,Noguns,tichondrius,1333,hunter,survival,30,14,16
16220,Bowzørx,tichondrius,1331,hunter,survival,30,14,16
16221,Bigsexi,kiljaeden,1329,hunter,survival,62,27,35
16222,Inheart,khazgoroth,1326,hunter,survival,66,28,38
16223,Viró,sargeras,1325,hunter,survival,27,15,12
16224,Pablita,drakkari,1322,hunter,survival,24,15,9
16225,Freebeë,area-52,1320,hunter,survival,30,14,16
16226,Taiberianrex,khazgoroth,1317,hunter,survival,48,28,20
16227,Buggyhuntz,stormrage,1317,hunter,survival,42,16,26
16228,Bangerzx,stormrage,1315,hunter,survival,30,18,12
16229,Carnosynn,sargeras,1315,hunter,survival,24,14,10
16230,Cocobread,stormreaver,1315,hunter,survival,102,43,59
16231,Nippoc,aerie-peak,1314,hunter,survival,18,14,4
16232,Chiad,kargath,1313,hunter,survival,36,22,14
16233,Vhan,azralon,1313,hunter,survival,136,71,65
16234,Ryonel,moon-guard,1313,hunter,survival,167,81,86
16235,Luckboy,tichondrius,1311,hunter,survival,173,85,88
16236,Éygon,sargeras,1311,hunter,survival,39,17,22
16237,Mypeach,frostmourne,1310,hunter,survival,66,33,33
16238,Draban,stormrage,1305,hunter,survival,30,14,16
16239,Snoopinator,malganis,1305,hunter,survival,42,15,27
16240,Zorht,ragnaros,1301,hunter,survival,206,103,103
16241,Bredys,quelthalas,1295,hunter,survival,42,15,27
16242,Cvelian,tichondrius,1293,hunter,survival,60,23,37
16243,Rykbad,area-52,1292,hunter,survival,49,28,21
16244,Hovahdo,proudmoore,1287,hunter,survival,35,14,21
16245,Rogaldornn,thrall,1280,hunter,survival,47,23,24
16246,Lashga,wyrmrest-accord,1279,hunter,survival,45,17,28
16247,Vongard,wyrmrest-accord,1277,hunter,survival,52,24,28
16248,Orgpopeyes,illidan,1275,hunter,survival,37,15,22
16249,Wrathofexwif,proudmoore,1273,hunter,survival,30,16,14
16250,Nanotorque,moon-guard,1273,hunter,survival,84,44,40
16251,Dreebizz,gorefiend,1272,hunter,survival,91,41,50
16252,Lorethor,kaelthas,1270,hunter,survival,36,15,21
16253,Gxswow,tichondrius,1268,hunter,survival,66,30,36
16254,Seratoninx,malganis,1267,hunter,survival,29,14,15
16255,Ghuntcassh,quelthalas,1262,hunter,survival,30,18,12
16256,Félíx,ragnaros,1258,hunter,survival,44,18,26
16257,Fancyox,frostmourne,1247,hunter,survival,18,13,5
16258,Honorola,twisting-nether,1247,hunter,survival,18,13,5
16259,Tinsho,drakkari,1247,hunter,survival,66,34,32
16260,Duckpow,frostmourne,1247,hunter,survival,60,24,36
16261,Hawkem,illidan,1246,hunter,survival,24,13,11
16262,Maran,chogall,1245,hunter,survival,18,13,5
16263,Bicflop,azralon,1241,hunter,survival,18,13,5
16264,Vindication,ysera,1240,hunter,survival,24,13,11
16265,Ganderion,sargeras,1240,hunter,survival,27,14,13
16266,Madhuntter,azralon,1239,hunter,survival,24,13,11
16267,Nowê,azralon,1239,hunter,survival,36,15,21
16268,Ariädne,sargeras,1239,hunter,survival,72,27,45
16269,Søapbubble,tichondrius,1236,hunter,survival,18,13,5
16270,Bubblesh,whisperwind,1234,hunter,survival,36,18,18
16271,Ropivacaine,illidan,1232,hunter,survival,30,13,17
16272,Sealteamrick,frostmourne,1231,hunter,survival,30,15,15
16273,Nucleosome,stormrage,1219,hunter,survival,24,13,11
16274,Natsai,illidan,1217,hunter,survival,45,19,26
16275,Skriill,tichondrius,1211,hunter,survival,60,26,34
16276,Diebleeding,ragnaros,1210,hunter,survival,29,13,16
16277,Laurett,ragnaros,1208,hunter,survival,24,13,11
16278,Cufless,proudmoore,1204,hunter,survival,36,13,23
16279,Arkeryn,azralon,1203,hunter,survival,18,13,5
16280,Firesail,kelthuzad,1199,hunter,survival,79,36,43
16281,Wartoz,dragonblight,1190,hunter,survival,59,40,19
16282,Rensv,frostmourne,1190,hunter,survival,56,30,26
16283,Rairin,tichondrius,1190,hunter,survival,47,20,27
16284,Extremis,emerald-dream,1185,hunter,survival,106,47,59
16285,Wìllòw,khazgoroth,1174,hunter,survival,42,14,28
16286,Spitballa,emerald-dream,1170,hunter,survival,35,14,21
16287,Allahakbar,ragnaros,1169,hunter,survival,36,15,21
16288,Gruì,malganis,1168,hunter,survival,26,13,13
16289,Kukulkán,muradin,1164,hunter,survival,28,13,15
16290,Travail,illidan,1163,hunter,survival,24,17,7
16291,Trapordie,stormrage,1162,hunter,survival,30,13,17
16292,Banai,the-underbog,1161,hunter,survival,67,26,41
16293,Daymanaahh,malfurion,1159,hunter,survival,56,24,32
16294,Mokuraak,emerald-dream,1154,hunter,survival,42,20,22
16295,Gigabigly,wyrmrest-accord,1152,hunter,survival,18,12,6
16296,Yøske,tichondrius,1152,hunter,survival,18,12,6
16297,Wingclipt,stormrage,1151,hunter,survival,29,12,17
16298,Drunknachos,bleeding-hollow,1150,hunter,survival,24,12,12
16299,Broskina,stormrage,1150,hunter,survival,24,12,12
16300,Laralodge,stormrage,1150,hunter,survival,78,32,46
16301,Crimsoncoast,tichondrius,1149,hunter,survival,18,12,6
16302,Barnbougle,sargeras,1149,hunter,survival,24,12,12
16303,Imbrokenlol,kiljaeden,1148,hunter,survival,30,12,18
16304,Giraffetrap,zuljin,1147,hunter,survival,18,12,6
16305,Expskippy,darkspear,1146,hunter,survival,55,34,21
16306,Kaiholeo,tichondrius,1143,hunter,survival,18,12,6
16307,Leftty,illidan,1140,hunter,survival,30,12,18
16308,Arcos,emerald-dream,1138,hunter,survival,18,12,6
16309,Xitara,stormrage,1137,hunter,survival,24,12,12
16310,Chopsley,feathermoon,1136,hunter,survival,71,30,41
16311,Joeexotíc,moknathal,1132,hunter,survival,24,12,12
16312,Vansatih,azralon,1126,hunter,survival,125,68,57
16313,Ligerjin,ragnaros,1122,hunter,survival,30,12,18
16314,Eastera,tichondrius,1119,hunter,survival,68,30,38
16315,Rayhuntard,tichondrius,1115,hunter,survival,23,12,11
16316,Superiorkill,arathor,1113,hunter,survival,31,13,18
16317,Chicall,kalecgos,1096,hunter,survival,31,13,18
16318,Eskii,moon-guard,1079,hunter,survival,18,12,6
16319,Lesseneth,aegwynn,1072,hunter,survival,48,20,28
16320,Zhafiro,drakkari,1067,hunter,survival,36,21,15
16321,Arucedd,frostmourne,1064,hunter,survival,69,40,29
16322,Kaïmsael,kelthuzad,1064,hunter,survival,125,69,56
16323,Summerdope,aggramar,1056,hunter,survival,18,11,7
16324,Scythedom,tichondrius,1056,hunter,survival,18,11,7
16325,Cptx,kelthuzad,1056,hunter,survival,18,11,7
16326,Anooß,tichondrius,1056,hunter,survival,21,12,9
16327,Lovevv,frostmourne,1055,hunter,survival,18,11,7
16328,Ïkite,zuljin,1055,hunter,survival,18,11,7
16329,Nevertraps,frostmourne,1055,hunter,survival,18,11,7
16330,Maxlol,stormrage,1055,hunter,survival,24,11,13
16331,Plsbepatient,wyrmrest-accord,1054,hunter,survival,18,11,7
16332,Reignwolf,nemesis,1053,hunter,survival,18,11,7
16333,Sagadegêmeos,stormrage,1053,hunter,survival,18,11,7
16334,Jaw,hakkar,1053,hunter,survival,18,11,7
16335,Petmychode,illidan,1053,hunter,survival,18,11,7
16336,Sarvaxagar,tichondrius,1052,hunter,survival,24,11,13
16337,Thoriden,amanthul,1051,hunter,survival,54,14,40
16338,Syff,korgath,1050,hunter,survival,30,11,19
16339,Sarqis,lightbringer,1044,hunter,survival,24,11,13
16340,Panm,runetotem,1034,hunter,survival,27,12,15
16341,Eithelleta,frostmourne,1034,hunter,survival,104,43,61
16342,Akigga,arthas,1033,hunter,survival,18,11,7
16343,Triggers,ghostlands,1033,hunter,survival,30,11,19
16344,Kalgorn,emerald-dream,1030,hunter,survival,28,13,15
16345,Fisthammer,frostmane,1018,hunter,survival,30,16,14
16346,Wkx,tichondrius,1017,hunter,survival,26,12,14
16347,Jaykwan,boulderfist,1016,hunter,survival,23,11,12
16348,Rukkora,deathwing,1009,hunter,survival,66,30,36
16349,Prêd,malganis,990,hunter,survival,22,11,11
16350,Luangg,tichondrius,989,hunter,survival,20,11,9
16351,Lucarcher,stormrage,988,hunter,survival,17,11,6
16352,Thrandrial,smolderthorn,985,hunter,survival,20,11,9
16353,Tempistworg,greymane,982,hunter,survival,87,44,43
16354,Hellrayserr,azralon,970,hunter,survival,24,11,13
16355,Virindi,barthilas,960,hunter,survival,12,10,2
16356,Sbgrv,dalaran,960,hunter,survival,18,10,8
16357,Covlolzz,illidan,960,hunter,survival,24,10,14
16358,Corpo,area-52,960,hunter,survival,24,10,14
16359,Zipzyo,tichondrius,960,hunter,survival,24,10,14
16360,Snipin,ragnaros,960,hunter,survival,30,10,20
16361,Kêdokî,sargeras,959,hunter,survival,12,10,2
16362,Rickybobby,warsong,959,hunter,survival,18,10,8
16363,Egurl,firetree,959,hunter,survival,18,10,8
16364,Zizilio,kelthuzad,959,hunter,survival,18,10,8
16365,Tyleraq,area-52,959,hunter,survival,18,10,8
16366,Piñg,tichondrius,959,hunter,survival,18,10,8
16367,Narakara,stormreaver,959,hunter,survival,21,11,10
16368,Venoc,bleeding-hollow,959,hunter,survival,24,10,14
16369,Jerusa,illidan,958,hunter,survival,18,10,8
16370,Kimchimaster,tichondrius,958,hunter,survival,26,10,16
16371,Fanikita,azralon,957,hunter,survival,15,11,4
16372,Rockehm,frostmourne,957,hunter,survival,18,10,8
16373,Deejwithabow,frostmourne,957,hunter,survival,18,10,8
16374,Wouow,tichondrius,957,hunter,survival,18,10,8
16375,Genesiz,sargeras,957,hunter,survival,24,10,14
16376,Daréz,blackrock,956,hunter,survival,16,11,5
16377,Vietnrg,doomhammer,954,hunter,survival,24,10,14
16378,Grayrat,trollbane,947,hunter,survival,18,10,8
16379,Loochlin,sargeras,946,hunter,survival,27,10,17
16380,Syvarris,medivh,943,hunter,survival,17,10,7
16381,Amarox,zuljin,938,hunter,survival,23,11,12
16382,Khaoskills,thunderlord,926,hunter,survival,49,26,23
16383,Gelter,stormrage,924,hunter,survival,23,10,13
16384,Sitalces,ragnaros,895,hunter,survival,36,18,18
16385,Crapshot,daggerspine,885,hunter,survival,33,10,23
16386,Turkshot,area-52,875,hunter,survival,25,10,15
16387,Jaywaz,tichondrius,864,hunter,survival,12,9,3
16388,Unicom,malganis,864,hunter,survival,12,9,3
16389,Puffcopeak,illidan,864,hunter,survival,12,9,3
16390,Hunterguyy,tichondrius,864,hunter,survival,12,9,3
16391,Weedzy,tichondrius,864,hunter,survival,12,9,3
16392,Tigglyjits,tichondrius,864,hunter,survival,12,9,3
16393,Yná,nemesis,864,hunter,survival,12,9,3
16394,Alansho,tichondrius,864,hunter,survival,18,9,9
16395,Desari,thunderhorn,864,hunter,survival,18,9,9
16396,Scottmeyers,proudmoore,864,hunter,survival,24,9,15
16397,Sharkzooka,illidan,864,hunter,survival,24,9,15
16398,Kaldrool,frostmourne,864,hunter,survival,24,9,15
16399,Daspx,nagrand,863,hunter,survival,18,9,9
16400,Riram,stormrage,863,hunter,survival,18,9,9
16401,Arigon,frostmane,863,hunter,survival,18,9,9
16402,Twodoobies,ghostlands,863,hunter,survival,18,9,9
16403,Serpantsting,moon-guard,863,hunter,survival,18,9,9
16404,Landscape,kiljaeden,863,hunter,survival,24,9,15
16405,Lovoo,sargeras,862,hunter,survival,12,9,3
16406,Keenai,moon-guard,862,hunter,survival,12,9,3
16407,Contrack,zuljin,862,hunter,survival,19,10,9
16408,Lasagnadaddy,maiev,862,hunter,survival,18,9,9
16409,Huntardxo,moon-guard,862,hunter,survival,18,9,9
16410,Deerhunt,black-dragonflight,862,hunter,survival,18,9,9
16411,Vulkru,azralon,862,hunter,survival,18,9,9
16412,Chootyboi,bronzebeard,862,hunter,survival,18,9,9
16413,Nøzhaha,area-52,861,hunter,survival,18,9,9
16414,Packlead,sargeras,861,hunter,survival,18,9,9
16415,Ashtron,trollbane,860,hunter,survival,24,9,15
16416,Junglepaw,moon-guard,860,hunter,survival,24,9,15
16417,Zotahunterx,ragnaros,859,hunter,survival,24,9,15
16418,Mabaku,tichondrius,858,hunter,survival,12,9,3
16419,Turquesaa,wyrmrest-accord,856,hunter,survival,18,9,9
16420,Obsididan,aerie-peak,855,hunter,survival,24,9,15
16421,Prettysure,nesingwary,851,hunter,survival,25,12,13
16422,Vizkha,azralon,847,hunter,survival,18,9,9
16423,Lisbboax,stormrage,844,hunter,survival,27,11,16
16424,Shukucingjr,illidan,842,hunter,survival,18,9,9
16425,Blaymorrd,senjin,839,hunter,survival,18,9,9
16426,Defiance,rexxar,831,hunter,survival,16,9,7
16427,Gairkill,area-52,831,hunter,survival,98,50,48
16428,Ðfac,moon-guard,768,hunter,survival,12,8,4
16429,Shootypie,hyjal,768,hunter,survival,12,8,4
16430,Elccid,tichondrius,768,hunter,survival,12,8,4
16431,Kanta,bleeding-hollow,768,hunter,survival,12,8,4
16432,Eain,wyrmrest-accord,768,hunter,survival,12,8,4
16433,Árröw,arygos,768,hunter,survival,12,8,4
16434,Fiftyyddash,tichondrius,768,hunter,survival,12,8,4
16435,Gondolin,andorhal,768,hunter,survival,12,8,4
16436,Trappah,stormrage,768,hunter,survival,12,8,4
16437,Iizerd,illidan,768,hunter,survival,12,8,4
16438,Fineye,illidan,768,hunter,survival,14,8,6
16439,Madival,ragnaros,768,hunter,survival,18,8,10
16440,Igotloud,illidan,768,hunter,survival,18,8,10
16441,Goromi,tichondrius,768,hunter,survival,18,8,10
16442,Nautílus,ragnaros,768,hunter,survival,18,8,10
16443,Drupert,tichondrius,768,hunter,survival,18,8,10
16444,Diddycombe,stormrage,768,hunter,survival,18,8,10
16445,Michaeljfox,area-52,768,hunter,survival,18,8,10
16446,Kuzar,thrall,768,hunter,survival,18,8,10
16447,Kimssis,tichondrius,768,hunter,survival,18,8,10
16448,Eref,sargeras,768,hunter,survival,24,8,16
16449,Sniperælite,korgath,768,hunter,survival,24,8,16
16450,Nervousness,draka,767,hunter,survival,12,8,4
16451,Brissy,sargeras,767,hunter,survival,18,8,10
16452,Trixster,lethon,767,hunter,survival,18,8,10
16453,Slimshadie,kiljaeden,767,hunter,survival,18,8,10
16454,Rummaker,mugthol,767,hunter,survival,18,8,10
16455,Zouzu,area-52,767,hunter,survival,18,8,10
16456,Bruzit,tol-barad,767,hunter,survival,18,8,10
16457,Yesthyra,sargeras,767,hunter,survival,18,8,10
16458,Korasaya,area-52,767,hunter,survival,18,8,10
16459,Wakkå,mugthol,767,hunter,survival,21,9,12
16460,Mmchode,zuljin,767,hunter,survival,24,8,16
16461,Soberish,bleeding-hollow,767,hunter,survival,24,8,16
16462,Zyzzmirin,illidan,767,hunter,survival,24,8,16
16463,Bowowner,aggramar,767,hunter,survival,30,8,22
16464,Chokemescara,stormrage,767,hunter,survival,30,8,22
16465,Najmoira,area-52,766,hunter,survival,12,8,4
16466,Kraslin,bleeding-hollow,766,hunter,survival,12,8,4
16467,Greyh,madoran,766,hunter,survival,12,8,4
16468,Hunfor,anubarak,766,hunter,survival,18,8,10
16469,Cynya,wyrmrest-accord,766,hunter,survival,18,8,10
16470,Segulah,dalaran,766,hunter,survival,18,8,10
16471,Ariran,illidan,766,hunter,survival,18,8,10
16472,Stoleurgurl,sargeras,766,hunter,survival,24,8,16
16473,Jathriel,zuljin,765,hunter,survival,18,8,10
16474,Lohse,emerald-dream,765,hunter,survival,18,8,10
16475,Sterge,maiev,764,hunter,survival,18,8,10
16476,Haumer,wyrmrest-accord,763,hunter,survival,12,8,4
16477,Emiri,dalaran,763,hunter,survival,24,8,16
16478,Querosushi,ragnaros,760,hunter,survival,18,8,10
16479,Kaelgrog,kiljaeden,754,hunter,survival,24,8,16
16480,Gaahl,aggramar,735,hunter,survival,14,9,5
16481,Iraxium,illidan,735,hunter,survival,14,9,5
16482,Thesniperx,sargeras,719,hunter,survival,21,8,13
16483,Thrakgor,wyrmrest-accord,713,hunter,survival,23,10,13
16484,Acidhunt,tichondrius,703,hunter,survival,28,8,20
16485,Kanekki,ragnaros,688,hunter,survival,13,8,5
16486,Joree,medivh,672,hunter,survival,12,7,5
16487,Equalizér,sargeras,672,hunter,survival,12,7,5
16488,Ozzsimp,stormrage,672,hunter,survival,12,7,5
16489,Mattyhuntz,tichondrius,672,hunter,survival,12,7,5
16490,Jamesön,sargeras,672,hunter,survival,12,7,5
16491,Magvez,tichondrius,672,hunter,survival,12,7,5
16492,Endxworld,tichondrius,672,hunter,survival,12,7,5
16493,Antø,tichondrius,672,hunter,survival,12,7,5
16494,Huntbay,destromath,672,hunter,survival,12,7,5
16495,Vânillaice,stormrage,672,hunter,survival,12,7,5
16496,Tsuka,eldrethalas,672,hunter,survival,12,7,5
16497,Trenbolone,frostmourne,672,hunter,survival,12,7,5
16498,Oronir,frostmourne,672,hunter,survival,12,7,5
16499,Negligent,sargeras,672,hunter,survival,12,7,5
16500,Arraza,ragnaros,672,hunter,survival,12,7,5
16501,Dumshot,zuljin,672,hunter,survival,12,7,5
16502,Ayjay,zuljin,672,hunter,survival,12,7,5
16503,Glediator,tichondrius,672,hunter,survival,12,7,5
16504,Irishredd,undermine,672,hunter,survival,12,7,5
16505,Trapirl,tichondrius,672,hunter,survival,12,7,5
16506,Fannypacks,dragonmaw,672,hunter,survival,12,7,5
16507,Pfheign,area-52,672,hunter,survival,12,7,5
16508,Onécare,bleeding-hollow,672,hunter,survival,12,7,5
16509,Greyhollow,sargeras,672,hunter,survival,15,8,7
16510,Bombbot,zuljin,672,hunter,survival,18,7,11
16511,Oattes,daggerspine,672,hunter,survival,18,7,11
16512,Porrainga,auchindoun,672,hunter,survival,18,7,11
16513,Meowimadog,spinebreaker,672,hunter,survival,18,7,11
16514,Ziaxel,bleeding-hollow,671,hunter,survival,12,7,5
16515,Jigua,stormrage,671,hunter,survival,12,7,5
16516,Otternaught,tichondrius,671,hunter,survival,12,7,5
16517,Mav,dragonmaw,671,hunter,survival,12,7,5
16518,Genocell,thunderlord,671,hunter,survival,12,7,5
16519,Zackèse,area-52,671,hunter,survival,18,7,11
16520,Gaezangsu,tichondrius,671,hunter,survival,24,7,17
16521,Killswitches,dragonmaw,670,hunter,survival,12,7,5
16522,Joskyia,drenden,669,hunter,survival,12,7,5
16523,Hatespark,bonechewer,667,hunter,survival,12,7,5
16524,Imraghorn,sargeras,655,hunter,survival,17,7,10
16525,Illustrus,bleeding-hollow,639,hunter,survival,11,7,4
16526,Catboikilla,altar-of-storms,639,hunter,survival,17,7,10
16527,Cagooggo,moon-guard,638,hunter,survival,16,7,9
16528,Rotthem,ragnaros,638,hunter,survival,20,8,12
16529,Trappin,malganis,623,hunter,survival,11,7,4
16530,Lartrius,bleeding-hollow,621,hunter,survival,15,8,7
16531,Arrebol,tichondrius,608,hunter,survival,16,7,9
16532,Primez,sargeras,607,hunter,survival,11,7,4
16533,Austelos,moon-guard,607,hunter,survival,11,7,4
16534,Odynsraven,stormrage,605,hunter,survival,11,7,4
16535,Ðevil,ragnaros,576,hunter,survival,6,6,0
16536,Drees,nerzhul,576,hunter,survival,6,6,0
16537,Garkia,hyjal,576,hunter,survival,6,6,0
16538,Ÿöskë,tichondrius,576,hunter,survival,6,6,0
16539,Ivanjackenov,illidan,576,hunter,survival,10,7,3
16540,Nijicon,frostmourne,576,hunter,survival,12,6,6
16541,Amhavgun,tichondrius,576,hunter,survival,12,6,6
16542,Mctrapturds,tichondrius,576,hunter,survival,12,6,6
16543,Zugfeito,nemesis,576,hunter,survival,12,6,6
16544,Nedad,tichondrius,576,hunter,survival,12,6,6
16545,Yoske,tichondrius,576,hunter,survival,12,6,6
16546,Wezkerh,ragnaros,576,hunter,survival,12,6,6
16547,Mythfive,stormrage,576,hunter,survival,12,6,6
16548,Walterwhite,trollbane,576,hunter,survival,12,6,6
16549,Araqíel,aegwynn,576,hunter,survival,12,6,6
16550,Tazsic,mannoroth,576,hunter,survival,12,6,6
16551,Traponomics,stormrage,576,hunter,survival,12,6,6
16552,Fíction,kelthuzad,576,hunter,survival,12,6,6
16553,Cosmodome,daggerspine,576,hunter,survival,12,6,6
16554,Tenzën,drakkari,576,hunter,survival,12,6,6
16555,Zerark,kelthuzad,576,hunter,survival,13,6,7
16556,Jaggeroi,thrall,576,hunter,survival,16,7,9
16557,Lahinch,darkspear,576,hunter,survival,21,7,14
16558,Pilesofpoop,sargeras,576,hunter,survival,18,6,12
16559,Chetvi,uldum,576,hunter,survival,18,6,12
16560,Kowabungy,tichondrius,576,hunter,survival,18,6,12
16561,Xochiquetzal,jubeithos,575,hunter,survival,6,6,0
16562,Dfnhdft,stormrage,575,hunter,survival,12,6,6
16563,Zepplin,medivh,575,hunter,survival,12,6,6
16564,Xeiana,proudmoore,575,hunter,survival,12,6,6
16565,Týrak,illidan,575,hunter,survival,12,6,6
16566,Jerza,emerald-dream,575,hunter,survival,12,6,6
16567,Dgs,nemesis,575,hunter,survival,12,6,6
16568,Bôwbafett,sargeras,575,hunter,survival,12,6,6
16569,Blizhunt,thunderlord,575,hunter,survival,18,6,12
16570,Vortann,proudmoore,575,hunter,survival,18,6,12
16571,Kerion,emerald-dream,575,hunter,survival,18,6,12
16572,Berzxd,stormrage,573,hunter,survival,12,6,6
16573,Bushytails,illidan,573,hunter,survival,18,6,12
16574,Aiyanafox,moon-guard,572,hunter,survival,24,6,18
16575,Mookvader,illidan,562,hunter,survival,24,10,14
16576,Alpacxpress,stormrage,544,hunter,survival,16,6,10
16577,Tyrokk,barthilas,543,hunter,survival,18,6,12
16578,Dräkö,tichondrius,527,hunter,survival,15,7,8
16579,Ceezrh,sargeras,527,hunter,survival,15,7,8
16580,Kovoth,darkspear,526,hunter,survival,15,6,9
16581,Showtheio,azralon,522,hunter,survival,16,7,9
16582,Lawafla,area-52,521,hunter,survival,14,7,7
16583,Raeshots,area-52,518,hunter,survival,21,8,13
16584,Pxry,drenden,511,hunter,survival,11,6,5
16585,Therealpafo,tichondrius,507,hunter,survival,20,6,14
16586,Grimbrew,garona,480,hunter,survival,6,5,1
16587,Selenis,khadgar,480,hunter,survival,6,5,1
16588,Wwangman,tichondrius,480,hunter,survival,6,5,1
16589,Poorapple,tichondrius,480,hunter,survival,6,5,1
16590,Tmzsteezy,tichondrius,480,hunter,survival,6,5,1
16591,Ewife,illidan,480,hunter,survival,6,5,1
16592,Narukín,tichondrius,480,hunter,survival,6,5,1
16593,Gufanyaun,tichondrius,480,hunter,survival,6,5,1
16594,Nearsight,proudmoore,480,hunter,survival,6,5,1
16595,Jonah,sargeras,480,hunter,survival,6,5,1
16596,Jäger,zuljin,480,hunter,survival,6,5,1
16597,Minnsc,tichondrius,480,hunter,survival,6,5,1
16598,Toyshoota,stormrage,480,hunter,survival,9,6,3
16599,Casadega,sargeras,480,hunter,survival,10,6,4
16600,Redhøød,moon-guard,480,hunter,survival,12,5,7
16601,Cuervostreet,ragnaros,480,hunter,survival,12,5,7
16602,Mìtáng,moon-guard,480,hunter,survival,12,5,7
16603,Jumpkick,azralon,480,hunter,survival,12,5,7
16604,Minxed,sargeras,480,hunter,survival,12,5,7
16605,Bastÿ,area-52,480,hunter,survival,12,5,7
16606,Veluci,tichondrius,480,hunter,survival,12,5,7
16607,Myrfes,ragnaros,480,hunter,survival,12,5,7
16608,Tezlekhan,haomarush,480,hunter,survival,12,5,7
16609,Thiccita,tichondrius,480,hunter,survival,12,5,7
16610,Bowjoby,kelthuzad,480,hunter,survival,12,5,7
16611,Downrange,stonemaul,480,hunter,survival,12,5,7
16612,Giorvannar,ragnaros,480,hunter,survival,12,5,7
16613,Drysst,tichondrius,480,hunter,survival,12,5,7
16614,Droj,stormrage,480,hunter,survival,12,5,7
16615,Cefirhok,ragnaros,480,hunter,survival,12,5,7
16616,Luckione,destromath,480,hunter,survival,12,5,7
16617,Firskin,frostmourne,480,hunter,survival,12,5,7
16618,Shootnoscore,vashj,480,hunter,survival,15,6,9
16619,Dartoo,ragnaros,480,hunter,survival,18,5,13
16620,Ärtémisa,quelthalas,480,hunter,survival,18,5,13
16621,Phasm,ravencrest,479,hunter,survival,6,5,1
16622,Mcgoob,tichondrius,479,hunter,survival,12,5,7
16623,Alfaan,moon-guard,479,hunter,survival,12,5,7
16624,Mirdous,moon-guard,479,hunter,survival,12,5,7
16625,Villainshunt,stormrage,479,hunter,survival,12,5,7
16626,Belvhar,skullcrusher,479,hunter,survival,12,5,7
16627,Ghannha,wyrmrest-accord,479,hunter,survival,12,5,7
16628,Pastelitoz,tichondrius,479,hunter,survival,21,6,15
16629,Calvarîam,korgath,479,hunter,survival,18,5,13
16630,Légölás,tichondrius,463,hunter,survival,17,5,12
16631,Faniquitinha,stormrage,431,hunter,survival,13,6,7
16632,Crumpit,moon-guard,426,hunter,survival,22,6,16
16633,Flowolf,tichondrius,416,hunter,survival,10,5,5
16634,Cinnybunz,malganis,415,hunter,survival,16,6,10
16635,Rinehart,dalaran,415,hunter,survival,14,5,9
16636,Siëgward,quelthalas,384,hunter,survival,6,4,2
16637,Bigpets,azralon,384,hunter,survival,6,4,2
16638,Pulso,illidan,384,hunter,survival,6,4,2
16639,Vegâ,ursin,384,hunter,survival,6,4,2
16640,Malkuri,medivh,384,hunter,survival,6,4,2
16641,Kapukapu,illidan,384,hunter,survival,6,4,2
16642,Virgim,kelthuzad,384,hunter,survival,6,4,2
16643,Litchi,illidan,384,hunter,survival,6,4,2
16644,Ehhee,twisting-nether,384,hunter,survival,6,4,2
16645,Chasseür,quelthalas,384,hunter,survival,6,4,2
16646,Surprisemfkr,emerald-dream,384,hunter,survival,6,4,2
16647,Trapful,illidan,384,hunter,survival,6,4,2
16648,Ethxx,emerald-dream,384,hunter,survival,6,4,2
16649,Nastoid,area-52,384,hunter,survival,6,4,2
16650,Rankonee,area-52,384,hunter,survival,6,4,2
16651,Scrubmastery,emerald-dream,384,hunter,survival,6,4,2
16652,Swagprince,skullcrusher,384,hunter,survival,6,4,2
16653,Hunterlolxd,altar-of-storms,384,hunter,survival,6,4,2
16654,Ofthedeath,ragnaros,384,hunter,survival,6,4,2
16655,Ikitefordmt,zuljin,384,hunter,survival,6,4,2
16656,Failtrap,ragnaros,384,hunter,survival,6,4,2
16657,Æßç,ragnaros,384,hunter,survival,6,4,2
16658,Boomseed,nagrand,384,hunter,survival,6,4,2
16659,Aurelqt,tichondrius,384,hunter,survival,6,4,2
16660,Bendoon,sargeras,384,hunter,survival,6,4,2
16661,Wapnonymous,mugthol,384,hunter,survival,6,4,2
16662,Pumpkinovo,tichondrius,384,hunter,survival,6,4,2
16663,Mihall,tichondrius,384,hunter,survival,6,4,2
16664,Gaymonbarnet,sargeras,384,hunter,survival,6,4,2
16665,Thalyxion,moon-guard,384,hunter,survival,6,4,2
16666,Petstun,moon-guard,384,hunter,survival,6,4,2
16667,Ratherbully,tichondrius,384,hunter,survival,6,4,2
16668,Volbz,barthilas,384,hunter,survival,6,4,2
16669,Pouncedgg,sargeras,384,hunter,survival,6,4,2
16670,Junglefever,skywall,384,hunter,survival,6,4,2
16671,Suyesh,tichondrius,384,hunter,survival,6,4,2
16672,ßløømtøðèáth,shadow-council,384,hunter,survival,6,4,2
16673,Elcap,tichondrius,384,hunter,survival,6,4,2
16674,Mameikilled,saurfang,384,hunter,survival,6,4,2
16675,Thefanbus,tichondrius,384,hunter,survival,6,4,2
16676,Hyena,kelthuzad,384,hunter,survival,9,5,4
16677,Wolfsorgorr,area-52,384,hunter,survival,12,4,8
16678,Vogtfog,tichondrius,384,hunter,survival,12,4,8
16679,Sybernetik,tichondrius,384,hunter,survival,12,4,8
16680,Newcomb,tichondrius,384,hunter,survival,12,4,8
16681,Kissmylin,tichondrius,384,hunter,survival,12,4,8
16682,Ælij,tichondrius,384,hunter,survival,12,4,8
16683,Stupidgodx,tichondrius,384,hunter,survival,12,4,8
16684,Gluegobbler,spinebreaker,384,hunter,survival,12,4,8
16685,Oatmeallover,stormrage,384,hunter,survival,12,4,8
16686,Golorn,malganis,384,hunter,survival,12,4,8
16687,Àngèl,malganis,384,hunter,survival,12,4,8
16688,Goonlmao,hyjal,384,hunter,survival,12,4,8
16689,Gunicks,illidan,384,hunter,survival,12,4,8
16690,Camfeed,illidan,384,hunter,survival,12,4,8
16691,Braindeadorc,illidan,384,hunter,survival,12,4,8
16692,Malikyr,moon-guard,384,hunter,survival,12,4,8
16693,Aeht,illidan,384,hunter,survival,12,4,8
16694,Ganash,gallywix,384,hunter,survival,12,4,8
16695,Troglav,drakkari,384,hunter,survival,12,4,8
16696,Fâpple,stormrage,384,hunter,survival,12,4,8
16697,Eforas,ragnaros,384,hunter,survival,12,4,8
16698,Zerkie,area-52,384,hunter,survival,12,4,8
16699,Keenz,frostmourne,384,hunter,survival,12,4,8
16700,Axxax,azralon,384,hunter,survival,12,4,8
16701,Wolfsok,norgannon,384,hunter,survival,12,4,8
16702,Bearbarryls,azralon,384,hunter,survival,12,4,8
16703,Cakeislife,kelthuzad,384,hunter,survival,18,4,14
16704,Tydee,nagrand,383,hunter,survival,18,4,14
16705,Yory,tol-barad,362,hunter,survival,12,6,6
16706,Sliturthroat,barthilas,336,hunter,survival,9,4,5
16707,Adamariss,stormrage,319,hunter,survival,16,4,12
16708,Skolfongoun,malfurion,318,hunter,survival,14,4,10
16709,Dangerrangér,area-52,304,hunter,survival,7,4,3
16710,Illshot,tichondrius,304,hunter,survival,13,4,9
16711,Hendlie,frostmourne,288,hunter,survival,6,3,3
16712,Mistrj,frostmourne,288,hunter,survival,6,3,3
16713,Adonai,stormrage,288,hunter,survival,6,3,3
16714,Badseedz,kargath,288,hunter,survival,6,3,3
16715,Rustyspork,muradin,288,hunter,survival,6,3,3
16716,Musculate,firetree,288,hunter,survival,6,3,3
16717,Fearna,destromath,288,hunter,survival,6,3,3
16718,Shootdogg,mannoroth,288,hunter,survival,6,3,3
16719,Banshers,stormrage,288,hunter,survival,6,3,3
16720,Bherskrograx,burning-legion,288,hunter,survival,6,3,3
16721,Hazzersk,ragnaros,288,hunter,survival,6,3,3
16722,Furipoon,stormrage,288,hunter,survival,6,3,3
16723,Loogan,sargeras,288,hunter,survival,6,3,3
16724,Pridefulzjr,stormrage,288,hunter,survival,6,3,3
16725,Cantantie,tichondrius,288,hunter,survival,6,3,3
16726,Fancyxo,frostmourne,288,hunter,survival,6,3,3
16727,Slowdamage,ragnaros,288,hunter,survival,6,3,3
16728,Pewpewboi,malganis,288,hunter,survival,6,3,3
16729,Makeastinky,malfurion,288,hunter,survival,6,3,3
16730,Hackerman,tichondrius,288,hunter,survival,6,3,3
16731,Duune,wyrmrest-accord,288,hunter,survival,6,3,3
16732,Petkd,frostmourne,288,hunter,survival,6,3,3
16733,Guncontrol,malganis,288,hunter,survival,6,3,3
16734,Griefs,malganis,288,hunter,survival,6,3,3
16735,Dirtymongrel,barthilas,288,hunter,survival,6,3,3
16736,Yoppa,zuljin,288,hunter,survival,6,3,3
16737,Draevinz,stormrage,288,hunter,survival,6,3,3
16738,Pistolon,quelthalas,288,hunter,survival,6,3,3
16739,Embaçado,bleeding-hollow,288,hunter,survival,6,3,3
16740,Zà,sargeras,288,hunter,survival,6,3,3
16741,Samsin,sargeras,288,hunter,survival,6,3,3
16742,Seiber,quelthalas,288,hunter,survival,6,3,3
16743,Slowhunterr,tichondrius,288,hunter,survival,6,3,3
16744,Moistbooger,emerald-dream,288,hunter,survival,6,3,3
16745,Wooftoof,frostmourne,288,hunter,survival,6,3,3
16746,Slaughterr,kelthuzad,288,hunter,survival,6,3,3
16747,Lowlore,moon-guard,288,hunter,survival,6,3,3
16748,Fjdominador,azralon,288,hunter,survival,6,3,3
16749,Tawok,moon-guard,288,hunter,survival,6,3,3
16750,Soul,sargeras,288,hunter,survival,6,3,3
16751,Goodtimez,sargeras,288,hunter,survival,6,3,3
16752,Vaz,haomarush,288,hunter,survival,6,3,3
16753,Whitemàne,dalaran,288,hunter,survival,6,3,3
16754,Pvx,darkspear,288,hunter,survival,6,3,3
16755,Spårrow,alleria,288,hunter,survival,6,3,3
16756,Gorgrokk,area-52,288,hunter,survival,6,3,3
16757,Littlechooch,illidan,288,hunter,survival,6,3,3
16758,Ünitedi,nemesis,288,hunter,survival,6,3,3
16759,Rûff,azralon,288,hunter,survival,6,3,3
16760,Trapmasterx,tichondrius,288,hunter,survival,6,3,3
16761,Lemmetrap,illidan,288,hunter,survival,6,3,3
16762,Calidian,moon-guard,288,hunter,survival,6,3,3
16763,Nitroguy,moknathal,288,hunter,survival,6,3,3
16764,Bakalan,dalaran,288,hunter,survival,16,4,12
16765,Lixniqua,tichondrius,288,hunter,survival,12,3,9
16766,Kalibah,azralon,288,hunter,survival,12,3,9
16767,Pooshot,kelthuzad,288,hunter,survival,12,3,9
16768,Hawkéns,moon-guard,288,hunter,survival,12,3,9
16769,Runecbow,eonar,288,hunter,survival,12,3,9
16770,Gutshott,tichondrius,288,hunter,survival,12,3,9
16771,Wildhùnt,tichondrius,288,hunter,survival,12,3,9
16772,Krispyflayz,sargeras,288,hunter,survival,12,3,9
16773,Kharñe,tichondrius,288,hunter,survival,12,3,9
16774,Waylòn,moon-guard,287,hunter,survival,12,3,9
16775,Ynoit,illidan,271,hunter,survival,11,3,8
16776,Mokaonly,wildhammer,256,hunter,survival,8,4,4
16777,Crèpes,bleeding-hollow,239,hunter,survival,5,3,2
16778,Böuntyhuntêr,area-52,239,hunter,survival,5,3,2
16779,Yogurtti,zuljin,239,hunter,survival,5,3,2
16780,Frostwulff,tichondrius,239,hunter,survival,5,3,2
16781,Onehitrip,illidan,233,hunter,survival,8,4,4
16782,Moscato,cenarion-circle,232,hunter,survival,14,4,10
16783,Cumman,sargeras,208,hunter,survival,7,3,4
16784,Rifomen,illidan,192,hunter,survival,9,3,6
16785,Gugucachorro,azralon,192,hunter,survival,6,2,4
16786,Shaftgravy,area-52,192,hunter,survival,6,2,4
16787,Razzldazzlbb,thrall,192,hunter,survival,6,2,4
16788,Heãdhunter,area-52,192,hunter,survival,6,2,4
16789,Machunt,lightbringer,192,hunter,survival,6,2,4
16790,Splewsh,area-52,192,hunter,survival,6,2,4
16791,Clampula,sargeras,192,hunter,survival,6,2,4
16792,Sharpster,zuljin,192,hunter,survival,6,2,4
16793,Dikkins,windrunner,192,hunter,survival,6,2,4
16794,Gaim,dalaran,192,hunter,survival,6,2,4
16795,Achilles,twisting-nether,192,hunter,survival,6,2,4
16796,Kharvaash,onyxia,192,hunter,survival,6,2,4
16797,Rimbar,ysera,192,hunter,survival,6,2,4
16798,Gunudown,haomarush,192,hunter,survival,6,2,4
16799,Gobygobbs,magtheridon,192,hunter,survival,6,2,4
16800,Zellor,wyrmrest-accord,192,hunter,survival,6,2,4
16801,Zirstorm,altar-of-storms,192,hunter,survival,6,2,4
16802,Quiveringboy,chogall,192,hunter,survival,6,2,4
16803,Finol,azralon,192,hunter,survival,6,2,4
16804,Pint,madoran,192,hunter,survival,6,2,4
16805,Sebastian,blackhand,192,hunter,survival,6,2,4
16806,Harosh,azralon,192,hunter,survival,6,2,4
16807,Cernos,malganis,192,hunter,survival,6,2,4
16808,Zèd,azralon,192,hunter,survival,6,2,4
16809,ßn,zuljin,192,hunter,survival,6,2,4
16810,Araghrn,draktharon,192,hunter,survival,6,2,4
16811,Spizsnipes,malganis,192,hunter,survival,6,2,4
16812,Harposmash,trollbane,192,hunter,survival,6,2,4
16813,Gswag,malganis,192,hunter,survival,6,2,4
16814,Blackjesu,blackrock,192,hunter,survival,6,2,4
16815,Comebacks,ragnaros,192,hunter,survival,6,2,4
16816,Xoxono,frostmourne,192,hunter,survival,6,2,4
16817,Shïndow,ragnaros,192,hunter,survival,6,2,4
16818,Pedropete,frostmourne,192,hunter,survival,6,2,4
16819,Kravern,ragnaros,192,hunter,survival,6,2,4
16820,Thazen,sargeras,192,hunter,survival,6,2,4
16821,Rainzs,stormrage,192,hunter,survival,6,2,4
16822,Femboyfatale,stormrage,192,hunter,survival,6,2,4
16823,Nahzah,stormrage,192,hunter,survival,6,2,4
16824,Cio,fizzcrank,192,hunter,survival,6,2,4
16825,Tréèstump,tichondrius,192,hunter,survival,6,2,4
16826,Eclipsie,aerie-peak,192,hunter,survival,6,2,4
16827,Trígger,azshara,192,hunter,survival,6,2,4
16828,Gaea,korgath,192,hunter,survival,6,2,4
16829,Ishotmydog,malganis,192,hunter,survival,6,2,4
16830,Sunchea,arygos,192,hunter,survival,6,2,4
16831,Bboo,bonechewer,192,hunter,survival,6,2,4
16832,Gomrog,gurubashi,192,hunter,survival,6,2,4
16833,Théw,tichondrius,192,hunter,survival,6,2,4
16834,Qua,perenolde,192,hunter,survival,6,2,4
16835,Durko,frostmourne,192,hunter,survival,6,2,4
16836,Toruhagakure,tichondrius,192,hunter,survival,6,2,4
16837,Dobuu,tichondrius,192,hunter,survival,6,2,4
16838,Eekbarbadrkl,frostmourne,192,hunter,survival,6,2,4
16839,Freshko,kiljaeden,192,hunter,survival,6,2,4
16840,Mukbangbj,terenas,192,hunter,survival,6,2,4
16841,Woobinman,tichondrius,192,hunter,survival,6,2,4
16842,Slipox,sargeras,192,hunter,survival,6,2,4
16843,Côckblocked,tichondrius,192,hunter,survival,6,2,4
16844,Giovasper,sargeras,192,hunter,survival,6,2,4
16845,Lenyuecf,proudmoore,192,hunter,survival,6,2,4
16846,Traptations,sargeras,192,hunter,survival,6,2,4
16847,Nelandris,tichondrius,192,hunter,survival,6,2,4
16848,Viio,sargeras,192,hunter,survival,6,2,4
16849,Tagsy,quelthalas,192,hunter,survival,12,2,10
16850,Naturan,drakkari,192,hunter,survival,12,2,10
16851,Raythør,area-52,192,hunter,survival,12,2,10
16852,Linova,stormrage,192,hunter,survival,12,2,10
16853,Yukisong,bleeding-hollow,192,hunter,survival,12,2,10
16854,Zhona,moon-guard,192,hunter,survival,12,2,10
16855,Skrìms,tichondrius,192,hunter,survival,12,2,10
16856,Twom,area-52,138,hunter,survival,8,3,5
16857,Ohnahra,kiljaeden,138,hunter,survival,9,3,6
16858,Xradû,dawnbringer,138,hunter,survival,9,3,6
16859,Morganson,moon-guard,138,hunter,survival,22,4,18
16860,Bránn,quelthalas,128,hunter,survival,4,2,2
16861,Drunkbunny,tichondrius,121,hunter,survival,16,5,11
16862,Fenrock,cenarius,96,hunter,survival,3,2,1
16863,Whitecake,area-52,96,hunter,survival,3,2,1
16864,Berkhof,tichondrius,96,hunter,survival,6,1,5
16865,Feorbxl,proudmoore,96,hunter,survival,6,1,5
16866,Bloodarrow,tichondrius,96,hunter,survival,6,1,5
16867,Ezpzx,sargeras,96,hunter,survival,6,1,5
16868,Jîlt,aerie-peak,96,hunter,survival,6,1,5
16869,Shottz,aerie-peak,96,hunter,survival,6,1,5
16870,Caliente,tichondrius,96,hunter,survival,6,1,5
16871,Alorick,ragnaros,96,hunter,survival,6,1,5
16872,Symz,ragnaros,96,hunter,survival,6,1,5
16873,Survbot,malganis,96,hunter,survival,6,1,5
16874,Taofang,emerald-dream,96,hunter,survival,6,1,5
16875,Terrabytés,kelthuzad,96,hunter,survival,6,1,5
16876,Weegnomie,wyrmrest-accord,96,hunter,survival,6,1,5
16877,Pinktrexx,darkspear,96,hunter,survival,6,1,5
16878,Ergen,zuluhed,96,hunter,survival,6,1,5
16879,Dusle,azralon,96,hunter,survival,6,1,5
16880,Lance,darrowmere,96,hunter,survival,6,1,5
16881,Fearlesarrow,suramar,96,hunter,survival,6,1,5
16882,Nevertraps,tichondrius,96,hunter,survival,6,1,5
16883,Legosshi,darrowmere,96,hunter,survival,6,1,5
16884,Sobala,azralon,96,hunter,survival,6,1,5
16885,Kölhberg,azralon,96,hunter,survival,6,1,5
16886,Kdik,azralon,96,hunter,survival,6,1,5
16887,Skybourne,nemesis,96,hunter,survival,6,1,5
16888,Lammy,bleeding-hollow,96,hunter,survival,6,1,5
16889,Feignqt,illidan,96,hunter,survival,6,1,5
16890,Floorislava,durotan,96,hunter,survival,6,1,5
16891,Hironna,proudmoore,96,hunter,survival,6,1,5
16892,Shuweet,moon-guard,96,hunter,survival,6,1,5
16893,Elroyjetson,arthas,96,hunter,survival,6,1,5
16894,Esser,mannoroth,96,hunter,survival,6,1,5
16895,Killerxzxz,stormrage,96,hunter,survival,6,1,5
16896,Critz,undermine,96,hunter,survival,6,1,5
16897,Purpmang,bleeding-hollow,96,hunter,survival,12,1,11
16898,Montakka,illidan,79,hunter,survival,5,1,4
16899,Vortex,arthas,63,hunter,survival,2,2,0
16900,Tayeal,thrall,31,hunter,survival,2,1,1
16901,Longshánks,stormrage,16,hunter,survival,1,1,0
16902,Hurrican,kaelthas,16,hunter,survival,1,1,0
16903,Saiiph,bleeding-hollow,2274,hunter,beastmastery,136,76,60
16904,Sphericsnow,shuhalo,2210,hunter,beastmastery,95,51,44
16905,Studiosx,tichondrius,2186,hunter,beastmastery,106,56,50
16906,Missedmytrap,agamaggan,2149,hunter,beastmastery,80,46,34
16907,Zujo,emerald-dream,2134,hunter,beastmastery,173,89,84
16908,Ucl,tichondrius,2125,hunter,beastmastery,90,45,45
16909,Eref,sargeras,2116,hunter,beastmastery,78,42,36
16910,Wmsgs,tichondrius,2116,hunter,beastmastery,129,64,65
16911,Traptations,sargeras,2114,hunter,beastmastery,90,43,47
16912,Warpath,ursin,2113,hunter,beastmastery,138,76,62
16913,Pãrzival,tichondrius,2100,hunter,beastmastery,66,35,31
16914,Maiyev,quelthalas,2074,hunter,beastmastery,95,52,43
16915,Fish,darkspear,2070,hunter,beastmastery,90,45,45
16916,Hfn,stormrage,2058,hunter,beastmastery,70,37,33
16917,Manyu,tichondrius,2035,hunter,beastmastery,69,34,35
16918,Orber,stormrage,2028,hunter,beastmastery,290,153,137
16919,Hazzersk,ragnaros,2023,hunter,beastmastery,161,78,83
16920,Perawantua,frostmourne,2002,hunter,beastmastery,73,43,30
16921,Outz,anvilmar,1998,hunter,beastmastery,419,211,208
16922,Pokìmane,tichondrius,1997,hunter,beastmastery,200,109,91
16923,Antø,tichondrius,1997,hunter,beastmastery,135,66,69
16924,Genom,tichondrius,1996,hunter,beastmastery,342,175,167
16925,Cannondale,tichondrius,1993,hunter,beastmastery,42,21,21
16926,Trapful,illidan,1992,hunter,beastmastery,96,49,47
16927,Øverdose,ragnaros,1989,hunter,beastmastery,60,31,29
16928,Beastmunster,frostmourne,1984,hunter,beastmastery,72,34,38
16929,Pikabow,tichondrius,1968,hunter,beastmastery,57,31,26
16930,Arcobaleno,tichondrius,1952,hunter,beastmastery,89,44,45
16931,Trapandclap,tichondrius,1950,hunter,beastmastery,119,57,62
16932,Arsk,ragnaros,1934,hunter,beastmastery,136,70,66
16933,Diegoshotz,zuljin,1934,hunter,beastmastery,70,36,34
16934,Blackathena,tichondrius,1933,hunter,beastmastery,162,83,79
16935,Vëëv,proudmoore,1926,hunter,beastmastery,107,55,52
16936,Headshotzplz,tichondrius,1924,hunter,beastmastery,71,39,32
16937,Axlee,tichondrius,1919,hunter,beastmastery,308,151,157
16938,Lenacraft,frostmourne,1917,hunter,beastmastery,66,41,25
16939,Wodhunterxdd,sargeras,1915,hunter,beastmastery,70,34,36
16940,Benay,emerald-dream,1904,hunter,beastmastery,84,49,35
16941,Trappxy,sargeras,1902,hunter,beastmastery,108,55,53
16942,Zeddead,magtheridon,1901,hunter,beastmastery,184,94,90
16943,Nflmaster,malganis,1893,hunter,beastmastery,66,35,31
16944,Veevx,proudmoore,1890,hunter,beastmastery,77,50,27
16945,Kyló,sargeras,1888,hunter,beastmastery,66,34,32
16946,Nyxus,tichondrius,1887,hunter,beastmastery,125,63,62
16947,Kensho,illidan,1887,hunter,beastmastery,202,100,102
16948,Lamerpvp,tichondrius,1885,hunter,beastmastery,50,31,19
16949,Nerfthepet,blackrock,1879,hunter,beastmastery,75,49,26
16950,Carlitocool,tichondrius,1877,hunter,beastmastery,36,28,8
16951,Mugiwara,frostwolf,1877,hunter,beastmastery,42,25,17
16952,Argryta,azralon,1872,hunter,beastmastery,47,22,25
16953,Graar,tichondrius,1871,hunter,beastmastery,48,25,23
16954,Taterballs,illidan,1871,hunter,beastmastery,84,43,41
16955,Notvn,illidan,1869,hunter,beastmastery,53,29,24
16956,Ciany,elune,1869,hunter,beastmastery,119,64,55
16957,Twopumphunt,tichondrius,1868,hunter,beastmastery,36,23,13
16958,Lilstinstin,tichondrius,1867,hunter,beastmastery,42,23,19
16959,Dekestei,bleeding-hollow,1867,hunter,beastmastery,65,27,38
16960,Kenshaunter,azralon,1864,hunter,beastmastery,71,31,40
16961,Starkhaven,firetree,1863,hunter,beastmastery,74,46,28
16962,Somethinggo,tichondrius,1863,hunter,beastmastery,212,105,107
16963,Hogx,sargeras,1862,hunter,beastmastery,72,32,40
16964,Mhter,tichondrius,1861,hunter,beastmastery,79,38,41
16965,Nelay,ragnaros,1857,hunter,beastmastery,106,59,47
16966,Quietqt,ragnaros,1857,hunter,beastmastery,117,63,54
16967,Faniquitinha,stormrage,1854,hunter,beastmastery,54,25,29
16968,Ñotorious,frostmane,1852,hunter,beastmastery,53,27,26
16969,Easonl,tichondrius,1852,hunter,beastmastery,175,81,94
16970,Cashisabeast,zuljin,1851,hunter,beastmastery,46,25,21
16971,Nutellacrepe,kelthuzad,1851,hunter,beastmastery,206,104,102
16972,Koridelse,nemesis,1850,hunter,beastmastery,138,68,70
16973,Infinit,onyxia,1848,hunter,beastmastery,112,54,58
16974,Nollzey,frostmourne,1847,hunter,beastmastery,45,22,23
16975,Tânsøxøxø,tichondrius,1847,hunter,beastmastery,54,22,32
16976,Wickyz,malganis,1846,hunter,beastmastery,42,24,18
16977,Bolanite,illidan,1846,hunter,beastmastery,48,27,21
16978,Bogen,nemesis,1846,hunter,beastmastery,82,44,38
16979,Nalasdottirh,moon-guard,1845,hunter,beastmastery,84,51,33
16980,Skysmile,tichondrius,1845,hunter,beastmastery,60,34,26
16981,Karumä,thrall,1845,hunter,beastmastery,66,31,35
16982,Inktray,durotan,1844,hunter,beastmastery,37,22,15
16983,Zugbrained,illidan,1843,hunter,beastmastery,190,99,91
16984,Ðeatheater,tichondrius,1843,hunter,beastmastery,41,21,20
16985,Aqq,moon-guard,1842,hunter,beastmastery,98,58,40
16986,Monffbe,tichondrius,1842,hunter,beastmastery,60,28,32
16987,Swang,kiljaeden,1841,hunter,beastmastery,67,34,33
16988,Sarutobi,black-dragonflight,1840,hunter,beastmastery,72,31,41
16989,Auwstin,tichondrius,1837,hunter,beastmastery,55,31,24
16990,Ashenga,cairne,1837,hunter,beastmastery,223,116,107
16991,Lenalena,tichondrius,1836,hunter,beastmastery,107,58,49
16992,Bowrockobama,illidan,1836,hunter,beastmastery,75,40,35
16993,Ârtæmïs,stormrage,1835,hunter,beastmastery,48,24,24
16994,Mørodox,sargeras,1834,hunter,beastmastery,54,24,30
16995,Rëxx,moon-guard,1833,hunter,beastmastery,103,62,41
16996,Hollymarie,nazjatar,1832,hunter,beastmastery,48,31,17
16997,Absinther,emerald-dream,1829,hunter,beastmastery,66,41,25
16998,Lkw,tichondrius,1829,hunter,beastmastery,80,37,43
16999,Dju,stormrage,1828,hunter,beastmastery,95,51,44
17000,Playnogames,moon-guard,1828,hunter,beastmastery,42,21,21
17001,Oromia,proudmoore,1828,hunter,beastmastery,60,29,31
17002,Vox,tichondrius,1827,hunter,beastmastery,46,30,16
17003,Tyleraq,area-52,1827,hunter,beastmastery,41,24,17
17004,Petmanx,tichondrius,1826,hunter,beastmastery,144,81,63
17005,Zå,dalaran,1826,hunter,beastmastery,93,50,43
17006,Sxra,area-52,1826,hunter,beastmastery,70,37,33
17007,Negãn,tichondrius,1826,hunter,beastmastery,80,41,39
17008,Flanzo,illidan,1825,hunter,beastmastery,59,32,27
17009,Sosaho,sargeras,1825,hunter,beastmastery,41,21,20
17010,Sniperælite,korgath,1824,hunter,beastmastery,55,32,23
17011,Phatshiet,anvilmar,1823,hunter,beastmastery,50,31,19
17012,Jeffersan,illidan,1823,hunter,beastmastery,149,72,77
17013,Zumago,tichondrius,1823,hunter,beastmastery,118,54,64
17014,Trap,demon-soul,1822,hunter,beastmastery,54,28,26
17015,Zefbaby,quelthalas,1822,hunter,beastmastery,66,31,35
17016,Tyreu,tichondrius,1820,hunter,beastmastery,59,30,29
17017,Torolol,tichondrius,1819,hunter,beastmastery,126,73,53
17018,Grimrokk,malganis,1819,hunter,beastmastery,78,40,38
17019,Phayzd,sargeras,1818,hunter,beastmastery,66,34,32
17020,Scuffedshots,tichondrius,1817,hunter,beastmastery,74,43,31
17021,Lrnb,tichondrius,1817,hunter,beastmastery,56,32,24
17022,Yucca,drenden,1816,hunter,beastmastery,42,23,19
17023,Çute,moon-guard,1815,hunter,beastmastery,60,39,21
17024,Flitt,zuljin,1815,hunter,beastmastery,36,19,17
17025,Audeline,tichondrius,1815,hunter,beastmastery,69,33,36
17026,Gumbro,malganis,1814,hunter,beastmastery,138,82,56
17027,Comebacks,ragnaros,1814,hunter,beastmastery,72,41,31
17028,Goonsh,tichondrius,1813,hunter,beastmastery,40,25,15
17029,Asukaw,barthilas,1813,hunter,beastmastery,57,28,29
17030,Mythxplosive,ragnaros,1813,hunter,beastmastery,73,32,41
17031,Drektorath,bleeding-hollow,1812,hunter,beastmastery,66,34,32
17032,Wodhunterxdd,tichondrius,1811,hunter,beastmastery,32,23,9
17033,Logjohn,frostmourne,1811,hunter,beastmastery,40,20,20
17034,Kybelís,dalaran,1810,hunter,beastmastery,110,61,49
17035,Hogd,sargeras,1810,hunter,beastmastery,54,26,28
17036,Robinhooz,illidan,1807,hunter,beastmastery,187,102,85
17037,Wilmaßallfit,malganis,1807,hunter,beastmastery,65,29,36
17038,Nishinos,tichondrius,1806,hunter,beastmastery,72,35,37
17039,Lilprimary,tichondrius,1806,hunter,beastmastery,48,23,25
17040,Sobewan,staghelm,1805,hunter,beastmastery,92,42,50
17041,Kytan,shadowmoon,1804,hunter,beastmastery,168,82,86
17042,Bustyredhead,kelthuzad,1804,hunter,beastmastery,95,42,53
17043,Shot,shuhalo,1802,hunter,beastmastery,30,24,6
17044,Kabalaku,moon-guard,1802,hunter,beastmastery,130,72,58
17045,Warcher,azralon,1802,hunter,beastmastery,60,32,28
17046,Hg,illidan,1800,hunter,beastmastery,38,25,13
17047,Kangarookyle,illidan,1800,hunter,beastmastery,96,58,38
17048,Shafttrapper,queldorei,1800,hunter,beastmastery,119,64,55
17049,Funkyjunk,arthas,1800,hunter,beastmastery,72,35,37
17050,Turtlegirl,tichondrius,1797,hunter,beastmastery,76,35,41
17051,Songhammer,tichondrius,1793,hunter,beastmastery,100,55,45
17052,Austelos,moon-guard,1793,hunter,beastmastery,95,52,43
17053,Mikey,exodar,1789,hunter,beastmastery,204,116,88
17054,Cuchulláin,area-52,1787,hunter,beastmastery,138,73,65
17055,Skywvlker,illidan,1787,hunter,beastmastery,88,41,47
17056,Sñïpêr,tichondrius,1784,hunter,beastmastery,53,29,24
17057,Survchris,bleeding-hollow,1784,hunter,beastmastery,100,45,55
17058,Pathofsexile,tichondrius,1783,hunter,beastmastery,93,43,50
17059,Xgoh,sargeras,1782,hunter,beastmastery,42,22,20
17060,Mukbangbj,terenas,1780,hunter,beastmastery,114,65,49
17061,Junglefever,skywall,1778,hunter,beastmastery,46,26,20
17062,Hunterphil,hyjal,1777,hunter,beastmastery,66,39,27
17063,Edarkness,gurubashi,1776,hunter,beastmastery,176,84,92
17064,Mckim,tichondrius,1775,hunter,beastmastery,48,28,20
17065,Dayquillx,illidan,1775,hunter,beastmastery,42,21,21
17066,Tyrokk,barthilas,1774,hunter,beastmastery,78,39,39
17067,Livelovelaff,tichondrius,1773,hunter,beastmastery,54,28,26
17068,Savagerko,illidan,1770,hunter,beastmastery,63,29,34
17069,Asynic,blades-edge,1768,hunter,beastmastery,113,59,54
17070,Tytonic,bleeding-hollow,1765,hunter,beastmastery,54,28,26
17071,Vonkrieg,tichondrius,1764,hunter,beastmastery,41,25,16
17072,Perffect,sargeras,1763,hunter,beastmastery,57,24,33
17073,Tracershot,malganis,1758,hunter,beastmastery,101,58,43
17074,Survivalists,kelthuzad,1752,hunter,beastmastery,36,24,12
17075,Datbigbowdoe,illidan,1752,hunter,beastmastery,36,23,13
17076,Mhters,tichondrius,1752,hunter,beastmastery,48,26,22
17077,Tembaktytyd,barthilas,1751,hunter,beastmastery,49,24,25
17078,Fockewulf,dragonmaw,1750,hunter,beastmastery,90,40,50
17079,Airpodpro,emerald-dream,1747,hunter,beastmastery,36,21,15
17080,Esstark,bleeding-hollow,1743,hunter,beastmastery,48,20,28
17081,Madbéê,tichondrius,1741,hunter,beastmastery,41,19,22
17082,Puffcopeak,illidan,1740,hunter,beastmastery,66,39,27
17083,Fxsb,tichondrius,1739,hunter,beastmastery,158,74,84
17084,Deathtomyfoe,sargeras,1735,hunter,beastmastery,54,21,33
17085,Pineapplees,tichondrius,1733,hunter,beastmastery,54,29,25
17086,Åspect,aegwynn,1732,hunter,beastmastery,53,28,25
17087,Dahmer,greymane,1732,hunter,beastmastery,62,29,33
17088,Melov,frostmourne,1730,hunter,beastmastery,64,30,34
17089,Kidao,emerald-dream,1729,hunter,beastmastery,54,30,24
17090,Liarael,illidan,1728,hunter,beastmastery,136,64,72
17091,Squawkers,sargeras,1727,hunter,beastmastery,36,22,14
17092,Xonios,frostwolf,1727,hunter,beastmastery,90,46,44
17093,Sniper,area-52,1725,hunter,beastmastery,182,90,92
17094,Dragonspider,zuljin,1724,hunter,beastmastery,30,21,9
17095,Krunkz,frostmourne,1724,hunter,beastmastery,53,33,20
17096,Ðfac,moon-guard,1724,hunter,beastmastery,84,42,42
17097,Reparcero,quelthalas,1723,hunter,beastmastery,42,20,22
17098,Bootydoo,illidan,1721,hunter,beastmastery,130,67,63
17099,Chrisp,bloodhoof,1721,hunter,beastmastery,48,23,25
17100,Kenpachie,jubeithos,1716,hunter,beastmastery,35,23,12
17101,Kenji,sargeras,1716,hunter,beastmastery,80,40,40
17102,Twixzorz,boulderfist,1716,hunter,beastmastery,60,28,32
17103,Lucki,blades-edge,1715,hunter,beastmastery,60,34,26
17104,Acres,emerald-dream,1714,hunter,beastmastery,27,19,8
17105,Warrccjr,steamwheedle-cartel,1714,hunter,beastmastery,47,21,26
17106,Ryûkø,quelthalas,1712,hunter,beastmastery,84,41,43
17107,Fanikita,azralon,1712,hunter,beastmastery,75,31,44
17108,Laoai,tichondrius,1711,hunter,beastmastery,37,23,14
17109,Revalay,emerald-dream,1711,hunter,beastmastery,54,32,22
17110,Edelyysa,arthas,1711,hunter,beastmastery,180,89,91
17111,Squeekin,sargeras,1709,hunter,beastmastery,33,26,7
17112,Shablagoosh,zuljin,1706,hunter,beastmastery,37,25,12
17113,Sbplayshunt,akama,1706,hunter,beastmastery,48,19,29
17114,Xorian,frostmourne,1705,hunter,beastmastery,36,18,18
17115,Pkkfantasy,archimonde,1704,hunter,beastmastery,82,44,38
17116,Saintpablo,mannoroth,1702,hunter,beastmastery,54,29,25
17117,Hyjax,darkspear,1701,hunter,beastmastery,43,26,17
17118,Snowmnz,tichondrius,1701,hunter,beastmastery,53,30,23
17119,Raymose,tichondrius,1701,hunter,beastmastery,64,30,34
17120,Killshøtß,tichondrius,1701,hunter,beastmastery,65,30,35
17121,Fatalshots,bonechewer,1699,hunter,beastmastery,42,24,18
17122,Pepepls,proudmoore,1699,hunter,beastmastery,72,38,34
17123,Wodunaz,stormrage,1698,hunter,beastmastery,71,45,26
17124,Geeshot,area-52,1698,hunter,beastmastery,66,27,39
17125,Urukah,gallywix,1697,hunter,beastmastery,40,19,21
17126,Sambucca,daggerspine,1696,hunter,beastmastery,54,26,28
17127,Bowreckage,malganis,1695,hunter,beastmastery,251,121,130
17128,Mojopojo,tichondrius,1694,hunter,beastmastery,61,35,26
17129,Jfkd,sargeras,1694,hunter,beastmastery,52,21,31
17130,Spídër,maiev,1692,hunter,beastmastery,62,31,31
17131,Nobito,quelthalas,1691,hunter,beastmastery,153,82,71
17132,Bicas,emerald-dream,1689,hunter,beastmastery,72,37,35
17133,Shadowfangs,tichondrius,1689,hunter,beastmastery,66,31,35
17134,Hxnry,barthilas,1686,hunter,beastmastery,30,18,12
17135,Cresselia,drakkari,1686,hunter,beastmastery,53,29,24
17136,Fabbs,frostmourne,1686,hunter,beastmastery,52,26,26
17137,Dirtymongrel,barthilas,1685,hunter,beastmastery,96,49,47
17138,Illweedx,kiljaeden,1684,hunter,beastmastery,125,56,69
17139,Lilskill,lightnings-blade,1682,hunter,beastmastery,30,18,12
17140,Ipickmynose,tichondrius,1681,hunter,beastmastery,71,41,30
17141,Kapukapu,illidan,1679,hunter,beastmastery,30,18,12
17142,Darylovejr,destromath,1679,hunter,beastmastery,36,19,17
17143,Flor,boulderfist,1679,hunter,beastmastery,38,20,18
17144,Silverbite,garona,1678,hunter,beastmastery,92,51,41
17145,Shootnskoot,icecrown,1677,hunter,beastmastery,30,20,10
17146,Shootiepie,hyjal,1677,hunter,beastmastery,30,19,11
17147,Coopshot,darkspear,1675,hunter,beastmastery,69,40,29
17148,Saiiphz,bleeding-hollow,1675,hunter,beastmastery,40,22,18
17149,Tuân,azgalor,1674,hunter,beastmastery,36,23,13
17150,Alaurys,moon-guard,1674,hunter,beastmastery,35,18,17
17151,Scythedom,tichondrius,1673,hunter,beastmastery,48,23,25
17152,Spizsnipes,malganis,1672,hunter,beastmastery,66,30,36
17153,Facerolled,area-52,1671,hunter,beastmastery,93,54,39
17154,Xionos,wyrmrest-accord,1671,hunter,beastmastery,144,75,69
17155,Sissleto,tichondrius,1667,hunter,beastmastery,347,172,175
17156,Koalahunter,area-52,1667,hunter,beastmastery,76,31,45
17157,Mortalz,barthilas,1663,hunter,beastmastery,208,108,100
17158,Hokutoxx,tichondrius,1663,hunter,beastmastery,61,25,36
17159,Yughii,stormrage,1662,hunter,beastmastery,42,20,22
17160,Pinêapplê,bleeding-hollow,1661,hunter,beastmastery,36,23,13
17161,Thtswap,moon-guard,1661,hunter,beastmastery,48,30,18
17162,Showtheio,azralon,1660,hunter,beastmastery,41,22,19
17163,Whoshotu,tichondrius,1660,hunter,beastmastery,53,27,26
17164,Sasorï,nemesis,1659,hunter,beastmastery,30,19,11
17165,Dj,arygos,1658,hunter,beastmastery,36,21,15
17166,Dpdóugh,illidan,1658,hunter,beastmastery,112,59,53
17167,Illsugoi,frostwolf,1657,hunter,beastmastery,141,70,71
17168,Showmakerc,proudmoore,1656,hunter,beastmastery,77,35,42
17169,Shyck,ragnaros,1655,hunter,beastmastery,59,31,28
17170,Casperonni,illidan,1654,hunter,beastmastery,120,64,56
17171,Gufanyaun,tichondrius,1654,hunter,beastmastery,34,18,16
17172,Smullik,wyrmrest-accord,1654,hunter,beastmastery,114,51,63
17173,Thezeus,barthilas,1654,hunter,beastmastery,47,20,27
17174,Crounzz,sargeras,1654,hunter,beastmastery,72,28,44
17175,Terpa,nemesis,1653,hunter,beastmastery,184,96,88
17176,Rndx,sargeras,1653,hunter,beastmastery,46,20,26
17177,Sylviai,hyjal,1652,hunter,beastmastery,77,40,37
17178,Kwinoah,zuljin,1652,hunter,beastmastery,174,84,90
17179,Teddybowschi,sargeras,1650,hunter,beastmastery,35,18,17
17180,Odb,kelthuzad,1650,hunter,beastmastery,48,20,28
17181,Mojopotato,stormrage,1649,hunter,beastmastery,77,37,40
17182,Ñðñdêsçrípt,frostmourne,1648,hunter,beastmastery,109,59,50
17183,Eastwood,tichondrius,1648,hunter,beastmastery,92,41,51
17184,Rcman,tichondrius,1647,hunter,beastmastery,54,41,13
17185,Cw,gorefiend,1647,hunter,beastmastery,48,25,23
17186,Camhaanes,area-52,1646,hunter,beastmastery,119,67,52
17187,Zemphoths,eredar,1645,hunter,beastmastery,93,41,52
17188,Urzoth,tichondrius,1644,hunter,beastmastery,54,35,19
17189,Trapordíe,tichondrius,1644,hunter,beastmastery,42,23,19
17190,Mauklindaufe,fenris,1644,hunter,beastmastery,85,43,42
17191,Mlemily,stormrage,1643,hunter,beastmastery,63,36,27
17192,Cachín,ragnaros,1642,hunter,beastmastery,54,26,28
17193,Icecaffemoca,tichondrius,1641,hunter,beastmastery,56,25,31
17194,Kaelhim,warsong,1638,hunter,beastmastery,28,20,8
17195,Andalora,malganis,1638,hunter,beastmastery,67,30,37
17196,Publicpooper,tichondrius,1637,hunter,beastmastery,36,21,15
17197,Energiser,stormrage,1637,hunter,beastmastery,58,29,29
17198,Mmeep,illidan,1636,hunter,beastmastery,58,30,28
17199,Mcclintock,executus,1636,hunter,beastmastery,41,21,20
17200,Massacration,area-52,1636,hunter,beastmastery,51,22,29
17201,Drakarth,khazgoroth,1635,hunter,beastmastery,47,22,25
17202,Kushaddict,lightnings-blade,1634,hunter,beastmastery,208,97,111
17203,Kahll,azralon,1634,hunter,beastmastery,54,24,30
17204,Plastera,zuljin,1634,hunter,beastmastery,52,23,29
17205,Montano,area-52,1633,hunter,beastmastery,32,22,10
17206,Svsnipe,tichondrius,1633,hunter,beastmastery,61,35,26
17207,Beastkets,area-52,1632,hunter,beastmastery,60,31,29
17208,Airhunt,thrall,1632,hunter,beastmastery,42,19,23
17209,Damadar,tichondrius,1632,hunter,beastmastery,42,19,23
17210,Thebush,dragonmaw,1629,hunter,beastmastery,84,48,36
17211,Axxll,tichondrius,1629,hunter,beastmastery,55,25,30
17212,Cocoapuffs,cenarius,1627,hunter,beastmastery,36,17,19
17213,Onemoreshot,bleeding-hollow,1626,hunter,beastmastery,84,44,40
17214,Layloww,thrall,1626,hunter,beastmastery,36,18,18
17215,Reachme,moon-guard,1624,hunter,beastmastery,36,17,19
17216,Urukkz,goldrinn,1624,hunter,beastmastery,48,21,27
17217,Liadrelle,proudmoore,1624,hunter,beastmastery,57,24,33
17218,Whitecake,area-52,1623,hunter,beastmastery,40,25,15
17219,Grimbrew,garona,1623,hunter,beastmastery,41,24,17
17220,Shootsb,tichondrius,1623,hunter,beastmastery,58,24,34
17221,Zakalla,malganis,1622,hunter,beastmastery,62,33,29
17222,Trickshotss,illidan,1621,hunter,beastmastery,106,63,43
17223,Metrallon,black-dragonflight,1621,hunter,beastmastery,53,29,24
17224,Sonichunterr,illidan,1620,hunter,beastmastery,76,46,30
17225,Brokiînn,aegwynn,1619,hunter,beastmastery,129,67,62
17226,Rürü,illidan,1618,hunter,beastmastery,40,21,19
17227,Darkoshuntar,tichondrius,1617,hunter,beastmastery,30,17,13
17228,Montakka,illidan,1617,hunter,beastmastery,54,28,26
17229,Oblivîon,illidan,1616,hunter,beastmastery,59,38,21
17230,Phiyuh,stormrage,1616,hunter,beastmastery,72,42,30
17231,Huntinpuss,tichondrius,1616,hunter,beastmastery,32,18,14
17232,Telånnas,illidan,1616,hunter,beastmastery,42,21,21
17233,Skytrooper,boulderfist,1616,hunter,beastmastery,59,26,33
17234,Nooche,bleeding-hollow,1615,hunter,beastmastery,36,22,14
17235,Monatre,fizzcrank,1615,hunter,beastmastery,51,22,29
17236,Unloaded,illidan,1614,hunter,beastmastery,51,32,19
17237,Wøden,draka,1614,hunter,beastmastery,72,38,34
17238,Legoflaiz,drakkari,1614,hunter,beastmastery,48,23,25
17239,Apøllö,kilrogg,1614,hunter,beastmastery,262,123,139
17240,Pillarington,tichondrius,1613,hunter,beastmastery,52,32,20
17241,Ecl,azralon,1613,hunter,beastmastery,48,27,21
17242,Bamfhunt,darkspear,1612,hunter,beastmastery,99,52,47
17243,Thamie,tichondrius,1610,hunter,beastmastery,24,17,7
17244,Vanasir,moon-guard,1610,hunter,beastmastery,47,24,23
17245,Mambothehunt,stormrage,1610,hunter,beastmastery,89,42,47
17246,Lark,emerald-dream,1609,hunter,beastmastery,33,18,15
17247,Kaizong,hyjal,1609,hunter,beastmastery,41,22,19
17248,Asurvivor,suramar,1609,hunter,beastmastery,190,98,92
17249,Mournebow,tichondrius,1608,hunter,beastmastery,279,151,128
17250,Statistic,black-dragonflight,1608,hunter,beastmastery,59,30,29
17251,Bertimus,sargeras,1608,hunter,beastmastery,132,61,71
17252,Recklaw,frostmourne,1607,hunter,beastmastery,36,21,15
17253,Parnicyon,frostmourne,1607,hunter,beastmastery,209,109,100
17254,Focusfire,khazgoroth,1607,hunter,beastmastery,66,32,34
17255,Mordriva,azjolnerub,1607,hunter,beastmastery,53,25,28
17256,Feignmilf,tichondrius,1606,hunter,beastmastery,84,51,33
17257,Shootnoscore,vashj,1606,hunter,beastmastery,83,46,37
17258,Elad,tichondrius,1606,hunter,beastmastery,102,55,47
17259,Foxqt,emerald-dream,1606,hunter,beastmastery,38,20,18
17260,Teneightt,tichondrius,1606,hunter,beastmastery,68,34,34
17261,Nodougaelark,dalaran,1606,hunter,beastmastery,48,20,28
17262,Mvpwonder,frostmourne,1606,hunter,beastmastery,54,22,32
17263,Legacyhunter,nazgrel,1605,hunter,beastmastery,30,17,13
17264,Légölás,tichondrius,1603,hunter,beastmastery,84,47,37
17265,Dreygar,dawnbringer,1603,hunter,beastmastery,129,66,63
17266,Jillypoo,azralon,1602,hunter,beastmastery,30,21,9
17267,Scattertrap,ragnaros,1601,hunter,beastmastery,30,20,10
17268,Bettallana,tichondrius,1601,hunter,beastmastery,30,17,13
17269,Axis,mugthol,1601,hunter,beastmastery,85,45,40
17270,Aazua,frostmourne,1601,hunter,beastmastery,45,22,23
17271,Snewfly,tichondrius,1600,hunter,beastmastery,54,36,18
17272,Getrekt,azralon,1600,hunter,beastmastery,78,38,40
17273,Goongarg,frostmourne,1600,hunter,beastmastery,36,17,19
17274,Fernn,illidan,1599,hunter,beastmastery,170,79,91
17275,Razor,destromath,1598,hunter,beastmastery,82,38,44
17276,Vanero,eonar,1598,hunter,beastmastery,48,22,26
17277,Lexandr,tichondrius,1597,hunter,beastmastery,120,65,55
17278,Beasting,moon-guard,1596,hunter,beastmastery,54,29,25
17279,Hillside,frostmourne,1595,hunter,beastmastery,89,45,44
17280,Morbow,proudmoore,1593,hunter,beastmastery,82,46,36
17281,Consanguin,sargeras,1590,hunter,beastmastery,42,24,18
17282,Grindal,drakkari,1590,hunter,beastmastery,54,25,29
17283,Merkidy,illidan,1588,hunter,beastmastery,35,20,15
17284,Häm,dalaran,1588,hunter,beastmastery,148,79,69
17285,Killwill,illidan,1587,hunter,beastmastery,54,28,26
17286,Assbow,kiljaeden,1586,hunter,beastmastery,115,52,63
17287,Hofftimus,tichondrius,1585,hunter,beastmastery,82,53,29
17288,Sashagreen,frostmourne,1585,hunter,beastmastery,83,43,40
17289,Toxarch,aggramar,1585,hunter,beastmastery,78,39,39
17290,Lissavi,tichondrius,1581,hunter,beastmastery,42,21,21
17291,Kniightjayyx,kelthuzad,1581,hunter,beastmastery,114,51,63
17292,Stonehard,mugthol,1581,hunter,beastmastery,42,17,25
17293,Chaw,nathrezim,1579,hunter,beastmastery,196,103,93
17294,Bloodymalik,tichondrius,1578,hunter,beastmastery,42,18,24
17295,Reloadz,shattered-hand,1577,hunter,beastmastery,52,29,23
17296,Zyzzmirin,illidan,1577,hunter,beastmastery,78,35,43
17297,Overshot,tichondrius,1577,hunter,beastmastery,72,31,41
17298,Zakrogg,tichondrius,1576,hunter,beastmastery,59,28,31
17299,Squishasf,tichondrius,1575,hunter,beastmastery,30,18,12
17300,Elieliloa,quelthalas,1573,hunter,beastmastery,60,29,31
17301,Squeeb,frostmourne,1572,hunter,beastmastery,62,30,32
17302,Zennifi,bleeding-hollow,1570,hunter,beastmastery,97,49,48
17303,Snipin,ragnaros,1570,hunter,beastmastery,48,18,30
17304,Phindo,agamaggan,1569,hunter,beastmastery,36,20,16
17305,Kopula,illidan,1569,hunter,beastmastery,55,30,25
17306,Robnhunt,tichondrius,1568,hunter,beastmastery,36,18,18
17307,Rektarrow,area-52,1568,hunter,beastmastery,47,23,24
17308,Skeetslinger,illidan,1568,hunter,beastmastery,45,18,27
17309,Ddänz,kiljaeden,1568,hunter,beastmastery,72,28,44
17310,Petkd,frostmourne,1566,hunter,beastmastery,48,27,21
17311,Tinyted,nathrezim,1566,hunter,beastmastery,84,43,41
17312,Morganson,moon-guard,1566,hunter,beastmastery,222,113,109
17313,Bubbzar,frostmourne,1564,hunter,beastmastery,54,29,25
17314,Njörðr,eldrethalas,1564,hunter,beastmastery,42,20,22
17315,Yandralen,kiljaeden,1563,hunter,beastmastery,117,63,54
17316,Uzpak,tichondrius,1561,hunter,beastmastery,77,44,33
17317,Ahuamax,tichondrius,1559,hunter,beastmastery,82,47,35
17318,Lasix,burning-blade,1559,hunter,beastmastery,107,52,55
17319,Lele,stormrage,1556,hunter,beastmastery,67,38,29
17320,Lemmetrap,illidan,1554,hunter,beastmastery,41,22,19
17321,Keboks,alleria,1551,hunter,beastmastery,33,18,15
17322,Reay,frostmourne,1551,hunter,beastmastery,36,19,17
17323,Khaydarin,sargeras,1551,hunter,beastmastery,48,21,27
17324,Kolyanis,stormrage,1550,hunter,beastmastery,95,52,43
17325,Partz,darkspear,1549,hunter,beastmastery,36,20,16
17326,Readtitle,malganis,1546,hunter,beastmastery,60,35,25
17327,Gernon,frostmourne,1546,hunter,beastmastery,39,20,19
17328,Despairius,moon-guard,1543,hunter,beastmastery,44,25,19
17329,Deirrë,saurfang,1543,hunter,beastmastery,191,103,88
17330,Outfazed,tichondrius,1541,hunter,beastmastery,105,57,48
17331,Ungoliánt,cairne,1541,hunter,beastmastery,54,28,26
17332,Dôntlosmebro,stormrage,1540,hunter,beastmastery,66,37,29
17333,Varka,area-52,1539,hunter,beastmastery,36,20,16
17334,Cerébro,illidan,1538,hunter,beastmastery,78,31,47
17335,Laurenx,illidan,1537,hunter,beastmastery,33,20,13
17336,Somethinglit,sargeras,1537,hunter,beastmastery,75,38,37
17337,Runforthehil,barthilas,1537,hunter,beastmastery,60,30,30
17338,Mms,frostmourne,1532,hunter,beastmastery,30,18,12
17339,Freebeë,area-52,1531,hunter,beastmastery,85,49,36
17340,Biehuixin,tichondrius,1531,hunter,beastmastery,74,34,40
17341,Tsuro,area-52,1530,hunter,beastmastery,59,30,29
17342,Buggyhuntz,stormrage,1529,hunter,beastmastery,55,33,22
17343,Cyrsmen,ragnaros,1529,hunter,beastmastery,234,116,118
17344,Teaks,aggramar,1527,hunter,beastmastery,30,16,14
17345,Breezekeeper,area-52,1527,hunter,beastmastery,78,40,38
17346,Shadowtensai,stormrage,1527,hunter,beastmastery,78,34,44
17347,Sindragostra,tichondrius,1526,hunter,beastmastery,123,62,61
17348,Robitur,sargeras,1526,hunter,beastmastery,36,17,19
17349,Tus,tichondrius,1526,hunter,beastmastery,36,16,20
17350,Exitwoundz,hyjal,1524,hunter,beastmastery,59,29,30
17351,Broydiesnipe,illidan,1523,hunter,beastmastery,24,16,8
17352,Ullr,gurubashi,1522,hunter,beastmastery,76,28,48
17353,Thoridhal,quelthalas,1521,hunter,beastmastery,36,20,16
17354,Lindsang,illidan,1520,hunter,beastmastery,60,31,29
17355,Bonnèy,zuljin,1518,hunter,beastmastery,49,32,17
17356,Barbed,blackrock,1518,hunter,beastmastery,36,16,20
17357,Clinteastwoo,ragnaros,1517,hunter,beastmastery,48,16,32
17358,Hazzeth,thrall,1516,hunter,beastmastery,30,21,9
17359,Nitroxl,illidan,1516,hunter,beastmastery,66,34,32
17360,Bigolekack,tichondrius,1516,hunter,beastmastery,54,27,27
17361,Balldik,bleeding-hollow,1516,hunter,beastmastery,42,20,22
17362,Whatfoxsay,tichondrius,1513,hunter,beastmastery,54,26,28
17363,Yager,kalecgos,1512,hunter,beastmastery,52,26,26
17364,Dorkins,azralon,1511,hunter,beastmastery,44,25,19
17365,Askelon,firetree,1511,hunter,beastmastery,45,22,23
17366,Gamestopceo,tichondrius,1511,hunter,beastmastery,84,41,43
17367,Hobbingtons,thunderlord,1510,hunter,beastmastery,36,19,17
17368,Kript,dragonmaw,1510,hunter,beastmastery,385,186,199
17369,Yugno,wildhammer,1509,hunter,beastmastery,36,19,17
17370,Kaliaraan,bleeding-hollow,1509,hunter,beastmastery,82,43,39
17371,Internade,frostmourne,1509,hunter,beastmastery,54,25,29
17372,Myladyy,zuljin,1509,hunter,beastmastery,71,30,41
17373,Pingaamarela,nemesis,1508,hunter,beastmastery,198,106,92
17374,Qlbl,tichondrius,1508,hunter,beastmastery,57,27,30
17375,Sanchode,tichondrius,1508,hunter,beastmastery,48,20,28
17376,Datadyne,stormrage,1507,hunter,beastmastery,18,16,2
17377,Velhokoira,illidan,1507,hunter,beastmastery,54,31,23
17378,Diavál,area-52,1507,hunter,beastmastery,46,26,20
17379,Sereom,frostmourne,1505,hunter,beastmastery,131,74,57
17380,Volbz,barthilas,1505,hunter,beastmastery,36,16,20
17381,Yeaheh,area-52,1504,hunter,beastmastery,30,18,12
17382,Emilysamuels,tichondrius,1503,hunter,beastmastery,24,16,8
17383,Pankyrangs,kelthuzad,1503,hunter,beastmastery,48,24,24
17384,Fkkroglash,barthilas,1501,hunter,beastmastery,42,23,19
17385,Chrest,sargeras,1500,hunter,beastmastery,76,39,37
17386,Irøneye,sargeras,1499,hunter,beastmastery,55,20,35
17387,Entrapment,emerald-dream,1498,hunter,beastmastery,41,22,19
17388,Folf,turalyon,1497,hunter,beastmastery,78,34,44
17389,Sartel,tichondrius,1495,hunter,beastmastery,30,17,13
17390,Shockwave,velen,1495,hunter,beastmastery,236,120,116
17391,Ramchi,burning-blade,1494,hunter,beastmastery,61,33,28
17392,Xuorias,area-52,1494,hunter,beastmastery,47,24,23
17393,Kaboomza,tichondrius,1493,hunter,beastmastery,36,19,17
17394,Zünma,tichondrius,1492,hunter,beastmastery,30,16,14
17395,Punjisticks,tichondrius,1492,hunter,beastmastery,110,53,57
17396,Finalshot,barthilas,1491,hunter,beastmastery,39,18,21
17397,Pavlovik,ragnaros,1491,hunter,beastmastery,60,25,35
17398,Anastasia,gorgonnash,1490,hunter,beastmastery,66,36,30
17399,Oceandoom,tichondrius,1489,hunter,beastmastery,146,78,68
17400,Limcross,drakkari,1489,hunter,beastmastery,56,28,28
17401,Setepalms,azralon,1489,hunter,beastmastery,38,18,20
17402,Wredd,nemesis,1488,hunter,beastmastery,35,20,15
17403,Borudin,stormrage,1488,hunter,beastmastery,215,104,111
17404,Scirfreez,ragnaros,1487,hunter,beastmastery,66,30,36
17405,Laras,blades-edge,1484,hunter,beastmastery,36,22,14
17406,Chizhi,tichondrius,1484,hunter,beastmastery,90,45,45
17407,Midgetsniper,thrall,1481,hunter,beastmastery,32,17,15
17408,Chowyunfatss,proudmoore,1481,hunter,beastmastery,112,53,59
17409,Selhort,quelthalas,1481,hunter,beastmastery,84,36,48
17410,Rengarok,emerald-dream,1480,hunter,beastmastery,44,23,21
17411,Grànd,tortheldrin,1480,hunter,beastmastery,66,33,33
17412,Angdre,tichondrius,1480,hunter,beastmastery,36,18,18
17413,Shedowhunter,azralon,1479,hunter,beastmastery,36,23,13
17414,Junmuxiao,ragnaros,1478,hunter,beastmastery,124,61,63
17415,Scourgesurge,kiljaeden,1478,hunter,beastmastery,145,71,74
17416,Spitballa,emerald-dream,1478,hunter,beastmastery,60,28,32
17417,Josyv,quelthalas,1477,hunter,beastmastery,36,21,15
17418,Garzb,area-52,1476,hunter,beastmastery,42,22,20
17419,Aguntur,ragnaros,1474,hunter,beastmastery,99,59,40
17420,Loktarnum,illidan,1474,hunter,beastmastery,52,23,29
17421,Narus,whisperwind,1472,hunter,beastmastery,126,72,54
17422,Virolac,tichondrius,1469,hunter,beastmastery,32,16,16
17423,Caetomon,kiljaeden,1467,hunter,beastmastery,29,18,11
17424,Zaetor,ragnaros,1466,hunter,beastmastery,78,43,35
17425,Hughneutron,kirin-tor,1466,hunter,beastmastery,249,136,113
17426,Tacos,kelthuzad,1465,hunter,beastmastery,36,22,14
17427,Sootgarbage,sargeras,1464,hunter,beastmastery,72,42,30
17428,Lunarlunar,khadgar,1464,hunter,beastmastery,48,20,28
17429,Xpyro,azralon,1462,hunter,beastmastery,72,36,36
17430,ßoness,area-52,1460,hunter,beastmastery,92,38,54
17431,Danncer,alexstrasza,1459,hunter,beastmastery,102,56,46
17432,Bootylickin,tichondrius,1459,hunter,beastmastery,36,17,19
17433,Pheijaumn,azralon,1458,hunter,beastmastery,55,32,23
17434,Ehnó,illidan,1458,hunter,beastmastery,39,19,20
17435,Mikly,ragnaros,1457,hunter,beastmastery,44,18,26
17436,Jaysuper,zuljin,1457,hunter,beastmastery,66,25,41
17437,Fifie,azgalor,1455,hunter,beastmastery,55,28,27
17438,Wolfarms,area-52,1455,hunter,beastmastery,87,42,45
17439,Earlzmoade,bleeding-hollow,1454,hunter,beastmastery,42,21,21
17440,Hongnael,tichondrius,1452,hunter,beastmastery,36,17,19
17441,Sax,stormreaver,1452,hunter,beastmastery,36,16,20
17442,Fusbowdah,bleeding-hollow,1451,hunter,beastmastery,64,29,35
17443,Salvatiel,stormrage,1447,hunter,beastmastery,36,21,15
17444,Stalkstride,destromath,1447,hunter,beastmastery,78,36,42
17445,Jacss,azralon,1446,hunter,beastmastery,30,17,13
17446,Bronke,azralon,1446,hunter,beastmastery,67,30,37
17447,Jugi,wyrmrest-accord,1444,hunter,beastmastery,60,30,30
17448,Gorgoon,sargeras,1444,hunter,beastmastery,42,21,21
17449,Kouandjio,area-52,1444,hunter,beastmastery,36,18,18
17450,Limpnoodle,nerzhul,1443,hunter,beastmastery,170,83,87
17451,Sabanna,proudmoore,1442,hunter,beastmastery,36,20,16
17452,Zanahoria,stormscale,1442,hunter,beastmastery,43,19,24
17453,Daarrk,thrall,1441,hunter,beastmastery,82,39,43
17454,Akoshi,illidan,1440,hunter,beastmastery,30,16,14
17455,Dontmissz,tichondrius,1439,hunter,beastmastery,59,32,27
17456,Gennaro,ragnaros,1439,hunter,beastmastery,30,15,15
17457,Lashga,wyrmrest-accord,1439,hunter,beastmastery,47,22,25
17458,Yná,azralon,1438,hunter,beastmastery,24,15,9
17459,Critterz,gorgonnash,1438,hunter,beastmastery,71,32,39
17460,Bigclamz,dragonmaw,1437,hunter,beastmastery,45,25,20
17461,Bliv,tichondrius,1436,hunter,beastmastery,18,15,3
17462,Aristæos,kelthuzad,1436,hunter,beastmastery,77,40,37
17463,Sungoro,tichondrius,1436,hunter,beastmastery,78,35,43
17464,Squírtle,ragnaros,1436,hunter,beastmastery,36,15,21
17465,Sarahbeara,moonrunner,1435,hunter,beastmastery,24,15,9
17466,Alexxspewpew,ragnaros,1434,hunter,beastmastery,29,15,14
17467,Seatback,arathor,1432,hunter,beastmastery,76,33,43
17468,Kkoner,illidan,1431,hunter,beastmastery,24,15,9
17469,Cyboreg,stormrage,1431,hunter,beastmastery,53,30,23
17470,Seljzs,zuljin,1430,hunter,beastmastery,24,15,9
17471,Cigâro,thrall,1429,hunter,beastmastery,165,84,81
17472,Prierhunt,frostmourne,1429,hunter,beastmastery,36,15,21
17473,Droneshot,tichondrius,1428,hunter,beastmastery,36,24,12
17474,Zarova,moon-guard,1428,hunter,beastmastery,24,15,9
17475,Dabondweebs,dalaran,1428,hunter,beastmastery,36,20,16
17476,Snypêr,tichondrius,1428,hunter,beastmastery,48,21,27
17477,Lilbic,bleeding-hollow,1427,hunter,beastmastery,33,22,11
17478,Iyne,stormrage,1427,hunter,beastmastery,36,15,21
17479,Munyshotz,tichondrius,1426,hunter,beastmastery,104,59,45
17480,Yaisk,tichondrius,1426,hunter,beastmastery,74,38,36
17481,Kleankilla,malganis,1425,hunter,beastmastery,50,27,23
17482,Taelen,aegwynn,1424,hunter,beastmastery,50,26,24
17483,Szone,tichondrius,1424,hunter,beastmastery,124,59,65
17484,Syldris,proudmoore,1423,hunter,beastmastery,24,15,9
17485,Handicrap,tichondrius,1423,hunter,beastmastery,44,26,18
17486,Huntard,stormrage,1423,hunter,beastmastery,36,15,21
17487,Kellsier,nordrassil,1422,hunter,beastmastery,30,15,15
17488,Keknine,gnomeregan,1421,hunter,beastmastery,92,44,48
17489,Boomseed,nagrand,1420,hunter,beastmastery,34,16,18
17490,Kerandas,stormrage,1419,hunter,beastmastery,29,16,13
17491,Mukeru,stormrage,1418,hunter,beastmastery,24,15,9
17492,Araghrn,draktharon,1417,hunter,beastmastery,111,54,57
17493,Celarla,tichondrius,1416,hunter,beastmastery,27,16,11
17494,Gannidema,illidan,1416,hunter,beastmastery,30,17,13
17495,Eldlichi,proudmoore,1416,hunter,beastmastery,48,20,28
17496,Belime,korgath,1415,hunter,beastmastery,96,53,43
17497,Horcnbeans,bleeding-hollow,1415,hunter,beastmastery,203,99,104
17498,Javoz,drakkari,1415,hunter,beastmastery,42,18,24
17499,Terminatôr,malganis,1415,hunter,beastmastery,36,15,21
17500,Drunkhunter,malygos,1414,hunter,beastmastery,24,15,9
17501,Legolasbow,tichondrius,1414,hunter,beastmastery,58,30,28
17502,Wrècked,kiljaeden,1413,hunter,beastmastery,42,19,23
17503,Puppe,sargeras,1412,hunter,beastmastery,52,25,27
17504,Existential,moon-guard,1412,hunter,beastmastery,59,27,32
17505,Turbows,proudmoore,1412,hunter,beastmastery,48,20,28
17506,Mopgodxqt,nemesis,1410,hunter,beastmastery,48,19,29
17507,Shangowar,darrowmere,1409,hunter,beastmastery,24,15,9
17508,Zombified,moon-guard,1409,hunter,beastmastery,50,23,27
17509,Hobbléfoot,proudmoore,1409,hunter,beastmastery,36,15,21
17510,Drig,korgath,1409,hunter,beastmastery,47,19,28
17511,Boomsprocket,khazgoroth,1407,hunter,beastmastery,26,19,7
17512,Dlabio,emerald-dream,1405,hunter,beastmastery,102,50,52
17513,Sioul,bleeding-hollow,1403,hunter,beastmastery,30,15,15
17514,Sharpster,zuljin,1403,hunter,beastmastery,85,41,44
17515,Ruffini,tichondrius,1403,hunter,beastmastery,42,18,24
17516,Sliturthroat,barthilas,1402,hunter,beastmastery,50,20,30
17517,Floopze,burning-legion,1399,hunter,beastmastery,30,16,14
17518,Thralzun,dunemaul,1398,hunter,beastmastery,43,22,21
17519,Luckshot,destromath,1398,hunter,beastmastery,60,27,33
17520,Overshot,barthilas,1397,hunter,beastmastery,24,16,8
17521,Jyttrg,tichondrius,1396,hunter,beastmastery,65,34,31
17522,Elyssandrá,thrall,1396,hunter,beastmastery,107,52,55
17523,Spèedbump,stormrage,1394,hunter,beastmastery,81,40,41
17524,Petmayo,tichondrius,1393,hunter,beastmastery,30,19,11
17525,Dinaoce,frostmourne,1393,hunter,beastmastery,78,39,39
17526,Huntncheekz,kelthuzad,1393,hunter,beastmastery,30,15,15
17527,Grumnz,thrall,1393,hunter,beastmastery,30,15,15
17528,Unrealpewpew,lightbringer,1393,hunter,beastmastery,108,48,60
17529,Timmee,bleeding-hollow,1392,hunter,beastmastery,36,15,21
17530,Liillilliil,tichondrius,1391,hunter,beastmastery,31,16,15
17531,Paganfinn,tichondrius,1391,hunter,beastmastery,66,29,37
17532,Fuzzypjs,stormrage,1390,hunter,beastmastery,42,24,18
17533,Rycksanches,quelthalas,1390,hunter,beastmastery,73,35,38
17534,Tentoontrey,emerald-dream,1390,hunter,beastmastery,42,20,22
17535,Jesselos,stormrage,1390,hunter,beastmastery,54,25,29
17536,Sülivan,zuljin,1388,hunter,beastmastery,55,29,26
17537,Recha,emerald-dream,1388,hunter,beastmastery,42,21,21
17538,Genx,frostmane,1387,hunter,beastmastery,89,44,45
17539,Fleetfox,tichondrius,1385,hunter,beastmastery,115,57,58
17540,Alwaysblazed,hyjal,1383,hunter,beastmastery,36,17,19
17541,Revbubs,darkspear,1382,hunter,beastmastery,60,30,30
17542,Darthski,drenden,1382,hunter,beastmastery,62,29,33
17543,Tearsofnoobs,tichondrius,1381,hunter,beastmastery,33,16,17
17544,Meowimadog,spinebreaker,1380,hunter,beastmastery,36,23,13
17545,Viperstng,area-52,1380,hunter,beastmastery,70,40,30
17546,Lastanar,amanthul,1376,hunter,beastmastery,122,65,57
17547,Killshotqq,tichondrius,1375,hunter,beastmastery,40,18,22
17548,Fruitenveg,frostmourne,1374,hunter,beastmastery,36,18,18
17549,ßutter,thunderlord,1374,hunter,beastmastery,171,80,91
17550,Gejagt,sargeras,1373,hunter,beastmastery,43,23,20
17551,Tearsofrogue,tichondrius,1373,hunter,beastmastery,30,16,14
17552,Lilpoots,warsong,1373,hunter,beastmastery,71,33,38
17553,Chrise,darkspear,1371,hunter,beastmastery,24,18,6
17554,Kleivar,alleria,1370,hunter,beastmastery,30,15,15
17555,Therooth,bleeding-hollow,1369,hunter,beastmastery,53,31,22
17556,Phaction,tichondrius,1369,hunter,beastmastery,60,26,34
17557,Jangle,mannoroth,1368,hunter,beastmastery,34,19,15
17558,Léfty,burning-blade,1368,hunter,beastmastery,55,21,34
17559,Stonëdpimp,moon-guard,1366,hunter,beastmastery,24,15,9
17560,Voodoohunter,blood-furnace,1366,hunter,beastmastery,47,25,22
17561,Wulfgeng,azgalor,1366,hunter,beastmastery,100,51,49
17562,Bubbz,bloodscalp,1365,hunter,beastmastery,126,67,59
17563,Femonemos,nemesis,1364,hunter,beastmastery,55,29,26
17564,Terrygross,sargeras,1364,hunter,beastmastery,36,15,21
17565,Yembohi,queldorei,1363,hunter,beastmastery,24,15,9
17566,Eightbeers,bleeding-hollow,1363,hunter,beastmastery,80,43,37
17567,Stfd,illidan,1363,hunter,beastmastery,38,15,23
17568,Aggargh,baelgun,1362,hunter,beastmastery,51,28,23
17569,Boward,illidan,1362,hunter,beastmastery,67,36,31
17570,Blackspit,ragnaros,1362,hunter,beastmastery,65,34,31
17571,Ogkhalifa,tichondrius,1362,hunter,beastmastery,59,26,33
17572,Moistlegs,proudmoore,1360,hunter,beastmastery,36,16,20
17573,Wook,hyjal,1359,hunter,beastmastery,35,17,18
17574,Ryukuzen,tichondrius,1359,hunter,beastmastery,35,15,20
17575,Shlandy,frostmourne,1356,hunter,beastmastery,32,18,14
17576,Oblíviion,stormrage,1356,hunter,beastmastery,62,33,29
17577,Reallybroke,stormrage,1355,hunter,beastmastery,33,16,17
17578,Kronc,dethecus,1355,hunter,beastmastery,40,16,24
17579,Deadlyarrows,ragnaros,1354,hunter,beastmastery,78,35,43
17580,Saintshaka,drakkari,1353,hunter,beastmastery,23,15,8
17581,Tokendaily,sargeras,1353,hunter,beastmastery,72,40,32
17582,Nephewblasty,nagrand,1353,hunter,beastmastery,36,18,18
17583,Xcisiion,nagrand,1353,hunter,beastmastery,69,31,38
17584,Cinamong,blackrock,1347,hunter,beastmastery,30,15,15
17585,Pokérap,dalaran,1347,hunter,beastmastery,42,17,25
17586,Djfortnité,tichondrius,1343,hunter,beastmastery,24,14,10
17587,Huntmon,nemesis,1343,hunter,beastmastery,30,14,16
17588,Wildlifezoo,tichondrius,1343,hunter,beastmastery,30,14,16
17589,Willdey,frostmourne,1343,hunter,beastmastery,36,14,22
17590,Kronas,laughing-skull,1342,hunter,beastmastery,47,24,23
17591,Pressbro,tichondrius,1342,hunter,beastmastery,30,14,16
17592,Lilien,khazgoroth,1341,hunter,beastmastery,30,18,12
17593,Bingdat,area-52,1341,hunter,beastmastery,88,45,43
17594,Choclit,scilla,1341,hunter,beastmastery,42,14,28
17595,Devised,proudmoore,1340,hunter,beastmastery,29,16,13
17596,Burtone,aegwynn,1340,hunter,beastmastery,40,19,21
17597,Kârân,tichondrius,1340,hunter,beastmastery,79,36,43
17598,Cantcatchtin,tichondrius,1339,hunter,beastmastery,30,14,16
17599,Oatmeallover,stormrage,1339,hunter,beastmastery,30,14,16
17600,Clydebarro,sargeras,1339,hunter,beastmastery,30,14,16
17601,Peterming,tichondrius,1339,hunter,beastmastery,108,49,59
17602,Euclase,bleeding-hollow,1338,hunter,beastmastery,46,23,23
17603,Aiollus,stormreaver,1338,hunter,beastmastery,30,14,16
17604,Pvrisxoxo,frostmourne,1337,hunter,beastmastery,31,15,16
17605,Bro,malorne,1337,hunter,beastmastery,96,45,51
17606,Ordius,azralon,1337,hunter,beastmastery,36,14,22
17607,Crownchild,illidan,1336,hunter,beastmastery,24,14,10
17608,Muffkick,illidan,1336,hunter,beastmastery,27,15,12
17609,Soulreaperts,ragnaros,1336,hunter,beastmastery,40,21,19
17610,Skulgor,zuljin,1336,hunter,beastmastery,66,34,32
17611,Psychiatry,bonechewer,1336,hunter,beastmastery,70,35,35
17612,Azx,tichondrius,1336,hunter,beastmastery,42,19,23
17613,Stel,tichondrius,1335,hunter,beastmastery,33,17,16
17614,Roostersauce,durotan,1335,hunter,beastmastery,36,18,18
17615,Norcklow,ragnaros,1335,hunter,beastmastery,64,31,33
17616,Selljzs,zuljin,1333,hunter,beastmastery,24,14,10
17617,Highdroe,tichondrius,1333,hunter,beastmastery,90,50,40
17618,Óriion,zuljin,1331,hunter,beastmastery,30,15,15
17619,Daken,ysera,1330,hunter,beastmastery,24,14,10
17620,Vurlo,tichondrius,1330,hunter,beastmastery,24,14,10
17621,Argent,altar-of-storms,1330,hunter,beastmastery,42,23,19
17622,Khels,stormreaver,1330,hunter,beastmastery,28,15,13
17623,Jjack,muradin,1330,hunter,beastmastery,96,45,51
17624,Gïzmo,malganis,1329,hunter,beastmastery,36,20,16
17625,Eggbertx,frostmourne,1329,hunter,beastmastery,30,15,15
17626,Luprikus,maelstrom,1328,hunter,beastmastery,29,14,15
17627,Frostyarrow,moon-guard,1325,hunter,beastmastery,55,28,27
17628,Bulleitrye,illidan,1325,hunter,beastmastery,58,28,30
17629,Fallenfates,stormrage,1324,hunter,beastmastery,84,41,43
17630,Jetzy,illidan,1324,hunter,beastmastery,95,46,49
17631,Hitts,kelthuzad,1323,hunter,beastmastery,31,17,14
17632,Bowna,stormscale,1323,hunter,beastmastery,54,20,34
17633,Fusionrpg,quelthalas,1320,hunter,beastmastery,30,17,13
17634,Jesticles,zuljin,1320,hunter,beastmastery,60,30,30
17635,Sáns,sargeras,1320,hunter,beastmastery,30,14,16
17636,Tergls,illidan,1319,hunter,beastmastery,91,41,50
17637,Cottonshots,dalaran,1318,hunter,beastmastery,107,49,58
17638,Redwolf,moon-guard,1317,hunter,beastmastery,42,20,22
17639,Doug,illidan,1317,hunter,beastmastery,30,14,16
17640,Nøtsurê,llane,1317,hunter,beastmastery,66,25,41
17641,Youngteflon,bonechewer,1314,hunter,beastmastery,30,15,15
17642,Velkhan,sargeras,1314,hunter,beastmastery,30,14,16
17643,Xeminis,area-52,1314,hunter,beastmastery,30,14,16
17644,Peiching,proudmoore,1314,hunter,beastmastery,36,15,21
17645,Hoboh,illidan,1310,hunter,beastmastery,66,32,34
17646,Huntmeplz,proudmoore,1309,hunter,beastmastery,35,17,18
17647,Ellarise,stormrage,1308,hunter,beastmastery,36,22,14
17648,Rocchettâ,kirin-tor,1308,hunter,beastmastery,24,14,10
17649,Lizymcguire,malganis,1308,hunter,beastmastery,42,23,19
17650,Varthurg,ragnaros,1308,hunter,beastmastery,30,15,15
17651,Fames,shuhalo,1308,hunter,beastmastery,73,30,43
17652,Pooterdrip,shadowmoon,1307,hunter,beastmastery,30,14,16
17653,Vruul,sargeras,1306,hunter,beastmastery,82,38,44
17654,Kamikazey,tichondrius,1304,hunter,beastmastery,36,18,18
17655,Bluebow,tichondrius,1302,hunter,beastmastery,96,46,50
17656,Radat,stormscale,1301,hunter,beastmastery,25,17,8
17657,Bacatran,darkspear,1301,hunter,beastmastery,58,32,26
17658,Sunchea,arygos,1300,hunter,beastmastery,30,14,16
17659,Eglon,bleeding-hollow,1299,hunter,beastmastery,24,16,8
17660,Henski,wyrmrest-accord,1299,hunter,beastmastery,36,18,18
17661,Zzsocrateszz,dragonmaw,1295,hunter,beastmastery,128,64,64
17662,Bagodonuts,malganis,1295,hunter,beastmastery,35,17,18
17663,Piu,illidan,1295,hunter,beastmastery,60,28,32
17664,Taxest,illidan,1294,hunter,beastmastery,29,14,15
17665,Jacobsladder,illidan,1293,hunter,beastmastery,113,51,62
17666,Dabznblunts,twisting-nether,1292,hunter,beastmastery,36,15,21
17667,Artemisa,warsong,1291,hunter,beastmastery,84,34,50
17668,Darksector,nemesis,1290,hunter,beastmastery,41,14,27
17669,Mitulla,wyrmrest-accord,1289,hunter,beastmastery,56,27,29
17670,Wogolas,barthilas,1288,hunter,beastmastery,30,16,14
17671,Huukend,azjolnerub,1286,hunter,beastmastery,54,27,27
17672,Vaettai,barthilas,1286,hunter,beastmastery,72,32,40
17673,Shorÿuken,tichondrius,1285,hunter,beastmastery,45,15,30
17674,Orcbeast,illidan,1280,hunter,beastmastery,68,27,41
17675,Peppiee,tichondrius,1279,hunter,beastmastery,23,14,9
17676,Thiccphat,sargeras,1277,hunter,beastmastery,23,14,9
17677,Bowflëx,zuljin,1277,hunter,beastmastery,48,23,25
17678,Sleepywrld,area-52,1275,hunter,beastmastery,29,14,15
17679,Conizle,sargeras,1275,hunter,beastmastery,30,14,16
17680,Haiume,nemesis,1273,hunter,beastmastery,42,17,25
17681,Shootaids,illidan,1272,hunter,beastmastery,56,31,25
17682,Blury,tichondrius,1272,hunter,beastmastery,59,32,27
17683,Scaredcrow,azshara,1272,hunter,beastmastery,40,14,26
17684,Snipershot,blackrock,1271,hunter,beastmastery,42,19,23
17685,Iar,tichondrius,1270,hunter,beastmastery,30,18,12
17686,Ascer,gurubashi,1270,hunter,beastmastery,110,55,55
17687,Balsagoth,azralon,1270,hunter,beastmastery,42,19,23
17688,Glediator,tichondrius,1269,hunter,beastmastery,45,21,24
17689,Trapz,hellscream,1267,hunter,beastmastery,96,48,48
17690,Rnger,aerie-peak,1267,hunter,beastmastery,61,28,33
17691,Starsworn,moon-guard,1266,hunter,beastmastery,78,38,40
17692,Gigawrench,darkspear,1265,hunter,beastmastery,24,16,8
17693,Airtight,area-52,1265,hunter,beastmastery,59,26,33
17694,Böuntyhuntêr,area-52,1263,hunter,beastmastery,72,35,37
17695,Hugehuntard,frostmane,1263,hunter,beastmastery,77,28,49
17696,Shekiro,illidan,1261,hunter,beastmastery,61,27,34
17697,Itsdoom,sargeras,1259,hunter,beastmastery,60,37,23
17698,Saltz,tichondrius,1259,hunter,beastmastery,27,15,12
17699,Bobbysmurica,cenarion-circle,1257,hunter,beastmastery,66,30,36
17700,Trianthel,azralon,1255,hunter,beastmastery,24,15,9
17701,Socrato,tichondrius,1252,hunter,beastmastery,43,21,22
17702,Dunkam,quelthalas,1252,hunter,beastmastery,72,34,38
17703,Ownyoufast,darkspear,1251,hunter,beastmastery,54,23,31
17704,Exotichunter,the-underbog,1250,hunter,beastmastery,64,26,38
17705,Danion,aerie-peak,1249,hunter,beastmastery,64,27,37
17706,Vesity,tichondrius,1248,hunter,beastmastery,63,29,34
17707,Karev,area-52,1248,hunter,beastmastery,36,16,20
17708,Lfghunter,frostmourne,1247,hunter,beastmastery,24,13,11
17709,Jawnhunterii,tichondrius,1247,hunter,beastmastery,24,13,11
17710,Ztyer,stormrage,1247,hunter,beastmastery,24,13,11
17711,Frankabingle,area-52,1247,hunter,beastmastery,30,13,17
17712,Wastdpenguin,area-52,1247,hunter,beastmastery,30,13,17
17713,Slowhunterr,tichondrius,1247,hunter,beastmastery,36,13,23
17714,Refinedx,sargeras,1246,hunter,beastmastery,18,13,5
17715,Sotsöl,ragnaros,1246,hunter,beastmastery,24,13,11
17716,Sylriynn,moon-guard,1246,hunter,beastmastery,59,29,30
17717,Thiccit,illidan,1246,hunter,beastmastery,54,26,28
17718,Gabulmenina,nemesis,1245,hunter,beastmastery,24,13,11
17719,Òrìòn,tichondrius,1245,hunter,beastmastery,51,20,31
17720,Reeload,tichondrius,1244,hunter,beastmastery,24,13,11
17721,Shotmieye,thunderhorn,1244,hunter,beastmastery,60,30,30
17722,Maquire,tichondrius,1244,hunter,beastmastery,36,17,19
17723,Digitizoid,tichondrius,1244,hunter,beastmastery,30,13,17
17724,Craftarrow,tichondrius,1243,hunter,beastmastery,41,21,20
17725,Alitharia,nerzhul,1243,hunter,beastmastery,189,84,105
17726,Guapshot,stormreaver,1242,hunter,beastmastery,41,16,25
17727,Heparinqt,area-52,1242,hunter,beastmastery,36,13,23
17728,Missedtrap,tichondrius,1241,hunter,beastmastery,24,13,11
17729,Bighuntz,bleeding-hollow,1241,hunter,beastmastery,36,13,23
17730,Gunbladez,burning-blade,1240,hunter,beastmastery,27,13,14
17731,Angrypepe,bleeding-hollow,1240,hunter,beastmastery,30,13,17
17732,Vayesa,stormscale,1240,hunter,beastmastery,39,16,23
17733,Deepcarver,tichondrius,1240,hunter,beastmastery,41,16,25
17734,Wadadly,malganis,1239,hunter,beastmastery,144,69,75
17735,Chrønic,khadgar,1238,hunter,beastmastery,30,16,14
17736,Ioioi,tichondrius,1238,hunter,beastmastery,34,16,18
17737,Fistbirtdor,illidan,1237,hunter,beastmastery,30,13,17
17738,Nebulahaze,stormrage,1236,hunter,beastmastery,56,27,29
17739,Timogen,illidan,1236,hunter,beastmastery,36,16,20
17740,Nogaro,nemesis,1235,hunter,beastmastery,42,20,22
17741,Artilleria,quelthalas,1235,hunter,beastmastery,54,25,29
17742,Yesterday,draka,1234,hunter,beastmastery,30,13,17
17743,Hynathios,azralon,1233,hunter,beastmastery,30,13,17
17744,Honeygold,tichondrius,1233,hunter,beastmastery,51,19,32
17745,Wârhunt,frostmourne,1232,hunter,beastmastery,78,41,37
17746,Rbtz,illidan,1231,hunter,beastmastery,17,13,4
17747,Xtop,draktharon,1231,hunter,beastmastery,23,15,8
17748,Accuzationzx,tichondrius,1231,hunter,beastmastery,24,13,11
17749,Tanarin,bleeding-hollow,1230,hunter,beastmastery,30,13,17
17750,Blanar,quelthalas,1230,hunter,beastmastery,42,13,29
17751,Tiraa,kelthuzad,1228,hunter,beastmastery,48,19,29
17752,Laudion,quelthalas,1227,hunter,beastmastery,18,13,5
17753,Luoca,shuhalo,1227,hunter,beastmastery,24,13,11
17754,Skywrecker,bleeding-hollow,1226,hunter,beastmastery,24,13,11
17755,Warwonka,magtheridon,1226,hunter,beastmastery,50,23,27
17756,Smallsouljah,demon-soul,1226,hunter,beastmastery,39,17,22
17757,Hovahdo,proudmoore,1224,hunter,beastmastery,23,13,10
17758,Urimiel,daggerspine,1223,hunter,beastmastery,36,16,20
17759,Xxty,stormrage,1221,hunter,beastmastery,24,13,11
17760,Mithrandiel,blood-furnace,1221,hunter,beastmastery,97,49,48
17761,Bromance,kaelthas,1221,hunter,beastmastery,36,18,18
17762,Crumpit,moon-guard,1220,hunter,beastmastery,51,17,34
17763,Grands,tortheldrin,1219,hunter,beastmastery,29,14,15
17764,Havymetal,andorhal,1219,hunter,beastmastery,48,20,28
17765,Machiko,gorefiend,1218,hunter,beastmastery,30,13,17
17766,Anaiset,hyjal,1217,hunter,beastmastery,24,13,11
17767,Mazziy,zangarmarsh,1217,hunter,beastmastery,36,15,21
17768,Xxo,frostmourne,1215,hunter,beastmastery,34,13,21
17769,Loathin,stormrage,1213,hunter,beastmastery,33,21,12
17770,Frxyza,stormrage,1211,hunter,beastmastery,24,13,11
17771,Zullypewpew,stormrage,1207,hunter,beastmastery,28,19,9
17772,Alexbm,amanthul,1207,hunter,beastmastery,51,28,23
17773,Hairyhype,malganis,1207,hunter,beastmastery,48,22,26
17774,Rogshunt,sargeras,1207,hunter,beastmastery,29,13,16
17775,Dayneryz,quelthalas,1206,hunter,beastmastery,99,46,53
17776,Omegalulzxd,kelthuzad,1206,hunter,beastmastery,111,49,62
17777,Ydaine,alexstrasza,1206,hunter,beastmastery,75,33,42
17778,Neymoxi,icecrown,1205,hunter,beastmastery,48,26,22
17779,Iffy,dentarg,1203,hunter,beastmastery,30,17,13
17780,Ryøkø,nemesis,1202,hunter,beastmastery,23,14,9
17781,Winchestyr,lightbringer,1201,hunter,beastmastery,30,14,16
17782,Leannon,stormrage,1200,hunter,beastmastery,35,19,16
17783,Tmac,winterhoof,1198,hunter,beastmastery,53,28,25
17784,Rypunzul,proudmoore,1196,hunter,beastmastery,24,13,11
17785,Alaranel,kiljaeden,1190,hunter,beastmastery,68,29,39
17786,Gaktog,area-52,1189,hunter,beastmastery,27,13,14
17787,Vord,frostmourne,1189,hunter,beastmastery,30,13,17
17788,Dracð,malganis,1187,hunter,beastmastery,42,24,18
17789,Chetta,ragnaros,1187,hunter,beastmastery,66,28,38
17790,Kaxer,illidan,1182,hunter,beastmastery,65,33,32
17791,Desydn,draenor,1180,hunter,beastmastery,155,77,78
17792,Shneedle,illidan,1180,hunter,beastmastery,54,22,32
17793,Thetrickyone,area-52,1180,hunter,beastmastery,52,20,32
17794,Poonbaddy,kiljaeden,1179,hunter,beastmastery,35,13,22
17795,Aztrappin,illidan,1177,hunter,beastmastery,63,24,39
17796,Brendie,thrall,1176,hunter,beastmastery,286,143,143
17797,Fixnoone,moon-guard,1176,hunter,beastmastery,38,18,20
17798,Warsh,anubarak,1173,hunter,beastmastery,34,19,15
17799,Foffy,darkspear,1172,hunter,beastmastery,30,16,14
17800,Trailbreaker,trollbane,1169,hunter,beastmastery,93,50,43
17801,Håwkeye,hyjal,1169,hunter,beastmastery,139,74,65
17802,Riivali,quelthalas,1169,hunter,beastmastery,87,40,47
17803,Kathoey,wyrmrest-accord,1166,hunter,beastmastery,65,26,39
17804,Elfinballz,khadgar,1164,hunter,beastmastery,36,18,18
17805,Pikochon,illidan,1164,hunter,beastmastery,51,22,29
17806,Jezoo,frostmourne,1163,hunter,beastmastery,42,18,24
17807,Thiccshawts,moon-guard,1162,hunter,beastmastery,24,13,11
17808,Frenzyfire,whisperwind,1162,hunter,beastmastery,45,19,26
17809,Londen,tichondrius,1160,hunter,beastmastery,36,18,18
17810,Minkô,tichondrius,1159,hunter,beastmastery,30,13,17
17811,Totorostarh,tichondrius,1158,hunter,beastmastery,33,13,20
17812,Therealgam,the-underbog,1155,hunter,beastmastery,30,15,15
17813,Arucedd,frostmourne,1154,hunter,beastmastery,74,32,42
17814,Lustblitz,illidan,1152,hunter,beastmastery,18,12,6
17815,Shinhyez,tichondrius,1152,hunter,beastmastery,24,12,12
17816,Malvnfresh,tichondrius,1152,hunter,beastmastery,24,12,12
17817,Tyrec,proudmoore,1152,hunter,beastmastery,30,12,18
17818,Rthr,kiljaeden,1151,hunter,beastmastery,18,12,6
17819,Survenant,zuljin,1151,hunter,beastmastery,24,12,12
17820,Awps,sargeras,1150,hunter,beastmastery,18,12,6
17821,Shrian,illidan,1150,hunter,beastmastery,25,12,13
17822,Tageh,malganis,1149,hunter,beastmastery,18,12,6
17823,Thuperduper,tichondrius,1149,hunter,beastmastery,18,12,6
17824,Kroozeh,illidan,1149,hunter,beastmastery,24,12,12
17825,Tosila,tichondrius,1149,hunter,beastmastery,30,12,18
17826,Ddukgue,tichondrius,1149,hunter,beastmastery,30,12,18
17827,Berreydingle,norgannon,1148,hunter,beastmastery,24,12,12
17828,Funnk,tichondrius,1148,hunter,beastmastery,24,12,12
17829,Phatniss,tichondrius,1148,hunter,beastmastery,30,12,18
17830,Elfo,kelthuzad,1147,hunter,beastmastery,18,12,6
17831,Suetyic,tichondrius,1147,hunter,beastmastery,24,12,12
17832,Mangosteen,illidan,1147,hunter,beastmastery,33,13,20
17833,Cuteorcgirl,sargeras,1145,hunter,beastmastery,38,15,23
17834,Ragnarlobkk,ragnaros,1144,hunter,beastmastery,148,71,77
17835,Souperman,malganis,1144,hunter,beastmastery,30,12,18
17836,Cotó,stormrage,1142,hunter,beastmastery,24,12,12
17837,Dooper,malfurion,1141,hunter,beastmastery,30,12,18
17838,Gratmuk,ragnaros,1139,hunter,beastmastery,30,12,18
17839,Hatteras,drakthul,1139,hunter,beastmastery,50,16,34
17840,Dyz,ragnaros,1137,hunter,beastmastery,28,13,15
17841,Daréz,blackrock,1136,hunter,beastmastery,31,14,17
17842,Traxêx,nemesis,1136,hunter,beastmastery,30,13,17
17843,Calypso,chromaggus,1133,hunter,beastmastery,24,12,12
17844,Blimpbooty,stormrage,1130,hunter,beastmastery,41,20,21
17845,Wildfirefly,whisperwind,1130,hunter,beastmastery,56,26,30
17846,Revö,area-52,1129,hunter,beastmastery,30,12,18
17847,Blankshot,doomhammer,1128,hunter,beastmastery,76,39,37
17848,Juicedhunter,tichondrius,1128,hunter,beastmastery,24,12,12
17849,Baconzola,dalaran,1127,hunter,beastmastery,18,12,6
17850,Camperbill,borean-tundra,1127,hunter,beastmastery,25,14,11
17851,Huñté,stormrage,1127,hunter,beastmastery,24,12,12
17852,Kälec,quelthalas,1127,hunter,beastmastery,66,32,34
17853,Neverhunter,azralon,1127,hunter,beastmastery,30,13,17
17854,Xarmozao,nemesis,1127,hunter,beastmastery,39,14,25
17855,Bepee,auchindoun,1126,hunter,beastmastery,98,52,46
17856,Lieolaste,area-52,1126,hunter,beastmastery,35,17,18
17857,Drexzo,tichondrius,1125,hunter,beastmastery,24,12,12
17858,Traps,deathwing,1123,hunter,beastmastery,30,12,18
17859,Qpoc,tichondrius,1120,hunter,beastmastery,44,20,24
17860,Skpro,tichondrius,1118,hunter,beastmastery,42,13,29
17861,Mvpbunny,tichondrius,1117,hunter,beastmastery,46,21,25
17862,Vegamax,illidan,1115,hunter,beastmastery,30,17,13
17863,Rhonishot,tichondrius,1115,hunter,beastmastery,61,24,37
17864,Brandough,detheroc,1111,hunter,beastmastery,21,12,9
17865,Brokenstars,illidan,1108,hunter,beastmastery,146,70,76
17866,Ukamau,ragnaros,1105,hunter,beastmastery,30,17,13
17867,Soccratees,shattered-hand,1102,hunter,beastmastery,17,12,5
17868,Berelai,area-52,1102,hunter,beastmastery,30,12,18
17869,Trono,korgath,1102,hunter,beastmastery,30,12,18
17870,Topshunter,sargeras,1100,hunter,beastmastery,93,49,44
17871,Despise,frostmourne,1098,hunter,beastmastery,27,12,15
17872,Massivattack,skullcrusher,1096,hunter,beastmastery,30,12,18
17873,Shmurda,duskwood,1095,hunter,beastmastery,100,40,60
17874,Strelyatil,trollbane,1092,hunter,beastmastery,36,20,16
17875,Valintine,the-scryers,1090,hunter,beastmastery,23,12,11
17876,Funwell,dalaran,1090,hunter,beastmastery,29,14,15
17877,Chickenadobo,maelstrom,1088,hunter,beastmastery,30,16,14
17878,Zalyssavara,aerie-peak,1085,hunter,beastmastery,27,12,15
17879,Pewpew,gallywix,1082,hunter,beastmastery,35,14,21
17880,Onihanzo,thrall,1078,hunter,beastmastery,31,13,18
17881,Eithelleta,frostmourne,1078,hunter,beastmastery,48,18,30
17882,Firesail,kelthuzad,1076,hunter,beastmastery,20,12,8
17883,Snoozee,emerald-dream,1074,hunter,beastmastery,32,12,20
17884,Buyaga,stormreaver,1073,hunter,beastmastery,72,37,35
17885,Myrfes,ragnaros,1073,hunter,beastmastery,54,19,35
17886,Kinete,proudmoore,1072,hunter,beastmastery,25,13,12
17887,Brendenhunt,area-52,1071,hunter,beastmastery,17,12,5
17888,Jackcoügh,frostmourne,1069,hunter,beastmastery,31,12,19
17889,Jayken,gnomeregan,1067,hunter,beastmastery,28,12,16
17890,Dadhatesme,stormrage,1066,hunter,beastmastery,27,12,15
17891,Nightfal,emerald-dream,1064,hunter,beastmastery,75,28,47
17892,Mouthymerc,zuljin,1063,hunter,beastmastery,35,12,23
17893,Splosiv,stormrage,1056,hunter,beastmastery,18,11,7
17894,Trapinc,sargeras,1056,hunter,beastmastery,18,11,7
17895,Hog,darkspear,1056,hunter,beastmastery,18,11,7
17896,Jawnhunter,tichondrius,1056,hunter,beastmastery,24,11,13
17897,Prêd,malganis,1056,hunter,beastmastery,27,12,15
17898,Unicom,malganis,1056,hunter,beastmastery,30,11,19
17899,Jellyleg,bleeding-hollow,1055,hunter,beastmastery,18,11,7
17900,Ryutiz,fizzcrank,1055,hunter,beastmastery,18,11,7
17901,Undeadroach,tichondrius,1055,hunter,beastmastery,24,11,13
17902,Tashio,aerie-peak,1055,hunter,beastmastery,24,11,13
17903,Emmihunt,tichondrius,1055,hunter,beastmastery,24,11,13
17904,Raven,sargeras,1055,hunter,beastmastery,28,12,16
17905,Toozz,frostmourne,1055,hunter,beastmastery,30,11,19
17906,Puns,stormreaver,1054,hunter,beastmastery,18,11,7
17907,Ispamtraps,emerald-dream,1054,hunter,beastmastery,18,11,7
17908,Houdan,frostmourne,1054,hunter,beastmastery,22,11,11
17909,Kelgar,the-scryers,1054,hunter,beastmastery,30,14,16
17910,Morenarösa,nemesis,1053,hunter,beastmastery,54,22,32
17911,Hitx,tichondrius,1052,hunter,beastmastery,18,11,7
17912,Sagadegêmeos,stormrage,1052,hunter,beastmastery,30,11,19
17913,Sylpheous,bleeding-hollow,1052,hunter,beastmastery,36,11,25
17914,Cummis,skullcrusher,1051,hunter,beastmastery,18,11,7
17915,Ezari,zuljin,1051,hunter,beastmastery,27,12,15
17916,Mav,dragonmaw,1051,hunter,beastmastery,26,11,15
17917,Hohohohahah,gallywix,1051,hunter,beastmastery,30,11,19
17918,Booffmeister,area-52,1050,hunter,beastmastery,24,11,13
17919,Regivaness,nemesis,1049,hunter,beastmastery,24,11,13
17920,Memënto,barthilas,1049,hunter,beastmastery,30,11,19
17921,Gølin,aerie-peak,1049,hunter,beastmastery,30,11,19
17922,Freeside,emerald-dream,1048,hunter,beastmastery,18,11,7
17923,Wingclipped,kelthuzad,1048,hunter,beastmastery,18,11,7
17924,Computer,darkspear,1048,hunter,beastmastery,24,11,13
17925,ßaelon,malganis,1047,hunter,beastmastery,12,11,1
17926,Flacidpasta,sargeras,1047,hunter,beastmastery,18,11,7
17927,Kynagidas,korgath,1047,hunter,beastmastery,24,11,13
17928,Grimhuntz,frostmourne,1047,hunter,beastmastery,24,11,13
17929,Quigfoot,area-52,1047,hunter,beastmastery,87,36,51
17930,Cilnolm,moon-guard,1045,hunter,beastmastery,24,11,13
17931,Gandson,fizzcrank,1045,hunter,beastmastery,29,12,17
17932,Riukyv,ragnaros,1045,hunter,beastmastery,30,11,19
17933,Braii,blood-furnace,1042,hunter,beastmastery,42,18,24
17934,Jijiyoyo,tichondrius,1041,hunter,beastmastery,41,13,28
17935,Zooker,tichondrius,1039,hunter,beastmastery,29,11,18
17936,Frenzygirl,azralon,1036,hunter,beastmastery,18,11,7
17937,Harÿn,nemesis,1036,hunter,beastmastery,24,11,13
17938,More,khadgar,1035,hunter,beastmastery,30,11,19
17939,Vicluvv,stormrage,1034,hunter,beastmastery,23,11,12
17940,Huntercry,ragnaros,1026,hunter,beastmastery,18,11,7
17941,Wrekkthal,illidan,1023,hunter,beastmastery,41,16,25
17942,Elisen,frostmourne,1021,hunter,beastmastery,42,13,29
17943,Bolbathefett,shadowsong,1020,hunter,beastmastery,30,11,19
17944,Taedulos,azralon,1019,hunter,beastmastery,36,19,17
17945,Hetaya,haomarush,1019,hunter,beastmastery,137,60,77
17946,Dragonman,grizzly-hills,1019,hunter,beastmastery,48,15,33
17947,Oldmatador,azralon,1018,hunter,beastmastery,48,21,27
17948,Zpax,area-52,1010,hunter,beastmastery,18,11,7
17949,Jônathan,tichondrius,1010,hunter,beastmastery,18,11,7
17950,Caytano,quelthalas,1010,hunter,beastmastery,30,17,13
17951,Erik,nemesis,1009,hunter,beastmastery,165,79,86
17952,Killerronald,ragnaros,1009,hunter,beastmastery,24,11,13
17953,Fwun,nerzhul,1008,hunter,beastmastery,18,12,6
17954,Hunterjim,tichondrius,1005,hunter,beastmastery,26,12,14
17955,Namikawa,stormrage,1005,hunter,beastmastery,24,11,13
17956,Rairin,tichondrius,1004,hunter,beastmastery,65,33,32
17957,Antihero,norgannon,1001,hunter,beastmastery,20,12,8
17958,Eddyholiday,tichondrius,1001,hunter,beastmastery,26,13,13
17959,Leandrox,quelthalas,1001,hunter,beastmastery,23,11,12
17960,Catharsis,quelthalas,1001,hunter,beastmastery,24,11,13
17961,Shikago,wyrmrest-accord,1001,hunter,beastmastery,31,12,19
17962,Falesta,sargeras,999,hunter,beastmastery,28,12,16
17963,Flexxbow,thrall,994,hunter,beastmastery,23,13,10
17964,Robobrain,area-52,993,hunter,beastmastery,23,11,12
17965,Speirs,tichondrius,993,hunter,beastmastery,60,27,33
17966,Trassic,emerald-dream,990,hunter,beastmastery,23,11,12
17967,Cocstrong,darrowmere,988,hunter,beastmastery,60,31,29
17968,Robingear,baelgun,983,hunter,beastmastery,195,94,101
17969,Ruthgarth,akama,983,hunter,beastmastery,30,13,17
17970,Puhpsy,azralon,981,hunter,beastmastery,72,37,35
17971,Barabulk,wyrmrest-accord,981,hunter,beastmastery,24,12,12
17972,Arrowae,sargeras,981,hunter,beastmastery,56,24,32
17973,Faldran,earthen-ring,977,hunter,beastmastery,112,46,66
17974,Gammaraven,dalaran,968,hunter,beastmastery,19,11,8
17975,Skillvanas,stormrage,965,hunter,beastmastery,25,11,14
17976,Raikuu,skullcrusher,964,hunter,beastmastery,66,34,32
17977,Ahhpash,tichondrius,960,hunter,beastmastery,16,11,5
17978,Csantana,sargeras,960,hunter,beastmastery,18,10,8
17979,Dualp,tichondrius,960,hunter,beastmastery,18,10,8
17980,Worsthunt,tichondrius,960,hunter,beastmastery,18,10,8
17981,Pumplum,kiljaeden,960,hunter,beastmastery,18,10,8
17982,Killaseason,akama,960,hunter,beastmastery,18,10,8
17983,Sniperfx,lightbringer,960,hunter,beastmastery,18,10,8
17984,Gööber,hyjal,960,hunter,beastmastery,18,10,8
17985,Spekgäwd,emerald-dream,960,hunter,beastmastery,18,10,8
17986,Wovow,tichondrius,960,hunter,beastmastery,18,10,8
17987,Xbee,shattered-halls,960,hunter,beastmastery,18,10,8
17988,Fishxxo,frostmourne,960,hunter,beastmastery,24,10,14
17989,Focús,laughing-skull,960,hunter,beastmastery,24,10,14
17990,Justforfunxx,tichondrius,960,hunter,beastmastery,30,10,20
17991,Rosebullets,bleeding-hollow,959,hunter,beastmastery,18,10,8
17992,Tmnarcanttv,tichondrius,959,hunter,beastmastery,18,10,8
17993,Bigkolache,zuljin,959,hunter,beastmastery,18,10,8
17994,Arrowsgobrr,norgannon,959,hunter,beastmastery,18,10,8
17995,Geregaux,sargeras,959,hunter,beastmastery,18,10,8
17996,Evolushun,kiljaeden,959,hunter,beastmastery,21,11,10
17997,Vigon,stormrage,959,hunter,beastmastery,24,10,14
17998,Tangoda,tichondrius,959,hunter,beastmastery,24,10,14
17999,Yangthekhunt,tichondrius,959,hunter,beastmastery,24,10,14
18000,Orgpopeyes,illidan,959,hunter,beastmastery,24,10,14
18001,Huntfaceguy,agamaggan,959,hunter,beastmastery,24,10,14
18002,Leyliann,quelthalas,959,hunter,beastmastery,27,11,16
18003,Kimbaa,tichondrius,959,hunter,beastmastery,30,10,20
18004,Yolloswag,tichondrius,959,hunter,beastmastery,36,10,26
18005,Motegi,illidan,959,hunter,beastmastery,36,10,26
18006,Bunsglazing,illidan,958,hunter,beastmastery,18,10,8
18007,Smoothbrainz,blackrock,958,hunter,beastmastery,18,10,8
18008,Aquabat,wildhammer,958,hunter,beastmastery,18,10,8
18009,Quickfyre,stormrage,958,hunter,beastmastery,18,10,8
18010,Tazer,area-52,958,hunter,beastmastery,24,10,14
18011,Chunco,ragnaros,958,hunter,beastmastery,24,10,14
18012,Marexx,tichondrius,958,hunter,beastmastery,24,10,14
18013,Khattab,tichondrius,958,hunter,beastmastery,24,10,14
18014,Pafäcïle,tichondrius,958,hunter,beastmastery,24,10,14
18015,Behavior,nemesis,957,hunter,beastmastery,18,10,8
18016,Wabí,tichondrius,957,hunter,beastmastery,18,10,8
18017,Xua,frostmourne,957,hunter,beastmastery,18,10,8
18018,Imthaböss,nazjatar,957,hunter,beastmastery,23,10,13
18019,Xuv,illidan,957,hunter,beastmastery,24,10,14
18020,Sumom,darrowmere,957,hunter,beastmastery,44,18,26
18021,Littledougie,boulderfist,957,hunter,beastmastery,30,10,20
18022,Kaiholeo,tichondrius,957,hunter,beastmastery,30,10,20
18023,Bowjobe,tichondrius,955,hunter,beastmastery,24,10,14
18024,Hyena,kelthuzad,955,hunter,beastmastery,24,10,14
18025,Chimpx,moon-guard,955,hunter,beastmastery,24,10,14
18026,Hartman,frostwolf,954,hunter,beastmastery,18,10,8
18027,Trim,tichondrius,954,hunter,beastmastery,18,10,8
18028,Murdaugh,icecrown,954,hunter,beastmastery,18,10,8
18029,Coppersnout,wyrmrest-accord,954,hunter,beastmastery,24,10,14
18030,Rezkiin,tichondrius,953,hunter,beastmastery,18,10,8
18031,Jendell,area-52,952,hunter,beastmastery,18,10,8
18032,Huntertimes,ragnaros,951,hunter,beastmastery,12,10,2
18033,Steelaeon,moon-guard,951,hunter,beastmastery,24,10,14
18034,Easypoacher,tichondrius,948,hunter,beastmastery,18,10,8
18035,Flacidhunter,kelthuzad,948,hunter,beastmastery,24,10,14
18036,ßaeløn,malganis,947,hunter,beastmastery,15,11,4
18037,Bittitan,frostmourne,947,hunter,beastmastery,18,10,8
18038,Leaii,thrall,944,hunter,beastmastery,43,24,19
18039,Oddangel,azuremyst,944,hunter,beastmastery,24,10,14
18040,Erovianoria,silver-hand,943,hunter,beastmastery,63,31,32
18041,Jagër,dalaran,940,hunter,beastmastery,15,11,4
18042,Noitrag,azralon,937,hunter,beastmastery,17,10,7
18043,Malthiz,antonidas,934,hunter,beastmastery,38,17,21
18044,Salurian,destromath,930,hunter,beastmastery,40,15,25
18045,Shootyurshot,stormrage,927,hunter,beastmastery,20,11,9
18046,Finol,azralon,926,hunter,beastmastery,14,11,3
18047,Hunbatz,dalaran,923,hunter,beastmastery,31,16,15
18048,Ashantii,hakkar,919,hunter,beastmastery,24,10,14
18049,Maveraxx,executus,916,hunter,beastmastery,42,15,27
18050,Çhexmix,kiljaeden,910,hunter,beastmastery,15,10,5
18051,Rachetbutt,tichondrius,910,hunter,beastmastery,17,10,7
18052,Actehón,ragnaros,909,hunter,beastmastery,36,18,18
18053,Beolwolf,darkspear,907,hunter,beastmastery,17,10,7
18054,Coyner,tichondrius,907,hunter,beastmastery,21,10,11
18055,Capnjack,hyjal,906,hunter,beastmastery,33,10,23
18056,Wael,perenolde,905,hunter,beastmastery,17,10,7
18057,Glizzys,cairne,904,hunter,beastmastery,29,12,17
18058,Cernos,malganis,902,hunter,beastmastery,23,10,13
18059,Twatshót,burning-legion,898,hunter,beastmastery,28,13,15
18060,Ketulirantle,azralon,891,hunter,beastmastery,46,13,33
18061,Boww,sargeras,890,hunter,beastmastery,20,10,10
18062,Foh,kelthuzad,888,hunter,beastmastery,17,10,7
18063,Killmachine,sargeras,886,hunter,beastmastery,22,10,12
18064,Rotokrim,emerald-dream,882,hunter,beastmastery,184,87,97
18065,Petattack,barthilas,864,hunter,beastmastery,12,9,3
18066,Slipox,sargeras,864,hunter,beastmastery,12,9,3
18067,Bmhuntlol,illidan,864,hunter,beastmastery,12,9,3
18068,Lilperc,zuljin,864,hunter,beastmastery,12,9,3
18069,Lubze,bleeding-hollow,864,hunter,beastmastery,12,9,3
18070,Elaisse,uther,864,hunter,beastmastery,12,9,3
18071,Phetch,bleeding-hollow,864,hunter,beastmastery,12,9,3
18072,Huntations,sargeras,864,hunter,beastmastery,12,9,3
18073,Bmobepip,malganis,864,hunter,beastmastery,12,9,3
18074,Naestrá,bleeding-hollow,864,hunter,beastmastery,12,9,3
18075,Fereni,emerald-dream,864,hunter,beastmastery,16,10,6
18076,Clütch,darkspear,864,hunter,beastmastery,18,9,9
18077,Actioh,stormrage,864,hunter,beastmastery,18,9,9
18078,Elenin,tichondrius,864,hunter,beastmastery,18,9,9
18079,Lilsynchfyb,sargeras,864,hunter,beastmastery,18,9,9
18080,Chouklak,zuljin,864,hunter,beastmastery,18,9,9
18081,Liennä,stormrage,864,hunter,beastmastery,18,9,9
18082,Yatyegatchun,illidan,864,hunter,beastmastery,18,9,9
18083,Hagadinn,frostmourne,864,hunter,beastmastery,18,9,9
18084,Airlol,tichondrius,864,hunter,beastmastery,18,9,9
18085,Zizilio,kelthuzad,864,hunter,beastmastery,18,9,9
18086,Xbloody,tichondrius,864,hunter,beastmastery,18,9,9
18087,Alenkras,stormrage,864,hunter,beastmastery,18,9,9
18088,Déwi,tichondrius,864,hunter,beastmastery,18,9,9
18089,Deutêr,quelthalas,864,hunter,beastmastery,18,9,9
18090,Arteene,illidan,864,hunter,beastmastery,24,9,15
18091,Dirtyytroll,area-52,864,hunter,beastmastery,24,9,15
18092,Balrröt,malganis,864,hunter,beastmastery,24,9,15
18093,Scurvypete,perenolde,864,hunter,beastmastery,24,9,15
18094,Kaitoo,tichondrius,864,hunter,beastmastery,24,9,15
18095,Katiepie,frostmourne,864,hunter,beastmastery,30,9,21
18096,Saynice,warsong,863,hunter,beastmastery,12,9,3
18097,Noisetrader,illidan,863,hunter,beastmastery,12,9,3
18098,Twoshotzz,darkspear,863,hunter,beastmastery,15,10,5
18099,Reic,kiljaeden,863,hunter,beastmastery,15,10,5
18100,Berkhof,tichondrius,863,hunter,beastmastery,18,9,9
18101,Slap,shattered-hand,863,hunter,beastmastery,18,9,9
18102,Nikronos,quelthalas,863,hunter,beastmastery,18,9,9
18103,Luçkyan,tichondrius,863,hunter,beastmastery,18,9,9
18104,Drezzial,illidan,863,hunter,beastmastery,18,9,9
18105,Brorc,kul-tiras,863,hunter,beastmastery,18,9,9
18106,Jockitch,wildhammer,863,hunter,beastmastery,18,9,9
18107,Beabalm,dalaran,863,hunter,beastmastery,18,9,9
18108,Snowjin,stormrage,863,hunter,beastmastery,18,9,9
18109,Dbrickashaw,proudmoore,863,hunter,beastmastery,18,9,9
18110,Jamzlol,frostmourne,863,hunter,beastmastery,18,9,9
18111,Burguir,ragnaros,863,hunter,beastmastery,18,9,9
18112,Ellzuk,tichondrius,863,hunter,beastmastery,18,9,9
18113,Xernen,thrall,863,hunter,beastmastery,18,9,9
18114,Drivebyjuju,dentarg,863,hunter,beastmastery,18,9,9
18115,Aredbull,jubeithos,863,hunter,beastmastery,18,9,9
18116,Wellerman,firetree,863,hunter,beastmastery,18,9,9
18117,Hendó,korgath,863,hunter,beastmastery,18,9,9
18118,Viral,grizzly-hills,863,hunter,beastmastery,18,9,9
18119,Tethro,zuljin,863,hunter,beastmastery,18,9,9
18120,Tarah,lightbringer,863,hunter,beastmastery,24,9,15
18121,Junglepaw,moon-guard,863,hunter,beastmastery,24,9,15
18122,Nubberton,sargeras,863,hunter,beastmastery,24,9,15
18123,Bleedwish,tichondrius,863,hunter,beastmastery,31,9,22
18124,Seáhawk,kiljaeden,862,hunter,beastmastery,12,9,3
18125,Loriandel,proudmoore,862,hunter,beastmastery,14,9,5
18126,Qúin,frostmourne,862,hunter,beastmastery,18,9,9
18127,Strongene,aegwynn,862,hunter,beastmastery,18,9,9
18128,Toross,stormscale,862,hunter,beastmastery,18,9,9
18129,Hawkeye,boulderfist,862,hunter,beastmastery,24,9,15
18130,Korasaurus,tichondrius,861,hunter,beastmastery,12,9,3
18131,Arrowbadoors,azralon,861,hunter,beastmastery,18,9,9
18132,Trápngap,barthilas,861,hunter,beastmastery,24,9,15
18133,Ogbrooks,tichondrius,861,hunter,beastmastery,24,9,15
18134,Alikay,ragnaros,861,hunter,beastmastery,24,9,15
18135,Hrodvitnir,quelthalas,861,hunter,beastmastery,24,9,15
18136,Jahir,tichondrius,860,hunter,beastmastery,18,9,9
18137,Blockeyhunt,tichondrius,860,hunter,beastmastery,18,9,9
18138,Shdwhntrclub,wyrmrest-accord,860,hunter,beastmastery,24,9,15
18139,Byrdh,zuljin,860,hunter,beastmastery,27,10,17
18140,Goinghuntin,frostmourne,859,hunter,beastmastery,18,9,9
18141,Trionias,malfurion,859,hunter,beastmastery,30,9,21
18142,Xeriife,stormrage,858,hunter,beastmastery,19,9,10
18143,Soulshots,malganis,858,hunter,beastmastery,30,9,21
18144,Chuphunts,tichondrius,857,hunter,beastmastery,12,9,3
18145,Nikå,ragnaros,857,hunter,beastmastery,24,9,15
18146,Vexxør,bleeding-hollow,856,hunter,beastmastery,18,9,9
18147,Kalekros,tichondrius,856,hunter,beastmastery,30,9,21
18148,Galerius,illidan,855,hunter,beastmastery,36,9,27
18149,Sagittarion,malfurion,854,hunter,beastmastery,19,10,9
18150,Shiztec,malganis,854,hunter,beastmastery,24,9,15
18151,Lanadari,trollbane,853,hunter,beastmastery,12,9,3
18152,ßloodmain,tichondrius,852,hunter,beastmastery,24,9,15
18153,Hunterdps,gurubashi,851,hunter,beastmastery,18,9,9
18154,Zhanzu,quelthalas,851,hunter,beastmastery,24,9,15
18155,Survival,dentarg,851,hunter,beastmastery,24,9,15
18156,Euamomilfs,azralon,850,hunter,beastmastery,18,9,9
18157,Nalsa,tichondrius,847,hunter,beastmastery,17,9,8
18158,Johnwïck,moon-guard,847,hunter,beastmastery,30,9,21
18159,Doombug,lethon,846,hunter,beastmastery,18,9,9
18160,Dakirell,drakkari,846,hunter,beastmastery,24,9,15
18161,Eggsquatch,emerald-dream,844,hunter,beastmastery,12,9,3
18162,Dikkins,windrunner,844,hunter,beastmastery,17,9,8
18163,Skullgrain,eitrigg,844,hunter,beastmastery,23,9,14
18164,Alby,daggerspine,843,hunter,beastmastery,23,9,14
18165,Anya,proudmoore,839,hunter,beastmastery,47,20,27
18166,Larthas,greymane,835,hunter,beastmastery,18,9,9
18167,Seenobody,stormrage,834,hunter,beastmastery,41,9,32
18168,Noahxkhalel,azralon,832,hunter,beastmastery,29,9,20
18169,Hikkupz,tichondrius,831,hunter,beastmastery,23,9,14
18170,Flamenco,arthas,830,hunter,beastmastery,17,9,8
18171,Spunky,zuluhed,830,hunter,beastmastery,17,9,8
18172,Moash,spinebreaker,830,hunter,beastmastery,17,9,8
18173,Vastiks,dalaran,829,hunter,beastmastery,26,9,17
18174,Tupirani,azralon,828,hunter,beastmastery,16,9,7
18175,Acotas,blades-edge,828,hunter,beastmastery,36,16,20
18176,Coletrickle,chogall,822,hunter,beastmastery,32,10,22
18177,Falsifier,ragnaros,815,hunter,beastmastery,21,9,12
18178,Rawspits,kiljaeden,814,hunter,beastmastery,29,9,20
18179,Fhodhaz,nemesis,813,hunter,beastmastery,17,9,8
18180,Vyalaris,emerald-dream,813,hunter,beastmastery,21,9,12
18181,Drimhuzzah,velen,809,hunter,beastmastery,17,9,8
18182,Bagurgur,tichondrius,799,hunter,beastmastery,16,9,7
18183,Jonyvi,stormrage,798,hunter,beastmastery,19,10,9
18184,Owoonisan,illidan,794,hunter,beastmastery,22,9,13
18185,Chippendales,illidan,768,hunter,beastmastery,12,8,4
18186,Ogstrutt,zuljin,768,hunter,beastmastery,12,8,4
18187,Petizoql,ragnaros,768,hunter,beastmastery,12,8,4
18188,Newcomb,sargeras,768,hunter,beastmastery,12,8,4
18189,Kite,dathremar,768,hunter,beastmastery,12,8,4
18190,Jsrhuntz,sargeras,768,hunter,beastmastery,12,8,4
18191,Kolotak,kelthuzad,768,hunter,beastmastery,12,8,4
18192,Paraxh,tichondrius,768,hunter,beastmastery,12,8,4
18193,Huntsey,frostmourne,768,hunter,beastmastery,12,8,4
18194,Flub,shadow-council,768,hunter,beastmastery,12,8,4
18195,Bowzørx,tichondrius,768,hunter,beastmastery,12,8,4
18196,Priapismxh,stormrage,768,hunter,beastmastery,12,8,4
18197,Valtierd,illidan,768,hunter,beastmastery,12,8,4
18198,Mavrik,sargeras,768,hunter,beastmastery,12,8,4
18199,Meshunt,tichondrius,768,hunter,beastmastery,12,8,4
18200,Deinaito,bleeding-hollow,768,hunter,beastmastery,12,8,4
18201,Zute,sargeras,768,hunter,beastmastery,12,8,4
18202,Disper,hyjal,768,hunter,beastmastery,12,8,4
18203,Jboogie,malganis,768,hunter,beastmastery,18,8,10
18204,Seongnam,tichondrius,768,hunter,beastmastery,18,8,10
18205,Rethum,tichondrius,768,hunter,beastmastery,18,8,10
18206,Wolfzburg,moon-guard,768,hunter,beastmastery,18,8,10
18207,Seeq,illidan,768,hunter,beastmastery,18,8,10
18208,Heädshöt,malorne,768,hunter,beastmastery,18,8,10
18209,Gotrap,saurfang,768,hunter,beastmastery,18,8,10
18210,Mastasnipa,illidan,768,hunter,beastmastery,18,8,10
18211,Oblitus,zuljin,768,hunter,beastmastery,18,8,10
18212,Teammatescba,tichondrius,768,hunter,beastmastery,18,8,10
18213,Oblio,silvermoon,768,hunter,beastmastery,18,8,10
18214,Tigglyjits,tichondrius,768,hunter,beastmastery,18,8,10
18215,Barosan,illidan,768,hunter,beastmastery,18,8,10
18216,Yonzo,area-52,768,hunter,beastmastery,18,8,10
18217,Katherìnelol,tichondrius,768,hunter,beastmastery,21,9,12
18218,Misakilr,illidan,768,hunter,beastmastery,19,8,11
18219,Peregrin,burning-legion,768,hunter,beastmastery,24,8,16
18220,Kolosaltraps,tichondrius,768,hunter,beastmastery,24,8,16
18221,Aamoody,bloodhoof,768,hunter,beastmastery,24,8,16
18222,Remièl,frostmourne,767,hunter,beastmastery,12,8,4
18223,Keldrek,wyrmrest-accord,767,hunter,beastmastery,12,8,4
18224,Hackerman,tichondrius,767,hunter,beastmastery,12,8,4
18225,Torva,firetree,767,hunter,beastmastery,12,8,4
18226,Probo,aegwynn,767,hunter,beastmastery,12,8,4
18227,Cxnt,saurfang,767,hunter,beastmastery,15,9,6
18228,Eatmybow,nemesis,767,hunter,beastmastery,16,9,7
18229,Nimbioth,proudmoore,767,hunter,beastmastery,18,8,10
18230,Jímmycorn,sargeras,767,hunter,beastmastery,18,8,10
18231,Iamreek,sargeras,767,hunter,beastmastery,18,8,10
18232,Gerathorn,sargeras,767,hunter,beastmastery,18,8,10
18233,Picapaul,stormrage,767,hunter,beastmastery,18,8,10
18234,Vindication,ysera,767,hunter,beastmastery,18,8,10
18235,Raphgun,stormrage,767,hunter,beastmastery,18,8,10
18236,Bowjingles,blackrock,767,hunter,beastmastery,18,8,10
18237,Thehunturd,dalaran,767,hunter,beastmastery,18,8,10
18238,Flîp,daggerspine,767,hunter,beastmastery,18,8,10
18239,Covfefeqt,illidan,767,hunter,beastmastery,18,8,10
18240,Zephanno,sargeras,767,hunter,beastmastery,18,8,10
18241,Brickgrimes,illidan,767,hunter,beastmastery,19,8,11
18242,Lûrtz,aegwynn,767,hunter,beastmastery,21,8,13
18243,Snipingmilfs,zuluhed,766,hunter,beastmastery,12,8,4
18244,Hideontrap,malganis,766,hunter,beastmastery,18,8,10
18245,Katsumito,sargeras,766,hunter,beastmastery,18,8,10
18246,Atheranni,azralon,766,hunter,beastmastery,18,8,10
18247,Föcker,emerald-dream,766,hunter,beastmastery,18,8,10
18248,Jaboe,thrall,766,hunter,beastmastery,18,8,10
18249,Ghostone,sargeras,766,hunter,beastmastery,18,8,10
18250,Thirtyeight,blades-edge,766,hunter,beastmastery,18,8,10
18251,Tirocertobr,azralon,766,hunter,beastmastery,18,8,10
18252,Satours,quelthalas,766,hunter,beastmastery,18,8,10
18253,Thugio,sargeras,766,hunter,beastmastery,24,8,16
18254,Ivix,sargeras,765,hunter,beastmastery,12,8,4
18255,Calbone,stormrage,765,hunter,beastmastery,12,8,4
18256,Queldana,drakkari,765,hunter,beastmastery,18,8,10
18257,Hunt,akama,765,hunter,beastmastery,24,8,16
18258,Franzosisch,stormrage,764,hunter,beastmastery,12,8,4
18259,Grøøves,dalaran,763,hunter,beastmastery,18,8,10
18260,Skarioth,azralon,763,hunter,beastmastery,18,8,10
18261,Speshylponi,smolderthorn,763,hunter,beastmastery,18,8,10
18262,Dodirty,laughing-skull,763,hunter,beastmastery,24,8,16
18263,Liightnight,illidan,762,hunter,beastmastery,12,8,4
18264,Tookoid,sargeras,762,hunter,beastmastery,12,8,4
18265,Jayker,illidan,762,hunter,beastmastery,12,8,4
18266,Halberick,quelthalas,762,hunter,beastmastery,12,8,4
18267,Shamtus,bladefist,762,hunter,beastmastery,12,8,4
18268,Kluetus,sargeras,762,hunter,beastmastery,18,8,10
18269,Stillkrow,sargeras,762,hunter,beastmastery,18,8,10
18270,Élmérfudd,tichondrius,762,hunter,beastmastery,24,8,16
18271,Lhax,stormrage,762,hunter,beastmastery,30,8,22
18272,Riccolonamek,veknilash,761,hunter,beastmastery,12,8,4
18273,Galadrieel,magtheridon,761,hunter,beastmastery,28,9,19
18274,Derringer,the-scryers,760,hunter,beastmastery,18,8,10
18275,Bakharnabi,azralon,760,hunter,beastmastery,18,8,10
18276,Àléç,mannoroth,760,hunter,beastmastery,18,8,10
18277,Ophiela,shuhalo,759,hunter,beastmastery,36,8,28
18278,Eeremm,drakkari,758,hunter,beastmastery,12,8,4
18279,Drpenatrator,barthilas,755,hunter,beastmastery,18,8,10
18280,Bblsallday,illidan,754,hunter,beastmastery,12,8,4
18281,Androki,stormrage,752,hunter,beastmastery,12,8,4
18282,Krispyflayz,sargeras,751,hunter,beastmastery,17,8,9
18283,Raevenah,dalaran,747,hunter,beastmastery,12,8,4
18284,Luxyminx,moon-guard,747,hunter,beastmastery,23,8,15
18285,Stimpblimp,jubeithos,736,hunter,beastmastery,16,8,8
18286,Relaxnerd,antonidas,735,hunter,beastmastery,17,8,9
18287,Cabel,ragnaros,735,hunter,beastmastery,17,8,9
18288,Tekkys,barthilas,734,hunter,beastmastery,17,8,9
18289,Hawkkeye,thunderlord,734,hunter,beastmastery,23,8,15
18290,Vendortrash,aggramar,733,hunter,beastmastery,17,8,9
18291,Wkg,azgalor,728,hunter,beastmastery,41,19,22
18292,Kathelvia,area-52,727,hunter,beastmastery,26,9,17
18293,Eksd,sargeras,719,hunter,beastmastery,11,8,3
18294,Timberex,drenden,715,hunter,beastmastery,15,8,7
18295,Kysii,burning-blade,714,hunter,beastmastery,21,8,13
18296,Cloxygen,moon-guard,713,hunter,beastmastery,22,9,13
18297,Popster,cenarius,704,hunter,beastmastery,16,8,8
18298,Petpenguin,kelthuzad,703,hunter,beastmastery,11,8,3
18299,Yozomoto,nordrassil,703,hunter,beastmastery,14,8,6
18300,Oppshot,kul-tiras,703,hunter,beastmastery,19,8,11
18301,Jinchuriki,shadow-council,703,hunter,beastmastery,28,8,20
18302,Qua,perenolde,702,hunter,beastmastery,17,8,9
18303,Ijii,tichondrius,700,hunter,beastmastery,20,8,12
18304,Mexishots,tichondrius,688,hunter,beastmastery,13,8,5
18305,Hollowhunt,sentinels,672,hunter,beastmastery,12,7,5
18306,Mehontar,area-52,672,hunter,beastmastery,12,7,5
18307,Jxbupx,tichondrius,672,hunter,beastmastery,12,7,5
18308,Downor,malganis,672,hunter,beastmastery,12,7,5
18309,Drwíggles,smolderthorn,672,hunter,beastmastery,12,7,5
18310,Jsr,tichondrius,672,hunter,beastmastery,12,7,5
18311,Crimsoncoast,tichondrius,672,hunter,beastmastery,12,7,5
18312,Alfentanil,thrall,672,hunter,beastmastery,12,7,5
18313,Barainto,tichondrius,672,hunter,beastmastery,12,7,5
18314,Hunatar,stormrage,672,hunter,beastmastery,12,7,5
18315,Skippyh,zuluhed,672,hunter,beastmastery,12,7,5
18316,Sakedji,area-52,672,hunter,beastmastery,12,7,5
18317,Tusxx,tichondrius,672,hunter,beastmastery,12,7,5
18318,Handmemygun,aggramar,672,hunter,beastmastery,12,7,5
18319,Buzzkilla,mannoroth,672,hunter,beastmastery,12,7,5
18320,Sensator,barthilas,672,hunter,beastmastery,12,7,5
18321,Küky,ragnaros,672,hunter,beastmastery,12,7,5
18322,Artames,tichondrius,672,hunter,beastmastery,12,7,5
18323,Buffhunt,tichondrius,672,hunter,beastmastery,12,7,5
18324,Ajukeo,tichondrius,672,hunter,beastmastery,12,7,5
18325,Interer,proudmoore,672,hunter,beastmastery,12,7,5
18326,Kuzar,thrall,672,hunter,beastmastery,12,7,5
18327,Cinnybunz,malganis,672,hunter,beastmastery,12,7,5
18328,Mylaqt,malganis,672,hunter,beastmastery,12,7,5
18329,Pmø,sargeras,672,hunter,beastmastery,12,7,5
18330,Grannygatya,tichondrius,672,hunter,beastmastery,12,7,5
18331,Kaikunoshiri,tichondrius,672,hunter,beastmastery,12,7,5
18332,Gun,shadowsong,672,hunter,beastmastery,12,7,5
18333,Yolotraps,thrall,672,hunter,beastmastery,12,7,5
18334,Buliss,wyrmrest-accord,672,hunter,beastmastery,12,7,5
18335,Dadedehuyeah,illidan,672,hunter,beastmastery,12,7,5
18336,Litchi,illidan,672,hunter,beastmastery,12,7,5
18337,Xerosa,emerald-dream,672,hunter,beastmastery,12,7,5
18338,Mauiies,sargeras,672,hunter,beastmastery,12,7,5
18339,Akirarika,wyrmrest-accord,672,hunter,beastmastery,12,7,5
18340,Gentledream,dalaran,672,hunter,beastmastery,12,7,5
18341,Cumman,sargeras,672,hunter,beastmastery,12,7,5
18342,Shaytime,proudmoore,672,hunter,beastmastery,16,8,8
18343,Szeh,tichondrius,672,hunter,beastmastery,14,7,7
18344,Greenmamba,thrall,672,hunter,beastmastery,18,7,11
18345,Antares,dalaran,672,hunter,beastmastery,18,7,11
18346,Ðevil,ragnaros,672,hunter,beastmastery,18,7,11
18347,Joerogan,hydraxis,672,hunter,beastmastery,18,7,11
18348,Nashi,burning-blade,672,hunter,beastmastery,18,7,11
18349,Sensitivthug,sargeras,672,hunter,beastmastery,18,7,11
18350,Dreagneal,ragnaros,672,hunter,beastmastery,18,7,11
18351,Msghunter,sargeras,672,hunter,beastmastery,18,7,11
18352,Moralidawn,illidan,672,hunter,beastmastery,18,7,11
18353,Mostmanly,tichondrius,672,hunter,beastmastery,18,7,11
18354,Aethernovae,area-52,672,hunter,beastmastery,18,7,11
18355,Deuzebuk,azralon,672,hunter,beastmastery,18,7,11
18356,Hyperíon,draenor,672,hunter,beastmastery,18,7,11
18357,Velaknahtou,illidan,672,hunter,beastmastery,18,7,11
18358,Clowntown,illidan,672,hunter,beastmastery,18,7,11
18359,Sèasons,tichondrius,672,hunter,beastmastery,21,7,14
18360,Trycaza,ragnaros,672,hunter,beastmastery,24,7,17
18361,Sunsinfour,proudmoore,672,hunter,beastmastery,24,7,17
18362,Titanaxis,tichondrius,672,hunter,beastmastery,24,7,17
18363,Desoh,kelthuzad,672,hunter,beastmastery,24,7,17
18364,Kango,azgalor,672,hunter,beastmastery,30,7,23
18365,Lavo,borean-tundra,671,hunter,beastmastery,12,7,5
18366,Anniefuchsia,stormrage,671,hunter,beastmastery,12,7,5
18367,Exploits,stormrage,671,hunter,beastmastery,12,7,5
18368,Thanthion,spirestone,671,hunter,beastmastery,12,7,5
18369,Winzip,whisperwind,671,hunter,beastmastery,12,7,5
18370,Mannypew,kelthuzad,671,hunter,beastmastery,12,7,5
18371,Tremobbin,kelthuzad,671,hunter,beastmastery,12,7,5
18372,Kupupor,area-52,671,hunter,beastmastery,12,7,5
18373,Scruffiebear,deathwing,671,hunter,beastmastery,12,7,5
18374,Scrubmastery,emerald-dream,671,hunter,beastmastery,12,7,5
18375,Spunkked,tichondrius,671,hunter,beastmastery,12,7,5
18376,Ziêg,eonar,671,hunter,beastmastery,12,7,5
18377,Melinda,kilrogg,671,hunter,beastmastery,12,7,5
18378,Terezhunt,tichondrius,671,hunter,beastmastery,12,7,5
18379,Beardedeagle,tichondrius,671,hunter,beastmastery,15,8,7
18380,Heylenny,area-52,671,hunter,beastmastery,18,7,11
18381,Dontkillpet,shandris,671,hunter,beastmastery,18,7,11
18382,Jagare,tichondrius,671,hunter,beastmastery,18,7,11
18383,Nj,kiljaeden,671,hunter,beastmastery,18,7,11
18384,Mooséhunt,wyrmrest-accord,671,hunter,beastmastery,18,7,11
18385,Threethirty,thrall,671,hunter,beastmastery,18,7,11
18386,Amortiz,illidan,671,hunter,beastmastery,18,7,11
18387,Genowin,sargeras,671,hunter,beastmastery,18,7,11
18388,Ratfood,tichondrius,671,hunter,beastmastery,23,7,16
18389,Yanzz,spinebreaker,670,hunter,beastmastery,12,7,5
18390,Topgun,laughing-skull,670,hunter,beastmastery,12,7,5
18391,Madness,zuljin,670,hunter,beastmastery,12,7,5
18392,Enigmer,area-52,670,hunter,beastmastery,12,7,5
18393,Macabre,scilla,670,hunter,beastmastery,18,7,11
18394,Fawn,moon-guard,670,hunter,beastmastery,18,7,11
18395,Spaeth,borean-tundra,670,hunter,beastmastery,24,7,17
18396,Vicarnam,uldum,669,hunter,beastmastery,12,7,5
18397,Neurosurgery,azralon,669,hunter,beastmastery,18,7,11
18398,Rinasonline,sargeras,669,hunter,beastmastery,18,7,11
18399,Fynnigan,shandris,669,hunter,beastmastery,18,7,11
18400,Oneshotman,hydraxis,668,hunter,beastmastery,12,7,5
18401,Oldmanmacd,tichondrius,667,hunter,beastmastery,12,7,5
18402,Bosslord,wyrmrest-accord,667,hunter,beastmastery,12,7,5
18403,Terusa,ragnaros,667,hunter,beastmastery,24,7,17
18404,Arielma,illidan,667,hunter,beastmastery,30,7,23
18405,Badboyzcry,deathwing,666,hunter,beastmastery,12,7,5
18406,Strafenshoot,darkspear,666,hunter,beastmastery,12,7,5
18407,Olelf,chogall,666,hunter,beastmastery,12,7,5
18408,Jashak,windrunner,665,hunter,beastmastery,12,7,5
18409,Rikitiki,bleeding-hollow,663,hunter,beastmastery,18,7,11
18410,Eastera,tichondrius,663,hunter,beastmastery,27,8,19
18411,Isagypsy,ragnaros,662,hunter,beastmastery,18,7,11
18412,Cbramatacera,drakkari,661,hunter,beastmastery,12,7,5
18413,Theprovider,burning-blade,659,hunter,beastmastery,12,7,5
18414,Benryats,area-52,657,hunter,beastmastery,21,8,13
18415,Legendhunter,quelthalas,655,hunter,beastmastery,12,8,4
18416,Lyduc,barthilas,655,hunter,beastmastery,17,7,10
18417,Wuzi,echo-isles,653,hunter,beastmastery,18,7,11
18418,Linszsz,nemesis,648,hunter,beastmastery,23,9,14
18419,Cuddle,arathor,637,hunter,beastmastery,17,7,10
18420,Árescarries,shuhalo,623,hunter,beastmastery,15,7,8
18421,Ashx,nemesis,623,hunter,beastmastery,17,7,10
18422,Xhítt,sargeras,623,hunter,beastmastery,17,7,10
18423,Lelreisw,goldrinn,622,hunter,beastmastery,21,7,14
18424,Ôhunter,sentinels,618,hunter,beastmastery,17,8,9
18425,Snapyaf,area-52,618,hunter,beastmastery,22,8,14
18426,Tribë,emerald-dream,607,hunter,beastmastery,11,7,4
18427,Supdawg,aggramar,607,hunter,beastmastery,17,7,10
18428,Shootdogg,mannoroth,607,hunter,beastmastery,20,7,13
18429,Lulafourdedo,stormrage,606,hunter,beastmastery,9,7,2
18430,Drisilla,stormrage,606,hunter,beastmastery,11,7,4
18431,Shanghunt,cenarius,604,hunter,beastmastery,14,7,7
18432,Oshosiwar,ragnaros,588,hunter,beastmastery,21,7,14
18433,Rekkis,area-52,576,hunter,beastmastery,6,6,0
18434,Igotapvpness,tichondrius,576,hunter,beastmastery,6,6,0
18435,Gassmask,area-52,576,hunter,beastmastery,6,6,0
18436,Jjaro,area-52,576,hunter,beastmastery,6,6,0
18437,Mavmavmavmav,illidan,576,hunter,beastmastery,6,6,0
18438,Píps,maelstrom,576,hunter,beastmastery,6,6,0
18439,Taurask,tichondrius,576,hunter,beastmastery,12,6,6
18440,Wongy,tichondrius,576,hunter,beastmastery,12,6,6
18441,Nampa,stormrage,576,hunter,beastmastery,12,6,6
18442,Ahncheolsoo,tichondrius,576,hunter,beastmastery,12,6,6
18443,Fma,stormrage,576,hunter,beastmastery,12,6,6
18444,Nytefell,skullcrusher,576,hunter,beastmastery,12,6,6
18445,Chriscal,zuljin,576,hunter,beastmastery,12,6,6
18446,Dd,frostmourne,576,hunter,beastmastery,12,6,6
18447,Ziraiel,tichondrius,576,hunter,beastmastery,12,6,6
18448,Cubixer,zuljin,576,hunter,beastmastery,12,6,6
18449,Boybawang,area-52,576,hunter,beastmastery,12,6,6
18450,Gilv,frostmourne,576,hunter,beastmastery,12,6,6
18451,Kyoü,drakkari,576,hunter,beastmastery,12,6,6
18452,Shøz,wyrmrest-accord,576,hunter,beastmastery,12,6,6
18453,Alochol,vashj,576,hunter,beastmastery,12,6,6
18454,Deidada,ragnaros,576,hunter,beastmastery,12,6,6
18455,Hunterpk,lightbringer,576,hunter,beastmastery,12,6,6
18456,Makag,illidan,576,hunter,beastmastery,12,6,6
18457,Teaa,dalaran,576,hunter,beastmastery,12,6,6
18458,Trapgodtina,bleeding-hollow,576,hunter,beastmastery,12,6,6
18459,Jwzz,tichondrius,576,hunter,beastmastery,12,6,6
18460,Schvitz,darkspear,576,hunter,beastmastery,12,6,6
18461,Thugbus,frostmourne,576,hunter,beastmastery,12,6,6
18462,Rockoutt,emerald-dream,576,hunter,beastmastery,12,6,6
18463,Darksniper,proudmoore,576,hunter,beastmastery,12,6,6
18464,Peacemaker,dunemaul,576,hunter,beastmastery,12,6,6
18465,Raadun,terokkar,576,hunter,beastmastery,12,6,6
18466,Retaâáàäãart,tichondrius,576,hunter,beastmastery,12,6,6
18467,Zookeepah,tichondrius,576,hunter,beastmastery,12,6,6
18468,Hurato,stormrage,576,hunter,beastmastery,12,6,6
18469,Spottedoger,burning-legion,576,hunter,beastmastery,12,6,6
18470,Supernamh,sargeras,576,hunter,beastmastery,12,6,6
18471,Evilblammo,thorium-brotherhood,576,hunter,beastmastery,12,6,6
18472,Daylilycoast,emerald-dream,576,hunter,beastmastery,12,6,6
18473,Jonah,sargeras,576,hunter,beastmastery,12,6,6
18474,Zertkal,undermine,576,hunter,beastmastery,12,6,6
18475,Skyfel,aggramar,576,hunter,beastmastery,12,6,6
18476,Noblesaïnt,tichondrius,576,hunter,beastmastery,12,6,6
18477,Raerdun,bonechewer,576,hunter,beastmastery,12,6,6
18478,Itch,moon-guard,576,hunter,beastmastery,12,6,6
18479,Harmfulwang,emerald-dream,576,hunter,beastmastery,12,6,6
18480,Balboa,tortheldrin,576,hunter,beastmastery,12,6,6
18481,Invisabootz,hyjal,576,hunter,beastmastery,12,6,6
18482,Mcfibers,malganis,576,hunter,beastmastery,12,6,6
18483,Séptimo,illidan,576,hunter,beastmastery,12,6,6
18484,Jalinhabbei,azralon,576,hunter,beastmastery,12,6,6
18485,Kånade,ragnaros,576,hunter,beastmastery,12,6,6
18486,Leadblaster,gorefiend,576,hunter,beastmastery,12,6,6
18487,Orqism,tichondrius,576,hunter,beastmastery,12,6,6
18488,Khanittus,area-52,576,hunter,beastmastery,12,6,6
18489,Gravshot,zuljin,576,hunter,beastmastery,12,6,6
18490,Drdill,gorefiend,576,hunter,beastmastery,12,6,6
18491,Wopper,moon-guard,576,hunter,beastmastery,12,6,6
18492,Himmihyme,illidan,576,hunter,beastmastery,12,6,6
18493,Toniic,moon-guard,576,hunter,beastmastery,12,6,6
18494,Sumpunter,barthilas,576,hunter,beastmastery,12,6,6
18495,Aduurant,quelthalas,576,hunter,beastmastery,12,6,6
18496,Oidhunter,barthilas,576,hunter,beastmastery,12,6,6
18497,Wapnonymous,mugthol,576,hunter,beastmastery,12,6,6
18498,Zigum,dalaran,576,hunter,beastmastery,12,6,6
18499,Arrebol,tichondrius,576,hunter,beastmastery,12,6,6
18500,Zeedii,dalaran,576,hunter,beastmastery,12,6,6
18501,Rhovanni,ragnaros,576,hunter,beastmastery,15,7,8
18502,Arraza,ragnaros,576,hunter,beastmastery,16,7,9
18503,Mørødox,sargeras,576,hunter,beastmastery,18,6,12
18504,Thorssman,illidan,576,hunter,beastmastery,18,6,12
18505,Larrydog,fizzcrank,576,hunter,beastmastery,18,6,12
18506,Ljai,gilneas,576,hunter,beastmastery,18,6,12
18507,Virgim,kelthuzad,576,hunter,beastmastery,18,6,12
18508,Kanta,bleeding-hollow,576,hunter,beastmastery,18,6,12
18509,Pieman,azuremyst,576,hunter,beastmastery,18,6,12
18510,Møoo,ragnaros,576,hunter,beastmastery,18,6,12
18511,Ærês,ysondre,576,hunter,beastmastery,20,6,14
18512,Beastbaal,sargeras,576,hunter,beastmastery,24,6,18
18513,Sniffler,barthilas,576,hunter,beastmastery,24,6,18
18514,Wdb,tichondrius,575,hunter,beastmastery,12,6,6
18515,Recoyl,proudmoore,575,hunter,beastmastery,12,6,6
18516,Gwarnar,stormrage,575,hunter,beastmastery,12,6,6
18517,Chinoiti,bleeding-hollow,575,hunter,beastmastery,12,6,6
18518,Fireshots,tichondrius,575,hunter,beastmastery,12,6,6
18519,Mindbreaker,illidan,575,hunter,beastmastery,12,6,6
18520,Ventura,emerald-dream,575,hunter,beastmastery,12,6,6
18521,Eastwake,stormrage,575,hunter,beastmastery,12,6,6
18522,Hollee,turalyon,575,hunter,beastmastery,12,6,6
18523,Aoife,zuljin,575,hunter,beastmastery,12,6,6
18524,Asuryakha,darkspear,575,hunter,beastmastery,12,6,6
18525,Brenoob,azralon,575,hunter,beastmastery,12,6,6
18526,Míbu,lightbringer,575,hunter,beastmastery,12,6,6
18527,Ontop,draka,575,hunter,beastmastery,12,6,6
18528,Rankhor,darkspear,575,hunter,beastmastery,12,6,6
18529,Longshott,azralon,575,hunter,beastmastery,12,6,6
18530,Ovî,area-52,575,hunter,beastmastery,12,6,6
18531,Yobby,area-52,575,hunter,beastmastery,12,6,6
18532,Horsegirl,chogall,575,hunter,beastmastery,12,6,6
18533,Orangegummy,frostmourne,575,hunter,beastmastery,15,7,8
18534,Boradin,lightbringer,575,hunter,beastmastery,18,6,12
18535,Aliciaomg,andorhal,575,hunter,beastmastery,18,6,12
18536,Camorcaist,stormrage,575,hunter,beastmastery,18,6,12
18537,Logandawgfan,thunderlord,575,hunter,beastmastery,18,6,12
18538,Tozier,destromath,575,hunter,beastmastery,18,6,12
18539,Bagofsnit,frostmourne,575,hunter,beastmastery,18,6,12
18540,Fiddich,shattered-hand,574,hunter,beastmastery,12,6,6
18541,Nekrongar,agamaggan,574,hunter,beastmastery,12,6,6
18542,Arcticuz,aegwynn,574,hunter,beastmastery,12,6,6
18543,Kalibah,azralon,574,hunter,beastmastery,18,6,12
18544,Sapphie,frostmourne,574,hunter,beastmastery,24,6,18
18545,Flooring,illidan,573,hunter,beastmastery,12,6,6
18546,Barberreggie,barthilas,573,hunter,beastmastery,30,6,24
18547,Dethh,dunemaul,572,hunter,beastmastery,12,6,6
18548,Pewpewd,tichondrius,572,hunter,beastmastery,12,6,6
18549,Høød,aggramar,571,hunter,beastmastery,12,6,6
18550,Cousinlarry,kaelthas,571,hunter,beastmastery,12,6,6
18551,Katmang,frostmourne,571,hunter,beastmastery,18,6,12
18552,Lanamatt,azralon,569,hunter,beastmastery,12,6,6
18553,Kargathx,ragnaros,569,hunter,beastmastery,20,8,12
18554,Kenhay,wyrmrest-accord,569,hunter,beastmastery,18,6,12
18555,Pureguava,gorefiend,567,hunter,beastmastery,18,6,12
18556,Bluehead,emerald-dream,566,hunter,beastmastery,12,6,6
18557,Parâsite,kelthuzad,559,hunter,beastmastery,23,6,17
18558,Gerpshot,darrowmere,557,hunter,beastmastery,18,7,11
18559,Jîa,tichondrius,544,hunter,beastmastery,16,6,10
18560,Ullria,frostmourne,544,hunter,beastmastery,16,6,10
18561,Triggamikê,tichondrius,543,hunter,beastmastery,8,7,1
18562,Habanero,anetheron,543,hunter,beastmastery,14,7,7
18563,Boopuh,illidan,543,hunter,beastmastery,14,7,7
18564,Tezlekhan,haomarush,543,hunter,beastmastery,17,6,11
18565,Viserysll,azralon,542,hunter,beastmastery,11,6,5
18566,Trycen,bleeding-hollow,527,hunter,beastmastery,11,6,5
18567,Memorypet,proudmoore,527,hunter,beastmastery,15,6,9
18568,Pikepounder,tichondrius,527,hunter,beastmastery,15,6,9
18569,Yatolo,barthilas,526,hunter,beastmastery,15,6,9
18570,Oromme,ragnaros,526,hunter,beastmastery,20,7,13
18571,Porkrager,doomhammer,522,hunter,beastmastery,14,7,7
18572,Iililillilii,tichondrius,522,hunter,beastmastery,20,7,13
18573,Mïsërý,tichondrius,522,hunter,beastmastery,21,7,14
18574,Beastcraft,emerald-dream,521,hunter,beastmastery,21,7,14
18575,Bugsßunny,sargeras,521,hunter,beastmastery,22,7,15
18576,Fiury,hyjal,519,hunter,beastmastery,15,6,9
18577,Ataxyus,area-52,512,hunter,beastmastery,10,6,4
18578,Pigmaster,tichondrius,511,hunter,beastmastery,14,6,8
18579,Bowjobs,stormscale,511,hunter,beastmastery,14,6,8
18580,Aluminumfoil,kelthuzad,510,hunter,beastmastery,11,6,5
18581,Zock,lothar,494,hunter,beastmastery,19,6,13
18582,Nsjp,darkspear,480,hunter,beastmastery,6,5,1
18583,Cyrads,darkspear,480,hunter,beastmastery,6,5,1
18584,Glacierr,emerald-dream,480,hunter,beastmastery,6,5,1
18585,Luys,illidan,480,hunter,beastmastery,6,5,1
18586,Añtø,tichondrius,480,hunter,beastmastery,6,5,1
18587,Devilborne,tichondrius,480,hunter,beastmastery,6,5,1
18588,Sinon,stormrage,480,hunter,beastmastery,6,5,1
18589,Linkolnn,sargeras,480,hunter,beastmastery,6,5,1
18590,Arthäsxd,azralon,480,hunter,beastmastery,6,5,1
18591,Brokensnipez,area-52,480,hunter,beastmastery,6,5,1
18592,Tukki,quelthalas,480,hunter,beastmastery,6,5,1
18593,Bluez,tichondrius,480,hunter,beastmastery,6,5,1
18594,Dankshunt,arthas,480,hunter,beastmastery,6,5,1
18595,Moistbooger,emerald-dream,480,hunter,beastmastery,6,5,1
18596,Yajr,black-dragonflight,480,hunter,beastmastery,6,5,1
18597,Jareeth,bleeding-hollow,480,hunter,beastmastery,6,5,1
18598,Traptrinket,sargeras,480,hunter,beastmastery,6,5,1
18599,Oeoeoeoeoeoe,alterac-mountains,480,hunter,beastmastery,6,5,1
18600,Tèrrabite,sargeras,480,hunter,beastmastery,6,5,1
18601,Kkoduckk,tichondrius,480,hunter,beastmastery,6,5,1
18602,Chimeralol,area-52,480,hunter,beastmastery,6,5,1
18603,Zansnipes,dalaran,480,hunter,beastmastery,6,5,1
18604,Slêv,frostmourne,480,hunter,beastmastery,6,5,1
18605,Nokda,tichondrius,480,hunter,beastmastery,6,5,1
18606,Plsnobanmee,frostmourne,480,hunter,beastmastery,6,5,1
18607,Megahuntard,bleeding-hollow,480,hunter,beastmastery,6,5,1
18608,Arleesta,thrall,480,hunter,beastmastery,6,5,1
18609,Follard,stormrage,480,hunter,beastmastery,6,5,1
18610,Vynloresh,thrall,480,hunter,beastmastery,6,5,1
18611,Cojáx,dalaran,480,hunter,beastmastery,6,5,1
18612,Goodwillhunt,tichondrius,480,hunter,beastmastery,6,5,1
18613,Clawdio,ragnaros,480,hunter,beastmastery,6,5,1
18614,Hukkx,kalecgos,480,hunter,beastmastery,6,5,1
18615,Victorcrumb,tichondrius,480,hunter,beastmastery,6,5,1
18616,Airoh,gorefiend,480,hunter,beastmastery,10,6,4
18617,Pàstor,azralon,480,hunter,beastmastery,12,5,7
18618,Valeous,azjolnerub,480,hunter,beastmastery,12,5,7
18619,Feladorn,silver-hand,480,hunter,beastmastery,12,5,7
18620,Affections,darkspear,480,hunter,beastmastery,12,5,7
18621,Fallacies,moon-guard,480,hunter,beastmastery,12,5,7
18622,Hitcompleted,moon-guard,480,hunter,beastmastery,12,5,7
18623,Skitso,illidan,480,hunter,beastmastery,12,5,7
18624,Loranoh,illidan,480,hunter,beastmastery,12,5,7
18625,Chipsncheese,korgath,480,hunter,beastmastery,12,5,7
18626,Chernovax,altar-of-storms,480,hunter,beastmastery,12,5,7
18627,Mcbacon,illidan,480,hunter,beastmastery,12,5,7
18628,Taphh,moon-guard,480,hunter,beastmastery,12,5,7
18629,Exabyssus,bleeding-hollow,480,hunter,beastmastery,12,5,7
18630,Satàn,thrall,480,hunter,beastmastery,12,5,7
18631,Tureckk,illidan,480,hunter,beastmastery,12,5,7
18632,Smexyhunter,moon-guard,480,hunter,beastmastery,12,5,7
18633,Imperatrix,emerald-dream,480,hunter,beastmastery,12,5,7
18634,Ariais,zangarmarsh,480,hunter,beastmastery,12,5,7
18635,Cowahunt,illidan,480,hunter,beastmastery,12,5,7
18636,Squiik,wildhammer,480,hunter,beastmastery,12,5,7
18637,Mylfhunter,azralon,480,hunter,beastmastery,12,5,7
18638,Toontot,sargeras,480,hunter,beastmastery,12,5,7
18639,Bowzza,area-52,480,hunter,beastmastery,12,5,7
18640,Xavííer,tichondrius,480,hunter,beastmastery,12,5,7
18641,Backa,jubeithos,480,hunter,beastmastery,12,5,7
18642,Grizmin,sargeras,480,hunter,beastmastery,12,5,7
18643,Powerstrokes,sargeras,480,hunter,beastmastery,12,5,7
18644,Sunflwerdawn,emerald-dream,480,hunter,beastmastery,12,5,7
18645,Michaeljfox,area-52,480,hunter,beastmastery,12,5,7
18646,Hellbow,ragnaros,480,hunter,beastmastery,12,5,7
18647,Kansolly,tichondrius,480,hunter,beastmastery,12,5,7
18648,Alssong,tichondrius,480,hunter,beastmastery,12,5,7
18649,Zinelun,quelthalas,480,hunter,beastmastery,12,5,7
18650,Kaloh,daggerspine,480,hunter,beastmastery,12,5,7
18651,Deklin,malganis,480,hunter,beastmastery,12,5,7
18652,Hendlie,frostmourne,480,hunter,beastmastery,12,5,7
18653,Abloodelf,zuljin,480,hunter,beastmastery,12,5,7
18654,Thejw,firetree,480,hunter,beastmastery,12,5,7
18655,Banai,the-underbog,480,hunter,beastmastery,12,5,7
18656,Thoraky,stormrage,480,hunter,beastmastery,12,5,7
18657,Åî,tichondrius,480,hunter,beastmastery,12,5,7
18658,Taskete,ragnaros,480,hunter,beastmastery,12,5,7
18659,Kurmojo,hyjal,480,hunter,beastmastery,12,5,7
18660,Pichsolika,frostmourne,480,hunter,beastmastery,12,5,7
18661,Silveraero,ghostlands,480,hunter,beastmastery,12,5,7
18662,Wønky,stormrage,480,hunter,beastmastery,12,5,7
18663,Twoshotz,stormrage,480,hunter,beastmastery,12,5,7
18664,Ferex,tichondrius,480,hunter,beastmastery,12,5,7
18665,Ghostdâwg,stormrage,480,hunter,beastmastery,12,5,7
18666,Powdersoak,area-52,480,hunter,beastmastery,12,5,7
18667,Sinvat,tichondrius,480,hunter,beastmastery,12,5,7
18668,Drakku,zuljin,480,hunter,beastmastery,12,5,7
18669,Tarkovs,area-52,480,hunter,beastmastery,12,5,7
18670,Gorillafart,spirestone,480,hunter,beastmastery,12,5,7
18671,Køk,agamaggan,480,hunter,beastmastery,12,5,7
18672,Àthenaa,malygos,480,hunter,beastmastery,12,5,7
18673,Gonnujo,ragnaros,480,hunter,beastmastery,12,5,7
18674,Llachiip,zuljin,480,hunter,beastmastery,16,6,10
18675,Bøl,ragnaros,480,hunter,beastmastery,16,5,11
18676,Chetxs,bleeding-hollow,480,hunter,beastmastery,18,5,13
18677,Snoogen,illidan,480,hunter,beastmastery,18,5,13
18678,Mingsomnia,kiljaeden,480,hunter,beastmastery,18,5,13
18679,Semiautmatic,thrall,480,hunter,beastmastery,18,5,13
18680,Blockbusters,sargeras,480,hunter,beastmastery,18,5,13
18681,Amoreiene,stormrage,480,hunter,beastmastery,18,5,13
18682,Cophunter,tichondrius,480,hunter,beastmastery,18,5,13
18683,Panzerfäust,zuljin,480,hunter,beastmastery,18,5,13
18684,Sizzimus,area-52,479,hunter,beastmastery,6,5,1
18685,Riverjumper,ghostlands,479,hunter,beastmastery,6,5,1
18686,Segulah,dalaran,479,hunter,beastmastery,6,5,1
18687,Mafghine,malganis,479,hunter,beastmastery,6,5,1
18688,Apolex,velen,479,hunter,beastmastery,12,5,7
18689,Ashevan,stormrage,479,hunter,beastmastery,12,5,7
18690,Deadlyattack,barthilas,479,hunter,beastmastery,12,5,7
18691,Shoya,nerzhul,479,hunter,beastmastery,12,5,7
18692,Pickshot,boulderfist,479,hunter,beastmastery,12,5,7
18693,Kairoke,azralon,479,hunter,beastmastery,12,5,7
18694,Equipmunk,arthas,479,hunter,beastmastery,12,5,7
18695,Chosan,sargeras,479,hunter,beastmastery,12,5,7
18696,Livershot,zuljin,479,hunter,beastmastery,12,5,7
18697,Dwarfpecker,hydraxis,479,hunter,beastmastery,12,5,7
18698,Mecatrón,quelthalas,479,hunter,beastmastery,12,5,7
18699,Holyhunnter,proudmoore,479,hunter,beastmastery,12,5,7
18700,Simoro,malganis,479,hunter,beastmastery,14,5,9
18701,Trushôtz,tichondrius,479,hunter,beastmastery,17,5,12
18702,Boomup,tichondrius,479,hunter,beastmastery,21,6,15
18703,Morngrimm,area-52,479,hunter,beastmastery,18,5,13
18704,Smider,magtheridon,479,hunter,beastmastery,18,5,13
18705,Auset,aegwynn,479,hunter,beastmastery,18,5,13
18706,Starkmeister,stormrage,479,hunter,beastmastery,18,5,13
18707,Zarrockk,emerald-dream,478,hunter,beastmastery,12,5,7
18708,Waagg,ragnaros,478,hunter,beastmastery,12,5,7
18709,Fiznits,nerzhul,478,hunter,beastmastery,18,5,13
18710,Titchi,azralon,478,hunter,beastmastery,18,5,13
18711,Haltheron,azshara,477,hunter,beastmastery,12,5,7
18712,Slowbear,kiljaeden,477,hunter,beastmastery,12,5,7
18713,Feralhuntard,muradin,477,hunter,beastmastery,12,5,7
18714,Braindeadly,malganis,476,hunter,beastmastery,12,5,7
18715,Syphiel,moon-guard,476,hunter,beastmastery,12,5,7
18716,Gilonate,tichondrius,476,hunter,beastmastery,36,5,31
18717,Ogma,mugthol,475,hunter,beastmastery,12,5,7
18718,Mehtcurious,ragnaros,470,hunter,beastmastery,18,5,13
18719,Redrum,turalyon,448,hunter,beastmastery,10,5,5
18720,Revenantz,stormrage,447,hunter,beastmastery,11,5,6
18721,Degenape,bleeding-hollow,447,hunter,beastmastery,11,5,6
18722,Verzatyle,frostwolf,447,hunter,beastmastery,11,5,6
18723,Travisshot,tichondrius,447,hunter,beastmastery,11,5,6
18724,Gunther,korgath,447,hunter,beastmastery,11,5,6
18725,Vuur,korialstrasz,447,hunter,beastmastery,19,6,13
18726,Rástakhan,ragnaros,431,hunter,beastmastery,11,5,6
18727,Hazzlôk,cairne,426,hunter,beastmastery,20,7,13
18728,Ripmytoast,chogall,424,hunter,beastmastery,16,7,9
18729,Verse,aggramar,415,hunter,beastmastery,12,6,6
18730,Malgar,zuljin,415,hunter,beastmastery,11,5,6
18731,Kaiso,chogall,415,hunter,beastmastery,14,5,9
18732,Missionfiggs,malganis,415,hunter,beastmastery,14,5,9
18733,Resonators,tichondrius,400,hunter,beastmastery,13,5,8
18734,Silvershot,emerald-dream,384,hunter,beastmastery,6,4,2
18735,Skytah,darkspear,384,hunter,beastmastery,6,4,2
18736,Dexh,frostmourne,384,hunter,beastmastery,6,4,2
18737,Deddita,zuljin,384,hunter,beastmastery,6,4,2
18738,Redzic,tichondrius,384,hunter,beastmastery,6,4,2
18739,Damatic,area-52,384,hunter,beastmastery,6,4,2
18740,Fizzpow,blackrock,384,hunter,beastmastery,6,4,2
18741,Sindshai,onyxia,384,hunter,beastmastery,6,4,2
18742,Celdiirn,dragonmaw,384,hunter,beastmastery,6,4,2
18743,Zubo,tichondrius,384,hunter,beastmastery,6,4,2
18744,Jerso,zuljin,384,hunter,beastmastery,6,4,2
18745,Malcab,tichondrius,384,hunter,beastmastery,6,4,2
18746,Jerusa,illidan,384,hunter,beastmastery,6,4,2
18747,Deshiie,proudmoore,384,hunter,beastmastery,6,4,2
18748,Anisphia,tichondrius,384,hunter,beastmastery,6,4,2
18749,Chichi,korgath,384,hunter,beastmastery,6,4,2
18750,Yosra,frostmourne,384,hunter,beastmastery,6,4,2
18751,Bênton,tichondrius,384,hunter,beastmastery,6,4,2
18752,Ragerab,trollbane,384,hunter,beastmastery,6,4,2
18753,Skað,lightbringer,384,hunter,beastmastery,6,4,2
18754,Eazyaimz,thrall,384,hunter,beastmastery,6,4,2
18755,Putos,zuljin,384,hunter,beastmastery,6,4,2
18756,Valeine,barthilas,384,hunter,beastmastery,6,4,2
18757,Zarnick,frostwolf,384,hunter,beastmastery,6,4,2
18758,Stallwart,bronzebeard,384,hunter,beastmastery,6,4,2
18759,Tezcâtlipocâ,sargeras,384,hunter,beastmastery,6,4,2
18760,Markymarc,tichondrius,384,hunter,beastmastery,6,4,2
18761,Bowfox,area-52,384,hunter,beastmastery,6,4,2
18762,Scytsbow,illidan,384,hunter,beastmastery,6,4,2
18763,Drinktodrown,moon-guard,384,hunter,beastmastery,6,4,2
18764,Shotgunpain,nazjatar,384,hunter,beastmastery,6,4,2
18765,Krazykilla,spirestone,384,hunter,beastmastery,6,4,2
18766,Kong,tichondrius,384,hunter,beastmastery,6,4,2
18767,Chikkynuggy,destromath,384,hunter,beastmastery,6,4,2
18768,Hygogg,area-52,384,hunter,beastmastery,6,4,2
18769,Bufluu,bleeding-hollow,384,hunter,beastmastery,6,4,2
18770,Bodangel,galakrond,384,hunter,beastmastery,6,4,2
18771,Ithanna,quelthalas,384,hunter,beastmastery,6,4,2
18772,Dcousins,tichondrius,384,hunter,beastmastery,6,4,2
18773,Shiki,icecrown,384,hunter,beastmastery,6,4,2
18774,Hyyz,proudmoore,384,hunter,beastmastery,6,4,2
18775,Sôuleater,moon-guard,384,hunter,beastmastery,6,4,2
18776,Lowlore,moon-guard,384,hunter,beastmastery,6,4,2
18777,Hunterquim,stormrage,384,hunter,beastmastery,6,4,2
18778,Vanquisher,trollbane,384,hunter,beastmastery,6,4,2
18779,Chokemescara,stormrage,384,hunter,beastmastery,6,4,2
18780,Tìrra,stormrage,384,hunter,beastmastery,6,4,2
18781,Reilerhunt,stormrage,384,hunter,beastmastery,6,4,2
18782,Naxhunter,stormrage,384,hunter,beastmastery,6,4,2
18783,Infatuatedx,moon-guard,384,hunter,beastmastery,6,4,2
18784,Chutput,dalaran,384,hunter,beastmastery,9,5,4
18785,Nakyash,ragnaros,384,hunter,beastmastery,9,5,4
18786,Jeonghun,tichondrius,384,hunter,beastmastery,9,5,4
18787,Anteróz,tichondrius,384,hunter,beastmastery,9,4,5
18788,Withoutraps,quelthalas,384,hunter,beastmastery,12,4,8
18789,Zøro,malganis,384,hunter,beastmastery,12,4,8
18790,Bangerzx,stormrage,384,hunter,beastmastery,12,4,8
18791,Tigerswood,sargeras,384,hunter,beastmastery,12,4,8
18792,Dubbledee,malganis,384,hunter,beastmastery,12,4,8
18793,Alkynabm,kelthuzad,384,hunter,beastmastery,12,4,8
18794,Arcuz,quelthalas,384,hunter,beastmastery,12,4,8
18795,Zeront,garona,384,hunter,beastmastery,12,4,8
18796,Knarlin,uldum,384,hunter,beastmastery,12,4,8
18797,Pirateninja,illidan,384,hunter,beastmastery,12,4,8
18798,Largetender,illidan,384,hunter,beastmastery,12,4,8
18799,Sydina,malganis,384,hunter,beastmastery,12,4,8
18800,Wannakill,stormrage,384,hunter,beastmastery,12,4,8
18801,Øutpläyed,quelthalas,384,hunter,beastmastery,12,4,8
18802,Throwadox,malganis,384,hunter,beastmastery,12,4,8
18803,Shaevie,lothar,384,hunter,beastmastery,12,4,8
18804,Dopeykingdom,illidan,384,hunter,beastmastery,12,4,8
18805,Saharä,illidan,384,hunter,beastmastery,12,4,8
18806,Cndavyjones,akama,384,hunter,beastmastery,12,4,8
18807,Vandescar,illidan,384,hunter,beastmastery,12,4,8
18808,Noxura,illidan,384,hunter,beastmastery,12,4,8
18809,Kharvaash,onyxia,384,hunter,beastmastery,12,4,8
18810,Moùrningwood,stormrage,384,hunter,beastmastery,12,4,8
18811,Cluhaywood,zuljin,384,hunter,beastmastery,12,4,8
18812,Grumaku,area-52,384,hunter,beastmastery,12,4,8
18813,Shatterwax,area-52,384,hunter,beastmastery,12,4,8
18814,Killatrap,malganis,384,hunter,beastmastery,12,4,8
18815,Gaydin,zuljin,384,hunter,beastmastery,12,4,8
18816,Oztroza,grizzly-hills,384,hunter,beastmastery,12,4,8
18817,Dampteeth,sargeras,384,hunter,beastmastery,12,4,8
18818,Päinal,area-52,384,hunter,beastmastery,12,4,8
18819,Bowsauce,khadgar,384,hunter,beastmastery,12,4,8
18820,Elywen,alexstrasza,384,hunter,beastmastery,12,4,8
18821,Kok,andorhal,384,hunter,beastmastery,12,4,8
18822,Deahtgab,ragnaros,384,hunter,beastmastery,12,4,8
18823,Rhyzen,drenden,384,hunter,beastmastery,12,4,8
18824,Gandury,tichondrius,384,hunter,beastmastery,12,4,8
18825,Valrosan,stormrage,384,hunter,beastmastery,12,4,8
18826,Doves,wyrmrest-accord,384,hunter,beastmastery,12,4,8
18827,Bówjòb,nordrassil,384,hunter,beastmastery,12,4,8
18828,Ælij,tichondrius,384,hunter,beastmastery,12,4,8
18829,Vencc,tichondrius,384,hunter,beastmastery,12,4,8
18830,Seanpaì,tichondrius,384,hunter,beastmastery,12,4,8
18831,Bazanguita,tichondrius,384,hunter,beastmastery,12,4,8
18832,Grimshot,boulderfist,384,hunter,beastmastery,12,4,8
18833,Inetpub,stormrage,384,hunter,beastmastery,12,4,8
18834,Dangerclam,barthilas,384,hunter,beastmastery,12,4,8
18835,Calev,frostmourne,384,hunter,beastmastery,12,4,8
18836,Miansi,tichondrius,384,hunter,beastmastery,12,4,8
18837,Softhunter,tichondrius,384,hunter,beastmastery,12,4,8
18838,Mídnîght,azralon,384,hunter,beastmastery,12,4,8
18839,Graatata,shandris,384,hunter,beastmastery,12,4,8
18840,Lookoutt,tichondrius,384,hunter,beastmastery,12,4,8
18841,Coggter,uther,384,hunter,beastmastery,12,4,8
18842,Skycaptaín,lightbringer,384,hunter,beastmastery,12,4,8
18843,Devastavi,proudmoore,384,hunter,beastmastery,12,4,8
18844,Zothus,azralon,384,hunter,beastmastery,12,4,8
18845,Twopawshunta,tichondrius,384,hunter,beastmastery,12,4,8
18846,Coolbeanz,boulderfist,384,hunter,beastmastery,12,4,8
18847,Deatharrow,azuremyst,384,hunter,beastmastery,12,4,8
18848,Whaling,tichondrius,384,hunter,beastmastery,12,4,8
18849,Zylen,tichondrius,384,hunter,beastmastery,12,4,8
18850,Zoëx,amanthul,384,hunter,beastmastery,12,4,8
18851,Fydehunt,stormrage,384,hunter,beastmastery,14,4,10
18852,Atheos,gallywix,384,hunter,beastmastery,18,4,14
18853,Gugubird,proudmoore,384,hunter,beastmastery,18,4,14
18854,Löö,arthas,384,hunter,beastmastery,23,4,19
18855,Volga,haomarush,383,hunter,beastmastery,6,4,2
18856,Gichiwalrus,emerald-dream,383,hunter,beastmastery,6,4,2
18857,Ganaja,laughing-skull,383,hunter,beastmastery,6,4,2
18858,Bboo,bonechewer,383,hunter,beastmastery,6,4,2
18859,Mortia,thunderlord,383,hunter,beastmastery,12,4,8
18860,Böwjøb,illidan,383,hunter,beastmastery,12,4,8
18861,Patcherson,kargath,383,hunter,beastmastery,12,4,8
18862,Lamper,emerald-dream,383,hunter,beastmastery,12,4,8
18863,Paulayork,drakthul,383,hunter,beastmastery,12,4,8
18864,Tarakii,moon-guard,383,hunter,beastmastery,12,4,8
18865,Gals,saurfang,383,hunter,beastmastery,12,4,8
18866,Purna,moon-guard,383,hunter,beastmastery,12,4,8
18867,Defacecilth,dalaran,383,hunter,beastmastery,12,4,8
18868,Beatnyou,tichondrius,383,hunter,beastmastery,12,4,8
18869,Lazygnome,azshara,383,hunter,beastmastery,12,4,8
18870,Slutnamedjim,zuljin,383,hunter,beastmastery,12,4,8
18871,Foakus,zuljin,383,hunter,beastmastery,13,4,9
18872,Etb,bleeding-hollow,382,hunter,beastmastery,12,4,8
18873,Ire,kelthuzad,367,hunter,beastmastery,11,4,7
18874,Mondlicht,tichondrius,367,hunter,beastmastery,11,4,7
18875,Sylaris,arathor,366,hunter,beastmastery,11,4,7
18876,Clinkz,chogall,351,hunter,beastmastery,11,4,7
18877,Kemper,dragonmaw,351,hunter,beastmastery,11,4,7
18878,Vínçent,blood-furnace,351,hunter,beastmastery,17,4,13
18879,Sadarrow,frostmourne,334,hunter,beastmastery,11,4,7
18880,Drakarÿs,drakkari,326,hunter,beastmastery,18,5,13
18881,Rachael,veknilash,319,hunter,beastmastery,8,4,4
18882,Khillin,destromath,319,hunter,beastmastery,8,4,4
18883,Punkrockguy,illidan,319,hunter,beastmastery,14,4,10
18884,Huntli,elune,304,hunter,beastmastery,7,4,3
18885,Georgigeo,turalyon,288,hunter,beastmastery,6,3,3
18886,Tibineids,stormrage,288,hunter,beastmastery,6,3,3
18887,Wiittig,hyjal,288,hunter,beastmastery,6,3,3
18888,Emart,bloodhoof,288,hunter,beastmastery,6,3,3
18889,Mynds,stormrage,288,hunter,beastmastery,6,3,3
18890,Moyria,quelthalas,288,hunter,beastmastery,6,3,3
18891,Fakerz,stormrage,288,hunter,beastmastery,6,3,3
18892,Kalhistra,stormrage,288,hunter,beastmastery,6,3,3
18893,Yoyoletsgo,malganis,288,hunter,beastmastery,6,3,3
18894,Cloudbuck,aegwynn,288,hunter,beastmastery,6,3,3
18895,Beastmodex,quelthalas,288,hunter,beastmastery,6,3,3
18896,Vinksy,sargeras,288,hunter,beastmastery,6,3,3
18897,Trickshot,hakkar,288,hunter,beastmastery,6,3,3
18898,Latrampoza,quelthalas,288,hunter,beastmastery,6,3,3
18899,Jungling,kelthuzad,288,hunter,beastmastery,6,3,3
18900,Terrabytés,kelthuzad,288,hunter,beastmastery,6,3,3
18901,Archetype,bladefist,288,hunter,beastmastery,6,3,3
18902,Talksic,bladefist,288,hunter,beastmastery,6,3,3
18903,Gudlukk,stormrage,288,hunter,beastmastery,6,3,3
18904,Enonoa,thunderlord,288,hunter,beastmastery,6,3,3
18905,Markieemark,tichondrius,288,hunter,beastmastery,6,3,3
18906,Gupples,frostwolf,288,hunter,beastmastery,6,3,3
18907,Limpingspoon,kelthuzad,288,hunter,beastmastery,6,3,3
18908,Raainha,stormrage,288,hunter,beastmastery,6,3,3
18909,Shallaiya,stormrage,288,hunter,beastmastery,6,3,3
18910,Tonysting,sargeras,288,hunter,beastmastery,6,3,3
18911,Lelantos,stonemaul,288,hunter,beastmastery,6,3,3
18912,Prasanna,kelthuzad,288,hunter,beastmastery,6,3,3
18913,Arrazyne,jubeithos,288,hunter,beastmastery,6,3,3
18914,Yousokook,frostmourne,288,hunter,beastmastery,6,3,3
18915,Britannian,moon-guard,288,hunter,beastmastery,6,3,3
18916,Tuanorz,proudmoore,288,hunter,beastmastery,6,3,3
18917,Cablok,moon-guard,288,hunter,beastmastery,6,3,3
18918,Goraku,dalaran,288,hunter,beastmastery,6,3,3
18919,Arrowenn,zuljin,288,hunter,beastmastery,6,3,3
18920,Trailed,dalaran,288,hunter,beastmastery,6,3,3
18921,Shikay,frostmourne,288,hunter,beastmastery,6,3,3
18922,Anatric,illidan,288,hunter,beastmastery,6,3,3
18923,Nightstålkër,moon-guard,288,hunter,beastmastery,6,3,3
18924,Rakhesh,quelthalas,288,hunter,beastmastery,6,3,3
18925,Elroyjetson,arthas,288,hunter,beastmastery,6,3,3
18926,Skulltøn,area-52,288,hunter,beastmastery,6,3,3
18927,Crinkx,arthas,288,hunter,beastmastery,6,3,3
18928,Quepop,demon-soul,288,hunter,beastmastery,6,3,3
18929,Norgalys,proudmoore,288,hunter,beastmastery,6,3,3
18930,Coachs,tichondrius,288,hunter,beastmastery,6,3,3
18931,Hannes,boulderfist,288,hunter,beastmastery,6,3,3
18932,Longbeau,gnomeregan,288,hunter,beastmastery,6,3,3
18933,Schumann,ursin,288,hunter,beastmastery,6,3,3
18934,Mogradme,shadowsong,288,hunter,beastmastery,6,3,3
18935,Sibbleiv,boulderfist,288,hunter,beastmastery,6,3,3
18936,Scolhunter,scarlet-crusade,288,hunter,beastmastery,6,3,3
18937,Skarsnick,draenor,288,hunter,beastmastery,6,3,3
18938,Díllý,area-52,288,hunter,beastmastery,6,3,3
18939,Cefla,illidan,288,hunter,beastmastery,6,3,3
18940,Ironova,illidan,288,hunter,beastmastery,6,3,3
18941,Blastinnagas,tichondrius,288,hunter,beastmastery,6,3,3
18942,Tetzuo,illidan,288,hunter,beastmastery,6,3,3
18943,Makeastinky,malfurion,288,hunter,beastmastery,6,3,3
18944,Viavii,barthilas,288,hunter,beastmastery,6,3,3
18945,Gnurfgun,proudmoore,288,hunter,beastmastery,6,3,3
18946,Wrâge,senjin,288,hunter,beastmastery,6,3,3
18947,Vivaswan,tichondrius,288,hunter,beastmastery,6,3,3
18948,Ocxhunter,nemesis,288,hunter,beastmastery,6,3,3
18949,Çrimson,frostmourne,288,hunter,beastmastery,6,3,3
18950,Tulipbee,moon-guard,288,hunter,beastmastery,6,3,3
18951,Nopez,tichondrius,288,hunter,beastmastery,6,3,3
18952,Guacmec,tichondrius,288,hunter,beastmastery,6,3,3
18953,Ogkataro,tichondrius,288,hunter,beastmastery,6,3,3
18954,Trixex,darkspear,288,hunter,beastmastery,6,3,3
18955,Mackabeagden,illidan,288,hunter,beastmastery,6,3,3
18956,Doubletappz,stormreaver,288,hunter,beastmastery,6,3,3
18957,Braxigarr,area-52,288,hunter,beastmastery,6,3,3
18958,Adapted,proudmoore,288,hunter,beastmastery,6,3,3
18959,Firskin,frostmourne,288,hunter,beastmastery,6,3,3
18960,Vikshen,illidan,288,hunter,beastmastery,6,3,3
18961,Realzanderr,antonidas,288,hunter,beastmastery,6,3,3
18962,Archicur,darkspear,288,hunter,beastmastery,6,3,3
18963,Soberish,bleeding-hollow,288,hunter,beastmastery,6,3,3
18964,Nyloc,dalvengyr,288,hunter,beastmastery,6,3,3
18965,Aldurion,wyrmrest-accord,288,hunter,beastmastery,6,3,3
18966,Popshotz,khazgoroth,288,hunter,beastmastery,6,3,3
18967,Djpopshot,thrall,288,hunter,beastmastery,6,3,3
18968,Harosh,azralon,288,hunter,beastmastery,6,3,3
18969,Illine,azralon,288,hunter,beastmastery,6,3,3
18970,Redthedeer,warsong,288,hunter,beastmastery,6,3,3
18971,Chadbowsman,tichondrius,288,hunter,beastmastery,6,3,3
18972,Venj,proudmoore,288,hunter,beastmastery,6,3,3
18973,Dranel,nordrassil,288,hunter,beastmastery,6,3,3
18974,Perfectcrit,area-52,288,hunter,beastmastery,6,3,3
18975,Vipermaster,azralon,288,hunter,beastmastery,6,3,3
18976,Pewpewbang,muradin,288,hunter,beastmastery,6,3,3
18977,Billcsbyswtr,sargeras,288,hunter,beastmastery,6,3,3
18978,Bmsurvmm,tichondrius,288,hunter,beastmastery,6,3,3
18979,Grimpossible,sargeras,288,hunter,beastmastery,6,3,3
18980,Wanshöt,tichondrius,288,hunter,beastmastery,6,3,3
18981,Moroallytwo,sargeras,288,hunter,beastmastery,6,3,3
18982,Heãdhunter,area-52,288,hunter,beastmastery,6,3,3
18983,Comtambisuon,frostmourne,288,hunter,beastmastery,6,3,3
18984,Nexxa,muradin,288,hunter,beastmastery,6,3,3
18985,Siimmplicitz,area-52,288,hunter,beastmastery,6,3,3
18986,Barrohunt,tichondrius,288,hunter,beastmastery,6,3,3
18987,Grayføxx,twisting-nether,288,hunter,beastmastery,6,3,3
18988,Legendshot,area-52,288,hunter,beastmastery,6,3,3
18989,Hahahahahaha,frostmourne,288,hunter,beastmastery,6,3,3
18990,Toxicbowjobs,tichondrius,288,hunter,beastmastery,6,3,3
18991,Rolandschitt,area-52,288,hunter,beastmastery,6,3,3
18992,Shallwe,frostmourne,288,hunter,beastmastery,6,3,3
18993,Hordworld,tichondrius,288,hunter,beastmastery,6,3,3
18994,Wrectitralph,sargeras,288,hunter,beastmastery,6,3,3
18995,Shootin,frostmourne,288,hunter,beastmastery,6,3,3
18996,Miraclez,nerzhul,288,hunter,beastmastery,6,3,3
18997,Zeroday,emerald-dream,288,hunter,beastmastery,6,3,3
18998,Atlacatl,tichondrius,288,hunter,beastmastery,6,3,3
18999,Santiiadonai,quelthalas,288,hunter,beastmastery,6,3,3
19000,Naksha,area-52,288,hunter,beastmastery,6,3,3
19001,Saucypapi,kiljaeden,288,hunter,beastmastery,6,3,3
19002,Onahai,tichondrius,288,hunter,beastmastery,6,3,3
19003,Mulnaaj,zuljin,288,hunter,beastmastery,6,3,3
19004,Ballistik,area-52,288,hunter,beastmastery,6,3,3
19005,Lyler,tichondrius,288,hunter,beastmastery,6,3,3
19006,Añto,tichondrius,288,hunter,beastmastery,6,3,3
19007,Herroo,thrall,288,hunter,beastmastery,6,3,3
19008,Kahoykeso,frostmourne,288,hunter,beastmastery,6,3,3
19009,Bigun,emerald-dream,288,hunter,beastmastery,13,5,8
19010,Wargodthor,blades-edge,288,hunter,beastmastery,12,3,9
19011,Worewolf,lightninghoof,288,hunter,beastmastery,12,3,9
19012,Boyarsky,area-52,288,hunter,beastmastery,12,3,9
19013,Rice,veknilash,288,hunter,beastmastery,12,3,9
19014,Autismo,garithos,288,hunter,beastmastery,12,3,9
19015,Zhona,moon-guard,288,hunter,beastmastery,12,3,9
19016,Fosberry,sargeras,288,hunter,beastmastery,12,3,9
19017,Dieplox,thunderhorn,288,hunter,beastmastery,12,3,9
19018,Inurah,malganis,288,hunter,beastmastery,12,3,9
19019,Rooman,ragnaros,288,hunter,beastmastery,12,3,9
19020,Wave,kelthuzad,288,hunter,beastmastery,12,3,9
19021,Dsizzle,tichondrius,288,hunter,beastmastery,12,3,9
19022,Ryanderanged,wyrmrest-accord,288,hunter,beastmastery,12,3,9
19023,Thunderbúll,tichondrius,288,hunter,beastmastery,12,3,9
19024,Ratbasterrd,darkspear,288,hunter,beastmastery,12,3,9
19025,Zaydenm,sargeras,288,hunter,beastmastery,12,3,9
19026,Icculus,norgannon,288,hunter,beastmastery,12,3,9
19027,Jgalth,chogall,288,hunter,beastmastery,12,3,9
19028,Thiande,zuljin,288,hunter,beastmastery,12,3,9
19029,Mahdy,ragnaros,288,hunter,beastmastery,12,3,9
19030,Legacee,shattered-hand,288,hunter,beastmastery,12,3,9
19031,Leggodex,caelestrasz,288,hunter,beastmastery,12,3,9
19032,Reecerkoz,nagrand,288,hunter,beastmastery,12,3,9
19033,Tanrith,dark-iron,288,hunter,beastmastery,12,3,9
19034,Simyra,moon-guard,288,hunter,beastmastery,12,3,9
19035,Kharthorin,moon-guard,288,hunter,beastmastery,12,3,9
19036,Ruckq,stormrage,288,hunter,beastmastery,12,3,9
19037,Delanooch,rexxar,288,hunter,beastmastery,12,3,9
19038,Spurtzki,emerald-dream,288,hunter,beastmastery,12,3,9
19039,Brewster,burning-legion,288,hunter,beastmastery,12,3,9
19040,Prowd,staghelm,288,hunter,beastmastery,12,3,9
19041,Gunwalk,azjolnerub,288,hunter,beastmastery,12,3,9
19042,Iboofprofen,illidan,288,hunter,beastmastery,12,3,9
19043,Grlzzlyadams,norgannon,288,hunter,beastmastery,12,3,9
19044,Dragon,stormscale,288,hunter,beastmastery,12,3,9
19045,Digsites,emerald-dream,288,hunter,beastmastery,12,3,9
19046,Acturius,jubeithos,288,hunter,beastmastery,12,3,9
19047,Neríne,drakkari,288,hunter,beastmastery,12,3,9
19048,Natnat,sargeras,288,hunter,beastmastery,12,3,9
19049,Yiyixx,tichondrius,288,hunter,beastmastery,18,3,15
19050,Fiercetamer,azuremyst,288,hunter,beastmastery,18,3,15
19051,Kresnik,azralon,288,hunter,beastmastery,18,3,15
19052,Rhaygon,arthas,288,hunter,beastmastery,18,3,15
19053,Bëcäüsë,proudmoore,288,hunter,beastmastery,18,3,15
19054,Mphunter,azralon,288,hunter,beastmastery,24,3,21
19055,Wolftracer,sargeras,287,hunter,beastmastery,6,3,3
19056,Ledan,lightnings-blade,287,hunter,beastmastery,6,3,3
19057,Dagganet,thrall,287,hunter,beastmastery,6,3,3
19058,Euroniimus,ragnaros,287,hunter,beastmastery,6,3,3
19059,Luzyfer,quelthalas,287,hunter,beastmastery,6,3,3
19060,Qwazy,zuljin,287,hunter,beastmastery,6,3,3
19061,Frenchhtoast,sargeras,287,hunter,beastmastery,12,3,9
19062,Snaken,the-forgotten-coast,287,hunter,beastmastery,12,3,9
19063,Broseth,saurfang,287,hunter,beastmastery,12,3,9
19064,Drwu,stormrage,287,hunter,beastmastery,12,3,9
19065,Xereck,emerald-dream,287,hunter,beastmastery,12,3,9
19066,Arin,suramar,287,hunter,beastmastery,12,3,9
19067,Khaldru,drakkari,286,hunter,beastmastery,6,3,3
19068,Shelbyy,tichondrius,286,hunter,beastmastery,16,4,12
19069,Morasongg,area-52,286,hunter,beastmastery,12,3,9
19070,Darkally,blades-edge,285,hunter,beastmastery,18,3,15
19071,Smokiiganja,proudmoore,256,hunter,beastmastery,10,3,7
19072,Starkills,galakrond,256,hunter,beastmastery,10,3,7
19073,Bulszeye,azgalor,255,hunter,beastmastery,8,4,4
19074,Pokeyourbutt,hydraxis,240,hunter,beastmastery,15,3,12
19075,Vicecheney,illidan,239,hunter,beastmastery,5,3,2
19076,Diisdik,tichondrius,239,hunter,beastmastery,5,3,2
19077,Léfty,nagrand,239,hunter,beastmastery,11,3,8
19078,Djcummyfeet,stormrage,234,hunter,beastmastery,17,6,11
19079,Feralcat,nazjatar,208,hunter,beastmastery,13,3,10
19080,Fistbèk,bleeding-hollow,201,hunter,beastmastery,17,5,12
19081,Fancyxo,frostmourne,192,hunter,beastmastery,6,2,4
19082,Flawwless,eredar,192,hunter,beastmastery,6,2,4
19083,Dreadrahl,deathwing,192,hunter,beastmastery,6,2,4
19084,Critaclyzm,moon-guard,192,hunter,beastmastery,6,2,4
19085,Fáelin,proudmoore,192,hunter,beastmastery,6,2,4
19086,Sebastian,blackhand,192,hunter,beastmastery,6,2,4
19087,Csadark,nemesis,192,hunter,beastmastery,6,2,4
19088,Pudgihunt,proudmoore,192,hunter,beastmastery,6,2,4
19089,Chømp,tichondrius,192,hunter,beastmastery,6,2,4
19090,Monstroow,nemesis,192,hunter,beastmastery,6,2,4
19091,Illrannevian,garrosh,192,hunter,beastmastery,6,2,4
19092,Cufless,proudmoore,192,hunter,beastmastery,6,2,4
19093,Lilaeth,khadgar,192,hunter,beastmastery,6,2,4
19094,Strikerfirst,area-52,192,hunter,beastmastery,6,2,4
19095,Neverwipes,frostmourne,192,hunter,beastmastery,6,2,4
19096,Impërïum,zuljin,192,hunter,beastmastery,6,2,4
19097,Juicyfruit,bleeding-hollow,192,hunter,beastmastery,6,2,4
19098,Checkhunter,frostwolf,192,hunter,beastmastery,6,2,4
19099,Jagwaar,malganis,192,hunter,beastmastery,6,2,4
19100,Chaseurnoir,exodar,192,hunter,beastmastery,6,2,4
19101,Powerful,aerie-peak,192,hunter,beastmastery,6,2,4
19102,Twocranes,tichondrius,192,hunter,beastmastery,6,2,4
19103,Gruì,malganis,192,hunter,beastmastery,6,2,4
19104,Elmozz,thrall,192,hunter,beastmastery,6,2,4
19105,Rúdrá,area-52,192,hunter,beastmastery,6,2,4
19106,Johnnybee,demon-soul,192,hunter,beastmastery,6,2,4
19107,Honeyhunt,thrall,192,hunter,beastmastery,6,2,4
19108,Blakespace,area-52,192,hunter,beastmastery,6,2,4
19109,Hectorbuñue,quelthalas,192,hunter,beastmastery,6,2,4
19110,Skillhunter,tichondrius,192,hunter,beastmastery,6,2,4
19111,Bambii,fizzcrank,192,hunter,beastmastery,6,2,4
19112,Shootermgavn,frostmourne,192,hunter,beastmastery,6,2,4
19113,Jojojobo,tichondrius,192,hunter,beastmastery,6,2,4
19114,Nahzah,stormrage,192,hunter,beastmastery,6,2,4
19115,Castíèl,thrall,192,hunter,beastmastery,6,2,4
19116,Hüh,area-52,192,hunter,beastmastery,6,2,4
19117,Hötdôg,kiljaeden,192,hunter,beastmastery,6,2,4
19118,Spoojshot,frostmourne,192,hunter,beastmastery,6,2,4
19119,Hìrcine,nesingwary,192,hunter,beastmastery,6,2,4
19120,Hunata,crushridge,192,hunter,beastmastery,6,2,4
19121,Revengexyz,zuljin,192,hunter,beastmastery,6,2,4
19122,Art,guldan,192,hunter,beastmastery,6,2,4
19123,Nubcaks,nerzhul,192,hunter,beastmastery,6,2,4
19124,Jackrandall,frostmourne,192,hunter,beastmastery,6,2,4
19125,Dreiya,quelthalas,192,hunter,beastmastery,6,2,4
19126,Warplaquee,zuljin,192,hunter,beastmastery,6,2,4
19127,Ikiteforfood,zuljin,192,hunter,beastmastery,6,2,4
19128,Slanderous,korgath,192,hunter,beastmastery,6,2,4
19129,Greasyboi,tichondrius,192,hunter,beastmastery,6,2,4
19130,Resonatorrob,illidan,192,hunter,beastmastery,6,2,4
19131,ßoo,darkspear,192,hunter,beastmastery,6,2,4
19132,Nevon,azralon,192,hunter,beastmastery,6,2,4
19133,Bluntcrushed,area-52,192,hunter,beastmastery,6,2,4
19134,Mojito,frostmourne,192,hunter,beastmastery,6,2,4
19135,Fjdominador,azralon,192,hunter,beastmastery,6,2,4
19136,Sukr,korgath,192,hunter,beastmastery,6,2,4
19137,Xeneye,tichondrius,192,hunter,beastmastery,6,2,4
19138,Harrowin,area-52,192,hunter,beastmastery,6,2,4
19139,Camfeed,illidan,192,hunter,beastmastery,6,2,4
19140,Swettx,bleeding-hollow,192,hunter,beastmastery,6,2,4
19141,Monffbc,tichondrius,192,hunter,beastmastery,6,2,4
19142,Zarknoth,cenarius,192,hunter,beastmastery,6,2,4
19143,Rämbow,frostmourne,192,hunter,beastmastery,6,2,4
19144,Autoshotxprt,frostmourne,192,hunter,beastmastery,6,2,4
19145,Dradran,kelthuzad,192,hunter,beastmastery,6,2,4
19146,Estilingada,azralon,192,hunter,beastmastery,6,2,4
19147,Forsaken,bleeding-hollow,192,hunter,beastmastery,6,2,4
19148,Shådé,stormrage,192,hunter,beastmastery,6,2,4
19149,Farva,tanaris,192,hunter,beastmastery,6,2,4
19150,Ellishunter,frostmourne,192,hunter,beastmastery,6,2,4
19151,Ussy,area-52,192,hunter,beastmastery,6,2,4
19152,Titzyø,area-52,192,hunter,beastmastery,6,2,4
19153,Islapuwitaro,azjolnerub,192,hunter,beastmastery,6,2,4
19154,Slimezy,tichondrius,192,hunter,beastmastery,6,2,4
19155,Wayer,tichondrius,192,hunter,beastmastery,6,2,4
19156,Wooftoof,frostmourne,192,hunter,beastmastery,6,2,4
19157,Rostter,azralon,192,hunter,beastmastery,6,2,4
19158,Momodasi,illidan,192,hunter,beastmastery,6,2,4
19159,Bloodstark,dreadmaul,192,hunter,beastmastery,6,2,4
19160,Fova,wyrmrest-accord,192,hunter,beastmastery,6,2,4
19161,Kudzue,illidan,192,hunter,beastmastery,6,2,4
19162,Zellor,wyrmrest-accord,192,hunter,beastmastery,6,2,4
19163,Søapbubble,tichondrius,192,hunter,beastmastery,6,2,4
19164,Klepty,stormrage,192,hunter,beastmastery,6,2,4
19165,Caligar,tichondrius,192,hunter,beastmastery,6,2,4
19166,Halaruka,area-52,192,hunter,beastmastery,6,2,4
19167,Blickymon,wyrmrest-accord,192,hunter,beastmastery,6,2,4
19168,Iapsux,bleeding-hollow,192,hunter,beastmastery,6,2,4
19169,Singer,lothar,192,hunter,beastmastery,6,2,4
19170,Sogékíng,illidan,192,hunter,beastmastery,6,2,4
19171,Boquiinha,stormrage,192,hunter,beastmastery,6,2,4
19172,Totolol,trollbane,192,hunter,beastmastery,6,2,4
19173,Vanpeltz,illidan,192,hunter,beastmastery,6,2,4
19174,Shootr,darkspear,192,hunter,beastmastery,6,2,4
19175,Varianhunter,kelthuzad,192,hunter,beastmastery,6,2,4
19176,Jbahh,hyjal,192,hunter,beastmastery,6,2,4
19177,Shrapnelx,ragnaros,192,hunter,beastmastery,6,2,4
19178,Öops,hyjal,192,hunter,beastmastery,6,2,4
19179,Expskippy,darkspear,192,hunter,beastmastery,6,2,4
19180,Garble,darkspear,192,hunter,beastmastery,6,2,4
19181,Crawl,auchindoun,192,hunter,beastmastery,6,2,4
19182,Barrelsofrum,illidan,192,hunter,beastmastery,6,2,4
19183,Obsol,hyjal,192,hunter,beastmastery,6,2,4
19184,Skolzero,azralon,192,hunter,beastmastery,6,2,4
19185,Magvez,tichondrius,192,hunter,beastmastery,6,2,4
19186,Bernice,darrowmere,192,hunter,beastmastery,6,2,4
19187,Quintonius,stormrage,192,hunter,beastmastery,6,2,4
19188,Moonraven,laughing-skull,192,hunter,beastmastery,6,2,4
19189,Gohan,jubeithos,192,hunter,beastmastery,6,2,4
19190,Nfo,lightbringer,192,hunter,beastmastery,6,2,4
19191,Nenenhunt,ragnaros,192,hunter,beastmastery,6,2,4
19192,Taintz,altar-of-storms,192,hunter,beastmastery,6,2,4
19193,Etarie,malganis,192,hunter,beastmastery,6,2,4
19194,Sahjana,lothar,192,hunter,beastmastery,6,2,4
19195,Menaceqq,stormrage,192,hunter,beastmastery,6,2,4
19196,Dnicee,stormrage,192,hunter,beastmastery,6,2,4
19197,Tichong,tichondrius,192,hunter,beastmastery,6,2,4
19198,Sylvãnâs,tichondrius,192,hunter,beastmastery,6,2,4
19199,Vyndiln,tichondrius,192,hunter,beastmastery,6,2,4
19200,Presleyjane,tichondrius,192,hunter,beastmastery,6,2,4
19201,Krissiz,drakkari,192,hunter,beastmastery,6,2,4
19202,Munrrack,ragnaros,192,hunter,beastmastery,6,2,4
19203,Kaptincrunch,skywall,192,hunter,beastmastery,6,2,4
19204,Survbot,malganis,192,hunter,beastmastery,6,2,4
19205,Saveawp,stormrage,192,hunter,beastmastery,6,2,4
19206,Royshot,stormrage,192,hunter,beastmastery,6,2,4
19207,Sativ,moknathal,192,hunter,beastmastery,6,2,4
19208,Verzoz,illidan,192,hunter,beastmastery,6,2,4
19209,Frìtz,barthilas,192,hunter,beastmastery,6,2,4
19210,Greyk,moon-guard,192,hunter,beastmastery,6,2,4
19211,Diacachimbaa,ragnaros,192,hunter,beastmastery,6,2,4
19212,Phife,emerald-dream,192,hunter,beastmastery,6,2,4
19213,Madsniper,thunderlord,192,hunter,beastmastery,6,2,4
19214,Quinnshot,tichondrius,192,hunter,beastmastery,6,2,4
19215,Slobon,tichondrius,192,hunter,beastmastery,6,2,4
19216,Purpreynolds,tichondrius,192,hunter,beastmastery,6,2,4
19217,Rsttlegore,stormscale,192,hunter,beastmastery,6,2,4
19218,Nanotorque,moon-guard,192,hunter,beastmastery,6,2,4
19219,Nixuis,stormrage,192,hunter,beastmastery,6,2,4
19220,Elivivia,tichondrius,192,hunter,beastmastery,6,2,4
19221,Hitstickk,tichondrius,192,hunter,beastmastery,6,2,4
19222,Ivanjackenov,illidan,192,hunter,beastmastery,6,2,4
19223,Spicycheezit,malganis,192,hunter,beastmastery,6,2,4
19224,Berrydanish,tichondrius,192,hunter,beastmastery,6,2,4
19225,Viracha,stormrage,192,hunter,beastmastery,6,2,4
19226,Antwonziezz,tichondrius,192,hunter,beastmastery,6,2,4
19227,Newcomb,tichondrius,192,hunter,beastmastery,6,2,4
19228,Jämmëdclïp,emerald-dream,192,hunter,beastmastery,6,2,4
19229,Zoopdapoop,dalaran,192,hunter,beastmastery,6,2,4
19230,Hedshot,kelthuzad,192,hunter,beastmastery,6,2,4
19231,Solderboi,tichondrius,192,hunter,beastmastery,6,2,4
19232,Pfheign,area-52,192,hunter,beastmastery,6,2,4
19233,Mennis,archimonde,192,hunter,beastmastery,6,2,4
19234,Thazen,sargeras,192,hunter,beastmastery,6,2,4
19235,Ganderion,sargeras,192,hunter,beastmastery,6,2,4
19236,Averely,skywall,192,hunter,beastmastery,6,2,4
19237,Bombashotz,sargeras,192,hunter,beastmastery,6,2,4
19238,Luiiguii,quelthalas,192,hunter,beastmastery,6,2,4
19239,Izanägi,sargeras,192,hunter,beastmastery,6,2,4
19240,Aaggros,sargeras,192,hunter,beastmastery,6,2,4
19241,Romro,norgannon,192,hunter,beastmastery,6,2,4
19242,Equalizér,sargeras,192,hunter,beastmastery,6,2,4
19243,Notoffended,sargeras,192,hunter,beastmastery,6,2,4
19244,Budget,emerald-dream,192,hunter,beastmastery,6,2,4
19245,Zeenuts,sargeras,192,hunter,beastmastery,6,2,4
19246,Letsmakebaby,sargeras,192,hunter,beastmastery,6,2,4
19247,Kzxh,illidan,192,hunter,beastmastery,6,2,4
19248,Dynith,sargeras,192,hunter,beastmastery,6,2,4
19249,Kekorator,illidan,192,hunter,beastmastery,11,3,8
19250,Seratoninx,malganis,192,hunter,beastmastery,9,2,7
19251,Gunnpowder,malganis,192,hunter,beastmastery,12,2,10
19252,Mygun,deathwing,192,hunter,beastmastery,12,2,10
19253,Alexañdra,proudmoore,192,hunter,beastmastery,12,2,10
19254,Tánsøxøxø,tichondrius,192,hunter,beastmastery,12,2,10
19255,Thundis,hellscream,192,hunter,beastmastery,12,2,10
19256,Meetdmonster,illidan,192,hunter,beastmastery,12,2,10
19257,Arrowzpeckt,tichondrius,192,hunter,beastmastery,12,2,10
19258,Carloslaun,drakkari,192,hunter,beastmastery,12,2,10
19259,Miannmar,proudmoore,192,hunter,beastmastery,12,2,10
19260,Hughboner,illidan,192,hunter,beastmastery,12,2,10
19261,Pakale,amanthul,192,hunter,beastmastery,12,2,10
19262,Khabul,area-52,192,hunter,beastmastery,12,2,10
19263,Ãmi,moon-guard,192,hunter,beastmastery,12,2,10
19264,Thyladaern,kiljaeden,192,hunter,beastmastery,12,2,10
19265,Bjj,eonar,192,hunter,beastmastery,12,2,10
19266,Tjota,azralon,192,hunter,beastmastery,12,2,10
19267,Ahmunra,zuljin,192,hunter,beastmastery,12,2,10
19268,Floozy,frostmane,192,hunter,beastmastery,12,2,10
19269,Aeriladin,moon-guard,192,hunter,beastmastery,12,2,10
19270,Sojun,jaedenar,192,hunter,beastmastery,14,2,12
19271,Moapax,azralon,191,hunter,beastmastery,6,2,4
19272,Tuvasa,blood-furnace,191,hunter,beastmastery,6,2,4
19273,Recebaa,barthilas,191,hunter,beastmastery,6,2,4
19274,Aiilton,gallywix,191,hunter,beastmastery,6,2,4
19275,Ninoryzen,illidan,191,hunter,beastmastery,6,2,4
19276,Stoneforged,ragnaros,191,hunter,beastmastery,6,2,4
19277,Kolarius,emerald-dream,191,hunter,beastmastery,6,2,4
19278,Kangarang,khazgoroth,191,hunter,beastmastery,12,2,10
19279,Enrage,queldorei,191,hunter,beastmastery,12,2,10
19280,Maximum,tichondrius,159,hunter,beastmastery,5,2,3
19281,Helikaon,deathwing,159,hunter,beastmastery,5,2,3
19282,Skrìms,tichondrius,159,hunter,beastmastery,5,2,3
19283,Stèlla,frostmourne,159,hunter,beastmastery,5,2,3
19284,Twentyyfour,akama,144,hunter,beastmastery,3,3,0
19285,Piess,thrall,144,hunter,beastmastery,9,2,7
19286,Luckione,destromath,144,hunter,beastmastery,9,2,7
19287,Bountybud,kiljaeden,138,hunter,beastmastery,10,3,7
19288,Arrawn,illidan,128,hunter,beastmastery,4,2,2
19289,Beastmastr,garrosh,128,hunter,beastmastery,4,2,2
19290,Piñg,tichondrius,128,hunter,beastmastery,4,2,2
19291,Josharoni,sargeras,127,hunter,beastmastery,8,2,6
19292,Laviè,tichondrius,112,hunter,beastmastery,4,3,1
19293,Odratnuh,bleeding-hollow,96,hunter,beastmastery,6,1,5
19294,Bertiebott,zuljin,96,hunter,beastmastery,6,1,5
19295,Ferrettss,bleeding-hollow,96,hunter,beastmastery,6,1,5
19296,Singletap,barthilas,96,hunter,beastmastery,6,1,5
19297,Carot,dalaran,96,hunter,beastmastery,6,1,5
19298,Jiawoweixin,illidan,96,hunter,beastmastery,6,1,5
19299,Henhøuse,illidan,96,hunter,beastmastery,6,1,5
19300,Jootuber,barthilas,96,hunter,beastmastery,6,1,5
19301,Varag,amanthul,96,hunter,beastmastery,6,1,5
19302,Boido,ghostlands,96,hunter,beastmastery,6,1,5
19303,Oldmandave,stormrage,96,hunter,beastmastery,6,1,5
19304,Sõulhunter,frostmourne,96,hunter,beastmastery,6,1,5
19305,Tybierious,illidan,96,hunter,beastmastery,6,1,5
19306,Jabbar,bleeding-hollow,96,hunter,beastmastery,6,1,5
19307,Chîll,frostmourne,96,hunter,beastmastery,6,1,5
19308,Shoccka,thrall,96,hunter,beastmastery,6,1,5
19309,Shadeckz,stormrage,96,hunter,beastmastery,6,1,5
19310,Muckenfoose,frostmourne,96,hunter,beastmastery,6,1,5
19311,Ilîiìîìiilil,bleeding-hollow,96,hunter,beastmastery,6,1,5
19312,Laer,archimonde,96,hunter,beastmastery,6,1,5
19313,Wamion,zuljin,96,hunter,beastmastery,6,1,5
19314,Bellaphonte,stormrage,96,hunter,beastmastery,6,1,5
19315,Bosshunt,whisperwind,96,hunter,beastmastery,6,1,5
19316,Physical,destromath,96,hunter,beastmastery,6,1,5
19317,Nachtcloverr,stormrage,96,hunter,beastmastery,6,1,5
19318,Remak,barthilas,96,hunter,beastmastery,6,1,5
19319,Abundalacaca,sargeras,96,hunter,beastmastery,6,1,5
19320,Nearsightedd,area-52,96,hunter,beastmastery,6,1,5
19321,Beefcow,barthilas,96,hunter,beastmastery,6,1,5
19322,Slipperyqt,frostmourne,96,hunter,beastmastery,6,1,5
19323,Appä,lightnings-blade,96,hunter,beastmastery,6,1,5
19324,Roseandra,stormrage,96,hunter,beastmastery,6,1,5
19325,Blåckhat,frostmourne,96,hunter,beastmastery,6,1,5
19326,Allgasnocap,kelthuzad,96,hunter,beastmastery,6,1,5
19327,Fadingtrapz,jubeithos,96,hunter,beastmastery,6,1,5
19328,Arthanyz,quelthalas,96,hunter,beastmastery,6,1,5
19329,Bithiáh,quelthalas,96,hunter,beastmastery,6,1,5
19330,Taumelz,sargeras,96,hunter,beastmastery,6,1,5
19331,Hieke,nemesis,96,hunter,beastmastery,6,1,5
19332,Marksmanpain,malganis,96,hunter,beastmastery,6,1,5
19333,Justin,agamaggan,96,hunter,beastmastery,6,1,5
19334,Warpedshots,malganis,96,hunter,beastmastery,6,1,5
19335,Matahunt,blackwing-lair,96,hunter,beastmastery,6,1,5
19336,Fourkayiv,azgalor,96,hunter,beastmastery,6,1,5
19337,Locket,maelstrom,96,hunter,beastmastery,6,1,5
19338,Trolljinyou,thrall,96,hunter,beastmastery,6,1,5
19339,Opsi,ragnaros,96,hunter,beastmastery,6,1,5
19340,Richihunt,ragnaros,96,hunter,beastmastery,6,1,5
19341,Jägermeistër,twisting-nether,96,hunter,beastmastery,6,1,5
19342,Naariko,aggramar,96,hunter,beastmastery,6,1,5
19343,Birggitte,the-venture-co,96,hunter,beastmastery,6,1,5
19344,Cynasia,maelstrom,96,hunter,beastmastery,6,1,5
19345,Predatðr,frostmourne,96,hunter,beastmastery,6,1,5
19346,Xcopel,azralon,96,hunter,beastmastery,6,1,5
19347,Xclaw,llane,96,hunter,beastmastery,6,1,5
19348,Sobala,azralon,96,hunter,beastmastery,6,1,5
19349,Cocobread,stormreaver,96,hunter,beastmastery,6,1,5
19350,Wixyy,aegwynn,96,hunter,beastmastery,6,1,5
19351,Dusle,azralon,96,hunter,beastmastery,6,1,5
19352,Brokenfoot,bonechewer,96,hunter,beastmastery,6,1,5
19353,Bigpie,daggerspine,96,hunter,beastmastery,6,1,5
19354,Grullandàr,hakkar,96,hunter,beastmastery,6,1,5
19355,Brody,eitrigg,96,hunter,beastmastery,6,1,5
19356,Panm,runetotem,96,hunter,beastmastery,6,1,5
19357,Taurenseason,sargeras,96,hunter,beastmastery,6,1,5
19358,Alsomike,tichondrius,96,hunter,beastmastery,6,1,5
19359,Analtraps,tichondrius,96,hunter,beastmastery,6,1,5
19360,Teddyboy,proudmoore,96,hunter,beastmastery,6,1,5
19361,Audiofly,tichondrius,96,hunter,beastmastery,6,1,5
19362,Slideby,tichondrius,96,hunter,beastmastery,6,1,5
19363,Rexxiga,kiljaeden,96,hunter,beastmastery,6,1,5
19364,Slimetime,tichondrius,96,hunter,beastmastery,6,1,5
19365,Deletedyou,tichondrius,96,hunter,beastmastery,6,1,5
19366,Derekscrow,tichondrius,96,hunter,beastmastery,6,1,5
19367,Espaada,tichondrius,96,hunter,beastmastery,6,1,5
19368,Sóggybóxers,tichondrius,96,hunter,beastmastery,6,1,5
19369,Murk,spirestone,96,hunter,beastmastery,6,1,5
19370,Globlauncher,tichondrius,96,hunter,beastmastery,6,1,5
19371,Mtuanwm,tichondrius,96,hunter,beastmastery,6,1,5
19372,Percival,firetree,96,hunter,beastmastery,6,1,5
19373,Ballinpotato,tichondrius,96,hunter,beastmastery,6,1,5
19374,Huntardness,moon-guard,96,hunter,beastmastery,6,1,5
19375,Tiirra,sargeras,96,hunter,beastmastery,6,1,5
19376,Båttousai,kiljaeden,96,hunter,beastmastery,6,1,5
19377,Robious,tichondrius,96,hunter,beastmastery,6,1,5
19378,Darkhunterr,tichondrius,96,hunter,beastmastery,6,1,5
19379,Jarless,hydraxis,96,hunter,beastmastery,6,1,5
19380,Ophois,lightbringer,96,hunter,beastmastery,6,1,5
19381,Gulan,draka,96,hunter,beastmastery,6,1,5
19382,Pampas,darkspear,96,hunter,beastmastery,6,1,5
19383,Uncann,boulderfist,96,hunter,beastmastery,6,1,5
19384,Penelòpe,wyrmrest-accord,96,hunter,beastmastery,6,1,5
19385,Bendotexe,stormrage,96,hunter,beastmastery,7,1,6
19386,Colchagua,quelthalas,96,hunter,beastmastery,8,1,7
19387,Nakar,darkspear,96,hunter,beastmastery,10,1,9
19388,Ferdphin,dalaran,96,hunter,beastmastery,12,1,11
19389,Tinsho,drakkari,96,hunter,beastmastery,12,1,11
19390,Tstormzz,stormrage,96,hunter,beastmastery,12,1,11
19391,Blackstaur,illidan,96,hunter,beastmastery,12,1,11
19392,Rekows,stormrage,96,hunter,beastmastery,12,1,11
19393,Lorishblood,blackrock,96,hunter,beastmastery,12,1,11
19394,Divineseraph,dentarg,96,hunter,beastmastery,12,1,11
19395,Bee,shattered-halls,96,hunter,beastmastery,12,1,11
19396,Sylvanãs,ragnaros,96,hunter,beastmastery,12,1,11
19397,Twistedx,tichondrius,96,hunter,beastmastery,12,1,11
19398,Ñordombra,quelthalas,96,hunter,beastmastery,12,1,11
19399,Tydee,nagrand,96,hunter,beastmastery,12,1,11
19400,Caletten,destromath,96,hunter,beastmastery,12,1,11
19401,Baehydra,frostmourne,96,hunter,beastmastery,12,1,11
19402,Newdanni,barthilas,95,hunter,beastmastery,18,1,17
19403,Ssobit,tichondrius,79,hunter,beastmastery,5,1,4
19404,Kölhberg,azralon,64,hunter,beastmastery,10,1,9
19405,Aceventurapð,area-52,48,hunter,beastmastery,3,1,2
19406,Yory,tol-barad,48,hunter,beastmastery,3,1,2
19407,Wonshawt,tichondrius,48,hunter,beastmastery,3,1,2
19408,Dwrhunt,ragnaros,48,hunter,beastmastery,3,1,2
19409,Jumeog,stormscale,42,hunter,beastmastery,7,2,5
19410,Bowjoblul,stormrage,42,hunter,beastmastery,9,2,7
19411,Timesteal,tichondrius,31,hunter,beastmastery,2,1,1
19412,Gasslight,area-52,31,hunter,beastmastery,2,1,1
19413,Voladren,moon-guard,31,hunter,beastmastery,2,1,1
19414,Dirkberkeley,moon-guard,16,hunter,beastmastery,1,1,0
19415,Juicemage,tichondrius,2243,mage,arcane,107,58,49
19416,Numbing,sargeras,2233,mage,arcane,100,54,46
19417,Cvark,sargeras,2223,mage,arcane,88,51,37
19418,Ktp,tichondrius,2208,mage,arcane,95,59,36
19419,Oneschool,sargeras,2174,mage,arcane,78,45,33
19420,Venruki,tichondrius,2137,mage,arcane,78,44,34
19421,Junglejape,tichondrius,1967,mage,arcane,54,35,19
19422,Arcanemagek,tichondrius,1907,mage,arcane,48,32,16
19423,Whiterice,zuljin,1879,mage,arcane,50,31,19
19424,Birdfather,tichondrius,1861,mage,arcane,48,33,15
19425,Elfmage,tichondrius,1855,mage,arcane,36,25,11
19426,Hocusjokus,frostmourne,1851,mage,arcane,47,31,16
19427,Snortmeth,area-52,1841,mage,arcane,90,58,32
19428,Bíscuít,illidan,1836,mage,arcane,145,78,67
19429,Delibro,tichondrius,1834,mage,arcane,94,52,42
19430,Spellstéal,tichondrius,1828,mage,arcane,41,25,16
19431,Vampìrelolz,tichondrius,1809,mage,arcane,48,26,22
19432,Ezchallenger,undermine,1782,mage,arcane,102,47,55
19433,Bambambilly,kelthuzad,1777,mage,arcane,156,79,77
19434,Sestren,zuljin,1774,mage,arcane,103,51,52
19435,Edgkey,illidan,1771,mage,arcane,103,54,49
19436,Shwaysted,burning-blade,1766,mage,arcane,60,35,25
19437,Mokelovin,sargeras,1763,mage,arcane,65,33,32
19438,Esien,tichondrius,1758,mage,arcane,126,61,65
19439,Arçanemage,tichondrius,1745,mage,arcane,42,20,22
19440,Aosin,wyrmrest-accord,1738,mage,arcane,42,30,12
19441,Rhythmdog,tichondrius,1738,mage,arcane,87,45,42
19442,Maegwynah,jaedenar,1726,mage,arcane,52,27,25
19443,Tbkz,amanthul,1725,mage,arcane,54,25,29
19444,Bananappeal,kelthuzad,1717,mage,arcane,52,26,26
19445,Lmaginedying,illidan,1715,mage,arcane,30,24,6
19446,Dawitchery,illidan,1712,mage,arcane,52,23,29
19447,Magnesiium,illidan,1711,mage,arcane,48,28,20
19448,Zps,illidan,1706,mage,arcane,72,40,32
19449,Badboykilla,dentarg,1704,mage,arcane,39,33,6
19450,Melkdud,wyrmrest-accord,1703,mage,arcane,30,18,12
19451,Mageboy,bonechewer,1699,mage,arcane,67,33,34
19452,Unguided,moon-guard,1696,mage,arcane,36,21,15
19453,Arianark,sargeras,1679,mage,arcane,105,62,43
19454,Spart,runetotem,1676,mage,arcane,45,20,25
19455,Clutchy,gorefiend,1672,mage,arcane,42,29,13
19456,Nyj,tichondrius,1668,mage,arcane,65,36,29
19457,Zhanna,nazjatar,1668,mage,arcane,152,80,72
19458,Ilovejwoanna,kiljaeden,1665,mage,arcane,48,26,22
19459,Exterminatüs,tichondrius,1653,mage,arcane,87,44,43
19460,Höövalt,illidan,1641,mage,arcane,30,20,10
19461,Spitemage,tichondrius,1638,mage,arcane,109,52,57
19462,Hallat,archimonde,1631,mage,arcane,389,188,201
19463,Spellsteål,malganis,1627,mage,arcane,53,31,22
19464,Magecombe,thrall,1617,mage,arcane,30,17,13
19465,Dbox,stormscale,1615,mage,arcane,93,53,40
19466,Dmgperseç,tichondrius,1612,mage,arcane,30,20,10
19467,Proximalol,tichondrius,1610,mage,arcane,36,20,16
19468,Snoogma,illidan,1609,mage,arcane,42,20,22
19469,Ject,ragnaros,1606,mage,arcane,155,84,71
19470,Wïzarduous,mannoroth,1605,mage,arcane,60,33,27
19471,Hööva,illidan,1604,mage,arcane,30,17,13
19472,Primearcanis,tol-barad,1601,mage,arcane,48,22,26
19473,Höövaltx,illidan,1600,mage,arcane,36,19,17
19474,Failedwizard,frostmourne,1600,mage,arcane,58,25,33
19475,Sky,lightnings-blade,1599,mage,arcane,119,64,55
19476,Felsparkles,area-52,1589,mage,arcane,54,30,24
19477,Mairgik,proudmoore,1589,mage,arcane,36,19,17
19478,Waisted,kelthuzad,1573,mage,arcane,45,25,20
19479,Xialing,tichondrius,1570,mage,arcane,63,32,31
19480,Tbh,malganis,1555,mage,arcane,62,29,33
19481,Lucidaze,daggerspine,1551,mage,arcane,184,93,91
19482,Balencii,kiljaeden,1548,mage,arcane,36,20,16
19483,Clernlol,emerald-dream,1548,mage,arcane,60,27,33
19484,Étel,nemesis,1539,mage,arcane,39,19,20
19485,Enthy,frostmourne,1529,mage,arcane,36,18,18
19486,Alode,moon-guard,1526,mage,arcane,60,36,24
19487,Prosperoh,burning-legion,1526,mage,arcane,48,25,23
19488,Agoniey,illidan,1525,mage,arcane,138,69,69
19489,Vênsêr,emerald-dream,1523,mage,arcane,36,17,19
19490,Cyphen,proudmoore,1500,mage,arcane,30,16,14
19491,Toknsmoke,tichondrius,1497,mage,arcane,41,23,18
19492,Perrc,area-52,1488,mage,arcane,180,89,91
19493,Beerbelly,tichondrius,1486,mage,arcane,77,45,32
19494,Hustle,frostmourne,1483,mage,arcane,102,53,49
19495,Mävra,emerald-dream,1482,mage,arcane,30,18,12
19496,Thewizârd,stormrage,1480,mage,arcane,334,181,153
19497,Maplemage,akama,1480,mage,arcane,183,96,87
19498,Hennimage,sargeras,1468,mage,arcane,241,132,109
19499,Missile,frostmourne,1454,mage,arcane,36,17,19
19500,Hoçuspoçus,moon-guard,1448,mage,arcane,89,43,46
19501,Swàn,stormrage,1444,mage,arcane,42,23,19
19502,Ligmmah,stormrage,1440,mage,arcane,69,39,30
19503,Caseyjelly,tichondrius,1436,mage,arcane,36,20,16
19504,Sáron,quelthalas,1431,mage,arcane,78,41,37
19505,Parapio,tichondrius,1426,mage,arcane,38,20,18
19506,Wretchy,ragnaros,1412,mage,arcane,67,34,33
19507,Allýria,stormrage,1395,mage,arcane,42,18,24
19508,Söngs,goldrinn,1387,mage,arcane,24,15,9
19509,Frozonnee,aggramar,1379,mage,arcane,24,15,9
19510,Wizzyx,illidan,1373,mage,arcane,40,21,19
19511,Castarcane,nordrassil,1370,mage,arcane,36,17,19
19512,Pufs,stormrage,1369,mage,arcane,41,20,21
19513,Kickpollyplx,lothar,1368,mage,arcane,71,45,26
19514,Lünå,onyxia,1366,mage,arcane,60,35,25
19515,Avandal,proudmoore,1362,mage,arcane,71,29,42
19516,Raazzamage,moon-guard,1360,mage,arcane,81,44,37
19517,Somariais,illidan,1355,mage,arcane,90,43,47
19518,Astrojrue,sargeras,1353,mage,arcane,41,21,20
19519,Melkra,tichondrius,1348,mage,arcane,66,36,30
19520,Xtymhxy,tichondrius,1343,mage,arcane,18,14,4
19521,Szrp,stormrage,1336,mage,arcane,57,27,30
19522,Blaxmagic,stormrage,1333,mage,arcane,78,34,44
19523,Måndias,tichondrius,1328,mage,arcane,34,18,16
19524,Themagicman,whisperwind,1324,mage,arcane,42,17,25
19525,Zayth,silvermoon,1315,mage,arcane,45,24,21
19526,Coôler,illidan,1313,mage,arcane,39,16,23
19527,Zukoprince,azralon,1312,mage,arcane,24,14,10
19528,Linkolni,azralon,1312,mage,arcane,111,59,52
19529,Ruzam,area-52,1303,mage,arcane,186,91,95
19530,Draell,drakkari,1301,mage,arcane,54,30,24
19531,Véyda,emerald-dream,1300,mage,arcane,60,30,30
19532,Airbnb,area-52,1299,mage,arcane,46,26,20
19533,Valrendor,nazjatar,1298,mage,arcane,96,54,42
19534,Gin,nemesis,1296,mage,arcane,48,24,24
19535,Chezzmasterx,misha,1289,mage,arcane,69,34,35
19536,Gryd,area-52,1283,mage,arcane,112,62,50
19537,Chelseâ,emerald-dream,1281,mage,arcane,59,28,31
19538,Zulugara,barthilas,1277,mage,arcane,40,18,22
19539,Fruitdealerr,tichondrius,1266,mage,arcane,54,29,25
19540,Jedamere,proudmoore,1260,mage,arcane,48,23,25
19541,Oharvestero,illidan,1258,mage,arcane,55,27,28
19542,Strêss,kelthuzad,1255,mage,arcane,123,60,63
19543,Antifreezex,tichondrius,1253,mage,arcane,76,43,33
19544,Sorankim,tichondrius,1248,mage,arcane,24,13,11
19545,Nightsaber,blackrock,1247,mage,arcane,18,13,5
19546,Gessin,area-52,1245,mage,arcane,100,50,50
19547,Velvetlurker,sargeras,1243,mage,arcane,30,13,17
19548,Unlike,sargeras,1235,mage,arcane,71,29,42
19549,Edisia,moon-guard,1231,mage,arcane,24,13,11
19550,Magicos,frostmourne,1229,mage,arcane,24,13,11
19551,Myrondor,tichondrius,1227,mage,arcane,24,13,11
19552,Smoks,stormrage,1223,mage,arcane,50,25,25
19553,Nedrin,nemesis,1216,mage,arcane,96,46,50
19554,Kevymarts,tichondrius,1210,mage,arcane,36,14,22
19555,Cokézero,frostmourne,1200,mage,arcane,55,30,25
19556,Skywalkerino,azralon,1194,mage,arcane,151,76,75
19557,Dereliction,nagrand,1185,mage,arcane,102,52,50
19558,Softbody,barthilas,1179,mage,arcane,86,40,46
19559,Freehoñgkong,tichondrius,1177,mage,arcane,42,20,22
19560,Privilege,dragonmaw,1174,mage,arcane,41,20,21
19561,Greenwise,illidan,1170,mage,arcane,54,28,26
19562,Yonzho,area-52,1160,mage,arcane,20,13,7
19563,Fearhades,drakkari,1159,mage,arcane,24,13,11
19564,Sceledrus,quelthalas,1158,mage,arcane,42,21,21
19565,Nekrobear,nemesis,1150,mage,arcane,36,16,20
19566,Frozorfs,tichondrius,1141,mage,arcane,36,14,22
19567,Wasami,tichondrius,1140,mage,arcane,24,12,12
19568,Buffmages,malfurion,1135,mage,arcane,18,12,6
19569,Firehawk,azralon,1133,mage,arcane,24,15,9
19570,Billzeye,dalaran,1128,mage,arcane,24,12,12
19571,Numaïr,kiljaeden,1128,mage,arcane,30,14,16
19572,Nunezz,mannoroth,1123,mage,arcane,54,27,27
19573,Badwoman,tichondrius,1111,mage,arcane,36,13,23
19574,Kaiokenxten,bleeding-hollow,1102,mage,arcane,29,12,17
19575,Celciius,stormrage,1098,mage,arcane,56,18,38
19576,Oyagi,moon-guard,1097,mage,arcane,89,42,47
19577,Klausgc,sargeras,1084,mage,arcane,20,12,8
19578,Overratedxd,moon-guard,1084,mage,arcane,24,12,12
19579,Xakura,dragonmaw,1084,mage,arcane,29,14,15
19580,Chëryl,proudmoore,1061,mage,arcane,240,111,129
19581,Randalf,dragonmaw,1056,mage,arcane,24,15,9
19582,Flaux,sargeras,1055,mage,arcane,18,11,7
19583,Tommagic,tichondrius,1055,mage,arcane,30,11,19
19584,Glaciated,the-forgotten-coast,1053,mage,arcane,24,11,13
19585,Shmage,dragonmaw,1050,mage,arcane,24,11,13
19586,Oogleymoogly,zuljin,1040,mage,arcane,24,11,13
19587,Cassanara,moon-guard,1032,mage,arcane,36,13,23
19588,Thetodd,emerald-dream,1017,mage,arcane,24,16,8
19589,Kittikk,tichondrius,1005,mage,arcane,119,53,66
19590,Maiddan,azralon,1000,mage,arcane,26,12,14
19591,Döömsage,hydraxis,999,mage,arcane,23,11,12
19592,Kyrumage,illidan,998,mage,arcane,34,15,19
19593,Knotyouagain,emerald-dream,996,mage,arcane,54,31,23
19594,Casarenarrus,staghelm,985,mage,arcane,24,13,11
19595,Raeign,frostmourne,972,mage,arcane,141,67,74
19596,Mixler,feathermoon,970,mage,arcane,65,32,33
19597,Windwìtch,quelthalas,960,mage,arcane,18,10,8
19598,Jazzgroyper,sargeras,960,mage,arcane,24,10,14
19599,Lightsoran,tichondrius,960,mage,arcane,24,10,14
19600,Gachaguy,bleeding-hollow,960,mage,arcane,30,10,20
19601,Buyßitcoin,sargeras,959,mage,arcane,18,10,8
19602,Icydubya,illidan,958,mage,arcane,12,10,2
19603,Zerathremar,proudmoore,958,mage,arcane,18,10,8
19604,Alùcârd,tichondrius,958,mage,arcane,18,10,8
19605,Eruilúvatar,nerzhul,956,mage,arcane,30,17,13
19606,Haze,hyjal,955,mage,arcane,18,10,8
19607,Firèballin,tichondrius,955,mage,arcane,24,10,14
19608,Tagere,moon-guard,954,mage,arcane,24,10,14
19609,Orderlight,alexstrasza,954,mage,arcane,24,10,14
19610,Gusmaged,stormrage,953,mage,arcane,16,11,5
19611,Wizfajita,malganis,951,mage,arcane,24,10,14
19612,Tessar,moon-guard,951,mage,arcane,24,10,14
19613,Sksteve,rexxar,948,mage,arcane,30,10,20
19614,Wøogles,sargeras,946,mage,arcane,24,10,14
19615,Harmful,frostmourne,944,mage,arcane,21,10,11
19616,Morkleen,korgath,943,mage,arcane,30,10,20
19617,Shadows,exodar,934,mage,arcane,24,10,14
19618,Mahe,andorhal,928,mage,arcane,56,20,36
19619,Akagamix,sargeras,924,mage,arcane,36,17,19
19620,Dietdeww,borean-tundra,913,mage,arcane,18,10,8
19621,Khierlana,hellscream,910,mage,arcane,90,38,52
19622,Tsarevich,fizzcrank,907,mage,arcane,72,29,43
19623,Mastablastar,windrunner,899,mage,arcane,23,10,13
19624,Baskal,area-52,886,mage,arcane,28,10,18
19625,Littlefun,tichondrius,878,mage,arcane,11,10,1
19626,Søkø,tichondrius,868,mage,arcane,30,11,19
19627,Viôlentj,area-52,863,mage,arcane,12,9,3
19628,Arcalìte,illidan,863,mage,arcane,15,10,5
19629,Pandazed,proudmoore,863,mage,arcane,18,9,9
19630,Harshx,bleeding-hollow,863,mage,arcane,18,9,9
19631,Moond,drakkari,858,mage,arcane,18,9,9
19632,Mageyoulooks,kelthuzad,856,mage,arcane,24,9,15
19633,Magicå,area-52,845,mage,arcane,12,9,3
19634,Waef,quelthalas,838,mage,arcane,18,9,9
19635,Instataterz,eonar,833,mage,arcane,29,9,20
19636,Sherian,queldorei,832,mage,arcane,18,9,9
19637,Jackson,altar-of-storms,809,mage,arcane,60,17,43
19638,Fredcouples,tichondrius,803,mage,arcane,19,10,9
19639,Kirayu,gilneas,798,mage,arcane,16,9,7
19640,Unmix,tichondrius,794,mage,arcane,20,9,11
19641,Lewpithy,area-52,768,mage,arcane,12,8,4
19642,Cinnamon,boulderfist,768,mage,arcane,12,8,4
19643,Eludin,aegwynn,768,mage,arcane,18,8,10
19644,Hynzie,barthilas,768,mage,arcane,18,8,10
19645,Jööz,deathwing,768,mage,arcane,18,8,10
19646,Arcanatos,emerald-dream,767,mage,arcane,12,8,4
19647,Crøwgawd,tichondrius,767,mage,arcane,12,8,4
19648,Watchmepog,tichondrius,767,mage,arcane,12,8,4
19649,Azeroth,boulderfist,767,mage,arcane,13,8,5
19650,Fakebusiness,area-52,767,mage,arcane,18,8,10
19651,Fasttwitch,kiljaeden,767,mage,arcane,24,8,16
19652,Delana,darkspear,766,mage,arcane,24,8,16
19653,Boredmoomoo,thunderlord,765,mage,arcane,12,8,4
19654,Gimani,tichondrius,765,mage,arcane,18,8,10
19655,Archtype,azralon,764,mage,arcane,24,8,16
19656,Simongof,tichondrius,763,mage,arcane,24,8,16
19657,Iseltwald,proudmoore,761,mage,arcane,12,8,4
19658,Christensen,stormrage,761,mage,arcane,18,8,10
19659,Xplozion,lightninghoof,749,mage,arcane,19,10,9
19660,Aycc,tichondrius,735,mage,arcane,17,8,9
19661,Ebah,tichondrius,734,mage,arcane,20,9,11
19662,Perkaset,turalyon,703,mage,arcane,17,8,9
19663,Drainbamage,coilfang,689,mage,arcane,124,35,89
19664,Noescaping,illidan,687,mage,arcane,19,8,11
19665,Sazza,tichondrius,672,mage,arcane,12,7,5
19666,Poggywoggy,frostmourne,672,mage,arcane,12,7,5
19667,Feorbxx,proudmoore,672,mage,arcane,12,7,5
19668,Frostituty,kiljaeden,672,mage,arcane,12,7,5
19669,Rof,sargeras,672,mage,arcane,12,7,5
19670,Lavaera,illidan,672,mage,arcane,12,7,5
19671,Vixen,boulderfist,672,mage,arcane,12,7,5
19672,Umpire,boulderfist,672,mage,arcane,12,7,5
19673,Valériemeow,tichondrius,672,mage,arcane,18,7,11
19674,Garrieto,sargeras,671,mage,arcane,12,7,5
19675,Zezima,spirestone,671,mage,arcane,12,7,5
19676,Mershon,tichondrius,671,mage,arcane,12,7,5
19677,Murr,boulderfist,671,mage,arcane,12,7,5
19678,Ankidar,quelthalas,671,mage,arcane,18,7,11
19679,Austere,boulderfist,670,mage,arcane,12,7,5
19680,Warthormage,stormrage,670,mage,arcane,12,7,5
19681,Derkrìeger,turalyon,670,mage,arcane,18,7,11
19682,Zimzum,bladefist,666,mage,arcane,12,7,5
19683,Cubanarox,gallywix,661,mage,arcane,24,7,17
19684,Brazcane,skullcrusher,655,mage,arcane,17,7,10
19685,Karamzov,zuljin,652,mage,arcane,24,7,17
19686,Arcanochillz,ghostlands,621,mage,arcane,21,8,13
19687,Uhh,blackrock,607,mage,arcane,14,7,7
19688,Moogician,aerie-peak,592,mage,arcane,13,7,6
19689,Asalumm,quelthalas,589,mage,arcane,19,8,11
19690,Fryry,dalaran,576,mage,arcane,12,6,6
19691,Aeghis,stormrage,576,mage,arcane,12,6,6
19692,Astroner,frostmourne,576,mage,arcane,12,6,6
19693,Onibeef,duskwood,576,mage,arcane,12,6,6
19694,Rebornganegg,tichondrius,576,mage,arcane,12,6,6
19695,Icecreamboy,tichondrius,576,mage,arcane,12,6,6
19696,Afasge,illidan,576,mage,arcane,12,6,6
19697,Biscobush,turalyon,576,mage,arcane,15,7,8
19698,Fuchsia,boulderfist,576,mage,arcane,18,6,12
19699,Eimm,stormrage,576,mage,arcane,18,6,12
19700,Nazmagus,hydraxis,576,mage,arcane,18,6,12
19701,Cicciozi,sargeras,576,mage,arcane,24,6,18
19702,Snâred,aggramar,575,mage,arcane,6,6,0
19703,Nachtt,sargeras,575,mage,arcane,12,6,6
19704,Kârén,aggramar,575,mage,arcane,12,6,6
19705,Furrblock,tichondrius,575,mage,arcane,18,6,12
19706,Lacouet,lightnings-blade,575,mage,arcane,24,6,18
19707,Saladguy,thrall,574,mage,arcane,18,6,12
19708,Ispell,tichondrius,573,mage,arcane,24,6,18
19709,Enfuegoe,tichondrius,571,mage,arcane,12,6,6
19710,Francious,echo-isles,566,mage,arcane,12,6,6
19711,Belven,proudmoore,559,mage,arcane,17,6,11
19712,Vires,kelthuzad,543,mage,arcane,11,6,5
19713,Skillsbro,arthas,480,mage,arcane,6,5,1
19714,Enveas,illidan,480,mage,arcane,6,5,1
19715,Zeró,frostmourne,480,mage,arcane,6,5,1
19716,Wauzcrol,quelthalas,480,mage,arcane,12,5,7
19717,Fatso,boulderfist,480,mage,arcane,12,5,7
19718,Maxtorgar,quelthalas,480,mage,arcane,12,5,7
19719,Hansol,farstriders,480,mage,arcane,12,5,7
19720,Diamondx,ragnaros,480,mage,arcane,12,5,7
19721,Dagreatone,malganis,480,mage,arcane,12,5,7
19722,Rebdoomer,skullcrusher,480,mage,arcane,12,5,7
19723,Lúpìn,zuljin,480,mage,arcane,12,5,7
19724,Markage,stormrage,480,mage,arcane,12,5,7
19725,Shäräpova,zuljin,480,mage,arcane,12,5,7
19726,Lorlene,frostmourne,480,mage,arcane,12,5,7
19727,Inmylife,tichondrius,480,mage,arcane,15,6,9
19728,Hogdog,illidan,480,mage,arcane,18,5,13
19729,Sweetypie,fenris,479,mage,arcane,12,5,7
19730,Corsten,aerie-peak,479,mage,arcane,12,5,7
19731,Mandrakë,nemesis,478,mage,arcane,12,5,7
19732,Shocknawes,illidan,478,mage,arcane,15,5,10
19733,Humpadumplin,wyrmrest-accord,478,mage,arcane,24,5,19
19734,Merlon,dalaran,476,mage,arcane,12,5,7
19735,Culours,stormrage,472,mage,arcane,12,5,7
19736,Combusty,sargeras,447,mage,arcane,14,6,8
19737,Squishymage,moon-guard,446,mage,arcane,17,5,12
19738,Tubby,boulderfist,431,mage,arcane,11,5,6
19739,Larouse,quelthalas,415,mage,arcane,8,5,3
19740,Cømbust,frostmourne,384,mage,arcane,6,4,2
19741,Meroki,anetheron,384,mage,arcane,6,4,2
19742,Skoals,thrall,384,mage,arcane,6,4,2
19743,Chilléd,tichondrius,384,mage,arcane,6,4,2
19744,Hasteboy,kelthuzad,384,mage,arcane,6,4,2
19745,Tuggernaug,malganis,384,mage,arcane,6,4,2
19746,Wanming,tichondrius,384,mage,arcane,6,4,2
19747,Olympicz,kelthuzad,384,mage,arcane,6,4,2
19748,Riddickl,malfurion,384,mage,arcane,6,4,2
19749,Shawarms,tichondrius,384,mage,arcane,6,4,2
19750,Imbusting,kiljaeden,384,mage,arcane,6,4,2
19751,Rositajonez,terenas,384,mage,arcane,6,4,2
19752,Gelokay,tichondrius,384,mage,arcane,6,4,2
19753,Gandwàrf,moon-guard,384,mage,arcane,6,4,2
19754,Jordèb,sargeras,384,mage,arcane,6,4,2
19755,Myzzl,kelthuzad,384,mage,arcane,6,4,2
19756,Dogmagetw,tichondrius,384,mage,arcane,6,4,2
19757,Kynjji,azshara,384,mage,arcane,6,4,2
19758,Pwnstarx,proudmoore,384,mage,arcane,12,4,8
19759,Granmago,azralon,384,mage,arcane,12,4,8
19760,Bigbuttangel,borean-tundra,384,mage,arcane,12,4,8
19761,Muskinite,maiev,384,mage,arcane,12,4,8
19762,Sukaretto,illidan,384,mage,arcane,12,4,8
19763,Khaldyn,tichondrius,384,mage,arcane,12,4,8
19764,Scxut,tichondrius,384,mage,arcane,12,4,8
19765,Gobbstoppers,dalaran,384,mage,arcane,12,4,8
19766,Forestella,tichondrius,384,mage,arcane,12,4,8
19767,Nesomage,destromath,384,mage,arcane,12,4,8
19768,Hogslop,saurfang,384,mage,arcane,12,4,8
19769,Frostecho,moon-guard,384,mage,arcane,12,4,8
19770,Biotic,kiljaeden,384,mage,arcane,12,4,8
19771,Seaon,malganis,383,mage,arcane,6,4,2
19772,Hànk,tichondrius,383,mage,arcane,6,4,2
19773,Skoffla,executus,383,mage,arcane,6,4,2
19774,Raxxor,muradin,383,mage,arcane,6,4,2
19775,Sènding,sargeras,383,mage,arcane,18,4,14
19776,Preckwinkle,moon-guard,382,mage,arcane,12,4,8
19777,Dchee,nerzhul,381,mage,arcane,12,4,8
19778,Keepinitnoob,tichondrius,351,mage,arcane,8,5,3
19779,Ærtai,black-dragonflight,304,mage,arcane,7,4,3
19780,Grarg,stormrage,301,mage,arcane,13,4,9
19781,Jizzlez,tichondrius,288,mage,arcane,6,3,3
19782,Annalee,ragnaros,288,mage,arcane,6,3,3
19783,Watchmesleep,tichondrius,288,mage,arcane,6,3,3
19784,Natzue,sargeras,288,mage,arcane,6,3,3
19785,Xythros,stormrage,288,mage,arcane,6,3,3
19786,Fennix,ragnaros,288,mage,arcane,6,3,3
19787,Zerodium,sargeras,288,mage,arcane,6,3,3
19788,Yaya,kargath,288,mage,arcane,6,3,3
19789,Ksauce,twisting-nether,288,mage,arcane,6,3,3
19790,Rotaco,illidan,288,mage,arcane,6,3,3
19791,Koro,tichondrius,288,mage,arcane,6,3,3
19792,Bigmunkee,the-venture-co,288,mage,arcane,6,3,3
19793,Bobbyyx,sargeras,288,mage,arcane,6,3,3
19794,Kev,sentinels,288,mage,arcane,6,3,3
19795,Smãlls,sargeras,288,mage,arcane,6,3,3
19796,Madpoondog,frostmourne,288,mage,arcane,6,3,3
19797,Adrazell,sargeras,288,mage,arcane,6,3,3
19798,Xzude,korgath,288,mage,arcane,6,3,3
19799,Neverbroke,illidan,288,mage,arcane,6,3,3
19800,Triuneward,tichondrius,288,mage,arcane,6,3,3
19801,Kogin,thrall,288,mage,arcane,6,3,3
19802,Kasius,kelthuzad,288,mage,arcane,6,3,3
19803,Crøwgxd,tichondrius,288,mage,arcane,6,3,3
19804,Zakume,stormrage,288,mage,arcane,6,3,3
19805,Unknownblast,kul-tiras,288,mage,arcane,6,3,3
19806,Arkanons,azralon,288,mage,arcane,12,5,7
19807,Levalol,aggramar,288,mage,arcane,10,4,6
19808,Heflash,azralon,288,mage,arcane,12,3,9
19809,Skittels,azshara,288,mage,arcane,12,3,9
19810,Elux,whisperwind,288,mage,arcane,12,3,9
19811,Matmagic,drakkari,288,mage,arcane,13,3,10
19812,Compactor,emerald-dream,288,mage,arcane,18,3,15
19813,Calcaster,aegwynn,287,mage,arcane,6,3,3
19814,Kryptekk,area-52,287,mage,arcane,6,3,3
19815,Hýdro,ghostlands,287,mage,arcane,6,3,3
19816,Ìgnìtìöñ,whisperwind,287,mage,arcane,12,3,9
19817,Shinneex,ragnaros,287,mage,arcane,12,3,9
19818,Ottsca,emerald-dream,286,mage,arcane,6,3,3
19819,Prosperoo,aerie-peak,286,mage,arcane,6,3,3
19820,Arcanin,thunderlord,285,mage,arcane,12,3,9
19821,Sausage,boulderfist,276,mage,arcane,16,6,10
19822,Etyx,tichondrius,239,mage,arcane,5,3,2
19823,Pay,nordrassil,223,mage,arcane,9,3,6
19824,Røcco,azralon,192,mage,arcane,4,3,1
19825,Xpez,stormrage,192,mage,arcane,6,2,4
19826,Maguín,tichondrius,192,mage,arcane,6,2,4
19827,Blastgodx,stormrage,192,mage,arcane,6,2,4
19828,Sðsa,stormrage,192,mage,arcane,6,2,4
19829,Blinkmind,stormrage,192,mage,arcane,6,2,4
19830,Akunimon,ragnaros,192,mage,arcane,6,2,4
19831,Shareholder,stormrage,192,mage,arcane,6,2,4
19832,Fakelovè,area-52,192,mage,arcane,6,2,4
19833,Wayferz,illidan,192,mage,arcane,6,2,4
19834,Duffs,hyjal,192,mage,arcane,6,2,4
19835,Aenomaus,stormrage,192,mage,arcane,6,2,4
19836,Vensyr,stormrage,192,mage,arcane,6,2,4
19837,Highafrn,area-52,192,mage,arcane,6,2,4
19838,Suicune,area-52,192,mage,arcane,6,2,4
19839,Ferdabombs,tichondrius,192,mage,arcane,6,2,4
19840,Lilfruitsnac,illidan,192,mage,arcane,6,2,4
19841,Ichor,blackhand,192,mage,arcane,6,2,4
19842,Arcp,illidan,192,mage,arcane,6,2,4
19843,Sheepshot,dentarg,192,mage,arcane,6,2,4
19844,Tarmiel,quelthalas,192,mage,arcane,6,2,4
19845,Icebish,skullcrusher,192,mage,arcane,6,2,4
19846,Opiumlord,tichondrius,192,mage,arcane,6,2,4
19847,Mymaage,andorhal,192,mage,arcane,6,2,4
19848,Emden,khadgar,192,mage,arcane,6,2,4
19849,Alìv,tichondrius,192,mage,arcane,6,2,4
19850,Magekofwa,tichondrius,192,mage,arcane,6,2,4
19851,Yellowfevrz,thrall,192,mage,arcane,6,2,4
19852,Pullmefingy,illidan,192,mage,arcane,6,2,4
19853,Chinkins,illidan,192,mage,arcane,6,2,4
19854,Xannymancan,tichondrius,192,mage,arcane,6,2,4
19855,Burna,amanthul,192,mage,arcane,6,2,4
19856,Caimil,echo-isles,192,mage,arcane,6,2,4
19857,Slowmobius,tichondrius,192,mage,arcane,6,2,4
19858,Vengx,tichondrius,192,mage,arcane,6,2,4
19859,Shimmerpoly,sargeras,192,mage,arcane,6,2,4
19860,Xunalatu,frostmourne,192,mage,arcane,6,2,4
19861,Umber,dreadmaul,192,mage,arcane,6,2,4
19862,Crinkit,frostmourne,192,mage,arcane,6,2,4
19863,Rahahm,altar-of-storms,192,mage,arcane,12,2,10
19864,Barbarabush,hellscream,192,mage,arcane,12,2,10
19865,Amoredis,the-venture-co,192,mage,arcane,12,2,10
19866,Gatka,quelthalas,192,mage,arcane,12,2,10
19867,Mcshwackin,area-52,192,mage,arcane,12,2,10
19868,Lifeinaday,proudmoore,191,mage,arcane,6,2,4
19869,Nevswrld,stormrage,191,mage,arcane,24,2,22
19870,Vengefuly,tichondrius,138,mage,arcane,6,3,3
19871,Milfmaster,aerie-peak,138,mage,arcane,8,3,5
19872,Respektwaman,tichondrius,128,mage,arcane,4,2,2
19873,Pyropie,frostmourne,96,mage,arcane,3,2,1
19874,Purpledrank,nagrand,96,mage,arcane,9,2,7
19875,Magicious,tichondrius,96,mage,arcane,6,1,5
19876,Telkham,tichondrius,96,mage,arcane,6,1,5
19877,Quinnfreeze,boulderfist,96,mage,arcane,6,1,5
19878,Flomin,tichondrius,96,mage,arcane,6,1,5
19879,Pollybot,tichondrius,96,mage,arcane,6,1,5
19880,Trippy,senjin,96,mage,arcane,6,1,5
19881,Singheart,tichondrius,96,mage,arcane,6,1,5
19882,Mageki,ragnaros,96,mage,arcane,6,1,5
19883,Sula,muradin,96,mage,arcane,6,1,5
19884,Ignit,stormrage,96,mage,arcane,6,1,5
19885,Coldrin,tichondrius,96,mage,arcane,6,1,5
19886,Smôl,emerald-dream,96,mage,arcane,6,1,5
19887,Xlordpagan,sargeras,96,mage,arcane,6,1,5
19888,Hvnlyfathr,stormrage,96,mage,arcane,6,1,5
19889,Sabrita,proudmoore,96,mage,arcane,6,1,5
19890,Krazsus,tichondrius,96,mage,arcane,6,1,5
19891,Harquillen,dathremar,96,mage,arcane,6,1,5
19892,Octané,illidan,96,mage,arcane,6,1,5
19893,Darthez,darkspear,96,mage,arcane,6,1,5
19894,Copperfield,dreadmaul,96,mage,arcane,6,1,5
19895,Hhavok,scarlet-crusade,96,mage,arcane,6,1,5
19896,Nazztwren,bleeding-hollow,96,mage,arcane,6,1,5
19897,Helloimazu,gilneas,96,mage,arcane,6,1,5
19898,Genozyde,elune,96,mage,arcane,6,1,5
19899,Needmyvape,moon-guard,96,mage,arcane,6,1,5
19900,Omnislasher,terenas,96,mage,arcane,6,1,5
19901,Burrbon,area-52,96,mage,arcane,6,1,5
19902,Illúmi,moon-guard,96,mage,arcane,6,1,5
19903,Gôøglëlòl,nemesis,96,mage,arcane,6,1,5
19904,Noyade,illidan,96,mage,arcane,6,1,5
19905,Elemenopi,thrall,96,mage,arcane,6,1,5
19906,Greaterbust,tichondrius,96,mage,arcane,12,1,11
19907,Nikittomage,echo-isles,96,mage,arcane,12,1,11
19908,Sahaquiel,tichondrius,96,mage,arcane,12,1,11
19909,Kralien,dalaran,95,mage,arcane,6,1,5
19910,Poofnpass,malorne,95,mage,arcane,6,1,5
19911,Scribe,anvilmar,79,mage,arcane,5,1,4
19912,Pyroeuphoria,dark-iron,79,mage,arcane,5,1,4
19913,Frostmaul,dreadmaul,79,mage,arcane,11,1,10
19914,Frostybihh,bonechewer,42,mage,arcane,9,2,7
19915,Sol,shandris,2180,mage,fire,90,46,44
19916,Vcamus,tichondrius,2159,mage,fire,122,66,56
19917,Setback,illidan,2122,mage,fire,138,69,69
19918,Hansol,farstriders,2120,mage,fire,84,42,42
19919,Ranj,tichondrius,2110,mage,fire,103,51,52
19920,Horoba,sargeras,2107,mage,fire,305,154,151
19921,Setbackx,illidan,2105,mage,fire,96,47,49
19922,Valériemeow,tichondrius,2097,mage,fire,115,57,58
19923,Asetback,illidan,2081,mage,fire,156,78,78
19924,Benisp,stormrage,2070,mage,fire,98,56,42
19925,Kyphosis,illidan,2054,mage,fire,113,68,45
19926,Talibandzx,sargeras,2042,mage,fire,159,77,82
19927,Bigfirebat,tichondrius,2024,mage,fire,191,98,93
19928,Kasperkar,illidan,2022,mage,fire,293,149,144
19929,Taylorlol,tichondrius,2019,mage,fire,141,67,74
19930,Adjudicatory,tichondrius,2003,mage,fire,69,34,35
19931,Undeadmerlin,zuljin,1985,mage,fire,72,39,33
19932,Purpscurp,illidan,1980,mage,fire,159,91,68
19933,Xiaoxiaochu,tichondrius,1973,mage,fire,205,119,86
19934,Vcamusorz,tichondrius,1970,mage,fire,166,87,79
19935,Sorcerous,bloodhoof,1965,mage,fire,181,108,73
19936,Udmx,zuljin,1959,mage,fire,91,54,37
19937,Aeghis,stormrage,1958,mage,fire,48,26,22
19938,Getmaged,bleeding-hollow,1943,mage,fire,64,40,24
19939,Dáddyshark,sargeras,1941,mage,fire,187,90,97
19940,Háté,ragnaros,1931,mage,fire,217,106,111
19941,Gohonn,emerald-dream,1924,mage,fire,183,100,83
19942,Peachygamer,stormscale,1921,mage,fire,198,99,99
19943,Starxen,tichondrius,1915,mage,fire,54,31,23
19944,Poundcakezx,tichondrius,1905,mage,fire,54,28,26
19945,Sorankim,tichondrius,1893,mage,fire,54,30,24
19946,Vazlgs,tichondrius,1872,mage,fire,78,44,34
19947,Rmxd,malganis,1870,mage,fire,102,54,48
19948,Nightsaber,blackrock,1869,mage,fire,42,26,16
19949,Notini,azralon,1862,mage,fire,149,74,75
19950,Ròÿ,area-52,1861,mage,fire,72,37,35
19951,Opisop,kelthuzad,1858,mage,fire,60,32,28
19952,Fixrexbaxlls,tichondrius,1852,mage,fire,84,47,37
19953,Sunskim,tichondrius,1851,mage,fire,76,37,39
19954,Creaystar,area-52,1843,mage,fire,268,139,129
19955,Degen,laughing-skull,1842,mage,fire,46,31,15
19956,Ksmackm,illidan,1842,mage,fire,65,34,31
19957,Wanming,tichondrius,1831,mage,fire,78,44,34
19958,Pinkmagetko,tichondrius,1830,mage,fire,48,26,22
19959,Vampìrelolz,tichondrius,1828,mage,fire,47,25,22
19960,Csx,turalyon,1826,mage,fire,132,73,59
19961,Cinnablast,darkspear,1824,mage,fire,26,20,6
19962,Yorgøs,ragnaros,1824,mage,fire,90,49,41
19963,Fwooshinator,malganis,1823,mage,fire,71,56,15
19964,Epod,illidan,1823,mage,fire,78,36,42
19965,Dmgdaddy,zuljin,1822,mage,fire,42,20,22
19966,Såni,tichondrius,1819,mage,fire,67,39,28
19967,Téhflip,tichondrius,1818,mage,fire,60,37,23
19968,Kraxos,stormrage,1814,mage,fire,108,62,46
19969,Yaya,kargath,1811,mage,fire,105,51,54
19970,Wiredcc,illidan,1805,mage,fire,30,20,10
19971,Daddymayhem,proudmoore,1800,mage,fire,138,71,67
19972,Juju,tichondrius,1796,mage,fire,75,44,31
19973,Alenikus,blackhand,1791,mage,fire,143,77,66
19974,Zoryack,azralon,1784,mage,fire,174,89,85
19975,Kindle,malorne,1773,mage,fire,80,47,33
19976,Icetomeetyu,bleeding-hollow,1773,mage,fire,191,95,96
19977,Snoogma,illidan,1772,mage,fire,41,30,11
19978,Charkoalzz,moon-guard,1771,mage,fire,71,34,37
19979,Volkazar,sargeras,1766,mage,fire,39,21,18
19980,Käxs,ragnaros,1762,mage,fire,42,21,21
19981,Aigam,hyjal,1740,mage,fire,30,22,8
19982,Deepgodsz,azralon,1738,mage,fire,51,28,23
19983,Gelußabadook,kelthuzad,1733,mage,fire,36,24,12
19984,Dexpy,tichondrius,1732,mage,fire,43,26,17
19985,Farragan,ragnaros,1732,mage,fire,48,21,27
19986,Mana,shuhalo,1730,mage,fire,45,32,13
19987,Ogfresh,area-52,1725,mage,fire,88,54,34
19988,Stergenutfr,tichondrius,1720,mage,fire,42,27,15
19989,Englavian,frostmane,1709,mage,fire,54,28,26
19990,Snaregodx,area-52,1707,mage,fire,30,21,9
19991,Wizarts,ragnaros,1704,mage,fire,78,34,44
19992,Mângo,frostmourne,1699,mage,fire,24,18,6
19993,Highms,stormrage,1699,mage,fire,60,30,30
19994,Muztaccio,tichondrius,1697,mage,fire,77,43,34
19995,Likebutter,tichondrius,1695,mage,fire,30,22,8
19996,Younghehe,tichondrius,1692,mage,fire,148,77,71
19997,Myrondor,tichondrius,1691,mage,fire,106,60,46
19998,Benjamming,ragnaros,1687,mage,fire,48,30,18
19999,Dagreatone,malganis,1687,mage,fire,46,24,22
20000,Banquetmeal,emerald-dream,1686,mage,fire,42,27,15
20001,Thxo,hyjal,1683,mage,fire,123,61,62
20002,Salvick,emerald-dream,1676,mage,fire,52,27,25
20003,Nickioxox,tichondrius,1674,mage,fire,24,18,6
20004,Bighot,tichondrius,1673,mage,fire,90,53,37
20005,Ligmmah,stormrage,1670,mage,fire,78,45,33
20006,Dropdeadlol,bonechewer,1669,mage,fire,96,55,41
20007,Bigdjohnson,dalaran,1668,mage,fire,72,34,38
20008,Ööf,emerald-dream,1667,mage,fire,72,33,39
20009,Asap,frostmourne,1666,mage,fire,48,26,22
20010,Wotl,tichondrius,1665,mage,fire,225,118,107
20011,Blockjkdead,frostmourne,1663,mage,fire,32,21,11
20012,Frostymart,arthas,1663,mage,fire,36,23,13
20013,Anuub,kelthuzad,1657,mage,fire,60,38,22
20014,Magibe,thrall,1652,mage,fire,36,24,12
20015,Itshug,area-52,1652,mage,fire,53,27,26
20016,Lycheeoolong,frostmourne,1649,mage,fire,38,22,16
20017,Lolololololo,kelthuzad,1647,mage,fire,234,123,111
20018,Affewxd,lothar,1646,mage,fire,96,56,40
20019,Chainpoly,area-52,1639,mage,fire,43,29,14
20020,Pootysmooch,sargeras,1639,mage,fire,54,33,21
20021,Biscobush,turalyon,1636,mage,fire,42,27,15
20022,Oi,frostwolf,1636,mage,fire,75,48,27
20023,Chionê,velen,1634,mage,fire,30,18,12
20024,Rockoe,tichondrius,1630,mage,fire,76,44,32
20025,Trippy,senjin,1630,mage,fire,60,30,30
20026,Ârcano,ragnaros,1628,mage,fire,53,29,24
20027,Murcury,tichondrius,1627,mage,fire,291,151,140
20028,Mudohir,stormrage,1627,mage,fire,58,29,29
20029,Johnpopi,malganis,1626,mage,fire,24,17,7
20030,Worldonfire,ragnaros,1626,mage,fire,201,107,94
20031,Enthy,frostmourne,1623,mage,fire,60,30,30
20032,Bigpøppapump,tichondrius,1622,mage,fire,42,19,23
20033,Tweydey,tichondrius,1621,mage,fire,30,17,13
20034,Blinkaway,ragnaros,1617,mage,fire,42,23,19
20035,Darmora,kelthuzad,1615,mage,fire,24,17,7
20036,Torched,stormreaver,1613,mage,fire,102,51,51
20037,Iblïs,kelthuzad,1612,mage,fire,24,17,7
20038,Nazmagus,hydraxis,1612,mage,fire,125,72,53
20039,Domotricks,illidan,1612,mage,fire,59,33,26
20040,Gigatuts,stormrage,1612,mage,fire,61,31,30
20041,Formi,frostmourne,1611,mage,fire,88,41,47
20042,Eazzybaby,eredar,1610,mage,fire,540,283,257
20043,Yeetcannøn,illidan,1606,mage,fire,48,26,22
20044,Albbano,tichondrius,1605,mage,fire,30,21,9
20045,Sïthfù,tichondrius,1605,mage,fire,42,27,15
20046,Zarkanis,tichondrius,1604,mage,fire,49,25,24
20047,Elysõna,area-52,1602,mage,fire,126,71,55
20048,Mushys,stormrage,1601,mage,fire,35,22,13
20049,Grynthwzrd,stormrage,1601,mage,fire,60,37,23
20050,Jardz,area-52,1597,mage,fire,42,21,21
20051,Sakurai,tichondrius,1593,mage,fire,48,28,20
20052,Tuniepop,sargeras,1592,mage,fire,94,45,49
20053,Xs,stormrage,1591,mage,fire,138,78,60
20054,Velvetlurker,tichondrius,1588,mage,fire,30,17,13
20055,Chumpp,tichondrius,1586,mage,fire,30,21,9
20056,Choccookies,illidan,1584,mage,fire,32,18,14
20057,FleasyA8713E,wyrmrest-accord,1584,mage,fire,57,30,27
20058,Zoobiz,tichondrius,1583,mage,fire,36,21,15
20059,Pzaz,moon-guard,1582,mage,fire,50,30,20
20060,Sandylove,zuljin,1582,mage,fire,36,17,19
20061,Magekylex,proudmoore,1579,mage,fire,111,66,45
20062,Hpthewizard,deathwing,1579,mage,fire,89,52,37
20063,Iceward,frostmourne,1579,mage,fire,66,30,36
20064,Engage,garrosh,1578,mage,fire,48,29,19
20065,Wqnmlgbdy,tichondrius,1575,mage,fire,36,19,17
20066,Varroc,quelthalas,1574,mage,fire,250,119,131
20067,Garbagemage,barthilas,1572,mage,fire,78,41,37
20068,Absentbrain,stormrage,1570,mage,fire,30,17,13
20069,Firewreckage,malganis,1566,mage,fire,68,31,37
20070,Xanthan,runetotem,1563,mage,fire,57,35,22
20071,Ufree,tichondrius,1562,mage,fire,29,17,12
20072,Djpolymorph,stormrage,1560,mage,fire,108,60,48
20073,Kev,sentinels,1559,mage,fire,108,58,50
20074,Marrioo,tichondrius,1556,mage,fire,60,31,29
20075,Hööva,illidan,1553,mage,fire,95,53,42
20076,Polypolypoly,kiljaeden,1550,mage,fire,28,19,9
20077,Wickymorph,barthilas,1549,mage,fire,53,25,28
20078,Jenezis,area-52,1547,mage,fire,41,17,24
20079,Leonr,tichondrius,1546,mage,fire,92,56,36
20080,Trolson,sargeras,1546,mage,fire,54,26,28
20081,Ferdabombs,tichondrius,1544,mage,fire,124,70,54
20082,Yooyar,barthilas,1543,mage,fire,191,95,96
20083,Kevymarts,tichondrius,1541,mage,fire,54,33,21
20084,Imannoyingha,darkspear,1539,mage,fire,77,41,36
20085,Diewnuts,zuljin,1538,mage,fire,96,53,43
20086,Squantanimo,shadowmoon,1537,mage,fire,87,43,44
20087,Xoese,illidan,1531,mage,fire,132,61,71
20088,Fruitdealerr,tichondrius,1530,mage,fire,66,35,31
20089,Coôler,illidan,1530,mage,fire,175,90,85
20090,Teetems,sargeras,1530,mage,fire,116,59,57
20091,Fifthelëment,emerald-dream,1529,mage,fire,119,65,54
20092,Mageonthc,korgath,1528,mage,fire,41,24,17
20093,Ultrá,stormscale,1528,mage,fire,84,49,35
20094,Bajaoreily,zangarmarsh,1528,mage,fire,42,19,23
20095,Orionmage,frostmourne,1525,mage,fire,39,18,21
20096,Willzada,azralon,1523,mage,fire,69,34,35
20097,Magicmaghar,area-52,1521,mage,fire,60,31,29
20098,Dreadparadox,bleeding-hollow,1521,mage,fire,64,31,33
20099,Sparklepoof,tichondrius,1519,mage,fire,47,26,21
20100,Crazytime,tichondrius,1519,mage,fire,42,23,19
20101,Squishymage,frostmourne,1515,mage,fire,37,19,18
20102,Gadgítte,moon-guard,1514,mage,fire,30,18,12
20103,Sabrita,proudmoore,1513,mage,fire,42,19,23
20104,Lilbabyx,stormrage,1509,mage,fire,116,60,56
20105,Mager,dentarg,1508,mage,fire,62,40,22
20106,Coneofkony,bleeding-hollow,1503,mage,fire,36,23,13
20107,Marfaz,ravencrest,1500,mage,fire,72,33,39
20108,Pòlly,illidan,1495,mage,fire,42,25,17
20109,Juul,emerald-dream,1492,mage,fire,126,62,64
20110,Pyroshima,barthilas,1492,mage,fire,101,49,52
20111,Beerandmagic,zuljin,1487,mage,fire,30,16,14
20112,Coolhandz,tichondrius,1487,mage,fire,47,24,23
20113,Dârkus,sargeras,1487,mage,fire,122,60,62
20114,Smallbrainz,emerald-dream,1485,mage,fire,84,47,37
20115,Fookz,malganis,1484,mage,fire,66,34,32
20116,Øzmage,area-52,1482,mage,fire,27,18,9
20117,Skryte,mannoroth,1473,mage,fire,64,33,31
20118,Jojomage,thrall,1473,mage,fire,138,71,67
20119,Chickenspank,stormrage,1473,mage,fire,36,18,18
20120,Jööz,deathwing,1470,mage,fire,81,40,41
20121,Anàrchy,emerald-dream,1469,mage,fire,51,29,22
20122,Hannahaa,area-52,1468,mage,fire,57,32,25
20123,Connorq,stormrage,1467,mage,fire,62,35,27
20124,Audacy,sargeras,1461,mage,fire,150,72,78
20125,Frostpimp,anubarak,1460,mage,fire,60,22,38
20126,Syntacks,lightnings-blade,1459,mage,fire,42,25,17
20127,Pyroflinger,stormrage,1459,mage,fire,131,67,64
20128,Singheart,tichondrius,1457,mage,fire,162,80,82
20129,Toastedoats,hyjal,1456,mage,fire,97,51,46
20130,Aerligar,area-52,1455,mage,fire,36,20,16
20131,Mariomario,tichondrius,1455,mage,fire,84,46,38
20132,Frogbum,fizzcrank,1454,mage,fire,34,19,15
20133,Bettybonk,cenarius,1449,mage,fire,42,20,22
20134,Grymorum,ragnaros,1448,mage,fire,42,18,24
20135,Mirimida,ragnaros,1443,mage,fire,195,104,91
20136,Firèballin,tichondrius,1441,mage,fire,31,17,14
20137,Gasolína,stormrage,1436,mage,fire,84,48,36
20138,Swaglo,illidan,1435,mage,fire,40,18,22
20139,Grandpapi,arthas,1433,mage,fire,35,20,15
20140,Sorgannon,malganis,1432,mage,fire,94,50,44
20141,Fredcouples,tichondrius,1425,mage,fire,30,17,13
20142,Streetember,nemesis,1424,mage,fire,84,36,48
20143,Snanth,black-dragonflight,1420,mage,fire,51,29,22
20144,Tigang,frostmourne,1418,mage,fire,29,17,12
20145,Skoffla,executus,1411,mage,fire,48,25,23
20146,Eekzlol,illidan,1409,mage,fire,30,16,14
20147,Zstyle,frostmourne,1406,mage,fire,67,39,28
20148,Snuurf,ragnaros,1406,mage,fire,60,31,29
20149,Ålmøst,tichondrius,1405,mage,fire,65,36,29
20150,Fakewarlockk,illidan,1403,mage,fire,30,16,14
20151,Marajaade,tichondrius,1403,mage,fire,80,38,42
20152,Mayumî,moon-guard,1401,mage,fire,34,18,16
20153,Coldcaster,mugthol,1399,mage,fire,80,45,35
20154,Whiteyx,saurfang,1399,mage,fire,52,29,23
20155,Cumbus,stormrage,1399,mage,fire,42,15,27
20156,Ruzam,area-52,1394,mage,fire,66,31,35
20157,Jundead,dalaran,1393,mage,fire,79,46,33
20158,Sydrol,area-52,1392,mage,fire,143,74,69
20159,Jizzlez,tichondrius,1392,mage,fire,48,23,25
20160,Purpledrank,nagrand,1385,mage,fire,85,39,46
20161,Leaso,tichondrius,1384,mage,fire,45,22,23
20162,Tamarolfrost,illidan,1382,mage,fire,55,29,26
20163,Wïzarduous,mannoroth,1380,mage,fire,72,38,34
20164,Ingrumatig,tichondrius,1376,mage,fire,42,18,24
20165,Aliive,tichondrius,1375,mage,fire,30,16,14
20166,Eatnu,tichondrius,1374,mage,fire,36,16,20
20167,Amge,uldum,1373,mage,fire,26,15,11
20168,Wzrdxz,tichondrius,1370,mage,fire,36,17,19
20169,Melkra,tichondrius,1366,mage,fire,70,35,35
20170,Waffles,ravencrest,1363,mage,fire,80,40,40
20171,Garungar,antonidas,1361,mage,fire,24,15,9
20172,Coltrip,azralon,1359,mage,fire,83,38,45
20173,Elwyn,dunemaul,1358,mage,fire,60,29,31
20174,Lilmj,kelthuzad,1355,mage,fire,43,19,24
20175,Magiaguarra,ragnaros,1353,mage,fire,36,17,19
20176,Wakkaflame,stormrage,1348,mage,fire,78,33,45
20177,Prinseza,quelthalas,1345,mage,fire,55,27,28
20178,Badaszbich,tichondrius,1344,mage,fire,36,20,16
20179,Hempy,mannoroth,1344,mage,fire,55,24,31
20180,Sikeyzlol,bleeding-hollow,1343,mage,fire,24,14,10
20181,Papita,mugthol,1342,mage,fire,18,14,4
20182,Alzagen,ragnaros,1342,mage,fire,80,42,38
20183,Kraftfull,azralon,1338,mage,fire,19,15,4
20184,Subscribe,malganis,1336,mage,fire,48,22,26
20185,Dearasian,ragnaros,1335,mage,fire,60,32,28
20186,Búrsting,kelthuzad,1334,mage,fire,31,16,15
20187,Adrazell,sargeras,1333,mage,fire,42,21,21
20188,Sahala,frostmourne,1333,mage,fire,60,25,35
20189,Gødvana,frostmourne,1329,mage,fire,51,28,23
20190,Gôøglëlòl,nemesis,1321,mage,fire,30,14,16
20191,Nukeit,azgalor,1320,mage,fire,42,20,22
20192,Coldrin,tichondrius,1320,mage,fire,58,27,31
20193,Carnelius,bleeding-hollow,1319,mage,fire,75,39,36
20194,Magination,frostmourne,1313,mage,fire,48,22,26
20195,Quizzard,blackrock,1310,mage,fire,28,15,13
20196,Snoü,proudmoore,1309,mage,fire,42,14,28
20197,Raisonmage,tichondrius,1308,mage,fire,60,25,35
20198,Raynark,nemesis,1307,mage,fire,30,18,12
20199,Cymbalta,azralon,1306,mage,fire,47,31,16
20200,Jjijuns,tichondrius,1302,mage,fire,40,18,22
20201,Abzy,sargeras,1294,mage,fire,72,36,36
20202,Rudeswizard,area-52,1291,mage,fire,73,32,41
20203,Flame,arthas,1288,mage,fire,48,23,25
20204,Morbøl,tichondrius,1282,mage,fire,29,17,12
20205,Hypernova,vashj,1277,mage,fire,41,19,22
20206,Akephálos,drakkari,1273,mage,fire,23,14,9
20207,Helcarwen,area-52,1261,mage,fire,60,30,30
20208,Adronicus,tichondrius,1259,mage,fire,66,33,33
20209,Licklix,tichondrius,1258,mage,fire,46,27,19
20210,Zulugara,barthilas,1258,mage,fire,36,19,17
20211,Rizzlerx,stormrage,1257,mage,fire,17,14,3
20212,Absolutepowa,bleeding-hollow,1255,mage,fire,26,14,12
20213,Dorkski,bleeding-hollow,1253,mage,fire,181,86,95
20214,Reddfire,proudmoore,1253,mage,fire,42,15,27
20215,Lorlene,frostmourne,1252,mage,fire,54,27,27
20216,Supermajor,frostmourne,1249,mage,fire,43,19,24
20217,Babysharky,uther,1249,mage,fire,34,14,20
20218,Glaucus,illidan,1247,mage,fire,18,13,5
20219,Gominsi,tichondrius,1247,mage,fire,18,13,5
20220,Leakyboots,illidan,1247,mage,fire,24,13,11
20221,Chapelrat,sargeras,1247,mage,fire,24,13,11
20222,Hüz,frostmourne,1244,mage,fire,18,13,5
20223,Kronicblast,bleeding-hollow,1240,mage,fire,63,26,37
20224,Gualter,nemesis,1239,mage,fire,36,15,21
20225,Christjan,tichondrius,1237,mage,fire,229,117,112
20226,Feogato,proudmoore,1237,mage,fire,60,29,31
20227,Sky,lightnings-blade,1237,mage,fire,30,13,17
20228,Polymedaddi,tichondrius,1236,mage,fire,36,13,23
20229,Blinksz,korgath,1235,mage,fire,30,13,17
20230,Politeness,tichondrius,1233,mage,fire,24,13,11
20231,Mongomike,stormrage,1233,mage,fire,69,30,39
20232,Christensen,stormrage,1231,mage,fire,30,17,13
20233,Slumpgodd,frostmourne,1230,mage,fire,30,13,17
20234,Dragonie,nordrassil,1224,mage,fire,45,23,22
20235,Smigui,azralon,1223,mage,fire,164,76,88
20236,Psycles,dragonmaw,1223,mage,fire,54,21,33
20237,Arrcadia,darkspear,1221,mage,fire,36,13,23
20238,Zinnos,tichondrius,1218,mage,fire,30,13,17
20239,Archtype,azralon,1217,mage,fire,18,13,5
20240,Vanairel,emerald-dream,1216,mage,fire,30,18,12
20241,Genthruz,ragnaros,1215,mage,fire,48,22,26
20242,Fíery,blades-edge,1211,mage,fire,90,42,48
20243,Putridìty,thrall,1210,mage,fire,30,16,14
20244,Halfsquad,malfurion,1208,mage,fire,24,13,11
20245,Pyrotactics,sargeras,1205,mage,fire,46,17,29
20246,Hadlly,tichondrius,1197,mage,fire,23,13,10
20247,Mageolisious,kelthuzad,1197,mage,fire,46,21,25
20248,Hositonet,malganis,1188,mage,fire,78,40,38
20249,Sorrenton,sargeras,1186,mage,fire,41,23,18
20250,Burist,illidan,1185,mage,fire,38,19,19
20251,Esfire,frostmourne,1185,mage,fire,48,23,25
20252,Vamkari,ragnaros,1178,mage,fire,42,23,19
20253,Zonmague,drakkari,1177,mage,fire,36,17,19
20254,Othokk,tichondrius,1170,mage,fire,48,21,27
20255,Iguanodon,proudmoore,1159,mage,fire,56,29,27
20256,Gradmage,proudmoore,1156,mage,fire,50,20,30
20257,Maxvila,kelthuzad,1152,mage,fire,18,12,6
20258,Jazzgroyper,sargeras,1151,mage,fire,18,12,6
20259,Technique,tichondrius,1151,mage,fire,18,12,6
20260,Kjuuler,moon-guard,1151,mage,fire,24,12,12
20261,Freaknastyxo,stormrage,1150,mage,fire,18,12,6
20262,Mágos,stormrage,1150,mage,fire,18,12,6
20263,Rhykx,malganis,1149,mage,fire,18,12,6
20264,Balmunc,proudmoore,1147,mage,fire,18,12,6
20265,Aulle,whisperwind,1146,mage,fire,18,12,6
20266,Sheepxyz,thrall,1146,mage,fire,24,12,12
20267,Jonboym,illidan,1141,mage,fire,24,12,12
20268,Fleët,tichondrius,1139,mage,fire,18,12,6
20269,Jnxzx,sargeras,1138,mage,fire,18,12,6
20270,Nachtt,sargeras,1136,mage,fire,24,12,12
20271,Usirfail,bleeding-hollow,1133,mage,fire,30,12,18
20272,Gnarwallx,stormrage,1132,mage,fire,30,12,18
20273,Trevihl,malganis,1131,mage,fire,32,16,16
20274,Priyel,hyjal,1130,mage,fire,30,15,15
20275,Xzilence,aerie-peak,1118,mage,fire,30,12,18
20276,Sánzunokawa,quelthalas,1109,mage,fire,27,16,11
20277,Isendra,bleeding-hollow,1105,mage,fire,23,12,11
20278,Noescaping,illidan,1102,mage,fire,24,12,12
20279,Pyromaster,emerald-dream,1101,mage,fire,24,13,11
20280,Saladguy,thrall,1101,mage,fire,48,17,31
20281,Wawakun,ragnaros,1098,mage,fire,42,19,23
20282,Gempette,tichondrius,1095,mage,fire,23,12,11
20283,Wazzerd,moon-guard,1093,mage,fire,27,12,15
20284,Frogpapi,illidan,1086,mage,fire,64,31,33
20285,Guccilaflur,proudmoore,1082,mage,fire,27,12,15
20286,Crnomage,area-52,1081,mage,fire,23,12,11
20287,Pikoda,azralon,1066,mage,fire,28,12,16
20288,Coldblooded,zuljin,1061,mage,fire,47,16,31
20289,Lmaginedying,illidan,1056,mage,fire,18,11,7
20290,Lightsoran,tichondrius,1055,mage,fire,18,11,7
20291,Flaux,sargeras,1055,mage,fire,18,11,7
20292,Piratecaster,kargath,1054,mage,fire,18,11,7
20293,Dbox,stormscale,1054,mage,fire,18,11,7
20294,Alorae,wyrmrest-accord,1054,mage,fire,18,11,7
20295,Marxeflamer,ragnaros,1054,mage,fire,24,11,13
20296,Lavarain,illidan,1054,mage,fire,27,11,16
20297,Avicci,shattered-halls,1054,mage,fire,30,11,19
20298,Joobi,sargeras,1053,mage,fire,24,11,13
20299,Majjix,illidan,1051,mage,fire,18,11,7
20300,Cinns,moon-guard,1051,mage,fire,24,11,13
20301,Radakos,emerald-dream,1050,mage,fire,24,11,13
20302,Kiz,zuljin,1050,mage,fire,24,11,13
20303,Orianne,windrunner,1049,mage,fire,27,19,8
20304,Aphazia,kiljaeden,1049,mage,fire,42,20,22
20305,Magalí,nemesis,1049,mage,fire,78,33,45
20306,Harlloo,the-underbog,1049,mage,fire,30,11,19
20307,Kryptekk,area-52,1048,mage,fire,24,11,13
20308,Pyroeuphoria,dark-iron,1044,mage,fire,32,13,19
20309,Erlendr,moon-guard,1041,mage,fire,44,22,22
20310,Scmage,exodar,1040,mage,fire,30,11,19
20311,Freez,garona,1037,mage,fire,27,12,15
20312,Daggoe,nazjatar,1032,mage,fire,24,11,13
20313,Palruki,tichondrius,1030,mage,fire,23,11,12
20314,Sasghengis,frostmourne,1029,mage,fire,66,33,33
20315,Søkø,tichondrius,1021,mage,fire,38,18,20
20316,Asönia,illidan,1020,mage,fire,30,11,19
20317,Pyrepad,moon-guard,1015,mage,fire,24,11,13
20318,Ops,frostmourne,1009,mage,fire,117,62,55
20319,Hotjazzfarts,sargeras,1003,mage,fire,61,35,26
20320,Minerves,tichondrius,1001,mage,fire,28,13,15
20321,Theodosa,frostmourne,988,mage,fire,18,11,7
20322,Hýdro,ghostlands,978,mage,fire,42,23,19
20323,Shashyta,drakkari,974,mage,fire,66,18,48
20324,Endmepls,ysera,965,mage,fire,96,40,56
20325,Deathlist,frostmourne,960,mage,fire,12,10,2
20326,Loopsyliu,stormrage,960,mage,fire,12,10,2
20327,Tupactopus,tichondrius,960,mage,fire,18,10,8
20328,Xythros,stormrage,960,mage,fire,18,10,8
20329,Pollybot,tichondrius,959,mage,fire,12,10,2
20330,Bis,aggramar,959,mage,fire,18,10,8
20331,Astanadora,tichondrius,959,mage,fire,18,10,8
20332,Squidio,stormrage,959,mage,fire,18,10,8
20333,Vîgïl,feathermoon,959,mage,fire,18,10,8
20334,Mokelovin,sargeras,959,mage,fire,18,10,8
20335,Fantabulous,korgath,958,mage,fire,18,10,8
20336,Zakume,stormrage,958,mage,fire,18,10,8
20337,Pyrod,tichondrius,958,mage,fire,24,10,14
20338,Preceptør,azralon,957,mage,fire,24,10,14
20339,Osh,malorne,957,mage,fire,24,10,14
20340,Alunarassra,tichondrius,956,mage,fire,24,10,14
20341,Dårks,area-52,955,mage,fire,24,10,14
20342,Ripburn,stormrage,953,mage,fire,47,20,27
20343,Etyx,tichondrius,953,mage,fire,30,10,20
20344,Flavaflame,mugthol,952,mage,fire,18,10,8
20345,Clapsyou,illidan,951,mage,fire,24,10,14
20346,Zukoprince,azralon,950,mage,fire,12,10,2
20347,Zancro,ragnaros,948,mage,fire,24,10,14
20348,Brànd,antonidas,947,mage,fire,18,11,7
20349,Abstractgoat,tichondrius,946,mage,fire,30,15,15
20350,Trollsita,thrall,945,mage,fire,18,10,8
20351,Rammers,coilfang,935,mage,fire,12,10,2
20352,Senegau,azralon,932,mage,fire,57,27,30
20353,Boptimus,moonrunner,930,mage,fire,18,10,8
20354,Coldarei,nagrand,928,mage,fire,27,12,15
20355,Xxnova,moon-guard,927,mage,fire,30,11,19
20356,Ispell,tichondrius,924,mage,fire,101,41,60
20357,Bàttlemage,nagrand,922,mage,fire,42,22,20
20358,Bloomper,stormrage,914,mage,fire,42,11,31
20359,Dojacute,frostmourne,910,mage,fire,17,10,7
20360,Alywgard,sargeras,894,mage,fire,22,10,12
20361,Beji,frostmourne,894,mage,fire,38,17,21
20362,Béssie,area-52,891,mage,fire,62,30,32
20363,Alaramaria,sargeras,886,mage,fire,18,10,8
20364,Jaysaucetv,tichondrius,878,mage,fire,19,10,9
20365,Tungstentoes,shuhalo,875,mage,fire,21,12,9
20366,Nakana,area-52,875,mage,fire,52,25,27
20367,Strêss,kelthuzad,870,mage,fire,22,12,10
20368,Tribes,dalaran,864,mage,fire,12,9,3
20369,Itizar,frostmourne,864,mage,fire,12,9,3
20370,Amage,drakthul,864,mage,fire,18,9,9
20371,Ñïz,bleeding-hollow,864,mage,fire,18,9,9
20372,Trés,ragnaros,863,mage,fire,12,9,3
20373,Fullsheep,emerald-dream,863,mage,fire,12,9,3
20374,Muhfin,tichondrius,863,mage,fire,18,9,9
20375,Minverces,tichondrius,863,mage,fire,18,9,9
20376,Gtown,kelthuzad,863,mage,fire,18,9,9
20377,Dabsx,moon-guard,863,mage,fire,18,9,9
20378,Ddouble,tichondrius,863,mage,fire,18,9,9
20379,Hittheshower,tichondrius,863,mage,fire,18,9,9
20380,Quikcast,archimonde,863,mage,fire,24,9,15
20381,Shimmerpoly,sargeras,863,mage,fire,24,9,15
20382,Avócadó,malganis,863,mage,fire,24,9,15
20383,Desfunz,mugthol,862,mage,fire,18,9,9
20384,Unknownblast,kul-tiras,862,mage,fire,26,9,17
20385,Garion,moon-guard,860,mage,fire,20,9,11
20386,Fryry,dalaran,860,mage,fire,24,9,15
20387,Magja,bloodhoof,859,mage,fire,18,9,9
20388,Baelthezer,moon-guard,858,mage,fire,21,12,9
20389,Product,mugthol,858,mage,fire,18,9,9
20390,Gadalka,frostmourne,857,mage,fire,18,9,9
20391,Dánó,lightbringer,843,mage,fire,62,26,36
20392,Umber,dreadmaul,829,mage,fire,17,9,8
20393,Midewmage,proudmoore,829,mage,fire,23,9,14
20394,Zniper,emerald-dream,823,mage,fire,24,9,15
20395,Sossmage,jaedenar,815,mage,fire,15,9,6
20396,Ljaie,lightbringer,813,mage,fire,17,9,8
20397,Vengefuly,tichondrius,809,mage,fire,20,11,9
20398,Phantose,sargeras,808,mage,fire,22,10,12
20399,Zendrix,bonechewer,806,mage,fire,30,9,21
20400,Arcanemain,kargath,799,mage,fire,42,18,24
20401,Drewann,draenor,799,mage,fire,22,9,13
20402,Certifried,emerald-dream,797,mage,fire,20,9,11
20403,Alàh,stormscale,795,mage,fire,22,9,13
20404,Almondcocoa,tichondrius,768,mage,fire,12,8,4
20405,Keepv,tichondrius,768,mage,fire,12,8,4
20406,Rendézvous,tichondrius,768,mage,fire,12,8,4
20407,Pherixsw,stormrage,768,mage,fire,12,8,4
20408,Porthúb,illidan,768,mage,fire,12,8,4
20409,Dandrix,sargeras,768,mage,fire,12,8,4
20410,Voljezus,jubeithos,768,mage,fire,12,8,4
20411,Sahlokinn,stormrage,768,mage,fire,18,8,10
20412,Original,ysera,768,mage,fire,18,8,10
20413,Castana,tichondrius,768,mage,fire,18,8,10
20414,Sunstry,tichondrius,768,mage,fire,18,8,10
20415,Hexed,kiljaeden,767,mage,fire,12,8,4
20416,Zajebisty,aegwynn,767,mage,fire,12,8,4
20417,Kawailenard,tichondrius,767,mage,fire,12,8,4
20418,Yugedamn,nazjatar,767,mage,fire,12,8,4
20419,Laradria,kiljaeden,767,mage,fire,18,8,10
20420,Snowday,nerzhul,767,mage,fire,18,8,10
20421,Preplex,thrall,767,mage,fire,18,8,10
20422,Shmoked,kelthuzad,767,mage,fire,18,8,10
20423,Mccorkle,azshara,767,mage,fire,21,9,12
20424,Wayferz,illidan,767,mage,fire,24,8,16
20425,Siayo,stormscale,767,mage,fire,30,8,22
20426,Ashenlad,moon-guard,766,mage,fire,18,8,10
20427,Zafel,tichondrius,766,mage,fire,18,8,10
20428,Magicmaster,quelthalas,765,mage,fire,24,8,16
20429,Tarmiel,quelthalas,765,mage,fire,24,8,16
20430,Wetguuch,area-52,763,mage,fire,18,8,10
20431,Spellbrker,stormrage,763,mage,fire,24,8,16
20432,Marrika,amanthul,762,mage,fire,18,8,10
20433,Bennyhana,frostwolf,761,mage,fire,12,8,4
20434,Dayv,azshara,760,mage,fire,30,8,22
20435,Isoicast,moon-guard,759,mage,fire,22,11,11
20436,Noyade,illidan,758,mage,fire,18,8,10
20437,Pyromidget,khazgoroth,756,mage,fire,18,8,10
20438,Ashex,moon-guard,750,mage,fire,24,9,15
20439,Yasmani,drakkari,738,mage,fire,28,11,17
20440,Pyrlos,terokkar,738,mage,fire,24,9,15
20441,Dìus,malganis,719,mage,fire,17,8,9
20442,Letitgoo,azralon,715,mage,fire,25,9,16
20443,Flippendicus,stormrage,697,mage,fire,36,9,27
20444,Vakina,tichondrius,690,mage,fire,27,8,19
20445,Shmagee,azralon,684,mage,fire,13,8,5
20446,Silimage,area-52,672,mage,fire,12,7,5
20447,Refreshments,bleeding-hollow,672,mage,fire,12,7,5
20448,Frankkie,mugthol,672,mage,fire,12,7,5
20449,Sos,kelthuzad,672,mage,fire,12,7,5
20450,Wînx,barthilas,672,mage,fire,12,7,5
20451,Vamplol,tichondrius,672,mage,fire,12,7,5
20452,Coldkite,tichondrius,672,mage,fire,12,7,5
20453,Nattylites,emerald-dream,672,mage,fire,12,7,5
20454,Belven,proudmoore,672,mage,fire,12,7,5
20455,Wienerjeff,area-52,672,mage,fire,12,7,5
20456,Warpfactor,malganis,672,mage,fire,12,7,5
20457,Tuggernaug,malganis,672,mage,fire,12,7,5
20458,Osirax,frostmane,672,mage,fire,12,7,5
20459,Tbh,malganis,672,mage,fire,12,7,5
20460,Vastlord,stormrage,672,mage,fire,18,7,11
20461,Sogood,tanaris,672,mage,fire,18,7,11
20462,Strumms,tichondrius,672,mage,fire,18,7,11
20463,Allhitz,ragnaros,671,mage,fire,12,7,5
20464,Keileon,tichondrius,671,mage,fire,12,7,5
20465,Lucidaze,daggerspine,671,mage,fire,12,7,5
20466,Ásune,moon-guard,671,mage,fire,12,7,5
20467,Shírley,tichondrius,671,mage,fire,12,7,5
20468,Blastfire,stormrage,671,mage,fire,12,7,5
20469,Mymrmage,mannoroth,671,mage,fire,12,7,5
20470,Maressara,sargeras,671,mage,fire,18,7,11
20471,Dreaming,draktharon,670,mage,fire,12,7,5
20472,Brutalatops,terenas,670,mage,fire,12,7,5
20473,Icepond,proudmoore,670,mage,fire,12,7,5
20474,Gribbets,stormrage,670,mage,fire,18,8,10
20475,Fanshen,tichondrius,670,mage,fire,17,7,10
20476,Ddeuuk,tichondrius,670,mage,fire,18,7,11
20477,Tmo,mannoroth,670,mage,fire,24,7,17
20478,Novice,barthilas,667,mage,fire,18,7,11
20479,Baelzharon,hellscream,667,mage,fire,18,7,11
20480,Rageymagey,azshara,665,mage,fire,24,7,17
20481,Vonfrmdao,illidan,624,mage,fire,15,8,7
20482,Tmharp,tichondrius,623,mage,fire,15,8,7
20483,Proximalol,tichondrius,607,mage,fire,11,7,4
20484,Slipqt,tichondrius,607,mage,fire,22,7,15
20485,Chumleyson,eonar,606,mage,fire,14,7,7
20486,Mômö,argent-dawn,606,mage,fire,22,7,15
20487,Mzr,proudmoore,576,mage,fire,6,6,0
20488,Strdelmaker,tichondrius,576,mage,fire,6,6,0
20489,Tearsfórgód,kelthuzad,576,mage,fire,12,6,6
20490,Eludin,aegwynn,576,mage,fire,12,6,6
20491,Juniel,bleeding-hollow,576,mage,fire,12,6,6
20492,Mageboy,bonechewer,576,mage,fire,12,6,6
20493,Magicmidget,malganis,576,mage,fire,12,6,6
20494,Magicmichel,malganis,576,mage,fire,12,6,6
20495,Toteypotter,frostmourne,576,mage,fire,12,6,6
20496,Catchmage,bleeding-hollow,576,mage,fire,12,6,6
20497,Orangemilk,hyjal,576,mage,fire,12,6,6
20498,Frostboy,borean-tundra,576,mage,fire,12,6,6
20499,Omagawd,tichondrius,576,mage,fire,12,6,6
20500,Bøfa,tichondrius,576,mage,fire,12,6,6
20501,Myfamilygpie,nazgrel,576,mage,fire,12,6,6
20502,Gnitraf,malganis,576,mage,fire,12,6,6
20503,Ghili,tichondrius,576,mage,fire,12,6,6
20504,Yupmage,tichondrius,576,mage,fire,12,6,6
20505,Rhoadies,malfurion,576,mage,fire,12,6,6
20506,Enchantress,wyrmrest-accord,576,mage,fire,12,6,6
20507,Wakamage,area-52,576,mage,fire,12,6,6
20508,Darkisfrosty,tichondrius,576,mage,fire,12,6,6
20509,Kylar,icecrown,576,mage,fire,12,6,6
20510,Cuterthanyou,sargeras,576,mage,fire,12,6,6
20511,Stratokvn,ragnaros,576,mage,fire,12,6,6
20512,Kaylemage,tichondrius,576,mage,fire,12,6,6
20513,Jajaragnaros,bleeding-hollow,576,mage,fire,12,6,6
20514,Fullsénd,tichondrius,576,mage,fire,12,6,6
20515,Thalanar,barthilas,576,mage,fire,12,6,6
20516,Plutón,tichondrius,576,mage,fire,12,6,6
20517,Crøwgxd,tichondrius,576,mage,fire,12,6,6
20518,Herzthroh,stormrage,576,mage,fire,12,6,6
20519,Sourpatchkds,emerald-dream,576,mage,fire,12,6,6
20520,Neät,frostmourne,576,mage,fire,13,6,7
20521,Aangx,stormrage,576,mage,fire,16,7,9
20522,Linkolni,azralon,576,mage,fire,18,6,12
20523,Stimml,blood-furnace,576,mage,fire,18,6,12
20524,Shivamode,thrall,576,mage,fire,18,6,12
20525,Pecs,kiljaeden,576,mage,fire,18,6,12
20526,Choccoeu,illidan,576,mage,fire,20,6,14
20527,Insightæ,frostmourne,575,mage,fire,10,7,3
20528,Ellywizzle,tichondrius,575,mage,fire,12,6,6
20529,Minuswizard,dalaran,575,mage,fire,12,6,6
20530,Tigerzinho,stormrage,575,mage,fire,12,6,6
20531,Faxandu,tichondrius,575,mage,fire,18,6,12
20532,Astroblasty,tichondrius,575,mage,fire,18,6,12
20533,Eraticmage,illidan,575,mage,fire,24,6,18
20534,Calínico,quelthalas,575,mage,fire,24,6,18
20535,Pellemus,malganis,574,mage,fire,12,6,6
20536,Spellpowa,khaz-modan,574,mage,fire,12,6,6
20537,Calcaster,aegwynn,573,mage,fire,18,6,12
20538,Xannymancan,tichondrius,573,mage,fire,30,6,24
20539,Dedlyspells,dalaran,572,mage,fire,12,6,6
20540,Navira,feathermoon,572,mage,fire,12,6,6
20541,Trepid,illidan,565,mage,fire,18,6,12
20542,Shotö,skullcrusher,558,mage,fire,23,6,17
20543,Thragè,sargeras,543,mage,fire,11,6,5
20544,Glacier,firetree,543,mage,fire,11,6,5
20545,Magicke,azgalor,542,mage,fire,22,6,16
20546,Chiatsup,tichondrius,528,mage,fire,9,7,2
20547,Nuzzle,boulderfist,521,mage,fire,15,7,8
20548,Ghostrr,tichondrius,511,mage,fire,8,6,2
20549,Uhh,blackrock,511,mage,fire,16,6,10
20550,Jaywazz,tichondrius,496,mage,fire,7,6,1
20551,Slavic,sargeras,480,mage,fire,6,5,1
20552,Porthub,boulderfist,480,mage,fire,6,5,1
20553,Cubanmage,drakkari,480,mage,fire,6,5,1
20554,Stickylol,tichondrius,480,mage,fire,6,5,1
20555,Shaabby,shadowmoon,480,mage,fire,6,5,1
20556,Maxmie,sargeras,480,mage,fire,6,5,1
20557,Youezdawg,tichondrius,480,mage,fire,6,5,1
20558,Ject,ragnaros,480,mage,fire,6,5,1
20559,Zaiyge,bleeding-hollow,480,mage,fire,6,5,1
20560,Hocusjokus,frostmourne,480,mage,fire,6,5,1
20561,Weedzerd,illidan,480,mage,fire,12,5,7
20562,Numbing,sargeras,480,mage,fire,12,5,7
20563,Dbsheep,kul-tiras,480,mage,fire,12,5,7
20564,Imhotboi,illidan,480,mage,fire,12,5,7
20565,Icestory,tichondrius,480,mage,fire,12,5,7
20566,Kushjointz,tichondrius,480,mage,fire,12,5,7
20567,Bxgs,tichondrius,480,mage,fire,12,5,7
20568,Jikario,zuljin,480,mage,fire,12,5,7
20569,Kyriê,darkspear,480,mage,fire,12,5,7
20570,Rmpisgay,tichondrius,480,mage,fire,12,5,7
20571,Cnumlab,proudmoore,480,mage,fire,12,5,7
20572,Maxtorgar,quelthalas,480,mage,fire,12,5,7
20573,Espyy,area-52,480,mage,fire,12,5,7
20574,Baida,kelthuzad,480,mage,fire,12,5,7
20575,Dawonie,frostmourne,480,mage,fire,12,5,7
20576,Pugsmugg,icecrown,480,mage,fire,12,5,7
20577,Entomas,quelthalas,480,mage,fire,12,5,7
20578,Honeydutchss,black-dragonflight,480,mage,fire,12,5,7
20579,Lambsalsa,tichondrius,480,mage,fire,12,5,7
20580,Kqlyy,tichondrius,480,mage,fire,12,5,7
20581,Littlemunkee,the-venture-co,480,mage,fire,12,5,7
20582,Triuneward,tichondrius,480,mage,fire,12,5,7
20583,Zerosaspect,thrall,480,mage,fire,12,5,7
20584,Valodrin,tichondrius,480,mage,fire,12,5,7
20585,Arishasis,tichondrius,480,mage,fire,12,5,7
20586,ßutteryßoner,area-52,480,mage,fire,12,5,7
20587,Chadicewayne,tichondrius,480,mage,fire,12,5,7
20588,Skillcap,nagrand,480,mage,fire,12,5,7
20589,Diamondx,ragnaros,480,mage,fire,12,5,7
20590,Marther,whisperwind,480,mage,fire,12,5,7
20591,Magicalbuns,illidan,480,mage,fire,12,5,7
20592,Covín,malganis,480,mage,fire,12,5,7
20593,Defaultx,turalyon,480,mage,fire,12,5,7
20594,Rennifer,malganis,480,mage,fire,15,6,9
20595,Aapple,tichondrius,480,mage,fire,17,5,12
20596,Tunax,tichondrius,480,mage,fire,18,5,13
20597,Mageyoulooks,kelthuzad,480,mage,fire,18,5,13
20598,Burstyboi,frostmourne,479,mage,fire,9,6,3
20599,Xunalatu,frostmourne,479,mage,fire,12,5,7
20600,Ghostblaze,blackhand,479,mage,fire,12,5,7
20601,Shadowgalaxy,arthas,479,mage,fire,12,5,7
20602,Mescudi,bonechewer,479,mage,fire,12,5,7
20603,Finanahs,sargeras,479,mage,fire,12,5,7
20604,Chuky,terokkar,479,mage,fire,12,5,7
20605,Apolarus,bonechewer,478,mage,fire,12,5,7
20606,Infusion,ysondre,477,mage,fire,12,5,7
20607,Gwenage,tichondrius,472,mage,fire,12,5,7
20608,Normethy,illidan,447,mage,fire,11,5,6
20609,Prepcook,dalaran,447,mage,fire,11,5,6
20610,Roastbeefxd,tichondrius,447,mage,fire,11,5,6
20611,Icewrld,nemesis,447,mage,fire,14,6,8
20612,Jazen,quelthalas,432,mage,fire,15,6,9
20613,Myelvenlady,proudmoore,431,mage,fire,11,5,6
20614,Eromir,dawnbringer,416,mage,fire,10,5,5
20615,Molassess,illidan,400,mage,fire,13,5,8
20616,Eanur,azralon,400,mage,fire,19,5,14
20617,Brbsheepingx,illidan,384,mage,fire,6,4,2
20618,Octané,illidan,384,mage,fire,6,4,2
20619,Xgrave,sargeras,384,mage,fire,6,4,2
20620,Sifr,tichondrius,384,mage,fire,6,4,2
20621,Cruelhabbits,tichondrius,384,mage,fire,6,4,2
20622,Mysticlotus,doomhammer,384,mage,fire,6,4,2
20623,Floatyz,tichondrius,384,mage,fire,6,4,2
20624,Enveas,illidan,384,mage,fire,6,4,2
20625,Wolfgangs,thrall,384,mage,fire,6,4,2
20626,Poonfarmer,zangarmarsh,384,mage,fire,6,4,2
20627,Animatronic,nordrassil,384,mage,fire,6,4,2
20628,Extremeways,tichondrius,384,mage,fire,6,4,2
20629,Mithràndìr,tichondrius,384,mage,fire,6,4,2
20630,Terarosa,tichondrius,384,mage,fire,6,4,2
20631,Fmpenjoyerx,illidan,384,mage,fire,6,4,2
20632,Codeine,darkspear,384,mage,fire,6,4,2
20633,Haze,hyjal,384,mage,fire,6,4,2
20634,Dersão,azralon,384,mage,fire,6,4,2
20635,Cømbust,frostmourne,384,mage,fire,6,4,2
20636,Playtimex,proudmoore,384,mage,fire,6,4,2
20637,Crøwgawd,tichondrius,384,mage,fire,6,4,2
20638,Zaxrie,malganis,384,mage,fire,6,4,2
20639,Koadic,zuljin,384,mage,fire,6,4,2
20640,Frozonnee,aggramar,384,mage,fire,6,4,2
20641,Bonyobo,stormrage,384,mage,fire,6,4,2
20642,Tafa,stormrage,384,mage,fire,6,4,2
20643,Gíldrin,proudmoore,384,mage,fire,6,4,2
20644,Zokorzik,area-52,384,mage,fire,6,4,2
20645,Cottonmage,malganis,384,mage,fire,6,4,2
20646,Pyröz,kelthuzad,384,mage,fire,6,4,2
20647,Ferchu,emerald-dream,384,mage,fire,6,4,2
20648,Fïtz,quelthalas,384,mage,fire,6,4,2
20649,Playsfrost,skullcrusher,384,mage,fire,6,4,2
20650,Mxdeez,tichondrius,384,mage,fire,9,5,4
20651,Dytonie,moon-guard,384,mage,fire,9,4,5
20652,Spookydookie,dark-iron,384,mage,fire,12,4,8
20653,Magicshroomy,frostmourne,384,mage,fire,12,4,8
20654,Sarahbeth,khadgar,384,mage,fire,12,4,8
20655,Riencë,tol-barad,384,mage,fire,12,4,8
20656,Felsparkles,area-52,384,mage,fire,12,4,8
20657,Percivaltp,scarlet-crusade,384,mage,fire,12,4,8
20658,Aquralina,moon-guard,384,mage,fire,12,4,8
20659,Tìnkerspell,stormrage,384,mage,fire,12,4,8
20660,Aeg,stormrage,384,mage,fire,12,4,8
20661,Elfmage,tichondrius,384,mage,fire,12,4,8
20662,Pòpsmóke,tichondrius,384,mage,fire,12,4,8
20663,Thiio,tichondrius,384,mage,fire,12,4,8
20664,Pigdancel,tichondrius,384,mage,fire,12,4,8
20665,Galsola,bronzebeard,384,mage,fire,12,4,8
20666,Arialla,mannoroth,384,mage,fire,12,4,8
20667,Annhubis,quelthalas,384,mage,fire,12,4,8
20668,Moghedi,emerald-dream,384,mage,fire,12,4,8
20669,Hogslop,saurfang,384,mage,fire,12,4,8
20670,Dasanimomo,sargeras,384,mage,fire,12,4,8
20671,Kinrow,stormrage,384,mage,fire,12,4,8
20672,Missingxx,silvermoon,384,mage,fire,12,4,8
20673,Araski,malganis,384,mage,fire,12,4,8
20674,Uwuwhatnow,tichondrius,384,mage,fire,12,4,8
20675,Cam,kul-tiras,384,mage,fire,12,4,8
20676,Cacaushow,stormrage,384,mage,fire,12,4,8
20677,Udó,proudmoore,384,mage,fire,12,4,8
20678,Ejzok,dreadmaul,384,mage,fire,12,4,8
20679,Djp,tichondrius,384,mage,fire,12,4,8
20680,Droppinbombs,draka,384,mage,fire,12,4,8
20681,Neferpitøu,tichondrius,383,mage,fire,6,4,2
20682,Paires,azralon,383,mage,fire,6,4,2
20683,Drewzz,tichondrius,383,mage,fire,8,4,4
20684,Chuggin,emerald-dream,383,mage,fire,15,5,10
20685,Hockisonz,moon-guard,383,mage,fire,12,4,8
20686,Soulwiper,illidan,383,mage,fire,17,5,12
20687,Caldian,wyrmrest-accord,383,mage,fire,18,4,14
20688,Smoney,icecrown,383,mage,fire,18,4,14
20689,Kopke,ragnaros,381,mage,fire,13,4,9
20690,Hollfz,nemesis,367,mage,fire,11,4,7
20691,Vixm,stormrage,352,mage,fire,10,5,5
20692,Wabï,tichondrius,330,mage,fire,15,5,10
20693,Elemenopi,thrall,304,mage,fire,14,4,10
20694,Timme,ravencrest,288,mage,fire,6,3,3
20695,Kuther,draenor,288,mage,fire,6,3,3
20696,Bombr,sargeras,288,mage,fire,6,3,3
20697,Mntaindew,bleeding-hollow,288,mage,fire,6,3,3
20698,Urbadxd,llane,288,mage,fire,6,3,3
20699,Buffmages,malfurion,288,mage,fire,6,3,3
20700,Sølár,ragnaros,288,mage,fire,6,3,3
20701,Kassekx,area-52,288,mage,fire,6,3,3
20702,Vyzo,stormrage,288,mage,fire,6,3,3
20703,Sðsa,stormrage,288,mage,fire,6,3,3
20704,Sikamikanico,kiljaeden,288,mage,fire,6,3,3
20705,Polyenjoyerx,ysera,288,mage,fire,6,3,3
20706,Thecorruptor,malorne,288,mage,fire,6,3,3
20707,Cristábel,stormrage,288,mage,fire,6,3,3
20708,Kyliec,tichondrius,288,mage,fire,6,3,3
20709,Dicmojo,area-52,288,mage,fire,6,3,3
20710,Polyburst,darkspear,288,mage,fire,6,3,3
20711,Jimmyhendrix,wildhammer,288,mage,fire,6,3,3
20712,Spindarella,dreadmaul,288,mage,fire,6,3,3
20713,Bhalec,kelthuzad,288,mage,fire,6,3,3
20714,Slinkyslink,area-52,288,mage,fire,6,3,3
20715,Lunatti,frostmourne,288,mage,fire,6,3,3
20716,Skw,sargeras,288,mage,fire,6,3,3
20717,Botoslàp,dragonmaw,288,mage,fire,6,3,3
20718,Ancientmagik,area-52,288,mage,fire,6,3,3
20719,Xtymhxy,tichondrius,288,mage,fire,6,3,3
20720,Kandyperreo,ragnaros,288,mage,fire,6,3,3
20721,Azuriex,tichondrius,288,mage,fire,6,3,3
20722,Easyfreeze,sargeras,288,mage,fire,6,3,3
20723,Gåndalf,ragnaros,288,mage,fire,6,3,3
20724,Taevy,tichondrius,288,mage,fire,6,3,3
20725,Mindthegap,tichondrius,288,mage,fire,6,3,3
20726,Yòkai,tichondrius,288,mage,fire,6,3,3
20727,Ave,anetheron,288,mage,fire,6,3,3
20728,Síra,firetree,288,mage,fire,6,3,3
20729,Whyze,malganis,288,mage,fire,6,3,3
20730,Gandrich,drakkari,288,mage,fire,6,3,3
20731,Mugiara,azralon,288,mage,fire,6,3,3
20732,Boorster,illidan,288,mage,fire,6,3,3
20733,Globglob,tichondrius,288,mage,fire,6,3,3
20734,Frostkage,tichondrius,288,mage,fire,6,3,3
20735,Svips,illidan,288,mage,fire,6,3,3
20736,Rích,tichondrius,288,mage,fire,6,3,3
20737,Lampert,tichondrius,288,mage,fire,6,3,3
20738,Chez,tichondrius,288,mage,fire,6,3,3
20739,Bergan,sargeras,288,mage,fire,6,3,3
20740,Zuhbo,moon-guard,288,mage,fire,6,3,3
20741,Needloog,sargeras,288,mage,fire,6,3,3
20742,Zenzoh,azuremyst,288,mage,fire,6,3,3
20743,Blinkinghobo,sargeras,288,mage,fire,6,3,3
20744,Hunchojack,tichondrius,288,mage,fire,6,3,3
20745,Slapmesilly,destromath,288,mage,fire,6,3,3
20746,Craigsdad,tichondrius,288,mage,fire,6,3,3
20747,Zerathremar,proudmoore,288,mage,fire,6,3,3
20748,Hasteboy,kelthuzad,288,mage,fire,6,3,3
20749,Chilléd,tichondrius,288,mage,fire,6,3,3
20750,Tráshmage,zuljin,288,mage,fire,6,3,3
20751,Rhunón,dalaran,288,mage,fire,6,3,3
20752,Pollylol,proudmoore,288,mage,fire,6,3,3
20753,Gö,tichondrius,288,mage,fire,6,3,3
20754,Angryßirdz,kelthuzad,288,mage,fire,6,3,3
20755,Emvepee,sargeras,288,mage,fire,6,3,3
20756,Rikko,gundrak,288,mage,fire,15,4,11
20757,Chanko,bleeding-hollow,288,mage,fire,12,3,9
20758,Fatalexo,tichondrius,288,mage,fire,12,3,9
20759,Danggurl,tichondrius,288,mage,fire,12,3,9
20760,Chale,tichondrius,288,mage,fire,12,3,9
20761,Zogo,bleeding-hollow,288,mage,fire,12,3,9
20762,Keionti,dalaran,288,mage,fire,12,3,9
20763,Mendittorosa,tichondrius,288,mage,fire,12,3,9
20764,Skynhet,ragnaros,288,mage,fire,12,3,9
20765,Turbogeo,shuhalo,288,mage,fire,12,3,9
20766,Magichands,darkspear,288,mage,fire,12,3,9
20767,Nilla,hyjal,288,mage,fire,12,3,9
20768,Funkeoto,thrall,288,mage,fire,12,3,9
20769,Orkinekek,frostmourne,288,mage,fire,12,3,9
20770,Twizz,haomarush,288,mage,fire,12,3,9
20771,Chelseâ,emerald-dream,288,mage,fire,18,3,15
20772,Xroz,barthilas,288,mage,fire,18,3,15
20773,Gnomegeddons,dalaran,288,mage,fire,24,3,21
20774,Harlen,quelthalas,287,mage,fire,6,3,3
20775,Seaon,malganis,287,mage,fire,6,3,3
20776,Shutouchi,frostwolf,287,mage,fire,6,3,3
20777,Frostyii,stonemaul,287,mage,fire,6,3,3
20778,Nushala,stonemaul,287,mage,fire,11,3,8
20779,Zipacna,antonidas,286,mage,fire,12,3,9
20780,Mageymeows,dalaran,285,mage,fire,12,3,9
20781,Kittikk,tichondrius,284,mage,fire,18,3,15
20782,Nesomage,destromath,256,mage,fire,10,3,7
20783,Rossanopolis,tichondrius,255,mage,fire,17,3,14
20784,Nephalem,moknathal,240,mage,fire,9,3,6
20785,Orderlight,alexstrasza,239,mage,fire,5,3,2
20786,Genozyde,elune,239,mage,fire,5,3,2
20787,Qohoo,frostmourne,239,mage,fire,5,3,2
20788,Xiangfe,emerald-dream,239,mage,fire,5,3,2
20789,Fizario,barthilas,239,mage,fire,5,3,2
20790,Feenìx,tichondrius,234,mage,fire,6,4,2
20791,Flomin,tichondrius,234,mage,fire,16,6,10
20792,Magicdro,scilla,224,mage,fire,10,3,7
20793,Mcdfries,tichondrius,208,mage,fire,7,3,4
20794,Coldgirl,malganis,192,mage,fire,11,4,7
20795,Coldnuke,stormrage,192,mage,fire,6,2,4
20796,Hugostiglets,dreadmaul,192,mage,fire,6,2,4
20797,Jinglehz,frostmourne,192,mage,fire,6,2,4
20798,Burna,amanthul,192,mage,fire,6,2,4
20799,Copperfield,dreadmaul,192,mage,fire,6,2,4
20800,Friézá,stormrage,192,mage,fire,6,2,4
20801,Trízín,frostmourne,192,mage,fire,6,2,4
20802,Swàn,stormrage,192,mage,fire,6,2,4
20803,Kaboodlz,stormrage,192,mage,fire,6,2,4
20804,Remana,anvilmar,192,mage,fire,6,2,4
20805,Karameltart,barthilas,192,mage,fire,6,2,4
20806,Massivepoo,barthilas,192,mage,fire,6,2,4
20807,Parruka,warsong,192,mage,fire,6,2,4
20808,Faeylyn,stormrage,192,mage,fire,6,2,4
20809,Pipeguzzler,zuljin,192,mage,fire,6,2,4
20810,Shäräpova,zuljin,192,mage,fire,6,2,4
20811,Randommagi,area-52,192,mage,fire,6,2,4
20812,Gódsfather,kelthuzad,192,mage,fire,6,2,4
20813,Laf,frostmourne,192,mage,fire,6,2,4
20814,Shardgodx,kelthuzad,192,mage,fire,6,2,4
20815,Briklyx,zuljin,192,mage,fire,6,2,4
20816,Toroy,wyrmrest-accord,192,mage,fire,6,2,4
20817,Ignitex,bleeding-hollow,192,mage,fire,6,2,4
20818,Pendrake,sargeras,192,mage,fire,6,2,4
20819,Juicemage,tichondrius,192,mage,fire,6,2,4
20820,Keii,bleeding-hollow,192,mage,fire,6,2,4
20821,Grisherina,quelthalas,192,mage,fire,6,2,4
20822,Starguy,terenas,192,mage,fire,6,2,4
20823,Onehitter,tichondrius,192,mage,fire,6,2,4
20824,Privilege,dragonmaw,192,mage,fire,6,2,4
20825,Hellfireice,kiljaeden,192,mage,fire,6,2,4
20826,Melkdud,wyrmrest-accord,192,mage,fire,6,2,4
20827,Avandal,proudmoore,192,mage,fire,6,2,4
20828,Natzue,sargeras,192,mage,fire,6,2,4
20829,Cradic,tichondrius,192,mage,fire,6,2,4
20830,Kymowiz,sargeras,192,mage,fire,6,2,4
20831,Högnues,tichondrius,192,mage,fire,6,2,4
20832,Mävra,emerald-dream,192,mage,fire,6,2,4
20833,Herpsgungetu,maiev,192,mage,fire,6,2,4
20834,Ogpdk,sargeras,192,mage,fire,6,2,4
20835,Missile,frostmourne,192,mage,fire,6,2,4
20836,Gotya,tichondrius,192,mage,fire,6,2,4
20837,Zuqo,sargeras,192,mage,fire,6,2,4
20838,Rbn,tichondrius,192,mage,fire,6,2,4
20839,Maddoggs,tichondrius,192,mage,fire,6,2,4
20840,Dustychill,illidan,192,mage,fire,6,2,4
20841,Bojackal,illidan,192,mage,fire,6,2,4
20842,Berrur,azralon,192,mage,fire,6,2,4
20843,Naimi,malganis,192,mage,fire,6,2,4
20844,Trebbiano,illidan,192,mage,fire,6,2,4
20845,Roggitman,emerald-dream,192,mage,fire,6,2,4
20846,Nerff,sargeras,192,mage,fire,6,2,4
20847,Tannbone,illidan,192,mage,fire,6,2,4
20848,Likelyhard,tichondrius,192,mage,fire,6,2,4
20849,Wetworx,illidan,192,mage,fire,6,2,4
20850,Notria,illidan,192,mage,fire,6,2,4
20851,Burrbon,area-52,192,mage,fire,6,2,4
20852,Yellowfevrz,thrall,192,mage,fire,6,2,4
20853,Josephaqil,tichondrius,192,mage,fire,6,2,4
20854,Chillstep,dark-iron,192,mage,fire,6,2,4
20855,Elmozezos,thrall,192,mage,fire,6,2,4
20856,Dîarrhea,sargeras,192,mage,fire,6,2,4
20857,Telkham,tichondrius,192,mage,fire,6,2,4
20858,Iludron,aegwynn,192,mage,fire,6,2,4
20859,Dohnutt,tichondrius,192,mage,fire,6,2,4
20860,Ðfuego,azralon,192,mage,fire,6,2,4
20861,Elhechizero,quelthalas,192,mage,fire,6,2,4
20862,Variex,tichondrius,192,mage,fire,6,2,4
20863,Clickhard,suramar,192,mage,fire,6,2,4
20864,Khelzter,area-52,192,mage,fire,6,2,4
20865,Erîol,ragnaros,192,mage,fire,6,2,4
20866,Shesy,sargeras,192,mage,fire,6,2,4
20867,Thedodgex,sargeras,192,mage,fire,6,2,4
20868,Magifish,malganis,192,mage,fire,6,2,4
20869,Zënith,quelthalas,192,mage,fire,6,2,4
20870,Killemz,dragonmaw,192,mage,fire,6,2,4
20871,Gunzz,aegwynn,192,mage,fire,6,2,4
20872,Yonzho,area-52,192,mage,fire,6,2,4
20873,Quickwizard,tichondrius,192,mage,fire,6,2,4
20874,Emìlia,malygos,192,mage,fire,6,2,4
20875,Alïce,kelthuzad,192,mage,fire,6,2,4
20876,Wauzcrol,quelthalas,192,mage,fire,6,2,4
20877,Itension,tichondrius,192,mage,fire,6,2,4
20878,Lilmager,tichondrius,192,mage,fire,6,2,4
20879,Aquafiona,garona,192,mage,fire,6,2,4
20880,Magiër,tichondrius,192,mage,fire,6,2,4
20881,Arianark,sargeras,192,mage,fire,6,2,4
20882,Zerii,aggramar,192,mage,fire,6,2,4
20883,Stooki,tichondrius,192,mage,fire,6,2,4
20884,Abrácadaver,frostwolf,192,mage,fire,10,3,7
20885,Flamiohotman,illidan,192,mage,fire,7,2,5
20886,Arnx,tichondrius,192,mage,fire,11,2,9
20887,Lauroca,azralon,192,mage,fire,12,2,10
20888,Granmago,azralon,192,mage,fire,12,2,10
20889,Skatas,barthilas,192,mage,fire,12,2,10
20890,Saydar,stormrage,192,mage,fire,12,2,10
20891,Driel,illidan,192,mage,fire,12,2,10
20892,Bic,darrowmere,192,mage,fire,12,2,10
20893,Abruaa,area-52,192,mage,fire,12,2,10
20894,Firehawk,azralon,192,mage,fire,12,2,10
20895,Ëfc,nemesis,192,mage,fire,12,2,10
20896,Itslilme,gurubashi,191,mage,fire,6,2,4
20897,Magemajor,uldum,191,mage,fire,12,2,10
20898,Prosperoo,aerie-peak,191,mage,fire,12,2,10
20899,Neroclover,ysera,191,mage,fire,24,2,22
20900,Madalon,nemesis,160,mage,fire,10,2,8
20901,Zezima,spirestone,159,mage,fire,5,2,3
20902,Razaklov,tichondrius,159,mage,fire,5,2,3
20903,Kindlin,frostmourne,159,mage,fire,5,2,3
20904,Fingerblaste,malganis,138,mage,fire,16,3,13
20905,Ratfather,the-forgotten-coast,128,mage,fire,4,2,2
20906,Yeweiliang,tichondrius,128,mage,fire,4,2,2
20907,Dwayniewayni,tichondrius,128,mage,fire,4,2,2
20908,Supremeboxer,tichondrius,127,mage,fire,8,2,6
20909,Neltar,dalaran,112,mage,fire,7,2,5
20910,Haliax,bronzebeard,96,mage,fire,3,2,1
20911,Lv,stormscale,96,mage,fire,6,1,5
20912,Trojay,malganis,96,mage,fire,6,1,5
20913,Purpkush,zuljin,96,mage,fire,6,1,5
20914,Bbaxter,stormrage,96,mage,fire,6,1,5
20915,Litiria,burning-blade,96,mage,fire,6,1,5
20916,Memnor,amanthul,96,mage,fire,6,1,5
20917,Magicmooman,thunderlord,96,mage,fire,6,1,5
20918,Prosperoh,burning-legion,96,mage,fire,6,1,5
20919,Tisao,bronzebeard,96,mage,fire,6,1,5
20920,Jazco,tichondrius,96,mage,fire,6,1,5
20921,Blinkmind,stormrage,96,mage,fire,6,1,5
20922,Iamsol,area-52,96,mage,fire,6,1,5
20923,Rieltar,barthilas,96,mage,fire,6,1,5
20924,Nomidian,area-52,96,mage,fire,6,1,5
20925,Édika,area-52,96,mage,fire,6,1,5
20926,Ignit,stormrage,96,mage,fire,6,1,5
20927,Tabuta,ravenholdt,96,mage,fire,6,1,5
20928,Clutchy,gorefiend,96,mage,fire,6,1,5
20929,Firemids,thrall,96,mage,fire,6,1,5
20930,Jarethleon,ragnaros,96,mage,fire,6,1,5
20931,Ross,deathwing,96,mage,fire,6,1,5
20932,Jaçkjaçk,moon-guard,96,mage,fire,6,1,5
20933,Arkuran,proudmoore,96,mage,fire,6,1,5
20934,Clickersz,sargeras,96,mage,fire,6,1,5
20935,Bdmxd,stormrage,96,mage,fire,6,1,5
20936,Dâzk,sargeras,96,mage,fire,6,1,5
20937,Firehazard,tichondrius,96,mage,fire,6,1,5
20938,Bigmêan,boulderfist,96,mage,fire,6,1,5
20939,Ssmurfett,dalaran,96,mage,fire,6,1,5
20940,Pyrophobia,mannoroth,96,mage,fire,6,1,5
20941,Hyndoriann,azgalor,96,mage,fire,6,1,5
20942,Aimedint,sargeras,96,mage,fire,6,1,5
20943,Tonydippin,illidan,96,mage,fire,6,1,5
20944,Merreda,sargeras,96,mage,fire,6,1,5
20945,Warmweather,nagrand,96,mage,fire,6,1,5
20946,Dildope,frostmourne,96,mage,fire,6,1,5
20947,Gnomoguapo,altar-of-storms,96,mage,fire,6,1,5
20948,Gurion,bleeding-hollow,96,mage,fire,6,1,5
20949,Hèrò,barthilas,96,mage,fire,6,1,5
20950,Sny,bleeding-hollow,96,mage,fire,6,1,5
20951,Nazztwren,bleeding-hollow,96,mage,fire,6,1,5
20952,Truewinter,tichondrius,96,mage,fire,6,1,5
20953,Pyromaniac,stormscale,96,mage,fire,6,1,5
20954,Wíntersun,frostmourne,96,mage,fire,6,1,5
20955,Fireblast,stormscale,96,mage,fire,6,1,5
20956,Muted,frostmourne,96,mage,fire,6,1,5
20957,Miapolyafoo,stormrage,96,mage,fire,6,1,5
20958,Rolypolyman,tichondrius,96,mage,fire,6,1,5
20959,Brayni,wyrmrest-accord,96,mage,fire,6,1,5
20960,Auraelius,tichondrius,96,mage,fire,6,1,5
20961,Phrana,tichondrius,96,mage,fire,6,1,5
20962,Couto,tichondrius,96,mage,fire,6,1,5
20963,Somnuss,barthilas,96,mage,fire,7,1,6
20964,Allesanda,sargeras,96,mage,fire,12,1,11
20965,Duhquarius,warsong,96,mage,fire,12,1,11
20966,Zuroz,dathremar,96,mage,fire,12,1,11
20967,Dezax,malfurion,96,mage,fire,12,1,11
20968,Mideon,whisperwind,95,mage,fire,6,1,5
20969,Doomguyx,korgath,95,mage,fire,14,1,13
20970,Cînderellas,proudmoore,84,mage,fire,14,5,9
20971,Noquemacuuh,ragnaros,79,mage,fire,5,1,4
20972,Kibazn,sisters-of-elune,79,mage,fire,5,1,4
20973,Jaked,frostmourne,79,mage,fire,5,1,4
20974,Savanali,kelthuzad,79,mage,fire,5,1,4
20975,Jarvase,mugthol,79,mage,fire,5,1,4
20976,Skerei,azralon,48,mage,fire,3,1,2
20977,Redeyez,arthas,48,mage,fire,9,1,8
20978,Juicemage,tichondrius,2203,mage,frost,168,90,78
20979,Hogdog,illidan,2105,mage,frost,90,47,43
20980,Stonedmonkeý,tichondrius,2103,mage,frost,149,75,74
20981,Juicechanel,tichondrius,2071,mage,frost,70,38,32
20982,Cremgotrockd,blackrock,2061,mage,frost,113,62,51
20983,Lawuera,quelthalas,2011,mage,frost,96,48,48
20984,Zlint,quelthalas,2007,mage,frost,115,59,56
20985,Easyfreeze,sargeras,1996,mage,frost,48,27,21
20986,Cunzhang,tichondrius,1989,mage,frost,78,39,39
20987,Backjing,tichondrius,1969,mage,frost,87,42,45
20988,Hogmantwo,illidan,1965,mage,frost,66,36,30
20989,Ghostrr,tichondrius,1963,mage,frost,190,97,93
20990,Factszxy,area-52,1934,mage,frost,59,41,18
20991,Frostitutex,illidan,1911,mage,frost,73,38,35
20992,Douyuweifa,tichondrius,1911,mage,frost,65,31,34
20993,Elkiador,area-52,1909,mage,frost,30,21,9
20994,Bamx,stormrage,1900,mage,frost,72,39,33
20995,Grumpyòlfart,tichondrius,1898,mage,frost,132,67,65
20996,Vazlgs,tichondrius,1896,mage,frost,82,47,35
20997,Miilky,tichondrius,1893,mage,frost,66,33,33
20998,Flaux,sargeras,1892,mage,frost,88,50,38
20999,Ams,aerie-peak,1890,mage,frost,60,33,27
21000,Smuky,stormrage,1888,mage,frost,155,75,80
21001,Zerodium,sargeras,1887,mage,frost,107,54,53
21002,Snaregodx,area-52,1885,mage,frost,59,31,28
21003,Kassmage,skullcrusher,1884,mage,frost,150,71,79
21004,Faynet,dalaran,1882,mage,frost,158,84,74
21005,Politeness,tichondrius,1873,mage,frost,42,20,22
21006,Chrisxo,azuremyst,1866,mage,frost,48,27,21
21007,Tupactopus,tichondrius,1861,mage,frost,54,27,27
21008,Stöpwatch,hyjal,1859,mage,frost,66,43,23
21009,Theydeadx,illidan,1858,mage,frost,47,31,16
21010,Pigdancell,tichondrius,1858,mage,frost,60,25,35
21011,Corgim,thrall,1857,mage,frost,65,33,32
21012,Sheepard,sargeras,1856,mage,frost,36,25,11
21013,Fròzt,ragnaros,1854,mage,frost,96,43,53
21014,Mcdfries,tichondrius,1853,mage,frost,60,32,28
21015,Hunchojack,tichondrius,1852,mage,frost,66,27,39
21016,Xanthilia,chogall,1849,mage,frost,96,49,47
21017,Valériemeow,tichondrius,1847,mage,frost,184,86,98
21018,Chunzhangfs,tichondrius,1843,mage,frost,46,23,23
21019,Hideongp,barthilas,1842,mage,frost,108,54,54
21020,Maebalim,tichondrius,1835,mage,frost,48,27,21
21021,Evilnuts,quelthalas,1832,mage,frost,61,34,27
21022,Dahp,thrall,1831,mage,frost,47,23,24
21023,Micfiyah,thrall,1827,mage,frost,66,41,25
21024,Vague,tichondrius,1824,mage,frost,80,42,38
21025,Gelokay,tichondrius,1821,mage,frost,42,25,17
21026,Joe,llane,1821,mage,frost,195,95,100
21027,Srinshi,sargeras,1820,mage,frost,160,80,80
21028,Miketao,tichondrius,1820,mage,frost,67,31,36
21029,Headbake,malganis,1820,mage,frost,66,30,36
21030,Evilear,andorhal,1819,mage,frost,66,33,33
21031,Chez,tichondrius,1818,mage,frost,30,19,11
21032,Cømbust,frostmourne,1816,mage,frost,72,50,22
21033,Theetwotime,area-52,1814,mage,frost,148,77,71
21034,Quippy,kiljaeden,1813,mage,frost,309,156,153
21035,Leakyboots,illidan,1812,mage,frost,47,25,22
21036,Ribot,sargeras,1812,mage,frost,60,28,32
21037,Tris,malganis,1807,mage,frost,63,32,31
21038,Swagbased,tichondrius,1807,mage,frost,60,29,31
21039,Koozay,kelthuzad,1805,mage,frost,65,38,27
21040,Dace,tichondrius,1804,mage,frost,53,29,24
21041,Maegwynah,stormrage,1804,mage,frost,66,29,37
21042,Aapple,tichondrius,1803,mage,frost,60,32,28
21043,Instincts,uldum,1796,mage,frost,42,25,17
21044,Ligmmah,stormrage,1792,mage,frost,110,61,49
21045,Yellowfevrz,thrall,1791,mage,frost,42,19,23
21046,Laserface,bleeding-hollow,1789,mage,frost,72,42,30
21047,Lantx,tichondrius,1789,mage,frost,80,43,37
21048,Koro,tichondrius,1784,mage,frost,133,68,65
21049,Drewdy,stormreaver,1783,mage,frost,30,19,11
21050,Valtessa,stormrage,1781,mage,frost,54,32,22
21051,Endymiòn,tichondrius,1780,mage,frost,48,24,24
21052,Sheepgodx,malganis,1779,mage,frost,35,20,15
21053,Kleinz,quelthalas,1776,mage,frost,91,54,37
21054,Golfirl,doomhammer,1774,mage,frost,54,24,30
21055,Tjofmajik,stormrage,1771,mage,frost,54,28,26
21056,Sestren,zuljin,1766,mage,frost,54,25,29
21057,Kissradiox,tichondrius,1763,mage,frost,138,65,73
21058,Dtbmar,misha,1762,mage,frost,94,43,51
21059,Dorsia,jaedenar,1760,mage,frost,76,49,27
21060,Rhythmdog,tichondrius,1758,mage,frost,60,25,35
21061,Gôøglëlòl,nemesis,1755,mage,frost,271,139,132
21062,Frikabust,stormrage,1747,mage,frost,65,39,26
21063,Stealing,barthilas,1746,mage,frost,59,30,29
21064,Mokelovin,sargeras,1744,mage,frost,47,30,17
21065,Lemmiwïnks,area-52,1744,mage,frost,44,27,17
21066,Téfy,ragnaros,1744,mage,frost,59,34,25
21067,Riddickl,malfurion,1738,mage,frost,102,50,52
21068,Kazimìr,tichondrius,1735,mage,frost,30,19,11
21069,Tofusmell,illidan,1735,mage,frost,54,31,23
21070,Bravden,area-52,1735,mage,frost,72,40,32
21071,Kymowiz,sargeras,1731,mage,frost,54,26,28
21072,Pitball,area-52,1730,mage,frost,139,70,69
21073,Ingcho,tichondrius,1730,mage,frost,72,32,40
21074,Castana,tichondrius,1729,mage,frost,116,54,62
21075,Blinkbow,tichondrius,1724,mage,frost,161,80,81
21076,Feener,stormreaver,1722,mage,frost,42,19,23
21077,Illumià,illidan,1719,mage,frost,26,20,6
21078,Atra,spinebreaker,1717,mage,frost,60,29,31
21079,Traelol,blades-edge,1715,mage,frost,114,58,56
21080,Sifr,tichondrius,1713,mage,frost,36,18,18
21081,Covil,tichondrius,1710,mage,frost,114,54,60
21082,Zhangxiaowu,tichondrius,1706,mage,frost,56,37,19
21083,Jerawokee,undermine,1706,mage,frost,97,44,53
21084,Isellstuff,thrall,1704,mage,frost,78,40,38
21085,Luckysir,illidan,1704,mage,frost,42,21,21
21086,Xuxä,stormrage,1701,mage,frost,68,36,32
21087,Polyenjoyerx,ysera,1701,mage,frost,106,55,51
21088,Rizke,tichondrius,1701,mage,frost,35,18,17
21089,Zssy,tichondrius,1693,mage,frost,65,43,22
21090,Chinye,tichondrius,1691,mage,frost,68,32,36
21091,Fromcanadaqc,stormrage,1689,mage,frost,41,24,17
21092,Zinnos,tichondrius,1684,mage,frost,214,105,109
21093,Pichorrá,quelthalas,1683,mage,frost,86,49,37
21094,Persia,illidan,1683,mage,frost,53,24,29
21095,Blinkmind,stormrage,1682,mage,frost,54,26,28
21096,Sabrita,proudmoore,1680,mage,frost,98,50,48
21097,Perrc,area-52,1680,mage,frost,206,100,106
21098,Jtizzlè,tichondrius,1679,mage,frost,59,33,26
21099,Deallus,tichondrius,1677,mage,frost,82,40,42
21100,Cayoux,darkspear,1676,mage,frost,30,18,12
21101,Alurion,moon-guard,1673,mage,frost,32,21,11
21102,Factsx,area-52,1669,mage,frost,42,22,20
21103,Bmuafgfe,tichondrius,1668,mage,frost,36,22,14
21104,Tommagic,tichondrius,1666,mage,frost,40,23,17
21105,Praestigium,barthilas,1665,mage,frost,98,54,44
21106,Marrioo,tichondrius,1663,mage,frost,54,26,28
21107,Stimml,blood-furnace,1662,mage,frost,66,38,28
21108,Arcayne,tichondrius,1662,mage,frost,127,69,58
21109,Tatertots,bladefist,1658,mage,frost,47,18,29
21110,Bambambilly,kelthuzad,1655,mage,frost,75,35,40
21111,Bemaster,area-52,1654,mage,frost,50,33,17
21112,Minverces,tichondrius,1653,mage,frost,40,23,17
21113,Arcánè,velen,1652,mage,frost,29,19,10
21114,Dve,frostmourne,1651,mage,frost,84,51,33
21115,Entm,burning-blade,1651,mage,frost,42,22,20
21116,Kassody,kelthuzad,1650,mage,frost,36,22,14
21117,Seeu,tichondrius,1649,mage,frost,60,21,39
21118,Hüz,frostmourne,1648,mage,frost,62,41,21
21119,Yeweiliang,tichondrius,1648,mage,frost,486,242,244
21120,Luxør,aegwynn,1647,mage,frost,30,18,12
21121,Zorexx,area-52,1643,mage,frost,61,30,31
21122,Juniel,bleeding-hollow,1643,mage,frost,46,22,24
21123,Sheepshot,dentarg,1641,mage,frost,48,24,24
21124,Glaciated,the-forgotten-coast,1641,mage,frost,86,42,44
21125,Sorankim,tichondrius,1641,mage,frost,43,18,25
21126,Horrendum,azralon,1639,mage,frost,42,24,18
21127,Qcomberoo,frostmane,1637,mage,frost,45,22,23
21128,Gûmbÿ,illidan,1636,mage,frost,36,28,8
21129,Charmed,black-dragonflight,1635,mage,frost,86,45,41
21130,Venachi,emerald-dream,1633,mage,frost,146,83,63
21131,Mayumî,moon-guard,1632,mage,frost,42,21,21
21132,Lambsalsa,tichondrius,1631,mage,frost,42,18,24
21133,Gnitraf,malganis,1630,mage,frost,48,27,21
21134,Fawcett,khazgoroth,1629,mage,frost,102,53,49
21135,Thatlejund,tichondrius,1628,mage,frost,97,52,45
21136,Scarablast,bleeding-hollow,1628,mage,frost,73,35,38
21137,Magecombe,thrall,1626,mage,frost,67,33,34
21138,Zezima,spirestone,1625,mage,frost,36,23,13
21139,Elyandria,proudmoore,1625,mage,frost,42,23,19
21140,Xialing,tichondrius,1625,mage,frost,35,18,17
21141,Animatronic,moon-guard,1622,mage,frost,261,131,130
21142,Erykk,mugthol,1622,mage,frost,63,22,41
21143,Kouks,tichondrius,1621,mage,frost,35,21,14
21144,Harmõny,tichondrius,1621,mage,frost,31,18,13
21145,Fgnb,sargeras,1620,mage,frost,60,32,28
21146,Mashii,kiljaeden,1620,mage,frost,36,17,19
21147,Triuneward,tichondrius,1619,mage,frost,42,22,20
21148,Yulian,tichondrius,1618,mage,frost,127,75,52
21149,Neverblockx,kirin-tor,1618,mage,frost,30,17,13
21150,Savanali,kelthuzad,1616,mage,frost,63,33,30
21151,Aycc,tichondrius,1616,mage,frost,52,27,25
21152,Hotrunner,sargeras,1615,mage,frost,211,108,103
21153,Gwyn,nemesis,1614,mage,frost,54,29,25
21154,Kabrax,nerzhul,1613,mage,frost,48,22,26
21155,Whosdismage,illidan,1608,mage,frost,36,22,14
21156,Soulberg,emerald-dream,1606,mage,frost,107,53,54
21157,Squidio,stormrage,1605,mage,frost,130,72,58
21158,Terarosa,tichondrius,1605,mage,frost,66,34,32
21159,Jaked,frostmourne,1604,mage,frost,62,27,35
21160,Sheepu,bladefist,1603,mage,frost,112,64,48
21161,Snoogensftw,tichondrius,1602,mage,frost,36,17,19
21162,Preceptør,azralon,1601,mage,frost,61,33,28
21163,Umber,dreadmaul,1600,mage,frost,222,113,109
21164,Aramire,drakkari,1597,mage,frost,45,23,22
21165,Trippy,senjin,1595,mage,frost,38,19,19
21166,Frostpimp,anubarak,1594,mage,frost,62,27,35
21167,Flâvor,illidan,1593,mage,frost,54,29,25
21168,Littlejay,kelthuzad,1591,mage,frost,42,19,23
21169,Enflame,tichondrius,1583,mage,frost,66,42,24
21170,Mageonthcc,korgath,1583,mage,frost,98,49,49
21171,Orderlight,alexstrasza,1582,mage,frost,144,68,76
21172,Baleiabranca,stormrage,1580,mage,frost,195,91,104
21173,Axecap,tichondrius,1578,mage,frost,72,38,34
21174,Pocsermage,drakkari,1577,mage,frost,40,18,22
21175,Bibi,ragnaros,1575,mage,frost,57,26,31
21176,Alùcârd,tichondrius,1572,mage,frost,64,34,30
21177,Tonystonerz,lightnings-blade,1570,mage,frost,36,20,16
21178,Lorlene,frostmourne,1570,mage,frost,199,92,107
21179,Crithappy,baelgun,1568,mage,frost,48,26,22
21180,Dexd,laughing-skull,1567,mage,frost,72,38,34
21181,Fizario,barthilas,1567,mage,frost,95,47,48
21182,Frizbee,sargeras,1567,mage,frost,39,19,20
21183,Nickioxox,tichondrius,1567,mage,frost,41,17,24
21184,Hermanmiller,tichondrius,1561,mage,frost,118,65,53
21185,Burrstful,destromath,1561,mage,frost,59,26,33
21186,Marisadaze,tichondrius,1558,mage,frost,74,32,42
21187,Affewxd,lothar,1557,mage,frost,126,65,61
21188,Qsc,barthilas,1555,mage,frost,213,107,106
21189,Deverror,frostmourne,1555,mage,frost,216,104,112
21190,Fracxure,area-52,1554,mage,frost,47,21,26
21191,Deathrøll,moon-guard,1552,mage,frost,84,48,36
21192,Kabonkle,drakthul,1545,mage,frost,68,32,36
21193,Maxtorgar,quelthalas,1545,mage,frost,48,17,31
21194,Couto,tichondrius,1544,mage,frost,59,26,33
21195,Moyuu,proudmoore,1541,mage,frost,343,172,171
21196,Mkudos,ragnaros,1540,mage,frost,119,63,56
21197,Nairmage,tichondrius,1540,mage,frost,38,20,18
21198,Snôz,illidan,1539,mage,frost,72,32,40
21199,Omnislasher,terenas,1537,mage,frost,145,70,75
21200,Lilpolyx,illidan,1537,mage,frost,36,17,19
21201,Priyel,hyjal,1536,mage,frost,68,35,33
21202,Daydreamz,lightnings-blade,1535,mage,frost,77,32,45
21203,Kyphosis,illidan,1533,mage,frost,31,16,15
21204,Chrislongtv,tichondrius,1533,mage,frost,678,339,339
21205,Biglance,frostmourne,1533,mage,frost,36,17,19
21206,Frostqt,area-52,1532,mage,frost,132,71,61
21207,Froshar,ragnaros,1532,mage,frost,60,29,31
21208,Pigdancel,tichondrius,1531,mage,frost,36,16,20
21209,Icyspring,tichondrius,1530,mage,frost,24,16,8
21210,Yorgøs,ragnaros,1530,mage,frost,30,16,14
21211,Mcfry,illidan,1528,mage,frost,70,40,30
21212,Pëpz,emerald-dream,1527,mage,frost,42,17,25
21213,Slipqt,tichondrius,1519,mage,frost,77,38,39
21214,Aosin,wyrmrest-accord,1519,mage,frost,36,17,19
21215,Janchi,moon-guard,1518,mage,frost,119,52,67
21216,Ehcos,stormrage,1517,mage,frost,90,42,48
21217,Floofies,moon-guard,1516,mage,frost,133,65,68
21218,Fakebusiness,area-52,1515,mage,frost,198,102,96
21219,Dillor,tichondrius,1511,mage,frost,195,99,96
21220,Icestory,tichondrius,1511,mage,frost,138,56,82
21221,Kandyperreo,ragnaros,1510,mage,frost,70,35,35
21222,Paü,illidan,1509,mage,frost,117,55,62
21223,Unseën,area-52,1508,mage,frost,36,18,18
21224,Warmweather,nagrand,1508,mage,frost,54,25,29
21225,Swaxi,illidan,1506,mage,frost,30,16,14
21226,Trebbiano,illidan,1503,mage,frost,163,85,78
21227,Playsfrost,skullcrusher,1501,mage,frost,106,62,44
21228,Tuçhi,tichondrius,1501,mage,frost,48,27,21
21229,Khadberry,aerie-peak,1501,mage,frost,71,34,37
21230,Sáron,quelthalas,1499,mage,frost,69,37,32
21231,Yourefat,emerald-dream,1497,mage,frost,96,60,36
21232,Tylers,moon-guard,1496,mage,frost,48,28,20
21233,Noescaping,illidan,1494,mage,frost,53,24,29
21234,Kazmir,area-52,1494,mage,frost,41,16,25
21235,Vornz,sargeras,1493,mage,frost,102,51,51
21236,Galacticslug,tichondrius,1491,mage,frost,54,30,24
21237,Burritsacold,bleeding-hollow,1491,mage,frost,54,26,28
21238,Megladon,tichondrius,1489,mage,frost,65,40,25
21239,Arcaneshally,area-52,1489,mage,frost,42,20,22
21240,Datazonfire,illidan,1488,mage,frost,36,22,14
21241,Spurski,emerald-dream,1487,mage,frost,27,17,10
21242,Maagin,zuljin,1487,mage,frost,182,95,87
21243,Genswift,thrall,1486,mage,frost,60,27,33
21244,Song,sargeras,1485,mage,frost,83,42,41
21245,Supergun,tichondrius,1485,mage,frost,45,21,24
21246,Emetah,ysera,1485,mage,frost,60,27,33
21247,Icegiants,tichondrius,1484,mage,frost,65,35,30
21248,Betrian,quelthalas,1482,mage,frost,72,33,39
21249,Pibb,rivendare,1480,mage,frost,48,25,23
21250,Léstat,quelthalas,1479,mage,frost,36,21,15
21251,Magneto,blood-furnace,1479,mage,frost,36,17,19
21252,Cubanmage,drakkari,1477,mage,frost,42,19,23
21253,Fbd,bloodscalp,1473,mage,frost,30,16,14
21254,Toaststrudel,tichondrius,1472,mage,frost,105,49,56
21255,Ado,zuluhed,1471,mage,frost,114,59,55
21256,Snowmassive,illidan,1471,mage,frost,42,20,22
21257,Agoniey,illidan,1471,mage,frost,66,26,40
21258,Kylar,icecrown,1470,mage,frost,66,32,34
21259,Bruxelejolie,twisting-nether,1468,mage,frost,24,16,8
21260,Vecna,tichondrius,1468,mage,frost,109,52,57
21261,Fròzen,moon-guard,1466,mage,frost,80,39,41
21262,Wíntersun,frostmourne,1465,mage,frost,342,173,169
21263,Osh,malorne,1464,mage,frost,56,27,29
21264,Enterthevoid,proudmoore,1463,mage,frost,36,21,15
21265,Tynka,drakkari,1463,mage,frost,30,16,14
21266,Jikario,zuljin,1463,mage,frost,42,21,21
21267,Magetherian,frostmourne,1463,mage,frost,96,46,50
21268,Revised,sargeras,1462,mage,frost,94,52,42
21269,Hugostiglets,dreadmaul,1462,mage,frost,146,71,75
21270,Gualter,nemesis,1460,mage,frost,147,84,63
21271,Zeshilol,stormrage,1460,mage,frost,51,21,30
21272,Fakewarlockk,illidan,1459,mage,frost,100,54,46
21273,Ruzam,area-52,1456,mage,frost,113,60,53
21274,Deadsayru,drakkari,1456,mage,frost,52,27,25
21275,Corruptionz,nemesis,1455,mage,frost,72,36,36
21276,Syntacks,lightnings-blade,1454,mage,frost,324,157,167
21277,Tifrodo,azralon,1452,mage,frost,70,39,31
21278,Üman,bleeding-hollow,1451,mage,frost,30,17,13
21279,Coôler,illidan,1451,mage,frost,160,90,70
21280,Kfortyone,kiljaeden,1450,mage,frost,30,16,14
21281,Meer,stonemaul,1448,mage,frost,72,44,28
21282,Scrúmp,tichondrius,1448,mage,frost,66,33,33
21283,Nereidan,drakkari,1448,mage,frost,62,29,33
21284,Myxzz,barthilas,1447,mage,frost,380,192,188
21285,Minerves,tichondrius,1446,mage,frost,42,20,22
21286,Roseofsharon,tichondrius,1446,mage,frost,42,18,24
21287,Wolfgangvn,stormrage,1446,mage,frost,48,20,28
21288,Bettybonk,cenarius,1441,mage,frost,59,26,33
21289,Aloredron,illidan,1440,mage,frost,53,27,26
21290,Pvpbilly,tichondrius,1439,mage,frost,24,15,9
21291,Zirkur,mannoroth,1437,mage,frost,56,26,30
21292,Forged,tichondrius,1436,mage,frost,60,25,35
21293,Siayo,stormscale,1433,mage,frost,46,24,22
21294,Cumbustyomom,illidan,1433,mage,frost,30,15,15
21295,Getsheepedon,boulderfist,1433,mage,frost,54,22,32
21296,Sesshomaru,emerald-dream,1433,mage,frost,51,18,33
21297,Ddeuuk,tichondrius,1431,mage,frost,59,27,32
21298,Mmine,tichondrius,1430,mage,frost,30,15,15
21299,Vendizzle,malganis,1429,mage,frost,59,27,32
21300,Crøwgxd,tichondrius,1428,mage,frost,24,15,9
21301,Erîol,ragnaros,1428,mage,frost,200,99,101
21302,Osnapmage,malganis,1428,mage,frost,276,136,140
21303,Babyspise,nathrezim,1425,mage,frost,24,15,9
21304,Respectx,nemesis,1425,mage,frost,76,34,42
21305,Trolson,sargeras,1425,mage,frost,102,45,57
21306,Fireguard,azralon,1424,mage,frost,30,16,14
21307,Renoria,norgannon,1424,mage,frost,30,15,15
21308,Linhny,tichondrius,1421,mage,frost,111,59,52
21309,Raisonmage,tichondrius,1421,mage,frost,54,28,26
21310,Garbagemage,barthilas,1421,mage,frost,30,15,15
21311,Choxiy,illidan,1419,mage,frost,36,15,21
21312,Guyza,frostmourne,1418,mage,frost,143,66,77
21313,Lachawr,stormrage,1414,mage,frost,214,109,105
21314,Tossdztosdoz,tichondrius,1414,mage,frost,30,15,15
21315,Biofreze,malganis,1414,mage,frost,60,26,34
21316,Gazzuu,ragnaros,1413,mage,frost,42,22,20
21317,Creatïne,stormrage,1413,mage,frost,151,76,75
21318,Kitenic,proudmoore,1412,mage,frost,71,37,34
21319,Ciaooh,tichondrius,1408,mage,frost,93,43,50
21320,Canva,barthilas,1406,mage,frost,41,25,16
21321,Throatdemon,hakkar,1405,mage,frost,48,25,23
21322,Odaravla,proudmoore,1405,mage,frost,108,51,57
21323,Nate,black-dragonflight,1404,mage,frost,128,65,63
21324,Nargine,tichondrius,1403,mage,frost,30,15,15
21325,Gunzup,lightnings-blade,1403,mage,frost,30,15,15
21326,Pizzatest,area-52,1402,mage,frost,52,19,33
21327,Gasolína,stormrage,1401,mage,frost,100,47,53
21328,Koulder,zuljin,1400,mage,frost,62,35,27
21329,Archewing,azjolnerub,1399,mage,frost,42,16,26
21330,Därkmägician,tichondrius,1398,mage,frost,44,24,20
21331,Rossanopolis,tichondrius,1397,mage,frost,59,30,29
21332,Frussy,blood-furnace,1395,mage,frost,114,57,57
21333,Arckayne,zuljin,1395,mage,frost,82,31,51
21334,Starscreamm,ragnaros,1394,mage,frost,40,23,17
21335,Azhim,tichondrius,1394,mage,frost,54,25,29
21336,Clm,lightnings-blade,1393,mage,frost,137,68,69
21337,Crymachine,garrosh,1391,mage,frost,33,17,16
21338,Boejanglz,frostmourne,1390,mage,frost,28,17,11
21339,Kahili,stormrage,1390,mage,frost,77,35,42
21340,Chadyus,illidan,1390,mage,frost,42,17,25
21341,Affinitty,zuljin,1389,mage,frost,48,27,21
21342,Zzyuh,proudmoore,1389,mage,frost,52,25,27
21343,Mclanda,frostmourne,1388,mage,frost,116,55,61
21344,Wienerjeff,area-52,1385,mage,frost,47,28,19
21345,Maguín,tichondrius,1384,mage,frost,30,15,15
21346,Epifeni,blackrock,1383,mage,frost,55,24,31
21347,Magicbunny,andorhal,1382,mage,frost,213,109,104
21348,Ultrá,stormscale,1379,mage,frost,33,16,17
21349,Mëlkart,ragnaros,1377,mage,frost,72,36,36
21350,Zoidy,bleeding-hollow,1377,mage,frost,35,15,20
21351,Lightsoran,tichondrius,1375,mage,frost,17,15,2
21352,Kh,stormrage,1374,mage,frost,99,50,49
21353,Cheesebuns,proudmoore,1373,mage,frost,74,32,42
21354,Wojnova,zuljin,1372,mage,frost,24,15,9
21355,Lilkyrie,senjin,1372,mage,frost,60,25,35
21356,Hhappier,tichondrius,1371,mage,frost,65,32,33
21357,Harrypothead,senjin,1370,mage,frost,35,24,11
21358,Tagere,moon-guard,1370,mage,frost,80,38,42
21359,Nhinsanity,ghostlands,1369,mage,frost,27,17,10
21360,Rrite,tichondrius,1366,mage,frost,29,15,14
21361,Dazby,tichondrius,1363,mage,frost,35,17,18
21362,Magicmooman,thunderlord,1359,mage,frost,63,30,33
21363,Kevymarts,tichondrius,1358,mage,frost,54,31,23
21364,Starkp,ragnaros,1357,mage,frost,177,86,91
21365,Tentaçao,stormrage,1352,mage,frost,68,34,34
21366,Iladiin,malganis,1350,mage,frost,52,26,26
21367,Asparagoose,stormrage,1347,mage,frost,29,15,14
21368,Radiku,blood-furnace,1347,mage,frost,31,16,15
21369,Freez,garona,1346,mage,frost,40,18,22
21370,Anarista,wyrmrest-accord,1345,mage,frost,24,15,9
21371,Aqcamus,illidan,1344,mage,frost,23,15,8
21372,Vampìrelolz,tichondrius,1344,mage,frost,24,14,10
21373,Mâsterkush,tichondrius,1343,mage,frost,46,23,23
21374,Cryogeniks,illidan,1343,mage,frost,30,14,16
21375,Frøstdrægöñ,illidan,1341,mage,frost,18,14,4
21376,Mageyoulooks,kelthuzad,1340,mage,frost,36,17,19
21377,Shatturd,sargeras,1339,mage,frost,78,31,47
21378,Messiaah,tichondrius,1339,mage,frost,36,14,22
21379,Plainblaine,illidan,1337,mage,frost,98,47,51
21380,Krabby,malganis,1337,mage,frost,66,26,40
21381,Clownspocket,tichondrius,1336,mage,frost,83,46,37
21382,Pivnert,boulderfist,1336,mage,frost,30,14,16
21383,Luckysix,illidan,1336,mage,frost,36,14,22
21384,Safu,bleeding-hollow,1335,mage,frost,120,63,57
21385,Milambehr,elune,1335,mage,frost,54,28,26
21386,Nicemangoes,proudmoore,1335,mage,frost,30,15,15
21387,Hammed,dalaran,1334,mage,frost,68,32,36
21388,Aherom,ragnaros,1333,mage,frost,51,30,21
21389,Safety,stormreaver,1330,mage,frost,146,77,69
21390,Rích,tichondrius,1330,mage,frost,126,56,70
21391,Juul,emerald-dream,1328,mage,frost,237,109,128
21392,Zaddyx,whisperwind,1326,mage,frost,30,14,16
21393,Selless,zuljin,1325,mage,frost,66,33,33
21394,Valtaira,wyrmrest-accord,1322,mage,frost,148,81,67
21395,Hirune,ragnaros,1322,mage,frost,70,25,45
21396,Eriktherod,maelstrom,1321,mage,frost,36,15,21
21397,Tarmiel,quelthalas,1319,mage,frost,54,28,26
21398,Skillcap,nagrand,1315,mage,frost,30,16,14
21399,Andorlin,barthilas,1315,mage,frost,47,22,25
21400,Aarne,thrall,1315,mage,frost,36,16,20
21401,Elegantbroth,illidan,1312,mage,frost,30,14,16
21402,Phergo,ragnaros,1311,mage,frost,36,14,22
21403,Ragemage,borean-tundra,1311,mage,frost,59,20,39
21404,Plunks,bleeding-hollow,1310,mage,frost,80,30,50
21405,Mntaindew,bleeding-hollow,1309,mage,frost,35,14,21
21406,Shäräpova,zuljin,1308,mage,frost,36,20,16
21407,Frøzzen,quelthalas,1307,mage,frost,147,67,80
21408,Vorass,kelthuzad,1305,mage,frost,42,18,24
21409,Tyning,blood-furnace,1304,mage,frost,54,27,27
21410,Abracadaver,greymane,1302,mage,frost,64,36,28
21411,Xárdas,quelthalas,1302,mage,frost,107,56,51
21412,Soia,ragnaros,1302,mage,frost,143,72,71
21413,Rahzac,dalaran,1302,mage,frost,62,29,33
21414,Tessar,moon-guard,1300,mage,frost,100,43,57
21415,Samaë,zuljin,1300,mage,frost,35,15,20
21416,Haruká,ragnaros,1300,mage,frost,45,15,30
21417,Paidemago,azralon,1299,mage,frost,65,40,25
21418,Frostítute,alterac-mountains,1299,mage,frost,60,28,32
21419,Eskimoan,frostmourne,1298,mage,frost,42,15,27
21420,Jugobomb,madoran,1295,mage,frost,46,25,21
21421,Frostitutå,eonar,1293,mage,frost,118,54,64
21422,Hotpeachpie,zuljin,1290,mage,frost,85,44,41
21423,Gralnur,kelthuzad,1286,mage,frost,32,15,17
21424,Rastafarix,ragnaros,1285,mage,frost,47,21,26
21425,Cìfel,quelthalas,1281,mage,frost,31,18,13
21426,Dohnutt,tichondrius,1281,mage,frost,53,25,28
21427,Dumblexgamer,ragnaros,1281,mage,frost,72,33,39
21428,Ràmdas,hyjal,1278,mage,frost,60,30,30
21429,Derpmanjr,area-52,1277,mage,frost,60,39,21
21430,Skynhet,ragnaros,1277,mage,frost,36,16,20
21431,Cyberstar,proudmoore,1276,mage,frost,41,21,20
21432,Thergon,kul-tiras,1275,mage,frost,38,19,19
21433,Showtíme,spirestone,1273,mage,frost,24,16,8
21434,Kryliak,ragnaros,1273,mage,frost,60,33,27
21435,Discoinferno,kelthuzad,1273,mage,frost,45,22,23
21436,Somethinglos,sargeras,1273,mage,frost,106,47,59
21437,Cheapsects,drakthul,1272,mage,frost,32,17,15
21438,Unleáshed,moonrunner,1272,mage,frost,135,68,67
21439,Feogato,proudmoore,1271,mage,frost,153,76,77
21440,Quietusllil,gurubashi,1269,mage,frost,102,60,42
21441,Ignit,stormrage,1269,mage,frost,34,17,17
21442,Luckysi,illidan,1268,mage,frost,38,15,23
21443,Vengefuly,tichondrius,1264,mage,frost,34,17,17
21444,Bossmage,tichondrius,1263,mage,frost,37,15,22
21445,Missingxx,silvermoon,1261,mage,frost,53,26,27
21446,Whyammage,dalaran,1260,mage,frost,77,46,31
21447,Satív,moknathal,1258,mage,frost,42,25,17
21448,Drfrostie,anvilmar,1257,mage,frost,26,14,12
21449,Guji,area-52,1255,mage,frost,55,26,29
21450,Alìv,tichondrius,1254,mage,frost,190,85,105
21451,Comaner,frostmourne,1253,mage,frost,28,14,14
21452,Degenhours,illidan,1253,mage,frost,51,25,26
21453,Numz,sargeras,1252,mage,frost,148,67,81
21454,Baemers,tichondrius,1252,mage,frost,36,14,22
21455,Hýdramist,sargeras,1246,mage,frost,24,13,11
21456,Mângo,frostmourne,1243,mage,frost,24,13,11
21457,Lucyphilis,stormrage,1243,mage,frost,86,43,43
21458,Kromeus,illidan,1243,mage,frost,48,23,25
21459,Peetufo,whisperwind,1243,mage,frost,41,17,24
21460,Låvazza,tichondrius,1242,mage,frost,24,13,11
21461,Ðontßlink,illidan,1240,mage,frost,24,13,11
21462,Vênsêr,emerald-dream,1240,mage,frost,30,13,17
21463,Merkkinz,thrall,1239,mage,frost,65,31,34
21464,Mageyoulooks,shattered-hand,1238,mage,frost,30,15,15
21465,Agniih,azralon,1236,mage,frost,72,34,38
21466,ßlitzkreig,area-52,1235,mage,frost,24,18,6
21467,Tyrecgosa,tichondrius,1235,mage,frost,66,35,31
21468,Kevdra,kelthuzad,1233,mage,frost,72,32,40
21469,Hykkup,frostmourne,1232,mage,frost,24,13,11
21470,Phoenixic,frostmourne,1232,mage,frost,191,84,107
21471,Magifish,malganis,1231,mage,frost,62,35,27
21472,Rankryman,quelthalas,1231,mage,frost,58,29,29
21473,Magicginger,barthilas,1231,mage,frost,52,23,29
21474,Frostzadan,quelthalas,1228,mage,frost,56,23,33
21475,Mageosaurusx,tichondrius,1228,mage,frost,36,13,23
21476,Arcaninez,bleeding-hollow,1224,mage,frost,24,13,11
21477,Sturmrevenge,lightnings-blade,1224,mage,frost,137,70,67
21478,Samuoa,tichondrius,1223,mage,frost,41,21,20
21479,Gsr,nerzhul,1222,mage,frost,46,19,27
21480,Jobar,malganis,1221,mage,frost,24,13,11
21481,Jagmag,area-52,1219,mage,frost,18,14,4
21482,Jejihev,drakkari,1219,mage,frost,35,17,18
21483,Makén,illidan,1218,mage,frost,48,32,16
21484,Maac,nemesis,1216,mage,frost,29,14,15
21485,Fíebs,queldorei,1209,mage,frost,36,19,17
21486,Åquå,area-52,1208,mage,frost,33,18,15
21487,Phantombila,azralon,1207,mage,frost,39,14,25
21488,Djp,tichondrius,1206,mage,frost,43,25,18
21489,Iceehott,kargath,1206,mage,frost,73,38,35
21490,Akagamix,sargeras,1205,mage,frost,47,20,27
21491,Gunzz,aegwynn,1202,mage,frost,48,21,27
21492,Ejzok,dreadmaul,1201,mage,frost,202,89,113
21493,Acarilla,stormrage,1199,mage,frost,54,20,34
21494,Saski,nathrezim,1196,mage,frost,30,16,14
21495,Palruki,tichondrius,1193,mage,frost,60,22,38
21496,Kyll,moon-guard,1192,mage,frost,30,13,17
21497,Highafrn,area-52,1191,mage,frost,30,14,16
21498,Valrendor,nazjatar,1191,mage,frost,79,36,43
21499,Juxmcmage,kiljaeden,1189,mage,frost,60,20,40
21500,Dooie,sargeras,1188,mage,frost,28,19,9
21501,Canassa,azralon,1183,mage,frost,131,66,65
21502,Sîmply,zuljin,1183,mage,frost,42,13,29
21503,Maigoddess,proudmoore,1180,mage,frost,71,29,42
21504,Twinklestars,sargeras,1179,mage,frost,72,40,32
21505,Numaïr,kiljaeden,1179,mage,frost,68,27,41
21506,Featherboo,stormrage,1178,mage,frost,35,16,19
21507,Chade,dunemaul,1178,mage,frost,53,22,31
21508,Icebboxx,tichondrius,1176,mage,frost,36,21,15
21509,Daddyplease,bleeding-hollow,1176,mage,frost,42,20,22
21510,Gatka,quelthalas,1171,mage,frost,334,162,172
21511,Layolis,area-52,1170,mage,frost,92,46,46
21512,Pendrake,sargeras,1170,mage,frost,34,13,21
21513,Giovannie,zuluhed,1169,mage,frost,54,25,29
21514,Darkrukia,tichondrius,1168,mage,frost,63,32,31
21515,Cocmagic,kelthuzad,1167,mage,frost,33,15,18
21516,Aquariusmoon,bonechewer,1166,mage,frost,60,31,29
21517,Toesuckerlol,tichondrius,1164,mage,frost,33,16,17
21518,Yamitenshi,dalaran,1162,mage,frost,68,24,44
21519,Bubbleblower,hakkar,1161,mage,frost,30,15,15
21520,Devlux,area-52,1158,mage,frost,104,50,54
21521,Khaldyn,tichondrius,1156,mage,frost,132,65,67
21522,Defarefa,frostmourne,1156,mage,frost,150,71,79
21523,Floopse,agamaggan,1153,mage,frost,18,13,5
21524,Cavit,wyrmrest-accord,1153,mage,frost,63,29,34
21525,Bçøløñápûðgé,illidan,1152,mage,frost,18,12,6
21526,Xtymhxy,tichondrius,1152,mage,frost,24,12,12
21527,Iceward,frostmourne,1151,mage,frost,18,12,6
21528,Czq,tichondrius,1150,mage,frost,18,12,6
21529,Damage,skullcrusher,1150,mage,frost,31,13,18
21530,Rbn,tichondrius,1148,mage,frost,33,13,20
21531,Magewara,area-52,1147,mage,frost,18,12,6
21532,Snipymagus,shattered-hand,1146,mage,frost,27,13,14
21533,Crizzpy,tichondrius,1146,mage,frost,48,22,26
21534,Alatria,frostmourne,1146,mage,frost,66,24,42
21535,Pyroshima,barthilas,1145,mage,frost,40,13,27
21536,Corrmic,winterhoof,1144,mage,frost,72,36,36
21537,Peakd,bleeding-hollow,1144,mage,frost,30,12,18
21538,Yungice,hyjal,1144,mage,frost,36,14,22
21539,Frenk,moon-guard,1143,mage,frost,42,15,27
21540,Vasthrash,bleeding-hollow,1142,mage,frost,78,33,45
21541,Diixynormus,illidan,1141,mage,frost,30,17,13
21542,Tsuchek,tichondrius,1139,mage,frost,24,12,12
21543,Hiiamtay,azralon,1138,mage,frost,26,14,12
21544,Boldwarp,dalaran,1138,mage,frost,29,14,15
21545,Thatotherguy,lightnings-blade,1137,mage,frost,22,13,9
21546,Sahir,thaurissan,1135,mage,frost,48,20,28
21547,Twirkin,proudmoore,1131,mage,frost,42,22,20
21548,Littlebeth,azjolnerub,1127,mage,frost,89,46,43
21549,Fatum,ragnaros,1124,mage,frost,32,14,18
21550,Elwyn,dunemaul,1123,mage,frost,27,13,14
21551,Evierix,illidan,1123,mage,frost,88,42,46
21552,Nazneen,elune,1122,mage,frost,73,31,42
21553,Icelordd,ragnaros,1121,mage,frost,30,14,16
21554,Coldfrønt,moon-guard,1120,mage,frost,48,21,27
21555,Deadmarley,blackhand,1116,mage,frost,36,19,17
21556,Dannyyoo,blackrock,1116,mage,frost,23,12,11
21557,Bellåtrîx,quelthalas,1115,mage,frost,18,12,6
21558,Icybanter,emerald-dream,1115,mage,frost,53,22,31
21559,Who,emerald-dream,1113,mage,frost,58,27,31
21560,Menacë,tichondrius,1112,mage,frost,30,12,18
21561,Sølem,frostmourne,1112,mage,frost,42,16,26
21562,Osda,azralon,1111,mage,frost,36,19,17
21563,Levitaine,bleeding-hollow,1110,mage,frost,38,19,19
21564,Ibalyn,khazgoroth,1109,mage,frost,101,49,52
21565,Castingmommy,moon-guard,1108,mage,frost,73,37,36
21566,Rekonx,tichondrius,1107,mage,frost,91,41,50
21567,Granmago,azralon,1106,mage,frost,30,12,18
21568,Skdonkay,nerzhul,1102,mage,frost,89,45,44
21569,Hollerin,whisperwind,1098,mage,frost,18,12,6
21570,Memnor,amanthul,1098,mage,frost,24,12,12
21571,Gelile,tichondrius,1097,mage,frost,59,28,31
21572,Magedango,bleeding-hollow,1095,mage,frost,35,14,21
21573,Azzurn,doomhammer,1090,mage,frost,24,13,11
21574,Esun,moon-guard,1088,mage,frost,36,17,19
21575,Drumzter,ragnaros,1085,mage,frost,41,21,20
21576,Ralzarek,zuluhed,1085,mage,frost,30,15,15
21577,Raxxor,muradin,1085,mage,frost,30,12,18
21578,Helcarwen,area-52,1081,mage,frost,31,13,18
21579,Blancnoir,tichondrius,1081,mage,frost,39,16,23
21580,Magekingz,shattered-halls,1080,mage,frost,54,27,27
21581,Wickednoob,malganis,1080,mage,frost,132,62,70
21582,Mageeoh,bleeding-hollow,1072,mage,frost,47,15,32
21583,Leets,mugthol,1070,mage,frost,18,12,6
21584,Gryd,area-52,1070,mage,frost,88,43,45
21585,Travarra,terenas,1069,mage,frost,60,19,41
21586,Mageolisious,kelthuzad,1063,mage,frost,30,12,18
21587,Bootnet,drakkari,1063,mage,frost,54,16,38
21588,Copperfield,dreadmaul,1060,mage,frost,122,50,72
21589,Lildabpen,tichondrius,1057,mage,frost,86,34,52
21590,Dealzy,malganis,1056,mage,frost,18,11,7
21591,Saydar,stormrage,1056,mage,frost,36,11,25
21592,Redhell,dalaran,1055,mage,frost,18,11,7
21593,Zacx,area-52,1055,mage,frost,24,11,13
21594,Gadogear,draka,1054,mage,frost,30,11,19
21595,Doubledown,kiljaeden,1053,mage,frost,18,11,7
21596,Corucia,echo-isles,1053,mage,frost,256,121,135
21597,Xannymancan,tichondrius,1052,mage,frost,60,23,37
21598,Walrusxo,kelthuzad,1052,mage,frost,30,11,19
21599,Arcranium,icecrown,1051,mage,frost,18,11,7
21600,Coldshouldér,nerzhul,1051,mage,frost,24,11,13
21601,Auralyn,wyrmrest-accord,1051,mage,frost,25,11,14
21602,Zuqo,sargeras,1050,mage,frost,18,11,7
21603,Mirmaduck,wyrmrest-accord,1049,mage,frost,18,11,7
21604,Klinkr,illidan,1049,mage,frost,30,11,19
21605,Ggtoasted,thrall,1048,mage,frost,18,11,7
21606,Annalee,ragnaros,1048,mage,frost,24,11,13
21607,Médüsa,moon-guard,1047,mage,frost,18,11,7
21608,Moistcream,bloodscalp,1047,mage,frost,22,12,10
21609,Zehlks,garrosh,1047,mage,frost,30,13,17
21610,Zibbo,ragnaros,1046,mage,frost,18,11,7
21611,Ceadruk,darkspear,1046,mage,frost,30,14,16
21612,Skywalkerino,azralon,1045,mage,frost,24,11,13
21613,Mindthegap,tichondrius,1044,mage,frost,57,30,27
21614,Keahiláni,area-52,1043,mage,frost,27,13,14
21615,Vyninovan,aggramar,1043,mage,frost,24,11,13
21616,Magicke,azgalor,1042,mage,frost,23,14,9
21617,Gradivous,emerald-dream,1042,mage,frost,88,39,49
21618,Iacceptvenmo,tichondrius,1041,mage,frost,18,11,7
21619,Jorzan,kelthuzad,1041,mage,frost,24,11,13
21620,Ispell,tichondrius,1040,mage,frost,30,20,10
21621,Devoh,dunemaul,1040,mage,frost,20,11,9
21622,Remana,anvilmar,1039,mage,frost,24,11,13
21623,Limeade,ursin,1038,mage,frost,24,11,13
21624,Xoxmage,frostmourne,1037,mage,frost,66,35,31
21625,Khrixa,illidan,1036,mage,frost,114,55,59
21626,Arkoz,tichondrius,1035,mage,frost,24,14,10
21627,Starguy,laughing-skull,1034,mage,frost,37,14,23
21628,Trentos,illidan,1033,mage,frost,54,29,25
21629,Briélla,area-52,1032,mage,frost,54,26,28
21630,Smáckington,tichondrius,1032,mage,frost,118,53,65
21631,Pugsmugg,icecrown,1032,mage,frost,49,13,36
21632,Sluagh,terenas,1031,mage,frost,52,24,28
21633,Brashen,stormrage,1030,mage,frost,55,27,28
21634,Niscra,nemesis,1026,mage,frost,40,12,28
21635,Wowenjoyer,area-52,1025,mage,frost,91,42,49
21636,Sciona,suramar,1025,mage,frost,141,62,79
21637,Raáiden,stormrage,1024,mage,frost,42,18,24
21638,Drbloodmuscl,black-dragonflight,1020,mage,frost,36,15,21
21639,Codexzero,bleeding-hollow,1017,mage,frost,66,29,37
21640,Trollsita,thrall,1013,mage,frost,18,11,7
21641,Voidera,wyrmrest-accord,1012,mage,frost,36,11,25
21642,Sènding,sargeras,1010,mage,frost,42,11,31
21643,Oopsyourapig,darkspear,1007,mage,frost,48,17,31
21644,Rizzbot,sargeras,1005,mage,frost,75,27,48
21645,Pizzle,perenolde,1004,mage,frost,58,27,31
21646,Neacel,tichondrius,1004,mage,frost,24,11,13
21647,Vynruki,area-52,1003,mage,frost,30,15,15
21648,Jaymage,agamaggan,994,mage,frost,37,13,24
21649,Vantus,tichondrius,993,mage,frost,32,17,15
21650,Worknlurk,malganis,992,mage,frost,24,12,12
21651,Kannim,sargeras,992,mage,frost,66,27,39
21652,Megapasta,illidan,989,mage,frost,23,11,12
21653,Superoirity,trollbane,988,mage,frost,48,24,24
21654,Prometheus,crushridge,986,mage,frost,52,27,25
21655,Jayfunk,sargeras,984,mage,frost,23,11,12
21656,Bound,emerald-dream,983,mage,frost,23,11,12
21657,Bòóyah,muradin,980,mage,frost,40,21,19
21658,Grudel,archimonde,979,mage,frost,41,21,20
21659,Hékate,moon-guard,979,mage,frost,48,12,36
21660,Iesca,ragnaros,978,mage,frost,23,12,11
21661,Bigpinkies,korgath,976,mage,frost,42,16,26
21662,Thaldarian,emerald-dream,975,mage,frost,31,12,19
21663,Dejavuh,dalaran,972,mage,frost,54,25,29
21664,Rephlex,tichondrius,970,mage,frost,19,11,8
21665,Dieselonfire,the-venture-co,967,mage,frost,56,29,27
21666,Crankweigth,rivendare,965,mage,frost,84,40,44
21667,Édika,area-52,963,mage,frost,30,11,19
21668,Torthie,burning-blade,960,mage,frost,12,10,2
21669,Bigsplosions,kiljaeden,960,mage,frost,15,11,4
21670,Tainx,frostmourne,960,mage,frost,18,10,8
21671,Thefridge,shadowmoon,960,mage,frost,18,10,8
21672,Kygores,tichondrius,960,mage,frost,18,10,8
21673,Hadlly,tichondrius,960,mage,frost,18,10,8
21674,Legendkiller,bleeding-hollow,959,mage,frost,18,10,8
21675,Finnancy,stormrage,959,mage,frost,18,10,8
21676,Arillius,malganis,959,mage,frost,18,10,8
21677,Nukedat,proudmoore,959,mage,frost,18,10,8
21678,Ntys,frostmourne,959,mage,frost,18,10,8
21679,Shimmerpoly,sargeras,959,mage,frost,24,10,14
21680,Bigmêan,boulderfist,958,mage,frost,18,10,8
21681,Aluce,frostmourne,958,mage,frost,18,10,8
21682,Fineous,kalecgos,958,mage,frost,24,10,14
21683,Hylord,tichondrius,957,mage,frost,18,10,8
21684,Zunyu,tichondrius,957,mage,frost,18,10,8
21685,Aurumpaleas,moon-guard,956,mage,frost,24,11,13
21686,Shephard,nemesis,956,mage,frost,24,10,14
21687,Solusek,garona,955,mage,frost,18,10,8
21688,Nethros,stormrage,954,mage,frost,15,11,4
21689,Trízín,frostmourne,954,mage,frost,18,10,8
21690,Nnenna,bonechewer,952,mage,frost,18,10,8
21691,Moonfhang,azralon,952,mage,frost,257,120,137
21692,Unmix,tichondrius,952,mage,frost,24,10,14
21693,Imoen,zangarmarsh,951,mage,frost,36,15,21
21694,Zedroçk,shadowmoon,951,mage,frost,24,10,14
21695,Nksbluedeath,area-52,949,mage,frost,18,10,8
21696,Keelaron,proudmoore,949,mage,frost,24,10,14
21697,Rasmin,greymane,948,mage,frost,40,22,18
21698,Shírley,tichondrius,948,mage,frost,30,10,20
21699,Redeyez,arthas,947,mage,frost,137,65,72
21700,Misfyre,malganis,946,mage,frost,28,11,17
21701,Hhavok,scarlet-crusade,944,mage,frost,36,10,26
21702,Onlyfansme,dalaran,939,mage,frost,18,10,8
21703,Gaduri,tichondrius,938,mage,frost,23,11,12
21704,Bôsco,bleeding-hollow,936,mage,frost,20,11,9
21705,Diegoneally,bleeding-hollow,936,mage,frost,63,26,37
21706,Angerfrost,khazgoroth,935,mage,frost,48,23,25
21707,Mystics,dawnbringer,935,mage,frost,110,44,66
21708,Hasty,emerald-dream,927,mage,frost,29,10,19
21709,Ärià,sargeras,926,mage,frost,18,10,8
21710,Maldine,tol-barad,926,mage,frost,18,10,8
21711,Trollings,azralon,925,mage,frost,63,30,33
21712,Fireace,emerald-dream,922,mage,frost,17,10,7
21713,Drpeppor,blades-edge,922,mage,frost,18,10,8
21714,Fireblast,stormscale,922,mage,frost,41,16,25
21715,Brynach,trollbane,913,mage,frost,42,20,22
21716,Cawyro,caelestrasz,913,mage,frost,47,22,25
21717,Mongera,bonechewer,909,mage,frost,50,25,25
21718,Moesel,emerald-dream,908,mage,frost,15,11,4
21719,Hambürglar,garrosh,907,mage,frost,24,12,12
21720,Leocius,daggerspine,906,mage,frost,23,10,13
21721,Marschubas,drakthul,905,mage,frost,83,37,46
21722,Mugiara,azralon,897,mage,frost,21,10,11
21723,Critique,malorne,894,mage,frost,54,27,27
21724,Lillbean,thunderlord,894,mage,frost,25,11,14
21725,Mageboy,bonechewer,894,mage,frost,29,10,19
21726,Puvö,tichondrius,889,mage,frost,26,10,16
21727,Tristania,archimonde,888,mage,frost,107,54,53
21728,Scár,blackrock,873,mage,frost,20,10,10
21729,Luxfumante,azralon,869,mage,frost,24,12,12
21730,Mideon,whisperwind,865,mage,frost,43,20,23
21731,Nasgeth,darkspear,864,mage,frost,12,9,3
21732,Blurrs,illidan,864,mage,frost,12,9,3
21733,Kaylemage,tichondrius,864,mage,frost,12,9,3
21734,Furisheep,stormrage,864,mage,frost,12,9,3
21735,Rositajonez,terenas,864,mage,frost,12,9,3
21736,Nalabb,illidan,864,mage,frost,12,9,3
21737,Zlint,ragnaros,864,mage,frost,12,9,3
21738,Benzos,eitrigg,864,mage,frost,12,9,3
21739,Hyoonsfeet,stormrage,864,mage,frost,18,9,9
21740,Fromcanada,eitrigg,864,mage,frost,18,9,9
21741,Weathersmell,tichondrius,864,mage,frost,18,9,9
21742,Skoals,thrall,864,mage,frost,29,10,19
21743,Blinkbotx,proudmoore,863,mage,frost,18,9,9
21744,Lastiari,wyrmrest-accord,863,mage,frost,18,9,9
21745,Jottami,azralon,863,mage,frost,18,9,9
21746,Juanmánce,quelthalas,863,mage,frost,20,9,11
21747,Soukidiot,sargeras,863,mage,frost,24,9,15
21748,Benjamming,ragnaros,863,mage,frost,24,9,15
21749,Blinkharder,stormrage,863,mage,frost,24,9,15
21750,Wolfsmind,frostmourne,863,mage,frost,30,9,21
21751,Jodebabss,dalaran,862,mage,frost,18,9,9
21752,Cryyo,queldorei,862,mage,frost,18,9,9
21753,Boredomkïlls,burning-legion,862,mage,frost,18,9,9
21754,Youngwiz,arthas,862,mage,frost,18,9,9
21755,Faire,stonemaul,862,mage,frost,18,9,9
21756,Åøe,tichondrius,862,mage,frost,18,9,9
21757,Neomage,elune,862,mage,frost,22,9,13
21758,Tunax,tichondrius,862,mage,frost,24,9,15
21759,FleasyA8713E,wyrmrest-accord,862,mage,frost,24,9,15
21760,Skizzlés,bleeding-hollow,861,mage,frost,18,9,9
21761,Shenme,moon-guard,861,mage,frost,20,9,11
21762,Fruza,emerald-dream,860,mage,frost,16,10,6
21763,Zaxrie,malganis,860,mage,frost,18,9,9
21764,Pantsbeard,illidan,859,mage,frost,30,9,21
21765,Vallet,ragnaros,858,mage,frost,12,9,3
21766,Cuoreforte,moon-guard,858,mage,frost,24,9,15
21767,Cùrtiñ,tichondrius,858,mage,frost,30,9,21
21768,Telios,azralon,857,mage,frost,16,10,6
21769,Cransmage,illidan,856,mage,frost,18,9,9
21770,Kaboozles,area-52,853,mage,frost,24,9,15
21771,Soya,sargeras,852,mage,frost,24,9,15
21772,Naoz,ragnaros,851,mage,frost,18,9,9
21773,Rkbj,korgath,851,mage,frost,31,9,22
21774,Zabaione,stormrage,847,mage,frost,28,10,18
21775,Avers,frostwolf,844,mage,frost,24,9,15
21776,Bandagris,garrosh,840,mage,frost,21,10,11
21777,Rathrizar,emerald-dream,840,mage,frost,30,13,17
21778,Jarethleon,ragnaros,837,mage,frost,21,11,10
21779,Nezarrek,sargeras,835,mage,frost,18,9,9
21780,Âürõrâ,firetree,834,mage,frost,24,9,15
21781,Taylorrain,arthas,829,mage,frost,36,14,22
21782,Craftin,sargeras,827,mage,frost,18,9,9
21783,Itoncruxy,tichondrius,825,mage,frost,69,30,39
21784,Assasix,tichondrius,810,mage,frost,36,12,24
21785,Airgumbo,illidan,796,mage,frost,14,9,5
21786,Zionist,earthen-ring,796,mage,frost,14,9,5
21787,Frightmare,sargeras,768,mage,frost,12,8,4
21788,Pandazed,stormscale,768,mage,frost,12,8,4
21789,Eyesofrage,tichondrius,768,mage,frost,12,8,4
21790,Dearyuanmage,tichondrius,768,mage,frost,12,8,4
21791,Arrokoth,malganis,768,mage,frost,12,8,4
21792,Justmoss,sargeras,768,mage,frost,12,8,4
21793,Edm,proudmoore,768,mage,frost,12,8,4
21794,Nefm,frostmourne,768,mage,frost,12,8,4
21795,Brandonlol,area-52,768,mage,frost,12,8,4
21796,Wiztopher,frostmourne,768,mage,frost,12,8,4
21797,Zstyle,frostmourne,768,mage,frost,18,8,10
21798,Georgian,malfurion,768,mage,frost,18,8,10
21799,Blinkinghobo,sargeras,768,mage,frost,18,8,10
21800,Yeetcannøn,illidan,768,mage,frost,18,8,10
21801,Mcdude,kiljaeden,768,mage,frost,18,8,10
21802,Magibe,thrall,768,mage,frost,18,8,10
21803,Dead,nemesis,768,mage,frost,18,8,10
21804,Lycheeoolong,frostmourne,768,mage,frost,18,8,10
21805,Magnificaxd,area-52,768,mage,frost,24,8,16
21806,Nôtôrious,thrall,767,mage,frost,12,8,4
21807,Vonte,elune,767,mage,frost,12,8,4
21808,Mempool,darkspear,767,mage,frost,12,8,4
21809,Magicmaster,quelthalas,767,mage,frost,12,8,4
21810,Crvarla,tichondrius,767,mage,frost,12,8,4
21811,Seeumaybe,proudmoore,767,mage,frost,12,8,4
21812,Bigdjohnson,dalaran,767,mage,frost,12,8,4
21813,Frosttwoop,moon-guard,767,mage,frost,12,8,4
21814,Songnineone,tichondrius,767,mage,frost,12,8,4
21815,Maauie,sargeras,767,mage,frost,16,8,8
21816,Staytrill,stormreaver,767,mage,frost,18,8,10
21817,Vamplol,tichondrius,767,mage,frost,18,8,10
21818,Numb,trollbane,767,mage,frost,18,8,10
21819,Jayma,moon-guard,767,mage,frost,18,8,10
21820,Keiiox,ragnaros,767,mage,frost,18,8,10
21821,Qtqq,malganis,767,mage,frost,18,8,10
21822,Linsz,nemesis,767,mage,frost,18,8,10
21823,Wickymorph,barthilas,767,mage,frost,18,8,10
21824,Drdocx,frostmourne,767,mage,frost,18,8,10
21825,Badboykilla,dentarg,767,mage,frost,21,9,12
21826,Gardes,tichondrius,767,mage,frost,24,8,16
21827,Teloiv,malganis,766,mage,frost,12,8,4
21828,Mägï,tichondrius,766,mage,frost,12,8,4
21829,Stinker,nazjatar,766,mage,frost,18,8,10
21830,Barcilas,proudmoore,766,mage,frost,24,8,16
21831,Moonpie,frostmane,765,mage,frost,12,8,4
21832,Moonwater,vashj,765,mage,frost,18,8,10
21833,Rmprmp,tichondrius,764,mage,frost,18,8,10
21834,Nynalith,area-52,764,mage,frost,18,8,10
21835,Snowjôb,illidan,764,mage,frost,24,8,16
21836,Marvelcuck,sargeras,763,mage,frost,12,8,4
21837,Syndra,korialstrasz,763,mage,frost,24,8,16
21838,Frigginbeast,shattered-halls,762,mage,frost,19,8,11
21839,Ashklabam,azralon,761,mage,frost,12,8,4
21840,Ràisens,stormscale,755,mage,frost,12,8,4
21841,Scmage,exodar,755,mage,frost,18,8,10
21842,Queimabixo,azralon,755,mage,frost,18,8,10
21843,Icepickk,blackwater-raiders,752,mage,frost,12,8,4
21844,Ratrider,dreadmaul,752,mage,frost,12,8,4
21845,Hoecakez,tichondrius,749,mage,frost,17,9,8
21846,Artruis,detheroc,748,mage,frost,12,8,4
21847,Bandmaid,emerald-dream,736,mage,frost,16,9,7
21848,Cowwboydan,malganis,735,mage,frost,14,9,5
21849,Phalkore,dalaran,735,mage,frost,16,8,8
21850,Omegablink,sargeras,734,mage,frost,17,8,9
21851,Letitgoo,azralon,733,mage,frost,34,17,17
21852,Silverstrza,gnomeregan,726,mage,frost,18,8,10
21853,Homodilf,blackrock,726,mage,frost,24,9,15
21854,Heca,tichondrius,719,mage,frost,11,8,3
21855,Stankfreezer,thrall,719,mage,frost,11,8,3
21856,Ìgnìtìöñ,whisperwind,718,mage,frost,21,8,13
21857,Triambukh,grizzly-hills,712,mage,frost,25,10,15
21858,Scarlin,proudmoore,703,mage,frost,11,8,3
21859,Lünâliä,bleeding-hollow,686,mage,frost,14,8,6
21860,Proximalol,tichondrius,672,mage,frost,12,7,5
21861,Stinkyblinky,bleeding-hollow,672,mage,frost,12,7,5
21862,Sylendron,area-52,672,mage,frost,12,7,5
21863,Ankidar,quelthalas,672,mage,frost,12,7,5
21864,Neovim,stormrage,672,mage,frost,12,7,5
21865,Kujousara,stormrage,672,mage,frost,12,7,5
21866,Mushys,stormrage,672,mage,frost,12,7,5
21867,Elfvis,deathwing,672,mage,frost,12,7,5
21868,Kogin,thrall,672,mage,frost,12,7,5
21869,Kahve,dalaran,672,mage,frost,12,7,5
21870,Crnomage,area-52,672,mage,frost,12,7,5
21871,Tibbit,kelthuzad,672,mage,frost,12,7,5
21872,Playtimex,proudmoore,672,mage,frost,12,7,5
21873,Reptär,demon-soul,672,mage,frost,12,7,5
21874,Bigchilly,malganis,672,mage,frost,12,7,5
21875,Cädemäddox,stormrage,672,mage,frost,12,7,5
21876,Toteypotter,frostmourne,672,mage,frost,12,7,5
21877,Fakewizard,frostmane,672,mage,frost,12,7,5
21878,Brobo,chogall,672,mage,frost,12,7,5
21879,Versacejay,sargeras,672,mage,frost,12,7,5
21880,Emvepee,sargeras,672,mage,frost,12,7,5
21881,Myfamilygpie,nazgrel,672,mage,frost,12,7,5
21882,Matchstickk,tichondrius,672,mage,frost,15,8,7
21883,Lillb,bleeding-hollow,672,mage,frost,18,7,11
21884,Licklix,tichondrius,672,mage,frost,18,7,11
21885,Privilege,burning-legion,672,mage,frost,18,7,11
21886,Converseqt,stormrage,672,mage,frost,18,7,11
21887,Xàr,ragnaros,672,mage,frost,18,7,11
21888,Arynnwyll,chogall,672,mage,frost,18,7,11
21889,Parapio,tichondrius,672,mage,frost,18,7,11
21890,Riverb,bleeding-hollow,672,mage,frost,18,7,11
21891,Fortemage,tichondrius,672,mage,frost,24,7,17
21892,Ranidos,area-52,671,mage,frost,12,7,5
21893,Tokiaro,tortheldrin,671,mage,frost,12,7,5
21894,Burist,illidan,671,mage,frost,12,7,5
21895,Dairian,whisperwind,671,mage,frost,12,7,5
21896,Blinksz,korgath,671,mage,frost,12,7,5
21897,Nihilitý,malganis,671,mage,frost,12,7,5
21898,Hermiønie,quelthalas,671,mage,frost,12,7,5
21899,Athenaswrath,sargeras,671,mage,frost,12,7,5
21900,Khaziiong,scilla,671,mage,frost,12,7,5
21901,Rekys,black-dragonflight,671,mage,frost,12,7,5
21902,Snoogma,illidan,671,mage,frost,12,7,5
21903,Msspelld,turalyon,671,mage,frost,14,7,7
21904,Nickygift,tichondrius,671,mage,frost,18,7,11
21905,Elemenopi,thrall,671,mage,frost,18,7,11
21906,Tendies,blackwater-raiders,671,mage,frost,18,7,11
21907,Kasparhausar,garithos,671,mage,frost,18,7,11
21908,Oharvestero,illidan,671,mage,frost,18,7,11
21909,Optic,chogall,671,mage,frost,18,7,11
21910,Arendelle,kiljaeden,671,mage,frost,18,7,11
21911,Shãy,area-52,671,mage,frost,18,7,11
21912,Ranje,kiljaeden,670,mage,frost,12,7,5
21913,Perfectpink,bleeding-hollow,670,mage,frost,12,7,5
21914,Tchass,skullcrusher,670,mage,frost,12,7,5
21915,Kidfurry,wyrmrest-accord,670,mage,frost,12,7,5
21916,Plasmah,saurfang,670,mage,frost,12,7,5
21917,Aulie,burning-blade,670,mage,frost,12,7,5
21918,Sparklmotion,cenarius,670,mage,frost,18,7,11
21919,Putosucio,nordrassil,670,mage,frost,18,7,11
21920,Akhilá,stormrage,670,mage,frost,18,7,11
21921,Syura,ragnaros,670,mage,frost,18,7,11
21922,Cäelüm,area-52,670,mage,frost,24,7,17
21923,Criticalness,illidan,669,mage,frost,12,7,5
21924,Banída,stormrage,669,mage,frost,12,7,5
21925,Zould,alleria,669,mage,frost,12,7,5
21926,Havôc,malorne,669,mage,frost,12,7,5
21927,Zalatirix,bleeding-hollow,669,mage,frost,12,7,5
21928,Scorgasm,thrall,669,mage,frost,12,7,5
21929,Shinneex,ragnaros,669,mage,frost,18,7,11
21930,Dchee,nerzhul,669,mage,frost,18,7,11
21931,Trincando,azralon,669,mage,frost,24,7,17
21932,Xarmog,tichondrius,668,mage,frost,24,7,17
21933,Nohealani,dragonmaw,667,mage,frost,15,8,7
21934,Aumar,shandris,665,mage,frost,9,8,1
21935,Evieril,tichondrius,665,mage,frost,12,7,5
21936,Dánó,lightbringer,663,mage,frost,24,7,17
21937,Tigoditties,emerald-dream,662,mage,frost,12,7,5
21938,Deadlysok,barthilas,660,mage,frost,12,7,5
21939,Landard,exodar,659,mage,frost,12,7,5
21940,Magemochi,dalaran,658,mage,frost,12,7,5
21941,Slaash,barthilas,639,mage,frost,14,8,6
21942,Grausum,tichondrius,638,mage,frost,16,7,9
21943,Magusia,emerald-dream,638,mage,frost,17,7,10
21944,Shaynna,tichondrius,624,mage,frost,15,7,8
21945,Leeandroo,quelthalas,623,mage,frost,17,7,10
21946,Ghostblaze,blackhand,621,mage,frost,15,8,7
21947,Krip,boulderfist,608,mage,frost,16,7,9
21948,Ghili,tichondrius,607,mage,frost,11,7,4
21949,Ghrámz,stormrage,607,mage,frost,16,7,9
21950,Ineedashave,shandris,606,mage,frost,20,7,13
21951,Skywarp,blackhand,606,mage,frost,25,7,18
21952,Parruka,warsong,605,mage,frost,26,7,19
21953,Iceqube,drenden,576,mage,frost,6,6,0
21954,Galiax,illidan,576,mage,frost,12,6,6
21955,Vritus,emerald-dream,576,mage,frost,12,6,6
21956,Manadart,quelthalas,576,mage,frost,12,6,6
21957,Magidius,stormrage,576,mage,frost,12,6,6
21958,Wetsocks,alexstrasza,576,mage,frost,12,6,6
21959,Mägë,kirin-tor,576,mage,frost,12,6,6
21960,Johncxvii,sargeras,576,mage,frost,12,6,6
21961,Decady,stormrage,576,mage,frost,12,6,6
21962,Suicune,area-52,576,mage,frost,12,6,6
21963,Celia,area-52,576,mage,frost,12,6,6
21964,Phuzadd,tichondrius,576,mage,frost,12,6,6
21965,Arittamordio,sargeras,576,mage,frost,12,6,6
21966,Vamage,goldrinn,576,mage,frost,12,6,6
21967,Pollylol,proudmoore,576,mage,frost,12,6,6
21968,Winstonchill,zuljin,576,mage,frost,12,6,6
21969,Moogician,aerie-peak,576,mage,frost,12,6,6
21970,Illblink,lightninghoof,576,mage,frost,12,6,6
21971,Ingrumatig,tichondrius,576,mage,frost,12,6,6
21972,Saymenre,tichondrius,576,mage,frost,12,6,6
21973,Dezz,gilneas,576,mage,frost,12,6,6
21974,Angelsarebad,illidan,576,mage,frost,12,6,6
21975,Magemagick,mannoroth,576,mage,frost,12,6,6
21976,Alludèd,illidan,576,mage,frost,12,6,6
21977,Lemonicee,sargeras,576,mage,frost,12,6,6
21978,Bustercraft,kelthuzad,576,mage,frost,18,6,12
21979,Snowybunny,emerald-dream,576,mage,frost,18,6,12
21980,Krazemagi,stormrage,576,mage,frost,18,6,12
21981,Fromcanada,tichondrius,576,mage,frost,18,6,12
21982,Fatalexo,tichondrius,576,mage,frost,18,6,12
21983,Polymorphlol,queldorei,576,mage,frost,24,6,18
21984,Twiztidwitch,burning-legion,576,mage,frost,24,6,18
21985,Bloodpumper,thrall,575,mage,frost,12,6,6
21986,Cosï,ragnaros,575,mage,frost,12,6,6
21987,Casual,arthas,575,mage,frost,12,6,6
21988,Tundraga,malganis,575,mage,frost,12,6,6
21989,Bootygoats,emerald-dream,575,mage,frost,12,6,6
21990,Vocaris,stormrage,575,mage,frost,12,6,6
21991,Baultery,moon-guard,575,mage,frost,12,6,6
21992,Kickpollyplx,lothar,575,mage,frost,12,6,6
21993,Lisaerys,dalaran,575,mage,frost,12,6,6
21994,Smoney,icecrown,575,mage,frost,12,6,6
21995,Dinklord,azuremyst,575,mage,frost,12,6,6
21996,Oogabooga,lethon,575,mage,frost,12,6,6
21997,Rieltar,barthilas,575,mage,frost,18,6,12
21998,Lucidgaze,bonechewer,575,mage,frost,18,6,12
21999,Fabled,stonemaul,575,mage,frost,18,6,12
22000,Snowyj,khaz-modan,575,mage,frost,19,6,13
22001,Millions,jubeithos,575,mage,frost,24,6,18
22002,Irrandina,moon-guard,574,mage,frost,12,6,6
22003,Kalzak,hyjal,574,mage,frost,12,6,6
22004,Kaël,area-52,574,mage,frost,12,6,6
22005,Icetooseeyou,barthilas,574,mage,frost,12,6,6
22006,Lincepotter,quelthalas,574,mage,frost,18,6,12
22007,Tonepedo,zuljin,574,mage,frost,18,6,12
22008,Bartholomew,lothar,574,mage,frost,18,6,12
22009,Harmful,frostmourne,574,mage,frost,18,6,12
22010,Srloko,azralon,574,mage,frost,24,6,18
22011,Josemayer,nemesis,573,mage,frost,12,6,6
22012,Sohotritenow,malganis,573,mage,frost,18,6,12
22013,Litiria,burning-blade,573,mage,frost,18,6,12
22014,Crimpster,illidan,573,mage,frost,24,6,18
22015,Sodrezinn,illidan,571,mage,frost,12,6,6
22016,Monstermage,madoran,571,mage,frost,18,6,12
22017,Eatmyfritter,stonemaul,570,mage,frost,12,6,6
22018,Freyia,mugthol,569,mage,frost,18,6,12
22019,Meliam,tichondrius,557,mage,frost,29,6,23
22020,Casualboy,skullcrusher,527,mage,frost,11,6,5
22021,Ozwauld,emerald-dream,526,mage,frost,11,6,5
22022,Pyromager,thrall,526,mage,frost,11,6,5
22023,Jooss,quelthalas,521,mage,frost,18,7,11
22024,Pidge,aggramar,519,mage,frost,22,6,16
22025,Tatersmaccs,sargeras,517,mage,frost,20,7,13
22026,Emieralol,tichondrius,512,mage,frost,10,6,4
22027,Ereblink,proudmoore,511,mage,frost,11,6,5
22028,Frostytoez,firetree,511,mage,frost,14,6,8
22029,Korisaurus,tichondrius,496,mage,frost,13,6,7
22030,Hansol,farstriders,480,mage,frost,6,5,1
22031,Truemagician,tichondrius,480,mage,frost,6,5,1
22032,Fatamericanx,area-52,480,mage,frost,6,5,1
22033,Elwynnforest,sargeras,480,mage,frost,6,5,1
22034,Buffmages,malfurion,480,mage,frost,6,5,1
22035,Dasanimomo,sargeras,480,mage,frost,6,5,1
22036,Melkdud,wyrmrest-accord,480,mage,frost,6,5,1
22037,Pkf,tichondrius,480,mage,frost,6,5,1
22038,Jooblee,illidan,480,mage,frost,6,5,1
22039,Fromcanadaqc,zuljin,480,mage,frost,6,5,1
22040,Roggitman,emerald-dream,480,mage,frost,6,5,1
22041,Magerat,icecrown,480,mage,frost,6,5,1
22042,Flavaflame,mugthol,480,mage,frost,6,5,1
22043,Jarvase,mugthol,480,mage,frost,10,6,4
22044,Veritas,wildhammer,480,mage,frost,10,6,4
22045,Zime,moon-guard,480,mage,frost,12,5,7
22046,Legendary,deathwing,480,mage,frost,12,5,7
22047,Gadwick,alexstrasza,480,mage,frost,12,5,7
22048,Tëy,zuljin,480,mage,frost,12,5,7
22049,Cinns,moon-guard,480,mage,frost,12,5,7
22050,Polymurph,terenas,480,mage,frost,12,5,7
22051,Foodfish,bleeding-hollow,480,mage,frost,12,5,7
22052,Starguy,terenas,480,mage,frost,12,5,7
22053,Vires,kelthuzad,480,mage,frost,12,5,7
22054,Freezerburnz,illidan,480,mage,frost,12,5,7
22055,Lewpithy,area-52,480,mage,frost,12,5,7
22056,Combustya,khazgoroth,480,mage,frost,12,5,7
22057,Kayenri,area-52,480,mage,frost,12,5,7
22058,Emppty,tichondrius,480,mage,frost,12,5,7
22059,Adronicus,tichondrius,480,mage,frost,12,5,7
22060,Razkall,shattered-hand,480,mage,frost,12,5,7
22061,Hustle,frostmourne,480,mage,frost,12,5,7
22062,Iceyhott,bloodhoof,480,mage,frost,12,5,7
22063,Emelian,barthilas,480,mage,frost,12,5,7
22064,Icetomeetyu,bleeding-hollow,480,mage,frost,12,5,7
22065,Doodledew,bleeding-hollow,480,mage,frost,12,5,7
22066,Triknology,dalaran,480,mage,frost,12,5,7
22067,Houndoôm,hyjal,480,mage,frost,12,5,7
22068,Siobhána,moon-guard,480,mage,frost,12,5,7
22069,Pyrod,tichondrius,480,mage,frost,12,5,7
22070,Maelista,tichondrius,480,mage,frost,12,5,7
22071,Harlloo,the-underbog,480,mage,frost,12,5,7
22072,Isömetrics,tichondrius,480,mage,frost,12,5,7
22073,Nunezz,mannoroth,480,mage,frost,12,5,7
22074,Mcshwackin,area-52,480,mage,frost,12,5,7
22075,Qordix,tichondrius,480,mage,frost,12,5,7
22076,Coolbuts,area-52,480,mage,frost,18,5,13
22077,Dreddpool,barthilas,480,mage,frost,18,5,13
22078,Kutulu,aerie-peak,480,mage,frost,18,5,13
22079,Icebish,skullcrusher,480,mage,frost,18,5,13
22080,Artty,velen,480,mage,frost,18,5,13
22081,Mikwam,proudmoore,479,mage,frost,6,5,1
22082,Piixxiie,sargeras,479,mage,frost,6,5,1
22083,Diabølcangel,malganis,479,mage,frost,12,5,7
22084,Cezax,frostmourne,479,mage,frost,12,5,7
22085,Inumano,laughing-skull,479,mage,frost,12,5,7
22086,Odinzz,azralon,479,mage,frost,12,5,7
22087,Loa,hydraxis,479,mage,frost,12,5,7
22088,Dimmershnitz,draka,479,mage,frost,12,5,7
22089,Brokser,quelthalas,479,mage,frost,12,5,7
22090,Icesickle,barthilas,479,mage,frost,12,5,7
22091,Phazora,suramar,479,mage,frost,12,5,7
22092,Raynark,nemesis,479,mage,frost,12,5,7
22093,Grimreefer,trollbane,479,mage,frost,12,5,7
22094,Dwazam,lothar,479,mage,frost,12,5,7
22095,Kpoppin,stormrage,479,mage,frost,12,5,7
22096,Paintsicle,thunderlord,479,mage,frost,12,5,7
22097,Hugadoug,zuljin,479,mage,frost,24,5,19
22098,Asthar,ursin,479,mage,frost,24,5,19
22099,Suprido,illidan,478,mage,frost,15,6,9
22100,Babbushka,thrall,478,mage,frost,18,5,13
22101,Magodelphi,azralon,477,mage,frost,6,5,1
22102,Ehduh,onyxia,477,mage,frost,12,5,7
22103,Rawrxd,kiljaeden,477,mage,frost,12,5,7
22104,Colddevil,hyjal,476,mage,frost,19,5,14
22105,Spazzticblur,frostwolf,473,mage,frost,12,5,7
22106,Claddagh,kelthuzad,473,mage,frost,12,5,7
22107,Polyblart,hyjal,446,mage,frost,10,6,4
22108,Barkäi,ragnaros,432,mage,frost,15,5,10
22109,Cerisium,kiljaeden,431,mage,frost,11,5,6
22110,Summey,tichondrius,431,mage,frost,11,5,6
22111,Aggrosheep,tichondrius,416,mage,frost,10,5,5
22112,Quinnfreeze,boulderfist,414,mage,frost,11,5,6
22113,Powder,lightninghoof,400,mage,frost,15,7,8
22114,Mèduså,tichondrius,384,mage,frost,6,4,2
22115,Myrondor,tichondrius,384,mage,frost,6,4,2
22116,Danbì,ragnaros,384,mage,frost,6,4,2
22117,Fromcanadaqc,tichondrius,384,mage,frost,6,4,2
22118,Frobo,mannoroth,384,mage,frost,6,4,2
22119,Çhíllßrõ,tichondrius,384,mage,frost,6,4,2
22120,Cewchí,tichondrius,384,mage,frost,6,4,2
22121,Finnese,medivh,384,mage,frost,6,4,2
22122,Frostkage,tichondrius,384,mage,frost,6,4,2
22123,Poonfarmer,zangarmarsh,384,mage,frost,6,4,2
22124,Neverbroke,illidan,384,mage,frost,6,4,2
22125,Hocusjokus,frostmourne,384,mage,frost,6,4,2
22126,Balencii,kiljaeden,384,mage,frost,6,4,2
22127,Pew,dathremar,384,mage,frost,6,4,2
22128,Unlike,sargeras,384,mage,frost,6,4,2
22129,Udmx,zuljin,384,mage,frost,6,4,2
22130,Frostedtips,hakkar,384,mage,frost,6,4,2
22131,Lohkey,darkspear,384,mage,frost,6,4,2
22132,Voiddude,proudmoore,384,mage,frost,6,4,2
22133,Kälis,zuljin,384,mage,frost,6,4,2
22134,Schwab,warsong,384,mage,frost,6,4,2
22135,Jamesper,tichondrius,384,mage,frost,6,4,2
22136,Sydne,ysera,384,mage,frost,6,4,2
22137,Azraël,zuljin,384,mage,frost,6,4,2
22138,Turbobones,tichondrius,384,mage,frost,6,4,2
22139,Arkane,barthilas,384,mage,frost,6,4,2
22140,Marfaz,ravencrest,384,mage,frost,6,4,2
22141,Belven,proudmoore,384,mage,frost,6,4,2
22142,Pzaz,moon-guard,384,mage,frost,6,4,2
22143,Froznpizza,zuljin,384,mage,frost,6,4,2
22144,Zolix,malganis,384,mage,frost,6,4,2
22145,Dashdoor,stormrage,384,mage,frost,6,4,2
22146,Variex,tichondrius,384,mage,frost,6,4,2
22147,Zokorzik,area-52,384,mage,frost,6,4,2
22148,Legelance,malganis,384,mage,frost,6,4,2
22149,Lampert,tichondrius,384,mage,frost,6,4,2
22150,Gai,lightnings-blade,384,mage,frost,6,4,2
22151,Polymedaddi,tichondrius,384,mage,frost,6,4,2
22152,Zgodspeedz,stormrage,384,mage,frost,6,4,2
22153,Frðstítutè,tichondrius,384,mage,frost,6,4,2
22154,Vixm,stormrage,384,mage,frost,6,4,2
22155,Ratfather,the-forgotten-coast,384,mage,frost,6,4,2
22156,Aigam,hyjal,384,mage,frost,6,4,2
22157,Gnomoguapo,altar-of-storms,384,mage,frost,6,4,2
22158,Expozed,icecrown,384,mage,frost,6,4,2
22159,Nexttmage,area-52,384,mage,frost,12,4,8
22160,Slurpey,moon-guard,384,mage,frost,12,4,8
22161,Percivaltp,scarlet-crusade,384,mage,frost,12,4,8
22162,Slot,kirin-tor,384,mage,frost,12,4,8
22163,Meduka,proudmoore,384,mage,frost,12,4,8
22164,Badaszbich,tichondrius,384,mage,frost,12,4,8
22165,Novokaine,area-52,384,mage,frost,12,4,8
22166,Timêrmórk,kalecgos,384,mage,frost,12,4,8
22167,Fishfood,bleeding-hollow,384,mage,frost,12,4,8
22168,Yeuxbleus,tichondrius,384,mage,frost,12,4,8
22169,Bluedustfart,illidan,384,mage,frost,12,4,8
22170,Oneminute,tichondrius,384,mage,frost,12,4,8
22171,Caseyjelly,tichondrius,384,mage,frost,12,4,8
22172,Wuzzo,tichondrius,384,mage,frost,12,4,8
22173,Splocke,azralon,384,mage,frost,12,4,8
22174,Coldcaster,mugthol,384,mage,frost,12,4,8
22175,Horizons,moon-guard,384,mage,frost,12,4,8
22176,Darthez,darkspear,384,mage,frost,12,4,8
22177,Hemm,nemesis,384,mage,frost,12,4,8
22178,Natashaeb,wyrmrest-accord,384,mage,frost,12,4,8
22179,Xenagozs,antonidas,384,mage,frost,12,4,8
22180,Yippmagus,area-52,384,mage,frost,12,4,8
22181,Aangx,stormrage,384,mage,frost,12,4,8
22182,Perkaset,turalyon,384,mage,frost,12,4,8
22183,Îùx,stormrage,384,mage,frost,12,4,8
22184,Arcanatos,emerald-dream,384,mage,frost,12,4,8
22185,Gemaicy,sargeras,384,mage,frost,12,4,8
22186,Dallamar,frostwolf,384,mage,frost,12,4,8
22187,Stefan,malganis,384,mage,frost,12,4,8
22188,Themageguy,eitrigg,384,mage,frost,12,4,8
22189,Fantabulous,korgath,384,mage,frost,14,4,10
22190,Astería,ragnaros,384,mage,frost,14,4,10
22191,Snanth,black-dragonflight,384,mage,frost,18,4,14
22192,Fullmetal,jaedenar,384,mage,frost,18,4,14
22193,Rolypolyman,tichondrius,384,mage,frost,24,4,20
22194,Billionnaire,tichondrius,383,mage,frost,6,4,2
22195,Robinesque,moon-guard,383,mage,frost,12,4,8
22196,Cynafox,moon-guard,383,mage,frost,12,4,8
22197,Surrsly,tortheldrin,383,mage,frost,12,4,8
22198,Undersky,tichondrius,383,mage,frost,12,4,8
22199,Abstractgoat,tichondrius,383,mage,frost,12,4,8
22200,Skazzbomb,nerzhul,383,mage,frost,12,4,8
22201,Preckwinkle,moon-guard,383,mage,frost,14,4,10
22202,Kuni,ghostlands,382,mage,frost,12,4,8
22203,Brezman,tichondrius,382,mage,frost,12,4,8
22204,Georgez,ragnaros,382,mage,frost,20,4,16
22205,Zoninsasseo,tichondrius,381,mage,frost,12,4,8
22206,Killerflaco,drakkari,381,mage,frost,24,4,20
22207,Eirwan,illidan,379,mage,frost,12,4,8
22208,Alfaflux,nemesis,366,mage,frost,17,4,13
22209,Eanur,azralon,352,mage,frost,16,4,12
22210,Lirahmi,quelthalas,351,mage,frost,17,4,13
22211,Freezeup,area-52,349,mage,frost,14,7,7
22212,Titsncoke,proudmoore,336,mage,frost,9,4,5
22213,Jizzlez,tichondrius,335,mage,frost,11,4,7
22214,Coldrin,tichondrius,330,mage,frost,15,5,10
22215,Devkek,area-52,330,mage,frost,22,7,15
22216,Icëblöck,ysera,329,mage,frost,6,5,1
22217,Lezafort,area-52,320,mage,frost,16,4,12
22218,Crøwgawd,tichondrius,304,mage,frost,7,4,3
22219,Frostyßamf,kiljaeden,288,mage,frost,6,3,3
22220,Illúmi,moon-guard,288,mage,frost,6,3,3
22221,Kqlyy,tichondrius,288,mage,frost,6,3,3
22222,Cruxx,ragnaros,288,mage,frost,6,3,3
22223,Killemz,dragonmaw,288,mage,frost,6,3,3
22224,Léras,stormrage,288,mage,frost,6,3,3
22225,Baybespice,malganis,288,mage,frost,6,3,3
22226,Nofoodforu,thrall,288,mage,frost,6,3,3
22227,Tessarìon,tichondrius,288,mage,frost,6,3,3
22228,Felsparkles,area-52,288,mage,frost,6,3,3
22229,Shiryu,thrall,288,mage,frost,6,3,3
22230,Feldt,korgath,288,mage,frost,6,3,3
22231,Betaduck,bleeding-hollow,288,mage,frost,6,3,3
22232,Bønemage,azralon,288,mage,frost,6,3,3
22233,Benisp,stormrage,288,mage,frost,6,3,3
22234,Índís,ragnaros,288,mage,frost,6,3,3
22235,Morti,sargeras,288,mage,frost,6,3,3
22236,Hýdro,ghostlands,288,mage,frost,6,3,3
22237,Simpleorz,tichondrius,288,mage,frost,6,3,3
22238,Lunchfirst,tichondrius,288,mage,frost,6,3,3
22239,Abruaa,area-52,288,mage,frost,6,3,3
22240,Murcury,tichondrius,288,mage,frost,6,3,3
22241,Chriglol,black-dragonflight,288,mage,frost,6,3,3
22242,Captncold,area-52,288,mage,frost,6,3,3
22243,Blâzer,nazjatar,288,mage,frost,6,3,3
22244,Clerene,area-52,288,mage,frost,6,3,3
22245,Honchó,velen,288,mage,frost,6,3,3
22246,Kryptekk,area-52,288,mage,frost,6,3,3
22247,Undeadmerlin,zuljin,288,mage,frost,6,3,3
22248,Jaklinburton,stormrage,288,mage,frost,6,3,3
22249,Fredcouples,tichondrius,288,mage,frost,6,3,3
22250,Dotznsheep,zuljin,288,mage,frost,6,3,3
22251,Zukoprince,azralon,288,mage,frost,6,3,3
22252,Címegripe,stormrage,288,mage,frost,6,3,3
22253,Whøîsýoû,kelthuzad,288,mage,frost,6,3,3
22254,Gpie,jubeithos,288,mage,frost,6,3,3
22255,Wabï,tichondrius,288,mage,frost,6,3,3
22256,Urbadxd,llane,288,mage,frost,6,3,3
22257,Tasarion,mannoroth,288,mage,frost,6,3,3
22258,Krililin,stormrage,288,mage,frost,6,3,3
22259,Ariezx,kelthuzad,288,mage,frost,6,3,3
22260,Mäz,malorne,288,mage,frost,6,3,3
22261,Midmage,tichondrius,288,mage,frost,6,3,3
22262,Natallyn,stormrage,288,mage,frost,6,3,3
22263,Grawmp,thunderlord,288,mage,frost,6,3,3
22264,Isuikido,nemesis,288,mage,frost,6,3,3
22265,Pyroseraph,bleeding-hollow,288,mage,frost,6,3,3
22266,Ellywizzle,tichondrius,288,mage,frost,6,3,3
22267,Lilsake,sargeras,288,mage,frost,6,3,3
22268,Gadalka,frostmourne,288,mage,frost,6,3,3
22269,Coneofkony,bleeding-hollow,288,mage,frost,6,3,3
22270,Murderlin,tichondrius,288,mage,frost,6,3,3
22271,Atwyxn,illidan,288,mage,frost,6,3,3
22272,Diminisher,agamaggan,288,mage,frost,6,3,3
22273,Nalla,nerzhul,288,mage,frost,6,3,3
22274,Dersão,azralon,288,mage,frost,6,3,3
22275,Dragonie,nordrassil,288,mage,frost,6,3,3
22276,Dìus,malganis,288,mage,frost,6,3,3
22277,Quinnc,tichondrius,288,mage,frost,6,3,3
22278,Gobstpper,nagrand,288,mage,frost,6,3,3
22279,Coldkite,tichondrius,288,mage,frost,6,3,3
22280,Aurumium,illidan,288,mage,frost,6,3,3
22281,Packaged,emerald-dream,288,mage,frost,6,3,3
22282,Personah,darkspear,288,mage,frost,6,3,3
22283,Toastmg,tichondrius,288,mage,frost,6,3,3
22284,Oomoo,malganis,288,mage,frost,6,3,3
22285,Eraticmage,illidan,288,mage,frost,6,3,3
22286,Whatthesheep,sargeras,288,mage,frost,6,3,3
22287,Magicianqt,tichondrius,288,mage,frost,6,3,3
22288,Orangemilk,hyjal,288,mage,frost,6,3,3
22289,Centrika,emerald-dream,288,mage,frost,6,3,3
22290,Combusty,sargeras,288,mage,frost,6,3,3
22291,Cbm,dalaran,288,mage,frost,6,3,3
22292,Frostytits,spirestone,288,mage,frost,6,3,3
22293,Trozkov,dalaran,288,mage,frost,6,3,3
22294,Botoslàp,dragonmaw,288,mage,frost,6,3,3
22295,Icecreamboy,tichondrius,288,mage,frost,6,3,3
22296,Thxo,hyjal,288,mage,frost,6,3,3
22297,Dcup,quelthalas,288,mage,frost,6,3,3
22298,Faeylyn,stormrage,288,mage,frost,9,4,5
22299,Etyx,tichondrius,288,mage,frost,10,4,6
22300,Rabeiro,tichondrius,288,mage,frost,12,3,9
22301,Worldonfire,ragnaros,288,mage,frost,12,3,9
22302,Linadeslayer,chogall,288,mage,frost,12,3,9
22303,Littleguzto,garrosh,288,mage,frost,12,3,9
22304,Argyron,fizzcrank,288,mage,frost,12,3,9
22305,Hozlu,kiljaeden,288,mage,frost,12,3,9
22306,Grynthwzrd,stormrage,288,mage,frost,12,3,9
22307,Calcaster,aegwynn,288,mage,frost,12,3,9
22308,Castermuffin,stormrage,288,mage,frost,12,3,9
22309,Stormfrieza,tichondrius,288,mage,frost,12,3,9
22310,Fingeredx,zuljin,288,mage,frost,12,3,9
22311,Draell,drakkari,288,mage,frost,12,3,9
22312,Ezchallenger,undermine,288,mage,frost,12,3,9
22313,Steefers,arygos,288,mage,frost,12,3,9
22314,Bootyclapper,shadowmoon,288,mage,frost,12,3,9
22315,Nøzotica,kelthuzad,288,mage,frost,12,3,9
22316,Albbano,tichondrius,288,mage,frost,12,3,9
22317,Maagão,azralon,288,mage,frost,12,3,9
22318,Hqscoltt,azralon,288,mage,frost,12,3,9
22319,Kaïdis,nemesis,288,mage,frost,12,3,9
22320,Aderia,gorefiend,288,mage,frost,12,3,9
22321,Vyyp,echo-isles,288,mage,frost,12,3,9
22322,Technique,tichondrius,288,mage,frost,12,3,9
22323,Failzy,darkspear,288,mage,frost,12,3,9
22324,Houdiinii,illidan,288,mage,frost,12,3,9
22325,Anuub,kelthuzad,288,mage,frost,12,3,9
22326,Sukaretto,illidan,288,mage,frost,12,3,9
22327,Jimmygibbler,illidan,288,mage,frost,12,3,9
22328,Frostcakes,quelthalas,288,mage,frost,12,3,9
22329,Gattmage,illidan,288,mage,frost,12,3,9
22330,Radakos,emerald-dream,288,mage,frost,12,3,9
22331,Tamarolfrost,illidan,288,mage,frost,12,3,9
22332,Tracemaker,emerald-dream,288,mage,frost,18,3,15
22333,Exonerate,mannoroth,288,mage,frost,18,3,15
22334,Wawakun,ragnaros,287,mage,frost,6,3,3
22335,Gufi,drakkari,287,mage,frost,6,3,3
22336,Clausolas,ragnaros,287,mage,frost,6,3,3
22337,Applemage,ragnaros,287,mage,frost,6,3,3
22338,Magotom,ragnaros,287,mage,frost,6,3,3
22339,Pyromaster,emerald-dream,287,mage,frost,6,3,3
22340,Cölossus,gorefiend,287,mage,frost,6,3,3
22341,Shimotama,malganis,287,mage,frost,6,3,3
22342,Icehero,tichondrius,287,mage,frost,6,3,3
22343,Merlinaa,ragnaros,287,mage,frost,10,3,7
22344,Taevy,tichondrius,256,mage,frost,10,3,7
22345,Chuekona,ragnaros,256,mage,frost,10,3,7
22346,Magemoney,area-52,239,mage,frost,5,3,2
22347,Unydae,frostmourne,239,mage,frost,5,3,2
22348,Drewann,draenor,239,mage,frost,5,3,2
22349,Arielak,kelthuzad,239,mage,frost,5,3,2
22350,Cheyz,onyxia,239,mage,frost,5,3,2
22351,Itsoveryo,jubeithos,239,mage,frost,11,3,8
22352,Kizran,frostmourne,239,mage,frost,11,3,8
22353,Gtown,kelthuzad,234,mage,frost,11,4,7
22354,Skerei,azralon,234,mage,frost,19,4,15
22355,Brôcolîni,zuljin,233,mage,frost,11,4,7
22356,Ophian,shattered-hand,222,mage,frost,8,3,5
22357,Rayricefan,blood-furnace,192,mage,frost,4,3,1
22358,Onioneyes,area-52,192,mage,frost,4,3,1
22359,Shahnazz,darkspear,192,mage,frost,8,3,5
22360,Gradmage,proudmoore,192,mage,frost,6,2,4
22361,Muskybiggie,bleeding-hollow,192,mage,frost,6,2,4
22362,Weedzird,thrall,192,mage,frost,6,2,4
22363,Xü,stormrage,192,mage,frost,6,2,4
22364,Slymage,illidan,192,mage,frost,6,2,4
22365,Duwapkaine,sargeras,192,mage,frost,6,2,4
22366,Quesomancer,illidan,192,mage,frost,6,2,4
22367,Shivamode,thrall,192,mage,frost,6,2,4
22368,Elvin,frostmourne,192,mage,frost,6,2,4
22369,Roarly,stonemaul,192,mage,frost,6,2,4
22370,Undeadmager,nerzhul,192,mage,frost,6,2,4
22371,Wïzarduous,mannoroth,192,mage,frost,6,2,4
22372,Ryusuke,thrall,192,mage,frost,6,2,4
22373,Getmaged,bleeding-hollow,192,mage,frost,6,2,4
22374,Biillionaire,frostmourne,192,mage,frost,6,2,4
22375,Lilbabyx,stormrage,192,mage,frost,6,2,4
22376,Uhh,blackrock,192,mage,frost,6,2,4
22377,Sparqablink,tichondrius,192,mage,frost,6,2,4
22378,Mager,dentarg,192,mage,frost,6,2,4
22379,Halimage,zuljin,192,mage,frost,6,2,4
22380,Vailor,whisperwind,192,mage,frost,6,2,4
22381,Massivepoo,barthilas,192,mage,frost,6,2,4
22382,Kammany,thrall,192,mage,frost,6,2,4
22383,Afknz,frostmourne,192,mage,frost,6,2,4
22384,Bluishhue,thrall,192,mage,frost,6,2,4
22385,Arkuran,proudmoore,192,mage,frost,6,2,4
22386,Cantblocklul,baelgun,192,mage,frost,6,2,4
22387,Tanedos,tichondrius,192,mage,frost,6,2,4
22388,Gattî,tichondrius,192,mage,frost,6,2,4
22389,Gusmaged,stormrage,192,mage,frost,6,2,4
22390,Iguanodon,proudmoore,192,mage,frost,6,2,4
22391,Jurgers,tichondrius,192,mage,frost,6,2,4
22392,Raidem,dalaran,192,mage,frost,6,2,4
22393,Westii,illidan,192,mage,frost,6,2,4
22394,Karameltart,barthilas,192,mage,frost,6,2,4
22395,Duhquarius,warsong,192,mage,frost,6,2,4
22396,Blînxx,bleeding-hollow,192,mage,frost,6,2,4
22397,Aeroclouda,stormrage,192,mage,frost,6,2,4
22398,Avicci,shattered-halls,192,mage,frost,6,2,4
22399,Khaosflare,stormrage,192,mage,frost,6,2,4
22400,Indignatio,arthas,192,mage,frost,6,2,4
22401,Earff,kiljaeden,192,mage,frost,6,2,4
22402,Herzthroh,stormrage,192,mage,frost,6,2,4
22403,Magegpt,illidan,192,mage,frost,6,2,4
22404,Korky,dalvengyr,192,mage,frost,6,2,4
22405,Drewzz,tichondrius,192,mage,frost,6,2,4
22406,Magickus,korgath,192,mage,frost,6,2,4
22407,Choctøp,frostmourne,192,mage,frost,6,2,4
22408,Echoz,frostmourne,192,mage,frost,6,2,4
22409,Vortex,fenris,192,mage,frost,6,2,4
22410,Viccluvin,stormrage,192,mage,frost,6,2,4
22411,Fleët,tichondrius,192,mage,frost,6,2,4
22412,Kzm,illidan,192,mage,frost,6,2,4
22413,Stìnkfîst,tichondrius,192,mage,frost,6,2,4
22414,Makius,area-52,192,mage,frost,6,2,4
22415,Airsickjet,kiljaeden,192,mage,frost,6,2,4
22416,Cradic,tichondrius,192,mage,frost,6,2,4
22417,Whiteyx,saurfang,192,mage,frost,6,2,4
22418,Wanming,tichondrius,192,mage,frost,6,2,4
22419,Jainamommy,emerald-dream,192,mage,frost,6,2,4
22420,Kevinfan,area-52,192,mage,frost,6,2,4
22421,Fïtz,quelthalas,192,mage,frost,6,2,4
22422,Thebrain,twisting-nether,192,mage,frost,6,2,4
22423,Ess,tichondrius,192,mage,frost,6,2,4
22424,Mageethot,moon-guard,192,mage,frost,6,2,4
22425,Firehawk,azralon,192,mage,frost,6,2,4
22426,Smók,ragnaros,192,mage,frost,6,2,4
22427,Sahaquiel,tichondrius,192,mage,frost,6,2,4
22428,Rapidmage,malganis,192,mage,frost,6,2,4
22429,Magika,area-52,192,mage,frost,6,2,4
22430,Anyahs,tichondrius,192,mage,frost,6,2,4
22431,Elhechizero,quelthalas,192,mage,frost,6,2,4
22432,Crazytime,tichondrius,192,mage,frost,6,2,4
22433,Kârén,aggramar,192,mage,frost,6,2,4
22434,Pyröz,kelthuzad,192,mage,frost,6,2,4
22435,Strêss,kelthuzad,192,mage,frost,6,2,4
22436,Wyss,azralon,192,mage,frost,6,2,4
22437,Ayci,velen,192,mage,frost,6,2,4
22438,Magiaguarra,ragnaros,192,mage,frost,6,2,4
22439,Nachtt,sargeras,192,mage,frost,6,2,4
22440,Cottonmage,malganis,192,mage,frost,6,2,4
22441,Audacy,sargeras,192,mage,frost,6,2,4
22442,Xar,guldan,192,mage,frost,6,2,4
22443,Sophrates,burning-blade,192,mage,frost,6,2,4
22444,Maxvila,kelthuzad,192,mage,frost,6,2,4
22445,Urmagesty,daggerspine,192,mage,frost,6,2,4
22446,Chelseâ,emerald-dream,192,mage,frost,6,2,4
22447,Vallfire,malganis,192,mage,frost,6,2,4
22448,Myzzl,kelthuzad,192,mage,frost,6,2,4
22449,Clickhard,suramar,192,mage,frost,9,2,7
22450,Mendittorosa,tichondrius,192,mage,frost,12,2,10
22451,Alode,moon-guard,192,mage,frost,12,2,10
22452,Dashonthany,arthas,192,mage,frost,12,2,10
22453,Joare,area-52,192,mage,frost,12,2,10
22454,Ironwolft,tichondrius,192,mage,frost,12,2,10
22455,Hositonet,malganis,192,mage,frost,12,2,10
22456,Kinrow,stormrage,192,mage,frost,12,2,10
22457,Lemmepoly,illidan,192,mage,frost,12,2,10
22458,Excentral,tichondrius,192,mage,frost,12,2,10
22459,Rán,spirestone,192,mage,frost,12,2,10
22460,Shwack,boulderfist,192,mage,frost,12,2,10
22461,Eretik,ragnaros,192,mage,frost,12,2,10
22462,Zerg,fenris,192,mage,frost,12,2,10
22463,Zyzzmirin,barthilas,192,mage,frost,12,2,10
22464,Èvilmage,blackrock,192,mage,frost,12,2,10
22465,Mônstâ,thrall,192,mage,frost,12,2,10
22466,Boxslinger,illidan,192,mage,frost,12,2,10
22467,Molassess,illidan,192,mage,frost,12,2,10
22468,Adxion,quelthalas,192,mage,frost,12,2,10
22469,Dylanpickles,darkspear,192,mage,frost,12,2,10
22470,Wqnmlgbdy,tichondrius,192,mage,frost,18,2,16
22471,Kahldyn,stormrage,191,mage,frost,4,3,1
22472,Pândàfæçé,ghostlands,191,mage,frost,4,3,1
22473,Bittérs,tichondrius,191,mage,frost,6,2,4
22474,Alladen,anubarak,191,mage,frost,6,2,4
22475,Blync,emerald-dream,191,mage,frost,6,2,4
22476,Stillborn,lethon,191,mage,frost,6,2,4
22477,Hense,stormrage,191,mage,frost,6,2,4
22478,Renthalar,area-52,191,mage,frost,18,2,16
22479,Cheapped,emerald-dream,175,mage,frost,6,3,3
22480,Spellsurg,malganis,175,mage,frost,11,2,9
22481,Blakus,tichondrius,159,mage,frost,6,3,3
22482,Frosteddiks,shattered-halls,159,mage,frost,5,2,3
22483,Wizzyx,illidan,159,mage,frost,5,2,3
22484,Csx,turalyon,144,mage,frost,3,3,0
22485,Noyade,illidan,144,mage,frost,9,2,7
22486,Erudit,tichondrius,144,mage,frost,15,2,13
22487,Shardgodx,kelthuzad,138,mage,frost,8,4,4
22488,Idamnedu,crushridge,128,mage,frost,4,2,2
22489,Firèballin,tichondrius,128,mage,frost,4,2,2
22490,Máximus,illidan,128,mage,frost,4,2,2
22491,Goingmassive,frostmourne,127,mage,frost,4,2,2
22492,Proviet,frostmourne,127,mage,frost,8,2,6
22493,Thebraveonee,frostmourne,126,mage,frost,8,2,6
22494,Sillycole,emerald-dream,96,mage,frost,3,2,1
22495,Thôrsena,ursin,96,mage,frost,3,2,1
22496,Quickwizard,tichondrius,96,mage,frost,6,1,5
22497,Ricter,hyjal,96,mage,frost,6,1,5
22498,Ogfresh,area-52,96,mage,frost,6,1,5
22499,Geekm,frostmourne,96,mage,frost,6,1,5
22500,Tmi,darkspear,96,mage,frost,6,1,5
22501,Trevihl,malganis,96,mage,frost,6,1,5
22502,Gnòmêrcy,kelthuzad,96,mage,frost,6,1,5
22503,Freezze,malganis,96,mage,frost,6,1,5
22504,Mastacombust,illidan,96,mage,frost,6,1,5
22505,Mïzzfreeze,haomarush,96,mage,frost,6,1,5
22506,Professor,khadgar,96,mage,frost,6,1,5
22507,Ëfc,nemesis,96,mage,frost,6,1,5
22508,Yeonmok,tichondrius,96,mage,frost,6,1,5
22509,Kaoz,emerald-dream,96,mage,frost,6,1,5
22510,Neverworks,tichondrius,96,mage,frost,6,1,5
22511,Furrblock,tichondrius,96,mage,frost,6,1,5
22512,Soulbite,barthilas,96,mage,frost,6,1,5
22513,Fadedfire,area-52,96,mage,frost,6,1,5
22514,Truewinter,tichondrius,96,mage,frost,6,1,5
22515,Åpollous,frostmourne,96,mage,frost,6,1,5
22516,Sky,lightnings-blade,96,mage,frost,6,1,5
22517,Fookz,malganis,96,mage,frost,6,1,5
22518,Kattyy,drakkari,96,mage,frost,6,1,5
22519,Kbola,tichondrius,96,mage,frost,6,1,5
22520,Oring,tichondrius,96,mage,frost,6,1,5
22521,Pirne,executus,96,mage,frost,6,1,5
22522,Aerodynamiq,area-52,96,mage,frost,6,1,5
22523,Ñõxx,sargeras,96,mage,frost,6,1,5
22524,Scarrgon,wyrmrest-accord,96,mage,frost,6,1,5
22525,Twizzlerz,executus,96,mage,frost,6,1,5
22526,Daêgon,area-52,96,mage,frost,6,1,5
22527,Pikoda,azralon,96,mage,frost,6,1,5
22528,Dathoe,laughing-skull,96,mage,frost,6,1,5
22529,Heztus,area-52,96,mage,frost,6,1,5
22530,Muskinite,maiev,96,mage,frost,6,1,5
22531,Pyrofrost,stonemaul,96,mage,frost,6,1,5
22532,Oab,proudmoore,96,mage,frost,6,1,5
22533,Naviator,tichondrius,96,mage,frost,6,1,5
22534,Braelynn,frostwolf,96,mage,frost,6,1,5
22535,Ârcano,ragnaros,96,mage,frost,6,1,5
22536,Thewizârd,stormrage,96,mage,frost,6,1,5
22537,Magicdro,scilla,96,mage,frost,6,1,5
22538,Magicmom,wyrmrest-accord,96,mage,frost,6,1,5
22539,Beerandmagic,zuljin,96,mage,frost,6,1,5
22540,Gíldrin,proudmoore,96,mage,frost,6,1,5
22541,Thiccness,hydraxis,96,mage,frost,6,1,5
22542,Ichirou,stormrage,96,mage,frost,6,1,5
22543,Coolhandz,tichondrius,96,mage,frost,6,1,5
22544,Michaelbust,tichondrius,96,mage,frost,6,1,5
22545,Damadness,kiljaeden,96,mage,frost,6,1,5
22546,Loopsyliu,stormrage,96,mage,frost,6,1,5
22547,Pblastdatass,stormrage,96,mage,frost,6,1,5
22548,Absentbrain,stormrage,96,mage,frost,6,1,5
22549,Hruine,chogall,96,mage,frost,6,1,5
22550,Adrazell,sargeras,96,mage,frost,6,1,5
22551,Majx,eldrethalas,96,mage,frost,6,1,5
22552,Themose,sargeras,96,mage,frost,6,1,5
22553,Taladas,suramar,96,mage,frost,12,1,11
22554,Pyrophobia,mannoroth,96,mage,frost,12,1,11
22555,Carmile,azralon,96,mage,frost,12,1,11
22556,Bøndu,zuljin,96,mage,frost,12,1,11
22557,Vensyr,stormrage,96,mage,frost,12,1,11
22558,Tema,daggerspine,96,mage,frost,12,1,11
22559,Jmanpk,stormrage,96,mage,frost,12,1,11
22560,Badiatorr,alterac-mountains,96,mage,frost,12,1,11
22561,Ldc,kelthuzad,96,mage,frost,12,1,11
22562,Zei,bleeding-hollow,96,mage,frost,12,1,11
22563,Voxbluvine,hakkar,96,mage,frost,18,1,17
22564,Icemaker,destromath,95,mage,frost,18,1,17
22565,Notria,illidan,79,mage,frost,5,1,4
22566,Huaerfei,thunderlord,79,mage,frost,5,1,4
22567,Ventiarcana,area-52,79,mage,frost,5,1,4
22568,Buckybever,illidan,79,mage,frost,11,1,10
22569,Frostybihh,bonechewer,64,mage,frost,4,1,3
22570,Unclekyle,skullcrusher,48,mage,frost,3,1,2
22571,Lv,stormscale,48,mage,frost,9,1,8
22572,Jiblemynippl,illidan,42,mage,frost,7,2,5
22573,Kushjointz,tichondrius,42,mage,frost,11,3,8
22574,Fizzlepops,kiljaeden,31,mage,frost,2,1,1
22575,Dãnwun,tichondrius,2284,monk,mistweaver,102,63,39
22576,Sharkpiggie,illidan,2283,monk,mistweaver,102,66,36
22577,Akkiraa,sargeras,2283,monk,mistweaver,95,60,35
22578,Meepmonk,tichondrius,2283,monk,mistweaver,102,64,38
22579,Dannycarey,tichondrius,2278,monk,mistweaver,78,55,23
22580,Garbagemonk,scilla,2277,monk,mistweaver,191,120,71
22581,Woezx,stormreaver,2264,monk,mistweaver,68,47,21
22582,Mysticallx,sargeras,2259,monk,mistweaver,84,53,31
22583,Linlol,tichondrius,2257,monk,mistweaver,478,278,200
22584,Akkiira,sargeras,2229,monk,mistweaver,114,64,50
22585,Raddxd,illidan,2227,monk,mistweaver,95,64,31
22586,Mãsterpõ,tichondrius,2227,monk,mistweaver,313,170,143
22587,Weavied,sargeras,2215,monk,mistweaver,156,84,72
22588,Stinkycok,tichondrius,2214,monk,mistweaver,84,54,30
22589,Zenjj,thorium-brotherhood,2211,monk,mistweaver,170,99,71
22590,Sharkpiglet,illidan,2201,monk,mistweaver,156,97,59
22591,Boogstyle,malganis,2201,monk,mistweaver,142,81,61
22592,Jep,tichondrius,2190,monk,mistweaver,144,91,53
22593,Vaen,kelthuzad,2173,monk,mistweaver,102,61,41
22594,Pragma,kiljaeden,2168,monk,mistweaver,84,53,31
22595,Ðrägønéyèz,malygos,2168,monk,mistweaver,211,119,92
22596,Cool,crushridge,2167,monk,mistweaver,126,75,51
22597,Dowsk,tichondrius,2162,monk,mistweaver,105,63,42
22598,Idiotgriefer,tichondrius,2160,monk,mistweaver,78,48,30
22599,Emoeres,kelthuzad,2151,monk,mistweaver,104,55,49
22600,Flarks,area-52,2151,monk,mistweaver,155,80,75
22601,Moonym,nagrand,2144,monk,mistweaver,80,48,32
22602,Oblivæon,tichondrius,2143,monk,mistweaver,72,45,27
22603,Sloppyroppy,tichondrius,2143,monk,mistweaver,107,62,45
22604,Oliveirarr,tichondrius,2143,monk,mistweaver,174,95,79
22605,Dro,khadgar,2141,monk,mistweaver,66,39,27
22606,Vramonk,area-52,2141,monk,mistweaver,115,64,51
22607,Moremoretea,tichondrius,2140,monk,mistweaver,87,53,34
22608,Illify,tichondrius,2139,monk,mistweaver,66,52,14
22609,Cuteballs,tichondrius,2138,monk,mistweaver,81,50,31
22610,Oldmanswirl,mugthol,2137,monk,mistweaver,90,54,36
22611,Crunchyrollx,tichondrius,2135,monk,mistweaver,66,49,17
22612,Xeus,darkspear,2133,monk,mistweaver,60,38,22
22613,Jetnoob,sargeras,2132,monk,mistweaver,120,66,54
22614,Parodies,illidan,2131,monk,mistweaver,103,53,50
22615,Nfm,cairne,2130,monk,mistweaver,215,123,92
22616,Woggitie,jubeithos,2129,monk,mistweaver,68,45,23
22617,Igriefidiots,tichondrius,2129,monk,mistweaver,71,40,31
22618,Ringofpeace,sargeras,2128,monk,mistweaver,60,40,20
22619,Griefgodx,tichondrius,2127,monk,mistweaver,88,49,39
22620,Wheatsli,malganis,2126,monk,mistweaver,138,81,57
22621,Taichí,tichondrius,2123,monk,mistweaver,207,111,96
22622,Canghaigg,tichondrius,2122,monk,mistweaver,150,94,56
22623,Timermørk,kalecgos,2122,monk,mistweaver,139,86,53
22624,Purgenm,tichondrius,2122,monk,mistweaver,90,52,38
22625,Slunka,tichondrius,2121,monk,mistweaver,72,42,30
22626,Hernameplz,proudmoore,2120,monk,mistweaver,153,82,71
22627,Secdog,tichondrius,2118,monk,mistweaver,84,44,40
22628,Yogapantsx,nerzhul,2116,monk,mistweaver,80,44,36
22629,Kicub,emerald-dream,2115,monk,mistweaver,84,44,40
22630,Itzokinlol,malganis,2113,monk,mistweaver,114,70,44
22631,Firewatches,emerald-dream,2113,monk,mistweaver,72,42,30
22632,Tekuto,tichondrius,2112,monk,mistweaver,174,109,65
22633,Moldboy,area-52,2112,monk,mistweaver,75,45,30
22634,Nezly,sargeras,2112,monk,mistweaver,138,71,67
22635,Sintifissti,sargeras,2111,monk,mistweaver,62,41,21
22636,Wolf,shattered-hand,2111,monk,mistweaver,60,36,24
22637,Ccain,stormrage,2111,monk,mistweaver,145,78,67
22638,Yangroumo,tichondrius,2110,monk,mistweaver,131,78,53
22639,Gsdfjskpx,sargeras,2107,monk,mistweaver,306,165,141
22640,Gameníne,tichondrius,2103,monk,mistweaver,72,42,30
22641,Millé,frostmourne,2102,monk,mistweaver,84,52,32
22642,Waggìes,moon-guard,2101,monk,mistweaver,83,50,33
22643,Melonmuncher,duskwood,2101,monk,mistweaver,135,79,56
22644,Heywhatsup,emerald-dream,2097,monk,mistweaver,102,50,52
22645,Vaemonka,stormrage,2091,monk,mistweaver,219,127,92
22646,Proghouse,illidan,2089,monk,mistweaver,90,47,43
22647,Canghaimonk,tichondrius,2082,monk,mistweaver,166,87,79
22648,Elvenmonk,frostmane,2080,monk,mistweaver,72,44,28
22649,Hydroz,dethecus,2080,monk,mistweaver,101,56,45
22650,Natalié,caelestrasz,2079,monk,mistweaver,96,58,38
22651,Furiousfrank,stormrage,2079,monk,mistweaver,108,64,44
22652,Drracaryss,sargeras,2060,monk,mistweaver,203,125,78
22653,Strugglebus,sargeras,2056,monk,mistweaver,42,31,11
22654,Glqjkglbfgdl,zuljin,2053,monk,mistweaver,156,86,70
22655,Pandacottoca,azralon,2048,monk,mistweaver,108,73,35
22656,Huaren,tichondrius,2048,monk,mistweaver,137,78,59
22657,Breadweaver,malganis,2046,monk,mistweaver,96,47,49
22658,Wagfu,moon-guard,2045,monk,mistweaver,70,40,30
22659,Zuhak,tichondrius,2043,monk,mistweaver,96,54,42
22660,Thèwy,tichondrius,2041,monk,mistweaver,71,45,26
22661,Praggers,proudmoore,2039,monk,mistweaver,151,77,74
22662,Chimme,skywall,2036,monk,mistweaver,72,48,24
22663,Friendshipx,emerald-dream,2034,monk,mistweaver,42,33,9
22664,Morzmyth,nemesis,2034,monk,mistweaver,220,115,105
22665,Neuron,spirestone,2033,monk,mistweaver,56,30,26
22666,Nohandslost,blackrock,2033,monk,mistweaver,206,103,103
22667,Réðçräñé,sargeras,2031,monk,mistweaver,54,36,18
22668,Fizzlefarmer,moon-guard,2031,monk,mistweaver,89,54,35
22669,Brazfu,skullcrusher,2031,monk,mistweaver,153,89,64
22670,Físterxd,bleeding-hollow,2030,monk,mistweaver,318,173,145
22671,Babyfaceqt,skullcrusher,2027,monk,mistweaver,195,104,91
22672,Xdfu,stormrage,2025,monk,mistweaver,137,84,53
22673,Gogumamonk,tichondrius,2023,monk,mistweaver,114,55,59
22674,Zhoku,tichondrius,2020,monk,mistweaver,58,34,24
22675,Originull,darkspear,2020,monk,mistweaver,107,58,49
22676,Chadweave,moon-guard,2019,monk,mistweaver,441,234,207
22677,Triixxy,thrall,2018,monk,mistweaver,101,64,37
22678,Lodbork,tichondrius,2016,monk,mistweaver,198,114,84
22679,Drdabz,illidan,2012,monk,mistweaver,90,46,44
22680,Mcoos,tichondrius,2011,monk,mistweaver,186,112,74
22681,Punchgodx,greymane,2010,monk,mistweaver,78,46,32
22682,Bungfist,stormrage,2006,monk,mistweaver,41,29,12
22683,Kris,llane,2004,monk,mistweaver,95,55,40
22684,Jakethegreat,moknathal,2004,monk,mistweaver,217,124,93
22685,Voidstate,stormrage,2001,monk,mistweaver,131,71,60
22686,Leetcoder,tichondrius,2000,monk,mistweaver,195,120,75
22687,Sypìì,stormrage,2000,monk,mistweaver,120,64,56
22688,Àvríam,stormrage,1999,monk,mistweaver,113,54,59
22689,Danarolls,spirestone,1998,monk,mistweaver,95,46,49
22690,Sqmw,tichondrius,1996,monk,mistweaver,54,34,20
22691,Orbgodx,darkspear,1996,monk,mistweaver,66,39,27
22692,Taeeun,tichondrius,1994,monk,mistweaver,57,38,19
22693,Quitw,tichondrius,1994,monk,mistweaver,73,40,33
22694,Tyrfan,sargeras,1994,monk,mistweaver,154,84,70
22695,Ezqueue,area-52,1992,monk,mistweaver,36,27,9
22696,Bhoredom,kiljaeden,1992,monk,mistweaver,146,80,66
22697,Sevymonk,stormrage,1990,monk,mistweaver,102,62,40
22698,Thet,sargeras,1989,monk,mistweaver,177,90,87
22699,Wingchungus,sargeras,1987,monk,mistweaver,42,30,12
22700,Jiwå,terenas,1985,monk,mistweaver,648,328,320
22701,Nesoween,tichondrius,1979,monk,mistweaver,110,65,45
22702,Nuriva,tichondrius,1977,monk,mistweaver,88,62,26
22703,Vinnyd,tichondrius,1976,monk,mistweaver,39,27,12
22704,Benneroy,moon-guard,1976,monk,mistweaver,36,24,12
22705,Nilox,sargeras,1976,monk,mistweaver,174,96,78
22706,Meepmonk,kilrogg,1975,monk,mistweaver,51,27,24
22707,Kaylux,stormrage,1974,monk,mistweaver,60,36,24
22708,Martiálfarts,malganis,1973,monk,mistweaver,42,30,12
22709,Xcrispy,scilla,1969,monk,mistweaver,67,43,24
22710,Liltuna,icecrown,1968,monk,mistweaver,42,26,16
22711,Heha,tichondrius,1966,monk,mistweaver,346,176,170
22712,Assez,tichondrius,1966,monk,mistweaver,74,37,37
22713,Actualcrime,tichondrius,1965,monk,mistweaver,60,33,27
22714,Zaqqari,wyrmrest-accord,1965,monk,mistweaver,96,51,45
22715,Qup,lightbringer,1963,monk,mistweaver,132,88,44
22716,Venfuki,tichondrius,1963,monk,mistweaver,60,35,25
22717,Hawainpunch,stormscale,1961,monk,mistweaver,90,53,37
22718,Shlunks,illidan,1960,monk,mistweaver,267,155,112
22719,Carzzy,sargeras,1957,monk,mistweaver,88,51,37
22720,Wetchickennz,tichondrius,1955,monk,mistweaver,148,84,64
22721,Speedcapped,area-52,1954,monk,mistweaver,138,67,71
22722,Hafezassad,illidan,1954,monk,mistweaver,48,23,25
22723,Qtmonk,emerald-dream,1950,monk,mistweaver,159,93,66
22724,Vongg,tichondrius,1950,monk,mistweaver,66,36,30
22725,Zamist,sargeras,1949,monk,mistweaver,84,52,32
22726,Nakedidiot,kelthuzad,1948,monk,mistweaver,120,67,53
22727,Ekn,tichondrius,1945,monk,mistweaver,66,45,21
22728,Poscom,tichondrius,1944,monk,mistweaver,155,104,51
22729,Gabîmaru,area-52,1944,monk,mistweaver,192,114,78
22730,Lmhs,tichondrius,1942,monk,mistweaver,60,36,24
22731,Grif,nazjatar,1942,monk,mistweaver,207,108,99
22732,Yasysy,tichondrius,1938,monk,mistweaver,42,25,17
22733,Discurzed,barthilas,1938,monk,mistweaver,193,111,82
22734,Akiramenaide,tichondrius,1936,monk,mistweaver,64,44,20
22735,Swurvex,bleeding-hollow,1935,monk,mistweaver,78,36,42
22736,Ilovekok,sargeras,1933,monk,mistweaver,84,64,20
22737,Xzeer,illidan,1933,monk,mistweaver,53,36,17
22738,Beez,balnazzar,1931,monk,mistweaver,69,35,34
22739,Zeçe,tichondrius,1930,monk,mistweaver,42,26,16
22740,Stepfistz,aegwynn,1930,monk,mistweaver,154,90,64
22741,Crypomunkz,malganis,1929,monk,mistweaver,53,32,21
22742,Mixon,archimonde,1927,monk,mistweaver,36,25,11
22743,Pandacottoco,azralon,1924,monk,mistweaver,78,44,34
22744,Brews,black-dragonflight,1924,monk,mistweaver,121,65,56
22745,Imdabes,velen,1923,monk,mistweaver,72,39,33
22746,Postmark,tichondrius,1922,monk,mistweaver,60,34,26
22747,Confa,ragnaros,1922,monk,mistweaver,262,131,131
22748,Vethosis,illidan,1921,monk,mistweaver,43,27,16
22749,Esqu,sargeras,1920,monk,mistweaver,42,26,16
22750,Ònó,quelthalas,1919,monk,mistweaver,67,39,28
22751,Brewsome,bloodhoof,1919,monk,mistweaver,82,43,39
22752,Soprà,zuljin,1914,monk,mistweaver,63,39,24
22753,Itsbald,bleeding-hollow,1913,monk,mistweaver,90,57,33
22754,Kansú,ragnaros,1913,monk,mistweaver,100,53,47
22755,Abellmonk,tichondrius,1910,monk,mistweaver,203,117,86
22756,Paperfist,stormrage,1906,monk,mistweaver,126,87,39
22757,Basedbuck,dalaran,1904,monk,mistweaver,36,23,13
22758,Keshir,sargeras,1903,monk,mistweaver,111,71,40
22759,Lexxbtw,thrall,1903,monk,mistweaver,148,84,64
22760,Sillyguy,stormrage,1901,monk,mistweaver,107,69,38
22761,Aegea,illidan,1901,monk,mistweaver,67,37,30
22762,Cardrik,thrall,1901,monk,mistweaver,149,79,70
22763,Youstop,stormrage,1900,monk,mistweaver,96,61,35
22764,Xhangtu,thrall,1900,monk,mistweaver,190,120,70
22765,Toyotasupra,emerald-dream,1898,monk,mistweaver,72,46,26
22766,Canadá,bleeding-hollow,1896,monk,mistweaver,60,41,19
22767,Rokkon,sargeras,1896,monk,mistweaver,106,59,47
22768,Watersheep,darkspear,1896,monk,mistweaver,72,38,34
22769,Worldhopperx,area-52,1894,monk,mistweaver,89,57,32
22770,Sniffinsteak,laughing-skull,1892,monk,mistweaver,42,33,9
22771,Kristië,stormrage,1891,monk,mistweaver,42,30,12
22772,Monktease,tichondrius,1890,monk,mistweaver,96,50,46
22773,Michæ,ragnaros,1888,monk,mistweaver,267,146,121
22774,Suamw,tichondrius,1888,monk,mistweaver,115,55,60
22775,Wrxx,kelthuzad,1886,monk,mistweaver,352,174,178
22776,Zengriff,ysondre,1885,monk,mistweaver,72,44,28
22777,Poppinbrews,thrall,1880,monk,mistweaver,46,27,19
22778,Fenriranger,tichondrius,1878,monk,mistweaver,172,105,67
22779,Suhjoon,bleeding-hollow,1878,monk,mistweaver,160,80,80
22780,Toozmania,stormrage,1876,monk,mistweaver,52,31,21
22781,Okchat,emerald-dream,1876,monk,mistweaver,216,125,91
22782,Gentleuncle,tichondrius,1874,monk,mistweaver,143,83,60
22783,Liteup,smolderthorn,1874,monk,mistweaver,456,231,225
22784,Sifu,bleeding-hollow,1873,monk,mistweaver,59,36,23
22785,Søpra,zuljin,1872,monk,mistweaver,138,81,57
22786,Spicyx,kiljaeden,1871,monk,mistweaver,30,24,6
22787,Spook,kalecgos,1871,monk,mistweaver,67,44,23
22788,Robocto,area-52,1869,monk,mistweaver,102,61,41
22789,Shùù,tichondrius,1866,monk,mistweaver,65,37,28
22790,Dalillama,stormreaver,1865,monk,mistweaver,48,31,17
22791,Logtich,moon-guard,1864,monk,mistweaver,78,42,36
22792,Ileffsinll,illidan,1863,monk,mistweaver,113,64,49
22793,Dancah,eitrigg,1861,monk,mistweaver,41,22,19
22794,Papermade,barthilas,1860,monk,mistweaver,48,26,22
22795,Cmonktwo,turalyon,1858,monk,mistweaver,54,31,23
22796,Sevenmonk,tichondrius,1857,monk,mistweaver,54,36,18
22797,Tokol,tichondrius,1857,monk,mistweaver,168,90,78
22798,Wpola,tichondrius,1856,monk,mistweaver,48,31,17
22799,Cmonk,turalyon,1856,monk,mistweaver,40,24,16
22800,Threefanandy,kelthuzad,1855,monk,mistweaver,36,23,13
22801,Milkshayx,kiljaeden,1855,monk,mistweaver,42,25,17
22802,Cbrewfeaver,malganis,1855,monk,mistweaver,54,31,23
22803,Piilsburry,sargeras,1855,monk,mistweaver,48,26,22
22804,Timbomist,kelthuzad,1855,monk,mistweaver,97,52,45
22805,Bengotitboi,magtheridon,1853,monk,mistweaver,42,24,18
22806,Shad,frostmourne,1853,monk,mistweaver,102,58,44
22807,Zdeg,tichondrius,1852,monk,mistweaver,51,28,23
22808,Senseipwnda,stormrage,1851,monk,mistweaver,77,46,31
22809,Fluval,moon-guard,1850,monk,mistweaver,71,47,24
22810,Velzarria,zuljin,1849,monk,mistweaver,60,36,24
22811,Damogen,spinebreaker,1849,monk,mistweaver,54,28,26
22812,Elesm,area-52,1849,monk,mistweaver,108,48,60
22813,Zipmw,tichondrius,1848,monk,mistweaver,66,36,30
22814,Moushindeiru,sargeras,1846,monk,mistweaver,78,58,20
22815,Proxy,ragnaros,1846,monk,mistweaver,46,31,15
22816,Tonyboloney,tichondrius,1845,monk,mistweaver,42,25,17
22817,Wizlee,tichondrius,1845,monk,mistweaver,60,34,26
22818,Dampdampdamp,tichondrius,1844,monk,mistweaver,24,20,4
22819,Fîstweave,emerald-dream,1844,monk,mistweaver,77,45,32
22820,Snuggubae,moon-guard,1844,monk,mistweaver,204,111,93
22821,Yujiro,draktharon,1843,monk,mistweaver,36,23,13
22822,Dwánesan,tichondrius,1843,monk,mistweaver,72,44,28
22823,Crabfest,zuljin,1843,monk,mistweaver,60,35,25
22824,Wombglazer,dalaran,1841,monk,mistweaver,34,26,8
22825,Xinergy,illidan,1840,monk,mistweaver,98,65,33
22826,Youngsìnatra,muradin,1840,monk,mistweaver,42,26,16
22827,Stonemists,ragnaros,1840,monk,mistweaver,71,43,28
22828,Fingies,whisperwind,1838,monk,mistweaver,60,36,24
22829,Caffeinated,barthilas,1838,monk,mistweaver,274,135,139
22830,Nabunaga,illidan,1837,monk,mistweaver,42,34,8
22831,Hinåta,thrall,1837,monk,mistweaver,40,26,14
22832,Baychiz,sargeras,1837,monk,mistweaver,42,25,17
22833,Irraeine,malganis,1836,monk,mistweaver,48,31,17
22834,Itspoils,illidan,1835,monk,mistweaver,73,53,20
22835,Veejaex,stormreaver,1835,monk,mistweaver,39,27,12
22836,Zarenki,tichondrius,1835,monk,mistweaver,73,33,40
22837,Supbro,hyjal,1834,monk,mistweaver,36,23,13
22838,Spacebar,ysondre,1834,monk,mistweaver,54,31,23
22839,Monjimen,ragnaros,1834,monk,mistweaver,408,216,192
22840,Blackoutmonk,stormreaver,1833,monk,mistweaver,131,80,51
22841,Harkwind,azralon,1833,monk,mistweaver,187,108,79
22842,Guarantee,tichondrius,1832,monk,mistweaver,182,102,80
22843,Cmonkey,turalyon,1831,monk,mistweaver,48,31,17
22844,Fistër,area-52,1830,monk,mistweaver,72,43,29
22845,Ichiros,cenarion-circle,1830,monk,mistweaver,390,219,171
22846,Zuhakmw,tichondrius,1830,monk,mistweaver,142,66,76
22847,Aviee,illidan,1830,monk,mistweaver,180,83,97
22848,Chonmist,darkspear,1829,monk,mistweaver,92,60,32
22849,Drunkenfist,chogall,1829,monk,mistweaver,71,32,39
22850,Takugava,illidan,1828,monk,mistweaver,96,66,30
22851,Qxt,tichondrius,1828,monk,mistweaver,76,44,32
22852,Turbokíll,proudmoore,1828,monk,mistweaver,54,30,24
22853,Jtea,malganis,1827,monk,mistweaver,29,20,9
22854,Baoma,tichondrius,1827,monk,mistweaver,95,55,40
22855,Monklike,illidan,1827,monk,mistweaver,60,30,30
22856,Bootÿmagic,tichondrius,1826,monk,mistweaver,150,94,56
22857,Wigglygiggly,mannoroth,1826,monk,mistweaver,113,64,49
22858,Macrobrewski,tichondrius,1825,monk,mistweaver,41,32,9
22859,Jackouse,frostmourne,1824,monk,mistweaver,50,31,19
22860,Onepunçhman,stormreaver,1824,monk,mistweaver,250,141,109
22861,Hugdealer,warsong,1823,monk,mistweaver,80,47,33
22862,Patfu,area-52,1823,monk,mistweaver,57,32,25
22863,Gtmdyjs,illidan,1822,monk,mistweaver,29,20,9
22864,Jojostar,shadowsong,1822,monk,mistweaver,54,32,22
22865,Zenchi,kelthuzad,1821,monk,mistweaver,36,26,10
22866,Vynchi,area-52,1821,monk,mistweaver,97,67,30
22867,Tazi,chromaggus,1821,monk,mistweaver,84,50,34
22868,Mackiechan,kelthuzad,1821,monk,mistweaver,134,77,57
22869,Voltio,frostmane,1820,monk,mistweaver,103,68,35
22870,Chaddington,malorne,1820,monk,mistweaver,48,30,18
22871,Barelroll,proudmoore,1819,monk,mistweaver,122,83,39
22872,Monknutt,tichondrius,1819,monk,mistweaver,56,32,24
22873,Ilovefrogs,stormrage,1819,monk,mistweaver,60,30,30
22874,Fatnugly,sargeras,1818,monk,mistweaver,62,39,23
22875,Djkungfu,thrall,1818,monk,mistweaver,180,107,73
22876,Malibrew,proudmoore,1817,monk,mistweaver,42,29,13
22877,Deathsteel,emerald-dream,1817,monk,mistweaver,41,25,16
22878,Fistinator,blackrock,1817,monk,mistweaver,120,71,49
22879,Toxicbeans,tichondrius,1817,monk,mistweaver,100,58,42
22880,Rektral,ragnaros,1817,monk,mistweaver,127,73,54
22881,Ándi,barthilas,1817,monk,mistweaver,53,28,25
22882,Bubblepony,illidan,1817,monk,mistweaver,313,164,149
22883,Chaihard,sargeras,1816,monk,mistweaver,45,25,20
22884,Yobeel,tichondrius,1816,monk,mistweaver,54,23,31
22885,Iovegõd,tichondrius,1815,monk,mistweaver,163,99,64
22886,Xhilong,quelthalas,1815,monk,mistweaver,48,28,20
22887,Zilph,malganis,1815,monk,mistweaver,66,36,30
22888,Mð,vashj,1815,monk,mistweaver,229,119,110
22889,Decompress,illidan,1814,monk,mistweaver,99,60,39
22890,Phunkymonkey,mannoroth,1814,monk,mistweaver,90,50,40
22891,Adop,dark-iron,1813,monk,mistweaver,130,79,51
22892,Miley,lethon,1812,monk,mistweaver,36,23,13
22893,Hyori,saurfang,1812,monk,mistweaver,54,29,25
22894,Intra,exodar,1812,monk,mistweaver,150,79,71
22895,Soö,tichondrius,1812,monk,mistweaver,66,34,32
22896,Evilfantum,illidan,1811,monk,mistweaver,42,32,10
22897,Battlecruise,tichondrius,1811,monk,mistweaver,36,24,12
22898,Gnappyy,tichondrius,1811,monk,mistweaver,41,25,16
22899,Mistpump,tichondrius,1811,monk,mistweaver,48,26,22
22900,Oppsimop,frostmourne,1811,monk,mistweaver,114,61,53
22901,Tirionx,area-52,1810,monk,mistweaver,227,130,97
22902,Vernki,laughing-skull,1809,monk,mistweaver,77,48,29
22903,Mavvi,tichondrius,1809,monk,mistweaver,170,88,82
22904,Cangry,area-52,1809,monk,mistweaver,60,31,29
22905,Epî,tichondrius,1809,monk,mistweaver,312,155,157
22906,Shadmw,barthilas,1808,monk,mistweaver,42,30,12
22907,Phattea,thrall,1808,monk,mistweaver,48,31,17
22908,Jiskweaver,sargeras,1808,monk,mistweaver,36,22,14
22909,Enfold,stormrage,1808,monk,mistweaver,48,26,22
22910,Yokuu,thunderlord,1808,monk,mistweaver,54,29,25
22911,Jaja,kiljaeden,1807,monk,mistweaver,48,28,20
22912,Abeldra,moon-guard,1807,monk,mistweaver,82,42,40
22913,Sayflight,tichondrius,1807,monk,mistweaver,72,31,41
22914,Itdreams,illidan,1806,monk,mistweaver,42,25,17
22915,Taekwonscro,proudmoore,1806,monk,mistweaver,60,33,27
22916,Timed,shuhalo,1806,monk,mistweaver,49,26,23
22917,Shiinobi,area-52,1806,monk,mistweaver,140,74,66
22918,Astrino,zuljin,1805,monk,mistweaver,42,29,13
22919,Chimaekrush,tichondrius,1805,monk,mistweaver,36,24,12
22920,Crispeel,tichondrius,1805,monk,mistweaver,54,33,21
22921,Briàr,area-52,1805,monk,mistweaver,48,27,21
22922,Strongmandan,twisting-nether,1805,monk,mistweaver,42,23,19
22923,Onlyfansx,ragnaros,1805,monk,mistweaver,256,139,117
22924,Cenfu,malganis,1805,monk,mistweaver,72,29,43
22925,Alphamist,thrall,1804,monk,mistweaver,36,23,13
22926,Proventos,azralon,1804,monk,mistweaver,483,256,227
22927,Imdabes,destromath,1804,monk,mistweaver,87,38,49
22928,Vrieden,illidan,1804,monk,mistweaver,99,42,57
22929,Bickli,tichondrius,1803,monk,mistweaver,57,32,25
22930,Celerein,illidan,1803,monk,mistweaver,118,61,57
22931,Gabaan,azralon,1803,monk,mistweaver,54,27,27
22932,Zundor,ghostlands,1802,monk,mistweaver,32,25,7
22933,Nefazzto,ragnaros,1802,monk,mistweaver,30,19,11
22934,Udderpunch,barthilas,1802,monk,mistweaver,83,51,32
22935,Zenno,darkspear,1802,monk,mistweaver,51,31,20
22936,Kungfoocious,tichondrius,1802,monk,mistweaver,57,33,24
22937,Zeroskil,thrall,1802,monk,mistweaver,66,38,28
22938,Ojarax,bleeding-hollow,1802,monk,mistweaver,60,34,26
22939,ßullsack,barthilas,1802,monk,mistweaver,108,57,51
22940,Mixflo,bleeding-hollow,1802,monk,mistweaver,39,20,19
22941,Wootzhu,zuljin,1802,monk,mistweaver,122,62,60
22942,Séthrogèn,tichondrius,1801,monk,mistweaver,47,30,17
22943,Mistweave,aerie-peak,1801,monk,mistweaver,54,34,20
22944,Vanmonk,eonar,1801,monk,mistweaver,54,33,21
22945,Squalicorax,area-52,1801,monk,mistweaver,47,24,23
22946,Jiucho,dalaran,1800,monk,mistweaver,35,23,12
22947,Exuperjun,emerald-dream,1800,monk,mistweaver,46,26,20
22948,Mekawa,gurubashi,1799,monk,mistweaver,40,26,14
22949,Tiptea,stormrage,1799,monk,mistweaver,42,23,19
22950,Femalejam,darkspear,1798,monk,mistweaver,66,40,26
22951,Toonington,sargeras,1797,monk,mistweaver,57,39,18
22952,Karatechawp,bleeding-hollow,1795,monk,mistweaver,64,44,20
22953,Swoleypoley,tichondrius,1794,monk,mistweaver,54,29,25
22954,Senritsuh,drakkari,1793,monk,mistweaver,42,25,17
22955,Cromulent,saurfang,1792,monk,mistweaver,134,70,64
22956,Zukki,zuljin,1791,monk,mistweaver,166,87,79
22957,Valhira,kiljaeden,1787,monk,mistweaver,78,45,33
22958,Greenbrews,area-52,1787,monk,mistweaver,246,133,113
22959,Roypoker,illidan,1785,monk,mistweaver,48,34,14
22960,Rexfiend,tichondrius,1782,monk,mistweaver,24,19,5
22961,Triarcs,area-52,1781,monk,mistweaver,36,24,12
22962,Hepp,stormrage,1781,monk,mistweaver,54,35,19
22963,Dræmwalker,malygos,1781,monk,mistweaver,735,367,368
22964,Suppfastlol,nemesis,1780,monk,mistweaver,114,65,49
22965,Ttvchickchau,tichondrius,1779,monk,mistweaver,125,75,50
22966,Chiang,chogall,1778,monk,mistweaver,71,54,17
22967,Coomweaver,stormrage,1778,monk,mistweaver,42,22,20
22968,Lgee,kelthuzad,1774,monk,mistweaver,30,19,11
22969,Khungfeu,area-52,1774,monk,mistweaver,60,35,25
22970,Qarmax,azralon,1772,monk,mistweaver,41,23,18
22971,Copula,illidan,1770,monk,mistweaver,296,150,146
22972,Integrity,durotan,1769,monk,mistweaver,250,134,116
22973,Chikid,barthilas,1768,monk,mistweaver,54,35,19
22974,Trackstarx,area-52,1767,monk,mistweaver,30,25,5
22975,Daito,jubeithos,1767,monk,mistweaver,110,62,48
22976,Cyrøwø,ragnaros,1765,monk,mistweaver,36,27,9
22977,Iknwmyname,proudmoore,1764,monk,mistweaver,29,23,6
22978,Roogymw,emerald-dream,1764,monk,mistweaver,94,54,40
22979,Misthealz,black-dragonflight,1763,monk,mistweaver,125,77,48
22980,Onecoolmonk,tichondrius,1762,monk,mistweaver,68,43,25
22981,Iightning,dentarg,1762,monk,mistweaver,66,40,26
22982,Jayvex,illidan,1762,monk,mistweaver,72,37,35
22983,Kelstrike,sargeras,1760,monk,mistweaver,42,26,16
22984,Beerflow,stormrage,1760,monk,mistweaver,118,61,57
22985,Izolatedrin,tichondrius,1757,monk,mistweaver,23,19,4
22986,Zoltwo,sargeras,1757,monk,mistweaver,136,82,54
22987,Bouncymoo,frostmourne,1756,monk,mistweaver,36,21,15
22988,Whatdaheal,darkspear,1756,monk,mistweaver,72,31,41
22989,Mikamonk,illidan,1755,monk,mistweaver,81,48,33
22990,Monkeymonk,eonar,1755,monk,mistweaver,36,19,17
22991,Rîce,burning-blade,1754,monk,mistweaver,42,29,13
22992,Rokk,rivendare,1754,monk,mistweaver,78,44,34
22993,Mymissteak,darkspear,1753,monk,mistweaver,105,66,39
22994,Grabbitz,kelthuzad,1751,monk,mistweaver,42,27,15
22995,Pichau,zuljin,1751,monk,mistweaver,57,35,22
22996,Bouncycheeks,frostmourne,1751,monk,mistweaver,90,50,40
22997,Lovehate,zuljin,1751,monk,mistweaver,77,39,38
22998,Spinharder,stormrage,1750,monk,mistweaver,65,38,27
22999,Ensaymada,frostmourne,1750,monk,mistweaver,138,71,67
23000,Ahlanna,malganis,1748,monk,mistweaver,29,19,10
23001,Monkeyhealz,tichondrius,1748,monk,mistweaver,185,105,80
23002,Callmekoldi,dalaran,1748,monk,mistweaver,93,52,41
23003,Motogp,tichondrius,1748,monk,mistweaver,176,87,89
23004,Nerf,malganis,1747,monk,mistweaver,29,19,10
23005,Gamesuxlol,the-underbog,1747,monk,mistweaver,96,55,41
23006,Tippity,stormrage,1746,monk,mistweaver,37,24,13
23007,Boomtac,moon-guard,1746,monk,mistweaver,104,60,44
23008,Gramazen,tichondrius,1746,monk,mistweaver,72,39,33
23009,Mêlon,tichondrius,1745,monk,mistweaver,30,22,8
23010,Bebuu,proudmoore,1744,monk,mistweaver,65,44,21
23011,Chérudim,malganis,1744,monk,mistweaver,36,22,14
23012,Grublord,stormrage,1744,monk,mistweaver,53,27,26
23013,Mxf,tichondrius,1743,monk,mistweaver,36,23,13
23014,Cystweaver,dalaran,1743,monk,mistweaver,71,45,26
23015,Mistpowaz,stormrage,1742,monk,mistweaver,143,84,59
23016,Baittor,proudmoore,1741,monk,mistweaver,62,39,23
23017,Tyforprecog,kelthuzad,1739,monk,mistweaver,54,33,21
23018,Yepcocc,lightbringer,1739,monk,mistweaver,41,24,17
23019,Ellesig,ragnaros,1739,monk,mistweaver,250,129,121
23020,Bobbytheorc,tichondrius,1738,monk,mistweaver,35,21,14
23021,Vamplyyz,kelthuzad,1737,monk,mistweaver,60,30,30
23022,Pandatrainer,drakkari,1736,monk,mistweaver,36,23,13
23023,Bubear,stormreaver,1735,monk,mistweaver,36,23,13
23024,Mistqt,illidan,1735,monk,mistweaver,48,28,20
23025,Gujunpyó,sargeras,1734,monk,mistweaver,90,56,34
23026,Antriai,icecrown,1734,monk,mistweaver,60,26,34
23027,Monkney,tichondrius,1733,monk,mistweaver,106,71,35
23028,Sleeks,bonechewer,1733,monk,mistweaver,114,64,50
23029,Ricearolli,area-52,1731,monk,mistweaver,36,26,10
23030,Lasagnacàt,moon-guard,1731,monk,mistweaver,180,105,75
23031,Zenblazer,illidan,1731,monk,mistweaver,43,22,21
23032,Moonhealsyou,moon-guard,1730,monk,mistweaver,100,65,35
23033,Nevercranex,kirin-tor,1730,monk,mistweaver,42,26,16
23034,Monke,onyxia,1730,monk,mistweaver,54,31,23
23035,Gummycat,bonechewer,1729,monk,mistweaver,204,107,97
23036,Fistofchanny,tichondrius,1725,monk,mistweaver,104,57,47
23037,Ajizzaÿ,saurfang,1725,monk,mistweaver,92,46,46
23038,Pp,icecrown,1724,monk,mistweaver,43,38,5
23039,Flavier,illidan,1724,monk,mistweaver,48,25,23
23040,Smoovhoov,kiljaeden,1723,monk,mistweaver,30,19,11
23041,Canadien,silver-hand,1723,monk,mistweaver,30,18,12
23042,Cloq,kelthuzad,1723,monk,mistweaver,71,38,33
23043,Smallboots,area-52,1722,monk,mistweaver,30,24,6
23044,Steelcase,frostmourne,1722,monk,mistweaver,47,26,21
23045,Kênpächi,rexxar,1722,monk,mistweaver,57,29,28
23046,Igaku,windrunner,1721,monk,mistweaver,54,33,21
23047,Kawali,thrall,1721,monk,mistweaver,96,53,43
23048,Ðescubra,stormrage,1721,monk,mistweaver,80,44,36
23049,Xblingtron,malganis,1721,monk,mistweaver,65,27,38
23050,Rizzdriver,moon-guard,1719,monk,mistweaver,66,41,25
23051,Calvana,tichondrius,1719,monk,mistweaver,143,63,80
23052,Sixesm,dalaran,1717,monk,mistweaver,48,25,23
23053,Joonbug,moonrunner,1715,monk,mistweaver,83,47,36
23054,Xtramist,tichondrius,1713,monk,mistweaver,48,24,24
23055,Alexìn,sargeras,1712,monk,mistweaver,79,50,29
23056,Inalambrico,quelthalas,1712,monk,mistweaver,36,22,14
23057,Hansul,tichondrius,1711,monk,mistweaver,111,51,60
23058,Buhmonk,thrall,1710,monk,mistweaver,60,34,26
23059,Zuen,ragnaros,1710,monk,mistweaver,230,117,113
23060,Noremaç,frostmourne,1709,monk,mistweaver,36,21,15
23061,Gauche,arygos,1709,monk,mistweaver,168,88,80
23062,Trezzic,aegwynn,1709,monk,mistweaver,49,25,24
23063,Betasquadxd,bleeding-hollow,1707,monk,mistweaver,43,25,18
23064,Gundamfish,tichondrius,1707,monk,mistweaver,42,22,20
23065,Meâghân,bladefist,1705,monk,mistweaver,27,19,8
23066,Knuqz,stormrage,1705,monk,mistweaver,36,18,18
23067,Monkyou,area-52,1705,monk,mistweaver,72,35,37
23068,Røllitup,illidan,1704,monk,mistweaver,54,34,20
23069,Yamatoqt,frostmourne,1704,monk,mistweaver,60,35,25
23070,Omihli,sargeras,1704,monk,mistweaver,48,28,20
23071,Whaes,thrall,1704,monk,mistweaver,36,21,15
23072,Bloodyxmonk,firetree,1704,monk,mistweaver,55,31,24
23073,Spot,kelthuzad,1704,monk,mistweaver,48,24,24
23074,Kynalla,thunderlord,1703,monk,mistweaver,30,18,12
23075,Manggi,tichondrius,1702,monk,mistweaver,169,98,71
23076,Sparksgamer,ragnaros,1701,monk,mistweaver,36,18,18
23077,Badonkadonk,kiljaeden,1701,monk,mistweaver,66,27,39
23078,Starçandy,tichondrius,1699,monk,mistweaver,120,62,58
23079,Manicata,tichondrius,1698,monk,mistweaver,207,121,86
23080,Goldenfoot,tichondrius,1698,monk,mistweaver,150,79,71
23081,Mexii,hellscream,1697,monk,mistweaver,247,119,128
23082,Krömbopulos,magtheridon,1696,monk,mistweaver,36,24,12
23083,Zawlp,sargeras,1693,monk,mistweaver,62,37,25
23084,Gellindra,malganis,1692,monk,mistweaver,30,22,8
23085,Nevershower,malganis,1692,monk,mistweaver,30,22,8
23086,Velenious,tichondrius,1692,monk,mistweaver,125,75,50
23087,Jaige,illidan,1692,monk,mistweaver,30,18,12
23088,Florla,illidan,1692,monk,mistweaver,46,24,22
23089,Anandamayi,emerald-dream,1691,monk,mistweaver,48,27,21
23090,Linsey,frostmourne,1691,monk,mistweaver,36,20,16
23091,Jiubak,dalaran,1691,monk,mistweaver,48,26,22
23092,Teewin,area-52,1690,monk,mistweaver,89,61,28
23093,Jinker,malganis,1690,monk,mistweaver,53,33,20
23094,Healmart,bloodhoof,1690,monk,mistweaver,30,18,12
23095,Mariabaraks,darkspear,1690,monk,mistweaver,102,56,46
23096,Seokdenam,tichondrius,1689,monk,mistweaver,99,56,43
23097,Carlyjepsen,shadowmoon,1688,monk,mistweaver,133,70,63
23098,Bromonster,zuljin,1687,monk,mistweaver,36,18,18
23099,Cohenn,tichondrius,1686,monk,mistweaver,24,18,6
23100,Botweaver,proudmoore,1686,monk,mistweaver,80,45,35
23101,Spencere,hyjal,1686,monk,mistweaver,84,44,40
23102,Unclety,tichondrius,1685,monk,mistweaver,42,24,18
23103,Alekun,quelthalas,1685,monk,mistweaver,174,91,83
23104,Alternatives,sargeras,1684,monk,mistweaver,24,18,6
23105,Ropturttlê,tichondrius,1684,monk,mistweaver,36,24,12
23106,Tazermw,sargeras,1684,monk,mistweaver,68,41,27
23107,Hogarg,emerald-dream,1684,monk,mistweaver,36,21,15
23108,Doomstroller,aegwynn,1684,monk,mistweaver,177,91,86
23109,Azurro,jubeithos,1683,monk,mistweaver,36,24,12
23110,Versachi,stormreaver,1683,monk,mistweaver,111,62,49
23111,Cherep,kiljaeden,1683,monk,mistweaver,111,59,52
23112,Vïolët,moon-guard,1682,monk,mistweaver,213,124,89
23113,Aráshicage,malganis,1681,monk,mistweaver,48,29,19
23114,Chopschtichs,kiljaeden,1680,monk,mistweaver,75,47,28
23115,Fisetèrr,kelthuzad,1680,monk,mistweaver,59,35,24
23116,Ninetrigrams,illidan,1680,monk,mistweaver,56,33,23
23117,Hoofweaver,proudmoore,1680,monk,mistweaver,60,25,35
23118,Todnerey,sargeras,1679,monk,mistweaver,77,52,25
23119,Lazeekick,sargeras,1679,monk,mistweaver,48,23,25
23120,Dwãrf,tichondrius,1678,monk,mistweaver,36,25,11
23121,Thraging,sargeras,1678,monk,mistweaver,54,29,25
23122,Maicuta,thrall,1675,monk,mistweaver,42,26,16
23123,Muzzye,frostmourne,1675,monk,mistweaver,298,171,127
23124,Zenox,rexxar,1675,monk,mistweaver,90,46,44
23125,Brewy,bloodhoof,1674,monk,mistweaver,24,19,5
23126,Phlexz,jubeithos,1674,monk,mistweaver,30,22,8
23127,Sickdrip,magtheridon,1674,monk,mistweaver,42,23,19
23128,Aiswalle,illidan,1673,monk,mistweaver,39,22,17
23129,Dryungpwnz,zuljin,1673,monk,mistweaver,248,139,109
23130,Drunkentoker,illidan,1673,monk,mistweaver,48,26,22
23131,Yeji,altar-of-storms,1673,monk,mistweaver,145,69,76
23132,Greenstar,bleeding-hollow,1672,monk,mistweaver,247,128,119
23133,Tezcatyo,malganis,1671,monk,mistweaver,54,32,22
23134,Stonymcblaze,malganis,1671,monk,mistweaver,48,28,20
23135,Djuice,tichondrius,1670,monk,mistweaver,42,25,17
23136,Fisticufs,bleeding-hollow,1670,monk,mistweaver,42,23,19
23137,Phtarded,stormreaver,1670,monk,mistweaver,140,70,70
23138,Quitschi,tichondrius,1669,monk,mistweaver,42,26,16
23139,Yulfee,kelthuzad,1669,monk,mistweaver,39,22,17
23140,Lýøp,illidan,1668,monk,mistweaver,48,29,19
23141,Ïtächï,illidan,1668,monk,mistweaver,66,27,39
23142,Garg,malganis,1666,monk,mistweaver,30,22,8
23143,Loudpäck,dalaran,1666,monk,mistweaver,41,26,15
23144,Noneedlokita,illidan,1666,monk,mistweaver,42,26,16
23145,Nahr,tichondrius,1666,monk,mistweaver,39,22,17
23146,Nugskis,dalaran,1666,monk,mistweaver,263,135,128
23147,Twoshero,tichondrius,1665,monk,mistweaver,34,22,12
23148,Mememories,tichondrius,1665,monk,mistweaver,74,46,28
23149,Jamerino,jubeithos,1665,monk,mistweaver,210,119,91
23150,Raymond,malganis,1664,monk,mistweaver,58,37,21
23151,Winfred,bleeding-hollow,1663,monk,mistweaver,54,36,18
23152,Mistastep,tichondrius,1663,monk,mistweaver,168,88,80
23153,Blasê,frostmourne,1662,monk,mistweaver,36,22,14
23154,Crypslegacy,tichondrius,1662,monk,mistweaver,208,108,100
23155,Gomon,terenas,1661,monk,mistweaver,29,20,9
23156,Èmacs,barthilas,1661,monk,mistweaver,35,24,11
23157,Coldridge,bleeding-hollow,1661,monk,mistweaver,42,20,22
23158,Jeskâi,tichondrius,1660,monk,mistweaver,45,26,19
23159,Chessyx,ragnaros,1660,monk,mistweaver,42,20,22
23160,Rectus,proudmoore,1659,monk,mistweaver,30,22,8
23161,Dupaweaver,stormrage,1659,monk,mistweaver,59,26,33
23162,Fistwrapped,bleeding-hollow,1658,monk,mistweaver,42,27,15
23163,Cheetosnmilk,malganis,1658,monk,mistweaver,35,20,15
23164,Lu,nesingwary,1657,monk,mistweaver,30,19,11
23165,Serikko,frostmourne,1657,monk,mistweaver,44,26,18
23166,Vybe,frostmourne,1656,monk,mistweaver,69,48,21
23167,Sóntix,sargeras,1656,monk,mistweaver,71,38,33
23168,Cööked,illidan,1656,monk,mistweaver,63,33,30
23169,Damndaniel,hyjal,1656,monk,mistweaver,214,107,107
23170,Greenrice,thrall,1655,monk,mistweaver,52,33,19
23171,Lilsloptop,moon-guard,1655,monk,mistweaver,161,96,65
23172,Alocxo,drakkari,1654,monk,mistweaver,34,24,10
23173,Trojanz,malganis,1654,monk,mistweaver,36,20,16
23174,Zachxd,onyxia,1653,monk,mistweaver,42,26,16
23175,Repbrew,sargeras,1653,monk,mistweaver,63,33,30
23176,Groundways,sargeras,1653,monk,mistweaver,65,31,34
23177,Raígon,ragnaros,1652,monk,mistweaver,36,20,16
23178,Molochko,area-52,1651,monk,mistweaver,26,20,6
23179,Pai,sargeras,1651,monk,mistweaver,36,22,14
23180,Gnetic,nemesis,1651,monk,mistweaver,92,51,41
23181,Tonytornado,proudmoore,1651,monk,mistweaver,84,40,44
23182,Lartridia,malganis,1650,monk,mistweaver,45,27,18
23183,Toastsmonk,tichondrius,1649,monk,mistweaver,38,24,14
23184,Rexzilla,tichondrius,1648,monk,mistweaver,36,25,11
23185,Ccop,kelthuzad,1647,monk,mistweaver,36,25,11
23186,Notblakexo,tichondrius,1647,monk,mistweaver,35,19,16
23187,Donnieyen,area-52,1647,monk,mistweaver,72,37,35
23188,Ashamah,bleeding-hollow,1644,monk,mistweaver,30,22,8
23189,Miillkz,zuljin,1644,monk,mistweaver,47,25,22
23190,Ragemore,emerald-dream,1643,monk,mistweaver,37,23,14
23191,Ahnlev,ragnaros,1643,monk,mistweaver,116,66,50
23192,Mistweaverxo,malganis,1643,monk,mistweaver,128,70,58
23193,Ææøææôææôææô,illidan,1642,monk,mistweaver,138,88,50
23194,Misooyom,moon-guard,1641,monk,mistweaver,54,35,19
23195,Swiftm,thrall,1641,monk,mistweaver,321,179,142
23196,Tenoseven,area-52,1640,monk,mistweaver,21,19,2
23197,Centalink,barthilas,1640,monk,mistweaver,56,38,18
23198,Rhorkfist,frostmourne,1640,monk,mistweaver,43,23,20
23199,Julipz,tichondrius,1640,monk,mistweaver,36,19,17
23200,Djux,zuljin,1639,monk,mistweaver,30,20,10
23201,Senseii,dathremar,1639,monk,mistweaver,66,43,23
23202,Brewjitsu,tichondrius,1639,monk,mistweaver,42,23,19
23203,Kharazim,skullcrusher,1639,monk,mistweaver,108,47,61
23204,Pandareng,tichondrius,1638,monk,mistweaver,32,20,12
23205,Floka,bleeding-hollow,1638,monk,mistweaver,36,22,14
23206,Rañga,caelestrasz,1638,monk,mistweaver,77,45,32
23207,Pandaiax,area-52,1638,monk,mistweaver,65,36,29
23208,Grizzm,sargeras,1637,monk,mistweaver,78,48,30
23209,Genjen,bleeding-hollow,1637,monk,mistweaver,46,26,20
23210,Liké,tichondrius,1636,monk,mistweaver,54,32,22
23211,Bradyfour,moon-guard,1636,monk,mistweaver,137,74,63
23212,Samzo,barthilas,1636,monk,mistweaver,51,27,24
23213,Paralee,tichondrius,1635,monk,mistweaver,48,34,14
23214,Ropgobbler,muradin,1634,monk,mistweaver,30,18,12
23215,Caibiws,tichondrius,1634,monk,mistweaver,50,27,23
23216,Sixsticks,tichondrius,1633,monk,mistweaver,70,37,33
23217,Gooncave,stormrage,1633,monk,mistweaver,86,41,45
23218,Ermac,kiljaeden,1632,monk,mistweaver,47,32,15
23219,Minaffection,tichondrius,1632,monk,mistweaver,36,19,17
23220,Avm,azralon,1632,monk,mistweaver,60,31,29
23221,Misswalk,ragnaros,1632,monk,mistweaver,45,20,25
23222,Chongal,whisperwind,1631,monk,mistweaver,42,24,18
23223,Bossmonk,tichondrius,1631,monk,mistweaver,140,78,62
23224,Sodamint,sargeras,1631,monk,mistweaver,60,31,29
23225,Dragonwhirl,stormrage,1630,monk,mistweaver,95,54,41
23226,Cranekicks,moon-guard,1630,monk,mistweaver,269,148,121
23227,Roloyolo,illidan,1630,monk,mistweaver,64,25,39
23228,Ludan,eredar,1629,monk,mistweaver,160,85,75
23229,Místme,tichondrius,1629,monk,mistweaver,78,41,37
23230,Tuesdây,wyrmrest-accord,1628,monk,mistweaver,30,20,10
23231,Drama,tichondrius,1627,monk,mistweaver,44,30,14
23232,Baldbutcute,darkspear,1627,monk,mistweaver,28,19,9
23233,Avãrîce,stormrage,1626,monk,mistweaver,24,17,7
23234,Cryptmist,frostmourne,1626,monk,mistweaver,48,32,16
23235,Valelarus,doomhammer,1626,monk,mistweaver,42,24,18
23236,Zxenn,tichondrius,1626,monk,mistweaver,30,17,13
23237,Josciel,ragnaros,1626,monk,mistweaver,543,277,266
23238,Qoong,tichondrius,1625,monk,mistweaver,70,42,28
23239,Wittymonk,illidan,1625,monk,mistweaver,99,57,42
23240,Bodhisattvax,bleeding-hollow,1625,monk,mistweaver,42,24,18
23241,Zlatan,thaurissan,1625,monk,mistweaver,30,17,13
23242,Peachtea,burning-legion,1625,monk,mistweaver,45,21,24
23243,Crentist,mannoroth,1624,monk,mistweaver,40,31,9
23244,Innerchii,tichondrius,1624,monk,mistweaver,24,17,7
23245,Dirtyde,sargeras,1624,monk,mistweaver,181,87,94
23246,Fistergand,frostwolf,1623,monk,mistweaver,37,30,7
23247,Solusek,korgath,1623,monk,mistweaver,36,27,9
23248,Starryysky,illidan,1623,monk,mistweaver,48,32,16
23249,Lickthefist,sargeras,1623,monk,mistweaver,30,20,10
23250,Röshi,kelthuzad,1623,monk,mistweaver,54,35,19
23251,Zhíu,ragnaros,1623,monk,mistweaver,54,33,21
23252,Liteup,korgath,1623,monk,mistweaver,102,62,40
23253,Nicotinetap,tichondrius,1623,monk,mistweaver,30,18,12
23254,Chignar,dathremar,1622,monk,mistweaver,30,17,13
23255,Swuseng,tichondrius,1622,monk,mistweaver,54,29,25
23256,Ywingtsuan,frostmourne,1622,monk,mistweaver,41,21,20
23257,Diobrando,illidan,1621,monk,mistweaver,63,40,23
23258,Valian,tichondrius,1621,monk,mistweaver,42,22,20
23259,Ghðst,ragnaros,1620,monk,mistweaver,42,24,18
23260,Monkwalker,tichondrius,1620,monk,mistweaver,66,35,31
23261,Swolington,proudmoore,1619,monk,mistweaver,41,26,15
23262,Intertwine,frostmourne,1619,monk,mistweaver,30,17,13
23263,Footloverx,area-52,1618,monk,mistweaver,38,29,9
23264,Avz,azralon,1618,monk,mistweaver,30,21,9
23265,Metakillër,ragnaros,1618,monk,mistweaver,98,53,45
23266,Masamunes,thrall,1616,monk,mistweaver,50,38,12
23267,Stormpounder,proudmoore,1616,monk,mistweaver,60,40,20
23268,Locusta,tichondrius,1616,monk,mistweaver,30,19,11
23269,Drinkkin,bleeding-hollow,1616,monk,mistweaver,114,68,46
23270,Swiixm,frostmourne,1616,monk,mistweaver,64,38,26
23271,Mwgodqtxtko,nazjatar,1616,monk,mistweaver,54,32,22
23272,Sebsws,proudmoore,1616,monk,mistweaver,100,59,41
23273,Immamonkey,tichondrius,1616,monk,mistweaver,200,114,86
23274,Wokoon,kelthuzad,1615,monk,mistweaver,27,21,6
23275,Nekzí,sargeras,1615,monk,mistweaver,30,20,10
23276,Slipperybobs,tichondrius,1615,monk,mistweaver,89,57,32
23277,Yuï,bleeding-hollow,1615,monk,mistweaver,36,21,15
23278,Bréwmaster,stormrage,1615,monk,mistweaver,36,17,19
23279,Mukboo,tichondrius,1615,monk,mistweaver,36,17,19
23280,Kungfuturdle,tichondrius,1614,monk,mistweaver,101,58,43
23281,Xtacie,sargeras,1614,monk,mistweaver,66,30,36
23282,Keiirah,zuluhed,1614,monk,mistweaver,60,24,36
23283,Greenvan,tichondrius,1613,monk,mistweaver,24,17,7
23284,Pacee,deathwing,1613,monk,mistweaver,24,17,7
23285,Kûshi,stormrage,1613,monk,mistweaver,35,23,12
23286,Kendro,trollbane,1613,monk,mistweaver,59,38,21
23287,Whoonmonk,tichondrius,1613,monk,mistweaver,66,41,25
23288,Somebodym,illidan,1613,monk,mistweaver,36,22,14
23289,Merkey,tichondrius,1613,monk,mistweaver,72,39,33
23290,Yunmen,blades-edge,1613,monk,mistweaver,113,61,52
23291,Tharja,bonechewer,1612,monk,mistweaver,56,34,22
23292,Craziediemon,malganis,1612,monk,mistweaver,38,23,15
23293,Qords,tichondrius,1612,monk,mistweaver,148,77,71
23294,Musedz,barthilas,1612,monk,mistweaver,60,23,37
23295,Ninakittenx,staghelm,1611,monk,mistweaver,60,36,24
23296,Ggjudo,sargeras,1611,monk,mistweaver,52,31,21
23297,Braindi,arathor,1611,monk,mistweaver,54,30,24
23298,Dlysezzic,tichondrius,1611,monk,mistweaver,98,54,44
23299,Tweiliax,tichondrius,1611,monk,mistweaver,51,26,25
23300,Prisonike,bleeding-hollow,1610,monk,mistweaver,60,36,24
23301,Sudury,tichondrius,1610,monk,mistweaver,96,55,41
23302,Pingpang,stormreaver,1610,monk,mistweaver,81,46,35
23303,Korata,frostwolf,1610,monk,mistweaver,42,23,19
23304,Healzpapi,tichondrius,1609,monk,mistweaver,214,117,97
23305,Hîbîscus,illidan,1609,monk,mistweaver,32,17,15
23306,Lazura,tichondrius,1609,monk,mistweaver,65,33,32
23307,Planetariumz,bleeding-hollow,1608,monk,mistweaver,320,168,152
23308,Revivalol,dragonmaw,1608,monk,mistweaver,77,40,37
23309,Suntzulml,quelthalas,1608,monk,mistweaver,219,113,106
23310,Mîstchievous,sargeras,1607,monk,mistweaver,28,21,7
23311,Jadestørmz,illidan,1607,monk,mistweaver,30,20,10
23312,Azahri,sargeras,1607,monk,mistweaver,46,29,17
23313,Santiaguiño,ragnaros,1607,monk,mistweaver,71,27,44
23314,Tubby,eredar,1606,monk,mistweaver,36,22,14
23315,Ramisan,barthilas,1606,monk,mistweaver,77,44,33
23316,Mýthik,hyjal,1606,monk,mistweaver,66,37,29
23317,Gooseoba,tichondrius,1605,monk,mistweaver,24,18,6
23318,Tarkir,quelthalas,1605,monk,mistweaver,89,55,34
23319,Tamingpanda,wildhammer,1605,monk,mistweaver,60,33,27
23320,Eppsmonk,tichondrius,1604,monk,mistweaver,30,18,12
23321,Oblivion,wildhammer,1604,monk,mistweaver,61,36,25
23322,Oochi,illidan,1604,monk,mistweaver,60,31,29
23323,Cymonka,sargeras,1603,monk,mistweaver,30,17,13
23324,Goochtickles,bleeding-hollow,1602,monk,mistweaver,128,79,49
23325,Gess,stormscale,1602,monk,mistweaver,108,54,54
23326,Docpalpatine,tichondrius,1602,monk,mistweaver,36,17,19
23327,Xuenws,tichondrius,1602,monk,mistweaver,84,36,48
23328,Bussyweaver,sargeras,1601,monk,mistweaver,147,90,57
23329,Bowstâff,lightbringer,1601,monk,mistweaver,36,22,14
23330,Zeroxe,area-52,1600,monk,mistweaver,42,30,12
23331,Slothman,nagrand,1600,monk,mistweaver,144,82,62
23332,Mistysweep,sargeras,1600,monk,mistweaver,85,45,40
23333,Manchu,stormrage,1599,monk,mistweaver,30,18,12
23334,Jackphan,azralon,1598,monk,mistweaver,112,66,46
23335,Bobbybiz,bleeding-hollow,1597,monk,mistweaver,152,86,66
23336,Snoozzy,kelthuzad,1596,monk,mistweaver,42,21,21
23337,Lightskinmon,area-52,1595,monk,mistweaver,42,23,19
23338,Monkzilla,tichondrius,1593,monk,mistweaver,24,17,7
23339,Cisneros,doomhammer,1593,monk,mistweaver,291,156,135
23340,Slashsmack,caelestrasz,1593,monk,mistweaver,86,46,40
23341,Flagreturned,illidan,1593,monk,mistweaver,36,19,17
23342,Chavbrew,stormrage,1592,monk,mistweaver,85,46,39
23343,Onees,tichondrius,1590,monk,mistweaver,99,49,50
23344,Furyjames,quelthalas,1589,monk,mistweaver,103,45,58
23345,Anagark,barthilas,1588,monk,mistweaver,45,34,11
23346,Brosiedon,sargeras,1588,monk,mistweaver,148,71,77
23347,Coralys,sargeras,1587,monk,mistweaver,42,36,6
23348,Toastage,tichondrius,1587,monk,mistweaver,48,28,20
23349,Songwei,barthilas,1587,monk,mistweaver,89,50,39
23350,Rileyreidfan,azjolnerub,1586,monk,mistweaver,30,21,9
23351,Neonep,stormrage,1586,monk,mistweaver,130,72,58
23352,Rakia,moon-guard,1586,monk,mistweaver,219,110,109
23353,Kwoon,hyjal,1585,monk,mistweaver,52,30,22
23354,Luvdeluxe,skullcrusher,1585,monk,mistweaver,67,32,35
23355,Yoshinator,area-52,1585,monk,mistweaver,42,20,22
23356,Miniswag,arthas,1584,monk,mistweaver,54,22,32
23357,Musachi,barthilas,1582,monk,mistweaver,84,41,43
23358,Scrotburg,thrall,1579,monk,mistweaver,36,19,17
23359,Victuskk,tichondrius,1577,monk,mistweaver,67,45,22
23360,Pumakicks,tichondrius,1576,monk,mistweaver,70,37,33
23361,Waataafaak,malganis,1576,monk,mistweaver,93,47,46
23362,Mfmiscreant,illidan,1576,monk,mistweaver,48,20,28
23363,Peege,kelthuzad,1574,monk,mistweaver,89,59,30
23364,Lozza,jubeithos,1574,monk,mistweaver,54,32,22
23365,Tamonger,stormrage,1574,monk,mistweaver,224,119,105
23366,Wildfists,tichondrius,1574,monk,mistweaver,738,370,368
23367,Bigpøppa,tichondrius,1573,monk,mistweaver,60,33,27
23368,Chevvyy,azshara,1573,monk,mistweaver,36,18,18
23369,Beboté,quelthalas,1573,monk,mistweaver,205,97,108
23370,Snoodle,korgath,1572,monk,mistweaver,168,92,76
23371,Buffmonkdmg,tichondrius,1571,monk,mistweaver,90,48,42
23372,Vohdka,malganis,1569,monk,mistweaver,148,86,62
23373,Ckqt,stormrage,1569,monk,mistweaver,41,23,18
23374,Emporertrump,bleeding-hollow,1569,monk,mistweaver,289,150,139
23375,Boneykicks,tichondrius,1569,monk,mistweaver,42,21,21
23376,Treessome,tichondrius,1567,monk,mistweaver,29,20,9
23377,Mvqws,tichondrius,1564,monk,mistweaver,32,24,8
23378,Bebess,moon-guard,1564,monk,mistweaver,51,28,23
23379,Sshri,illidan,1564,monk,mistweaver,257,128,129
23380,Eatmykïtty,dalaran,1563,monk,mistweaver,36,23,13
23381,Frogsarecool,stormrage,1563,monk,mistweaver,40,20,20
23382,Zkingmonk,stormrage,1563,monk,mistweaver,48,20,28
23383,Rockcalm,malganis,1562,monk,mistweaver,74,38,36
23384,Hatsu,madoran,1562,monk,mistweaver,155,79,76
23385,Muzzen,fizzcrank,1562,monk,mistweaver,40,20,20
23386,Tiduskies,crushridge,1562,monk,mistweaver,54,25,29
23387,Bøkky,frostmourne,1561,monk,mistweaver,126,76,50
23388,Spaazz,tichondrius,1561,monk,mistweaver,113,68,45
23389,Fistuhcuffs,sargeras,1561,monk,mistweaver,87,49,38
23390,Gsv,sargeras,1560,monk,mistweaver,144,82,62
23391,Wide,scarlet-crusade,1560,monk,mistweaver,30,17,13
23392,Voltekkor,tichondrius,1558,monk,mistweaver,32,18,14
23393,Buoymoose,bleeding-hollow,1557,monk,mistweaver,53,35,18
23394,Bunnygal,thaurissan,1557,monk,mistweaver,143,73,70
23395,Bobthedrag,illidan,1555,monk,mistweaver,147,79,68
23396,Pappaya,tichondrius,1554,monk,mistweaver,30,20,10
23397,Aramonk,tichondrius,1554,monk,mistweaver,64,37,27
23398,Lonebamboo,tichondrius,1553,monk,mistweaver,56,28,28
23399,Jerumay,tichondrius,1552,monk,mistweaver,58,34,24
23400,Zerker,nagrand,1552,monk,mistweaver,61,29,32
23401,Nelly,grizzly-hills,1552,monk,mistweaver,36,17,19
23402,Zugroi,frostmourne,1551,monk,mistweaver,30,25,5
23403,Ekèl,tichondrius,1551,monk,mistweaver,113,60,53
23404,Dedracula,quelthalas,1550,monk,mistweaver,51,37,14
23405,Nailtech,tichondrius,1550,monk,mistweaver,66,37,29
23406,Sabersatin,sargeras,1550,monk,mistweaver,42,21,21
23407,Statue,cenarius,1549,monk,mistweaver,29,17,12
23408,Hunkymonky,thrall,1549,monk,mistweaver,81,44,37
23409,Kungfused,frostmourne,1549,monk,mistweaver,54,28,26
23410,Frenchfries,dragonmaw,1547,monk,mistweaver,72,34,38
23411,Krob,bleeding-hollow,1544,monk,mistweaver,33,17,16
23412,Kymoshenz,sargeras,1543,monk,mistweaver,24,17,7
23413,Lariv,bleeding-hollow,1543,monk,mistweaver,73,39,34
23414,Haiyà,malganis,1542,monk,mistweaver,30,17,13
23415,Monkatron,arthas,1542,monk,mistweaver,36,20,16
23416,Sushî,eonar,1541,monk,mistweaver,24,19,5
23417,Bruceki,bleeding-hollow,1540,monk,mistweaver,47,26,21
23418,Omii,darkspear,1540,monk,mistweaver,34,17,17
23419,Notfw,tichondrius,1540,monk,mistweaver,64,27,37
23420,Lørðjimmy,sargeras,1539,monk,mistweaver,42,29,13
23421,Soothinn,tichondrius,1536,monk,mistweaver,60,41,19
23422,Scrapfu,proudmoore,1536,monk,mistweaver,83,44,39
23423,Babychi,frostmourne,1535,monk,mistweaver,91,49,42
23424,Fissg,frostmourne,1535,monk,mistweaver,48,25,23
23425,Squaanched,emerald-dream,1535,monk,mistweaver,48,17,31
23426,Forgèt,kelthuzad,1534,monk,mistweaver,30,16,14
23427,Keileas,moon-guard,1534,monk,mistweaver,94,43,51
23428,Austinm,tichondrius,1532,monk,mistweaver,24,16,8
23429,Fehthermane,area-52,1531,monk,mistweaver,82,51,31
23430,Jugies,emerald-dream,1531,monk,mistweaver,66,40,26
23431,Jinjunxi,tichondrius,1531,monk,mistweaver,96,57,39
23432,Kungpaofish,tichondrius,1531,monk,mistweaver,30,16,14
23433,Ghorb,boulderfist,1530,monk,mistweaver,99,54,45
23434,Jlowbob,tichondrius,1530,monk,mistweaver,96,51,45
23435,Brucechez,tichondrius,1529,monk,mistweaver,24,16,8
23436,Chiban,misha,1529,monk,mistweaver,30,18,12
23437,Monkgyfatso,tichondrius,1528,monk,mistweaver,21,18,3
23438,Napzzxo,sargeras,1528,monk,mistweaver,30,19,11
23439,Banterx,sargeras,1528,monk,mistweaver,79,39,40
23440,Carzo,area-52,1527,monk,mistweaver,38,23,15
23441,Tirêd,sargeras,1526,monk,mistweaver,120,66,54
23442,Turbofist,bleeding-hollow,1526,monk,mistweaver,35,17,18
23443,Lépøissøn,tichondrius,1525,monk,mistweaver,30,16,14
23444,Atsugin,khazgoroth,1525,monk,mistweaver,36,16,20
23445,Ghim,frostmourne,1525,monk,mistweaver,102,45,57
23446,Fister,garithos,1524,monk,mistweaver,70,46,24
23447,Rockemsockem,gorefiend,1524,monk,mistweaver,72,41,31
23448,Peezadelo,azralon,1523,monk,mistweaver,45,25,20
23449,Mistohh,kiljaeden,1522,monk,mistweaver,24,16,8
23450,Maripaulita,ragnaros,1522,monk,mistweaver,30,17,13
23451,Marsha,tichondrius,1522,monk,mistweaver,72,31,41
23452,Jitsu,frostmane,1521,monk,mistweaver,105,64,41
23453,Gngrbeardman,tichondrius,1519,monk,mistweaver,39,21,18
23454,Kiqz,stormrage,1519,monk,mistweaver,30,16,14
23455,Yurm,moon-guard,1518,monk,mistweaver,54,38,16
23456,Brewswayne,argent-dawn,1518,monk,mistweaver,36,23,13
23457,Aledal,agamaggan,1517,monk,mistweaver,66,41,25
23458,Dharma,khaz-modan,1517,monk,mistweaver,102,56,46
23459,Ophibrew,zuljin,1516,monk,mistweaver,30,16,14
23460,Romdansik,tichondrius,1515,monk,mistweaver,136,73,63
23461,Mis,tichondrius,1514,monk,mistweaver,30,16,14
23462,Voodubrew,area-52,1514,monk,mistweaver,48,24,24
23463,Xenitate,bleeding-hollow,1513,monk,mistweaver,36,19,17
23464,Chelada,sargeras,1513,monk,mistweaver,48,22,26
23465,Sorowblade,lothar,1512,monk,mistweaver,56,35,21
23466,Pcyesh,nemesis,1512,monk,mistweaver,92,50,42
23467,Themonkfunk,bleeding-hollow,1511,monk,mistweaver,36,25,11
23468,Wohrfnok,illidan,1511,monk,mistweaver,36,24,12
23469,Justsidiousm,sargeras,1510,monk,mistweaver,36,26,10
23470,Brewmanchew,frostmourne,1509,monk,mistweaver,135,75,60
23471,Aristea,emerald-dream,1509,monk,mistweaver,30,16,14
23472,Zettelkasten,tichondrius,1508,monk,mistweaver,42,18,24
23473,Oakleet,bleeding-hollow,1507,monk,mistweaver,48,27,21
23474,Chìforce,sargeras,1507,monk,mistweaver,53,23,30
23475,Nelda,gorgonnash,1505,monk,mistweaver,108,64,44
23476,Greenpigo,tichondrius,1504,monk,mistweaver,18,17,1
23477,Närza,kelthuzad,1504,monk,mistweaver,54,30,24
23478,Dextr,arthas,1503,monk,mistweaver,87,50,37
23479,Hazelbazel,bleeding-hollow,1502,monk,mistweaver,42,27,15
23480,Glad,stormscale,1502,monk,mistweaver,306,163,143
23481,Santhz,ragnaros,1501,monk,mistweaver,24,16,8
23482,Axellrod,tichondrius,1500,monk,mistweaver,60,38,22
23483,Märthä,azralon,1500,monk,mistweaver,161,85,76
23484,Grimaku,tichondrius,1500,monk,mistweaver,51,23,28
23485,Dareelyst,arygos,1500,monk,mistweaver,42,17,25
23486,Xomonik,borean-tundra,1499,monk,mistweaver,66,39,27
23487,Ferrarí,quelthalas,1499,monk,mistweaver,281,153,128
23488,Lekrosa,thrall,1499,monk,mistweaver,71,38,33
23489,Beejae,tichondrius,1499,monk,mistweaver,31,16,15
23490,Äncient,quelthalas,1497,monk,mistweaver,142,82,60
23491,Tinypunch,emerald-dream,1496,monk,mistweaver,72,34,38
23492,Missweaver,sargeras,1495,monk,mistweaver,78,39,39
23493,Hiiyaa,tichondrius,1493,monk,mistweaver,128,63,65
23494,Fidgetspinna,zuljin,1493,monk,mistweaver,44,21,23
23495,Mcdubbles,korgath,1493,monk,mistweaver,48,20,28
23496,Hoggs,sargeras,1492,monk,mistweaver,181,105,76
23497,Showshoway,tichondrius,1492,monk,mistweaver,229,110,119
23498,Seung,duskwood,1492,monk,mistweaver,255,121,134
23499,Leemîn,tichondrius,1491,monk,mistweaver,42,30,12
23500,Juchiyosamu,illidan,1491,monk,mistweaver,27,16,11
23501,Caellum,quelthalas,1490,monk,mistweaver,41,27,14
23502,Abdoolah,illidan,1488,monk,mistweaver,140,73,67
23503,Fistnanweavn,dawnbringer,1488,monk,mistweaver,132,62,70
23504,Jèricho,thrall,1487,monk,mistweaver,84,49,35
23505,Conormonk,tichondrius,1486,monk,mistweaver,24,18,6
23506,Vardeh,stormscale,1486,monk,mistweaver,96,59,37
23507,Warzsong,azralon,1486,monk,mistweaver,54,33,21
23508,Saeloon,frostmourne,1486,monk,mistweaver,77,36,41
23509,Buddhabud,sargeras,1485,monk,mistweaver,54,28,26
23510,Grandpå,tichondrius,1484,monk,mistweaver,42,23,19
23511,Ebrew,frostmourne,1483,monk,mistweaver,60,37,23
23512,Swiftyboi,tichondrius,1483,monk,mistweaver,132,64,68
23513,Barnåcle,darkspear,1482,monk,mistweaver,60,37,23
23514,Pagtuk,daggerspine,1482,monk,mistweaver,60,28,32
23515,Phatcheeks,aegwynn,1480,monk,mistweaver,111,64,47
23516,Âfrika,ysondre,1480,monk,mistweaver,65,31,34
23517,Rômmul,azralon,1478,monk,mistweaver,48,32,16
23518,Clipping,tichondrius,1478,monk,mistweaver,48,29,19
23519,Monkybidness,tichondrius,1478,monk,mistweaver,51,24,27
23520,Taigared,ragnaros,1478,monk,mistweaver,45,17,28
23521,Talented,azuremyst,1477,monk,mistweaver,63,41,22
23522,Bastilaqt,korgath,1477,monk,mistweaver,157,83,74
23523,Ungankable,sargeras,1477,monk,mistweaver,303,156,147
23524,Drfoochi,tichondrius,1477,monk,mistweaver,60,29,31
23525,Srshy,drakkari,1477,monk,mistweaver,60,27,33
23526,Monkpowaz,stormrage,1476,monk,mistweaver,42,26,16
23527,Reque,illidan,1475,monk,mistweaver,234,132,102
23528,Popchi,stormrage,1475,monk,mistweaver,48,18,30
23529,Bruceteå,area-52,1473,monk,mistweaver,29,19,10
23530,Mòñk,shattered-halls,1473,monk,mistweaver,42,26,16
23531,Hymasterlol,tichondrius,1473,monk,mistweaver,60,28,32
23532,Göat,emerald-dream,1472,monk,mistweaver,57,29,28
23533,Wheygodx,lothar,1471,monk,mistweaver,42,28,14
23534,Willowa,frostmourne,1470,monk,mistweaver,50,30,20
23535,Fisthealz,area-52,1469,monk,mistweaver,30,22,8
23536,Tuss,tichondrius,1468,monk,mistweaver,76,31,45
23537,Dovhug,draenor,1465,monk,mistweaver,66,30,36
23538,Gotmonk,aggramar,1464,monk,mistweaver,30,19,11
23539,Ÿipman,frostmourne,1464,monk,mistweaver,48,22,26
23540,Dangerkage,stormrage,1463,monk,mistweaver,42,17,25
23541,Fattyboy,area-52,1462,monk,mistweaver,73,48,25
23542,Brewball,illidan,1462,monk,mistweaver,41,24,17
23543,Mustaf,stormrage,1462,monk,mistweaver,132,67,65
23544,Iamamonk,kelthuzad,1461,monk,mistweaver,44,29,15
23545,Lenee,frostmourne,1461,monk,mistweaver,39,25,14
23546,Docwang,malganis,1460,monk,mistweaver,60,39,21
23547,Topnotch,malganis,1460,monk,mistweaver,66,38,28
23548,Odindad,tichondrius,1460,monk,mistweaver,108,57,51
23549,Quinoo,emerald-dream,1460,monk,mistweaver,51,25,26
23550,Himah,area-52,1460,monk,mistweaver,36,16,20
23551,Gnomepuncher,dalaran,1459,monk,mistweaver,48,25,23
23552,Iluvthugnmcz,sargeras,1459,monk,mistweaver,112,58,54
23553,Fistea,frostmourne,1459,monk,mistweaver,51,24,27
23554,Kazov,proudmoore,1458,monk,mistweaver,178,92,86
23555,Hitaru,azralon,1457,monk,mistweaver,64,39,25
23556,Çät,frostmourne,1457,monk,mistweaver,38,22,16
23557,Guïnness,tichondrius,1455,monk,mistweaver,30,18,12
23558,Americå,zuljin,1453,monk,mistweaver,60,39,21
23559,Saulgóòdman,tichondrius,1453,monk,mistweaver,42,18,24
23560,Fairyeflora,wyrmrest-accord,1452,monk,mistweaver,48,31,17
23561,Rôbo,emerald-dream,1452,monk,mistweaver,29,16,13
23562,Themys,zuljin,1451,monk,mistweaver,42,26,16
23563,Rosellina,kelthuzad,1451,monk,mistweaver,38,23,15
23564,Janeil,wyrmrest-accord,1451,monk,mistweaver,300,153,147
23565,Baee,cairne,1451,monk,mistweaver,43,17,26
23566,Pomonk,nazjatar,1450,monk,mistweaver,69,45,24
23567,Jeolmyung,tichondrius,1450,monk,mistweaver,33,17,16
23568,Mcfisted,area-52,1450,monk,mistweaver,81,41,40
23569,Caliroll,gorefiend,1450,monk,mistweaver,70,31,39
23570,Xtrememisty,frostmourne,1449,monk,mistweaver,66,35,31
23571,Bresmeatfore,barthilas,1446,monk,mistweaver,54,33,21
23572,Lidela,sargeras,1445,monk,mistweaver,52,27,25
23573,Diagrams,tichondrius,1444,monk,mistweaver,23,16,7
23574,Prf,ragnaros,1443,monk,mistweaver,69,39,30
23575,Darkjab,tichondrius,1442,monk,mistweaver,48,22,26
23576,Shenzuu,daggerspine,1441,monk,mistweaver,24,18,6
23577,Meshugah,quelthalas,1441,monk,mistweaver,124,59,65
23578,Kirshta,kelthuzad,1439,monk,mistweaver,38,28,10
23579,Elcidx,tichondrius,1438,monk,mistweaver,24,15,9
23580,Proctology,tichondrius,1438,monk,mistweaver,40,24,16
23581,Zonianman,tichondrius,1438,monk,mistweaver,113,63,50
23582,Nukeproof,stormreaver,1438,monk,mistweaver,31,16,15
23583,Kariwanji,tichondrius,1438,monk,mistweaver,305,155,150
23584,Bigs,duskwood,1438,monk,mistweaver,35,15,20
23585,Taekwondope,antonidas,1437,monk,mistweaver,25,16,9
23586,Cooltran,tichondrius,1437,monk,mistweaver,36,22,14
23587,Kaelastra,stormrage,1437,monk,mistweaver,114,62,52
23588,Nijl,sargeras,1436,monk,mistweaver,18,15,3
23589,Grandsonweez,thrall,1436,monk,mistweaver,65,27,38
23590,Xaurian,firetree,1435,monk,mistweaver,103,59,44
23591,Outhume,eredar,1435,monk,mistweaver,30,15,15
23592,Dhomonk,rexxar,1434,monk,mistweaver,29,17,12
23593,Benex,tichondrius,1434,monk,mistweaver,35,19,16
23594,Alinejat,auchindoun,1433,monk,mistweaver,24,15,9
23595,Monktor,dalaran,1433,monk,mistweaver,78,41,37
23596,Fartknocker,magtheridon,1433,monk,mistweaver,30,15,15
23597,Safiel,proudmoore,1433,monk,mistweaver,118,51,67
23598,Softer,frostmane,1432,monk,mistweaver,24,15,9
23599,Jackâl,malganis,1432,monk,mistweaver,31,19,12
23600,Mungka,tichondrius,1432,monk,mistweaver,94,47,47
23601,Gotosleepkid,dalaran,1432,monk,mistweaver,50,25,25
23602,Dåßz,illidan,1432,monk,mistweaver,49,22,27
23603,Anxin,tichondrius,1431,monk,mistweaver,30,15,15
23604,Kemmy,ravencrest,1429,monk,mistweaver,37,21,16
23605,Fuqame,kiljaeden,1428,monk,mistweaver,42,19,23
23606,Poundmedaddi,tichondrius,1427,monk,mistweaver,139,84,55
23607,Titanus,chogall,1427,monk,mistweaver,48,26,22
23608,Vorikson,stormrage,1426,monk,mistweaver,228,108,120
23609,Jooshy,tichondrius,1426,monk,mistweaver,83,39,44
23610,Fistlord,zuljin,1425,monk,mistweaver,32,18,14
23611,Gomey,bleeding-hollow,1425,monk,mistweaver,32,18,14
23612,Bbyyoda,illidan,1425,monk,mistweaver,132,70,62
23613,Tenshu,runetotem,1425,monk,mistweaver,93,48,45
23614,Mastamonksta,illidan,1425,monk,mistweaver,34,16,18
23615,Pøkemonk,malganis,1424,monk,mistweaver,24,15,9
23616,Chuks,nerzhul,1424,monk,mistweaver,212,117,95
23617,Goocn,tichondrius,1424,monk,mistweaver,66,35,31
23618,Bergoth,bleeding-hollow,1422,monk,mistweaver,24,15,9
23619,Friskyfister,tichondrius,1422,monk,mistweaver,30,15,15
23620,Brüce,ragnaros,1421,monk,mistweaver,57,33,24
23621,Jasonmonk,sargeras,1420,monk,mistweaver,31,19,12
23622,Sob,frostmourne,1420,monk,mistweaver,113,66,47
23623,Taijutzu,darkspear,1419,monk,mistweaver,24,15,9
23624,Mingchen,tichondrius,1419,monk,mistweaver,36,21,15
23625,Telospateo,ragnaros,1418,monk,mistweaver,90,48,42
23626,Mightbweavin,bleeding-hollow,1418,monk,mistweaver,126,58,68
23627,Dumbmonk,frostmourne,1416,monk,mistweaver,18,15,3
23628,Comonk,area-52,1416,monk,mistweaver,24,15,9
23629,Punch,lothar,1414,monk,mistweaver,37,21,16
23630,Bakus,tichondrius,1414,monk,mistweaver,35,19,16
23631,Hadryan,proudmoore,1414,monk,mistweaver,190,96,94
23632,Puoll,gallywix,1413,monk,mistweaver,128,68,60
23633,Markofzugzug,tichondrius,1413,monk,mistweaver,36,15,21
23634,Sihgriid,tichondrius,1412,monk,mistweaver,50,27,23
23635,Alianli,tichondrius,1412,monk,mistweaver,65,16,49
23636,Monkeybooze,sargeras,1411,monk,mistweaver,44,26,18
23637,Thors,gorgonnash,1411,monk,mistweaver,78,44,34
23638,Güwop,tichondrius,1411,monk,mistweaver,81,43,38
23639,Ralphiex,tichondrius,1411,monk,mistweaver,101,53,48
23640,Xenzas,chogall,1410,monk,mistweaver,29,17,12
23641,Shoumi,turalyon,1410,monk,mistweaver,30,17,13
23642,Noodalie,moon-guard,1408,monk,mistweaver,30,22,8
23643,Nyght,moon-guard,1408,monk,mistweaver,96,41,55
23644,Hungfuu,tichondrius,1407,monk,mistweaver,18,15,3
23645,Knucklebadge,tichondrius,1407,monk,mistweaver,47,30,17
23646,Sobuu,wyrmrest-accord,1406,monk,mistweaver,30,24,6
23647,Zeelos,kelthuzad,1406,monk,mistweaver,24,15,9
23648,Vegoku,moon-guard,1406,monk,mistweaver,137,72,65
23649,Jmonks,stormrage,1406,monk,mistweaver,66,27,39
23650,Sisfist,blackhand,1405,monk,mistweaver,30,16,14
23651,Mistcrab,tichondrius,1403,monk,mistweaver,71,44,27
23652,Thirteendads,turalyon,1403,monk,mistweaver,35,17,18
23653,Sonicenergy,tichondrius,1402,monk,mistweaver,57,27,30
23654,Xiang,dreadmaul,1401,monk,mistweaver,48,29,19
23655,Zarma,stormrage,1401,monk,mistweaver,88,48,40
23656,Lunarc,mannoroth,1401,monk,mistweaver,93,50,43
23657,Bbunglee,tichondrius,1400,monk,mistweaver,41,27,14
23658,Ric,gundrak,1400,monk,mistweaver,81,48,33
23659,Waxxi,barthilas,1400,monk,mistweaver,135,78,57
23660,Clyteai,arthas,1398,monk,mistweaver,24,16,8
23661,Carlosm,tichondrius,1398,monk,mistweaver,30,19,11
23662,Shyntä,dalaran,1396,monk,mistweaver,42,25,17
23663,ßrewslèè,tichondrius,1396,monk,mistweaver,157,84,73
23664,Pimpolhona,nemesis,1396,monk,mistweaver,126,61,65
23665,Edbtz,illidan,1394,monk,mistweaver,24,18,6
23666,Xyamïxo,tichondrius,1394,monk,mistweaver,60,35,25
23667,Htm,barthilas,1392,monk,mistweaver,41,16,25
23668,Mcfluffey,area-52,1391,monk,mistweaver,89,49,40
23669,Metapôd,tichondrius,1389,monk,mistweaver,63,32,31
23670,Damemasduro,ragnaros,1389,monk,mistweaver,554,270,284
23671,Dblfistez,stormreaver,1389,monk,mistweaver,52,23,29
23672,Twirl,mugthol,1389,monk,mistweaver,42,18,24
23673,Hyugga,azralon,1388,monk,mistweaver,71,42,29
23674,Taipanni,sargeras,1388,monk,mistweaver,40,16,24
23675,Kymist,stormrage,1386,monk,mistweaver,134,71,63
23676,Verelaana,moon-guard,1386,monk,mistweaver,41,21,20
23677,Vum,quelthalas,1385,monk,mistweaver,21,16,5
23678,Bârcõdë,tichondrius,1384,monk,mistweaver,36,23,13
23679,Redweave,moon-guard,1383,monk,mistweaver,36,17,19
23680,Flixz,stormrage,1382,monk,mistweaver,48,25,23
23681,Riokhan,ragnaros,1381,monk,mistweaver,54,31,23
23682,Ojiin,wyrmrest-accord,1381,monk,mistweaver,227,119,108
23683,Valiantroar,shandris,1381,monk,mistweaver,38,16,22
23684,Hummerkungfu,azralon,1380,monk,mistweaver,79,40,39
23685,Phoenixspark,gnomeregan,1379,monk,mistweaver,44,30,14
23686,Tanskee,sargeras,1378,monk,mistweaver,65,38,27
23687,Akván,ragnaros,1378,monk,mistweaver,85,43,42
23688,Shandaspanda,rivendare,1378,monk,mistweaver,54,26,28
23689,Sangthos,darkspear,1378,monk,mistweaver,204,90,114
23690,Monkol,nemesis,1377,monk,mistweaver,30,18,12
23691,Sodosopaw,area-52,1376,monk,mistweaver,82,41,41
23692,Pablojám,ragnaros,1375,monk,mistweaver,42,23,19
23693,Mystafista,tichondrius,1375,monk,mistweaver,29,15,14
23694,Xxgonchi,quelthalas,1374,monk,mistweaver,140,77,63
23695,Afabled,drakkari,1373,monk,mistweaver,48,26,22
23696,Ozen,burning-blade,1373,monk,mistweaver,74,38,36
23697,Baroon,chogall,1373,monk,mistweaver,93,40,53
23698,Metalmønk,nerzhul,1372,monk,mistweaver,43,29,14
23699,Hybrid,draenor,1371,monk,mistweaver,36,21,15
23700,Sinistuhm,tichondrius,1371,monk,mistweaver,47,25,22
23701,Rhynoo,lothar,1371,monk,mistweaver,96,51,45
23702,Kylièjenner,gilneas,1370,monk,mistweaver,70,39,31
23703,Presas,nemesis,1370,monk,mistweaver,54,25,29
23704,Thyfist,frostmourne,1369,monk,mistweaver,28,16,12
23705,Beätfeet,tichondrius,1368,monk,mistweaver,30,19,11
23706,Fonnf,nemesis,1368,monk,mistweaver,26,15,11
23707,Vonn,drakkari,1368,monk,mistweaver,83,42,41
23708,Fistful,destromath,1367,monk,mistweaver,18,15,3
23709,Mintÿ,wyrmrest-accord,1366,monk,mistweaver,48,24,24
23710,Trüa,stormrage,1364,monk,mistweaver,30,20,10
23711,Soothem,tichondrius,1364,monk,mistweaver,103,64,39
23712,Lanifer,area-52,1364,monk,mistweaver,35,20,15
23713,Tianji,malganis,1363,monk,mistweaver,42,26,16
23714,Tert,aerie-peak,1363,monk,mistweaver,146,83,63
23715,Bibibi,moon-guard,1362,monk,mistweaver,30,15,15
23716,Pepperoncini,korgath,1361,monk,mistweaver,93,43,50
23717,Snuzzao,darkspear,1359,monk,mistweaver,44,22,22
23718,Trixië,vashj,1358,monk,mistweaver,29,15,14
23719,Tobyblack,illidan,1357,monk,mistweaver,123,60,63
23720,Aokuâng,malganis,1356,monk,mistweaver,91,56,35
23721,Ataxic,illidan,1355,monk,mistweaver,29,15,14
23722,Ninjagordu,nemesis,1353,monk,mistweaver,118,57,61
23723,Pandemikmonk,turalyon,1349,monk,mistweaver,48,22,26
23724,Cdeez,malganis,1347,monk,mistweaver,36,23,13
23725,Nornangus,sargeras,1346,monk,mistweaver,53,25,28
23726,Monkqi,lightbringer,1344,monk,mistweaver,30,23,7
23727,Hensing,malganis,1344,monk,mistweaver,24,14,10
23728,Itsnoozes,illidan,1343,monk,mistweaver,18,14,4
23729,Hydrig,ragnaros,1343,monk,mistweaver,18,14,4
23730,Onegai,tichondrius,1343,monk,mistweaver,18,14,4
23731,Rylens,draka,1343,monk,mistweaver,40,25,15
23732,Siserfister,sargeras,1343,monk,mistweaver,24,14,10
23733,Khylu,kelthuzad,1342,monk,mistweaver,18,14,4
23734,Zor,stormscale,1342,monk,mistweaver,18,14,4
23735,Cnww,tichondrius,1342,monk,mistweaver,24,14,10
23736,Jonnymon,sargeras,1341,monk,mistweaver,18,14,4
23737,Vulbeast,dalaran,1341,monk,mistweaver,18,14,4
23738,Lustymonk,kelthuzad,1341,monk,mistweaver,18,14,4
23739,Cilantrõ,malorne,1341,monk,mistweaver,30,21,9
23740,Lõgan,azralon,1341,monk,mistweaver,58,29,29
23741,Evyllyn,bleeding-hollow,1340,monk,mistweaver,18,14,4
23742,Anthuri,frostmourne,1339,monk,mistweaver,95,62,33
23743,Allegedheals,tichondrius,1339,monk,mistweaver,60,26,34
23744,Pisswalker,area-52,1338,monk,mistweaver,18,14,4
23745,Catmonk,the-forgotten-coast,1338,monk,mistweaver,24,14,10
23746,Kungfuchious,dalaran,1338,monk,mistweaver,31,18,13
23747,Sengesen,sargeras,1338,monk,mistweaver,28,15,13
23748,Inkar,tichondrius,1338,monk,mistweaver,30,14,16
23749,Ðamntaiyo,sargeras,1336,monk,mistweaver,35,19,16
23750,Atruefister,tichondrius,1336,monk,mistweaver,79,42,37
23751,Ryantiger,tichondrius,1336,monk,mistweaver,30,14,16
23752,Karynia,illidan,1335,monk,mistweaver,110,56,54
23753,Iielia,wyrmrest-accord,1335,monk,mistweaver,35,16,19
23754,Streetjezus,bloodhoof,1335,monk,mistweaver,64,28,36
23755,Limi,malganis,1334,monk,mistweaver,24,17,7
23756,Chañi,ragnaros,1333,monk,mistweaver,59,33,26
23757,Åvå,emerald-dream,1333,monk,mistweaver,73,29,44
23758,Tamagotchi,emerald-dream,1332,monk,mistweaver,30,16,14
23759,Naxanax,area-52,1332,monk,mistweaver,66,33,33
23760,Jellobag,frostmane,1331,monk,mistweaver,24,14,10
23761,Inebriated,auchindoun,1329,monk,mistweaver,24,14,10
23762,Hotpotatoee,aerie-peak,1325,monk,mistweaver,129,66,63
23763,Neww,tichondrius,1325,monk,mistweaver,58,25,33
23764,Pandalee,skullcrusher,1324,monk,mistweaver,54,33,21
23765,Tenzing,azgalor,1324,monk,mistweaver,24,14,10
23766,Zenmasta,exodar,1324,monk,mistweaver,36,19,17
23767,Awwchi,tichondrius,1324,monk,mistweaver,54,26,28
23768,Moltenbeard,trollbane,1323,monk,mistweaver,54,35,19
23769,Momochi,malygos,1323,monk,mistweaver,30,16,14
23770,Turkspin,smolderthorn,1322,monk,mistweaver,33,24,9
23771,Nerfmonk,spirestone,1322,monk,mistweaver,24,14,10
23772,Pydelo,tichondrius,1322,monk,mistweaver,24,14,10
23773,Precóggodx,tichondrius,1322,monk,mistweaver,24,14,10
23774,Jeffdagnome,moon-guard,1320,monk,mistweaver,96,48,48
23775,Zeevaliara,caelestrasz,1320,monk,mistweaver,30,15,15
23776,Brewamp,zuljin,1320,monk,mistweaver,35,17,18
23777,Psykhed,emerald-dream,1319,monk,mistweaver,78,33,45
23778,Gerranni,wyrmrest-accord,1318,monk,mistweaver,24,16,8
23779,Nazvik,quelthalas,1318,monk,mistweaver,24,14,10
23780,Shon,frostmourne,1316,monk,mistweaver,24,14,10
23781,Albusventos,azralon,1315,monk,mistweaver,35,21,14
23782,Smackdat,azjolnerub,1315,monk,mistweaver,58,29,29
23783,Kungfumika,ragnaros,1314,monk,mistweaver,48,23,25
23784,Johnkreese,andorhal,1313,monk,mistweaver,30,14,16
23785,Breezymist,doomhammer,1311,monk,mistweaver,30,14,16
23786,Nuubchi,stormrage,1310,monk,mistweaver,24,14,10
23787,Dashenna,illidan,1310,monk,mistweaver,84,32,52
23788,Rollypunch,illidan,1309,monk,mistweaver,48,28,20
23789,Orgrrim,area-52,1309,monk,mistweaver,24,14,10
23790,Trapeez,kelthuzad,1308,monk,mistweaver,24,16,8
23791,Asliam,undermine,1308,monk,mistweaver,36,23,13
23792,Lotusdream,argent-dawn,1308,monk,mistweaver,90,46,44
23793,Odogin,tichondrius,1307,monk,mistweaver,65,41,24
23794,Valapan,tichondrius,1306,monk,mistweaver,72,39,33
23795,Sweatweaver,frostmourne,1306,monk,mistweaver,94,43,51
23796,Mango,spirestone,1305,monk,mistweaver,42,24,18
23797,Hafu,wildhammer,1305,monk,mistweaver,54,29,25
23798,Shizunô,stormrage,1305,monk,mistweaver,36,17,19
23799,Fânnybâws,stormrage,1302,monk,mistweaver,36,18,18
23800,Hirahxx,frostmourne,1301,monk,mistweaver,27,16,11
23801,Melrose,kiljaeden,1301,monk,mistweaver,24,14,10
23802,Bluemyselph,tichondrius,1300,monk,mistweaver,40,21,19
23803,Endér,tichondrius,1300,monk,mistweaver,160,82,78
23804,Kickbone,tichondrius,1300,monk,mistweaver,60,30,30
23805,Raidenmnx,tichondrius,1300,monk,mistweaver,96,47,49
23806,Chitacos,trollbane,1300,monk,mistweaver,30,14,16
23807,Twinktoez,bleeding-hollow,1299,monk,mistweaver,26,15,11
23808,Szuka,tichondrius,1297,monk,mistweaver,36,20,16
23809,Kung,tichondrius,1297,monk,mistweaver,30,14,16
23810,Monktyson,barthilas,1296,monk,mistweaver,66,43,23
23811,Lawroadp,tichondrius,1295,monk,mistweaver,57,33,24
23812,Rapope,quelthalas,1294,monk,mistweaver,65,32,33
23813,Gguldduk,tichondrius,1292,monk,mistweaver,40,26,14
23814,Ymiron,smolderthorn,1292,monk,mistweaver,42,15,27
23815,Monkisses,bonechewer,1290,monk,mistweaver,65,36,29
23816,Speedymonk,malfurion,1289,monk,mistweaver,60,25,35
23817,Zarakna,sargeras,1288,monk,mistweaver,210,112,98
23818,Giatzo,barthilas,1288,monk,mistweaver,73,35,38
23819,Perzevel,azshara,1286,monk,mistweaver,30,19,11
23820,Gallorex,frostmourne,1286,monk,mistweaver,42,24,18
23821,Onekickman,dalaran,1283,monk,mistweaver,72,41,31
23822,Healyboi,bronzebeard,1283,monk,mistweaver,52,22,30
23823,Boozebear,spirestone,1282,monk,mistweaver,136,68,68
23824,Kìmjungheal,tichondrius,1281,monk,mistweaver,41,21,20
23825,Stendari,moon-guard,1281,monk,mistweaver,30,14,16
23826,Tankozorr,zuljin,1281,monk,mistweaver,60,27,33
23827,Chnzhs,tichondrius,1281,monk,mistweaver,58,18,40
23828,Zeiana,proudmoore,1280,monk,mistweaver,38,22,16
23829,Miçrosoft,area-52,1279,monk,mistweaver,78,46,32
23830,Holdmychi,stormrage,1279,monk,mistweaver,55,29,26
23831,Iloki,shuhalo,1279,monk,mistweaver,81,40,41
23832,Siddlez,frostmourne,1278,monk,mistweaver,53,36,17
23833,Byakugan,moon-guard,1277,monk,mistweaver,41,23,18
23834,Börg,bleeding-hollow,1277,monk,mistweaver,38,19,19
23835,Fludz,burning-blade,1276,monk,mistweaver,66,28,38
23836,Kiso,sargeras,1274,monk,mistweaver,29,14,15
23837,Tigraxus,proudmoore,1274,monk,mistweaver,43,19,24
23838,Evilstep,tichondrius,1272,monk,mistweaver,131,68,63
23839,Selfhealings,korgath,1272,monk,mistweaver,71,31,40
23840,Zxychi,hyjal,1271,monk,mistweaver,23,14,9
23841,Galiplays,zangarmarsh,1271,monk,mistweaver,35,19,16
23842,Rustedbarrel,azjolnerub,1271,monk,mistweaver,46,23,23
23843,Ratioed,moon-guard,1270,monk,mistweaver,65,45,20
23844,Mortimir,echo-isles,1269,monk,mistweaver,42,21,21
23845,Cthulumonk,lightnings-blade,1269,monk,mistweaver,36,14,22
23846,Onlyhands,whisperwind,1268,monk,mistweaver,47,24,23
23847,Makimä,stormrage,1267,monk,mistweaver,80,41,39
23848,Miretunie,arathor,1266,monk,mistweaver,98,57,41
23849,Monkeynut,whisperwind,1265,monk,mistweaver,125,65,60
23850,Dragonwarior,zuluhed,1261,monk,mistweaver,26,15,11
23851,Zenquadz,elune,1259,monk,mistweaver,36,25,11
23852,Wmo,tichondrius,1258,monk,mistweaver,23,15,8
23853,Marimonkori,stormscale,1258,monk,mistweaver,63,32,31
23854,Monkêy,ghostlands,1258,monk,mistweaver,66,30,36
23855,Keyszz,tichondrius,1258,monk,mistweaver,218,97,121
23856,Teil,illidan,1257,monk,mistweaver,48,25,23
23857,Pépto,bleeding-hollow,1257,monk,mistweaver,70,35,35
23858,Zuchi,frostmourne,1255,monk,mistweaver,24,14,10
23859,Ninjatoots,aerie-peak,1255,monk,mistweaver,79,42,37
23860,Hongmeï,illidan,1254,monk,mistweaver,48,25,23
23861,Liamaz,amanthul,1254,monk,mistweaver,30,14,16
23862,Hungrydevil,tichondrius,1253,monk,mistweaver,30,15,15
23863,Sayd,misha,1251,monk,mistweaver,24,15,9
23864,Darkheälzz,sargeras,1251,monk,mistweaver,122,60,62
23865,Omimonk,sargeras,1251,monk,mistweaver,56,24,32
23866,Donnieyen,aerie-peak,1250,monk,mistweaver,19,14,5
23867,Maiitoguy,illidan,1250,monk,mistweaver,48,24,24
23868,Lelomonk,ragnaros,1249,monk,mistweaver,84,43,41
23869,Afw,moon-guard,1248,monk,mistweaver,38,21,17
23870,Shefcurry,boulderfist,1248,monk,mistweaver,24,13,11
23871,Mwomegalul,sargeras,1248,monk,mistweaver,30,13,17
23872,Ticmonk,frostmourne,1247,monk,mistweaver,18,13,5
23873,Feel,frostmourne,1247,monk,mistweaver,18,13,5
23874,Annisokay,bleeding-hollow,1247,monk,mistweaver,18,13,5
23875,Beefyteet,tichondrius,1247,monk,mistweaver,18,13,5
23876,Gothamonk,tichondrius,1247,monk,mistweaver,24,13,11
23877,Demisodax,tichondrius,1247,monk,mistweaver,24,13,11
23878,Mlngo,illidan,1247,monk,mistweaver,24,13,11
23879,Steadfastsr,black-dragonflight,1246,monk,mistweaver,18,13,5
23880,Mirokushan,skywall,1246,monk,mistweaver,117,65,52
23881,Shinarri,thrall,1246,monk,mistweaver,141,77,64
23882,Gottí,sargeras,1246,monk,mistweaver,24,13,11
23883,Danceofchiji,tichondrius,1246,monk,mistweaver,24,13,11
23884,Fheng,emerald-dream,1246,monk,mistweaver,24,13,11
23885,Bullët,tichondrius,1246,monk,mistweaver,84,43,41
23886,Cowsgonuts,gorefiend,1246,monk,mistweaver,30,13,17
23887,Hîddëncløùdx,tichondrius,1245,monk,mistweaver,18,13,5
23888,Nawzhy,emerald-dream,1245,monk,mistweaver,24,13,11
23889,Drunkgiraffe,zuljin,1244,monk,mistweaver,18,13,5
23890,Ironfistorm,stormrage,1244,monk,mistweaver,36,24,12
23891,Shilakamesn,tichondrius,1244,monk,mistweaver,24,13,11
23892,React,frostwolf,1242,monk,mistweaver,18,13,5
23893,Psypalm,zuljin,1242,monk,mistweaver,18,13,5
23894,Ammonk,bloodhoof,1242,monk,mistweaver,18,13,5
23895,Kreacher,ravencrest,1242,monk,mistweaver,71,37,34
23896,Rehder,barthilas,1241,monk,mistweaver,24,13,11
23897,Puya,nemesis,1241,monk,mistweaver,36,18,18
23898,Poppyharlow,saurfang,1240,monk,mistweaver,24,17,7
23899,Darrhon,illidan,1240,monk,mistweaver,125,65,60
23900,Meldrop,tichondrius,1240,monk,mistweaver,30,13,17
23901,Miyung,quelthalas,1240,monk,mistweaver,30,13,17
23902,Elmozosz,thrall,1239,monk,mistweaver,24,13,11
23903,Noogiie,barthilas,1238,monk,mistweaver,22,14,8
23904,Originalmonk,tichondrius,1237,monk,mistweaver,18,13,5
23905,Madkickzack,blades-edge,1237,monk,mistweaver,30,13,17
23906,Oyyo,tichondrius,1237,monk,mistweaver,95,35,60
23907,Safigirl,doomhammer,1236,monk,mistweaver,67,39,28
23908,Monkash,sargeras,1234,monk,mistweaver,24,13,11
23909,Lolkungfu,spirestone,1234,monk,mistweaver,24,13,11
23910,Madnox,sargeras,1234,monk,mistweaver,36,19,17
23911,Kodrik,tichondrius,1234,monk,mistweaver,84,44,40
23912,Vchii,tichondrius,1234,monk,mistweaver,30,13,17
23913,Midfrie,ghostlands,1233,monk,mistweaver,24,15,9
23914,Knaveus,frostmourne,1233,monk,mistweaver,54,30,24
23915,Critôris,tichondrius,1233,monk,mistweaver,24,13,11
23916,Lothnälar,ragnaros,1231,monk,mistweaver,36,26,10
23917,Azizyzz,barthilas,1231,monk,mistweaver,42,20,22
23918,Kaølin,azralon,1228,monk,mistweaver,18,13,5
23919,Fkedyourwife,dalaran,1227,monk,mistweaver,30,13,17
23920,Gôrr,tichondrius,1226,monk,mistweaver,42,23,19
23921,Zefta,moon-guard,1226,monk,mistweaver,42,18,24
23922,Dirtyshef,deathwing,1225,monk,mistweaver,75,32,43
23923,Petsëmatary,bleeding-hollow,1224,monk,mistweaver,41,16,25
23924,Cheesemónk,tichondrius,1222,monk,mistweaver,30,13,17
23925,Habuba,eredar,1221,monk,mistweaver,18,13,5
23926,Binghe,illidan,1221,monk,mistweaver,63,35,28
23927,Monxellius,moon-guard,1221,monk,mistweaver,105,51,54
23928,Ninjahogan,azgalor,1221,monk,mistweaver,32,15,17
23929,Xstepfister,tichondrius,1220,monk,mistweaver,52,25,27
23930,Zignzag,stormscale,1220,monk,mistweaver,36,13,23
23931,Cammy,aerie-peak,1219,monk,mistweaver,32,20,12
23932,Pixelface,barthilas,1218,monk,mistweaver,18,13,5
23933,Troutline,bonechewer,1218,monk,mistweaver,84,50,34
23934,Hashìba,kiljaeden,1217,monk,mistweaver,18,13,5
23935,Xulieng,tichondrius,1215,monk,mistweaver,331,169,162
23936,Sedition,emerald-dream,1215,monk,mistweaver,323,162,161
23937,Ludafist,whisperwind,1212,monk,mistweaver,72,37,35
23938,Enfoque,quelthalas,1210,monk,mistweaver,77,43,34
23939,Monknificent,medivh,1210,monk,mistweaver,36,15,21
23940,Aeress,kelthuzad,1208,monk,mistweaver,30,13,17
23941,Chaotics,bleeding-hollow,1207,monk,mistweaver,41,25,16
23942,Razod,stormrage,1207,monk,mistweaver,223,115,108
23943,Stephani,turalyon,1207,monk,mistweaver,43,22,21
23944,Tjitsu,zuljin,1207,monk,mistweaver,38,19,19
23945,Haruko,baelgun,1207,monk,mistweaver,46,14,32
23946,Biggoosie,korgath,1206,monk,mistweaver,76,47,29
23947,Chunkynorris,stormscale,1206,monk,mistweaver,38,18,20
23948,Foomanshoes,shandris,1204,monk,mistweaver,52,14,38
23949,Dokfu,tichondrius,1201,monk,mistweaver,207,113,94
23950,Chainwax,korgath,1201,monk,mistweaver,56,30,26
23951,Taichichuan,tichondrius,1201,monk,mistweaver,71,36,35
23952,Ieatshrooms,malfurion,1201,monk,mistweaver,66,26,40
23953,Elcidw,tichondrius,1200,monk,mistweaver,21,14,7
23954,Lenakai,malganis,1199,monk,mistweaver,35,13,22
23955,Michaeljordn,destromath,1199,monk,mistweaver,44,16,28
23956,Menadraene,wyrmrest-accord,1198,monk,mistweaver,26,14,12
23957,Wraithfire,uldum,1197,monk,mistweaver,48,24,24
23958,Dasubb,crushridge,1196,monk,mistweaver,23,13,10
23959,Puffpuffp,nazgrel,1196,monk,mistweaver,24,13,11
23960,Zsalcior,jaedenar,1195,monk,mistweaver,36,24,12
23961,Drexlla,barthilas,1191,monk,mistweaver,38,23,15
23962,Titofresh,quelthalas,1191,monk,mistweaver,33,15,18
23963,Eqoy,moon-guard,1191,monk,mistweaver,30,13,17
23964,Raphzen,stormrage,1189,monk,mistweaver,33,17,16
23965,Soapy,moon-guard,1188,monk,mistweaver,35,16,19
23966,Littlegeorge,moon-guard,1187,monk,mistweaver,36,24,12
23967,Smokee,blackhand,1187,monk,mistweaver,30,15,15
23968,Tusil,tichondrius,1187,monk,mistweaver,36,13,23
23969,Hinudhera,barthilas,1186,monk,mistweaver,104,51,53
23970,Soderbergh,ysera,1185,monk,mistweaver,36,13,23
23971,Valdosta,bloodscalp,1183,monk,mistweaver,54,29,25
23972,Joeyfists,frostwolf,1181,monk,mistweaver,38,19,19
23973,Noctes,thunderlord,1179,monk,mistweaver,36,22,14
23974,Blackthorne,illidan,1179,monk,mistweaver,30,14,16
23975,Kreezoo,tichondrius,1178,monk,mistweaver,51,24,27
23976,Kromkwando,burning-blade,1177,monk,mistweaver,42,13,29
23977,Iseeyouqt,tichondrius,1176,monk,mistweaver,20,13,7
23978,Monkoala,illidan,1176,monk,mistweaver,42,21,21
23979,Touchkarma,stormrage,1175,monk,mistweaver,90,45,45
23980,Mongénoio,nemesis,1172,monk,mistweaver,26,13,13
23981,Purging,draka,1171,monk,mistweaver,98,68,30
23982,Touzin,bleeding-hollow,1171,monk,mistweaver,28,14,14
23983,Hamandchi,sargeras,1169,monk,mistweaver,23,16,7
23984,Evílryü,quelthalas,1168,monk,mistweaver,27,16,11
23985,Gazzoxsan,chogall,1168,monk,mistweaver,31,13,18
23986,Lumïnous,moon-guard,1167,monk,mistweaver,36,17,19
23987,Daddyrugburn,area-52,1167,monk,mistweaver,53,25,28
23988,Hie,laughing-skull,1166,monk,mistweaver,90,38,52
23989,Shwankeesha,thrall,1165,monk,mistweaver,28,14,14
23990,Miraculer,drakkari,1163,monk,mistweaver,28,14,14
23991,Chèmosh,fenris,1162,monk,mistweaver,29,13,16
23992,Polofasho,illidan,1159,monk,mistweaver,23,13,10
23993,Madmint,illidan,1159,monk,mistweaver,60,26,34
23994,Stevejabz,malganis,1156,monk,mistweaver,30,13,17
23995,Callibella,amanthul,1155,monk,mistweaver,26,13,13
23996,Hammonk,deathwing,1154,monk,mistweaver,36,20,16
23997,Orenj,boulderfist,1154,monk,mistweaver,36,17,19
23998,Fudoki,area-52,1153,monk,mistweaver,36,13,23
23999,Envymonk,tichondrius,1152,monk,mistweaver,18,12,6
24000,Magmuruk,garrosh,1152,monk,mistweaver,18,12,6
24001,Qimeng,sargeras,1152,monk,mistweaver,30,12,18
24002,Iilgayrob,stormrage,1151,monk,mistweaver,18,12,6
24003,Karaka,ysera,1151,monk,mistweaver,22,14,8
24004,Bigthing,burning-blade,1151,monk,mistweaver,24,12,12
24005,Danceschi,area-52,1151,monk,mistweaver,24,12,12
24006,Billycobham,tichondrius,1151,monk,mistweaver,24,12,12
24007,Affrika,ragnaros,1151,monk,mistweaver,53,25,28
24008,Møzy,darkspear,1150,monk,mistweaver,18,12,6
24009,Pissweever,barthilas,1150,monk,mistweaver,18,12,6
24010,Ragepalm,aegwynn,1150,monk,mistweaver,36,19,17
24011,Monkybizniss,skywall,1150,monk,mistweaver,24,12,12
24012,Habaneroz,wyrmrest-accord,1150,monk,mistweaver,24,12,12
24013,Shaweaver,caelestrasz,1150,monk,mistweaver,24,12,12
24014,Strixx,silvermoon,1148,monk,mistweaver,30,21,9
24015,Onlythumbs,area-52,1148,monk,mistweaver,18,12,6
24016,Zallie,frostmourne,1147,monk,mistweaver,18,12,6
24017,Jïngwei,proudmoore,1147,monk,mistweaver,24,12,12
24018,Smashgordon,burning-legion,1147,monk,mistweaver,30,12,18
24019,Bopmykarma,kelthuzad,1146,monk,mistweaver,25,12,13
24020,Kaniou,proudmoore,1146,monk,mistweaver,29,13,16
24021,Azenia,barthilas,1146,monk,mistweaver,30,12,18
24022,Kelpri,sentinels,1145,monk,mistweaver,18,12,6
24023,Jagichan,area-52,1145,monk,mistweaver,18,12,6
24024,Monkaveli,ursin,1145,monk,mistweaver,78,37,41
24025,Antimoine,saurfang,1144,monk,mistweaver,54,31,23
24026,Monkgov,illidan,1144,monk,mistweaver,24,12,12
24027,Bozzychi,illidan,1143,monk,mistweaver,30,12,18
24028,Onemonkk,tichondrius,1141,monk,mistweaver,132,72,60
24029,Uwufistgodx,tichondrius,1141,monk,mistweaver,30,12,18
24030,Crankxx,malganis,1139,monk,mistweaver,21,13,8
24031,Frothy,bleeding-hollow,1139,monk,mistweaver,24,12,12
24032,Dreadknotz,hyjal,1139,monk,mistweaver,51,25,26
24033,Calmemaybe,darkspear,1138,monk,mistweaver,18,12,6
24034,Tetsuo,altar-of-storms,1137,monk,mistweaver,18,12,6
24035,Çuß,kelthuzad,1137,monk,mistweaver,30,12,18
24036,Darksoult,kelthuzad,1136,monk,mistweaver,72,23,49
24037,Kexti,wyrmrest-accord,1135,monk,mistweaver,45,18,27
24038,Paraíba,azralon,1135,monk,mistweaver,35,12,23
24039,Illushadio,moon-guard,1132,monk,mistweaver,18,12,6
24040,Herbivorous,sargeras,1131,monk,mistweaver,24,12,12
24041,Hastle,windrunner,1130,monk,mistweaver,78,43,35
24042,Modelman,area-52,1130,monk,mistweaver,26,14,12
24043,Gobfu,emerald-dream,1130,monk,mistweaver,65,26,39
24044,Chicheez,sargeras,1129,monk,mistweaver,22,13,9
24045,Ciru,zangarmarsh,1129,monk,mistweaver,43,18,25
24046,Kongpoo,kelthuzad,1127,monk,mistweaver,21,14,7
24047,Atiantian,proudmoore,1127,monk,mistweaver,36,12,24
24048,Fitmonje,drakkari,1126,monk,mistweaver,43,22,21
24049,Boostmonk,terenas,1126,monk,mistweaver,78,34,44
24050,Fistmeister,tichondrius,1125,monk,mistweaver,30,19,11
24051,Crãsh,quelthalas,1125,monk,mistweaver,28,15,13
24052,Rxtea,darkspear,1124,monk,mistweaver,25,13,12
24053,Tübes,trollbane,1122,monk,mistweaver,24,12,12
24054,Ursorcen,frostmourne,1122,monk,mistweaver,33,16,17
24055,Honjada,tichondrius,1121,monk,mistweaver,18,12,6
24056,Jighte,illidan,1121,monk,mistweaver,30,16,14
24057,Tinze,bonechewer,1121,monk,mistweaver,43,17,26
24058,Tsyatvo,illidan,1119,monk,mistweaver,24,14,10
24059,Fluffykitty,deathwing,1119,monk,mistweaver,45,19,26
24060,Whiteknight,tichondrius,1118,monk,mistweaver,14,13,1
24061,Orbí,tichondrius,1113,monk,mistweaver,54,35,19
24062,Lepasfin,sargeras,1112,monk,mistweaver,30,20,10
24063,Sukrit,darkspear,1111,monk,mistweaver,52,24,28
24064,Halfaling,tichondrius,1109,monk,mistweaver,18,12,6
24065,Rosinhood,illidan,1109,monk,mistweaver,80,41,39
24066,Shaolyyn,zuljin,1107,monk,mistweaver,156,82,74
24067,Kafuru,quelthalas,1105,monk,mistweaver,22,13,9
24068,Lolcutie,shandris,1105,monk,mistweaver,37,21,16
24069,Rowbur,thrall,1101,monk,mistweaver,57,36,21
24070,Emenboats,zuljin,1096,monk,mistweaver,70,44,26
24071,Fruitcakezz,arthas,1095,monk,mistweaver,18,12,6
24072,Kimonk,proudmoore,1095,monk,mistweaver,36,21,15
24073,Lushona,ragnaros,1093,monk,mistweaver,36,26,10
24074,Gentle,cenarius,1093,monk,mistweaver,26,12,14
24075,Shoguns,zuljin,1091,monk,mistweaver,48,24,24
24076,Keekirx,tichondrius,1088,monk,mistweaver,28,14,14
24077,Zendemic,thrall,1087,monk,mistweaver,60,36,24
24078,Coachputmein,barthilas,1086,monk,mistweaver,17,12,5
24079,Skydouken,sargeras,1086,monk,mistweaver,22,12,10
24080,Focalors,proudmoore,1085,monk,mistweaver,20,12,8
24081,Knucklez,frostwolf,1078,monk,mistweaver,90,49,41
24082,Pwned,ghostlands,1078,monk,mistweaver,63,21,42
24083,Lzt,ragnaros,1075,monk,mistweaver,34,13,21
24084,Hapgido,deathwing,1074,monk,mistweaver,62,31,31
24085,Harryrichard,sargeras,1073,monk,mistweaver,23,12,11
24086,Lita,barthilas,1071,monk,mistweaver,17,12,5
24087,Keeanuweaves,tichondrius,1069,monk,mistweaver,13,12,1
24088,Hakushin,ragnaros,1067,monk,mistweaver,36,20,16
24089,Jackburton,deathwing,1066,monk,mistweaver,18,13,5
24090,Lizavet,stormrage,1065,monk,mistweaver,30,22,8
24091,Cosetteb,proudmoore,1064,monk,mistweaver,23,12,11
24092,Shanalot,stormrage,1063,monk,mistweaver,19,12,7
24093,Hache,azjolnerub,1062,monk,mistweaver,86,37,49
24094,Chugs,malorne,1062,monk,mistweaver,57,16,41
24095,Duelist,the-scryers,1056,monk,mistweaver,12,11,1
24096,Jmanownz,stormrage,1056,monk,mistweaver,12,11,1
24097,Spirits,dreadmaul,1056,monk,mistweaver,18,11,7
24098,Haren,gundrak,1056,monk,mistweaver,18,11,7
24099,Mistussy,sargeras,1056,monk,mistweaver,18,11,7
24100,Yangzai,tichondrius,1056,monk,mistweaver,18,11,7
24101,Saitamâ,tichondrius,1056,monk,mistweaver,18,11,7
24102,Mxxb,illidan,1056,monk,mistweaver,18,11,7
24103,Solidww,moon-guard,1055,monk,mistweaver,12,11,1
24104,Alandis,spinebreaker,1055,monk,mistweaver,18,11,7
24105,Ninjachavez,tichondrius,1055,monk,mistweaver,18,11,7
24106,Ephéyxq,area-52,1055,monk,mistweaver,18,11,7
24107,Undertickle,illidan,1055,monk,mistweaver,18,11,7
24108,Iplus,thrall,1055,monk,mistweaver,18,11,7
24109,Axibar,tichondrius,1055,monk,mistweaver,18,11,7
24110,Ryanx,azjolnerub,1055,monk,mistweaver,18,11,7
24111,Stephenia,tichondrius,1055,monk,mistweaver,18,11,7
24112,Fkinbis,area-52,1055,monk,mistweaver,18,11,7
24113,Lemmetouch,illidan,1055,monk,mistweaver,24,11,13
24114,Dowzk,tichondrius,1055,monk,mistweaver,24,11,13
24115,Imafqnbaby,tichondrius,1055,monk,mistweaver,24,11,13
24116,Chillionaíre,proudmoore,1055,monk,mistweaver,24,11,13
24117,Kriticalkush,kelthuzad,1055,monk,mistweaver,24,11,13
24118,Taelinn,moonrunner,1055,monk,mistweaver,30,11,19
24119,Raonoc,area-52,1055,monk,mistweaver,30,11,19
24120,Evilbit,boulderfist,1054,monk,mistweaver,18,11,7
24121,Børraicho,ragnaros,1054,monk,mistweaver,18,11,7
24122,Phazorr,frostmourne,1054,monk,mistweaver,18,11,7
24123,Punchopuncho,malganis,1054,monk,mistweaver,24,11,13
24124,Cungflu,crushridge,1054,monk,mistweaver,24,11,13
24125,Zhuangnimane,tichondrius,1053,monk,mistweaver,12,11,1
24126,Shogundachi,moon-guard,1053,monk,mistweaver,21,13,8
24127,Lindraice,illidan,1053,monk,mistweaver,18,11,7
24128,Zoochans,tichondrius,1053,monk,mistweaver,67,40,27
24129,Walmartguard,arthas,1053,monk,mistweaver,40,20,20
24130,Arahabaki,wyrmrest-accord,1053,monk,mistweaver,24,11,13
24131,Topanga,azralon,1053,monk,mistweaver,42,12,30
24132,Theymistbuda,kelthuzad,1052,monk,mistweaver,12,11,1
24133,Djslimweaver,stormrage,1052,monk,mistweaver,14,11,3
24134,Wungpo,the-forgotten-coast,1052,monk,mistweaver,18,11,7
24135,Havasupai,turalyon,1052,monk,mistweaver,18,11,7
24136,Creamchop,stormreaver,1052,monk,mistweaver,18,11,7
24137,Vayce,barthilas,1052,monk,mistweaver,24,11,13
24138,Karnbroo,frostmourne,1052,monk,mistweaver,24,11,13
24139,Benedïct,korgath,1052,monk,mistweaver,24,11,13
24140,Zenspice,stormrage,1051,monk,mistweaver,18,11,7
24141,Rolybones,boulderfist,1051,monk,mistweaver,19,11,8
24142,Steenkk,tichondrius,1051,monk,mistweaver,60,29,31
24143,Superbae,area-52,1051,monk,mistweaver,24,11,13
24144,Dégg,thrall,1050,monk,mistweaver,18,11,7
24145,Jimmythemist,mugthol,1050,monk,mistweaver,18,11,7
24146,Eldrik,stormrage,1050,monk,mistweaver,18,11,7
24147,Sevenpunch,area-52,1050,monk,mistweaver,30,11,19
24148,Dellunnax,azralon,1049,monk,mistweaver,18,11,7
24149,Pichiquechi,frostmourne,1049,monk,mistweaver,24,11,13
24150,Lochekx,stonemaul,1048,monk,mistweaver,48,17,31
24151,Ilani,malganis,1047,monk,mistweaver,18,11,7
24152,Monky,black-dragonflight,1047,monk,mistweaver,18,11,7
24153,Decha,skywall,1047,monk,mistweaver,18,11,7
24154,Shaolinmists,malganis,1045,monk,mistweaver,12,11,1
24155,Feynzen,frostmourne,1044,monk,mistweaver,18,11,7
24156,Xbrewtal,tichondrius,1043,monk,mistweaver,128,71,57
24157,Philthyjutsu,moon-guard,1042,monk,mistweaver,12,11,1
24158,Dustyweaver,illidan,1039,monk,mistweaver,55,22,33
24159,Patman,nazjatar,1038,monk,mistweaver,18,12,6
24160,Teancrumpets,wyrmrest-accord,1038,monk,mistweaver,48,20,28
24161,Leësin,ragnaros,1037,monk,mistweaver,18,11,7
24162,Blorkk,area-52,1035,monk,mistweaver,18,11,7
24163,Rektfu,emerald-dream,1033,monk,mistweaver,27,13,14
24164,Tadaku,dalaran,1033,monk,mistweaver,37,17,20
24165,Reinah,malganis,1033,monk,mistweaver,30,11,19
24166,Poem,grizzly-hills,1032,monk,mistweaver,21,12,9
24167,Mahhnaga,tichondrius,1032,monk,mistweaver,101,42,59
24168,Merand,tichondrius,1031,monk,mistweaver,36,20,16
24169,Baiji,gorefiend,1030,monk,mistweaver,12,11,1
24170,Esotericzeo,mugthol,1030,monk,mistweaver,72,35,37
24171,Chopy,dragonblight,1030,monk,mistweaver,66,32,34
24172,Ahshurra,blackhand,1029,monk,mistweaver,41,14,27
24173,Joxo,nordrassil,1028,monk,mistweaver,18,13,5
24174,Marnartou,zuljin,1026,monk,mistweaver,12,11,1
24175,Ambuinc,burning-blade,1024,monk,mistweaver,18,11,7
24176,Dalillamas,sargeras,1023,monk,mistweaver,14,12,2
24177,Schein,sargeras,1023,monk,mistweaver,17,11,6
24178,Koyon,sargeras,1023,monk,mistweaver,17,11,6
24179,Nezukó,malganis,1022,monk,mistweaver,17,11,6
24180,Venomqt,laughing-skull,1021,monk,mistweaver,17,11,6
24181,Ghostmk,nagrand,1021,monk,mistweaver,30,12,18
24182,Grizzchan,sargeras,1017,monk,mistweaver,17,11,6
24183,Ainz,nagrand,1016,monk,mistweaver,30,15,15
24184,Kocksnapper,stormreaver,1014,monk,mistweaver,86,48,38
24185,Vitcheztein,ragnaros,1007,monk,mistweaver,17,11,6
24186,Twizzurp,magtheridon,1007,monk,mistweaver,21,12,9
24187,Bigjuicers,bleeding-hollow,1006,monk,mistweaver,17,11,6
24188,Supmybrew,frostmourne,1005,monk,mistweaver,23,11,12
24189,Kpeste,tichondrius,1002,monk,mistweaver,78,41,37
24190,Vencö,tichondrius,1001,monk,mistweaver,33,11,22
24191,Yookho,tichondrius,1000,monk,mistweaver,17,12,5
24192,Matchuh,stormrage,1000,monk,mistweaver,55,24,31
24193,Clutchinmist,malganis,1000,monk,mistweaver,40,12,28
24194,Bearchi,sargeras,997,monk,mistweaver,21,12,9
24195,Telrande,ysondre,994,monk,mistweaver,35,24,11
24196,Beefdadyfist,tichondrius,994,monk,mistweaver,36,14,22
24197,Gòss,azgalor,993,monk,mistweaver,61,25,36
24198,Tisafister,kelthuzad,992,monk,mistweaver,28,12,16
24199,Honorviejos,illidan,991,monk,mistweaver,23,11,12
24200,Bonquavius,thrall,990,monk,mistweaver,20,11,9
24201,Whitepotato,bleeding-hollow,986,monk,mistweaver,132,69,63
24202,Lilbee,azjolnerub,986,monk,mistweaver,23,12,11
24203,Mintbear,illidan,984,monk,mistweaver,14,11,3
24204,Silito,drakkari,981,monk,mistweaver,138,55,83
24205,Bomer,moknathal,980,monk,mistweaver,49,29,20
24206,Monkgringo,azralon,978,monk,mistweaver,76,40,36
24207,Winniethepoo,borean-tundra,975,monk,mistweaver,19,11,8
24208,Ogsimpsonn,tichondrius,972,monk,mistweaver,20,11,9
24209,Kfpanda,hellscream,971,monk,mistweaver,83,38,45
24210,Soulex,blackwater-raiders,970,monk,mistweaver,23,12,11
24211,Deadlyzz,gilneas,970,monk,mistweaver,99,51,48
24212,Sipu,wyrmrest-accord,969,monk,mistweaver,41,20,21
24213,Djwushu,blackhand,969,monk,mistweaver,26,11,15
24214,Klanianhere,sargeras,960,monk,mistweaver,12,10,2
24215,Gnet,azralon,960,monk,mistweaver,12,10,2
24216,Woes,stormreaver,960,monk,mistweaver,12,10,2
24217,Toonahroll,area-52,960,monk,mistweaver,12,10,2
24218,Hype,ursin,960,monk,mistweaver,12,10,2
24219,Drizzywow,arathor,960,monk,mistweaver,12,10,2
24220,Wordword,tichondrius,960,monk,mistweaver,18,10,8
24221,Impersonal,sargeras,960,monk,mistweaver,18,10,8
24222,Thatfknguy,sargeras,960,monk,mistweaver,18,10,8
24223,Mauvem,tichondrius,960,monk,mistweaver,18,10,8
24224,Titti,korgath,960,monk,mistweaver,18,10,8
24225,Agilities,sargeras,960,monk,mistweaver,18,10,8
24226,Mywave,bleeding-hollow,960,monk,mistweaver,18,10,8
24227,Chevvy,azshara,960,monk,mistweaver,18,10,8
24228,Syro,spinebreaker,960,monk,mistweaver,18,10,8
24229,Greenfriend,illidan,960,monk,mistweaver,18,10,8
24230,Dapperdabz,illidan,960,monk,mistweaver,18,10,8
24231,Suitosky,ragnaros,960,monk,mistweaver,24,10,14
24232,Barlyfe,tichondrius,960,monk,mistweaver,24,10,14
24233,Sharpstorm,darkspear,959,monk,mistweaver,12,10,2
24234,Mïstyfïsty,moon-guard,959,monk,mistweaver,12,10,2
24235,Hanlover,tichondrius,959,monk,mistweaver,12,10,2
24236,Shâdòw,ragnaros,959,monk,mistweaver,12,10,2
24237,Nezkabad,frostmourne,959,monk,mistweaver,12,10,2
24238,Chanîng,frostmourne,959,monk,mistweaver,18,10,8
24239,Melpaine,frostmourne,959,monk,mistweaver,18,10,8
24240,Diâblomw,barthilas,959,monk,mistweaver,18,10,8
24241,Truefists,stormrage,959,monk,mistweaver,18,10,8
24242,Insidedog,frostmourne,959,monk,mistweaver,18,10,8
24243,Beaver,zuljin,959,monk,mistweaver,18,10,8
24244,Monkmarz,malygos,959,monk,mistweaver,23,10,13
24245,Anabolicx,khazgoroth,959,monk,mistweaver,24,10,14
24246,Pumpsx,area-52,959,monk,mistweaver,24,10,14
24247,Twïst,tichondrius,958,monk,mistweaver,12,10,2
24248,Kåtê,sargeras,958,monk,mistweaver,12,10,2
24249,Trazmold,emerald-dream,958,monk,mistweaver,18,10,8
24250,Fïish,stormrage,958,monk,mistweaver,18,10,8
24251,Nientea,wyrmrest-accord,958,monk,mistweaver,18,10,8
24252,Lostinmistz,tichondrius,958,monk,mistweaver,18,10,8
24253,Fistfreak,stormrage,957,monk,mistweaver,18,10,8
24254,Inkers,detheroc,957,monk,mistweaver,18,10,8
24255,Oldfashheals,tichondrius,957,monk,mistweaver,24,10,14
24256,Mizzycash,malganis,957,monk,mistweaver,26,10,16
24257,Strokahontas,stormreaver,957,monk,mistweaver,42,10,32
24258,Bamboozile,arthas,956,monk,mistweaver,18,10,8
24259,Diligentmonk,illidan,955,monk,mistweaver,27,11,16
24260,Indigojo,silver-hand,955,monk,mistweaver,30,10,20
24261,Bojflow,dalaran,954,monk,mistweaver,18,10,8
24262,Wessex,sargeras,954,monk,mistweaver,18,10,8
24263,Prodivuss,stormrage,954,monk,mistweaver,24,10,14
24264,Aotd,tichondrius,954,monk,mistweaver,24,10,14
24265,Divaweaver,sargeras,953,monk,mistweaver,24,10,14
24266,Daddbear,kiljaeden,952,monk,mistweaver,18,10,8
24267,Kurtall,area-52,952,monk,mistweaver,24,10,14
24268,Rdmptn,bleeding-hollow,952,monk,mistweaver,24,10,14
24269,Fìst,hyjal,951,monk,mistweaver,18,10,8
24270,Kailzchi,area-52,951,monk,mistweaver,18,10,8
24271,Brewtalitops,illidan,950,monk,mistweaver,18,10,8
24272,Shinobui,jubeithos,950,monk,mistweaver,18,10,8
24273,Lañdo,uldaman,950,monk,mistweaver,23,12,11
24274,Omegasix,nazjatar,949,monk,mistweaver,18,10,8
24275,Palomagozzu,ragnaros,947,monk,mistweaver,18,10,8
24276,Howu,tichondrius,947,monk,mistweaver,35,12,23
24277,Jæmz,moon-guard,944,monk,mistweaver,36,13,23
24278,Kiyou,drakkari,940,monk,mistweaver,18,10,8
24279,Kyndrïa,tichondrius,938,monk,mistweaver,155,71,84
24280,Nigondatnay,tichondrius,927,monk,mistweaver,16,11,5
24281,Sahalee,sargeras,927,monk,mistweaver,38,18,20
24282,Ultramaga,dentarg,927,monk,mistweaver,28,10,18
24283,Nosweaver,malganis,926,monk,mistweaver,14,11,3
24284,Tcoon,frostmourne,925,monk,mistweaver,26,11,15
24285,Siamack,illidan,920,monk,mistweaver,14,11,3
24286,Kratis,doomhammer,915,monk,mistweaver,71,28,43
24287,Karkata,sargeras,914,monk,mistweaver,48,20,28
24288,Kangeroo,tichondrius,912,monk,mistweaver,21,11,10
24289,Sensey,veknilash,910,monk,mistweaver,17,10,7
24290,Julox,azralon,910,monk,mistweaver,18,10,8
24291,Lovechabill,darkspear,906,monk,mistweaver,17,10,7
24292,Ægo,sargeras,906,monk,mistweaver,22,11,11
24293,Xentra,stormrage,895,monk,mistweaver,11,10,1
24294,Griddio,wyrmrest-accord,895,monk,mistweaver,14,10,4
24295,Delassian,moon-guard,894,monk,mistweaver,37,16,21
24296,Inbu,tichondrius,893,monk,mistweaver,26,10,16
24297,Gino,proudmoore,890,monk,mistweaver,214,99,115
24298,Stickbundle,illidan,888,monk,mistweaver,15,11,4
24299,Edj,drenden,884,monk,mistweaver,75,37,38
24300,Boojaa,silvermoon,882,monk,mistweaver,83,33,50
24301,Madmoose,smolderthorn,879,monk,mistweaver,48,18,30
24302,Galyndra,darkspear,877,monk,mistweaver,13,10,3
24303,Imnumberone,alterac-mountains,864,monk,mistweaver,12,9,3
24304,Rumor,lethon,864,monk,mistweaver,12,9,3
24305,Daneil,illidan,864,monk,mistweaver,12,9,3
24306,Franqx,tichondrius,864,monk,mistweaver,12,9,3
24307,Ggonext,wyrmrest-accord,864,monk,mistweaver,12,9,3
24308,Flicksx,arthas,864,monk,mistweaver,12,9,3
24309,Zbhm,illidan,864,monk,mistweaver,12,9,3
24310,Sâx,stormreaver,864,monk,mistweaver,12,9,3
24311,Horndog,skullcrusher,864,monk,mistweaver,12,9,3
24312,Mistyfisty,laughing-skull,864,monk,mistweaver,14,9,5
24313,Xitearith,ragnaros,864,monk,mistweaver,18,9,9
24314,Pinkfairy,wyrmrest-accord,864,monk,mistweaver,18,9,9
24315,Kármah,emerald-dream,864,monk,mistweaver,18,9,9
24316,Pantypirate,tichondrius,864,monk,mistweaver,18,9,9
24317,Hulkhogan,mugthol,863,monk,mistweaver,14,11,3
24318,Brewley,thrall,863,monk,mistweaver,12,9,3
24319,Theminivan,sargeras,863,monk,mistweaver,12,9,3
24320,Brewtillis,tichondrius,863,monk,mistweaver,12,9,3
24321,Ztalian,moon-guard,863,monk,mistweaver,12,9,3
24322,Kazzichi,area-52,863,monk,mistweaver,12,9,3
24323,Beastmonk,sargeras,863,monk,mistweaver,12,9,3
24324,Tjab,kiljaeden,863,monk,mistweaver,18,9,9
24325,Neverfake,sargeras,863,monk,mistweaver,18,9,9
24326,Shadowbringr,proudmoore,863,monk,mistweaver,18,9,9
24327,Strummies,tichondrius,863,monk,mistweaver,18,9,9
24328,Bootytoes,emerald-dream,863,monk,mistweaver,18,9,9
24329,Srgtbingo,azgalor,863,monk,mistweaver,18,9,9
24330,Boothchi,kelthuzad,863,monk,mistweaver,18,9,9
24331,Sumaran,hydraxis,863,monk,mistweaver,18,9,9
24332,Fìst,zuljin,863,monk,mistweaver,18,9,9
24333,Slickbeef,thrall,863,monk,mistweaver,24,9,15
24334,Icytoned,kelthuzad,863,monk,mistweaver,24,9,15
24335,Globalmonk,emerald-dream,862,monk,mistweaver,12,9,3
24336,Zac,veknilash,862,monk,mistweaver,12,9,3
24337,Ørçhid,ravenholdt,862,monk,mistweaver,12,9,3
24338,Pharmasee,proudmoore,862,monk,mistweaver,12,9,3
24339,Kungupanda,nesingwary,862,monk,mistweaver,24,9,15
24340,Jhaded,tichondrius,862,monk,mistweaver,24,9,15
24341,Madussy,zuljin,862,monk,mistweaver,24,9,15
24342,Kromrax,stormrage,862,monk,mistweaver,24,9,15
24343,Lillyanda,lightbringer,861,monk,mistweaver,12,9,3
24344,Gitwwrekd,area-52,861,monk,mistweaver,12,9,3
24345,Monkydoo,blackhand,861,monk,mistweaver,18,9,9
24346,Justfakeit,area-52,861,monk,mistweaver,18,9,9
24347,Dumplinz,tichondrius,860,monk,mistweaver,12,9,3
24348,Moonkers,tichondrius,860,monk,mistweaver,18,9,9
24349,Håzê,kul-tiras,860,monk,mistweaver,18,9,9
24350,Yudrin,zuljin,859,monk,mistweaver,24,9,15
24351,Medge,kelthuzad,858,monk,mistweaver,18,9,9
24352,Monkism,warsong,855,monk,mistweaver,12,9,3
24353,Winwakamank,sargeras,855,monk,mistweaver,24,9,15
24354,Rabico,azralon,854,monk,mistweaver,12,9,3
24355,Rauschende,feathermoon,854,monk,mistweaver,12,9,3
24356,Maqaveli,sargeras,854,monk,mistweaver,18,9,9
24357,Tubbytiph,ghostlands,853,monk,mistweaver,30,9,21
24358,Eago,sargeras,852,monk,mistweaver,24,9,15
24359,Zeeboogerton,wildhammer,851,monk,mistweaver,12,9,3
24360,Bullshido,aerie-peak,851,monk,mistweaver,18,9,9
24361,Epptwo,aggramar,851,monk,mistweaver,30,9,21
24362,Goodgodsz,tichondrius,849,monk,mistweaver,12,9,3
24363,Gesir,tichondrius,848,monk,mistweaver,21,10,11
24364,Sìrtankallot,stormrage,837,monk,mistweaver,32,9,23
24365,Dreamy,mugthol,833,monk,mistweaver,48,17,31
24366,Kimchimaj,tichondrius,832,monk,mistweaver,18,9,9
24367,Fakelove,kelthuzad,830,monk,mistweaver,28,10,18
24368,Seaja,malganis,823,monk,mistweaver,99,26,73
24369,Måz,malorne,822,monk,mistweaver,21,12,9
24370,Domisalamii,sargeras,815,monk,mistweaver,17,9,8
24371,Eggwoll,velen,814,monk,mistweaver,15,10,5
24372,Obàma,tichondrius,809,monk,mistweaver,19,10,9
24373,Matsakaicin,azralon,809,monk,mistweaver,22,10,12
24374,Goodluck,madoran,809,monk,mistweaver,27,10,17
24375,Paniku,sargeras,807,monk,mistweaver,51,17,34
24376,Tokkyo,frostmourne,804,monk,mistweaver,66,15,51
24377,Picoree,frostmourne,799,monk,mistweaver,15,10,5
24378,Udmonk,tichondrius,799,monk,mistweaver,14,9,5
24379,Mastahp,tichondrius,797,monk,mistweaver,22,9,13
24380,Sivedrafely,arthas,793,monk,mistweaver,35,10,25
24381,Qlispe,bloodscalp,784,monk,mistweaver,76,35,41
24382,Omnly,stormrage,768,monk,mistweaver,12,8,4
24383,Kaskã,tichondrius,768,monk,mistweaver,12,8,4
24384,Dontchattome,sargeras,768,monk,mistweaver,12,8,4
24385,Ericfu,tichondrius,768,monk,mistweaver,12,8,4
24386,Kaystorm,stormrage,768,monk,mistweaver,12,8,4
24387,Scrypter,proudmoore,768,monk,mistweaver,12,8,4
24388,Cuckoon,malganis,768,monk,mistweaver,12,8,4
24389,Brewtankx,tichondrius,768,monk,mistweaver,12,8,4
24390,Bralex,black-dragonflight,768,monk,mistweaver,12,8,4
24391,Snowbunny,llane,768,monk,mistweaver,12,8,4
24392,Prodigious,illidan,768,monk,mistweaver,12,8,4
24393,Shquiz,sargeras,768,monk,mistweaver,12,8,4
24394,Sainlaurent,tichondrius,768,monk,mistweaver,12,8,4
24395,Chipapi,sargeras,768,monk,mistweaver,12,8,4
24396,Funkmunk,aegwynn,768,monk,mistweaver,12,8,4
24397,Fangerlia,moon-guard,768,monk,mistweaver,12,8,4
24398,Vexed,illidan,768,monk,mistweaver,12,8,4
24399,Leesinga,alexstrasza,768,monk,mistweaver,12,8,4
24400,Kobuya,tichondrius,768,monk,mistweaver,12,8,4
24401,Tuladura,tichondrius,768,monk,mistweaver,12,8,4
24402,Tubescreamer,barthilas,768,monk,mistweaver,12,8,4
24403,Sàìñtàsønìà,kelthuzad,768,monk,mistweaver,12,8,4
24404,Picklefartjr,malfurion,768,monk,mistweaver,12,8,4
24405,Kwatann,bonechewer,768,monk,mistweaver,18,8,10
24406,Watercowz,tichondrius,768,monk,mistweaver,18,8,10
24407,Torakigai,hyjal,768,monk,mistweaver,18,8,10
24408,Rockyßalboa,sargeras,768,monk,mistweaver,18,8,10
24409,Backflip,nemesis,768,monk,mistweaver,18,8,10
24410,Mmrmonkey,tichondrius,768,monk,mistweaver,18,8,10
24411,Phyte,kelthuzad,768,monk,mistweaver,18,8,10
24412,Drkeen,frostmourne,768,monk,mistweaver,28,10,18
24413,Erwynz,tichondrius,768,monk,mistweaver,24,8,16
24414,Psyx,frostmourne,767,monk,mistweaver,12,8,4
24415,Kymosolomk,sargeras,767,monk,mistweaver,12,8,4
24416,Blitzcombo,thrall,767,monk,mistweaver,12,8,4
24417,Nøzawri,area-52,767,monk,mistweaver,12,8,4
24418,Pungeebi,tichondrius,767,monk,mistweaver,12,8,4
24419,Rilenn,area-52,767,monk,mistweaver,12,8,4
24420,Abird,tichondrius,767,monk,mistweaver,12,8,4
24421,Pandicapped,the-underbog,767,monk,mistweaver,12,8,4
24422,Sììre,tichondrius,767,monk,mistweaver,12,8,4
24423,Mightbewôrth,thunderhorn,767,monk,mistweaver,12,8,4
24424,Bogez,area-52,767,monk,mistweaver,18,8,10
24425,Dùffmán,jubeithos,767,monk,mistweaver,18,8,10
24426,Harmoñize,moon-guard,767,monk,mistweaver,18,8,10
24427,Alfonzó,tichondrius,767,monk,mistweaver,18,8,10
24428,Notastreamer,frostmourne,767,monk,mistweaver,18,8,10
24429,Elfass,bleeding-hollow,767,monk,mistweaver,18,8,10
24430,Buymymixtape,ursin,767,monk,mistweaver,18,8,10
24431,Ocmonk,hyjal,767,monk,mistweaver,18,8,10
24432,Dabnhash,emerald-dream,767,monk,mistweaver,18,8,10
24433,Vvsm,tichondrius,767,monk,mistweaver,18,8,10
24434,Barleygar,tichondrius,767,monk,mistweaver,18,8,10
24435,Palden,blackrock,767,monk,mistweaver,18,8,10
24436,Onegai,illidan,767,monk,mistweaver,24,8,16
24437,Bambolee,thunderhorn,766,monk,mistweaver,12,8,4
24438,Skonk,shattered-hand,766,monk,mistweaver,12,8,4
24439,Apexian,kelthuzad,766,monk,mistweaver,12,8,4
24440,Artomist,stormrage,766,monk,mistweaver,12,8,4
24441,Catchdismist,tichondrius,766,monk,mistweaver,12,8,4
24442,Nakiki,cenarion-circle,766,monk,mistweaver,12,8,4
24443,Jnziww,area-52,766,monk,mistweaver,12,8,4
24444,Selfiestíck,tichondrius,766,monk,mistweaver,12,8,4
24445,Tàekwondo,drakkari,766,monk,mistweaver,18,8,10
24446,Orthôdox,tichondrius,766,monk,mistweaver,18,8,10
24447,Malusiftw,tichondrius,766,monk,mistweaver,18,8,10
24448,Biglinky,sargeras,765,monk,mistweaver,18,8,10
24449,Wzzi,tichondrius,765,monk,mistweaver,18,8,10
24450,Slinger,kalecgos,764,monk,mistweaver,16,9,7
24451,Scips,fizzcrank,764,monk,mistweaver,18,8,10
24452,Savyi,stormreaver,763,monk,mistweaver,12,8,4
24453,Dower,archimonde,763,monk,mistweaver,16,9,7
24454,Tigmo,alleria,762,monk,mistweaver,18,8,10
24455,Kushmintz,whisperwind,762,monk,mistweaver,18,8,10
24456,Fufu,terokkar,761,monk,mistweaver,18,8,10
24457,Angrybrewski,tichondrius,757,monk,mistweaver,18,8,10
24458,Fusionspell,stormrage,747,monk,mistweaver,24,8,16
24459,Prddoss,quelthalas,745,monk,mistweaver,12,8,4
24460,Sätsu,bleeding-hollow,735,monk,mistweaver,17,8,9
24461,Karlrogan,stormrage,734,monk,mistweaver,16,9,7
24462,Áasuna,ragnaros,734,monk,mistweaver,20,9,11
24463,Senseißones,area-52,734,monk,mistweaver,23,8,15
24464,Whosaidthat,frostmourne,723,monk,mistweaver,18,8,10
24465,Kryflex,frostmourne,720,monk,mistweaver,15,9,6
24466,Thaliondor,stormrage,720,monk,mistweaver,15,9,6
24467,Bombshellxo,illidan,719,monk,mistweaver,11,8,3
24468,Whee,wyrmrest-accord,703,monk,mistweaver,11,8,3
24469,Teddybéar,illidan,703,monk,mistweaver,14,8,6
24470,Kármâ,darkspear,703,monk,mistweaver,14,8,6
24471,Keloxx,ragnaros,702,monk,mistweaver,16,10,6
24472,Hirav,khazgoroth,697,monk,mistweaver,21,9,12
24473,Shortbuss,aegwynn,696,monk,mistweaver,14,8,6
24474,Minttea,kiljaeden,690,monk,mistweaver,28,9,19
24475,Hunchojack,undermine,672,monk,mistweaver,10,8,2
24476,Rawmonk,blackrock,672,monk,mistweaver,12,7,5
24477,Jasonluv,illidan,672,monk,mistweaver,12,7,5
24478,Jaxvisto,dalaran,672,monk,mistweaver,12,7,5
24479,Opclassxd,illidan,672,monk,mistweaver,12,7,5
24480,Brimhildaa,tichondrius,672,monk,mistweaver,12,7,5
24481,Laggytoodope,kelthuzad,672,monk,mistweaver,12,7,5
24482,Mwr,frostmourne,672,monk,mistweaver,12,7,5
24483,Yuumeì,senjin,672,monk,mistweaver,12,7,5
24484,Mundane,sargeras,672,monk,mistweaver,12,7,5
24485,Zbell,sargeras,672,monk,mistweaver,12,7,5
24486,Kyrap,stormscale,672,monk,mistweaver,12,7,5
24487,Rookere,malganis,672,monk,mistweaver,12,7,5
24488,Darong,tichondrius,672,monk,mistweaver,12,7,5
24489,Såd,zuljin,672,monk,mistweaver,12,7,5
24490,Dogmonster,stormrage,672,monk,mistweaver,12,7,5
24491,Immersion,the-forgotten-coast,672,monk,mistweaver,12,7,5
24492,Brantkicks,tichondrius,672,monk,mistweaver,12,7,5
24493,Lynio,area-52,672,monk,mistweaver,12,7,5
24494,Kegwalker,earthen-ring,672,monk,mistweaver,12,7,5
24495,Arumat,shadow-council,672,monk,mistweaver,12,7,5
24496,Ashmisty,kelthuzad,672,monk,mistweaver,12,7,5
24497,Lilpøøter,tichondrius,672,monk,mistweaver,12,7,5
24498,Yaloon,stormrage,672,monk,mistweaver,12,7,5
24499,Loppjr,tichondrius,672,monk,mistweaver,12,7,5
24500,Brokenfeels,azralon,672,monk,mistweaver,12,7,5
24501,Strawberriez,kelthuzad,672,monk,mistweaver,12,7,5
24502,Aniwhy,tichondrius,672,monk,mistweaver,12,7,5
24503,Zhoutai,malganis,672,monk,mistweaver,12,7,5
24504,Moönk,tichondrius,672,monk,mistweaver,12,7,5
24505,Boorams,tichondrius,672,monk,mistweaver,12,7,5
24506,Toothpick,blackrock,672,monk,mistweaver,12,7,5
24507,Fox,azshara,672,monk,mistweaver,12,7,5
24508,Galeindra,whisperwind,672,monk,mistweaver,12,7,5
24509,Copamine,dalaran,672,monk,mistweaver,12,7,5
24510,Vesaves,azralon,672,monk,mistweaver,12,7,5
24511,Abevx,bonechewer,672,monk,mistweaver,12,7,5
24512,Tooflyfobrew,sargeras,672,monk,mistweaver,12,7,5
24513,Notrof,korgath,672,monk,mistweaver,12,7,5
24514,Sweetröll,stormrage,672,monk,mistweaver,12,7,5
24515,Missclickx,azralon,672,monk,mistweaver,12,7,5
24516,Saiyañ,proudmoore,672,monk,mistweaver,12,7,5
24517,Synpunch,tichondrius,672,monk,mistweaver,12,7,5
24518,Ishtári,tichondrius,672,monk,mistweaver,15,8,7
24519,Fistay,burning-legion,672,monk,mistweaver,15,8,7
24520,Sjw,icecrown,672,monk,mistweaver,14,7,7
24521,Èxpèrtisè,jubeithos,672,monk,mistweaver,14,7,7
24522,Matthew,ravencrest,672,monk,mistweaver,18,7,11
24523,Thevy,area-52,672,monk,mistweaver,18,7,11
24524,Monktu,frostmourne,672,monk,mistweaver,18,7,11
24525,Argoholic,proudmoore,672,monk,mistweaver,18,7,11
24526,Audrun,frostmourne,672,monk,mistweaver,18,7,11
24527,Russtie,sargeras,672,monk,mistweaver,18,7,11
24528,Catchmemaybe,stormscale,672,monk,mistweaver,24,7,17
24529,Tayytay,kiljaeden,671,monk,mistweaver,12,7,5
24530,Universalize,zuljin,671,monk,mistweaver,12,7,5
24531,Monkgins,area-52,671,monk,mistweaver,12,7,5
24532,Iwonson,mugthol,671,monk,mistweaver,12,7,5
24533,Delightni,area-52,671,monk,mistweaver,12,7,5
24534,Shwrmist,bleeding-hollow,671,monk,mistweaver,12,7,5
24535,Jbonk,hyjal,671,monk,mistweaver,12,7,5
24536,Hornymonkale,thrall,671,monk,mistweaver,12,7,5
24537,Rizchi,tichondrius,671,monk,mistweaver,12,7,5
24538,Alisoly,tichondrius,671,monk,mistweaver,12,7,5
24539,Niculinha,nemesis,671,monk,mistweaver,12,7,5
24540,Shórtlived,skullcrusher,671,monk,mistweaver,13,7,6
24541,Táishen,wyrmrest-accord,671,monk,mistweaver,16,8,8
24542,Bükki,ragnaros,671,monk,mistweaver,18,7,11
24543,Femifist,lightbringer,671,monk,mistweaver,18,7,11
24544,Sterow,kiljaeden,671,monk,mistweaver,18,7,11
24545,Paradissô,tichondrius,671,monk,mistweaver,18,7,11
24546,Thahomie,nordrassil,671,monk,mistweaver,24,7,17
24547,Drizzie,queldorei,671,monk,mistweaver,24,7,17
24548,Swann,stormreaver,670,monk,mistweaver,12,7,5
24549,Onlyfistss,illidan,670,monk,mistweaver,12,7,5
24550,Jianrèn,wyrmrest-accord,670,monk,mistweaver,12,7,5
24551,Microdose,blackrock,670,monk,mistweaver,18,7,11
24552,Khaldi,tichondrius,670,monk,mistweaver,19,7,12
24553,Pandaranga,saurfang,670,monk,mistweaver,28,8,20
24554,Runkfyr,ragnaros,670,monk,mistweaver,30,7,23
24555,Nymchi,stormrage,669,monk,mistweaver,12,7,5
24556,Unlemike,runetotem,669,monk,mistweaver,12,7,5
24557,Tzidkiyahu,barthilas,669,monk,mistweaver,12,7,5
24558,Melyodis,thrall,669,monk,mistweaver,18,7,11
24559,Absolutvodca,nemesis,669,monk,mistweaver,24,7,17
24560,Ügway,azralon,669,monk,mistweaver,30,7,23
24561,Gímley,bleeding-hollow,667,monk,mistweaver,12,7,5
24562,Balooballs,frostmourne,667,monk,mistweaver,18,7,11
24563,Shihfu,azralon,667,monk,mistweaver,24,7,17
24564,Dornix,illidan,664,monk,mistweaver,18,7,11
24565,Wetspaghetti,malganis,661,monk,mistweaver,18,7,11
24566,Munchan,hyjal,654,monk,mistweaver,11,9,2
24567,Akfourseven,barthilas,645,monk,mistweaver,72,32,40
24568,Karu,barthilas,639,monk,mistweaver,18,8,10
24569,Rènh,ragnaros,639,monk,mistweaver,17,7,10
24570,Reflexsivex,malganis,638,monk,mistweaver,11,7,4
24571,Tomaz,nazjatar,632,monk,mistweaver,11,7,4
24572,Saucyfists,silvermoon,624,monk,mistweaver,15,8,7
24573,Sourcandyx,area-52,624,monk,mistweaver,15,7,8
24574,Berzerk,dalvengyr,624,monk,mistweaver,15,7,8
24575,Blessedbalor,tichondrius,624,monk,mistweaver,21,7,14
24576,Praydoh,tichondrius,623,monk,mistweaver,11,7,4
24577,Jetchi,proudmoore,623,monk,mistweaver,11,7,4
24578,Azz,barthilas,623,monk,mistweaver,11,7,4
24579,Aerona,stormreaver,617,monk,mistweaver,12,8,4
24580,Mistyheals,emerald-dream,617,monk,mistweaver,17,10,7
24581,Jayjaybrew,area-52,615,monk,mistweaver,22,8,14
24582,Happymonk,tichondrius,613,monk,mistweaver,43,8,35
24583,Pandica,kiljaeden,607,monk,mistweaver,11,7,4
24584,Robochöp,emerald-dream,606,monk,mistweaver,14,7,7
24585,Monjepa,illidan,604,monk,mistweaver,20,7,13
24586,Pandamoanda,azgalor,593,monk,mistweaver,16,7,9
24587,Reoc,bleeding-hollow,592,monk,mistweaver,13,7,6
24588,Kruxx,anvilmar,576,monk,mistweaver,6,6,0
24589,Bdâwg,frostmourne,576,monk,mistweaver,6,6,0
24590,Watty,zuljin,576,monk,mistweaver,6,6,0
24591,Minivanmom,illidan,576,monk,mistweaver,6,6,0
24592,Ozáí,illidan,576,monk,mistweaver,6,6,0
24593,Munkï,tichondrius,576,monk,mistweaver,6,6,0
24594,Chrîstmas,proudmoore,576,monk,mistweaver,6,6,0
24595,Jg,staghelm,576,monk,mistweaver,6,6,0
24596,Kryptoniko,illidan,576,monk,mistweaver,6,6,0
24597,Larkssmw,zuljin,576,monk,mistweaver,6,6,0
24598,Søck,malfurion,576,monk,mistweaver,6,6,0
24599,Dracc,zuljin,576,monk,mistweaver,12,6,6
24600,Sekushî,kelthuzad,576,monk,mistweaver,12,6,6
24601,Kaztíel,ragnaros,576,monk,mistweaver,12,6,6
24602,Wuwei,onyxia,576,monk,mistweaver,12,6,6
24603,Emerald,emerald-dream,576,monk,mistweaver,12,6,6
24604,Meisterbrew,garona,576,monk,mistweaver,12,6,6
24605,Eightpoint,illidan,576,monk,mistweaver,12,6,6
24606,Daarl,burning-blade,576,monk,mistweaver,12,6,6
24607,Até,azralon,576,monk,mistweaver,12,6,6
24608,Tunchii,sargeras,576,monk,mistweaver,12,6,6
24609,Ñightingale,queldorei,576,monk,mistweaver,12,6,6
24610,Transcend,nerzhul,576,monk,mistweaver,12,6,6
24611,Underpants,skullcrusher,576,monk,mistweaver,12,6,6
24612,Wèave,tichondrius,576,monk,mistweaver,12,6,6
24613,Dreamfist,emerald-dream,576,monk,mistweaver,12,6,6
24614,Mtsalt,bleeding-hollow,576,monk,mistweaver,12,6,6
24615,Ryukenshin,proudmoore,576,monk,mistweaver,12,6,6
24616,Frésa,ragnaros,576,monk,mistweaver,12,6,6
24617,Magnustavick,bleeding-hollow,576,monk,mistweaver,12,6,6
24618,Mënmä,ragnaros,576,monk,mistweaver,12,6,6
24619,Lackofsleep,tichondrius,576,monk,mistweaver,12,6,6
24620,Silkymoves,tichondrius,576,monk,mistweaver,12,6,6
24621,Zchi,zuljin,576,monk,mistweaver,12,6,6
24622,Dgmonk,tichondrius,576,monk,mistweaver,12,6,6
24623,Zeshmo,firetree,576,monk,mistweaver,12,6,6
24624,Flfltmfrl,tichondrius,576,monk,mistweaver,12,6,6
24625,Gnomshini,proudmoore,576,monk,mistweaver,12,6,6
24626,Boppweave,tichondrius,576,monk,mistweaver,12,6,6
24627,Cerrado,emerald-dream,576,monk,mistweaver,12,6,6
24628,Bearmode,wyrmrest-accord,576,monk,mistweaver,12,6,6
24629,Brujitsu,thrall,576,monk,mistweaver,12,6,6
24630,Dungfish,mugthol,576,monk,mistweaver,12,6,6
24631,Steyi,nazjatar,576,monk,mistweaver,12,6,6
24632,Shaqkobe,area-52,576,monk,mistweaver,12,6,6
24633,Jieterchan,malganis,576,monk,mistweaver,12,6,6
24634,Broyoulined,spirestone,576,monk,mistweaver,12,6,6
24635,Jbg,staghelm,576,monk,mistweaver,12,6,6
24636,Lumiän,area-52,576,monk,mistweaver,12,6,6
24637,Rajile,sargeras,576,monk,mistweaver,12,6,6
24638,Aerlin,tichondrius,576,monk,mistweaver,12,6,6
24639,Karrigwyn,tichondrius,576,monk,mistweaver,12,6,6
24640,Caradlevinge,ragnaros,576,monk,mistweaver,12,6,6
24641,Faccemelter,illidan,576,monk,mistweaver,12,6,6
24642,Imakeplaysyo,illidan,576,monk,mistweaver,12,6,6
24643,Bamboozïe,arthas,576,monk,mistweaver,12,6,6
24644,Trins,azjolnerub,576,monk,mistweaver,12,6,6
24645,Janim,illidan,576,monk,mistweaver,12,6,6
24646,Mesak,ragnaros,576,monk,mistweaver,15,7,8
24647,Simarity,kelthuzad,576,monk,mistweaver,18,6,12
24648,Tragictea,zuljin,576,monk,mistweaver,18,6,12
24649,Fistweebin,area-52,576,monk,mistweaver,18,6,12
24650,Hugerichard,wyrmrest-accord,576,monk,mistweaver,18,6,12
24651,Rollsrice,area-52,576,monk,mistweaver,18,6,12
24652,Chingwang,frostmourne,576,monk,mistweaver,18,6,12
24653,Mwgapper,sargeras,576,monk,mistweaver,18,6,12
24654,Tohkmonk,crushridge,575,monk,mistweaver,6,6,0
24655,Shabudinetz,stormrage,575,monk,mistweaver,6,6,0
24656,Itsjohnnylol,azuremyst,575,monk,mistweaver,12,6,6
24657,Sknypicho,malganis,575,monk,mistweaver,12,6,6
24658,Xinn,kiljaeden,575,monk,mistweaver,12,6,6
24659,Agrïppa,caelestrasz,575,monk,mistweaver,12,6,6
24660,Compacier,illidan,575,monk,mistweaver,12,6,6
24661,Rocketfist,bleeding-hollow,575,monk,mistweaver,12,6,6
24662,Misha,akama,575,monk,mistweaver,12,6,6
24663,Criarla,tichondrius,575,monk,mistweaver,12,6,6
24664,Almondmïlk,bonechewer,575,monk,mistweaver,12,6,6
24665,Myrsken,area-52,575,monk,mistweaver,12,6,6
24666,Putisucia,nordrassil,575,monk,mistweaver,12,6,6
24667,Morhe,the-forgotten-coast,575,monk,mistweaver,12,6,6
24668,Soysaucë,malganis,575,monk,mistweaver,12,6,6
24669,Salindrena,thrall,575,monk,mistweaver,12,6,6
24670,Nf,zuljin,575,monk,mistweaver,12,6,6
24671,Freeoni,sargeras,575,monk,mistweaver,12,6,6
24672,Glitchi,area-52,575,monk,mistweaver,12,6,6
24673,Liucang,archimonde,575,monk,mistweaver,12,6,6
24674,Miso,nathrezim,575,monk,mistweaver,12,6,6
24675,Clytpuncher,emerald-dream,575,monk,mistweaver,12,6,6
24676,Zargtruth,proudmoore,575,monk,mistweaver,12,6,6
24677,Hibìscus,tichondrius,575,monk,mistweaver,12,6,6
24678,Laopow,area-52,575,monk,mistweaver,12,6,6
24679,Buttfists,stormrage,575,monk,mistweaver,12,6,6
24680,Ormchi,stormrage,575,monk,mistweaver,13,6,7
24681,Opmother,elune,575,monk,mistweaver,18,6,12
24682,Fortyozkilla,thrall,575,monk,mistweaver,18,6,12
24683,Freepunchz,frostmourne,575,monk,mistweaver,18,6,12
24684,Beatboxblues,skullcrusher,574,monk,mistweaver,12,6,6
24685,Yanedin,dalaran,574,monk,mistweaver,12,6,6
24686,Cornfist,zuljin,573,monk,mistweaver,12,6,6
24687,Dokuho,silvermoon,572,monk,mistweaver,12,6,6
24688,Mënace,skullcrusher,572,monk,mistweaver,12,6,6
24689,Gaturis,tichondrius,572,monk,mistweaver,21,7,14
24690,Paladinei,tichondrius,571,monk,mistweaver,12,6,6
24691,Samanosukee,illidan,571,monk,mistweaver,12,6,6
24692,Bógus,tichondrius,571,monk,mistweaver,12,6,6
24693,Keekismonk,gorefiend,566,monk,mistweaver,12,6,6
24694,Dejohnette,quelthalas,565,monk,mistweaver,12,6,6
24695,Boofie,perenolde,559,monk,mistweaver,11,6,5
24696,Gyunyumanjuu,proudmoore,559,monk,mistweaver,11,6,5
24697,Sohéi,proudmoore,559,monk,mistweaver,17,6,11
24698,Fiztingfaded,area-52,551,monk,mistweaver,26,9,17
24699,Ñoobmonk,tichondrius,543,monk,mistweaver,11,6,5
24700,Saltyone,firetree,543,monk,mistweaver,14,7,7
24701,Bigolagile,velen,537,monk,mistweaver,22,6,16
24702,Tøåst,illidan,527,monk,mistweaver,11,6,5
24703,Rakesh,azralon,525,monk,mistweaver,9,7,2
24704,Yuløn,illidan,511,monk,mistweaver,8,6,2
24705,Räyè,tichondrius,511,monk,mistweaver,8,6,2
24706,Oldmanwalker,mannoroth,511,monk,mistweaver,11,6,5
24707,Chickntendys,sargeras,511,monk,mistweaver,11,6,5
24708,Feihung,executus,511,monk,mistweaver,11,6,5
24709,Tbrew,area-52,511,monk,mistweaver,14,6,8
24710,Figurines,sargeras,496,monk,mistweaver,19,6,13
24711,Roskoh,area-52,493,monk,mistweaver,19,6,13
24712,Danwunwolf,tichondrius,480,monk,mistweaver,6,5,1
24713,Dbmmonk,malganis,480,monk,mistweaver,6,5,1
24714,Meepz,arthas,480,monk,mistweaver,6,5,1
24715,Pinot,dragonmaw,480,monk,mistweaver,6,5,1
24716,Yuldaddy,tichondrius,480,monk,mistweaver,6,5,1
24717,Spicym,proudmoore,480,monk,mistweaver,6,5,1
24718,Ceronash,dalaran,480,monk,mistweaver,6,5,1
24719,Theodôn,dalaran,480,monk,mistweaver,6,5,1
24720,Ninjaheals,spirestone,480,monk,mistweaver,6,5,1
24721,Donatello,arthas,480,monk,mistweaver,6,5,1
24722,Grumpî,tichondrius,480,monk,mistweaver,6,5,1
24723,Jurassaf,illidan,480,monk,mistweaver,6,5,1
24724,Thegreentaco,tichondrius,480,monk,mistweaver,6,5,1
24725,Shandilla,proudmoore,480,monk,mistweaver,6,5,1
24726,Satiremaster,frostmourne,480,monk,mistweaver,6,5,1
24727,Getswept,area-52,480,monk,mistweaver,6,5,1
24728,Stepfíster,tichondrius,480,monk,mistweaver,6,5,1
24729,Serénity,kiljaeden,480,monk,mistweaver,6,5,1
24730,Alvinete,tichondrius,480,monk,mistweaver,6,5,1
24731,Zammymonk,area-52,480,monk,mistweaver,6,5,1
24732,Pyoapple,tichondrius,480,monk,mistweaver,6,5,1
24733,Mongénoìo,nemesis,480,monk,mistweaver,6,5,1
24734,Yajirobei,area-52,480,monk,mistweaver,6,5,1
24735,Møzy,tichondrius,480,monk,mistweaver,6,5,1
24736,Nickimínaj,illidan,480,monk,mistweaver,6,5,1
24737,Zuchi,barthilas,480,monk,mistweaver,6,5,1
24738,Kayflock,tichondrius,480,monk,mistweaver,6,5,1
24739,Dirtysmonk,mugthol,480,monk,mistweaver,6,5,1
24740,Blackmist,khazgoroth,480,monk,mistweaver,6,5,1
24741,Siddharthä,barthilas,480,monk,mistweaver,6,5,1
24742,Genia,ragnaros,480,monk,mistweaver,6,5,1
24743,Chifang,elune,480,monk,mistweaver,6,5,1
24744,Rivnn,sargeras,480,monk,mistweaver,6,5,1
24745,Mistwalk,tichondrius,480,monk,mistweaver,6,5,1
24746,Pandatong,tichondrius,480,monk,mistweaver,6,5,1
24747,Touchoftism,proudmoore,480,monk,mistweaver,6,5,1
24748,Khidda,barthilas,480,monk,mistweaver,6,5,1
24749,Choibaedal,tichondrius,480,monk,mistweaver,7,5,2
24750,Ouibaguette,kelthuzad,480,monk,mistweaver,12,5,7
24751,Otzyy,turalyon,480,monk,mistweaver,12,5,7
24752,Judo,khadgar,480,monk,mistweaver,12,5,7
24753,Gnarmony,malganis,480,monk,mistweaver,12,5,7
24754,Snooky,kiljaeden,480,monk,mistweaver,12,5,7
24755,Whipllash,tichondrius,480,monk,mistweaver,12,5,7
24756,Zlatân,sargeras,480,monk,mistweaver,12,5,7
24757,Amybaby,sargeras,480,monk,mistweaver,12,5,7
24758,Chronost,sargeras,480,monk,mistweaver,12,5,7
24759,Palumorww,deathwing,480,monk,mistweaver,12,5,7
24760,Thehomìe,tichondrius,480,monk,mistweaver,12,5,7
24761,Piece,blackrock,480,monk,mistweaver,12,5,7
24762,Rzeznik,boulderfist,480,monk,mistweaver,12,5,7
24763,Mythsmonkx,barthilas,480,monk,mistweaver,12,5,7
24764,Kimjongkick,sargeras,480,monk,mistweaver,12,5,7
24765,Cloudl,silvermoon,480,monk,mistweaver,12,5,7
24766,Zenwyatt,area-52,480,monk,mistweaver,12,5,7
24767,Bigolbootay,tichondrius,480,monk,mistweaver,12,5,7
24768,Mistymarc,zuljin,480,monk,mistweaver,12,5,7
24769,Nîxs,frostmourne,480,monk,mistweaver,12,5,7
24770,Btipton,tichondrius,480,monk,mistweaver,12,5,7
24771,Joggï,stormrage,480,monk,mistweaver,12,5,7
24772,Khadfu,sargeras,480,monk,mistweaver,12,5,7
24773,Kaiøken,tichondrius,480,monk,mistweaver,12,5,7
24774,Touchofdell,illidan,480,monk,mistweaver,12,5,7
24775,Brewtari,whisperwind,480,monk,mistweaver,12,5,7
24776,Odradek,thunderlord,480,monk,mistweaver,12,5,7
24777,Rawmonk,malganis,480,monk,mistweaver,12,5,7
24778,Serpp,kelthuzad,480,monk,mistweaver,12,5,7
24779,Cannenmonk,sargeras,480,monk,mistweaver,12,5,7
24780,Onak,illidan,480,monk,mistweaver,12,5,7
24781,Biggyballs,tichondrius,480,monk,mistweaver,12,5,7
24782,Jumexo,sargeras,480,monk,mistweaver,12,5,7
24783,Eraticmonk,illidan,480,monk,mistweaver,12,5,7
24784,Guerrero,tichondrius,480,monk,mistweaver,12,5,7
24785,Xavelha,tichondrius,480,monk,mistweaver,12,5,7
24786,Crìstiano,malganis,480,monk,mistweaver,12,5,7
24787,Linxiss,tichondrius,480,monk,mistweaver,12,5,7
24788,Wdsprdpanic,tichondrius,480,monk,mistweaver,12,5,7
24789,Ìsrael,sargeras,480,monk,mistweaver,12,5,7
24790,Vashnir,lothar,480,monk,mistweaver,12,5,7
24791,Ariss,ragnaros,480,monk,mistweaver,12,5,7
24792,Kungfused,antonidas,480,monk,mistweaver,12,5,7
24793,Masonn,kiljaeden,480,monk,mistweaver,12,5,7
24794,Zarrend,stormrage,480,monk,mistweaver,12,5,7
24795,Xiaotaimei,frostmourne,480,monk,mistweaver,12,5,7
24796,Bruiseu,illidan,480,monk,mistweaver,18,5,13
24797,Sna,dragonmaw,480,monk,mistweaver,18,5,13
24798,Blackflag,queldorei,480,monk,mistweaver,18,5,13
24799,Skyrim,tichondrius,480,monk,mistweaver,18,5,13
24800,Sagapunch,hyjal,480,monk,mistweaver,18,5,13
24801,Duckpond,nerzhul,480,monk,mistweaver,18,5,13
24802,Màngø,ragnaros,480,monk,mistweaver,24,5,19
24803,Cckknckr,sargeras,480,monk,mistweaver,24,5,19
24804,Monqq,tichondrius,479,monk,mistweaver,6,5,1
24805,Badkarmasix,tichondrius,479,monk,mistweaver,6,5,1
24806,Chimpo,ragnaros,479,monk,mistweaver,12,5,7
24807,Qi,draktharon,479,monk,mistweaver,12,5,7
24808,Bitrau,destromath,479,monk,mistweaver,12,5,7
24809,Paticus,area-52,479,monk,mistweaver,12,5,7
24810,Tianhu,sargeras,479,monk,mistweaver,12,5,7
24811,Troutz,sargeras,479,monk,mistweaver,12,5,7
24812,Annara,tichondrius,479,monk,mistweaver,12,5,7
24813,Wisepaw,tichondrius,479,monk,mistweaver,12,5,7
24814,Satchelgizmo,tichondrius,479,monk,mistweaver,18,5,13
24815,Westchi,arthas,479,monk,mistweaver,18,5,13
24816,Manxxin,illidan,479,monk,mistweaver,18,5,13
24817,Ltsneaky,bladefist,479,monk,mistweaver,30,5,25
24818,Shmello,akama,478,monk,mistweaver,6,5,1
24819,Jb,burning-blade,478,monk,mistweaver,12,5,7
24820,Moojìtsu,stormrage,478,monk,mistweaver,12,5,7
24821,Cahuun,baelgun,478,monk,mistweaver,12,5,7
24822,Anußisito,stormrage,478,monk,mistweaver,18,5,13
24823,Tutulee,tichondrius,477,monk,mistweaver,6,5,1
24824,Doicare,tichondrius,477,monk,mistweaver,12,5,7
24825,Sputnîk,nemesis,468,monk,mistweaver,22,10,12
24826,Yungsun,ragnaros,463,monk,mistweaver,13,6,7
24827,Drgigglez,tichondrius,463,monk,mistweaver,11,5,6
24828,Zønnis,zuljin,448,monk,mistweaver,10,6,4
24829,Jentmonk,tichondrius,448,monk,mistweaver,10,5,5
24830,Majinyooshi,kelthuzad,448,monk,mistweaver,10,5,5
24831,Moistspot,frostmourne,447,monk,mistweaver,8,6,2
24832,Scoopyafupa,illidan,447,monk,mistweaver,8,6,2
24833,Graoul,thaurissan,447,monk,mistweaver,11,5,6
24834,Drizzimonk,thrall,447,monk,mistweaver,11,5,6
24835,Summersoup,zuljin,447,monk,mistweaver,11,5,6
24836,Bengal,arthas,447,monk,mistweaver,11,5,6
24837,Indrazzxx,jubeithos,426,monk,mistweaver,11,7,4
24838,Bellátíx,quelthalas,426,monk,mistweaver,17,9,8
24839,Mindengo,sargeras,426,monk,mistweaver,15,7,8
24840,Yinlong,illidan,416,monk,mistweaver,10,5,5
24841,Durath,burning-blade,415,monk,mistweaver,10,5,5
24842,Nikitip,tichondrius,384,monk,mistweaver,6,4,2
24843,Raires,tichondrius,384,monk,mistweaver,6,4,2
24844,Chopana,malganis,384,monk,mistweaver,6,4,2
24845,Renzin,gilneas,384,monk,mistweaver,6,4,2
24846,Tinyboots,area-52,384,monk,mistweaver,6,4,2
24847,Sunnfistway,sargeras,384,monk,mistweaver,6,4,2
24848,Scovillah,emerald-dream,384,monk,mistweaver,6,4,2
24849,Justamönk,moon-guard,384,monk,mistweaver,6,4,2
24850,Snmonk,illidan,384,monk,mistweaver,6,4,2
24851,Chopsake,khadgar,384,monk,mistweaver,6,4,2
24852,Fistfyre,kiljaeden,384,monk,mistweaver,6,4,2
24853,Brucetea,chogall,384,monk,mistweaver,6,4,2
24854,Keepcryin,gorefiend,384,monk,mistweaver,6,4,2
24855,Ufs,illidan,384,monk,mistweaver,6,4,2
24856,Snoogiee,khazgoroth,384,monk,mistweaver,6,4,2
24857,Monkinator,anvilmar,384,monk,mistweaver,6,4,2
24858,Alshee,nagrand,384,monk,mistweaver,6,4,2
24859,Saren,nordrassil,384,monk,mistweaver,6,4,2
24860,Doodoodookie,thunderhorn,384,monk,mistweaver,6,4,2
24861,Vetism,thrall,384,monk,mistweaver,6,4,2
24862,Blpkosher,tichondrius,384,monk,mistweaver,6,4,2
24863,Talker,stormrage,384,monk,mistweaver,6,4,2
24864,Treysongz,illidan,384,monk,mistweaver,6,4,2
24865,Howziexd,tichondrius,384,monk,mistweaver,6,4,2
24866,Avendare,tichondrius,384,monk,mistweaver,6,4,2
24867,Healkinxo,tichondrius,384,monk,mistweaver,6,4,2
24868,Zamzae,tichondrius,384,monk,mistweaver,6,4,2
24869,Balduglybaby,tichondrius,384,monk,mistweaver,6,4,2
24870,Macnia,frostmourne,384,monk,mistweaver,6,4,2
24871,Levoz,area-52,384,monk,mistweaver,6,4,2
24872,Kharazina,azralon,384,monk,mistweaver,6,4,2
24873,Shakeweightt,blackrock,384,monk,mistweaver,6,4,2
24874,Tic,barthilas,384,monk,mistweaver,6,4,2
24875,Põng,tichondrius,384,monk,mistweaver,6,4,2
24876,Kwazinator,area-52,384,monk,mistweaver,6,4,2
24877,Nipfuu,maelstrom,384,monk,mistweaver,6,4,2
24878,Jâzze,zuljin,384,monk,mistweaver,6,4,2
24879,Throws,stormrage,384,monk,mistweaver,6,4,2
24880,Bháv,tichondrius,384,monk,mistweaver,6,4,2
24881,Dude,tichondrius,384,monk,mistweaver,6,4,2
24882,Kruznîk,illidan,384,monk,mistweaver,6,4,2
24883,Drchake,quelthalas,384,monk,mistweaver,6,4,2
24884,Kokochiggy,tichondrius,384,monk,mistweaver,6,4,2
24885,Lyla,aegwynn,384,monk,mistweaver,6,4,2
24886,Kàdè,dalaran,384,monk,mistweaver,6,4,2
24887,Keyndanlamor,sargeras,384,monk,mistweaver,6,4,2
24888,Punteeftw,sargeras,384,monk,mistweaver,6,4,2
24889,Danie,nerzhul,384,monk,mistweaver,6,4,2
24890,Kennjin,spinebreaker,384,monk,mistweaver,6,4,2
24891,Dakism,sargeras,384,monk,mistweaver,6,4,2
24892,Glorioushole,area-52,384,monk,mistweaver,6,4,2
24893,Beersmonk,tichondrius,384,monk,mistweaver,6,4,2
24894,Rizzjutsu,stormrage,384,monk,mistweaver,6,4,2
24895,Lingerer,aerie-peak,384,monk,mistweaver,6,4,2
24896,Stellae,emerald-dream,384,monk,mistweaver,10,5,5
24897,Plopnspheres,arthas,384,monk,mistweaver,10,4,6
24898,Rìzzo,tichondrius,384,monk,mistweaver,12,4,8
24899,Mõnk,illidan,384,monk,mistweaver,12,4,8
24900,Yunei,tichondrius,384,monk,mistweaver,12,4,8
24901,Pandàmonium,frostmourne,384,monk,mistweaver,12,4,8
24902,Jincíe,area-52,384,monk,mistweaver,12,4,8
24903,Mccoy,quelthalas,384,monk,mistweaver,12,4,8
24904,Sim,frostmourne,384,monk,mistweaver,12,4,8
24905,Zënløvë,tichondrius,384,monk,mistweaver,12,4,8
24906,Hoyocochino,quelthalas,384,monk,mistweaver,12,4,8
24907,Galsello,moon-guard,384,monk,mistweaver,12,4,8
24908,Pax,boulderfist,384,monk,mistweaver,12,4,8
24909,Frankènmonk,illidan,384,monk,mistweaver,12,4,8
24910,Lazy,shattered-halls,384,monk,mistweaver,12,4,8
24911,Crakgirl,malganis,384,monk,mistweaver,12,4,8
24912,Mockz,dentarg,384,monk,mistweaver,12,4,8
24913,Macktickle,zuljin,384,monk,mistweaver,12,4,8
24914,Nicolascåge,destromath,384,monk,mistweaver,12,4,8
24915,Fistorcstar,daggerspine,384,monk,mistweaver,12,4,8
24916,Darkeiji,stormrage,384,monk,mistweaver,12,4,8
24917,Jimbojenkins,bleeding-hollow,384,monk,mistweaver,12,4,8
24918,Shredmw,tichondrius,384,monk,mistweaver,12,4,8
24919,Neversweep,tichondrius,384,monk,mistweaver,12,4,8
24920,Migchi,sargeras,384,monk,mistweaver,12,4,8
24921,Nutbag,norgannon,384,monk,mistweaver,12,4,8
24922,Darylphilbin,emerald-dream,384,monk,mistweaver,12,4,8
24923,Fluffykaboom,destromath,384,monk,mistweaver,12,4,8
24924,Valkana,kelthuzad,384,monk,mistweaver,12,4,8
24925,Sprinkli,sargeras,384,monk,mistweaver,12,4,8
24926,Windwalken,sargeras,384,monk,mistweaver,12,4,8
24927,Greentea,kaelthas,384,monk,mistweaver,12,4,8
24928,Tanipto,tichondrius,384,monk,mistweaver,12,4,8
24929,Mingfei,uther,384,monk,mistweaver,12,4,8
24930,Iamapotato,tichondrius,384,monk,mistweaver,18,4,14
24931,Therivermist,tichondrius,383,monk,mistweaver,6,4,2
24932,Tsukuyômi,thrall,383,monk,mistweaver,6,4,2
24933,Esleif,moonrunner,383,monk,mistweaver,12,4,8
24934,Fvl,barthilas,383,monk,mistweaver,12,4,8
24935,Zyemell,tichondrius,383,monk,mistweaver,12,4,8
24936,Biggddaddy,thaurissan,383,monk,mistweaver,12,4,8
24937,Jigong,bleeding-hollow,383,monk,mistweaver,12,4,8
24938,Izgoku,frostmane,383,monk,mistweaver,18,4,14
24939,Rollbot,kelthuzad,382,monk,mistweaver,6,4,2
24940,Drzoid,thrall,382,monk,mistweaver,12,4,8
24941,Baaron,sargeras,382,monk,mistweaver,12,4,8
24942,Taintickler,stormrage,382,monk,mistweaver,18,4,14
24943,Sence,lightnings-blade,382,monk,mistweaver,18,4,14
24944,Kurrama,twisting-nether,381,monk,mistweaver,12,4,8
24945,Jeme,tichondrius,379,monk,mistweaver,12,4,8
24946,Sáble,stormrage,351,monk,mistweaver,11,4,7
24947,Daddywarpig,tichondrius,336,monk,mistweaver,9,4,5
24948,Zhihua,moon-guard,336,monk,mistweaver,21,4,17
24949,ßiggiesmallz,barthilas,330,monk,mistweaver,12,5,7
24950,Stunnedheals,arthas,330,monk,mistweaver,16,5,11
24951,Xiaovega,dalaran,329,monk,mistweaver,16,5,11
24952,Kimchidelite,gorefiend,319,monk,mistweaver,5,4,1
24953,Hauntings,hellscream,319,monk,mistweaver,5,4,1
24954,Hundski,bleeding-hollow,288,monk,mistweaver,6,3,3
24955,Densíty,kiljaeden,288,monk,mistweaver,6,3,3
24956,Psii,the-venture-co,288,monk,mistweaver,6,3,3
24957,Rasgacrú,stormrage,288,monk,mistweaver,6,3,3
24958,Madson,darkspear,288,monk,mistweaver,6,3,3
24959,Maybeyooshi,kelthuzad,288,monk,mistweaver,6,3,3
24960,Zóë,korgath,288,monk,mistweaver,6,3,3
24961,Flakkon,hyjal,288,monk,mistweaver,6,3,3
24962,Monkgodx,tichondrius,288,monk,mistweaver,6,3,3
24963,Ighostgirls,thrall,288,monk,mistweaver,6,3,3
24964,ßöe,sargeras,288,monk,mistweaver,6,3,3
24965,Dedmk,azralon,288,monk,mistweaver,6,3,3
24966,Leeleeyong,tichondrius,288,monk,mistweaver,6,3,3
24967,Cashina,azralon,288,monk,mistweaver,6,3,3
24968,Austaar,frostmourne,288,monk,mistweaver,6,3,3
24969,Facekandy,tichondrius,288,monk,mistweaver,6,3,3
24970,Macproblem,malganis,288,monk,mistweaver,6,3,3
24971,Teclas,ragnaros,288,monk,mistweaver,6,3,3
24972,Thiccstroke,illidan,288,monk,mistweaver,6,3,3
24973,Monaks,barthilas,288,monk,mistweaver,6,3,3
24974,Lemeta,tichondrius,288,monk,mistweaver,6,3,3
24975,Ðreadhot,malganis,288,monk,mistweaver,6,3,3
24976,Mustard,arthas,288,monk,mistweaver,6,3,3
24977,Marçi,moon-guard,288,monk,mistweaver,6,3,3
24978,Mystï,silvermoon,288,monk,mistweaver,6,3,3
24979,Smungus,bloodscalp,288,monk,mistweaver,6,3,3
24980,Polyphia,lothar,288,monk,mistweaver,6,3,3
24981,Bakanani,magtheridon,288,monk,mistweaver,6,3,3
24982,Lyántrying,korgath,288,monk,mistweaver,6,3,3
24983,Tambher,lightbringer,288,monk,mistweaver,6,3,3
24984,Grogio,wyrmrest-accord,288,monk,mistweaver,6,3,3
24985,Greenteafrãp,bleeding-hollow,288,monk,mistweaver,6,3,3
24986,Darches,quelthalas,288,monk,mistweaver,6,3,3
24987,Voguex,area-52,288,monk,mistweaver,6,3,3
24988,Fammi,stormrage,288,monk,mistweaver,6,3,3
24989,Streetcreds,bleeding-hollow,288,monk,mistweaver,6,3,3
24990,Feelsogöod,tichondrius,288,monk,mistweaver,6,3,3
24991,Dkdakìng,stormrage,288,monk,mistweaver,6,3,3
24992,Yoshimiitsu,bleeding-hollow,288,monk,mistweaver,6,3,3
24993,Zamerà,bleeding-hollow,288,monk,mistweaver,6,3,3
24994,Jutsu,moon-guard,288,monk,mistweaver,6,3,3
24995,Giggacuck,frostmourne,288,monk,mistweaver,6,3,3
24996,Seii,ravenholdt,288,monk,mistweaver,6,3,3
24997,Furrykisser,tichondrius,288,monk,mistweaver,6,3,3
24998,Seshiro,area-52,288,monk,mistweaver,6,3,3
24999,Quartztiger,sargeras,288,monk,mistweaver,6,3,3
25000,Notcheez,area-52,288,monk,mistweaver,6,3,3
25001,Növa,alterac-mountains,288,monk,mistweaver,6,3,3
25002,Hooverphonic,ragnaros,288,monk,mistweaver,6,3,3
25003,Dbgzx,illidan,288,monk,mistweaver,6,3,3
25004,Droppinfast,sargeras,288,monk,mistweaver,6,3,3
25005,Nomonko,tichondrius,288,monk,mistweaver,6,3,3
25006,Swansational,sargeras,288,monk,mistweaver,6,3,3
25007,Fistin,laughing-skull,288,monk,mistweaver,6,3,3
25008,Spiritmist,sargeras,288,monk,mistweaver,6,3,3
25009,Spacoli,stormrage,288,monk,mistweaver,6,3,3
25010,Foxjade,thrall,288,monk,mistweaver,6,3,3
25011,Kotonnoha,quelthalas,288,monk,mistweaver,6,3,3
25012,Chayim,wyrmrest-accord,288,monk,mistweaver,6,3,3
25013,Lundch,tichondrius,288,monk,mistweaver,6,3,3
25014,Vidrus,gorefiend,288,monk,mistweaver,6,3,3
25015,Chingu,ragnaros,288,monk,mistweaver,6,3,3
25016,Tunaroll,tichondrius,288,monk,mistweaver,6,3,3
25017,Baelmao,wyrmrest-accord,288,monk,mistweaver,6,3,3
25018,Bosschops,illidan,288,monk,mistweaver,6,3,3
25019,Lightweaving,norgannon,288,monk,mistweaver,6,3,3
25020,Stigzz,stormrage,288,monk,mistweaver,6,3,3
25021,Vasera,moon-guard,288,monk,mistweaver,6,3,3
25022,Fysicalx,stormrage,288,monk,mistweaver,6,3,3
25023,Mipkek,saurfang,288,monk,mistweaver,6,3,3
25024,Möösê,moon-guard,288,monk,mistweaver,6,3,3
25025,Miýagi,sargeras,288,monk,mistweaver,6,3,3
25026,Aphrodîîte,area-52,288,monk,mistweaver,6,3,3
25027,Arinix,tichondrius,288,monk,mistweaver,6,3,3
25028,Cädemaddöx,stormrage,288,monk,mistweaver,6,3,3
25029,Omnivò,emerald-dream,288,monk,mistweaver,6,3,3
25030,Quander,tichondrius,288,monk,mistweaver,6,3,3
25031,Gguldduck,tichondrius,288,monk,mistweaver,6,3,3
25032,Kayla,ursin,288,monk,mistweaver,6,3,3
25033,Ase,frostwolf,288,monk,mistweaver,6,3,3
25034,Zzizzi,tichondrius,288,monk,mistweaver,6,3,3
25035,Skâ,kiljaeden,288,monk,mistweaver,6,3,3
25036,Imisswodxo,illidan,288,monk,mistweaver,6,3,3
25037,Duckingkarma,tichondrius,288,monk,mistweaver,6,3,3
25038,Zaçh,frostmane,288,monk,mistweaver,6,3,3
25039,Backup,lothar,288,monk,mistweaver,11,4,7
25040,Kúrios,azralon,288,monk,mistweaver,10,3,7
25041,Dreadneck,sargeras,288,monk,mistweaver,12,3,9
25042,Chilliweaver,frostmourne,288,monk,mistweaver,12,3,9
25043,Øtpp,sargeras,288,monk,mistweaver,12,3,9
25044,Porkmist,icecrown,288,monk,mistweaver,12,3,9
25045,Gentlefists,sargeras,288,monk,mistweaver,12,3,9
25046,Fitofryfitof,aegwynn,288,monk,mistweaver,12,3,9
25047,Mwtouch,nemesis,288,monk,mistweaver,12,3,9
25048,Selfîe,ysera,288,monk,mistweaver,12,3,9
25049,Mistabrew,frostmourne,288,monk,mistweaver,12,3,9
25050,Wizcaulifa,stormrage,288,monk,mistweaver,12,3,9
25051,Wørm,emerald-dream,288,monk,mistweaver,12,3,9
25052,Katalina,alexstrasza,288,monk,mistweaver,12,3,9
25053,Hixemonk,illidan,288,monk,mistweaver,12,3,9
25054,Korvishka,malganis,288,monk,mistweaver,12,3,9
25055,Aokuang,malganis,288,monk,mistweaver,21,4,17
25056,Imakiya,tichondrius,288,monk,mistweaver,17,3,14
25057,Holandri,moon-guard,287,monk,mistweaver,6,3,3
25058,Iarw,tichondrius,287,monk,mistweaver,6,3,3
25059,Gatsbi,arthas,287,monk,mistweaver,6,3,3
25060,Alanimistw,khadgar,287,monk,mistweaver,6,3,3
25061,Pikafist,tichondrius,287,monk,mistweaver,6,3,3
25062,Starskreem,tichondrius,287,monk,mistweaver,6,3,3
25063,Deyseddia,azgalor,287,monk,mistweaver,6,3,3
25064,Fistidmi,area-52,287,monk,mistweaver,11,4,7
25065,Shlumpuh,tichondrius,287,monk,mistweaver,16,4,12
25066,Uninvited,perenolde,286,monk,mistweaver,6,3,3
25067,Lilpielover,zuljin,286,monk,mistweaver,15,4,11
25068,Klassik,thrall,286,monk,mistweaver,21,4,17
25069,Timjongill,stormrage,271,monk,mistweaver,11,3,8
25070,Fingies,garrosh,271,monk,mistweaver,11,3,8
25071,Lildae,burning-legion,256,monk,mistweaver,4,4,0
25072,Koragro,tichondrius,239,monk,mistweaver,5,3,2
25073,Isit,vashj,234,monk,mistweaver,9,4,5
25074,Zeisei,wyrmrest-accord,234,monk,mistweaver,10,4,6
25075,Hirado,kelthuzad,234,monk,mistweaver,16,4,12
25076,Friedpanda,kelthuzad,234,monk,mistweaver,16,4,12
25077,Badnboojie,malganis,234,monk,mistweaver,21,4,17
25078,Shaotee,tichondrius,208,monk,mistweaver,7,3,4
25079,Fujiô,illidan,192,monk,mistweaver,4,3,1
25080,Furryfisttin,illidan,192,monk,mistweaver,8,3,5
25081,Wangba,tichondrius,192,monk,mistweaver,6,2,4
25082,Bamboøzled,daggerspine,192,monk,mistweaver,6,2,4
25083,Gyatso,aegwynn,192,monk,mistweaver,6,2,4
25084,Mistbeard,aggramar,192,monk,mistweaver,6,2,4
25085,Primez,frostmourne,192,monk,mistweaver,6,2,4
25086,Skadouch,wyrmrest-accord,192,monk,mistweaver,6,2,4
25087,Apparent,lightnings-blade,192,monk,mistweaver,6,2,4
25088,Zåz,nazgrel,192,monk,mistweaver,6,2,4
25089,Yenizä,illidan,192,monk,mistweaver,6,2,4
25090,Flexmonk,barthilas,192,monk,mistweaver,6,2,4
25091,Djbluezx,tichondrius,192,monk,mistweaver,6,2,4
25092,Sebasu,perenolde,192,monk,mistweaver,6,2,4
25093,Fortnight,emerald-dream,192,monk,mistweaver,6,2,4
25094,Lilknucks,bonechewer,192,monk,mistweaver,6,2,4
25095,Acena,stormrage,192,monk,mistweaver,6,2,4
25096,Broxxenidas,quelthalas,192,monk,mistweaver,6,2,4
25097,Caralia,exodar,192,monk,mistweaver,6,2,4
25098,Tarae,nagrand,192,monk,mistweaver,6,2,4
25099,Wamii,tichondrius,192,monk,mistweaver,6,2,4
25100,Fäded,trollbane,192,monk,mistweaver,6,2,4
25101,Selocke,bleeding-hollow,192,monk,mistweaver,6,2,4
25102,Melocotonn,goldrinn,192,monk,mistweaver,6,2,4
25103,Privm,moonrunner,192,monk,mistweaver,6,2,4
25104,Udjun,bleeding-hollow,192,monk,mistweaver,6,2,4
25105,Kîkû,moon-guard,192,monk,mistweaver,6,2,4
25106,Springsummer,tichondrius,192,monk,mistweaver,6,2,4
25107,Xanzee,area-52,192,monk,mistweaver,6,2,4
25108,Demödras,stormrage,192,monk,mistweaver,6,2,4
25109,Foxmacleod,bleeding-hollow,192,monk,mistweaver,6,2,4
25110,Zengoku,zuljin,192,monk,mistweaver,6,2,4
25111,Gullystylez,hellscream,192,monk,mistweaver,6,2,4
25112,Drfistyfingr,malganis,192,monk,mistweaver,6,2,4
25113,Tommywiseau,amanthul,192,monk,mistweaver,6,2,4
25114,Rekque,amanthul,192,monk,mistweaver,6,2,4
25115,Ashenn,area-52,192,monk,mistweaver,6,2,4
25116,Vams,barthilas,192,monk,mistweaver,6,2,4
25117,Rubntug,zuljin,192,monk,mistweaver,6,2,4
25118,Aquamonk,tichondrius,192,monk,mistweaver,6,2,4
25119,Ahlam,tichondrius,192,monk,mistweaver,6,2,4
25120,Theriní,stormrage,192,monk,mistweaver,6,2,4
25121,Fïstbeaver,malganis,192,monk,mistweaver,6,2,4
25122,Hitchslapz,tichondrius,192,monk,mistweaver,6,2,4
25123,Jittersx,silvermoon,192,monk,mistweaver,6,2,4
25124,Pandamanapua,dragonmaw,192,monk,mistweaver,6,2,4
25125,Iililiililil,stormrage,192,monk,mistweaver,6,2,4
25126,Tigerlust,sargeras,192,monk,mistweaver,6,2,4
25127,Ricecákez,alterac-mountains,192,monk,mistweaver,6,2,4
25128,Kickflipy,dalaran,192,monk,mistweaver,6,2,4
25129,Nilonsso,sargeras,192,monk,mistweaver,6,2,4
25130,Bamboozle,blackrock,192,monk,mistweaver,6,2,4
25131,Bodyshot,area-52,192,monk,mistweaver,6,2,4
25132,Banidiin,moon-guard,192,monk,mistweaver,6,2,4
25133,Jaybum,sargeras,192,monk,mistweaver,6,2,4
25134,Touchbot,tichondrius,192,monk,mistweaver,6,2,4
25135,Míyãgí,tichondrius,192,monk,mistweaver,6,2,4
25136,Kåelarayn,moon-guard,192,monk,mistweaver,6,2,4
25137,Quickhands,dalaran,192,monk,mistweaver,6,2,4
25138,Onepunch,exodar,192,monk,mistweaver,7,2,5
25139,Glowsgreenby,area-52,192,monk,mistweaver,8,2,6
25140,Coffeek,area-52,192,monk,mistweaver,8,2,6
25141,Mung,boulderfist,192,monk,mistweaver,12,2,10
25142,Ðetroitsmash,sargeras,192,monk,mistweaver,12,2,10
25143,Bubblekit,nerzhul,192,monk,mistweaver,12,2,10
25144,Monkik,laughing-skull,192,monk,mistweaver,12,2,10
25145,Hellcow,frostmourne,192,monk,mistweaver,12,2,10
25146,Taymonk,stormrage,192,monk,mistweaver,12,2,10
25147,Tacoma,sargeras,192,monk,mistweaver,12,2,10
25148,Hunglikejfk,thrall,192,monk,mistweaver,12,2,10
25149,Missmagda,darkspear,192,monk,mistweaver,12,2,10
25150,Kick,dragonmaw,192,monk,mistweaver,12,2,10
25151,Gândhi,kiljaeden,192,monk,mistweaver,12,2,10
25152,Yomamaflo,wildhammer,192,monk,mistweaver,12,2,10
25153,Fuchizaki,ragnaros,192,monk,mistweaver,12,2,10
25154,Salzamonk,aggramar,192,monk,mistweaver,12,2,10
25155,Göönsqüäd,moon-guard,192,monk,mistweaver,12,2,10
25156,Whynotec,tichondrius,192,monk,mistweaver,12,2,10
25157,Sanytea,sargeras,192,monk,mistweaver,12,2,10
25158,Chuggernaut,illidan,192,monk,mistweaver,15,2,13
25159,Fatde,daggerspine,192,monk,mistweaver,18,2,16
25160,Farmerstan,sargeras,192,monk,mistweaver,18,2,16
25161,Senzmist,lightbringer,191,monk,mistweaver,6,2,4
25162,Realisthands,barthilas,191,monk,mistweaver,6,2,4
25163,Honestworkz,area-52,191,monk,mistweaver,6,2,4
25164,Blazebeast,blackhand,191,monk,mistweaver,6,2,4
25165,Rorik,deathwing,191,monk,mistweaver,12,2,10
25166,Phystweaver,malganis,175,monk,mistweaver,11,2,9
25167,Fistaholic,turalyon,159,monk,mistweaver,5,2,3
25168,Pathad,stormrage,159,monk,mistweaver,5,2,3
25169,Duskier,garithos,144,monk,mistweaver,3,3,0
25170,Miestro,tichondrius,138,monk,mistweaver,6,3,3
25171,Spicybrew,tichondrius,138,monk,mistweaver,7,3,4
25172,Wifflenut,tichondrius,138,monk,mistweaver,11,4,7
25173,Fijiwater,stormrage,138,monk,mistweaver,9,3,6
25174,ßøøstêðçhåñ,illidan,138,monk,mistweaver,9,3,6
25175,Slimweaver,stormrage,138,monk,mistweaver,13,4,9
25176,Vyostao,ragnaros,138,monk,mistweaver,11,3,8
25177,Liaoran,stormrage,128,monk,mistweaver,4,2,2
25178,Averagéjoe,tichondrius,127,monk,mistweaver,8,2,6
25179,Mysstickle,icecrown,96,monk,mistweaver,3,2,1
25180,Kungfucheeks,illidan,96,monk,mistweaver,6,1,5
25181,Ezpzmonk,bloodscalp,96,monk,mistweaver,6,1,5
25182,Jamesboong,illidan,96,monk,mistweaver,6,1,5
25183,Hawrang,tichondrius,96,monk,mistweaver,6,1,5
25184,Bannedbybliz,thrall,96,monk,mistweaver,6,1,5
25185,Backfistt,tichondrius,96,monk,mistweaver,6,1,5
25186,Rockfu,illidan,96,monk,mistweaver,6,1,5
25187,Shrimptown,dalaran,96,monk,mistweaver,6,1,5
25188,Zrza,tichondrius,96,monk,mistweaver,6,1,5
25189,Stickyloads,illidan,96,monk,mistweaver,6,1,5
25190,Meniscusmonk,emerald-dream,96,monk,mistweaver,6,1,5
25191,Fatboyswag,tichondrius,96,monk,mistweaver,6,1,5
25192,Froggie,illidan,96,monk,mistweaver,6,1,5
25193,Brewtalìty,tichondrius,96,monk,mistweaver,6,1,5
25194,Samaera,uther,96,monk,mistweaver,6,1,5
25195,Kenvuki,emerald-dream,96,monk,mistweaver,6,1,5
25196,Kimmyfists,tichondrius,96,monk,mistweaver,6,1,5
25197,Yangdingtian,sargeras,96,monk,mistweaver,6,1,5
25198,Ruion,moon-guard,96,monk,mistweaver,6,1,5
25199,Daeio,burning-legion,96,monk,mistweaver,6,1,5
25200,Emrose,demon-soul,96,monk,mistweaver,6,1,5
25201,Kayakpunch,moon-guard,96,monk,mistweaver,6,1,5
25202,Squidbillie,moon-guard,96,monk,mistweaver,6,1,5
25203,Turkeydinner,frostmourne,96,monk,mistweaver,6,1,5
25204,Criminall,aegwynn,96,monk,mistweaver,6,1,5
25205,Sheff,daggerspine,96,monk,mistweaver,6,1,5
25206,Tedbondy,moon-guard,96,monk,mistweaver,6,1,5
25207,Lainerya,moon-guard,96,monk,mistweaver,6,1,5
25208,Lomist,nazjatar,96,monk,mistweaver,6,1,5
25209,Twistedchi,stormrage,96,monk,mistweaver,6,1,5
25210,Hedgefrogs,stormrage,96,monk,mistweaver,6,1,5
25211,Dirack,quelthalas,96,monk,mistweaver,6,1,5
25212,Tzobee,stormrage,96,monk,mistweaver,6,1,5
25213,Súprä,stormrage,96,monk,mistweaver,6,1,5
25214,Naveex,bleeding-hollow,96,monk,mistweaver,6,1,5
25215,Findorato,windrunner,96,monk,mistweaver,6,1,5
25216,Monkuxe,zuljin,96,monk,mistweaver,6,1,5
25217,Kiawe,zuljin,96,monk,mistweaver,6,1,5
25218,Charrek,zuljin,96,monk,mistweaver,6,1,5
25219,Raylá,kelthuzad,96,monk,mistweaver,6,1,5
25220,Dankestkhan,korialstrasz,96,monk,mistweaver,6,1,5
25221,Notthefather,area-52,96,monk,mistweaver,6,1,5
25222,Limejuulpod,malganis,96,monk,mistweaver,6,1,5
25223,Danicah,altar-of-storms,96,monk,mistweaver,6,1,5
25224,Ogmonk,skullcrusher,96,monk,mistweaver,6,1,5
25225,Kaÿñ,area-52,96,monk,mistweaver,6,1,5
25226,Ünarù,area-52,96,monk,mistweaver,6,1,5
25227,Tofugoku,area-52,96,monk,mistweaver,6,1,5
25228,Faméd,stormrage,96,monk,mistweaver,8,1,7
25229,Ghostsofur,tichondrius,96,monk,mistweaver,12,1,11
25230,Eliwenn,ragnaros,96,monk,mistweaver,12,1,11
25231,Théophila,illidan,96,monk,mistweaver,12,1,11
25232,Zenmidget,kelthuzad,96,monk,mistweaver,12,1,11
25233,Selectra,malfurion,95,monk,mistweaver,6,1,5
25234,Fairymonk,frostwolf,79,monk,mistweaver,5,1,4
25235,Clixstermonk,area-52,79,monk,mistweaver,5,1,4
25236,Thalreyzian,vashj,64,monk,mistweaver,4,1,3
25237,Rockxtv,illidan,63,monk,mistweaver,2,2,0
25238,Deethnutth,bleeding-hollow,63,monk,mistweaver,2,2,0
25239,Fumoo,sargeras,42,monk,mistweaver,10,3,7
25240,Mataleao,emerald-dream,42,monk,mistweaver,10,2,8
25241,Whtnyhuston,sargeras,42,monk,mistweaver,12,2,10
25242,Vazana,moon-guard,30,monk,mistweaver,18,7,11
25243,Worldpvp,nerzhul,1398,monk,brewmaster,39,16,23
25244,Epucphail,kelthuzad,1221,monk,brewmaster,78,33,45
25245,Omgar,frostmourne,1046,monk,brewmaster,44,17,27
25246,Daesun,quelthalas,958,monk,brewmaster,18,10,8
25247,Robbo,tichondrius,576,monk,brewmaster,18,6,12
25248,Chochas,tichondrius,477,monk,brewmaster,12,5,7
25249,Morpheous,whisperwind,383,monk,brewmaster,6,4,2
25250,Doughboy,skullcrusher,383,monk,brewmaster,12,4,8
25251,Genié,moon-guard,288,monk,brewmaster,6,3,3
25252,Akhar,nazgrel,288,monk,brewmaster,6,3,3
25253,Lonebamboo,tichondrius,288,monk,brewmaster,12,3,9
25254,Quaria,moon-guard,288,monk,brewmaster,18,3,15
25255,Daedae,quelthalas,192,monk,brewmaster,8,3,5
25256,Sistuhfista,tichondrius,192,monk,brewmaster,6,2,4
25257,Drunkfight,zuljin,192,monk,brewmaster,18,2,16
25258,Encry,zuljin,191,monk,brewmaster,6,2,4
25259,Ferrarí,quelthalas,79,monk,brewmaster,11,1,10
25260,Rín,dalaran,42,monk,brewmaster,7,2,5
25261,Yerky,stormrage,2300,monk,windwalker,95,54,41
25262,Neighbors,sargeras,2287,monk,windwalker,139,76,63
25263,Iminglee,area-52,2264,monk,windwalker,118,62,56
25264,Keyam,illidan,2208,monk,windwalker,101,54,47
25265,Primez,frostmourne,2195,monk,windwalker,83,45,38
25266,Judo,agamaggan,2157,monk,windwalker,86,46,40
25267,Sean,nazjatar,2143,monk,windwalker,72,38,34
25268,Senseiww,sargeras,2143,monk,windwalker,126,64,62
25269,Pacmankr,tichondrius,2135,monk,windwalker,153,80,73
25270,Thewy,tichondrius,2132,monk,windwalker,108,55,53
25271,Fueld,burning-legion,2132,monk,windwalker,378,192,186
25272,Cmx,sargeras,2125,monk,windwalker,172,88,84
25273,Riversøng,frostmourne,2115,monk,windwalker,84,46,38
25274,Chyx,tichondrius,2113,monk,windwalker,112,57,55
25275,Xyän,bleeding-hollow,2112,monk,windwalker,94,47,47
25276,Edenx,sargeras,2111,monk,windwalker,66,38,28
25277,Flattsww,tichondrius,2111,monk,windwalker,274,140,134
25278,Stárset,illidan,2104,monk,windwalker,96,54,42
25279,Rickybobbyx,vashj,2103,monk,windwalker,119,61,58
25280,Iílílílílílí,area-52,2101,monk,windwalker,84,43,41
25281,Catgallery,tichondrius,2100,monk,windwalker,203,105,98
25282,Homun,tichondrius,2100,monk,windwalker,94,46,48
25283,Bigherosixx,tichondrius,2097,monk,windwalker,120,65,55
25284,Chopt,zuljin,2061,monk,windwalker,90,45,45
25285,Fatal,bonechewer,2059,monk,windwalker,118,65,53
25286,Hypnøtìze,frostmourne,2055,monk,windwalker,203,107,96
25287,Larryjonés,area-52,2051,monk,windwalker,209,106,103
25288,Liamllama,barthilas,2036,monk,windwalker,176,92,84
25289,Rytes,moon-guard,2025,monk,windwalker,189,99,90
25290,Xølik,draenor,2019,monk,windwalker,60,43,17
25291,Blackpandax,tichondrius,2008,monk,windwalker,107,55,52
25292,Spotifyfan,ysera,1994,monk,windwalker,189,103,86
25293,Touchofdeáth,stormrage,1991,monk,windwalker,161,88,73
25294,Hakri,arthas,1987,monk,windwalker,30,21,9
25295,Madtiger,scilla,1978,monk,windwalker,135,69,66
25296,Droguex,tichondrius,1973,monk,windwalker,276,131,145
25297,Cuteirl,tichondrius,1970,monk,windwalker,84,53,31
25298,Shïvïr,azralon,1962,monk,windwalker,207,107,100
25299,Fínzy,tichondrius,1962,monk,windwalker,203,104,99
25300,Crashandflow,zuljin,1961,monk,windwalker,60,33,27
25301,Inbu,tichondrius,1957,monk,windwalker,158,79,79
25302,Bdw,tichondrius,1955,monk,windwalker,142,84,58
25303,Dzq,stormrage,1953,monk,windwalker,98,55,43
25304,Robbo,tichondrius,1949,monk,windwalker,71,37,34
25305,Kranelo,tichondrius,1946,monk,windwalker,54,32,22
25306,Percentx,tichondrius,1935,monk,windwalker,60,29,31
25307,Repbrew,sargeras,1934,monk,windwalker,81,40,41
25308,Baddi,uldum,1931,monk,windwalker,154,79,75
25309,Wondý,quelthalas,1931,monk,windwalker,173,86,87
25310,Nehji,illidan,1927,monk,windwalker,141,70,71
25311,Wwlékinhø,azralon,1926,monk,windwalker,90,51,39
25312,Yuujitsu,sargeras,1924,monk,windwalker,169,90,79
25313,Hiurge,tichondrius,1922,monk,windwalker,102,52,50
25314,Torkscrew,bleeding-hollow,1919,monk,windwalker,42,25,17
25315,Frootsmoothi,thrall,1919,monk,windwalker,106,52,54
25316,Broomooster,bleeding-hollow,1919,monk,windwalker,65,29,36
25317,Choplo,demon-soul,1911,monk,windwalker,78,43,35
25318,Omnly,stormrage,1901,monk,windwalker,56,30,26
25319,Tippytap,bleeding-hollow,1899,monk,windwalker,119,60,59
25320,Weathermanxv,kelthuzad,1896,monk,windwalker,123,56,67
25321,Duhäst,sargeras,1895,monk,windwalker,78,46,32
25322,Conngaline,stormreaver,1893,monk,windwalker,419,206,213
25323,Threnody,malganis,1891,monk,windwalker,82,39,43
25324,Lodbork,tichondrius,1887,monk,windwalker,437,223,214
25325,Lhiri,moon-guard,1886,monk,windwalker,65,33,32
25326,Gaslighterr,tichondrius,1883,monk,windwalker,57,35,22
25327,Maozhën,tichondrius,1882,monk,windwalker,60,31,29
25328,Sínsayer,tichondrius,1882,monk,windwalker,123,55,68
25329,Mikephoenix,tichondrius,1877,monk,windwalker,133,69,64
25330,Jaxvisto,dalaran,1868,monk,windwalker,101,51,50
25331,Unhappyclown,tichondrius,1867,monk,windwalker,167,94,73
25332,Screwz,tichondrius,1867,monk,windwalker,67,33,34
25333,Mikeyx,area-52,1862,monk,windwalker,36,21,15
25334,Shírÿu,azralon,1857,monk,windwalker,83,42,41
25335,Garypool,emerald-dream,1856,monk,windwalker,33,20,13
25336,Boeycalma,illidan,1855,monk,windwalker,60,36,24
25337,Alshee,nagrand,1846,monk,windwalker,45,24,21
25338,Guylian,tichondrius,1845,monk,windwalker,58,30,28
25339,Tschi,illidan,1844,monk,windwalker,42,29,13
25340,Artam,thrall,1844,monk,windwalker,89,51,38
25341,Smokechief,hyjal,1844,monk,windwalker,60,33,27
25342,Helvectius,tichondrius,1843,monk,windwalker,192,90,102
25343,Züdo,area-52,1841,monk,windwalker,105,55,50
25344,Allmight,wyrmrest-accord,1839,monk,windwalker,105,58,47
25345,Bunnygal,thaurissan,1838,monk,windwalker,82,43,39
25346,Napbox,bleeding-hollow,1837,monk,windwalker,152,79,73
25347,Absurd,mannoroth,1836,monk,windwalker,33,21,12
25348,Kuranchi,sargeras,1836,monk,windwalker,42,23,19
25349,Sunfistway,sargeras,1835,monk,windwalker,80,48,32
25350,Karmerr,proudmoore,1835,monk,windwalker,66,35,31
25351,Peachcactus,sargeras,1833,monk,windwalker,42,27,15
25352,Rockxtv,illidan,1831,monk,windwalker,60,27,33
25353,Lopez,sargeras,1825,monk,windwalker,54,35,19
25354,Backfliptime,ragnaros,1825,monk,windwalker,46,28,18
25355,Lahri,silvermoon,1824,monk,windwalker,80,48,32
25356,Nelariah,wyrmrest-accord,1822,monk,windwalker,59,28,31
25357,Sylash,ragnaros,1821,monk,windwalker,36,21,15
25358,Zionk,tichondrius,1820,monk,windwalker,114,79,35
25359,Sentomaru,bleeding-hollow,1820,monk,windwalker,66,33,33
25360,Elfoverde,stormrage,1819,monk,windwalker,48,30,18
25361,Vybïn,tichondrius,1816,monk,windwalker,294,146,148
25362,Micai,thrall,1813,monk,windwalker,42,25,17
25363,Bakha,illidan,1812,monk,windwalker,35,22,13
25364,Shisama,area-52,1812,monk,windwalker,62,38,24
25365,Doczen,malganis,1812,monk,windwalker,60,29,31
25366,Jamut,stormrage,1812,monk,windwalker,54,23,31
25367,Senritsuh,drakkari,1811,monk,windwalker,58,29,29
25368,Maomaogun,tichondrius,1810,monk,windwalker,42,29,13
25369,Xìðñ,moon-guard,1808,monk,windwalker,102,70,32
25370,Hailan,area-52,1808,monk,windwalker,48,29,19
25371,Turbofist,bleeding-hollow,1803,monk,windwalker,42,25,17
25372,Imasterl,proudmoore,1803,monk,windwalker,51,27,24
25373,Bussÿ,area-52,1803,monk,windwalker,111,54,57
25374,Furiamvp,stormrage,1801,monk,windwalker,54,28,26
25375,Accidntprone,zangarmarsh,1801,monk,windwalker,54,28,26
25376,Ghooch,illidan,1800,monk,windwalker,66,39,27
25377,Muhli,kiljaeden,1800,monk,windwalker,42,22,20
25378,Monkatron,arthas,1799,monk,windwalker,119,60,59
25379,Marçi,moon-guard,1799,monk,windwalker,139,64,75
25380,Fátë,tichondrius,1790,monk,windwalker,114,50,64
25381,Brewceo,area-52,1787,monk,windwalker,66,34,32
25382,Dwarfmonk,tichondrius,1782,monk,windwalker,48,22,26
25383,Innerverse,tichondrius,1781,monk,windwalker,53,26,27
25384,Snebyos,tichondrius,1780,monk,windwalker,107,62,45
25385,Alps,darkspear,1780,monk,windwalker,48,24,24
25386,Atsuyuki,nemesis,1778,monk,windwalker,55,25,30
25387,Rockyßalboa,sargeras,1774,monk,windwalker,85,50,35
25388,Thuyvan,barthilas,1773,monk,windwalker,54,31,23
25389,Serthean,illidan,1773,monk,windwalker,230,112,118
25390,Mhmmzz,sargeras,1769,monk,windwalker,114,58,56
25391,Tristantwo,sargeras,1761,monk,windwalker,96,47,49
25392,Gigached,zuljin,1759,monk,windwalker,75,35,40
25393,Jümmy,area-52,1757,monk,windwalker,54,26,28
25394,Phistea,area-52,1749,monk,windwalker,75,37,38
25395,Jåðëðrägøñ,sargeras,1745,monk,windwalker,61,36,25
25396,Kagebunshin,kelthuzad,1744,monk,windwalker,42,25,17
25397,Bruceteå,area-52,1744,monk,windwalker,36,19,17
25398,Zynflex,tichondrius,1743,monk,windwalker,59,27,32
25399,Tragorin,tichondrius,1740,monk,windwalker,60,31,29
25400,Danimalz,stormrage,1737,monk,windwalker,60,31,29
25401,Nyofu,moon-guard,1737,monk,windwalker,47,23,24
25402,Pandagirlw,tichondrius,1735,monk,windwalker,72,43,29
25403,Lidä,tichondrius,1735,monk,windwalker,60,25,35
25404,Ambal,hellscream,1734,monk,windwalker,55,32,23
25405,Syerzie,dalaran,1732,monk,windwalker,93,42,51
25406,Kárma,malganis,1731,monk,windwalker,42,24,18
25407,Khawai,sargeras,1730,monk,windwalker,54,29,25
25408,Jasey,area-52,1729,monk,windwalker,29,21,8
25409,Jükedx,stormrage,1728,monk,windwalker,91,54,37
25410,Mechamonk,aerie-peak,1728,monk,windwalker,105,46,59
25411,Iremía,azralon,1727,monk,windwalker,48,26,22
25412,Altaidm,ragnaros,1724,monk,windwalker,61,30,31
25413,Monkgyatso,drakthul,1722,monk,windwalker,126,65,61
25414,Raphåel,area-52,1722,monk,windwalker,35,18,17
25415,Xanaxåddict,sargeras,1722,monk,windwalker,225,113,112
25416,Hîddènsõündx,tichondrius,1721,monk,windwalker,36,18,18
25417,Boostedww,bloodscalp,1720,monk,windwalker,48,25,23
25418,Warblaze,barthilas,1720,monk,windwalker,62,31,31
25419,Chunlee,tichondrius,1718,monk,windwalker,42,22,20
25420,Vai,korgath,1716,monk,windwalker,94,46,48
25421,Takkeya,zuljin,1713,monk,windwalker,42,25,17
25422,Livitsu,aerie-peak,1712,monk,windwalker,30,18,12
25423,Haco,malganis,1710,monk,windwalker,57,31,26
25424,Orkmonk,tichondrius,1708,monk,windwalker,42,28,14
25425,Tenooki,illidan,1707,monk,windwalker,41,19,22
25426,Squidie,tichondrius,1707,monk,windwalker,48,19,29
25427,Setback,tichondrius,1706,monk,windwalker,24,18,6
25428,Rakije,barthilas,1703,monk,windwalker,72,44,28
25429,Excalibrew,malganis,1703,monk,windwalker,66,36,30
25430,Tôpsônworld,tichondrius,1700,monk,windwalker,66,39,27
25431,Capiirotta,nemesis,1700,monk,windwalker,128,75,53
25432,Sickbanga,barthilas,1699,monk,windwalker,36,18,18
25433,Akanq,tichondrius,1698,monk,windwalker,39,21,18
25434,Öñlýfåñs,tichondrius,1698,monk,windwalker,65,33,32
25435,Xas,sentinels,1698,monk,windwalker,78,36,42
25436,Humonkulous,darkspear,1696,monk,windwalker,43,19,24
25437,Wolffangfist,sargeras,1695,monk,windwalker,75,45,30
25438,Daracus,kelthuzad,1694,monk,windwalker,38,24,14
25439,Mastâ,kelthuzad,1694,monk,windwalker,116,62,54
25440,Titanus,chogall,1689,monk,windwalker,379,195,184
25441,Xï,proudmoore,1688,monk,windwalker,86,47,39
25442,Ojii,tichondrius,1687,monk,windwalker,58,26,32
25443,Haharetsdead,illidan,1686,monk,windwalker,131,71,60
25444,Shids,barthilas,1686,monk,windwalker,47,22,25
25445,Nightww,area-52,1683,monk,windwalker,60,34,26
25446,Zenluckydo,grizzly-hills,1683,monk,windwalker,113,61,52
25447,Jaspier,quelthalas,1682,monk,windwalker,53,28,25
25448,Thåi,anubarak,1682,monk,windwalker,48,19,29
25449,Vanmonk,eonar,1681,monk,windwalker,36,18,18
25450,Jatzai,emerald-dream,1680,monk,windwalker,52,24,28
25451,Hellstabberm,lightbringer,1678,monk,windwalker,48,26,22
25452,Zhoku,tichondrius,1674,monk,windwalker,30,19,11
25453,Miýagi,sargeras,1671,monk,windwalker,47,28,19
25454,Jdanîel,ragnaros,1671,monk,windwalker,42,21,21
25455,Zenigma,area-52,1670,monk,windwalker,45,24,21
25456,Dea,thrall,1670,monk,windwalker,84,43,41
25457,Watercowz,tichondrius,1669,monk,windwalker,36,22,14
25458,Bigpoppap,tichondrius,1668,monk,windwalker,54,29,25
25459,Madtigon,scilla,1668,monk,windwalker,42,22,20
25460,Ighostgirls,thrall,1668,monk,windwalker,35,18,17
25461,Hèllòkîttý,illidan,1666,monk,windwalker,30,19,11
25462,Hæt,stormrage,1665,monk,windwalker,48,23,25
25463,Shaszx,zuljin,1661,monk,windwalker,47,25,22
25464,Bamron,fizzcrank,1660,monk,windwalker,113,57,56
25465,Windmónk,tichondrius,1657,monk,windwalker,156,76,80
25466,Gêrôx,sargeras,1656,monk,windwalker,42,21,21
25467,Galaxystrike,illidan,1655,monk,windwalker,60,32,28
25468,Quanyaozu,ragnaros,1654,monk,windwalker,32,19,13
25469,Wørm,emerald-dream,1653,monk,windwalker,36,21,15
25470,Fiddletix,stormrage,1647,monk,windwalker,55,28,27
25471,Dumplíngs,emerald-dream,1647,monk,windwalker,59,27,32
25472,Bearface,blades-edge,1646,monk,windwalker,88,36,52
25473,Mists,velen,1645,monk,windwalker,54,31,23
25474,Oxli,emerald-dream,1645,monk,windwalker,46,26,20
25475,Npepper,khadgar,1645,monk,windwalker,112,59,53
25476,Rïggen,thrall,1644,monk,windwalker,88,50,38
25477,Ludanford,eitrigg,1643,monk,windwalker,48,22,26
25478,Foxchik,zuljin,1641,monk,windwalker,76,42,34
25479,Pankekz,tichondrius,1639,monk,windwalker,192,97,95
25480,Akumà,tichondrius,1636,monk,windwalker,48,19,29
25481,Akir,zuljin,1635,monk,windwalker,29,20,9
25482,Rnmedic,stormrage,1632,monk,windwalker,56,24,32
25483,Hotwatertank,area-52,1629,monk,windwalker,60,34,26
25484,Harde,thrall,1629,monk,windwalker,83,43,40
25485,Kungpóa,sargeras,1628,monk,windwalker,39,23,16
25486,Singao,malganis,1628,monk,windwalker,74,36,38
25487,Djjackyd,stormrage,1625,monk,windwalker,30,17,13
25488,Ddoongmonk,tichondrius,1625,monk,windwalker,48,21,27
25489,Plucky,tichondrius,1624,monk,windwalker,37,18,19
25490,Tnsnow,illidan,1623,monk,windwalker,36,21,15
25491,Fuqmeh,darkspear,1621,monk,windwalker,84,42,42
25492,Phistycuffs,bleeding-hollow,1621,monk,windwalker,85,40,45
25493,Jigong,bleeding-hollow,1620,monk,windwalker,42,23,19
25494,Karelio,wyrmrest-accord,1619,monk,windwalker,48,22,26
25495,Aidenww,area-52,1618,monk,windwalker,24,17,7
25496,Sonsia,arthas,1618,monk,windwalker,112,64,48
25497,Fatboí,sargeras,1618,monk,windwalker,51,29,22
25498,Fimeu,kiljaeden,1617,monk,windwalker,54,28,26
25499,Corsan,illidan,1616,monk,windwalker,48,33,15
25500,Hadoukeñ,thrall,1616,monk,windwalker,41,22,19
25501,Jbills,muradin,1615,monk,windwalker,71,41,30
25502,Banyasong,tichondrius,1615,monk,windwalker,108,62,46
25503,Zeati,tichondrius,1613,monk,windwalker,24,17,7
25504,Azizyzz,barthilas,1613,monk,windwalker,30,20,10
25505,Euman,sargeras,1613,monk,windwalker,36,21,15
25506,Themanski,area-52,1612,monk,windwalker,46,24,22
25507,Cpapi,sargeras,1612,monk,windwalker,60,30,30
25508,Xinpa,quelthalas,1612,monk,windwalker,38,19,19
25509,Fapmonk,illidan,1611,monk,windwalker,59,39,20
25510,Whøru,azralon,1611,monk,windwalker,42,17,25
25511,Ehdunno,kelthuzad,1610,monk,windwalker,68,37,31
25512,Punchco,senjin,1610,monk,windwalker,42,21,21
25513,Hím,garrosh,1609,monk,windwalker,87,52,35
25514,Fistnu,aggramar,1608,monk,windwalker,83,49,34
25515,Bumbleechi,azralon,1606,monk,windwalker,36,17,19
25516,Toyotatacoma,bleeding-hollow,1605,monk,windwalker,42,27,15
25517,Daeio,burning-legion,1605,monk,windwalker,31,19,12
25518,Rennafgc,stormrage,1605,monk,windwalker,36,20,16
25519,Jegann,tichondrius,1605,monk,windwalker,140,71,69
25520,Sterow,kiljaeden,1604,monk,windwalker,42,21,21
25521,Flyingfury,illidan,1604,monk,windwalker,54,25,29
25522,Facekandy,tichondrius,1602,monk,windwalker,34,18,16
25523,Xradu,dawnbringer,1601,monk,windwalker,82,49,33
25524,Bruhmesoftly,thrall,1601,monk,windwalker,60,34,26
25525,Flattswwjr,tichondrius,1601,monk,windwalker,36,19,17
25526,Pepeloser,illidan,1601,monk,windwalker,48,23,25
25527,Ronk,the-forgotten-coast,1600,monk,windwalker,30,17,13
25528,Homunculusx,bleeding-hollow,1600,monk,windwalker,42,19,23
25529,Shôckley,tichondrius,1598,monk,windwalker,129,71,58
25530,Dirtypunch,proudmoore,1598,monk,windwalker,42,19,23
25531,Windwalker,blackhand,1597,monk,windwalker,35,19,16
25532,Mitras,dragonblight,1594,monk,windwalker,30,19,11
25533,Lingerer,aerie-peak,1593,monk,windwalker,110,57,53
25534,Marcusm,bleeding-hollow,1592,monk,windwalker,33,20,13
25535,Surgarush,moon-guard,1592,monk,windwalker,106,64,42
25536,Fistyuh,illidan,1590,monk,windwalker,54,31,23
25537,Druta,illidan,1589,monk,windwalker,48,35,13
25538,Feyalash,stormrage,1589,monk,windwalker,74,33,41
25539,Kuffy,kelthuzad,1584,monk,windwalker,67,37,30
25540,Peacefulpaco,malganis,1583,monk,windwalker,54,30,24
25541,Reprap,elune,1582,monk,windwalker,58,33,25
25542,Kogoli,frostwolf,1580,monk,windwalker,101,47,54
25543,Råii,sargeras,1579,monk,windwalker,30,20,10
25544,Wonderx,darkspear,1579,monk,windwalker,30,20,10
25545,Gøgeta,stormrage,1579,monk,windwalker,173,86,87
25546,Copenfist,black-dragonflight,1578,monk,windwalker,36,21,15
25547,Yogiji,proudmoore,1578,monk,windwalker,48,26,22
25548,Udderpunch,barthilas,1578,monk,windwalker,46,21,25
25549,Chucksandmk,barthilas,1577,monk,windwalker,66,32,34
25550,Kitingqt,area-52,1576,monk,windwalker,42,19,23
25551,Pinot,dragonmaw,1572,monk,windwalker,42,17,25
25552,Saucyfists,silvermoon,1568,monk,windwalker,64,32,32
25553,Meatwrap,mugthol,1566,monk,windwalker,52,26,26
25554,Unlike,tichondrius,1566,monk,windwalker,102,49,53
25555,Rigi,stormrage,1564,monk,windwalker,107,46,61
25556,Ráchez,tichondrius,1559,monk,windwalker,93,54,39
25557,Jerax,thunderlord,1559,monk,windwalker,109,59,50
25558,Brewbaker,hyjal,1556,monk,windwalker,86,48,38
25559,Chongzly,frostmourne,1552,monk,windwalker,90,44,46
25560,Dïsturbedtko,azralon,1552,monk,windwalker,120,58,62
25561,Allmother,area-52,1552,monk,windwalker,43,19,24
25562,Fistnafurry,tichondrius,1550,monk,windwalker,42,21,21
25563,Fornoraisin,thrall,1547,monk,windwalker,54,21,33
25564,Nagato,nemesis,1545,monk,windwalker,23,17,6
25565,Thouther,sargeras,1545,monk,windwalker,42,17,25
25566,Ranchy,zuljin,1543,monk,windwalker,144,71,73
25567,Chingu,ragnaros,1543,monk,windwalker,123,59,64
25568,Therapeutics,moon-guard,1543,monk,windwalker,102,47,55
25569,Okoh,wyrmrest-accord,1542,monk,windwalker,50,28,22
25570,Pokinpooters,stormrage,1536,monk,windwalker,129,65,64
25571,Lørdjåshïn,azjolnerub,1534,monk,windwalker,30,16,14
25572,Çraßsßùrgêr,bonechewer,1533,monk,windwalker,24,16,8
25573,Adilm,illidan,1533,monk,windwalker,30,16,14
25574,Veso,tichondrius,1532,monk,windwalker,18,16,2
25575,Hamyu,illidan,1531,monk,windwalker,36,18,18
25576,Healzpapi,tichondrius,1530,monk,windwalker,120,73,47
25577,Bakedmonk,smolderthorn,1530,monk,windwalker,82,32,50
25578,Zaabuza,azralon,1528,monk,windwalker,60,39,21
25579,Feelsogöod,tichondrius,1528,monk,windwalker,64,38,26
25580,Wât,bleeding-hollow,1528,monk,windwalker,30,16,14
25581,Panduh,moon-guard,1528,monk,windwalker,198,100,98
25582,Domiik,ragnaros,1528,monk,windwalker,36,17,19
25583,Drakfu,tichondrius,1527,monk,windwalker,45,26,19
25584,Deezfist,illidan,1527,monk,windwalker,36,17,19
25585,Napoleonic,vashj,1524,monk,windwalker,30,20,10
25586,Hagano,drakkari,1523,monk,windwalker,107,55,52
25587,Muritors,ragnaros,1523,monk,windwalker,36,17,19
25588,Byakugun,wyrmrest-accord,1522,monk,windwalker,36,21,15
25589,Zòrrò,area-52,1521,monk,windwalker,24,16,8
25590,Naagg,tichondrius,1521,monk,windwalker,30,16,14
25591,Yoshifistsu,malganis,1521,monk,windwalker,54,26,28
25592,Odogin,tichondrius,1520,monk,windwalker,65,42,23
25593,Göllyjee,tichondrius,1517,monk,windwalker,90,39,51
25594,Bløødÿ,ragnaros,1516,monk,windwalker,21,17,4
25595,Wenisdeep,frostmourne,1516,monk,windwalker,94,47,47
25596,Kómugi,area-52,1514,monk,windwalker,137,72,65
25597,Borekkar,emerald-dream,1512,monk,windwalker,47,24,23
25598,Kutz,proudmoore,1512,monk,windwalker,81,40,41
25599,Odi,stonemaul,1509,monk,windwalker,101,48,53
25600,Sgarbossa,tortheldrin,1509,monk,windwalker,42,16,26
25601,Arizøna,illidan,1507,monk,windwalker,80,44,36
25602,Hòlygòd,dalaran,1506,monk,windwalker,88,45,43
25603,Geekweek,frostmourne,1503,monk,windwalker,30,17,13
25604,Nject,malganis,1502,monk,windwalker,108,60,48
25605,Ökami,tichondrius,1501,monk,windwalker,56,29,27
25606,Dabzin,stormrage,1501,monk,windwalker,87,44,43
25607,Varn,frostmourne,1500,monk,windwalker,95,46,49
25608,Yeawe,tichondrius,1499,monk,windwalker,36,19,17
25609,Punchiboi,thrall,1498,monk,windwalker,48,27,21
25610,Captnmurphy,tichondrius,1498,monk,windwalker,29,16,13
25611,Ascilica,firetree,1495,monk,windwalker,24,16,8
25612,Tigerstrikes,sargeras,1494,monk,windwalker,30,19,11
25613,Sleýin,tichondrius,1493,monk,windwalker,190,101,89
25614,Monkings,tichondrius,1491,monk,windwalker,65,30,35
25615,Allure,frostmourne,1489,monk,windwalker,45,20,25
25616,Simonb,tichondrius,1487,monk,windwalker,54,24,30
25617,Minimonke,moon-guard,1486,monk,windwalker,86,45,41
25618,Rockemsockem,gorefiend,1485,monk,windwalker,90,48,42
25619,Wizcaulifa,stormrage,1484,monk,windwalker,30,17,13
25620,Astteell,proudmoore,1484,monk,windwalker,45,18,27
25621,Kiulang,kelthuzad,1483,monk,windwalker,93,44,49
25622,Yamoshì,stormrage,1482,monk,windwalker,54,30,24
25623,Jdkick,sargeras,1482,monk,windwalker,42,16,26
25624,Aubiemonk,malygos,1479,monk,windwalker,30,16,14
25625,Yungtoochi,tichondrius,1479,monk,windwalker,54,23,31
25626,Sivedrafely,arthas,1475,monk,windwalker,60,30,30
25627,Beverage,frostmourne,1475,monk,windwalker,51,24,27
25628,Atreia,malganis,1474,monk,windwalker,26,17,9
25629,Ohgiddyttv,dalaran,1468,monk,windwalker,83,43,40
25630,Sckmonk,tichondrius,1466,monk,windwalker,34,16,18
25631,ßlesséd,tichondrius,1465,monk,windwalker,85,36,49
25632,Butjaum,stormrage,1464,monk,windwalker,70,34,36
25633,Senseî,altar-of-storms,1460,monk,windwalker,60,27,33
25634,Wartenja,frostmourne,1459,monk,windwalker,90,42,48
25635,Gójó,tichondrius,1458,monk,windwalker,36,23,13
25636,Katsübooy,azralon,1458,monk,windwalker,310,158,152
25637,Tyroneßanks,stormrage,1457,monk,windwalker,36,20,16
25638,Mastahp,tichondrius,1457,monk,windwalker,42,23,19
25639,Xogum,azralon,1453,monk,windwalker,30,16,14
25640,Grimpossible,malganis,1452,monk,windwalker,66,32,34
25641,Shishosenin,quelthalas,1450,monk,windwalker,218,104,114
25642,Callae,dreadmaul,1449,monk,windwalker,66,34,32
25643,Lickthefist,sargeras,1445,monk,windwalker,24,16,8
25644,Infest,azralon,1442,monk,windwalker,42,30,12
25645,Wind,misha,1440,monk,windwalker,55,35,20
25646,Pånkekz,tichondrius,1440,monk,windwalker,90,45,45
25647,Lavinci,area-52,1437,monk,windwalker,30,15,15
25648,Smoothboxing,tichondrius,1436,monk,windwalker,116,66,50
25649,Jackdaniel,sargeras,1435,monk,windwalker,24,15,9
25650,Aizu,ragnaros,1435,monk,windwalker,30,15,15
25651,Wüsok,thrall,1435,monk,windwalker,30,15,15
25652,Rocketfrogg,bleeding-hollow,1434,monk,windwalker,36,15,21
25653,Ahrk,emerald-dream,1434,monk,windwalker,78,30,48
25654,Kungfupurk,bleeding-hollow,1433,monk,windwalker,24,15,9
25655,Fistys,area-52,1433,monk,windwalker,117,60,57
25656,Izu,senjin,1433,monk,windwalker,30,15,15
25657,Heiwei,stormrage,1432,monk,windwalker,24,15,9
25658,Skippa,emerald-dream,1432,monk,windwalker,54,30,24
25659,Bhodie,zuljin,1432,monk,windwalker,74,32,42
25660,Xuenws,tichondrius,1429,monk,windwalker,24,15,9
25661,Rafên,moon-guard,1429,monk,windwalker,42,15,27
25662,Giatzo,barthilas,1427,monk,windwalker,66,37,29
25663,Mattyj,darkspear,1423,monk,windwalker,30,15,15
25664,Chuchinga,tichondrius,1423,monk,windwalker,90,43,47
25665,Judgevr,frostmourne,1423,monk,windwalker,39,17,22
25666,Rocketfist,bleeding-hollow,1422,monk,windwalker,102,48,54
25667,Daddyrugburn,area-52,1421,monk,windwalker,119,57,62
25668,Dazzler,ragnaros,1419,monk,windwalker,66,35,31
25669,Maunk,illidan,1418,monk,windwalker,18,15,3
25670,Gún,ragnaros,1416,monk,windwalker,89,45,44
25671,Convectuoso,illidan,1414,monk,windwalker,24,15,9
25672,Norrischucks,sargeras,1412,monk,windwalker,30,22,8
25673,Daslow,quelthalas,1412,monk,windwalker,146,75,71
25674,Whizz,frostmane,1408,monk,windwalker,37,17,20
25675,Gesir,tichondrius,1407,monk,windwalker,57,25,32
25676,Sodamint,sargeras,1403,monk,windwalker,44,16,28
25677,Saiyajinsoul,ragnaros,1402,monk,windwalker,60,29,31
25678,Chingwang,frostmourne,1400,monk,windwalker,41,24,17
25679,Creonus,proudmoore,1400,monk,windwalker,56,24,32
25680,Showshoway,tichondrius,1396,monk,windwalker,65,27,38
25681,Meniscusmonk,emerald-dream,1392,monk,windwalker,35,17,18
25682,Milkychi,frostmourne,1392,monk,windwalker,40,15,25
25683,Asaltofsorts,tichondrius,1390,monk,windwalker,30,18,12
25684,Onepunchman,quelthalas,1389,monk,windwalker,51,19,32
25685,Versuri,azralon,1387,monk,windwalker,117,60,57
25686,Shlumpuh,tichondrius,1385,monk,windwalker,42,18,24
25687,Trapeez,kelthuzad,1383,monk,windwalker,70,40,30
25688,Mannkin,zuluhed,1383,monk,windwalker,38,16,22
25689,Kawasakii,tichondrius,1382,monk,windwalker,166,83,83
25690,Pepepunch,bleeding-hollow,1381,monk,windwalker,36,15,21
25691,Niked,tichondrius,1379,monk,windwalker,36,15,21
25692,Chopsake,khadgar,1377,monk,windwalker,66,40,26
25693,Shianjuo,ragnaros,1372,monk,windwalker,42,20,22
25694,Eavale,destromath,1371,monk,windwalker,121,61,60
25695,Bradyfour,moon-guard,1370,monk,windwalker,83,42,41
25696,Tacofox,tichondrius,1369,monk,windwalker,119,57,62
25697,Tassmonk,hyjal,1367,monk,windwalker,36,17,19
25698,Brewmaker,sargeras,1366,monk,windwalker,51,24,27
25699,Varekaî,frostmourne,1365,monk,windwalker,62,32,30
25700,Chigang,deathwing,1362,monk,windwalker,42,22,20
25701,Screwballz,blackrock,1360,monk,windwalker,117,53,64
25702,Headsmasher,wyrmrest-accord,1359,monk,windwalker,113,51,62
25703,Sarious,lightbringer,1354,monk,windwalker,273,142,131
25704,Kriticalkush,kelthuzad,1353,monk,windwalker,24,17,7
25705,Chihad,stormrage,1352,monk,windwalker,42,25,17
25706,Owned,dreadmaul,1349,monk,windwalker,36,23,13
25707,Kungfusacks,sargeras,1346,monk,windwalker,24,16,8
25708,Sultanofwind,malganis,1344,monk,windwalker,24,14,10
25709,Dalearnhardt,proudmoore,1343,monk,windwalker,18,14,4
25710,Zuì,sargeras,1342,monk,windwalker,24,14,10
25711,Astrofu,tichondrius,1341,monk,windwalker,82,34,48
25712,Dakenprime,tichondrius,1340,monk,windwalker,82,40,42
25713,Telospateo,ragnaros,1340,monk,windwalker,30,14,16
25714,Obiiwan,tichondrius,1340,monk,windwalker,42,17,25
25715,Bluntdoctor,stormreaver,1340,monk,windwalker,66,24,42
25716,Dkdakìng,stormrage,1339,monk,windwalker,24,14,10
25717,Gigagirth,emerald-dream,1338,monk,windwalker,30,14,16
25718,Skymonge,stormrage,1338,monk,windwalker,104,48,56
25719,Tingum,kelthuzad,1337,monk,windwalker,34,15,19
25720,Ghaelessi,senjin,1336,monk,windwalker,77,42,35
25721,Novoctek,quelthalas,1336,monk,windwalker,30,14,16
25722,Büster,tichondrius,1334,monk,windwalker,24,14,10
25723,Raskalnikov,kelthuzad,1334,monk,windwalker,32,16,16
25724,Kungfüsed,stormrage,1329,monk,windwalker,36,19,17
25725,Resolver,stormscale,1327,monk,windwalker,52,27,25
25726,Yeji,altar-of-storms,1326,monk,windwalker,24,14,10
25727,Saltystepbro,illidan,1323,monk,windwalker,24,14,10
25728,Æeeæ,hakkar,1318,monk,windwalker,18,14,4
25729,Jajabelugeng,tichondrius,1315,monk,windwalker,24,14,10
25730,Omimonk,sargeras,1314,monk,windwalker,24,14,10
25731,Shocclol,stormrage,1306,monk,windwalker,27,17,10
25732,Acharä,tichondrius,1305,monk,windwalker,36,20,16
25733,Goonkeg,frostmourne,1304,monk,windwalker,30,14,16
25734,Madbuffz,nemesis,1304,monk,windwalker,72,32,40
25735,Twïst,tichondrius,1303,monk,windwalker,18,14,4
25736,Xiaowën,nemesis,1300,monk,windwalker,63,31,32
25737,Owenxdd,stormrage,1299,monk,windwalker,62,33,29
25738,Xøxo,trollbane,1299,monk,windwalker,48,22,26
25739,Tianhu,sargeras,1295,monk,windwalker,36,20,16
25740,Tino,kelthuzad,1295,monk,windwalker,66,35,31
25741,Jacquelline,moon-guard,1294,monk,windwalker,36,19,17
25742,Anarska,thrall,1291,monk,windwalker,96,46,50
25743,Çhëèch,tichondrius,1291,monk,windwalker,47,20,27
25744,Dodried,ragnaros,1290,monk,windwalker,52,24,28
25745,Yrn,crushridge,1287,monk,windwalker,60,32,28
25746,Fanetö,stormrage,1283,monk,windwalker,48,15,33
25747,Highku,drenden,1282,monk,windwalker,30,17,13
25748,Opmother,elune,1279,monk,windwalker,47,26,21
25749,Smalltall,area-52,1278,monk,windwalker,26,14,12
25750,Siddharthä,barthilas,1274,monk,windwalker,36,20,16
25751,Rbs,tichondrius,1274,monk,windwalker,87,35,52
25752,Hitchslapz,tichondrius,1271,monk,windwalker,30,15,15
25753,Garmakasmonk,skullcrusher,1269,monk,windwalker,40,19,21
25754,Wutangkillaß,kiljaeden,1266,monk,windwalker,48,18,30
25755,Weezzyboi,tichondrius,1263,monk,windwalker,42,22,20
25756,Natus,greymane,1262,monk,windwalker,36,18,18
25757,Calmpunchman,mannoroth,1258,monk,windwalker,31,14,17
25758,Murder,magtheridon,1256,monk,windwalker,43,21,22
25759,Renrukie,frostmourne,1256,monk,windwalker,30,14,16
25760,Supremekick,frostmourne,1254,monk,windwalker,43,27,16
25761,Pangpoong,tichondrius,1249,monk,windwalker,99,44,55
25762,Baconbiscuit,area-52,1247,monk,windwalker,30,13,17
25763,ßájkà,area-52,1247,monk,windwalker,30,13,17
25764,Prostotak,area-52,1246,monk,windwalker,18,13,5
25765,Molta,tichondrius,1246,monk,windwalker,24,13,11
25766,Pamii,quelthalas,1246,monk,windwalker,36,13,23
25767,Båshkin,terenas,1245,monk,windwalker,42,19,23
25768,Hèàvy,stormrage,1244,monk,windwalker,24,13,11
25769,Bükki,ragnaros,1243,monk,windwalker,18,13,5
25770,Bowlbreak,sargeras,1243,monk,windwalker,36,20,16
25771,Nuclearpunch,tichondrius,1242,monk,windwalker,24,13,11
25772,Rozlynnww,tichondrius,1242,monk,windwalker,24,13,11
25773,Gelgameks,eredar,1242,monk,windwalker,30,13,17
25774,Sedition,emerald-dream,1241,monk,windwalker,94,46,48
25775,Killmachine,farstriders,1241,monk,windwalker,189,91,98
25776,Grocerymonk,malganis,1240,monk,windwalker,30,13,17
25777,Xinghao,tichondrius,1240,monk,windwalker,30,13,17
25778,Honkbazz,illidan,1238,monk,windwalker,30,13,17
25779,Slapcîty,bleeding-hollow,1238,monk,windwalker,30,13,17
25780,Blumpfu,thrall,1235,monk,windwalker,24,13,11
25781,Ilvory,tichondrius,1235,monk,windwalker,30,13,17
25782,Metios,aggramar,1234,monk,windwalker,52,22,30
25783,Felgolos,azralon,1232,monk,windwalker,27,17,10
25784,Zettelkasten,tichondrius,1232,monk,windwalker,72,35,37
25785,Ipnam,kelthuzad,1231,monk,windwalker,22,14,8
25786,Starymww,tichondrius,1230,monk,windwalker,24,13,11
25787,Finesse,frostwolf,1227,monk,windwalker,18,13,5
25788,Ruckm,stormrage,1225,monk,windwalker,24,13,11
25789,Currycooker,tichondrius,1220,monk,windwalker,29,13,16
25790,Kungxxl,kiljaeden,1219,monk,windwalker,95,44,51
25791,Razielic,frostmourne,1212,monk,windwalker,66,29,37
25792,Rasta,ragnaros,1211,monk,windwalker,30,17,13
25793,Weewalker,wyrmrest-accord,1207,monk,windwalker,27,14,13
25794,Gurda,wyrmrest-accord,1203,monk,windwalker,72,34,38
25795,Ofn,moon-guard,1202,monk,windwalker,96,45,51
25796,Xéia,area-52,1201,monk,windwalker,60,23,37
25797,Rufaso,sargeras,1199,monk,windwalker,54,24,30
25798,Wwmonks,sargeras,1197,monk,windwalker,18,13,5
25799,Honeyjaem,tichondrius,1193,monk,windwalker,29,14,15
25800,Xxvbamm,thrall,1193,monk,windwalker,29,13,16
25801,Stickyloads,illidan,1190,monk,windwalker,78,35,43
25802,Marstol,bleeding-hollow,1186,monk,windwalker,53,31,22
25803,Leehofook,azshara,1180,monk,windwalker,84,40,44
25804,Slapstun,barthilas,1176,monk,windwalker,77,28,49
25805,Hinakii,dalaran,1175,monk,windwalker,144,62,82
25806,Moopdahoop,stormrage,1174,monk,windwalker,124,67,57
25807,Sleepÿ,area-52,1171,monk,windwalker,84,34,50
25808,Milktank,medivh,1167,monk,windwalker,69,40,29
25809,Mommysalamii,moon-guard,1167,monk,windwalker,25,13,12
25810,Anavara,drakkari,1160,monk,windwalker,48,24,24
25811,Kandinarra,jubeithos,1156,monk,windwalker,58,31,27
25812,Habana,stormreaver,1155,monk,windwalker,54,20,34
25813,Sahhalea,sargeras,1153,monk,windwalker,56,25,31
25814,Linkya,daggerspine,1152,monk,windwalker,22,14,8
25815,Xedou,azralon,1151,monk,windwalker,18,12,6
25816,Soprà,zuljin,1151,monk,windwalker,24,12,12
25817,Lalpu,tichondrius,1151,monk,windwalker,30,12,18
25818,Hybrid,stormrage,1150,monk,windwalker,18,12,6
25819,Mcbluffin,onyxia,1150,monk,windwalker,18,12,6
25820,Hulkapro,azralon,1150,monk,windwalker,51,30,21
25821,Pikotaro,tichondrius,1150,monk,windwalker,24,12,12
25822,Antiherox,sargeras,1149,monk,windwalker,18,12,6
25823,Jabman,stormrage,1149,monk,windwalker,33,13,20
25824,Bigfel,nazjatar,1148,monk,windwalker,24,12,12
25825,Boxxzer,kelthuzad,1147,monk,windwalker,18,12,6
25826,Dobsy,bleeding-hollow,1147,monk,windwalker,24,12,12
25827,Stendari,moon-guard,1147,monk,windwalker,30,12,18
25828,Misery,stormscale,1146,monk,windwalker,23,15,8
25829,Omashu,nemesis,1145,monk,windwalker,24,12,12
25830,Tenshu,runetotem,1141,monk,windwalker,24,12,12
25831,Mechabre,stormrage,1140,monk,windwalker,18,12,6
25832,Acindian,malganis,1140,monk,windwalker,36,18,18
25833,Ugrak,chogall,1140,monk,windwalker,24,12,12
25834,Píñg,area-52,1140,monk,windwalker,33,13,20
25835,Delorenzi,hellscream,1137,monk,windwalker,24,12,12
25836,Kfpeeves,sargeras,1134,monk,windwalker,30,15,15
25837,Shinjiki,tichondrius,1134,monk,windwalker,29,12,17
25838,Duwhack,wyrmrest-accord,1133,monk,windwalker,30,12,18
25839,Bigxthaplug,moon-guard,1132,monk,windwalker,30,12,18
25840,Boldyr,sargeras,1128,monk,windwalker,24,12,12
25841,Shinaniganz,chogall,1128,monk,windwalker,42,17,25
25842,Iamanangel,illidan,1127,monk,windwalker,30,20,10
25843,Spinning,nagrand,1122,monk,windwalker,30,12,18
25844,Monkii,bonechewer,1121,monk,windwalker,33,21,12
25845,Stigzz,stormrage,1118,monk,windwalker,23,12,11
25846,Jimothydab,lightbringer,1117,monk,windwalker,23,12,11
25847,Gorton,lightbringer,1114,monk,windwalker,24,12,12
25848,Vetism,thrall,1113,monk,windwalker,22,12,10
25849,Imonkalot,destromath,1111,monk,windwalker,55,23,32
25850,Lyfegiver,blackrock,1110,monk,windwalker,20,13,7
25851,Jinpo,lightninghoof,1110,monk,windwalker,60,32,28
25852,Loadedfries,frostmourne,1110,monk,windwalker,24,12,12
25853,Silvopanda,azralon,1108,monk,windwalker,161,79,82
25854,Fitmonje,drakkari,1108,monk,windwalker,28,13,15
25855,Lexivixi,khazgoroth,1103,monk,windwalker,96,48,48
25856,Tochtlea,wyrmrest-accord,1102,monk,windwalker,23,12,11
25857,Drektarz,area-52,1098,monk,windwalker,111,52,59
25858,Angerday,illidan,1097,monk,windwalker,30,12,18
25859,Deadlyfist,stormrage,1089,monk,windwalker,47,19,28
25860,Vokarhi,whisperwind,1082,monk,windwalker,24,15,9
25861,Lööpér,tichondrius,1081,monk,windwalker,24,13,11
25862,Ojiin,wyrmrest-accord,1079,monk,windwalker,24,13,11
25863,Quanon,stormreaver,1071,monk,windwalker,33,14,19
25864,Sandii,azralon,1070,monk,windwalker,87,48,39
25865,Tokyozesty,area-52,1056,monk,windwalker,18,11,7
25866,Yavaxye,stormrage,1056,monk,windwalker,24,11,13
25867,Songokusan,thrall,1055,monk,windwalker,18,11,7
25868,Whitepandax,tichondrius,1055,monk,windwalker,18,11,7
25869,Rubntug,zuljin,1055,monk,windwalker,18,11,7
25870,Abenobashi,malganis,1055,monk,windwalker,18,11,7
25871,Hate,korialstrasz,1055,monk,windwalker,18,11,7
25872,Sockem,arthas,1055,monk,windwalker,24,11,13
25873,Monkfy,moon-guard,1054,monk,windwalker,17,11,6
25874,Monkamax,tichondrius,1054,monk,windwalker,18,11,7
25875,Powerfisterr,stormrage,1054,monk,windwalker,18,11,7
25876,Zenpachi,hyjal,1053,monk,windwalker,27,11,16
25877,Wimdrewk,quelthalas,1053,monk,windwalker,39,12,27
25878,Kristiana,aegwynn,1052,monk,windwalker,18,11,7
25879,Razekahl,wyrmrest-accord,1052,monk,windwalker,30,11,19
25880,Hira,zuljin,1052,monk,windwalker,30,11,19
25881,Zenkam,ragnaros,1052,monk,windwalker,30,11,19
25882,Drunkmaster,frostmourne,1051,monk,windwalker,18,11,7
25883,Lotusdream,argent-dawn,1051,monk,windwalker,23,11,12
25884,Suntzuvius,tichondrius,1050,monk,windwalker,24,11,13
25885,Turbodyne,tichondrius,1050,monk,windwalker,24,11,13
25886,Whtnyhuston,sargeras,1049,monk,windwalker,24,11,13
25887,Chowlaos,coilfang,1048,monk,windwalker,18,11,7
25888,Miyage,emerald-dream,1045,monk,windwalker,54,31,23
25889,Caulífla,barthilas,1045,monk,windwalker,24,11,13
25890,Chaosrose,area-52,1044,monk,windwalker,18,11,7
25891,Aedale,emerald-dream,1044,monk,windwalker,45,23,22
25892,Tremonk,kelthuzad,1043,monk,windwalker,18,11,7
25893,Tert,aerie-peak,1043,monk,windwalker,24,11,13
25894,Tsubal,mugthol,1042,monk,windwalker,18,11,7
25895,Gentlefists,sargeras,1041,monk,windwalker,24,11,13
25896,Hylithia,proudmoore,1040,monk,windwalker,30,17,13
25897,Tobearus,stormscale,1038,monk,windwalker,35,18,17
25898,Jnx,emerald-dream,1038,monk,windwalker,24,11,13
25899,Arshavin,skullcrusher,1038,monk,windwalker,30,11,19
25900,Mcnipple,moonrunner,1036,monk,windwalker,18,11,7
25901,Dynamo,blackrock,1036,monk,windwalker,30,11,19
25902,Kungfused,frostmourne,1035,monk,windwalker,30,11,19
25903,Natintell,drakkari,1032,monk,windwalker,71,33,38
25904,Abboo,hyjal,1030,monk,windwalker,24,12,12
25905,Blackychan,scilla,1027,monk,windwalker,36,15,21
25906,Steenkk,tichondrius,1023,monk,windwalker,24,11,13
25907,Sébástián,drakkari,1021,monk,windwalker,52,28,24
25908,Åsurã,stormrage,1021,monk,windwalker,34,11,23
25909,Leafondawind,boulderfist,1020,monk,windwalker,29,11,18
25910,Tzidkiyahu,barthilas,1018,monk,windwalker,28,16,12
25911,Rosarìolover,stormrage,1008,monk,windwalker,36,18,18
25912,Bonflur,quelthalas,1007,monk,windwalker,352,173,179
25913,Averagewang,sargeras,1002,monk,windwalker,54,28,26
25914,Brewzllee,tichondrius,1000,monk,windwalker,66,34,32
25915,Nutcrakerz,tichondrius,995,monk,windwalker,30,18,12
25916,Romeoe,muradin,992,monk,windwalker,30,11,19
25917,Fatde,daggerspine,991,monk,windwalker,47,27,20
25918,Traxshin,kelthuzad,982,monk,windwalker,30,12,18
25919,Rollsroycist,trollbane,975,monk,windwalker,49,27,22
25920,Kush,dalvengyr,969,monk,windwalker,33,15,18
25921,Mynamegeorge,area-52,968,monk,windwalker,46,21,25
25922,Ðilara,area-52,960,monk,windwalker,12,10,2
25923,Kegrolls,proudmoore,960,monk,windwalker,12,10,2
25924,Aýre,ravencrest,960,monk,windwalker,12,10,2
25925,Fettywhopper,kaelthas,960,monk,windwalker,12,10,2
25926,Glad,tichondrius,960,monk,windwalker,12,10,2
25927,Shadmtwo,tichondrius,960,monk,windwalker,12,10,2
25928,Xuenfu,tichondrius,960,monk,windwalker,18,10,8
25929,Afrosamurai,thrall,960,monk,windwalker,18,10,8
25930,Zoomerxd,stormrage,960,monk,windwalker,18,10,8
25931,Hitt,barthilas,960,monk,windwalker,24,10,14
25932,Kinkykyle,emerald-dream,960,monk,windwalker,24,10,14
25933,Tazermw,sargeras,959,monk,windwalker,12,10,2
25934,Rskmedaddy,tichondrius,959,monk,windwalker,12,10,2
25935,Plotting,tichondrius,959,monk,windwalker,18,10,8
25936,Goldfornudez,area-52,959,monk,windwalker,18,10,8
25937,Kaize,sargeras,959,monk,windwalker,18,10,8
25938,Undertickle,illidan,959,monk,windwalker,18,10,8
25939,Iol,whisperwind,959,monk,windwalker,18,10,8
25940,Neejitsu,malganis,959,monk,windwalker,18,10,8
25941,Jnco,thrall,958,monk,windwalker,18,10,8
25942,Zunfu,tichondrius,958,monk,windwalker,18,10,8
25943,Thiccdih,area-52,958,monk,windwalker,24,10,14
25944,Sxywind,azgalor,957,monk,windwalker,18,10,8
25945,Mônkdunk,daggerspine,957,monk,windwalker,18,10,8
25946,Avz,azralon,957,monk,windwalker,24,10,14
25947,Memonk,ysera,957,monk,windwalker,24,10,14
25948,Vuadeira,azralon,957,monk,windwalker,30,10,20
25949,Skyvaan,barthilas,956,monk,windwalker,18,10,8
25950,Ezpzmonk,bloodscalp,956,monk,windwalker,21,11,10
25951,Dangodxz,quelthalas,955,monk,windwalker,22,11,11
25952,Thalreyzian,vashj,954,monk,windwalker,24,10,14
25953,Megatraun,tichondrius,953,monk,windwalker,18,10,8
25954,Alcaquito,goldrinn,950,monk,windwalker,18,10,8
25955,Samaelsin,emerald-dream,948,monk,windwalker,30,10,20
25956,Hehex,bleeding-hollow,943,monk,windwalker,23,10,13
25957,Madmint,illidan,941,monk,windwalker,23,11,12
25958,Ryucko,azralon,933,monk,windwalker,18,10,8
25959,Mcwallets,moon-guard,933,monk,windwalker,78,33,45
25960,Nedpanders,nagrand,930,monk,windwalker,18,11,7
25961,Thäiländiä,bleeding-hollow,928,monk,windwalker,36,20,16
25962,Reeperfist,area-52,927,monk,windwalker,14,11,3
25963,Clytpuncher,emerald-dream,926,monk,windwalker,23,10,13
25964,Shnooze,barthilas,926,monk,windwalker,66,23,43
25965,Poanda,illidan,914,monk,windwalker,24,13,11
25966,Thedeäd,stormrage,904,monk,windwalker,42,13,29
25967,Scarlos,tichondrius,894,monk,windwalker,199,94,105
25968,Raninn,bleeding-hollow,894,monk,windwalker,22,10,12
25969,Ipmán,moon-guard,892,monk,windwalker,41,18,23
25970,Veganbacon,mannoroth,875,monk,windwalker,14,10,4
25971,Poormanx,illidan,864,monk,windwalker,12,9,3
25972,Gucchimane,illidan,864,monk,windwalker,12,9,3
25973,Rhyskrispiez,sargeras,864,monk,windwalker,12,9,3
25974,Wwrizz,frostmane,864,monk,windwalker,12,9,3
25975,Loenius,wyrmrest-accord,864,monk,windwalker,12,9,3
25976,Arunaa,tichondrius,864,monk,windwalker,12,9,3
25977,Jaige,illidan,864,monk,windwalker,18,9,9
25978,Tmjojo,tichondrius,864,monk,windwalker,24,9,15
25979,Chiang,chogall,864,monk,windwalker,24,9,15
25980,Poem,grizzly-hills,863,monk,windwalker,12,9,3
25981,Danksweaver,malganis,863,monk,windwalker,12,9,3
25982,Aligned,zuljin,863,monk,windwalker,12,9,3
25983,Stepsista,sargeras,863,monk,windwalker,18,9,9
25984,Helicopter,borean-tundra,863,monk,windwalker,18,9,9
25985,Tomatosaucin,area-52,863,monk,windwalker,18,9,9
25986,Rodign,hyjal,863,monk,windwalker,18,9,9
25987,Vandamme,durotan,863,monk,windwalker,18,9,9
25988,Azzmane,bronzebeard,863,monk,windwalker,18,9,9
25989,Röllup,area-52,863,monk,windwalker,18,9,9
25990,Kahpital,azralon,863,monk,windwalker,18,9,9
25991,Inko,ragnaros,863,monk,windwalker,24,9,15
25992,Somethingre,sargeras,862,monk,windwalker,12,9,3
25993,Mapaly,ragnaros,862,monk,windwalker,18,9,9
25994,Funji,skullcrusher,862,monk,windwalker,18,9,9
25995,Kaishya,emerald-dream,861,monk,windwalker,12,9,3
25996,Kentodne,stormrage,861,monk,windwalker,18,9,9
25997,Zackesé,area-52,861,monk,windwalker,24,9,15
25998,Pandagendon,quelthalas,860,monk,windwalker,12,9,3
25999,Arimonk,mannoroth,860,monk,windwalker,18,9,9
26000,Ryútt,illidan,860,monk,windwalker,24,9,15
26001,Romeonjuliet,tichondrius,859,monk,windwalker,18,9,9
26002,Legsweeps,tichondrius,859,monk,windwalker,24,9,15
26003,Selfless,gilneas,858,monk,windwalker,18,9,9
26004,Anatomyx,kelthuzad,858,monk,windwalker,18,9,9
26005,Acena,stormrage,856,monk,windwalker,24,9,15
26006,Rowenoa,tichondrius,856,monk,windwalker,30,9,21
26007,Pastarasta,malganis,854,monk,windwalker,18,10,8
26008,Hairybadger,destromath,848,monk,windwalker,12,9,3
26009,Agroétudo,azralon,838,monk,windwalker,18,9,9
26010,Phuumyn,llane,829,monk,windwalker,17,9,8
26011,Thekilla,aegwynn,827,monk,windwalker,18,9,9
26012,Knuckbutter,sargeras,824,monk,windwalker,33,11,22
26013,Nobmaster,garrosh,815,monk,windwalker,22,9,13
26014,Scoobfly,illidan,814,monk,windwalker,17,9,8
26015,Lolqtxd,sargeras,810,monk,windwalker,26,10,16
26016,Cráne,duskwood,797,monk,windwalker,14,9,5
26017,Tulalong,area-52,797,monk,windwalker,20,9,11
26018,Yeonguo,drakthul,795,monk,windwalker,16,9,7
26019,Rykouu,area-52,784,monk,windwalker,19,9,10
26020,Axtîn,stormreaver,768,monk,windwalker,12,8,4
26021,Crakgirl,malganis,768,monk,windwalker,12,8,4
26022,Sistuhfista,tichondrius,768,monk,windwalker,12,8,4
26023,Kungpaochicn,tichondrius,768,monk,windwalker,12,8,4
26024,Twichyling,tichondrius,768,monk,windwalker,12,8,4
26025,Involve,tichondrius,768,monk,windwalker,12,8,4
26026,Awfulww,tichondrius,768,monk,windwalker,12,8,4
26027,Khungfeu,area-52,768,monk,windwalker,12,8,4
26028,Hitman,thrall,768,monk,windwalker,12,8,4
26029,Kkonaman,illidan,768,monk,windwalker,12,8,4
26030,Bootowsky,zuljin,768,monk,windwalker,12,8,4
26031,Kambrielx,zuljin,768,monk,windwalker,12,8,4
26032,Jamaldamort,sargeras,768,monk,windwalker,12,8,4
26033,Kfchi,tichondrius,768,monk,windwalker,16,9,7
26034,Rerolled,moon-guard,768,monk,windwalker,18,8,10
26035,Miuss,illidan,768,monk,windwalker,18,8,10
26036,Stepfistz,aegwynn,768,monk,windwalker,18,8,10
26037,Richywayne,bleeding-hollow,768,monk,windwalker,18,8,10
26038,Güwop,tichondrius,768,monk,windwalker,18,8,10
26039,Gnomepuncher,dalaran,768,monk,windwalker,18,8,10
26040,Mahatmä,dalaran,768,monk,windwalker,18,8,10
26041,Amphíon,kelthuzad,768,monk,windwalker,18,8,10
26042,Ludenz,emerald-dream,768,monk,windwalker,18,8,10
26043,Slimcognito,zuljin,768,monk,windwalker,18,8,10
26044,Ballok,bleeding-hollow,768,monk,windwalker,18,8,10
26045,Taggz,thunderlord,768,monk,windwalker,18,8,10
26046,Skela,emerald-dream,768,monk,windwalker,18,8,10
26047,Goonsy,tichondrius,768,monk,windwalker,18,8,10
26048,Leegueen,tichondrius,768,monk,windwalker,18,8,10
26049,Röllö,tichondrius,768,monk,windwalker,21,9,12
26050,Blackìce,sargeras,768,monk,windwalker,24,8,16
26051,Monke,onyxia,768,monk,windwalker,24,8,16
26052,Shinobiww,area-52,768,monk,windwalker,24,8,16
26053,Raikou,frostmourne,767,monk,windwalker,12,8,4
26054,Tews,quelthalas,767,monk,windwalker,12,8,4
26055,Prickhead,sargeras,767,monk,windwalker,15,9,6
26056,Fumoo,sargeras,767,monk,windwalker,16,9,7
26057,Xunzao,emerald-dream,767,monk,windwalker,18,8,10
26058,Silkzy,frostwolf,767,monk,windwalker,18,8,10
26059,Faashbae,illidan,767,monk,windwalker,18,8,10
26060,Supernam,sargeras,767,monk,windwalker,18,8,10
26061,Biggyballs,tichondrius,767,monk,windwalker,18,8,10
26062,Akrethar,medivh,767,monk,windwalker,18,8,10
26063,Metalmønk,nerzhul,767,monk,windwalker,18,8,10
26064,Iarw,tichondrius,767,monk,windwalker,18,8,10
26065,Aydowon,illidan,767,monk,windwalker,18,8,10
26066,Pipochen,ragnaros,767,monk,windwalker,18,8,10
26067,Suspicious,malfurion,767,monk,windwalker,18,8,10
26068,Zukki,zuljin,767,monk,windwalker,18,8,10
26069,Luckystrike,area-52,767,monk,windwalker,24,8,16
26070,Yoshimotto,area-52,766,monk,windwalker,12,8,4
26071,Nf,zuljin,766,monk,windwalker,12,8,4
26072,Ragraxx,quelthalas,766,monk,windwalker,18,8,10
26073,Karatay,tichondrius,765,monk,windwalker,12,8,4
26074,Jackboi,the-underbog,765,monk,windwalker,24,8,16
26075,Jãe,stormrage,764,monk,windwalker,24,8,16
26076,Extinctión,stormscale,762,monk,windwalker,12,8,4
26077,Sprinkli,sargeras,761,monk,windwalker,24,8,16
26078,Kïri,wyrmrest-accord,760,monk,windwalker,15,9,6
26079,Ogre,the-venture-co,756,monk,windwalker,18,8,10
26080,Kilabit,azshara,756,monk,windwalker,44,19,25
26081,Kylièjenner,gilneas,755,monk,windwalker,18,8,10
26082,Wodinswolf,sargeras,749,monk,windwalker,18,8,10
26083,Hontaruk,ragnaros,749,monk,windwalker,29,8,21
26084,Deathgoku,norgannon,735,monk,windwalker,17,8,9
26085,Shinjaru,area-52,735,monk,windwalker,22,8,14
26086,Habanèro,tichondrius,734,monk,windwalker,17,8,9
26087,Alkaholik,stormrage,719,monk,windwalker,23,8,15
26088,Chaipie,kelthuzad,703,monk,windwalker,11,8,3
26089,Onepunch,exodar,702,monk,windwalker,14,8,6
26090,Kurha,queldorei,690,monk,windwalker,24,8,16
26091,Strokahontas,stormreaver,672,monk,windwalker,12,7,5
26092,Jwazz,tichondrius,672,monk,windwalker,12,7,5
26093,Peterpunch,illidan,672,monk,windwalker,12,7,5
26094,Shry,kiljaeden,672,monk,windwalker,12,7,5
26095,Incaustik,ragnaros,672,monk,windwalker,12,7,5
26096,Ganjäsmoke,skullcrusher,672,monk,windwalker,12,7,5
26097,Goldx,ragnaros,672,monk,windwalker,12,7,5
26098,Danzr,ragnaros,672,monk,windwalker,12,7,5
26099,Touchbot,tichondrius,672,monk,windwalker,12,7,5
26100,Bibis,sargeras,672,monk,windwalker,12,7,5
26101,Porxhub,tichondrius,672,monk,windwalker,12,7,5
26102,Redami,gnomeregan,672,monk,windwalker,12,7,5
26103,Shiphappens,barthilas,672,monk,windwalker,12,7,5
26104,Atengie,stormrage,672,monk,windwalker,12,7,5
26105,Kudrix,frostwolf,672,monk,windwalker,12,7,5
26106,Bramicaye,malganis,672,monk,windwalker,12,7,5
26107,Yoojimin,kiljaeden,672,monk,windwalker,12,7,5
26108,Crittinka,bonechewer,672,monk,windwalker,12,7,5
26109,Gothamonk,tichondrius,672,monk,windwalker,12,7,5
26110,Ázão,stormrage,672,monk,windwalker,12,7,5
26111,Bangtanboy,tichondrius,672,monk,windwalker,12,7,5
26112,Kryptikkyt,gilneas,672,monk,windwalker,12,7,5
26113,Goosyloosy,dathremar,672,monk,windwalker,12,7,5
26114,Monkuban,destromath,672,monk,windwalker,12,7,5
26115,Tag,tichondrius,672,monk,windwalker,12,7,5
26116,Jxyfist,illidan,672,monk,windwalker,12,7,5
26117,Garofalo,tichondrius,672,monk,windwalker,12,7,5
26118,Dragonwhirl,stormrage,672,monk,windwalker,12,7,5
26119,Lilpøøter,tichondrius,672,monk,windwalker,12,7,5
26120,Dublefist,draktharon,672,monk,windwalker,12,7,5
26121,Ftxyolo,azralon,672,monk,windwalker,12,7,5
26122,Ristion,moon-guard,672,monk,windwalker,12,7,5
26123,Buffmonkdmg,tichondrius,672,monk,windwalker,15,8,7
26124,Tapzm,area-52,672,monk,windwalker,18,7,11
26125,Stevezee,barthilas,672,monk,windwalker,18,7,11
26126,Verizani,stormrage,672,monk,windwalker,18,7,11
26127,Popchi,stormrage,672,monk,windwalker,18,7,11
26128,Paracetamonk,kelthuzad,672,monk,windwalker,18,7,11
26129,Pandaforlife,area-52,672,monk,windwalker,18,7,11
26130,Awcfanboy,bleeding-hollow,672,monk,windwalker,21,8,13
26131,Monkyun,tichondrius,672,monk,windwalker,24,7,17
26132,Kapoerista,azralon,671,monk,windwalker,12,7,5
26133,Reckin,frostmourne,671,monk,windwalker,12,7,5
26134,Døjø,dalaran,671,monk,windwalker,12,7,5
26135,Mosaden,suramar,671,monk,windwalker,12,7,5
26136,Bauddor,ragnaros,671,monk,windwalker,12,7,5
26137,Bataan,tichondrius,671,monk,windwalker,12,7,5
26138,Qebui,darkspear,671,monk,windwalker,12,7,5
26139,Quietbegger,sargeras,671,monk,windwalker,12,7,5
26140,Keys,earthen-ring,671,monk,windwalker,12,7,5
26141,Drainar,bleeding-hollow,671,monk,windwalker,12,7,5
26142,Leozen,skullcrusher,671,monk,windwalker,18,7,11
26143,Inaruss,ragnaros,671,monk,windwalker,18,7,11
26144,Huángbó,blackhand,670,monk,windwalker,10,8,2
26145,Astorari,illidan,670,monk,windwalker,12,7,5
26146,Minusmonk,dalaran,670,monk,windwalker,12,7,5
26147,Cryptique,tichondrius,670,monk,windwalker,12,7,5
26148,Solafyde,aerie-peak,670,monk,windwalker,16,8,8
26149,Merand,tichondrius,670,monk,windwalker,18,7,11
26150,Dekù,ragnaros,669,monk,windwalker,12,7,5
26151,Santiie,drakkari,669,monk,windwalker,18,7,11
26152,Elmanteca,ragnaros,668,monk,windwalker,12,7,5
26153,Kuungfoo,tichondrius,667,monk,windwalker,12,7,5
26154,Hyun,stormrage,666,monk,windwalker,12,7,5
26155,Liänä,quelthalas,658,monk,windwalker,18,7,11
26156,Honghong,kargath,655,monk,windwalker,17,8,9
26157,Léesin,stormrage,655,monk,windwalker,17,7,10
26158,Titsmagees,frostwolf,639,monk,windwalker,23,7,16
26159,Shadowstripe,the-venture-co,638,monk,windwalker,11,7,4
26160,Mùnkey,nagrand,638,monk,windwalker,17,7,10
26161,Fmbbasedgód,tichondrius,623,monk,windwalker,17,7,10
26162,Iilmachoggy,stormrage,607,monk,windwalker,11,7,4
26163,Sistafistaa,akama,606,monk,windwalker,14,7,7
26164,Goblinitto,archimonde,576,monk,windwalker,6,6,0
26165,Srýbrø,illidan,576,monk,windwalker,6,6,0
26166,Selfîe,ysera,576,monk,windwalker,6,6,0
26167,Griswolld,ragnaros,576,monk,windwalker,6,6,0
26168,Aveium,moon-guard,576,monk,windwalker,6,6,0
26169,Makgøra,malganis,576,monk,windwalker,6,6,0
26170,Bonzibuddy,barthilas,576,monk,windwalker,12,6,6
26171,Fivebears,blackwing-lair,576,monk,windwalker,12,6,6
26172,Monksoon,tichondrius,576,monk,windwalker,12,6,6
26173,Tribunez,stormrage,576,monk,windwalker,12,6,6
26174,Kaminagi,proudmoore,576,monk,windwalker,12,6,6
26175,Frânkdux,tichondrius,576,monk,windwalker,12,6,6
26176,Affected,lightninghoof,576,monk,windwalker,12,6,6
26177,Tahs,azralon,576,monk,windwalker,12,6,6
26178,Xoir,tichondrius,576,monk,windwalker,12,6,6
26179,Yimmy,zuluhed,576,monk,windwalker,12,6,6
26180,Läôtzu,fizzcrank,576,monk,windwalker,12,6,6
26181,Brewlong,area-52,576,monk,windwalker,12,6,6
26182,Silvyrx,boulderfist,576,monk,windwalker,12,6,6
26183,Monasticc,undermine,576,monk,windwalker,12,6,6
26184,Rafyww,tichondrius,576,monk,windwalker,12,6,6
26185,Detoxalt,sargeras,576,monk,windwalker,12,6,6
26186,Funtscat,zuljin,576,monk,windwalker,12,6,6
26187,Syffer,sargeras,576,monk,windwalker,12,6,6
26188,Gaps,ragnaros,576,monk,windwalker,12,6,6
26189,Jubei,dragonmaw,576,monk,windwalker,12,6,6
26190,Bakacia,ragnaros,576,monk,windwalker,12,6,6
26191,Fúgg,zuljin,576,monk,windwalker,12,6,6
26192,Varicin,zuljin,576,monk,windwalker,12,6,6
26193,Dippy,moon-guard,576,monk,windwalker,12,6,6
26194,Bvndio,ragnaros,576,monk,windwalker,12,6,6
26195,Santatsu,emerald-dream,576,monk,windwalker,12,6,6
26196,Birgs,sargeras,576,monk,windwalker,12,6,6
26197,Orcslam,tichondrius,576,monk,windwalker,12,6,6
26198,Kawasakizph,tichondrius,576,monk,windwalker,12,6,6
26199,Grandsonweez,thrall,576,monk,windwalker,12,6,6
26200,Creamchop,stormreaver,576,monk,windwalker,12,6,6
26201,Jaykun,ragnaros,576,monk,windwalker,12,6,6
26202,Xua,sargeras,576,monk,windwalker,12,6,6
26203,Tinypunch,emerald-dream,576,monk,windwalker,12,6,6
26204,Guuttzz,area-52,576,monk,windwalker,12,6,6
26205,Coldridge,bleeding-hollow,576,monk,windwalker,12,6,6
26206,Forthekicks,tichondrius,576,monk,windwalker,19,8,11
26207,Bollzdepe,wyrmrest-accord,576,monk,windwalker,18,6,12
26208,Kuafu,illidan,576,monk,windwalker,18,6,12
26209,Awsmonk,malygos,576,monk,windwalker,18,6,12
26210,Lxg,emerald-dream,576,monk,windwalker,18,6,12
26211,Monjimen,ragnaros,576,monk,windwalker,18,6,12
26212,Káizen,area-52,576,monk,windwalker,18,6,12
26213,Fruitpünch,tichondrius,576,monk,windwalker,18,6,12
26214,Tayden,korgath,575,monk,windwalker,12,6,6
26215,Yoshimoku,dalaran,575,monk,windwalker,12,6,6
26216,Kalrsk,frostmourne,575,monk,windwalker,12,6,6
26217,Frimayadri,area-52,575,monk,windwalker,12,6,6
26218,Atulzo,emerald-dream,575,monk,windwalker,12,6,6
26219,Kajjou,illidan,575,monk,windwalker,20,6,14
26220,Zhixx,stormrage,574,monk,windwalker,12,6,6
26221,Dragorovich,aerie-peak,574,monk,windwalker,12,6,6
26222,Linwong,garithos,574,monk,windwalker,12,6,6
26223,Fistidmi,area-52,573,monk,windwalker,12,6,6
26224,Jish,bleeding-hollow,572,monk,windwalker,12,6,6
26225,Tøxicø,quelthalas,572,monk,windwalker,16,7,9
26226,Stellae,emerald-dream,543,monk,windwalker,11,6,5
26227,Bakicaa,dalaran,527,monk,windwalker,11,6,5
26228,Wft,frostmourne,527,monk,windwalker,11,6,5
26229,Rokkenstone,wyrmrest-accord,527,monk,windwalker,11,6,5
26230,Jowtaro,azralon,522,monk,windwalker,16,7,9
26231,Shindoro,bonechewer,521,monk,windwalker,16,10,6
26232,Nitrobrewed,stormrage,480,monk,windwalker,6,5,1
26233,Hennyww,dalaran,480,monk,windwalker,6,5,1
26234,Iloveabby,sargeras,480,monk,windwalker,6,5,1
26235,Bomba,arthas,480,monk,windwalker,6,5,1
26236,Kuranchi,illidan,480,monk,windwalker,6,5,1
26237,Monkskiiz,tichondrius,480,monk,windwalker,6,5,1
26238,Zegood,tichondrius,480,monk,windwalker,6,5,1
26239,Kimmyfists,tichondrius,480,monk,windwalker,6,5,1
26240,Getmistéd,sargeras,480,monk,windwalker,6,5,1
26241,Zakaza,kelthuzad,480,monk,windwalker,6,5,1
26242,Miresa,kelthuzad,480,monk,windwalker,6,5,1
26243,Varimå,area-52,480,monk,windwalker,6,5,1
26244,Koochies,aegwynn,480,monk,windwalker,6,5,1
26245,Yenjung,azralon,480,monk,windwalker,6,5,1
26246,Pikadejegue,nemesis,480,monk,windwalker,6,5,1
26247,Pleasetouch,emerald-dream,480,monk,windwalker,6,5,1
26248,Iflykites,zuljin,480,monk,windwalker,6,5,1
26249,Shevchenkô,quelthalas,480,monk,windwalker,6,5,1
26250,Blazebeast,blackhand,480,monk,windwalker,9,6,3
26251,Ýogï,stormrage,480,monk,windwalker,10,6,4
26252,Tyrus,kelthuzad,480,monk,windwalker,9,5,4
26253,Chakrah,laughing-skull,480,monk,windwalker,12,5,7
26254,Zadaa,alleria,480,monk,windwalker,12,5,7
26255,Xueyu,malganis,480,monk,windwalker,12,5,7
26256,Mepepegaclap,malganis,480,monk,windwalker,12,5,7
26257,Transcend,nerzhul,480,monk,windwalker,12,5,7
26258,Lokimana,zuljin,480,monk,windwalker,12,5,7
26259,Zakuu,blackrock,480,monk,windwalker,12,5,7
26260,Birean,area-52,480,monk,windwalker,12,5,7
26261,Ferknights,moon-guard,480,monk,windwalker,12,5,7
26262,Antril,bleeding-hollow,480,monk,windwalker,12,5,7
26263,Zhíu,ragnaros,480,monk,windwalker,12,5,7
26264,Pathad,stormrage,480,monk,windwalker,12,5,7
26265,Tenkix,zuljin,480,monk,windwalker,12,5,7
26266,Tripster,wyrmrest-accord,480,monk,windwalker,12,5,7
26267,Valdur,sargeras,480,monk,windwalker,12,5,7
26268,Kickkick,burning-blade,480,monk,windwalker,12,5,7
26269,Tigerwoo,tichondrius,480,monk,windwalker,12,5,7
26270,Bokchoii,sargeras,480,monk,windwalker,12,5,7
26271,Chrisdamonk,stormrage,480,monk,windwalker,12,5,7
26272,Abdoolah,illidan,480,monk,windwalker,12,5,7
26273,Trunkx,area-52,480,monk,windwalker,12,5,7
26274,Nomonko,tichondrius,480,monk,windwalker,12,5,7
26275,Plagai,fizzcrank,480,monk,windwalker,12,5,7
26276,Ultraop,emerald-dream,480,monk,windwalker,12,5,7
26277,Omoplàta,illidan,480,monk,windwalker,12,5,7
26278,Idonthustle,area-52,480,monk,windwalker,12,5,7
26279,Yacub,tichondrius,480,monk,windwalker,12,5,7
26280,Browniemix,tichondrius,480,monk,windwalker,12,5,7
26281,Toughmonk,tichondrius,480,monk,windwalker,12,5,7
26282,Ãcé,ragnaros,480,monk,windwalker,18,5,13
26283,Maisoftheart,barthilas,480,monk,windwalker,18,5,13
26284,Vinndz,azralon,480,monk,windwalker,18,5,13
26285,Gabaan,azralon,480,monk,windwalker,18,5,13
26286,Smigz,area-52,480,monk,windwalker,18,5,13
26287,Zmajevratnik,illidan,479,monk,windwalker,6,5,1
26288,Søuei,skullcrusher,479,monk,windwalker,12,5,7
26289,Tababtz,illidan,479,monk,windwalker,12,5,7
26290,Kiukiukiu,tichondrius,479,monk,windwalker,12,5,7
26291,Shà,kelthuzad,479,monk,windwalker,12,5,7
26292,Brzy,spinebreaker,479,monk,windwalker,12,5,7
26293,Hêrsh,frostmourne,479,monk,windwalker,17,5,12
26294,Breakbonez,dalaran,479,monk,windwalker,24,5,19
26295,Tamonk,veknilash,478,monk,windwalker,6,5,1
26296,Smashdmonk,gnomeregan,476,monk,windwalker,12,5,7
26297,Leisa,jaedenar,463,monk,windwalker,11,5,6
26298,Orcarucas,illidan,447,monk,windwalker,8,6,2
26299,Mcmaplol,tichondrius,447,monk,windwalker,11,5,6
26300,Chisuschrist,hyjal,432,monk,windwalker,15,5,10
26301,Prettyflacko,thrall,416,monk,windwalker,10,5,5
26302,Yomonk,hydraxis,384,monk,windwalker,6,4,2
26303,Mabaoguo,aerie-peak,384,monk,windwalker,6,4,2
26304,Illiea,cenarius,384,monk,windwalker,6,4,2
26305,Donbaltica,ragnaros,384,monk,windwalker,6,4,2
26306,Spacefolk,quelthalas,384,monk,windwalker,6,4,2
26307,Castiwhite,quelthalas,384,monk,windwalker,6,4,2
26308,Sobuu,wyrmrest-accord,384,monk,windwalker,6,4,2
26309,Fistedby,nesingwary,384,monk,windwalker,6,4,2
26310,Lowkn,sargeras,384,monk,windwalker,6,4,2
26311,Liucang,archimonde,384,monk,windwalker,6,4,2
26312,Molific,gurubashi,384,monk,windwalker,6,4,2
26313,Hazed,lightbringer,384,monk,windwalker,6,4,2
26314,Kiggo,bonechewer,384,monk,windwalker,6,4,2
26315,Satchelgizmo,tichondrius,384,monk,windwalker,6,4,2
26316,Preceptonk,azralon,384,monk,windwalker,6,4,2
26317,Orbgodx,darkspear,384,monk,windwalker,6,4,2
26318,Stevìl,medivh,384,monk,windwalker,6,4,2
26319,Imperio,stormrage,384,monk,windwalker,6,4,2
26320,Xulieng,tichondrius,384,monk,windwalker,6,4,2
26321,Barleygar,tichondrius,384,monk,windwalker,6,4,2
26322,Thewyjr,illidan,384,monk,windwalker,6,4,2
26323,Chopana,malganis,384,monk,windwalker,6,4,2
26324,Zenitsu,burning-blade,384,monk,windwalker,6,4,2
26325,Jackphan,azralon,384,monk,windwalker,6,4,2
26326,Ganksyou,sargeras,384,monk,windwalker,6,4,2
26327,Ðøhkø,nemesis,384,monk,windwalker,6,4,2
26328,Trembull,gurubashi,384,monk,windwalker,6,4,2
26329,Vernki,laughing-skull,384,monk,windwalker,6,4,2
26330,Aedalithe,stormrage,384,monk,windwalker,6,4,2
26331,Milli,twisting-nether,384,monk,windwalker,6,4,2
26332,Thoraki,illidan,384,monk,windwalker,6,4,2
26333,Chizhao,tichondrius,384,monk,windwalker,6,4,2
26334,Freetristan,sargeras,384,monk,windwalker,6,4,2
26335,Korgark,tichondrius,384,monk,windwalker,6,4,2
26336,Cowhoe,icecrown,384,monk,windwalker,6,4,2
26337,Champoo,executus,384,monk,windwalker,6,4,2
26338,Paullyfists,garona,384,monk,windwalker,6,4,2
26339,Ezpumpm,azralon,384,monk,windwalker,6,4,2
26340,Saitamami,tichondrius,384,monk,windwalker,6,4,2
26341,Fearrae,sargeras,384,monk,windwalker,6,4,2
26342,Punchbuggy,frostmourne,384,monk,windwalker,6,4,2
26343,Monkespin,stormrage,384,monk,windwalker,6,4,2
26344,Vetting,stormrage,384,monk,windwalker,6,4,2
26345,Research,frostmourne,384,monk,windwalker,6,4,2
26346,Kame,moon-guard,384,monk,windwalker,6,4,2
26347,Winney,frostmourne,384,monk,windwalker,6,4,2
26348,Delaî,dalaran,384,monk,windwalker,6,4,2
26349,Evanyfist,proudmoore,384,monk,windwalker,6,4,2
26350,Gorblox,emerald-dream,384,monk,windwalker,6,4,2
26351,Crave,tichondrius,384,monk,windwalker,6,4,2
26352,Jbebe,tichondrius,384,monk,windwalker,6,4,2
26353,Cowsgonuts,gorefiend,384,monk,windwalker,6,4,2
26354,Etrasu,thrall,384,monk,windwalker,6,4,2
26355,Eçua,tichondrius,384,monk,windwalker,7,4,3
26356,Serenitys,tanaris,384,monk,windwalker,9,4,5
26357,Kickflipy,dalaran,384,monk,windwalker,15,5,10
26358,Xinvictus,frostmourne,384,monk,windwalker,12,4,8
26359,Solrise,wyrmrest-accord,384,monk,windwalker,12,4,8
26360,Tesdra,moon-guard,384,monk,windwalker,12,4,8
26361,Kygol,zuljin,384,monk,windwalker,12,4,8
26362,Raekwan,area-52,384,monk,windwalker,12,4,8
26363,Cranjis,agamaggan,384,monk,windwalker,12,4,8
26364,Jxytwo,arygos,384,monk,windwalker,12,4,8
26365,Ohtani,frostwolf,384,monk,windwalker,12,4,8
26366,Tóru,kelthuzad,384,monk,windwalker,12,4,8
26367,Giorhno,ragnaros,384,monk,windwalker,12,4,8
26368,Wheresmyjuul,malganis,384,monk,windwalker,12,4,8
26369,Fluffykitty,deathwing,384,monk,windwalker,12,4,8
26370,Mysticzen,tichondrius,384,monk,windwalker,12,4,8
26371,Threnz,magtheridon,384,monk,windwalker,12,4,8
26372,Gngrbeardman,tichondrius,384,monk,windwalker,12,4,8
26373,Sdns,stormrage,384,monk,windwalker,12,4,8
26374,Chijinx,area-52,384,monk,windwalker,12,4,8
26375,Téoo,azralon,384,monk,windwalker,12,4,8
26376,Evilstep,tichondrius,384,monk,windwalker,12,4,8
26377,Rookz,drakthul,384,monk,windwalker,12,4,8
26378,Cudzingtin,dalaran,384,monk,windwalker,12,4,8
26379,Machita,spirestone,384,monk,windwalker,12,4,8
26380,Kfp,gorefiend,384,monk,windwalker,12,4,8
26381,Talondien,dalaran,384,monk,windwalker,12,4,8
26382,Nakwood,proudmoore,384,monk,windwalker,12,4,8
26383,Piece,blackrock,384,monk,windwalker,12,4,8
26384,Merçeÿ,tichondrius,384,monk,windwalker,12,4,8
26385,Ferrarí,quelthalas,384,monk,windwalker,12,4,8
26386,Bwan,kelthuzad,384,monk,windwalker,12,4,8
26387,Sïfu,barthilas,384,monk,windwalker,12,4,8
26388,Ramisan,barthilas,384,monk,windwalker,12,4,8
26389,Jayr,bleeding-hollow,384,monk,windwalker,18,4,14
26390,Mönk,blood-furnace,384,monk,windwalker,18,4,14
26391,Ruì,malganis,384,monk,windwalker,18,4,14
26392,Fistermus,tichondrius,384,monk,windwalker,36,4,32
26393,Zanmonk,moon-guard,383,monk,windwalker,6,4,2
26394,Chugs,malorne,383,monk,windwalker,18,4,14
26395,Viko,llane,382,monk,windwalker,6,4,2
26396,Lilutha,illidan,382,monk,windwalker,12,4,8
26397,Pandalex,draenor,382,monk,windwalker,12,4,8
26398,Liw,quelthalas,362,monk,windwalker,21,7,14
26399,Broxxenidas,quelthalas,351,monk,windwalker,11,4,7
26400,Nakuang,tichondrius,339,monk,windwalker,24,7,17
26401,Ariannahxd,malganis,330,monk,windwalker,15,5,10
26402,Mistyfist,bleeding-hollow,330,monk,windwalker,22,5,17
26403,Jeffspicoli,emerald-dream,319,monk,windwalker,5,4,1
26404,Oyyo,tichondrius,288,monk,windwalker,6,3,3
26405,Mgzx,kelthuzad,288,monk,windwalker,6,3,3
26406,Detox,sargeras,288,monk,windwalker,6,3,3
26407,Dripharder,tichondrius,288,monk,windwalker,6,3,3
26408,Slurrpslutt,proudmoore,288,monk,windwalker,6,3,3
26409,Mistérfister,blackrock,288,monk,windwalker,6,3,3
26410,Karkata,sargeras,288,monk,windwalker,6,3,3
26411,Bunnynoodle,gnomeregan,288,monk,windwalker,6,3,3
26412,Harvex,area-52,288,monk,windwalker,6,3,3
26413,Frogepoge,area-52,288,monk,windwalker,6,3,3
26414,Lomist,nazjatar,288,monk,windwalker,6,3,3
26415,Zexana,gorefiend,288,monk,windwalker,6,3,3
26416,Sýññ,illidan,288,monk,windwalker,6,3,3
26417,Sosm,kelthuzad,288,monk,windwalker,6,3,3
26418,Kallandron,thunderhorn,288,monk,windwalker,6,3,3
26419,Fistay,burning-legion,288,monk,windwalker,6,3,3
26420,Burash,frostwolf,288,monk,windwalker,6,3,3
26421,Daspmonk,nagrand,288,monk,windwalker,6,3,3
26422,Tigerlust,sargeras,288,monk,windwalker,6,3,3
26423,Kyzen,trollbane,288,monk,windwalker,6,3,3
26424,Raires,tichondrius,288,monk,windwalker,6,3,3
26425,Brewtool,tichondrius,288,monk,windwalker,6,3,3
26426,Lackofsleep,tichondrius,288,monk,windwalker,6,3,3
26427,Militantww,tichondrius,288,monk,windwalker,6,3,3
26428,Carmelfist,kargath,288,monk,windwalker,6,3,3
26429,Hábìtz,area-52,288,monk,windwalker,6,3,3
26430,Zonianman,tichondrius,288,monk,windwalker,6,3,3
26431,Mlngo,illidan,288,monk,windwalker,6,3,3
26432,Mcfluffey,area-52,288,monk,windwalker,6,3,3
26433,Tictox,sargeras,288,monk,windwalker,6,3,3
26434,Conterkick,stormrage,288,monk,windwalker,6,3,3
26435,Niçky,tichondrius,288,monk,windwalker,6,3,3
26436,Matins,tichondrius,288,monk,windwalker,6,3,3
26437,Dorander,frostmourne,288,monk,windwalker,6,3,3
26438,Gulmokk,tichondrius,288,monk,windwalker,6,3,3
26439,ßluedream,dalaran,288,monk,windwalker,6,3,3
26440,Tsosai,wyrmrest-accord,288,monk,windwalker,6,3,3
26441,Rhonco,quelthalas,288,monk,windwalker,6,3,3
26442,Bogez,area-52,288,monk,windwalker,6,3,3
26443,Apølon,azralon,288,monk,windwalker,6,3,3
26444,Spaaca,kelthuzad,288,monk,windwalker,6,3,3
26445,Onepunchmän,zuljin,288,monk,windwalker,6,3,3
26446,Akumuh,tichondrius,288,monk,windwalker,6,3,3
26447,Fysicalx,stormrage,288,monk,windwalker,6,3,3
26448,Maserati,azjolnerub,288,monk,windwalker,6,3,3
26449,Monkdruffy,tichondrius,288,monk,windwalker,6,3,3
26450,Tonkchi,khaz-modan,288,monk,windwalker,6,3,3
26451,Pusily,tichondrius,288,monk,windwalker,6,3,3
26452,Hellcow,frostmourne,288,monk,windwalker,6,3,3
26453,Crayóns,stormreaver,288,monk,windwalker,6,3,3
26454,Swurvex,bleeding-hollow,288,monk,windwalker,6,3,3
26455,Momkisserl,sargeras,288,monk,windwalker,6,3,3
26456,Evilbit,boulderfist,288,monk,windwalker,6,3,3
26457,Reflexsivex,malganis,288,monk,windwalker,6,3,3
26458,Thalassassin,bleeding-hollow,288,monk,windwalker,6,3,3
26459,Triixxy,thrall,288,monk,windwalker,6,3,3
26460,Choibaedal,tichondrius,288,monk,windwalker,6,3,3
26461,Leemîn,tichondrius,288,monk,windwalker,6,3,3
26462,Atezo,tichondrius,288,monk,windwalker,6,3,3
26463,Cannafist,tichondrius,288,monk,windwalker,6,3,3
26464,Highaskite,tichondrius,288,monk,windwalker,6,3,3
26465,Wungpow,magtheridon,288,monk,windwalker,6,3,3
26466,Bromonster,zuljin,288,monk,windwalker,6,3,3
26467,Gageismonk,mugthol,288,monk,windwalker,6,3,3
26468,Rumlee,sargeras,288,monk,windwalker,6,3,3
26469,Badvisto,dalaran,288,monk,windwalker,6,3,3
26470,Legolos,runetotem,288,monk,windwalker,6,3,3
26471,Hanzøu,ragnaros,288,monk,windwalker,6,3,3
26472,Goodluck,madoran,288,monk,windwalker,6,3,3
26473,Monklad,malganis,288,monk,windwalker,6,3,3
26474,Muffinz,shattered-halls,288,monk,windwalker,6,3,3
26475,Rampant,anubarak,288,monk,windwalker,9,4,5
26476,Aangg,madoran,288,monk,windwalker,12,3,9
26477,Natörr,dalaran,288,monk,windwalker,12,3,9
26478,Atarii,emerald-dream,288,monk,windwalker,12,3,9
26479,Dmhsaint,sargeras,288,monk,windwalker,12,3,9
26480,Vova,bleeding-hollow,288,monk,windwalker,12,3,9
26481,Meatcleave,kiljaeden,288,monk,windwalker,12,3,9
26482,Kickxy,sargeras,288,monk,windwalker,12,3,9
26483,Setzua,cairne,288,monk,windwalker,12,3,9
26484,Shizzyowoxd,bleeding-hollow,288,monk,windwalker,12,3,9
26485,Bujiburger,frostmourne,288,monk,windwalker,12,3,9
26486,Keloxx,ragnaros,288,monk,windwalker,12,3,9
26487,Okuraseru,bleeding-hollow,288,monk,windwalker,12,3,9
26488,Senseixww,sargeras,288,monk,windwalker,12,3,9
26489,Kthanïd,ragnaros,288,monk,windwalker,12,3,9
26490,Saohta,quelthalas,288,monk,windwalker,12,3,9
26491,Messym,illidan,288,monk,windwalker,12,3,9
26492,Wwx,whisperwind,288,monk,windwalker,12,3,9
26493,Tofugoku,area-52,288,monk,windwalker,12,3,9
26494,Donn,illidan,288,monk,windwalker,12,3,9
26495,Howlit,illidan,288,monk,windwalker,12,3,9
26496,Paramendic,frostwolf,288,monk,windwalker,12,3,9
26497,Maziyen,thunderlord,288,monk,windwalker,12,3,9
26498,Raviolipolie,sargeras,288,monk,windwalker,12,3,9
26499,Joreg,moon-guard,288,monk,windwalker,12,3,9
26500,Brewmooser,area-52,287,monk,windwalker,6,3,3
26501,Firstfire,stormrage,287,monk,windwalker,12,3,9
26502,Gaziee,tichondrius,271,monk,windwalker,11,3,8
26503,Dafuqk,stormrage,256,monk,windwalker,16,3,13
26504,Rockfu,illidan,239,monk,windwalker,5,3,2
26505,Hellrosennin,area-52,239,monk,windwalker,5,3,2
26506,Çruel,dalaran,223,monk,windwalker,8,3,5
26507,Klamfu,thrall,192,monk,windwalker,4,3,1
26508,Mùk,tichondrius,192,monk,windwalker,4,3,1
26509,Möösê,moon-guard,192,monk,windwalker,6,2,4
26510,Averagéjoe,tichondrius,192,monk,windwalker,6,2,4
26511,Lonebamboo,tichondrius,192,monk,windwalker,6,2,4
26512,Hydraoxy,moon-guard,192,monk,windwalker,6,2,4
26513,Undmonge,azralon,192,monk,windwalker,6,2,4
26514,Privix,tichondrius,192,monk,windwalker,6,2,4
26515,Happymonk,tichondrius,192,monk,windwalker,6,2,4
26516,Mcoos,tichondrius,192,monk,windwalker,6,2,4
26517,Gøldéngødx,tichondrius,192,monk,windwalker,6,2,4
26518,Imafqnbaby,tichondrius,192,monk,windwalker,6,2,4
26519,Smungus,bloodscalp,192,monk,windwalker,6,2,4
26520,Metaxzy,sargeras,192,monk,windwalker,6,2,4
26521,Brëwslee,twisting-nether,192,monk,windwalker,6,2,4
26522,Musclemanx,tichondrius,192,monk,windwalker,6,2,4
26523,Strongmandan,twisting-nether,192,monk,windwalker,6,2,4
26524,Mîghtguy,barthilas,192,monk,windwalker,6,2,4
26525,Sinistuhm,tichondrius,192,monk,windwalker,6,2,4
26526,Jüdo,barthilas,192,monk,windwalker,6,2,4
26527,Wrynnerverse,tichondrius,192,monk,windwalker,6,2,4
26528,Weendwolker,moon-guard,192,monk,windwalker,6,2,4
26529,Icesmoker,frostmourne,192,monk,windwalker,6,2,4
26530,Jagichan,area-52,192,monk,windwalker,6,2,4
26531,Furrykisser,tichondrius,192,monk,windwalker,6,2,4
26532,Kakusanni,nemesis,192,monk,windwalker,6,2,4
26533,Yopper,tichondrius,192,monk,windwalker,6,2,4
26534,Kitfisty,kiljaeden,192,monk,windwalker,6,2,4
26535,Epî,tichondrius,192,monk,windwalker,6,2,4
26536,Mîstchievous,sargeras,192,monk,windwalker,6,2,4
26537,Bhoredom,kiljaeden,192,monk,windwalker,6,2,4
26538,Hossdelgadoe,kiljaeden,192,monk,windwalker,6,2,4
26539,Brokenfeels,azralon,192,monk,windwalker,6,2,4
26540,Gracesowner,moon-guard,192,monk,windwalker,6,2,4
26541,Dragoro,exodar,192,monk,windwalker,6,2,4
26542,Fistpumps,thrall,192,monk,windwalker,6,2,4
26543,Spirits,dreadmaul,192,monk,windwalker,6,2,4
26544,Meidan,azralon,192,monk,windwalker,6,2,4
26545,Troutz,sargeras,192,monk,windwalker,6,2,4
26546,Upcoming,moon-guard,192,monk,windwalker,6,2,4
26547,Vulpirino,drakkari,192,monk,windwalker,6,2,4
26548,Taringa,drakkari,192,monk,windwalker,6,2,4
26549,Sù,moon-guard,192,monk,windwalker,6,2,4
26550,Khnum,fizzcrank,192,monk,windwalker,6,2,4
26551,Rouladecave,zuljin,192,monk,windwalker,6,2,4
26552,Induhca,area-52,192,monk,windwalker,6,2,4
26553,Deyasth,zuljin,192,monk,windwalker,6,2,4
26554,Thöran,ragnaros,192,monk,windwalker,6,2,4
26555,Akiiko,draenor,192,monk,windwalker,6,2,4
26556,Lìpz,zuljin,192,monk,windwalker,6,2,4
26557,Prf,ragnaros,192,monk,windwalker,6,2,4
26558,Fuchizaki,ragnaros,192,monk,windwalker,6,2,4
26559,Ked,ragnaros,192,monk,windwalker,6,2,4
26560,Pvptone,bleeding-hollow,192,monk,windwalker,6,2,4
26561,Bakusao,bleeding-hollow,192,monk,windwalker,6,2,4
26562,Eîr,emerald-dream,192,monk,windwalker,6,2,4
26563,Xarra,bleeding-hollow,192,monk,windwalker,6,2,4
26564,Salanzoww,bleeding-hollow,192,monk,windwalker,6,2,4
26565,Trillek,firetree,192,monk,windwalker,6,2,4
26566,Streetcreds,bleeding-hollow,192,monk,windwalker,6,2,4
26567,Robocto,area-52,192,monk,windwalker,6,2,4
26568,Merrell,area-52,192,monk,windwalker,6,2,4
26569,Zengawd,magtheridon,192,monk,windwalker,6,2,4
26570,Jadiel,quelthalas,192,monk,windwalker,6,2,4
26571,Monkbro,altar-of-storms,192,monk,windwalker,6,2,4
26572,Flicksx,arthas,192,monk,windwalker,6,2,4
26573,Tadaku,dalaran,192,monk,windwalker,6,2,4
26574,Fistnyou,norgannon,192,monk,windwalker,6,2,4
26575,Heävenly,kelthuzad,192,monk,windwalker,6,2,4
26576,Toxicaff,dalaran,192,monk,windwalker,6,2,4
26577,Takazawas,bonechewer,192,monk,windwalker,6,2,4
26578,Hutmok,dalaran,192,monk,windwalker,6,2,4
26579,Tenfingers,dalaran,192,monk,windwalker,6,2,4
26580,Coomerww,kelthuzad,192,monk,windwalker,6,2,4
26581,Boeingair,kelthuzad,192,monk,windwalker,6,2,4
26582,Mtnbrew,sargeras,192,monk,windwalker,6,2,4
26583,Gumrag,illidan,192,monk,windwalker,6,2,4
26584,Bubblewater,illidan,192,monk,windwalker,6,2,4
26585,Burningfist,stormrage,192,monk,windwalker,6,2,4
26586,Defacen,illidan,192,monk,windwalker,6,2,4
26587,Astralsurfer,tichondrius,192,monk,windwalker,6,2,4
26588,Saywha,windrunner,192,monk,windwalker,6,2,4
26589,Youngnudy,sargeras,192,monk,windwalker,6,2,4
26590,Théwy,tichondrius,192,monk,windwalker,6,2,4
26591,Sukrit,darkspear,192,monk,windwalker,6,2,4
26592,Grëyfox,sargeras,192,monk,windwalker,6,2,4
26593,Puraimu,sargeras,192,monk,windwalker,6,2,4
26594,Guyfíeri,velen,192,monk,windwalker,8,2,6
26595,Motivmonk,uldum,192,monk,windwalker,12,2,10
26596,Dankestkhan,korialstrasz,192,monk,windwalker,12,2,10
26597,Eliwenn,ragnaros,192,monk,windwalker,12,2,10
26598,Pongo,kelthuzad,192,monk,windwalker,12,2,10
26599,Bruceflea,gurubashi,192,monk,windwalker,18,2,16
26600,Staypuftmm,tichondrius,191,monk,windwalker,6,2,4
26601,Kipao,deathwing,191,monk,windwalker,12,2,10
26602,Punch,agamaggan,175,monk,windwalker,11,2,9
26603,Wheatsli,malganis,159,monk,windwalker,5,2,3
26604,Lazy,shattered-halls,159,monk,windwalker,5,2,3
26605,Fendi,stormrage,159,monk,windwalker,5,2,3
26606,Goku,frostmourne,159,monk,windwalker,5,2,3
26607,Shenlong,jaedenar,159,monk,windwalker,6,2,4
26608,Heavytrain,azralon,138,monk,windwalker,10,4,6
26609,Choyou,bleeding-hollow,138,monk,windwalker,10,4,6
26610,Heartsies,sargeras,128,monk,windwalker,4,2,2
26611,Monkwayz,emerald-dream,96,monk,windwalker,3,2,1
26612,Neaxain,tichondrius,96,monk,windwalker,3,2,1
26613,Vanishm,ragnaros,96,monk,windwalker,3,2,1
26614,Jayjaybrew,area-52,96,monk,windwalker,3,2,1
26615,Jg,staghelm,96,monk,windwalker,6,1,5
26616,Ravenius,moon-guard,96,monk,windwalker,6,1,5
26617,Zinque,emerald-dream,96,monk,windwalker,6,1,5
26618,Netang,emerald-dream,96,monk,windwalker,6,1,5
26619,Jh,korgath,96,monk,windwalker,6,1,5
26620,Spicybrew,tichondrius,96,monk,windwalker,6,1,5
26621,Pandacottoco,azralon,96,monk,windwalker,6,1,5
26622,Piccolo,emerald-dream,96,monk,windwalker,6,1,5
26623,Munnk,stormreaver,96,monk,windwalker,6,1,5
26624,Furrwalker,tichondrius,96,monk,windwalker,6,1,5
26625,Kablam,frostmourne,96,monk,windwalker,6,1,5
26626,Saruyo,frostmourne,96,monk,windwalker,6,1,5
26627,Vanaxi,moon-guard,96,monk,windwalker,6,1,5
26628,Sanemi,amanthul,96,monk,windwalker,6,1,5
26629,Quaria,moon-guard,96,monk,windwalker,6,1,5
26630,Tmtricks,tichondrius,96,monk,windwalker,6,1,5
26631,Banidiin,moon-guard,96,monk,windwalker,6,1,5
26632,Blacdaryl,destromath,96,monk,windwalker,6,1,5
26633,Molsonicee,tichondrius,96,monk,windwalker,6,1,5
26634,Emßerly,thrall,96,monk,windwalker,6,1,5
26635,Siserfister,sargeras,96,monk,windwalker,6,1,5
26636,Æsir,moon-guard,96,monk,windwalker,6,1,5
26637,Srgtbingo,azgalor,96,monk,windwalker,6,1,5
26638,Lainerya,moon-guard,96,monk,windwalker,6,1,5
26639,Teewin,area-52,96,monk,windwalker,6,1,5
26640,Bussyweaver,sargeras,96,monk,windwalker,6,1,5
26641,Forestweaver,area-52,96,monk,windwalker,6,1,5
26642,Murgleh,misha,96,monk,windwalker,6,1,5
26643,Buddaba,tichondrius,96,monk,windwalker,6,1,5
26644,Cerocool,hyjal,96,monk,windwalker,6,1,5
26645,Gablle,tol-barad,96,monk,windwalker,6,1,5
26646,Friëden,quelthalas,96,monk,windwalker,6,1,5
26647,Nbatrap,stormrage,96,monk,windwalker,6,1,5
26648,Cystweaver,dalaran,96,monk,windwalker,6,1,5
26649,Minimonki,bleeding-hollow,96,monk,windwalker,6,1,5
26650,Srshy,drakkari,96,monk,windwalker,6,1,5
26651,Giriom,thrall,96,monk,windwalker,6,1,5
26652,Monkanome,gilneas,96,monk,windwalker,6,1,5
26653,Bvndo,illidan,96,monk,windwalker,6,1,5
26654,Chipócluda,ragnaros,96,monk,windwalker,6,1,5
26655,Memurk,bleeding-hollow,96,monk,windwalker,6,1,5
26656,Yípman,uldum,96,monk,windwalker,6,1,5
26657,Comical,malygos,96,monk,windwalker,6,1,5
26658,Londobell,frostmourne,96,monk,windwalker,6,1,5
26659,Windlordx,illidan,96,monk,windwalker,6,1,5
26660,Imingleejr,illidan,96,monk,windwalker,6,1,5
26661,Xhu,kelthuzad,96,monk,windwalker,6,1,5
26662,Boomboomspin,illidan,96,monk,windwalker,6,1,5
26663,Tubshark,kelthuzad,96,monk,windwalker,6,1,5
26664,Espanasan,dalaran,96,monk,windwalker,6,1,5
26665,Ischys,kelthuzad,96,monk,windwalker,6,1,5
26666,Pléb,kelthuzad,96,monk,windwalker,6,1,5
26667,Monkspanka,nemesis,96,monk,windwalker,6,1,5
26668,Tuskytwofist,kargath,96,monk,windwalker,12,1,11
26669,Cmon,icecrown,96,monk,windwalker,12,1,11
26670,Yosisoy,zuljin,79,monk,windwalker,5,1,4
26671,Hít,bonechewer,64,monk,windwalker,4,1,3
26672,Criminall,aegwynn,64,monk,windwalker,4,1,3
26673,Zhatafaq,ragnaros,48,monk,windwalker,3,1,2
26674,Stumpling,earthen-ring,42,monk,windwalker,10,3,7
26675,Alzen,tichondrius,42,monk,windwalker,9,2,7
26676,Kreese,rivendare,42,monk,windwalker,9,2,7
26677,Cosetteb,proudmoore,31,monk,windwalker,2,1,1
26678,Notamønk,bonechewer,31,monk,windwalker,2,1,1
26679,Laggyfist,frostmourne,16,monk,windwalker,1,1,0
26680,Rèxpéi,area-52,2157,paladin,holy,84,48,36
26681,Overwhelm,muradin,2125,paladin,holy,64,39,25
26682,Holylolz,ragnaros,2125,paladin,holy,258,132,126
26683,Sunita,arthas,2116,paladin,holy,189,99,90
26684,Pattar,area-52,2107,paladin,holy,66,37,29
26685,Dreathhammer,muradin,2093,paladin,holy,96,48,48
26686,Tmborn,tichondrius,2093,paladin,holy,119,57,62
26687,Caveyodeler,zuluhed,2048,paladin,holy,77,45,32
26688,Digglesx,area-52,2012,paladin,holy,78,35,43
26689,Bubblebuddyx,tichondrius,2010,paladin,holy,136,66,70
26690,Bilmurii,zuljin,1990,paladin,holy,102,54,48
26691,Curator,emerald-dream,1964,paladin,holy,74,37,37
26692,Saacbot,area-52,1959,paladin,holy,81,34,47
26693,Reverbz,malganis,1953,paladin,holy,120,56,64
26694,Badnold,area-52,1952,paladin,holy,55,26,29
26695,Bombboyoz,area-52,1936,paladin,holy,84,44,40
26696,Eskerda,nemesis,1926,paladin,holy,65,32,33
26697,Flõw,gnomeregan,1919,paladin,holy,84,52,32
26698,Hamsti,sargeras,1909,paladin,holy,125,63,62
26699,Baelsimp,illidan,1898,paladin,holy,96,50,46
26700,Flashv,barthilas,1896,paladin,holy,62,32,30
26701,Braindeadrsj,anetheron,1890,paladin,holy,185,99,86
26702,Angrycubanx,black-dragonflight,1887,paladin,holy,50,25,25
26703,Jaywalker,baelgun,1885,paladin,holy,78,45,33
26704,Nickimahoj,tichondrius,1882,paladin,holy,98,48,50
26705,Thejustice,tichondrius,1870,paladin,holy,162,79,83
26706,Careless,malganis,1869,paladin,holy,54,28,26
26707,Cynthianna,tichondrius,1865,paladin,holy,266,137,129
26708,Bravepala,tichondrius,1862,paladin,holy,78,35,43
26709,Thejustices,tichondrius,1860,paladin,holy,36,22,14
26710,Chenzo,exodar,1856,paladin,holy,206,110,96
26711,Sde,kelthuzad,1855,paladin,holy,132,61,71
26712,Uxe,zuljin,1853,paladin,holy,66,33,33
26713,Judgejim,barthilas,1851,paladin,holy,228,110,118
26714,Scrubbinton,zuljin,1850,paladin,holy,114,58,56
26715,Pelletbrain,emerald-dream,1850,paladin,holy,262,133,129
26716,Nyctemavanna,ragnaros,1848,paladin,holy,124,65,59
26717,Ðáxø,sargeras,1846,paladin,holy,48,25,23
26718,Truluck,area-52,1845,paladin,holy,135,69,66
26719,Ddeuk,tichondrius,1841,paladin,holy,593,309,284
26720,Dýstopia,stormrage,1841,paladin,holy,41,21,20
26721,Skillenjoyer,tichondrius,1839,paladin,holy,78,49,29
26722,Bobthemad,proudmoore,1838,paladin,holy,59,33,26
26723,Bobthemad,illidan,1838,paladin,holy,59,33,26
26724,Bushyy,tichondrius,1838,paladin,holy,54,26,28
26725,Duallkore,stormrage,1835,paladin,holy,78,42,36
26726,Sojupapi,area-52,1826,paladin,holy,239,119,120
26727,Ppgdx,azralon,1826,paladin,holy,78,34,44
26728,Cyphinx,darkspear,1822,paladin,holy,103,48,55
26729,Csupremacy,tichondrius,1822,paladin,holy,99,46,53
26730,Memnoche,frostmane,1821,paladin,holy,89,53,36
26731,Sacbubldead,area-52,1820,paladin,holy,126,79,47
26732,Perfect,crushridge,1820,paladin,holy,56,28,28
26733,Deadlyassian,sargeras,1819,paladin,holy,100,54,46
26734,Ðáx,sargeras,1817,paladin,holy,87,44,43
26735,Everrlasting,tichondrius,1817,paladin,holy,72,36,36
26736,Fonypally,tichondrius,1815,paladin,holy,332,171,161
26737,Fukndibs,kiljaeden,1811,paladin,holy,172,85,87
26738,Sd,kelthuzad,1811,paladin,holy,123,59,64
26739,Bubblist,tichondrius,1811,paladin,holy,68,28,40
26740,Bravepl,tichondrius,1808,paladin,holy,73,28,45
26741,Dracfire,zuljin,1807,paladin,holy,45,24,21
26742,Zetsubõ,stormrage,1806,paladin,holy,54,24,30
26743,Insthy,illidan,1804,paladin,holy,185,97,88
26744,Ængelic,barthilas,1803,paladin,holy,202,107,95
26745,Dyppally,moon-guard,1803,paladin,holy,102,51,51
26746,Wtbmana,frostmourne,1801,paladin,holy,72,39,33
26747,Varies,kelthuzad,1801,paladin,holy,58,28,30
26748,Tylennis,archimonde,1801,paladin,holy,172,82,90
26749,Richpiana,nathrezim,1800,paladin,holy,106,60,46
26750,Kevinthecube,nerzhul,1797,paladin,holy,60,44,16
26751,Hongwoosang,tichondrius,1795,paladin,holy,188,89,99
26752,Colepal,zuljin,1792,paladin,holy,96,42,54
26753,Hats,icecrown,1791,paladin,holy,233,120,113
26754,Esd,kelthuzad,1791,paladin,holy,65,27,38
26755,Chobbler,tichondrius,1788,paladin,holy,66,26,40
26756,Boomda,tichondrius,1787,paladin,holy,199,110,89
26757,Amourranth,stormrage,1785,paladin,holy,52,30,22
26758,Scamlikely,tichondrius,1785,paladin,holy,121,62,59
26759,Airbad,tichondrius,1785,paladin,holy,53,23,30
26760,Veejayx,tichondrius,1775,paladin,holy,44,21,23
26761,Zilea,kiljaeden,1768,paladin,holy,48,24,24
26762,Hps,argent-dawn,1759,paladin,holy,42,22,20
26763,Eskerda,azralon,1756,paladin,holy,202,96,106
26764,Theebus,tichondrius,1753,paladin,holy,71,28,43
26765,Defensezone,tichondrius,1749,paladin,holy,74,36,38
26766,Adrizzyx,barthilas,1748,paladin,holy,42,23,19
26767,Mercedez,bleeding-hollow,1744,paladin,holy,102,53,49
26768,Ihaveajob,zuluhed,1730,paladin,holy,42,23,19
26769,Evylinn,burning-legion,1727,paladin,holy,150,83,67
26770,Cewekmbek,barthilas,1727,paladin,holy,48,19,29
26771,Mayru,ragnaros,1721,paladin,holy,45,25,20
26772,Chenzio,garona,1719,paladin,holy,63,41,22
26773,Fixyouz,mannoroth,1718,paladin,holy,118,55,63
26774,Ckaïnë,stormrage,1714,paladin,holy,68,36,32
26775,Pallice,queldorei,1714,paladin,holy,126,61,65
26776,Softsister,tichondrius,1713,paladin,holy,42,22,20
26777,Heaven,gurubashi,1705,paladin,holy,47,22,25
26778,Bombboyozjr,area-52,1701,paladin,holy,36,24,12
26779,Taargaryenn,tichondrius,1701,paladin,holy,60,32,28
26780,Fortold,bloodhoof,1692,paladin,holy,54,23,31
26781,Virabelle,gurubashi,1690,paladin,holy,48,25,23
26782,Yuuichi,moon-guard,1688,paladin,holy,76,37,39
26783,Stephon,area-52,1686,paladin,holy,66,29,37
26784,Holymooie,frostmourne,1681,paladin,holy,42,20,22
26785,Citylights,tichondrius,1677,paladin,holy,51,28,23
26786,Xciss,kiljaeden,1675,paladin,holy,332,162,170
26787,Beejae,stormreaver,1675,paladin,holy,53,23,30
26788,Barcie,lothar,1675,paladin,holy,78,29,49
26789,Tenêbrae,area-52,1674,paladin,holy,52,33,19
26790,Mangoflash,malganis,1673,paladin,holy,66,26,40
26791,Bubbleofil,barthilas,1671,paladin,holy,36,26,10
26792,Sàga,hyjal,1671,paladin,holy,53,29,24
26793,Chunzhangsqs,tichondrius,1670,paladin,holy,54,24,30
26794,Mvpj,medivh,1669,paladin,holy,153,78,75
26795,Cheerleader,bleeding-hollow,1668,paladin,holy,138,62,76
26796,Denthus,dragonmaw,1663,paladin,holy,47,25,22
26797,Imshmackedd,darkspear,1663,paladin,holy,84,35,49
26798,Tiernoo,illidan,1662,paladin,holy,98,46,52
26799,Fary,malganis,1661,paladin,holy,36,20,16
26800,Runihaveaids,stormrage,1661,paladin,holy,232,123,109
26801,Landrysdad,malorne,1660,paladin,holy,54,26,28
26802,Zacháry,sargeras,1659,paladin,holy,290,151,139
26803,Ivan,tichondrius,1659,paladin,holy,136,62,74
26804,Sacridas,fizzcrank,1657,paladin,holy,36,20,16
26805,Shijielol,tichondrius,1656,paladin,holy,42,22,20
26806,Zunit,laughing-skull,1656,paladin,holy,46,22,24
26807,Thorfinaa,moon-guard,1653,paladin,holy,71,38,33
26808,Avengom,tichondrius,1653,paladin,holy,357,179,178
26809,Lalatinaford,amanthul,1647,paladin,holy,76,44,32
26810,Kustp,tichondrius,1646,paladin,holy,189,105,84
26811,Kensyzs,tichondrius,1644,paladin,holy,60,24,36
26812,Boklahoma,stormrage,1643,paladin,holy,36,25,11
26813,Ppgddxx,azralon,1643,paladin,holy,30,18,12
26814,Nerfretpls,area-52,1642,paladin,holy,42,20,22
26815,Arcanux,thrall,1639,paladin,holy,42,19,23
26816,Dazargeros,moon-guard,1638,paladin,holy,132,66,66
26817,Bushys,tichondrius,1638,paladin,holy,42,21,21
26818,Gaelinar,tichondrius,1637,paladin,holy,60,29,31
26819,Bpalaayo,kelthuzad,1636,paladin,holy,94,37,57
26820,Ellyarian,emerald-dream,1635,paladin,holy,42,22,20
26821,Bpalaax,kelthuzad,1635,paladin,holy,46,23,23
26822,Teenytoots,burning-legion,1635,paladin,holy,87,35,52
26823,Oing,tichondrius,1634,paladin,holy,76,45,31
26824,Enzõ,illidan,1632,paladin,holy,48,26,22
26825,Castleknight,tichondrius,1632,paladin,holy,77,38,39
26826,Rhönin,sargeras,1632,paladin,holy,54,22,32
26827,Rhunon,dalaran,1631,paladin,holy,78,41,37
26828,Shazuwu,illidan,1630,paladin,holy,30,17,13
26829,Xcuse,tichondrius,1630,paladin,holy,84,43,41
26830,Boundric,emerald-dream,1629,paladin,holy,42,23,19
26831,Gazapal,thrall,1628,paladin,holy,168,95,73
26832,Pála,dalaran,1625,paladin,holy,164,80,84
26833,Songminsu,proudmoore,1625,paladin,holy,99,47,52
26834,Deepnasty,galakrond,1624,paladin,holy,215,110,105
26835,Piïls,sargeras,1623,paladin,holy,42,20,22
26836,Solfire,stormreaver,1622,paladin,holy,92,45,47
26837,Bopbotx,area-52,1621,paladin,holy,49,17,32
26838,Gospel,duskwood,1617,paladin,holy,65,37,28
26839,Aldrion,stormrage,1617,paladin,holy,54,28,26
26840,Scoopzi,frostmourne,1616,paladin,holy,47,27,20
26841,Rhönin,illidan,1616,paladin,holy,42,22,20
26842,Minefujiko,tichondrius,1616,paladin,holy,381,194,187
26843,Sinfolly,whisperwind,1615,paladin,holy,90,47,43
26844,Ascion,tichondrius,1614,paladin,holy,119,58,61
26845,Censy,tichondrius,1613,paladin,holy,30,17,13
26846,Caitthegreat,malorne,1613,paladin,holy,42,23,19
26847,Nodenom,blackrock,1612,paladin,holy,30,18,12
26848,Vmxp,barthilas,1611,paladin,holy,94,56,38
26849,Sekitar,ragnaros,1611,paladin,holy,155,79,76
26850,Zergmé,executus,1610,paladin,holy,42,21,21
26851,Ricopal,frostmourne,1610,paladin,holy,36,17,19
26852,Madorian,bleeding-hollow,1610,paladin,holy,71,31,40
26853,Bërzerk,zuluhed,1609,paladin,holy,93,44,49
26854,Denke,thrall,1609,paladin,holy,36,17,19
26855,Jealp,sargeras,1608,paladin,holy,42,26,16
26856,Roundhere,area-52,1608,paladin,holy,30,18,12
26857,Naxzy,quelthalas,1608,paladin,holy,46,27,19
26858,Moonmi,tichondrius,1608,paladin,holy,187,106,81
26859,Larryhoova,malganis,1608,paladin,holy,36,20,16
26860,Crâfty,bleeding-hollow,1608,paladin,holy,83,45,38
26861,Dwarrior,quelthalas,1606,paladin,holy,39,18,21
26862,Forsakenlite,sargeras,1606,paladin,holy,90,41,49
26863,Raigha,stormrage,1604,paladin,holy,42,22,20
26864,Zhula,nerzhul,1601,paladin,holy,48,31,17
26865,Erikx,smolderthorn,1601,paladin,holy,120,66,54
26866,Orphandog,zuljin,1600,paladin,holy,29,21,8
26867,Gjoker,azralon,1600,paladin,holy,42,25,17
26868,Jiraya,nemesis,1598,paladin,holy,79,39,40
26869,Wuhbp,illidan,1596,paladin,holy,88,44,44
26870,Peggy,azralon,1596,paladin,holy,39,18,21
26871,Klam,kelthuzad,1595,paladin,holy,96,48,48
26872,Brynnhild,stormrage,1592,paladin,holy,126,62,64
26873,Ricardão,emerald-dream,1592,paladin,holy,36,17,19
26874,Asherm,moon-guard,1590,paladin,holy,98,48,50
26875,Abellpally,tichondrius,1589,paladin,holy,54,23,31
26876,Beyondsausag,malganis,1589,paladin,holy,125,53,72
26877,Madsama,quelthalas,1587,paladin,holy,72,39,33
26878,Retsincewod,zuluhed,1586,paladin,holy,54,28,26
26879,Kencyz,tichondrius,1585,paladin,holy,37,22,15
26880,Chonsic,darkspear,1582,paladin,holy,90,40,50
26881,Bopthebomb,sargeras,1580,paladin,holy,71,33,38
26882,Sevenword,tichondrius,1577,paladin,holy,67,38,29
26883,Molki,tichondrius,1575,paladin,holy,111,64,47
26884,Thelac,dalaran,1575,paladin,holy,72,39,33
26885,Regivän,azralon,1575,paladin,holy,78,39,39
26886,Dodgeandhoj,nerzhul,1572,paladin,holy,36,19,17
26887,Babaganôush,illidan,1571,paladin,holy,35,18,17
26888,Leonideez,moon-guard,1571,paladin,holy,42,17,25
26889,Gwok,thrall,1569,paladin,holy,167,89,78
26890,Aluríel,quelthalas,1568,paladin,holy,56,28,28
26891,Drisx,sargeras,1567,paladin,holy,96,48,48
26892,Peelmeree,kelthuzad,1565,paladin,holy,36,18,18
26893,Hônòr,thrall,1564,paladin,holy,51,29,22
26894,Ashley,sargeras,1563,paladin,holy,42,22,20
26895,Sprjustice,frostmourne,1562,paladin,holy,36,18,18
26896,Nontheism,malganis,1559,paladin,holy,42,19,23
26897,Senorbaxter,emerald-dream,1557,paladin,holy,66,27,39
26898,Montageflav,illidan,1554,paladin,holy,56,27,29
26899,Gorgona,illidan,1551,paladin,holy,107,53,54
26900,Ilovecanada,sargeras,1550,paladin,holy,34,19,15
26901,Crabsaladpal,illidan,1550,paladin,holy,112,62,50
26902,Xinqingle,tichondrius,1550,paladin,holy,471,237,234
26903,Sheriff,tanaris,1547,paladin,holy,48,22,26
26904,Quertz,sargeras,1545,paladin,holy,149,87,62
26905,Jässy,muradin,1545,paladin,holy,59,29,30
26906,Amiigo,tichondrius,1545,paladin,holy,54,24,30
26907,Riptonix,stormrage,1540,paladin,holy,121,66,55
26908,Saibasita,tichondrius,1539,paladin,holy,48,33,15
26909,Discordnitro,illidan,1539,paladin,holy,36,20,16
26910,Killmoth,illidan,1539,paladin,holy,269,130,139
26911,Slüg,bleeding-hollow,1536,paladin,holy,264,134,130
26912,Handsomedan,twisting-nether,1533,paladin,holy,72,34,38
26913,Holyknight,veknilash,1532,paladin,holy,89,45,44
26914,Rg,nerzhul,1532,paladin,holy,219,108,111
26915,Drägonmynuts,tichondrius,1532,paladin,holy,109,45,64
26916,Avahir,moon-guard,1528,paladin,holy,60,30,30
26917,Saveursavior,bleeding-hollow,1524,paladin,holy,147,70,77
26918,Vaerume,sargeras,1523,paladin,holy,123,66,57
26919,Kidstable,nathrezim,1523,paladin,holy,70,27,43
26920,Superzero,area-52,1520,paladin,holy,48,26,22
26921,Beyönd,quelthalas,1520,paladin,holy,78,39,39
26922,Pandahorn,tichondrius,1520,paladin,holy,54,23,31
26923,Wokeinator,malganis,1519,paladin,holy,249,135,114
26924,Dageraad,tichondrius,1519,paladin,holy,30,16,14
26925,Bigoldman,tichondrius,1519,paladin,holy,72,37,35
26926,Sadamell,tichondrius,1518,paladin,holy,24,16,8
26927,Jiberish,illidan,1515,paladin,holy,126,60,66
26928,Bebebig,tichondrius,1511,paladin,holy,182,100,82
26929,Maeyz,sargeras,1511,paladin,holy,126,67,59
26930,Bosat,drakkari,1509,paladin,holy,48,19,29
26931,Bushÿ,tichondrius,1508,paladin,holy,94,52,42
26932,Humañ,tichondrius,1507,paladin,holy,60,32,28
26933,Cjqcjq,tichondrius,1507,paladin,holy,41,21,20
26934,Kdex,tichondrius,1505,paladin,holy,84,37,47
26935,Goldensmile,frostmourne,1504,paladin,holy,36,19,17
26936,Kencyxx,tichondrius,1504,paladin,holy,42,19,23
26937,Ageroÿ,sargeras,1503,paladin,holy,61,31,30
26938,Doofum,stormrage,1503,paladin,holy,131,58,73
26939,Serendipidy,bleeding-hollow,1503,paladin,holy,98,43,55
26940,Brumm,quelthalas,1501,paladin,holy,77,39,38
26941,Konvi,tichondrius,1501,paladin,holy,129,60,69
26942,Guerrer,hyjal,1499,paladin,holy,566,285,281
26943,Rodrigo,frostmourne,1499,paladin,holy,81,39,42
26944,Saphri,kiljaeden,1497,paladin,holy,214,110,104
26945,Harryhui,tichondrius,1496,paladin,holy,42,23,19
26946,Jeromee,area-52,1496,paladin,holy,48,19,29
26947,Haitishammer,stormrage,1494,paladin,holy,78,37,41
26948,Lightkillerx,thrall,1494,paladin,holy,84,37,47
26949,Daenrahh,azralon,1491,paladin,holy,176,91,85
26950,Paladanim,tichondrius,1490,paladin,holy,77,23,54
26951,Nickiminhoj,stormrage,1488,paladin,holy,51,29,22
26952,Neurôtoxins,frostmourne,1488,paladin,holy,54,27,27
26953,Prettylightx,kelthuzad,1487,paladin,holy,259,128,131
26954,Irunnal,kelthuzad,1486,paladin,holy,41,27,14
26955,Donkeydumper,wyrmrest-accord,1486,paladin,holy,118,67,51
26956,Stophamrtime,barthilas,1484,paladin,holy,42,20,22
26957,Condone,earthen-ring,1484,paladin,holy,96,44,52
26958,Baitur,zuljin,1480,paladin,holy,49,21,28
26959,Regivan,nemesis,1479,paladin,holy,42,16,26
26960,Aulty,sargeras,1479,paladin,holy,77,28,49
26961,Fredward,bleeding-hollow,1478,paladin,holy,35,18,17
26962,Dewlight,zuljin,1477,paladin,holy,161,77,84
26963,Jorik,lightbringer,1477,paladin,holy,42,20,22
26964,Dimix,sargeras,1476,paladin,holy,65,32,33
26965,Lhpal,ragnaros,1475,paladin,holy,30,19,11
26966,Zenkk,sargeras,1475,paladin,holy,57,23,34
26967,Caobobby,tichondrius,1474,paladin,holy,57,25,32
26968,Buqi,barthilas,1474,paladin,holy,57,23,34
26969,Percüles,sargeras,1473,paladin,holy,66,38,28
26970,Atelva,moon-guard,1471,paladin,holy,75,46,29
26971,Judgemode,the-scryers,1468,paladin,holy,96,41,55
26972,Ryhighdi,sargeras,1467,paladin,holy,48,22,26
26973,Ooppa,proudmoore,1467,paladin,holy,61,26,35
26974,Pasda,frostmourne,1467,paladin,holy,77,29,48
26975,Blarr,azshara,1466,paladin,holy,84,34,50
26976,Glørythrives,tichondrius,1465,paladin,holy,57,25,32
26977,Vitabro,bleeding-hollow,1464,paladin,holy,155,81,74
26978,Traumaboy,terenas,1463,paladin,holy,87,44,43
26979,Danpros,azralon,1462,paladin,holy,84,34,50
26980,Hughmyron,stormrage,1461,paladin,holy,40,24,16
26981,Cohesion,draenor,1461,paladin,holy,77,35,42
26982,Jezëbel,azralon,1460,paladin,holy,52,27,25
26983,Sanasana,spirestone,1459,paladin,holy,117,66,51
26984,Allitharis,tichondrius,1458,paladin,holy,112,59,53
26985,Indemnity,wildhammer,1457,paladin,holy,69,40,29
26986,Gotomars,tichondrius,1457,paladin,holy,89,45,44
26987,Wonpai,frostmourne,1457,paladin,holy,57,26,31
26988,Wonpaiv,frostmourne,1456,paladin,holy,53,21,32
26989,Gankstapwn,tichondrius,1455,paladin,holy,59,27,32
26990,Omfgitsyang,tichondrius,1453,paladin,holy,41,24,17
26991,Devöut,aggramar,1453,paladin,holy,103,48,55
26992,Handyandy,kelthuzad,1450,paladin,holy,118,61,57
26993,Zakath,the-underbog,1449,paladin,holy,72,31,41
26994,Zoeyxo,tichondrius,1448,paladin,holy,80,42,38
26995,Noback,ragnaros,1448,paladin,holy,66,31,35
26996,Kihluxo,frostmourne,1446,paladin,holy,101,56,45
26997,Tigranes,proudmoore,1444,paladin,holy,36,17,19
26998,Celsica,kelthuzad,1443,paladin,holy,153,73,80
26999,Chowdar,proudmoore,1443,paladin,holy,78,36,42
27000,Holyprotectr,tichondrius,1442,paladin,holy,30,17,13
27001,Cykcp,burning-legion,1441,paladin,holy,72,34,38
27002,Danyuel,zuljin,1441,paladin,holy,86,39,47
27003,Notdjalex,zuljin,1440,paladin,holy,30,19,11
27004,Holyhades,auchindoun,1439,paladin,holy,125,70,55
27005,Sigmapepe,quelthalas,1436,paladin,holy,96,52,44
27006,Ryhigh,sargeras,1436,paladin,holy,89,38,51
27007,Rarth,nemesis,1434,paladin,holy,65,26,39
27008,Xuantianchai,tichondrius,1431,paladin,holy,30,15,15
27009,Shagalaga,tichondrius,1431,paladin,holy,155,72,83
27010,Kriegmeister,amanthul,1429,paladin,holy,48,24,24
27011,Herakleitos,firetree,1428,paladin,holy,69,41,28
27012,Nume,nesingwary,1428,paladin,holy,96,49,47
27013,Lyticmartyr,bleeding-hollow,1427,paladin,holy,48,24,24
27014,Nrpzy,stormrage,1425,paladin,holy,83,39,44
27015,Brioc,tichondrius,1424,paladin,holy,36,22,14
27016,Lothnalar,ragnaros,1424,paladin,holy,54,23,31
27017,Justeight,stormrage,1423,paladin,holy,66,37,29
27018,Mastadin,illidan,1422,paladin,holy,36,19,17
27019,Mabia,tichondrius,1421,paladin,holy,215,111,104
27020,Splashleyy,bleeding-hollow,1421,paladin,holy,148,69,79
27021,Holyterror,dentarg,1420,paladin,holy,48,25,23
27022,Vodokus,area-52,1420,paladin,holy,106,46,60
27023,Graceyrae,tichondrius,1419,paladin,holy,50,30,20
27024,Jpwx,barthilas,1419,paladin,holy,30,15,15
27025,Droopyz,quelthalas,1418,paladin,holy,66,27,39
27026,Decalli,tichondrius,1417,paladin,holy,69,35,34
27027,Dartpuncher,frostmourne,1414,paladin,holy,120,63,57
27028,Realpalada,tichondrius,1414,paladin,holy,65,25,40
27029,Alessan,nemesis,1413,paladin,holy,31,18,13
27030,Cynical,dalvengyr,1413,paladin,holy,120,64,56
27031,Palladomal,azralon,1413,paladin,holy,84,41,43
27032,Xuanxingchai,tichondrius,1413,paladin,holy,72,30,42
27033,Unbreakable,antonidas,1412,paladin,holy,51,36,15
27034,Berseus,tichondrius,1411,paladin,holy,78,31,47
27035,Lliliiliil,illidan,1410,paladin,holy,68,39,29
27036,Quadrifoglio,moon-guard,1409,paladin,holy,205,106,99
27037,Arral,malganis,1408,paladin,holy,66,31,35
27038,Samaze,tichondrius,1407,paladin,holy,126,61,65
27039,Vasar,tichondrius,1406,paladin,holy,37,26,11
27040,Maleguz,azralon,1406,paladin,holy,309,159,150
27041,Kokomö,kelthuzad,1404,paladin,holy,47,21,26
27042,Nxkita,sargeras,1403,paladin,holy,54,28,26
27043,Nanøha,frostmourne,1402,paladin,holy,88,26,62
27044,Crüst,proudmoore,1401,paladin,holy,42,21,21
27045,Liå,frostmourne,1399,paladin,holy,96,49,47
27046,Wálker,ragnaros,1399,paladin,holy,98,48,50
27047,Talantyr,zuljin,1398,paladin,holy,48,23,25
27048,Uprise,chogall,1397,paladin,holy,66,33,33
27049,Fabîan,guldan,1395,paladin,holy,42,22,20
27050,Kirilx,vashj,1395,paladin,holy,48,25,23
27051,Dadcantsac,frostmourne,1395,paladin,holy,87,41,46
27052,Anderentonso,tichondrius,1395,paladin,holy,54,24,30
27053,Paladinaiko,nemesis,1394,paladin,holy,117,57,60
27054,Vêgenace,proudmoore,1394,paladin,holy,39,19,20
27055,Enuug,malfurion,1390,paladin,holy,78,48,30
27056,Holyramen,illidan,1389,paladin,holy,209,98,111
27057,Anea,kelthuzad,1388,paladin,holy,32,17,15
27058,Sapphiros,tichondrius,1388,paladin,holy,68,25,43
27059,Summercarma,area-52,1387,paladin,holy,27,15,12
27060,Odiinn,stormscale,1385,paladin,holy,85,39,46
27061,Viviana,shadowmoon,1385,paladin,holy,46,20,26
27062,Granitei,quelthalas,1384,paladin,holy,50,24,26
27063,Luminainre,zuljin,1384,paladin,holy,149,66,83
27064,Stormzy,zuljin,1383,paladin,holy,80,39,41
27065,Ricemang,kiljaeden,1380,paladin,holy,53,24,29
27066,Palapoxi,arygos,1377,paladin,holy,77,36,41
27067,Doorii,tichondrius,1377,paladin,holy,47,18,29
27068,Oralen,daggerspine,1376,paladin,holy,60,29,31
27069,Ibury,quelthalas,1376,paladin,holy,139,67,72
27070,Delilahxoxo,mugthol,1376,paladin,holy,63,26,37
27071,Leónrey,stormrage,1376,paladin,holy,92,33,59
27072,Lu,the-venture-co,1371,paladin,holy,34,15,19
27073,Fiate,azralon,1370,paladin,holy,36,16,20
27074,Massivesac,frostmourne,1369,paladin,holy,36,22,14
27075,Jimmipepe,quelthalas,1369,paladin,holy,42,24,18
27076,Palltard,illidan,1369,paladin,holy,42,18,24
27077,Mânz,zuljin,1369,paladin,holy,60,21,39
27078,Shaidd,bleeding-hollow,1368,paladin,holy,77,34,43
27079,Mellidi,azralon,1367,paladin,holy,42,23,19
27080,Saeranella,moon-guard,1366,paladin,holy,106,44,62
27081,Paladinaa,lothar,1364,paladin,holy,104,41,63
27082,Gorilla,kiljaeden,1362,paladin,holy,59,15,44
27083,Rengen,frostmourne,1360,paladin,holy,42,22,20
27084,Xöchïqüëtzäl,tichondrius,1360,paladin,holy,29,15,14
27085,Bakoø,tichondrius,1360,paladin,holy,65,31,34
27086,Zephyrvalor,sargeras,1360,paladin,holy,48,18,30
27087,Jestiny,amanthul,1356,paladin,holy,97,55,42
27088,Choonsly,tichondrius,1356,paladin,holy,69,36,33
27089,Lightupx,stormrage,1356,paladin,holy,61,22,39
27090,Negodoskate,nemesis,1353,paladin,holy,207,105,102
27091,Amadeo,hyjal,1353,paladin,holy,101,44,57
27092,Galabanja,malganis,1350,paladin,holy,42,24,18
27093,Bulgecranker,tichondrius,1350,paladin,holy,36,20,16
27094,Hawtwangs,proudmoore,1349,paladin,holy,48,26,22
27095,Hamen,frostwolf,1349,paladin,holy,41,22,19
27096,Møcha,moon-guard,1347,paladin,holy,44,23,21
27097,Palazin,frostmourne,1347,paladin,holy,128,54,74
27098,Flippo,sargeras,1346,paladin,holy,36,17,19
27099,Hoonjojjyanp,tichondrius,1346,paladin,holy,35,15,20
27100,Piura,stormreaver,1345,paladin,holy,48,23,25
27101,Clare,burning-blade,1345,paladin,holy,61,28,33
27102,Airbusx,tichondrius,1343,paladin,holy,24,14,10
27103,Aberos,stonemaul,1343,paladin,holy,69,24,45
27104,Mctacos,proudmoore,1342,paladin,holy,18,14,4
27105,Ocean,sargeras,1342,paladin,holy,30,14,16
27106,Miswalkpally,ragnaros,1342,paladin,holy,30,14,16
27107,Rhamadicinu,frostmourne,1341,paladin,holy,55,31,24
27108,Bakoo,tichondrius,1341,paladin,holy,54,27,27
27109,Htmlar,tichondrius,1338,paladin,holy,75,41,34
27110,Xiaoladin,frostmourne,1337,paladin,holy,25,16,9
27111,Güido,stormrage,1337,paladin,holy,42,23,19
27112,Röniin,ragnaros,1337,paladin,holy,298,156,142
27113,Minereth,quelthalas,1337,paladin,holy,59,30,29
27114,Leonrey,stormrage,1337,paladin,holy,43,21,22
27115,Malakor,thrall,1334,paladin,holy,87,46,41
27116,Finerkane,quelthalas,1334,paladin,holy,138,62,76
27117,Alphanerd,burning-blade,1333,paladin,holy,55,27,28
27118,Therealdeal,sargeras,1332,paladin,holy,77,41,36
27119,Hawianbread,stormrage,1331,paladin,holy,60,33,27
27120,Nepnade,stormrage,1331,paladin,holy,47,25,22
27121,Rezmefool,tichondrius,1331,paladin,holy,133,59,74
27122,Buri,tichondrius,1330,paladin,holy,42,17,25
27123,Phinnik,tichondrius,1329,paladin,holy,250,125,125
27124,Riporeo,rexxar,1327,paladin,holy,24,18,6
27125,Syrenz,khazgoroth,1327,paladin,holy,42,24,18
27126,Ashgrim,kiljaeden,1327,paladin,holy,77,37,40
27127,Catechism,laughing-skull,1325,paladin,holy,44,24,20
27128,Deepsearide,illidan,1324,paladin,holy,150,82,68
27129,Alcaedra,shadowsong,1324,paladin,holy,92,45,47
27130,Jordenz,bonechewer,1324,paladin,holy,30,14,16
27131,Consecrated,daggerspine,1324,paladin,holy,75,30,45
27132,Mcllovin,kiljaeden,1323,paladin,holy,60,28,32
27133,Lucciuzz,tichondrius,1323,paladin,holy,68,29,39
27134,Dimior,quelthalas,1322,paladin,holy,54,29,25
27135,Zantdemption,frostmourne,1322,paladin,holy,30,15,15
27136,Îcandy,stormrage,1319,paladin,holy,24,16,8
27137,Kektrixia,tichondrius,1318,paladin,holy,24,15,9
27138,Ùnholypally,jubeithos,1316,paladin,holy,71,42,29
27139,Nilin,tichondrius,1316,paladin,holy,24,14,10
27140,Ramphastoz,quelthalas,1316,paladin,holy,66,29,37
27141,Valandiel,proudmoore,1315,paladin,holy,61,15,46
27142,Sinay,azshara,1314,paladin,holy,76,43,33
27143,Jaenus,azralon,1314,paladin,holy,66,32,34
27144,Hodl,barthilas,1313,paladin,holy,113,58,55
27145,Papaa,nemesis,1312,paladin,holy,166,79,87
27146,Mawning,kelthuzad,1311,paladin,holy,220,111,109
27147,Ryhighh,sargeras,1311,paladin,holy,93,37,56
27148,Twck,hyjal,1309,paladin,holy,168,81,87
27149,Holyredx,bleeding-hollow,1307,paladin,holy,126,70,56
27150,Solanin,frostmourne,1307,paladin,holy,75,38,37
27151,Ozpal,burning-blade,1305,paladin,holy,38,24,14
27152,Errant,bonechewer,1305,paladin,holy,53,31,22
27153,Wiley,dark-iron,1305,paladin,holy,36,20,16
27154,Santiadin,ragnaros,1304,paladin,holy,20,15,5
27155,Dreadrot,azralon,1302,paladin,holy,50,24,26
27156,Sorkar,tichondrius,1301,paladin,holy,129,66,63
27157,Einjerhar,quelthalas,1300,paladin,holy,48,22,26
27158,Dóminos,quelthalas,1298,paladin,holy,48,24,24
27159,Galearn,ragnaros,1298,paladin,holy,30,14,16
27160,Ironpaladin,sargeras,1297,paladin,holy,90,39,51
27161,Shámder,quelthalas,1295,paladin,holy,59,27,32
27162,Vurian,uther,1295,paladin,holy,90,36,54
27163,Ballsmcgee,bleeding-hollow,1294,paladin,holy,141,63,78
27164,Botburger,stormrage,1293,paladin,holy,30,14,16
27165,Goodwood,ghostlands,1293,paladin,holy,90,41,49
27166,Jacobhowda,tichondrius,1292,paladin,holy,54,25,29
27167,Colbroggins,crushridge,1289,paladin,holy,45,24,21
27168,Daphillen,frostmourne,1288,paladin,holy,41,23,18
27169,Yadiyadiyada,barthilas,1287,paladin,holy,42,24,18
27170,Lørdthemar,azralon,1286,paladin,holy,60,26,34
27171,Blessthfall,bleeding-hollow,1286,paladin,holy,51,14,37
27172,Undefeatæd,korgath,1285,paladin,holy,52,29,23
27173,Psuito,ragnaros,1285,paladin,holy,60,32,28
27174,Quarall,blackhand,1283,paladin,holy,58,29,29
27175,Slygonjinn,area-52,1281,paladin,holy,36,14,22
27176,Swordstrikes,tichondrius,1271,paladin,holy,29,14,15
27177,Merll,ragnaros,1267,paladin,holy,121,58,63
27178,Klamindor,emerald-dream,1266,paladin,holy,48,22,26
27179,Cowladino,tichondrius,1265,paladin,holy,55,27,28
27180,Affrika,ysondre,1264,paladin,holy,104,52,52
27181,Pallin,sargeras,1264,paladin,holy,90,41,49
27182,Sneakypal,dalaran,1263,paladin,holy,58,22,36
27183,Motoa,stormrage,1262,paladin,holy,36,19,17
27184,Dumpytrucks,sargeras,1262,paladin,holy,48,24,24
27185,Chånïng,frostmourne,1262,paladin,holy,42,16,26
27186,Hèró,barthilas,1261,paladin,holy,30,16,14
27187,Coltlocks,sargeras,1261,paladin,holy,54,26,28
27188,Thiccholy,deathwing,1260,paladin,holy,170,93,77
27189,Lilfingered,malganis,1260,paladin,holy,57,29,28
27190,Vithar,bleeding-hollow,1259,paladin,holy,173,84,89
27191,Randuir,proudmoore,1258,paladin,holy,68,38,30
27192,Salipally,dalaran,1258,paladin,holy,101,46,55
27193,Showtíme,steamwheedle-cartel,1257,paladin,holy,25,14,11
27194,Lafasíta,ragnaros,1257,paladin,holy,36,19,17
27195,Brenenk,quelthalas,1257,paladin,holy,65,32,33
27196,Imabandagins,bleeding-hollow,1257,paladin,holy,109,52,57
27197,Holyslapy,illidan,1255,paladin,holy,71,38,33
27198,Troypolamalu,dark-iron,1255,paladin,holy,30,14,16
27199,Holysplonk,stonemaul,1255,paladin,holy,72,30,42
27200,Lightleadsme,sargeras,1254,paladin,holy,234,113,121
27201,Swazanaseger,frostmourne,1252,paladin,holy,42,22,20
27202,Ckemosabe,emerald-dream,1252,paladin,holy,38,14,24
27203,Deidei,blood-furnace,1251,paladin,holy,29,17,12
27204,Wukongsunn,dalaran,1251,paladin,holy,30,14,16
27205,Elizzabeth,skullcrusher,1248,paladin,holy,41,25,16
27206,Whitekao,illidan,1247,paladin,holy,18,13,5
27207,Elutherios,tichondrius,1247,paladin,holy,54,26,28
27208,Hopeyouheal,sargeras,1247,paladin,holy,30,14,16
27209,Darkbringer,frostmourne,1245,paladin,holy,76,38,38
27210,Silvermind,tichondrius,1244,paladin,holy,30,17,13
27211,Freyr,deathwing,1244,paladin,holy,38,21,17
27212,Bubblepigo,tichondrius,1243,paladin,holy,36,22,14
27213,Sologriefer,sargeras,1242,paladin,holy,30,13,17
27214,Scarlet,skywall,1241,paladin,holy,30,13,17
27215,Herroprease,frostmane,1241,paladin,holy,30,13,17
27216,Cudiskush,tichondrius,1237,paladin,holy,45,26,19
27217,Anatnof,malganis,1237,paladin,holy,30,16,14
27218,Roundbutts,stormrage,1237,paladin,holy,27,14,13
27219,Chewyjitsu,tichondrius,1237,paladin,holy,54,23,31
27220,Kristienna,boulderfist,1236,paladin,holy,35,16,19
27221,Cbm,tichondrius,1235,paladin,holy,23,14,9
27222,Chewiipal,dalaran,1235,paladin,holy,57,31,26
27223,Judgynomnom,the-underbog,1234,paladin,holy,36,13,23
27224,Elladan,illidan,1234,paladin,holy,66,20,46
27225,Tuor,nerzhul,1233,paladin,holy,18,13,5
27226,Twìceborn,emerald-dream,1233,paladin,holy,24,13,11
27227,Kariack,malganis,1231,paladin,holy,30,15,15
27228,Diebeatus,zuljin,1231,paladin,holy,54,25,29
27229,Justizz,vashj,1228,paladin,holy,65,35,30
27230,Mobitz,dalvengyr,1228,paladin,holy,36,16,20
27231,Wodlim,azralon,1228,paladin,holy,37,13,24
27232,Venictus,frostwolf,1227,paladin,holy,24,13,11
27233,Gareyn,moon-guard,1227,paladin,holy,36,14,22
27234,Mundomaloo,quelthalas,1226,paladin,holy,59,31,28
27235,Moogmodular,malganis,1226,paladin,holy,98,47,51
27236,Crocfacex,tichondrius,1226,paladin,holy,46,18,28
27237,Harke,drakkari,1224,paladin,holy,18,13,5
27238,Szsfstnoob,tichondrius,1224,paladin,holy,30,13,17
27239,Aellithiene,tichondrius,1221,paladin,holy,30,13,17
27240,Ballingirl,gnomeregan,1220,paladin,holy,51,22,29
27241,Akromma,drakkari,1219,paladin,holy,47,25,22
27242,Ramspartan,drakkari,1218,paladin,holy,106,52,54
27243,Whangsta,tichondrius,1217,paladin,holy,48,21,27
27244,Bárdokø,ragnaros,1216,paladin,holy,84,42,42
27245,Monts,azralon,1215,paladin,holy,61,24,37
27246,Saffranzord,azralon,1214,paladin,holy,73,35,38
27247,Tandury,tichondrius,1214,paladin,holy,60,28,32
27248,Hobbsone,trollbane,1214,paladin,holy,137,54,83
27249,Savagegirlz,tichondrius,1213,paladin,holy,82,35,47
27250,Sventyn,frostmourne,1212,paladin,holy,55,29,26
27251,Kamaelyn,proudmoore,1211,paladin,holy,133,68,65
27252,Tizzi,eredar,1210,paladin,holy,23,13,10
27253,Capedcrusade,area-52,1208,paladin,holy,24,13,11
27254,Yérn,barthilas,1208,paladin,holy,42,15,27
27255,Krysalid,stormrage,1207,paladin,holy,39,22,17
27256,Kënsi,quelthalas,1206,paladin,holy,158,82,76
27257,Kenric,quelthalas,1204,paladin,holy,77,30,47
27258,Burgalveist,azgalor,1202,paladin,holy,25,15,10
27259,Contémpt,kelthuzad,1202,paladin,holy,30,14,16
27260,Stemi,kelthuzad,1202,paladin,holy,59,21,38
27261,Oopalaoo,azralon,1202,paladin,holy,54,19,35
27262,Chor,tichondrius,1201,paladin,holy,22,14,8
27263,Nikopala,tichondrius,1201,paladin,holy,39,20,19
27264,Chopsparks,khadgar,1201,paladin,holy,147,75,72
27265,Galeras,norgannon,1201,paladin,holy,164,70,94
27266,Holyflux,winterhoof,1200,paladin,holy,18,13,5
27267,Maaxxee,zuljin,1200,paladin,holy,27,13,14
27268,Aoishie,bleeding-hollow,1200,paladin,holy,90,40,50
27269,Boarfarmer,tichondrius,1199,paladin,holy,87,37,50
27270,Mörphêus,tichondrius,1197,paladin,holy,54,30,24
27271,Shorthordeon,kelthuzad,1194,paladin,holy,54,30,24
27272,Dreemie,tichondrius,1194,paladin,holy,54,20,34
27273,Dbolpala,frostmourne,1192,paladin,holy,48,26,22
27274,Jessuss,shandris,1192,paladin,holy,51,21,30
27275,Swanp,stormrage,1191,paladin,holy,60,26,34
27276,Encantado,thrall,1190,paladin,holy,43,20,23
27277,Yogafire,kelthuzad,1188,paladin,holy,24,13,11
27278,Pallythre,proudmoore,1187,paladin,holy,54,23,31
27279,Faileeria,malganis,1185,paladin,holy,36,25,11
27280,Sinara,detheroc,1184,paladin,holy,143,69,74
27281,Hulksmash,terenas,1184,paladin,holy,41,13,28
27282,Bubblebooty,drakthul,1182,paladin,holy,60,38,22
27283,Donoph,blades-edge,1182,paladin,holy,44,20,24
27284,Granklol,tichondrius,1181,paladin,holy,98,41,57
27285,Paladinomoto,sargeras,1180,paladin,holy,46,22,24
27286,Sixtynine,nathrezim,1180,paladin,holy,78,35,43
27287,Prosykt,sargeras,1179,paladin,holy,36,14,22
27288,Myrthedara,kargath,1178,paladin,holy,33,16,17
27289,Mianheyo,quelthalas,1178,paladin,holy,41,18,23
27290,Vänhélsing,tichondrius,1176,paladin,holy,37,16,21
27291,Barbaluzz,quelthalas,1174,paladin,holy,257,123,134
27292,Psychorino,tichondrius,1173,paladin,holy,33,13,20
27293,Madcandy,illidan,1172,paladin,holy,24,15,9
27294,Ihr,kiljaeden,1162,paladin,holy,84,39,45
27295,Pemodyne,illidan,1161,paladin,holy,66,21,45
27296,Jazzmatic,dalaran,1157,paladin,holy,53,24,29
27297,Babylonfive,zuluhed,1157,paladin,holy,126,53,73
27298,Hammercy,tichondrius,1155,paladin,holy,73,39,34
27299,Onecmpeter,kelthuzad,1152,paladin,holy,67,38,29
27300,Shxz,illidan,1152,paladin,holy,24,12,12
27301,Dispirit,the-forgotten-coast,1151,paladin,holy,41,25,16
27302,Ej,ragnaros,1151,paladin,holy,24,12,12
27303,Holycowisroy,illidan,1150,paladin,holy,24,12,12
27304,Picorii,frostmourne,1150,paladin,holy,30,12,18
27305,Bignum,illidan,1150,paladin,holy,36,12,24
27306,Toroke,nemesis,1149,paladin,holy,60,33,27
27307,Boxjang,tichondrius,1149,paladin,holy,24,12,12
27308,Lòuisvuttion,tichondrius,1148,paladin,holy,18,12,6
27309,Bluemitch,malfurion,1147,paladin,holy,36,14,22
27310,Lindnerxo,malganis,1147,paladin,holy,36,12,24
27311,Toesy,area-52,1146,paladin,holy,64,27,37
27312,Oldgrumpster,stormrage,1145,paladin,holy,123,54,69
27313,Renteria,sargeras,1144,paladin,holy,24,12,12
27314,Homiepaldino,nordrassil,1143,paladin,holy,30,12,18
27315,Lindsans,illidan,1142,paladin,holy,18,12,6
27316,Repèntance,stormrage,1142,paladin,holy,24,12,12
27317,Iramm,gallywix,1141,paladin,holy,18,12,6
27318,Daik,proudmoore,1140,paladin,holy,34,20,14
27319,Thorgard,antonidas,1140,paladin,holy,30,17,13
27320,Dazztrain,barthilas,1139,paladin,holy,24,12,12
27321,Exxin,turalyon,1139,paladin,holy,90,40,50
27322,Elogant,mannoroth,1138,paladin,holy,58,33,25
27323,Flareous,moon-guard,1138,paladin,holy,30,12,18
27324,Smitty,korgath,1137,paladin,holy,30,12,18
27325,Zavop,tichondrius,1136,paladin,holy,24,12,12
27326,Raqu,laughing-skull,1136,paladin,holy,54,24,30
27327,Heniou,tichondrius,1136,paladin,holy,59,26,33
27328,Rajava,gallywix,1132,paladin,holy,78,43,35
27329,Holodecoy,bleeding-hollow,1129,paladin,holy,50,22,28
27330,Kipow,proudmoore,1128,paladin,holy,30,14,16
27331,Alarter,azralon,1128,paladin,holy,36,13,23
27332,Divinetits,sargeras,1127,paladin,holy,32,13,19
27333,Clehley,turalyon,1126,paladin,holy,54,24,30
27334,Belmonte,greymane,1125,paladin,holy,18,12,6
27335,Dawnhammer,mugthol,1125,paladin,holy,58,28,30
27336,Jiaofu,illidan,1123,paladin,holy,24,12,12
27337,Kentö,area-52,1123,paladin,holy,30,14,16
27338,Mywifeisbad,tichondrius,1122,paladin,holy,18,12,6
27339,Bonz,ragnaros,1121,paladin,holy,24,12,12
27340,Salitheion,queldorei,1120,paladin,holy,42,14,28
27341,Sloppybobby,zuljin,1119,paladin,holy,30,16,14
27342,Dueprøcess,elune,1119,paladin,holy,24,12,12
27343,Ziggzag,hyjal,1117,paladin,holy,78,34,44
27344,Bunksta,kelthuzad,1116,paladin,holy,52,25,27
27345,Center,ragnaros,1116,paladin,holy,29,12,17
27346,Meatburger,stormrage,1113,paladin,holy,30,12,18
27347,Ouken,frostmourne,1111,paladin,holy,55,22,33
27348,Holyhali,zuljin,1111,paladin,holy,80,27,53
27349,Ëd,moon-guard,1110,paladin,holy,180,89,91
27350,Holymorph,tichondrius,1108,paladin,holy,22,13,9
27351,Zowolf,quelthalas,1108,paladin,holy,65,33,32
27352,Acori,azralon,1108,paladin,holy,39,18,21
27353,Onno,tichondrius,1105,paladin,holy,54,28,26
27354,Kelthor,azralon,1104,paladin,holy,36,18,18
27355,Freezion,aegwynn,1104,paladin,holy,33,15,18
27356,Lovehan,tichondrius,1103,paladin,holy,27,12,15
27357,Holysols,zuljin,1102,paladin,holy,24,12,12
27358,Joeboomers,tichondrius,1098,paladin,holy,118,62,56
27359,Lavarball,tichondrius,1098,paladin,holy,41,14,27
27360,Vamir,magtheridon,1093,paladin,holy,48,24,24
27361,Whosharted,area-52,1092,paladin,holy,66,36,30
27362,Balanoriaa,azralon,1092,paladin,holy,62,29,33
27363,Hojula,area-52,1087,paladin,holy,16,12,4
27364,Unworn,proudmoore,1087,paladin,holy,66,34,32
27365,Tittanfalls,illidan,1086,paladin,holy,48,25,23
27366,Lobõ,ragnaros,1086,paladin,holy,48,18,30
27367,Maín,tichondrius,1085,paladin,holy,22,12,10
27368,Liadrin,sentinels,1085,paladin,holy,29,12,17
27369,Teloniow,quelthalas,1084,paladin,holy,38,19,19
27370,Holyginger,barthilas,1084,paladin,holy,90,32,58
27371,Overthrrow,kelthuzad,1082,paladin,holy,180,93,87
27372,Salivan,darkspear,1082,paladin,holy,27,13,14
27373,Palaadiin,sargeras,1081,paladin,holy,60,33,27
27374,Hivers,stormrage,1081,paladin,holy,48,22,26
27375,Spikele,barthilas,1079,paladin,holy,30,13,17
27376,Ahundo,stonemaul,1078,paladin,holy,71,39,32
27377,Shocka,norgannon,1078,paladin,holy,90,48,42
27378,Bloodyhull,azralon,1077,paladin,holy,18,12,6
27379,Trivv,illidan,1077,paladin,holy,39,13,26
27380,Maldobarr,stormrage,1075,paladin,holy,30,12,18
27381,Rykeran,warsong,1074,paladin,holy,120,66,54
27382,Rogrmurtaugh,sargeras,1073,paladin,holy,65,30,35
27383,Vaalbara,fizzcrank,1070,paladin,holy,30,14,16
27384,Resio,illidan,1068,paladin,holy,36,13,23
27385,Lycheelz,illidan,1064,paladin,holy,48,26,22
27386,Constantino,hakkar,1064,paladin,holy,24,13,11
27387,Júpiter,kiljaeden,1064,paladin,holy,40,17,23
27388,Fuzed,frostmourne,1063,paladin,holy,163,81,82
27389,Vidalia,barthilas,1062,paladin,holy,23,12,11
27390,Fatsoo,sargeras,1062,paladin,holy,25,12,13
27391,Buckybarnes,gorefiend,1061,paladin,holy,42,26,16
27392,Mitshuki,ragnaros,1060,paladin,holy,30,12,18
27393,Lukas,vashj,1059,paladin,holy,176,89,87
27394,Cephadrome,proudmoore,1058,paladin,holy,42,20,22
27395,Mèdic,illidan,1057,paladin,holy,62,34,28
27396,Odriew,sargeras,1056,paladin,holy,18,11,7
27397,Narcissism,emerald-dream,1056,paladin,holy,18,11,7
27398,Babe,crushridge,1056,paladin,holy,30,11,19
27399,Waifu,area-52,1055,paladin,holy,18,11,7
27400,Twichy,tichondrius,1055,paladin,holy,18,11,7
27401,Lazio,frostmourne,1055,paladin,holy,24,11,13
27402,Lickmysacx,tichondrius,1055,paladin,holy,30,11,19
27403,Trivana,durotan,1054,paladin,holy,19,12,7
27404,Pseudoret,tichondrius,1054,paladin,holy,18,11,7
27405,Pality,illidan,1054,paladin,holy,24,11,13
27406,Holygutzz,barthilas,1054,paladin,holy,30,11,19
27407,Bloodrefuge,tichondrius,1054,paladin,holy,46,12,34
27408,Beerüs,crushridge,1053,paladin,holy,48,22,26
27409,Stingay,nemesis,1052,paladin,holy,24,11,13
27410,Eldessia,wyrmrest-accord,1052,paladin,holy,24,11,13
27411,Malakk,zuljin,1051,paladin,holy,47,25,22
27412,Jonfox,stormrage,1051,paladin,holy,70,35,35
27413,Hoopzz,illidan,1050,paladin,holy,30,11,19
27414,Zxylight,hyjal,1048,paladin,holy,18,11,7
27415,Kolmourn,deathwing,1048,paladin,holy,30,11,19
27416,Palooma,area-52,1047,paladin,holy,72,29,43
27417,Boostsixty,proudmoore,1046,paladin,holy,36,13,23
27418,Èmmà,stormrage,1044,paladin,holy,87,41,46
27419,Hybbo,runetotem,1042,paladin,holy,24,12,12
27420,Tig,alleria,1042,paladin,holy,30,11,19
27421,Ramhammerz,sargeras,1039,paladin,holy,150,71,79
27422,Tyriam,stormscale,1038,paladin,holy,18,11,7
27423,Waldir,silver-hand,1038,paladin,holy,36,11,25
27424,Kymosolopal,sargeras,1038,paladin,holy,36,11,25
27425,Mcduss,proudmoore,1037,paladin,holy,18,11,7
27426,Xq,aegwynn,1037,paladin,holy,41,18,23
27427,Cloûd,tichondrius,1036,paladin,holy,25,14,11
27428,Raenilil,area-52,1036,paladin,holy,41,20,21
27429,Nugsbunne,tichondrius,1035,paladin,holy,115,49,66
27430,Whiteknight,kilrogg,1034,paladin,holy,24,11,13
27431,Kromthael,burning-blade,1032,paladin,holy,24,11,13
27432,Pheriox,agamaggan,1032,paladin,holy,24,11,13
27433,Starfaith,illidan,1032,paladin,holy,67,27,40
27434,Seonghwa,kelthuzad,1031,paladin,holy,70,40,30
27435,Troxnar,ragnaros,1030,paladin,holy,64,38,26
27436,Palqq,tichondrius,1025,paladin,holy,24,11,13
27437,Stompcomp,tichondrius,1024,paladin,holy,75,32,43
27438,Klansey,magtheridon,1023,paladin,holy,54,30,24
27439,Wrathmatics,arthas,1022,paladin,holy,82,38,44
27440,Minouther,area-52,1022,paladin,holy,80,32,48
27441,Ahsys,tichondrius,1022,paladin,holy,53,18,35
27442,Tylnish,hyjal,1021,paladin,holy,24,11,13
27443,Voxoen,bleeding-hollow,1021,paladin,holy,24,11,13
27444,Lexdor,quelthalas,1021,paladin,holy,24,11,13
27445,Asclepiius,frostmourne,1020,paladin,holy,59,32,27
27446,Erán,quelthalas,1019,paladin,holy,218,109,109
27447,Tacori,gorefiend,1017,paladin,holy,24,13,11
27448,Dissident,stormrage,1016,paladin,holy,87,37,50
27449,Varenka,stormrage,1015,paladin,holy,83,36,47
27450,Iamholyman,dragonmaw,1014,paladin,holy,29,14,15
27451,Kithkannon,tichondrius,1007,paladin,holy,51,17,34
27452,Kbot,zuljin,1005,paladin,holy,15,11,4
27453,Tarnak,kelthuzad,1005,paladin,holy,33,11,22
27454,Adventholy,tichondrius,1004,paladin,holy,42,19,23
27455,Sutadansa,doomhammer,1001,paladin,holy,89,47,42
27456,Paulx,malganis,999,paladin,holy,87,46,41
27457,Gigadunker,tichondrius,999,paladin,holy,29,13,16
27458,Ðß,arthas,995,paladin,holy,30,15,15
27459,Westlysñipes,tichondrius,995,paladin,holy,92,44,48
27460,Hzo,tichondrius,989,paladin,holy,17,11,6
27461,Kaina,wildhammer,987,paladin,holy,53,22,31
27462,Colombía,illidan,986,paladin,holy,54,27,27
27463,Agravaine,moon-guard,986,paladin,holy,23,11,12
27464,Lawroadm,tichondrius,985,paladin,holy,18,12,6
27465,Gillgamesh,sentinels,978,paladin,holy,24,16,8
27466,Shanvo,tichondrius,977,paladin,holy,46,28,18
27467,Carneguisada,sargeras,975,paladin,holy,42,20,22
27468,Imajeala,thrall,973,paladin,holy,76,42,34
27469,Marcopolo,azralon,972,paladin,holy,29,11,18
27470,Huijji,illidan,967,paladin,holy,24,15,9
27471,Photons,emerald-dream,966,paladin,holy,24,13,11
27472,Romeoo,silver-hand,964,paladin,holy,66,26,40
27473,Hammerabi,moon-guard,963,paladin,holy,21,13,8
27474,Divinadin,stormrage,961,paladin,holy,94,51,43
27475,Thoryin,tichondrius,960,paladin,holy,12,10,2
27476,Síríús,malganis,960,paladin,holy,15,11,4
27477,Svitanie,bleeding-hollow,960,paladin,holy,80,38,42
27478,Biwi,zuljin,960,paladin,holy,97,35,62
27479,Arevia,stormrage,959,paladin,holy,18,10,8
27480,Kagranac,moon-guard,959,paladin,holy,24,10,14
27481,Zakh,proudmoore,959,paladin,holy,32,12,20
27482,Milkovir,quelthalas,959,paladin,holy,42,10,32
27483,Bubblet,bleeding-hollow,958,paladin,holy,18,10,8
27484,Vajuicy,dalaran,957,paladin,holy,24,10,14
27485,Lightswitchx,stormrage,957,paladin,holy,24,10,14
27486,Jdxqt,darkspear,957,paladin,holy,30,10,20
27487,Zayiro,eonar,957,paladin,holy,30,10,20
27488,Paluh,sargeras,956,paladin,holy,24,10,14
27489,Marklite,area-52,955,paladin,holy,24,10,14
27490,Tèhflip,tichondrius,954,paladin,holy,24,10,14
27491,Evanlina,bleeding-hollow,953,paladin,holy,18,10,8
27492,Avasti,proudmoore,953,paladin,holy,24,10,14
27493,Dragonchaos,ragnaros,953,paladin,holy,27,11,16
27494,Hruuhwa,wyrmrest-accord,952,paladin,holy,18,10,8
27495,Madnhairy,zuljin,952,paladin,holy,24,10,14
27496,Kusotarão,nemesis,952,paladin,holy,24,10,14
27497,Zafenate,nemesis,952,paladin,holy,24,10,14
27498,Aiyoku,illidan,951,paladin,holy,18,10,8
27499,Caike,frostmourne,950,paladin,holy,18,10,8
27500,Beefyjones,illidan,949,paladin,holy,18,10,8
27501,Heálbót,tichondrius,949,paladin,holy,20,10,10
27502,Palawun,nerzhul,949,paladin,holy,45,11,34
27503,Paladam,burning-blade,948,paladin,holy,24,10,14
27504,Holydood,thunderhorn,947,paladin,holy,18,10,8
27505,Hitsilent,warsong,947,paladin,holy,18,10,8
27506,Tolliver,area-52,944,paladin,holy,18,11,7
27507,Lazygamerr,sargeras,944,paladin,holy,18,10,8
27508,Snnow,stormrage,942,paladin,holy,36,21,15
27509,Lemuzinho,ragnaros,941,paladin,holy,24,10,14
27510,Sweettartts,zuljin,941,paladin,holy,36,10,26
27511,Joshington,stormrage,938,paladin,holy,29,10,19
27512,Doidyph,frostmourne,935,paladin,holy,24,10,14
27513,Pallyox,hellscream,933,paladin,holy,12,10,2
27514,Bubbleosevèn,frostmourne,932,paladin,holy,30,10,20
27515,Cooldbrew,frostmourne,932,paladin,holy,34,11,23
27516,Mikeawk,tichondrius,932,paladin,holy,36,10,26
27517,Gênji,eldrethalas,930,paladin,holy,54,20,34
27518,Ramzäbeoulve,tichondrius,930,paladin,holy,96,25,71
27519,Eradrae,mannoroth,929,paladin,holy,58,23,35
27520,Saìdelia,moon-guard,929,paladin,holy,71,24,47
27521,Finaldecis,zuljin,929,paladin,holy,42,10,32
27522,Ljusett,frostmourne,925,paladin,holy,97,43,54
27523,Hurkalzul,azralon,923,paladin,holy,24,10,14
27524,Swamprat,zuljin,922,paladin,holy,23,10,13
27525,Shâka,stormrage,921,paladin,holy,57,28,29
27526,Monad,nazjatar,921,paladin,holy,60,29,31
27527,Hentaiangel,kiljaeden,918,paladin,holy,39,19,20
27528,Lysetskriger,azralon,915,paladin,holy,24,12,12
27529,Ascension,amanthul,915,paladin,holy,144,57,87
27530,Iwaterboy,malganis,912,paladin,holy,24,14,10
27531,Ilse,deathwing,911,paladin,holy,27,10,17
27532,Va,onyxia,906,paladin,holy,150,75,75
27533,Scorcholdman,tichondrius,906,paladin,holy,35,10,25
27534,Grumpybubble,sargeras,905,paladin,holy,19,11,8
27535,Zhahira,hakkar,905,paladin,holy,24,10,14
27536,Thaedrun,hydraxis,896,paladin,holy,54,26,28
27537,Durendin,bonechewer,894,paladin,holy,14,10,4
27538,Fedpowell,tichondrius,894,paladin,holy,23,10,13
27539,Redentor,dalaran,892,paladin,holy,44,24,20
27540,Shananakin,azshara,892,paladin,holy,29,13,16
27541,Takodaddy,elune,889,paladin,holy,16,10,6
27542,Lennon,stormrage,888,paladin,holy,84,38,46
27543,Blackiron,frostmourne,883,paladin,holy,32,11,21
27544,Letsirk,doomhammer,880,paladin,holy,30,11,19
27545,Papakatsu,proudmoore,878,paladin,holy,48,22,26
27546,Trâshcårt,sargeras,864,paladin,holy,12,9,3
27547,Sovice,illidan,864,paladin,holy,12,9,3
27548,Athanaiëll,proudmoore,864,paladin,holy,22,11,11
27549,Rachaelucky,malganis,864,paladin,holy,18,9,9
27550,Deadry,ysera,864,paladin,holy,18,9,9
27551,Mâdâra,stormrage,864,paladin,holy,18,9,9
27552,Zilzag,moon-guard,864,paladin,holy,23,9,14
27553,Diamondwater,tichondrius,864,paladin,holy,24,9,15
27554,Racketyman,illidan,863,paladin,holy,12,9,3
27555,Auraingraham,stormscale,863,paladin,holy,18,9,9
27556,Cheers,garona,863,paladin,holy,18,9,9
27557,Lamas,kelthuzad,863,paladin,holy,18,9,9
27558,Paintthinner,frostmourne,863,paladin,holy,24,9,15
27559,Onlycams,sargeras,863,paladin,holy,24,9,15
27560,Flow,spinebreaker,863,paladin,holy,24,9,15
27561,Proxima,laughing-skull,863,paladin,holy,24,9,15
27562,Niense,wyrmrest-accord,862,paladin,holy,12,9,3
27563,Krackanut,kelthuzad,862,paladin,holy,18,9,9
27564,Msheen,azralon,861,paladin,holy,12,9,3
27565,Potatopasta,area-52,861,paladin,holy,12,9,3
27566,Gothsick,zuljin,857,paladin,holy,18,9,9
27567,Holyquadz,elune,857,paladin,holy,18,9,9
27568,Slippyp,darkspear,857,paladin,holy,18,9,9
27569,Spamsalot,malganis,857,paladin,holy,24,9,15
27570,Stricken,kul-tiras,857,paladin,holy,24,9,15
27571,Pathalerix,eonar,854,paladin,holy,18,9,9
27572,Løl,zuljin,854,paladin,holy,54,22,32
27573,Saxmurderz,tichondrius,853,paladin,holy,18,9,9
27574,Holyiseasy,alleria,853,paladin,holy,29,11,18
27575,Nedorshock,stormrage,853,paladin,holy,24,9,15
27576,Veronica,sentinels,852,paladin,holy,42,9,33
27577,Vëlar,tichondrius,851,paladin,holy,18,9,9
27578,Mytolo,malganis,851,paladin,holy,24,9,15
27579,Nualrossan,veknilash,848,paladin,holy,53,21,32
27580,Ðeathspire,tichondrius,846,paladin,holy,18,10,8
27581,Alydralmao,area-52,845,paladin,holy,24,9,15
27582,Maalik,thrall,844,paladin,holy,18,9,9
27583,Andormu,wyrmrest-accord,841,paladin,holy,24,9,15
27584,Allegiance,drenden,840,paladin,holy,17,10,7
27585,Jaok,tichondrius,831,paladin,holy,21,10,11
27586,Orleenz,zuljin,831,paladin,holy,35,15,20
27587,Supercutee,malganis,830,paladin,holy,22,9,13
27588,Bainn,nerzhul,822,paladin,holy,73,31,42
27589,Alltoohuman,nagrand,821,paladin,holy,23,9,14
27590,Palaknight,tichondrius,812,paladin,holy,60,21,39
27591,Êctheliøn,drakkari,807,paladin,holy,18,10,8
27592,Weenustickle,barthilas,807,paladin,holy,32,10,22
27593,Praisin,zuljin,805,paladin,holy,18,9,9
27594,Davinity,senjin,799,paladin,holy,23,9,14
27595,Snowdawg,blackhand,788,paladin,holy,30,10,20
27596,Cyandra,moon-guard,783,paladin,holy,13,9,4
27597,Holythunderx,tichondrius,782,paladin,holy,25,9,16
27598,Holyfrénzy,thrall,776,paladin,holy,25,9,16
27599,Alkyna,kelthuzad,768,paladin,holy,12,8,4
27600,Notalkyna,kelthuzad,768,paladin,holy,12,8,4
27601,Archerxx,ragnaros,768,paladin,holy,12,8,4
27602,Swellowsx,tichondrius,768,paladin,holy,12,8,4
27603,Siebens,illidan,768,paladin,holy,12,8,4
27604,Kritzyx,stormrage,768,paladin,holy,12,8,4
27605,Artús,ragnaros,768,paladin,holy,18,8,10
27606,Loganholy,tichondrius,768,paladin,holy,18,8,10
27607,Zero,anetheron,768,paladin,holy,18,8,10
27608,Saintus,proudmoore,768,paladin,holy,18,8,10
27609,Mattc,tichondrius,768,paladin,holy,24,8,16
27610,Rawpaladin,blackrock,768,paladin,holy,24,8,16
27611,Ahkairee,whisperwind,768,paladin,holy,24,8,16
27612,Voladis,malganis,768,paladin,holy,30,8,22
27613,Bestpally,alterac-mountains,767,paladin,holy,12,8,4
27614,Mhera,sargeras,767,paladin,holy,12,8,4
27615,Fupascoopa,illidan,767,paladin,holy,12,8,4
27616,Linaiah,moon-guard,767,paladin,holy,12,8,4
27617,Ezmødë,kelthuzad,767,paladin,holy,12,8,4
27618,Kriegstier,scarlet-crusade,767,paladin,holy,12,8,4
27619,Miniweiner,proudmoore,767,paladin,holy,18,8,10
27620,Kigz,illidan,767,paladin,holy,18,8,10
27621,Trancelancer,kelthuzad,767,paladin,holy,18,8,10
27622,Wonpai,barthilas,767,paladin,holy,18,8,10
27623,Lanzzelot,goldrinn,767,paladin,holy,18,8,10
27624,Bopsamdi,barthilas,767,paladin,holy,24,8,16
27625,Trevmagoosey,tichondrius,767,paladin,holy,24,8,16
27626,Wrekster,tichondrius,766,paladin,holy,18,8,10
27627,Wakethelight,illidan,766,paladin,holy,18,8,10
27628,Banga,farstriders,766,paladin,holy,18,8,10
27629,Holydeath,arthas,766,paladin,holy,24,8,16
27630,Agert,bloodhoof,766,paladin,holy,36,8,28
27631,Thonar,stormrage,765,paladin,holy,12,8,4
27632,Lightsòut,frostmourne,765,paladin,holy,24,8,16
27633,Revenere,tichondrius,765,paladin,holy,36,8,28
27634,Grumpy,the-forgotten-coast,764,paladin,holy,12,8,4
27635,Instaded,illidan,764,paladin,holy,18,8,10
27636,Guççi,thunderlord,764,paladin,holy,25,9,16
27637,Plsdontburst,tichondrius,763,paladin,holy,12,8,4
27638,Pambam,thrall,763,paladin,holy,18,9,9
27639,Jereth,kelthuzad,763,paladin,holy,18,8,10
27640,Etlas,windrunner,763,paladin,holy,18,8,10
27641,Porkwatchy,eonar,762,paladin,holy,24,8,16
27642,Gyle,stormrage,761,paladin,holy,18,8,10
27643,Sixthycent,kiljaeden,760,paladin,holy,18,8,10
27644,Mcpuffin,aggramar,760,paladin,holy,18,8,10
27645,Mixtapes,kargath,757,paladin,holy,12,8,4
27646,Blacktemplar,area-52,755,paladin,holy,18,8,10
27647,Crusæder,stormrage,753,paladin,holy,12,8,4
27648,Unsungherø,skywall,752,paladin,holy,12,8,4
27649,Jyin,emerald-dream,750,paladin,holy,24,8,16
27650,Willycrow,nordrassil,740,paladin,holy,18,8,10
27651,Mirotchburns,illidan,724,paladin,holy,16,9,7
27652,Ashera,amanthul,722,paladin,holy,26,9,17
27653,Mfn,tichondrius,714,paladin,holy,18,9,9
27654,Bigolbittiez,tichondrius,712,paladin,holy,22,9,13
27655,Sanastris,zuljin,693,paladin,holy,20,8,12
27656,Nea,argent-dawn,684,paladin,holy,95,32,63
27657,Visanth,bonechewer,677,paladin,holy,24,9,15
27658,Femsquatch,kelthuzad,672,paladin,holy,12,7,5
27659,Dgpaladin,tichondrius,672,paladin,holy,12,7,5
27660,Xiaoholy,barthilas,672,paladin,holy,12,7,5
27661,Busdid,sargeras,672,paladin,holy,12,7,5
27662,Loyantal,tichondrius,672,paladin,holy,12,7,5
27663,Jachunga,bleeding-hollow,672,paladin,holy,12,7,5
27664,Farvadin,illidan,672,paladin,holy,12,7,5
27665,Gimmethéloot,stormrage,672,paladin,holy,12,7,5
27666,Zpsychotycx,tichondrius,672,paladin,holy,12,7,5
27667,Imsuffering,zuljin,672,paladin,holy,12,7,5
27668,Crinject,sargeras,672,paladin,holy,12,7,5
27669,Oîn,area-52,672,paladin,holy,12,7,5
27670,Pkkcandy,archimonde,672,paladin,holy,12,7,5
27671,Canny,emerald-dream,672,paladin,holy,12,7,5
27672,Brogepi,cenarius,672,paladin,holy,12,7,5
27673,Mlpx,stormrage,672,paladin,holy,12,7,5
27674,Iamguess,stormscale,672,paladin,holy,18,7,11
27675,Orekilol,stormrage,672,paladin,holy,18,7,11
27676,Obllivionn,wildhammer,672,paladin,holy,18,7,11
27677,Oreki,area-52,672,paladin,holy,18,7,11
27678,Emmipal,tichondrius,672,paladin,holy,18,7,11
27679,Stompedlawl,illidan,672,paladin,holy,24,7,17
27680,Sensible,sargeras,672,paladin,holy,24,7,17
27681,Boraz,bleeding-hollow,672,paladin,holy,36,7,29
27682,Thin,ragnaros,671,paladin,holy,12,7,5
27683,Doktavius,lightbringer,671,paladin,holy,12,7,5
27684,Thrandeill,bleeding-hollow,671,paladin,holy,12,7,5
27685,Lördnextdoor,tichondrius,671,paladin,holy,12,7,5
27686,Billytwoshoe,laughing-skull,671,paladin,holy,12,7,5
27687,Cirillah,quelthalas,671,paladin,holy,12,7,5
27688,Scatterslol,korgath,671,paladin,holy,12,7,5
27689,Aràyleus,kelthuzad,671,paladin,holy,12,7,5
27690,Rahruan,wyrmrest-accord,671,paladin,holy,12,7,5
27691,Votasha,tichondrius,671,paladin,holy,18,7,11
27692,Milonus,frostmourne,671,paladin,holy,18,7,11
27693,Lemmiéwinkzz,sargeras,671,paladin,holy,18,7,11
27694,Loguto,stormrage,671,paladin,holy,18,7,11
27695,Animal,korialstrasz,671,paladin,holy,18,7,11
27696,Shoppee,jubeithos,671,paladin,holy,18,7,11
27697,Virkas,area-52,671,paladin,holy,18,7,11
27698,Sýteck,sargeras,671,paladin,holy,24,7,17
27699,Éætûgýäëí,area-52,671,paladin,holy,42,8,34
27700,Bolzar,zuljin,670,paladin,holy,12,7,5
27701,Korvén,area-52,670,paladin,holy,12,7,5
27702,Bjdreams,ragnaros,670,paladin,holy,12,7,5
27703,Extee,proudmoore,670,paladin,holy,12,7,5
27704,Kalthorne,wyrmrest-accord,670,paladin,holy,12,7,5
27705,Pradå,tichondrius,670,paladin,holy,12,7,5
27706,Ingrìd,ragnaros,670,paladin,holy,12,7,5
27707,Numenor,kiljaeden,670,paladin,holy,18,7,11
27708,Tropicorn,proudmoore,670,paladin,holy,18,7,11
27709,Rebelion,nagrand,670,paladin,holy,24,7,17
27710,Drgn,azgalor,670,paladin,holy,30,7,23
27711,Pluto,the-underbog,669,paladin,holy,12,7,5
27712,Balkin,kelthuzad,669,paladin,holy,12,7,5
27713,Stationarity,frostmourne,669,paladin,holy,18,7,11
27714,Solef,stormrage,669,paladin,holy,18,7,11
27715,Røusseff,azralon,669,paladin,holy,18,7,11
27716,Jiralla,ragnaros,669,paladin,holy,18,7,11
27717,Kimahri,anvilmar,669,paladin,holy,36,7,29
27718,Lovinglight,zuljin,668,paladin,holy,12,7,5
27719,Annii,aegwynn,666,paladin,holy,12,7,5
27720,Vanquishyr,stormrage,666,paladin,holy,30,7,23
27721,Geroden,tichondrius,665,paladin,holy,18,7,11
27722,Bangerzzx,sargeras,663,paladin,holy,18,7,11
27723,Chaós,queldorei,657,paladin,holy,18,7,11
27724,Gnomesexer,illidan,655,paladin,holy,17,7,10
27725,Ryuzu,arathor,640,paladin,holy,16,8,8
27726,Emojunz,ragnaros,638,paladin,holy,11,7,4
27727,Mycow,tichondrius,638,paladin,holy,17,7,10
27728,Mikiná,proudmoore,638,paladin,holy,22,7,15
27729,Koraesta,stormrage,632,paladin,holy,17,7,10
27730,Bullivan,sisters-of-elune,630,paladin,holy,23,7,16
27731,Luxsit,tichondrius,626,paladin,holy,30,9,21
27732,Mamothman,barthilas,622,paladin,holy,18,9,9
27733,Usebandage,sargeras,617,paladin,holy,16,9,7
27734,Hildibrandt,stormrage,606,paladin,holy,14,7,7
27735,Mojiberus,wyrmrest-accord,606,paladin,holy,14,7,7
27736,Turnevil,wyrmrest-accord,591,paladin,holy,19,7,12
27737,Wonpait,frostmourne,576,paladin,holy,9,7,2
27738,Fadiez,sargeras,576,paladin,holy,12,6,6
27739,Centimus,moon-guard,576,paladin,holy,12,6,6
27740,Holydubya,illidan,576,paladin,holy,12,6,6
27741,Ùthèr,tichondrius,576,paladin,holy,12,6,6
27742,Drossp,illidan,576,paladin,holy,12,6,6
27743,Tríno,malganis,576,paladin,holy,12,6,6
27744,Doradar,zuljin,576,paladin,holy,12,6,6
27745,Jurjen,quelthalas,576,paladin,holy,12,6,6
27746,Vamplyy,kelthuzad,576,paladin,holy,12,6,6
27747,Catharsis,tichondrius,576,paladin,holy,12,6,6
27748,Gbj,staghelm,576,paladin,holy,12,6,6
27749,Holymomia,blackrock,576,paladin,holy,12,6,6
27750,Irêsha,quelthalas,576,paladin,holy,12,6,6
27751,Squarehammer,blackrock,576,paladin,holy,12,6,6
27752,Neeks,zuljin,576,paladin,holy,12,6,6
27753,Tolentino,elune,576,paladin,holy,12,6,6
27754,Amadin,winterhoof,576,paladin,holy,12,6,6
27755,Dequincy,tichondrius,576,paladin,holy,12,6,6
27756,Faie,frostmourne,576,paladin,holy,12,6,6
27757,Jnzip,area-52,576,paladin,holy,15,7,8
27758,Ironjudge,hakkar,576,paladin,holy,17,6,11
27759,Imsoholy,tichondrius,576,paladin,holy,18,6,12
27760,Remibear,tichondrius,576,paladin,holy,18,6,12
27761,Marleigh,kelthuzad,576,paladin,holy,18,6,12
27762,Nikxx,tichondrius,576,paladin,holy,18,6,12
27763,Ghrumpy,thrall,576,paladin,holy,18,6,12
27764,Jiråchi,sargeras,576,paladin,holy,18,6,12
27765,Nelliellx,tichondrius,576,paladin,holy,18,6,12
27766,Okcheon,tichondrius,576,paladin,holy,18,6,12
27767,Lubed,aegwynn,576,paladin,holy,18,6,12
27768,Shocksta,dalaran,576,paladin,holy,18,6,12
27769,Kelosia,bonechewer,576,paladin,holy,18,6,12
27770,Marien,kelthuzad,576,paladin,holy,18,6,12
27771,Santiagolol,ragnaros,576,paladin,holy,24,6,18
27772,Acpally,tichondrius,576,paladin,holy,24,6,18
27773,Okx,illidan,575,paladin,holy,6,6,0
27774,Borntocoom,stormrage,575,paladin,holy,12,6,6
27775,Auralyon,tichondrius,575,paladin,holy,12,6,6
27776,Hammersdown,stormrage,575,paladin,holy,12,6,6
27777,Roachpally,area-52,575,paladin,holy,12,6,6
27778,Leatherfase,dalaran,575,paladin,holy,12,6,6
27779,Aldrukor,quelthalas,575,paladin,holy,12,6,6
27780,Bigpal,area-52,575,paladin,holy,12,6,6
27781,Emptyjump,eredar,575,paladin,holy,12,6,6
27782,Anderious,moon-guard,575,paladin,holy,12,6,6
27783,Septimia,illidan,575,paladin,holy,12,6,6
27784,Nøzawkalypse,kelthuzad,575,paladin,holy,12,6,6
27785,Luminouser,stormrage,575,paladin,holy,12,6,6
27786,Cassiel,barthilas,575,paladin,holy,12,6,6
27787,Docternoon,stormrage,575,paladin,holy,12,6,6
27788,Nochance,queldorei,575,paladin,holy,12,6,6
27789,Mendes,stormrage,575,paladin,holy,12,6,6
27790,Grombaby,lightnings-blade,575,paladin,holy,12,6,6
27791,Taiion,proudmoore,575,paladin,holy,18,6,12
27792,Clonazedin,ragnaros,575,paladin,holy,18,6,12
27793,Hojadin,area-52,575,paladin,holy,18,6,12
27794,Areura,hellscream,575,paladin,holy,18,6,12
27795,Asunä,bloodscalp,575,paladin,holy,18,6,12
27796,Theprimus,darkspear,574,paladin,holy,6,6,0
27797,Pizzaface,stormrage,574,paladin,holy,12,6,6
27798,Rhonielson,tichondrius,574,paladin,holy,12,6,6
27799,Litebright,bleeding-hollow,574,paladin,holy,12,6,6
27800,Kilion,illidan,574,paladin,holy,18,6,12
27801,Mileihot,quelthalas,574,paladin,holy,18,6,12
27802,Beefstewmre,dalaran,573,paladin,holy,18,6,12
27803,Iluvitar,kiljaeden,573,paladin,holy,18,6,12
27804,Metalpriest,shattered-halls,573,paladin,holy,24,6,18
27805,Nellie,deathwing,572,paladin,holy,12,6,6
27806,Holymomo,malganis,572,paladin,holy,12,6,6
27807,Tehgodofdmg,tichondrius,572,paladin,holy,18,6,12
27808,Ducii,stormrage,571,paladin,holy,18,6,12
27809,Fantasy,ragnaros,571,paladin,holy,24,6,18
27810,Cynotik,moon-guard,570,paladin,holy,12,6,6
27811,Maplleafs,kelthuzad,560,paladin,holy,24,6,18
27812,Fleshoflíght,azjolnerub,559,paladin,holy,17,6,11
27813,Glueconsumer,wyrmrest-accord,558,paladin,holy,12,7,5
27814,Fayernaa,proudmoore,557,paladin,holy,10,7,3
27815,Powtilted,thrall,543,paladin,holy,11,6,5
27816,Redpally,emerald-dream,543,paladin,holy,16,6,10
27817,Gabs,quelthalas,543,paladin,holy,16,6,10
27818,Antivaxer,frostmourne,543,paladin,holy,17,6,11
27819,Eboi,daggerspine,542,paladin,holy,26,7,19
27820,Louisvuttiøn,tichondrius,527,paladin,holy,11,6,5
27821,Leggomyagro,fenris,522,paladin,holy,26,7,19
27822,Tyygore,nagrand,521,paladin,holy,19,8,11
27823,Biggestkritz,frostmourne,511,paladin,holy,14,6,8
27824,Splyts,stormrage,490,paladin,holy,23,7,16
27825,Badboí,azralon,480,paladin,holy,6,5,1
27826,Josabbilra,tichondrius,480,paladin,holy,6,5,1
27827,Zenastra,moon-guard,480,paladin,holy,6,5,1
27828,Bigboiyahurd,sargeras,480,paladin,holy,6,5,1
27829,Mjölk,tichondrius,480,paladin,holy,6,5,1
27830,Darfnarvis,sargeras,480,paladin,holy,6,5,1
27831,Isecretly,stormrage,480,paladin,holy,6,5,1
27832,Dlt,frostmourne,480,paladin,holy,6,5,1
27833,Zanduncy,stormrage,480,paladin,holy,6,5,1
27834,Cotopax,sargeras,480,paladin,holy,15,7,8
27835,Keodis,suramar,480,paladin,holy,12,5,7
27836,Vicentê,ragnaros,480,paladin,holy,12,5,7
27837,Beila,illidan,480,paladin,holy,12,5,7
27838,Garethorne,illidan,480,paladin,holy,12,5,7
27839,Trycider,lightninghoof,480,paladin,holy,12,5,7
27840,Runterran,illidan,480,paladin,holy,12,5,7
27841,Mightypally,area-52,480,paladin,holy,12,5,7
27842,Subotai,frostmourne,480,paladin,holy,12,5,7
27843,Zhangliyi,tichondrius,480,paladin,holy,12,5,7
27844,Cleanprotein,tichondrius,480,paladin,holy,12,5,7
27845,Drunknbum,area-52,480,paladin,holy,12,5,7
27846,Fartburger,saurfang,480,paladin,holy,12,5,7
27847,Velline,tichondrius,480,paladin,holy,12,5,7
27848,Eneraxx,proudmoore,480,paladin,holy,12,5,7
27849,Gendevo,suramar,480,paladin,holy,12,5,7
27850,Gøldenlight,illidan,480,paladin,holy,12,5,7
27851,Timeparadox,illidan,480,paladin,holy,12,5,7
27852,Twoshockz,stormrage,480,paladin,holy,12,5,7
27853,Leddie,stormrage,480,paladin,holy,12,5,7
27854,Tryvor,stormrage,480,paladin,holy,12,5,7
27855,Inmortall,illidan,480,paladin,holy,12,5,7
27856,Mortolla,duskwood,480,paladin,holy,12,5,7
27857,Sixty,sargeras,480,paladin,holy,12,5,7
27858,Slexpala,tichondrius,480,paladin,holy,12,5,7
27859,Scubblez,zuljin,480,paladin,holy,12,5,7
27860,Jeryko,gundrak,480,paladin,holy,12,5,7
27861,Oxycleän,doomhammer,480,paladin,holy,12,5,7
27862,Bíteme,sargeras,480,paladin,holy,15,6,9
27863,Chimp,kiljaeden,480,paladin,holy,18,5,13
27864,Stahz,illidan,480,paladin,holy,18,5,13
27865,Chrisgrin,malganis,480,paladin,holy,18,5,13
27866,Ashenira,barthilas,480,paladin,holy,18,5,13
27867,Wêsleypipes,crushridge,480,paladin,holy,18,5,13
27868,Mootumba,boulderfist,480,paladin,holy,24,5,19
27869,Bubbleosèven,tichondrius,479,paladin,holy,6,5,1
27870,Mightythorxx,tichondrius,479,paladin,holy,12,5,7
27871,Bubbes,nerzhul,479,paladin,holy,12,5,7
27872,Lmy,stormrage,479,paladin,holy,12,5,7
27873,Ellisar,kiljaeden,479,paladin,holy,12,5,7
27874,Hulkamaniac,blackhand,479,paladin,holy,12,5,7
27875,Holyshasha,tichondrius,479,paladin,holy,12,5,7
27876,Joelsama,area-52,479,paladin,holy,12,5,7
27877,Pazztez,arthas,479,paladin,holy,12,5,7
27878,Nielec,arygos,479,paladin,holy,12,5,7
27879,Judgejitsu,black-dragonflight,479,paladin,holy,12,5,7
27880,Tankgreed,quelthalas,479,paladin,holy,12,5,7
27881,Loabandit,malorne,479,paladin,holy,12,5,7
27882,Goksuu,ragnaros,479,paladin,holy,12,5,7
27883,Lachaple,illidan,479,paladin,holy,12,5,7
27884,Healadelphia,illidan,479,paladin,holy,18,5,13
27885,Meistyr,thrall,479,paladin,holy,18,5,13
27886,Ozirus,frostmourne,478,paladin,holy,12,5,7
27887,Yobnai,zuljin,478,paladin,holy,12,5,7
27888,Mfpink,thrall,478,paladin,holy,12,5,7
27889,Boiducéu,azralon,478,paladin,holy,12,5,7
27890,Sihylde,quelthalas,478,paladin,holy,18,5,13
27891,Duecesz,area-52,478,paladin,holy,26,5,21
27892,Goingturbo,wyrmrest-accord,477,paladin,holy,12,5,7
27893,Sovereignt,aggramar,477,paladin,holy,12,5,7
27894,Thaeldan,archimonde,477,paladin,holy,18,5,13
27895,Stilreigning,darkspear,476,paladin,holy,12,5,7
27896,Crazykil,fenris,476,paladin,holy,12,5,7
27897,Miros,wyrmrest-accord,473,paladin,holy,12,5,7
27898,Callmeweazy,arathor,472,paladin,holy,18,5,13
27899,Granada,kirin-tor,470,paladin,holy,18,5,13
27900,Parts,aerie-peak,468,paladin,holy,30,5,25
27901,Toastedheals,stormreaver,463,paladin,holy,17,5,12
27902,Darkwingdad,illidan,452,paladin,holy,35,13,22
27903,Blancaflór,ragnaros,447,paladin,holy,11,5,6
27904,Blassphamy,chogall,447,paladin,holy,14,6,8
27905,Nabora,aggramar,446,paladin,holy,29,5,24
27906,Ziggerqt,stormrage,432,paladin,holy,15,5,10
27907,Kratheus,azralon,431,paladin,holy,11,5,6
27908,Belfordz,stormrage,430,paladin,holy,15,6,9
27909,Nivie,moon-guard,430,paladin,holy,15,5,10
27910,Rashell,garrosh,426,paladin,holy,16,7,9
27911,Mousesack,dragonmaw,426,paladin,holy,16,7,9
27912,Valhallaborn,illidan,426,paladin,holy,15,6,9
27913,Retribution,mannoroth,426,paladin,holy,23,6,17
27914,Ziti,bonechewer,415,paladin,holy,8,5,3
27915,Sushiopath,area-52,415,paladin,holy,14,5,9
27916,Dewagon,area-52,398,paladin,holy,25,5,20
27917,Vgeater,ysera,397,paladin,holy,13,5,8
27918,Synasthesia,zuljin,384,paladin,holy,6,4,2
27919,Oceania,grizzly-hills,384,paladin,holy,6,4,2
27920,Volphorix,illidan,384,paladin,holy,6,4,2
27921,Respect,black-dragonflight,384,paladin,holy,6,4,2
27922,Robötwizard,tichondrius,384,paladin,holy,6,4,2
27923,Anonymvs,eredar,384,paladin,holy,6,4,2
27924,Rc,tichondrius,384,paladin,holy,6,4,2
27925,Immensepower,tichondrius,384,paladin,holy,6,4,2
27926,Ceeten,tichondrius,384,paladin,holy,6,4,2
27927,Icac,stormrage,384,paladin,holy,6,4,2
27928,Aswaran,jaedenar,384,paladin,holy,6,4,2
27929,Eladore,hakkar,384,paladin,holy,6,4,2
27930,Arleos,mannoroth,384,paladin,holy,6,4,2
27931,Lightwerk,frostmourne,384,paladin,holy,6,4,2
27932,Decree,rexxar,384,paladin,holy,6,4,2
27933,Grfauxpal,sargeras,384,paladin,holy,6,4,2
27934,Ohthatguy,sargeras,384,paladin,holy,6,4,2
27935,Tontô,barthilas,384,paladin,holy,6,4,2
27936,Nickahunnid,sargeras,384,paladin,holy,6,4,2
27937,Ladanthal,barthilas,384,paladin,holy,6,4,2
27938,Nfl,moon-guard,384,paladin,holy,9,5,4
27939,Dragnix,dalaran,384,paladin,holy,11,4,7
27940,Penpal,sargeras,384,paladin,holy,12,4,8
27941,Cubic,wyrmrest-accord,384,paladin,holy,12,4,8
27942,Zamn,frostmourne,384,paladin,holy,12,4,8
27943,Nerfrets,stormrage,384,paladin,holy,12,4,8
27944,Demonsbane,frostmourne,384,paladin,holy,12,4,8
27945,Floweezy,thrall,384,paladin,holy,12,4,8
27946,Sentence,moon-guard,384,paladin,holy,12,4,8
27947,Maicolsalanu,quelthalas,384,paladin,holy,12,4,8
27948,Swolsus,illidan,384,paladin,holy,12,4,8
27949,Alicethemad,aerie-peak,384,paladin,holy,12,4,8
27950,Alkina,kelthuzad,384,paladin,holy,12,4,8
27951,Daflash,emerald-dream,384,paladin,holy,12,4,8
27952,Nikkixo,ysera,384,paladin,holy,12,4,8
27953,Egf,illidan,384,paladin,holy,12,4,8
27954,Tyryan,azralon,384,paladin,holy,12,4,8
27955,Ajlol,thrall,384,paladin,holy,12,4,8
27956,Zundralak,korgath,384,paladin,holy,12,4,8
27957,Gùmbý,illidan,384,paladin,holy,12,4,8
27958,Bigtimepali,tichondrius,384,paladin,holy,12,4,8
27959,Saintcassi,wyrmrest-accord,384,paladin,holy,12,4,8
27960,Gotredwings,proudmoore,384,paladin,holy,12,4,8
27961,Gâbríél,maiev,384,paladin,holy,12,4,8
27962,Lesauceboss,tichondrius,384,paladin,holy,12,4,8
27963,Bighardshock,aggramar,384,paladin,holy,12,4,8
27964,Eull,skullcrusher,384,paladin,holy,12,4,8
27965,Purdicks,emerald-dream,384,paladin,holy,12,4,8
27966,Qoop,tichondrius,384,paladin,holy,12,4,8
27967,Wangzu,wildhammer,384,paladin,holy,12,4,8
27968,Sacratess,area-52,384,paladin,holy,12,4,8
27969,Derbizzle,darkspear,384,paladin,holy,12,4,8
27970,Devsrdumb,bonechewer,384,paladin,holy,12,4,8
27971,Cadap,bleeding-hollow,384,paladin,holy,12,4,8
27972,Lánná,tichondrius,384,paladin,holy,12,4,8
27973,Palastik,malganis,384,paladin,holy,12,4,8
27974,Justarius,stormrage,384,paladin,holy,12,4,8
27975,Ardrider,emerald-dream,384,paladin,holy,18,4,14
27976,Mory,aegwynn,384,paladin,holy,18,4,14
27977,Bloodangelz,sargeras,384,paladin,holy,18,4,14
27978,Luminali,frostwolf,384,paladin,holy,18,4,14
27979,Beebopper,illidan,384,paladin,holy,18,4,14
27980,Riyu,blackrock,384,paladin,holy,18,4,14
27981,Kaminasol,quelthalas,384,paladin,holy,18,4,14
27982,Retholyprot,tichondrius,384,paladin,holy,18,4,14
27983,Cutebtw,zuljin,384,paladin,holy,18,4,14
27984,Hímüra,nemesis,384,paladin,holy,18,4,14
27985,Õblivion,jubeithos,384,paladin,holy,18,4,14
27986,Shockzer,bloodscalp,384,paladin,holy,23,4,19
27987,Scah,illidan,383,paladin,holy,6,4,2
27988,Namaru,hellscream,383,paladin,holy,12,4,8
27989,Lunchmoney,aggramar,383,paladin,holy,12,4,8
27990,Rënner,stormrage,383,paladin,holy,12,4,8
27991,Thulamon,zuljin,383,paladin,holy,12,4,8
27992,Vorex,ragnaros,383,paladin,holy,12,4,8
27993,Fivestarzx,malganis,383,paladin,holy,12,4,8
27994,Lightbeard,feathermoon,383,paladin,holy,12,4,8
27995,Tennesse,sargeras,383,paladin,holy,18,4,14
27996,Anjøs,azralon,383,paladin,holy,18,4,14
27997,Gokzurah,dragonmaw,383,paladin,holy,18,4,14
27998,Alyosya,barthilas,383,paladin,holy,24,4,20
27999,Outforblood,stormscale,382,paladin,holy,8,4,4
28000,Veliona,thaurissan,382,paladin,holy,12,4,8
28001,Sleepadin,shadowsong,382,paladin,holy,12,4,8
28002,Densom,aggramar,381,paladin,holy,12,4,8
28003,Rustacian,area-52,380,paladin,holy,12,4,8
28004,Gornack,draka,379,paladin,holy,12,4,8
28005,Gnomeslapper,frostmourne,351,paladin,holy,11,4,7
28006,Palewan,kiljaeden,351,paladin,holy,11,4,7
28007,Aärøn,stormrage,351,paladin,holy,11,4,7
28008,Cristineth,tanaris,351,paladin,holy,14,5,9
28009,Nvgesus,undermine,329,paladin,holy,16,5,11
28010,Sothalas,dalaran,328,paladin,holy,15,6,9
28011,Pakalun,area-52,319,paladin,holy,14,4,10
28012,Clearcoms,stormrage,304,paladin,holy,7,4,3
28013,Veeve,emerald-dream,304,paladin,holy,7,4,3
28014,Nulric,moon-guard,304,paladin,holy,13,4,9
28015,Nskkbr,frostmourne,304,paladin,holy,13,4,9
28016,Rett,chogall,288,paladin,holy,8,5,3
28017,Repgodx,illidan,288,paladin,holy,6,3,3
28018,Feelsögood,tichondrius,288,paladin,holy,6,3,3
28019,Hazkal,sargeras,288,paladin,holy,6,3,3
28020,Kshock,proudmoore,288,paladin,holy,6,3,3
28021,Kusunoki,kelthuzad,288,paladin,holy,6,3,3
28022,Datguysname,illidan,288,paladin,holy,6,3,3
28023,Holysheesh,cenarion-circle,288,paladin,holy,6,3,3
28024,Odinns,proudmoore,288,paladin,holy,6,3,3
28025,Yacè,moon-guard,288,paladin,holy,6,3,3
28026,Kharissia,proudmoore,288,paladin,holy,6,3,3
28027,Arena,mannoroth,288,paladin,holy,6,3,3
28028,Powerassasin,tichondrius,288,paladin,holy,6,3,3
28029,Demoniret,ragnaros,288,paladin,holy,6,3,3
28030,Lighteiron,moonrunner,288,paladin,holy,6,3,3
28031,Phut,stormrage,288,paladin,holy,6,3,3
28032,Laythoz,hyjal,288,paladin,holy,6,3,3
28033,Kaleroenin,cenarius,288,paladin,holy,6,3,3
28034,Dayatthespa,stormrage,288,paladin,holy,6,3,3
28035,Lànd,tichondrius,288,paladin,holy,6,3,3
28036,Breesh,nerzhul,288,paladin,holy,6,3,3
28037,Brightcore,stormrage,288,paladin,holy,6,3,3
28038,Krritter,illidan,288,paladin,holy,6,3,3
28039,Nipon,stormrage,288,paladin,holy,6,3,3
28040,Banpally,tichondrius,288,paladin,holy,6,3,3
28041,Psalms,lightnings-blade,288,paladin,holy,6,3,3
28042,Leronos,zuljin,288,paladin,holy,6,3,3
28043,Tpane,kelthuzad,288,paladin,holy,6,3,3
28044,Rheepent,hyjal,288,paladin,holy,6,3,3
28045,Miggsy,stormrage,288,paladin,holy,6,3,3
28046,Apally,drakthul,288,paladin,holy,6,3,3
28047,Wonpæi,frostmourne,288,paladin,holy,6,3,3
28048,Barquin,dalaran,288,paladin,holy,6,3,3
28049,Schwârts,blackrock,288,paladin,holy,6,3,3
28050,Antarcticala,frostmourne,288,paladin,holy,6,3,3
28051,Árrest,tichondrius,288,paladin,holy,6,3,3
28052,Kãrmä,area-52,288,paladin,holy,6,3,3
28053,Sigfriéd,tichondrius,288,paladin,holy,6,3,3
28054,Thyedron,azralon,288,paladin,holy,6,3,3
28055,Paen,area-52,288,paladin,holy,6,3,3
28056,Vanitasz,bleeding-hollow,288,paladin,holy,6,3,3
28057,Soapgirl,area-52,288,paladin,holy,6,3,3
28058,Grimmey,azjolnerub,288,paladin,holy,6,3,3
28059,Jackywacky,malganis,288,paladin,holy,6,3,3
28060,Alîcë,wyrmrest-accord,288,paladin,holy,6,3,3
28061,Aduhrawl,moon-guard,288,paladin,holy,6,3,3
28062,Stormvikingx,darkspear,288,paladin,holy,6,3,3
28063,Holzinger,quelthalas,288,paladin,holy,6,3,3
28064,Gompa,bleeding-hollow,288,paladin,holy,6,3,3
28065,Mindfoolness,sargeras,288,paladin,holy,6,3,3
28066,Gutzzx,frostmourne,288,paladin,holy,6,3,3
28067,Andronik,bleeding-hollow,288,paladin,holy,6,3,3
28068,Guidö,stormrage,288,paladin,holy,8,3,5
28069,Urudith,azralon,288,paladin,holy,11,3,8
28070,Mosso,bleeding-hollow,288,paladin,holy,12,3,9
28071,Ratface,dathremar,288,paladin,holy,12,3,9
28072,Ehbowlskesk,zuljin,288,paladin,holy,12,3,9
28073,Repths,illidan,288,paladin,holy,12,3,9
28074,Revoraal,frostmourne,288,paladin,holy,12,3,9
28075,Mevand,windrunner,288,paladin,holy,12,3,9
28076,Yanggongru,sargeras,288,paladin,holy,12,3,9
28077,Kommuna,stormscale,288,paladin,holy,12,3,9
28078,Drippinheals,eitrigg,288,paladin,holy,12,3,9
28079,Deckter,ragnaros,288,paladin,holy,12,3,9
28080,Imabigkidnow,emerald-dream,288,paladin,holy,12,3,9
28081,Teerblood,illidan,288,paladin,holy,12,3,9
28082,Sanctifyd,kiljaeden,288,paladin,holy,12,3,9
28083,Thichammer,frostmourne,288,paladin,holy,12,3,9
28084,Dráugus,azralon,288,paladin,holy,12,3,9
28085,Afkyouheal,suramar,288,paladin,holy,12,3,9
28086,Rudez,kiljaeden,288,paladin,holy,12,3,9
28087,Quits,tichondrius,288,paladin,holy,12,3,9
28088,Geðff,burning-legion,288,paladin,holy,12,3,9
28089,Tolipos,earthen-ring,288,paladin,holy,12,3,9
28090,Taethelan,malganis,288,paladin,holy,12,3,9
28091,Eijara,shattered-hand,288,paladin,holy,12,3,9
28092,Serca,khadgar,288,paladin,holy,12,3,9
28093,Haldry,wyrmrest-accord,288,paladin,holy,12,3,9
28094,Hemmyr,deathwing,288,paladin,holy,12,3,9
28095,Prâytorian,illidan,288,paladin,holy,12,3,9
28096,Dartherion,shandris,288,paladin,holy,12,3,9
28097,Ariste,emerald-dream,288,paladin,holy,12,3,9
28098,Beeodin,malganis,288,paladin,holy,12,3,9
28099,Buslightyear,azralon,288,paladin,holy,12,3,9
28100,Hugokpz,quelthalas,288,paladin,holy,18,3,15
28101,Bigboppapump,lightnings-blade,288,paladin,holy,18,3,15
28102,Tooholy,kiljaeden,288,paladin,holy,18,3,15
28103,Flarisic,kelthuzad,288,paladin,holy,18,3,15
28104,Mathalt,area-52,288,paladin,holy,18,3,15
28105,Alogagain,frostmourne,288,paladin,holy,18,3,15
28106,Capsiel,caelestrasz,288,paladin,holy,18,3,15
28107,Holyslapz,nazjatar,287,paladin,holy,6,3,3
28108,Avantasias,sargeras,287,paladin,holy,12,3,9
28109,Spacebacon,thunderlord,287,paladin,holy,12,3,9
28110,Fokatayew,korialstrasz,287,paladin,holy,12,3,9
28111,Giscicatrice,firetree,287,paladin,holy,12,3,9
28112,Rost,jaedenar,287,paladin,holy,24,3,21
28113,Moraxeus,gundrak,286,paladin,holy,6,3,3
28114,Hehealsyou,alleria,285,paladin,holy,12,3,9
28115,Schnabdain,exodar,285,paladin,holy,18,3,15
28116,Sellathice,khadgar,271,paladin,holy,11,3,8
28117,Malthisz,antonidas,265,paladin,holy,17,5,12
28118,Iradruidz,tichondrius,255,paladin,holy,11,3,8
28119,Holywoof,agamaggan,234,paladin,holy,11,5,6
28120,Itheternal,dalaran,234,paladin,holy,9,4,5
28121,Wëlch,nemesis,234,paladin,holy,16,4,12
28122,Inarit,thrall,232,paladin,holy,22,5,17
28123,Jaxal,nordrassil,208,paladin,holy,7,3,4
28124,Bigdmcgee,frostmourne,192,paladin,holy,6,2,4
28125,Patpatterson,mannoroth,192,paladin,holy,6,2,4
28126,Cheliere,kiljaeden,192,paladin,holy,6,2,4
28127,Svane,thunderlord,192,paladin,holy,6,2,4
28128,Gilazhar,eldrethalas,192,paladin,holy,6,2,4
28129,Razzypal,sargeras,192,paladin,holy,6,2,4
28130,Hitabull,hyjal,192,paladin,holy,6,2,4
28131,Flintstone,barthilas,192,paladin,holy,6,2,4
28132,Eckò,malganis,192,paladin,holy,6,2,4
28133,Technicolour,frostmourne,192,paladin,holy,6,2,4
28134,Veguê,ragnaros,192,paladin,holy,6,2,4
28135,Sainttom,sargeras,192,paladin,holy,6,2,4
28136,Ronnierawdog,frostmourne,192,paladin,holy,6,2,4
28137,Beaconlol,proudmoore,192,paladin,holy,6,2,4
28138,Kimbr,gallywix,192,paladin,holy,6,2,4
28139,Mangchì,tichondrius,192,paladin,holy,6,2,4
28140,Jabusty,kelthuzad,192,paladin,holy,6,2,4
28141,Tumatauenga,burning-blade,192,paladin,holy,6,2,4
28142,Pallydeen,illidan,192,paladin,holy,6,2,4
28143,Drii,moon-guard,192,paladin,holy,6,2,4
28144,Lazydin,tichondrius,192,paladin,holy,6,2,4
28145,Eicke,malganis,192,paladin,holy,6,2,4
28146,Misakiqs,sargeras,192,paladin,holy,6,2,4
28147,Antoniano,ragnaros,192,paladin,holy,6,2,4
28148,Smôres,sargeras,192,paladin,holy,6,2,4
28149,Pearlx,ragnaros,192,paladin,holy,6,2,4
28150,Nachius,ragnaros,192,paladin,holy,6,2,4
28151,Flexxborn,thrall,192,paladin,holy,6,2,4
28152,Ironmanfrank,tichondrius,192,paladin,holy,6,2,4
28153,Borngood,tichondrius,192,paladin,holy,6,2,4
28154,Romaztlan,area-52,192,paladin,holy,6,2,4
28155,Toonchies,barthilas,192,paladin,holy,6,2,4
28156,Healheal,tichondrius,192,paladin,holy,6,2,4
28157,Healnsqueal,stormrage,192,paladin,holy,6,2,4
28158,Chinaballoon,moonrunner,192,paladin,holy,6,2,4
28159,Pgpal,kelthuzad,192,paladin,holy,6,2,4
28160,Mordirhar,tichondrius,192,paladin,holy,6,2,4
28161,Raywhite,kelthuzad,192,paladin,holy,6,2,4
28162,Lóli,azralon,192,paladin,holy,6,2,4
28163,Stormwinter,azralon,192,paladin,holy,6,2,4
28164,Elchupalibre,tichondrius,192,paladin,holy,6,2,4
28165,Turnipfãrmer,tichondrius,192,paladin,holy,6,2,4
28166,Akj,tichondrius,192,paladin,holy,6,2,4
28167,Xtabelcnu,illidan,192,paladin,holy,6,2,4
28168,Bakapal,tichondrius,192,paladin,holy,6,2,4
28169,Iolwhat,sargeras,192,paladin,holy,6,2,4
28170,Breach,blades-edge,192,paladin,holy,6,2,4
28171,Trâgedy,azjolnerub,192,paladin,holy,6,2,4
28172,Goldirock,quelthalas,192,paladin,holy,6,2,4
28173,Câno,quelthalas,192,paladin,holy,6,2,4
28174,Xinane,dalaran,192,paladin,holy,6,2,4
28175,Raiel,aegwynn,192,paladin,holy,6,2,4
28176,Wâr,aegwynn,192,paladin,holy,6,2,4
28177,Bravomedic,emerald-dream,192,paladin,holy,6,2,4
28178,Jastella,illidan,192,paladin,holy,6,2,4
28179,Goldieg,tichondrius,192,paladin,holy,6,2,4
28180,Cathandrix,malganis,192,paladin,holy,6,2,4
28181,Illbubble,duskwood,192,paladin,holy,7,2,5
28182,Naxzero,shadowsong,192,paladin,holy,8,2,6
28183,Minzyy,frostmourne,192,paladin,holy,12,2,10
28184,Gavril,kirin-tor,192,paladin,holy,12,2,10
28185,Märdrius,tichondrius,192,paladin,holy,12,2,10
28186,Trojani,malganis,192,paladin,holy,12,2,10
28187,Carmiínha,azralon,192,paladin,holy,12,2,10
28188,Murkpal,frostmourne,192,paladin,holy,12,2,10
28189,Vaylindor,area-52,192,paladin,holy,12,2,10
28190,Cehart,windrunner,192,paladin,holy,12,2,10
28191,Hxnny,kiljaeden,192,paladin,holy,12,2,10
28192,Willywønka,azgalor,192,paladin,holy,12,2,10
28193,Bohoqt,tichondrius,192,paladin,holy,12,2,10
28194,Giuseppepee,malganis,192,paladin,holy,12,2,10
28195,Piupiubiu,stormrage,192,paladin,holy,12,2,10
28196,Streetacus,stormrage,192,paladin,holy,12,2,10
28197,Einheilagr,stormrage,192,paladin,holy,12,2,10
28198,Spoons,malganis,192,paladin,holy,12,2,10
28199,Dwemeor,azuremyst,192,paladin,holy,12,2,10
28200,Bighausse,thrall,192,paladin,holy,12,2,10
28201,Shoresy,terokkar,192,paladin,holy,18,2,16
28202,Levarious,thunderlord,192,paladin,holy,18,2,16
28203,Krypton,tichondrius,192,paladin,holy,18,2,16
28204,Ronatiú,tichondrius,192,paladin,holy,18,2,16
28205,Waifupaladin,azralon,192,paladin,holy,18,2,16
28206,Cedinea,wyrmrest-accord,191,paladin,holy,6,2,4
28207,Prh,frostmourne,191,paladin,holy,6,2,4
28208,Holygota,nemesis,191,paladin,holy,6,2,4
28209,Mose,scilla,191,paladin,holy,6,2,4
28210,Arobelse,sargeras,191,paladin,holy,12,2,10
28211,Myû,korgath,160,paladin,holy,10,3,7
28212,Itsoverninek,emerald-dream,159,paladin,holy,17,2,15
28213,Hearthledger,ragnaros,144,paladin,holy,3,3,0
28214,Elrecka,stormrage,144,paladin,holy,9,2,7
28215,Whitedozer,darkspear,138,paladin,holy,10,4,6
28216,Zela,ghostlands,137,paladin,holy,21,3,18
28217,Guelmin,azralon,112,paladin,holy,7,2,5
28218,Kamí,elune,96,paladin,holy,6,1,5
28219,Evilpallie,illidan,96,paladin,holy,6,1,5
28220,Cathraga,moknathal,96,paladin,holy,6,1,5
28221,Syrenadrel,hydraxis,96,paladin,holy,6,1,5
28222,Criaharn,turalyon,96,paladin,holy,6,1,5
28223,Netéro,skywall,96,paladin,holy,6,1,5
28224,Deadlyassian,ysera,96,paladin,holy,6,1,5
28225,Chucknoreis,azralon,96,paladin,holy,6,1,5
28226,Kurook,moon-guard,96,paladin,holy,6,1,5
28227,Retattack,area-52,96,paladin,holy,6,1,5
28228,Sevina,twisting-nether,96,paladin,holy,6,1,5
28229,Luxs,tichondrius,96,paladin,holy,6,1,5
28230,Daz,spinebreaker,96,paladin,holy,6,1,5
28231,Wings,arygos,96,paladin,holy,6,1,5
28232,Combidin,garrosh,96,paladin,holy,6,1,5
28233,Romeh,malganis,96,paladin,holy,6,1,5
28234,Ploppers,sargeras,96,paladin,holy,6,1,5
28235,Silreck,ragnaros,96,paladin,holy,6,1,5
28236,Zwilliam,frostmourne,96,paladin,holy,6,1,5
28237,Couchz,area-52,96,paladin,holy,6,1,5
28238,Parzsival,blood-furnace,96,paladin,holy,6,1,5
28239,Shartea,moon-guard,96,paladin,holy,6,1,5
28240,Yikyok,stormrage,96,paladin,holy,6,1,5
28241,Elronda,malganis,96,paladin,holy,6,1,5
28242,Phpremium,dalaran,96,paladin,holy,6,1,5
28243,Oofky,ragnaros,96,paladin,holy,6,1,5
28244,Traditionalp,area-52,96,paladin,holy,6,1,5
28245,Tetulia,quelthalas,96,paladin,holy,6,1,5
28246,Palabora,kelthuzad,96,paladin,holy,6,1,5
28247,Jeffylolmar,sargeras,96,paladin,holy,6,1,5
28248,Boppal,tichondrius,96,paladin,holy,6,1,5
28249,Khaosactual,proudmoore,96,paladin,holy,6,1,5
28250,Chakris,wyrmrest-accord,96,paladin,holy,6,1,5
28251,Arturias,kiljaeden,96,paladin,holy,6,1,5
28252,Antigone,tichondrius,96,paladin,holy,6,1,5
28253,ßls,illidan,96,paladin,holy,6,1,5
28254,Razuel,frostmourne,96,paladin,holy,6,1,5
28255,Oncehumanoid,stormrage,96,paladin,holy,6,1,5
28256,Therëv,zuljin,96,paladin,holy,6,1,5
28257,Lgbtq,trollbane,96,paladin,holy,6,1,5
28258,Komugì,thrall,96,paladin,holy,6,1,5
28259,Crosjudge,zuljin,96,paladin,holy,6,1,5
28260,Cremefraichè,tichondrius,96,paladin,holy,6,1,5
28261,Zoneyy,proudmoore,96,paladin,holy,6,1,5
28262,Vîxey,ragnaros,96,paladin,holy,6,1,5
28263,Kaynè,senjin,96,paladin,holy,6,1,5
28264,Burgasari,tichondrius,96,paladin,holy,6,1,5
28265,Greddlok,rivendare,96,paladin,holy,6,1,5
28266,Hibunny,thaurissan,96,paladin,holy,6,1,5
28267,Owllii,frostwolf,96,paladin,holy,6,1,5
28268,Tradorel,illidan,96,paladin,holy,6,1,5
28269,Keltheas,rivendare,96,paladin,holy,6,1,5
28270,Tfcpaladin,the-forgotten-coast,96,paladin,holy,6,1,5
28271,Trixzthot,barthilas,96,paladin,holy,6,1,5
28272,Bayraa,tichondrius,96,paladin,holy,6,1,5
28273,Rhinno,lothar,96,paladin,holy,6,1,5
28274,Tarpeeksi,tichondrius,96,paladin,holy,6,1,5
28275,Sherrill,nagrand,96,paladin,holy,6,1,5
28276,Victores,illidan,96,paladin,holy,6,1,5
28277,Ripadin,dunemaul,96,paladin,holy,11,1,10
28278,Grîshnâkh,ragnaros,96,paladin,holy,11,1,10
28279,Rockysh,tichondrius,96,paladin,holy,12,1,11
28280,Dapallytroll,area-52,96,paladin,holy,12,1,11
28281,Ordained,moonrunner,96,paladin,holy,12,1,11
28282,Midnightboto,dragonmaw,96,paladin,holy,12,1,11
28283,Nickpala,bleeding-hollow,96,paladin,holy,12,1,11
28284,Zentrick,whisperwind,96,paladin,holy,12,1,11
28285,Jwilks,black-dragonflight,96,paladin,holy,12,1,11
28286,Jumahji,illidan,96,paladin,holy,12,1,11
28287,Pedin,stormrage,96,paladin,holy,12,1,11
28288,Lafawndah,blackhand,96,paladin,holy,12,1,11
28289,Soloist,tichondrius,96,paladin,holy,12,1,11
28290,Yccorz,frostmourne,96,paladin,holy,12,1,11
28291,Vexe,emerald-dream,96,paladin,holy,12,1,11
28292,Aenwyl,quelthalas,96,paladin,holy,24,1,23
28293,Arlé,stormrage,95,paladin,holy,6,1,5
28294,Ååron,thrall,89,paladin,holy,11,3,8
28295,Emilywilis,sargeras,84,paladin,holy,17,5,12
28296,Zaeris,proudmoore,79,paladin,holy,5,1,4
28297,Athenia,moon-guard,63,paladin,holy,6,3,3
28298,Paladinkofwa,tichondrius,48,paladin,holy,3,1,2
28299,Jkethuhsnake,ghostlands,48,paladin,holy,21,1,20
28300,Burgermeat,bleeding-hollow,42,paladin,holy,9,2,7
28301,Alpinestârs,tichondrius,42,paladin,holy,9,2,7
28302,Justinbebr,tichondrius,42,paladin,holy,14,3,11
28303,Kziwei,stormrage,31,paladin,holy,2,1,1
28304,Shkafell,ragnaros,9,paladin,holy,8,2,6
28305,Oghal,frostmourne,9,paladin,holy,23,3,20
28306,Vânguards,tichondrius,2250,paladin,retribution,111,62,49
28307,Vanguards,tichondrius,2192,paladin,retribution,78,43,35
28308,Imitlol,alexstrasza,2154,paladin,retribution,181,91,90
28309,Zozo,zuljin,2152,paladin,retribution,95,50,45
28310,Venguards,azralon,2151,paladin,retribution,127,68,59
28311,Hamburgeryu,tichondrius,2119,paladin,retribution,100,49,51
28312,Thørmento,azralon,2118,paladin,retribution,201,107,94
28313,Notvelic,tichondrius,2111,paladin,retribution,146,74,72
28314,Condiments,earthen-ring,2110,paladin,retribution,144,77,67
28315,Coolvelic,tichondrius,2110,paladin,retribution,156,79,77
28316,Angryvelic,tichondrius,2107,paladin,retribution,105,52,53
28317,Evanguards,tichondrius,2105,paladin,retribution,202,102,100
28318,Picachü,ragnaros,2104,paladin,retribution,125,63,62
28319,Yuji,darkspear,2102,paladin,retribution,108,54,54
28320,Shôtgun,tichondrius,2101,paladin,retribution,138,69,69
28321,Tramatic,sargeras,2100,paladin,retribution,126,63,63
28322,Xalarius,illidan,2096,paladin,retribution,65,33,32
28323,Lanteranth,drenden,2096,paladin,retribution,204,102,102
28324,Hollyflame,tichondrius,2077,paladin,retribution,191,97,94
28325,Lvladen,sargeras,2065,paladin,retribution,84,41,43
28326,Quitzz,tichondrius,2050,paladin,retribution,117,58,59
28327,Dayuanzhong,tichondrius,2044,paladin,retribution,105,52,53
28328,Bullmarket,tichondrius,2035,paladin,retribution,215,105,110
28329,Thulêan,moon-guard,2035,paladin,retribution,215,105,110
28330,Xexe,stormreaver,2030,paladin,retribution,150,74,76
28331,Xiaoqingye,tichondrius,2026,paladin,retribution,113,59,54
28332,Caperx,tichondrius,2026,paladin,retribution,66,31,35
28333,Wasteddwolf,tichondrius,2025,paladin,retribution,177,90,87
28334,Alicê,moon-guard,2018,paladin,retribution,84,41,43
28335,Bartharious,malganis,2017,paladin,retribution,108,53,55
28336,Slíckhuman,spinebreaker,2014,paladin,retribution,108,64,44
28337,Iqt,moon-guard,2011,paladin,retribution,132,66,66
28338,Furylolz,tichondrius,2009,paladin,retribution,70,35,35
28339,Maledraenei,sargeras,2004,paladin,retribution,119,58,61
28340,Mashbringer,moon-guard,2001,paladin,retribution,78,42,36
28341,Mcconnell,sargeras,1988,paladin,retribution,66,40,26
28342,Aldda,azralon,1988,paladin,retribution,134,63,71
28343,Dreamcastx,tichondrius,1985,paladin,retribution,161,79,82
28344,Genericuser,sargeras,1984,paladin,retribution,82,44,38
28345,Ohuo,tichondrius,1983,paladin,retribution,328,175,153
28346,Ryuseiblade,ragnaros,1983,paladin,retribution,120,56,64
28347,Simplybést,zuljin,1981,paladin,retribution,180,88,92
28348,Swurvezx,bleeding-hollow,1976,paladin,retribution,59,37,22
28349,Ashenhallow,alexstrasza,1973,paladin,retribution,42,27,15
28350,Møemøeda,illidan,1973,paladin,retribution,60,28,32
28351,Bigdickrick,ragnaros,1972,paladin,retribution,54,32,22
28352,Ämoureux,bleeding-hollow,1970,paladin,retribution,141,67,74
28353,Theblèss,tichondrius,1969,paladin,retribution,127,59,68
28354,Yccorz,frostmourne,1968,paladin,retribution,230,118,112
28355,Conndiment,earthen-ring,1968,paladin,retribution,90,45,45
28356,Holychris,shadowmoon,1968,paladin,retribution,144,67,77
28357,Smortain,tichondrius,1966,paladin,retribution,95,44,51
28358,Caveyodeler,zuluhed,1962,paladin,retribution,66,31,35
28359,Kubota,sargeras,1958,paladin,retribution,60,36,24
28360,Dreamcastz,tichondrius,1957,paladin,retribution,48,33,15
28361,Kurôsh,kalecgos,1955,paladin,retribution,96,52,44
28362,Draenkz,quelthalas,1954,paladin,retribution,57,37,20
28363,Damionblade,proudmoore,1953,paladin,retribution,265,141,124
28364,Ðori,tichondrius,1952,paladin,retribution,82,38,44
28365,Kraggar,arthas,1951,paladin,retribution,66,41,25
28366,Lazypally,frostmourne,1951,paladin,retribution,66,35,31
28367,Scathol,tichondrius,1950,paladin,retribution,78,38,40
28368,Enjoy,frostmourne,1947,paladin,retribution,60,34,26
28369,Xuantianchai,tichondrius,1944,paladin,retribution,60,36,24
28370,Bøgård,sargeras,1941,paladin,retribution,299,151,148
28371,Dratzq,ragnaros,1938,paladin,retribution,90,49,41
28372,Daxxj,akama,1937,paladin,retribution,164,77,87
28373,Mikeqiaodan,tichondrius,1936,paladin,retribution,150,75,75
28374,Nbtv,tichondrius,1931,paladin,retribution,78,36,42
28375,Indivisionxp,tichondrius,1928,paladin,retribution,55,34,21
28376,Omnnii,tichondrius,1928,paladin,retribution,71,38,33
28377,Fossilz,sargeras,1927,paladin,retribution,59,31,28
28378,Xxwitcherxx,stormrage,1926,paladin,retribution,129,70,59
28379,Mwqyyds,tichondrius,1915,paladin,retribution,148,71,77
28380,Xuanxingchai,tichondrius,1915,paladin,retribution,83,35,48
28381,Monkeypala,dathremar,1911,paladin,retribution,54,30,24
28382,Metallíka,nemesis,1910,paladin,retribution,77,36,41
28383,Memorisë,ragnaros,1907,paladin,retribution,283,146,137
28384,Ozzium,ragnaros,1907,paladin,retribution,161,80,81
28385,Hammrekt,illidan,1905,paladin,retribution,48,25,23
28386,Furgalicious,area-52,1904,paladin,retribution,125,60,65
28387,Bestowed,moon-guard,1903,paladin,retribution,93,46,47
28388,Valytonz,wyrmrest-accord,1901,paladin,retribution,78,38,40
28389,Angelguards,tichondrius,1900,paladin,retribution,60,30,30
28390,Clapstick,illidan,1900,paladin,retribution,72,33,39
28391,Zanthus,shadow-council,1896,paladin,retribution,35,20,15
28392,Dadadalala,tichondrius,1895,paladin,retribution,36,20,16
28393,Danceholy,tichondrius,1894,paladin,retribution,81,39,42
28394,Cønk,khadgar,1892,paladin,retribution,170,100,70
28395,Kamadonezuko,illidan,1892,paladin,retribution,89,44,45
28396,Asukaba,sargeras,1892,paladin,retribution,80,37,43
28397,Bluerunebar,illidan,1890,paladin,retribution,60,33,27
28398,Peledin,azralon,1890,paladin,retribution,95,48,47
28399,Attkdmgcurry,illidan,1890,paladin,retribution,71,34,37
28400,Dtaitou,tichondrius,1889,paladin,retribution,60,28,32
28401,Dankrachet,thrall,1888,paladin,retribution,72,35,37
28402,Vendatha,darkspear,1887,paladin,retribution,30,25,5
28403,Hellsingwolf,zuljin,1885,paladin,retribution,30,20,10
28404,Pécorino,malganis,1884,paladin,retribution,52,31,21
28405,Palypants,proudmoore,1881,paladin,retribution,43,21,22
28406,Iäl,tichondrius,1881,paladin,retribution,71,31,40
28407,Alpinestârs,tichondrius,1880,paladin,retribution,158,75,83
28408,Zeldoul,magtheridon,1879,paladin,retribution,71,36,35
28409,Homelanderp,tichondrius,1879,paladin,retribution,81,41,40
28410,Ðiviñe,zuluhed,1878,paladin,retribution,160,86,74
28411,Savøx,sargeras,1875,paladin,retribution,177,100,77
28412,Roushex,sargeras,1875,paladin,retribution,72,35,37
28413,Matthrian,moon-guard,1875,paladin,retribution,90,38,52
28414,Voidaz,stormscale,1873,paladin,retribution,60,31,29
28415,Attkdamdam,illidan,1871,paladin,retribution,54,26,28
28416,Beautiful,proudmoore,1870,paladin,retribution,135,72,63
28417,Fairgame,dathremar,1869,paladin,retribution,60,28,32
28418,Koyoikonan,tichondrius,1867,paladin,retribution,42,28,14
28419,Alexjones,stormrage,1866,paladin,retribution,78,43,35
28420,Bohring,bleeding-hollow,1865,paladin,retribution,54,29,25
28421,Parlore,moon-guard,1865,paladin,retribution,168,89,79
28422,Xilio,tichondrius,1865,paladin,retribution,72,36,36
28423,Pallehx,tichondrius,1862,paladin,retribution,71,33,38
28424,Juffury,illidan,1861,paladin,retribution,66,32,34
28425,Getmeabag,tichondrius,1861,paladin,retribution,54,25,29
28426,Slaneesh,ragnaros,1861,paladin,retribution,72,30,42
28427,Sweetfish,kiljaeden,1860,paladin,retribution,65,36,29
28428,Talymra,ragnaros,1860,paladin,retribution,72,38,34
28429,Víkk,zuljin,1860,paladin,retribution,182,94,88
28430,Galeatus,tichondrius,1860,paladin,retribution,73,30,43
28431,Teniale,moon-guard,1859,paladin,retribution,54,28,26
28432,Chuoo,proudmoore,1859,paladin,retribution,46,22,24
28433,Therëv,zuljin,1857,paladin,retribution,101,50,51
28434,Ksvoten,azralon,1856,paladin,retribution,53,31,22
28435,Dréveleth,quelthalas,1856,paladin,retribution,143,67,76
28436,Saakero,illidan,1855,paladin,retribution,60,32,28
28437,Retroreq,tichondrius,1854,paladin,retribution,166,88,78
28438,Alecx,tichondrius,1853,paladin,retribution,58,33,25
28439,Marthellus,quelthalas,1853,paladin,retribution,79,38,41
28440,Subtilizer,tichondrius,1851,paladin,retribution,48,32,16
28441,Foofs,shadowmoon,1851,paladin,retribution,53,26,27
28442,Gelosagrado,illidan,1850,paladin,retribution,165,75,90
28443,Solanin,frostmourne,1849,paladin,retribution,35,20,15
28444,Burnning,tichondrius,1849,paladin,retribution,57,30,27
28445,Hurv,area-52,1848,paladin,retribution,53,30,23
28446,Moocowd,senjin,1847,paladin,retribution,66,35,31
28447,Miktley,area-52,1847,paladin,retribution,66,32,34
28448,Iloveqiqi,sargeras,1846,paladin,retribution,54,26,28
28449,Retxsilver,thrall,1845,paladin,retribution,136,69,67
28450,Sacredknight,kelthuzad,1845,paladin,retribution,48,23,25
28451,Mixz,bleeding-hollow,1843,paladin,retribution,60,36,24
28452,Nishru,sargeras,1843,paladin,retribution,60,32,28
28453,Auxilio,arathor,1843,paladin,retribution,60,29,31
28454,Divinehammer,proudmoore,1843,paladin,retribution,66,31,35
28455,Lejeñd,stormrage,1842,paladin,retribution,65,34,31
28456,Mikhàël,stormscale,1840,paladin,retribution,52,37,15
28457,Truthkeeper,moon-guard,1840,paladin,retribution,47,23,24
28458,Luosiding,tichondrius,1840,paladin,retribution,155,68,87
28459,Chuckvandam,illidan,1839,paladin,retribution,54,36,18
28460,Popje,zuljin,1839,paladin,retribution,36,20,16
28461,Grifnballs,agamaggan,1839,paladin,retribution,56,31,25
28462,Roguesmoker,zuljin,1839,paladin,retribution,59,31,28
28463,Sukilol,tichondrius,1839,paladin,retribution,114,58,56
28464,Immobilized,frostmourne,1839,paladin,retribution,58,29,29
28465,Mvpj,medivh,1839,paladin,retribution,48,23,25
28466,Ilaaria,moon-guard,1838,paladin,retribution,66,44,22
28467,Zanur,tichondrius,1837,paladin,retribution,160,80,80
28468,Kushsessions,zuljin,1837,paladin,retribution,42,20,22
28469,Alodorx,tichondrius,1836,paladin,retribution,36,23,13
28470,Vip,frostmourne,1836,paladin,retribution,108,55,53
28471,Paladincane,sargeras,1835,paladin,retribution,185,99,86
28472,Avenging,wyrmrest-accord,1835,paladin,retribution,62,32,30
28473,Kangsang,illidan,1835,paladin,retribution,70,33,37
28474,Lolcraftv,tichondrius,1834,paladin,retribution,60,30,30
28475,Dkdldkdld,tichondrius,1833,paladin,retribution,36,27,9
28476,Lilglick,illidan,1833,paladin,retribution,36,21,15
28477,Holyfused,illidan,1833,paladin,retribution,53,28,25
28478,Masqadin,tichondrius,1832,paladin,retribution,36,26,10
28479,Shiryn,illidan,1832,paladin,retribution,62,33,29
28480,Leonilx,tichondrius,1832,paladin,retribution,48,21,27
28481,Kaitúr,stormrage,1831,paladin,retribution,56,29,27
28482,ßò,area-52,1830,paladin,retribution,46,31,15
28483,Hge,proudmoore,1830,paladin,retribution,53,32,21
28484,Awbie,moon-guard,1830,paladin,retribution,60,30,30
28485,Dubliner,garona,1830,paladin,retribution,47,23,24
28486,Eldenblade,moon-guard,1829,paladin,retribution,54,31,23
28487,Honeydutchtv,black-dragonflight,1829,paladin,retribution,174,79,95
28488,Hammrekt,kelthuzad,1829,paladin,retribution,47,20,27
28489,Chainsapally,stormrage,1828,paladin,retribution,54,38,16
28490,Palabora,kelthuzad,1828,paladin,retribution,53,28,25
28491,Bornterrible,queldorei,1828,paladin,retribution,54,25,29
28492,Idenline,moon-guard,1827,paladin,retribution,59,30,29
28493,Blake,frostmourne,1827,paladin,retribution,53,24,29
28494,Wolfs,firetree,1826,paladin,retribution,66,29,37
28495,Alxndrr,area-52,1825,paladin,retribution,108,58,50
28496,Apollidin,malganis,1825,paladin,retribution,111,50,61
28497,Lyrz,sargeras,1824,paladin,retribution,115,69,46
28498,Monchmon,tichondrius,1824,paladin,retribution,47,24,23
28499,Praysnblaze,zuljin,1824,paladin,retribution,55,28,27
28500,Zèrà,thunderhorn,1823,paladin,retribution,54,26,28
28501,Pantufä,stormrage,1822,paladin,retribution,53,29,24
28502,Jonathein,barthilas,1822,paladin,retribution,138,72,66
28503,Saradomin,kelthuzad,1822,paladin,retribution,129,66,63
28504,Cryof,illidan,1822,paladin,retribution,72,28,44
28505,Saakadin,illidan,1821,paladin,retribution,48,29,19
28506,Jereth,kelthuzad,1821,paladin,retribution,77,46,31
28507,Olixx,blackrock,1821,paladin,retribution,54,30,24
28508,Promethèus,jubeithos,1821,paladin,retribution,66,34,32
28509,Kíngkáísér,azralon,1820,paladin,retribution,29,20,9
28510,Malakor,thrall,1820,paladin,retribution,150,79,71
28511,Fuchí,tichondrius,1820,paladin,retribution,218,106,112
28512,Draidan,area-52,1819,paladin,retribution,131,81,50
28513,Blackcandle,tichondrius,1819,paladin,retribution,48,29,19
28514,Yorøchi,azralon,1819,paladin,retribution,57,31,26
28515,Backdrop,proudmoore,1819,paladin,retribution,169,91,78
28516,Geöspäwn,tichondrius,1819,paladin,retribution,39,20,19
28517,Anbivilent,moon-guard,1819,paladin,retribution,48,23,25
28518,Cardynivans,tichondrius,1819,paladin,retribution,67,25,42
28519,Warstompgg,ragnaros,1818,paladin,retribution,36,25,11
28520,Mervor,quelthalas,1818,paladin,retribution,60,29,31
28521,Zett,jubeithos,1818,paladin,retribution,97,45,52
28522,Dorex,moon-guard,1817,paladin,retribution,111,72,39
28523,Dazargeros,moon-guard,1817,paladin,retribution,30,19,11
28524,Nr,blood-furnace,1817,paladin,retribution,54,32,22
28525,Comeuppance,wyrmrest-accord,1817,paladin,retribution,190,103,87
28526,Evangelìne,darkspear,1816,paladin,retribution,48,32,16
28527,Dwimberlike,ragnaros,1816,paladin,retribution,56,37,19
28528,Chadsteroid,sargeras,1816,paladin,retribution,48,29,19
28529,Xinqingle,tichondrius,1816,paladin,retribution,76,44,32
28530,Kumdonia,illidan,1816,paladin,retribution,36,19,17
28531,Kooi,illidan,1816,paladin,retribution,78,35,43
28532,Tyrillian,aerie-peak,1816,paladin,retribution,48,21,27
28533,Kíngkáiser,azralon,1815,paladin,retribution,46,27,19
28534,Loisterly,bladefist,1814,paladin,retribution,128,70,58
28535,Zulmay,malganis,1814,paladin,retribution,156,78,78
28536,Traize,kelthuzad,1813,paladin,retribution,48,30,18
28537,Ìshen,illidan,1813,paladin,retribution,54,30,24
28538,Dorktanian,stormrage,1813,paladin,retribution,78,40,38
28539,Heatyr,malganis,1813,paladin,retribution,59,28,31
28540,Cagowhite,tichondrius,1813,paladin,retribution,50,23,27
28541,Lovy,area-52,1813,paladin,retribution,66,30,36
28542,Pallysmack,stormrage,1812,paladin,retribution,48,28,20
28543,Arquidea,tichondrius,1812,paladin,retribution,114,61,53
28544,Mürlin,illidan,1812,paladin,retribution,227,112,115
28545,Gabbynator,emerald-dream,1812,paladin,retribution,59,28,31
28546,Rethumtv,tichondrius,1812,paladin,retribution,72,30,42
28547,Arkadiano,drakkari,1812,paladin,retribution,78,29,49
28548,Triston,area-52,1810,paladin,retribution,120,66,54
28549,Lilcyans,ragnaros,1810,paladin,retribution,66,34,32
28550,Ienhova,area-52,1810,paladin,retribution,72,36,36
28551,Primaryee,tichondrius,1810,paladin,retribution,121,53,68
28552,Ladeon,proudmoore,1809,paladin,retribution,72,44,28
28553,Émiluss,stormrage,1809,paladin,retribution,66,33,33
28554,Beaconlol,proudmoore,1808,paladin,retribution,107,67,40
28555,Fussyotter,stormreaver,1808,paladin,retribution,103,59,44
28556,Rédbarön,illidan,1808,paladin,retribution,72,32,40
28557,Màli,akama,1808,paladin,retribution,52,20,32
28558,Stêvêts,tichondrius,1807,paladin,retribution,36,20,16
28559,Downways,sargeras,1807,paladin,retribution,73,39,34
28560,Profundity,area-52,1807,paladin,retribution,70,37,33
28561,Ratg,frostmourne,1807,paladin,retribution,46,24,22
28562,Andelko,tichondrius,1807,paladin,retribution,46,23,23
28563,Strøngkiing,bleeding-hollow,1807,paladin,retribution,66,31,35
28564,Velstadt,sargeras,1807,paladin,retribution,66,29,37
28565,Jhasøn,quelthalas,1806,paladin,retribution,60,40,20
28566,Pornenjoyer,dalaran,1806,paladin,retribution,30,19,11
28567,Darcobs,ragnaros,1806,paladin,retribution,172,90,82
28568,Kishou,stormrage,1806,paladin,retribution,39,20,19
28569,Pambeazley,bronzebeard,1806,paladin,retribution,46,23,23
28570,Mortaine,moon-guard,1806,paladin,retribution,204,101,103
28571,Zeyrox,stormrage,1806,paladin,retribution,54,26,28
28572,Pramethious,sargeras,1806,paladin,retribution,72,34,38
28573,Erodan,moon-guard,1806,paladin,retribution,88,38,50
28574,Annihilàtion,frostmourne,1805,paladin,retribution,42,30,12
28575,Ipomaikai,dragonmaw,1805,paladin,retribution,30,19,11
28576,Çestlavie,korgath,1805,paladin,retribution,90,51,39
28577,Antlkd,quelthalas,1805,paladin,retribution,59,31,28
28578,Angelicwhim,stormrage,1805,paladin,retribution,48,25,23
28579,Christtel,stormrage,1805,paladin,retribution,72,36,36
28580,Koketsu,ragnaros,1805,paladin,retribution,219,109,110
28581,Huuzhaa,tichondrius,1805,paladin,retribution,92,44,48
28582,Panncakeman,tichondrius,1804,paladin,retribution,60,33,27
28583,Ironblade,zuljin,1804,paladin,retribution,54,29,25
28584,Outkas,area-52,1804,paladin,retribution,54,28,26
28585,Palli,moon-guard,1804,paladin,retribution,60,31,29
28586,Lumbersnack,moon-guard,1804,paladin,retribution,75,36,39
28587,Thantore,scilla,1804,paladin,retribution,76,34,42
28588,Justicejosh,frostmourne,1803,paladin,retribution,42,25,17
28589,Reypally,dalaran,1803,paladin,retribution,132,66,66
28590,Niubcjq,tichondrius,1803,paladin,retribution,42,19,23
28591,Lucy,sargeras,1803,paladin,retribution,72,32,40
28592,Disappearing,stormrage,1802,paladin,retribution,48,31,17
28593,Arkcadius,frostmourne,1802,paladin,retribution,96,52,44
28594,Sâdê,bleeding-hollow,1802,paladin,retribution,36,19,17
28595,Tèhflip,tichondrius,1801,paladin,retribution,36,19,17
28596,Gunderbok,emerald-dream,1801,paladin,retribution,63,33,30
28597,Mabia,tichondrius,1801,paladin,retribution,72,37,35
28598,Iloveyouxoxo,tichondrius,1800,paladin,retribution,54,29,25
28599,Duhvine,malganis,1800,paladin,retribution,41,22,19
28600,Ashkandi,tichondrius,1800,paladin,retribution,101,53,48
28601,Sôck,zuljin,1800,paladin,retribution,44,22,22
28602,Kalgormoth,ragnaros,1800,paladin,retribution,89,43,46
28603,Ha,bleeding-hollow,1800,paladin,retribution,64,26,38
28604,Määx,bleeding-hollow,1799,paladin,retribution,42,25,17
28605,Ulcerà,azralon,1797,paladin,retribution,61,28,33
28606,Shotgunzs,tichondrius,1796,paladin,retribution,54,22,32
28607,Joeschmo,area-52,1795,paladin,retribution,48,29,19
28608,Dúrnir,stormscale,1794,paladin,retribution,30,19,11
28609,Kádabrak,tichondrius,1794,paladin,retribution,54,34,20
28610,Obsolete,onyxia,1793,paladin,retribution,108,53,55
28611,Coldzerox,ragnaros,1792,paladin,retribution,173,87,86
28612,Raxadin,stormrage,1791,paladin,retribution,54,29,25
28613,Chadatron,tichondrius,1791,paladin,retribution,42,21,21
28614,Dippedxd,tichondrius,1790,paladin,retribution,78,43,35
28615,Johnmacclane,azralon,1790,paladin,retribution,183,98,85
28616,Galatus,tichondrius,1790,paladin,retribution,59,26,33
28617,Puredecuy,ragnaros,1787,paladin,retribution,72,32,40
28618,Pomboxd,stormrage,1786,paladin,retribution,89,50,39
28619,Apnea,ragnaros,1786,paladin,retribution,186,89,97
28620,Youguessedit,stormrage,1785,paladin,retribution,30,19,11
28621,Areuss,tichondrius,1783,paladin,retribution,41,22,19
28622,Abegáil,area-52,1783,paladin,retribution,54,28,26
28623,Giørther,ragnaros,1783,paladin,retribution,57,29,28
28624,Retsaíyan,tichondrius,1783,paladin,retribution,66,31,35
28625,Honeybunza,area-52,1782,paladin,retribution,80,42,38
28626,Rasler,stormrage,1782,paladin,retribution,186,95,91
28627,Judgejudyx,sargeras,1781,paladin,retribution,31,21,10
28628,Lunalunar,quelthalas,1781,paladin,retribution,65,30,35
28629,Moød,ragnaros,1780,paladin,retribution,95,53,42
28630,Whathehell,black-dragonflight,1780,paladin,retribution,228,115,113
28631,Toughxguy,sargeras,1780,paladin,retribution,116,58,58
28632,Soverejgn,bleeding-hollow,1780,paladin,retribution,422,205,217
28633,Naverpay,tichondrius,1779,paladin,retribution,40,22,18
28634,Dampenedxd,bleeding-hollow,1779,paladin,retribution,98,45,53
28635,Robo,tichondrius,1778,paladin,retribution,30,19,11
28636,Zakladchick,illidan,1778,paladin,retribution,48,26,22
28637,Incubus,rexxar,1778,paladin,retribution,66,30,36
28638,Nhsvikings,bleeding-hollow,1777,paladin,retribution,59,31,28
28639,Galedance,tichondrius,1777,paladin,retribution,52,25,27
28640,Litium,frostmourne,1776,paladin,retribution,54,30,24
28641,Hargol,stormrage,1776,paladin,retribution,102,47,55
28642,Mardùk,stormrage,1775,paladin,retribution,45,30,15
28643,Animepower,moon-guard,1775,paladin,retribution,144,80,64
28644,Hallmark,kelthuzad,1775,paladin,retribution,60,28,32
28645,Titannious,stormrage,1772,paladin,retribution,119,61,58
28646,Thebless,tichondrius,1770,paladin,retribution,47,27,20
28647,Htmlar,tichondrius,1770,paladin,retribution,70,30,40
28648,Filthyape,wyrmrest-accord,1769,paladin,retribution,118,73,45
28649,Syleith,shadow-council,1768,paladin,retribution,115,54,61
28650,Rahkinishu,khaz-modan,1766,paladin,retribution,189,109,80
28651,Talivar,kelthuzad,1766,paladin,retribution,156,89,67
28652,Bigdogchief,stormrage,1765,paladin,retribution,42,24,18
28653,Aegious,darkspear,1764,paladin,retribution,42,22,20
28654,Tofuupal,tichondrius,1764,paladin,retribution,78,38,40
28655,Dippedlol,tichondrius,1762,paladin,retribution,48,28,20
28656,Teknik,stormscale,1760,paladin,retribution,150,74,76
28657,Younghova,kelthuzad,1759,paladin,retribution,96,43,53
28658,Marvallous,area-52,1758,paladin,retribution,90,50,40
28659,Britanybich,area-52,1757,paladin,retribution,72,36,36
28660,Knuckifubuck,illidan,1756,paladin,retribution,36,22,14
28661,Berryblast,shadowmoon,1755,paladin,retribution,48,32,16
28662,Danaimei,tichondrius,1755,paladin,retribution,56,31,25
28663,Quinnzel,barthilas,1754,paladin,retribution,74,41,33
28664,Bigdaddysdic,illidan,1752,paladin,retribution,114,58,56
28665,Neonblade,illidan,1752,paladin,retribution,88,42,46
28666,Adamantïum,azralon,1751,paladin,retribution,72,27,45
28667,Scarotv,malganis,1750,paladin,retribution,60,29,31
28668,Plniss,tichondrius,1749,paladin,retribution,66,34,32
28669,Rethir,illidan,1746,paladin,retribution,65,40,25
28670,Rugay,sargeras,1745,paladin,retribution,29,19,10
28671,Traceless,emerald-dream,1745,paladin,retribution,111,66,45
28672,Pérona,tichondrius,1744,paladin,retribution,48,25,23
28673,Ibullyourmom,tichondrius,1744,paladin,retribution,137,68,69
28674,Thebubbajay,illidan,1743,paladin,retribution,54,31,23
28675,Htnhy,aegwynn,1743,paladin,retribution,60,24,36
28676,Rashbringer,azgalor,1742,paladin,retribution,67,34,33
28677,Yérn,barthilas,1742,paladin,retribution,42,21,21
28678,Josxth,stormrage,1741,paladin,retribution,54,29,25
28679,Mmbakes,shadowsong,1740,paladin,retribution,36,22,14
28680,Tuuro,stormrage,1740,paladin,retribution,241,120,121
28681,Galess,tichondrius,1740,paladin,retribution,60,24,36
28682,Helldevil,zuljin,1739,paladin,retribution,48,25,23
28683,Lundor,ragnaros,1739,paladin,retribution,137,66,71
28684,Popwings,azralon,1738,paladin,retribution,52,27,25
28685,Nitemareforu,stormreaver,1735,paladin,retribution,90,54,36
28686,Lecheroø,tichondrius,1735,paladin,retribution,72,41,31
28687,Gellehar,barthilas,1735,paladin,retribution,36,19,17
28688,Shakalot,illidan,1735,paladin,retribution,114,55,59
28689,Palimedic,sargeras,1734,paladin,retribution,114,55,59
28690,Clee,sargeras,1732,paladin,retribution,111,58,53
28691,Ítsyôúñötmé,tichondrius,1731,paladin,retribution,146,81,65
28692,Rektwings,area-52,1731,paladin,retribution,60,28,32
28693,Zoliz,tichondrius,1730,paladin,retribution,78,42,36
28694,Orindel,tichondrius,1729,paladin,retribution,29,19,10
28695,Galeast,tichondrius,1729,paladin,retribution,66,28,38
28696,Alduur,aggramar,1728,paladin,retribution,48,30,18
28697,Fylerz,blackhand,1728,paladin,retribution,90,49,41
28698,Xiddin,frostmourne,1728,paladin,retribution,66,33,33
28699,Triginhall,moon-guard,1727,paladin,retribution,89,43,46
28700,Thrax,spirestone,1727,paladin,retribution,129,59,70
28701,Cristø,stormrage,1727,paladin,retribution,72,30,42
28702,Coleta,stormrage,1725,paladin,retribution,42,28,14
28703,Nah,emerald-dream,1725,paladin,retribution,57,30,27
28704,Nume,nesingwary,1724,paladin,retribution,64,26,38
28705,Ponytail,dark-iron,1723,paladin,retribution,58,31,27
28706,Riseandgrind,tichondrius,1723,paladin,retribution,36,18,18
28707,Mihawk,drenden,1721,paladin,retribution,30,21,9
28708,Marvinceo,stormreaver,1721,paladin,retribution,36,18,18
28709,Arkantion,whisperwind,1720,paladin,retribution,59,37,22
28710,Holywaffle,nemesis,1720,paladin,retribution,121,63,58
28711,Wantsome,frostmourne,1719,paladin,retribution,55,25,30
28712,Insanity,dethecus,1719,paladin,retribution,42,18,24
28713,Toguro,kelthuzad,1718,paladin,retribution,97,55,42
28714,Pheonixpally,azralon,1718,paladin,retribution,78,33,45
28715,Retrachet,thrall,1717,paladin,retribution,42,21,21
28716,Notae,icecrown,1717,paladin,retribution,42,21,21
28717,Aora,kiljaeden,1717,paladin,retribution,60,24,36
28718,Vanath,bleeding-hollow,1716,paladin,retribution,54,30,24
28719,Éætûgýäëí,area-52,1716,paladin,retribution,42,18,24
28720,Midheaven,moon-guard,1713,paladin,retribution,65,41,24
28721,Ssjlimit,tichondrius,1713,paladin,retribution,53,27,26
28722,Áldin,ragnaros,1711,paladin,retribution,40,23,17
28723,Nqe,area-52,1711,paladin,retribution,94,54,40
28724,Emaus,tichondrius,1711,paladin,retribution,72,28,44
28725,Imcomingbro,blackrock,1710,paladin,retribution,56,27,29
28726,Markcrisman,quelthalas,1709,paladin,retribution,45,22,23
28727,Svinadin,emerald-dream,1708,paladin,retribution,36,21,15
28728,Luzoscura,quelthalas,1708,paladin,retribution,78,43,35
28729,Handyandy,kelthuzad,1708,paladin,retribution,108,47,61
28730,Watchamebaba,malganis,1708,paladin,retribution,54,21,33
28731,Palban,tichondrius,1706,paladin,retribution,78,43,35
28732,Sathandrä,sargeras,1706,paladin,retribution,73,36,37
28733,Lokâr,lightbringer,1706,paladin,retribution,66,30,36
28734,Egirlret,tichondrius,1706,paladin,retribution,48,21,27
28735,Omensageiro,azralon,1705,paladin,retribution,72,27,45
28736,Oneaßoveall,azralon,1704,paladin,retribution,103,57,46
28737,Remethea,sargeras,1704,paladin,retribution,188,95,93
28738,Allixis,wyrmrest-accord,1704,paladin,retribution,52,22,30
28739,Wutefuh,azgalor,1703,paladin,retribution,36,24,12
28740,Genovah,sargeras,1703,paladin,retribution,36,22,14
28741,Glowbulled,area-52,1703,paladin,retribution,60,32,28
28742,Cuteluna,tichondrius,1703,paladin,retribution,54,28,26
28743,Usdacertifed,lightnings-blade,1703,paladin,retribution,191,94,97
28744,Bakafish,tichondrius,1702,paladin,retribution,24,18,6
28745,Vapanor,ragnaros,1702,paladin,retribution,59,30,29
28746,Sugnidrom,frostmourne,1700,paladin,retribution,58,31,27
28747,Kaharule,akama,1700,paladin,retribution,46,20,26
28748,Griffïth,thrall,1699,paladin,retribution,36,21,15
28749,Buckey,kilrogg,1699,paladin,retribution,52,28,24
28750,Lepirate,emerald-dream,1699,paladin,retribution,36,18,18
28751,Voodoovon,tichondrius,1697,paladin,retribution,89,42,47
28752,Bubblemark,tichondrius,1697,paladin,retribution,91,39,52
28753,Izidar,tichondrius,1696,paladin,retribution,42,29,13
28754,Ópsv,quelthalas,1696,paladin,retribution,173,97,76
28755,Bizzaz,moon-guard,1696,paladin,retribution,72,30,42
28756,Lidranas,sargeras,1695,paladin,retribution,57,35,22
28757,Ledster,kelthuzad,1695,paladin,retribution,54,22,32
28758,Axcvnz,draka,1694,paladin,retribution,42,23,19
28759,Nadinebb,proudmoore,1694,paladin,retribution,54,23,31
28760,Liadrives,area-52,1693,paladin,retribution,78,46,32
28761,Zensargge,tichondrius,1693,paladin,retribution,84,34,50
28762,Dazn,tichondrius,1693,paladin,retribution,78,26,52
28763,Keltar,burning-blade,1692,paladin,retribution,30,18,12
28764,Bisket,illidan,1692,paladin,retribution,59,29,30
28765,Justnikop,tichondrius,1692,paladin,retribution,115,56,59
28766,Shova,nemesis,1691,paladin,retribution,42,25,17
28767,Dârkk,tichondrius,1691,paladin,retribution,36,20,16
28768,Forzanapoli,tichondrius,1691,paladin,retribution,48,23,25
28769,Clownfister,barthilas,1690,paladin,retribution,54,29,25
28770,Elegan,frostmourne,1690,paladin,retribution,66,32,34
28771,Xeldar,tichondrius,1689,paladin,retribution,72,37,35
28772,Pickleret,emerald-dream,1689,paladin,retribution,108,51,57
28773,Sandokhán,ragnaros,1689,paladin,retribution,53,25,28
28774,Lasteroy,nemesis,1688,paladin,retribution,88,49,39
28775,Bakapal,tichondrius,1688,paladin,retribution,96,51,45
28776,Actionb,aggramar,1688,paladin,retribution,113,56,57
28777,Solånar,bloodscalp,1688,paladin,retribution,55,24,31
28778,Mønaka,tichondrius,1687,paladin,retribution,48,29,19
28779,ßountystrike,sargeras,1687,paladin,retribution,60,26,34
28780,Noctisu,tichondrius,1687,paladin,retribution,48,18,30
28781,Pathalerix,eonar,1686,paladin,retribution,53,29,24
28782,Healmeboi,tichondrius,1686,paladin,retribution,74,39,35
28783,Borntobebad,barthilas,1686,paladin,retribution,36,18,18
28784,Djdiogø,azralon,1686,paladin,retribution,104,50,54
28785,Utherparty,frostmourne,1685,paladin,retribution,103,55,48
28786,Tzakial,area-52,1685,paladin,retribution,60,25,35
28787,Wing,frostwolf,1684,paladin,retribution,96,49,47
28788,Lillm,malganis,1683,paladin,retribution,96,49,47
28789,Konesky,dalaran,1683,paladin,retribution,57,27,30
28790,Nizzy,caelestrasz,1683,paladin,retribution,42,18,24
28791,Hînøkåmí,tichondrius,1681,paladin,retribution,42,24,18
28792,Hólyélf,illidan,1680,paladin,retribution,102,44,58
28793,Bravepala,tichondrius,1680,paladin,retribution,54,20,34
28794,Sosalo,sargeras,1679,paladin,retribution,81,38,43
28795,Sasorï,stormrage,1679,paladin,retribution,90,41,49
28796,Insîght,frostmourne,1678,paladin,retribution,70,27,43
28797,Lilthroatbby,malganis,1677,paladin,retribution,126,53,73
28798,Siire,darkspear,1676,paladin,retribution,72,39,33
28799,Syreqt,nemesis,1676,paladin,retribution,48,25,23
28800,Semellem,bloodhoof,1675,paladin,retribution,60,28,32
28801,Shieldheart,moon-guard,1674,paladin,retribution,42,23,19
28802,Kuico,ragnaros,1674,paladin,retribution,48,24,24
28803,Jelial,chogall,1673,paladin,retribution,69,35,34
28804,Weike,barthilas,1673,paladin,retribution,100,45,55
28805,Palajeans,stormrage,1672,paladin,retribution,40,23,17
28806,Moolishous,frostmourne,1672,paladin,retribution,89,48,41
28807,Todesgott,tichondrius,1671,paladin,retribution,42,25,17
28808,Elëssar,ragnaros,1671,paladin,retribution,179,91,88
28809,Chriskriego,frostmourne,1671,paladin,retribution,60,24,36
28810,Bubbledober,tichondrius,1670,paladin,retribution,30,20,10
28811,Pumperjer,tichondrius,1669,paladin,retribution,53,26,27
28812,Boarfarmer,tichondrius,1669,paladin,retribution,48,23,25
28813,Theseusz,tichondrius,1666,paladin,retribution,42,30,12
28814,Sniper,uther,1666,paladin,retribution,54,29,25
28815,Palejandro,illidan,1666,paladin,retribution,101,53,48
28816,Powermonster,tichondrius,1666,paladin,retribution,42,19,23
28817,Eurekasret,ragnaros,1665,paladin,retribution,113,60,53
28818,Whosyadaddy,tichondrius,1665,paladin,retribution,148,73,75
28819,Haiden,goldrinn,1665,paladin,retribution,55,23,32
28820,Bübbleqt,exodar,1664,paladin,retribution,30,18,12
28821,Anjurus,moon-guard,1664,paladin,retribution,42,24,18
28822,Perturabeau,bonechewer,1664,paladin,retribution,58,33,25
28823,Kozk,quelthalas,1663,paladin,retribution,213,121,92
28824,Mazaltoff,proudmoore,1663,paladin,retribution,105,53,52
28825,Jxke,barthilas,1663,paladin,retribution,41,20,21
28826,Stompëd,proudmoore,1663,paladin,retribution,62,29,33
28827,Garlond,moon-guard,1662,paladin,retribution,60,32,28
28828,Finaljustice,sargeras,1661,paladin,retribution,30,19,11
28829,Lalatinx,quelthalas,1661,paladin,retribution,108,54,54
28830,Jucker,tichondrius,1661,paladin,retribution,54,23,31
28831,Trippën,tichondrius,1660,paladin,retribution,229,119,110
28832,Xenk,moon-guard,1659,paladin,retribution,34,18,16
28833,Crismj,tichondrius,1659,paladin,retribution,78,41,37
28834,Mesmi,moon-guard,1659,paladin,retribution,94,46,48
28835,Selivara,zuljin,1659,paladin,retribution,42,20,22
28836,Fatkidslag,sargeras,1659,paladin,retribution,42,19,23
28837,Happybubbles,tichondrius,1658,paladin,retribution,42,25,17
28838,Bigjiba,proudmoore,1658,paladin,retribution,48,25,23
28839,Alyxandr,dalaran,1658,paladin,retribution,48,24,24
28840,Redoubt,archimonde,1658,paladin,retribution,47,23,24
28841,Daylin,tichondrius,1657,paladin,retribution,32,19,13
28842,Thoreal,thrall,1657,paladin,retribution,84,41,43
28843,Vanas,stormrage,1657,paladin,retribution,57,26,31
28844,Slashnroses,tichondrius,1656,paladin,retribution,44,19,25
28845,Waffletrain,tichondrius,1655,paladin,retribution,46,22,24
28846,Reckcowning,area-52,1655,paladin,retribution,48,20,28
28847,Alexese,area-52,1654,paladin,retribution,89,55,34
28848,Paladinomg,darkspear,1654,paladin,retribution,130,74,56
28849,Forthestreet,tichondrius,1654,paladin,retribution,88,48,40
28850,Shirael,ragnaros,1654,paladin,retribution,84,41,43
28851,Wîckèd,tichondrius,1654,paladin,retribution,47,21,26
28852,Iggÿ,illidan,1654,paladin,retribution,70,30,40
28853,Itzcupcake,illidan,1653,paladin,retribution,120,69,51
28854,Oppressive,moon-guard,1653,paladin,retribution,380,188,192
28855,Duffnroses,tichondrius,1653,paladin,retribution,60,27,33
28856,Hozna,andorhal,1652,paladin,retribution,61,36,25
28857,Konsentrate,tichondrius,1652,paladin,retribution,162,82,80
28858,Alanthor,ragnaros,1652,paladin,retribution,150,74,76
28859,Misbah,stormrage,1651,paladin,retribution,50,30,20
28860,Lanach,lightbringer,1651,paladin,retribution,64,33,31
28861,Orivia,spirestone,1651,paladin,retribution,54,26,28
28862,Trixtur,tichondrius,1651,paladin,retribution,60,28,32
28863,Rexx,frostmourne,1650,paladin,retribution,54,30,24
28864,Sabotsaint,tichondrius,1649,paladin,retribution,72,29,43
28865,Likzebawlz,tichondrius,1648,paladin,retribution,42,25,17
28866,Zcho,proudmoore,1648,paladin,retribution,63,31,32
28867,Ylilliana,illidan,1648,paladin,retribution,49,22,27
28868,Lánná,tichondrius,1647,paladin,retribution,30,18,12
28869,Divínos,area-52,1647,paladin,retribution,66,34,32
28870,Claudleon,drakkari,1647,paladin,retribution,41,21,20
28871,Nasnyl,stormrage,1646,paladin,retribution,42,20,22
28872,Xerobite,quelthalas,1646,paladin,retribution,70,32,38
28873,Parkwons,tichondrius,1646,paladin,retribution,66,26,40
28874,Akâme,kelthuzad,1645,paladin,retribution,28,19,9
28875,Holdup,moon-guard,1645,paladin,retribution,83,54,29
28876,Amgirlinv,malganis,1645,paladin,retribution,32,20,12
28877,Bigolcriddys,barthilas,1645,paladin,retribution,36,21,15
28878,Geedee,ysera,1645,paladin,retribution,70,39,31
28879,Gwff,tichondrius,1645,paladin,retribution,41,18,23
28880,Eneraxx,proudmoore,1645,paladin,retribution,48,20,28
28881,Yusha,barthilas,1644,paladin,retribution,47,32,15
28882,Därth,azralon,1644,paladin,retribution,46,20,26
28883,Palabeshar,area-52,1644,paladin,retribution,48,18,30
28884,Yezzyll,korgath,1643,paladin,retribution,36,19,17
28885,Blackpie,bleeding-hollow,1643,paladin,retribution,48,23,25
28886,Jackstank,dragonmaw,1642,paladin,retribution,53,33,20
28887,Diebygcd,tichondrius,1642,paladin,retribution,37,21,16
28888,Seraphini,illidan,1642,paladin,retribution,65,34,31
28889,Oathen,proudmoore,1642,paladin,retribution,56,27,29
28890,Schmïtty,tichondrius,1642,paladin,retribution,48,23,25
28891,Furdaddylant,drenden,1641,paladin,retribution,30,18,12
28892,Practícal,moon-guard,1641,paladin,retribution,90,45,45
28893,Serås,silvermoon,1640,paladin,retribution,66,43,23
28894,Pockopea,arygos,1640,paladin,retribution,88,56,32
28895,Shiadfang,tichondrius,1640,paladin,retribution,72,39,33
28896,Angrytitan,tichondrius,1640,paladin,retribution,60,29,31
28897,Lleo,nemesis,1640,paladin,retribution,118,54,64
28898,Cøøkïë,frostmourne,1639,paladin,retribution,48,27,21
28899,Craq,alexstrasza,1639,paladin,retribution,134,64,70
28900,Candysugar,tichondrius,1638,paladin,retribution,30,18,12
28901,Notneo,zuljin,1638,paladin,retribution,59,34,25
28902,Weskar,garithos,1638,paladin,retribution,142,81,61
28903,Ceyh,ragnaros,1638,paladin,retribution,53,25,28
28904,Lirtheil,quelthalas,1637,paladin,retribution,36,21,15
28905,Benoít,zuljin,1637,paladin,retribution,90,51,39
28906,Brightstar,azjolnerub,1637,paladin,retribution,71,39,32
28907,Dimdabbin,malganis,1637,paladin,retribution,42,22,20
28908,Saccro,area-52,1637,paladin,retribution,114,57,57
28909,Jud,frostmourne,1636,paladin,retribution,90,43,47
28910,Frepz,illidan,1635,paladin,retribution,46,25,21
28911,Amanzhul,quelthalas,1635,paladin,retribution,99,46,53
28912,Gimlias,kelthuzad,1635,paladin,retribution,54,25,29
28913,Nuggetpusher,thunderlord,1634,paladin,retribution,55,30,25
28914,Nattandin,ragnaros,1634,paladin,retribution,42,22,20
28915,Mílkywayx,stormrage,1634,paladin,retribution,108,54,54
28916,Daddytoad,tichondrius,1634,paladin,retribution,66,32,34
28917,Lightowen,draka,1634,paladin,retribution,46,22,24
28918,Cyanss,ragnaros,1634,paladin,retribution,47,19,28
28919,Beardy,emerald-dream,1633,paladin,retribution,60,36,24
28920,Inmortall,illidan,1632,paladin,retribution,54,30,24
28921,Ajulgedang,frostmourne,1632,paladin,retribution,120,57,63
28922,Dreneisha,malganis,1631,paladin,retribution,42,22,20
28923,Aiethyria,tichondrius,1630,paladin,retribution,30,18,12
28924,Zayblade,dragonblight,1630,paladin,retribution,40,23,17
28925,Tobaz,azralon,1630,paladin,retribution,85,48,37
28926,Fistâcuffs,stormrage,1630,paladin,retribution,54,22,32
28927,Ulrah,moon-guard,1629,paladin,retribution,120,68,52
28928,Intense,moonrunner,1628,paladin,retribution,40,20,20
28929,Derigoth,quelthalas,1628,paladin,retribution,42,20,22
28930,Kíbá,malganis,1627,paladin,retribution,33,18,15
28931,Làzårus,area-52,1627,paladin,retribution,56,30,26
28932,Masqadin,stormrage,1627,paladin,retribution,36,17,19
28933,Zazaron,kiljaeden,1627,paladin,retribution,54,24,30
28934,Elcíd,quelthalas,1627,paladin,retribution,111,47,64
28935,Ziberax,chogall,1626,paladin,retribution,64,40,24
28936,Damnhammer,tichondrius,1626,paladin,retribution,42,26,16
28937,Gareesa,wyrmrest-accord,1626,paladin,retribution,78,39,39
28938,Gatzu,tichondrius,1626,paladin,retribution,54,24,30
28939,Fluffnac,tichondrius,1625,paladin,retribution,30,17,13
28940,Davinshki,stormrage,1625,paladin,retribution,55,31,24
28941,Notbärry,area-52,1625,paladin,retribution,48,27,21
28942,Tatánka,ragnaros,1625,paladin,retribution,54,29,25
28943,Renckay,ragnaros,1625,paladin,retribution,99,52,47
28944,Chajaaro,ragnaros,1625,paladin,retribution,67,33,34
28945,Goons,frostmourne,1625,paladin,retribution,54,21,33
28946,Ödin,scarlet-crusade,1623,paladin,retribution,48,26,22
28947,Techno,tichondrius,1623,paladin,retribution,175,89,86
28948,Radacos,emerald-dream,1623,paladin,retribution,160,80,80
28949,Joeyrat,area-52,1623,paladin,retribution,42,20,22
28950,Holyflopper,malganis,1623,paladin,retribution,48,21,27
28951,Retrodino,anvilmar,1623,paladin,retribution,48,21,27
28952,Alianór,tichondrius,1623,paladin,retribution,47,19,28
28953,Cyrenity,tichondrius,1623,paladin,retribution,59,19,40
28954,Litler,tichondrius,1622,paladin,retribution,44,30,14
28955,Gobblerr,blackrock,1622,paladin,retribution,30,20,10
28956,Bizarrap,quelthalas,1622,paladin,retribution,43,25,18
28957,Munaru,illidan,1621,paladin,retribution,36,22,14
28958,Pandoro,tichondrius,1621,paladin,retribution,55,33,22
28959,Hazexd,illidan,1621,paladin,retribution,36,20,16
28960,Dashhighborn,sargeras,1621,paladin,retribution,71,38,33
28961,Faladrim,moon-guard,1621,paladin,retribution,160,84,76
28962,Michaelsmith,frostmourne,1621,paladin,retribution,36,17,19
28963,Aredel,drakkari,1621,paladin,retribution,53,24,29
28964,Lêggy,moon-guard,1621,paladin,retribution,54,23,31
28965,Rùckûs,tichondrius,1621,paladin,retribution,47,19,28
28966,Rukkas,sargeras,1621,paladin,retribution,54,21,33
28967,Yukíteru,illidan,1620,paladin,retribution,69,32,37
28968,Merculios,stormrage,1619,paladin,retribution,63,34,29
28969,Tronzyy,trollbane,1619,paladin,retribution,59,26,33
28970,Bbtea,frostmourne,1619,paladin,retribution,48,20,28
28971,Glørious,drakkari,1618,paladin,retribution,90,42,48
28972,Hamerfall,tichondrius,1618,paladin,retribution,54,22,32
28973,Sunnix,illidan,1618,paladin,retribution,48,17,31
28974,Beefjustice,velen,1617,paladin,retribution,60,32,28
28975,Aleríon,ragnaros,1617,paladin,retribution,181,92,89
28976,Holiness,stormreaver,1617,paladin,retribution,48,18,30
28977,Lawmower,sargeras,1616,paladin,retribution,54,32,22
28978,Agamemnom,tichondrius,1616,paladin,retribution,227,116,111
28979,Jackedx,sargeras,1615,paladin,retribution,36,21,15
28980,Zadquel,ragnaros,1615,paladin,retribution,106,61,45
28981,Inquisition,moon-guard,1615,paladin,retribution,30,17,13
28982,Feelsögood,tichondrius,1615,paladin,retribution,45,24,21
28983,Drholypurp,tichondrius,1615,paladin,retribution,59,31,28
28984,Øðyn,sargeras,1615,paladin,retribution,59,30,29
28985,Outstrike,tichondrius,1615,paladin,retribution,36,17,19
28986,Thenextx,illidan,1615,paladin,retribution,66,22,44
28987,Daweeki,area-52,1614,paladin,retribution,24,19,5
28988,Raelan,icecrown,1614,paladin,retribution,77,52,25
28989,Sevik,garithos,1614,paladin,retribution,78,40,38
28990,Goldnhart,wyrmrest-accord,1614,paladin,retribution,78,37,41
28991,Stax,moon-guard,1614,paladin,retribution,42,17,25
28992,Bramot,moon-guard,1613,paladin,retribution,36,20,16
28993,Xbloodknight,malganis,1613,paladin,retribution,50,27,23
28994,Gattís,stormrage,1613,paladin,retribution,79,42,37
28995,Milizi,zuljin,1613,paladin,retribution,72,32,40
28996,Jessheim,emerald-dream,1613,paladin,retribution,42,18,24
28997,Kurasi,frostmourne,1613,paladin,retribution,63,26,37
28998,Milkmemamma,nordrassil,1612,paladin,retribution,36,21,15
28999,Hakson,stormrage,1612,paladin,retribution,61,35,26
29000,Whyta,azralon,1612,paladin,retribution,193,100,93
29001,Telarøn,stormrage,1612,paladin,retribution,200,101,99
29002,Hristian,tichondrius,1612,paladin,retribution,60,30,30
29003,Kaithen,quelthalas,1612,paladin,retribution,248,123,125
29004,Poisson,wildhammer,1612,paladin,retribution,60,27,33
29005,Jvbai,area-52,1612,paladin,retribution,87,39,48
29006,Halrix,stormrage,1611,paladin,retribution,60,34,26
29007,Kevybevy,stormrage,1611,paladin,retribution,150,81,69
29008,Lightslion,stormrage,1611,paladin,retribution,36,18,18
29009,Accépting,sargeras,1611,paladin,retribution,90,43,47
29010,Mordirhar,tichondrius,1611,paladin,retribution,90,39,51
29011,Rahmie,kiljaeden,1611,paladin,retribution,96,41,55
29012,Purejudgemnt,area-52,1610,paladin,retribution,54,33,21
29013,Kadabrak,area-52,1610,paladin,retribution,36,17,19
29014,Atair,antonidas,1609,paladin,retribution,36,21,15
29015,Beeftink,tichondrius,1609,paladin,retribution,100,51,49
29016,Allîe,malganis,1609,paladin,retribution,73,37,36
29017,Battlepope,thrall,1609,paladin,retribution,59,27,32
29018,Utherpendrag,bladefist,1609,paladin,retribution,78,32,46
29019,Regivan,nemesis,1609,paladin,retribution,54,21,33
29020,Rhodela,illidan,1608,paladin,retribution,95,52,43
29021,Sololeveling,malganis,1608,paladin,retribution,98,48,50
29022,Golden,tichondrius,1608,paladin,retribution,42,20,22
29023,Ahsilum,frostmourne,1608,paladin,retribution,48,17,31
29024,Holyroro,area-52,1607,paladin,retribution,44,26,18
29025,Secksorcism,frostwolf,1607,paladin,retribution,42,24,18
29026,Humbubble,cairne,1607,paladin,retribution,41,22,19
29027,Hellfound,bleeding-hollow,1607,paladin,retribution,41,22,19
29028,Shampin,alexstrasza,1607,paladin,retribution,72,38,34
29029,Trolladin,rivendare,1607,paladin,retribution,110,51,59
29030,Wde,zuljin,1607,paladin,retribution,43,18,25
29031,Marehk,thrall,1606,paladin,retribution,59,32,27
29032,Abigaile,ragnaros,1606,paladin,retribution,72,38,34
29033,Shádøwy,nemesis,1606,paladin,retribution,61,32,29
29034,Skilladin,zuljin,1606,paladin,retribution,77,40,37
29035,Ibustcheeks,sargeras,1606,paladin,retribution,71,36,35
29036,Southerly,tichondrius,1606,paladin,retribution,78,39,39
29037,Aefuezar,earthen-ring,1606,paladin,retribution,56,28,28
29038,Lit,alexstrasza,1606,paladin,retribution,52,22,30
29039,Hurtmypp,stormrage,1605,paladin,retribution,48,31,17
29040,Mfgspally,kelthuzad,1605,paladin,retribution,76,45,31
29041,Pçpaladin,stormrage,1605,paladin,retribution,36,21,15
29042,Uoenò,moon-guard,1605,paladin,retribution,41,23,18
29043,Chrisader,stormrage,1605,paladin,retribution,36,19,17
29044,Zarrakra,daggerspine,1605,paladin,retribution,99,52,47
29045,Dïlly,area-52,1605,paladin,retribution,90,46,44
29046,Ragarèn,emerald-dream,1605,paladin,retribution,42,20,22
29047,Cuchuflaiz,drakkari,1604,paladin,retribution,30,17,13
29048,Virtuosi,area-52,1604,paladin,retribution,42,23,19
29049,Joltie,quelthalas,1604,paladin,retribution,220,119,101
29050,Seantate,stormrage,1604,paladin,retribution,36,19,17
29051,Xeniél,illidan,1604,paladin,retribution,36,19,17
29052,Recliner,wyrmrest-accord,1604,paladin,retribution,36,19,17
29053,Rycerzforge,ragnaros,1604,paladin,retribution,74,38,36
29054,Trullz,illidan,1604,paladin,retribution,94,44,50
29055,Rhegyna,quelthalas,1603,paladin,retribution,48,26,22
29056,Plophero,moon-guard,1603,paladin,retribution,54,28,26
29057,Tanishalfelf,stormrage,1603,paladin,retribution,36,18,18
29058,Ÿøzsh,azralon,1603,paladin,retribution,66,30,36
29059,Ascetic,barthilas,1603,paladin,retribution,218,99,119
29060,Skylinator,bleeding-hollow,1603,paladin,retribution,59,26,33
29061,Pocserpala,drakkari,1602,paladin,retribution,42,26,16
29062,Palieop,aerie-peak,1601,paladin,retribution,30,18,12
29063,Leona,stormrage,1601,paladin,retribution,34,20,14
29064,Beshiki,hakkar,1601,paladin,retribution,358,180,178
29065,Aeterias,dalaran,1601,paladin,retribution,202,101,101
29066,Jowliet,stormrage,1601,paladin,retribution,36,17,19
29067,Tonimâster,misha,1601,paladin,retribution,47,21,26
29068,Dmghack,tichondrius,1601,paladin,retribution,42,17,25
29069,Pallydestroy,stormrage,1601,paladin,retribution,48,17,31
29070,Aethelwulf,stormrage,1600,paladin,retribution,42,24,18
29071,Varekaì,frostmourne,1600,paladin,retribution,153,80,73
29072,Sonatas,ursin,1599,paladin,retribution,39,21,18
29073,Mcbroken,tichondrius,1599,paladin,retribution,45,22,23
29074,Hupa,crushridge,1598,paladin,retribution,42,20,22
29075,Samgonz,tichondrius,1597,paladin,retribution,54,32,22
29076,Kymmy,ragnaros,1597,paladin,retribution,54,21,33
29077,Imnoracist,thrall,1597,paladin,retribution,72,24,48
29078,Løøsè,frostmourne,1595,paladin,retribution,36,20,16
29079,Tyirr,kelthuzad,1595,paladin,retribution,138,65,73
29080,Ellyee,jaedenar,1595,paladin,retribution,99,45,54
29081,Dazedpal,tichondrius,1594,paladin,retribution,345,180,165
29082,Layonhánd,ragnaros,1593,paladin,retribution,54,25,29
29083,Fây,sargeras,1593,paladin,retribution,66,29,37
29084,Umbrasanctus,daggerspine,1592,paladin,retribution,54,29,25
29085,Nidalee,kilrogg,1591,paladin,retribution,48,20,28
29086,Torinel,illidan,1590,paladin,retribution,35,17,18
29087,Auralyon,tichondrius,1590,paladin,retribution,42,17,25
29088,Aiseyqt,frostmourne,1589,paladin,retribution,114,70,44
29089,Barcar,area-52,1589,paladin,retribution,39,21,18
29090,Deepsearide,illidan,1589,paladin,retribution,155,82,73
29091,Beardedbrute,korgath,1589,paladin,retribution,42,19,23
29092,Fakesimp,illidan,1587,paladin,retribution,24,17,7
29093,Royalfather,tichondrius,1587,paladin,retribution,52,31,21
29094,Hedilyan,azralon,1587,paladin,retribution,96,48,48
29095,Lucianz,ragnaros,1587,paladin,retribution,60,29,31
29096,Sigmond,azralon,1587,paladin,retribution,63,28,35
29097,Ilovecl,tichondrius,1586,paladin,retribution,54,32,22
29098,Cowsecration,ragnaros,1585,paladin,retribution,24,17,7
29099,Drízzy,ragnaros,1585,paladin,retribution,64,31,33
29100,Swiftskillz,bleeding-hollow,1584,paladin,retribution,159,84,75
29101,Ënfos,azralon,1584,paladin,retribution,42,20,22
29102,Shïnjïtsu,tichondrius,1583,paladin,retribution,24,17,7
29103,Lightlana,frostwolf,1583,paladin,retribution,68,34,34
29104,Arlanso,frostmourne,1583,paladin,retribution,46,22,24
29105,Noholy,nemesis,1583,paladin,retribution,67,28,39
29106,Chuizz,frostmourne,1583,paladin,retribution,48,19,29
29107,Stöneblood,moon-guard,1583,paladin,retribution,54,18,36
29108,Wasembroder,ragnaros,1582,paladin,retribution,121,65,56
29109,Dallyon,stormrage,1582,paladin,retribution,42,21,21
29110,Taphos,icecrown,1581,paladin,retribution,53,30,23
29111,Sinmca,moon-guard,1581,paladin,retribution,68,37,31
29112,Lumaros,wyrmrest-accord,1581,paladin,retribution,54,29,25
29113,Ulrìck,quelthalas,1580,paladin,retribution,65,39,26
29114,Bastiion,stormrage,1580,paladin,retribution,88,43,45
29115,Miniell,tichondrius,1580,paladin,retribution,36,17,19
29116,Palaxoto,nemesis,1580,paladin,retribution,78,33,45
29117,Borrus,malygos,1579,paladin,retribution,78,40,38
29118,Sneeber,stormrage,1578,paladin,retribution,84,42,42
29119,Rimjobrachel,barthilas,1577,paladin,retribution,86,42,44
29120,Fuknshané,area-52,1577,paladin,retribution,68,32,36
29121,Pirofosfato,azralon,1577,paladin,retribution,46,21,25
29122,Anafensa,malganis,1577,paladin,retribution,66,27,39
29123,Malacriianza,quelthalas,1576,paladin,retribution,54,30,24
29124,Leztatium,quelthalas,1576,paladin,retribution,42,21,21
29125,Amialra,moon-guard,1576,paladin,retribution,55,27,28
29126,Fìlìgree,tichondrius,1574,paladin,retribution,55,30,25
29127,Ruhn,eldrethalas,1574,paladin,retribution,36,18,18
29128,Renzo,frostmourne,1574,paladin,retribution,63,28,35
29129,Daleroth,ragnaros,1573,paladin,retribution,39,22,17
29130,Tesak,emerald-dream,1573,paladin,retribution,114,58,56
29131,Purdicks,emerald-dream,1572,paladin,retribution,158,79,79
29132,Stackmymoney,kelthuzad,1572,paladin,retribution,50,22,28
29133,Chancellor,azralon,1571,paladin,retribution,234,125,109
29134,Tatakaicjq,tichondrius,1571,paladin,retribution,129,66,63
29135,Tenacer,darkspear,1571,paladin,retribution,52,24,28
29136,Mormdring,fizzcrank,1571,paladin,retribution,77,35,42
29137,Spala,tichondrius,1571,paladin,retribution,75,32,43
29138,Kdym,azralon,1570,paladin,retribution,30,19,11
29139,Guerrer,hyjal,1568,paladin,retribution,72,39,33
29140,Palmangels,bleeding-hollow,1568,paladin,retribution,44,18,26
29141,Coffeepal,tichondrius,1567,paladin,retribution,48,23,25
29142,Sammyste,elune,1566,paladin,retribution,98,55,43
29143,Articilia,ragnaros,1566,paladin,retribution,42,22,20
29144,Esçanór,darkspear,1566,paladin,retribution,61,30,31
29145,Chiphazard,stormscale,1566,paladin,retribution,58,23,35
29146,Nilin,tichondrius,1565,paladin,retribution,60,31,29
29147,Troyamat,nemesis,1565,paladin,retribution,53,27,26
29148,Andrilsteh,malganis,1565,paladin,retribution,108,48,60
29149,Damndoi,tichondrius,1564,paladin,retribution,54,29,25
29150,Fionno,quelthalas,1564,paladin,retribution,116,58,58
29151,Bogùs,tichondrius,1564,paladin,retribution,54,26,28
29152,Tantradin,area-52,1564,paladin,retribution,48,20,28
29153,Blasstar,quelthalas,1563,paladin,retribution,53,27,26
29154,Marcêl,quelthalas,1562,paladin,retribution,42,23,19
29155,Mixnut,tichondrius,1561,paladin,retribution,65,27,38
29156,Feannor,drakkari,1560,paladin,retribution,70,35,35
29157,Baeflux,kelthuzad,1560,paladin,retribution,48,19,29
29158,Pinkies,frostmourne,1559,paladin,retribution,93,49,44
29159,Arturias,kiljaeden,1559,paladin,retribution,95,49,46
29160,Darguen,ragnaros,1557,paladin,retribution,28,18,10
29161,Lawbandit,tichondrius,1557,paladin,retribution,34,19,15
29162,Chewyjitsu,tichondrius,1557,paladin,retribution,36,20,16
29163,Razneroka,ragnaros,1557,paladin,retribution,51,27,24
29164,Ironcoco,ragnaros,1557,paladin,retribution,53,27,26
29165,Luret,tichondrius,1557,paladin,retribution,34,17,17
29166,Insideous,kelthuzad,1557,paladin,retribution,69,34,35
29167,Tarnyb,illidan,1557,paladin,retribution,50,23,27
29168,Worder,tichondrius,1556,paladin,retribution,41,29,12
29169,Vêgenace,proudmoore,1556,paladin,retribution,48,24,24
29170,Missusomutch,azralon,1556,paladin,retribution,50,17,33
29171,Fótm,bleeding-hollow,1555,paladin,retribution,78,38,40
29172,Bawek,azralon,1555,paladin,retribution,60,25,35
29173,Grifnshlong,agamaggan,1554,paladin,retribution,33,19,14
29174,Bubblelol,bloodhoof,1554,paladin,retribution,98,42,56
29175,Crybátt,quelthalas,1553,paladin,retribution,68,35,33
29176,Luminiscente,ragnaros,1553,paladin,retribution,58,29,29
29177,Skynn,stormrage,1553,paladin,retribution,36,18,18
29178,Alexieus,wyrmrest-accord,1553,paladin,retribution,71,32,39
29179,Ájummalukout,tichondrius,1553,paladin,retribution,63,25,38
29180,Kissherlin,tichondrius,1552,paladin,retribution,30,18,12
29181,Thastrian,stormreaver,1552,paladin,retribution,60,31,29
29182,Yree,ragnaros,1552,paladin,retribution,78,37,41
29183,Notoriouus,bleeding-hollow,1552,paladin,retribution,42,18,24
29184,Yovan,proudmoore,1551,paladin,retribution,90,51,39
29185,Souldrainlol,quelthalas,1551,paladin,retribution,48,27,21
29186,Albïreo,drakkari,1550,paladin,retribution,54,28,26
29187,Detrimentãl,nagrand,1550,paladin,retribution,69,33,36
29188,Holyjoint,uther,1550,paladin,retribution,98,42,56
29189,Souyiro,sargeras,1550,paladin,retribution,64,23,41
29190,Mcholy,thrall,1549,paladin,retribution,50,27,23
29191,Eustace,thunderhorn,1549,paladin,retribution,58,31,27
29192,Zalndraeda,barthilas,1548,paladin,retribution,108,55,53
29193,Caribourider,tichondrius,1548,paladin,retribution,65,29,36
29194,Scrubble,thrall,1547,paladin,retribution,90,44,46
29195,Evilmerdoc,kelthuzad,1547,paladin,retribution,54,26,28
29196,Redemptiøn,nemesis,1547,paladin,retribution,66,26,40
29197,Sozmsjackson,barthilas,1546,paladin,retribution,51,28,23
29198,Alpengeist,turalyon,1546,paladin,retribution,60,29,31
29199,Dgâza,tichondrius,1546,paladin,retribution,48,23,25
29200,Lagwat,sargeras,1545,paladin,retribution,60,37,23
29201,Sweetcandy,sargeras,1545,paladin,retribution,54,28,26
29202,Varlip,wyrmrest-accord,1545,paladin,retribution,53,18,35
29203,Lorienv,sargeras,1544,paladin,retribution,36,17,19
29204,Cloaxy,azgalor,1543,paladin,retribution,181,86,95
29205,Margit,moon-guard,1541,paladin,retribution,36,22,14
29206,Björñ,moon-guard,1541,paladin,retribution,52,29,23
29207,Thaldun,wyrmrest-accord,1541,paladin,retribution,95,41,54
29208,Ðoflamingo,area-52,1540,paladin,retribution,72,38,34
29209,Quadrifoglio,moon-guard,1540,paladin,retribution,138,70,68
29210,Lygophobia,frostmourne,1539,paladin,retribution,42,22,20
29211,Brokeniron,wyrmrest-accord,1539,paladin,retribution,66,31,35
29212,Excalibur,amanthul,1539,paladin,retribution,43,19,24
29213,Frùglé,sargeras,1538,paladin,retribution,36,20,16
29214,Celethor,wyrmrest-accord,1537,paladin,retribution,54,30,24
29215,Tìg,proudmoore,1537,paladin,retribution,143,79,64
29216,Thepinkdept,proudmoore,1537,paladin,retribution,38,20,18
29217,Neovincent,aggramar,1536,paladin,retribution,69,37,32
29218,Aberpal,illidan,1535,paladin,retribution,41,23,18
29219,Freddieroach,tichondrius,1535,paladin,retribution,72,33,39
29220,Greciâ,ragnaros,1535,paladin,retribution,42,18,24
29221,Hammrekt,sargeras,1534,paladin,retribution,24,16,8
29222,Tearet,tichondrius,1534,paladin,retribution,24,16,8
29223,Tæven,tichondrius,1534,paladin,retribution,36,16,20
29224,Álkair,ragnaros,1534,paladin,retribution,83,36,47
29225,Rxes,frostmourne,1534,paladin,retribution,105,45,60
29226,Stônemôuntan,moon-guard,1534,paladin,retribution,84,29,55
29227,Jager,medivh,1533,paladin,retribution,71,41,30
29228,Cókelol,zuljin,1533,paladin,retribution,84,46,38
29229,Snussp,emerald-dream,1533,paladin,retribution,75,38,37
29230,Minidin,kiljaeden,1533,paladin,retribution,120,55,65
29231,Retcuzyaknow,illidan,1533,paladin,retribution,36,16,20
29232,Atterz,azralon,1532,paladin,retribution,46,21,25
29233,Kattkaffe,tichondrius,1531,paladin,retribution,30,16,14
29234,Yiqieyouwei,proudmoore,1531,paladin,retribution,55,25,30
29235,Ezcoatl,stormrage,1530,paladin,retribution,92,47,45
29236,Loyality,sargeras,1530,paladin,retribution,36,16,20
29237,Schankyy,stormrage,1529,paladin,retribution,36,19,17
29238,Unfairness,skullcrusher,1528,paladin,retribution,63,33,30
29239,Ástridr,moon-guard,1528,paladin,retribution,95,43,52
29240,Prettycure,illidan,1528,paladin,retribution,36,16,20
29241,Ezpzxd,arygos,1527,paladin,retribution,116,58,58
29242,Mundomaloo,quelthalas,1527,paladin,retribution,45,21,24
29243,Hefaista,ragnaros,1527,paladin,retribution,42,16,26
29244,Muffinknight,quelthalas,1526,paladin,retribution,66,44,22
29245,Oneshotman,stormrage,1526,paladin,retribution,30,16,14
29246,Kenpachí,doomhammer,1525,paladin,retribution,42,30,12
29247,Venxpeita,azralon,1525,paladin,retribution,24,16,8
29248,Swiftyflower,dawnbringer,1525,paladin,retribution,24,16,8
29249,Tinymeatgang,misha,1524,paladin,retribution,36,19,17
29250,Freiermoth,shadowmoon,1524,paladin,retribution,195,101,94
29251,Holybirkkal,arthas,1524,paladin,retribution,56,29,27
29252,Aoishie,bleeding-hollow,1524,paladin,retribution,108,54,54
29253,Shaidd,bleeding-hollow,1524,paladin,retribution,98,49,49
29254,Flykzu,azralon,1524,paladin,retribution,166,76,90
29255,Jizii,tichondrius,1523,paladin,retribution,78,44,34
29256,Xandia,aegwynn,1523,paladin,retribution,48,16,32
29257,Holyshockss,stormrage,1522,paladin,retribution,30,16,14
29258,Blitzzed,area-52,1522,paladin,retribution,35,18,17
29259,Alacrity,shadowsong,1522,paladin,retribution,39,20,19
29260,Dragin,azralon,1522,paladin,retribution,71,36,35
29261,Landeren,khazgoroth,1522,paladin,retribution,66,29,37
29262,Pvrisxx,frostmourne,1521,paladin,retribution,60,31,29
29263,Whackadin,illidan,1521,paladin,retribution,67,32,35
29264,Whitearmor,draenor,1520,paladin,retribution,69,41,28
29265,Moutai,dalaran,1519,paladin,retribution,83,42,41
29266,Castïël,area-52,1519,paladin,retribution,157,77,80
29267,Andallar,nordrassil,1518,paladin,retribution,60,34,26
29268,Gude,sargeras,1518,paladin,retribution,30,16,14
29269,Shartea,moon-guard,1518,paladin,retribution,64,32,32
29270,Reesescupz,kelthuzad,1518,paladin,retribution,66,26,40
29271,Grubbyhands,tichondrius,1518,paladin,retribution,42,16,26
29272,Worshipmex,tichondrius,1517,paladin,retribution,36,20,16
29273,Relentless,magtheridon,1517,paladin,retribution,107,54,53
29274,Arreliya,sargeras,1517,paladin,retribution,100,49,51
29275,Lorenzinho,azralon,1516,paladin,retribution,80,42,38
29276,Dzx,nemesis,1516,paladin,retribution,347,179,168
29277,Sacredstella,illidan,1516,paladin,retribution,142,72,70
29278,Soterios,daggerspine,1516,paladin,retribution,72,33,39
29279,Sorhihi,illidan,1515,paladin,retribution,36,19,17
29280,Ignasius,blood-furnace,1515,paladin,retribution,54,26,28
29281,Gronmpa,nemesis,1514,paladin,retribution,41,25,16
29282,Sephiroth,hyjal,1514,paladin,retribution,86,40,46
29283,Kendren,ragnaros,1514,paladin,retribution,36,16,20
29284,Bøble,thrall,1514,paladin,retribution,42,16,26
29285,Luminainre,zuljin,1513,paladin,retribution,39,19,20
29286,Rëtribution,tichondrius,1513,paladin,retribution,80,36,44
29287,Howlerhead,illidan,1512,paladin,retribution,30,16,14
29288,Kawkpaladin,kaelthas,1512,paladin,retribution,60,31,29
29289,Bladetm,proudmoore,1512,paladin,retribution,119,59,60
29290,Tagex,malganis,1511,paladin,retribution,161,75,86
29291,Paradisso,tichondrius,1511,paladin,retribution,36,16,20
29292,Guluge,sargeras,1510,paladin,retribution,24,16,8
29293,Thazadin,barthilas,1510,paladin,retribution,28,17,11
29294,Dachenkov,tichondrius,1510,paladin,retribution,30,17,13
29295,Skuxxlord,khazgoroth,1509,paladin,retribution,30,16,14
29296,Kaupe,barthilas,1509,paladin,retribution,41,16,25
29297,Protein,magtheridon,1509,paladin,retribution,42,16,26
29298,Mysticblade,sargeras,1508,paladin,retribution,54,31,23
29299,Smashnasty,area-52,1508,paladin,retribution,48,27,21
29300,Temote,anvilmar,1508,paladin,retribution,132,66,66
29301,Jøestar,proudmoore,1508,paladin,retribution,82,39,43
29302,Cyreus,emerald-dream,1508,paladin,retribution,57,26,31
29303,Snoogans,korgath,1508,paladin,retribution,36,16,20
29304,Miemiesage,illidan,1508,paladin,retribution,42,16,26
29305,Sowasred,emerald-dream,1507,paladin,retribution,84,45,39
29306,Xytoken,tichondrius,1507,paladin,retribution,77,38,39
29307,Liquidkoala,lightbringer,1507,paladin,retribution,58,28,30
29308,Yazuka,wyrmrest-accord,1506,paladin,retribution,54,30,24
29309,Traditionalp,area-52,1506,paladin,retribution,39,21,18
29310,Rethöe,tichondrius,1506,paladin,retribution,30,16,14
29311,Istril,ragnaros,1506,paladin,retribution,292,152,140
29312,Preacherfudd,area-52,1506,paladin,retribution,42,21,21
29313,Bojanglz,frostmourne,1504,paladin,retribution,39,21,18
29314,Cobaine,illidan,1504,paladin,retribution,131,62,69
29315,Piea,tichondrius,1503,paladin,retribution,66,32,34
29316,Eskannór,quelthalas,1502,paladin,retribution,42,18,24
29317,Alphanerd,burning-blade,1501,paladin,retribution,42,26,16
29318,Rohrn,firetree,1501,paladin,retribution,61,35,26
29319,Donao,illidan,1501,paladin,retribution,90,50,40
29320,Lichkingdenn,stormrage,1501,paladin,retribution,54,26,28
29321,Mesaa,illidan,1501,paladin,retribution,39,18,21
29322,Notae,alexstrasza,1501,paladin,retribution,35,16,19
29323,Ezael,crushridge,1501,paladin,retribution,48,21,27
29324,Rillumas,wyrmrest-accord,1501,paladin,retribution,71,30,41
29325,Wickedpälly,kelthuzad,1499,paladin,retribution,42,25,17
29326,Norlannd,ragnaros,1499,paladin,retribution,30,16,14
29327,Morneau,malganis,1499,paladin,retribution,258,132,126
29328,Kookamønga,tichondrius,1498,paladin,retribution,67,32,35
29329,Mordered,proudmoore,1498,paladin,retribution,70,27,43
29330,Hinataa,illidan,1497,paladin,retribution,81,45,36
29331,Audris,chogall,1497,paladin,retribution,65,29,36
29332,Snuggymuffin,barthilas,1496,paladin,retribution,46,27,19
29333,Plusultra,moon-guard,1495,paladin,retribution,48,24,24
29334,Superpaladin,stormrage,1495,paladin,retribution,65,32,33
29335,Schwârts,blackrock,1494,paladin,retribution,70,36,34
29336,Sprinkills,frostmourne,1493,paladin,retribution,48,31,17
29337,Narsys,tichondrius,1493,paladin,retribution,109,50,59
29338,ßabyshark,tichondrius,1493,paladin,retribution,36,16,20
29339,Dartpuncher,frostmourne,1492,paladin,retribution,33,19,14
29340,Upaitaon,stormrage,1491,paladin,retribution,58,29,29
29341,Xdiegox,stormrage,1491,paladin,retribution,36,16,20
29342,Týrael,uldum,1490,paladin,retribution,60,33,27
29343,Sàgadegemeós,stormrage,1489,paladin,retribution,60,32,28
29344,Kemono,dathremar,1488,paladin,retribution,73,42,31
29345,Mathieü,zuljin,1488,paladin,retribution,36,20,16
29346,Shishoknight,quelthalas,1488,paladin,retribution,73,32,41
29347,Grîshnâkh,ragnaros,1487,paladin,retribution,119,61,58
29348,Operise,stormrage,1487,paladin,retribution,48,24,24
29349,Xk,kiljaeden,1487,paladin,retribution,72,33,39
29350,Avvenging,tichondrius,1487,paladin,retribution,36,16,20
29351,Balín,quelthalas,1486,paladin,retribution,25,18,7
29352,Exwars,moon-guard,1485,paladin,retribution,32,21,11
29353,Urpi,drakkari,1485,paladin,retribution,41,25,16
29354,Whets,thrall,1485,paladin,retribution,96,48,48
29355,Sancthia,area-52,1485,paladin,retribution,47,22,25
29356,Haunter,akama,1485,paladin,retribution,54,25,29
29357,Dcountt,area-52,1484,paladin,retribution,47,22,25
29358,Wwanntae,tichondrius,1484,paladin,retribution,70,32,38
29359,Kadbury,icecrown,1484,paladin,retribution,221,101,120
29360,Natsîrt,bleeding-hollow,1483,paladin,retribution,46,27,19
29361,Imhardirl,area-52,1483,paladin,retribution,29,17,12
29362,Levian,spirestone,1483,paladin,retribution,90,46,44
29363,Greasysteve,stormrage,1482,paladin,retribution,60,33,27
29364,Janokaluo,wyrmrest-accord,1481,paladin,retribution,101,52,49
29365,Orestis,stormrage,1480,paladin,retribution,45,24,21
29366,Ralo,khaz-modan,1480,paladin,retribution,30,16,14
29367,Cillessá,kelthuzad,1480,paladin,retribution,132,65,67
29368,Forlam,sargeras,1480,paladin,retribution,108,45,63
29369,Cålamìty,dalaran,1478,paladin,retribution,24,16,8
29370,Imperious,anetheron,1478,paladin,retribution,60,34,26
29371,Viclovin,stormrage,1478,paladin,retribution,58,30,28
29372,Vaqoh,ragnaros,1478,paladin,retribution,42,17,25
29373,Buddyolpally,proudmoore,1477,paladin,retribution,48,23,25
29374,Killeralan,quelthalas,1477,paladin,retribution,74,34,40
29375,Againstfilet,azralon,1477,paladin,retribution,106,43,63
29376,Malandru,darrowmere,1477,paladin,retribution,93,37,56
29377,Konthrus,azralon,1476,paladin,retribution,99,60,39
29378,Airz,stormrage,1476,paladin,retribution,30,17,13
29379,Giulio,moon-guard,1476,paladin,retribution,113,62,51
29380,Limitier,proudmoore,1476,paladin,retribution,36,19,17
29381,Bigpin,shattered-hand,1476,paladin,retribution,53,24,29
29382,Pugnosano,black-dragonflight,1475,paladin,retribution,42,21,21
29383,Holydiver,sargeras,1475,paladin,retribution,158,75,83
29384,Kiritazuma,ravencrest,1475,paladin,retribution,84,39,45
29385,Azoruken,quelthalas,1475,paladin,retribution,71,31,40
29386,Arecht,moon-guard,1474,paladin,retribution,30,19,11
29387,Gigadorff,stormrage,1474,paladin,retribution,60,37,23
29388,Yamush,silver-hand,1474,paladin,retribution,80,40,40
29389,Bubblless,thrall,1474,paladin,retribution,59,27,32
29390,Sunraiz,tichondrius,1473,paladin,retribution,46,26,20
29391,Fressbee,nathrezim,1473,paladin,retribution,41,19,22
29392,Ichigò,sargeras,1472,paladin,retribution,48,30,18
29393,Blulux,ragnaros,1472,paladin,retribution,101,55,46
29394,Zuthora,alleria,1471,paladin,retribution,70,37,33
29395,Ellanaria,thrall,1471,paladin,retribution,117,61,56
29396,Yoboyindahiz,stormrage,1471,paladin,retribution,57,23,34
29397,Rykorth,moon-guard,1470,paladin,retribution,33,20,13
29398,Yawnbringer,tichondrius,1469,paladin,retribution,140,70,70
29399,Mäýhëm,sargeras,1468,paladin,retribution,46,25,21
29400,Reînhard,drakkari,1468,paladin,retribution,42,19,23
29401,Polypal,zuljin,1468,paladin,retribution,42,18,24
29402,Dimmadome,frostmourne,1465,paladin,retribution,78,50,28
29403,Kanyewes,zuluhed,1465,paladin,retribution,71,35,36
29404,Édzor,area-52,1465,paladin,retribution,48,19,29
29405,Nicret,tichondrius,1464,paladin,retribution,24,18,6
29406,Trapqueenlol,alterac-mountains,1464,paladin,retribution,66,27,39
29407,Strabic,stormrage,1464,paladin,retribution,57,23,34
29408,Toughlife,tichondrius,1464,paladin,retribution,72,28,44
29409,Nohpalli,kelthuzad,1463,paladin,retribution,79,43,36
29410,Bañe,lightbringer,1463,paladin,retribution,81,35,46
29411,Bronytime,illidan,1462,paladin,retribution,29,16,13
29412,Dreyan,wyrmrest-accord,1462,paladin,retribution,47,23,24
29413,Sakicc,dalaran,1462,paladin,retribution,48,21,27
29414,Són,ragnaros,1462,paladin,retribution,52,21,31
29415,Sanguinata,shadowsong,1461,paladin,retribution,47,30,17
29416,Crayt,tichondrius,1461,paladin,retribution,97,40,57
29417,Konarik,stormrage,1459,paladin,retribution,46,25,21
29418,Biloro,azralon,1458,paladin,retribution,54,33,21
29419,Ereksean,sargeras,1458,paladin,retribution,50,26,24
29420,Athenauwu,illidan,1458,paladin,retribution,40,19,21
29421,Modafinil,bonechewer,1458,paladin,retribution,55,24,31
29422,Dannyram,zuljin,1457,paladin,retribution,75,40,35
29423,Bebopin,tichondrius,1457,paladin,retribution,58,29,29
29424,Valardaharis,thunderlord,1457,paladin,retribution,100,43,57
29425,Theholysword,tichondrius,1457,paladin,retribution,41,16,25
29426,Dentarg,garrosh,1456,paladin,retribution,66,35,31
29427,Erowyn,tichondrius,1456,paladin,retribution,42,19,23
29428,Vindictacho,tichondrius,1456,paladin,retribution,42,18,24
29429,Esixtytwoone,area-52,1455,paladin,retribution,30,21,9
29430,Krypton,tichondrius,1455,paladin,retribution,36,22,14
29431,Lettuceprey,the-underbog,1455,paladin,retribution,60,33,27
29432,Silvabac,illidan,1455,paladin,retribution,70,38,32
29433,Folgimar,moon-guard,1455,paladin,retribution,72,37,35
29434,Thalorian,azshara,1455,paladin,retribution,51,25,26
29435,Cryptdog,illidan,1455,paladin,retribution,87,40,47
29436,Astharor,stormrage,1454,paladin,retribution,70,40,30
29437,Layoya,aerie-peak,1454,paladin,retribution,34,19,15
29438,Mádz,ragnaros,1454,paladin,retribution,29,16,13
29439,Jorix,stormrage,1454,paladin,retribution,33,17,16
29440,Wesdarian,jaedenar,1454,paladin,retribution,119,56,63
29441,Urfavxbf,baelgun,1453,paladin,retribution,175,94,81
29442,Quotation,silvermoon,1453,paladin,retribution,56,30,26
29443,Sovereignt,aggramar,1453,paladin,retribution,157,84,73
29444,Monchy,bleeding-hollow,1453,paladin,retribution,52,27,25
29445,Carnagias,bleeding-hollow,1452,paladin,retribution,95,50,45
29446,Vexxa,nerzhul,1451,paladin,retribution,36,18,18
29447,Tacien,tichondrius,1451,paladin,retribution,112,54,58
29448,Saphiraz,wildhammer,1451,paladin,retribution,42,17,25
29449,Cyäbyë,frostmourne,1450,paladin,retribution,30,18,12
29450,Drtom,mannoroth,1450,paladin,retribution,39,21,18
29451,Hammerzite,whisperwind,1450,paladin,retribution,30,16,14
29452,Liaadrin,azralon,1450,paladin,retribution,32,16,16
29453,Gokuu,korgath,1450,paladin,retribution,90,44,46
29454,Solandiis,tichondrius,1450,paladin,retribution,67,32,35
29455,Prosykt,sargeras,1450,paladin,retribution,38,16,22
29456,Airplane,malygos,1449,paladin,retribution,24,16,8
29457,Jonfox,stormrage,1449,paladin,retribution,108,54,54
29458,Shourins,tichondrius,1449,paladin,retribution,36,17,19
29459,Lustros,stormrage,1449,paladin,retribution,66,28,38
29460,Avati,sargeras,1448,paladin,retribution,22,16,6
29461,Californía,bleeding-hollow,1448,paladin,retribution,37,23,14
29462,Corrán,thrall,1448,paladin,retribution,36,20,16
29463,Sconci,whisperwind,1448,paladin,retribution,48,22,26
29464,Hamertime,wyrmrest-accord,1447,paladin,retribution,125,62,63
29465,Bullzor,aerie-peak,1445,paladin,retribution,66,43,23
29466,Glizzybertz,bleeding-hollow,1445,paladin,retribution,36,21,15
29467,Angriel,azralon,1445,paladin,retribution,83,38,45
29468,Smallhammer,aegwynn,1444,paladin,retribution,102,45,57
29469,Lestaroth,goldrinn,1444,paladin,retribution,48,16,32
29470,Justicierø,aegwynn,1443,paladin,retribution,58,30,28
29471,Iluminadoor,nemesis,1442,paladin,retribution,29,19,10
29472,Ogholyhands,bleeding-hollow,1442,paladin,retribution,65,34,31
29473,Procs,hyjal,1441,paladin,retribution,48,34,14
29474,Pijbins,moon-guard,1441,paladin,retribution,74,37,37
29475,Antarcticala,frostmourne,1441,paladin,retribution,54,24,30
29476,Inquisídor,nemesis,1440,paladin,retribution,30,17,13
29477,Charleyy,stormscale,1440,paladin,retribution,90,50,40
29478,Rusinator,bonechewer,1440,paladin,retribution,53,27,26
29479,Taeret,tichondrius,1439,paladin,retribution,24,15,9
29480,Awake,chogall,1439,paladin,retribution,24,15,9
29481,Oldsixqs,illidan,1439,paladin,retribution,32,17,15
29482,Kkgame,tichondrius,1439,paladin,retribution,37,19,18
29483,Ozirus,frostmourne,1439,paladin,retribution,56,25,31
29484,Crazymikey,bleeding-hollow,1439,paladin,retribution,42,15,27
29485,Bigdaddypuff,cenarius,1438,paladin,retribution,30,15,15
29486,Thragar,stormrage,1438,paladin,retribution,30,15,15
29487,Holyskeeter,thunderhorn,1438,paladin,retribution,49,20,29
29488,Getdiswork,malygos,1437,paladin,retribution,108,52,56
29489,Dawncröwn,stormrage,1437,paladin,retribution,65,22,43
29490,Cesah,tichondrius,1436,paladin,retribution,24,15,9
29491,Hokkan,quelthalas,1436,paladin,retribution,59,33,26
29492,Xalø,ragnaros,1435,paladin,retribution,24,15,9
29493,Kêrmit,zuljin,1435,paladin,retribution,43,26,17
29494,Zolktro,stormrage,1435,paladin,retribution,52,27,25
29495,Qunima,tichondrius,1435,paladin,retribution,30,15,15
29496,Warmpôcket,proudmoore,1435,paladin,retribution,66,26,40
29497,Devvn,laughing-skull,1434,paladin,retribution,24,15,9
29498,Lumíty,sargeras,1434,paladin,retribution,137,70,67
29499,Bilbain,proudmoore,1434,paladin,retribution,225,114,111
29500,Gimli,mannoroth,1434,paladin,retribution,36,15,21
29501,Mgjun,ragnaros,1433,paladin,retribution,36,18,18
29502,Badbad,icecrown,1433,paladin,retribution,30,15,15
29503,Bloodrefuge,tichondrius,1433,paladin,retribution,30,15,15
29504,Jianwen,kargath,1433,paladin,retribution,30,15,15
29505,Internadi,frostmourne,1433,paladin,retribution,42,20,22
29506,Gummybearz,doomhammer,1433,paladin,retribution,48,20,28
29507,Inexcusable,wyrmrest-accord,1432,paladin,retribution,41,22,19
29508,Onitenshi,stormscale,1432,paladin,retribution,85,41,44
29509,Hatchet,skullcrusher,1431,paladin,retribution,30,15,15
29510,Perzeføne,quelthalas,1431,paladin,retribution,41,20,21
29511,Acallysta,moon-guard,1431,paladin,retribution,54,26,28
29512,Gogofisco,moonrunner,1431,paladin,retribution,48,19,29
29513,Richiggaa,illidan,1430,paladin,retribution,47,29,18
29514,Aztraseneco,ragnaros,1430,paladin,retribution,104,59,45
29515,Lmd,tichondrius,1430,paladin,retribution,66,35,31
29516,Bapped,dalaran,1430,paladin,retribution,60,26,34
29517,Supercharged,area-52,1429,paladin,retribution,30,15,15
29518,Gorriuke,wyrmrest-accord,1428,paladin,retribution,30,18,12
29519,Falaran,azralon,1428,paladin,retribution,62,32,30
29520,Alexandros,nordrassil,1428,paladin,retribution,30,15,15
29521,Alequin,stormrage,1428,paladin,retribution,30,15,15
29522,Artherion,kelthuzad,1428,paladin,retribution,87,35,52
29523,Hrrothgar,muradin,1427,paladin,retribution,48,26,22
29524,Murtag,bloodscalp,1427,paladin,retribution,60,28,32
29525,Cammack,thrall,1427,paladin,retribution,93,39,54
29526,Demonissh,area-52,1427,paladin,retribution,42,15,27
29527,Mechelle,thrall,1426,paladin,retribution,128,71,57
29528,Talantyr,zuljin,1426,paladin,retribution,78,36,42
29529,Faowin,sargeras,1426,paladin,retribution,89,40,49
29530,Killmönger,tichondrius,1426,paladin,retribution,65,29,36
29531,Tribiani,lightbringer,1425,paladin,retribution,24,15,9
29532,Mathalt,area-52,1425,paladin,retribution,51,26,25
29533,Floquiinhos,azralon,1425,paladin,retribution,36,15,21
29534,Âllmíght,quelthalas,1424,paladin,retribution,24,15,9
29535,Miguepally,ragnaros,1424,paladin,retribution,59,25,34
29536,Tekar,altar-of-storms,1424,paladin,retribution,42,17,25
29537,Gànnicus,korgath,1422,paladin,retribution,36,15,21
29538,Pallyseeker,thrall,1420,paladin,retribution,24,15,9
29539,Rafaela,alterac-mountains,1420,paladin,retribution,30,17,13
29540,Arahann,bleeding-hollow,1420,paladin,retribution,29,16,13
29541,Boozier,ragnaros,1420,paladin,retribution,30,16,14
29542,Palpinga,kelthuzad,1420,paladin,retribution,44,18,26
29543,Tåine,suramar,1420,paladin,retribution,48,16,32
29544,Burstpink,zuljin,1419,paladin,retribution,28,17,11
29545,Elri,ragnaros,1418,paladin,retribution,42,25,17
29546,Cuffaladin,fenris,1418,paladin,retribution,54,30,24
29547,Emethala,windrunner,1418,paladin,retribution,42,23,19
29548,Holyshôckz,stormrage,1418,paladin,retribution,86,47,39
29549,Annhette,sargeras,1418,paladin,retribution,31,15,16
29550,Velyssatha,moon-guard,1418,paladin,retribution,56,26,30
29551,Nocomus,andorhal,1418,paladin,retribution,78,35,43
29552,Lolslikeomg,malganis,1418,paladin,retribution,102,42,60
29553,Galanblack,dalaran,1417,paladin,retribution,56,31,25
29554,Blackop,gallywix,1417,paladin,retribution,30,16,14
29555,Napstër,ragnaros,1417,paladin,retribution,36,15,21
29556,Lyricism,tichondrius,1416,paladin,retribution,49,28,21
29557,Wagyou,skywall,1416,paladin,retribution,30,15,15
29558,Jaikerino,emerald-dream,1416,paladin,retribution,42,15,27
29559,Balrok,cenarius,1415,paladin,retribution,185,93,92
29560,Mitchyc,stormrage,1415,paladin,retribution,90,45,45
29561,Hdmi,darkspear,1415,paladin,retribution,41,20,21
29562,Andrinn,nemesis,1415,paladin,retribution,51,24,27
29563,Minzyy,frostmourne,1414,paladin,retribution,24,15,9
29564,Savagedemise,barthilas,1413,paladin,retribution,55,28,27
29565,Hägär,tichondrius,1413,paladin,retribution,67,27,40
29566,Jursch,emerald-dream,1412,paladin,retribution,175,88,87
29567,Rhoche,ysera,1412,paladin,retribution,36,17,19
29568,Oppression,kul-tiras,1412,paladin,retribution,77,29,48
29569,Andrevz,ragnaros,1411,paladin,retribution,78,44,34
29570,Jagehbombs,tichondrius,1411,paladin,retribution,60,31,29
29571,Sote,lightnings-blade,1410,paladin,retribution,45,22,23
29572,Lusangri,thrall,1410,paladin,retribution,45,17,28
29573,Hasla,tichondrius,1410,paladin,retribution,51,19,32
29574,Releváncé,barthilas,1409,paladin,retribution,66,31,35
29575,Vasharien,nerzhul,1409,paladin,retribution,86,39,47
29576,Willzaum,azralon,1408,paladin,retribution,30,19,11
29577,Kalboko,twisting-nether,1408,paladin,retribution,45,23,22
29578,Anivan,moon-guard,1408,paladin,retribution,60,27,33
29579,Reìarthur,stormrage,1408,paladin,retribution,72,32,40
29580,Søøka,azralon,1408,paladin,retribution,84,36,48
29581,Uholypala,dalaran,1408,paladin,retribution,78,33,45
29582,Kulandis,stormrage,1408,paladin,retribution,57,24,33
29583,Modjytech,tichondrius,1408,paladin,retribution,83,32,51
29584,Industry,firetree,1407,paladin,retribution,33,18,15
29585,Milke,chogall,1407,paladin,retribution,36,17,19
29586,Tooholy,kiljaeden,1406,paladin,retribution,87,54,33
29587,Peil,illidan,1406,paladin,retribution,36,15,21
29588,Sophany,shattered-halls,1405,paladin,retribution,40,26,14
29589,Szeq,tichondrius,1405,paladin,retribution,32,16,16
29590,Øxøxø,emerald-dream,1404,paladin,retribution,96,52,44
29591,Outlivz,hyjal,1404,paladin,retribution,33,17,16
29592,Chandlerrj,area-52,1404,paladin,retribution,42,21,21
29593,Gstbubble,hyjal,1404,paladin,retribution,36,15,21
29594,Mhelyssa,goldrinn,1403,paladin,retribution,24,15,9
29595,Zimzob,stormscale,1403,paladin,retribution,30,15,15
29596,Brenaluna,tichondrius,1403,paladin,retribution,55,24,31
29597,Swietomierz,proudmoore,1403,paladin,retribution,48,20,28
29598,Keltec,bonechewer,1403,paladin,retribution,61,25,36
29599,Holyginger,barthilas,1402,paladin,retribution,41,23,18
29600,Pvppaulx,moon-guard,1401,paladin,retribution,71,37,34
29601,Oschy,moon-guard,1401,paladin,retribution,101,51,50
29602,Sellenagomez,malganis,1401,paladin,retribution,60,29,31
29603,Wésters,quelthalas,1401,paladin,retribution,163,77,86
29604,Jdgmnt,sargeras,1401,paladin,retribution,72,33,39
29605,Véxv,emerald-dream,1401,paladin,retribution,92,36,56
29606,Salaminhoo,azralon,1400,paladin,retribution,30,19,11
29607,Eamon,kelthuzad,1400,paladin,retribution,29,15,14
29608,Rasc,barthilas,1400,paladin,retribution,103,48,55
29609,Dorzwaz,draka,1399,paladin,retribution,30,20,10
29610,Palabing,stormrage,1399,paladin,retribution,24,15,9
29611,Holyham,fizzcrank,1398,paladin,retribution,48,27,21
29612,Dfbattlepass,kelthuzad,1397,paladin,retribution,91,49,42
29613,Chuckman,skullcrusher,1397,paladin,retribution,30,16,14
29614,Uxd,tichondrius,1397,paladin,retribution,55,25,30
29615,Messeb,veknilash,1396,paladin,retribution,151,82,69
29616,Pathed,aerie-peak,1396,paladin,retribution,32,16,16
29617,Theretpally,kelthuzad,1396,paladin,retribution,60,28,32
29618,Emmastoned,bleeding-hollow,1396,paladin,retribution,84,39,45
29619,Dalgren,quelthalas,1396,paladin,retribution,105,39,66
29620,Ktwocrank,dalaran,1395,paladin,retribution,43,16,27
29621,Rhodius,dalaran,1393,paladin,retribution,42,23,19
29622,Tmac,azralon,1393,paladin,retribution,68,35,33
29623,Tsunin,area-52,1393,paladin,retribution,94,46,48
29624,Belregn,illidan,1393,paladin,retribution,78,36,42
29625,Taîno,thrall,1391,paladin,retribution,150,80,70
29626,Sthrealys,quelthalas,1391,paladin,retribution,30,16,14
29627,Shlaps,crushridge,1391,paladin,retribution,84,41,43
29628,Judgmentor,malganis,1391,paladin,retribution,82,34,48
29629,Droden,tichondrius,1390,paladin,retribution,55,29,26
29630,Schalpy,illidan,1388,paladin,retribution,60,28,32
29631,Miitt,blackrock,1387,paladin,retribution,36,20,16
29632,Slowedreverb,stormrage,1387,paladin,retribution,81,42,39
29633,Granisdh,aegwynn,1387,paladin,retribution,54,27,27
29634,Pallytoot,aerie-peak,1386,paladin,retribution,60,35,25
29635,Egufro,frostwolf,1386,paladin,retribution,66,36,30
29636,Valikyr,mugthol,1386,paladin,retribution,36,18,18
29637,Puresight,kelthuzad,1385,paladin,retribution,54,27,27
29638,Simplesam,draenor,1385,paladin,retribution,36,15,21
29639,Belgrieve,proudmoore,1384,paladin,retribution,48,22,26
29640,Onnakishi,azralon,1383,paladin,retribution,36,15,21
29641,Deafheavens,moon-guard,1381,paladin,retribution,30,15,15
29642,Zadragon,sargeras,1381,paladin,retribution,66,31,35
29643,Luðo,moon-guard,1380,paladin,retribution,35,15,20
29644,Blindburn,ragnaros,1379,paladin,retribution,36,17,19
29645,Elsinore,senjin,1377,paladin,retribution,35,19,16
29646,Kaelthasar,azralon,1376,paladin,retribution,30,15,15
29647,Maphisto,stormscale,1375,paladin,retribution,42,30,12
29648,Lebowski,nordrassil,1375,paladin,retribution,66,31,35
29649,Gorostas,kelthuzad,1375,paladin,retribution,34,15,19
29650,Delanadras,kelthuzad,1375,paladin,retribution,47,19,28
29651,Cyniaria,moon-guard,1374,paladin,retribution,114,57,57
29652,Stdee,zuljin,1372,paladin,retribution,63,33,30
29653,Adrockiller,quelthalas,1372,paladin,retribution,68,34,34
29654,Pallynation,korgath,1372,paladin,retribution,36,17,19
29655,Auka,zuljin,1371,paladin,retribution,36,18,18
29656,Lornd,quelthalas,1371,paladin,retribution,30,15,15
29657,Dawsonthebos,grizzly-hills,1370,paladin,retribution,30,16,14
29658,Yukiikaze,sargeras,1370,paladin,retribution,46,23,23
29659,Superzooted,sargeras,1370,paladin,retribution,34,15,19
29660,Sona,jubeithos,1370,paladin,retribution,42,18,24
29661,Hurrîcane,illidan,1370,paladin,retribution,48,15,33
29662,Holyrump,bleeding-hollow,1369,paladin,retribution,27,16,11
29663,Minitas,blackrock,1369,paladin,retribution,42,15,27
29664,Jxo,tichondrius,1368,paladin,retribution,30,17,13
29665,Kellissandra,aerie-peak,1368,paladin,retribution,84,34,50
29666,Vaelinarys,ragnaros,1366,paladin,retribution,30,20,10
29667,Ruinlite,emerald-dream,1366,paladin,retribution,48,30,18
29668,Tøpbløke,frostmourne,1366,paladin,retribution,121,60,61
29669,Scubàlicous,magtheridon,1366,paladin,retribution,42,19,23
29670,Eutectic,moon-guard,1366,paladin,retribution,36,15,21
29671,Hurukpaly,azralon,1365,paladin,retribution,52,23,29
29672,Heraolympian,black-dragonflight,1364,paladin,retribution,57,32,25
29673,Áthz,ragnaros,1363,paladin,retribution,41,21,20
29674,Nest,stormrage,1363,paladin,retribution,30,15,15
29675,Hùck,alexstrasza,1363,paladin,retribution,110,51,59
29676,Psadin,thunderlord,1363,paladin,retribution,60,25,35
29677,Alvick,icecrown,1363,paladin,retribution,39,16,23
29678,Äeriah,fizzcrank,1362,paladin,retribution,84,43,41
29679,Öpäf,steamwheedle-cartel,1362,paladin,retribution,55,23,32
29680,Arlizu,quelthalas,1361,paladin,retribution,35,17,18
29681,Ðetroity,stormrage,1359,paladin,retribution,105,57,48
29682,Pal,blackhand,1359,paladin,retribution,44,23,21
29683,Kalendawn,moon-guard,1358,paladin,retribution,76,43,33
29684,Xoxoxoxoxoxo,aegwynn,1357,paladin,retribution,48,23,25
29685,Lightcast,moon-guard,1357,paladin,retribution,72,34,38
29686,Nerilliah,sargeras,1357,paladin,retribution,33,15,18
29687,Pàladwarf,stormrage,1357,paladin,retribution,81,36,45
29688,Mareaaturbo,azralon,1356,paladin,retribution,53,30,23
29689,Wickedwingz,sargeras,1356,paladin,retribution,30,15,15
29690,Mïkhael,nemesis,1356,paladin,retribution,86,37,49
29691,Arbarrus,stormrage,1354,paladin,retribution,31,19,12
29692,Cinacalcet,dalaran,1354,paladin,retribution,29,15,14
29693,Levarious,thunderlord,1354,paladin,retribution,126,62,64
29694,Theldart,ragnaros,1353,paladin,retribution,59,30,29
29695,Lunchhboxx,kelthuzad,1353,paladin,retribution,47,22,25
29696,Adapa,azralon,1353,paladin,retribution,36,16,20
29697,Hrizul,drakthul,1353,paladin,retribution,36,15,21
29698,Dwk,thrall,1353,paladin,retribution,36,15,21
29699,Andronik,bleeding-hollow,1352,paladin,retribution,33,16,17
29700,Warspyder,alterac-mountains,1351,paladin,retribution,48,28,20
29701,Aeroßlaze,dragonmaw,1351,paladin,retribution,36,18,18
29702,Dekho,quelthalas,1351,paladin,retribution,47,19,28
29703,Tlahtoani,illidan,1350,paladin,retribution,23,15,8
29704,Chinsta,zuljin,1349,paladin,retribution,36,22,14
29705,Zantdemption,frostmourne,1349,paladin,retribution,29,15,14
29706,Sländers,sargeras,1348,paladin,retribution,107,49,58
29707,Dwurim,moon-guard,1346,paladin,retribution,48,26,22
29708,Lashlan,barthilas,1345,paladin,retribution,38,24,14
29709,Ddeadwhisper,executus,1345,paladin,retribution,104,56,48
29710,Hazmât,illidan,1345,paladin,retribution,82,32,50
29711,Lightvader,illidan,1344,paladin,retribution,36,15,21
29712,Retman,azuremyst,1344,paladin,retribution,48,19,29
29713,Bossmin,tichondrius,1343,paladin,retribution,24,14,10
29714,Dyskrazia,thrall,1343,paladin,retribution,32,15,17
29715,Zugzugondeez,illidan,1343,paladin,retribution,30,14,16
29716,Dublek,tichondrius,1342,paladin,retribution,18,14,4
29717,Wrathofangus,nesingwary,1342,paladin,retribution,30,14,16
29718,Xygra,stormrage,1342,paladin,retribution,30,14,16
29719,Tævèn,tichondrius,1342,paladin,retribution,30,14,16
29720,Lawdeedawh,tichondrius,1342,paladin,retribution,30,14,16
29721,Kikazaru,moon-guard,1341,paladin,retribution,36,14,22
29722,Icepondpal,proudmoore,1340,paladin,retribution,24,16,8
29723,Retsonictwo,tichondrius,1340,paladin,retribution,30,14,16
29724,Samphlty,azralon,1340,paladin,retribution,30,14,16
29725,Bosutai,dalaran,1340,paladin,retribution,36,15,21
29726,Bubblestar,ragnaros,1340,paladin,retribution,56,23,33
29727,Minikalina,ragnaros,1339,paladin,retribution,24,14,10
29728,Hoodmeatflap,stonemaul,1339,paladin,retribution,30,17,13
29729,Pennedurma,akama,1339,paladin,retribution,46,24,22
29730,Bulioevn,emerald-dream,1339,paladin,retribution,51,24,27
29731,Aaralis,ragnaros,1339,paladin,retribution,30,14,16
29732,Arlleth,area-52,1339,paladin,retribution,42,19,23
29733,Solgrïm,wyrmrest-accord,1339,paladin,retribution,54,24,30
29734,Thadose,bonechewer,1338,paladin,retribution,195,108,87
29735,Neró,quelthalas,1338,paladin,retribution,61,28,33
29736,Healsonyou,windrunner,1338,paladin,retribution,36,14,22
29737,Amarnath,turalyon,1337,paladin,retribution,27,16,11
29738,Iceburg,shadowmoon,1337,paladin,retribution,30,17,13
29739,Redspine,azralon,1337,paladin,retribution,36,14,22
29740,Wlq,frostmourne,1336,paladin,retribution,71,29,42
29741,Nightz,eonar,1336,paladin,retribution,36,14,22
29742,Refulgent,moon-guard,1335,paladin,retribution,58,35,23
29743,Shecara,malygos,1335,paladin,retribution,72,40,32
29744,Avantasias,sargeras,1335,paladin,retribution,82,39,43
29745,Albagail,draka,1335,paladin,retribution,46,20,26
29746,Dogf,tichondrius,1335,paladin,retribution,47,14,33
29747,Prôphêt,stormrage,1334,paladin,retribution,18,14,4
29748,Justsmiteit,dalaran,1334,paladin,retribution,30,17,13
29749,Torvus,bonechewer,1334,paladin,retribution,34,15,19
29750,Flynnee,illidan,1334,paladin,retribution,44,19,25
29751,Carliitoz,quelthalas,1334,paladin,retribution,111,44,67
29752,Oioo,proudmoore,1333,paladin,retribution,21,15,6
29753,Aretwin,dalaran,1333,paladin,retribution,48,23,25
29754,Reptila,bonechewer,1333,paladin,retribution,30,14,16
29755,Väkariän,quelthalas,1333,paladin,retribution,30,14,16
29756,Thortanous,icecrown,1333,paladin,retribution,54,25,29
29757,Astaro,malganis,1333,paladin,retribution,36,14,22
29758,Faaqmee,gorefiend,1332,paladin,retribution,30,19,11
29759,Pallyhealed,tichondrius,1332,paladin,retribution,37,17,20
29760,Malorian,azgalor,1332,paladin,retribution,48,21,27
29761,Lüuz,area-52,1332,paladin,retribution,42,15,27
29762,Trogdorpwn,bonechewer,1331,paladin,retribution,30,17,13
29763,Bonkky,whisperwind,1331,paladin,retribution,30,16,14
29764,Holybalsagna,garrosh,1331,paladin,retribution,66,35,31
29765,Mobitz,dalvengyr,1331,paladin,retribution,48,25,23
29766,Tutankhammer,stormrage,1331,paladin,retribution,100,50,50
29767,Mattilla,tichondrius,1331,paladin,retribution,30,14,16
29768,Keenos,frostmourne,1330,paladin,retribution,25,14,11
29769,Hunsung,tichondrius,1330,paladin,retribution,36,14,22
29770,Däkh,sargeras,1329,paladin,retribution,24,14,10
29771,Bigdoosa,frostmourne,1329,paladin,retribution,40,19,21
29772,Brightsaber,tichondrius,1328,paladin,retribution,63,34,29
29773,Nerfashen,zuljin,1327,paladin,retribution,24,14,10
29774,Revent,drakkari,1327,paladin,retribution,24,14,10
29775,Clayban,stormrage,1327,paladin,retribution,42,22,20
29776,Azajudgeman,nemesis,1327,paladin,retribution,33,14,19
29777,Garcinddra,vashj,1326,paladin,retribution,34,16,18
29778,Ennvy,nemesis,1326,paladin,retribution,30,14,16
29779,Melize,area-52,1325,paladin,retribution,118,57,61
29780,Mikezheng,tichondrius,1325,paladin,retribution,42,19,23
29781,Dexko,silvermoon,1324,paladin,retribution,34,24,10
29782,Akabanee,ragnaros,1324,paladin,retribution,24,14,10
29783,Kiergann,quelthalas,1324,paladin,retribution,65,30,35
29784,Unsignedint,hyjal,1323,paladin,retribution,24,14,10
29785,Kregar,kelthuzad,1323,paladin,retribution,70,38,32
29786,Gixpal,skullcrusher,1323,paladin,retribution,59,31,28
29787,Prïmavera,azralon,1323,paladin,retribution,35,15,20
29788,Christman,illidan,1323,paladin,retribution,78,33,45
29789,Dárí,stormrage,1320,paladin,retribution,132,65,67
29790,Sventyn,frostmourne,1320,paladin,retribution,41,14,27
29791,Bennu,sargeras,1319,paladin,retribution,45,17,28
29792,Oopalaoo,azralon,1318,paladin,retribution,30,15,15
29793,Arkanica,moon-guard,1318,paladin,retribution,41,16,25
29794,Dralkou,kaelthas,1318,paladin,retribution,75,29,46
29795,Serran,durotan,1318,paladin,retribution,54,20,34
29796,Vallahad,emerald-dream,1317,paladin,retribution,24,14,10
29797,Balango,azralon,1316,paladin,retribution,24,14,10
29798,Zoobro,tichondrius,1316,paladin,retribution,71,32,39
29799,Pallypapa,galakrond,1315,paladin,retribution,35,22,13
29800,Hapii,tichondrius,1315,paladin,retribution,47,18,29
29801,Crematória,azralon,1314,paladin,retribution,24,14,10
29802,Ajoladin,illidan,1314,paladin,retribution,75,34,41
29803,Lostkanvas,azralon,1313,paladin,retribution,46,27,19
29804,Lainn,zuljin,1313,paladin,retribution,74,41,33
29805,Phokboi,shattered-hand,1313,paladin,retribution,57,31,26
29806,Vanthor,emerald-dream,1313,paladin,retribution,30,15,15
29807,Siberios,stormrage,1313,paladin,retribution,30,14,16
29808,Ludvigsen,hakkar,1313,paladin,retribution,36,14,22
29809,Autoattacker,mannoroth,1312,paladin,retribution,24,14,10
29810,Hays,barthilas,1311,paladin,retribution,18,14,4
29811,Bravomedic,emerald-dream,1311,paladin,retribution,39,20,19
29812,Melloow,azralon,1311,paladin,retribution,91,43,48
29813,Toyotasupra,azgalor,1310,paladin,retribution,48,29,19
29814,Trg,azralon,1310,paladin,retribution,24,14,10
29815,Darthhelios,illidan,1310,paladin,retribution,36,14,22
29816,Trainstorm,emerald-dream,1309,paladin,retribution,38,19,19
29817,Sunwrath,quelthalas,1309,paladin,retribution,75,32,43
29818,Lumberjack,bloodhoof,1309,paladin,retribution,41,16,25
29819,Normaldude,sargeras,1307,paladin,retribution,30,14,16
29820,Erethonis,bladefist,1307,paladin,retribution,78,36,42
29821,Retrah,azralon,1306,paladin,retribution,24,14,10
29822,Shamo,stormreaver,1306,paladin,retribution,36,14,22
29823,Bayaz,emerald-dream,1304,paladin,retribution,67,36,31
29824,Nadrela,burning-blade,1303,paladin,retribution,54,32,22
29825,Uvatah,quelthalas,1303,paladin,retribution,24,14,10
29826,Elivathord,trollbane,1302,paladin,retribution,29,16,13
29827,Happywow,tichondrius,1302,paladin,retribution,59,30,29
29828,Atrayeus,dawnbringer,1300,paladin,retribution,48,21,27
29829,Saucepally,laughing-skull,1299,paladin,retribution,55,30,25
29830,Oneminute,nerzhul,1299,paladin,retribution,42,21,21
29831,Ultralord,dragonmaw,1299,paladin,retribution,28,14,14
29832,Vtyr,nemesis,1298,paladin,retribution,63,29,34
29833,Brsjak,frostmourne,1297,paladin,retribution,65,33,32
29834,Jerratt,thrall,1297,paladin,retribution,72,31,41
29835,Krinkin,illidan,1297,paladin,retribution,42,14,28
29836,Youwillatone,zuljin,1296,paladin,retribution,42,22,20
29837,Fabolouss,tichondrius,1296,paladin,retribution,114,58,56
29838,Ratburger,blood-furnace,1295,paladin,retribution,23,14,9
29839,Holyfaxis,rexxar,1293,paladin,retribution,38,17,21
29840,Paladingirl,darkspear,1292,paladin,retribution,92,50,42
29841,Vargonha,azralon,1292,paladin,retribution,54,27,27
29842,Mendaltv,dalaran,1292,paladin,retribution,36,17,19
29843,Philfred,frostmourne,1290,paladin,retribution,24,15,9
29844,Perfectgirl,maiev,1290,paladin,retribution,78,38,40
29845,Vosailer,illidan,1290,paladin,retribution,34,16,18
29846,Walleis,moon-guard,1290,paladin,retribution,58,22,36
29847,Vêndar,ragnaros,1289,paladin,retribution,78,33,45
29848,Sóapbubble,tichondrius,1287,paladin,retribution,27,14,13
29849,Critxx,tichondrius,1287,paladin,retribution,83,38,45
29850,Dedsxy,tichondrius,1286,paladin,retribution,30,14,16
29851,Hwanko,tichondrius,1285,paladin,retribution,40,25,15
29852,Broxon,tichondrius,1285,paladin,retribution,64,33,31
29853,Gainen,illidan,1285,paladin,retribution,47,24,23
29854,Paliodin,dalaran,1284,paladin,retribution,36,15,21
29855,ßlððdyßðnez,malganis,1283,paladin,retribution,36,20,16
29856,Sweatylight,bleeding-hollow,1283,paladin,retribution,74,37,37
29857,Arnblass,magtheridon,1283,paladin,retribution,63,27,36
29858,Hodne,blackhand,1282,paladin,retribution,49,26,23
29859,Navicc,zuljin,1279,paladin,retribution,29,14,15
29860,Aellâ,bloodscalp,1278,paladin,retribution,194,102,92
29861,Chippo,aegwynn,1278,paladin,retribution,35,15,20
29862,Denhoward,proudmoore,1277,paladin,retribution,36,14,22
29863,Theuss,nerzhul,1276,paladin,retribution,59,25,34
29864,Yuccalicious,area-52,1275,paladin,retribution,53,23,30
29865,Carolena,thaurissan,1274,paladin,retribution,74,31,43
29866,Dredberserk,stormrage,1273,paladin,retribution,30,16,14
29867,Balster,moon-guard,1273,paladin,retribution,85,40,45
29868,Throwable,illidan,1273,paladin,retribution,64,26,38
29869,Webothhateme,tichondrius,1272,paladin,retribution,36,20,16
29870,Quickthing,dalaran,1271,paladin,retribution,83,47,36
29871,Khorgus,gundrak,1271,paladin,retribution,54,27,27
29872,Såssy,moon-guard,1270,paladin,retribution,72,31,41
29873,Thankyouswen,tichondrius,1269,paladin,retribution,70,31,39
29874,Synthetic,moon-guard,1268,paladin,retribution,78,40,38
29875,Gramaton,malfurion,1268,paladin,retribution,54,25,29
29876,Holytémplar,proudmoore,1267,paladin,retribution,30,14,16
29877,Dewlight,zuljin,1266,paladin,retribution,71,41,30
29878,Giltronix,thrall,1266,paladin,retribution,60,30,30
29879,Palacamâ,quelthalas,1266,paladin,retribution,34,15,19
29880,Mindfoolness,sargeras,1265,paladin,retribution,42,21,21
29881,Formergf,crushridge,1265,paladin,retribution,60,29,31
29882,Wosy,azralon,1263,paladin,retribution,24,15,9
29883,Onemorelight,sargeras,1263,paladin,retribution,54,27,27
29884,Quinnl,dreadmaul,1262,paladin,retribution,38,18,20
29885,Galaxahan,bonechewer,1262,paladin,retribution,64,30,34
29886,Athenariel,bleeding-hollow,1262,paladin,retribution,55,24,31
29887,Punative,darkspear,1262,paladin,retribution,48,16,32
29888,Garruckadin,dalaran,1261,paladin,retribution,25,14,11
29889,Malicia,malorne,1261,paladin,retribution,36,17,19
29890,Herrit,frostmourne,1260,paladin,retribution,144,76,68
29891,Sïrenek,tichondrius,1260,paladin,retribution,55,27,28
29892,Jugheadqc,mugthol,1260,paladin,retribution,63,30,33
29893,Canadianeh,malganis,1260,paladin,retribution,66,28,38
29894,Revent,stormrage,1260,paladin,retribution,54,21,33
29895,Belena,jaedenar,1258,paladin,retribution,36,16,20
29896,Minlarkwa,frostmourne,1257,paladin,retribution,30,16,14
29897,Restitution,area-52,1257,paladin,retribution,35,14,21
29898,Ðivinestørm,stormrage,1256,paladin,retribution,25,14,11
29899,Soana,alexstrasza,1255,paladin,retribution,78,48,30
29900,Alucardlh,ragnaros,1254,paladin,retribution,70,38,32
29901,Huitz,drakkari,1254,paladin,retribution,66,33,33
29902,Snowcrow,tichondrius,1254,paladin,retribution,115,51,64
29903,Snowcrest,cenarius,1251,paladin,retribution,74,33,41
29904,Lvlone,sargeras,1250,paladin,retribution,30,17,13
29905,Menaus,duskwood,1250,paladin,retribution,39,20,19
29906,Barbesacrer,zuljin,1249,paladin,retribution,27,15,12
29907,Smorezz,bonechewer,1249,paladin,retribution,108,50,58
29908,Eleonorr,proudmoore,1248,paladin,retribution,30,16,14
29909,Wölfheärt,tichondrius,1247,paladin,retribution,18,13,5
29910,Truesound,malganis,1247,paladin,retribution,18,13,5
29911,Canadapants,kelthuzad,1247,paladin,retribution,36,21,15
29912,Davinchi,laughing-skull,1247,paladin,retribution,47,27,20
29913,Solidifyxz,area-52,1247,paladin,retribution,24,13,11
29914,Venturep,azralon,1247,paladin,retribution,24,13,11
29915,Daion,quelthalas,1247,paladin,retribution,24,13,11
29916,Billystacks,illidan,1247,paladin,retribution,24,13,11
29917,Thin,ragnaros,1247,paladin,retribution,30,14,16
29918,Hojdin,tichondrius,1247,paladin,retribution,30,13,17
29919,Vlandor,area-52,1246,paladin,retribution,35,19,16
29920,Talvyr,icecrown,1246,paladin,retribution,30,14,16
29921,Steelbreaker,deathwing,1246,paladin,retribution,47,21,26
29922,Beyönd,quelthalas,1246,paladin,retribution,30,13,17
29923,Bizaro,malganis,1246,paladin,retribution,36,13,23
29924,Zephyrvalor,sargeras,1245,paladin,retribution,54,32,22
29925,Rengen,frostmourne,1245,paladin,retribution,24,13,11
29926,Paladinaa,lothar,1245,paladin,retribution,30,13,17
29927,Onemassacre,spirestone,1245,paladin,retribution,36,13,23
29928,Rakzan,nerzhul,1244,paladin,retribution,24,13,11
29929,Hammerina,antonidas,1244,paladin,retribution,35,16,19
29930,Skylexx,ragnaros,1244,paladin,retribution,60,27,33
29931,Mákis,ragnaros,1244,paladin,retribution,30,13,17
29932,Aduhrawl,moon-guard,1244,paladin,retribution,38,14,24
29933,Jaimi,stormreaver,1243,paladin,retribution,18,13,5
29934,Yugee,doomhammer,1243,paladin,retribution,24,13,11
29935,Doktavius,lightbringer,1243,paladin,retribution,24,13,11
29936,Krixes,firetree,1243,paladin,retribution,30,16,14
29937,Treizen,frostmourne,1243,paladin,retribution,37,14,23
29938,Deployed,kaelthas,1243,paladin,retribution,36,13,23
29939,Fallóut,proudmoore,1243,paladin,retribution,42,13,29
29940,Bebitufiufiu,illidan,1242,paladin,retribution,24,13,11
29941,Tedward,emerald-dream,1242,paladin,retribution,24,13,11
29942,Rockbell,kiljaeden,1242,paladin,retribution,24,13,11
29943,Hahe,tichondrius,1242,paladin,retribution,30,13,17
29944,Justeight,stormrage,1242,paladin,retribution,33,13,20
29945,Glorgrim,emerald-dream,1241,paladin,retribution,24,13,11
29946,Anastos,anvilmar,1241,paladin,retribution,24,13,11
29947,Hellhawk,hellscream,1241,paladin,retribution,36,18,18
29948,Aurken,ragnaros,1241,paladin,retribution,30,13,17
29949,Holychow,tichondrius,1240,paladin,retribution,24,13,11
29950,Athamon,nemesis,1240,paladin,retribution,24,13,11
29951,Amadin,emerald-dream,1240,paladin,retribution,24,13,11
29952,Naxadin,tichondrius,1240,paladin,retribution,24,13,11
29953,Mavrixz,illidan,1240,paladin,retribution,30,13,17
29954,Impkpal,tichondrius,1240,paladin,retribution,36,13,23
29955,Nerfmehpls,ragnaros,1239,paladin,retribution,96,54,42
29956,Tifalockhart,dathremar,1239,paladin,retribution,24,13,11
29957,Saintpower,stormscale,1239,paladin,retribution,24,13,11
29958,Shrektacular,malganis,1238,paladin,retribution,24,13,11
29959,Deftonia,stormrage,1238,paladin,retribution,65,31,34
29960,Ràmetep,illidan,1238,paladin,retribution,30,13,17
29961,Theboxx,frostmourne,1238,paladin,retribution,39,16,23
29962,Xalixxa,wyrmrest-accord,1237,paladin,retribution,60,27,33
29963,Siaaryn,darkspear,1237,paladin,retribution,30,13,17
29964,Rigotakp,illidan,1237,paladin,retribution,30,13,17
29965,Pristinne,darkspear,1237,paladin,retribution,82,34,48
29966,Sconey,andorhal,1237,paladin,retribution,34,14,20
29967,Ablunedion,illidan,1237,paladin,retribution,41,14,27
29968,Nornix,fenris,1236,paladin,retribution,24,13,11
29969,Meanlight,zuljin,1236,paladin,retribution,78,42,36
29970,Carenye,thunderhorn,1235,paladin,retribution,37,16,21
29971,Covidin,quelthalas,1234,paladin,retribution,30,13,17
29972,Noblelight,saurfang,1233,paladin,retribution,29,17,12
29973,Cederas,sargeras,1233,paladin,retribution,30,17,13
29974,Pasterõ,ragnaros,1231,paladin,retribution,28,16,12
29975,Pìerre,ragnaros,1231,paladin,retribution,140,69,71
29976,Ôdenswrath,stormscale,1231,paladin,retribution,98,45,53
29977,Chopsparks,khadgar,1231,paladin,retribution,53,21,32
29978,Irand,area-52,1231,paladin,retribution,67,26,41
29979,Krawmwell,lothar,1230,paladin,retribution,78,43,35
29980,Davincintel,tichondrius,1230,paladin,retribution,24,13,11
29981,Uunjaaku,kiljaeden,1230,paladin,retribution,45,22,23
29982,Luke,frostwolf,1230,paladin,retribution,29,13,16
29983,Qpal,area-52,1230,paladin,retribution,30,13,17
29984,Leihateh,moon-guard,1229,paladin,retribution,24,13,11
29985,Elowod,frostmourne,1229,paladin,retribution,24,13,11
29986,Legible,tichondrius,1228,paladin,retribution,28,15,13
29987,Featscrows,nemesis,1228,paladin,retribution,48,20,28
29988,Uhklathel,quelthalas,1228,paladin,retribution,63,25,38
29989,Heindallr,nemesis,1227,paladin,retribution,48,22,26
29990,Forged,steamwheedle-cartel,1227,paladin,retribution,135,56,79
29991,Thorsenâ,sargeras,1226,paladin,retribution,27,17,10
29992,Hiikari,silver-hand,1225,paladin,retribution,30,14,16
29993,Haawkala,ragnaros,1225,paladin,retribution,30,13,17
29994,Misskilljoy,proudmoore,1225,paladin,retribution,30,13,17
29995,Keegân,area-52,1224,paladin,retribution,16,14,2
29996,Hellcallerl,quelthalas,1224,paladin,retribution,24,13,11
29997,Dankpaladin,frostwolf,1224,paladin,retribution,30,13,17
29998,Retneyspears,darkspear,1224,paladin,retribution,42,18,24
29999,Amarith,queldorei,1224,paladin,retribution,76,31,45
30000,Ulessys,bleeding-hollow,1223,paladin,retribution,54,27,27
30001,Tonnerre,silvermoon,1223,paladin,retribution,72,33,39
30002,Ekyu,sargeras,1222,paladin,retribution,25,15,10
30003,Gys,ragnaros,1222,paladin,retribution,60,31,29
30004,Lungjuice,stormrage,1222,paladin,retribution,47,18,29
30005,Albion,sargeras,1222,paladin,retribution,36,13,23
30006,Füriøsa,quelthalas,1221,paladin,retribution,59,29,30
30007,Areaky,khazgoroth,1220,paladin,retribution,38,22,16
30008,Imrahilaf,korialstrasz,1220,paladin,retribution,36,13,23
30009,Demihoj,illidan,1220,paladin,retribution,36,13,23
30010,Lortrin,quelthalas,1218,paladin,retribution,24,13,11
30011,Naghret,area-52,1218,paladin,retribution,24,13,11
30012,Beastyone,tichondrius,1218,paladin,retribution,116,61,55
30013,Uglymugz,area-52,1218,paladin,retribution,37,16,21
30014,Sycomaniac,illidan,1218,paladin,retribution,35,13,22
30015,Marshman,kelthuzad,1217,paladin,retribution,30,17,13
30016,Redeviliu,tichondrius,1217,paladin,retribution,41,15,26
30017,Holyshoc,kiljaeden,1216,paladin,retribution,56,28,28
30018,Brucedwal,moon-guard,1216,paladin,retribution,63,31,32
30019,Vassen,echo-isles,1216,paladin,retribution,33,16,17
30020,Ròwdy,area-52,1214,paladin,retribution,23,13,10
30021,Fogonaventa,nemesis,1214,paladin,retribution,57,18,39
30022,Madalynn,quelthalas,1213,paladin,retribution,54,21,33
30023,Armstrongz,bleeding-hollow,1210,paladin,retribution,36,13,23
30024,Azëitona,azralon,1208,paladin,retribution,24,13,11
30025,Xupalaa,azralon,1208,paladin,retribution,44,23,21
30026,Barbaluzz,quelthalas,1207,paladin,retribution,31,16,15
30027,Xenagos,akama,1207,paladin,retribution,30,13,17
30028,Gwendolyynn,moon-guard,1206,paladin,retribution,40,24,16
30029,Longinus,eredar,1206,paladin,retribution,24,13,11
30030,Bubbleöseven,agamaggan,1205,paladin,retribution,57,27,30
30031,Shusekki,drakkari,1204,paladin,retribution,111,54,57
30032,Botïs,sargeras,1203,paladin,retribution,36,22,14
30033,Rediems,drakkari,1203,paladin,retribution,42,21,21
30034,Soledad,tichondrius,1202,paladin,retribution,30,15,15
30035,Hibrael,azralon,1201,paladin,retribution,56,32,24
30036,Stõnêdpimp,agamaggan,1201,paladin,retribution,29,13,16
30037,Thal,silvermoon,1199,paladin,retribution,36,20,16
30038,Sturka,illidan,1199,paladin,retribution,60,29,31
30039,Johnyfresh,jubeithos,1199,paladin,retribution,44,20,24
30040,Rinneblack,ragnaros,1199,paladin,retribution,30,13,17
30041,Cexus,tichondrius,1198,paladin,retribution,23,13,10
30042,Oathden,area-52,1198,paladin,retribution,34,18,16
30043,Rönän,sargeras,1198,paladin,retribution,29,13,16
30044,Finishearlyx,kelthuzad,1198,paladin,retribution,35,13,22
30045,Lucigiorna,stormrage,1197,paladin,retribution,50,22,28
30046,Thomãs,moon-guard,1195,paladin,retribution,29,13,16
30047,Eetswaz,frostmourne,1193,paladin,retribution,36,20,16
30048,Virrata,tichondrius,1193,paladin,retribution,26,14,12
30049,Pikatripa,quelthalas,1192,paladin,retribution,38,17,21
30050,Spartus,area-52,1191,paladin,retribution,26,15,11
30051,Avelane,caelestrasz,1191,paladin,retribution,52,24,28
30052,Malavon,azralon,1190,paladin,retribution,21,14,7
30053,Noblearthur,feathermoon,1190,paladin,retribution,24,15,9
30054,Unsung,stormreaver,1190,paladin,retribution,47,23,24
30055,Verguetas,ragnaros,1190,paladin,retribution,60,27,33
30056,Dinpal,tichondrius,1190,paladin,retribution,36,13,23
30057,Jèrico,quelthalas,1188,paladin,retribution,32,14,18
30058,Dynamais,barthilas,1187,paladin,retribution,54,21,33
30059,Reptaur,bleeding-hollow,1185,paladin,retribution,64,31,33
30060,Stealhearsp,tichondrius,1185,paladin,retribution,41,14,27
30061,Holycower,tichondrius,1182,paladin,retribution,24,15,9
30062,Páláx,stormrage,1181,paladin,retribution,51,22,29
30063,Dsio,bleeding-hollow,1180,paladin,retribution,34,13,21
30064,Ezekìël,tichondrius,1179,paladin,retribution,24,15,9
30065,Paim,tol-barad,1179,paladin,retribution,32,13,19
30066,Noskill,moonrunner,1176,paladin,retribution,48,29,19
30067,Shadowarius,aerie-peak,1176,paladin,retribution,66,32,34
30068,Jerseÿ,sargeras,1176,paladin,retribution,39,18,21
30069,Bleeked,emerald-dream,1174,paladin,retribution,25,14,11
30070,Basstian,bleeding-hollow,1174,paladin,retribution,100,40,60
30071,Greasy,quelthalas,1173,paladin,retribution,32,13,19
30072,Kaladini,jubeithos,1171,paladin,retribution,22,13,9
30073,Schnabdain,exodar,1171,paladin,retribution,66,36,30
30074,Crosshammer,quelthalas,1170,paladin,retribution,42,20,22
30075,Popwingzz,sargeras,1170,paladin,retribution,66,23,43
30076,Linias,quelthalas,1169,paladin,retribution,21,14,7
30077,Holyrõller,malganis,1169,paladin,retribution,30,14,16
30078,Irantir,drakkari,1169,paladin,retribution,107,47,60
30079,Pengideath,barthilas,1168,paladin,retribution,30,14,16
30080,Souljahgirl,demon-soul,1168,paladin,retribution,42,18,24
30081,Mikkylol,tichondrius,1165,paladin,retribution,28,13,15
30082,Soopadupa,trollbane,1164,paladin,retribution,68,36,32
30083,Solomonss,frostmourne,1163,paladin,retribution,58,21,37
30084,Thaly,shadowmoon,1161,paladin,retribution,49,20,29
30085,Suncrashkid,nerzhul,1160,paladin,retribution,169,91,78
30086,Rynis,arthas,1160,paladin,retribution,34,14,20
30087,Draerys,drakkari,1159,paladin,retribution,36,26,10
30088,Oraborra,area-52,1158,paladin,retribution,36,14,22
30089,Thørîm,nazjatar,1154,paladin,retribution,36,15,21
30090,Kaysonso,thunderlord,1153,paladin,retribution,49,18,31
30091,Hammrekt,dalaran,1152,paladin,retribution,18,12,6
30092,Furylolx,tichondrius,1152,paladin,retribution,18,12,6
30093,Greatwyrm,illidan,1152,paladin,retribution,18,12,6
30094,Huavi,tichondrius,1152,paladin,retribution,18,12,6
30095,Ghøjan,malganis,1152,paladin,retribution,23,15,8
30096,Critwink,illidan,1152,paladin,retribution,21,12,9
30097,Vânguârds,tichondrius,1152,paladin,retribution,24,12,12
30098,Pique,malganis,1152,paladin,retribution,24,12,12
30099,Jivvy,eredar,1152,paladin,retribution,30,12,18
30100,Cöjax,dalaran,1151,paladin,retribution,18,12,6
30101,Jeinova,barthilas,1151,paladin,retribution,105,62,43
30102,Talions,illidan,1151,paladin,retribution,24,12,12
30103,Allohes,area-52,1151,paladin,retribution,24,12,12
30104,Zhaslk,ragnaros,1151,paladin,retribution,24,12,12
30105,ßrittany,gnomeregan,1151,paladin,retribution,24,12,12
30106,Torosagrado,drakkari,1151,paladin,retribution,24,12,12
30107,Lhacius,drakkari,1151,paladin,retribution,28,13,15
30108,Dragynfist,malganis,1151,paladin,retribution,30,12,18
30109,Fâmed,tichondrius,1151,paladin,retribution,30,12,18
30110,Sukmyret,sargeras,1151,paladin,retribution,30,12,18
30111,Geospawn,tichondrius,1151,paladin,retribution,30,12,18
30112,Softmograne,tichondrius,1151,paladin,retribution,30,12,18
30113,Jameson,andorhal,1150,paladin,retribution,18,12,6
30114,Hashmaal,tichondrius,1150,paladin,retribution,39,20,19
30115,Alvinsane,proudmoore,1150,paladin,retribution,24,12,12
30116,Bubbleblast,elune,1150,paladin,retribution,30,12,18
30117,Trinade,stormrage,1150,paladin,retribution,30,12,18
30118,Andrixi,bonechewer,1149,paladin,retribution,18,12,6
30119,Vaaga,quelthalas,1149,paladin,retribution,24,12,12
30120,Yeeter,thrall,1149,paladin,retribution,24,12,12
30121,Retosterone,stormrage,1149,paladin,retribution,30,12,18
30122,Saffuki,frostmourne,1149,paladin,retribution,30,12,18
30123,Emisoul,sargeras,1149,paladin,retribution,30,12,18
30124,Kadryck,drakkari,1148,paladin,retribution,18,12,6
30125,Daukan,quelthalas,1148,paladin,retribution,24,12,12
30126,Dontaylor,tichondrius,1148,paladin,retribution,30,12,18
30127,Bigdpally,frostmourne,1148,paladin,retribution,36,12,24
30128,Rickadin,bleeding-hollow,1147,paladin,retribution,22,13,9
30129,Pocacoco,azralon,1147,paladin,retribution,22,13,9
30130,Phanna,the-forgotten-coast,1147,paladin,retribution,24,12,12
30131,Arkoth,kelthuzad,1147,paladin,retribution,24,12,12
30132,Smudgexy,frostmourne,1147,paladin,retribution,30,12,18
30133,Mongerr,drakkari,1146,paladin,retribution,24,12,12
30134,Røshea,hydraxis,1146,paladin,retribution,24,12,12
30135,Ireckon,stormrage,1146,paladin,retribution,24,12,12
30136,Marhaus,emerald-dream,1146,paladin,retribution,24,12,12
30137,Deathodin,tichondrius,1146,paladin,retribution,24,12,12
30138,Mikehawkhuge,area-52,1146,paladin,retribution,60,26,34
30139,Adathan,ghostlands,1146,paladin,retribution,30,12,18
30140,Capedcrusade,area-52,1145,paladin,retribution,18,12,6
30141,Savethejelly,moon-guard,1145,paladin,retribution,24,12,12
30142,Cathode,area-52,1145,paladin,retribution,24,12,12
30143,Deosfires,ragnaros,1145,paladin,retribution,28,13,15
30144,Riggen,thrall,1144,paladin,retribution,30,12,18
30145,Lightshope,coilfang,1143,paladin,retribution,18,12,6
30146,Elbigboy,tichondrius,1143,paladin,retribution,89,45,44
30147,Thoti,tichondrius,1143,paladin,retribution,25,12,13
30148,Scudstock,tichondrius,1143,paladin,retribution,71,34,37
30149,Joeseph,stormrage,1143,paladin,retribution,30,12,18
30150,Seongje,tichondrius,1143,paladin,retribution,39,13,26
30151,Stormwinter,azralon,1143,paladin,retribution,36,12,24
30152,Oniizuna,thrall,1142,paladin,retribution,24,12,12
30153,Ginbirdup,kelthuzad,1141,paladin,retribution,18,12,6
30154,Swiftxheal,stormrage,1141,paladin,retribution,24,12,12
30155,Velarelan,moon-guard,1141,paladin,retribution,30,12,18
30156,Kelthálas,illidan,1141,paladin,retribution,30,12,18
30157,Beachyo,tichondrius,1140,paladin,retribution,18,12,6
30158,Bingbingcd,tichondrius,1140,paladin,retribution,30,13,17
30159,Athenax,area-52,1139,paladin,retribution,24,12,12
30160,Victidin,quelthalas,1138,paladin,retribution,24,12,12
30161,Brahion,icecrown,1137,paladin,retribution,62,33,29
30162,Sarkorius,moon-guard,1137,paladin,retribution,24,12,12
30163,Gavrill,thrall,1137,paladin,retribution,30,13,17
30164,Narcolepso,azralon,1137,paladin,retribution,30,12,18
30165,Akiralons,ragnaros,1137,paladin,retribution,30,12,18
30166,Haiyaa,frostwolf,1137,paladin,retribution,66,25,41
30167,Drekgor,drakkari,1136,paladin,retribution,42,21,21
30168,Soyafed,mugthol,1135,paladin,retribution,58,30,28
30169,Vejita,frostmourne,1135,paladin,retribution,24,12,12
30170,Areura,hellscream,1134,paladin,retribution,21,13,8
30171,Mandragor,borean-tundra,1134,paladin,retribution,36,21,15
30172,Vynlorderan,area-52,1134,paladin,retribution,24,12,12
30173,Dresdén,skullcrusher,1133,paladin,retribution,18,12,6
30174,Bradoxx,thorium-brotherhood,1133,paladin,retribution,78,43,35
30175,Maverickxz,nemesis,1133,paladin,retribution,29,12,17
30176,Meltedcheese,destromath,1132,paladin,retribution,30,15,15
30177,Ðß,arthas,1132,paladin,retribution,30,13,17
30178,Eddardstark,agamaggan,1131,paladin,retribution,68,31,37
30179,Joelanson,blood-furnace,1130,paladin,retribution,54,29,25
30180,Jdn,ysera,1130,paladin,retribution,60,29,31
30181,Grãnd,tortheldrin,1129,paladin,retribution,29,12,17
30182,Salasong,hellscream,1129,paladin,retribution,60,20,40
30183,Fortueni,illidan,1128,paladin,retribution,94,55,39
30184,Stepurgameup,ghostlands,1128,paladin,retribution,54,29,25
30185,Arun,arthas,1128,paladin,retribution,33,15,18
30186,Chbestafera,nemesis,1127,paladin,retribution,18,12,6
30187,Gamber,frostmourne,1127,paladin,retribution,38,16,22
30188,Ducii,stormrage,1126,paladin,retribution,46,22,24
30189,Redyomi,drakkari,1126,paladin,retribution,36,13,23
30190,Damorte,ragnaros,1125,paladin,retribution,30,15,15
30191,Sparkchaser,proudmoore,1125,paladin,retribution,24,12,12
30192,Dirkadirkka,stormrage,1125,paladin,retribution,24,12,12
30193,Newerlight,tichondrius,1124,paladin,retribution,25,13,12
30194,Reivilly,azralon,1124,paladin,retribution,30,13,17
30195,Palavittar,azralon,1122,paladin,retribution,23,13,10
30196,Dannoruk,ragnaros,1121,paladin,retribution,30,12,18
30197,Thorviim,azralon,1120,paladin,retribution,37,17,20
30198,Zaklehblue,daggerspine,1118,paladin,retribution,60,24,36
30199,Darkknes,quelthalas,1116,paladin,retribution,41,20,21
30200,Statícx,ragnaros,1116,paladin,retribution,103,43,60
30201,Deathwyz,thunderlord,1116,paladin,retribution,36,14,22
30202,Yenkmeilleur,zuljin,1115,paladin,retribution,24,13,11
30203,Diablosgrim,stormrage,1114,paladin,retribution,24,18,6
30204,Streetsaint,frostmourne,1114,paladin,retribution,66,32,34
30205,Adelsman,quelthalas,1113,paladin,retribution,30,14,16
30206,Sandicang,azuremyst,1112,paladin,retribution,54,27,27
30207,Drágons,stormrage,1109,paladin,retribution,72,30,42
30208,Wilmâ,ragnaros,1109,paladin,retribution,30,12,18
30209,Rcon,khadgar,1107,paladin,retribution,24,13,11
30210,Greatgirthy,hyjal,1106,paladin,retribution,30,13,17
30211,Thanatiel,area-52,1104,paladin,retribution,66,37,29
30212,Savagefck,sargeras,1103,paladin,retribution,24,15,9
30213,Billnighy,alleria,1103,paladin,retribution,66,32,34
30214,Vanillur,tichondrius,1103,paladin,retribution,55,24,31
30215,Gtate,azjolnerub,1102,paladin,retribution,23,12,11
30216,Decareos,tichondrius,1102,paladin,retribution,29,12,17
30217,Hyperforce,area-52,1099,paladin,retribution,30,12,18
30218,Soukaa,illidan,1097,paladin,retribution,23,12,11
30219,Gorgrand,gorgonnash,1097,paladin,retribution,39,14,25
30220,Holladrik,frostmourne,1096,paladin,retribution,36,12,24
30221,Lucifuge,twisting-nether,1095,paladin,retribution,18,12,6
30222,Durothar,dalaran,1095,paladin,retribution,42,22,20
30223,Aowynd,tichondrius,1094,paladin,retribution,79,39,40
30224,Riggar,uther,1094,paladin,retribution,77,31,46
30225,Kegmight,emerald-dream,1093,paladin,retribution,41,13,28
30226,Kittylickers,tichondrius,1092,paladin,retribution,108,56,52
30227,Omenix,laughing-skull,1091,paladin,retribution,29,12,17
30228,Cheesetitan,tichondrius,1090,paladin,retribution,52,22,30
30229,Mcbraín,quelthalas,1089,paladin,retribution,30,12,18
30230,Alairius,tichondrius,1087,paladin,retribution,23,15,8
30231,Killumminati,tichondrius,1087,paladin,retribution,21,13,8
30232,Rikkupìgu,sargeras,1087,paladin,retribution,20,12,8
30233,Pldd,tichondrius,1087,paladin,retribution,76,33,43
30234,Pallydin,smolderthorn,1086,paladin,retribution,30,15,15
30235,Rétribution,farstriders,1086,paladin,retribution,46,21,25
30236,Mybadfoo,lethon,1085,paladin,retribution,18,13,5
30237,Salvations,queldorei,1085,paladin,retribution,60,30,30
30238,Xandish,illidan,1084,paladin,retribution,20,12,8
30239,Bubblegums,nagrand,1084,paladin,retribution,69,39,30
30240,Grimhammer,the-scryers,1083,paladin,retribution,61,31,30
30241,Thirtyfivemm,area-52,1083,paladin,retribution,58,29,29
30242,Thorsmites,sargeras,1082,paladin,retribution,42,17,25
30243,Bubbleosevn,dragonmaw,1079,paladin,retribution,26,12,14
30244,Astralweed,quelthalas,1079,paladin,retribution,54,19,35
30245,Eliasor,illidan,1077,paladin,retribution,18,13,5
30246,Lízandor,ragnaros,1077,paladin,retribution,17,12,5
30247,Zir,frostmourne,1077,paladin,retribution,47,24,23
30248,Saamuus,quelthalas,1077,paladin,retribution,32,13,19
30249,Warswordz,stormrage,1077,paladin,retribution,40,16,24
30250,Clefairy,arathor,1076,paladin,retribution,39,23,16
30251,Jonsnou,tol-barad,1074,paladin,retribution,36,14,22
30252,Zorkus,turalyon,1073,paladin,retribution,42,22,20
30253,Brightfire,dawnbringer,1073,paladin,retribution,36,13,23
30254,Missoutale,aerie-peak,1072,paladin,retribution,82,35,47
30255,Trappadin,sargeras,1070,paladin,retribution,42,19,23
30256,Heiinneken,queldorei,1065,paladin,retribution,20,12,8
30257,Kaidao,black-dragonflight,1065,paladin,retribution,24,12,12
30258,Karimpro,emerald-dream,1065,paladin,retribution,38,15,23
30259,Morddrohung,hyjal,1063,paladin,retribution,18,12,6
30260,Holygerp,darrowmere,1060,paladin,retribution,18,12,6
30261,Anyatay,ragnaros,1060,paladin,retribution,77,28,49
30262,Tinithis,tichondrius,1059,paladin,retribution,17,12,5
30263,Andras,emerald-dream,1059,paladin,retribution,22,12,10
30264,Caitlyn,nazjatar,1058,paladin,retribution,30,17,13
30265,Jinfandi,gurubashi,1058,paladin,retribution,36,13,23
30266,Lessera,tichondrius,1057,paladin,retribution,26,12,14
30267,Zözo,zuljin,1056,paladin,retribution,18,11,7
30268,Retsupreme,tichondrius,1056,paladin,retribution,18,11,7
30269,Dasp,nagrand,1056,paladin,retribution,18,11,7
30270,Hardnow,emerald-dream,1056,paladin,retribution,24,11,13
30271,Makayla,kiljaeden,1056,paladin,retribution,24,11,13
30272,Wogharder,stormrage,1056,paladin,retribution,30,11,19
30273,Siq,arthas,1056,paladin,retribution,30,11,19
30274,Bakednub,malganis,1056,paladin,retribution,35,11,24
30275,Redarted,thrall,1055,paladin,retribution,18,11,7
30276,Volcathos,moon-guard,1055,paladin,retribution,18,11,7
30277,Ricocheto,ragnaros,1055,paladin,retribution,18,11,7
30278,Wonpaiv,frostmourne,1055,paladin,retribution,18,11,7
30279,Jakkatähn,malganis,1055,paladin,retribution,24,11,13
30280,Thrandeill,bleeding-hollow,1055,paladin,retribution,24,11,13
30281,Kmackk,tichondrius,1055,paladin,retribution,24,11,13
30282,Armstrong,azralon,1055,paladin,retribution,24,11,13
30283,Pugnacity,stormrage,1055,paladin,retribution,30,11,19
30284,Imposstopzc,chogall,1055,paladin,retribution,53,19,34
30285,Grimven,stormrage,1054,paladin,retribution,18,11,7
30286,Hrota,laughing-skull,1054,paladin,retribution,18,11,7
30287,Gannecus,bleeding-hollow,1054,paladin,retribution,18,11,7
30288,Arena,mannoroth,1054,paladin,retribution,24,11,13
30289,Protarena,zuljin,1054,paladin,retribution,24,11,13
30290,Telvannî,sargeras,1054,paladin,retribution,24,11,13
30291,Pallyzo,zuljin,1054,paladin,retribution,24,11,13
30292,Varaben,sargeras,1054,paladin,retribution,36,11,25
30293,Ðreschí,ragnaros,1053,paladin,retribution,22,11,11
30294,Dividin,stormrage,1053,paladin,retribution,24,11,13
30295,Vincible,illidan,1053,paladin,retribution,24,11,13
30296,Divineknight,moonrunner,1053,paladin,retribution,24,11,13
30297,Cripplemakër,stormrage,1052,paladin,retribution,18,11,7
30298,Vynesonia,emerald-dream,1052,paladin,retribution,21,12,9
30299,Brolando,hyjal,1052,paladin,retribution,24,11,13
30300,Jåckél,wyrmrest-accord,1052,paladin,retribution,30,11,19
30301,Iesous,kiljaeden,1051,paladin,retribution,18,11,7
30302,Ragnore,shadow-council,1051,paladin,retribution,21,12,9
30303,Exulta,illidan,1051,paladin,retribution,60,32,28
30304,Daeriius,moon-guard,1051,paladin,retribution,24,11,13
30305,Dominance,blackrock,1051,paladin,retribution,24,11,13
30306,Sleekz,moon-guard,1051,paladin,retribution,24,11,13
30307,Hermacles,stormrage,1051,paladin,retribution,25,11,14
30308,Libertylol,tichondrius,1051,paladin,retribution,28,12,16
30309,Släyèr,tichondrius,1051,paladin,retribution,30,11,19
30310,Caonizumu,area-52,1051,paladin,retribution,30,11,19
30311,Ranthoril,hydraxis,1050,paladin,retribution,12,11,1
30312,Vankaer,uldum,1050,paladin,retribution,18,11,7
30313,Cowhair,tichondrius,1050,paladin,retribution,24,11,13
30314,Tacohuntter,stormrage,1050,paladin,retribution,24,11,13
30315,Kaélthas,eonar,1050,paladin,retribution,24,11,13
30316,Connore,stormrage,1050,paladin,retribution,24,11,13
30317,Saîntpaul,shattered-halls,1050,paladin,retribution,30,11,19
30318,Ødin,turalyon,1049,paladin,retribution,18,11,7
30319,Freÿdis,tichondrius,1049,paladin,retribution,18,11,7
30320,Reaslovak,jubeithos,1049,paladin,retribution,18,11,7
30321,Mangguo,tichondrius,1049,paladin,retribution,24,11,13
30322,Gringi,blackrock,1049,paladin,retribution,24,11,13
30323,Amlovích,quelthalas,1049,paladin,retribution,24,11,13
30324,Wingalings,malganis,1049,paladin,retribution,28,12,16
30325,Morghelm,stormrage,1048,paladin,retribution,12,11,1
30326,Unknownplay,tichondrius,1048,paladin,retribution,18,11,7
30327,Lïgma,dalaran,1048,paladin,retribution,18,11,7
30328,Jajabola,zuljin,1048,paladin,retribution,24,11,13
30329,Dorka,illidan,1048,paladin,retribution,30,11,19
30330,Teewrecks,frostmourne,1048,paladin,retribution,30,11,19
30331,Tieberion,bleeding-hollow,1048,paladin,retribution,30,11,19
30332,Pappábear,tichondrius,1047,paladin,retribution,26,16,10
30333,Everyni,area-52,1047,paladin,retribution,18,11,7
30334,Stonekey,warsong,1046,paladin,retribution,18,11,7
30335,Kiboko,tichondrius,1046,paladin,retribution,19,11,8
30336,Pickypally,moon-guard,1046,paladin,retribution,30,17,13
30337,Lunchboxz,nazjatar,1046,paladin,retribution,24,11,13
30338,Flashbang,nazgrel,1046,paladin,retribution,30,11,19
30339,Pâpito,drakkari,1046,paladin,retribution,30,11,19
30340,Doogo,cenarius,1045,paladin,retribution,18,11,7
30341,Souiler,thunderlord,1045,paladin,retribution,22,12,10
30342,Guji,jubeithos,1045,paladin,retribution,24,11,13
30343,Kènjii,sargeras,1044,paladin,retribution,40,20,20
30344,Strobeyjr,tichondrius,1044,paladin,retribution,24,11,13
30345,Rensvall,frostmourne,1043,paladin,retribution,24,13,11
30346,Çløúdéd,area-52,1043,paladin,retribution,24,11,13
30347,Berthalas,stormrage,1042,paladin,retribution,18,11,7
30348,Pallyjs,anetheron,1042,paladin,retribution,18,11,7
30349,Biblestomp,laughing-skull,1042,paladin,retribution,18,11,7
30350,Brocolinî,zuljin,1042,paladin,retribution,24,11,13
30351,Holyfilers,thunderlord,1042,paladin,retribution,30,11,19
30352,Weenerboy,nerzhul,1041,paladin,retribution,18,11,7
30353,Ilumine,mannoroth,1041,paladin,retribution,24,11,13
30354,Neutroo,stormrage,1039,paladin,retribution,24,11,13
30355,Ceebuck,thrall,1038,paladin,retribution,24,11,13
30356,Fenfrineflo,azralon,1035,paladin,retribution,42,13,29
30357,Willhookah,azralon,1034,paladin,retribution,54,25,29
30358,Bainn,nerzhul,1033,paladin,retribution,49,28,21
30359,Mortika,frostmourne,1033,paladin,retribution,36,17,19
30360,Kryzshine,frostmourne,1030,paladin,retribution,18,11,7
30361,Atreuss,moon-guard,1029,paladin,retribution,42,21,21
30362,Asunima,wyrmrest-accord,1029,paladin,retribution,24,11,13
30363,Dreadain,gilneas,1027,paladin,retribution,24,11,13
30364,Holyqunt,dalaran,1026,paladin,retribution,24,11,13
30365,Murtsza,ragnaros,1026,paladin,retribution,60,21,39
30366,Moraxeus,gundrak,1020,paladin,retribution,18,11,7
30367,Theseuus,stormrage,1020,paladin,retribution,60,27,33
30368,Furnost,drenden,1019,paladin,retribution,23,11,12
30369,Wasimodo,emerald-dream,1019,paladin,retribution,66,31,35
30370,Pleasureman,gallywix,1017,paladin,retribution,24,12,12
30371,Volorick,dalaran,1016,paladin,retribution,38,13,25
30372,Sisterbubble,dathremar,1013,paladin,retribution,29,11,18
30373,Dirtfunk,illidan,1011,paladin,retribution,48,18,30
30374,Alpine,nordrassil,1009,paladin,retribution,85,44,41
30375,Nejie,nazjatar,1009,paladin,retribution,42,21,21
30376,Tuff,ysera,1008,paladin,retribution,36,21,15
30377,Keu,emerald-dream,1008,paladin,retribution,63,26,37
30378,Judgingu,proudmoore,1006,paladin,retribution,21,11,10
30379,Chilenoman,ragnaros,1004,paladin,retribution,48,21,27
30380,Loween,thunderlord,1002,paladin,retribution,54,22,32
30381,Smithulu,kelthuzad,997,paladin,retribution,45,24,21
30382,Tyrswrath,sargeras,992,paladin,retribution,36,19,17
30383,Bigsamtp,laughing-skull,992,paladin,retribution,23,11,12
30384,Whitepally,kiljaeden,992,paladin,retribution,28,11,17
30385,Iammj,skywall,990,paladin,retribution,17,11,6
30386,Guanglong,malganis,989,paladin,retribution,32,11,21
30387,Ssparkk,stormrage,989,paladin,retribution,35,12,23
30388,Veroth,caelestrasz,988,paladin,retribution,26,11,15
30389,Lêe,dalaran,987,paladin,retribution,15,12,3
30390,Tharkeves,cenarius,987,paladin,retribution,22,11,11
30391,Playandrunn,illidan,984,paladin,retribution,22,11,11
30392,Vinjonc,drenden,977,paladin,retribution,60,30,30
30393,Webby,azjolnerub,975,paladin,retribution,26,12,14
30394,Hammerhitter,lightbringer,972,paladin,retribution,36,14,22
30395,Follower,sargeras,967,paladin,retribution,71,31,40
30396,Cès,tichondrius,960,paladin,retribution,12,10,2
30397,Bigfkndam,dathremar,960,paladin,retribution,12,10,2
30398,Eloinflated,malganis,960,paladin,retribution,18,10,8
30399,Überlin,whisperwind,960,paladin,retribution,18,10,8
30400,Ripsader,stormrage,960,paladin,retribution,18,10,8
30401,Meleegodx,darkspear,960,paladin,retribution,18,10,8
30402,Hyphenated,frostmourne,960,paladin,retribution,18,10,8
30403,Hasmere,tichondrius,960,paladin,retribution,18,10,8
30404,Bigboiszn,area-52,960,paladin,retribution,18,10,8
30405,Saven,proudmoore,960,paladin,retribution,18,10,8
30406,Tiduz,tichondrius,960,paladin,retribution,18,10,8
30407,Khanid,emerald-dream,960,paladin,retribution,18,10,8
30408,Èmmà,stormrage,960,paladin,retribution,18,10,8
30409,Emiaru,illidan,960,paladin,retribution,22,11,11
30410,Fumaçaa,nemesis,960,paladin,retribution,27,13,14
30411,Giovannas,tichondrius,960,paladin,retribution,24,10,14
30412,Legèndaïry,tichondrius,960,paladin,retribution,24,10,14
30413,Randomwalk,illidan,960,paladin,retribution,24,10,14
30414,Talionz,illidan,960,paladin,retribution,24,10,14
30415,Friendfriend,proudmoore,960,paladin,retribution,24,10,14
30416,Alodor,dalaran,960,paladin,retribution,24,10,14
30417,Komonai,illidan,960,paladin,retribution,24,10,14
30418,Miketavius,moon-guard,960,paladin,retribution,24,10,14
30419,Drriz,stormrage,960,paladin,retribution,24,10,14
30420,Wryly,mannoroth,960,paladin,retribution,30,10,20
30421,Gompa,bleeding-hollow,960,paladin,retribution,30,10,20
30422,Kasoon,illidan,959,paladin,retribution,12,10,2
30423,Bop,azralon,959,paladin,retribution,12,10,2
30424,Strattaltork,ragnaros,959,paladin,retribution,18,10,8
30425,Shawra,moon-guard,959,paladin,retribution,18,10,8
30426,Kayaman,tichondrius,959,paladin,retribution,18,10,8
30427,Lightsheart,lightbringer,959,paladin,retribution,18,10,8
30428,Daeyang,tichondrius,959,paladin,retribution,18,10,8
30429,Astraelon,bleeding-hollow,959,paladin,retribution,18,10,8
30430,ßöbby,sargeras,959,paladin,retribution,18,10,8
30431,Yugawn,maiev,959,paladin,retribution,18,10,8
30432,Kaetix,frostmourne,959,paladin,retribution,18,10,8
30433,Lawzaddy,tichondrius,959,paladin,retribution,18,10,8
30434,Andriaana,moon-guard,959,paladin,retribution,18,10,8
30435,Lyghts,darkspear,959,paladin,retribution,18,10,8
30436,Grimmune,illidan,959,paladin,retribution,24,10,14
30437,Déathkiing,area-52,959,paladin,retribution,24,10,14
30438,Dithfeo,tichondrius,959,paladin,retribution,24,10,14
30439,Roddaric,nerzhul,959,paladin,retribution,24,10,14
30440,Zetka,tichondrius,959,paladin,retribution,24,10,14
30441,Hôtt,kul-tiras,959,paladin,retribution,24,10,14
30442,Tazanian,aegwynn,959,paladin,retribution,24,10,14
30443,Runö,frostmourne,959,paladin,retribution,37,10,27
30444,Littlebadbad,tichondrius,958,paladin,retribution,12,10,2
30445,Sathras,madoran,958,paladin,retribution,18,10,8
30446,Deadpoolman,emerald-dream,958,paladin,retribution,18,10,8
30447,Svenn,eredar,958,paladin,retribution,18,10,8
30448,Noitra,azralon,958,paladin,retribution,18,10,8
30449,Zyden,hellscream,958,paladin,retribution,18,10,8
30450,Bootcrusader,thrall,958,paladin,retribution,21,11,10
30451,Avengercc,tichondrius,958,paladin,retribution,24,10,14
30452,Benevolént,area-52,958,paladin,retribution,24,10,14
30453,Korranix,sargeras,958,paladin,retribution,28,11,17
30454,Krønos,nordrassil,958,paladin,retribution,28,11,17
30455,Verdicts,moon-guard,958,paladin,retribution,30,10,20
30456,Fokatayew,korialstrasz,958,paladin,retribution,30,10,20
30457,Donmi,dalaran,957,paladin,retribution,15,11,4
30458,Checkeettpal,sargeras,957,paladin,retribution,18,10,8
30459,Grünt,ragnaros,957,paladin,retribution,18,10,8
30460,Olsen,stormrage,957,paladin,retribution,18,10,8
30461,Poobiotic,frostmourne,957,paladin,retribution,18,10,8
30462,Luxord,ysera,957,paladin,retribution,22,11,11
30463,Retxmack,lightnings-blade,957,paladin,retribution,24,10,14
30464,Rektodin,tichondrius,957,paladin,retribution,24,10,14
30465,Petunias,malganis,957,paladin,retribution,30,10,20
30466,Brifos,sargeras,957,paladin,retribution,31,10,21
30467,Vulkaros,azralon,956,paladin,retribution,12,10,2
30468,Vacoro,tichondrius,956,paladin,retribution,18,10,8
30469,Caylorn,illidan,956,paladin,retribution,18,10,8
30470,Ryumi,lightbringer,956,paladin,retribution,24,10,14
30471,Runscapemain,feathermoon,955,paladin,retribution,22,11,11
30472,Bigjwpb,illidan,955,paladin,retribution,244,117,127
30473,Vólko,frostmourne,955,paladin,retribution,21,10,11
30474,Flyinpankake,illidan,955,paladin,retribution,24,10,14
30475,Heälmeñow,tichondrius,955,paladin,retribution,24,10,14
30476,Winbott,sargeras,955,paladin,retribution,30,10,20
30477,Torujo,drakkari,954,paladin,retribution,18,10,8
30478,Lunchboxpaly,stormrage,954,paladin,retribution,18,10,8
30479,Cacaine,goldrinn,954,paladin,retribution,21,11,10
30480,Kelenis,bonechewer,954,paladin,retribution,24,10,14
30481,Tomcat,bladefist,954,paladin,retribution,24,10,14
30482,Sòl,stormrage,954,paladin,retribution,24,10,14
30483,Didymus,boulderfist,954,paladin,retribution,41,17,24
30484,Coffiecup,frostmane,953,paladin,retribution,18,10,8
30485,Kelleybelly,black-dragonflight,953,paladin,retribution,25,10,15
30486,Llght,hydraxis,952,paladin,retribution,18,10,8
30487,Aura,stormreaver,952,paladin,retribution,18,10,8
30488,Exeneyder,elune,952,paladin,retribution,25,10,15
30489,Housemix,gurubashi,951,paladin,retribution,18,12,6
30490,Edjr,stormrage,951,paladin,retribution,18,10,8
30491,Giancenna,illidan,950,paladin,retribution,18,10,8
30492,Aewein,ragnaros,950,paladin,retribution,23,10,13
30493,Lionag,ragnaros,950,paladin,retribution,24,10,14
30494,Xhotbutters,korgath,945,paladin,retribution,31,13,18
30495,Ridethispony,tichondrius,945,paladin,retribution,36,10,26
30496,Mehchelol,azgalor,939,paladin,retribution,36,19,17
30497,Unicochori,drakkari,939,paladin,retribution,24,10,14
30498,Charopiinho,azralon,938,paladin,retribution,30,10,20
30499,Sanctum,barthilas,936,paladin,retribution,153,72,81
30500,Bigboytime,area-52,934,paladin,retribution,24,10,14
30501,Lailaa,balnazzar,932,paladin,retribution,30,13,17
30502,Cherrypally,area-52,927,paladin,retribution,23,10,13
30503,Nerfret,zuljin,926,paladin,retribution,14,11,3
30504,Celerios,stormreaver,926,paladin,retribution,19,11,8
30505,Cuthroat,area-52,926,paladin,retribution,318,156,162
30506,Biggin,garona,924,paladin,retribution,136,51,85
30507,Bukkning,tichondrius,922,paladin,retribution,58,17,41
30508,Pallyoh,moknathal,921,paladin,retribution,41,23,18
30509,Vengecide,proudmoore,920,paladin,retribution,24,13,11
30510,Kokuryuha,quelthalas,919,paladin,retribution,52,24,28
30511,Diësëlsmoke,bronzebeard,917,paladin,retribution,18,10,8
30512,Toepuller,doomhammer,917,paladin,retribution,42,21,21
30513,Slædgæhæmmær,bonechewer,917,paladin,retribution,42,13,29
30514,Brandforge,thunderlord,916,paladin,retribution,18,10,8
30515,Goldranger,hakkar,916,paladin,retribution,42,22,20
30516,Elgigante,azshara,914,paladin,retribution,48,25,23
30517,Avlystein,wyrmrest-accord,914,paladin,retribution,89,29,60
30518,Taéyeon,quelthalas,911,paladin,retribution,21,10,11
30519,Rebukezz,dalaran,911,paladin,retribution,23,10,13
30520,Stinaz,quelthalas,911,paladin,retribution,23,10,13
30521,Eljefee,emerald-dream,902,paladin,retribution,29,12,17
30522,Zentrick,whisperwind,902,paladin,retribution,42,16,26
30523,Lilsquirt,proudmoore,901,paladin,retribution,23,14,9
30524,Nuisances,illidan,899,paladin,retribution,18,10,8
30525,Kilidin,illidan,899,paladin,retribution,21,10,11
30526,Iralyn,frostmane,899,paladin,retribution,24,10,14
30527,Denthor,lightbringer,894,paladin,retribution,20,10,10
30528,Leennoox,quelthalas,894,paladin,retribution,41,17,24
30529,Narthres,drakkari,894,paladin,retribution,28,10,18
30530,Tectorr,proudmoore,893,paladin,retribution,78,38,40
30531,Àmárìs,tichondrius,882,paladin,retribution,22,10,12
30532,Releváncé,frostmourne,879,paladin,retribution,33,10,23
30533,Allandaa,frostmourne,878,paladin,retribution,25,10,15
30534,Dragollias,anvilmar,874,paladin,retribution,30,10,20
30535,Deltajk,drakkari,872,paladin,retribution,42,19,23
30536,Jonnywick,duskwood,872,paladin,retribution,36,13,23
30537,Juang,arthas,866,paladin,retribution,54,24,30
30538,Akumasakana,earthen-ring,864,paladin,retribution,12,9,3
30539,Divenelena,sargeras,864,paladin,retribution,12,9,3
30540,Skinnipeen,frostmourne,864,paladin,retribution,12,9,3
30541,Arukan,ragnaros,864,paladin,retribution,12,9,3
30542,Notprot,zuljin,864,paladin,retribution,12,9,3
30543,Raggnarokk,kelthuzad,864,paladin,retribution,12,9,3
30544,Naughtygames,area-52,864,paladin,retribution,12,9,3
30545,Arimae,turalyon,864,paladin,retribution,12,9,3
30546,Swegswog,frostmourne,864,paladin,retribution,12,9,3
30547,Slivkoff,wyrmrest-accord,864,paladin,retribution,12,9,3
30548,Fierfox,moon-guard,864,paladin,retribution,12,9,3
30549,Chrigpal,tichondrius,864,paladin,retribution,12,9,3
30550,Sonô,sargeras,864,paladin,retribution,12,9,3
30551,Tlawn,tichondrius,864,paladin,retribution,18,9,9
30552,Brohtato,area-52,864,paladin,retribution,18,9,9
30553,Rendyrend,frostmourne,864,paladin,retribution,18,9,9
30554,Bigdixss,tichondrius,864,paladin,retribution,18,9,9
30555,Zzerox,ragnaros,864,paladin,retribution,18,9,9
30556,Nite,thrall,864,paladin,retribution,18,9,9
30557,Héber,nemesis,864,paladin,retribution,18,9,9
30558,Rockdeath,sargeras,864,paladin,retribution,18,9,9
30559,Beefdaddyx,tichondrius,864,paladin,retribution,18,9,9
30560,Wogyu,area-52,864,paladin,retribution,18,9,9
30561,Strodvarn,proudmoore,864,paladin,retribution,18,9,9
30562,Axeliee,kiljaeden,864,paladin,retribution,18,9,9
30563,Yáhtzee,tichondrius,864,paladin,retribution,22,10,12
30564,Althsar,thunderlord,864,paladin,retribution,26,11,15
30565,Bageru,gnomeregan,864,paladin,retribution,24,9,15
30566,Manryux,tichondrius,864,paladin,retribution,24,9,15
30567,Hulfsark,stormrage,864,paladin,retribution,24,9,15
30568,Suro,moon-guard,864,paladin,retribution,24,9,15
30569,Yowanehaku,illidan,864,paladin,retribution,24,9,15
30570,Pistis,kelthuzad,864,paladin,retribution,24,9,15
30571,Traevel,moon-guard,864,paladin,retribution,24,9,15
30572,Auranove,azralon,864,paladin,retribution,24,9,15
30573,Valinorean,nemesis,864,paladin,retribution,24,9,15
30574,Stoof,arygos,864,paladin,retribution,24,9,15
30575,Ownedcrazy,stormrage,864,paladin,retribution,24,9,15
30576,Saintgeórge,frostmourne,864,paladin,retribution,25,9,16
30577,Doxan,quelthalas,864,paladin,retribution,30,9,21
30578,Stolzy,tichondrius,864,paladin,retribution,31,9,22
30579,Mightymagnus,silvermoon,863,paladin,retribution,12,9,3
30580,Glorious,drakkari,863,paladin,retribution,12,9,3
30581,Tayvar,stormrage,863,paladin,retribution,12,9,3
30582,Mightythorxx,tichondrius,863,paladin,retribution,12,9,3
30583,Heathen,spirestone,863,paladin,retribution,12,9,3
30584,Spruk,greymane,863,paladin,retribution,12,9,3
30585,Veliona,thaurissan,863,paladin,retribution,12,9,3
30586,Lenlaar,shadowsong,863,paladin,retribution,12,9,3
30587,Pallyofhell,area-52,863,paladin,retribution,12,9,3
30588,Valandur,kelthuzad,863,paladin,retribution,18,9,9
30589,Jhaann,tichondrius,863,paladin,retribution,18,9,9
30590,Paliwarrior,illidan,863,paladin,retribution,18,9,9
30591,Drinkn,kelthuzad,863,paladin,retribution,18,9,9
30592,Relsetta,sargeras,863,paladin,retribution,18,9,9
30593,Holyweaponz,sargeras,863,paladin,retribution,18,9,9
30594,Avacii,illidan,863,paladin,retribution,18,9,9
30595,Landryy,icecrown,863,paladin,retribution,18,9,9
30596,Ahzalon,azralon,863,paladin,retribution,18,9,9
30597,Lightballz,vashj,863,paladin,retribution,18,9,9
30598,Enril,azgalor,863,paladin,retribution,18,9,9
30599,Ltt,dalaran,863,paladin,retribution,18,9,9
30600,Wálker,ragnaros,863,paladin,retribution,18,9,9
30601,Hailsatans,ragnaros,863,paladin,retribution,18,9,9
30602,Remorâ,blackrock,863,paladin,retribution,18,9,9
30603,Wimans,quelthalas,863,paladin,retribution,18,9,9
30604,Escanøor,stormrage,863,paladin,retribution,18,9,9
30605,Wideloadphd,malganis,863,paladin,retribution,18,9,9
30606,Heizero,area-52,863,paladin,retribution,18,9,9
30607,Hammertime,boulderfist,863,paladin,retribution,18,9,9
30608,Ironprice,tichondrius,863,paladin,retribution,18,9,9
30609,Mohrdeth,bonechewer,863,paladin,retribution,18,9,9
30610,Loraven,wyrmrest-accord,863,paladin,retribution,18,9,9
30611,Dreamlightz,tichondrius,863,paladin,retribution,18,9,9
30612,Trevion,malganis,863,paladin,retribution,24,9,15
30613,Mateeka,malganis,863,paladin,retribution,24,9,15
30614,Rivzx,tichondrius,863,paladin,retribution,24,9,15
30615,Stricken,kul-tiras,863,paladin,retribution,24,9,15
30616,Delvious,proudmoore,863,paladin,retribution,24,9,15
30617,Terrordin,illidan,863,paladin,retribution,24,9,15
30618,Galadriele,zuljin,863,paladin,retribution,24,9,15
30619,Amntir,sargeras,863,paladin,retribution,24,9,15
30620,Nuuska,dalaran,863,paladin,retribution,24,9,15
30621,Roländ,thrall,863,paladin,retribution,24,9,15
30622,Thickdam,korgath,863,paladin,retribution,24,9,15
30623,Zerohöur,emerald-dream,863,paladin,retribution,30,9,21
30624,Deddy,malganis,863,paladin,retribution,30,9,21
30625,Zrkoria,ragnaros,863,paladin,retribution,36,9,27
30626,Zero,garona,863,paladin,retribution,36,9,27
30627,Ástedór,ragnaros,862,paladin,retribution,12,9,3
30628,Sabêr,ragnaros,862,paladin,retribution,12,9,3
30629,Badboí,azralon,862,paladin,retribution,12,9,3
30630,Keiora,sargeras,862,paladin,retribution,12,9,3
30631,Fante,alleria,862,paladin,retribution,16,10,6
30632,Chàrron,garrosh,862,paladin,retribution,18,9,9
30633,Surrogat,ragnaros,862,paladin,retribution,18,9,9
30634,Lightblade,stormrage,862,paladin,retribution,18,9,9
30635,Rocknpally,icecrown,862,paladin,retribution,18,9,9
30636,Naritan,greymane,862,paladin,retribution,18,9,9
30637,Pinelli,aegwynn,862,paladin,retribution,18,9,9
30638,Xlnc,illidan,862,paladin,retribution,18,9,9
30639,Illëst,stormrage,862,paladin,retribution,18,9,9
30640,Omegaziion,garrosh,862,paladin,retribution,18,9,9
30641,Karelys,area-52,862,paladin,retribution,20,9,11
30642,Ashric,moon-guard,862,paladin,retribution,24,9,15
30643,Aewynn,nemesis,862,paladin,retribution,24,9,15
30644,Boogerred,korialstrasz,862,paladin,retribution,24,9,15
30645,Gerian,altar-of-storms,862,paladin,retribution,24,9,15
30646,Retligious,kelthuzad,861,paladin,retribution,12,9,3
30647,Stevas,khazgoroth,861,paladin,retribution,12,9,3
30648,Ringout,tichondrius,861,paladin,retribution,18,9,9
30649,Borélock,kelthuzad,861,paladin,retribution,18,9,9
30650,Kommuna,stormscale,861,paladin,retribution,18,9,9
30651,Clamhammer,malganis,861,paladin,retribution,18,9,9
30652,Guttis,nemesis,861,paladin,retribution,18,9,9
30653,Aerandír,stormrage,861,paladin,retribution,18,9,9
30654,Ashess,sargeras,861,paladin,retribution,24,9,15
30655,Rennalux,stormrage,861,paladin,retribution,24,9,15
30656,Deztrom,dalaran,860,paladin,retribution,12,9,3
30657,Punjabeast,illidan,860,paladin,retribution,16,10,6
30658,Jiasmat,ragnaros,860,paladin,retribution,28,12,16
30659,Unholypally,suramar,860,paladin,retribution,24,9,15
30660,Rusticles,aerie-peak,860,paladin,retribution,24,9,15
30661,Lexdor,quelthalas,860,paladin,retribution,30,9,21
30662,Easiestcomp,sargeras,859,paladin,retribution,18,9,9
30663,Khetzi,thunderhorn,859,paladin,retribution,18,9,9
30664,Kylarha,stormrage,859,paladin,retribution,18,9,9
30665,Layonthis,the-venture-co,859,paladin,retribution,18,9,9
30666,Mòse,emerald-dream,859,paladin,retribution,18,9,9
30667,Atularis,tichondrius,858,paladin,retribution,12,9,3
30668,Irongiant,grizzly-hills,858,paladin,retribution,18,9,9
30669,Derethen,emerald-dream,858,paladin,retribution,18,9,9
30670,Alysca,tichondrius,858,paladin,retribution,18,9,9
30671,Abuenano,ragnaros,857,paladin,retribution,12,9,3
30672,Vick,zuljin,857,paladin,retribution,12,9,3
30673,Holyzeen,darkspear,857,paladin,retribution,17,11,6
30674,Alerz,moon-guard,857,paladin,retribution,15,9,6
30675,Amyrana,medivh,857,paladin,retribution,24,9,15
30676,Frostbitee,nerzhul,856,paladin,retribution,18,9,9
30677,Atilas,ragnaros,856,paladin,retribution,18,9,9
30678,Zerolayer,proudmoore,855,paladin,retribution,12,9,3
30679,Maraboujan,nemesis,855,paladin,retribution,18,9,9
30680,Persefaní,moon-guard,855,paladin,retribution,18,9,9
30681,Clariten,ghostlands,855,paladin,retribution,24,9,15
30682,Agonyss,quelthalas,853,paladin,retribution,18,9,9
30683,Goldfînger,zuljin,853,paladin,retribution,24,9,15
30684,Jade,black-dragonflight,853,paladin,retribution,30,9,21
30685,Eldirn,bleeding-hollow,848,paladin,retribution,18,9,9
30686,Leyon,alterac-mountains,847,paladin,retribution,18,9,9
30687,Elysés,stormrage,846,paladin,retribution,17,9,8
30688,Morthalos,moon-guard,845,paladin,retribution,23,9,14
30689,Reti,ursin,844,paladin,retribution,193,94,99
30690,Hotdgwatr,bleeding-hollow,843,paladin,retribution,24,10,14
30691,Avaheal,dragonmaw,842,paladin,retribution,23,9,14
30692,Palgiga,tichondrius,834,paladin,retribution,18,9,9
30693,Palee,garrosh,833,paladin,retribution,44,19,25
30694,Brioc,tichondrius,832,paladin,retribution,22,9,13
30695,Lemuzinho,ragnaros,831,paladin,retribution,14,10,4
30696,Bellamor,burning-blade,830,paladin,retribution,17,9,8
30697,Poppmybubble,frostmourne,816,paladin,retribution,21,9,12
30698,Hallowgrave,moon-guard,815,paladin,retribution,11,9,2
30699,Sinica,barthilas,815,paladin,retribution,17,9,8
30700,Fiate,azralon,815,paladin,retribution,23,9,14
30701,ßirdie,ragnaros,814,paladin,retribution,23,9,14
30702,Yulzypal,tichondrius,813,paladin,retribution,17,9,8
30703,Cozzey,amanthul,810,paladin,retribution,17,9,8
30704,Naeamen,dragonmaw,808,paladin,retribution,15,10,5
30705,Porterhousee,bleeding-hollow,807,paladin,retribution,23,11,12
30706,Sondaar,madoran,807,paladin,retribution,65,18,47
30707,Zela,ghostlands,805,paladin,retribution,23,9,14
30708,Connextion,terenas,800,paladin,retribution,22,9,13
30709,Lizzyz,illidan,799,paladin,retribution,20,9,11
30710,Witewolf,illidan,798,paladin,retribution,19,10,9
30711,Erós,azralon,798,paladin,retribution,22,9,13
30712,Navex,tichondrius,797,paladin,retribution,16,9,7
30713,Gryphin,moon-guard,797,paladin,retribution,20,9,11
30714,Lightfdre,rexxar,797,paladin,retribution,33,11,22
30715,Kûrâmâ,ragnaros,796,paladin,retribution,16,9,7
30716,Kiloalpha,area-52,791,paladin,retribution,22,9,13
30717,Lítebearer,kelthuzad,787,paladin,retribution,17,9,8
30718,Kletüs,quelthalas,784,paladin,retribution,13,9,4
30719,Rspect,trollbane,782,paladin,retribution,11,9,2
30720,Jdisco,bonechewer,782,paladin,retribution,19,9,10
30721,Wrekkin,stormrage,772,paladin,retribution,37,9,28
30722,Retpa,tichondrius,768,paladin,retribution,12,8,4
30723,Hypheríon,ragnaros,768,paladin,retribution,12,8,4
30724,Franckz,ragnaros,768,paladin,retribution,12,8,4
30725,Pochanaw,wyrmrest-accord,768,paladin,retribution,12,8,4
30726,Liangguang,tichondrius,768,paladin,retribution,12,8,4
30727,Unicornslayr,antonidas,768,paladin,retribution,12,8,4
30728,Céllash,tichondrius,768,paladin,retribution,12,8,4
30729,Sebbytheman,tichondrius,768,paladin,retribution,12,8,4
30730,Tolliver,area-52,768,paladin,retribution,12,8,4
30731,Depøpulatìng,moon-guard,768,paladin,retribution,12,8,4
30732,Twobuttons,draktharon,768,paladin,retribution,12,8,4
30733,Lotarow,wyrmrest-accord,768,paladin,retribution,12,8,4
30734,Syorì,wyrmrest-accord,768,paladin,retribution,12,8,4
30735,Swellows,tichondrius,768,paladin,retribution,12,8,4
30736,Takinvcards,area-52,768,paladin,retribution,12,8,4
30737,Arellis,barthilas,768,paladin,retribution,12,8,4
30738,Valoren,spinebreaker,768,paladin,retribution,12,8,4
30739,Cratos,nemesis,768,paladin,retribution,12,8,4
30740,Illustrata,illidan,768,paladin,retribution,12,8,4
30741,Allpower,azralon,768,paladin,retribution,12,8,4
30742,Luzmu,azralon,768,paladin,retribution,12,8,4
30743,Pennywenny,barthilas,768,paladin,retribution,12,8,4
30744,Eskynor,sargeras,768,paladin,retribution,12,8,4
30745,Baloria,stormrage,768,paladin,retribution,12,8,4
30746,Brotherjon,stormrage,768,paladin,retribution,12,8,4
30747,Mortalbeef,zuljin,768,paladin,retribution,12,8,4
30748,Lastjedi,whisperwind,768,paladin,retribution,12,8,4
30749,Laboøn,stormrage,768,paladin,retribution,12,8,4
30750,Zelo,emerald-dream,768,paladin,retribution,12,8,4
30751,Meditaté,emerald-dream,768,paladin,retribution,12,8,4
30752,Soymilkdrnka,sargeras,768,paladin,retribution,12,8,4
30753,Djangø,azuremyst,768,paladin,retribution,12,8,4
30754,Cutebtw,zuljin,768,paladin,retribution,16,9,7
30755,Grimreaperx,azralon,768,paladin,retribution,17,8,9
30756,Zøzø,zuljin,768,paladin,retribution,18,8,10
30757,Jachugz,tichondrius,768,paladin,retribution,18,8,10
30758,Zaxxous,hyjal,768,paladin,retribution,18,8,10
30759,Ohmyglob,bleeding-hollow,768,paladin,retribution,18,8,10
30760,Mythbuster,frostwolf,768,paladin,retribution,18,8,10
30761,Nozfferatu,drakkari,768,paladin,retribution,18,8,10
30762,Roxiomoxa,ragnaros,768,paladin,retribution,18,8,10
30763,Roshord,quelthalas,768,paladin,retribution,18,8,10
30764,Xamo,drakkari,768,paladin,retribution,18,8,10
30765,Jerichô,destromath,768,paladin,retribution,18,8,10
30766,Maanuel,ragnaros,768,paladin,retribution,18,8,10
30767,Nikho,thunderlord,768,paladin,retribution,18,8,10
30768,Jeralldo,ragnaros,768,paladin,retribution,18,8,10
30769,Caution,rexxar,768,paladin,retribution,18,8,10
30770,Mizumaru,sargeras,768,paladin,retribution,18,8,10
30771,Ratkiller,barthilas,768,paladin,retribution,18,8,10
30772,Jebpal,tichondrius,768,paladin,retribution,18,8,10
30773,Turaylon,bloodscalp,768,paladin,retribution,18,8,10
30774,Vanquishy,burning-legion,768,paladin,retribution,18,8,10
30775,Dynamism,frostmourne,768,paladin,retribution,18,8,10
30776,Bubbletaunt,frostmourne,768,paladin,retribution,18,8,10
30777,Noansr,proudmoore,768,paladin,retribution,18,8,10
30778,Smiteup,sargeras,768,paladin,retribution,18,8,10
30779,Gersin,azralon,768,paladin,retribution,18,8,10
30780,Quiznossubs,kelthuzad,768,paladin,retribution,18,8,10
30781,Palakanda,azralon,768,paladin,retribution,18,8,10
30782,Inquísítor,stormrage,768,paladin,retribution,18,8,10
30783,Theehopper,shandris,768,paladin,retribution,18,8,10
30784,Deltronzerø,area-52,768,paladin,retribution,24,8,16
30785,Bergz,agamaggan,768,paladin,retribution,24,8,16
30786,Immunelf,azgalor,768,paladin,retribution,24,8,16
30787,Forgivers,kiljaeden,768,paladin,retribution,24,8,16
30788,Cnret,tichondrius,768,paladin,retribution,24,8,16
30789,Vibránium,tichondrius,768,paladin,retribution,24,8,16
30790,Rexpeitaboot,azralon,768,paladin,retribution,24,8,16
30791,Bubbleblade,burning-blade,768,paladin,retribution,24,8,16
30792,Marcopolo,azralon,768,paladin,retribution,24,8,16
30793,Isayas,tichondrius,768,paladin,retribution,24,8,16
30794,Crasíus,quelthalas,768,paladin,retribution,30,8,22
30795,Garethorne,illidan,768,paladin,retribution,30,8,22
30796,Roundhere,area-52,768,paladin,retribution,30,8,22
30797,Goldmembër,malganis,768,paladin,retribution,30,8,22
30798,Jarlsirius,tichondrius,767,paladin,retribution,12,8,4
30799,Keit,moon-guard,767,paladin,retribution,12,8,4
30800,Awsem,barthilas,767,paladin,retribution,12,8,4
30801,Hqknight,moon-guard,767,paladin,retribution,12,8,4
30802,Infamoustool,barthilas,767,paladin,retribution,12,8,4
30803,Gläd,tichondrius,767,paladin,retribution,12,8,4
30804,Hoelï,stormrage,767,paladin,retribution,12,8,4
30805,Smitetheweak,rivendare,767,paladin,retribution,12,8,4
30806,Invictus,onyxia,767,paladin,retribution,12,8,4
30807,Rhumil,tichondrius,767,paladin,retribution,12,8,4
30808,Acidhammer,kelthuzad,767,paladin,retribution,12,8,4
30809,Greybrox,barthilas,767,paladin,retribution,12,8,4
30810,Dinapal,frostmourne,767,paladin,retribution,12,8,4
30811,Gospel,duskwood,767,paladin,retribution,12,8,4
30812,Mægenta,tichondrius,767,paladin,retribution,12,8,4
30813,Baladine,zuljin,767,paladin,retribution,12,8,4
30814,Darkestday,hellscream,767,paladin,retribution,12,8,4
30815,Elhoj,illidan,767,paladin,retribution,12,8,4
30816,Sauceclock,illidan,767,paladin,retribution,12,8,4
30817,Faith,thorium-brotherhood,767,paladin,retribution,12,8,4
30818,Darkeclipse,area-52,767,paladin,retribution,12,8,4
30819,Meatyblessin,area-52,767,paladin,retribution,12,8,4
30820,Husurdaddy,dalaran,767,paladin,retribution,12,8,4
30821,Holydaddyy,area-52,767,paladin,retribution,12,8,4
30822,Brubb,illidan,767,paladin,retribution,18,8,10
30823,Angeluquis,quelthalas,767,paladin,retribution,18,8,10
30824,Yyh,illidan,767,paladin,retribution,18,8,10
30825,Blackmuu,malganis,767,paladin,retribution,18,8,10
30826,Jeffprobstt,kelthuzad,767,paladin,retribution,18,8,10
30827,Nutsmashèr,illidan,767,paladin,retribution,18,8,10
30828,Nooplug,illidan,767,paladin,retribution,18,8,10
30829,Nightfallz,farstriders,767,paladin,retribution,18,8,10
30830,Stroods,stormrage,767,paladin,retribution,18,8,10
30831,Janumbers,frostwolf,767,paladin,retribution,18,8,10
30832,Yurinos,illidan,767,paladin,retribution,18,8,10
30833,Zyras,whisperwind,767,paladin,retribution,18,8,10
30834,Avasti,proudmoore,767,paladin,retribution,18,8,10
30835,Toxanator,frostmourne,767,paladin,retribution,18,8,10
30836,Mhortái,stormrage,767,paladin,retribution,18,8,10
30837,Dontsleep,magtheridon,767,paladin,retribution,18,8,10
30838,Holytrev,tichondrius,767,paladin,retribution,18,8,10
30839,Yoiro,stormrage,767,paladin,retribution,18,8,10
30840,Hughkane,tichondrius,767,paladin,retribution,18,8,10
30841,Verbum,malfurion,767,paladin,retribution,18,8,10
30842,Sermon,moon-guard,767,paladin,retribution,18,8,10
30843,Hikarae,bleeding-hollow,767,paladin,retribution,18,8,10
30844,Rodsley,zuljin,767,paladin,retribution,18,8,10
30845,Bruhstice,area-52,767,paladin,retribution,18,8,10
30846,Gåbrîel,emerald-dream,767,paladin,retribution,18,8,10
30847,Yehdardi,frostmourne,767,paladin,retribution,18,8,10
30848,Doobiehigh,proudmoore,767,paladin,retribution,18,8,10
30849,Pudgë,bleeding-hollow,767,paladin,retribution,18,8,10
30850,Chriscoz,korgath,767,paladin,retribution,24,8,16
30851,Ollyollyawks,bloodscalp,767,paladin,retribution,24,8,16
30852,Shãnks,illidan,767,paladin,retribution,24,8,16
30853,Ashbrînger,emerald-dream,767,paladin,retribution,24,8,16
30854,Saifollah,area-52,767,paladin,retribution,30,8,22
30855,Judgementalz,frostwolf,766,paladin,retribution,12,8,4
30856,Palapeludo,azralon,766,paladin,retribution,12,8,4
30857,Passion,wyrmrest-accord,766,paladin,retribution,12,8,4
30858,Dreek,azralon,766,paladin,retribution,12,8,4
30859,Deesqueezie,area-52,766,paladin,retribution,12,8,4
30860,Bübbleboy,malganis,766,paladin,retribution,12,8,4
30861,Otorten,bladefist,766,paladin,retribution,12,8,4
30862,Dubledeez,malganis,766,paladin,retribution,12,8,4
30863,Wehrmachtt,emerald-dream,766,paladin,retribution,18,8,10
30864,Nussaar,kelthuzad,766,paladin,retribution,18,8,10
30865,Dalance,draka,766,paladin,retribution,18,8,10
30866,Dragonbait,khadgar,766,paladin,retribution,18,8,10
30867,Nevanethus,frostmourne,766,paladin,retribution,18,8,10
30868,Masho,skullcrusher,766,paladin,retribution,18,8,10
30869,Crtinsideyou,skullcrusher,766,paladin,retribution,21,9,12
30870,Hanael,quelthalas,766,paladin,retribution,19,8,11
30871,Mothh,terokkar,765,paladin,retribution,12,8,4
30872,Nikinaki,stormrage,765,paladin,retribution,12,8,4
30873,Holyhammered,kelthuzad,765,paladin,retribution,12,8,4
30874,Kristary,ragnaros,765,paladin,retribution,12,8,4
30875,Gírthbrooks,hyjal,765,paladin,retribution,12,8,4
30876,Peepilled,uldum,765,paladin,retribution,12,8,4
30877,Zuljaboi,thrall,765,paladin,retribution,12,8,4
30878,Darktaron,ragnaros,765,paladin,retribution,18,8,10
30879,Wexting,ragnaros,765,paladin,retribution,18,8,10
30880,Micurs,hyjal,765,paladin,retribution,24,8,16
30881,Lightahean,proudmoore,765,paladin,retribution,24,8,16
30882,Butchur,area-52,765,paladin,retribution,30,8,22
30883,Angelz,garrosh,764,paladin,retribution,18,8,10
30884,Calithia,destromath,764,paladin,retribution,18,8,10
30885,Xanamun,magtheridon,764,paladin,retribution,18,8,10
30886,Freesorrow,area-52,764,paladin,retribution,19,8,11
30887,Guccii,quelthalas,763,paladin,retribution,18,8,10
30888,Deathblazer,blades-edge,763,paladin,retribution,18,8,10
30889,Palade,proudmoore,763,paladin,retribution,18,8,10
30890,Mooroy,moon-guard,763,paladin,retribution,18,8,10
30891,Amorimbr,area-52,763,paladin,retribution,24,8,16
30892,Jebadia,proudmoore,762,paladin,retribution,12,8,4
30893,Faerdrik,emerald-dream,762,paladin,retribution,18,8,10
30894,Aetol,proudmoore,762,paladin,retribution,24,8,16
30895,Flisk,garona,761,paladin,retribution,12,8,4
30896,Gilmax,emerald-dream,760,paladin,retribution,18,8,10
30897,Slar,emerald-dream,760,paladin,retribution,18,8,10
30898,Mordrime,moon-guard,760,paladin,retribution,18,8,10
30899,Palman,frostmourne,759,paladin,retribution,18,8,10
30900,Trodos,quelthalas,758,paladin,retribution,12,8,4
30901,Aladid,aggramar,758,paladin,retribution,12,8,4
30902,Appolas,shattered-hand,758,paladin,retribution,12,8,4
30903,Chombe,tichondrius,758,paladin,retribution,18,8,10
30904,Populate,tichondrius,752,paladin,retribution,12,8,4
30905,Piojopaladin,quelthalas,752,paladin,retribution,25,8,17
30906,Supreme,farstriders,751,paladin,retribution,29,8,21
30907,Cleavix,tichondrius,751,paladin,retribution,35,8,27
30908,Captdangle,stormrage,750,paladin,retribution,12,8,4
30909,Dunecan,tichondrius,750,paladin,retribution,17,8,9
30910,Maelie,shadowmoon,749,paladin,retribution,12,8,4
30911,Oogablah,wyrmrest-accord,749,paladin,retribution,12,8,4
30912,Gemutlich,khazgoroth,748,paladin,retribution,23,8,15
30913,Jorkoh,the-scryers,747,paladin,retribution,29,8,21
30914,Shanuslight,moon-guard,742,paladin,retribution,21,9,12
30915,Yulasa,area-52,735,paladin,retribution,14,9,5
30916,Retartin,kelthuzad,735,paladin,retribution,20,9,11
30917,Hekki,ragnaros,735,paladin,retribution,19,8,11
30918,Xcream,nemesis,735,paladin,retribution,32,9,23
30919,Swholly,senjin,733,paladin,retribution,21,10,11
30920,Felordron,silvermoon,731,paladin,retribution,22,9,13
30921,Retgasm,drakthul,729,paladin,retribution,16,8,8
30922,Necrodar,ragnaros,722,paladin,retribution,14,9,5
30923,Darkpalaa,gallywix,722,paladin,retribution,18,8,10
30924,Bomdia,stormrage,720,paladin,retribution,15,8,7
30925,Whisk,tichondrius,720,paladin,retribution,15,8,7
30926,Oxoslayeroxo,firetree,717,paladin,retribution,21,8,13
30927,Romonite,bleeding-hollow,715,paladin,retribution,29,8,21
30928,Lilbursty,tichondrius,714,paladin,retribution,19,9,10
30929,Newwow,tichondrius,714,paladin,retribution,21,9,12
30930,Andorsi,elune,714,paladin,retribution,21,9,12
30931,Ryanslover,kelthuzad,714,paladin,retribution,23,9,14
30932,Pantheeon,altar-of-storms,713,paladin,retribution,30,9,21
30933,Kaallell,blackhand,710,paladin,retribution,22,9,13
30934,Andelk,tichondrius,703,paladin,retribution,14,9,5
30935,Chstypuller,tichondrius,703,paladin,retribution,22,8,14
30936,Mujika,area-52,702,paladin,retribution,14,8,6
30937,Zägä,quelthalas,702,paladin,retribution,26,8,18
30938,Wadalee,tichondrius,702,paladin,retribution,26,8,18
30939,Artaxerxes,stormrage,701,paladin,retribution,20,8,12
30940,Valdarin,emerald-dream,701,paladin,retribution,20,8,12
30941,Bratette,fenris,701,paladin,retribution,62,22,40
30942,Palaðu,azralon,700,paladin,retribution,14,8,6
30943,Kromcrush,azralon,700,paladin,retribution,16,8,8
30944,Fizzlewig,malganis,688,paladin,retribution,19,8,11
30945,Paullokis,gallywix,686,paladin,retribution,13,8,5
30946,Turtlehoof,thrall,684,paladin,retribution,19,8,11
30947,Sparklepuss,turalyon,676,paladin,retribution,17,8,9
30948,Paltarrd,bleeding-hollow,672,paladin,retribution,12,7,5
30949,Safename,area-52,672,paladin,retribution,12,7,5
30950,Nailuj,moon-guard,672,paladin,retribution,12,7,5
30951,Holyåvenger,thunderhorn,672,paladin,retribution,12,7,5
30952,Qsx,bleeding-hollow,672,paladin,retribution,12,7,5
30953,Near,saurfang,672,paladin,retribution,12,7,5
30954,Jellybrah,stormrage,672,paladin,retribution,12,7,5
30955,Araguaney,bleeding-hollow,672,paladin,retribution,12,7,5
30956,Garzzy,tichondrius,672,paladin,retribution,12,7,5
30957,Alahster,sargeras,672,paladin,retribution,12,7,5
30958,Uríel,frostmourne,672,paladin,retribution,12,7,5
30959,Dabbicus,tichondrius,672,paladin,retribution,12,7,5
30960,Noxtrael,frostmourne,672,paladin,retribution,12,7,5
30961,Kanaki,gilneas,672,paladin,retribution,12,7,5
30962,Rektributíon,area-52,672,paladin,retribution,12,7,5
30963,Pallisix,barthilas,672,paladin,retribution,12,7,5
30964,Griezadin,azgalor,672,paladin,retribution,12,7,5
30965,Bighoochie,moon-guard,672,paladin,retribution,12,7,5
30966,Skylightz,area-52,672,paladin,retribution,12,7,5
30967,Aurðra,kiljaeden,672,paladin,retribution,12,7,5
30968,Rexinarr,area-52,672,paladin,retribution,12,7,5
30969,Merkzz,arthas,672,paladin,retribution,12,7,5
30970,Condign,moon-guard,672,paladin,retribution,12,7,5
30971,Steezyret,barthilas,672,paladin,retribution,12,7,5
30972,Steelemantle,moon-guard,672,paladin,retribution,12,7,5
30973,Motivlight,area-52,672,paladin,retribution,12,7,5
30974,Imcjq,tichondrius,672,paladin,retribution,12,7,5
30975,Shadoweelite,sargeras,672,paladin,retribution,12,7,5
30976,Cëlestial,drakkari,672,paladin,retribution,12,7,5
30977,Supernampal,sargeras,672,paladin,retribution,12,7,5
30978,Unitiss,velen,672,paladin,retribution,12,7,5
30979,Wackobeef,barthilas,672,paladin,retribution,12,7,5
30980,Homelord,drakkari,672,paladin,retribution,12,7,5
30981,Naarumaster,stormrage,672,paladin,retribution,12,7,5
30982,Nutbro,tichondrius,672,paladin,retribution,12,7,5
30983,Boxader,dalaran,672,paladin,retribution,12,7,5
30984,Popwingsz,nemesis,672,paladin,retribution,12,7,5
30985,Montyer,ragnaros,672,paladin,retribution,12,7,5
30986,Turner,skullcrusher,672,paladin,retribution,12,7,5
30987,Trejetë,tichondrius,672,paladin,retribution,12,7,5
30988,Attackonpal,illidan,672,paladin,retribution,12,7,5
30989,Thephreak,madoran,672,paladin,retribution,12,7,5
30990,Schecterbug,stormrage,672,paladin,retribution,12,7,5
30991,Irahan,stormrage,672,paladin,retribution,12,7,5
30992,Mikâel,cairne,672,paladin,retribution,12,7,5
30993,Holreshee,tichondrius,672,paladin,retribution,12,7,5
30994,Laurenlight,tichondrius,672,paladin,retribution,12,7,5
30995,Holycar,illidan,672,paladin,retribution,12,7,5
30996,Paredes,demon-soul,672,paladin,retribution,12,7,5
30997,Meridional,tichondrius,672,paladin,retribution,12,7,5
30998,Eduardoap,azralon,672,paladin,retribution,12,7,5
30999,Montecrîsto,area-52,672,paladin,retribution,12,7,5
31000,Bootyfùnk,tichondrius,672,paladin,retribution,12,7,5
31001,Thüridan,azralon,672,paladin,retribution,12,7,5
31002,Iloveket,blackrock,672,paladin,retribution,12,7,5
31003,Tmwesker,azralon,672,paladin,retribution,12,7,5
31004,Teléza,illidan,672,paladin,retribution,12,7,5
31005,Fermion,illidan,672,paladin,retribution,12,7,5
31006,Slighted,illidan,672,paladin,retribution,12,7,5
31007,Wèbb,burning-legion,672,paladin,retribution,12,7,5
31008,Aurelea,frostmourne,672,paladin,retribution,12,7,5
31009,Layson,uldum,672,paladin,retribution,12,7,5
31010,Uprisen,daggerspine,672,paladin,retribution,12,7,5
31011,Mes,dragonmaw,672,paladin,retribution,12,7,5
31012,Brookeh,frostmourne,672,paladin,retribution,12,7,5
31013,Bigblackbull,whisperwind,672,paladin,retribution,12,7,5
31014,Chäinswellx,area-52,672,paladin,retribution,12,7,5
31015,Nosferätu,illidan,672,paladin,retribution,12,7,5
31016,Balduin,quelthalas,672,paladin,retribution,12,7,5
31017,Vozy,bronzebeard,672,paladin,retribution,12,7,5
31018,Khêll,sargeras,672,paladin,retribution,12,7,5
31019,Hèlfar,wyrmrest-accord,672,paladin,retribution,12,7,5
31020,Pals,bronzebeard,672,paladin,retribution,12,7,5
31021,Leaelda,wyrmrest-accord,672,paladin,retribution,16,8,8
31022,Paladan,tichondrius,672,paladin,retribution,17,7,10
31023,Anjocaído,nemesis,672,paladin,retribution,18,7,11
31024,Orin,guldan,672,paladin,retribution,18,7,11
31025,Shoresy,terokkar,672,paladin,retribution,18,7,11
31026,Neverwogx,kirin-tor,672,paladin,retribution,18,7,11
31027,Urukap,goldrinn,672,paladin,retribution,18,7,11
31028,Moistbible,kelthuzad,672,paladin,retribution,18,7,11
31029,Roundbutts,stormrage,672,paladin,retribution,18,7,11
31030,Gigantidab,tichondrius,672,paladin,retribution,18,7,11
31031,Valantor,anvilmar,672,paladin,retribution,18,7,11
31032,Knaring,aggramar,672,paladin,retribution,18,7,11
31033,Trfreedomz,frostmourne,672,paladin,retribution,18,7,11
31034,Vodulight,tichondrius,672,paladin,retribution,18,7,11
31035,Aldhebarán,ragnaros,672,paladin,retribution,18,7,11
31036,Paintpumper,malganis,672,paladin,retribution,18,7,11
31037,Hølyshyt,tichondrius,672,paladin,retribution,18,7,11
31038,Eurthswrath,lightbringer,672,paladin,retribution,18,7,11
31039,Nawwll,stonemaul,672,paladin,retribution,18,7,11
31040,Zotro,sargeras,672,paladin,retribution,18,7,11
31041,Vernon,ragnaros,672,paladin,retribution,18,7,11
31042,Kipow,proudmoore,672,paladin,retribution,18,7,11
31043,Tothegravetv,illidan,672,paladin,retribution,18,7,11
31044,Aledin,frostmourne,672,paladin,retribution,18,7,11
31045,Kloud,sargeras,672,paladin,retribution,18,7,11
31046,Cliftôn,illidan,672,paladin,retribution,18,7,11
31047,Bdaws,tichondrius,672,paladin,retribution,18,7,11
31048,Serinos,zuljin,672,paladin,retribution,18,7,11
31049,Absolution,gurubashi,672,paladin,retribution,18,7,11
31050,Solambul,tichondrius,672,paladin,retribution,18,7,11
31051,Ziti,bonechewer,672,paladin,retribution,18,7,11
31052,Lmac,frostmourne,672,paladin,retribution,18,7,11
31053,Teamamerica,proudmoore,672,paladin,retribution,18,7,11
31054,Xvetis,thrall,672,paladin,retribution,18,7,11
31055,Atalzel,kiljaeden,672,paladin,retribution,18,7,11
31056,Mayoclinic,frostmane,672,paladin,retribution,18,7,11
31057,Rebelion,nagrand,672,paladin,retribution,18,7,11
31058,Zugonomics,proudmoore,672,paladin,retribution,18,7,11
31059,Cylano,tichondrius,672,paladin,retribution,18,7,11
31060,Lakera,proudmoore,672,paladin,retribution,18,7,11
31061,Geospawn,bleeding-hollow,672,paladin,retribution,18,7,11
31062,Guidö,stormrage,672,paladin,retribution,22,8,14
31063,Kamí,elune,672,paladin,retribution,21,7,14
31064,Haimdallr,azralon,672,paladin,retribution,24,7,17
31065,Ballsmcgee,bleeding-hollow,672,paladin,retribution,24,7,17
31066,Digider,area-52,672,paladin,retribution,24,7,17
31067,Tenethor,area-52,672,paladin,retribution,24,7,17
31068,Kyuubî,bloodhoof,672,paladin,retribution,24,7,17
31069,Goozlight,area-52,672,paladin,retribution,24,7,17
31070,Heavener,tichondrius,672,paladin,retribution,24,7,17
31071,Hayden,stormscale,672,paladin,retribution,24,7,17
31072,Heilige,thrall,672,paladin,retribution,24,7,17
31073,Ganan,frostmane,672,paladin,retribution,24,7,17
31074,Spoelstra,dragonmaw,672,paladin,retribution,30,7,23
31075,Tanesdeline,area-52,671,paladin,retribution,12,7,5
31076,Holypillager,zuljin,671,paladin,retribution,12,7,5
31077,Darawin,korgath,671,paladin,retribution,12,7,5
31078,Palameme,hyjal,671,paladin,retribution,12,7,5
31079,Ðrêâð,kirin-tor,671,paladin,retribution,12,7,5
31080,Åphrodite,bleeding-hollow,671,paladin,retribution,12,7,5
31081,Joobas,zuljin,671,paladin,retribution,12,7,5
31082,Kizaru,shuhalo,671,paladin,retribution,12,7,5
31083,Zerofans,ragnaros,671,paladin,retribution,12,7,5
31084,Smuglý,wyrmrest-accord,671,paladin,retribution,12,7,5
31085,Lowkeyy,tichondrius,671,paladin,retribution,12,7,5
31086,Dillysdilly,zuljin,671,paladin,retribution,12,7,5
31087,Annii,aegwynn,671,paladin,retribution,12,7,5
31088,Krossret,thrall,671,paladin,retribution,12,7,5
31089,Xfiles,alterac-mountains,671,paladin,retribution,12,7,5
31090,Guthdrak,azgalor,671,paladin,retribution,12,7,5
31091,Holyretribut,tichondrius,671,paladin,retribution,12,7,5
31092,Tonytoi,aegwynn,671,paladin,retribution,12,7,5
31093,Loctár,tichondrius,671,paladin,retribution,12,7,5
31094,Jåy,nazjatar,671,paladin,retribution,12,7,5
31095,Prophesied,zuljin,671,paladin,retribution,12,7,5
31096,Lystia,malfurion,671,paladin,retribution,12,7,5
31097,Ironpaladin,sargeras,671,paladin,retribution,12,7,5
31098,Blingster,hellscream,671,paladin,retribution,12,7,5
31099,Dabnpaladin,moon-guard,671,paladin,retribution,12,7,5
31100,Koohny,stormrage,671,paladin,retribution,12,7,5
31101,Ranknoob,khazgoroth,671,paladin,retribution,12,7,5
31102,Thorean,sargeras,671,paladin,retribution,12,7,5
31103,Jaybbers,malganis,671,paladin,retribution,12,7,5
31104,Shivaku,area-52,671,paladin,retribution,12,7,5
31105,Elemezs,tichondrius,671,paladin,retribution,12,7,5
31106,Darktank,malganis,671,paladin,retribution,12,7,5
31107,Kaynè,senjin,671,paladin,retribution,12,7,5
31108,Shadd,destromath,671,paladin,retribution,12,7,5
31109,Mürdøx,illidan,671,paladin,retribution,12,7,5
31110,Hopebreaker,spinebreaker,671,paladin,retribution,12,7,5
31111,Ruca,icecrown,671,paladin,retribution,12,7,5
31112,Showfet,dalaran,671,paladin,retribution,16,8,8
31113,Auriol,azshara,671,paladin,retribution,14,7,7
31114,Bettyböp,bleeding-hollow,671,paladin,retribution,18,7,11
31115,Sixty,sargeras,671,paladin,retribution,18,7,11
31116,Wolfgrad,stormrage,671,paladin,retribution,18,7,11
31117,Tyelca,zuljin,671,paladin,retribution,18,7,11
31118,Ottiepal,kelthuzad,671,paladin,retribution,18,7,11
31119,Golozzakum,tichondrius,671,paladin,retribution,18,7,11
31120,Ailo,nemesis,671,paladin,retribution,18,7,11
31121,Thadrian,nazgrel,671,paladin,retribution,18,7,11
31122,Babyshuangs,illidan,671,paladin,retribution,18,7,11
31123,Littlemoses,exodar,671,paladin,retribution,18,7,11
31124,Kaidoz,aegwynn,671,paladin,retribution,18,7,11
31125,Jakkburton,stormrage,671,paladin,retribution,18,7,11
31126,Valtariel,wyrmrest-accord,671,paladin,retribution,18,7,11
31127,Ibull,stormscale,671,paladin,retribution,18,7,11
31128,Lemonliime,moon-guard,671,paladin,retribution,18,7,11
31129,Dragomnnm,stormrage,671,paladin,retribution,18,7,11
31130,Hasbi,area-52,671,paladin,retribution,18,7,11
31131,Nibuwolfx,daggerspine,671,paladin,retribution,18,7,11
31132,Bubbleôsevèn,stormrage,671,paladin,retribution,18,7,11
31133,Vaelicus,emerald-dream,671,paladin,retribution,18,7,11
31134,Basslinee,quelthalas,671,paladin,retribution,18,7,11
31135,Jazztice,mannoroth,671,paladin,retribution,18,7,11
31136,Ane,gorefiend,671,paladin,retribution,18,7,11
31137,Blaeng,shandris,671,paladin,retribution,18,7,11
31138,Inareus,agamaggan,671,paladin,retribution,18,7,11
31139,Hisenberg,drakkari,671,paladin,retribution,18,7,11
31140,Contritus,kiljaeden,671,paladin,retribution,18,7,11
31141,Giorgyos,ragnaros,671,paladin,retribution,18,7,11
31142,Drpawg,tichondrius,671,paladin,retribution,18,7,11
31143,Jswyrm,quelthalas,671,paladin,retribution,18,7,11
31144,Doraléous,illidan,671,paladin,retribution,24,7,17
31145,Indemnity,wildhammer,671,paladin,retribution,24,7,17
31146,Swissalami,proudmoore,670,paladin,retribution,12,7,5
31147,Capsiel,caelestrasz,670,paladin,retribution,12,7,5
31148,Biggwill,proudmoore,670,paladin,retribution,12,7,5
31149,Skankysocks,tichondrius,670,paladin,retribution,12,7,5
31150,Holychach,tichondrius,670,paladin,retribution,12,7,5
31151,Tomaz,ragnaros,670,paladin,retribution,12,7,5
31152,Itsapoc,sargeras,670,paladin,retribution,12,7,5
31153,Blackflare,undermine,670,paladin,retribution,12,7,5
31154,Hanno,azshara,670,paladin,retribution,12,7,5
31155,Lomis,azgalor,670,paladin,retribution,12,7,5
31156,Riek,sargeras,670,paladin,retribution,16,8,8
31157,Jorgevercilo,azralon,670,paladin,retribution,18,7,11
31158,Zaeris,proudmoore,670,paladin,retribution,18,7,11
31159,Augus,arygos,670,paladin,retribution,18,7,11
31160,Delukk,azralon,670,paladin,retribution,18,7,11
31161,Grindlimg,dalaran,670,paladin,retribution,18,7,11
31162,Rampetos,mannoroth,670,paladin,retribution,18,7,11
31163,Tpane,kelthuzad,670,paladin,retribution,18,7,11
31164,Murdameek,area-52,670,paladin,retribution,24,7,17
31165,Zealotry,tichondrius,670,paladin,retribution,24,7,17
31166,Exer,ragnaros,670,paladin,retribution,24,7,17
31167,Terroll,bonechewer,669,paladin,retribution,13,7,6
31168,Tpaartes,mannoroth,669,paladin,retribution,18,7,11
31169,Sîegfried,moon-guard,669,paladin,retribution,18,7,11
31170,Denstain,kul-tiras,669,paladin,retribution,18,7,11
31171,Playmaker,mannoroth,669,paladin,retribution,21,8,13
31172,Salvø,tichondrius,669,paladin,retribution,24,7,17
31173,Sponce,kirin-tor,669,paladin,retribution,30,7,23
31174,Vooltron,bonechewer,668,paladin,retribution,12,7,5
31175,Praisin,zuljin,668,paladin,retribution,12,7,5
31176,Glowstone,emerald-dream,668,paladin,retribution,18,7,11
31177,Alexanderrex,illidan,668,paladin,retribution,18,7,11
31178,Bennygee,moonrunner,668,paladin,retribution,24,7,17
31179,Kapaw,windrunner,667,paladin,retribution,12,7,5
31180,Tacosmells,thunderlord,667,paladin,retribution,18,7,11
31181,Mandow,tichondrius,667,paladin,retribution,22,8,14
31182,Calmador,proudmoore,666,paladin,retribution,12,7,5
31183,Imsoosmall,sargeras,666,paladin,retribution,12,7,5
31184,Batix,malfurion,666,paladin,retribution,12,7,5
31185,Toogud,moon-guard,666,paladin,retribution,21,8,13
31186,Boomeers,emerald-dream,666,paladin,retribution,24,7,17
31187,Chaosbubble,burning-legion,665,paladin,retribution,18,7,11
31188,Kithrin,emerald-dream,664,paladin,retribution,12,7,5
31189,Dweezill,daggerspine,664,paladin,retribution,18,7,11
31190,Trutax,black-dragonflight,662,paladin,retribution,18,7,11
31191,Elderbill,emerald-dream,659,paladin,retribution,12,7,5
31192,Olstonie,garrosh,658,paladin,retribution,12,7,5
31193,Nicepally,moon-guard,657,paladin,retribution,18,7,11
31194,Taego,tichondrius,655,paladin,retribution,17,7,10
31195,Iceddcoffee,barthilas,655,paladin,retribution,17,7,10
31196,Mèdic,illidan,654,paladin,retribution,17,7,10
31197,Palliful,runetotem,651,paladin,retribution,18,7,11
31198,Tooperilous,exodar,639,paladin,retribution,16,7,9
31199,Vietnomeez,tichondrius,639,paladin,retribution,17,7,10
31200,Epòc,frostmourne,639,paladin,retribution,20,8,12
31201,Goldclaw,moon-guard,639,paladin,retribution,20,8,12
31202,Hanicon,dragonmaw,638,paladin,retribution,16,7,9
31203,Unversed,illidan,637,paladin,retribution,18,9,9
31204,Fatalpally,antonidas,633,paladin,retribution,17,7,10
31205,Arkeon,shadowsong,631,paladin,retribution,17,7,10
31206,Táçô,illidan,623,paladin,retribution,11,7,4
31207,Krossfyre,kiljaeden,623,paladin,retribution,17,7,10
31208,Ethernaly,quelthalas,623,paladin,retribution,17,7,10
31209,Jortesh,tichondrius,622,paladin,retribution,15,7,8
31210,Alkon,quelthalas,619,paladin,retribution,27,7,20
31211,Grinzin,azralon,618,paladin,retribution,17,9,8
31212,Shuckles,windrunner,618,paladin,retribution,26,8,18
31213,Antoniano,ragnaros,617,paladin,retribution,13,8,5
31214,Vanaris,blackrock,615,paladin,retribution,15,7,8
31215,Saltytaco,gurubashi,608,paladin,retribution,16,7,9
31216,Frêyr,barthilas,608,paladin,retribution,22,7,15
31217,Anarkay,frostmourne,607,paladin,retribution,10,7,3
31218,Kelhell,stormrage,607,paladin,retribution,11,7,4
31219,Chestbrah,nemesis,607,paladin,retribution,14,7,7
31220,Tolkki,dalaran,607,paladin,retribution,26,7,19
31221,Captqueso,stormrage,606,paladin,retribution,14,7,7
31222,Sixtynine,nathrezim,592,paladin,retribution,31,7,24
31223,Unïk,zuljin,591,paladin,retribution,11,7,4
31224,Warbird,lightnings-blade,591,paladin,retribution,13,7,6
31225,Theomere,sargeras,586,paladin,retribution,27,10,17
31226,Hinnamnor,tichondrius,576,paladin,retribution,6,6,0
31227,Xandiê,sargeras,576,paladin,retribution,6,6,0
31228,Liht,blood-furnace,576,paladin,retribution,6,6,0
31229,Lucard,drakkari,576,paladin,retribution,6,6,0
31230,Spellshield,barthilas,576,paladin,retribution,6,6,0
31231,Fibonaci,sargeras,576,paladin,retribution,6,6,0
31232,Thøradin,moon-guard,576,paladin,retribution,6,6,0
31233,Odegaret,illidan,576,paladin,retribution,10,7,3
31234,Dumbledwarf,hyjal,576,paladin,retribution,12,6,6
31235,Cvpal,stormrage,576,paladin,retribution,12,6,6
31236,Cjq,tichondrius,576,paladin,retribution,12,6,6
31237,Irushthots,tichondrius,576,paladin,retribution,12,6,6
31238,Wyon,stormrage,576,paladin,retribution,12,6,6
31239,Ironaddict,frostmourne,576,paladin,retribution,12,6,6
31240,Cybopig,kelthuzad,576,paladin,retribution,12,6,6
31241,Epicbro,kiljaeden,576,paladin,retribution,12,6,6
31242,Koyourfamily,proudmoore,576,paladin,retribution,12,6,6
31243,Healplzz,tichondrius,576,paladin,retribution,12,6,6
31244,Emetselchs,tichondrius,576,paladin,retribution,12,6,6
31245,Byebyetwinks,khaz-modan,576,paladin,retribution,12,6,6
31246,Aura,emerald-dream,576,paladin,retribution,12,6,6
31247,Raywhite,kelthuzad,576,paladin,retribution,12,6,6
31248,Snivasgo,ragnaros,576,paladin,retribution,12,6,6
31249,Leonkennedyx,stormrage,576,paladin,retribution,12,6,6
31250,Thaléros,tichondrius,576,paladin,retribution,12,6,6
31251,Onixx,kargath,576,paladin,retribution,12,6,6
31252,Bootacious,tichondrius,576,paladin,retribution,12,6,6
31253,Hjolgrim,sargeras,576,paladin,retribution,12,6,6
31254,Arraladin,tichondrius,576,paladin,retribution,12,6,6
31255,Bigdig,stormrage,576,paladin,retribution,12,6,6
31256,Thiccpala,tichondrius,576,paladin,retribution,12,6,6
31257,Beluros,tichondrius,576,paladin,retribution,12,6,6
31258,Sacerbelator,zuluhed,576,paladin,retribution,12,6,6
31259,Jabrohnie,sargeras,576,paladin,retribution,12,6,6
31260,Accept,frostmourne,576,paladin,retribution,12,6,6
31261,Kulikahn,terenas,576,paladin,retribution,12,6,6
31262,Beato,silvermoon,576,paladin,retribution,12,6,6
31263,Vilert,balnazzar,576,paladin,retribution,12,6,6
31264,Immensepower,tichondrius,576,paladin,retribution,12,6,6
31265,Xavorn,illidan,576,paladin,retribution,12,6,6
31266,Proctrlx,tichondrius,576,paladin,retribution,12,6,6
31267,Oynx,emerald-dream,576,paladin,retribution,12,6,6
31268,Cause,farstriders,576,paladin,retribution,12,6,6
31269,Bloodyängel,emerald-dream,576,paladin,retribution,12,6,6
31270,Piroc,tichondrius,576,paladin,retribution,12,6,6
31271,Crânkdât,frostmourne,576,paladin,retribution,12,6,6
31272,Bloodeladin,deathwing,576,paladin,retribution,12,6,6
31273,Yungcheezy,illidan,576,paladin,retribution,12,6,6
31274,Lebubbles,azuremyst,576,paladin,retribution,12,6,6
31275,Pokeyabutt,hydraxis,576,paladin,retribution,12,6,6
31276,Supramario,dragonmaw,576,paladin,retribution,12,6,6
31277,Zèró,terokkar,576,paladin,retribution,12,6,6
31278,Germ,korgath,576,paladin,retribution,12,6,6
31279,Pállyho,tichondrius,576,paladin,retribution,12,6,6
31280,Zercker,ragnaros,576,paladin,retribution,12,6,6
31281,Troegenator,stormrage,576,paladin,retribution,12,6,6
31282,Jacklo,the-venture-co,576,paladin,retribution,12,6,6
31283,Glynisir,sargeras,576,paladin,retribution,12,6,6
31284,Gambitdin,moon-guard,576,paladin,retribution,12,6,6
31285,Hydroponicz,tichondrius,576,paladin,retribution,12,6,6
31286,Potatopasta,area-52,576,paladin,retribution,12,6,6
31287,Retsuxks,twisting-nether,576,paladin,retribution,12,6,6
31288,Obeliskk,frostmourne,576,paladin,retribution,12,6,6
31289,Bruxx,twisting-nether,576,paladin,retribution,12,6,6
31290,Hammerd,area-52,576,paladin,retribution,12,6,6
31291,Nragedpal,illidan,576,paladin,retribution,12,6,6
31292,Sparticuss,frostmane,576,paladin,retribution,12,6,6
31293,Ashley,sargeras,576,paladin,retribution,12,6,6
31294,Bigkspally,korgath,576,paladin,retribution,12,6,6
31295,Dogecoln,bleeding-hollow,576,paladin,retribution,12,6,6
31296,Antonn,stormrage,576,paladin,retribution,12,6,6
31297,Grim,eonar,576,paladin,retribution,12,6,6
31298,Zägreus,moon-guard,576,paladin,retribution,12,6,6
31299,Porxhux,tichondrius,576,paladin,retribution,12,6,6
31300,Trixzthot,barthilas,576,paladin,retribution,12,6,6
31301,Mikeyqt,nemesis,576,paladin,retribution,12,6,6
31302,Holycrp,proudmoore,576,paladin,retribution,12,6,6
31303,Cübe,malganis,576,paladin,retribution,12,6,6
31304,Memepaladin,area-52,576,paladin,retribution,12,6,6
31305,Breid,sargeras,576,paladin,retribution,12,6,6
31306,Enj,stormrage,576,paladin,retribution,12,6,6
31307,Brpistol,azralon,576,paladin,retribution,12,6,6
31308,Venter,bleeding-hollow,576,paladin,retribution,12,6,6
31309,Çhñkzrèt,illidan,576,paladin,retribution,12,6,6
31310,Aëriy,moon-guard,576,paladin,retribution,12,6,6
31311,Gàreth,aerie-peak,576,paladin,retribution,12,6,6
31312,Zuther,spirestone,576,paladin,retribution,12,6,6
31313,Holycrusador,bleeding-hollow,576,paladin,retribution,12,6,6
31314,Zoroastrø,azralon,576,paladin,retribution,12,6,6
31315,Sneely,kelthuzad,576,paladin,retribution,12,6,6
31316,Vozy,shandris,576,paladin,retribution,12,6,6
31317,Mystictoast,area-52,576,paladin,retribution,12,6,6
31318,Panicbubblin,stormrage,576,paladin,retribution,12,6,6
31319,Òp,illidan,576,paladin,retribution,12,6,6
31320,Thuggrnaut,darkspear,576,paladin,retribution,12,6,6
31321,Longtai,proudmoore,576,paladin,retribution,12,6,6
31322,Rhoruk,turalyon,576,paladin,retribution,12,6,6
31323,Retboy,archimonde,576,paladin,retribution,12,6,6
31324,Sonicblazer,darrowmere,576,paladin,retribution,12,6,6
31325,Klamindor,emerald-dream,576,paladin,retribution,12,6,6
31326,Banzz,azralon,576,paladin,retribution,12,6,6
31327,Fallenp,hakkar,576,paladin,retribution,12,6,6
31328,Octaviak,moon-guard,576,paladin,retribution,12,6,6
31329,Nýze,area-52,576,paladin,retribution,12,6,6
31330,Careyprice,area-52,576,paladin,retribution,12,6,6
31331,Seeys,tichondrius,576,paladin,retribution,12,6,6
31332,Gánico,ragnaros,576,paladin,retribution,12,6,6
31333,Sabêr,mannoroth,576,paladin,retribution,12,6,6
31334,Skarlagen,moon-guard,576,paladin,retribution,12,6,6
31335,Masemune,bonechewer,576,paladin,retribution,12,6,6
31336,Alphali,quelthalas,576,paladin,retribution,12,6,6
31337,Totalaustin,sargeras,576,paladin,retribution,12,6,6
31338,Rohad,thrall,576,paladin,retribution,12,6,6
31339,Nyroxz,quelthalas,576,paladin,retribution,12,6,6
31340,Sóláris,moon-guard,576,paladin,retribution,12,6,6
31341,Dýnamo,azralon,576,paladin,retribution,12,6,6
31342,Evelimash,bloodhoof,576,paladin,retribution,12,6,6
31343,Zeröcoöl,malganis,576,paladin,retribution,12,6,6
31344,Seballedo,drakkari,576,paladin,retribution,12,6,6
31345,Afterdawn,dreadmaul,576,paladin,retribution,12,6,6
31346,Geesworld,nazjatar,576,paladin,retribution,12,6,6
31347,Koûtt,ragnaros,576,paladin,retribution,12,6,6
31348,Pallyalli,burning-blade,576,paladin,retribution,12,6,6
31349,Soapgirl,area-52,576,paladin,retribution,12,6,6
31350,Lyà,area-52,576,paladin,retribution,12,6,6
31351,Fálko,azralon,576,paladin,retribution,12,6,6
31352,Smaugg,boulderfist,576,paladin,retribution,15,7,8
31353,Trulymental,bleeding-hollow,576,paladin,retribution,13,6,7
31354,Xanaxlol,sargeras,576,paladin,retribution,16,7,9
31355,Sunwalker,tichondrius,576,paladin,retribution,17,6,11
31356,Joshington,stormrage,576,paladin,retribution,21,7,14
31357,Koreancannon,tichondrius,576,paladin,retribution,21,7,14
31358,Júdgedredd,illidan,576,paladin,retribution,18,6,12
31359,Ishuffle,malganis,576,paladin,retribution,18,6,12
31360,Abregut,ragnaros,576,paladin,retribution,18,6,12
31361,Kochinodin,ragnaros,576,paladin,retribution,18,6,12
31362,Slowmoshend,illidan,576,paladin,retribution,18,6,12
31363,Kramsìb,ragnaros,576,paladin,retribution,18,6,12
31364,Xpect,spinebreaker,576,paladin,retribution,18,6,12
31365,Liandroa,stormrage,576,paladin,retribution,18,6,12
31366,Washavy,drakkari,576,paladin,retribution,18,6,12
31367,Femaledog,ragnaros,576,paladin,retribution,18,6,12
31368,Divineera,frostmourne,576,paladin,retribution,18,6,12
31369,Nufi,magtheridon,576,paladin,retribution,18,6,12
31370,Jafbe,mugthol,576,paladin,retribution,18,6,12
31371,Càséy,zuljin,576,paladin,retribution,18,6,12
31372,Wreathy,sargeras,576,paladin,retribution,18,6,12
31373,Goldskìn,sargeras,576,paladin,retribution,18,6,12
31374,Niksilp,malfurion,576,paladin,retribution,18,6,12
31375,Pauliss,sargeras,576,paladin,retribution,18,6,12
31376,Felwythe,emerald-dream,576,paladin,retribution,18,6,12
31377,Shiftybugar,tichondrius,576,paladin,retribution,18,6,12
31378,Omniknìght,stormrage,576,paladin,retribution,18,6,12
31379,Hetodo,blood-furnace,576,paladin,retribution,18,6,12
31380,Kronicle,bleeding-hollow,576,paladin,retribution,18,6,12
31381,Retz,tichondrius,576,paladin,retribution,18,6,12
31382,Simplychi,area-52,576,paladin,retribution,18,6,12
31383,Astolfo,tortheldrin,576,paladin,retribution,18,6,12
31384,Kaïty,azralon,576,paladin,retribution,18,6,12
31385,Ålltimer,stormrage,576,paladin,retribution,18,6,12
31386,Respect,moon-guard,576,paladin,retribution,18,6,12
31387,Sourpatchh,stormrage,576,paladin,retribution,18,6,12
31388,Kreigvar,moon-guard,576,paladin,retribution,18,6,12
31389,Cupcaked,blackrock,576,paladin,retribution,23,6,17
31390,Exorcìst,tichondrius,576,paladin,retribution,24,6,18
31391,Hojpack,tichondrius,576,paladin,retribution,24,6,18
31392,Supermetroid,vashj,576,paladin,retribution,24,6,18
31393,Holyhymen,mannoroth,576,paladin,retribution,24,6,18
31394,Pallyfreddyy,frostmourne,576,paladin,retribution,24,6,18
31395,Spoons,malganis,576,paladin,retribution,24,6,18
31396,Dragrias,altar-of-storms,575,paladin,retribution,10,7,3
31397,Blëssëd,zuljin,575,paladin,retribution,12,6,6
31398,Potiguar,azralon,575,paladin,retribution,12,6,6
31399,Crixius,eredar,575,paladin,retribution,12,6,6
31400,Vincentnero,runetotem,575,paladin,retribution,12,6,6
31401,Apollon,zuljin,575,paladin,retribution,12,6,6
31402,Übermane,illidan,575,paladin,retribution,12,6,6
31403,Arkmedys,azralon,575,paladin,retribution,12,6,6
31404,Jovolur,dalaran,575,paladin,retribution,12,6,6
31405,Jotajotamz,quelthalas,575,paladin,retribution,12,6,6
31406,Onecmpeter,kelthuzad,575,paladin,retribution,12,6,6
31407,Drágônbôrn,tichondrius,575,paladin,retribution,12,6,6
31408,Kelbii,sargeras,575,paladin,retribution,12,6,6
31409,Toscadin,ragnaros,575,paladin,retribution,12,6,6
31410,Shaggrilla,trollbane,575,paladin,retribution,12,6,6
31411,Jolandrine,sargeras,575,paladin,retribution,12,6,6
31412,Knobody,emerald-dream,575,paladin,retribution,12,6,6
31413,Skelà,sargeras,575,paladin,retribution,12,6,6
31414,Camcam,thrall,575,paladin,retribution,12,6,6
31415,Vanmauren,quelthalas,575,paladin,retribution,12,6,6
31416,Blankei,stormrage,575,paladin,retribution,12,6,6
31417,Yuzuru,mannoroth,575,paladin,retribution,12,6,6
31418,Skyangel,illidan,575,paladin,retribution,12,6,6
31419,Laluce,malganis,575,paladin,retribution,12,6,6
31420,Killmode,kelthuzad,575,paladin,retribution,12,6,6
31421,Butterbeanz,tanaris,575,paladin,retribution,12,6,6
31422,Ikanacanyon,stormrage,575,paladin,retribution,12,6,6
31423,Warboard,tichondrius,575,paladin,retribution,15,7,8
31424,Trekpii,area-52,575,paladin,retribution,13,6,7
31425,Bebedor,azralon,575,paladin,retribution,15,6,9
31426,Retoric,maelstrom,575,paladin,retribution,18,6,12
31427,Anoleak,tichondrius,575,paladin,retribution,18,6,12
31428,Nashtty,guldan,575,paladin,retribution,18,6,12
31429,Oceangal,illidan,575,paladin,retribution,18,6,12
31430,Valdi,stonemaul,575,paladin,retribution,18,6,12
31431,Haziel,darkspear,575,paladin,retribution,18,6,12
31432,Cropcircles,whisperwind,575,paladin,retribution,18,6,12
31433,Faffyi,thunderlord,575,paladin,retribution,18,6,12
31434,Palpaladines,quelthalas,575,paladin,retribution,18,6,12
31435,Killstien,illidan,575,paladin,retribution,24,6,18
31436,Lecarde,cenarion-circle,575,paladin,retribution,24,6,18
31437,Vecknilashx,quelthalas,575,paladin,retribution,24,6,18
31438,Freiror,azralon,574,paladin,retribution,12,6,6
31439,Clasheoff,mannoroth,574,paladin,retribution,12,6,6
31440,Belzibuth,zuljin,574,paladin,retribution,12,6,6
31441,Korann,proudmoore,574,paladin,retribution,12,6,6
31442,Kkrewk,illidan,574,paladin,retribution,12,6,6
31443,Crithealss,dalaran,574,paladin,retribution,12,6,6
31444,Ihmperiuus,quelthalas,574,paladin,retribution,12,6,6
31445,Akeero,khaz-modan,574,paladin,retribution,12,6,6
31446,Darqtank,smolderthorn,574,paladin,retribution,18,6,12
31447,Synnderilla,wyrmrest-accord,574,paladin,retribution,18,6,12
31448,Halordriest,tichondrius,574,paladin,retribution,18,6,12
31449,Tamahu,azralon,574,paladin,retribution,18,6,12
31450,Judgemèntal,illidan,574,paladin,retribution,20,6,14
31451,Takz,daggerspine,574,paladin,retribution,26,6,20
31452,Kalayton,nesingwary,573,paladin,retribution,12,6,6
31453,Tauyoshi,azjolnerub,573,paladin,retribution,12,6,6
31454,Phankro,quelthalas,573,paladin,retribution,12,6,6
31455,Gämä,azralon,573,paladin,retribution,18,6,12
31456,Scyni,kelthuzad,573,paladin,retribution,20,6,14
31457,Alluxian,zuljin,573,paladin,retribution,24,6,18
31458,Callahan,frostwolf,572,paladin,retribution,12,6,6
31459,Thorbrecht,moon-guard,572,paladin,retribution,12,6,6
31460,Chadrickk,tichondrius,572,paladin,retribution,12,6,6
31461,Ajaex,area-52,571,paladin,retribution,12,6,6
31462,Kalerien,wildhammer,571,paladin,retribution,12,6,6
31463,Lucent,duskwood,571,paladin,retribution,18,6,12
31464,Bunkalunk,lightbringer,570,paladin,retribution,15,6,9
31465,Niáa,quelthalas,570,paladin,retribution,18,6,12
31466,Ginwow,hakkar,570,paladin,retribution,18,6,12
31467,Palâdino,azralon,568,paladin,retribution,21,7,14
31468,Halldhyr,quelthalas,566,paladin,retribution,12,6,6
31469,Lorawynn,cenarion-circle,557,paladin,retribution,11,6,5
31470,Ssggk,proudmoore,553,paladin,retribution,17,6,11
31471,Bringbackrmp,tichondrius,543,paladin,retribution,11,6,5
31472,Zyllo,area-52,543,paladin,retribution,14,7,7
31473,Holymanè,tichondrius,543,paladin,retribution,14,7,7
31474,Wunderbread,dalaran,543,paladin,retribution,17,6,11
31475,Gloren,garrosh,543,paladin,retribution,17,6,11
31476,Buffalosaucé,illidan,543,paladin,retribution,17,6,11
31477,Suslazin,area-52,543,paladin,retribution,20,7,13
31478,Fødãø,azralon,542,paladin,retribution,11,6,5
31479,Criskaruz,ragnaros,542,paladin,retribution,17,6,11
31480,Taegwyn,thunderlord,542,paladin,retribution,22,6,16
31481,Hadagoodlay,zuljin,528,paladin,retribution,15,6,9
31482,Fulgal,jubeithos,528,paladin,retribution,15,6,9
31483,Svaanah,moon-guard,527,paladin,retribution,11,6,5
31484,Sucris,kelthuzad,527,paladin,retribution,11,6,5
31485,Tazzul,turalyon,527,paladin,retribution,15,7,8
31486,Vardrik,darkspear,527,paladin,retribution,15,6,9
31487,Yuriie,stormrage,527,paladin,retribution,17,6,11
31488,Radiantheart,norgannon,525,paladin,retribution,11,6,5
31489,Briaelyne,tichondrius,522,paladin,retribution,25,8,17
31490,Parkhwi,tichondrius,521,paladin,retribution,28,7,21
31491,Nathaniel,galakrond,511,paladin,retribution,14,6,8
31492,ßìgdám,bleeding-hollow,511,paladin,retribution,17,6,11
31493,Javiermiléi,quelthalas,511,paladin,retribution,26,6,20
31494,Pemodyne,illidan,495,paladin,retribution,13,6,7
31495,Spàrhawke,stormrage,495,paladin,retribution,13,6,7
31496,Fionax,frostmourne,495,paladin,retribution,21,6,15
31497,Senorwang,dalaran,494,paladin,retribution,13,6,7
31498,Akemih,ragnaros,480,paladin,retribution,6,5,1
31499,Bubblybuns,proudmoore,480,paladin,retribution,6,5,1
31500,Strykerrz,tanaris,480,paladin,retribution,6,5,1
31501,Gramsby,aggramar,480,paladin,retribution,6,5,1
31502,Wambo,emerald-dream,480,paladin,retribution,6,5,1
31503,Corevp,frostmourne,480,paladin,retribution,6,5,1
31504,Kongo,darkspear,480,paladin,retribution,6,5,1
31505,Einjerhar,quelthalas,480,paladin,retribution,6,5,1
31506,Bauschret,thrall,480,paladin,retribution,6,5,1
31507,Mcjudgin,kilrogg,480,paladin,retribution,6,5,1
31508,Wabnote,twisting-nether,480,paladin,retribution,6,5,1
31509,Kettlebaby,wildhammer,480,paladin,retribution,6,5,1
31510,Moozafa,kiljaeden,480,paladin,retribution,6,5,1
31511,Everwaken,ragnaros,480,paladin,retribution,6,5,1
31512,Silviis,stormrage,480,paladin,retribution,6,5,1
31513,Tdm,bleeding-hollow,480,paladin,retribution,6,5,1
31514,Kelimir,dathremar,480,paladin,retribution,6,5,1
31515,Shibbx,quelthalas,480,paladin,retribution,6,5,1
31516,Zelowrath,emerald-dream,480,paladin,retribution,6,5,1
31517,Oldlemon,tichondrius,480,paladin,retribution,6,5,1
31518,Rekindle,barthilas,480,paladin,retribution,6,5,1
31519,Eomàr,barthilas,480,paladin,retribution,6,5,1
31520,Kimitail,tichondrius,480,paladin,retribution,6,5,1
31521,Ganrof,mugthol,480,paladin,retribution,6,5,1
31522,Mmrdonator,icecrown,480,paladin,retribution,6,5,1
31523,Mythîcxd,tichondrius,480,paladin,retribution,6,5,1
31524,Speedlight,ragnaros,480,paladin,retribution,6,5,1
31525,Mardrïus,tichondrius,480,paladin,retribution,6,5,1
31526,Adrieoss,stormrage,480,paladin,retribution,6,5,1
31527,Iamurpal,hakkar,480,paladin,retribution,6,5,1
31528,Pickleparker,stormrage,480,paladin,retribution,6,5,1
31529,Jùnmå,tichondrius,480,paladin,retribution,6,5,1
31530,Fistrozenemy,illidan,480,paladin,retribution,6,5,1
31531,Rangedmelee,stormrage,480,paladin,retribution,6,5,1
31532,Míkau,barthilas,480,paladin,retribution,6,5,1
31533,Mandymuze,illidan,480,paladin,retribution,6,5,1
31534,Mollymatt,drenden,480,paladin,retribution,6,5,1
31535,Van,tichondrius,480,paladin,retribution,6,5,1
31536,Tenkäi,quelthalas,480,paladin,retribution,6,5,1
31537,Demetriusxy,tichondrius,480,paladin,retribution,6,5,1
31538,Dragon,uldum,480,paladin,retribution,6,5,1
31539,Lafasíta,ragnaros,480,paladin,retribution,6,5,1
31540,Zeprikito,nemesis,480,paladin,retribution,6,5,1
31541,Guggle,lothar,480,paladin,retribution,6,5,1
31542,Overbet,area-52,480,paladin,retribution,9,6,3
31543,Romeh,malganis,480,paladin,retribution,8,5,3
31544,Bootscrapper,sargeras,480,paladin,retribution,11,6,5
31545,Siamac,illidan,480,paladin,retribution,13,7,6
31546,Goodwood,ghostlands,480,paladin,retribution,12,6,6
31547,Wetterguuch,area-52,480,paladin,retribution,12,5,7
31548,Lumpylot,sargeras,480,paladin,retribution,12,5,7
31549,Lücid,arthas,480,paladin,retribution,12,5,7
31550,Hattie,arthas,480,paladin,retribution,12,5,7
31551,Wreckina,tichondrius,480,paladin,retribution,12,5,7
31552,Dinobe,arthas,480,paladin,retribution,12,5,7
31553,Delightt,sargeras,480,paladin,retribution,12,5,7
31554,Bold,frostmourne,480,paladin,retribution,12,5,7
31555,Supasavage,maiev,480,paladin,retribution,12,5,7
31556,Suddify,area-52,480,paladin,retribution,12,5,7
31557,Shinymoo,laughing-skull,480,paladin,retribution,12,5,7
31558,Mikewazowski,chogall,480,paladin,retribution,12,5,7
31559,Addisen,malganis,480,paladin,retribution,12,5,7
31560,Hegarth,archimonde,480,paladin,retribution,12,5,7
31561,Dimsimbar,frostmourne,480,paladin,retribution,12,5,7
31562,Theraptos,frostmourne,480,paladin,retribution,12,5,7
31563,Fixyouz,mannoroth,480,paladin,retribution,12,5,7
31564,Rhaegorn,drakkari,480,paladin,retribution,12,5,7
31565,Kaelel,barthilas,480,paladin,retribution,12,5,7
31566,Retroactive,thunderlord,480,paladin,retribution,12,5,7
31567,Seratonyn,malganis,480,paladin,retribution,12,5,7
31568,Faithkiller,garrosh,480,paladin,retribution,12,5,7
31569,Rymondo,sargeras,480,paladin,retribution,12,5,7
31570,Mickelodeon,sargeras,480,paladin,retribution,12,5,7
31571,Critadins,thrall,480,paladin,retribution,12,5,7
31572,Cedwarlancy,sargeras,480,paladin,retribution,12,5,7
31573,Perasticus,garrosh,480,paladin,retribution,12,5,7
31574,Principe,queldorei,480,paladin,retribution,12,5,7
31575,Wahpop,sargeras,480,paladin,retribution,12,5,7
31576,Callandør,illidan,480,paladin,retribution,12,5,7
31577,Redearth,bleeding-hollow,480,paladin,retribution,12,5,7
31578,Shadomourne,arthas,480,paladin,retribution,12,5,7
31579,Ganster,dreadmaul,480,paladin,retribution,12,5,7
31580,Mikeawk,tichondrius,480,paladin,retribution,12,5,7
31581,Daddyspit,arthas,480,paladin,retribution,12,5,7
31582,Únhøly,aegwynn,480,paladin,retribution,12,5,7
31583,Sabericdos,proudmoore,480,paladin,retribution,12,5,7
31584,Crucifuk,sargeras,480,paladin,retribution,12,5,7
31585,Morbop,proudmoore,480,paladin,retribution,12,5,7
31586,Toojazzyleah,proudmoore,480,paladin,retribution,12,5,7
31587,Akain,tichondrius,480,paladin,retribution,12,5,7
31588,Tisu,kiljaeden,480,paladin,retribution,12,5,7
31589,Bigbleuu,kiljaeden,480,paladin,retribution,12,5,7
31590,Níngjìngy,tichondrius,480,paladin,retribution,12,5,7
31591,Lowhp,tichondrius,480,paladin,retribution,12,5,7
31592,Shadòw,emerald-dream,480,paladin,retribution,12,5,7
31593,Bullpaladin,barthilas,480,paladin,retribution,12,5,7
31594,Lastal,kiljaeden,480,paladin,retribution,12,5,7
31595,Zulyourmom,tichondrius,480,paladin,retribution,12,5,7
31596,Yoroding,tichondrius,480,paladin,retribution,12,5,7
31597,Hotnchocolat,stormrage,480,paladin,retribution,12,5,7
31598,Liadryn,kiljaeden,480,paladin,retribution,12,5,7
31599,Delaswing,quelthalas,480,paladin,retribution,12,5,7
31600,Farmerzonly,tichondrius,480,paladin,retribution,12,5,7
31601,Ärlex,moon-guard,480,paladin,retribution,12,5,7
31602,Semamnohands,illidan,480,paladin,retribution,12,5,7
31603,Heamis,thunderlord,480,paladin,retribution,12,5,7
31604,Valkaurus,drakkari,480,paladin,retribution,12,5,7
31605,Azerothmajor,tichondrius,480,paladin,retribution,12,5,7
31606,Ssawsy,illidan,480,paladin,retribution,12,5,7
31607,Foxesshadow,tichondrius,480,paladin,retribution,12,5,7
31608,Ankmael,ragnaros,480,paladin,retribution,12,5,7
31609,Õblivion,jubeithos,480,paladin,retribution,12,5,7
31610,Noleyboo,proudmoore,480,paladin,retribution,12,5,7
31611,Namiiswan,area-52,480,paladin,retribution,12,5,7
31612,Trensei,emerald-dream,480,paladin,retribution,12,5,7
31613,Beatman,blades-edge,480,paladin,retribution,12,5,7
31614,Aeoliá,moon-guard,480,paladin,retribution,12,5,7
31615,Aeolus,uldaman,480,paladin,retribution,12,5,7
31616,Raveen,veknilash,480,paladin,retribution,12,5,7
31617,Metalpriest,shattered-halls,480,paladin,retribution,12,5,7
31618,Baelmun,thrall,480,paladin,retribution,12,5,7
31619,Héathèn,area-52,480,paladin,retribution,12,5,7
31620,Lodin,kalecgos,480,paladin,retribution,12,5,7
31621,Fistopain,staghelm,480,paladin,retribution,12,5,7
31622,Meith,ragnaros,480,paladin,retribution,12,5,7
31623,Methor,thrall,480,paladin,retribution,12,5,7
31624,Uneazyxx,tichondrius,480,paladin,retribution,12,5,7
31625,Minzyp,illidan,480,paladin,retribution,12,5,7
31626,Isevp,illidan,480,paladin,retribution,12,5,7
31627,Tarà,sargeras,480,paladin,retribution,12,5,7
31628,Diplomacy,illidan,480,paladin,retribution,12,5,7
31629,Randvi,sargeras,480,paladin,retribution,12,5,7
31630,Nohtu,quelthalas,480,paladin,retribution,12,5,7
31631,Hinamattsuri,velen,480,paladin,retribution,12,5,7
31632,Dirtbagg,demon-soul,480,paladin,retribution,12,5,7
31633,Dipho,illidan,480,paladin,retribution,12,5,7
31634,Pallypallyy,aerie-peak,480,paladin,retribution,12,5,7
31635,Flavor,cairne,480,paladin,retribution,12,5,7
31636,Shiningtendi,aerie-peak,480,paladin,retribution,12,5,7
31637,Trinkhammer,illidan,480,paladin,retribution,12,5,7
31638,Thickgirl,bleeding-hollow,480,paladin,retribution,12,5,7
31639,Dehya,sargeras,480,paladin,retribution,12,5,7
31640,Hallastus,stormrage,480,paladin,retribution,12,5,7
31641,Gotwingz,moon-guard,480,paladin,retribution,12,5,7
31642,Keelroi,sargeras,480,paladin,retribution,12,5,7
31643,Kuyueh,tichondrius,480,paladin,retribution,12,5,7
31644,Varezion,vashj,480,paladin,retribution,12,5,7
31645,Líønheart,stormrage,480,paladin,retribution,12,5,7
31646,Pussandboots,cairne,480,paladin,retribution,12,5,7
31647,Selentia,shadowmoon,480,paladin,retribution,12,5,7
31648,Hekcthor,ragnaros,480,paladin,retribution,12,5,7
31649,Holyham,bonechewer,480,paladin,retribution,12,5,7
31650,Jadedx,stormrage,480,paladin,retribution,12,5,7
31651,Berapal,tichondrius,480,paladin,retribution,12,5,7
31652,Alexpalad,sargeras,480,paladin,retribution,12,5,7
31653,Loudpaq,guldan,480,paladin,retribution,12,5,7
31654,Hkingx,frostwolf,480,paladin,retribution,12,5,7
31655,Merphy,tichondrius,480,paladin,retribution,12,5,7
31656,Balmain,moon-guard,480,paladin,retribution,12,5,7
31657,Cranick,bleeding-hollow,480,paladin,retribution,12,5,7
31658,Undefeatæd,korgath,480,paladin,retribution,12,5,7
31659,Buslightyear,azralon,480,paladin,retribution,12,5,7
31660,Thrasheric,ragnaros,480,paladin,retribution,12,5,7
31661,Maxduo,bleeding-hollow,480,paladin,retribution,12,5,7
31662,Gotenks,trollbane,480,paladin,retribution,12,5,7
31663,Joonzu,frostmane,480,paladin,retribution,12,5,7
31664,Shaktii,ragnaros,480,paladin,retribution,12,5,7
31665,Emotiza,illidan,480,paladin,retribution,12,5,7
31666,Adrexious,dalaran,480,paladin,retribution,12,5,7
31667,Ravage,lothar,480,paladin,retribution,12,5,7
31668,Polisexüs,azralon,480,paladin,retribution,12,5,7
31669,ßraveheart,zuljin,480,paladin,retribution,12,5,7
31670,Mágna,illidan,480,paladin,retribution,12,5,7
31671,Shieldgrab,illidan,480,paladin,retribution,12,5,7
31672,Itaghí,sargeras,480,paladin,retribution,12,5,7
31673,Sigismud,quelthalas,480,paladin,retribution,12,5,7
31674,Swishey,tichondrius,480,paladin,retribution,12,5,7
31675,Cairdk,ragnaros,480,paladin,retribution,12,5,7
31676,Gennara,ragnaros,480,paladin,retribution,12,5,7
31677,Vain,shuhalo,480,paladin,retribution,12,5,7
31678,Yellowmay,sargeras,480,paladin,retribution,12,5,7
31679,Bigolhammer,khadgar,480,paladin,retribution,12,5,7
31680,Lightknight,lothar,480,paladin,retribution,12,5,7
31681,Chenghisret,tichondrius,480,paladin,retribution,12,5,7
31682,Kirklandbeef,gorefiend,480,paladin,retribution,12,5,7
31683,Rikku,undermine,480,paladin,retribution,12,5,7
31684,Silreck,ragnaros,480,paladin,retribution,12,5,7
31685,Jaenus,azralon,480,paladin,retribution,12,5,7
31686,Banglin,draenor,480,paladin,retribution,12,5,7
31687,Bigmilkdog,tichondrius,480,paladin,retribution,12,5,7
31688,Jonbonholy,sargeras,480,paladin,retribution,12,5,7
31689,Locustknight,illidan,480,paladin,retribution,12,5,7
31690,Darksaint,hellscream,480,paladin,retribution,12,5,7
31691,Holytankadin,alleria,480,paladin,retribution,12,5,7
31692,Wonas,ragnaros,480,paladin,retribution,12,5,7
31693,Rakkhalar,ragnaros,480,paladin,retribution,12,5,7
31694,Loctherion,ragnaros,480,paladin,retribution,12,5,7
31695,Gavriel,quelthalas,480,paladin,retribution,12,5,7
31696,Jaslexa,illidan,480,paladin,retribution,12,5,7
31697,Leslievernon,ursin,480,paladin,retribution,12,5,7
31698,Holydawa,zuljin,480,paladin,retribution,12,5,7
31699,Stamptime,emerald-dream,480,paladin,retribution,12,5,7
31700,Luxetveritas,tichondrius,480,paladin,retribution,12,5,7
31701,Jinuhn,illidan,480,paladin,retribution,12,5,7
31702,Xizzor,darkspear,480,paladin,retribution,12,5,7
31703,Funk,sargeras,480,paladin,retribution,12,5,7
31704,Freerating,moon-guard,480,paladin,retribution,15,6,9
31705,Ckrim,malganis,480,paladin,retribution,16,5,11
31706,Thepeony,tichondrius,480,paladin,retribution,17,5,12
31707,Harke,drakkari,480,paladin,retribution,18,5,13
31708,Midnightboto,dragonmaw,480,paladin,retribution,18,5,13
31709,Melgamis,quelthalas,480,paladin,retribution,18,5,13
31710,Boopif,sargeras,480,paladin,retribution,18,5,13
31711,Deecompose,sargeras,480,paladin,retribution,18,5,13
31712,Papazon,tichondrius,480,paladin,retribution,18,5,13
31713,Spótt,stormrage,480,paladin,retribution,18,5,13
31714,Odiato,stormrage,480,paladin,retribution,18,5,13
31715,Photons,emerald-dream,480,paladin,retribution,18,5,13
31716,Reehzlol,stormrage,480,paladin,retribution,18,5,13
31717,Holycots,stormrage,480,paladin,retribution,18,5,13
31718,Moltensilver,emerald-dream,480,paladin,retribution,18,5,13
31719,Ztpz,illidan,480,paladin,retribution,18,5,13
31720,Seraphim,tichondrius,480,paladin,retribution,18,5,13
31721,Razuel,frostmourne,480,paladin,retribution,18,5,13
31722,Alibuda,tichondrius,480,paladin,retribution,18,5,13
31723,Theril,kelthuzad,480,paladin,retribution,18,5,13
31724,Typheuz,wyrmrest-accord,480,paladin,retribution,18,5,13
31725,Gingibeno,tichondrius,480,paladin,retribution,18,5,13
31726,Purged,wyrmrest-accord,480,paladin,retribution,18,5,13
31727,Tikkun,area-52,480,paladin,retribution,18,5,13
31728,Downs,tichondrius,480,paladin,retribution,18,5,13
31729,Furrpally,tichondrius,480,paladin,retribution,18,5,13
31730,Zightmare,azralon,480,paladin,retribution,18,5,13
31731,Bigboynathan,frostmourne,480,paladin,retribution,18,5,13
31732,Grïmaldus,moon-guard,480,paladin,retribution,19,5,14
31733,Firexfist,gurubashi,480,paladin,retribution,24,5,19
31734,Azdan,ragnaros,480,paladin,retribution,30,5,25
31735,Ajaxen,azshara,479,paladin,retribution,6,5,1
31736,Reidolitrao,nemesis,479,paladin,retribution,6,5,1
31737,Kremation,zuljin,479,paladin,retribution,6,5,1
31738,Palaknight,tichondrius,479,paladin,retribution,6,5,1
31739,Asttryd,barthilas,479,paladin,retribution,12,7,5
31740,Ashera,amanthul,479,paladin,retribution,12,5,7
31741,Ðarksealz,laughing-skull,479,paladin,retribution,12,5,7
31742,Farvadin,illidan,479,paladin,retribution,12,5,7
31743,Mereoleona,elune,479,paladin,retribution,12,5,7
31744,Robz,malygos,479,paladin,retribution,12,5,7
31745,Inqa,thunderlord,479,paladin,retribution,12,5,7
31746,Noctis,nerzhul,479,paladin,retribution,12,5,7
31747,Cowsavior,terenas,479,paladin,retribution,12,5,7
31748,Rayrunner,tanaris,479,paladin,retribution,12,5,7
31749,Cóg,area-52,479,paladin,retribution,12,5,7
31750,Giricoret,azralon,479,paladin,retribution,12,5,7
31751,Zelrich,moon-guard,479,paladin,retribution,12,5,7
31752,Minjikim,tichondrius,479,paladin,retribution,12,5,7
31753,Kaylafell,kelthuzad,479,paladin,retribution,12,5,7
31754,Chrisqwa,sargeras,479,paladin,retribution,12,5,7
31755,Khels,gilneas,479,paladin,retribution,12,5,7
31756,Sgtskittles,aggramar,479,paladin,retribution,12,5,7
31757,Reedeemer,bonechewer,479,paladin,retribution,12,5,7
31758,Heneaz,quelthalas,479,paladin,retribution,12,5,7
31759,Memoríez,zuljin,479,paladin,retribution,12,5,7
31760,Murderous,frostmourne,479,paladin,retribution,12,5,7
31761,Maswell,emerald-dream,479,paladin,retribution,12,5,7
31762,Evielia,tichondrius,479,paladin,retribution,12,5,7
31763,Holyzolt,zuljin,479,paladin,retribution,18,5,13
31764,Provail,stormrage,479,paladin,retribution,18,5,13
31765,Griz,magtheridon,479,paladin,retribution,18,5,13
31766,Agelikos,moon-guard,479,paladin,retribution,18,5,13
31767,Oilme,bleeding-hollow,479,paladin,retribution,18,5,13
31768,Kajoruun,bleeding-hollow,479,paladin,retribution,24,5,19
31769,Kief,emerald-dream,479,paladin,retribution,24,5,19
31770,Disconnect,azjolnerub,479,paladin,retribution,24,5,19
31771,Palypunchh,darrowmere,478,paladin,retribution,12,6,6
31772,Ashheart,the-venture-co,478,paladin,retribution,12,5,7
31773,Herbzilla,haomarush,478,paladin,retribution,12,5,7
31774,Impia,tichondrius,478,paladin,retribution,12,5,7
31775,Neipala,ragnaros,478,paladin,retribution,12,5,7
31776,Lagun,wyrmrest-accord,478,paladin,retribution,12,5,7
31777,Millicentt,quelthalas,478,paladin,retribution,12,5,7
31778,Chengduqq,illidan,478,paladin,retribution,12,5,7
31779,Vonfraud,lightbringer,478,paladin,retribution,18,5,13
31780,Alvis,kiljaeden,478,paladin,retribution,24,5,19
31781,Jammsheed,arthas,477,paladin,retribution,12,5,7
31782,Benzen,bleeding-hollow,477,paladin,retribution,12,5,7
31783,Anard,eredar,477,paladin,retribution,13,5,8
31784,Kaminasol,quelthalas,477,paladin,retribution,18,5,13
31785,Pedromuulos,misha,477,paladin,retribution,24,5,19
31786,Solstein,dalaran,474,paladin,retribution,12,5,7
31787,Dubaron,burning-blade,473,paladin,retribution,12,5,7
31788,Torms,illidan,463,paladin,retribution,15,7,8
31789,Kforty,kiljaeden,458,paladin,retribution,18,7,11
31790,Pablito,fizzcrank,457,paladin,retribution,21,7,14
31791,Thepallyx,silvermoon,448,paladin,retribution,16,5,11
31792,Kumahdori,stormrage,447,paladin,retribution,8,6,2
31793,Remake,stormrage,447,paladin,retribution,8,6,2
31794,Bloodybill,frostmane,447,paladin,retribution,11,5,6
31795,Jireen,tichondrius,447,paladin,retribution,11,5,6
31796,Asarul,ragnaros,447,paladin,retribution,14,6,8
31797,Clarïtý,stormrage,446,paladin,retribution,20,6,14
31798,Holythanos,bleeding-hollow,445,paladin,retribution,17,5,12
31799,Árèz,frostmourne,441,paladin,retribution,17,7,10
31800,Lorgax,alterac-mountains,432,paladin,retribution,15,5,10
31801,Dreadrein,tichondrius,431,paladin,retribution,11,5,6
31802,Neverforgot,quelthalas,431,paladin,retribution,11,5,6
31803,Zzf,turalyon,431,paladin,retribution,11,5,6
31804,Ahzreal,garona,426,paladin,retribution,16,8,8
31805,Regivän,azralon,426,paladin,retribution,12,6,6
31806,Hálløwéð,firetree,426,paladin,retribution,14,6,8
31807,Stankylordz,sargeras,426,paladin,retribution,19,8,11
31808,Rashrind,moon-guard,426,paladin,retribution,23,8,15
31809,Sundher,ragnaros,426,paladin,retribution,29,7,22
31810,Kimochiyuh,illidan,425,paladin,retribution,17,7,10
31811,Yemotis,emerald-dream,416,paladin,retribution,10,5,5
31812,Ææøææøææøææø,illidan,416,paladin,retribution,10,5,5
31813,Molodino,nemesis,416,paladin,retribution,10,5,5
31814,Lndrenk,gallywix,416,paladin,retribution,13,5,8
31815,Stahny,thrall,415,paladin,retribution,10,5,5
31816,Hrödric,stormrage,415,paladin,retribution,11,5,6
31817,Saviorsavior,bleeding-hollow,415,paladin,retribution,11,5,6
31818,Epxilon,ragnaros,415,paladin,retribution,14,5,9
31819,Waffulzz,moonrunner,415,paladin,retribution,20,5,15
31820,Rainingrets,tichondrius,404,paladin,retribution,28,10,18
31821,Iamriched,illidan,400,paladin,retribution,13,5,8
31822,Thechoseno,tichondrius,400,paladin,retribution,13,5,8
31823,Sydnneeyy,kelthuzad,399,paladin,retribution,5,5,0
31824,Bubblebùtt,tichondrius,384,paladin,retribution,6,4,2
31825,Plateßound,black-dragonflight,384,paladin,retribution,6,4,2
31826,Laventus,area-52,384,paladin,retribution,6,4,2
31827,Gooeylouie,thunderlord,384,paladin,retribution,6,4,2
31828,Crocfacex,tichondrius,384,paladin,retribution,6,4,2
31829,Casko,wyrmrest-accord,384,paladin,retribution,6,4,2
31830,Anaxxie,azralon,384,paladin,retribution,6,4,2
31831,Owllii,frostwolf,384,paladin,retribution,6,4,2
31832,Waycooltwo,darrowmere,384,paladin,retribution,6,4,2
31833,Vxm,illidan,384,paladin,retribution,6,4,2
31834,Snajky,sargeras,384,paladin,retribution,6,4,2
31835,Giancarloss,quelthalas,384,paladin,retribution,6,4,2
31836,Akadios,azralon,384,paladin,retribution,6,4,2
31837,Slakyph,zuljin,384,paladin,retribution,6,4,2
31838,Farlayne,quelthalas,384,paladin,retribution,6,4,2
31839,Drakewood,moon-guard,384,paladin,retribution,6,4,2
31840,Aohxmathoss,zuljin,384,paladin,retribution,6,4,2
31841,Warspite,caelestrasz,384,paladin,retribution,6,4,2
31842,Wyrmblood,moon-guard,384,paladin,retribution,6,4,2
31843,Sentence,moon-guard,384,paladin,retribution,6,4,2
31844,Leoros,blackrock,384,paladin,retribution,6,4,2
31845,Dartárok,ragnaros,384,paladin,retribution,6,4,2
31846,Pronther,ragnaros,384,paladin,retribution,6,4,2
31847,Saulhudson,bleeding-hollow,384,paladin,retribution,6,4,2
31848,Sasukee,quelthalas,384,paladin,retribution,6,4,2
31849,Gilgamesh,moonrunner,384,paladin,retribution,6,4,2
31850,Lilpéep,area-52,384,paladin,retribution,6,4,2
31851,Ashlín,sargeras,384,paladin,retribution,6,4,2
31852,Inactive,gilneas,384,paladin,retribution,6,4,2
31853,Reclusiarch,tichondrius,384,paladin,retribution,6,4,2
31854,Reckoniing,moon-guard,384,paladin,retribution,6,4,2
31855,Chillpal,illidan,384,paladin,retribution,6,4,2
31856,Tyranoss,azralon,384,paladin,retribution,6,4,2
31857,Salithan,gilneas,384,paladin,retribution,6,4,2
31858,Dazztrain,barthilas,384,paladin,retribution,6,4,2
31859,Ironpallyx,garrosh,384,paladin,retribution,6,4,2
31860,Easiestclass,azshara,384,paladin,retribution,6,4,2
31861,Täintcrusher,illidan,384,paladin,retribution,6,4,2
31862,Protopally,zuljin,384,paladin,retribution,6,4,2
31863,Trynith,area-52,384,paladin,retribution,6,4,2
31864,Bastila,zuljin,384,paladin,retribution,6,4,2
31865,Koal,area-52,384,paladin,retribution,6,4,2
31866,Flfltmf,tichondrius,384,paladin,retribution,6,4,2
31867,Taiffan,azralon,384,paladin,retribution,6,4,2
31868,Rockysh,tichondrius,384,paladin,retribution,6,4,2
31869,Xs,nagrand,384,paladin,retribution,6,4,2
31870,Maeldart,quelthalas,384,paladin,retribution,6,4,2
31871,Daylit,proudmoore,384,paladin,retribution,6,4,2
31872,Hugëhammer,emerald-dream,384,paladin,retribution,6,4,2
31873,Airmight,frostmourne,384,paladin,retribution,6,4,2
31874,Dwarfineas,dalaran,384,paladin,retribution,6,4,2
31875,Luluwu,stormrage,384,paladin,retribution,6,4,2
31876,Nutonhands,moon-guard,384,paladin,retribution,6,4,2
31877,Pappablanco,stormrage,384,paladin,retribution,6,4,2
31878,Shadp,frostmourne,384,paladin,retribution,6,4,2
31879,Palagan,frostmourne,384,paladin,retribution,6,4,2
31880,Heniou,tichondrius,384,paladin,retribution,6,4,2
31881,Plottwists,bleeding-hollow,384,paladin,retribution,6,4,2
31882,Unluckopal,illidan,384,paladin,retribution,6,4,2
31883,Canibaluy,ragnaros,384,paladin,retribution,6,4,2
31884,Holybubble,silvermoon,384,paladin,retribution,6,4,2
31885,Expiate,tichondrius,384,paladin,retribution,6,4,2
31886,Ashgrim,kiljaeden,384,paladin,retribution,6,4,2
31887,Temptrez,bleeding-hollow,384,paladin,retribution,6,4,2
31888,Cenital,quelthalas,384,paladin,retribution,6,4,2
31889,Aswaran,jaedenar,384,paladin,retribution,6,4,2
31890,Crewsade,sargeras,384,paladin,retribution,6,4,2
31891,Ascencer,spirestone,384,paladin,retribution,6,4,2
31892,Anstyl,moon-guard,384,paladin,retribution,6,4,2
31893,Dörisseline,bleeding-hollow,384,paladin,retribution,6,4,2
31894,Kpopsicle,frostmourne,384,paladin,retribution,6,4,2
31895,Lalatinaford,amanthul,384,paladin,retribution,6,4,2
31896,Babylonfive,zuluhed,384,paladin,retribution,6,4,2
31897,Legionare,quelthalas,384,paladin,retribution,6,4,2
31898,Atheistqtlol,illidan,384,paladin,retribution,6,4,2
31899,Dyreilas,stormrage,384,paladin,retribution,6,4,2
31900,Seven,blackwing-lair,384,paladin,retribution,6,4,2
31901,Lothremar,stormrage,384,paladin,retribution,6,4,2
31902,Bmorezaddy,tichondrius,384,paladin,retribution,6,4,2
31903,Chunggus,eredar,384,paladin,retribution,6,4,2
31904,Trisøn,area-52,384,paladin,retribution,6,4,2
31905,Aymer,thrall,384,paladin,retribution,6,4,2
31906,Heliösdark,quelthalas,384,paladin,retribution,6,4,2
31907,Rohlin,boulderfist,384,paladin,retribution,6,4,2
31908,Doç,stormrage,384,paladin,retribution,6,4,2
31909,Yuliu,magtheridon,384,paladin,retribution,6,4,2
31910,Cratt,chromaggus,384,paladin,retribution,6,4,2
31911,Vorne,tortheldrin,384,paladin,retribution,6,4,2
31912,Darklyght,madoran,384,paladin,retribution,6,4,2
31913,Mesiaussx,area-52,384,paladin,retribution,6,4,2
31914,Kaypross,area-52,384,paladin,retribution,6,4,2
31915,Xöchïqüëtzäl,tichondrius,384,paladin,retribution,6,4,2
31916,Fxxku,tichondrius,384,paladin,retribution,6,4,2
31917,Goontaa,staghelm,384,paladin,retribution,6,4,2
31918,Thottylight,stormrage,384,paladin,retribution,6,4,2
31919,Notaefc,icecrown,384,paladin,retribution,6,4,2
31920,Tanrid,moon-guard,384,paladin,retribution,6,4,2
31921,Liebesleid,quelthalas,384,paladin,retribution,6,4,2
31922,Mhuzz,nemesis,384,paladin,retribution,6,4,2
31923,Krewe,uldaman,384,paladin,retribution,6,4,2
31924,Couraegus,azgalor,384,paladin,retribution,6,4,2
31925,Pray,thunderlord,384,paladin,retribution,6,4,2
31926,Patrikuu,tichondrius,384,paladin,retribution,6,4,2
31927,Raphaelo,tichondrius,384,paladin,retribution,6,4,2
31928,Redempshun,drenden,384,paladin,retribution,6,4,2
31929,Merlinä,illidan,384,paladin,retribution,7,4,3
31930,Bigddady,quelthalas,384,paladin,retribution,8,4,4
31931,Armilus,area-52,384,paladin,retribution,11,5,6
31932,Minaxx,dalaran,384,paladin,retribution,9,4,5
31933,Thõre,frostmourne,384,paladin,retribution,15,5,10
31934,Phattpump,tichondrius,384,paladin,retribution,12,4,8
31935,Eddf,ursin,384,paladin,retribution,12,4,8
31936,Mirâ,tichondrius,384,paladin,retribution,12,4,8
31937,Vhaun,cairne,384,paladin,retribution,12,4,8
31938,Gloryholy,shattered-hand,384,paladin,retribution,12,4,8
31939,Kratosq,tichondrius,384,paladin,retribution,12,4,8
31940,Grimdel,moon-guard,384,paladin,retribution,12,4,8
31941,Fiorena,malganis,384,paladin,retribution,12,4,8
31942,Baptism,shattered-hand,384,paladin,retribution,12,4,8
31943,Réxul,ragnaros,384,paladin,retribution,12,4,8
31944,Exolust,dalaran,384,paladin,retribution,12,4,8
31945,Sethy,feathermoon,384,paladin,retribution,12,4,8
31946,Thaleros,tichondrius,384,paladin,retribution,12,4,8
31947,Zexion,azralon,384,paladin,retribution,12,4,8
31948,Sanctïon,bleeding-hollow,384,paladin,retribution,12,4,8
31949,Botch,drenden,384,paladin,retribution,12,4,8
31950,Ihitthose,moon-guard,384,paladin,retribution,12,4,8
31951,Remm,emerald-dream,384,paladin,retribution,12,4,8
31952,Glexann,sargeras,384,paladin,retribution,12,4,8
31953,Oppaladin,elune,384,paladin,retribution,12,4,8
31954,Joepepperoni,korgath,384,paladin,retribution,12,4,8
31955,Goloh,shadowmoon,384,paladin,retribution,12,4,8
31956,Wards,thunderlord,384,paladin,retribution,12,4,8
31957,Ðorlie,malganis,384,paladin,retribution,12,4,8
31958,Adrn,tichondrius,384,paladin,retribution,12,4,8
31959,Mashy,moon-guard,384,paladin,retribution,12,4,8
31960,Thejüdge,malfurion,384,paladin,retribution,12,4,8
31961,Moosgo,emerald-dream,384,paladin,retribution,12,4,8
31962,Blikzy,caelestrasz,384,paladin,retribution,12,4,8
31963,Treboroyal,area-52,384,paladin,retribution,12,4,8
31964,Kiami,tichondrius,384,paladin,retribution,12,4,8
31965,Drakensang,tichondrius,384,paladin,retribution,12,4,8
31966,Rightz,muradin,384,paladin,retribution,12,4,8
31967,Jimithing,senjin,384,paladin,retribution,12,4,8
31968,Passinpeace,tichondrius,384,paladin,retribution,12,4,8
31969,Msjudged,blackrock,384,paladin,retribution,12,4,8
31970,Øathßreaker,laughing-skull,384,paladin,retribution,12,4,8
31971,Varuul,nerzhul,384,paladin,retribution,12,4,8
31972,Kyrianjutsu,area-52,384,paladin,retribution,12,4,8
31973,Picorii,frostmourne,384,paladin,retribution,12,4,8
31974,Marlynx,tichondrius,384,paladin,retribution,12,4,8
31975,Aidillon,shadowsong,384,paladin,retribution,12,4,8
31976,Lenneth,nordrassil,384,paladin,retribution,12,4,8
31977,Taelpalx,stormrage,384,paladin,retribution,12,4,8
31978,Tëmplar,bleeding-hollow,384,paladin,retribution,12,4,8
31979,Lowther,bleeding-hollow,384,paladin,retribution,12,4,8
31980,Phelix,lightninghoof,384,paladin,retribution,12,4,8
31981,Cafre,illidan,384,paladin,retribution,12,4,8
31982,Tyronethebbc,tichondrius,384,paladin,retribution,12,4,8
31983,Kurook,moon-guard,384,paladin,retribution,12,4,8
31984,Fengyutongqs,tichondrius,384,paladin,retribution,12,4,8
31985,Evilmoocow,grizzly-hills,384,paladin,retribution,12,4,8
31986,Adauto,illidan,384,paladin,retribution,12,4,8
31987,Veshral,arthas,384,paladin,retribution,12,4,8
31988,Actionman,bleeding-hollow,384,paladin,retribution,12,4,8
31989,Dionysius,silvermoon,384,paladin,retribution,12,4,8
31990,Dohsevèn,tichondrius,384,paladin,retribution,12,4,8
31991,Eldruin,amanthul,384,paladin,retribution,12,4,8
31992,Andromëdä,hyjal,384,paladin,retribution,12,4,8
31993,Kamianna,tichondrius,384,paladin,retribution,12,4,8
31994,Givinpowpows,korgath,384,paladin,retribution,12,4,8
31995,Bauldrin,moon-guard,384,paladin,retribution,12,4,8
31996,Simpforomenx,emerald-dream,384,paladin,retribution,12,4,8
31997,Jimxeung,tichondrius,384,paladin,retribution,12,4,8
31998,Kegari,tichondrius,384,paladin,retribution,12,4,8
31999,Dezul,stormscale,384,paladin,retribution,12,4,8
32000,Jeddmaus,tichondrius,384,paladin,retribution,12,4,8
32001,Prettylightx,kelthuzad,384,paladin,retribution,12,4,8
32002,Ddawz,proudmoore,384,paladin,retribution,12,4,8
32003,Justsaiyen,bleeding-hollow,384,paladin,retribution,12,4,8
32004,Eettooko,aegwynn,384,paladin,retribution,12,4,8
32005,Sahbabii,baelgun,384,paladin,retribution,12,4,8
32006,Zakh,proudmoore,384,paladin,retribution,12,4,8
32007,Nicc,kelthuzad,384,paladin,retribution,12,4,8
32008,Volphorix,illidan,384,paladin,retribution,12,4,8
32009,Korijame,area-52,384,paladin,retribution,12,4,8
32010,Blargnarg,area-52,384,paladin,retribution,12,4,8
32011,Tirinor,malganis,384,paladin,retribution,12,4,8
32012,Bangerr,bonechewer,384,paladin,retribution,12,4,8
32013,Rouzygoozy,illidan,384,paladin,retribution,12,4,8
32014,Hølyknìght,tichondrius,384,paladin,retribution,12,4,8
32015,Leail,frostmourne,384,paladin,retribution,12,4,8
32016,Crystahlmeth,sargeras,384,paladin,retribution,12,4,8
32017,Smontis,sargeras,384,paladin,retribution,12,4,8
32018,Lightmodel,sargeras,384,paladin,retribution,12,4,8
32019,Whoowhat,zuljin,384,paladin,retribution,12,4,8
32020,Yedema,tichondrius,384,paladin,retribution,12,4,8
32021,Uver,tichondrius,384,paladin,retribution,12,4,8
32022,Palinator,bleeding-hollow,384,paladin,retribution,12,4,8
32023,Alínna,ragnaros,384,paladin,retribution,12,4,8
32024,Oroürke,stormrage,384,paladin,retribution,12,4,8
32025,Gerudö,stormrage,384,paladin,retribution,12,4,8
32026,Àpolo,stormrage,384,paladin,retribution,12,4,8
32027,Goodgardener,hyjal,384,paladin,retribution,12,4,8
32028,Tufybighamer,malganis,384,paladin,retribution,12,4,8
32029,Slimxx,burning-blade,384,paladin,retribution,12,4,8
32030,Strugglèbus,thrall,384,paladin,retribution,12,4,8
32031,Craphtyßop,zuljin,384,paladin,retribution,12,4,8
32032,Crazysyco,proudmoore,384,paladin,retribution,12,4,8
32033,Retspec,darkspear,384,paladin,retribution,12,4,8
32034,Maelificus,aggramar,384,paladin,retribution,12,4,8
32035,Paldan,illidan,384,paladin,retribution,12,4,8
32036,Icekiss,tichondrius,384,paladin,retribution,12,4,8
32037,Greenracer,kiljaeden,384,paladin,retribution,12,4,8
32038,Salvatores,ragnaros,384,paladin,retribution,12,4,8
32039,Bubblestuft,illidan,384,paladin,retribution,12,4,8
32040,Pogwogs,illidan,384,paladin,retribution,12,4,8
32041,Gripadin,tichondrius,384,paladin,retribution,12,4,8
32042,Ilsey,ragnaros,384,paladin,retribution,12,4,8
32043,Senion,velen,384,paladin,retribution,12,4,8
32044,Catuvalos,kiljaeden,384,paladin,retribution,12,4,8
32045,Mercuryx,tichondrius,384,paladin,retribution,12,4,8
32046,Aricen,thunderhorn,384,paladin,retribution,12,4,8
32047,Sigmapepe,quelthalas,384,paladin,retribution,12,4,8
32048,Mikeelul,tichondrius,384,paladin,retribution,12,4,8
32049,Niolite,ragnaros,384,paladin,retribution,12,4,8
32050,Simonis,windrunner,384,paladin,retribution,12,4,8
32051,Thêirin,lightbringer,384,paladin,retribution,12,4,8
32052,Strøngwin,bleeding-hollow,384,paladin,retribution,12,4,8
32053,Elflicious,illidan,384,paladin,retribution,12,4,8
32054,Illhaveacoke,moon-guard,384,paladin,retribution,12,4,8
32055,Vonmagnus,sargeras,384,paladin,retribution,12,4,8
32056,Ippótis,sargeras,384,paladin,retribution,12,4,8
32057,Dose,moon-guard,384,paladin,retribution,12,4,8
32058,Avataar,blades-edge,384,paladin,retribution,12,4,8
32059,Lânnâ,tichondrius,384,paladin,retribution,12,4,8
32060,Juliusplzher,area-52,384,paladin,retribution,12,4,8
32061,Lokkillos,drakkari,384,paladin,retribution,12,4,8
32062,Tymy,tichondrius,384,paladin,retribution,12,4,8
32063,Bracen,emerald-dream,384,paladin,retribution,12,4,8
32064,Smöke,frostmourne,384,paladin,retribution,12,4,8
32065,Lépéedophil,zuljin,384,paladin,retribution,12,4,8
32066,Roodictz,zuljin,384,paladin,retribution,12,4,8
32067,Pallyforeva,sargeras,384,paladin,retribution,12,4,8
32068,Acquiesce,bleeding-hollow,384,paladin,retribution,16,5,11
32069,Batmanp,quelthalas,384,paladin,retribution,13,4,9
32070,Ccpx,area-52,384,paladin,retribution,18,4,14
32071,Powercelest,quelthalas,384,paladin,retribution,18,4,14
32072,Caityaj,illidan,384,paladin,retribution,18,4,14
32073,Theadona,runetotem,384,paladin,retribution,18,4,14
32074,Draknals,illidan,384,paladin,retribution,18,4,14
32075,Tylnish,hyjal,384,paladin,retribution,18,4,14
32076,Retsáiyan,tichondrius,384,paladin,retribution,18,4,14
32077,Xinoh,area-52,384,paladin,retribution,18,4,14
32078,ßén,bleeding-hollow,384,paladin,retribution,18,4,14
32079,Talurius,azralon,384,paladin,retribution,18,4,14
32080,Ongang,illidan,384,paladin,retribution,18,4,14
32081,Essexqt,blackhand,384,paladin,retribution,18,4,14
32082,Milfcrusader,tichondrius,384,paladin,retribution,18,4,14
32083,Malisaa,tichondrius,384,paladin,retribution,18,4,14
32084,Fragnum,barthilas,384,paladin,retribution,18,4,14
32085,Iskándar,tichondrius,384,paladin,retribution,24,4,20
32086,Mhakoi,bleeding-hollow,384,paladin,retribution,24,4,20
32087,Matrium,kiljaeden,384,paladin,retribution,24,4,20
32088,Backfattammy,bleeding-hollow,384,paladin,retribution,24,4,20
32089,Memorabilia,quelthalas,383,paladin,retribution,6,4,2
32090,Thaerim,ragnaros,383,paladin,retribution,6,4,2
32091,Dabsmaster,dalaran,383,paladin,retribution,6,4,2
32092,Pajjy,azralon,383,paladin,retribution,6,4,2
32093,Adandon,dalaran,383,paladin,retribution,6,4,2
32094,Balador,uldum,383,paladin,retribution,6,4,2
32095,Charmeine,zuljin,383,paladin,retribution,6,4,2
32096,Themachon,stormrage,383,paladin,retribution,6,4,2
32097,Sinficha,quelthalas,383,paladin,retribution,6,4,2
32098,Amazarak,stormrage,383,paladin,retribution,12,4,8
32099,Holyqt,thunderlord,383,paladin,retribution,12,4,8
32100,Øexørcistta,nemesis,383,paladin,retribution,12,4,8
32101,Mugann,malganis,383,paladin,retribution,12,4,8
32102,Kennysun,azralon,383,paladin,retribution,12,4,8
32103,Desrexen,malganis,383,paladin,retribution,12,4,8
32104,Holyburger,hakkar,383,paladin,retribution,12,4,8
32105,Nastenatren,steamwheedle-cartel,383,paladin,retribution,18,4,14
32106,Imimmune,garithos,383,paladin,retribution,18,4,14
32107,Funkknight,sargeras,383,paladin,retribution,18,4,14
32108,Dago,azralon,383,paladin,retribution,18,4,14
32109,Stunnaax,frostmourne,383,paladin,retribution,18,4,14
32110,Balnot,blackrock,383,paladin,retribution,18,4,14
32111,Paladocka,stormrage,383,paladin,retribution,24,4,20
32112,Hadrianus,azralon,383,paladin,retribution,24,4,20
32113,Ðrekai,moon-guard,383,paladin,retribution,24,4,20
32114,Kenbad,aegwynn,382,paladin,retribution,6,4,2
32115,Kungrowl,emerald-dream,382,paladin,retribution,6,4,2
32116,Derpnstein,gorgonnash,382,paladin,retribution,12,4,8
32117,Zedekia,aerie-peak,382,paladin,retribution,12,4,8
32118,Sundreland,moon-guard,382,paladin,retribution,12,4,8
32119,Amerok,malfurion,378,paladin,retribution,18,4,14
32120,Nyms,gallywix,374,paladin,retribution,36,4,32
32121,Vegetå,malganis,372,paladin,retribution,37,8,29
32122,Novachrono,bladefist,367,paladin,retribution,9,5,4
32123,Barzø,tichondrius,367,paladin,retribution,11,4,7
32124,Crucifine,wyrmrest-accord,367,paladin,retribution,11,4,7
32125,Goinglarge,frostmourne,367,paladin,retribution,11,4,7
32126,Mop,eitrigg,367,paladin,retribution,17,4,13
32127,Feelmenu,deathwing,367,paladin,retribution,17,4,13
32128,Nohozano,area-52,352,paladin,retribution,10,4,6
32129,Bibimbop,boulderfist,352,paladin,retribution,13,5,8
32130,Gordonryan,bleeding-hollow,352,paladin,retribution,16,4,12
32131,Sesshomâru,nemesis,351,paladin,retribution,11,4,7
32132,Páladian,quelthalas,351,paladin,retribution,11,4,7
32133,Conquistador,proudmoore,351,paladin,retribution,11,4,7
32134,Estarosta,azralon,351,paladin,retribution,17,4,13
32135,Língnafòx,tichondrius,336,paladin,retribution,9,5,4
32136,Bruujqt,moon-guard,336,paladin,retribution,9,5,4
32137,Titansnake,illidan,336,paladin,retribution,9,4,5
32138,Meduselda,kelthuzad,335,paladin,retribution,9,5,4
32139,Yellowflash,sentinels,330,paladin,retribution,17,7,10
32140,Returdstrenf,illidan,330,paladin,retribution,20,5,15
32141,Dubbz,silvermoon,320,paladin,retribution,10,4,6
32142,Asolace,dark-iron,320,paladin,retribution,10,4,6
32143,Junmá,tichondrius,319,paladin,retribution,5,4,1
32144,Ruulight,tichondrius,319,paladin,retribution,5,4,1
32145,Karig,sargeras,319,paladin,retribution,8,4,4
32146,Jadelong,azshara,319,paladin,retribution,8,4,4
32147,Holyshasha,tichondrius,319,paladin,retribution,8,4,4
32148,Holynaps,malganis,319,paladin,retribution,9,4,5
32149,Wrath,frostmourne,319,paladin,retribution,14,4,10
32150,Darkjewmagic,frostmourne,319,paladin,retribution,14,4,10
32151,Naizen,tichondrius,304,paladin,retribution,7,4,3
32152,Torrthak,area-52,304,paladin,retribution,7,4,3
32153,Jacobelaylo,moon-guard,288,paladin,retribution,6,3,3
32154,Purekiller,destromath,288,paladin,retribution,6,3,3
32155,Daigorro,illidan,288,paladin,retribution,6,3,3
32156,Pahlevahn,stormrage,288,paladin,retribution,6,3,3
32157,Senisse,illidan,288,paladin,retribution,6,3,3
32158,Ironboxer,tichondrius,288,paladin,retribution,6,3,3
32159,Nickahunnid,sargeras,288,paladin,retribution,6,3,3
32160,Kanachi,bleeding-hollow,288,paladin,retribution,6,3,3
32161,Siyepaladin,illidan,288,paladin,retribution,6,3,3
32162,Menjo,malganis,288,paladin,retribution,6,3,3
32163,Shakemup,stormrage,288,paladin,retribution,6,3,3
32164,Zuezz,korialstrasz,288,paladin,retribution,6,3,3
32165,Nickotines,kelthuzad,288,paladin,retribution,6,3,3
32166,Eldanx,stormrage,288,paladin,retribution,6,3,3
32167,Shockdoctor,stormrage,288,paladin,retribution,6,3,3
32168,Holyoverdose,laughing-skull,288,paladin,retribution,6,3,3
32169,Vaels,sargeras,288,paladin,retribution,6,3,3
32170,Mki,kargath,288,paladin,retribution,6,3,3
32171,Ataraxy,bleeding-hollow,288,paladin,retribution,6,3,3
32172,Xbertiize,tichondrius,288,paladin,retribution,6,3,3
32173,Kôld,tichondrius,288,paladin,retribution,6,3,3
32174,Judgem,tichondrius,288,paladin,retribution,6,3,3
32175,Bubblet,bleeding-hollow,288,paladin,retribution,6,3,3
32176,Mayfirepal,hyjal,288,paladin,retribution,6,3,3
32177,Àxçël,hyjal,288,paladin,retribution,6,3,3
32178,Borisdablade,bleeding-hollow,288,paladin,retribution,6,3,3
32179,Lorainn,ragnaros,288,paladin,retribution,6,3,3
32180,Vük,destromath,288,paladin,retribution,6,3,3
32181,Kyperion,stormrage,288,paladin,retribution,6,3,3
32182,Reiot,sargeras,288,paladin,retribution,6,3,3
32183,Numela,moon-guard,288,paladin,retribution,6,3,3
32184,Konyfotm,bleeding-hollow,288,paladin,retribution,6,3,3
32185,Mcfleye,malganis,288,paladin,retribution,6,3,3
32186,Morlunè,tichondrius,288,paladin,retribution,6,3,3
32187,Obbzz,spirestone,288,paladin,retribution,6,3,3
32188,Kloernstarr,sargeras,288,paladin,retribution,6,3,3
32189,Tsubakî,norgannon,288,paladin,retribution,6,3,3
32190,Vanitasz,bleeding-hollow,288,paladin,retribution,6,3,3
32191,Shibbz,illidan,288,paladin,retribution,6,3,3
32192,Sadamell,tichondrius,288,paladin,retribution,6,3,3
32193,Chickenlover,tichondrius,288,paladin,retribution,6,3,3
32194,Slüg,bleeding-hollow,288,paladin,retribution,6,3,3
32195,Krackanut,kelthuzad,288,paladin,retribution,6,3,3
32196,Baladinn,tichondrius,288,paladin,retribution,6,3,3
32197,Everith,bleeding-hollow,288,paladin,retribution,6,3,3
32198,Astasia,laughing-skull,288,paladin,retribution,6,3,3
32199,Holyplaise,tichondrius,288,paladin,retribution,6,3,3
32200,Draeneihead,gnomeregan,288,paladin,retribution,6,3,3
32201,Rost,jaedenar,288,paladin,retribution,6,3,3
32202,Snippdeux,garrosh,288,paladin,retribution,6,3,3
32203,Sâbër,moon-guard,288,paladin,retribution,6,3,3
32204,Pallyson,thunderhorn,288,paladin,retribution,6,3,3
32205,Nhanless,tichondrius,288,paladin,retribution,6,3,3
32206,Gorillawings,tichondrius,288,paladin,retribution,6,3,3
32207,Dfz,mannoroth,288,paladin,retribution,6,3,3
32208,Thorkell,moon-guard,288,paladin,retribution,6,3,3
32209,Nalenne,alexstrasza,288,paladin,retribution,6,3,3
32210,Ýøg,tichondrius,288,paladin,retribution,6,3,3
32211,Holyyness,bleeding-hollow,288,paladin,retribution,6,3,3
32212,Brahlix,area-52,288,paladin,retribution,6,3,3
32213,Deadlyskills,arathor,288,paladin,retribution,6,3,3
32214,Jojoboskies,aegwynn,288,paladin,retribution,6,3,3
32215,Vynlen,uldaman,288,paladin,retribution,6,3,3
32216,Lituation,sargeras,288,paladin,retribution,6,3,3
32217,Zeroret,tichondrius,288,paladin,retribution,6,3,3
32218,Dev,frostwolf,288,paladin,retribution,6,3,3
32219,Pallynatir,ragnaros,288,paladin,retribution,6,3,3
32220,Lasonil,zuljin,288,paladin,retribution,6,3,3
32221,Varo,laughing-skull,288,paladin,retribution,6,3,3
32222,Casadorez,tichondrius,288,paladin,retribution,6,3,3
32223,Qoop,tichondrius,288,paladin,retribution,6,3,3
32224,Pvar,stormrage,288,paladin,retribution,6,3,3
32225,Apocryphx,stormrage,288,paladin,retribution,6,3,3
32226,Jónò,tichondrius,288,paladin,retribution,6,3,3
32227,Ludicrus,tichondrius,288,paladin,retribution,6,3,3
32228,Divinebehind,laughing-skull,288,paladin,retribution,6,3,3
32229,Hybrix,tichondrius,288,paladin,retribution,6,3,3
32230,Exaltedthot,zuljin,288,paladin,retribution,6,3,3
32231,Pâllywhacker,bleeding-hollow,288,paladin,retribution,6,3,3
32232,Holycenter,stormrage,288,paladin,retribution,6,3,3
32233,Coldverdict,tichondrius,288,paladin,retribution,6,3,3
32234,Miangder,tichondrius,288,paladin,retribution,6,3,3
32235,Efilios,tichondrius,288,paladin,retribution,6,3,3
32236,Bigdamham,tichondrius,288,paladin,retribution,6,3,3
32237,Chicoweather,sargeras,288,paladin,retribution,6,3,3
32238,Ximenita,ragnaros,288,paladin,retribution,6,3,3
32239,Chiraqret,thunderhorn,288,paladin,retribution,6,3,3
32240,Stømpdøwn,tichondrius,288,paladin,retribution,6,3,3
32241,Netflixnfeet,stormreaver,288,paladin,retribution,6,3,3
32242,Salamislappr,stormrage,288,paladin,retribution,6,3,3
32243,Karwryn,magtheridon,288,paladin,retribution,6,3,3
32244,Syvir,area-52,288,paladin,retribution,6,3,3
32245,Zilladin,darkspear,288,paladin,retribution,6,3,3
32246,Pipay,proudmoore,288,paladin,retribution,6,3,3
32247,Xaospaladin,frostmourne,288,paladin,retribution,6,3,3
32248,Babar,doomhammer,288,paladin,retribution,6,3,3
32249,Arngrim,the-venture-co,288,paladin,retribution,6,3,3
32250,Theßest,baelgun,288,paladin,retribution,6,3,3
32251,Kegman,thrall,288,paladin,retribution,6,3,3
32252,Nerfmywings,frostmourne,288,paladin,retribution,6,3,3
32253,Assaultron,dalaran,288,paladin,retribution,6,3,3
32254,Tahonto,malganis,288,paladin,retribution,6,3,3
32255,Pirupiru,quelthalas,288,paladin,retribution,6,3,3
32256,Ulfsark,garrosh,288,paladin,retribution,6,3,3
32257,Ouken,frostmourne,288,paladin,retribution,6,3,3
32258,Thecrusaders,proudmoore,288,paladin,retribution,6,3,3
32259,Zugzorr,azralon,288,paladin,retribution,6,3,3
32260,Absolvus,emerald-dream,288,paladin,retribution,6,3,3
32261,Reallyfe,skullcrusher,288,paladin,retribution,6,3,3
32262,Lencelia,deathwing,288,paladin,retribution,6,3,3
32263,Palladini,jubeithos,288,paladin,retribution,6,3,3
32264,Finnthepally,proudmoore,288,paladin,retribution,6,3,3
32265,Bigdmcgee,frostmourne,288,paladin,retribution,6,3,3
32266,Timu,suramar,288,paladin,retribution,6,3,3
32267,Itzon,proudmoore,288,paladin,retribution,6,3,3
32268,Légolas,llane,288,paladin,retribution,6,3,3
32269,Lowbb,sargeras,288,paladin,retribution,6,3,3
32270,Luminali,frostwolf,288,paladin,retribution,6,3,3
32271,Tekkies,barthilas,288,paladin,retribution,6,3,3
32272,Hadory,shattered-halls,288,paladin,retribution,6,3,3
32273,Aelael,icecrown,288,paladin,retribution,6,3,3
32274,Taynos,tichondrius,288,paladin,retribution,6,3,3
32275,Luxuriousman,fizzcrank,288,paladin,retribution,6,3,3
32276,Legelight,malganis,288,paladin,retribution,6,3,3
32277,Scamadin,tichondrius,288,paladin,retribution,6,3,3
32278,Bíteme,sargeras,288,paladin,retribution,6,3,3
32279,Valadinna,tichondrius,288,paladin,retribution,6,3,3
32280,Buttflapster,proudmoore,288,paladin,retribution,6,3,3
32281,Lóli,azralon,288,paladin,retribution,6,3,3
32282,Boladosx,azralon,288,paladin,retribution,6,3,3
32283,Bivol,whisperwind,288,paladin,retribution,6,3,3
32284,Pixilade,barthilas,288,paladin,retribution,6,3,3
32285,Rhoynar,quelthalas,288,paladin,retribution,6,3,3
32286,Halnarran,area-52,288,paladin,retribution,6,3,3
32287,Dordrolan,frostmourne,288,paladin,retribution,6,3,3
32288,Cocodog,kiljaeden,288,paladin,retribution,6,3,3
32289,Lighttzz,azralon,288,paladin,retribution,6,3,3
32290,Mvpp,dalaran,288,paladin,retribution,6,3,3
32291,Alocr,drakkari,288,paladin,retribution,6,3,3
32292,Divinetits,sargeras,288,paladin,retribution,6,3,3
32293,Darthalion,quelthalas,288,paladin,retribution,6,3,3
32294,Runebane,doomhammer,288,paladin,retribution,6,3,3
32295,Condexx,quelthalas,288,paladin,retribution,6,3,3
32296,Otame,quelthalas,288,paladin,retribution,6,3,3
32297,Danks,arthas,288,paladin,retribution,6,3,3
32298,Haarun,blackrock,288,paladin,retribution,6,3,3
32299,Zenpally,doomhammer,288,paladin,retribution,6,3,3
32300,Therocker,darkspear,288,paladin,retribution,6,3,3
32301,Wonpai,frostmourne,288,paladin,retribution,6,3,3
32302,Vixybae,illidan,288,paladin,retribution,6,3,3
32303,Tûrbotax,sargeras,288,paladin,retribution,6,3,3
32304,Nyxkithar,nagrand,288,paladin,retribution,6,3,3
32305,Moox,wyrmrest-accord,288,paladin,retribution,6,3,3
32306,Mónstër,ragnaros,288,paladin,retribution,6,3,3
32307,Kräthöz,quelthalas,288,paladin,retribution,6,3,3
32308,Xizima,ragnaros,288,paladin,retribution,6,3,3
32309,Dráugus,azralon,288,paladin,retribution,6,3,3
32310,Beepsmash,executus,288,paladin,retribution,6,3,3
32311,Orangepa,dalaran,288,paladin,retribution,6,3,3
32312,Marof,spirestone,288,paladin,retribution,6,3,3
32313,Transwoman,frostmourne,288,paladin,retribution,6,3,3
32314,Dimitrony,quelthalas,288,paladin,retribution,6,3,3
32315,Víctor,quelthalas,288,paladin,retribution,6,3,3
32316,Jestiny,amanthul,288,paladin,retribution,6,3,3
32317,Twochains,aegwynn,288,paladin,retribution,6,3,3
32318,Kahleesy,sargeras,288,paladin,retribution,6,3,3
32319,Sinhero,area-52,288,paladin,retribution,6,3,3
32320,Uritank,thrall,288,paladin,retribution,6,3,3
32321,Nâtion,cenarius,288,paladin,retribution,6,3,3
32322,Coachcarter,nerzhul,288,paladin,retribution,6,3,3
32323,Bootboi,thrall,288,paladin,retribution,6,3,3
32324,Kithrah,dathremar,288,paladin,retribution,6,3,3
32325,Feikonia,queldorei,288,paladin,retribution,6,3,3
32326,Ankhz,area-52,288,paladin,retribution,6,3,3
32327,Warchaos,skullcrusher,288,paladin,retribution,6,3,3
32328,Flareous,moon-guard,288,paladin,retribution,6,3,3
32329,Holyshrekt,frostmourne,288,paladin,retribution,6,3,3
32330,Stepbrodi,moon-guard,288,paladin,retribution,6,3,3
32331,Brodyb,malganis,288,paladin,retribution,6,3,3
32332,Alexrt,frostmourne,288,paladin,retribution,6,3,3
32333,Slopzy,sargeras,288,paladin,retribution,6,3,3
32334,Radbout,blackrock,288,paladin,retribution,6,3,3
32335,Açaelus,wyrmrest-accord,288,paladin,retribution,6,3,3
32336,Nerfretpls,area-52,288,paladin,retribution,6,3,3
32337,Gapingpooter,shadowmoon,288,paladin,retribution,6,3,3
32338,Teazie,ursin,288,paladin,retribution,6,3,3
32339,Kickflipped,dalaran,288,paladin,retribution,6,3,3
32340,Makiligos,area-52,288,paladin,retribution,6,3,3
32341,Normnom,area-52,288,paladin,retribution,6,3,3
32342,Bigdumpy,thaurissan,288,paladin,retribution,6,3,3
32343,Leá,illidan,288,paladin,retribution,6,3,3
32344,Coldzito,ragnaros,288,paladin,retribution,6,3,3
32345,Sprezzatura,illidan,288,paladin,retribution,6,3,3
32346,Ðova,moon-guard,288,paladin,retribution,6,3,3
32347,Lovelàce,proudmoore,288,paladin,retribution,6,3,3
32348,Tadaki,dalaran,288,paladin,retribution,6,3,3
32349,Rectaluse,dalaran,288,paladin,retribution,6,3,3
32350,Netguru,ragnaros,288,paladin,retribution,6,3,3
32351,Lightheartx,proudmoore,288,paladin,retribution,6,3,3
32352,Zaghad,ragnaros,288,paladin,retribution,9,4,5
32353,Ivanko,dalaran,288,paladin,retribution,7,3,4
32354,Retattack,area-52,288,paladin,retribution,10,4,6
32355,Josepala,stormrage,288,paladin,retribution,9,3,6
32356,Eljosco,nordrassil,288,paladin,retribution,12,3,9
32357,Dalden,trollbane,288,paladin,retribution,12,3,9
32358,Marrike,moon-guard,288,paladin,retribution,12,3,9
32359,Ucvnt,illidan,288,paladin,retribution,12,3,9
32360,Darkkantares,ragnaros,288,paladin,retribution,12,3,9
32361,Paladatrox,ragnaros,288,paladin,retribution,12,3,9
32362,Bigjoetheceo,mannoroth,288,paladin,retribution,12,3,9
32363,Baconsock,kelthuzad,288,paladin,retribution,12,3,9
32364,Ogtandoness,azgalor,288,paladin,retribution,12,3,9
32365,Momhips,bloodscalp,288,paladin,retribution,12,3,9
32366,Asukaxt,illidan,288,paladin,retribution,12,3,9
32367,Ajara,moon-guard,288,paladin,retribution,12,3,9
32368,Chetmorton,emerald-dream,288,paladin,retribution,12,3,9
32369,Påladin,area-52,288,paladin,retribution,12,3,9
32370,Tolleytrain,malganis,288,paladin,retribution,12,3,9
32371,Aeltharix,blackwater-raiders,288,paladin,retribution,12,3,9
32372,Bulbi,emerald-dream,288,paladin,retribution,12,3,9
32373,Sanction,the-forgotten-coast,288,paladin,retribution,12,3,9
32374,Balancelight,azgalor,288,paladin,retribution,12,3,9
32375,Aenwyl,quelthalas,288,paladin,retribution,12,3,9
32376,Burom,kelthuzad,288,paladin,retribution,12,3,9
32377,Slania,area-52,288,paladin,retribution,12,3,9
32378,Thnannan,tichondrius,288,paladin,retribution,12,3,9
32379,Kuoch,shandris,288,paladin,retribution,12,3,9
32380,Corthic,area-52,288,paladin,retribution,12,3,9
32381,Quelite,sargeras,288,paladin,retribution,12,3,9
32382,Unspankable,burning-legion,288,paladin,retribution,12,3,9
32383,Mwanmwa,blades-edge,288,paladin,retribution,12,3,9
32384,Calvary,stormscale,288,paladin,retribution,12,3,9
32385,Kentö,area-52,288,paladin,retribution,12,3,9
32386,Bubblebooty,drakthul,288,paladin,retribution,12,3,9
32387,Aggromatik,zuljin,288,paladin,retribution,12,3,9
32388,Säv,tichondrius,288,paladin,retribution,12,3,9
32389,Svane,thunderlord,288,paladin,retribution,12,3,9
32390,Ashy,bonechewer,288,paladin,retribution,12,3,9
32391,Darkshield,stormrage,288,paladin,retribution,12,3,9
32392,Homeboywill,hyjal,288,paladin,retribution,12,3,9
32393,Wasabipal,malganis,288,paladin,retribution,12,3,9
32394,Tacoroll,tichondrius,288,paladin,retribution,12,3,9
32395,Urmumsbeefer,thrall,288,paladin,retribution,12,3,9
32396,Bigplucker,kelthuzad,288,paladin,retribution,12,3,9
32397,Sàber,tichondrius,288,paladin,retribution,12,3,9
32398,Ashlïe,moon-guard,288,paladin,retribution,12,3,9
32399,Tarpeeksi,tichondrius,288,paladin,retribution,12,3,9
32400,Brutaldeath,area-52,288,paladin,retribution,12,3,9
32401,Asellusarc,kelthuzad,288,paladin,retribution,12,3,9
32402,Nik,the-underbog,288,paladin,retribution,12,3,9
32403,Aduynn,tichondrius,288,paladin,retribution,12,3,9
32404,Tíron,dalaran,288,paladin,retribution,12,3,9
32405,Smokeys,sargeras,288,paladin,retribution,12,3,9
32406,Theodrei,darrowmere,288,paladin,retribution,12,3,9
32407,Dävis,ragnaros,288,paladin,retribution,12,3,9
32408,Holydiarrhea,illidan,288,paladin,retribution,12,3,9
32409,Dárkness,blades-edge,288,paladin,retribution,12,3,9
32410,Vintibusca,azralon,288,paladin,retribution,12,3,9
32411,Kreigan,hellscream,288,paladin,retribution,12,3,9
32412,Ultrah,area-52,288,paladin,retribution,12,3,9
32413,Thunddarr,stormrage,288,paladin,retribution,12,3,9
32414,Gashlycrumb,tichondrius,288,paladin,retribution,12,3,9
32415,Aafushou,proudmoore,288,paladin,retribution,12,3,9
32416,Leronos,zuljin,288,paladin,retribution,12,3,9
32417,Lilby,lightbringer,288,paladin,retribution,12,3,9
32418,Johnus,lightbringer,288,paladin,retribution,12,3,9
32419,Fpaladin,tichondrius,288,paladin,retribution,12,3,9
32420,Wälly,garona,288,paladin,retribution,12,3,9
32421,Palâdin,zuljin,288,paladin,retribution,12,3,9
32422,Fknnoath,frostmourne,288,paladin,retribution,12,3,9
32423,Yepsqorz,tichondrius,288,paladin,retribution,12,3,9
32424,Laelias,lightbringer,288,paladin,retribution,12,3,9
32425,Donsagrado,quelthalas,288,paladin,retribution,12,3,9
32426,Aválerion,proudmoore,288,paladin,retribution,12,3,9
32427,Sbpluss,illidan,288,paladin,retribution,12,3,9
32428,Bringbakbuff,illidan,288,paladin,retribution,12,3,9
32429,Zippzyx,tichondrius,288,paladin,retribution,12,3,9
32430,Lue,boulderfist,288,paladin,retribution,12,3,9
32431,Cromsecrate,dalaran,288,paladin,retribution,12,3,9
32432,Tharinty,ragnaros,288,paladin,retribution,12,3,9
32433,Crusticus,stormrage,288,paladin,retribution,12,3,9
32434,Treezey,durotan,288,paladin,retribution,12,3,9
32435,Koltar,stormrage,288,paladin,retribution,12,3,9
32436,Tutle,nathrezim,288,paladin,retribution,12,3,9
32437,Olorunn,tichondrius,288,paladin,retribution,12,3,9
32438,Perdiseus,stormrage,288,paladin,retribution,12,3,9
32439,Xkillz,korgath,288,paladin,retribution,12,3,9
32440,Sivan,crushridge,288,paladin,retribution,12,3,9
32441,Somite,stormrage,288,paladin,retribution,12,3,9
32442,Varthinator,stormrage,288,paladin,retribution,12,3,9
32443,Tarkovkappa,illidan,288,paladin,retribution,12,3,9
32444,Yeluh,malganis,288,paladin,retribution,12,3,9
32445,Vaaleria,dalaran,288,paladin,retribution,12,3,9
32446,Lightfûry,kelthuzad,288,paladin,retribution,12,3,9
32447,Lìnkzq,frostmourne,288,paladin,retribution,12,3,9
32448,Kãrën,emerald-dream,288,paladin,retribution,12,3,9
32449,Geekpala,thrall,288,paladin,retribution,12,3,9
32450,Rxxkiee,tichondrius,288,paladin,retribution,12,3,9
32451,Ðeathguise,ysera,288,paladin,retribution,12,3,9
32452,Clorpi,drakkari,288,paladin,retribution,12,3,9
32453,Flashstark,area-52,288,paladin,retribution,12,3,9
32454,Merothin,drakkari,288,paladin,retribution,12,3,9
32455,Uzbadkhazad,ragnaros,288,paladin,retribution,12,3,9
32456,Kloerny,sargeras,288,paladin,retribution,12,3,9
32457,Walkerbait,nazgrel,288,paladin,retribution,12,3,9
32458,Kaorah,drakkari,288,paladin,retribution,12,3,9
32459,Sessybrexy,bleeding-hollow,288,paladin,retribution,12,3,9
32460,Madworld,moon-guard,288,paladin,retribution,12,3,9
32461,Elpal,thrall,288,paladin,retribution,12,3,9
32462,Pallypòwer,garrosh,288,paladin,retribution,12,3,9
32463,Jontapally,stormrage,288,paladin,retribution,12,3,9
32464,Lìghtning,stormrage,288,paladin,retribution,12,3,9
32465,Corni,kiljaeden,288,paladin,retribution,12,3,9
32466,Lxwd,tichondrius,288,paladin,retribution,12,3,9
32467,Amega,bleeding-hollow,288,paladin,retribution,12,3,9
32468,Hardclimacks,frostmourne,288,paladin,retribution,12,3,9
32469,Veguê,ragnaros,288,paladin,retribution,12,3,9
32470,Spiritkeep,veknilash,288,paladin,retribution,12,3,9
32471,Mightbeard,proudmoore,288,paladin,retribution,14,3,11
32472,Divinedabs,stormrage,288,paladin,retribution,18,3,15
32473,Bullworm,ragnaros,288,paladin,retribution,18,3,15
32474,Zoriå,sargeras,288,paladin,retribution,18,3,15
32475,Taredowo,area-52,288,paladin,retribution,18,3,15
32476,Bellzebut,sargeras,288,paladin,retribution,18,3,15
32477,Mollybop,stormrage,288,paladin,retribution,18,3,15
32478,Rohland,illidan,288,paladin,retribution,18,3,15
32479,Fourchon,tichondrius,288,paladin,retribution,18,3,15
32480,Voorrkk,kelthuzad,288,paladin,retribution,18,3,15
32481,Pepepally,area-52,288,paladin,retribution,18,3,15
32482,Whangsta,tichondrius,288,paladin,retribution,24,3,21
32483,Sweetpally,moonrunner,287,paladin,retribution,6,3,3
32484,Nøxus,azralon,287,paladin,retribution,6,3,3
32485,Kimbr,gallywix,287,paladin,retribution,6,3,3
32486,Matøs,stormrage,287,paladin,retribution,6,3,3
32487,Tenshí,windrunner,287,paladin,retribution,6,3,3
32488,Holytrails,sargeras,287,paladin,retribution,6,3,3
32489,Covidxlx,hakkar,287,paladin,retribution,6,3,3
32490,Nalahra,moon-guard,287,paladin,retribution,9,4,5
32491,Paladinkofwa,tichondrius,287,paladin,retribution,12,4,8
32492,Reathe,llane,287,paladin,retribution,12,3,9
32493,Níka,turalyon,287,paladin,retribution,12,3,9
32494,Laylee,anvilmar,287,paladin,retribution,12,3,9
32495,Mynnorath,emerald-dream,287,paladin,retribution,12,3,9
32496,Divinetank,amanthul,287,paladin,retribution,12,3,9
32497,Stainless,magtheridon,287,paladin,retribution,12,3,9
32498,Cruz,silver-hand,286,paladin,retribution,12,3,9
32499,Hukah,darkspear,286,paladin,retribution,18,3,15
32500,Tyrack,ragnaros,271,paladin,retribution,11,3,8
32501,Ronatiú,tichondrius,271,paladin,retribution,11,3,8
32502,Bostonbird,sargeras,271,paladin,retribution,11,3,8
32503,Milkmi,frostmourne,271,paladin,retribution,11,3,8
32504,Ôv,norgannon,256,paladin,retribution,4,4,0
32505,Gabrielú,lightninghoof,256,paladin,retribution,10,3,7
32506,Wingsproc,stormrage,256,paladin,retribution,10,3,7
32507,Logaen,stormrage,256,paladin,retribution,16,3,13
32508,Trippierett,bloodscalp,256,paladin,retribution,16,3,13
32509,Kealthamar,wyrmrest-accord,255,paladin,retribution,4,4,0
32510,Gusset,tichondrius,255,paladin,retribution,8,4,4
32511,Hoeliekow,dalaran,255,paladin,retribution,12,5,7
32512,Serazan,moon-guard,255,paladin,retribution,11,3,8
32513,Vero,agamaggan,254,paladin,retribution,23,3,20
32514,Anoxis,tichondrius,239,paladin,retribution,5,3,2
32515,Thomir,tichondrius,239,paladin,retribution,5,3,2
32516,Egu,mugthol,239,paladin,retribution,5,3,2
32517,Wegie,emerald-dream,239,paladin,retribution,5,3,2
32518,Helberth,stormrage,239,paladin,retribution,5,3,2
32519,Badmix,tichondrius,239,paladin,retribution,5,3,2
32520,Sôsaboy,tichondrius,239,paladin,retribution,5,3,2
32521,Ðablordx,tichondrius,239,paladin,retribution,9,4,5
32522,Palitard,tichondrius,234,paladin,retribution,7,5,2
32523,Malumá,ragnaros,234,paladin,retribution,11,6,5
32524,Carneguisada,sargeras,234,paladin,retribution,10,5,5
32525,Inarit,thrall,234,paladin,retribution,8,4,4
32526,Westee,stormrage,234,paladin,retribution,8,4,4
32527,Swiftysh,ragnaros,234,paladin,retribution,9,4,5
32528,Stinkystan,korgath,234,paladin,retribution,10,4,6
32529,Filoz,ragnaros,234,paladin,retribution,17,5,12
32530,Sølaire,stormrage,234,paladin,retribution,14,4,10
32531,Matts,sargeras,234,paladin,retribution,15,4,11
32532,Needbuffs,ysondre,234,paladin,retribution,15,4,11
32533,Pearlx,ragnaros,234,paladin,retribution,16,4,12
32534,Hølydiver,rivendare,233,paladin,retribution,15,4,11
32535,Píkachü,azralon,224,paladin,retribution,10,3,7
32536,Livalil,chogall,224,paladin,retribution,16,3,13
32537,Wabukis,illidan,223,paladin,retribution,8,3,5
32538,Tydrialin,tichondrius,223,paladin,retribution,8,3,5
32539,Lhury,quelthalas,223,paladin,retribution,8,3,5
32540,Argonis,shadowsong,223,paladin,retribution,8,3,5
32541,Ráky,quelthalas,223,paladin,retribution,14,3,11
32542,Diotiz,area-52,208,paladin,retribution,11,4,7
32543,Moistsaiyan,blood-furnace,206,paladin,retribution,7,3,4
32544,Mjman,tichondrius,192,paladin,retribution,4,3,1
32545,Undrgrndman,dalaran,192,paladin,retribution,4,3,1
32546,Powerassasin,tichondrius,192,paladin,retribution,4,3,1
32547,Biggbraiin,drakkari,192,paladin,retribution,4,3,1
32548,Zhspeilian,tichondrius,192,paladin,retribution,11,4,7
32549,Anonymvs,eredar,192,paladin,retribution,9,3,6
32550,Crijr,ragnaros,192,paladin,retribution,6,2,4
32551,Angelscrÿ,stormrage,192,paladin,retribution,6,2,4
32552,Trenbolóne,area-52,192,paladin,retribution,6,2,4
32553,Spyglas,quelthalas,192,paladin,retribution,6,2,4
32554,Nicerice,dalaran,192,paladin,retribution,6,2,4
32555,Virisanctii,stormrage,192,paladin,retribution,6,2,4
32556,Angeluzlk,quelthalas,192,paladin,retribution,6,2,4
32557,Lightkillerx,thrall,192,paladin,retribution,6,2,4
32558,Starski,korgath,192,paladin,retribution,6,2,4
32559,Trê,sargeras,192,paladin,retribution,6,2,4
32560,Fallan,khaz-modan,192,paladin,retribution,6,2,4
32561,Trøn,kalecgos,192,paladin,retribution,6,2,4
32562,Stépz,frostmourne,192,paladin,retribution,6,2,4
32563,Mexipaladin,thrall,192,paladin,retribution,6,2,4
32564,Rochet,kiljaeden,192,paladin,retribution,6,2,4
32565,Insidous,galakrond,192,paladin,retribution,6,2,4
32566,Halot,skullcrusher,192,paladin,retribution,6,2,4
32567,Crnoshock,area-52,192,paladin,retribution,6,2,4
32568,Jazzmatic,dalaran,192,paladin,retribution,6,2,4
32569,Outofholy,stormrage,192,paladin,retribution,6,2,4
32570,Cowlomus,ragnaros,192,paladin,retribution,6,2,4
32571,Moohulk,ragnaros,192,paladin,retribution,6,2,4
32572,Heartsend,nerzhul,192,paladin,retribution,6,2,4
32573,Repèntance,stormrage,192,paladin,retribution,6,2,4
32574,Mosés,area-52,192,paladin,retribution,6,2,4
32575,Gîmply,proudmoore,192,paladin,retribution,6,2,4
32576,Alphönsë,quelthalas,192,paladin,retribution,6,2,4
32577,Cloudx,shattered-hand,192,paladin,retribution,6,2,4
32578,Calmpressure,tichondrius,192,paladin,retribution,6,2,4
32579,Amarexp,stormrage,192,paladin,retribution,6,2,4
32580,Metalsword,tichondrius,192,paladin,retribution,6,2,4
32581,Shanehere,thrall,192,paladin,retribution,6,2,4
32582,Xenophanes,dalaran,192,paladin,retribution,6,2,4
32583,Spanx,blackwing-lair,192,paladin,retribution,6,2,4
32584,Eull,skullcrusher,192,paladin,retribution,6,2,4
32585,Holymight,gurubashi,192,paladin,retribution,6,2,4
32586,Blackbeerd,stormrage,192,paladin,retribution,6,2,4
32587,Pállymán,proudmoore,192,paladin,retribution,6,2,4
32588,Disastroùs,frostmourne,192,paladin,retribution,6,2,4
32589,Sleepynug,proudmoore,192,paladin,retribution,6,2,4
32590,Zenix,tanaris,192,paladin,retribution,6,2,4
32591,Blastoise,drakkari,192,paladin,retribution,6,2,4
32592,Minereth,quelthalas,192,paladin,retribution,6,2,4
32593,Dwarfpaladin,dragonmaw,192,paladin,retribution,6,2,4
32594,Greatblade,barthilas,192,paladin,retribution,6,2,4
32595,Hulc,ysera,192,paladin,retribution,6,2,4
32596,Tomackin,quelthalas,192,paladin,retribution,6,2,4
32597,Dorados,gallywix,192,paladin,retribution,6,2,4
32598,Desterro,quelthalas,192,paladin,retribution,6,2,4
32599,Gasunits,stormrage,192,paladin,retribution,6,2,4
32600,Kêy,the-venture-co,192,paladin,retribution,6,2,4
32601,Roity,proudmoore,192,paladin,retribution,6,2,4
32602,Soundscape,proudmoore,192,paladin,retribution,6,2,4
32603,Tyrfall,akama,192,paladin,retribution,6,2,4
32604,Loocille,frostmourne,192,paladin,retribution,6,2,4
32605,Islain,smolderthorn,192,paladin,retribution,6,2,4
32606,Shaqueefah,illidan,192,paladin,retribution,6,2,4
32607,Whataio,tichondrius,192,paladin,retribution,6,2,4
32608,Litjoint,hyjal,192,paladin,retribution,6,2,4
32609,Mendes,stormrage,192,paladin,retribution,6,2,4
32610,Ekhia,ragnaros,192,paladin,retribution,6,2,4
32611,Rây,stormrage,192,paladin,retribution,6,2,4
32612,Issac,tichondrius,192,paladin,retribution,6,2,4
32613,Haznthley,proudmoore,192,paladin,retribution,6,2,4
32614,Palix,bonechewer,192,paladin,retribution,6,2,4
32615,Holywafu,tichondrius,192,paladin,retribution,6,2,4
32616,Exalter,malganis,192,paladin,retribution,6,2,4
32617,Eyecandý,tichondrius,192,paladin,retribution,6,2,4
32618,Legionret,thrall,192,paladin,retribution,6,2,4
32619,Crânkz,blackrock,192,paladin,retribution,6,2,4
32620,Avengzeus,tichondrius,192,paladin,retribution,6,2,4
32621,Whyurunning,area-52,192,paladin,retribution,6,2,4
32622,Ordinary,greymane,192,paladin,retribution,6,2,4
32623,Holypoizan,tichondrius,192,paladin,retribution,6,2,4
32624,Zenarus,stormrage,192,paladin,retribution,6,2,4
32625,Lilpally,frostmourne,192,paladin,retribution,6,2,4
32626,Pelegroot,azralon,192,paladin,retribution,6,2,4
32627,Ookcoo,tichondrius,192,paladin,retribution,6,2,4
32628,Prèèd,frostmourne,192,paladin,retribution,6,2,4
32629,Oxycleän,doomhammer,192,paladin,retribution,6,2,4
32630,Motrîn,sargeras,192,paladin,retribution,6,2,4
32631,Holycakes,malygos,192,paladin,retribution,6,2,4
32632,Kåshmïr,tichondrius,192,paladin,retribution,6,2,4
32633,Shebas,kilrogg,192,paladin,retribution,6,2,4
32634,Bøzø,stormrage,192,paladin,retribution,6,2,4
32635,Adavinn,azjolnerub,192,paladin,retribution,6,2,4
32636,Omegabubble,garrosh,192,paladin,retribution,6,2,4
32637,Martin,haomarush,192,paladin,retribution,6,2,4
32638,Guelmin,azralon,192,paladin,retribution,6,2,4
32639,Morcant,drakkari,192,paladin,retribution,6,2,4
32640,Ohsoclose,bleeding-hollow,192,paladin,retribution,6,2,4
32641,Duz,malganis,192,paladin,retribution,6,2,4
32642,Rúdely,tichondrius,192,paladin,retribution,6,2,4
32643,Ramises,nemesis,192,paladin,retribution,6,2,4
32644,Hurkalzul,azralon,192,paladin,retribution,6,2,4
32645,Dexstarr,frostmourne,192,paladin,retribution,6,2,4
32646,Psychlight,quelthalas,192,paladin,retribution,6,2,4
32647,Streetacus,stormrage,192,paladin,retribution,6,2,4
32648,Ghatte,azralon,192,paladin,retribution,6,2,4
32649,Helioos,stormrage,192,paladin,retribution,6,2,4
32650,Abivion,stormrage,192,paladin,retribution,6,2,4
32651,Durotar,ragnaros,192,paladin,retribution,6,2,4
32652,Çßitching,baelgun,192,paladin,retribution,6,2,4
32653,Wyot,tichondrius,192,paladin,retribution,6,2,4
32654,Killmoth,illidan,192,paladin,retribution,6,2,4
32655,Retku,tichondrius,192,paladin,retribution,6,2,4
32656,Scoobs,bleeding-hollow,192,paladin,retribution,6,2,4
32657,Tuama,frostmourne,192,paladin,retribution,6,2,4
32658,Sac,sargeras,192,paladin,retribution,6,2,4
32659,Androgeos,hyjal,192,paladin,retribution,6,2,4
32660,Twck,hyjal,192,paladin,retribution,6,2,4
32661,Barragañ,malganis,192,paladin,retribution,6,2,4
32662,Airane,sargeras,192,paladin,retribution,6,2,4
32663,Domiet,bleeding-hollow,192,paladin,retribution,6,2,4
32664,Æyden,azgalor,192,paladin,retribution,6,2,4
32665,Egf,illidan,192,paladin,retribution,6,2,4
32666,Izaacckk,hakkar,192,paladin,retribution,6,2,4
32667,Petsmacker,dalaran,192,paladin,retribution,6,2,4
32668,Varianpally,kelthuzad,192,paladin,retribution,6,2,4
32669,Stlgunna,tichondrius,192,paladin,retribution,6,2,4
32670,Maviskuku,tichondrius,192,paladin,retribution,6,2,4
32671,Achalius,queldorei,192,paladin,retribution,6,2,4
32672,Tyberas,wyrmrest-accord,192,paladin,retribution,6,2,4
32673,Lèo,ghostlands,192,paladin,retribution,6,2,4
32674,Ugotburstt,arthas,192,paladin,retribution,6,2,4
32675,Nestus,shuhalo,192,paladin,retribution,6,2,4
32676,Dakoo,burning-blade,192,paladin,retribution,6,2,4
32677,Citadehl,bleeding-hollow,192,paladin,retribution,6,2,4
32678,Lightgasm,alterac-mountains,192,paladin,retribution,6,2,4
32679,Alasper,malganis,192,paladin,retribution,6,2,4
32680,Dimensions,spirestone,192,paladin,retribution,6,2,4
32681,Taddedpally,tichondrius,192,paladin,retribution,6,2,4
32682,Invïctus,dalaran,192,paladin,retribution,6,2,4
32683,Krabbiepatty,wyrmrest-accord,192,paladin,retribution,6,2,4
32684,Jaok,tichondrius,192,paladin,retribution,6,2,4
32685,Gordyn,khazgoroth,192,paladin,retribution,6,2,4
32686,Holywrecked,khazgoroth,192,paladin,retribution,6,2,4
32687,Liht,khazgoroth,192,paladin,retribution,6,2,4
32688,Whittia,wyrmrest-accord,192,paladin,retribution,6,2,4
32689,Awarena,area-52,192,paladin,retribution,6,2,4
32690,Fairbairn,tichondrius,192,paladin,retribution,6,2,4
32691,Ddeuk,tichondrius,192,paladin,retribution,6,2,4
32692,Johnygoodboi,khazgoroth,192,paladin,retribution,6,2,4
32693,Pallylyfe,wyrmrest-accord,192,paladin,retribution,6,2,4
32694,Vindified,tichondrius,192,paladin,retribution,6,2,4
32695,Reepr,tichondrius,192,paladin,retribution,6,2,4
32696,Hafra,zuljin,192,paladin,retribution,6,2,4
32697,Piousgecko,illidan,192,paladin,retribution,6,2,4
32698,Felourian,malganis,192,paladin,retribution,6,2,4
32699,Xoppo,tichondrius,192,paladin,retribution,6,2,4
32700,Yamn,tichondrius,192,paladin,retribution,6,2,4
32701,Bërzerk,zuluhed,192,paladin,retribution,6,2,4
32702,Stlthykilla,cenarion-circle,192,paladin,retribution,6,2,4
32703,Byonsay,zuljin,192,paladin,retribution,6,2,4
32704,Ret,onyxia,192,paladin,retribution,6,2,4
32705,Moshio,nagrand,192,paladin,retribution,6,2,4
32706,Galdraxis,dalaran,192,paladin,retribution,6,2,4
32707,Blessinofsac,nagrand,192,paladin,retribution,6,2,4
32708,Ogretchair,zuljin,192,paladin,retribution,6,2,4
32709,Zoeyxo,tichondrius,192,paladin,retribution,6,2,4
32710,Bharan,dalaran,192,paladin,retribution,6,2,4
32711,Hogù,tichondrius,192,paladin,retribution,6,2,4
32712,Smolbeef,tichondrius,192,paladin,retribution,6,2,4
32713,Kolten,kelthuzad,192,paladin,retribution,6,2,4
32714,Granada,kirin-tor,192,paladin,retribution,6,2,4
32715,Cyliex,illidan,192,paladin,retribution,6,2,4
32716,Runterran,illidan,192,paladin,retribution,6,2,4
32717,Ríf,sargeras,192,paladin,retribution,6,2,4
32718,Extramustard,frostmourne,192,paladin,retribution,6,2,4
32719,Tysads,darkspear,192,paladin,retribution,6,2,4
32720,Buri,tichondrius,192,paladin,retribution,6,2,4
32721,Thorrh,malganis,192,paladin,retribution,6,2,4
32722,Machoo,laughing-skull,192,paladin,retribution,6,2,4
32723,Rite,azralon,192,paladin,retribution,6,2,4
32724,Líghts,caelestrasz,192,paladin,retribution,6,2,4
32725,Tormentoxd,azralon,192,paladin,retribution,6,2,4
32726,Felkor,caelestrasz,192,paladin,retribution,6,2,4
32727,Homiepaldino,nordrassil,192,paladin,retribution,6,2,4
32728,Schooiez,tichondrius,192,paladin,retribution,6,2,4
32729,Tôhru,ragnaros,192,paladin,retribution,6,2,4
32730,Brucitenjr,illidan,192,paladin,retribution,6,2,4
32731,Carmelito,hakkar,192,paladin,retribution,6,2,4
32732,Stöny,illidan,192,paladin,retribution,6,2,4
32733,Noscajj,tichondrius,192,paladin,retribution,6,2,4
32734,Verzuhazadon,tichondrius,192,paladin,retribution,6,2,4
32735,Diänë,ragnaros,192,paladin,retribution,6,2,4
32736,Forprophet,blackrock,192,paladin,retribution,6,2,4
32737,Ladner,tichondrius,192,paladin,retribution,6,2,4
32738,Ryuuku,gilneas,192,paladin,retribution,6,2,4
32739,Retikulous,tichondrius,192,paladin,retribution,6,2,4
32740,Sigurd,khadgar,192,paladin,retribution,6,2,4
32741,Cudiskush,tichondrius,192,paladin,retribution,6,2,4
32742,Malakk,zuljin,192,paladin,retribution,6,2,4
32743,Rheddbull,bonechewer,192,paladin,retribution,6,2,4
32744,Retro,magtheridon,192,paladin,retribution,6,2,4
32745,Kigz,illidan,192,paladin,retribution,6,2,4
32746,Madnhairy,zuljin,192,paladin,retribution,6,2,4
32747,Twatiegodx,malganis,192,paladin,retribution,6,2,4
32748,Juiicebox,darrowmere,192,paladin,retribution,6,2,4
32749,Detk,darrowmere,192,paladin,retribution,6,2,4
32750,Quessillo,ragnaros,192,paladin,retribution,6,2,4
32751,Paladam,burning-blade,192,paladin,retribution,6,2,4
32752,Armasexodus,barthilas,192,paladin,retribution,6,2,4
32753,Thejokermp,kelthuzad,192,paladin,retribution,6,2,4
32754,Voro,barthilas,192,paladin,retribution,6,2,4
32755,Azúlá,garona,192,paladin,retribution,6,2,4
32756,Juggerat,barthilas,192,paladin,retribution,6,2,4
32757,Rekos,zuljin,192,paladin,retribution,6,2,4
32758,Honeydews,zuljin,192,paladin,retribution,6,2,4
32759,Majinpal,illidan,192,paladin,retribution,6,2,4
32760,Daddykronz,magtheridon,192,paladin,retribution,6,2,4
32761,Sweettartts,zuljin,192,paladin,retribution,6,2,4
32762,Realbad,lightbringer,192,paladin,retribution,6,2,4
32763,Crosjudge,zuljin,192,paladin,retribution,6,2,4
32764,Yoúngdolph,elune,192,paladin,retribution,6,2,4
32765,Ðuel,area-52,192,paladin,retribution,6,2,4
32766,Theodden,tichondrius,192,paladin,retribution,6,2,4
32767,Mazexd,illidan,192,paladin,retribution,6,2,4
32768,Oroth,ragnaros,192,paladin,retribution,6,2,4
32769,Révolution,barthilas,192,paladin,retribution,6,2,4
32770,Juanvaldez,muradin,192,paladin,retribution,6,2,4
32771,Pushabuton,illidan,192,paladin,retribution,6,2,4
32772,Palåth,barthilas,192,paladin,retribution,6,2,4
32773,Freslys,zuljin,192,paladin,retribution,6,2,4
32774,Yeshayah,dalaran,192,paladin,retribution,6,2,4
32775,Dritan,lightbringer,192,paladin,retribution,6,2,4
32776,Retbullvodka,tichondrius,192,paladin,retribution,6,2,4
32777,Vengx,sargeras,192,paladin,retribution,6,2,4
32778,Ohthatguy,sargeras,192,paladin,retribution,6,2,4
32779,Míguelito,sargeras,192,paladin,retribution,6,2,4
32780,Bigdret,moon-guard,192,paladin,retribution,6,2,4
32781,Holysmokz,emerald-dream,192,paladin,retribution,6,2,4
32782,Luke,moon-guard,192,paladin,retribution,6,2,4
32783,Titamn,area-52,192,paladin,retribution,6,2,4
32784,Brizdiz,area-52,192,paladin,retribution,6,2,4
32785,Toto,sargeras,192,paladin,retribution,6,2,4
32786,Brand,emerald-dream,192,paladin,retribution,6,2,4
32787,Crimsonjudge,sargeras,192,paladin,retribution,6,2,4
32788,Pallycow,kargath,192,paladin,retribution,6,2,4
32789,Alexandros,the-underbog,192,paladin,retribution,6,2,4
32790,Drintense,area-52,192,paladin,retribution,6,2,4
32791,Logust,area-52,192,paladin,retribution,6,2,4
32792,Caeson,moon-guard,192,paladin,retribution,6,2,4
32793,Réalg,area-52,192,paladin,retribution,6,2,4
32794,Sinsy,moon-guard,192,paladin,retribution,6,2,4
32795,Astrøworld,sargeras,192,paladin,retribution,6,2,4
32796,Axelx,sargeras,192,paladin,retribution,6,2,4
32797,Bradybub,sargeras,192,paladin,retribution,6,2,4
32798,Aleio,moon-guard,192,paladin,retribution,6,2,4
32799,Atan,emerald-dream,192,paladin,retribution,6,2,4
32800,Neydisa,sargeras,192,paladin,retribution,6,2,4
32801,Roseheart,emerald-dream,192,paladin,retribution,6,2,4
32802,Nëø,moon-guard,192,paladin,retribution,6,2,4
32803,Dayim,moon-guard,192,paladin,retribution,6,2,4
32804,Gangsta,silvermoon,192,paladin,retribution,6,2,4
32805,Dynastyhero,area-52,192,paladin,retribution,6,2,4
32806,Thaidron,area-52,192,paladin,retribution,6,2,4
32807,Zeliq,silvermoon,192,paladin,retribution,6,2,4
32808,Honeyduw,moon-guard,192,paladin,retribution,6,2,4
32809,Nyc,sargeras,192,paladin,retribution,6,2,4
32810,Holypumper,moon-guard,192,paladin,retribution,6,2,4
32811,Gredel,sargeras,192,paladin,retribution,6,2,4
32812,Strîkes,emerald-dream,192,paladin,retribution,6,2,4
32813,Guacamello,emerald-dream,192,paladin,retribution,6,2,4
32814,Lumpypotatos,aegwynn,192,paladin,retribution,10,3,7
32815,Pòßà,malganis,192,paladin,retribution,7,2,5
32816,Jessecash,tichondrius,192,paladin,retribution,12,3,9
32817,Murgly,tichondrius,192,paladin,retribution,8,2,6
32818,Raylewis,ghostlands,192,paladin,retribution,9,2,7
32819,Orellios,moon-guard,192,paladin,retribution,9,2,7
32820,Misease,illidan,192,paladin,retribution,9,2,7
32821,Thormonger,dalaran,192,paladin,retribution,14,3,11
32822,Alberich,tichondrius,192,paladin,retribution,11,2,9
32823,Flexedonyou,sentinels,192,paladin,retribution,12,2,10
32824,Terppy,stormrage,192,paladin,retribution,12,2,10
32825,Cabacarl,quelthalas,192,paladin,retribution,12,2,10
32826,Slithix,stormreaver,192,paladin,retribution,12,2,10
32827,Jarvin,kiljaeden,192,paladin,retribution,12,2,10
32828,Rayli,dalaran,192,paladin,retribution,12,2,10
32829,Simbelmyne,thrall,192,paladin,retribution,12,2,10
32830,Fazoéli,stormrage,192,paladin,retribution,12,2,10
32831,Kaiyleigh,sargeras,192,paladin,retribution,12,2,10
32832,Nygardian,sargeras,192,paladin,retribution,12,2,10
32833,Elarilein,emerald-dream,192,paladin,retribution,12,2,10
32834,Léa,illidan,192,paladin,retribution,12,2,10
32835,Dánteé,ragnaros,192,paladin,retribution,12,2,10
32836,Octí,quelthalas,192,paladin,retribution,12,2,10
32837,Kheltas,area-52,192,paladin,retribution,12,2,10
32838,Goldfaith,sargeras,192,paladin,retribution,12,2,10
32839,Calferx,area-52,192,paladin,retribution,12,2,10
32840,Criixx,malganis,192,paladin,retribution,12,2,10
32841,Lamer,proudmoore,192,paladin,retribution,12,2,10
32842,Rîf,malganis,192,paladin,retribution,12,2,10
32843,Seratox,illidan,192,paladin,retribution,12,2,10
32844,Clrty,area-52,192,paladin,retribution,12,2,10
32845,Ghratadin,bleeding-hollow,192,paladin,retribution,12,2,10
32846,Holyelfs,boulderfist,192,paladin,retribution,12,2,10
32847,Arminhamer,sargeras,192,paladin,retribution,12,2,10
32848,Sleepybiden,darkspear,192,paladin,retribution,12,2,10
32849,Hurlnix,stormscale,192,paladin,retribution,12,2,10
32850,Kedubb,stormrage,192,paladin,retribution,12,2,10
32851,Phawkes,eredar,192,paladin,retribution,12,2,10
32852,Sïncere,frostmourne,192,paladin,retribution,12,2,10
32853,Vantz,tichondrius,192,paladin,retribution,12,2,10
32854,Goomie,icecrown,192,paladin,retribution,12,2,10
32855,Ricopal,frostmourne,192,paladin,retribution,12,2,10
32856,Cronodxl,quelthalas,192,paladin,retribution,12,2,10
32857,Holyshifts,exodar,192,paladin,retribution,12,2,10
32858,Krístem,stormrage,192,paladin,retribution,12,2,10
32859,Grimsfate,emerald-dream,192,paladin,retribution,12,2,10
32860,Vamplyy,kelthuzad,192,paladin,retribution,12,2,10
32861,Yawnday,farstriders,192,paladin,retribution,12,2,10
32862,Killerspally,area-52,192,paladin,retribution,12,2,10
32863,Jachug,tichondrius,192,paladin,retribution,12,2,10
32864,Gilfan,proudmoore,192,paladin,retribution,12,2,10
32865,Ðáddý,zuljin,192,paladin,retribution,12,2,10
32866,Alyosya,barthilas,192,paladin,retribution,12,2,10
32867,Renorhal,moon-guard,192,paladin,retribution,12,2,10
32868,Bubzfordubz,sargeras,192,paladin,retribution,12,2,10
32869,Spîke,sargeras,192,paladin,retribution,12,2,10
32870,Anahl,icecrown,192,paladin,retribution,12,2,10
32871,Seltzer,tichondrius,192,paladin,retribution,12,2,10
32872,Zatoci,shadowsong,192,paladin,retribution,17,2,15
32873,Runandhide,aerie-peak,192,paladin,retribution,18,2,16
32874,Dorisseline,emerald-dream,192,paladin,retribution,18,2,16
32875,Oldmanmark,jubeithos,191,paladin,retribution,6,2,4
32876,Túss,khazgoroth,191,paladin,retribution,6,2,4
32877,Dkpally,doomhammer,191,paladin,retribution,6,2,4
32878,Lahila,area-52,191,paladin,retribution,6,2,4
32879,Larlanos,bloodhoof,190,paladin,retribution,12,2,10
32880,Jaidun,stormrage,190,paladin,retribution,12,2,10
32881,Thugmuffin,thrall,176,paladin,retribution,7,3,4
32882,Wokeinator,malganis,175,paladin,retribution,11,3,8
32883,Baalduru,borean-tundra,175,paladin,retribution,11,2,9
32884,Divinetoco,stormrage,175,paladin,retribution,11,2,9
32885,Wellowar,moon-guard,170,paladin,retribution,11,4,7
32886,Jnxzster,sargeras,169,paladin,retribution,11,4,7
32887,Laysonus,moon-guard,169,paladin,retribution,11,4,7
32888,Bubbletop,tichondrius,169,paladin,retribution,11,4,7
32889,Oates,sargeras,159,paladin,retribution,5,2,3
32890,Bubbledown,bleeding-hollow,159,paladin,retribution,5,2,3
32891,Beelzebøss,frostmourne,159,paladin,retribution,5,2,3
32892,Sorgeno,ursin,159,paladin,retribution,5,2,3
32893,Maldayn,quelthalas,159,paladin,retribution,5,2,3
32894,Hobbsone,trollbane,159,paladin,retribution,5,2,3
32895,Pallydeen,illidan,159,paladin,retribution,5,2,3
32896,Kaorii,mannoroth,159,paladin,retribution,5,2,3
32897,Ubbhe,quelthalas,159,paladin,retribution,5,2,3
32898,Whoopsie,dragonmaw,159,paladin,retribution,5,2,3
32899,Seasondbeef,shandris,159,paladin,retribution,5,2,3
32900,Perallta,tichondrius,144,paladin,retribution,3,3,0
32901,Whiplashlol,frostwolf,144,paladin,retribution,3,3,0
32902,Holeesheett,tichondrius,144,paladin,retribution,9,2,7
32903,Chancéllor,stormrage,138,paladin,retribution,6,3,3
32904,Leevii,azralon,138,paladin,retribution,11,4,7
32905,Åddict,kelthuzad,138,paladin,retribution,10,3,7
32906,Iæl,stormrage,138,paladin,retribution,10,3,7
32907,Dathromir,stormrage,138,paladin,retribution,15,3,12
32908,Bubbleosèven,tichondrius,138,paladin,retribution,16,3,13
32909,Sweetbunz,altar-of-storms,128,paladin,retribution,4,2,2
32910,Stârfôx,area-52,128,paladin,retribution,4,2,2
32911,Anbor,azralon,128,paladin,retribution,4,2,2
32912,Mikwa,ragnaros,128,paladin,retribution,4,2,2
32913,Telaenchufo,ragnaros,128,paladin,retribution,4,2,2
32914,Seebastian,kelthuzad,128,paladin,retribution,4,2,2
32915,Holyjoe,area-52,128,paladin,retribution,4,2,2
32916,Comptoncody,area-52,128,paladin,retribution,9,3,6
32917,Khileeha,sargeras,128,paladin,retribution,10,2,8
32918,Sofiora,thunderlord,128,paladin,retribution,10,2,8
32919,Vishpal,malganis,112,paladin,retribution,7,2,5
32920,Dazak,ragnaros,96,paladin,retribution,3,2,1
32921,Shalith,thrall,96,paladin,retribution,3,2,1
32922,Gaismagorm,ragnaros,96,paladin,retribution,3,2,1
32923,Utho,wyrmrest-accord,96,paladin,retribution,3,2,1
32924,Swordstrikes,tichondrius,96,paladin,retribution,3,2,1
32925,Simple,ghostlands,96,paladin,retribution,16,3,13
32926,Bigshaftt,gorgonnash,96,paladin,retribution,6,1,5
32927,Brutalize,moon-guard,96,paladin,retribution,6,1,5
32928,Tehgodofdmg,tichondrius,96,paladin,retribution,6,1,5
32929,Flashbubble,sargeras,96,paladin,retribution,6,1,5
32930,Ünkøwn,stormrage,96,paladin,retribution,6,1,5
32931,Holyclapzy,stormrage,96,paladin,retribution,6,1,5
32932,Smïthh,area-52,96,paladin,retribution,6,1,5
32933,Balloony,stormrage,96,paladin,retribution,6,1,5
32934,Ret,burning-legion,96,paladin,retribution,6,1,5
32935,Djset,blackhand,96,paladin,retribution,6,1,5
32936,Vicentez,area-52,96,paladin,retribution,6,1,5
32937,Fydepala,stormrage,96,paladin,retribution,6,1,5
32938,Palajem,stormrage,96,paladin,retribution,6,1,5
32939,Dafoq,stormrage,96,paladin,retribution,6,1,5
32940,Respiratoryy,kelthuzad,96,paladin,retribution,6,1,5
32941,Orthín,stormrage,96,paladin,retribution,6,1,5
32942,Brank,agamaggan,96,paladin,retribution,6,1,5
32943,Ashlane,tichondrius,96,paladin,retribution,6,1,5
32944,Duecesz,area-52,96,paladin,retribution,6,1,5
32945,Yøu,tichondrius,96,paladin,retribution,6,1,5
32946,Thòrisòn,stormrage,96,paladin,retribution,6,1,5
32947,Cupidxbye,tichondrius,96,paladin,retribution,6,1,5
32948,Ahrieze,moon-guard,96,paladin,retribution,6,1,5
32949,Sanddor,moon-guard,96,paladin,retribution,6,1,5
32950,Mîrrors,barthilas,96,paladin,retribution,6,1,5
32951,Acpally,tichondrius,96,paladin,retribution,6,1,5
32952,Coltoniac,kaelthas,96,paladin,retribution,6,1,5
32953,Valadinn,tichondrius,96,paladin,retribution,6,1,5
32954,Raams,moon-guard,96,paladin,retribution,6,1,5
32955,Checkmater,malganis,96,paladin,retribution,6,1,5
32956,Franchy,stormrage,96,paladin,retribution,6,1,5
32957,Chuggawhugga,area-52,96,paladin,retribution,6,1,5
32958,Dûälïpä,barthilas,96,paladin,retribution,6,1,5
32959,Sleyn,stormrage,96,paladin,retribution,6,1,5
32960,Zulzander,kelthuzad,96,paladin,retribution,6,1,5
32961,Scuffedhoj,tichondrius,96,paladin,retribution,6,1,5
32962,Jüstice,tichondrius,96,paladin,retribution,6,1,5
32963,Chootoy,tichondrius,96,paladin,retribution,6,1,5
32964,Bromango,emerald-dream,96,paladin,retribution,6,1,5
32965,Yesdaddyxo,emerald-dream,96,paladin,retribution,6,1,5
32966,Englishdude,tichondrius,96,paladin,retribution,6,1,5
32967,Grimsical,kelthuzad,96,paladin,retribution,6,1,5
32968,Revendreth,caelestrasz,96,paladin,retribution,6,1,5
32969,Gdesign,tichondrius,96,paladin,retribution,6,1,5
32970,Dìlf,zuljin,96,paladin,retribution,6,1,5
32971,Turahk,amanthul,96,paladin,retribution,6,1,5
32972,Kuribohs,tichondrius,96,paladin,retribution,6,1,5
32973,Lythos,dathremar,96,paladin,retribution,6,1,5
32974,Bigdampally,tichondrius,96,paladin,retribution,6,1,5
32975,Bosmoklikdat,moon-guard,96,paladin,retribution,6,1,5
32976,Poeboyz,stormrage,96,paladin,retribution,6,1,5
32977,Prahv,shuhalo,96,paladin,retribution,6,1,5
32978,Nytto,lightnings-blade,96,paladin,retribution,6,1,5
32979,Pipesmoke,dunemaul,96,paladin,retribution,6,1,5
32980,Tyrannos,tichondrius,96,paladin,retribution,6,1,5
32981,Pùteduvilage,zuljin,96,paladin,retribution,6,1,5
32982,Erindor,emerald-dream,96,paladin,retribution,6,1,5
32983,Thumos,sargeras,96,paladin,retribution,6,1,5
32984,Warrenke,area-52,96,paladin,retribution,6,1,5
32985,Tehbeasty,hyjal,96,paladin,retribution,6,1,5
32986,Rodrigo,frostmourne,96,paladin,retribution,6,1,5
32987,Donoph,blades-edge,96,paladin,retribution,6,1,5
32988,Mentalíssues,moon-guard,96,paladin,retribution,6,1,5
32989,Bruwdblood,bleeding-hollow,96,paladin,retribution,6,1,5
32990,Scyfher,stormrage,96,paladin,retribution,6,1,5
32991,Warhero,sargeras,96,paladin,retribution,6,1,5
32992,Murzo,hyjal,96,paladin,retribution,6,1,5
32993,Slayalot,icecrown,96,paladin,retribution,6,1,5
32994,Retsarro,frostmourne,96,paladin,retribution,6,1,5
32995,Odos,zuljin,96,paladin,retribution,6,1,5
32996,Judgémental,bleeding-hollow,96,paladin,retribution,6,1,5
32997,Sneakycastro,bleeding-hollow,96,paladin,retribution,6,1,5
32998,Maldobarr,stormrage,96,paladin,retribution,6,1,5
32999,Palium,stormrage,96,paladin,retribution,6,1,5
33000,Chakin,burning-legion,96,paladin,retribution,6,1,5
33001,Zwilliam,frostmourne,96,paladin,retribution,6,1,5
33002,Retrib,tichondrius,96,paladin,retribution,6,1,5
33003,Salennai,daggerspine,96,paladin,retribution,6,1,5
33004,Vatherollin,proudmoore,96,paladin,retribution,6,1,5
33005,Febimus,magtheridon,96,paladin,retribution,6,1,5
33006,Lòuisvuttion,tichondrius,96,paladin,retribution,6,1,5
33007,Astolan,runetotem,96,paladin,retribution,6,1,5
33008,Daelann,moon-guard,96,paladin,retribution,6,1,5
33009,Gressilin,arthas,96,paladin,retribution,6,1,5
33010,Këys,earthen-ring,96,paladin,retribution,6,1,5
33011,Gazef,proudmoore,96,paladin,retribution,6,1,5
33012,Retx,arthas,96,paladin,retribution,6,1,5
33013,Cyona,gallywix,96,paladin,retribution,6,1,5
33014,Luiiguii,drakkari,96,paladin,retribution,6,1,5
33015,Ryudoshël,nemesis,96,paladin,retribution,6,1,5
33016,Kytheon,zuluhed,96,paladin,retribution,6,1,5
33017,Carloss,drakkari,96,paladin,retribution,6,1,5
33018,Madtrollaids,kiljaeden,96,paladin,retribution,6,1,5
33019,Parts,aerie-peak,96,paladin,retribution,6,1,5
33020,Rodt,dalaran,96,paladin,retribution,6,1,5
33021,Tooshka,azshara,96,paladin,retribution,6,1,5
33022,Meanervini,kiljaeden,96,paladin,retribution,6,1,5
33023,Deviill,winterhoof,96,paladin,retribution,6,1,5
33024,Scrubdin,illidan,96,paladin,retribution,6,1,5
33025,Beebopper,illidan,96,paladin,retribution,6,1,5
33026,Ariolo,baelgun,96,paladin,retribution,6,1,5
33027,Aldwyn,deathwing,96,paladin,retribution,6,1,5
33028,Isskandar,moon-guard,96,paladin,retribution,6,1,5
33029,Krylaa,madoran,96,paladin,retribution,6,1,5
33030,Krelya,ragnaros,96,paladin,retribution,6,1,5
33031,Lightmessiah,perenolde,96,paladin,retribution,6,1,5
33032,Aragonns,illidan,96,paladin,retribution,6,1,5
33033,Shamashjoel,black-dragonflight,96,paladin,retribution,6,1,5
33034,Chainjustice,area-52,96,paladin,retribution,6,1,5
33035,Slantee,illidan,96,paladin,retribution,6,1,5
33036,Tradalia,illidan,96,paladin,retribution,6,1,5
33037,Justtrollin,black-dragonflight,96,paladin,retribution,6,1,5
33038,Repsforjêsus,hydraxis,96,paladin,retribution,6,1,5
33039,Rg,nerzhul,96,paladin,retribution,6,1,5
33040,Killerofmind,azralon,96,paladin,retribution,6,1,5
33041,Marcovk,quelthalas,96,paladin,retribution,6,1,5
33042,Conámi,ragnaros,96,paladin,retribution,6,1,5
33043,Adjudicator,shuhalo,96,paladin,retribution,6,1,5
33044,Goksuu,ragnaros,96,paladin,retribution,6,1,5
33045,Tharok,spirestone,96,paladin,retribution,6,1,5
33046,Latchpaladin,sargeras,96,paladin,retribution,6,1,5
33047,Jeeb,blackrock,96,paladin,retribution,6,1,5
33048,Riçky,tichondrius,96,paladin,retribution,6,1,5
33049,Talahar,boulderfist,96,paladin,retribution,6,1,5
33050,Ssjgodvy,illidan,96,paladin,retribution,6,1,5
33051,Röniin,ragnaros,96,paladin,retribution,6,1,5
33052,Daivdsonbr,azralon,96,paladin,retribution,6,1,5
33053,Chapichapi,illidan,96,paladin,retribution,6,1,5
33054,Wakethelight,illidan,96,paladin,retribution,6,1,5
33055,Maeyz,sargeras,96,paladin,retribution,6,1,5
33056,Giita,quelthalas,96,paladin,retribution,6,1,5
33057,Freyrr,azralon,96,paladin,retribution,6,1,5
33058,Topsid,sargeras,96,paladin,retribution,6,1,5
33059,Kroman,quelthalas,96,paladin,retribution,6,1,5
33060,Liongolden,azralon,96,paladin,retribution,6,1,5
33061,Chøcølatte,azralon,96,paladin,retribution,6,1,5
33062,Brynleigh,malganis,96,paladin,retribution,6,1,5
33063,Zpaladino,azralon,96,paladin,retribution,6,1,5
33064,Skadooshh,illidan,96,paladin,retribution,6,1,5
33065,Energizzed,azralon,96,paladin,retribution,6,1,5
33066,Holyxsmokes,illidan,96,paladin,retribution,6,1,5
33067,Scah,illidan,96,paladin,retribution,6,1,5
33068,Wrongnumber,blackrock,96,paladin,retribution,6,1,5
33069,Angusbeef,hyjal,96,paladin,retribution,6,1,5
33070,Nvrbubble,area-52,96,paladin,retribution,6,1,5
33071,Scarllye,illidan,96,paladin,retribution,6,1,5
33072,Skeeta,area-52,96,paladin,retribution,6,1,5
33073,Boundric,emerald-dream,96,paladin,retribution,6,1,5
33074,Zko,frostmourne,96,paladin,retribution,6,1,5
33075,Shortj,malganis,96,paladin,retribution,6,1,5
33076,Urudith,azralon,96,paladin,retribution,6,1,5
33077,Mastadin,illidan,96,paladin,retribution,6,1,5
33078,Bubbllicious,thrall,96,paladin,retribution,6,1,5
33079,Teupaiécornu,azralon,96,paladin,retribution,6,1,5
33080,Ding,wyrmrest-accord,96,paladin,retribution,6,1,5
33081,Partenna,quelthalas,96,paladin,retribution,6,1,5
33082,Alk,windrunner,96,paladin,retribution,6,1,5
33083,Cots,azralon,96,paladin,retribution,6,1,5
33084,Adobro,tichondrius,96,paladin,retribution,6,1,5
33085,Kamael,darrowmere,96,paladin,retribution,6,1,5
33086,Krulu,thrall,96,paladin,retribution,6,1,5
33087,Hungheracles,thrall,96,paladin,retribution,6,1,5
33088,Fourwives,sargeras,96,paladin,retribution,6,1,5
33089,Coffeebean,quelthalas,96,paladin,retribution,6,1,5
33090,Chawbanger,proudmoore,96,paladin,retribution,6,1,5
33091,Akirahikarri,frostwolf,96,paladin,retribution,6,1,5
33092,Samsaratry,proudmoore,96,paladin,retribution,6,1,5
33093,Palagwen,emerald-dream,96,paladin,retribution,6,1,5
33094,Kírí,quelthalas,96,paladin,retribution,6,1,5
33095,Lakinipally,lightbringer,96,paladin,retribution,6,1,5
33096,Àurorâ,tichondrius,96,paladin,retribution,6,1,5
33097,Kamakazê,sargeras,96,paladin,retribution,6,1,5
33098,Måtrix,sargeras,96,paladin,retribution,6,1,5
33099,Asheryte,sargeras,96,paladin,retribution,6,1,5
33100,Bravsirrobin,firetree,96,paladin,retribution,6,1,5
33101,Thorgard,antonidas,96,paladin,retribution,6,1,5
33102,Trinkysteve,frostmane,96,paladin,retribution,7,1,6
33103,Lelythia,bleeding-hollow,96,paladin,retribution,7,1,6
33104,Cherix,thrall,96,paladin,retribution,9,1,8
33105,Whosyourdady,azjolnerub,96,paladin,retribution,12,1,11
33106,Roosterface,azjolnerub,96,paladin,retribution,12,1,11
33107,Kënsi,quelthalas,96,paladin,retribution,12,1,11
33108,Reinhardburm,quelthalas,96,paladin,retribution,12,1,11
33109,Zalacar,azralon,96,paladin,retribution,12,1,11
33110,Oshia,destromath,96,paladin,retribution,12,1,11
33111,Retski,thrall,96,paladin,retribution,12,1,11
33112,Miniminx,malganis,96,paladin,retribution,12,1,11
33113,Siglud,tichondrius,96,paladin,retribution,12,1,11
33114,Hojpocketx,tichondrius,96,paladin,retribution,12,1,11
33115,Catholica,tichondrius,96,paladin,retribution,12,1,11
33116,Séykän,ragnaros,96,paladin,retribution,12,1,11
33117,Æpaldin,tichondrius,96,paladin,retribution,12,1,11
33118,Hondacivicsi,mannoroth,96,paladin,retribution,12,1,11
33119,Bregalad,bleeding-hollow,96,paladin,retribution,12,1,11
33120,Imbackk,quelthalas,96,paladin,retribution,12,1,11
33121,Yobnai,zuljin,96,paladin,retribution,12,1,11
33122,Yoropal,tichondrius,96,paladin,retribution,12,1,11
33123,Axiskai,gorgonnash,96,paladin,retribution,12,1,11
33124,Lorenzojr,sargeras,96,paladin,retribution,12,1,11
33125,Rimorse,illidan,96,paladin,retribution,12,1,11
33126,Geykum,tichondrius,96,paladin,retribution,17,1,16
33127,Orendis,illidan,95,paladin,retribution,12,1,11
33128,Hottest,wyrmrest-accord,84,paladin,retribution,13,5,8
33129,Wainkywink,malganis,84,paladin,retribution,19,4,15
33130,Laydarus,frostmourne,79,paladin,retribution,5,1,4
33131,Ryxxi,sargeras,79,paladin,retribution,5,1,4
33132,Goldieg,tichondrius,79,paladin,retribution,5,1,4
33133,Bowdown,wildhammer,79,paladin,retribution,5,1,4
33134,Sprjustice,frostmourne,79,paladin,retribution,6,1,5
33135,Hivers,stormrage,79,paladin,retribution,11,1,10
33136,Dronedròp,illidan,63,paladin,retribution,2,2,0
33137,Belenor,quelthalas,63,paladin,retribution,2,2,0
33138,Corvious,tichondrius,63,paladin,retribution,2,2,0
33139,Crayonpal,tichondrius,63,paladin,retribution,2,2,0
33140,Piston,kiljaeden,63,paladin,retribution,2,2,0
33141,Kroneckerr,ragnaros,48,paladin,retribution,8,3,5
33142,Tryvor,stormrage,48,paladin,retribution,3,1,2
33143,Cïelo,dragonmaw,42,paladin,retribution,6,2,4
33144,Dabakle,stormrage,42,paladin,retribution,8,2,6
33145,Thisissus,tichondrius,42,paladin,retribution,8,2,6
33146,Voncruz,proudmoore,42,paladin,retribution,12,2,10
33147,Tydirion,burning-legion,31,paladin,retribution,2,1,1
33148,Patrious,moon-guard,31,paladin,retribution,2,1,1
33149,Øgre,illidan,31,paladin,retribution,2,1,1
33150,Tanneth,zuljin,31,paladin,retribution,2,1,1
33151,Gorila,stormrage,31,paladin,retribution,2,1,1
33152,Salx,tichondrius,31,paladin,retribution,8,1,7
33153,Retributión,darkspear,16,paladin,retribution,1,1,0
33154,Brinxy,ragnaros,16,paladin,retribution,1,1,0
33155,Warumbruder,stormrage,16,paladin,retribution,1,1,0
33156,Bluether,sargeras,16,paladin,retribution,1,1,0
33157,Cóisy,frostmourne,16,paladin,retribution,1,1,0
33158,ßleider,quelthalas,1906,paladin,protection,55,39,16
33159,Ëlmaster,nemesis,1831,paladin,protection,126,80,46
33160,Degenratebri,moon-guard,1753,paladin,protection,63,44,19
33161,Aluvia,malygos,1741,paladin,protection,70,50,20
33162,Zhspeilian,tichondrius,1730,paladin,protection,84,47,37
33163,Höpönpöppö,frostmourne,1729,paladin,protection,48,26,22
33164,Kierolechita,ragnaros,1721,paladin,protection,262,135,127
33165,Sigmapepe,quelthalas,1718,paladin,protection,120,83,37
33166,Crâfty,bleeding-hollow,1717,paladin,protection,113,65,48
33167,Motates,malganis,1706,paladin,protection,93,48,45
33168,Wilder,turalyon,1676,paladin,protection,47,27,20
33169,Dankerton,tichondrius,1670,paladin,protection,38,20,18
33170,Jimmipepe,quelthalas,1668,paladin,protection,164,107,57
33171,Sutadansa,doomhammer,1666,paladin,protection,158,79,79
33172,Zealna,tichondrius,1663,paladin,protection,35,24,11
33173,Eclipsor,bleeding-hollow,1657,paladin,protection,48,30,18
33174,Vondonna,moon-guard,1655,paladin,protection,113,65,48
33175,Sôlux,quelthalas,1638,paladin,protection,56,31,25
33176,Lxwd,tichondrius,1636,paladin,protection,131,66,65
33177,Uglyboyryan,sargeras,1632,paladin,protection,102,57,45
33178,Zephyrvalor,sargeras,1628,paladin,protection,158,77,81
33179,Poppadock,veknilash,1613,paladin,protection,74,44,30
33180,Bighardshock,aggramar,1589,paladin,protection,42,23,19
33181,Blackmiya,tichondrius,1570,paladin,protection,31,20,11
33182,Øziris,goldrinn,1567,paladin,protection,74,33,41
33183,Cusino,tichondrius,1560,paladin,protection,56,34,22
33184,Rehtua,bleeding-hollow,1557,paladin,protection,83,35,48
33185,Wowmike,sargeras,1518,paladin,protection,126,66,60
33186,Demloc,doomhammer,1496,paladin,protection,48,21,27
33187,Chozverialyz,ysondre,1494,paladin,protection,68,32,36
33188,Tooholy,kiljaeden,1486,paladin,protection,41,22,19
33189,Borrus,malygos,1480,paladin,protection,48,28,20
33190,Aeythyr,wyrmrest-accord,1469,paladin,protection,84,38,46
33191,Terayus,veknilash,1464,paladin,protection,30,18,12
33192,Zexion,azralon,1450,paladin,protection,45,19,26
33193,Alekvin,moon-guard,1442,paladin,protection,36,19,17
33194,Íaan,drakkari,1433,paladin,protection,70,43,27
33195,Taillien,bonechewer,1415,paladin,protection,70,41,29
33196,Whëëls,stormreaver,1411,paladin,protection,41,22,19
33197,Arcilys,illidan,1398,paladin,protection,60,29,31
33198,Lorec,zuljin,1395,paladin,protection,54,25,29
33199,Modafinil,bonechewer,1390,paladin,protection,117,53,64
33200,Domocho,azgalor,1387,paladin,protection,47,24,23
33201,Herimi,drakkari,1379,paladin,protection,107,43,64
33202,Bt,quelthalas,1376,paladin,protection,41,25,16
33203,Goldjade,khazgoroth,1374,paladin,protection,119,49,70
33204,Rakasho,azralon,1370,paladin,protection,60,23,37
33205,Goeun,destromath,1369,paladin,protection,37,16,21
33206,Aopidsfihjov,stormrage,1355,paladin,protection,107,55,52
33207,Almeta,kelthuzad,1350,paladin,protection,36,18,18
33208,Jenesis,illidan,1348,paladin,protection,30,20,10
33209,Khrome,cenarion-circle,1346,paladin,protection,217,80,137
33210,Stormvikingx,darkspear,1336,paladin,protection,24,14,10
33211,Palahogx,sargeras,1333,paladin,protection,30,14,16
33212,Fredward,bleeding-hollow,1329,paladin,protection,30,14,16
33213,Canibaluy,ragnaros,1329,paladin,protection,40,18,22
33214,Ronor,thorium-brotherhood,1323,paladin,protection,48,24,24
33215,Jkethuhsnake,ghostlands,1306,paladin,protection,51,31,20
33216,Thorsmites,sargeras,1273,paladin,protection,48,18,30
33217,Poorly,thorium-brotherhood,1266,paladin,protection,48,24,24
33218,Protdream,tichondrius,1245,paladin,protection,18,13,5
33219,Xbloodknight,malganis,1243,paladin,protection,36,13,23
33220,Lythos,dathremar,1238,paladin,protection,42,19,23
33221,Imthabromb,dragonblight,1189,paladin,protection,41,20,21
33222,Lelythia,bleeding-hollow,1161,paladin,protection,65,25,40
33223,Ratzon,dalaran,1156,paladin,protection,23,14,9
33224,Chanimalf,tichondrius,1118,paladin,protection,18,13,5
33225,Gredo,queldorei,1070,paladin,protection,17,12,5
33226,Zakh,proudmoore,1053,paladin,protection,18,11,7
33227,Bronislav,draka,1053,paladin,protection,18,11,7
33228,Penitent,barthilas,1052,paladin,protection,18,11,7
33229,Blicka,dragonblight,1031,paladin,protection,30,11,19
33230,Bullivan,sisters-of-elune,963,paladin,protection,40,14,26
33231,Devonius,sargeras,959,paladin,protection,18,10,8
33232,Bubblemark,tichondrius,959,paladin,protection,24,10,14
33233,Strontimus,moon-guard,958,paladin,protection,12,10,2
33234,Ndnpaly,bonechewer,953,paladin,protection,12,10,2
33235,Danthorin,malfurion,940,paladin,protection,44,10,34
33236,Matadore,arygos,908,paladin,protection,22,11,11
33237,Alexcydragon,quelthalas,863,paladin,protection,18,9,9
33238,Holybull,maiev,859,paladin,protection,18,9,9
33239,Hittit,thrall,859,paladin,protection,30,9,21
33240,Cherubic,sargeras,858,paladin,protection,30,9,21
33241,Kittié,proudmoore,818,paladin,protection,38,10,28
33242,Negativeiq,moon-guard,798,paladin,protection,10,10,0
33243,Trâgedy,azjolnerub,768,paladin,protection,12,8,4
33244,Courageousz,dalaran,768,paladin,protection,18,8,10
33245,Zackthepally,area-52,768,paladin,protection,24,8,16
33246,Crusâder,area-52,767,paladin,protection,24,8,16
33247,Lothwrynn,senjin,762,paladin,protection,18,8,10
33248,Dirkdigglerz,bleeding-hollow,746,paladin,protection,23,8,15
33249,Halnoth,dethecus,702,paladin,protection,11,8,3
33250,Buslightyear,azralon,672,paladin,protection,12,7,5
33251,Kurokodieru,dalaran,672,paladin,protection,18,7,11
33252,Valkaire,area-52,671,paladin,protection,12,7,5
33253,Nobleblood,emerald-dream,669,paladin,protection,18,7,11
33254,Trågédy,zuljin,576,paladin,protection,6,6,0
33255,Sølis,alleria,576,paladin,protection,12,6,6
33256,Lessera,tichondrius,576,paladin,protection,12,6,6
33257,Paldyn,illidan,575,paladin,protection,12,6,6
33258,Huwglyndur,trollbane,575,paladin,protection,12,6,6
33259,Steverógers,frostmourne,480,paladin,protection,6,5,1
33260,Kiehui,lightbringer,480,paladin,protection,12,5,7
33261,Typhoontravv,thrall,480,paladin,protection,12,5,7
33262,Gotankz,moon-guard,480,paladin,protection,12,5,7
33263,Tankfest,sargeras,480,paladin,protection,12,5,7
33264,Bullmarket,tichondrius,480,paladin,protection,18,5,13
33265,Thulêan,moon-guard,480,paladin,protection,18,5,13
33266,Lewstelamon,korialstrasz,446,paladin,protection,10,6,4
33267,Thorkell,moon-guard,384,paladin,protection,6,4,2
33268,Ibubblë,wildhammer,384,paladin,protection,6,4,2
33269,Guidö,stormrage,384,paladin,protection,6,4,2
33270,Holyknight,veknilash,384,paladin,protection,14,5,9
33271,Valisari,korialstrasz,384,paladin,protection,12,4,8
33272,Gîmply,proudmoore,384,paladin,protection,12,4,8
33273,Zaeris,proudmoore,384,paladin,protection,12,4,8
33274,Bullheaded,silvermoon,384,paladin,protection,12,4,8
33275,Belmorlin,moon-guard,384,paladin,protection,12,4,8
33276,Ilovéyou,barthilas,384,paladin,protection,12,4,8
33277,Rikurena,bonechewer,383,paladin,protection,6,4,2
33278,Jahirie,aegwynn,351,paladin,protection,17,4,13
33279,Isecretly,stormrage,335,paladin,protection,7,7,0
33280,Thortanous,icecrown,288,paladin,protection,6,3,3
33281,Cheers,garona,288,paladin,protection,6,3,3
33282,Drágons,stormrage,288,paladin,protection,6,3,3
33283,Kooshh,thunderlord,288,paladin,protection,12,3,9
33284,Irahan,stormrage,288,paladin,protection,12,3,9
33285,Eliteyahtzee,kelthuzad,288,paladin,protection,12,3,9
33286,Urfavxbf,baelgun,288,paladin,protection,13,3,10
33287,Cots,azralon,271,paladin,protection,11,3,8
33288,Saeranella,moon-guard,240,paladin,protection,9,3,6
33289,Blâckhârt,saurfang,234,paladin,protection,9,4,5
33290,Stompem,zuljin,192,paladin,protection,6,2,4
33291,Immensepower,tichondrius,192,paladin,protection,6,2,4
33292,Xinqingle,tichondrius,192,paladin,protection,6,2,4
33293,Troxnar,ragnaros,192,paladin,protection,6,2,4
33294,Protbeeff,area-52,192,paladin,protection,6,2,4
33295,Zatheus,area-52,192,paladin,protection,6,2,4
33296,Òp,illidan,192,paladin,protection,10,3,7
33297,Zifre,ragnaros,192,paladin,protection,12,2,10
33298,Consecrated,daggerspine,192,paladin,protection,12,2,10
33299,Dwarvendude,sargeras,159,paladin,protection,11,2,9
33300,Combidin,garrosh,96,paladin,protection,6,1,5
33301,Thrandaic,frostmourne,96,paladin,protection,6,1,5
33302,Lasonil,zuljin,96,paladin,protection,6,1,5
33303,Holykura,thrall,96,paladin,protection,6,1,5
33304,Qtipds,moon-guard,96,paladin,protection,6,1,5
33305,Airane,sargeras,96,paladin,protection,6,1,5
33306,Mtanchokeme,stormrage,96,paladin,protection,9,1,8
33307,Chàrron,garrosh,79,paladin,protection,5,1,4
33308,Garbagedisc,scilla,2139,priest,holy,114,56,58
33309,Yötönyö,sargeras,2082,priest,holy,114,57,57
33310,Priestlike,tichondrius,2010,priest,holy,127,68,59
33311,Pianohouse,illidan,1998,priest,holy,132,70,62
33312,Dogbutt,burning-legion,1996,priest,holy,222,111,111
33313,Pickle,illidan,1974,priest,holy,86,49,37
33314,Fusira,gurubashi,1941,priest,holy,48,25,23
33315,Rustymvp,nagrand,1936,priest,holy,161,77,84
33316,Saintjpii,tichondrius,1910,priest,holy,161,96,65
33317,Tirrify,frostmourne,1899,priest,holy,54,29,25
33318,Cokeheals,kelthuzad,1897,priest,holy,42,26,16
33319,Fluent,emerald-dream,1895,priest,holy,192,91,101
33320,Onemission,whisperwind,1889,priest,holy,72,27,45
33321,Cinnalite,darkspear,1870,priest,holy,42,29,13
33322,Teslashield,bleeding-hollow,1856,priest,holy,54,25,29
33323,Ninbara,tichondrius,1851,priest,holy,102,49,53
33324,Tookiex,stormrage,1847,priest,holy,61,29,32
33325,Mynaevis,malganis,1845,priest,holy,78,43,35
33326,Lilyxo,bleeding-hollow,1845,priest,holy,72,36,36
33327,Peat,hyjal,1844,priest,holy,54,27,27
33328,Lëønë,nemesis,1842,priest,holy,148,93,55
33329,Superduperr,illidan,1840,priest,holy,66,33,33
33330,Vandalia,shadowsong,1837,priest,holy,181,89,92
33331,Gerpe,stormrage,1830,priest,holy,189,106,83
33332,Citrinesta,illidan,1828,priest,holy,305,172,133
33333,Mastuti,azralon,1828,priest,holy,143,70,73
33334,Lagemela,quelthalas,1825,priest,holy,101,47,54
33335,Hyouka,area-52,1824,priest,holy,285,151,134
33336,Pmos,sargeras,1823,priest,holy,40,21,19
33337,Nickydamous,moon-guard,1817,priest,holy,66,38,28
33338,Meatboxmoldy,blood-furnace,1817,priest,holy,82,41,41
33339,Iniquitatem,tichondrius,1817,priest,holy,60,23,37
33340,Tromnasty,area-52,1816,priest,holy,90,53,37
33341,Whitetails,illidan,1816,priest,holy,54,31,23
33342,Rootandboot,frostmourne,1815,priest,holy,49,29,20
33343,Onikûdaki,sargeras,1814,priest,holy,86,37,49
33344,Whalexo,kelthuzad,1813,priest,holy,261,127,134
33345,Sweatynick,proudmoore,1813,priest,holy,227,109,118
33346,Immthuggin,tichondrius,1813,priest,holy,120,53,67
33347,Scyner,bleeding-hollow,1811,priest,holy,152,87,65
33348,Dmgisop,illidan,1811,priest,holy,141,80,61
33349,Clarifytwo,arathor,1809,priest,holy,48,29,19
33350,Qnzo,tichondrius,1806,priest,holy,60,39,21
33351,Pipelayerx,illidan,1804,priest,holy,50,25,25
33352,Murkd,tichondrius,1804,priest,holy,145,68,77
33353,Dreckie,sargeras,1801,priest,holy,207,105,102
33354,Gill,proudmoore,1800,priest,holy,148,78,70
33355,Moonideli,moon-guard,1783,priest,holy,90,46,44
33356,Walnut,kelthuzad,1782,priest,holy,42,23,19
33357,Turnipp,sargeras,1780,priest,holy,42,19,23
33358,Zenelu,tichondrius,1775,priest,holy,482,239,243
33359,Haruspex,azralon,1774,priest,holy,123,58,65
33360,Jjmms,akama,1755,priest,holy,275,137,138
33361,Goodlife,frostmourne,1753,priest,holy,107,52,55
33362,Óst,tichondrius,1747,priest,holy,54,23,31
33363,Heavyflo,kelthuzad,1746,priest,holy,96,49,47
33364,Jüdaspriest,gorefiend,1744,priest,holy,53,20,33
33365,Nanatoo,sargeras,1743,priest,holy,42,22,20
33366,Iovesosa,kelthuzad,1739,priest,holy,39,22,17
33367,Pigogo,tichondrius,1737,priest,holy,157,86,71
33368,Verymuscular,stormrage,1737,priest,holy,73,37,36
33369,Dream,kelthuzad,1736,priest,holy,96,48,48
33370,Zazul,frostmane,1734,priest,holy,107,61,46
33371,Iloveethan,moon-guard,1726,priest,holy,95,53,42
33372,Icychain,area-52,1726,priest,holy,35,19,16
33373,Minipriest,sargeras,1726,priest,holy,48,23,25
33374,Bloodlinex,malganis,1724,priest,holy,207,116,91
33375,Blazedpri,tichondrius,1721,priest,holy,30,18,12
33376,Qtasiangirl,emerald-dream,1721,priest,holy,93,42,51
33377,Soulghast,gorefiend,1720,priest,holy,42,24,18
33378,Nildryck,malganis,1720,priest,holy,42,19,23
33379,Cheekypriest,stormrage,1714,priest,holy,66,30,36
33380,Eccentricx,sargeras,1712,priest,holy,30,18,12
33381,Falsegodx,tichondrius,1706,priest,holy,132,69,63
33382,Yyuan,tichondrius,1705,priest,holy,48,23,25
33383,Snowymooie,frostmourne,1697,priest,holy,54,25,29
33384,Illooj,eonar,1696,priest,holy,55,33,22
33385,Baip,sargeras,1696,priest,holy,42,25,17
33386,Packet,zuluhed,1694,priest,holy,42,28,14
33387,Moldymeatbox,blood-furnace,1691,priest,holy,47,26,21
33388,ßsimp,darrowmere,1689,priest,holy,89,42,47
33389,Geoffrred,illidan,1686,priest,holy,54,21,33
33390,Pws,azralon,1683,priest,holy,66,29,37
33391,Candohp,frostmourne,1682,priest,holy,42,22,20
33392,Soloqqt,tichondrius,1675,priest,holy,42,24,18
33393,Gaudthree,tichondrius,1675,priest,holy,48,26,22
33394,Santyel,ragnaros,1668,priest,holy,102,54,48
33395,Hannavi,illidan,1667,priest,holy,72,51,21
33396,Myles,alexstrasza,1667,priest,holy,42,24,18
33397,Cosmicyiff,area-52,1666,priest,holy,76,38,38
33398,Moosepriestx,sargeras,1660,priest,holy,42,19,23
33399,Cryptron,tichondrius,1660,priest,holy,114,50,64
33400,Elbowbeans,tichondrius,1658,priest,holy,112,53,59
33401,Iluvthgnmicz,sargeras,1655,priest,holy,57,30,27
33402,Fyne,kelthuzad,1653,priest,holy,224,115,109
33403,Djdazzle,kargath,1652,priest,holy,35,18,17
33404,Wankenobi,stormrage,1651,priest,holy,297,149,148
33405,Stonemonkeyp,sargeras,1646,priest,holy,231,127,104
33406,Illmindofmoo,sargeras,1645,priest,holy,41,18,23
33407,Pancakeboi,tichondrius,1638,priest,holy,167,77,90
33408,Bopang,emerald-dream,1638,priest,holy,59,27,32
33409,Auntbrittany,tichondrius,1636,priest,holy,135,73,62
33410,Quicklight,sargeras,1633,priest,holy,54,30,24
33411,Dfâc,moon-guard,1633,priest,holy,44,23,21
33412,Dntchekpvpme,tichondrius,1630,priest,holy,42,23,19
33413,Hardiness,tichondrius,1627,priest,holy,66,45,21
33414,Qnarisha,tichondrius,1626,priest,holy,131,69,62
33415,Iaz,darkspear,1626,priest,holy,50,22,28
33416,Wisdumos,frostmourne,1625,priest,holy,72,36,36
33417,Snookp,kiljaeden,1620,priest,holy,77,44,33
33418,Dgpriest,tichondrius,1620,priest,holy,48,23,25
33419,Pej,emerald-dream,1620,priest,holy,54,22,32
33420,Holydome,daggerspine,1619,priest,holy,54,20,34
33421,Archbishop,stormscale,1615,priest,holy,154,78,76
33422,Clarify,arathor,1615,priest,holy,84,35,49
33423,Miserable,emerald-dream,1614,priest,holy,102,56,46
33424,Dinosmeow,sargeras,1614,priest,holy,90,41,49
33425,Lickless,illidan,1613,priest,holy,48,23,25
33426,Hpcando,frostmourne,1612,priest,holy,43,26,17
33427,Endure,moon-guard,1610,priest,holy,42,22,20
33428,Leoshi,turalyon,1604,priest,holy,48,27,21
33429,Jiñx,destromath,1601,priest,holy,54,27,27
33430,Dylbags,frostmourne,1600,priest,holy,35,21,14
33431,Vatan,dalaran,1600,priest,holy,42,24,18
33432,Lisnup,tichondrius,1600,priest,holy,45,22,23
33433,Lemmiewinkzx,sargeras,1598,priest,holy,24,17,7
33434,Madomie,bladefist,1597,priest,holy,36,20,16
33435,Thisistragic,frostmourne,1594,priest,holy,34,26,8
33436,Gosilly,tichondrius,1594,priest,holy,36,22,14
33437,Washdp,frostmourne,1591,priest,holy,60,26,34
33438,Evilpriest,stormrage,1590,priest,holy,42,21,21
33439,Manbooty,illidan,1588,priest,holy,39,22,17
33440,Shïryn,illidan,1585,priest,holy,53,26,27
33441,Cerebrill,bleeding-hollow,1585,priest,holy,51,24,27
33442,Noniok,blackrock,1583,priest,holy,80,49,31
33443,Operandi,sargeras,1583,priest,holy,41,22,19
33444,Alathea,elune,1583,priest,holy,237,113,124
33445,Dypkillet,moon-guard,1582,priest,holy,150,71,79
33446,Bloodyx,bleeding-hollow,1573,priest,holy,30,19,11
33447,Iaptop,tichondrius,1569,priest,holy,36,20,16
33448,Avis,illidan,1569,priest,holy,134,67,67
33449,Hatxsu,emerald-dream,1568,priest,holy,58,24,34
33450,Cutiepriest,gnomeregan,1565,priest,holy,151,86,65
33451,Padrecarras,ragnaros,1565,priest,holy,60,30,30
33452,ßeautiful,sargeras,1562,priest,holy,42,22,20
33453,Pootyspanked,daggerspine,1559,priest,holy,113,66,47
33454,Krobs,bleeding-hollow,1559,priest,holy,48,20,28
33455,Tarlex,illidan,1555,priest,holy,94,43,51
33456,Tytusx,stormrage,1543,priest,holy,44,22,22
33457,Heluupa,illidan,1538,priest,holy,113,71,42
33458,Sanojaz,ragnaros,1538,priest,holy,60,33,27
33459,Punkndrublic,sargeras,1537,priest,holy,189,91,98
33460,Tookz,stormrage,1530,priest,holy,24,16,8
33461,Sukeena,malganis,1530,priest,holy,125,60,65
33462,Rubymisfit,sargeras,1528,priest,holy,30,16,14
33463,Bubbles,drakthul,1527,priest,holy,532,265,267
33464,Nielbomb,tichondrius,1527,priest,holy,414,206,208
33465,Soaphia,kelthuzad,1525,priest,holy,130,65,65
33466,Bibleblak,stormrage,1525,priest,holy,54,27,27
33467,Dispassion,stormrage,1523,priest,holy,182,90,92
33468,Healinsucks,proudmoore,1519,priest,holy,52,29,23
33469,Anguishment,stormrage,1517,priest,holy,385,193,192
33470,Handsumheals,kiljaeden,1515,priest,holy,55,32,23
33471,Holypopocat,tichondrius,1514,priest,holy,33,18,15
33472,Saetia,drenden,1513,priest,holy,69,40,29
33473,Ducky,drakthul,1513,priest,holy,66,38,28
33474,Praggy,proudmoore,1513,priest,holy,48,20,28
33475,Miamama,hydraxis,1513,priest,holy,42,17,25
33476,Joeschmoe,proudmoore,1512,priest,holy,42,22,20
33477,Boboxiao,illidan,1512,priest,holy,47,16,31
33478,Cantheel,stormrage,1507,priest,holy,235,119,116
33479,Downturn,tichondrius,1507,priest,holy,42,18,24
33480,Tortellino,hyjal,1505,priest,holy,30,19,11
33481,Oyy,barthilas,1505,priest,holy,150,76,74
33482,Exploded,moon-guard,1505,priest,holy,96,48,48
33483,Arçhángël,moon-guard,1503,priest,holy,102,57,45
33484,Einheit,stormrage,1502,priest,holy,48,28,20
33485,Cardinalpéll,frostmourne,1498,priest,holy,74,39,35
33486,Giveheadpats,moon-guard,1496,priest,holy,164,80,84
33487,Symbolofhope,moon-guard,1495,priest,holy,75,36,39
33488,Tazzi,chromaggus,1494,priest,holy,79,35,44
33489,Sacrifer,moon-guard,1493,priest,holy,120,60,60
33490,Kostantina,kelthuzad,1484,priest,holy,42,18,24
33491,Tranquilty,tichondrius,1480,priest,holy,84,36,48
33492,Wøo,area-52,1476,priest,holy,172,89,83
33493,Macko,wyrmrest-accord,1476,priest,holy,37,18,19
33494,Goyimhealer,area-52,1476,priest,holy,53,23,30
33495,Chadopri,stormrage,1475,priest,holy,60,34,26
33496,Plebiss,burning-blade,1473,priest,holy,364,190,174
33497,Illyasviel,terenas,1472,priest,holy,103,41,62
33498,Adrenalinn,illidan,1471,priest,holy,60,34,26
33499,Ðemi,zuljin,1469,priest,holy,69,38,31
33500,Dawnside,wyrmrest-accord,1468,priest,holy,701,372,329
33501,Edmen,stormrage,1466,priest,holy,96,47,49
33502,Exol,ragnaros,1465,priest,holy,48,25,23
33503,Soleyxo,frostmourne,1464,priest,holy,90,47,43
33504,Aisperwind,shadowsong,1462,priest,holy,120,62,58
33505,Musashibo,kelthuzad,1462,priest,holy,67,25,42
33506,Ayanamil,tichondrius,1460,priest,holy,79,57,22
33507,Artiannaa,bleeding-hollow,1460,priest,holy,75,46,29
33508,Vampiric,laughing-skull,1460,priest,holy,68,38,30
33509,Matthiass,thrall,1458,priest,holy,184,88,96
33510,Discconnect,dark-iron,1456,priest,holy,41,19,22
33511,Reverenced,stormrage,1452,priest,holy,126,72,54
33512,Maplesyrupz,moonrunner,1452,priest,holy,40,16,24
33513,Sooyáaa,illidan,1447,priest,holy,288,131,157
33514,Pics,emerald-dream,1446,priest,holy,40,22,18
33515,Griddly,alterac-mountains,1445,priest,holy,55,17,38
33516,Swrvlol,emerald-dream,1444,priest,holy,36,25,11
33517,Owlchubz,mannoroth,1443,priest,holy,121,57,64
33518,Chervz,chogall,1443,priest,holy,78,32,46
33519,Dapcum,illidan,1441,priest,holy,30,20,10
33520,Strivedaily,proudmoore,1440,priest,holy,279,133,146
33521,Cuaiminator,ragnaros,1438,priest,holy,65,36,29
33522,Rolence,tichondrius,1437,priest,holy,86,46,40
33523,Akëla,nemesis,1436,priest,holy,52,28,24
33524,Necroplasma,area-52,1433,priest,holy,55,31,24
33525,Xedus,mannoroth,1433,priest,holy,74,32,42
33526,Shieldspamx,tichondrius,1432,priest,holy,24,20,4
33527,Krukam,sargeras,1432,priest,holy,58,28,30
33528,Hypepriest,sargeras,1431,priest,holy,24,17,7
33529,Iggyp,hyjal,1430,priest,holy,217,113,104
33530,Pesca,proudmoore,1429,priest,holy,36,15,21
33531,Marïmba,azralon,1428,priest,holy,42,20,22
33532,Wrinkletink,whisperwind,1426,priest,holy,49,24,25
33533,Qtcookiebunz,proudmoore,1424,priest,holy,35,17,18
33534,Taashigi,frostmourne,1423,priest,holy,58,31,27
33535,Klondikebar,whisperwind,1418,priest,holy,54,31,23
33536,Camedy,illidan,1415,priest,holy,119,57,62
33537,Discospider,sargeras,1412,priest,holy,37,20,17
33538,Tòxìç,stormrage,1411,priest,holy,187,96,91
33539,Mizzbehavn,tichondrius,1410,priest,holy,50,26,24
33540,Kaelthos,quelthalas,1409,priest,holy,101,50,51
33541,Kovaxx,frostmourne,1407,priest,holy,156,74,82
33542,Voïdx,emerald-dream,1407,priest,holy,54,20,34
33543,Îcarus,tichondrius,1406,priest,holy,36,17,19
33544,Berzum,chogall,1406,priest,holy,36,17,19
33545,ßugsy,illidan,1402,priest,holy,60,31,29
33546,Sacredforce,sargeras,1400,priest,holy,66,21,45
33547,Loosejeans,blackrock,1399,priest,holy,36,18,18
33548,Vìxèn,zuljin,1397,priest,holy,121,53,68
33549,Holyb,tichondrius,1396,priest,holy,89,46,43
33550,Bradythree,moon-guard,1394,priest,holy,40,25,15
33551,Pettypriest,dalaran,1394,priest,holy,201,95,106
33552,Bestgirlna,area-52,1393,priest,holy,144,64,80
33553,Floquii,area-52,1391,priest,holy,52,25,27
33554,Applepieyum,illidan,1391,priest,holy,108,46,62
33555,Soapfan,kelthuzad,1387,priest,holy,195,94,101
33556,Dreäveler,stormrage,1385,priest,holy,27,15,12
33557,Fenty,nemesis,1384,priest,holy,59,33,26
33558,Plod,kelthuzad,1380,priest,holy,42,25,17
33559,Etain,bloodscalp,1380,priest,holy,65,35,30
33560,Akaneo,tichondrius,1380,priest,holy,36,18,18
33561,Xenatic,emerald-dream,1380,priest,holy,138,67,71
33562,Suirr,tichondrius,1377,priest,holy,36,16,20
33563,Painpaws,moon-guard,1376,priest,holy,24,16,8
33564,Glaius,kiljaeden,1376,priest,holy,84,40,44
33565,Åutumn,tichondrius,1374,priest,holy,26,18,8
33566,Doob,ghostlands,1374,priest,holy,48,25,23
33567,Methodist,proudmoore,1374,priest,holy,84,31,53
33568,Holynug,stormrage,1370,priest,holy,36,19,17
33569,Preacherr,bonechewer,1368,priest,holy,42,24,18
33570,Sabene,greymane,1364,priest,holy,91,44,47
33571,Leggoscams,tichondrius,1360,priest,holy,44,22,22
33572,Mikeyxo,gnomeregan,1359,priest,holy,44,26,18
33573,Maddrox,sargeras,1359,priest,holy,47,26,21
33574,Aurorias,burning-legion,1359,priest,holy,60,24,36
33575,Rihen,tichondrius,1358,priest,holy,525,257,268
33576,Chemod,quelthalas,1355,priest,holy,47,26,21
33577,Cyelena,quelthalas,1355,priest,holy,72,32,40
33578,Quartzolio,azralon,1353,priest,holy,59,35,24
33579,Muffinecho,sargeras,1353,priest,holy,85,36,49
33580,Shaldra,bleeding-hollow,1348,priest,holy,109,64,45
33581,Ghostiepants,tichondrius,1347,priest,holy,53,25,28
33582,Sappes,area-52,1346,priest,holy,54,27,27
33583,Hérò,barthilas,1345,priest,holy,50,28,22
33584,Dioecesis,moon-guard,1345,priest,holy,83,30,53
33585,Debussynjoyr,malganis,1339,priest,holy,24,14,10
33586,Andruel,ragnaros,1338,priest,holy,109,56,53
33587,Esvary,quelthalas,1337,priest,holy,134,71,63
33588,Kurandies,nemesis,1337,priest,holy,73,37,36
33589,Kernelious,illidan,1337,priest,holy,30,14,16
33590,Hizha,tichondrius,1335,priest,holy,42,24,18
33591,Ænußís,stormrage,1335,priest,holy,84,46,38
33592,Spriest,kul-tiras,1332,priest,holy,74,41,33
33593,Kaelsgf,kaelthas,1331,priest,holy,54,22,32
33594,Trufumthunzi,illidan,1330,priest,holy,26,17,9
33595,Xumer,quelthalas,1329,priest,holy,56,29,27
33596,Karrera,kelthuzad,1328,priest,holy,66,36,30
33597,Droneboy,moon-guard,1327,priest,holy,36,20,16
33598,Merellia,moon-guard,1324,priest,holy,108,52,56
33599,Nylaza,kiljaeden,1324,priest,holy,90,42,48
33600,Holyshytt,tichondrius,1323,priest,holy,59,31,28
33601,Psytrance,proudmoore,1323,priest,holy,29,15,14
33602,Mkenze,moon-guard,1323,priest,holy,174,80,94
33603,Healztonic,dalaran,1323,priest,holy,85,38,47
33604,Dispersed,thrall,1319,priest,holy,92,42,50
33605,Priestlie,malganis,1318,priest,holy,98,43,55
33606,Freshtodeath,malganis,1316,priest,holy,48,28,20
33607,Cûrry,bleeding-hollow,1313,priest,holy,24,14,10
33608,Lectra,firetree,1313,priest,holy,40,21,19
33609,Phearix,zuljin,1313,priest,holy,54,23,31
33610,Lexiié,area-52,1312,priest,holy,55,33,22
33611,Mercý,zuljin,1309,priest,holy,60,34,26
33612,Ksâh,bleeding-hollow,1309,priest,holy,36,17,19
33613,Urdaisyy,kelthuzad,1306,priest,holy,36,14,22
33614,Animè,zuluhed,1305,priest,holy,89,52,37
33615,Xinferesia,sargeras,1305,priest,holy,61,25,36
33616,Gracarix,frostmourne,1304,priest,holy,40,23,17
33617,Dunanan,moon-guard,1304,priest,holy,30,17,13
33618,Snuffsnorter,kelthuzad,1304,priest,holy,41,16,25
33619,Cutensoft,moon-guard,1302,priest,holy,60,28,32
33620,Xrafa,azralon,1301,priest,holy,84,38,46
33621,Yujawang,sargeras,1300,priest,holy,36,17,19
33622,Nowwow,tichondrius,1299,priest,holy,41,22,19
33623,Cristobal,chogall,1299,priest,holy,30,15,15
33624,Giusep,tichondrius,1297,priest,holy,48,22,26
33625,Duhàst,sargeras,1296,priest,holy,95,43,52
33626,Littlebat,proudmoore,1294,priest,holy,82,41,41
33627,Holyfromrmp,tichondrius,1294,priest,holy,99,44,55
33628,Deemmortii,stormrage,1289,priest,holy,43,18,25
33629,Xanky,frostmourne,1287,priest,holy,34,18,16
33630,Lilyanná,tichondrius,1284,priest,holy,54,26,28
33631,Holiermilk,demon-soul,1281,priest,holy,239,110,129
33632,Edessa,lothar,1280,priest,holy,102,44,58
33633,Amaristinaa,frostmourne,1279,priest,holy,46,21,25
33634,Spïcÿ,frostmourne,1276,priest,holy,60,29,31
33635,Duskherald,zuljin,1274,priest,holy,96,45,51
33636,Dadcantdeath,frostmourne,1274,priest,holy,32,14,18
33637,Visse,auchindoun,1273,priest,holy,42,29,13
33638,Priestprease,malganis,1272,priest,holy,39,20,19
33639,Holyphodays,sargeras,1270,priest,holy,59,20,39
33640,Faerielee,thrall,1268,priest,holy,30,14,16
33641,Raskreia,dragonmaw,1268,priest,holy,30,14,16
33642,Tegridyfarm,malganis,1265,priest,holy,35,19,16
33643,Threesclass,tichondrius,1262,priest,holy,29,14,15
33644,Cruxave,aegwynn,1260,priest,holy,82,42,40
33645,Mirshadow,tichondrius,1260,priest,holy,48,24,24
33646,Cusquena,caelestrasz,1259,priest,holy,48,24,24
33647,Danerÿ,ragnaros,1255,priest,holy,56,28,28
33648,Alrüna,moon-guard,1253,priest,holy,62,30,32
33649,Benjamints,thrall,1252,priest,holy,30,15,15
33650,Padreamarol,ragnaros,1252,priest,holy,68,32,36
33651,Galadrael,quelthalas,1252,priest,holy,35,16,19
33652,Zallstan,zuljin,1249,priest,holy,30,15,15
33653,Valkur,aegwynn,1248,priest,holy,219,105,114
33654,Bjorke,tichondrius,1247,priest,holy,30,13,17
33655,Oxynor,zuljin,1246,priest,holy,24,13,11
33656,Wabie,illidan,1246,priest,holy,30,13,17
33657,Shoepooper,kelthuzad,1245,priest,holy,24,13,11
33658,Zumnb,quelthalas,1243,priest,holy,134,61,73
33659,Irídium,area-52,1243,priest,holy,30,13,17
33660,Bmouth,tichondrius,1241,priest,holy,24,13,11
33661,Fanseband,dalaran,1240,priest,holy,41,22,19
33662,Daisie,bleeding-hollow,1240,priest,holy,150,78,72
33663,Manocloth,frostmourne,1239,priest,holy,25,15,10
33664,Akainuu,nazjatar,1239,priest,holy,61,26,35
33665,Fearnfaith,zuljin,1239,priest,holy,36,13,23
33666,Valiann,lightbringer,1238,priest,holy,24,13,11
33667,Deathrina,moon-guard,1236,priest,holy,39,21,18
33668,Cléah,sargeras,1235,priest,holy,113,53,60
33669,Altera,drakkari,1233,priest,holy,30,13,17
33670,Kälashnikova,ragnaros,1232,priest,holy,116,59,57
33671,Etros,wyrmrest-accord,1232,priest,holy,102,47,55
33672,Junatoh,area-52,1231,priest,holy,55,29,26
33673,Dagaen,thunderlord,1230,priest,holy,240,120,120
33674,Healgirls,dalaran,1230,priest,holy,59,28,31
33675,Aiwa,winterhoof,1229,priest,holy,18,13,5
33676,Breathkeeper,proudmoore,1226,priest,holy,36,13,23
33677,Snoorklizzak,malganis,1225,priest,holy,24,13,11
33678,Delthas,nagrand,1225,priest,holy,224,121,103
33679,Zerolimitzz,arthas,1225,priest,holy,48,22,26
33680,Whitepigogo,tichondrius,1225,priest,holy,30,13,17
33681,Celinsa,ragnaros,1223,priest,holy,36,18,18
33682,Xarithea,caelestrasz,1222,priest,holy,41,19,22
33683,Arterrmis,barthilas,1222,priest,holy,65,29,36
33684,Urisaegin,senjin,1222,priest,holy,52,23,29
33685,Tïto,blackrock,1220,priest,holy,50,23,27
33686,Frïsk,illidan,1219,priest,holy,64,30,34
33687,Titô,frostmourne,1215,priest,holy,53,28,25
33688,Firewatcher,sisters-of-elune,1214,priest,holy,30,17,13
33689,Destïnÿ,zuljin,1213,priest,holy,51,24,27
33690,Salaknib,frostmourne,1206,priest,holy,40,17,23
33691,Dóctóre,thrall,1205,priest,holy,61,24,37
33692,Stayhealed,tichondrius,1201,priest,holy,45,22,23
33693,Akö,jubeithos,1200,priest,holy,30,14,16
33694,Vernis,nazjatar,1200,priest,holy,36,15,21
33695,Pílí,drakkari,1198,priest,holy,60,28,32
33696,Gronix,blood-furnace,1195,priest,holy,42,22,20
33697,Qelient,proudmoore,1192,priest,holy,48,26,22
33698,Ukizeal,moknathal,1192,priest,holy,134,63,71
33699,Theophobe,illidan,1190,priest,holy,85,45,40
33700,Darkheals,azralon,1190,priest,holy,52,20,32
33701,Stennic,emerald-dream,1183,priest,holy,33,17,16
33702,Dolandir,quelthalas,1181,priest,holy,30,18,12
33703,Kazehanaa,ragnaros,1180,priest,holy,42,22,20
33704,Flemyth,eitrigg,1180,priest,holy,40,16,24
33705,Pôê,blood-furnace,1171,priest,holy,24,13,11
33706,Bismund,chogall,1166,priest,holy,48,24,24
33707,Bonsana,shadowsong,1164,priest,holy,36,21,15
33708,Haushauha,azralon,1164,priest,holy,48,23,25
33709,Suzzanna,frostmourne,1160,priest,holy,41,23,18
33710,Aftercare,moon-guard,1157,priest,holy,72,27,45
33711,Ranøth,deathwing,1155,priest,holy,74,31,43
33712,Milkgulper,illidan,1152,priest,holy,24,12,12
33713,Leonihpriest,nemesis,1151,priest,holy,30,12,18
33714,Trompiscola,quelthalas,1151,priest,holy,30,12,18
33715,Lightwell,blackrock,1150,priest,holy,18,12,6
33716,Löstský,azralon,1148,priest,holy,37,19,18
33717,Mêgumin,area-52,1147,priest,holy,18,13,5
33718,Konãn,ragnaros,1145,priest,holy,18,12,6
33719,Ôôöô,sargeras,1145,priest,holy,24,13,11
33720,Selket,stormscale,1145,priest,holy,96,42,54
33721,Fiction,kelthuzad,1142,priest,holy,18,13,5
33722,Floppytatas,illidan,1142,priest,holy,279,143,136
33723,Luxar,aegwynn,1141,priest,holy,18,12,6
33724,Meiev,quelthalas,1139,priest,holy,24,12,12
33725,Anemonie,gorefiend,1138,priest,holy,122,52,70
33726,Kasiry,ragnaros,1137,priest,holy,90,37,53
33727,Voidthulhu,stormrage,1134,priest,holy,167,66,101
33728,Rienis,sargeras,1132,priest,holy,42,17,25
33729,Fallaner,destromath,1129,priest,holy,65,28,37
33730,Tianqing,tichondrius,1126,priest,holy,34,12,22
33731,Aprocalypse,malganis,1123,priest,holy,42,17,25
33732,Dactylion,moon-guard,1119,priest,holy,24,12,12
33733,Æsir,skullcrusher,1119,priest,holy,30,12,18
33734,Niná,arathor,1114,priest,holy,20,13,7
33735,Zojhira,khazgoroth,1114,priest,holy,66,32,34
33736,Carray,goldrinn,1113,priest,holy,49,16,33
33737,Veane,tichondrius,1111,priest,holy,68,28,40
33738,Atlana,gilneas,1107,priest,holy,24,16,8
33739,Mailboxxy,kelthuzad,1107,priest,holy,42,18,24
33740,Divona,blackhand,1106,priest,holy,66,23,43
33741,Veltaxis,moon-guard,1095,priest,holy,174,77,97
33742,Dotsallover,sargeras,1091,priest,holy,38,14,24
33743,Sanaconda,sargeras,1090,priest,holy,36,12,24
33744,Kytiana,blackwing-lair,1088,priest,holy,729,357,372
33745,Rdvark,stormrage,1085,priest,holy,26,12,14
33746,Bwaka,dalaran,1084,priest,holy,18,12,6
33747,Sôlîånia,alterac-mountains,1081,priest,holy,39,27,12
33748,Gewbrr,malganis,1073,priest,holy,24,12,12
33749,Beckzz,illidan,1070,priest,holy,26,17,9
33750,Mavuiss,barthilas,1069,priest,holy,25,12,13
33751,Sinthe,stormrage,1056,priest,holy,24,11,13
33752,Badgoy,dalaran,1056,priest,holy,24,11,13
33753,Ímhotep,sargeras,1055,priest,holy,18,11,7
33754,Pesian,dalaran,1055,priest,holy,22,12,10
33755,Sorrowful,mannoroth,1055,priest,holy,30,11,19
33756,Iilmama,area-52,1054,priest,holy,18,11,7
33757,Saltypepper,thunderhorn,1052,priest,holy,30,14,16
33758,Amayå,kelthuzad,1052,priest,holy,24,11,13
33759,Amynthel,tichondrius,1052,priest,holy,30,11,19
33760,Jsky,wyrmrest-accord,1050,priest,holy,21,11,10
33761,Karenpigbear,area-52,1050,priest,holy,243,107,136
33762,Dotdotdead,earthen-ring,1049,priest,holy,18,11,7
33763,Jol,aggramar,1049,priest,holy,30,13,17
33764,Soulhealer,shadowmoon,1048,priest,holy,24,13,11
33765,Paradoxbot,kelthuzad,1045,priest,holy,18,11,7
33766,Dylirium,dathremar,1044,priest,holy,18,11,7
33767,Fadedvi,wyrmrest-accord,1042,priest,holy,45,21,24
33768,Titoj,tichondrius,1035,priest,holy,38,19,19
33769,Zhideevskiy,trollbane,1033,priest,holy,42,20,22
33770,Alicia,nazjatar,1032,priest,holy,18,13,5
33771,Pikachuwu,moon-guard,1032,priest,holy,17,12,5
33772,Lieuwe,kelthuzad,1032,priest,holy,30,12,18
33773,Seventeen,hyjal,1029,priest,holy,30,11,19
33774,Healle,proudmoore,1027,priest,holy,23,11,12
33775,Tranith,jubeithos,1027,priest,holy,24,11,13
33776,Celani,gilneas,1026,priest,holy,24,11,13
33777,Ninbará,stormrage,1023,priest,holy,26,12,14
33778,Justjoekingh,gurubashi,1021,priest,holy,22,12,10
33779,Hälø,moon-guard,1019,priest,holy,27,12,15
33780,Krishpriest,azshara,1018,priest,holy,24,15,9
33781,Fivestarz,malganis,1014,priest,holy,24,11,13
33782,Fayth,maiev,1005,priest,holy,53,25,28
33783,Pandamila,azralon,1004,priest,holy,19,11,8
33784,Zantara,lightbringer,1002,priest,holy,24,12,12
33785,Maiyennefer,proudmoore,996,priest,holy,36,13,23
33786,Sybenela,proudmoore,994,priest,holy,61,28,33
33787,Souljourner,stormrage,993,priest,holy,95,46,49
33788,Pottime,tichondrius,989,priest,holy,76,33,43
33789,Yinaiteen,drakkari,985,priest,holy,64,33,31
33790,Cultofsins,tichondrius,982,priest,holy,23,11,12
33791,Priesttess,skullcrusher,981,priest,holy,23,11,12
33792,Seråphim,sargeras,979,priest,holy,66,36,30
33793,Ragekiller,lothar,964,priest,holy,59,28,31
33794,Eredwarraim,akama,964,priest,holy,48,21,27
33795,Adephene,illidan,960,priest,holy,18,10,8
33796,Jameswarren,silvermoon,959,priest,holy,11,11,0
33797,Runalor,zuljin,959,priest,holy,18,10,8
33798,Bunbuns,spirestone,959,priest,holy,18,10,8
33799,Naxray,quelthalas,959,priest,holy,18,10,8
33800,Pèrona,tichondrius,959,priest,holy,24,10,14
33801,Trickyhobo,area-52,958,priest,holy,12,10,2
33802,Folate,frostmourne,957,priest,holy,18,10,8
33803,Holyfizzle,dethecus,957,priest,holy,54,28,26
33804,Wockus,dalaran,956,priest,holy,18,10,8
33805,Bugshott,tichondrius,956,priest,holy,32,10,22
33806,Noobepriest,thrall,955,priest,holy,18,10,8
33807,Priestybear,illidan,955,priest,holy,18,10,8
33808,Cappoo,tichondrius,955,priest,holy,36,10,26
33809,Xoraya,proudmoore,954,priest,holy,18,10,8
33810,Rottigus,skullcrusher,951,priest,holy,18,10,8
33811,Dovoso,kargath,951,priest,holy,26,10,16
33812,Hycinamun,malganis,949,priest,holy,25,10,15
33813,Allaras,eldrethalas,946,priest,holy,24,10,14
33814,Novous,area-52,944,priest,holy,30,10,20
33815,Horimiya,silvermoon,943,priest,holy,23,11,12
33816,Aszdriel,azralon,936,priest,holy,18,10,8
33817,Taylorsmites,emerald-dream,931,priest,holy,42,18,24
33818,Dipanddøts,area-52,926,priest,holy,17,10,7
33819,Bienhechora,quelthalas,924,priest,holy,18,10,8
33820,Zelaya,hellscream,919,priest,holy,45,17,28
33821,Aliorixa,stormrage,908,priest,holy,26,11,15
33822,Artyòm,stormrage,897,priest,holy,297,138,159
33823,Meibuff,frostmourne,896,priest,holy,50,18,32
33824,Veni,kiljaeden,885,priest,holy,23,10,13
33825,Teheleopapi,quelthalas,877,priest,holy,75,19,56
33826,Rustymvpfan,nagrand,864,priest,holy,18,9,9
33827,Holyxb,bleeding-hollow,863,priest,holy,18,9,9
33828,Mhp,illidan,863,priest,holy,18,9,9
33829,Xhadow,sargeras,863,priest,holy,18,9,9
33830,Glöws,area-52,863,priest,holy,24,9,15
33831,Çummiñs,malganis,862,priest,holy,18,9,9
33832,Mëïsoön,quelthalas,862,priest,holy,18,9,9
33833,Leapofdoubt,zuljin,861,priest,holy,12,9,3
33834,Ilurvyou,frostwolf,861,priest,holy,24,9,15
33835,Legoland,skullcrusher,859,priest,holy,12,9,3
33836,Chaynal,proudmoore,859,priest,holy,18,9,9
33837,Meowforheals,sargeras,859,priest,holy,18,9,9
33838,Duonaiameng,illidan,859,priest,holy,18,9,9
33839,Faedre,smolderthorn,858,priest,holy,18,9,9
33840,Skywritten,area-52,857,priest,holy,18,9,9
33841,Swis,area-52,857,priest,holy,24,9,15
33842,Adjectives,nerzhul,854,priest,holy,24,9,15
33843,Shkeyia,stonemaul,852,priest,holy,30,9,21
33844,Sondrak,doomhammer,846,priest,holy,47,19,28
33845,Aldryth,lightbringer,838,priest,holy,18,9,9
33846,Pharmacee,korgath,836,priest,holy,102,33,69
33847,Hamburgle,blackrock,831,priest,holy,16,10,6
33848,Psïren,quelthalas,831,priest,holy,28,9,19
33849,Conno,thunderlord,829,priest,holy,54,27,27
33850,Jovon,frostmourne,828,priest,holy,29,9,20
33851,Bigmommyxo,whisperwind,811,priest,holy,33,10,23
33852,Ascian,daggerspine,809,priest,holy,18,10,8
33853,Helgar,frostmourne,808,priest,holy,18,10,8
33854,Híkarí,windrunner,796,priest,holy,14,9,5
33855,Gbumy,tichondrius,784,priest,holy,13,9,4
33856,Yikari,sargeras,783,priest,holy,11,9,2
33857,Saceryito,quelthalas,770,priest,holy,13,9,4
33858,Releknosleep,frostwolf,769,priest,holy,20,10,10
33859,Sengmin,burning-blade,768,priest,holy,12,8,4
33860,Powerwordsuc,malganis,768,priest,holy,12,8,4
33861,Gudóngmáe,tichondrius,768,priest,holy,12,8,4
33862,Fotmtrash,the-underbog,768,priest,holy,12,8,4
33863,Turnip,zuljin,768,priest,holy,12,8,4
33864,Becrixx,thunderlord,768,priest,holy,18,8,10
33865,Yanyo,skullcrusher,768,priest,holy,18,8,10
33866,Voidzx,tichondrius,768,priest,holy,18,8,10
33867,Ugotknocked,bleeding-hollow,768,priest,holy,18,8,10
33868,Khalesî,ragnaros,767,priest,holy,12,8,4
33869,Superheals,nordrassil,767,priest,holy,12,8,4
33870,Unhöly,norgannon,767,priest,holy,12,8,4
33871,Sunwarden,dalaran,767,priest,holy,12,8,4
33872,Tonybanderas,shattered-halls,767,priest,holy,18,8,10
33873,Pomdom,tichondrius,767,priest,holy,18,8,10
33874,Boundword,emerald-dream,767,priest,holy,18,8,10
33875,Hynzor,barthilas,767,priest,holy,30,8,22
33876,Prayzar,illidan,766,priest,holy,12,8,4
33877,Raphan,stormrage,766,priest,holy,12,8,4
33878,Ofmanyfaces,illidan,766,priest,holy,12,8,4
33879,Zeroo,maiev,765,priest,holy,12,8,4
33880,Manatea,moon-guard,765,priest,holy,18,8,10
33881,Velyndra,icecrown,765,priest,holy,18,8,10
33882,Yuritzi,duskwood,765,priest,holy,18,8,10
33883,Prayboy,aerie-peak,765,priest,holy,24,8,16
33884,Olivinpain,malganis,765,priest,holy,30,8,22
33885,Morticiá,blackrock,764,priest,holy,12,8,4
33886,Lenlune,bloodscalp,763,priest,holy,18,8,10
33887,Laj,proudmoore,763,priest,holy,30,8,22
33888,Papergaruru,illidan,762,priest,holy,30,8,22
33889,Uzakichan,arygos,760,priest,holy,30,8,22
33890,Priestognic,azralon,759,priest,holy,16,9,7
33891,Shadøwreaper,azralon,758,priest,holy,27,10,17
33892,Fäñcÿ,tichondrius,734,priest,holy,17,8,9
33893,Rylance,burning-blade,720,priest,holy,21,8,13
33894,Leist,ragnaros,719,priest,holy,24,9,15
33895,Msdash,tichondrius,717,priest,holy,15,8,7
33896,Saintfulsins,sargeras,716,priest,holy,15,8,7
33897,Amunsu,stormrage,711,priest,holy,30,11,19
33898,Messra,dathremar,707,priest,holy,30,8,22
33899,Jaytee,aggramar,703,priest,holy,14,9,5
33900,Humz,ragnaros,703,priest,holy,14,8,6
33901,Undevout,tichondrius,672,priest,holy,12,7,5
33902,Pevis,thrall,672,priest,holy,12,7,5
33903,Tewiyakichkn,tichondrius,672,priest,holy,12,7,5
33904,Hehehealyou,emerald-dream,672,priest,holy,12,7,5
33905,Canibumsmoke,illidan,672,priest,holy,12,7,5
33906,Qiahariya,emerald-dream,672,priest,holy,12,7,5
33907,Nwok,frostmourne,672,priest,holy,12,7,5
33908,Deevious,barthilas,672,priest,holy,12,7,5
33909,Pgpriest,kelthuzad,672,priest,holy,12,7,5
33910,Shadedlight,dalaran,672,priest,holy,12,7,5
33911,Beliana,boulderfist,672,priest,holy,16,8,8
33912,Selidri,proudmoore,672,priest,holy,18,7,11
33913,Nicksfury,stormrage,672,priest,holy,18,7,11
33914,Tylexus,tichondrius,672,priest,holy,18,7,11
33915,Drelia,jubeithos,672,priest,holy,24,7,17
33916,Xpenance,ragnaros,672,priest,holy,24,7,17
33917,Jordandoesnt,tichondrius,671,priest,holy,12,7,5
33918,Suppòrt,stormrage,671,priest,holy,12,7,5
33919,Deidre,illidan,671,priest,holy,16,8,8
33920,Braevera,wyrmrest-accord,671,priest,holy,18,7,11
33921,Cataline,emerald-dream,671,priest,holy,18,7,11
33922,Diablomonk,warsong,671,priest,holy,18,7,11
33923,Razakam,tichondrius,671,priest,holy,18,7,11
33924,Dankpope,malganis,670,priest,holy,12,7,5
33925,Exlord,illidan,670,priest,holy,12,7,5
33926,Lndsynbritny,darkspear,670,priest,holy,18,7,11
33927,Arena,lothar,669,priest,holy,12,7,5
33928,Context,mannoroth,669,priest,holy,12,7,5
33929,Skeyfyr,frostmourne,669,priest,holy,18,7,11
33930,Dëâth,ghostlands,669,priest,holy,21,8,13
33931,Klassy,thrall,668,priest,holy,17,8,9
33932,Kisstina,tichondrius,667,priest,holy,24,7,17
33933,Vichealer,firetree,660,priest,holy,12,7,5
33934,Yidra,illidan,623,priest,holy,17,7,10
33935,ßöp,sargeras,620,priest,holy,11,7,4
33936,Blackprez,dathremar,613,priest,holy,17,7,10
33937,Boogiedo,area-52,607,priest,holy,11,7,4
33938,Punishing,illidan,606,priest,holy,16,7,9
33939,Papadarkness,tichondrius,603,priest,holy,14,7,7
33940,Sizuré,frostmourne,591,priest,holy,11,7,4
33941,Ishtana,bleeding-hollow,584,priest,holy,17,9,8
33942,Hectorz,zuljin,576,priest,holy,6,6,0
33943,Chandracath,draktharon,576,priest,holy,6,6,0
33944,Archaellia,area-52,576,priest,holy,12,6,6
33945,Sìnz,area-52,576,priest,holy,12,6,6
33946,Sigx,area-52,576,priest,holy,12,6,6
33947,Everest,barthilas,576,priest,holy,12,6,6
33948,Jezebëll,nemesis,576,priest,holy,12,6,6
33949,Shockterror,area-52,576,priest,holy,12,6,6
33950,Lyleth,lightnings-blade,576,priest,holy,12,6,6
33951,Didntâsk,arthas,576,priest,holy,12,6,6
33952,Linvial,moon-guard,576,priest,holy,12,6,6
33953,Hysteria,dalaran,576,priest,holy,12,6,6
33954,Unsubbedd,sargeras,576,priest,holy,12,6,6
33955,Feverx,tichondrius,576,priest,holy,12,6,6
33956,Xtcbtc,sargeras,576,priest,holy,12,6,6
33957,Telarith,sargeras,576,priest,holy,12,6,6
33958,Calissy,proudmoore,576,priest,holy,12,6,6
33959,Zraken,emerald-dream,576,priest,holy,12,6,6
33960,Bootleg,crushridge,576,priest,holy,12,6,6
33961,Benedictiion,tichondrius,576,priest,holy,12,6,6
33962,Skylust,azralon,576,priest,holy,12,6,6
33963,Gustáv,sargeras,576,priest,holy,18,6,12
33964,Lolcrafthd,ragnaros,576,priest,holy,18,6,12
33965,Xhirra,quelthalas,576,priest,holy,18,6,12
33966,Atenai,sargeras,576,priest,holy,18,6,12
33967,Estaria,the-forgotten-coast,576,priest,holy,18,6,12
33968,Fertalize,maiev,576,priest,holy,24,6,18
33969,Youngwavy,area-52,575,priest,holy,12,6,6
33970,Mattkoster,mannoroth,575,priest,holy,12,6,6
33971,Handgina,frostmourne,575,priest,holy,12,6,6
33972,Healfouru,frostmourne,575,priest,holy,12,6,6
33973,Nevifell,area-52,575,priest,holy,13,6,7
33974,Kephrek,eonar,575,priest,holy,18,6,12
33975,Därkness,azralon,575,priest,holy,18,6,12
33976,Dundamer,shattered-hand,575,priest,holy,18,6,12
33977,Sêtsunà,dalaran,575,priest,holy,36,6,30
33978,Cassíopeía,blackhand,574,priest,holy,12,6,6
33979,Sacerdetiza,drakkari,574,priest,holy,12,6,6
33980,Laiya,nathrezim,574,priest,holy,15,6,9
33981,Ruhaani,moon-guard,574,priest,holy,18,6,12
33982,Aeoliana,laughing-skull,572,priest,holy,12,6,6
33983,Altara,malygos,569,priest,holy,12,6,6
33984,Zual,hakkar,569,priest,holy,12,6,6
33985,Sanntana,echo-isles,563,priest,holy,24,6,18
33986,Skalzi,thrall,559,priest,holy,11,6,5
33987,París,mannoroth,559,priest,holy,17,6,11
33988,Smellybox,area-52,558,priest,holy,19,7,12
33989,Satíva,dark-iron,543,priest,holy,11,6,5
33990,Eatsoupbro,tichondrius,543,priest,holy,17,6,11
33991,Albina,kelthuzad,526,priest,holy,11,6,5
33992,Jesaminealbe,quelthalas,516,priest,holy,21,7,14
33993,Trupriest,alleria,511,priest,holy,8,6,2
33994,Jâmïè,gurubashi,511,priest,holy,11,6,5
33995,Vandamnation,barthilas,511,priest,holy,14,6,8
33996,Helorren,nagrand,506,priest,holy,20,6,14
33997,Privx,bleeding-hollow,480,priest,holy,6,5,1
33998,Huxleypoo,boulderfist,480,priest,holy,6,5,1
33999,Malpraktice,mugthol,480,priest,holy,6,5,1
34000,Onion,garona,480,priest,holy,6,5,1
34001,Jaaregis,area-52,480,priest,holy,6,5,1
34002,Geartrixy,darkspear,480,priest,holy,6,5,1
34003,Design,frostmourne,480,priest,holy,8,5,3
34004,Toje,korgath,480,priest,holy,13,6,7
34005,Secrèt,tichondrius,480,priest,holy,12,5,7
34006,Meehx,illidan,480,priest,holy,12,5,7
34007,Shadowblazed,arthas,480,priest,holy,12,5,7
34008,Nzkbr,frostmourne,480,priest,holy,12,5,7
34009,Greytness,tichondrius,480,priest,holy,12,5,7
34010,Maelei,ragnaros,480,priest,holy,12,5,7
34011,Anahka,tichondrius,480,priest,holy,12,5,7
34012,Vaibye,dalaran,480,priest,holy,12,5,7
34013,Dumbthott,illidan,480,priest,holy,12,5,7
34014,Timbobaloo,thrall,480,priest,holy,12,5,7
34015,Xeras,ravencrest,480,priest,holy,12,5,7
34016,Turkings,proudmoore,480,priest,holy,12,5,7
34017,Gad,moon-guard,480,priest,holy,12,5,7
34018,Blackoss,sargeras,480,priest,holy,12,5,7
34019,Phatheals,proudmoore,480,priest,holy,12,5,7
34020,Buttercupx,vashj,480,priest,holy,12,5,7
34021,Anomoly,kiljaeden,480,priest,holy,12,5,7
34022,Steve,drakthul,480,priest,holy,12,5,7
34023,Írithyll,sargeras,480,priest,holy,12,5,7
34024,Rysie,winterhoof,480,priest,holy,12,5,7
34025,Bunnykinz,moon-guard,480,priest,holy,12,5,7
34026,Capriestsun,hydraxis,480,priest,holy,12,5,7
34027,Vaíl,wyrmrest-accord,480,priest,holy,12,5,7
34028,Drkwispers,stormrage,480,priest,holy,12,5,7
34029,Chûrch,malganis,480,priest,holy,18,5,13
34030,Holyharlot,sargeras,480,priest,holy,18,5,13
34031,Dankenz,darkspear,480,priest,holy,18,5,13
34032,Halfsorrow,tichondrius,480,priest,holy,18,5,13
34033,Nancynibbler,bleeding-hollow,480,priest,holy,24,5,19
34034,Tmturnt,tichondrius,479,priest,holy,10,5,5
34035,Miganmarkle,sargeras,479,priest,holy,12,5,7
34036,Threreye,sargeras,479,priest,holy,12,5,7
34037,Freshblubear,blood-furnace,479,priest,holy,12,5,7
34038,Dchi,tichondrius,479,priest,holy,12,5,7
34039,Pûrplehaze,aegwynn,479,priest,holy,12,5,7
34040,Mímì,wyrmrest-accord,479,priest,holy,12,5,7
34041,Mythica,gurubashi,479,priest,holy,18,5,13
34042,Pactru,ragnaros,479,priest,holy,18,5,13
34043,Unni,azralon,479,priest,holy,18,5,13
34044,Asuryani,lightbringer,477,priest,holy,12,5,7
34045,Jeraphìm,tichondrius,447,priest,holy,18,9,9
34046,Shadowchárm,bleeding-hollow,447,priest,holy,11,5,6
34047,Enzö,frostmourne,424,priest,holy,21,7,14
34048,Nolar,shadowmoon,415,priest,holy,11,5,6
34049,Ticheals,tichondrius,384,priest,holy,6,4,2
34050,Arcmage,malganis,384,priest,holy,6,4,2
34051,Khallmir,goldrinn,384,priest,holy,6,4,2
34052,Tiestô,tichondrius,384,priest,holy,6,4,2
34053,Xusin,tichondrius,384,priest,holy,6,4,2
34054,Schátten,spirestone,384,priest,holy,6,4,2
34055,Yav,exodar,384,priest,holy,6,4,2
34056,Faukauf,zuljin,384,priest,holy,6,4,2
34057,Thünderbird,area-52,384,priest,holy,6,4,2
34058,Dookieate,destromath,384,priest,holy,6,4,2
34059,Halfdeath,sargeras,384,priest,holy,6,4,2
34060,Chanyt,azralon,384,priest,holy,6,4,2
34061,Zallp,sargeras,384,priest,holy,6,4,2
34062,Patchyemoly,frostmourne,384,priest,holy,6,4,2
34063,Unholywood,lightbringer,384,priest,holy,10,5,5
34064,Döyöuliftbro,tichondrius,384,priest,holy,12,4,8
34065,Spags,nagrand,384,priest,holy,12,4,8
34066,Hoglet,moon-guard,384,priest,holy,12,4,8
34067,Hazzang,tichondrius,384,priest,holy,12,4,8
34068,Yumä,kiljaeden,384,priest,holy,12,4,8
34069,Sätîvá,tichondrius,384,priest,holy,12,4,8
34070,Depressednun,moon-guard,384,priest,holy,12,4,8
34071,Rofrofmu,aegwynn,384,priest,holy,12,4,8
34072,Salyd,onyxia,384,priest,holy,12,4,8
34073,Darknuzs,sargeras,384,priest,holy,12,4,8
34074,Râven,proudmoore,384,priest,holy,12,4,8
34075,Frozencherry,elune,384,priest,holy,12,4,8
34076,Voidrachet,thrall,384,priest,holy,12,4,8
34077,Zapix,tichondrius,384,priest,holy,12,4,8
34078,Carti,bleeding-hollow,384,priest,holy,12,4,8
34079,Ithardtoheal,sargeras,384,priest,holy,12,4,8
34080,Mellow,tichondrius,384,priest,holy,12,4,8
34081,Spshady,aegwynn,384,priest,holy,12,4,8
34082,Cheeseycake,illidan,384,priest,holy,12,4,8
34083,Chambler,aegwynn,384,priest,holy,18,4,14
34084,Aeøns,sargeras,384,priest,holy,18,4,14
34085,Pavle,laughing-skull,384,priest,holy,19,4,15
34086,Fesix,akama,383,priest,holy,6,4,2
34087,Healia,tichondrius,383,priest,holy,12,4,8
34088,Dyianah,wyrmrest-accord,383,priest,holy,12,4,8
34089,Zeruhl,kiljaeden,382,priest,holy,12,4,8
34090,Remixcandoit,malganis,379,priest,holy,12,4,8
34091,Brownsnooter,sargeras,367,priest,holy,11,4,7
34092,Stradey,tichondrius,367,priest,holy,11,4,7
34093,Sharkda,frostmourne,350,priest,holy,17,4,13
34094,Santamuerte,agamaggan,336,priest,holy,15,4,11
34095,Enzö,illidan,327,priest,holy,25,8,17
34096,Rybbukk,wyrmrest-accord,319,priest,holy,11,4,7
34097,Kabutta,stormrage,318,priest,holy,14,4,10
34098,Wubbi,blackrock,288,priest,holy,6,3,3
34099,Vynlanesh,illidan,288,priest,holy,6,3,3
34100,Epicnoobpwnr,sargeras,288,priest,holy,6,3,3
34101,Foreva,lightbringer,288,priest,holy,6,3,3
34102,Trying,ysera,288,priest,holy,6,3,3
34103,Ñÿx,arthas,288,priest,holy,6,3,3
34104,Oohso,chogall,288,priest,holy,6,3,3
34105,Laurens,fenris,288,priest,holy,6,3,3
34106,Yokoshukumeì,aerie-peak,288,priest,holy,6,3,3
34107,Cessar,proudmoore,288,priest,holy,6,3,3
34108,Purgeoften,sargeras,288,priest,holy,6,3,3
34109,Glycol,illidan,288,priest,holy,6,3,3
34110,Kittler,illidan,288,priest,holy,6,3,3
34111,Franquitó,illidan,288,priest,holy,6,3,3
34112,Asatruu,stormrage,288,priest,holy,6,3,3
34113,Arguseonp,proudmoore,288,priest,holy,6,3,3
34114,Barclan,destromath,288,priest,holy,6,3,3
34115,Orderic,ragnaros,288,priest,holy,6,3,3
34116,Sagapriest,hyjal,288,priest,holy,6,3,3
34117,Smiteyducks,stormrage,288,priest,holy,6,3,3
34118,Healdog,thrall,288,priest,holy,6,3,3
34119,Roseriela,moon-guard,288,priest,holy,6,3,3
34120,Shwayp,zuljin,288,priest,holy,6,3,3
34121,Charbosan,gorgonnash,288,priest,holy,6,3,3
34122,Rbmxp,barthilas,288,priest,holy,6,3,3
34123,Zesho,firetree,288,priest,holy,6,3,3
34124,Dividëd,stormrage,288,priest,holy,6,3,3
34125,Matiuca,stormrage,288,priest,holy,6,3,3
34126,Shredh,tichondrius,288,priest,holy,6,3,3
34127,Whitewalls,moonrunner,288,priest,holy,6,3,3
34128,Discountay,burning-legion,288,priest,holy,6,3,3
34129,Opeli,stormrage,288,priest,holy,6,3,3
34130,Mucada,tichondrius,288,priest,holy,6,3,3
34131,Calvisper,thunderlord,288,priest,holy,6,3,3
34132,Bagoheals,area-52,288,priest,holy,6,3,3
34133,Palastiel,hyjal,288,priest,holy,6,3,3
34134,Tseirpyeroc,area-52,288,priest,holy,6,3,3
34135,Ärchangél,tichondrius,288,priest,holy,6,3,3
34136,Kustem,tichondrius,288,priest,holy,6,3,3
34137,Crypthion,emerald-dream,288,priest,holy,6,3,3
34138,Alwaystry,tichondrius,288,priest,holy,6,3,3
34139,Meatguzzler,tichondrius,288,priest,holy,6,3,3
34140,Whehaw,kelthuzad,288,priest,holy,6,3,3
34141,Aardyx,frostmourne,288,priest,holy,6,3,3
34142,Plánemo,azralon,288,priest,holy,6,3,3
34143,Darkmoonsun,frostmourne,288,priest,holy,6,3,3
34144,Grindr,ragnaros,288,priest,holy,6,3,3
34145,Nerfdisc,azralon,288,priest,holy,6,3,3
34146,Deeznuhh,tichondrius,288,priest,holy,6,3,3
34147,Dunrirck,quelthalas,288,priest,holy,6,3,3
34148,Whitezz,frostmourne,288,priest,holy,6,3,3
34149,Lullabya,tichondrius,288,priest,holy,6,3,3
34150,Smalltoad,lightnings-blade,288,priest,holy,6,3,3
34151,Greet,hyjal,288,priest,holy,6,3,3
34152,Zombyrot,tichondrius,288,priest,holy,6,3,3
34153,Muertabella,kiljaeden,288,priest,holy,6,3,3
34154,Iamjakehill,area-52,288,priest,holy,9,4,5
34155,Likelydapper,tichondrius,288,priest,holy,7,3,4
34156,Lifesvr,kiljaeden,288,priest,holy,12,3,9
34157,Holyvulpin,barthilas,288,priest,holy,12,3,9
34158,Lalight,tichondrius,288,priest,holy,12,3,9
34159,Murderballad,tichondrius,288,priest,holy,12,3,9
34160,Healiûm,bleeding-hollow,288,priest,holy,12,3,9
34161,Hòwen,tichondrius,288,priest,holy,12,3,9
34162,Disperse,vashj,288,priest,holy,12,3,9
34163,Sarkozzlol,tichondrius,288,priest,holy,12,3,9
34164,Jichu,blackrock,288,priest,holy,12,3,9
34165,Øliverxp,lightbringer,288,priest,holy,12,3,9
34166,Smitepie,malganis,288,priest,holy,12,3,9
34167,Mushtakraken,mugthol,288,priest,holy,12,3,9
34168,Ísábella,ragnaros,288,priest,holy,12,3,9
34169,Haedn,azralon,288,priest,holy,12,3,9
34170,Zhadowbolts,thrall,288,priest,holy,12,3,9
34171,Irilde,proudmoore,288,priest,holy,12,3,9
34172,Pèngotnerfed,exodar,288,priest,holy,12,3,9
34173,Jezuz,aerie-peak,288,priest,holy,12,3,9
34174,Vyvanse,azuremyst,288,priest,holy,18,3,15
34175,Pringlés,suramar,288,priest,holy,24,3,21
34176,Fìngerbanger,lightnings-blade,287,priest,holy,6,3,3
34177,Korhíl,ragnaros,287,priest,holy,6,3,3
34178,Auradaluz,stormrage,287,priest,holy,12,3,9
34179,Mikeliteo,blades-edge,283,priest,holy,18,3,15
34180,Titò,tichondrius,239,priest,holy,13,4,9
34181,Bofin,stormrage,234,priest,holy,16,4,12
34182,Ftheman,tichondrius,234,priest,holy,17,4,13
34183,Halö,doomhammer,223,priest,holy,14,3,11
34184,Damokek,tichondrius,192,priest,holy,9,3,6
34185,Yevøn,ragnaros,192,priest,holy,6,2,4
34186,Mindgoblin,terokkar,192,priest,holy,6,2,4
34187,Tuulipp,aegwynn,192,priest,holy,6,2,4
34188,Jilt,aerie-peak,192,priest,holy,6,2,4
34189,Dentwo,aggramar,192,priest,holy,6,2,4
34190,Niftÿ,tichondrius,192,priest,holy,6,2,4
34191,Hypodontia,caelestrasz,192,priest,holy,6,2,4
34192,Wagnerr,jubeithos,192,priest,holy,6,2,4
34193,Jakemies,arathor,192,priest,holy,6,2,4
34194,Hansa,ragnaros,192,priest,holy,6,2,4
34195,Lavigne,tichondrius,192,priest,holy,6,2,4
34196,Shemhazai,ragnaros,192,priest,holy,6,2,4
34197,Sensitive,eitrigg,192,priest,holy,6,2,4
34198,Felmnir,ragnaros,192,priest,holy,6,2,4
34199,Invisibler,tichondrius,192,priest,holy,6,2,4
34200,Igotubrah,malganis,192,priest,holy,6,2,4
34201,Mommyafk,moon-guard,192,priest,holy,6,2,4
34202,Karmapi,malganis,192,priest,holy,6,2,4
34203,Dorraheals,tichondrius,192,priest,holy,6,2,4
34204,Schatzié,malganis,192,priest,holy,6,2,4
34205,Belfortx,tichondrius,192,priest,holy,6,2,4
34206,Aeroalisson,azralon,192,priest,holy,6,2,4
34207,Arodar,wyrmrest-accord,192,priest,holy,6,2,4
34208,Gusho,frostmourne,192,priest,holy,6,2,4
34209,Gles,quelthalas,192,priest,holy,6,2,4
34210,Skeemask,moon-guard,192,priest,holy,6,2,4
34211,Mamabless,quelthalas,192,priest,holy,6,2,4
34212,Dëëdëëpants,moon-guard,192,priest,holy,6,2,4
34213,Nodorme,quelthalas,192,priest,holy,6,2,4
34214,Aethriem,bleeding-hollow,192,priest,holy,6,2,4
34215,Verboden,kelthuzad,192,priest,holy,6,2,4
34216,Mitras,moon-guard,192,priest,holy,6,2,4
34217,Starzard,kelthuzad,192,priest,holy,6,2,4
34218,Angelface,darkspear,192,priest,holy,6,2,4
34219,Mutedox,frostmourne,192,priest,holy,6,2,4
34220,Jonhey,tichondrius,192,priest,holy,6,2,4
34221,Drippyjoones,sargeras,192,priest,holy,6,2,4
34222,Keicel,zuljin,192,priest,holy,6,2,4
34223,Whitelabel,proudmoore,192,priest,holy,6,2,4
34224,ßræcher,black-dragonflight,192,priest,holy,6,2,4
34225,Voltstein,dalaran,192,priest,holy,6,2,4
34226,Nikci,tichondrius,192,priest,holy,6,2,4
34227,Opas,rivendare,192,priest,holy,6,2,4
34228,Ôp,sargeras,192,priest,holy,6,2,4
34229,Nonbinary,trollbane,192,priest,holy,6,2,4
34230,Dayatthaspa,stormrage,192,priest,holy,6,2,4
34231,Pandap,dalaran,192,priest,holy,6,2,4
34232,Saenax,area-52,192,priest,holy,6,2,4
34233,Mendx,tichondrius,192,priest,holy,6,2,4
34234,Mizriz,emerald-dream,192,priest,holy,6,2,4
34235,Bilbopriest,illidan,192,priest,holy,6,2,4
34236,Silentprayer,area-52,192,priest,holy,6,2,4
34237,Speyside,medivh,192,priest,holy,6,2,4
34238,Swipathefox,tichondrius,192,priest,holy,6,2,4
34239,Lebwonjamdi,tichondrius,192,priest,holy,6,2,4
34240,Daddyhammer,area-52,192,priest,holy,6,2,4
34241,Prescella,sargeras,192,priest,holy,6,2,4
34242,Mevix,firetree,192,priest,holy,6,2,4
34243,Eblis,the-underbog,192,priest,holy,6,2,4
34244,Saintguard,tichondrius,192,priest,holy,11,3,8
34245,Langyi,tichondrius,192,priest,holy,10,2,8
34246,Nevertelsp,malganis,192,priest,holy,12,2,10
34247,Excellency,tichondrius,192,priest,holy,12,2,10
34248,Fraggydaddy,frostmourne,192,priest,holy,12,2,10
34249,Okitoki,tichondrius,192,priest,holy,12,2,10
34250,Althir,ragnaros,192,priest,holy,12,2,10
34251,Pinoculus,illidan,192,priest,holy,12,2,10
34252,Dawnwind,warsong,192,priest,holy,12,2,10
34253,Bigtizzle,illidan,192,priest,holy,12,2,10
34254,Påticus,area-52,192,priest,holy,13,2,11
34255,Gillís,thrall,192,priest,holy,18,2,16
34256,Postymalone,azgalor,191,priest,holy,6,2,4
34257,Lohila,kiljaeden,191,priest,holy,8,2,6
34258,Sneaks,frostmourne,159,priest,holy,5,2,3
34259,Identìty,moon-guard,138,priest,holy,8,3,5
34260,Sweetvoyeur,stormrage,138,priest,holy,9,3,6
34261,Pumpss,area-52,138,priest,holy,11,3,8
34262,Bigvuqoffdam,area-52,138,priest,holy,16,3,13
34263,Denarel,frostmourne,137,priest,holy,17,4,13
34264,Pasmalade,zuljin,112,priest,holy,7,2,5
34265,Lilpaprika,sargeras,96,priest,holy,6,1,5
34266,Vøido,whisperwind,96,priest,holy,6,1,5
34267,Grasy,ragnaros,96,priest,holy,6,1,5
34268,Shadyvoodoo,barthilas,96,priest,holy,6,1,5
34269,Lerien,thrall,96,priest,holy,6,1,5
34270,Yungmazikeen,proudmoore,96,priest,holy,6,1,5
34271,Acpriest,tichondrius,96,priest,holy,6,1,5
34272,Bofuri,barthilas,96,priest,holy,6,1,5
34273,Majjic,proudmoore,96,priest,holy,6,1,5
34274,Sukmysplooge,queldorei,96,priest,holy,6,1,5
34275,Dontgome,proudmoore,96,priest,holy,6,1,5
34276,Tammyone,emerald-dream,96,priest,holy,6,1,5
34277,Janova,tichondrius,96,priest,holy,6,1,5
34278,Luciellis,sargeras,96,priest,holy,6,1,5
34279,Missjules,illidan,96,priest,holy,6,1,5
34280,Kastwalker,earthen-ring,96,priest,holy,6,1,5
34281,Angelicduck,illidan,96,priest,holy,6,1,5
34282,Thorzan,eredar,96,priest,holy,6,1,5
34283,Kagura,dunemaul,96,priest,holy,6,1,5
34284,Minamy,tichondrius,96,priest,holy,6,1,5
34285,Hubbabubble,wyrmrest-accord,96,priest,holy,6,1,5
34286,Alëssana,illidan,96,priest,holy,6,1,5
34287,Rakel,nathrezim,96,priest,holy,6,1,5
34288,Deryus,dalaran,96,priest,holy,6,1,5
34289,Viehweg,azralon,96,priest,holy,6,1,5
34290,Tuuros,wyrmrest-accord,96,priest,holy,6,1,5
34291,Voodooloa,tichondrius,96,priest,holy,6,1,5
34292,Burpees,dalaran,96,priest,holy,6,1,5
34293,Bloodcure,ysera,96,priest,holy,6,1,5
34294,Thotsteal,lightbringer,96,priest,holy,6,1,5
34295,Hiroshikun,azshara,96,priest,holy,6,1,5
34296,Dietcokee,stormrage,96,priest,holy,6,1,5
34297,Chrystella,nagrand,96,priest,holy,6,1,5
34298,Yungsherm,tichondrius,96,priest,holy,6,1,5
34299,Bunked,bleeding-hollow,96,priest,holy,6,1,5
34300,Olassi,stormrage,96,priest,holy,6,1,5
34301,Lasaldra,quelthalas,96,priest,holy,6,1,5
34302,Sarïya,moon-guard,96,priest,holy,6,1,5
34303,Alaskaa,moon-guard,96,priest,holy,6,1,5
34304,Milkymana,tichondrius,96,priest,holy,6,1,5
34305,Burtier,zuljin,96,priest,holy,6,1,5
34306,Akami,tichondrius,96,priest,holy,6,1,5
34307,Hottaters,tichondrius,96,priest,holy,6,1,5
34308,Tichealstwo,tichondrius,96,priest,holy,6,1,5
34309,Bigboyadam,frostmourne,96,priest,holy,6,1,5
34310,Alvorr,ragnaros,96,priest,holy,6,1,5
34311,Novoul,stormrage,96,priest,holy,6,1,5
34312,Faithmelter,stormrage,96,priest,holy,6,1,5
34313,Hüde,stormrage,96,priest,holy,6,1,5
34314,Djriest,sargeras,96,priest,holy,12,1,11
34315,Gutrose,area-52,96,priest,holy,12,1,11
34316,Donmartin,tichondrius,96,priest,holy,12,1,11
34317,Barryp,wyrmrest-accord,96,priest,holy,12,1,11
34318,Wiralyn,nathrezim,79,priest,holy,11,1,10
34319,Undrcvr,sargeras,2273,priest,discipline,132,73,59
34320,Èfflux,sargeras,2257,priest,discipline,103,61,42
34321,Whammiez,tichondrius,2243,priest,discipline,84,50,34
34322,Gentlewoman,ragnaros,2236,priest,discipline,93,56,37
34323,Strickmaney,nathrezim,2157,priest,discipline,294,156,138
34324,Pesian,dalaran,2153,priest,discipline,233,121,112
34325,Yefri,ravencrest,2147,priest,discipline,201,114,87
34326,Reedyjrrtv,tichondrius,2145,priest,discipline,168,88,80
34327,Cinnamontage,illidan,2142,priest,discipline,114,64,50
34328,Castsmite,tichondrius,2141,priest,discipline,99,52,47
34329,Solecíto,ragnaros,2138,priest,discipline,165,106,59
34330,Shikinomi,illidan,2133,priest,discipline,78,46,32
34331,Shazdo,illidan,2128,priest,discipline,66,44,22
34332,Reecepack,moon-guard,2126,priest,discipline,89,49,40
34333,Wcnmb,blackrock,2123,priest,discipline,72,46,26
34334,Jiangfeng,tichondrius,2120,priest,discipline,72,37,35
34335,Devinere,tichondrius,2119,priest,discipline,580,317,263
34336,Celestiah,kelthuzad,2119,priest,discipline,72,37,35
34337,Zxxkawaii,tichondrius,2118,priest,discipline,169,90,79
34338,Rukiyou,frostwolf,2117,priest,discipline,210,105,105
34339,Baldzx,sargeras,2116,priest,discipline,292,160,132
34340,Idkmyname,proudmoore,2115,priest,discipline,76,40,36
34341,Nusrah,tichondrius,2114,priest,discipline,87,45,42
34342,Twocrshort,area-52,2112,priest,discipline,185,110,75
34343,Frksake,area-52,2111,priest,discipline,192,114,78
34344,Sylvphrena,stormrage,2111,priest,discipline,78,42,36
34345,Klydasoreass,malganis,2107,priest,discipline,83,47,36
34346,Kovulol,area-52,2107,priest,discipline,126,67,59
34347,Néylo,illidan,2106,priest,discipline,112,56,56
34348,Psyches,dalaran,2106,priest,discipline,109,50,59
34349,Kkelly,stormrage,2105,priest,discipline,257,131,126
34350,Amberturd,cenarius,2103,priest,discipline,102,48,54
34351,Woolp,frostmourne,2102,priest,discipline,100,58,42
34352,Changwongpk,kelthuzad,2101,priest,discipline,237,124,113
34353,Søryn,madoran,2100,priest,discipline,108,55,53
34354,Veivei,tichondrius,2095,priest,discipline,59,38,21
34355,Proxs,sargeras,2079,priest,discipline,234,121,113
34356,Ante,stonemaul,2075,priest,discipline,108,59,49
34357,Pancakeboi,tichondrius,2070,priest,discipline,131,64,67
34358,Cosmicyiff,area-52,2062,priest,discipline,212,115,97
34359,Classmaster,stormrage,2054,priest,discipline,183,100,83
34360,Soupbean,zuljin,2046,priest,discipline,90,45,45
34361,Esqueue,illidan,2044,priest,discipline,54,26,28
34362,Leorid,stormrage,2043,priest,discipline,196,99,97
34363,Veiveilol,tichondrius,2038,priest,discipline,89,42,47
34364,Lemonmint,tichondrius,2035,priest,discipline,154,76,78
34365,Clearclouds,tichondrius,2025,priest,discipline,332,176,156
34366,Astroverse,tichondrius,2024,priest,discipline,118,67,51
34367,Crutched,blackhand,2022,priest,discipline,60,35,25
34368,Bholebender,tichondrius,2022,priest,discipline,101,50,51
34369,Zámmy,area-52,2021,priest,discipline,65,44,21
34370,Praemal,tichondrius,2017,priest,discipline,102,47,55
34371,Blessxo,ragnaros,2016,priest,discipline,96,45,51
34372,Mauvex,stormrage,2014,priest,discipline,631,307,324
34373,Eluneslight,tichondrius,2012,priest,discipline,108,55,53
34374,Poporeborn,tichondrius,2012,priest,discipline,247,124,123
34375,Instoway,illidan,2011,priest,discipline,168,98,70
34376,Houseaddict,illidan,2011,priest,discipline,109,60,49
34377,Adûnaic,frostmourne,2011,priest,discipline,463,232,231
34378,Rmpmeeper,kilrogg,2008,priest,discipline,132,72,60
34379,Jiangfenglol,tichondrius,2006,priest,discipline,156,74,82
34380,Reilacoste,moon-guard,2002,priest,discipline,83,41,42
34381,Sÿnpriest,illidan,2000,priest,discipline,426,209,217
34382,Xajen,illidan,1996,priest,discipline,84,39,45
34383,Nucypher,illidan,1993,priest,discipline,204,118,86
34384,Boykoz,zuljin,1990,priest,discipline,163,84,79
34385,Markers,spinebreaker,1989,priest,discipline,130,64,66
34386,Sinthe,stormrage,1987,priest,discipline,59,34,25
34387,Jakemies,arathor,1983,priest,discipline,96,52,44
34388,Nerfthedoc,blackrock,1981,priest,discipline,79,46,33
34389,Crabsp,illidan,1981,priest,discipline,132,68,64
34390,Smokezter,area-52,1981,priest,discipline,159,81,78
34391,Crutch,blackhand,1980,priest,discipline,54,30,24
34392,Etharass,illidan,1976,priest,discipline,84,36,48
34393,Dayx,malganis,1975,priest,discipline,108,54,54
34394,Høwtokill,azralon,1975,priest,discipline,179,83,96
34395,Néy,illidan,1974,priest,discipline,78,54,24
34396,Fhenomenal,tichondrius,1972,priest,discipline,126,57,69
34397,Cklifer,tichondrius,1970,priest,discipline,58,33,25
34398,Azzäm,tichondrius,1970,priest,discipline,90,48,42
34399,Goodlife,frostmourne,1967,priest,discipline,71,34,37
34400,Robdàwg,illidan,1966,priest,discipline,78,39,39
34401,Kayern,kelthuzad,1965,priest,discipline,58,38,20
34402,Fannyny,tichondrius,1965,priest,discipline,202,116,86
34403,Peruggia,tichondrius,1965,priest,discipline,157,79,78
34404,Jthealz,tichondrius,1962,priest,discipline,72,36,36
34405,Muhfinx,tichondrius,1961,priest,discipline,65,38,27
34406,Aratis,bleeding-hollow,1961,priest,discipline,90,44,46
34407,Stinkiez,area-52,1956,priest,discipline,207,116,91
34408,Hospetal,tichondrius,1955,priest,discipline,146,74,72
34409,Ogneus,crushridge,1955,priest,discipline,75,35,40
34410,Curachon,darkspear,1953,priest,discipline,105,48,57
34411,Awàken,sargeras,1952,priest,discipline,57,35,22
34412,Sonicboomsz,azralon,1952,priest,discipline,128,64,64
34413,Iilmama,area-52,1948,priest,discipline,105,55,50
34414,Miamama,hydraxis,1946,priest,discipline,165,88,77
34415,Hairyleg,kelthuzad,1946,priest,discipline,78,36,42
34416,Deathblind,kelthuzad,1945,priest,discipline,95,48,47
34417,Wapriest,blades-edge,1943,priest,discipline,581,294,287
34418,Gosharbg,tichondrius,1940,priest,discipline,34,24,10
34419,Amine,tichondrius,1940,priest,discipline,108,55,53
34420,Sarkozzlol,tichondrius,1938,priest,discipline,84,43,41
34421,Mimz,trollbane,1936,priest,discipline,172,88,84
34422,Praeyer,area-52,1936,priest,discipline,386,196,190
34423,Penanceperry,bleeding-hollow,1936,priest,discipline,292,141,151
34424,Supaflute,tichondrius,1935,priest,discipline,102,47,55
34425,Plaedo,stormscale,1932,priest,discipline,52,28,24
34426,Fádé,illidan,1932,priest,discipline,97,48,49
34427,Noted,aegwynn,1931,priest,discipline,158,101,57
34428,Namilol,tichondrius,1931,priest,discipline,54,30,24
34429,Darkvss,illidan,1929,priest,discipline,72,39,33
34430,Donmartin,tichondrius,1929,priest,discipline,94,50,44
34431,Kalyndaxo,frostmourne,1928,priest,discipline,102,51,51
34432,Budings,tichondrius,1927,priest,discipline,143,77,66
34433,Velftrixi,sargeras,1927,priest,discipline,180,94,86
34434,Stepxo,sargeras,1925,priest,discipline,129,68,61
34435,Hectorz,zuljin,1925,priest,discipline,136,62,74
34436,Ccgo,tichondrius,1924,priest,discipline,142,72,70
34437,Alisas,malganis,1924,priest,discipline,190,90,100
34438,Balsak,zuljin,1924,priest,discipline,152,72,80
34439,Antts,tichondrius,1922,priest,discipline,60,39,21
34440,Lovelike,tichondrius,1922,priest,discipline,74,41,33
34441,Invincible,ragnaros,1919,priest,discipline,94,51,43
34442,Diabloluckie,tichondrius,1919,priest,discipline,120,62,58
34443,Vinnydiesel,tichondrius,1918,priest,discipline,66,32,34
34444,Likethis,ragnaros,1916,priest,discipline,484,246,238
34445,Fotmvark,stormrage,1916,priest,discipline,78,36,42
34446,Evicereith,ragnaros,1915,priest,discipline,54,29,25
34447,Yeeseafood,tichondrius,1913,priest,discipline,76,34,42
34448,Anasuzana,stormrage,1911,priest,discipline,66,38,28
34449,Artíst,sargeras,1911,priest,discipline,119,64,55
34450,Rawze,tichondrius,1911,priest,discipline,93,44,49
34451,Varenon,stormrage,1910,priest,discipline,159,90,69
34452,Tinyheal,sargeras,1910,priest,discipline,202,109,93
34453,Bearfriend,malorne,1910,priest,discipline,58,30,28
34454,Qipriest,tichondrius,1909,priest,discipline,90,40,50
34455,Shallwedance,tichondrius,1906,priest,discipline,86,50,36
34456,Omhz,tichondrius,1905,priest,discipline,96,49,47
34457,Cosenzza,tichondrius,1905,priest,discipline,78,37,41
34458,Snackermz,tichondrius,1905,priest,discipline,136,61,75
34459,Sabalonely,tichondrius,1904,priest,discipline,54,24,30
34460,Dairy,the-underbog,1902,priest,discipline,61,37,24
34461,Aitri,hakkar,1902,priest,discipline,193,94,99
34462,Fotmtrash,the-underbog,1897,priest,discipline,48,26,22
34463,Praitne,tichondrius,1897,priest,discipline,119,59,60
34464,Riseandshine,illidan,1896,priest,discipline,54,38,16
34465,Pølupoker,illidan,1895,priest,discipline,59,27,32
34466,Boriz,frostmourne,1892,priest,discipline,79,44,35
34467,Zerorizz,tichondrius,1890,priest,discipline,42,20,22
34468,Ndzy,malganis,1890,priest,discipline,48,21,27
34469,Niniua,tichondrius,1887,priest,discipline,47,25,22
34470,Eudog,zuljin,1886,priest,discipline,24,20,4
34471,Athênå,tichondrius,1886,priest,discipline,192,110,82
34472,Haunting,nerzhul,1886,priest,discipline,209,103,106
34473,Discopenguin,kelthuzad,1885,priest,discipline,60,34,26
34474,Usefirstaid,sargeras,1883,priest,discipline,42,26,16
34475,Grimacê,sargeras,1883,priest,discipline,122,62,60
34476,Cupitan,tichondrius,1883,priest,discipline,62,27,35
34477,Drnn,thrall,1882,priest,discipline,132,70,62
34478,Abt,proudmoore,1882,priest,discipline,66,31,35
34479,Usedwrap,sargeras,1881,priest,discipline,78,43,35
34480,Throatgoated,moon-guard,1881,priest,discipline,47,21,26
34481,Rubymisfit,sargeras,1881,priest,discipline,84,37,47
34482,Xiaoqunzi,tichondrius,1879,priest,discipline,167,81,86
34483,Hugemilkys,tichondrius,1878,priest,discipline,136,77,59
34484,Cremona,tichondrius,1878,priest,discipline,84,39,45
34485,Jangbi,tichondrius,1877,priest,discipline,76,33,43
34486,Breakmoon,tichondrius,1876,priest,discipline,78,33,45
34487,Chee,bleeding-hollow,1875,priest,discipline,72,39,33
34488,Sñ,illidan,1874,priest,discipline,48,27,21
34489,Reydehaiti,ragnaros,1874,priest,discipline,247,121,126
34490,Rileymcgerr,tichondrius,1873,priest,discipline,42,24,18
34491,Fordranger,frostmourne,1873,priest,discipline,64,32,32
34492,Redonkulos,wyrmrest-accord,1873,priest,discipline,210,102,108
34493,Dellaptop,sargeras,1871,priest,discipline,88,51,37
34494,Capcana,tichondrius,1871,priest,discipline,140,74,66
34495,Hadoka,ragnaros,1871,priest,discipline,66,29,37
34496,Renfury,bleeding-hollow,1869,priest,discipline,54,25,29
34497,Montagehey,illidan,1868,priest,discipline,83,43,40
34498,ßeyonder,tichondrius,1868,priest,discipline,146,69,77
34499,Layons,nemesis,1867,priest,discipline,146,93,53
34500,Candyshack,area-52,1867,priest,discipline,117,66,51
34501,Lidoradra,zuljin,1867,priest,discipline,77,36,41
34502,Walterwhite,bleeding-hollow,1867,priest,discipline,48,22,26
34503,Bkwhopper,emerald-dream,1866,priest,discipline,239,130,109
34504,Meloxicamm,tichondrius,1866,priest,discipline,233,118,115
34505,Notatk,tichondrius,1866,priest,discipline,221,99,122
34506,Wheresmyvape,tichondrius,1865,priest,discipline,38,22,16
34507,Xtcbtc,sargeras,1865,priest,discipline,99,50,49
34508,Tiestô,tichondrius,1864,priest,discipline,48,29,19
34509,Pitayakiller,tichondrius,1864,priest,discipline,59,32,27
34510,Syllè,area-52,1864,priest,discipline,54,27,27
34511,Shugelol,tichondrius,1862,priest,discipline,30,21,9
34512,Rèvrin,sargeras,1862,priest,discipline,114,56,58
34513,Spoõks,darkspear,1862,priest,discipline,141,69,72
34514,Tormybew,illidan,1861,priest,discipline,53,29,24
34515,Cokeheals,tichondrius,1861,priest,discipline,60,29,31
34516,Eyolo,tichondrius,1860,priest,discipline,144,70,74
34517,Bubblekanush,tichondrius,1859,priest,discipline,36,22,14
34518,Quaree,stormrage,1859,priest,discipline,716,366,350
34519,Thefiveoh,malganis,1858,priest,discipline,62,38,24
34520,Usebindwound,sargeras,1857,priest,discipline,108,65,43
34521,Highskrizzle,thrall,1857,priest,discipline,67,37,30
34522,Duw,icecrown,1857,priest,discipline,151,75,76
34523,Phludd,malganis,1856,priest,discipline,82,45,37
34524,Ravnica,kelthuzad,1856,priest,discipline,82,43,39
34525,Pregnantmale,area-52,1856,priest,discipline,214,112,102
34526,Mumrah,antonidas,1856,priest,discipline,148,71,77
34527,Presence,blood-furnace,1855,priest,discipline,42,23,19
34528,Vànhendrix,tichondrius,1855,priest,discipline,59,32,27
34529,Shadey,onyxia,1855,priest,discipline,54,26,28
34530,Nayzoh,darkspear,1855,priest,discipline,78,37,41
34531,Vidzar,area-52,1854,priest,discipline,42,28,14
34532,Drsquiddy,tichondrius,1854,priest,discipline,47,30,17
34533,Stayspooked,moon-guard,1852,priest,discipline,54,31,23
34534,Jtheals,illidan,1852,priest,discipline,35,20,15
34535,Yaksa,proudmoore,1852,priest,discipline,78,35,43
34536,Centalinkxo,frostmourne,1851,priest,discipline,72,36,36
34537,Curney,stormrage,1850,priest,discipline,71,51,20
34538,Joezyxz,tichondrius,1850,priest,discipline,210,111,99
34539,Shieldspamx,tichondrius,1850,priest,discipline,89,41,48
34540,Mautmaut,quelthalas,1849,priest,discipline,77,53,24
34541,Whiterhino,spirestone,1849,priest,discipline,67,32,35
34542,Corvenna,zuljin,1848,priest,discipline,60,33,27
34543,Lumies,tichondrius,1848,priest,discipline,42,21,21
34544,Polarnight,zuljin,1848,priest,discipline,59,29,30
34545,Paidtowin,frostmourne,1848,priest,discipline,68,30,38
34546,Chiot,tichondrius,1847,priest,discipline,71,55,16
34547,Bigshieldlol,illidan,1847,priest,discipline,60,39,21
34548,Chromielol,tichondrius,1847,priest,discipline,54,31,23
34549,Tzïñåçåñ,tichondrius,1847,priest,discipline,54,29,25
34550,Didy,dark-iron,1847,priest,discipline,82,39,43
34551,Voidnoodles,area-52,1846,priest,discipline,60,32,28
34552,Ultradumb,ragnaros,1846,priest,discipline,42,21,21
34553,Jmjeezy,tichondrius,1846,priest,discipline,48,22,26
34554,Leonilcx,tichondrius,1845,priest,discipline,902,456,446
34555,Koalakazamzy,shadow-council,1845,priest,discipline,58,29,29
34556,Gotdro,kelthuzad,1845,priest,discipline,80,39,41
34557,Quèénstar,tichondrius,1845,priest,discipline,85,35,50
34558,Cavityx,illidan,1844,priest,discipline,52,30,22
34559,Troja,malganis,1843,priest,discipline,78,43,35
34560,Steelcity,tichondrius,1843,priest,discipline,54,28,26
34561,Dacine,illidan,1843,priest,discipline,60,30,30
34562,Bubbliez,frostmourne,1843,priest,discipline,59,28,31
34563,Nickydamous,moon-guard,1843,priest,discipline,66,31,35
34564,Fearmen,tichondrius,1842,priest,discipline,83,48,35
34565,Anyra,stormrage,1842,priest,discipline,57,29,28
34566,Zelená,trollbane,1841,priest,discipline,128,77,51
34567,Vampirê,tichondrius,1841,priest,discipline,66,35,31
34568,Kck,sentinels,1841,priest,discipline,95,44,51
34569,Meoveryou,stormrage,1840,priest,discipline,92,50,42
34570,Syliva,frostmourne,1840,priest,discipline,65,30,35
34571,Donutpriest,kelthuzad,1839,priest,discipline,78,44,34
34572,Inquisitionx,frostmourne,1839,priest,discipline,283,156,127
34573,Koalakazamza,shadow-council,1839,priest,discipline,62,28,34
34574,Katalad,wyrmrest-accord,1838,priest,discipline,66,40,26
34575,Drtyror,area-52,1838,priest,discipline,191,109,82
34576,Tistapriest,proudmoore,1837,priest,discipline,70,41,29
34577,Waggers,moon-guard,1837,priest,discipline,42,23,19
34578,Lotion,icecrown,1837,priest,discipline,48,25,23
34579,Tmversace,tichondrius,1837,priest,discipline,123,64,59
34580,Rayllyn,bleeding-hollow,1836,priest,discipline,30,22,8
34581,Miraclesoul,tichondrius,1836,priest,discipline,38,26,12
34582,Hairypenance,sargeras,1836,priest,discipline,72,39,33
34583,Testzpriests,dalaran,1836,priest,discipline,42,22,20
34584,Celestiah,illidan,1836,priest,discipline,60,30,30
34585,Wpj,barthilas,1836,priest,discipline,93,41,52
34586,Binipriest,tichondrius,1835,priest,discipline,67,40,27
34587,Jamino,jubeithos,1835,priest,discipline,111,60,51
34588,Tmeugene,tichondrius,1835,priest,discipline,40,21,19
34589,Icychain,area-52,1835,priest,discipline,76,34,42
34590,Bugweeb,sargeras,1834,priest,discipline,87,56,31
34591,Twopiece,blackrock,1834,priest,discipline,54,31,23
34592,Rÿzo,tichondrius,1834,priest,discipline,111,63,48
34593,Thottsteal,queldorei,1834,priest,discipline,60,31,29
34594,June,dragonmaw,1834,priest,discipline,60,30,30
34595,Angelforcez,frostmourne,1834,priest,discipline,53,23,30
34596,Rigxy,arthas,1833,priest,discipline,147,92,55
34597,Ameliarys,sargeras,1833,priest,discipline,103,51,52
34598,Jadon,sargeras,1832,priest,discipline,54,42,12
34599,Sons,zuljin,1832,priest,discipline,54,29,25
34600,Oloriinn,stormrage,1831,priest,discipline,36,24,12
34601,Antagzy,bleeding-hollow,1830,priest,discipline,108,69,39
34602,Msai,tichondrius,1830,priest,discipline,114,68,46
34603,Yotinha,stormrage,1830,priest,discipline,48,28,20
34604,Pzx,zuljin,1830,priest,discipline,54,31,23
34605,Obsolete,area-52,1830,priest,discipline,60,33,27
34606,Strvnge,malganis,1830,priest,discipline,60,28,32
34607,Faeleath,emerald-dream,1830,priest,discipline,80,37,43
34608,Veejae,tichondrius,1829,priest,discipline,54,29,25
34609,Cpks,tichondrius,1828,priest,discipline,76,48,28
34610,Baphomet,hyjal,1828,priest,discipline,88,53,35
34611,Misatomori,tichondrius,1828,priest,discipline,54,28,26
34612,Epitoh,bleeding-hollow,1828,priest,discipline,78,36,42
34613,Sleetherp,barthilas,1827,priest,discipline,64,37,27
34614,Fishondabeat,proudmoore,1827,priest,discipline,42,23,19
34615,Fracxured,sargeras,1827,priest,discipline,68,31,37
34616,Bohomagz,tichondrius,1826,priest,discipline,42,24,18
34617,Haduth,area-52,1826,priest,discipline,272,148,124
34618,Bloodyxx,bleeding-hollow,1825,priest,discipline,34,23,11
34619,Buffle,zuluhed,1825,priest,discipline,66,38,28
34620,Yokuz,thunderlord,1825,priest,discipline,48,26,22
34621,Mackulate,tichondrius,1825,priest,discipline,65,34,31
34622,Cokeheals,kelthuzad,1825,priest,discipline,54,28,26
34623,Mancito,mannoroth,1825,priest,discipline,174,90,84
34624,Aprîl,quelthalas,1825,priest,discipline,72,37,35
34625,Däzzlë,quelthalas,1825,priest,discipline,72,35,37
34626,Pnsp,perenolde,1824,priest,discipline,42,30,12
34627,Xholyshietz,emerald-dream,1824,priest,discipline,71,48,23
34628,Pervysaged,sargeras,1824,priest,discipline,60,40,20
34629,Archìtects,wyrmrest-accord,1824,priest,discipline,108,68,40
34630,Clockwororan,tichondrius,1824,priest,discipline,84,50,34
34631,Cya,deathwing,1824,priest,discipline,54,30,24
34632,Zygotes,tichondrius,1824,priest,discipline,39,21,18
34633,Deadpla,ragnaros,1824,priest,discipline,143,73,70
34634,Temérios,azralon,1824,priest,discipline,60,30,30
34635,Aethestan,zuljin,1824,priest,discipline,102,50,52
34636,Tuxen,wyrmrest-accord,1823,priest,discipline,48,29,19
34637,Swurvexo,bleeding-hollow,1823,priest,discipline,47,28,19
34638,Guiila,azralon,1823,priest,discipline,71,38,33
34639,Barthol,malygos,1823,priest,discipline,225,115,110
34640,Sprankels,bleeding-hollow,1823,priest,discipline,108,55,53
34641,Abepriest,zuljin,1823,priest,discipline,232,113,119
34642,Luhkx,stormrage,1823,priest,discipline,54,25,29
34643,Fallspriest,frostmourne,1822,priest,discipline,42,25,17
34644,Lands,ragnaros,1822,priest,discipline,120,69,51
34645,Memoria,emerald-dream,1822,priest,discipline,117,60,57
34646,Ggwizkaboo,tichondrius,1822,priest,discipline,60,30,30
34647,Zachon,sargeras,1822,priest,discipline,54,27,27
34648,Bamboon,tanaris,1821,priest,discipline,150,79,71
34649,Rerollpriest,firetree,1821,priest,discipline,53,25,28
34650,Ultrà,ragnaros,1820,priest,discipline,71,44,27
34651,Wreklol,tichondrius,1820,priest,discipline,60,34,26
34652,Dietcokee,stormrage,1820,priest,discipline,62,31,31
34653,Ujelin,kiljaeden,1820,priest,discipline,48,24,24
34654,Tophr,illidan,1819,priest,discipline,41,24,17
34655,Vinvictus,tichondrius,1819,priest,discipline,444,227,217
34656,Chk,moon-guard,1819,priest,discipline,136,65,71
34657,Saviorlol,tichondrius,1819,priest,discipline,65,31,34
34658,Soojwa,frostmourne,1819,priest,discipline,54,24,30
34659,Summersetisl,tichondrius,1818,priest,discipline,72,31,41
34660,Novel,moon-guard,1817,priest,discipline,30,24,6
34661,Despairx,tichondrius,1817,priest,discipline,102,66,36
34662,Guerisser,hyjal,1817,priest,discipline,176,104,72
34663,Gaudthree,tichondrius,1817,priest,discipline,46,25,21
34664,Exdric,kiljaeden,1817,priest,discipline,108,51,57
34665,Akuzaki,illidan,1817,priest,discipline,54,25,29
34666,Sliktrik,area-52,1817,priest,discipline,65,29,36
34667,Dapp,barthilas,1817,priest,discipline,77,33,44
34668,Cynthus,dalvengyr,1816,priest,discipline,102,60,42
34669,Lichtschreit,zuljin,1816,priest,discipline,41,24,17
34670,Juicyturon,moon-guard,1816,priest,discipline,77,45,32
34671,Dispassion,dalaran,1816,priest,discipline,58,33,25
34672,Zulazane,azralon,1816,priest,discipline,378,207,171
34673,Tryfekta,frostmourne,1816,priest,discipline,114,62,52
34674,Woodowl,tichondrius,1816,priest,discipline,46,25,21
34675,Kragenn,malganis,1816,priest,discipline,195,103,92
34676,Jackski,nemesis,1816,priest,discipline,48,25,23
34677,Hideonlight,barthilas,1816,priest,discipline,645,332,313
34678,Legendary,ragnaros,1816,priest,discipline,78,33,45
34679,Mødilon,nemesis,1815,priest,discipline,47,29,18
34680,Rythmzz,kiljaeden,1815,priest,discipline,108,59,49
34681,Engle,arathor,1815,priest,discipline,42,22,20
34682,Selenitax,sargeras,1815,priest,discipline,104,52,52
34683,Badnsweaty,sargeras,1815,priest,discipline,76,38,38
34684,Ousïa,quelthalas,1815,priest,discipline,164,81,83
34685,Mommyafk,moon-guard,1815,priest,discipline,54,25,29
34686,Myeryc,frostmourne,1815,priest,discipline,53,21,32
34687,Diwara,ragnaros,1814,priest,discipline,60,37,23
34688,Fullmetals,azralon,1814,priest,discipline,53,30,23
34689,Memoriesorz,tichondrius,1814,priest,discipline,553,294,259
34690,Zuwukey,kirin-tor,1814,priest,discipline,163,85,78
34691,Tanmo,illidan,1814,priest,discipline,96,50,46
34692,Fibbre,tichondrius,1814,priest,discipline,121,54,67
34693,Razdaz,twisting-nether,1814,priest,discipline,66,29,37
34694,Relicx,firetree,1813,priest,discipline,54,33,21
34695,Youhealme,area-52,1813,priest,discipline,90,54,36
34696,Hoonjojjyang,tichondrius,1813,priest,discipline,66,37,29
34697,Morboo,proudmoore,1813,priest,discipline,78,43,35
34698,Svzy,illidan,1813,priest,discipline,48,26,22
34699,Wandynha,nemesis,1813,priest,discipline,119,63,56
34700,Crypcanheal,sargeras,1813,priest,discipline,551,277,274
34701,Sasha,muradin,1813,priest,discipline,142,70,72
34702,Sixfourtank,tichondrius,1813,priest,discipline,53,26,27
34703,Falsity,kelthuzad,1813,priest,discipline,66,32,34
34704,Ahoy,sargeras,1812,priest,discipline,75,46,29
34705,Heart,misha,1812,priest,discipline,150,84,66
34706,Abstention,area-52,1812,priest,discipline,66,35,31
34707,Cardinaldave,frostmourne,1812,priest,discipline,54,28,26
34708,Tiernocookie,illidan,1812,priest,discipline,466,235,231
34709,Fatbellyx,sargeras,1812,priest,discipline,72,36,36
34710,Iyoui,tichondrius,1811,priest,discipline,42,28,14
34711,Tyrrshadow,skywall,1811,priest,discipline,104,58,46
34712,Tallïa,stormrage,1811,priest,discipline,155,82,73
34713,Louisé,hydraxis,1811,priest,discipline,90,46,44
34714,Cellestine,aggramar,1811,priest,discipline,157,80,77
34715,Olark,durotan,1811,priest,discipline,423,209,214
34716,Wübbie,emerald-dream,1810,priest,discipline,72,40,32
34717,Trengodqt,destromath,1810,priest,discipline,235,129,106
34718,Pawnza,tichondrius,1810,priest,discipline,120,65,55
34719,Paytin,illidan,1810,priest,discipline,71,32,39
34720,Arguseonp,proudmoore,1809,priest,discipline,54,37,17
34721,Ãbelladanger,area-52,1809,priest,discipline,65,43,22
34722,Jemine,tichondrius,1809,priest,discipline,108,64,44
34723,Scrollozaddy,illidan,1809,priest,discipline,306,181,125
34724,Thepumps,sargeras,1809,priest,discipline,73,43,30
34725,Paramour,laughing-skull,1809,priest,discipline,108,59,49
34726,Jaquels,area-52,1809,priest,discipline,130,65,65
34727,Cearáa,azralon,1809,priest,discipline,65,32,33
34728,Thedude,spirestone,1809,priest,discipline,71,34,37
34729,Varbirttok,sargeras,1809,priest,discipline,61,29,32
34730,Dabaojian,tichondrius,1809,priest,discipline,60,28,32
34731,Aube,frostmourne,1809,priest,discipline,51,23,28
34732,Nudithree,malganis,1808,priest,discipline,38,26,12
34733,Vbear,dunemaul,1808,priest,discipline,71,39,32
34734,Shadowcakes,tichondrius,1808,priest,discipline,60,32,28
34735,Pkkdestiny,archimonde,1808,priest,discipline,71,37,34
34736,Catbabyorz,tichondrius,1808,priest,discipline,84,41,43
34737,Pns,perenolde,1808,priest,discipline,66,32,34
34738,Buhroketwo,thrall,1807,priest,discipline,66,41,25
34739,Marcìano,bleeding-hollow,1807,priest,discipline,85,49,36
34740,Dopeypriest,area-52,1807,priest,discipline,120,68,52
34741,Nomsayin,stormrage,1806,priest,discipline,48,32,16
34742,Gices,area-52,1806,priest,discipline,36,24,12
34743,Exøtic,tichondrius,1806,priest,discipline,54,35,19
34744,Ayakashi,frostmourne,1806,priest,discipline,75,46,29
34745,Wormface,moon-guard,1806,priest,discipline,58,35,23
34746,Senzy,tichondrius,1806,priest,discipline,150,81,69
34747,Releriel,area-52,1806,priest,discipline,58,31,27
34748,Ðiscipline,kelthuzad,1806,priest,discipline,253,134,119
34749,Inthemix,stormreaver,1806,priest,discipline,376,197,179
34750,Yezhua,zuljin,1806,priest,discipline,84,44,40
34751,Danceslol,area-52,1806,priest,discipline,59,28,31
34752,Purplebeauty,tichondrius,1805,priest,discipline,198,119,79
34753,Bonigan,sargeras,1805,priest,discipline,197,118,79
34754,Rylla,illidan,1805,priest,discipline,66,34,32
34755,Deathwisher,illidan,1805,priest,discipline,251,127,124
34756,Maghobou,tichondrius,1805,priest,discipline,66,30,36
34757,Öxhö,tichondrius,1804,priest,discipline,44,31,13
34758,Ðsco,tichondrius,1804,priest,discipline,36,24,12
34759,Absorbs,stormrage,1804,priest,discipline,30,19,11
34760,Selath,ragnaros,1804,priest,discipline,47,26,21
34761,Angelumlucis,frostmane,1804,priest,discipline,145,80,65
34762,Syrillia,wildhammer,1804,priest,discipline,142,78,64
34763,Barrenbuffet,zuljin,1804,priest,discipline,272,136,136
34764,Cln,bleeding-hollow,1804,priest,discipline,65,32,33
34765,Taipriest,frostmourne,1804,priest,discipline,222,103,119
34766,Jinais,zuluhed,1803,priest,discipline,48,33,15
34767,Phillthevoid,sargeras,1803,priest,discipline,45,29,16
34768,Applecare,illidan,1803,priest,discipline,102,60,42
34769,Tarlex,illidan,1803,priest,discipline,168,94,74
34770,Goldsunx,emerald-dream,1803,priest,discipline,152,85,67
34771,Tjphess,zuljin,1803,priest,discipline,240,130,110
34772,Luciuz,tichondrius,1803,priest,discipline,84,45,39
34773,Cbalnom,tichondrius,1803,priest,discipline,70,37,33
34774,Sußlime,frostwolf,1803,priest,discipline,90,47,43
34775,Criil,area-52,1803,priest,discipline,42,19,23
34776,Manyhot,tichondrius,1802,priest,discipline,51,32,19
34777,Yrñwiotøø,illidan,1802,priest,discipline,54,33,21
34778,Bmouth,tichondrius,1802,priest,discipline,102,59,43
34779,Dijkstracted,ragnaros,1802,priest,discipline,187,106,81
34780,Reignen,tichondrius,1802,priest,discipline,183,101,82
34781,Seifong,frostmourne,1802,priest,discipline,125,68,57
34782,Deathallpoly,tichondrius,1802,priest,discipline,431,227,204
34783,Ritzzx,ragnaros,1802,priest,discipline,107,55,52
34784,Retardèr,tichondrius,1801,priest,discipline,97,68,29
34785,Reverendtun,area-52,1801,priest,discipline,83,55,28
34786,Merit,emerald-dream,1801,priest,discipline,165,92,73
34787,Sinday,zuljin,1801,priest,discipline,72,38,34
34788,Wânda,tichondrius,1801,priest,discipline,111,57,54
34789,Lípjju,tichondrius,1801,priest,discipline,54,24,30
34790,Geekynerd,frostmourne,1800,priest,discipline,151,98,53
34791,Bigmomcook,tichondrius,1800,priest,discipline,215,125,90
34792,Imissdave,dethecus,1800,priest,discipline,48,27,21
34793,Narakku,sargeras,1800,priest,discipline,108,59,49
34794,Holyhõ,stormrage,1800,priest,discipline,60,32,28
34795,Bwgyx,area-52,1800,priest,discipline,42,22,20
34796,Bibleblak,stormrage,1800,priest,discipline,102,53,49
34797,Alola,illidan,1800,priest,discipline,135,69,66
34798,Shamáng,tichondrius,1800,priest,discipline,152,73,79
34799,Shenanígans,malganis,1800,priest,discipline,42,19,23
34800,Bomí,tichondrius,1799,priest,discipline,84,41,43
34801,Fearinoculúm,bleeding-hollow,1798,priest,discipline,24,19,5
34802,Thaldrum,tichondrius,1798,priest,discipline,91,36,55
34803,Vaaynee,ragnaros,1797,priest,discipline,114,61,53
34804,Secondes,azralon,1797,priest,discipline,36,19,17
34805,Comebaack,stormrage,1797,priest,discipline,98,51,47
34806,Horzp,bleeding-hollow,1797,priest,discipline,72,32,40
34807,Jaytee,aggramar,1796,priest,discipline,78,38,40
34808,Impvp,tichondrius,1795,priest,discipline,89,49,40
34809,Marython,tichondrius,1794,priest,discipline,148,76,72
34810,Wormclergy,tichondrius,1794,priest,discipline,92,45,47
34811,Holyster,tichondrius,1794,priest,discipline,50,24,26
34812,Onikûdaki,sargeras,1794,priest,discipline,59,27,32
34813,Frostinal,illidan,1793,priest,discipline,226,116,110
34814,Fancydisc,barthilas,1792,priest,discipline,36,23,13
34815,Topbruv,tichondrius,1792,priest,discipline,60,36,24
34816,Lesx,tichondrius,1791,priest,discipline,66,36,30
34817,Dipadre,azralon,1790,priest,discipline,102,72,30
34818,Nearo,barthilas,1789,priest,discipline,77,37,40
34819,Ryno,cenarion-circle,1788,priest,discipline,80,43,37
34820,Kostantina,kelthuzad,1788,priest,discipline,184,86,98
34821,Ohsop,chogall,1787,priest,discipline,68,42,26
34822,Euphorz,tichondrius,1786,priest,discipline,36,19,17
34823,Priceléss,tichondrius,1784,priest,discipline,30,22,8
34824,Xsy,stormrage,1784,priest,discipline,54,31,23
34825,Rlzpriest,tichondrius,1784,priest,discipline,124,65,59
34826,Pride,moon-guard,1784,priest,discipline,148,66,82
34827,Psyjes,stormrage,1783,priest,discipline,116,70,46
34828,Gochuxx,tichondrius,1783,priest,discipline,72,38,34
34829,Gibens,tichondrius,1781,priest,discipline,149,79,70
34830,Usedmedkit,sargeras,1780,priest,discipline,47,28,19
34831,Blesstwo,ragnaros,1779,priest,discipline,48,24,24
34832,Mindseye,azgalor,1779,priest,discipline,138,68,70
34833,Kóba,bleeding-hollow,1778,priest,discipline,48,33,15
34834,Høðj,tichondrius,1778,priest,discipline,36,19,17
34835,Meltmeltz,nerzhul,1778,priest,discipline,104,51,53
34836,Oohso,chogall,1778,priest,discipline,126,60,66
34837,Khorium,stormrage,1776,priest,discipline,64,29,35
34838,Fleckyy,tichondrius,1776,priest,discipline,42,19,23
34839,Ksâh,bleeding-hollow,1774,priest,discipline,81,50,31
34840,Whalexo,kelthuzad,1774,priest,discipline,155,82,73
34841,Tekneeq,barthilas,1774,priest,discipline,196,103,93
34842,Pesca,proudmoore,1774,priest,discipline,125,59,66
34843,Nickzx,tichondrius,1773,priest,discipline,76,51,25
34844,Pnub,aggramar,1772,priest,discipline,105,52,53
34845,Barley,chogall,1770,priest,discipline,58,30,28
34846,Deathlullaby,malganis,1769,priest,discipline,72,37,35
34847,Mcgg,tichondrius,1769,priest,discipline,210,99,111
34848,Auxp,tichondrius,1769,priest,discipline,59,23,36
34849,Dannycarrier,tichondrius,1768,priest,discipline,30,21,9
34850,Jackski,aerie-peak,1768,priest,discipline,36,24,12
34851,Smitelytius,tichondrius,1768,priest,discipline,36,21,15
34852,Kabugi,illidan,1768,priest,discipline,96,52,44
34853,Bellaelle,stormrage,1768,priest,discipline,69,35,34
34854,Hungrybone,proudmoore,1768,priest,discipline,885,447,438
34855,Catbabyeah,tichondrius,1767,priest,discipline,54,42,12
34856,Írithyll,stormrage,1767,priest,discipline,59,33,26
34857,Pibkac,stormrage,1767,priest,discipline,69,34,35
34858,Kälëy,ragnaros,1766,priest,discipline,268,150,118
34859,Kavxo,sargeras,1766,priest,discipline,131,73,58
34860,Sobamian,tichondrius,1766,priest,discipline,146,66,80
34861,Healum,nemesis,1765,priest,discipline,106,59,47
34862,Oghealz,lightnings-blade,1765,priest,discipline,84,38,46
34863,Badrapture,sargeras,1764,priest,discipline,104,73,31
34864,Osis,rivendare,1764,priest,discipline,165,80,85
34865,Sebpriest,proudmoore,1764,priest,discipline,42,20,22
34866,Rúbybest,tichondrius,1764,priest,discipline,72,30,42
34867,Sweetnipsbro,tichondrius,1763,priest,discipline,125,64,61
34868,Deadpriesst,arthas,1763,priest,discipline,72,36,36
34869,Rmxx,illidan,1762,priest,discipline,173,98,75
34870,Astroluma,illidan,1762,priest,discipline,136,72,64
34871,Darbybean,bleeding-hollow,1762,priest,discipline,54,28,26
34872,Bloodyx,bleeding-hollow,1762,priest,discipline,232,119,113
34873,Grimoz,illidan,1762,priest,discipline,77,35,42
34874,Zaryx,wildhammer,1761,priest,discipline,48,29,19
34875,Meatguzzler,tichondrius,1761,priest,discipline,85,51,34
34876,Matin,frostmourne,1761,priest,discipline,51,27,24
34877,Gothmidget,illidan,1761,priest,discipline,60,29,31
34878,Raysx,stormrage,1759,priest,discipline,83,37,46
34879,Kaddy,mannoroth,1757,priest,discipline,130,60,70
34880,Khaoshealer,destromath,1757,priest,discipline,191,88,103
34881,Compxx,barthilas,1756,priest,discipline,66,38,28
34882,Powerwordwap,malganis,1756,priest,discipline,71,33,38
34883,Spliffs,tichondrius,1755,priest,discipline,176,87,89
34884,Shadheda,andorhal,1755,priest,discipline,68,33,35
34885,Papabrokuttv,sargeras,1755,priest,discipline,42,19,23
34886,Skunkbishop,sargeras,1753,priest,discipline,243,117,126
34887,Séxgodx,tichondrius,1751,priest,discipline,59,28,31
34888,Zins,emerald-dream,1750,priest,discipline,114,54,60
34889,Ancilx,area-52,1749,priest,discipline,84,41,43
34890,Ukishizumi,tichondrius,1748,priest,discipline,149,78,71
34891,Nyluh,deathwing,1748,priest,discipline,74,38,36
34892,Sanddglokta,tichondrius,1748,priest,discipline,332,167,165
34893,Shadowbuzz,barthilas,1748,priest,discipline,84,42,42
34894,Raizy,stormrage,1748,priest,discipline,53,26,27
34895,Ferguss,ragnaros,1747,priest,discipline,79,42,37
34896,Dudebanger,sargeras,1745,priest,discipline,36,26,10
34897,Alarin,whisperwind,1745,priest,discipline,60,30,30
34898,Evilear,tichondrius,1745,priest,discipline,66,31,35
34899,Ninbara,tichondrius,1745,priest,discipline,59,27,32
34900,Pomdom,tichondrius,1744,priest,discipline,72,34,38
34901,Pisshorse,tichondrius,1743,priest,discipline,65,47,18
34902,Hamstip,sargeras,1743,priest,discipline,98,58,40
34903,Byck,tichondrius,1743,priest,discipline,60,26,34
34904,Natoshi,illidan,1742,priest,discipline,48,25,23
34905,Cursèlol,tichondrius,1742,priest,discipline,96,48,48
34906,Jabberwolky,blackrock,1742,priest,discipline,60,23,37
34907,Leapofdoubt,zuljin,1741,priest,discipline,256,132,124
34908,Envio,moon-guard,1740,priest,discipline,60,36,24
34909,Melshiesty,stormrage,1740,priest,discipline,53,24,29
34910,Cody,magtheridon,1738,priest,discipline,90,59,31
34911,Stinkypinkÿ,bleeding-hollow,1738,priest,discipline,45,27,18
34912,Aloxc,drakkari,1738,priest,discipline,36,19,17
34913,Chaner,scarlet-crusade,1738,priest,discipline,127,61,66
34914,Jimmythedon,mugthol,1738,priest,discipline,82,38,44
34915,Surfgang,tichondrius,1738,priest,discipline,77,35,42
34916,Whatsadot,tichondrius,1737,priest,discipline,60,46,14
34917,Leticia,magtheridon,1737,priest,discipline,159,78,81
34918,Marejaynez,tichondrius,1737,priest,discipline,289,141,148
34919,Stoneflute,emerald-dream,1736,priest,discipline,189,108,81
34920,Orderic,ragnaros,1736,priest,discipline,57,32,25
34921,Ilovemia,zuljin,1736,priest,discipline,42,23,19
34922,Creamedcorn,tichondrius,1736,priest,discipline,40,21,19
34923,Pgpriest,kelthuzad,1736,priest,discipline,114,56,58
34924,Haruspex,azralon,1736,priest,discipline,107,48,59
34925,Kelthax,sargeras,1736,priest,discipline,54,23,31
34926,Niark,frostmourne,1736,priest,discipline,48,20,28
34927,Maybedead,tichondrius,1734,priest,discipline,42,26,16
34928,Aupascamarad,tichondrius,1734,priest,discipline,35,19,16
34929,Obscure,malygos,1734,priest,discipline,74,32,42
34930,Larisa,moon-guard,1733,priest,discipline,54,32,22
34931,Claverr,stormrage,1733,priest,discipline,39,23,16
34932,Neverbeen,tichondrius,1733,priest,discipline,822,428,394
34933,Bublehead,zuljin,1733,priest,discipline,132,62,70
34934,Syo,dreadmaul,1732,priest,discipline,137,72,65
34935,Verymuscular,stormrage,1732,priest,discipline,66,34,32
34936,Castsmites,tichondrius,1731,priest,discipline,51,27,24
34937,Saelom,frostmourne,1730,priest,discipline,78,49,29
34938,Murth,laughing-skull,1729,priest,discipline,47,30,17
34939,Johanna,tichondrius,1729,priest,discipline,41,26,15
34940,Adrio,malorne,1729,priest,discipline,350,175,175
34941,Dirtydebbie,lightnings-blade,1729,priest,discipline,64,30,34
34942,Priestass,bleeding-hollow,1728,priest,discipline,227,118,109
34943,Airelia,sargeras,1728,priest,discipline,54,28,26
34944,Dëàthwîsh,tichondrius,1728,priest,discipline,53,26,27
34945,Deeznuhh,tichondrius,1728,priest,discipline,47,19,28
34946,Blasphêmy,malganis,1727,priest,discipline,86,52,34
34947,Frenezyz,ragnaros,1727,priest,discipline,66,37,29
34948,Thatruth,duskwood,1727,priest,discipline,48,26,22
34949,Beeffdaddy,tichondrius,1727,priest,discipline,198,98,100
34950,Oogs,tichondrius,1727,priest,discipline,244,108,136
34951,Åpples,tichondrius,1727,priest,discipline,71,31,40
34952,Apoorstudent,tichondrius,1726,priest,discipline,116,72,44
34953,Mxfd,tichondrius,1726,priest,discipline,47,27,20
34954,Dévore,dalaran,1726,priest,discipline,46,25,21
34955,Plumpkinn,kiljaeden,1726,priest,discipline,106,54,52
34956,Flagiddyflag,kelthuzad,1726,priest,discipline,48,24,24
34957,Analogxz,nemesis,1726,priest,discipline,168,81,87
34958,Vonpaolo,emerald-dream,1725,priest,discipline,24,20,4
34959,Conifer,emerald-dream,1725,priest,discipline,72,41,31
34960,Barthbelro,kiljaeden,1725,priest,discipline,87,49,38
34961,Xxqq,illidan,1725,priest,discipline,113,60,53
34962,Litterfeet,moon-guard,1725,priest,discipline,101,51,50
34963,Goneqt,illidan,1725,priest,discipline,60,29,31
34964,Jezebëll,nemesis,1724,priest,discipline,192,99,93
34965,Kebab,tichondrius,1723,priest,discipline,30,18,12
34966,Natahlia,area-52,1723,priest,discipline,90,44,46
34967,Jexso,tichondrius,1723,priest,discipline,199,96,103
34968,Dontlineme,tichondrius,1723,priest,discipline,142,64,78
34969,Xidis,vashj,1723,priest,discipline,71,29,42
34970,Mååxxee,zuljin,1722,priest,discipline,30,18,12
34971,Vegetable,suramar,1722,priest,discipline,36,18,18
34972,Downturn,tichondrius,1722,priest,discipline,54,23,31
34973,Starpass,illidan,1721,priest,discipline,60,42,18
34974,Canibumsmoke,illidan,1721,priest,discipline,99,50,49
34975,Fhinky,tichondrius,1721,priest,discipline,213,105,108
34976,Philmacrakn,stormrage,1721,priest,discipline,167,81,86
34977,Flamédøtz,ragnaros,1720,priest,discipline,54,30,24
34978,Luwoona,tichondrius,1720,priest,discipline,107,48,59
34979,Opriest,queldorei,1718,priest,discipline,54,27,27
34980,Ggsaurusrex,area-52,1718,priest,discipline,66,31,35
34981,Ooit,tichondrius,1717,priest,discipline,24,22,2
34982,Septmoon,tichondrius,1717,priest,discipline,66,34,32
34983,Cixelpvp,area-52,1717,priest,discipline,53,27,26
34984,Wizpell,area-52,1717,priest,discipline,42,18,24
34985,Epicp,sargeras,1716,priest,discipline,30,18,12
34986,Pissfeet,tichondrius,1716,priest,discipline,30,18,12
34987,Rotbaron,bleeding-hollow,1716,priest,discipline,108,48,60
34988,Woobgasm,sargeras,1715,priest,discipline,72,46,26
34989,Zlowbly,ragnaros,1715,priest,discipline,36,21,15
34990,Dippyboi,whisperwind,1715,priest,discipline,60,30,30
34991,Ganapati,the-underbog,1715,priest,discipline,36,18,18
34992,Meshuggah,archimonde,1713,priest,discipline,42,22,20
34993,Indiglo,arthas,1713,priest,discipline,138,68,70
34994,Mygameslaggy,area-52,1713,priest,discipline,78,33,45
34995,Likehisname,tichondrius,1713,priest,discipline,48,19,29
34996,Marminator,stormrage,1713,priest,discipline,66,24,42
34997,Pastapizza,zuljin,1712,priest,discipline,24,22,2
34998,Rachell,emerald-dream,1712,priest,discipline,36,26,10
34999,Twixicecream,sargeras,1712,priest,discipline,35,24,11
35000,Shrooks,frostmourne,1712,priest,discipline,56,30,26
35001,Bakara,jubeithos,1712,priest,discipline,42,18,24
35002,Nxghtmares,tichondrius,1711,priest,discipline,428,210,218
35003,Trebrooke,sargeras,1710,priest,discipline,161,88,73
35004,Touchrr,tichondrius,1710,priest,discipline,108,58,50
35005,Demaholy,illidan,1710,priest,discipline,163,82,81
35006,Valothrian,area-52,1710,priest,discipline,172,86,86
35007,Dorgondra,wyrmrest-accord,1709,priest,discipline,48,26,22
35008,Shadzx,andorhal,1709,priest,discipline,71,34,37
35009,Universe,spinebreaker,1707,priest,discipline,64,43,21
35010,Andreslol,sargeras,1707,priest,discipline,54,32,22
35011,Caveria,emerald-dream,1707,priest,discipline,283,146,137
35012,Asthenia,saurfang,1706,priest,discipline,120,59,61
35013,Sodezz,stormrage,1705,priest,discipline,36,21,15
35014,Bfts,illidan,1705,priest,discipline,227,119,108
35015,Mellow,tichondrius,1705,priest,discipline,170,89,81
35016,Discflips,dalaran,1705,priest,discipline,239,117,122
35017,Forti,sargeras,1705,priest,discipline,156,74,82
35018,Squaanchy,bleeding-hollow,1705,priest,discipline,129,61,68
35019,Highprofile,proudmoore,1705,priest,discipline,42,19,23
35020,Anmu,illidan,1704,priest,discipline,30,19,11
35021,Dream,kelthuzad,1704,priest,discipline,36,21,15
35022,Staars,ragnaros,1704,priest,discipline,66,37,29
35023,Justafkoutpr,gorefiend,1703,priest,discipline,54,36,18
35024,Sùlyvahñ,tichondrius,1702,priest,discipline,30,18,12
35025,Gfayde,sargeras,1702,priest,discipline,36,20,16
35026,Nightcráwler,illidan,1702,priest,discipline,89,47,42
35027,Shnozberry,tichondrius,1702,priest,discipline,114,46,68
35028,Sätîvá,tichondrius,1701,priest,discipline,44,24,20
35029,Irenesome,tichondrius,1701,priest,discipline,45,21,24
35030,Fullfear,lothar,1699,priest,discipline,54,33,21
35031,Bigbrother,andorhal,1699,priest,discipline,36,21,15
35032,Beowulfy,stormrage,1699,priest,discipline,48,27,21
35033,Nexp,tichondrius,1698,priest,discipline,141,90,51
35034,Cruces,malorne,1698,priest,discipline,33,18,15
35035,Nanoboost,dark-iron,1698,priest,discipline,759,380,379
35036,Nasser,tichondrius,1698,priest,discipline,42,18,24
35037,Prïestitute,zuljin,1697,priest,discipline,150,92,58
35038,Clydeington,illidan,1697,priest,discipline,49,29,20
35039,Cryptron,tichondrius,1697,priest,discipline,54,28,26
35040,Papafajita,area-52,1697,priest,discipline,71,34,37
35041,Nancynibbler,bleeding-hollow,1697,priest,discipline,70,32,38
35042,Lamont,archimonde,1697,priest,discipline,50,21,29
35043,Mixful,bleeding-hollow,1696,priest,discipline,40,27,13
35044,Twêet,frostmourne,1696,priest,discipline,186,87,99
35045,Pìuzera,azralon,1695,priest,discipline,89,45,44
35046,Serakiki,nemesis,1694,priest,discipline,90,51,39
35047,Metaverse,lightbringer,1694,priest,discipline,39,21,18
35048,Mintadnade,nemesis,1694,priest,discipline,198,100,98
35049,Slickwilly,bloodhoof,1694,priest,discipline,275,137,138
35050,Vandamnation,barthilas,1694,priest,discipline,223,107,116
35051,Stepsistér,ragnaros,1693,priest,discipline,54,29,25
35052,Deathtones,barthilas,1693,priest,discipline,167,85,82
35053,Geon,sargeras,1693,priest,discipline,107,53,54
35054,Afflickzz,kelthuzad,1692,priest,discipline,42,26,16
35055,Klttzz,sargeras,1692,priest,discipline,72,40,32
35056,Yunnan,executus,1692,priest,discipline,119,65,54
35057,Smyted,tichondrius,1692,priest,discipline,79,43,36
35058,Auntbrittany,tichondrius,1692,priest,discipline,36,18,18
35059,Scab,anetheron,1692,priest,discipline,161,79,82
35060,Beelzebul,illidan,1692,priest,discipline,66,31,35
35061,Hotgirlshiit,dalaran,1691,priest,discipline,364,175,189
35062,Bosspriest,tichondrius,1691,priest,discipline,48,23,25
35063,Drethor,saurfang,1691,priest,discipline,76,36,40
35064,Pigogo,tichondrius,1690,priest,discipline,45,26,19
35065,Slùm,barthilas,1689,priest,discipline,49,30,19
35066,Mastaspell,illidan,1689,priest,discipline,31,18,13
35067,Elybele,sargeras,1689,priest,discipline,114,61,53
35068,Yobell,tichondrius,1688,priest,discipline,36,23,13
35069,Argylemomo,emerald-dream,1688,priest,discipline,202,103,99
35070,Zrn,bleeding-hollow,1688,priest,discipline,102,47,55
35071,Wildsmite,hyjal,1688,priest,discipline,222,102,120
35072,Verboden,kelthuzad,1687,priest,discipline,36,25,11
35073,Duubz,kelthuzad,1687,priest,discipline,96,51,45
35074,Oopsy,bleeding-hollow,1687,priest,discipline,60,31,29
35075,Scryphe,kelthuzad,1687,priest,discipline,180,89,91
35076,Kastep,tichondrius,1687,priest,discipline,94,46,48
35077,Synsparks,tichondrius,1687,priest,discipline,77,35,42
35078,Luvenia,sargeras,1686,priest,discipline,186,101,85
35079,Fõrcedtowipe,tichondrius,1686,priest,discipline,215,113,102
35080,Änanti,tichondrius,1686,priest,discipline,160,79,81
35081,Andypr,illidan,1686,priest,discipline,66,25,41
35082,Jerome,tichondrius,1685,priest,discipline,105,61,44
35083,Catonement,moon-guard,1684,priest,discipline,690,335,355
35084,Salvation,tichondrius,1684,priest,discipline,60,27,33
35085,Turtlez,area-52,1684,priest,discipline,78,35,43
35086,Opscurum,bleeding-hollow,1683,priest,discipline,60,36,24
35087,Rámmstein,wyrmrest-accord,1682,priest,discipline,126,68,58
35088,Giveheadpats,moon-guard,1682,priest,discipline,167,90,77
35089,Persimmons,lightbringer,1682,priest,discipline,131,70,61
35090,Fyshme,frostmourne,1682,priest,discipline,42,22,20
35091,Skvmbag,tichondrius,1681,priest,discipline,40,26,14
35092,Märzy,thrall,1681,priest,discipline,42,26,16
35093,Onineko,bleeding-hollow,1681,priest,discipline,57,32,25
35094,Luthiene,area-52,1681,priest,discipline,245,136,109
35095,Shrimpouh,illidan,1681,priest,discipline,78,43,35
35096,Plaguebaby,stormrage,1681,priest,discipline,45,23,22
35097,Rilad,icecrown,1681,priest,discipline,222,111,111
35098,Goatspriesta,kelthuzad,1681,priest,discipline,50,25,25
35099,Serrahs,tichondrius,1681,priest,discipline,59,29,30
35100,Melforn,moon-guard,1681,priest,discipline,59,28,31
35101,Ieveling,skywall,1681,priest,discipline,65,30,35
35102,Lingdums,tichondrius,1680,priest,discipline,31,18,13
35103,Falsegodxd,tichondrius,1680,priest,discipline,42,20,22
35104,Laggytwodope,tichondrius,1679,priest,discipline,48,32,16
35105,Washdp,frostmourne,1679,priest,discipline,47,24,23
35106,Poosydoodlez,malganis,1679,priest,discipline,105,48,57
35107,Qtasiangirl,emerald-dream,1679,priest,discipline,109,47,62
35108,Shastea,crushridge,1678,priest,discipline,76,41,35
35109,Derpmodé,staghelm,1678,priest,discipline,54,28,26
35110,Nabukom,destromath,1678,priest,discipline,52,25,27
35111,Toastspriest,tichondrius,1677,priest,discipline,107,60,47
35112,Shesaidthat,stormrage,1677,priest,discipline,274,143,131
35113,Koopy,kiljaeden,1677,priest,discipline,120,62,58
35114,Mealmassttr,frostmourne,1677,priest,discipline,173,82,91
35115,Holyfall,sargeras,1676,priest,discipline,220,116,104
35116,Gurgs,emerald-dream,1676,priest,discipline,38,19,19
35117,Probs,frostmourne,1676,priest,discipline,149,73,76
35118,Chañing,frostmourne,1676,priest,discipline,90,43,47
35119,Muffinboy,illidan,1676,priest,discipline,60,21,39
35120,Narodiz,nemesis,1675,priest,discipline,48,26,22
35121,Chewey,tichondrius,1675,priest,discipline,71,35,36
35122,Bonehead,warsong,1675,priest,discipline,48,23,25
35123,Snakedoc,emerald-dream,1674,priest,discipline,96,50,46
35124,Jennyle,sargeras,1673,priest,discipline,78,43,35
35125,Bingleboi,area-52,1673,priest,discipline,369,198,171
35126,Howiecakes,bloodhoof,1673,priest,discipline,75,33,42
35127,Aco,tichondrius,1672,priest,discipline,150,79,71
35128,Acpriest,tichondrius,1672,priest,discipline,135,69,66
35129,Dojacatx,frostmourne,1672,priest,discipline,114,57,57
35130,Eetsqt,barthilas,1671,priest,discipline,120,74,46
35131,Meemó,area-52,1671,priest,discipline,36,22,14
35132,Räpture,andorhal,1671,priest,discipline,46,28,18
35133,Hrdz,zuljin,1671,priest,discipline,40,22,18
35134,Perothon,garrosh,1670,priest,discipline,153,82,71
35135,Zilah,ravencrest,1670,priest,discipline,138,72,66
35136,Flagiddy,kelthuzad,1670,priest,discipline,57,27,30
35137,Dachenchen,tichondrius,1669,priest,discipline,36,27,9
35138,Auras,boulderfist,1669,priest,discipline,70,41,29
35139,Drée,zuljin,1669,priest,discipline,44,23,21
35140,Bigdaddios,dalaran,1669,priest,discipline,57,29,28
35141,Kagemetsu,sargeras,1669,priest,discipline,152,74,78
35142,Boostedpi,tichondrius,1669,priest,discipline,44,21,23
35143,Madmilesstv,zuljin,1669,priest,discipline,51,24,27
35144,Jmlz,tichondrius,1668,priest,discipline,36,23,13
35145,Elilium,tichondrius,1668,priest,discipline,80,48,32
35146,Alomari,zuljin,1668,priest,discipline,32,19,13
35147,Milkkz,zuljin,1668,priest,discipline,54,30,24
35148,Klitarus,barthilas,1668,priest,discipline,48,23,25
35149,Maximiliano,barthilas,1668,priest,discipline,43,19,24
35150,Mcfref,tichondrius,1667,priest,discipline,135,70,65
35151,Dpendant,frostmourne,1667,priest,discipline,119,56,63
35152,Muffingal,tichondrius,1666,priest,discipline,36,19,17
35153,Nelpesh,tichondrius,1666,priest,discipline,60,27,33
35154,Fearnought,stormrage,1665,priest,discipline,224,121,103
35155,Icemocha,tichondrius,1665,priest,discipline,54,25,29
35156,Kepp,korgath,1665,priest,discipline,69,30,39
35157,Meren,kelthuzad,1664,priest,discipline,36,24,12
35158,Góndhi,tichondrius,1664,priest,discipline,42,25,17
35159,Crysknife,korgath,1664,priest,discipline,35,20,15
35160,Rmx,illidan,1664,priest,discipline,41,20,21
35161,Kujox,tichondrius,1664,priest,discipline,94,44,50
35162,Knoskeezy,proudmoore,1663,priest,discipline,30,22,8
35163,Gekko,azgalor,1663,priest,discipline,54,21,33
35164,Shocklol,stormrage,1662,priest,discipline,29,22,7
35165,Niik,tichondrius,1662,priest,discipline,36,25,11
35166,Syrul,tichondrius,1662,priest,discipline,87,50,37
35167,Hallucinogen,kelthuzad,1662,priest,discipline,95,51,44
35168,Isilador,moon-guard,1662,priest,discipline,119,52,67
35169,Fugazy,barthilas,1661,priest,discipline,44,24,20
35170,Fisp,moon-guard,1661,priest,discipline,72,33,39
35171,Bvh,kelthuzad,1661,priest,discipline,57,22,35
35172,Joeyslaps,frostwolf,1660,priest,discipline,64,34,30
35173,Resisted,gorefiend,1660,priest,discipline,238,120,118
35174,Cayleey,stormrage,1659,priest,discipline,90,40,50
35175,Randomprist,area-52,1658,priest,discipline,33,18,15
35176,Luciellis,sargeras,1658,priest,discipline,162,83,79
35177,Imms,tichondrius,1658,priest,discipline,48,21,27
35178,Caveron,tichondrius,1657,priest,discipline,42,23,19
35179,Pocket,alleria,1656,priest,discipline,36,21,15
35180,Ÿsk,tichondrius,1656,priest,discipline,222,117,105
35181,Swaheally,frostmourne,1656,priest,discipline,48,25,23
35182,Toopriestly,deathwing,1656,priest,discipline,65,32,33
35183,Yaz,emerald-dream,1656,priest,discipline,71,34,37
35184,Sarïya,moon-guard,1656,priest,discipline,143,68,75
35185,Hm,the-scryers,1655,priest,discipline,36,25,11
35186,Valith,bleeding-hollow,1655,priest,discipline,82,47,35
35187,Theravus,moon-guard,1655,priest,discipline,124,67,57
35188,Dances,emerald-dream,1655,priest,discipline,42,22,20
35189,Hermanmiller,frostmourne,1655,priest,discipline,48,25,23
35190,Shádowman,thrall,1655,priest,discipline,126,65,61
35191,Batiatus,moon-guard,1655,priest,discipline,252,127,125
35192,Vcainyfairy,stormrage,1655,priest,discipline,531,267,264
35193,Naranjitá,ragnaros,1654,priest,discipline,66,42,24
35194,Darknuz,sargeras,1654,priest,discipline,53,27,26
35195,Sacredmoon,dreadmaul,1654,priest,discipline,36,18,18
35196,Perceptions,dalaran,1653,priest,discipline,42,26,16
35197,Hypes,korgath,1653,priest,discipline,115,65,50
35198,Kathere,tichondrius,1653,priest,discipline,42,23,19
35199,Zunitpriest,laughing-skull,1653,priest,discipline,36,18,18
35200,Timbobaloo,thrall,1652,priest,discipline,82,47,35
35201,Vtp,frostmourne,1652,priest,discipline,70,40,30
35202,Kelime,azralon,1652,priest,discipline,60,34,26
35203,Jammeslight,quelthalas,1652,priest,discipline,154,81,73
35204,Glassbirds,stormrage,1652,priest,discipline,48,25,23
35205,Airalia,bleeding-hollow,1650,priest,discipline,36,23,13
35206,Somefire,proudmoore,1650,priest,discipline,155,78,77
35207,Peelforheals,nordrassil,1650,priest,discipline,78,39,39
35208,Yotz,destromath,1650,priest,discipline,60,27,33
35209,Packa,khaz-modan,1649,priest,discipline,42,26,16
35210,Hanley,tichondrius,1649,priest,discipline,85,48,37
35211,Larry,tichondrius,1649,priest,discipline,65,31,34
35212,Jatral,azralon,1649,priest,discipline,64,30,34
35213,Nopang,tichondrius,1649,priest,discipline,167,77,90
35214,Lanäthel,sargeras,1648,priest,discipline,28,19,9
35215,Nancya,stormrage,1648,priest,discipline,69,45,24
35216,Dreamteller,tichondrius,1648,priest,discipline,48,24,24
35217,Eazyp,stormrage,1647,priest,discipline,34,19,15
35218,Jönsnow,ghostlands,1647,priest,discipline,78,42,36
35219,Bigtomwudi,illidan,1647,priest,discipline,82,43,39
35220,Krewesin,ravencrest,1647,priest,discipline,43,22,21
35221,Trollpreist,tichondrius,1647,priest,discipline,148,75,73
35222,Lòthnalar,ragnaros,1647,priest,discipline,60,29,31
35223,Dorazòn,bleeding-hollow,1647,priest,discipline,54,25,29
35224,Twistynipple,malganis,1646,priest,discipline,42,25,17
35225,Saintguard,tichondrius,1646,priest,discipline,246,127,119
35226,Iamjakehill,area-52,1646,priest,discipline,154,79,75
35227,Rosaparksxo,sargeras,1645,priest,discipline,70,35,35
35228,Piils,sargeras,1645,priest,discipline,42,21,21
35229,Cavatea,illidan,1645,priest,discipline,42,21,21
35230,Maatrrixx,drakkari,1645,priest,discipline,60,19,41
35231,Azurestorm,tichondrius,1644,priest,discipline,60,31,29
35232,Cptcancer,tichondrius,1644,priest,discipline,54,23,31
35233,Toddmund,tichondrius,1644,priest,discipline,64,25,39
35234,Tonydatiger,the-forgotten-coast,1643,priest,discipline,36,21,15
35235,Silkydeath,frostmourne,1643,priest,discipline,60,33,27
35236,Holyneuro,illidan,1643,priest,discipline,42,22,20
35237,Judis,barthilas,1643,priest,discipline,78,39,39
35238,Skwishee,illidan,1642,priest,discipline,58,36,22
35239,Kuell,ragnaros,1642,priest,discipline,53,29,24
35240,Ixchelune,kelthuzad,1642,priest,discipline,243,122,121
35241,Reiae,malganis,1642,priest,discipline,70,27,43
35242,Alguîen,ragnaros,1640,priest,discipline,115,61,54
35243,Life,amanthul,1639,priest,discipline,143,84,59
35244,Randompreest,stormrage,1639,priest,discipline,42,23,19
35245,Purplepil,sargeras,1639,priest,discipline,36,18,18
35246,Lunarina,hyjal,1638,priest,discipline,167,75,92
35247,Manryu,tichondrius,1637,priest,discipline,132,68,64
35248,Evvylou,stormrage,1637,priest,discipline,42,19,23
35249,Zprist,illidan,1637,priest,discipline,66,29,37
35250,Choochang,sargeras,1636,priest,discipline,35,27,8
35251,Aethriem,bleeding-hollow,1636,priest,discipline,54,33,21
35252,Notkim,zuljin,1636,priest,discipline,83,47,36
35253,Takomochi,sargeras,1636,priest,discipline,41,22,19
35254,Purged,shadowmoon,1636,priest,discipline,379,203,176
35255,Döllyy,illidan,1636,priest,discipline,48,22,26
35256,Oiled,barthilas,1635,priest,discipline,98,63,35
35257,Frag,frostmourne,1635,priest,discipline,132,72,60
35258,Mutedox,frostmourne,1635,priest,discipline,47,24,23
35259,Mangolatte,frostmourne,1634,priest,discipline,55,41,14
35260,Thirdplace,tichondrius,1634,priest,discipline,36,24,12
35261,Ngin,queldorei,1634,priest,discipline,36,21,15
35262,Hårper,area-52,1634,priest,discipline,75,37,38
35263,Beejaex,stormreaver,1634,priest,discipline,48,22,26
35264,Benedictiion,tichondrius,1634,priest,discipline,86,38,48
35265,Zëref,azralon,1633,priest,discipline,88,52,36
35266,Priestreto,zuljin,1633,priest,discipline,119,66,53
35267,Creòle,area-52,1633,priest,discipline,42,23,19
35268,Huxleypoo,boulderfist,1633,priest,discipline,42,22,20
35269,Kazuret,ragnaros,1633,priest,discipline,272,141,131
35270,Bacpack,area-52,1633,priest,discipline,177,89,88
35271,Jâmïè,gurubashi,1632,priest,discipline,41,31,10
35272,Neuterednuts,zuljin,1632,priest,discipline,48,27,21
35273,Hasby,area-52,1632,priest,discipline,180,99,81
35274,Ärchangél,tichondrius,1632,priest,discipline,98,52,46
35275,Buhroke,thrall,1632,priest,discipline,62,29,33
35276,Soulcleave,dark-iron,1632,priest,discipline,84,38,46
35277,Kayare,area-52,1632,priest,discipline,53,23,30
35278,Haquin,malganis,1632,priest,discipline,42,18,24
35279,Justanoutlaw,darkspear,1631,priest,discipline,102,64,38
35280,Gödtier,frostwolf,1631,priest,discipline,42,18,24
35281,Meip,illidan,1630,priest,discipline,24,17,7
35282,Jâldabaoth,area-52,1630,priest,discipline,72,45,27
35283,Skadín,stormrage,1630,priest,discipline,155,92,63
35284,Gamepass,tichondrius,1630,priest,discipline,48,24,24
35285,Megz,zuljin,1630,priest,discipline,46,23,23
35286,Asj,illidan,1629,priest,discipline,45,30,15
35287,Valyx,tichondrius,1629,priest,discipline,189,102,87
35288,Bluecho,tichondrius,1629,priest,discipline,48,25,23
35289,Szx,akama,1629,priest,discipline,50,24,26
35290,Jzd,dreadmaul,1628,priest,discipline,66,36,30
35291,Bustit,azgalor,1628,priest,discipline,52,28,24
35292,Kazgry,illidan,1628,priest,discipline,42,22,20
35293,Bhoyka,ragnaros,1628,priest,discipline,57,29,28
35294,Chookspriest,tichondrius,1628,priest,discipline,179,90,89
35295,Crawly,illidan,1628,priest,discipline,119,59,60
35296,Jaysshadow,illidan,1627,priest,discipline,35,23,12
35297,Archecho,area-52,1627,priest,discipline,36,22,14
35298,Oesobagi,tichondrius,1627,priest,discipline,113,66,47
35299,Saltlevels,sargeras,1627,priest,discipline,174,94,80
35300,Djc,tichondrius,1627,priest,discipline,96,50,46
35301,Gutrìck,tichondrius,1627,priest,discipline,42,20,22
35302,Çammy,frostmourne,1626,priest,discipline,24,17,7
35303,Andrew,sargeras,1626,priest,discipline,30,20,10
35304,Discavow,bleeding-hollow,1626,priest,discipline,51,31,20
35305,Krupticus,tichondrius,1626,priest,discipline,40,24,16
35306,Brothercarl,stormrage,1626,priest,discipline,95,51,44
35307,Arianagrande,garona,1626,priest,discipline,95,50,45
35308,Raxekk,stormrage,1626,priest,discipline,48,25,23
35309,Odealp,stormscale,1626,priest,discipline,42,20,22
35310,Uroka,malganis,1626,priest,discipline,42,19,23
35311,Bòngu,tichondrius,1626,priest,discipline,58,24,34
35312,Mylo,azralon,1625,priest,discipline,48,28,20
35313,Psycozis,hyjal,1625,priest,discipline,262,138,124
35314,Luhhx,sargeras,1625,priest,discipline,134,70,64
35315,Highmoon,kelthuzad,1625,priest,discipline,42,20,22
35316,Esciel,ragnaros,1625,priest,discipline,122,57,65
35317,Linarindil,hyjal,1624,priest,discipline,126,63,63
35318,Zunari,thrall,1624,priest,discipline,54,27,27
35319,Momorabbit,tichondrius,1624,priest,discipline,36,17,19
35320,Ussmissouri,area-52,1624,priest,discipline,141,63,78
35321,Bobbyrich,sargeras,1623,priest,discipline,30,18,12
35322,Caesus,sargeras,1623,priest,discipline,124,70,54
35323,Fenty,nemesis,1623,priest,discipline,95,51,44
35324,Bonoo,tichondrius,1623,priest,discipline,335,175,160
35325,Nutshotxx,skullcrusher,1623,priest,discipline,250,118,132
35326,Astrøpriest,tichondrius,1623,priest,discipline,66,28,38
35327,Leviathanh,tichondrius,1622,priest,discipline,104,67,37
35328,Elbeefsteak,ragnaros,1622,priest,discipline,54,32,22
35329,Swagraptor,stormreaver,1622,priest,discipline,168,89,79
35330,Lawbster,jubeithos,1622,priest,discipline,34,18,16
35331,Grizzlysmite,stormrage,1622,priest,discipline,361,177,184
35332,Vsat,illidan,1622,priest,discipline,54,26,28
35333,Badhabit,zuluhed,1622,priest,discipline,109,51,58
35334,Wickedpriest,malganis,1622,priest,discipline,54,25,29
35335,Kûrtt,azralon,1622,priest,discipline,42,19,23
35336,Woodricks,frostmourne,1622,priest,discipline,71,27,44
35337,Spicer,eredar,1621,priest,discipline,41,25,16
35338,Tuniepope,sargeras,1621,priest,discipline,75,45,30
35339,Pedobearx,ragnaros,1621,priest,discipline,178,89,89
35340,Deathsmoke,ragnaros,1621,priest,discipline,112,55,57
35341,Fialiadia,illidan,1621,priest,discipline,54,20,34
35342,Tammyone,emerald-dream,1620,priest,discipline,66,42,24
35343,Pigro,area-52,1620,priest,discipline,30,19,11
35344,Wodturbo,bleeding-hollow,1620,priest,discipline,61,36,25
35345,Holyphodays,sargeras,1620,priest,discipline,193,105,88
35346,Brxddx,sargeras,1620,priest,discipline,125,64,61
35347,Darknuzs,sargeras,1620,priest,discipline,42,21,21
35348,Umadcüzubad,azralon,1620,priest,discipline,127,62,65
35349,Gosarix,tichondrius,1619,priest,discipline,24,17,7
35350,Meditåtion,tichondrius,1619,priest,discipline,280,149,131
35351,Crøws,ragnaros,1619,priest,discipline,294,145,149
35352,Dfâc,moon-guard,1619,priest,discipline,96,47,49
35353,Baddmachine,illidan,1619,priest,discipline,47,21,26
35354,Skcits,sargeras,1618,priest,discipline,42,26,16
35355,Conezy,frostmourne,1618,priest,discipline,78,42,36
35356,Nohéalforu,stormrage,1618,priest,discipline,48,25,23
35357,Discgoddess,proudmoore,1618,priest,discipline,169,87,82
35358,Punisherror,area-52,1618,priest,discipline,52,22,30
35359,Jmr,onyxia,1617,priest,discipline,24,17,7
35360,Cazuex,ragnaros,1617,priest,discipline,30,20,10
35361,Khathor,kargath,1617,priest,discipline,30,17,13
35362,Gurlyounasty,khazgoroth,1617,priest,discipline,103,55,48
35363,Ezelra,frostmourne,1617,priest,discipline,47,25,22
35364,Ingladforx,azralon,1617,priest,discipline,83,41,42
35365,Maxla,tichondrius,1616,priest,discipline,119,71,48
35366,Prayussy,tichondrius,1616,priest,discipline,135,72,63
35367,Charbosan,gorgonnash,1616,priest,discipline,746,383,363
35368,Zyonn,chogall,1616,priest,discipline,36,18,18
35369,Anahka,tichondrius,1616,priest,discipline,48,21,27
35370,Shaddäye,andorhal,1616,priest,discipline,48,20,28
35371,Apathist,sargeras,1615,priest,discipline,72,45,27
35372,Saintpleb,sargeras,1615,priest,discipline,30,18,12
35373,Kraamur,area-52,1615,priest,discipline,96,57,39
35374,Predolph,illidan,1615,priest,discipline,60,34,26
35375,Jîtters,silvermoon,1615,priest,discipline,84,45,39
35376,Halfcutt,tichondrius,1615,priest,discipline,96,48,48
35377,Velandrys,earthen-ring,1614,priest,discipline,72,36,36
35378,Hottymcdotty,black-dragonflight,1614,priest,discipline,42,21,21
35379,Galandora,kelthuzad,1614,priest,discipline,48,23,25
35380,Selfless,barthilas,1614,priest,discipline,66,28,38
35381,Iovedoctor,tichondrius,1614,priest,discipline,78,25,53
35382,Sâsh,stormrage,1613,priest,discipline,72,40,32
35383,Lîk,tichondrius,1613,priest,discipline,193,107,86
35384,Aåurøra,stormrage,1613,priest,discipline,46,23,23
35385,Trezz,hakkar,1613,priest,discipline,46,23,23
35386,ßðßßÿ,area-52,1613,priest,discipline,42,21,21
35387,Mattgarska,tichondrius,1613,priest,discipline,48,17,31
35388,Alfié,kelthuzad,1612,priest,discipline,48,33,15
35389,Draxxankou,tanaris,1612,priest,discipline,103,59,44
35390,Bombdevil,quelthalas,1612,priest,discipline,72,40,32
35391,Itachî,ravencrest,1612,priest,discipline,42,23,19
35392,Kks,tichondrius,1612,priest,discipline,90,46,44
35393,Halö,area-52,1612,priest,discipline,246,125,121
35394,Alphôn,bleeding-hollow,1612,priest,discipline,36,17,19
35395,Spicey,korgath,1611,priest,discipline,51,37,14
35396,Gsek,nemesis,1611,priest,discipline,36,23,13
35397,Scruge,frostmourne,1611,priest,discipline,55,32,23
35398,Littleshower,illidan,1611,priest,discipline,43,23,20
35399,Vincejddp,zuljin,1611,priest,discipline,199,105,94
35400,Tonybanderas,shattered-halls,1611,priest,discipline,120,63,57
35401,Haill,quelthalas,1611,priest,discipline,76,38,38
35402,Shadoris,antonidas,1611,priest,discipline,48,23,25
35403,Cinsare,moon-guard,1610,priest,discipline,84,49,35
35404,Psychic,bladefist,1610,priest,discipline,130,75,55
35405,Yidra,illidan,1610,priest,discipline,36,19,17
35406,Blathers,malganis,1610,priest,discipline,92,48,44
35407,Moalboal,tichondrius,1610,priest,discipline,268,136,132
35408,Billybobjane,jubeithos,1610,priest,discipline,42,21,21
35409,Interworld,illidan,1610,priest,discipline,50,24,26
35410,Mortteus,agamaggan,1610,priest,discipline,60,28,32
35411,Pleasant,dathremar,1610,priest,discipline,123,52,71
35412,Twistèr,zuljin,1610,priest,discipline,69,29,40
35413,Degenerates,blood-furnace,1610,priest,discipline,48,20,28
35414,Másterclass,stormrage,1609,priest,discipline,29,22,7
35415,Smashhley,bleeding-hollow,1609,priest,discipline,200,114,86
35416,Krusheal,tichondrius,1609,priest,discipline,47,22,25
35417,Gránd,emerald-dream,1609,priest,discipline,54,22,32
35418,Gsek,azralon,1608,priest,discipline,54,34,20
35419,Cléríc,moon-guard,1608,priest,discipline,67,42,25
35420,Indigojuly,sargeras,1608,priest,discipline,82,47,35
35421,Alcázardeyo,area-52,1608,priest,discipline,150,84,66
35422,Wrekkit,area-52,1608,priest,discipline,84,42,42
35423,Reginaa,nemesis,1608,priest,discipline,65,30,35
35424,Buttfive,illidan,1608,priest,discipline,58,24,34
35425,Lines,sargeras,1607,priest,discipline,88,47,41
35426,Jiñx,destromath,1607,priest,discipline,278,147,131
35427,Kaeda,drenden,1607,priest,discipline,84,44,40
35428,Hootheals,illidan,1607,priest,discipline,46,24,22
35429,Samirah,arthas,1607,priest,discipline,84,43,41
35430,Preeste,stormrage,1607,priest,discipline,44,22,22
35431,Darknus,sargeras,1607,priest,discipline,78,37,41
35432,Rustypinball,bleeding-hollow,1606,priest,discipline,105,62,43
35433,Mkowns,tichondrius,1606,priest,discipline,90,52,38
35434,Teewat,illidan,1606,priest,discipline,42,23,19
35435,Swartzp,tichondrius,1606,priest,discipline,122,64,58
35436,Xhadow,sargeras,1606,priest,discipline,161,84,77
35437,Mclyte,whisperwind,1606,priest,discipline,203,103,100
35438,Healbaby,illidan,1606,priest,discipline,358,181,177
35439,Lovesy,burning-legion,1606,priest,discipline,60,30,30
35440,Darkispriest,tichondrius,1606,priest,discipline,36,17,19
35441,Powerwordqt,kalecgos,1606,priest,discipline,60,26,34
35442,Trojanphobia,bleeding-hollow,1605,priest,discipline,54,29,25
35443,Yoggismydad,emerald-dream,1605,priest,discipline,185,95,90
35444,Shiromar,tichondrius,1605,priest,discipline,102,51,51
35445,Takosoufflé,emerald-dream,1605,priest,discipline,48,22,26
35446,Abbydaddy,illidan,1605,priest,discipline,51,23,28
35447,Lolkwtf,sargeras,1605,priest,discipline,49,22,27
35448,Míkò,sargeras,1604,priest,discipline,18,17,1
35449,Jagita,kelthuzad,1604,priest,discipline,31,20,11
35450,Hoglet,moon-guard,1604,priest,discipline,65,39,26
35451,Tanthsondis,illidan,1604,priest,discipline,54,28,26
35452,Staywild,tichondrius,1604,priest,discipline,66,34,32
35453,Tidbitsy,malganis,1604,priest,discipline,108,55,53
35454,Giblettz,lightbringer,1604,priest,discipline,141,69,72
35455,Vern,laughing-skull,1604,priest,discipline,78,29,49
35456,Zerokool,moonrunner,1603,priest,discipline,48,29,19
35457,Fukneasy,darkspear,1603,priest,discipline,37,20,17
35458,Feymuhsjr,black-dragonflight,1603,priest,discipline,54,29,25
35459,Iamgess,kilrogg,1603,priest,discipline,42,22,20
35460,Tooeasy,vashj,1603,priest,discipline,36,17,19
35461,Xävier,farstriders,1603,priest,discipline,48,22,26
35462,Resortv,illidan,1602,priest,discipline,42,32,10
35463,Hõlyshìt,whisperwind,1602,priest,discipline,30,19,11
35464,Aetyn,tichondrius,1602,priest,discipline,61,33,28
35465,Arcalon,thrall,1602,priest,discipline,86,45,41
35466,Gromkekz,area-52,1602,priest,discipline,73,38,35
35467,Ragretsxo,darkspear,1602,priest,discipline,150,75,75
35468,Manstench,tichondrius,1602,priest,discipline,81,40,41
35469,Crizem,bleeding-hollow,1602,priest,discipline,242,119,123
35470,Bennito,moon-guard,1602,priest,discipline,211,96,115
35471,Ünagi,thrall,1602,priest,discipline,77,34,43
35472,Zymmie,moon-guard,1602,priest,discipline,102,45,57
35473,Psyclick,zuljin,1601,priest,discipline,30,21,9
35474,Invicta,frostwolf,1601,priest,discipline,27,18,9
35475,Hølycrit,icecrown,1601,priest,discipline,63,36,27
35476,Primalshadow,kaelthas,1601,priest,discipline,36,19,17
35477,Størmy,kiljaeden,1601,priest,discipline,306,160,146
35478,Bistek,bleeding-hollow,1601,priest,discipline,166,83,83
35479,Mhp,illidan,1601,priest,discipline,51,20,31
35480,Cyntech,area-52,1600,priest,discipline,29,23,6
35481,Marethelia,stonemaul,1600,priest,discipline,60,34,26
35482,Tricklee,tichondrius,1600,priest,discipline,47,26,21
35483,Cezure,stormrage,1600,priest,discipline,341,187,154
35484,Jhivagosp,tichondrius,1600,priest,discipline,42,23,19
35485,Mepisth,sargeras,1600,priest,discipline,66,36,30
35486,Zarakonna,illidan,1600,priest,discipline,60,32,28
35487,Nijoral,tichondrius,1600,priest,discipline,368,194,174
35488,Eccentrixx,mannoroth,1600,priest,discipline,54,28,26
35489,Zãrrãlis,arthas,1600,priest,discipline,234,115,119
35490,Kukion,uldum,1600,priest,discipline,48,22,26
35491,Smoochinz,sargeras,1600,priest,discipline,52,23,29
35492,Bigsmart,tichondrius,1598,priest,discipline,56,25,31
35493,Dupaforted,stormrage,1598,priest,discipline,71,26,45
35494,Valeilah,illidan,1597,priest,discipline,126,80,46
35495,Healzyea,eonar,1597,priest,discipline,48,28,20
35496,Spx,frostmourne,1597,priest,discipline,84,46,38
35497,Zackor,maiev,1597,priest,discipline,64,34,30
35498,Shutkap,sargeras,1597,priest,discipline,48,23,25
35499,Pocserpriest,drakkari,1597,priest,discipline,44,21,23
35500,Mdibaxx,tichondrius,1597,priest,discipline,89,40,49
35501,Healther,firetree,1596,priest,discipline,48,24,24
35502,Pettypriest,dalaran,1596,priest,discipline,79,39,40
35503,Ivorytiger,bleeding-hollow,1596,priest,discipline,42,19,23
35504,Takethat,emerald-dream,1595,priest,discipline,90,58,32
35505,Serenewisp,tichondrius,1595,priest,discipline,101,48,53
35506,Onezor,frostmourne,1594,priest,discipline,78,39,39
35507,Gummachine,tichondrius,1594,priest,discipline,36,17,19
35508,Comana,frostmourne,1594,priest,discipline,53,25,28
35509,Blacklog,darkspear,1593,priest,discipline,50,25,25
35510,Winsforgoldd,area-52,1593,priest,discipline,57,28,29
35511,Ariês,tichondrius,1593,priest,discipline,60,22,38
35512,Planchebois,zuljin,1592,priest,discipline,36,20,16
35513,Vehex,malganis,1591,priest,discipline,30,20,10
35514,Astalail,emerald-dream,1591,priest,discipline,40,21,19
35515,Dellitor,illidan,1591,priest,discipline,65,33,32
35516,Darenlor,tichondrius,1591,priest,discipline,165,82,83
35517,Blobble,tichondrius,1591,priest,discipline,132,65,67
35518,Yugewap,hyjal,1590,priest,discipline,202,115,87
35519,Aralia,ragnaros,1590,priest,discipline,152,76,76
35520,Isteri,thrall,1590,priest,discipline,52,26,26
35521,Woosanghong,tichondrius,1590,priest,discipline,90,44,46
35522,Sanitizer,frostmourne,1590,priest,discipline,60,28,32
35523,Emotionally,sargeras,1589,priest,discipline,30,20,10
35524,Karmapi,malganis,1589,priest,discipline,54,31,23
35525,Ems,dawnbringer,1589,priest,discipline,243,122,121
35526,Ooft,tichondrius,1589,priest,discipline,46,23,23
35527,Lilbaldjosh,frostmourne,1589,priest,discipline,120,54,66
35528,Bigolbush,moon-guard,1588,priest,discipline,24,17,7
35529,Notoriousmmä,illidan,1588,priest,discipline,75,45,30
35530,Daleyn,ragnaros,1588,priest,discipline,54,30,24
35531,Scpzi,frostmourne,1588,priest,discipline,42,21,21
35532,Raffimilk,tichondrius,1588,priest,discipline,45,22,23
35533,Eggsdenny,illidan,1588,priest,discipline,36,17,19
35534,Rondrica,stormscale,1587,priest,discipline,48,31,17
35535,Voltstein,dalaran,1587,priest,discipline,199,105,94
35536,Buchöna,quelthalas,1587,priest,discipline,113,58,55
35537,Primael,tichondrius,1587,priest,discipline,40,18,22
35538,Highasf,sargeras,1586,priest,discipline,78,45,33
35539,Motions,frostmourne,1586,priest,discipline,56,23,33
35540,Magnuscorp,illidan,1585,priest,discipline,36,20,16
35541,Playsoon,illidan,1585,priest,discipline,130,70,60
35542,Säcrilege,drakkari,1585,priest,discipline,231,123,108
35543,Deadnyx,tichondrius,1585,priest,discipline,42,22,20
35544,Akëla,nemesis,1585,priest,discipline,159,78,81
35545,Angeldawn,stormrage,1585,priest,discipline,40,18,22
35546,Medikhurts,bleeding-hollow,1584,priest,discipline,36,23,13
35547,Arkeyz,quelthalas,1584,priest,discipline,60,30,30
35548,Hermeneutic,illidan,1584,priest,discipline,45,22,23
35549,Tý,frostmourne,1584,priest,discipline,54,24,30
35550,Lovesthebox,frostmourne,1584,priest,discipline,108,47,61
35551,Dotsfortots,malfurion,1583,priest,discipline,41,21,20
35552,Cigarillõ,thrall,1583,priest,discipline,35,17,18
35553,Puttles,tichondrius,1583,priest,discipline,83,33,50
35554,Tastyloads,illidan,1582,priest,discipline,144,74,70
35555,Sacrify,ragnaros,1582,priest,discipline,231,114,117
35556,Vanderbeek,frostmourne,1582,priest,discipline,84,39,45
35557,Bisholan,frostwolf,1582,priest,discipline,97,43,54
35558,Supôrte,nemesis,1581,priest,discipline,101,54,47
35559,Weapestrong,tichondrius,1581,priest,discipline,48,24,24
35560,Shieldharder,stormrage,1581,priest,discipline,39,18,21
35561,Gus,the-venture-co,1580,priest,discipline,78,44,34
35562,Ayabae,illidan,1580,priest,discipline,963,473,490
35563,Dasaq,sargeras,1580,priest,discipline,48,19,29
35564,Cringepriest,area-52,1579,priest,discipline,54,33,21
35565,Faithmelter,stormrage,1579,priest,discipline,167,89,78
35566,Tyksu,area-52,1579,priest,discipline,201,106,95
35567,Csjy,illidan,1579,priest,discipline,78,37,41
35568,Carti,bleeding-hollow,1578,priest,discipline,244,135,109
35569,Zyklonova,frostmourne,1578,priest,discipline,42,22,20
35570,Zombiz,tichondrius,1577,priest,discipline,59,32,27
35571,Sensaye,dalaran,1577,priest,discipline,150,76,74
35572,Marshpillow,barthilas,1577,priest,discipline,192,96,96
35573,Zizziz,tichondrius,1577,priest,discipline,66,33,33
35574,Katlø,stormrage,1576,priest,discipline,49,29,20
35575,Bater,mugthol,1576,priest,discipline,52,30,22
35576,Rexîfy,zuljin,1576,priest,discipline,75,43,32
35577,Lolweedbro,illidan,1576,priest,discipline,160,90,70
35578,Alaran,magtheridon,1576,priest,discipline,47,23,24
35579,Knucklesandy,tichondrius,1576,priest,discipline,35,17,18
35580,Oyy,barthilas,1576,priest,discipline,102,48,54
35581,Mettypws,tichondrius,1576,priest,discipline,71,33,38
35582,Staysmall,stormrage,1576,priest,discipline,42,19,23
35583,Descubra,stormrage,1575,priest,discipline,102,60,42
35584,Blindingstar,area-52,1575,priest,discipline,69,39,30
35585,Amaranth,the-forgotten-coast,1575,priest,discipline,48,26,22
35586,Honeyduutch,black-dragonflight,1575,priest,discipline,90,44,46
35587,Ketapriest,frostmourne,1575,priest,discipline,142,67,75
35588,Yungbaker,area-52,1574,priest,discipline,29,17,12
35589,Discobish,sargeras,1574,priest,discipline,48,21,27
35590,Brezi,azralon,1573,priest,discipline,53,32,21
35591,Fleshsack,area-52,1573,priest,discipline,30,17,13
35592,Skillfull,chogall,1573,priest,discipline,312,168,144
35593,Hopanda,tichondrius,1573,priest,discipline,89,47,42
35594,Catpictures,stormrage,1573,priest,discipline,54,26,28
35595,Kihlupr,frostmourne,1573,priest,discipline,58,25,33
35596,Cäpriestsunn,thrall,1572,priest,discipline,36,22,14
35597,Hoshx,sargeras,1572,priest,discipline,87,49,38
35598,Overpriest,ragnaros,1572,priest,discipline,40,22,18
35599,Bubblebuddí,tichondrius,1572,priest,discipline,68,37,31
35600,Flatlining,illidan,1572,priest,discipline,90,48,42
35601,Seriosity,kelthuzad,1572,priest,discipline,54,23,31
35602,Anastasìá,barthilas,1572,priest,discipline,64,23,41
35603,Archeo,area-52,1572,priest,discipline,60,19,41
35604,Madpriest,blades-edge,1571,priest,discipline,36,20,16
35605,Bushybush,darkspear,1571,priest,discipline,120,63,57
35606,Tokaru,frostmourne,1571,priest,discipline,56,26,30
35607,Whitecaster,tichondrius,1570,priest,discipline,30,17,13
35608,Gommacura,stormrage,1570,priest,discipline,405,208,197
35609,Zinnar,dalaran,1570,priest,discipline,120,54,66
35610,Liteztvp,tichondrius,1570,priest,discipline,168,75,93
35611,Soõ,tichondrius,1569,priest,discipline,33,21,12
35612,Goo,boulderfist,1569,priest,discipline,48,29,19
35613,Ppsp,azralon,1569,priest,discipline,42,25,17
35614,Incisions,moon-guard,1569,priest,discipline,114,61,53
35615,Ol,firetree,1569,priest,discipline,57,28,29
35616,Purgen,tichondrius,1568,priest,discipline,36,20,16
35617,Sêlbus,stormrage,1568,priest,discipline,287,148,139
35618,Holécriss,tichondrius,1568,priest,discipline,173,88,85
35619,Lelenia,tichondrius,1568,priest,discipline,130,65,65
35620,Disperse,vashj,1568,priest,discipline,197,96,101
35621,Hennywhite,sargeras,1568,priest,discipline,107,51,56
35622,Aleana,ragnaros,1568,priest,discipline,54,25,29
35623,Padrekevedø,azralon,1567,priest,discipline,42,27,15
35624,Sïlvermoon,ravencrest,1567,priest,discipline,36,20,16
35625,Safetyy,bleeding-hollow,1567,priest,discipline,44,24,20
35626,Feymuhs,blackrock,1567,priest,discipline,90,48,42
35627,Aphrodìtë,tichondrius,1567,priest,discipline,145,75,70
35628,Karebenniian,area-52,1567,priest,discipline,117,59,58
35629,Fairlightpp,zuljin,1567,priest,discipline,78,39,39
35630,Priestykro,stormrage,1567,priest,discipline,60,28,32
35631,Itsmurphy,sargeras,1567,priest,discipline,156,72,84
35632,Gospels,tichondrius,1566,priest,discipline,52,37,15
35633,Kflexx,hydraxis,1566,priest,discipline,158,64,94
35634,Alexsp,amanthul,1565,priest,discipline,76,45,31
35635,Sacredlight,malygos,1565,priest,discipline,117,61,56
35636,Amayå,kelthuzad,1565,priest,discipline,54,23,31
35637,Feivalentine,illidan,1565,priest,discipline,42,17,25
35638,Scarabless,bleeding-hollow,1564,priest,discipline,138,62,76
35639,Whateverbrah,tichondrius,1564,priest,discipline,45,20,25
35640,Goodvybes,tichondrius,1563,priest,discipline,89,46,43
35641,Valdurai,stormrage,1563,priest,discipline,47,24,23
35642,Myles,alexstrasza,1563,priest,discipline,186,93,93
35643,Soyul,tichondrius,1563,priest,discipline,47,19,28
35644,Hadtogothere,kelthuzad,1562,priest,discipline,209,103,106
35645,Zortkis,garithos,1562,priest,discipline,58,25,33
35646,Dreaminz,tichondrius,1561,priest,discipline,42,26,16
35647,Maomaoangel,tichondrius,1561,priest,discipline,60,30,30
35648,Jjmms,akama,1561,priest,discipline,322,149,173
35649,Jylertason,kelthuzad,1561,priest,discipline,58,26,32
35650,Eshimä,quelthalas,1560,priest,discipline,138,82,56
35651,Antifaithx,frostmourne,1560,priest,discipline,36,21,15
35652,Googolplex,tichondrius,1560,priest,discipline,93,54,39
35653,Verna,dunemaul,1560,priest,discipline,91,50,41
35654,Holyvoice,wyrmrest-accord,1560,priest,discipline,75,40,35
35655,Shathraxi,crushridge,1560,priest,discipline,48,21,27
35656,Moustachío,stormrage,1559,priest,discipline,59,27,32
35657,Melitele,magtheridon,1558,priest,discipline,36,21,15
35658,Vanco,tichondrius,1558,priest,discipline,59,32,27
35659,Twistinfate,hyjal,1558,priest,discipline,119,58,61
35660,Someonesxy,aggramar,1558,priest,discipline,46,22,24
35661,Siddhar,illidan,1558,priest,discipline,49,23,26
35662,Pennumbra,barthilas,1558,priest,discipline,84,31,53
35663,Bobelgum,emerald-dream,1557,priest,discipline,42,31,11
35664,Qenq,tichondrius,1557,priest,discipline,30,17,13
35665,Zachlol,area-52,1557,priest,discipline,108,61,47
35666,Vullena,moon-guard,1557,priest,discipline,152,80,72
35667,Gucciflops,tichondrius,1557,priest,discipline,48,25,23
35668,Illuminare,sargeras,1557,priest,discipline,166,85,81
35669,Dontgome,proudmoore,1557,priest,discipline,42,21,21
35670,Ropriest,frostmourne,1557,priest,discipline,59,29,30
35671,Zelfina,arthas,1557,priest,discipline,42,20,22
35672,Datdarnbéar,stormrage,1557,priest,discipline,54,25,29
35673,Chocopp,illidan,1557,priest,discipline,78,33,45
35674,Luxah,bloodhoof,1556,priest,discipline,51,31,20
35675,Qoon,tichondrius,1556,priest,discipline,30,17,13
35676,Vicara,moon-guard,1556,priest,discipline,129,57,72
35677,Tarlonypp,malganis,1555,priest,discipline,45,22,23
35678,Avashar,illidan,1555,priest,discipline,42,20,22
35679,Sinnskløft,tichondrius,1555,priest,discipline,56,23,33
35680,Josquin,illidan,1554,priest,discipline,120,60,60
35681,Marantbourge,frostmourne,1554,priest,discipline,146,71,75
35682,Overshields,caelestrasz,1554,priest,discipline,52,19,33
35683,Hiraa,frostmourne,1553,priest,discipline,36,23,13
35684,Saentha,sargeras,1553,priest,discipline,74,40,34
35685,Cario,emerald-dream,1553,priest,discipline,45,24,21
35686,Gilthðniel,quelthalas,1552,priest,discipline,231,111,120
35687,Mfynch,sargeras,1551,priest,discipline,66,40,26
35688,Grannieslove,sargeras,1551,priest,discipline,48,28,20
35689,Magazíne,tichondrius,1551,priest,discipline,42,23,19
35690,Leliane,tichondrius,1551,priest,discipline,66,35,31
35691,Sorrowful,mannoroth,1550,priest,discipline,30,19,11
35692,Sensitive,eitrigg,1550,priest,discipline,36,22,14
35693,Cultxo,sargeras,1550,priest,discipline,66,37,29
35694,Orzington,laughing-skull,1550,priest,discipline,122,66,56
35695,Unisia,tichondrius,1550,priest,discipline,98,41,57
35696,Rebzyyx,tichondrius,1549,priest,discipline,38,25,13
35697,Senpriest,ragnaros,1549,priest,discipline,35,21,14
35698,Jabreez,illidan,1549,priest,discipline,59,35,24
35699,Rousesz,ragnaros,1549,priest,discipline,42,23,19
35700,Keaina,malganis,1549,priest,discipline,49,25,24
35701,Önagashøw,azralon,1549,priest,discipline,277,140,137
35702,Rourk,medivh,1549,priest,discipline,161,81,80
35703,Spacecowboyz,stormrage,1549,priest,discipline,60,30,30
35704,Lydra,ragnaros,1549,priest,discipline,231,109,122
35705,Rdson,malganis,1549,priest,discipline,43,18,25
35706,Fámóus,stormrage,1549,priest,discipline,83,30,53
35707,Nisagerx,tichondrius,1548,priest,discipline,33,19,14
35708,Mudshadow,tichondrius,1548,priest,discipline,138,71,67
35709,Nelfpriest,khadgar,1548,priest,discipline,89,44,45
35710,Inerluna,tichondrius,1548,priest,discipline,75,31,44
35711,Kencyy,tichondrius,1547,priest,discipline,30,19,11
35712,Azureslaps,tichondrius,1547,priest,discipline,218,109,109
35713,Jugeumx,proudmoore,1547,priest,discipline,48,19,29
35714,Uriyel,quelthalas,1546,priest,discipline,119,62,57
35715,Androalis,thaurissan,1546,priest,discipline,102,53,49
35716,Zugzugheal,bleeding-hollow,1546,priest,discipline,75,35,40
35717,Bóì,barthilas,1545,priest,discipline,36,26,10
35718,Jtrxyz,tichondrius,1545,priest,discipline,30,18,12
35719,Wisher,tichondrius,1545,priest,discipline,188,89,99
35720,Shadöwtest,quelthalas,1545,priest,discipline,113,49,64
35721,Juckerr,tichondrius,1544,priest,discipline,251,132,119
35722,Ricekak,haomarush,1543,priest,discipline,78,46,32
35723,Curemeste,illidan,1543,priest,discipline,151,81,70
35724,Matics,tichondrius,1543,priest,discipline,62,33,29
35725,Xillak,ragnaros,1543,priest,discipline,36,19,17
35726,Dawnsy,arygos,1543,priest,discipline,56,26,30
35727,Played,dark-iron,1543,priest,discipline,62,24,38
35728,Happylonely,farstriders,1542,priest,discipline,33,20,13
35729,Justashadow,zangarmarsh,1542,priest,discipline,103,59,44
35730,Metick,illidan,1542,priest,discipline,48,18,30
35731,Benin,shattered-hand,1541,priest,discipline,36,22,14
35732,Extel,sargeras,1541,priest,discipline,54,30,24
35733,Zórg,stormrage,1541,priest,discipline,56,30,26
35734,Makuwu,area-52,1541,priest,discipline,93,49,44
35735,Winss,tichondrius,1541,priest,discipline,220,114,106
35736,Jacksreturne,kelthuzad,1541,priest,discipline,502,255,247
35737,Slipzie,sargeras,1540,priest,discipline,95,55,40
35738,Qmabayteckkl,tichondrius,1540,priest,discipline,42,23,19
35739,Shastyr,tichondrius,1540,priest,discipline,90,46,44
35740,Alex,boulderfist,1540,priest,discipline,189,90,99
35741,Unholyhusky,sargeras,1539,priest,discipline,60,38,22
35742,Voidmutex,emerald-dream,1539,priest,discipline,41,22,19
35743,Daddydoeet,zuljin,1539,priest,discipline,42,22,20
35744,Akayayuelol,tichondrius,1538,priest,discipline,37,28,9
35745,Life,thrall,1538,priest,discipline,101,50,51
35746,Mutilla,tichondrius,1537,priest,discipline,32,22,10
35747,Shadowdaddy,barthilas,1537,priest,discipline,96,55,41
35748,Yangpriest,malfurion,1537,priest,discipline,51,26,25
35749,Babirygen,khaz-modan,1537,priest,discipline,48,23,25
35750,Voidrachet,thrall,1537,priest,discipline,48,18,30
35751,Tokoyo,sargeras,1536,priest,discipline,82,53,29
35752,Croissånt,illidan,1536,priest,discipline,30,18,12
35753,Sportsgloss,tichondrius,1536,priest,discipline,132,73,59
35754,Calientaeggs,drakkari,1536,priest,discipline,382,202,180
35755,Psyclicker,zuljin,1536,priest,discipline,47,23,24
35756,Shadowgobbo,thrall,1536,priest,discipline,66,31,35
35757,Priestsz,stormrage,1535,priest,discipline,169,90,79
35758,Zivn,tichondrius,1535,priest,discipline,766,399,367
35759,Santhiel,ragnaros,1535,priest,discipline,42,18,24
35760,Mattkoster,mannoroth,1535,priest,discipline,44,17,27
35761,Mswatermelon,malganis,1534,priest,discipline,44,24,20
35762,Sevÿ,malygos,1534,priest,discipline,40,20,20
35763,Dopeyspriest,area-52,1534,priest,discipline,50,24,26
35764,Maid,demon-soul,1534,priest,discipline,63,28,35
35765,Anastasiá,barthilas,1534,priest,discipline,48,21,27
35766,Shadowglezy,area-52,1533,priest,discipline,107,59,48
35767,Wtfamdoing,quelthalas,1533,priest,discipline,65,35,30
35768,Baìter,zuljin,1533,priest,discipline,89,47,42
35769,Wiñtér,tichondrius,1533,priest,discipline,54,28,26
35770,Vorazzun,quelthalas,1533,priest,discipline,100,50,50
35771,Priesmatco,area-52,1533,priest,discipline,81,40,41
35772,Holdentudikz,area-52,1533,priest,discipline,89,43,46
35773,Suitoo,ragnaros,1533,priest,discipline,54,25,29
35774,Nesx,azuremyst,1532,priest,discipline,66,40,26
35775,Zsofi,rivendare,1532,priest,discipline,116,54,62
35776,Cityboyy,tichondrius,1532,priest,discipline,37,17,20
35777,Goatedpriest,kelthuzad,1531,priest,discipline,24,16,8
35778,Wbu,frostmourne,1531,priest,discipline,28,17,11
35779,Pryst,bonechewer,1531,priest,discipline,54,28,26
35780,Vañity,malganis,1531,priest,discipline,66,33,33
35781,Nonbinary,trollbane,1531,priest,discipline,60,26,34
35782,Mombi,bloodhoof,1530,priest,discipline,30,18,12
35783,Besó,proudmoore,1530,priest,discipline,144,81,63
35784,Merkinhealz,darkspear,1530,priest,discipline,112,59,53
35785,Emytoty,ragnaros,1530,priest,discipline,190,99,91
35786,Aríola,frostmourne,1529,priest,discipline,69,37,32
35787,Truce,moon-guard,1528,priest,discipline,77,39,38
35788,Mindblasterx,kelthuzad,1528,priest,discipline,345,171,174
35789,Bigwap,illidan,1528,priest,discipline,66,30,36
35790,Rafers,tichondrius,1528,priest,discipline,36,16,20
35791,Epijho,area-52,1527,priest,discipline,42,25,17
35792,Jamesxupttv,draenor,1527,priest,discipline,82,48,34
35793,Slippedadisc,kelthuzad,1527,priest,discipline,108,59,49
35794,Kencyx,tichondrius,1527,priest,discipline,30,16,14
35795,Lightsight,burning-blade,1527,priest,discipline,30,16,14
35796,Vezaxx,barthilas,1527,priest,discipline,178,92,86
35797,Luxury,blackrock,1527,priest,discipline,54,27,27
35798,Suekmydisc,frostmourne,1526,priest,discipline,36,20,16
35799,Nerfdisc,azralon,1526,priest,discipline,159,84,75
35800,Lolcrafthd,ragnaros,1526,priest,discipline,124,62,62
35801,Alëssana,illidan,1526,priest,discipline,128,63,65
35802,Mastahspell,illidan,1526,priest,discipline,36,16,20
35803,Wonpaipri,frostmourne,1526,priest,discipline,110,48,62
35804,Ghostchant,thrall,1525,priest,discipline,41,20,21
35805,Pilixil,bleeding-hollow,1525,priest,discipline,72,35,37
35806,Tooze,draka,1525,priest,discipline,60,27,33
35807,Umbrous,ysera,1525,priest,discipline,42,18,24
35808,Ååron,illidan,1524,priest,discipline,76,44,32
35809,Gankdez,kelthuzad,1524,priest,discipline,136,69,67
35810,Rómmul,azralon,1524,priest,discipline,71,34,37
35811,Psÿçhë,stormrage,1524,priest,discipline,36,16,20
35812,Somethingkoo,sargeras,1523,priest,discipline,83,46,37
35813,Sonofbetch,emerald-dream,1523,priest,discipline,55,30,25
35814,Swiggster,thrall,1523,priest,discipline,84,44,40
35815,Bloodytears,kiljaeden,1523,priest,discipline,138,65,73
35816,Ivf,darrowmere,1523,priest,discipline,125,57,68
35817,Antonietta,drakkari,1522,priest,discipline,24,16,8
35818,Ricopri,frostmourne,1522,priest,discipline,36,23,13
35819,Sadnez,illidan,1522,priest,discipline,157,89,68
35820,Madhairy,ragnaros,1522,priest,discipline,126,65,61
35821,Niurouchuan,tichondrius,1522,priest,discipline,123,60,63
35822,Lauretânia,nemesis,1522,priest,discipline,146,71,75
35823,Zenobiai,hyjal,1521,priest,discipline,163,87,76
35824,Rhima,tichondrius,1521,priest,discipline,133,67,66
35825,Elysiana,wyrmrest-accord,1521,priest,discipline,66,33,33
35826,Pheener,stormreaver,1521,priest,discipline,198,97,101
35827,Frymii,frostmourne,1521,priest,discipline,36,16,20
35828,Magpul,arthas,1521,priest,discipline,36,16,20
35829,Herder,zuljin,1520,priest,discipline,52,30,22
35830,Angusb,sargeras,1520,priest,discipline,170,85,85
35831,Ezzy,bleeding-hollow,1520,priest,discipline,48,24,24
35832,Razledazzled,grizzly-hills,1520,priest,discipline,133,63,70
35833,Oneinurdome,moknathal,1520,priest,discipline,60,28,32
35834,Vegfem,dalaran,1520,priest,discipline,64,27,37
35835,Holyclappah,illidan,1519,priest,discipline,233,122,111
35836,Radackan,quelthalas,1519,priest,discipline,117,61,56
35837,Kimjongdots,illidan,1519,priest,discipline,56,29,27
35838,Hideyason,area-52,1519,priest,discipline,60,31,29
35839,Zllik,illidan,1519,priest,discipline,101,52,49
35840,Friendzonefw,illidan,1519,priest,discipline,144,71,73
35841,Dædrà,stormrage,1519,priest,discipline,76,37,39
35842,Blessrish,icecrown,1519,priest,discipline,66,31,35
35843,Akuhei,illidan,1518,priest,discipline,24,16,8
35844,Peacewrench,moon-guard,1518,priest,discipline,118,59,59
35845,Cexcexyomi,tichondrius,1517,priest,discipline,94,50,44
35846,Erinzdern,quelthalas,1517,priest,discipline,88,43,45
35847,Joní,malganis,1517,priest,discipline,41,18,23
35848,Tbirdpriest,tichondrius,1516,priest,discipline,46,27,19
35849,Ilickdeadppl,sargeras,1516,priest,discipline,82,47,35
35850,Swapsy,illidan,1516,priest,discipline,53,29,24
35851,Bonnieron,frostmourne,1516,priest,discipline,77,39,38
35852,Triangle,draka,1516,priest,discipline,36,17,19
35853,Drupmonst,dalaran,1516,priest,discipline,60,26,34
35854,Vels,blackrock,1515,priest,discipline,30,18,12
35855,Dsls,daggerspine,1515,priest,discipline,30,16,14
35856,Lyrä,kiljaeden,1515,priest,discipline,102,54,48
35857,Lavenderism,moon-guard,1515,priest,discipline,96,50,46
35858,Undevout,tichondrius,1515,priest,discipline,36,16,20
35859,Mxst,frostmourne,1514,priest,discipline,18,16,2
35860,Stickypriest,dreadmaul,1514,priest,discipline,18,16,2
35861,Defilex,tichondrius,1514,priest,discipline,56,39,17
35862,Weakwind,burning-blade,1514,priest,discipline,56,33,23
35863,Zenfromwish,frostmourne,1514,priest,discipline,68,37,31
35864,Shnítzel,thrall,1514,priest,discipline,168,89,79
35865,Thranduil,kiljaeden,1514,priest,discipline,142,75,67
35866,Gamist,area-52,1514,priest,discipline,206,102,104
35867,Tecnica,kelthuzad,1514,priest,discipline,155,75,80
35868,Vonyka,area-52,1514,priest,discipline,48,23,25
35869,Inssania,ragnaros,1513,priest,discipline,60,28,32
35870,Gustáv,sargeras,1512,priest,discipline,72,37,35
35871,Mse,eonar,1511,priest,discipline,48,26,22
35872,Allysheedy,sargeras,1511,priest,discipline,54,29,25
35873,Galestick,illidan,1511,priest,discipline,30,16,14
35874,Ulzaar,nerzhul,1511,priest,discipline,89,37,52
35875,Greyx,moon-guard,1510,priest,discipline,48,25,23
35876,Absørptiøn,area-52,1510,priest,discipline,293,146,147
35877,Manascythe,illidan,1510,priest,discipline,46,22,24
35878,Zroheals,illidan,1510,priest,discipline,107,48,59
35879,Agraheals,barthilas,1509,priest,discipline,42,22,20
35880,Scræm,sargeras,1509,priest,discipline,115,52,63
35881,Myds,sargeras,1508,priest,discipline,30,24,6
35882,Aleykz,illidan,1508,priest,discipline,101,54,47
35883,Ballzach,ysera,1508,priest,discipline,197,102,95
35884,Mandymuze,barthilas,1508,priest,discipline,77,37,40
35885,Labraidor,tichondrius,1508,priest,discipline,211,95,116
35886,Melsebek,stormrage,1508,priest,discipline,58,26,32
35887,Lildeen,area-52,1507,priest,discipline,44,26,18
35888,Azuremissile,tichondrius,1507,priest,discipline,103,57,46
35889,Billzerian,nemesis,1507,priest,discipline,141,75,66
35890,Boujeeheals,darkspear,1507,priest,discipline,48,22,26
35891,Propagàndhi,daggerspine,1507,priest,discipline,158,72,86
35892,Sâishâ,proudmoore,1507,priest,discipline,194,85,109
35893,Shadyhoe,alterac-mountains,1506,priest,discipline,21,17,4
35894,Hawtzp,stormrage,1506,priest,discipline,42,24,18
35895,Tartapelle,zuljin,1506,priest,discipline,90,51,39
35896,Ndeezy,malganis,1506,priest,discipline,30,16,14
35897,Forsakenz,jaedenar,1506,priest,discipline,102,50,52
35898,Diskope,kelthuzad,1505,priest,discipline,24,16,8
35899,Altarboy,agamaggan,1505,priest,discipline,62,30,32
35900,Idolize,proudmoore,1505,priest,discipline,98,44,54
35901,Tazzi,chromaggus,1504,priest,discipline,73,44,29
35902,Dadcantdeath,frostmourne,1504,priest,discipline,93,51,42
35903,Blinxed,tichondrius,1504,priest,discipline,120,59,61
35904,Legó,illidan,1504,priest,discipline,60,29,31
35905,Daburnz,bleeding-hollow,1504,priest,discipline,120,57,63
35906,Pootzy,malganis,1504,priest,discipline,87,36,51
35907,Shonkee,tichondrius,1503,priest,discipline,33,20,13
35908,Littledog,velen,1503,priest,discipline,64,33,31
35909,Brahp,frostmourne,1503,priest,discipline,53,19,34
35910,Khaoticdark,stormrage,1502,priest,discipline,36,20,16
35911,Pics,emerald-dream,1502,priest,discipline,48,22,26
35912,Artista,quelthalas,1501,priest,discipline,100,54,46
35913,Yoozi,sargeras,1501,priest,discipline,126,63,63
35914,Compromise,the-scryers,1501,priest,discipline,64,30,34
35915,Bailez,malganis,1500,priest,discipline,55,30,25
35916,Xtri,kelthuzad,1500,priest,discipline,36,19,17
35917,Kaguyä,ragnaros,1500,priest,discipline,101,51,50
35918,Braffuki,frostmourne,1500,priest,discipline,107,54,53
35919,Valtres,tichondrius,1499,priest,discipline,30,16,14
35920,Somnix,emerald-dream,1499,priest,discipline,140,70,70
35921,Shunio,illidan,1499,priest,discipline,60,25,35
35922,Jpray,bleeding-hollow,1498,priest,discipline,121,65,56
35923,Aexdawg,malganis,1498,priest,discipline,126,67,59
35924,Delrey,sargeras,1498,priest,discipline,56,28,28
35925,Boundword,emerald-dream,1498,priest,discipline,142,66,76
35926,Meepsw,stormrage,1498,priest,discipline,78,36,42
35927,Inkders,detheroc,1498,priest,discipline,58,26,32
35928,Hotpockets,detheroc,1497,priest,discipline,29,16,13
35929,Unholyhand,moon-guard,1497,priest,discipline,84,45,39
35930,Yorp,tichondrius,1497,priest,discipline,72,36,36
35931,Malpractíce,zuljin,1497,priest,discipline,119,59,60
35932,Thottee,bleeding-hollow,1497,priest,discipline,120,55,65
35933,Valixia,sargeras,1497,priest,discipline,90,41,49
35934,Venustas,daggerspine,1497,priest,discipline,72,29,43
35935,Prniss,tichondrius,1496,priest,discipline,41,25,16
35936,Doutoodou,tichondrius,1495,priest,discipline,94,55,39
35937,Mtito,drakkari,1495,priest,discipline,49,27,22
35938,Penummbra,frostmourne,1495,priest,discipline,30,16,14
35939,Amarexlol,stormrage,1495,priest,discipline,54,27,27
35940,Holymagetv,tichondrius,1495,priest,discipline,62,27,35
35941,Klowdz,burning-blade,1494,priest,discipline,311,163,148
35942,Späcehulk,illidan,1494,priest,discipline,55,22,33
35943,Sgiath,alleria,1493,priest,discipline,42,30,12
35944,Sleezi,emerald-dream,1493,priest,discipline,60,34,26
35945,Healthreat,area-52,1493,priest,discipline,76,42,34
35946,Bradythree,moon-guard,1493,priest,discipline,38,20,18
35947,Keyoshe,altar-of-storms,1493,priest,discipline,295,146,149
35948,Prayf,area-52,1493,priest,discipline,245,121,124
35949,Ruminationz,stormrage,1493,priest,discipline,274,129,145
35950,Weezyxo,tichondrius,1493,priest,discipline,46,19,27
35951,Phasmaaxd,tichondrius,1492,priest,discipline,89,48,41
35952,Dbod,tichondrius,1492,priest,discipline,251,126,125
35953,Bubblerwrapp,malganis,1492,priest,discipline,36,17,19
35954,Rezee,kelthuzad,1491,priest,discipline,28,17,11
35955,Constin,doomhammer,1491,priest,discipline,36,20,16
35956,Saiyana,frostmourne,1491,priest,discipline,178,87,91
35957,Brakála,ragnaros,1491,priest,discipline,48,21,27
35958,Cobjr,frostmourne,1490,priest,discipline,52,29,23
35959,Huevos,blackwing-lair,1490,priest,discipline,156,83,73
35960,Vemilli,tichondrius,1490,priest,discipline,46,23,23
35961,Helarix,malganis,1490,priest,discipline,175,86,89
35962,Kalilol,tichondrius,1490,priest,discipline,132,61,71
35963,Somberr,dalaran,1489,priest,discipline,47,26,21
35964,Triggaz,tichondrius,1489,priest,discipline,138,75,63
35965,Inot,nemesis,1489,priest,discipline,121,56,65
35966,Alelith,quelthalas,1489,priest,discipline,59,27,32
35967,Discobluntzz,tichondrius,1488,priest,discipline,54,31,23
35968,Sibble,boulderfist,1488,priest,discipline,101,49,52
35969,Howdaw,tichondrius,1488,priest,discipline,59,26,33
35970,Durtybubz,tichondrius,1487,priest,discipline,167,95,72
35971,Watchemeyolo,tichondrius,1487,priest,discipline,66,35,31
35972,Sermøn,azuremyst,1487,priest,discipline,321,166,155
35973,Luxyel,azralon,1487,priest,discipline,149,65,84
35974,Xtty,thrall,1486,priest,discipline,43,24,19
35975,Coldphobia,uldum,1486,priest,discipline,245,132,113
35976,Windroseh,proudmoore,1486,priest,discipline,60,32,28
35977,Tyszie,sargeras,1485,priest,discipline,36,20,16
35978,Tëmpting,moon-guard,1485,priest,discipline,50,25,25
35979,Kiritomauti,ragnaros,1485,priest,discipline,58,28,30
35980,Aerdaras,illidan,1485,priest,discipline,80,36,44
35981,Sëv,stormrage,1485,priest,discipline,41,18,23
35982,Drully,moon-guard,1484,priest,discipline,172,86,86
35983,Chernota,kiljaeden,1484,priest,discipline,108,52,56
35984,Griddly,alterac-mountains,1483,priest,discipline,108,57,51
35985,Dingldangle,tichondrius,1483,priest,discipline,144,70,74
35986,Arzaei,quelthalas,1483,priest,discipline,130,61,69
35987,Blacklightz,korgath,1483,priest,discipline,91,42,49
35988,Prff,ragnaros,1483,priest,discipline,42,19,23
35989,Stynke,bleeding-hollow,1483,priest,discipline,66,20,46
35990,Sauile,kelthuzad,1482,priest,discipline,168,94,74
35991,Vampiric,laughing-skull,1482,priest,discipline,60,33,27
35992,Trickyhobo,area-52,1482,priest,discipline,151,80,71
35993,Rháényra,tichondrius,1482,priest,discipline,48,25,23
35994,Nottahealer,anvilmar,1482,priest,discipline,42,20,22
35995,Lumia,quelthalas,1482,priest,discipline,45,19,26
35996,Iinu,tichondrius,1481,priest,discipline,137,72,65
35997,Pvprashida,tichondrius,1481,priest,discipline,136,67,69
35998,Buqisama,barthilas,1481,priest,discipline,102,47,55
35999,Bakøo,tichondrius,1480,priest,discipline,49,32,17
36000,Pipete,frostmourne,1480,priest,discipline,174,98,76
36001,Kuriyasu,emerald-dream,1480,priest,discipline,209,113,96
36002,Dontstopxo,lightbringer,1480,priest,discipline,76,37,39
36003,Toxictampax,azjolnerub,1480,priest,discipline,114,55,59
36004,Sineater,zuljin,1480,priest,discipline,83,40,43
36005,Hysteria,dalaran,1480,priest,discipline,70,33,37
36006,Sstar,area-52,1479,priest,discipline,24,16,8
36007,Holymeta,dunemaul,1479,priest,discipline,72,42,30
36008,Steefe,arygos,1479,priest,discipline,38,21,17
36009,Minii,tichondrius,1479,priest,discipline,103,55,48
36010,Nvroom,illidan,1479,priest,discipline,55,28,27
36011,Aumsi,illidan,1479,priest,discipline,104,48,56
36012,Jodaa,sargeras,1478,priest,discipline,36,17,19
36013,Mørathy,ragnaros,1477,priest,discipline,72,46,26
36014,Jinxaleyster,ragnaros,1477,priest,discipline,143,81,62
36015,Thorzan,eredar,1477,priest,discipline,48,26,22
36016,Preacharóund,frostmourne,1477,priest,discipline,146,74,72
36017,Zerolyn,tichondrius,1476,priest,discipline,131,70,61
36018,Thadino,nagrand,1476,priest,discipline,126,61,65
36019,Shaytyme,tichondrius,1476,priest,discipline,62,23,39
36020,Imcringing,illidan,1475,priest,discipline,48,30,18
36021,Jjløver,tichondrius,1475,priest,discipline,31,19,12
36022,Madjak,lightnings-blade,1475,priest,discipline,126,72,54
36023,Luanwanx,tichondrius,1475,priest,discipline,91,51,40
36024,Mightydrëk,malganis,1475,priest,discipline,29,16,13
36025,Sinzex,tichondrius,1475,priest,discipline,84,45,39
36026,Daelynne,area-52,1475,priest,discipline,34,17,17
36027,Bittyheals,illidan,1475,priest,discipline,48,22,26
36028,Faxingberlin,sargeras,1475,priest,discipline,46,18,28
36029,Haizsu,tichondrius,1474,priest,discipline,77,38,39
36030,Dabaksp,area-52,1474,priest,discipline,63,31,32
36031,Visìons,tichondrius,1474,priest,discipline,66,30,36
36032,Xîîaotong,tichondrius,1473,priest,discipline,37,23,14
36033,Alyndral,illidan,1473,priest,discipline,50,29,21
36034,Ringofvalor,lightnings-blade,1473,priest,discipline,160,85,75
36035,Swagndragon,zuljin,1473,priest,discipline,86,42,44
36036,Bushwaker,darkspear,1472,priest,discipline,59,33,26
36037,Lily,blackrock,1472,priest,discipline,36,19,17
36038,Euphotic,tichondrius,1472,priest,discipline,75,38,37
36039,Talripington,area-52,1471,priest,discipline,41,25,16
36040,Rufían,quelthalas,1471,priest,discipline,48,25,23
36041,Brian,lightnings-blade,1471,priest,discipline,52,27,25
36042,Confesiional,area-52,1471,priest,discipline,71,32,39
36043,Bigtimeplay,tichondrius,1470,priest,discipline,42,25,17
36044,Kiddonia,whisperwind,1470,priest,discipline,51,25,26
36045,Doesine,area-52,1469,priest,discipline,42,25,17
36046,Zjqf,akama,1469,priest,discipline,185,94,91
36047,Travoidicus,wyrmrest-accord,1469,priest,discipline,109,55,54
36048,Vacyle,azralon,1468,priest,discipline,174,93,81
36049,Draazja,dalaran,1468,priest,discipline,146,74,72
36050,Zerola,sargeras,1468,priest,discipline,71,34,37
36051,Temnah,sargeras,1468,priest,discipline,50,22,28
36052,Dazull,bleeding-hollow,1468,priest,discipline,41,16,25
36053,Dorashadows,tichondrius,1467,priest,discipline,24,17,7
36054,Sandfire,thrall,1467,priest,discipline,30,16,14
36055,Stargoddess,illidan,1467,priest,discipline,168,84,84
36056,Krymze,tichondrius,1467,priest,discipline,36,16,20
36057,Saxy,quelthalas,1466,priest,discipline,68,38,30
36058,Blodwell,illidan,1466,priest,discipline,133,67,66
36059,Basisc,frostmourne,1465,priest,discipline,219,122,97
36060,Wöödy,area-52,1465,priest,discipline,40,21,19
36061,Whehaw,kelthuzad,1465,priest,discipline,143,71,72
36062,Azaradet,ragnaros,1465,priest,discipline,87,36,51
36063,Aizetsu,sargeras,1464,priest,discipline,36,21,15
36064,Billymaays,azgalor,1464,priest,discipline,145,80,65
36065,Vøidroid,malganis,1464,priest,discipline,156,82,74
36066,Apâthy,area-52,1464,priest,discipline,69,32,37
36067,Dib,arathor,1463,priest,discipline,48,25,23
36068,Bandèl,tichondrius,1462,priest,discipline,48,31,17
36069,Frogfrompad,tichondrius,1462,priest,discipline,89,54,35
36070,Tajee,area-52,1462,priest,discipline,271,140,131
36071,Gðttlich,stormrage,1462,priest,discipline,38,19,19
36072,Yeyoz,tichondrius,1462,priest,discipline,124,60,64
36073,Blavkata,area-52,1462,priest,discipline,76,30,46
36074,Tallshiraz,destromath,1461,priest,discipline,76,46,30
36075,Fallenumbra,area-52,1461,priest,discipline,77,44,33
36076,Javox,drakkari,1461,priest,discipline,36,19,17
36077,Chainsalight,stormrage,1461,priest,discipline,156,81,75
36078,Holypuffs,burning-legion,1461,priest,discipline,77,35,42
36079,Bloodify,azralon,1461,priest,discipline,121,54,67
36080,Syfy,thrall,1461,priest,discipline,114,48,66
36081,Thyrians,ragnaros,1460,priest,discipline,42,24,18
36082,Joktips,proudmoore,1460,priest,discipline,174,94,80
36083,Bugsbright,tichondrius,1459,priest,discipline,256,137,119
36084,Fanatic,nemesis,1459,priest,discipline,399,206,193
36085,Femìnazzi,ragnaros,1458,priest,discipline,88,48,40
36086,Renewed,frostmourne,1458,priest,discipline,52,28,24
36087,Zaemyn,dalaran,1458,priest,discipline,50,22,28
36088,Akåsha,zuljin,1458,priest,discipline,98,42,56
36089,Sublîme,sargeras,1457,priest,discipline,105,61,44
36090,Kafarmer,frostmourne,1457,priest,discipline,119,68,51
36091,Ermec,azralon,1457,priest,discipline,48,22,26
36092,Fleshliight,area-52,1456,priest,discipline,51,31,20
36093,Shykaii,azralon,1456,priest,discipline,108,61,47
36094,Sadistic,hyjal,1456,priest,discipline,118,59,59
36095,Akovob,tichondrius,1456,priest,discipline,50,25,25
36096,Payperbuff,tichondrius,1455,priest,discipline,30,20,10
36097,Tiannatrump,stormrage,1455,priest,discipline,53,31,22
36098,Sappes,area-52,1455,priest,discipline,200,110,90
36099,Aleistria,emerald-dream,1454,priest,discipline,42,26,16
36100,Lethalrosé,thrall,1454,priest,discipline,30,17,13
36101,Icetraygang,suramar,1454,priest,discipline,421,224,197
36102,Velastirra,saurfang,1454,priest,discipline,328,171,157
36103,Solkadp,tichondrius,1454,priest,discipline,34,16,18
36104,Modotszilla,bleeding-hollow,1454,priest,discipline,36,16,20
36105,Grimspriest,moon-guard,1453,priest,discipline,47,23,24
36106,Thoaxx,magtheridon,1453,priest,discipline,54,24,30
36107,Havocshadows,deathwing,1452,priest,discipline,219,129,90
36108,Aubieheal,malygos,1452,priest,discipline,91,50,41
36109,Akash,ragnaros,1452,priest,discipline,71,39,32
36110,Puddín,area-52,1452,priest,discipline,84,42,42
36111,Mistàclean,tichondrius,1452,priest,discipline,89,43,46
36112,Xeras,misha,1452,priest,discipline,47,21,26
36113,Bobet,zuljin,1452,priest,discipline,73,28,45
36114,Tonesandi,malganis,1451,priest,discipline,42,27,15
36115,Noblesx,illidan,1451,priest,discipline,54,30,24
36116,Høllywood,nazgrel,1451,priest,discipline,57,28,29
36117,Beefoverload,durotan,1451,priest,discipline,141,66,75
36118,Ssgpak,tichondrius,1450,priest,discipline,29,21,8
36119,Spookynun,moon-guard,1450,priest,discipline,216,122,94
36120,Jubalie,guldan,1450,priest,discipline,52,27,25
36121,Guccigriimes,tichondrius,1450,priest,discipline,81,37,44
36122,Bnn,arathor,1449,priest,discipline,23,16,7
36123,Eirua,proudmoore,1449,priest,discipline,78,35,43
36124,Notfandy,tichondrius,1449,priest,discipline,48,19,29
36125,Nek,malganis,1448,priest,discipline,103,61,42
36126,Spazmode,malganis,1448,priest,discipline,81,43,38
36127,Tomseleck,frostmourne,1448,priest,discipline,35,16,19
36128,Iivelaughluv,kiljaeden,1447,priest,discipline,69,40,29
36129,Diableero,barthilas,1447,priest,discipline,47,26,21
36130,Lexaprö,moon-guard,1447,priest,discipline,70,38,32
36131,Sinsuu,tichondrius,1447,priest,discipline,192,104,88
36132,Nolar,shadowmoon,1447,priest,discipline,90,40,50
36133,Velzirya,zuljin,1447,priest,discipline,89,39,50
36134,Newchaos,hakkar,1446,priest,discipline,40,24,16
36135,Elagabal,tichondrius,1446,priest,discipline,36,19,17
36136,Battlemage,magtheridon,1446,priest,discipline,111,58,53
36137,Mileslol,azgalor,1446,priest,discipline,68,34,34
36138,Mäe,nemesis,1446,priest,discipline,60,26,34
36139,Sleepiest,wyrmrest-accord,1445,priest,discipline,49,26,23
36140,Zeusqt,azralon,1445,priest,discipline,180,94,86
36141,Krillan,ysera,1445,priest,discipline,120,61,59
36142,Augustrox,ragnaros,1445,priest,discipline,164,78,86
36143,Vhexz,sargeras,1444,priest,discipline,80,52,28
36144,Aloo,zuljin,1444,priest,discipline,57,37,20
36145,Fakechow,nathrezim,1444,priest,discipline,139,71,68
36146,Blakalicious,illidan,1443,priest,discipline,39,27,12
36147,Specialed,wildhammer,1443,priest,discipline,71,39,32
36148,Paare,stormrage,1443,priest,discipline,42,21,21
36149,Jeresh,sargeras,1443,priest,discipline,65,21,44
36150,Winnzhor,bonechewer,1442,priest,discipline,100,57,43
36151,Shalters,tichondrius,1442,priest,discipline,60,31,29
36152,Famemolol,tichondrius,1442,priest,discipline,456,218,238
36153,Easypriest,tichondrius,1441,priest,discipline,96,50,46
36154,Sreykalip,frostmourne,1441,priest,discipline,48,24,24
36155,Voidathon,sargeras,1441,priest,discipline,36,17,19
36156,Shadowblax,thrall,1441,priest,discipline,160,75,85
36157,Punkndrublic,sargeras,1440,priest,discipline,129,66,63
36158,Lavazzå,tichondrius,1440,priest,discipline,36,18,18
36159,Docmcstufins,darkspear,1440,priest,discipline,65,31,34
36160,Kristyenna,boulderfist,1440,priest,discipline,42,20,22
36161,Ínfocus,area-52,1440,priest,discipline,138,65,73
36162,Zhatfko,illidan,1440,priest,discipline,78,31,47
36163,Ðohko,ragnaros,1439,priest,discipline,42,25,17
36164,Figueiredø,goldrinn,1439,priest,discipline,80,43,37
36165,Ketaminè,tichondrius,1439,priest,discipline,54,29,25
36166,Pinchevato,ragnaros,1439,priest,discipline,270,138,132
36167,Scrubx,malganis,1438,priest,discipline,18,15,3
36168,Bohomag,tichondrius,1438,priest,discipline,24,15,9
36169,Necroshine,vashj,1438,priest,discipline,57,25,32
36170,Mason,winterhoof,1437,priest,discipline,24,15,9
36171,Heelznfeelz,tichondrius,1437,priest,discipline,45,23,22
36172,Miaria,chogall,1437,priest,discipline,138,69,69
36173,Joesus,kelthuzad,1437,priest,discipline,38,17,21
36174,Arfaxad,quelthalas,1436,priest,discipline,18,15,3
36175,Vivián,tichondrius,1436,priest,discipline,115,63,52
36176,Compåctdisc,sargeras,1436,priest,discipline,36,18,18
36177,Bryelx,ragnaros,1436,priest,discipline,174,84,90
36178,Syruhl,tichondrius,1436,priest,discipline,35,16,19
36179,Amãnita,illidan,1436,priest,discipline,35,15,20
36180,Pphill,aegwynn,1436,priest,discipline,48,19,29
36181,Floratil,ragnaros,1436,priest,discipline,60,23,37
36182,Murdock,the-forgotten-coast,1435,priest,discipline,56,31,25
36183,Jaindoe,illidan,1435,priest,discipline,159,84,75
36184,Penetron,tichondrius,1435,priest,discipline,144,75,69
36185,Bootycough,malganis,1435,priest,discipline,63,32,31
36186,Rëckful,area-52,1435,priest,discipline,819,412,407
36187,Conorpriest,tichondrius,1435,priest,discipline,30,15,15
36188,Sliding,wyrmrest-accord,1435,priest,discipline,30,15,15
36189,Lonpriest,stormrage,1435,priest,discipline,210,99,111
36190,Earface,blades-edge,1435,priest,discipline,56,19,37
36191,Addisonraee,tichondrius,1434,priest,discipline,18,15,3
36192,Miix,proudmoore,1434,priest,discipline,18,15,3
36193,Yea,shadow-council,1434,priest,discipline,27,19,8
36194,Baali,moon-guard,1434,priest,discipline,41,27,14
36195,Evpray,area-52,1434,priest,discipline,54,35,19
36196,Mosarra,agamaggan,1434,priest,discipline,30,16,14
36197,Luminous,moon-guard,1434,priest,discipline,137,73,64
36198,Mamabless,quelthalas,1434,priest,discipline,740,378,362
36199,Meatboxmoldy,blood-furnace,1434,priest,discipline,30,15,15
36200,Detainedz,malganis,1434,priest,discipline,30,15,15
36201,Priestmode,garona,1434,priest,discipline,78,34,44
36202,Vineller,malganis,1434,priest,discipline,36,15,21
36203,Remusha,dalaran,1434,priest,discipline,42,16,26
36204,Giomoreno,tichondrius,1433,priest,discipline,30,15,15
36205,Zaneshy,azralon,1433,priest,discipline,49,19,30
36206,Amorus,illidan,1432,priest,discipline,60,40,20
36207,Psílocybín,icecrown,1432,priest,discipline,50,31,19
36208,Welovan,sargeras,1432,priest,discipline,88,47,41
36209,Wøo,area-52,1432,priest,discipline,113,60,53
36210,Necrodiva,magtheridon,1432,priest,discipline,84,43,41
36211,Rôôk,kiljaeden,1432,priest,discipline,56,26,30
36212,Lullabya,tichondrius,1431,priest,discipline,24,15,9
36213,Fathersean,sargeras,1431,priest,discipline,24,15,9
36214,Napzz,sargeras,1431,priest,discipline,45,27,18
36215,Shelak,frostmourne,1431,priest,discipline,104,55,49
36216,Frankoizz,quelthalas,1431,priest,discipline,55,25,30
36217,Swu,tichondrius,1431,priest,discipline,44,18,26
36218,Davinatrans,azralon,1430,priest,discipline,111,57,54
36219,Burroviejo,quelthalas,1430,priest,discipline,46,23,23
36220,Zuss,tichondrius,1430,priest,discipline,52,23,29
36221,Axelrod,tichondrius,1430,priest,discipline,66,27,39
36222,Eridan,moon-guard,1429,priest,discipline,65,33,32
36223,Kwaremont,sargeras,1429,priest,discipline,30,15,15
36224,Tainna,quelthalas,1428,priest,discipline,78,44,34
36225,Elexy,tichondrius,1428,priest,discipline,72,37,35
36226,Shaylari,kelthuzad,1428,priest,discipline,159,75,84
36227,Solestro,malganis,1428,priest,discipline,36,15,21
36228,Dayquills,illidan,1428,priest,discipline,36,15,21
36229,Linkolln,sargeras,1427,priest,discipline,30,18,12
36230,Fleische,thrall,1427,priest,discipline,48,27,21
36231,Bakí,hyjal,1427,priest,discipline,32,17,15
36232,Cherryfuzz,sargeras,1427,priest,discipline,89,45,44
36233,Pumtootoot,tichondrius,1427,priest,discipline,36,15,21
36234,Buffrmppls,ragnaros,1427,priest,discipline,36,15,21
36235,Alphe,sargeras,1426,priest,discipline,42,25,17
36236,Dreadpriate,emerald-dream,1426,priest,discipline,116,58,58
36237,Hugépenance,tichondrius,1425,priest,discipline,30,20,10
36238,Covnite,bloodscalp,1425,priest,discipline,48,26,22
36239,Voicekal,sargeras,1425,priest,discipline,77,41,36
36240,Camisoda,smolderthorn,1425,priest,discipline,34,17,17
36241,Yeshùa,drakkari,1425,priest,discipline,137,68,69
36242,Teeds,stormrage,1425,priest,discipline,69,34,35
36243,Flexxwzkaboo,thrall,1425,priest,discipline,68,33,35
36244,Yözsh,azralon,1425,priest,discipline,63,27,36
36245,Digop,azralon,1425,priest,discipline,41,17,24
36246,Wíckéd,frostmourne,1425,priest,discipline,57,23,34
36247,Sterycraiied,stormreaver,1424,priest,discipline,74,51,23
36248,Langyi,tichondrius,1424,priest,discipline,72,41,31
36249,ßlest,stormrage,1424,priest,discipline,150,84,66
36250,Cella,frostmourne,1424,priest,discipline,48,24,24
36251,Yótecuro,quelthalas,1424,priest,discipline,84,39,45
36252,Roshik,stormrage,1423,priest,discipline,54,33,21
36253,Eavin,laughing-skull,1423,priest,discipline,343,171,172
36254,Shakky,queldorei,1423,priest,discipline,84,37,47
36255,Inmøthep,ragnaros,1423,priest,discipline,68,29,39
36256,Pungentonion,tichondrius,1423,priest,discipline,36,15,21
36257,Nolan,drakkari,1422,priest,discipline,47,27,20
36258,Zørb,area-52,1422,priest,discipline,54,31,23
36259,Priøst,tichondrius,1422,priest,discipline,75,43,32
36260,Ohgiddyy,dalaran,1422,priest,discipline,79,38,41
36261,Tyzrapture,illidan,1422,priest,discipline,53,21,32
36262,Bloatie,zuljin,1421,priest,discipline,42,28,14
36263,Poine,tichondrius,1421,priest,discipline,36,20,16
36264,Sumrand,frostmourne,1421,priest,discipline,30,16,14
36265,Betterheals,tichondrius,1421,priest,discipline,169,88,81
36266,Izikial,illidan,1421,priest,discipline,48,24,24
36267,Kurobankai,tichondrius,1421,priest,discipline,51,25,26
36268,Spacelaces,stormrage,1420,priest,discipline,30,20,10
36269,Holycast,arygos,1420,priest,discipline,24,15,9
36270,Sentactic,illidan,1420,priest,discipline,33,17,16
36271,Inmotion,tichondrius,1420,priest,discipline,30,15,15
36272,Pretzah,barthilas,1419,priest,discipline,60,46,14
36273,Machinecoach,stormrage,1419,priest,discipline,30,15,15
36274,Brotatochip,andorhal,1419,priest,discipline,49,24,25
36275,Malavidax,malganis,1419,priest,discipline,108,45,63
36276,Leviosa,bleeding-hollow,1418,priest,discipline,32,19,13
36277,Helianna,whisperwind,1418,priest,discipline,223,110,113
36278,Shufflnjoyer,sargeras,1418,priest,discipline,114,54,60
36279,Holyish,proudmoore,1418,priest,discipline,42,19,23
36280,Vundead,tichondrius,1418,priest,discipline,36,16,20
36281,Guccísandals,emerald-dream,1418,priest,discipline,36,15,21
36282,Ammcho,tichondrius,1418,priest,discipline,42,16,26
36283,Boycrazy,nerzhul,1417,priest,discipline,24,15,9
36284,Ekros,illidan,1417,priest,discipline,40,23,17
36285,Soméone,sargeras,1417,priest,discipline,236,123,113
36286,Nidüz,stormrage,1417,priest,discipline,156,72,84
36287,Bllaazze,frostwolf,1417,priest,discipline,60,25,35
36288,Nutsin,tichondrius,1417,priest,discipline,36,15,21
36289,Zäelly,moon-guard,1416,priest,discipline,198,100,98
36290,Flexeggette,illidan,1416,priest,discipline,37,18,19
36291,Bent,gurubashi,1415,priest,discipline,41,22,19
36292,Dagónet,sargeras,1415,priest,discipline,72,38,34
36293,Sungji,tichondrius,1415,priest,discipline,30,15,15
36294,Sasaberry,frostmourne,1415,priest,discipline,169,80,89
36295,Dtsgx,tichondrius,1414,priest,discipline,27,16,11
36296,Kayluhn,area-52,1414,priest,discipline,42,24,18
36297,Muromsnel,proudmoore,1414,priest,discipline,120,59,61
36298,Ankhxiety,area-52,1414,priest,discipline,71,33,38
36299,Faerline,kelthuzad,1414,priest,discipline,35,15,20
36300,Aubine,sargeras,1414,priest,discipline,41,15,26
36301,Ananiel,moon-guard,1413,priest,discipline,24,15,9
36302,Benedictüs,tichondrius,1413,priest,discipline,202,104,98
36303,Koizs,frostmourne,1413,priest,discipline,30,15,15
36304,Clancygilroy,thrall,1413,priest,discipline,96,47,49
36305,Emmelly,whisperwind,1413,priest,discipline,78,33,45
36306,Daluu,tichondrius,1413,priest,discipline,51,18,33
36307,Snoog,tichondrius,1413,priest,discipline,54,17,37
36308,Feløre,quelthalas,1412,priest,discipline,51,32,19
36309,Sýpha,dalaran,1412,priest,discipline,51,25,26
36310,Accismus,khadgar,1412,priest,discipline,78,37,41
36311,Smegmancer,korgath,1412,priest,discipline,66,31,35
36312,Sofluffy,burning-blade,1412,priest,discipline,59,27,32
36313,Raileight,illidan,1412,priest,discipline,56,25,31
36314,Handyheals,frostmourne,1411,priest,discipline,113,62,51
36315,Sierrastorms,moon-guard,1411,priest,discipline,30,15,15
36316,Snoozemaster,cenarius,1411,priest,discipline,30,15,15
36317,Posabilties,bleeding-hollow,1411,priest,discipline,42,20,22
36318,Karmatron,chogall,1411,priest,discipline,42,17,25
36319,Macnabber,malganis,1410,priest,discipline,42,27,15
36320,Humpbackz,tichondrius,1410,priest,discipline,42,24,18
36321,Fashion,bleeding-hollow,1410,priest,discipline,54,30,24
36322,Finnabustt,tichondrius,1410,priest,discipline,149,70,79
36323,Elsanto,stormrage,1409,priest,discipline,24,15,9
36324,Silnetlee,tichondrius,1408,priest,discipline,30,16,14
36325,Hpalisdawg,malorne,1408,priest,discipline,31,16,15
36326,Eatmyfear,quelthalas,1408,priest,discipline,247,122,125
36327,Nightheals,sargeras,1408,priest,discipline,54,25,29
36328,Verchou,shattered-hand,1408,priest,discipline,36,15,21
36329,Midoopriest,proudmoore,1408,priest,discipline,36,15,21
36330,Kawin,goldrinn,1407,priest,discipline,101,54,47
36331,Nepy,stormrage,1407,priest,discipline,87,46,41
36332,Sunenergy,tichondrius,1407,priest,discipline,78,41,37
36333,Jaeza,azralon,1407,priest,discipline,93,45,48
36334,Ïndis,ragnaros,1407,priest,discipline,40,16,24
36335,Kerez,skywall,1406,priest,discipline,45,27,18
36336,Jilt,aerie-peak,1406,priest,discipline,96,55,41
36337,Ünarû,illidan,1406,priest,discipline,120,65,55
36338,Halliburton,illidan,1406,priest,discipline,188,98,90
36339,Mursey,sargeras,1406,priest,discipline,117,55,62
36340,Lavvari,durotan,1405,priest,discipline,36,25,11
36341,Seáoflions,aggramar,1405,priest,discipline,24,15,9
36342,Dmlx,frostmourne,1405,priest,discipline,156,90,66
36343,Mangueroide,quelthalas,1405,priest,discipline,123,63,60
36344,Chimiechurro,proudmoore,1405,priest,discipline,90,45,45
36345,Akkassha,zuljin,1405,priest,discipline,48,22,26
36346,Ghøstfaces,illidan,1405,priest,discipline,43,16,27
36347,Tryst,the-underbog,1404,priest,discipline,60,37,23
36348,Chaøz,emerald-dream,1403,priest,discipline,65,41,24
36349,Itsmaám,moon-guard,1403,priest,discipline,48,28,20
36350,Gwyneth,whisperwind,1403,priest,discipline,80,35,45
36351,Kjpriest,kelthuzad,1402,priest,discipline,54,34,20
36352,Therialjp,ragnaros,1402,priest,discipline,42,25,17
36353,Izanemi,sargeras,1402,priest,discipline,71,39,32
36354,Discalaneous,tichondrius,1402,priest,discipline,45,20,25
36355,Nicety,skywall,1402,priest,discipline,50,22,28
36356,Chaniste,moon-guard,1401,priest,discipline,46,27,19
36357,Kaonn,frostmourne,1401,priest,discipline,251,133,118
36358,Bubbahotep,laughing-skull,1401,priest,discipline,52,25,27
36359,Yishaarj,tichondrius,1401,priest,discipline,53,24,29
36360,Khyonne,nemesis,1400,priest,discipline,68,37,31
36361,Sistamaggie,bleeding-hollow,1400,priest,discipline,84,43,41
36362,Kibariyb,drakkari,1400,priest,discipline,40,19,21
36363,Stormìst,korgath,1399,priest,discipline,30,18,12
36364,Peristalsis,nesingwary,1399,priest,discipline,36,16,20
36365,Coldvbs,barthilas,1398,priest,discipline,46,26,20
36366,Slumpbusterx,bonechewer,1398,priest,discipline,205,95,110
36367,Moonarie,draka,1397,priest,discipline,42,25,17
36368,Namemetwo,malganis,1397,priest,discipline,126,59,67
36369,Diabiitus,stormrage,1396,priest,discipline,105,61,44
36370,Relaax,illidan,1396,priest,discipline,30,15,15
36371,Rabbix,aggramar,1395,priest,discipline,36,20,16
36372,Jacob,shadowmoon,1395,priest,discipline,171,82,89
36373,Vøíd,sargeras,1394,priest,discipline,41,23,18
36374,Luffzie,barthilas,1394,priest,discipline,162,85,77
36375,Karminha,azralon,1393,priest,discipline,24,17,7
36376,Freck,stormrage,1393,priest,discipline,42,25,17
36377,Icônz,malganis,1393,priest,discipline,59,31,28
36378,Lilblackguys,stormrage,1393,priest,discipline,120,59,61
36379,Scriptz,frostwolf,1393,priest,discipline,66,30,36
36380,Raggasoca,malganis,1393,priest,discipline,99,44,55
36381,Ðiplø,tichondrius,1392,priest,discipline,35,21,14
36382,Oprawinfree,tichondrius,1392,priest,discipline,130,72,58
36383,Letkidscome,archimonde,1391,priest,discipline,33,18,15
36384,Tluoc,nemesis,1391,priest,discipline,47,25,22
36385,Ggums,tichondrius,1391,priest,discipline,108,54,54
36386,Gimmedomex,tichondrius,1390,priest,discipline,102,58,44
36387,Smittën,barthilas,1390,priest,discipline,72,40,32
36388,Scortum,goldrinn,1390,priest,discipline,36,20,16
36389,Phayzz,area-52,1390,priest,discipline,123,63,60
36390,Moneymurph,blackrock,1390,priest,discipline,44,16,28
36391,Chofis,nathrezim,1389,priest,discipline,36,24,12
36392,Worstpriest,stormscale,1389,priest,discipline,36,20,16
36393,Pyta,frostmourne,1389,priest,discipline,68,36,32
36394,Xyló,area-52,1388,priest,discipline,118,65,53
36395,Aimeé,chromaggus,1387,priest,discipline,96,40,56
36396,Krindil,korgath,1386,priest,discipline,107,60,47
36397,Unholywizard,sargeras,1386,priest,discipline,66,37,29
36398,Strawson,quelthalas,1386,priest,discipline,117,56,61
36399,Kobayashy,ragnaros,1385,priest,discipline,48,29,19
36400,Vexyy,tichondrius,1385,priest,discipline,32,19,13
36401,Kevarsin,dalaran,1385,priest,discipline,60,31,29
36402,Kìttý,cenarius,1385,priest,discipline,48,23,25
36403,Laüren,ragnaros,1385,priest,discipline,103,46,57
36404,Atyourcervix,emerald-dream,1384,priest,discipline,32,20,12
36405,Tungus,shadowsong,1384,priest,discipline,97,51,46
36406,Misfyt,emerald-dream,1384,priest,discipline,78,40,38
36407,Yanye,tichondrius,1384,priest,discipline,161,78,83
36408,Itsme,quelthalas,1384,priest,discipline,77,36,41
36409,Victrix,tichondrius,1384,priest,discipline,118,51,67
36410,Thalyssarah,azralon,1384,priest,discipline,41,17,24
36411,Kms,sargeras,1383,priest,discipline,74,41,33
36412,Arkenes,dalaran,1383,priest,discipline,78,41,37
36413,Kerahk,drakkari,1383,priest,discipline,44,20,24
36414,Wholeness,kelthuzad,1383,priest,discipline,48,21,27
36415,Seleniax,sargeras,1383,priest,discipline,41,16,25
36416,Holykushed,tichondrius,1382,priest,discipline,38,19,19
36417,Aurajade,queldorei,1382,priest,discipline,36,18,18
36418,Dessire,ragnaros,1382,priest,discipline,35,17,18
36419,Starshollow,ragnaros,1382,priest,discipline,111,53,58
36420,Shrax,emerald-dream,1382,priest,discipline,149,68,81
36421,Sukmysplooge,queldorei,1382,priest,discipline,66,28,38
36422,Tiskka,magtheridon,1382,priest,discipline,68,28,40
36423,Èuneekz,thrall,1382,priest,discipline,42,16,26
36424,Sílvia,durotan,1381,priest,discipline,60,28,32
36425,Moresbo,frostmourne,1380,priest,discipline,42,24,18
36426,Spacebeard,tichondrius,1380,priest,discipline,46,22,24
36427,Armî,ragnaros,1380,priest,discipline,82,39,43
36428,Jinniu,azralon,1380,priest,discipline,42,17,25
36429,Pegwraith,sargeras,1379,priest,discipline,64,36,28
36430,Gristus,twisting-nether,1378,priest,discipline,47,27,20
36431,Tyreliy,eitrigg,1378,priest,discipline,199,104,95
36432,Lìlí,tichondrius,1378,priest,discipline,66,34,32
36433,Doggyy,tichondrius,1378,priest,discipline,178,91,87
36434,Joichua,sargeras,1378,priest,discipline,62,30,32
36435,Drhutchinson,illidan,1377,priest,discipline,30,16,14
36436,Oldris,darkspear,1377,priest,discipline,47,25,22
36437,Goosemongler,bleeding-hollow,1377,priest,discipline,36,18,18
36438,Lexinalis,stormrage,1376,priest,discipline,29,17,12
36439,Kallixprime,ragnaros,1376,priest,discipline,53,29,24
36440,Fádéd,tichondrius,1376,priest,discipline,29,15,14
36441,Bøness,area-52,1376,priest,discipline,142,73,69
36442,Feorlar,tichondrius,1376,priest,discipline,120,56,64
36443,Sixfiggas,darkspear,1375,priest,discipline,24,17,7
36444,Aldrych,malganis,1375,priest,discipline,61,35,26
36445,Rickjames,laughing-skull,1375,priest,discipline,104,58,46
36446,Dlysexic,barthilas,1375,priest,discipline,66,35,31
36447,Drinkndrive,tichondrius,1375,priest,discipline,57,30,27
36448,Piskel,vashj,1375,priest,discipline,66,29,37
36449,Jelzz,area-52,1374,priest,discipline,33,18,15
36450,Dominantz,khazgoroth,1374,priest,discipline,78,42,36
36451,Palpitine,kiljaeden,1374,priest,discipline,66,35,31
36452,Sackura,quelthalas,1374,priest,discipline,73,36,37
36453,Artiannaa,bleeding-hollow,1373,priest,discipline,66,35,31
36454,Kwitty,tichondrius,1373,priest,discipline,83,44,39
36455,Zombieheals,gundrak,1373,priest,discipline,53,27,26
36456,Quinnx,tichondrius,1373,priest,discipline,54,27,27
36457,Mäí,ragnaros,1372,priest,discipline,120,67,53
36458,Halcyon,eonar,1372,priest,discipline,74,34,40
36459,Mauriel,proudmoore,1372,priest,discipline,42,19,23
36460,Rrain,proudmoore,1372,priest,discipline,53,23,30
36461,Avis,illidan,1371,priest,discipline,60,37,23
36462,Wildmanfrank,tichondrius,1371,priest,discipline,49,30,19
36463,Zortroz,tichondrius,1371,priest,discipline,28,17,11
36464,Gnralways,andorhal,1371,priest,discipline,87,41,46
36465,Karazhan,burning-legion,1371,priest,discipline,44,19,25
36466,Methodist,proudmoore,1371,priest,discipline,94,39,55
36467,Miserable,emerald-dream,1371,priest,discipline,101,40,61
36468,Sluttiness,tichondrius,1370,priest,discipline,81,47,34
36469,Tatereh,illidan,1370,priest,discipline,64,34,30
36470,Endeshealer,suramar,1370,priest,discipline,54,28,26
36471,Jìtters,silvermoon,1370,priest,discipline,36,17,19
36472,Growth,fizzcrank,1370,priest,discipline,72,26,46
36473,Devilwithin,moon-guard,1369,priest,discipline,47,28,19
36474,Arvida,ragnaros,1369,priest,discipline,66,39,27
36475,Kyoku,tanaris,1369,priest,discipline,47,27,20
36476,Aarei,stormrage,1369,priest,discipline,30,16,14
36477,Mawlaana,frostmourne,1369,priest,discipline,42,21,21
36478,Onjah,kiljaeden,1369,priest,discipline,60,25,35
36479,Jesisapollo,blackrock,1368,priest,discipline,23,15,8
36480,Allivan,frostwolf,1368,priest,discipline,30,19,11
36481,Anymoon,tichondrius,1368,priest,discipline,96,53,43
36482,Zènó,bleeding-hollow,1368,priest,discipline,36,19,17
36483,Donzorro,ragnaros,1367,priest,discipline,99,51,48
36484,Mørphina,azralon,1366,priest,discipline,24,16,8
36485,Poefosho,stormrage,1366,priest,discipline,260,132,128
36486,Endereth,skullcrusher,1366,priest,discipline,306,144,162
36487,Solsano,stormrage,1365,priest,discipline,76,44,32
36488,Idel,runetotem,1365,priest,discipline,36,16,20
36489,Voyou,icecrown,1365,priest,discipline,130,57,73
36490,Purgingsyns,illidan,1364,priest,discipline,56,34,22
36491,Nars,draka,1364,priest,discipline,30,16,14
36492,Hideyourkids,stormreaver,1364,priest,discipline,83,42,41
36493,Naelsaze,tichondrius,1363,priest,discipline,22,15,7
36494,Shortty,arthas,1363,priest,discipline,36,23,13
36495,Halfyo,dragonmaw,1363,priest,discipline,90,49,41
36496,Holyjibs,moon-guard,1362,priest,discipline,37,26,11
36497,Dokthekim,frostmourne,1362,priest,discipline,56,29,27
36498,Temkcalb,ragnaros,1361,priest,discipline,90,46,44
36499,Sinnertitanz,quelthalas,1361,priest,discipline,90,46,44
36500,Lalo,bleeding-hollow,1361,priest,discipline,40,17,23
36501,Rakpriest,nerzhul,1360,priest,discipline,43,29,14
36502,Curasia,drakkari,1360,priest,discipline,57,37,20
36503,Andariel,quelthalas,1360,priest,discipline,42,27,15
36504,Supski,destromath,1360,priest,discipline,30,15,15
36505,Feedya,tichondrius,1360,priest,discipline,507,246,261
36506,Trummp,tichondrius,1359,priest,discipline,75,40,35
36507,Powerwordzz,dragonmaw,1359,priest,discipline,72,36,36
36508,Crucïfïx,stormrage,1358,priest,discipline,70,41,29
36509,Nexoox,drakkari,1358,priest,discipline,42,23,19
36510,Lexiahp,frostmourne,1358,priest,discipline,31,15,16
36511,Ålexánder,quelthalas,1358,priest,discipline,54,23,31
36512,Tûbes,trollbane,1358,priest,discipline,101,42,59
36513,Replacednewb,chogall,1357,priest,discipline,57,30,27
36514,Eiju,proudmoore,1357,priest,discipline,42,19,23
36515,Marcuse,ragnaros,1357,priest,discipline,73,27,46
36516,Aerdune,dalaran,1356,priest,discipline,68,36,32
36517,Smirkinlive,illidan,1356,priest,discipline,51,27,24
36518,Cyphrus,hyjal,1356,priest,discipline,47,21,26
36519,Matchakatt,tichondrius,1355,priest,discipline,65,41,24
36520,Kymmei,warsong,1354,priest,discipline,30,15,15
36521,PlayerWDHGQY,illidan,1354,priest,discipline,243,118,125
36522,Smileshadowx,frostmourne,1353,priest,discipline,27,16,11
36523,Msdash,tichondrius,1353,priest,discipline,42,23,19
36524,Srwilly,ragnaros,1353,priest,discipline,87,47,40
36525,Renews,azralon,1353,priest,discipline,52,28,24
36526,Rêvelation,trollbane,1353,priest,discipline,159,85,74
36527,Rvxy,tichondrius,1353,priest,discipline,90,48,42
36528,Vaticly,hyjal,1353,priest,discipline,132,62,70
36529,Mateekie,malganis,1352,priest,discipline,43,24,19
36530,Chìbiusa,proudmoore,1352,priest,discipline,106,52,54
36531,Stoutqt,arthas,1351,priest,discipline,30,23,7
36532,Hootin,whisperwind,1351,priest,discipline,62,35,27
36533,Risedead,azralon,1351,priest,discipline,132,70,62
36534,Saegusa,tichondrius,1351,priest,discipline,76,35,41
36535,Djefe,tichondrius,1350,priest,discipline,106,53,53
36536,Pagän,illidan,1349,priest,discipline,45,25,20
36537,Selenthea,moon-guard,1349,priest,discipline,100,52,48
36538,Beñzi,sargeras,1348,priest,discipline,26,16,10
36539,Rickitz,bleeding-hollow,1348,priest,discipline,60,32,28
36540,Toysqt,sargeras,1348,priest,discipline,29,15,14
36541,Yayoo,exodar,1348,priest,discipline,45,23,22
36542,Howdydoo,azshara,1348,priest,discipline,73,33,40
36543,Skadim,azralon,1348,priest,discipline,156,68,88
36544,Hellagud,kargath,1346,priest,discipline,78,42,36
36545,Revreal,thrall,1346,priest,discipline,48,25,23
36546,Eblis,the-underbog,1346,priest,discipline,63,26,37
36547,Pelagius,suramar,1345,priest,discipline,44,19,25
36548,ßræcher,black-dragonflight,1344,priest,discipline,36,24,12
36549,Photos,stormrage,1344,priest,discipline,60,37,23
36550,Myspacegirl,tichondrius,1344,priest,discipline,43,23,20
36551,Hoppus,stormrage,1344,priest,discipline,96,47,49
36552,Scaloni,proudmoore,1343,priest,discipline,29,18,11
36553,Textmepls,barthilas,1343,priest,discipline,54,32,22
36554,Censyz,tichondrius,1343,priest,discipline,24,14,10
36555,Elciid,tichondrius,1343,priest,discipline,24,14,10
36556,Swaggie,skullcrusher,1343,priest,discipline,24,14,10
36557,Mthwz,tichondrius,1343,priest,discipline,24,14,10
36558,Fadewench,sargeras,1343,priest,discipline,41,21,20
36559,Lucsor,malganis,1343,priest,discipline,119,60,59
36560,Míssdank,tichondrius,1343,priest,discipline,36,18,18
36561,Mitoloshi,ragnaros,1343,priest,discipline,126,61,65
36562,Grapeedrank,tichondrius,1342,priest,discipline,45,30,15
36563,Crazykitsune,thaurissan,1342,priest,discipline,42,27,15
36564,Annefrank,azjolnerub,1342,priest,discipline,24,14,10
36565,Loopzw,tichondrius,1342,priest,discipline,24,14,10
36566,Lawroade,tichondrius,1342,priest,discipline,67,36,31
36567,What,moon-guard,1342,priest,discipline,132,66,66
36568,Flab,tichondrius,1342,priest,discipline,34,17,17
36569,Kayzen,frostmourne,1342,priest,discipline,36,15,21
36570,Goseoa,tichondrius,1342,priest,discipline,60,24,36
36571,Spursky,emerald-dream,1341,priest,discipline,18,14,4
36572,Saintclac,illidan,1341,priest,discipline,24,15,9
36573,Redcoolaid,moon-guard,1341,priest,discipline,24,14,10
36574,Carlita,ravenholdt,1341,priest,discipline,24,14,10
36575,Ophailea,thrall,1341,priest,discipline,66,37,29
36576,Psyfriend,area-52,1341,priest,discipline,30,14,16
36577,Zoap,stormrage,1341,priest,discipline,60,26,34
36578,Gnomelester,kiljaeden,1340,priest,discipline,36,21,15
36579,Teiam,skullcrusher,1340,priest,discipline,24,14,10
36580,Phonomena,malganis,1340,priest,discipline,162,85,77
36581,Bionix,stormrage,1340,priest,discipline,72,37,35
36582,Storylord,malganis,1340,priest,discipline,30,14,16
36583,Pactosombrio,azralon,1339,priest,discipline,134,78,56
36584,Hollowsp,tichondrius,1339,priest,discipline,30,14,16
36585,Rondebarber,thunderlord,1338,priest,discipline,90,47,43
36586,Mellerwine,azralon,1338,priest,discipline,505,262,243
36587,Vehlind,quelthalas,1338,priest,discipline,101,52,49
36588,Krané,area-52,1338,priest,discipline,57,29,28
36589,Kasiry,ragnaros,1338,priest,discipline,78,38,40
36590,Ucksy,blackrock,1338,priest,discipline,30,14,16
36591,Foremender,illidan,1338,priest,discipline,84,33,51
36592,Lildubs,bloodhoof,1337,priest,discipline,18,14,4
36593,Seniro,tichondrius,1337,priest,discipline,42,27,15
36594,Kazandraah,quelthalas,1337,priest,discipline,36,23,13
36595,Aveil,bloodscalp,1337,priest,discipline,46,27,19
36596,Theboogieman,magtheridon,1337,priest,discipline,89,48,41
36597,Muuq,frostmourne,1337,priest,discipline,221,110,111
36598,Leejungjae,tichondrius,1337,priest,discipline,39,19,20
36599,Monâ,sargeras,1337,priest,discipline,30,14,16
36600,Foxspritques,area-52,1337,priest,discipline,58,16,42
36601,Chaseshadow,kelthuzad,1336,priest,discipline,23,18,5
36602,Lilazngirl,stormrage,1336,priest,discipline,30,19,11
36603,Devout,dentarg,1336,priest,discipline,24,14,10
36604,Såge,chogall,1336,priest,discipline,302,160,142
36605,Metagameswag,tichondrius,1335,priest,discipline,24,14,10
36606,Vìrus,jubeithos,1335,priest,discipline,30,17,13
36607,Krukam,sargeras,1335,priest,discipline,84,47,37
36608,Icyspicy,shadowsong,1335,priest,discipline,91,49,42
36609,Crashed,frostmourne,1335,priest,discipline,60,27,33
36610,Scrubnubz,barthilas,1335,priest,discipline,36,16,20
36611,Shadina,gorefiend,1335,priest,discipline,36,14,22
36612,Yaholyfather,aerie-peak,1334,priest,discipline,24,14,10
36613,Pherïox,drakkari,1334,priest,discipline,36,19,17
36614,Talbadontu,thrall,1334,priest,discipline,42,22,20
36615,Erossenin,proudmoore,1334,priest,discipline,30,15,15
36616,Papafuego,stormrage,1333,priest,discipline,18,14,4
36617,Galnaine,emerald-dream,1333,priest,discipline,24,14,10
36618,Angelicus,ragnaros,1333,priest,discipline,318,163,155
36619,Bubblerenew,altar-of-storms,1333,priest,discipline,30,14,16
36620,Rblood,emerald-dream,1332,priest,discipline,54,33,21
36621,Fatherbrah,kelthuzad,1332,priest,discipline,27,15,12
36622,Oomed,bonechewer,1332,priest,discipline,147,73,74
36623,Phenic,aggramar,1332,priest,discipline,41,18,23
36624,Feltsmaces,shadowmoon,1332,priest,discipline,35,14,21
36625,Layu,azralon,1332,priest,discipline,36,14,22
36626,Müsic,stormrage,1331,priest,discipline,24,14,10
36627,Noveh,tichondrius,1331,priest,discipline,36,17,19
36628,Bigskill,proudmoore,1331,priest,discipline,48,21,27
36629,Rhayzel,ragnaros,1330,priest,discipline,54,36,18
36630,Bathenape,bleeding-hollow,1330,priest,discipline,40,23,17
36631,Fatherßrian,draktharon,1330,priest,discipline,88,49,39
36632,Holyfromrmp,tichondrius,1330,priest,discipline,72,35,37
36633,Hunanbeef,kiljaeden,1330,priest,discipline,106,51,55
36634,Decline,balnazzar,1330,priest,discipline,30,14,16
36635,Náay,ragnaros,1329,priest,discipline,47,30,17
36636,Emotionless,bonechewer,1329,priest,discipline,140,75,65
36637,Mpshield,kiljaeden,1328,priest,discipline,37,22,15
36638,Vodhka,arthas,1328,priest,discipline,24,14,10
36639,Themoon,tichondrius,1328,priest,discipline,24,14,10
36640,Jeanbi,ragnaros,1328,priest,discipline,42,23,19
36641,Namî,barthilas,1328,priest,discipline,215,115,100
36642,Honypot,ysondre,1328,priest,discipline,96,51,45
36643,Raydz,altar-of-storms,1328,priest,discipline,272,130,142
36644,Kivz,stormrage,1328,priest,discipline,48,21,27
36645,Zóe,eredar,1327,priest,discipline,70,37,33
36646,Tursai,frostmourne,1327,priest,discipline,63,31,32
36647,ßlackøut,sargeras,1327,priest,discipline,30,14,16
36648,Nêrô,dalaran,1327,priest,discipline,66,29,37
36649,Shenanigans,illidan,1326,priest,discipline,23,14,9
36650,Danrien,azralon,1326,priest,discipline,34,20,14
36651,Effsinstinks,illidan,1326,priest,discipline,24,14,10
36652,Cathiah,darkspear,1326,priest,discipline,260,133,127
36653,Healmedaddyy,korgath,1326,priest,discipline,207,99,108
36654,Healznfeel,tichondrius,1326,priest,discipline,54,23,31
36655,Turrec,illidan,1325,priest,discipline,18,14,4
36656,Juliusceazer,skywall,1325,priest,discipline,128,73,55
36657,Magicßoy,magtheridon,1325,priest,discipline,298,153,145
36658,Durgen,stormreaver,1325,priest,discipline,43,20,23
36659,Zapix,tichondrius,1325,priest,discipline,36,15,21
36660,Blessedelf,tichondrius,1325,priest,discipline,66,26,40
36661,Edmust,black-dragonflight,1324,priest,discipline,24,14,10
36662,Plasmax,ragnaros,1324,priest,discipline,56,19,37
36663,Xerzosh,area-52,1323,priest,discipline,154,81,73
36664,Jaysontatum,gurubashi,1323,priest,discipline,33,17,16
36665,Zawi,zuljin,1323,priest,discipline,103,50,53
36666,Bedläm,kilrogg,1323,priest,discipline,54,23,31
36667,Kaeshia,proudmoore,1322,priest,discipline,30,18,12
36668,Gariell,ragnaros,1322,priest,discipline,24,14,10
36669,Illen,nemesis,1322,priest,discipline,60,34,26
36670,Methodist,sargeras,1322,priest,discipline,30,17,13
36671,Amarøth,illidan,1320,priest,discipline,30,14,16
36672,Powerwordshy,area-52,1320,priest,discipline,30,14,16
36673,Ayakoji,proudmoore,1320,priest,discipline,48,20,28
36674,Sanarion,area-52,1319,priest,discipline,60,36,24
36675,Volkova,quelthalas,1319,priest,discipline,54,30,24
36676,Nadiaxo,moon-guard,1319,priest,discipline,65,35,30
36677,Nøzmonica,kelthuzad,1319,priest,discipline,32,15,17
36678,Sidepiëce,area-52,1318,priest,discipline,35,14,21
36679,Neutrino,quelthalas,1317,priest,discipline,29,14,15
36680,Rookieone,thrall,1317,priest,discipline,92,44,48
36681,Ripscrew,area-52,1316,priest,discipline,24,14,10
36682,Gäindalt,tichondrius,1316,priest,discipline,42,24,18
36683,Malevolently,illidan,1316,priest,discipline,137,62,75
36684,Demimo,frostwolf,1315,priest,discipline,30,18,12
36685,Hustleplay,tichondrius,1315,priest,discipline,48,27,21
36686,Holyninfo,quelthalas,1315,priest,discipline,102,54,48
36687,Eleeira,zuljin,1315,priest,discipline,42,18,24
36688,Eirenth,bleeding-hollow,1314,priest,discipline,46,32,14
36689,Thelondon,tichondrius,1314,priest,discipline,27,15,12
36690,Blaydun,elune,1313,priest,discipline,114,66,48
36691,Moontearss,tichondrius,1313,priest,discipline,48,25,23
36692,Jjojae,illidan,1313,priest,discipline,30,14,16
36693,Mynigajeff,zuljin,1312,priest,discipline,68,33,35
36694,Darkquinn,boulderfist,1312,priest,discipline,284,132,152
36695,Huck,khazgoroth,1312,priest,discipline,42,19,23
36696,Discgolfsux,sargeras,1312,priest,discipline,68,29,39
36697,Jsuschristix,zuljin,1311,priest,discipline,36,23,13
36698,Empower,garrosh,1311,priest,discipline,51,30,21
36699,Médic,guldan,1311,priest,discipline,30,17,13
36700,Peavzian,kiljaeden,1311,priest,discipline,64,30,34
36701,Goodwin,darkspear,1310,priest,discipline,48,29,19
36702,Chîna,hyjal,1310,priest,discipline,126,76,50
36703,Chloangel,frostmourne,1310,priest,discipline,24,14,10
36704,Conney,mugthol,1310,priest,discipline,24,14,10
36705,Pico,spirestone,1310,priest,discipline,72,41,31
36706,Warmth,moon-guard,1310,priest,discipline,81,44,37
36707,Eclìpsè,barthilas,1310,priest,discipline,50,23,27
36708,Slyoda,area-52,1310,priest,discipline,42,19,23
36709,Yunganal,sargeras,1309,priest,discipline,30,17,13
36710,Súlfuro,quelthalas,1309,priest,discipline,119,60,59
36711,Malarkie,sargeras,1309,priest,discipline,30,14,16
36712,Kakera,tichondrius,1308,priest,discipline,24,14,10
36713,Jaskil,skywall,1308,priest,discipline,78,42,36
36714,Aesudan,dalaran,1308,priest,discipline,63,33,30
36715,Booyâh,muradin,1308,priest,discipline,54,27,27
36716,Majesticar,moon-guard,1307,priest,discipline,30,20,10
36717,Rompenepes,drakkari,1307,priest,discipline,24,14,10
36718,Clickbait,spirestone,1307,priest,discipline,24,14,10
36719,Soaphia,kelthuzad,1307,priest,discipline,120,68,52
36720,Médíc,dalaran,1307,priest,discipline,63,32,31
36721,Fìngerbanger,lightnings-blade,1307,priest,discipline,198,98,100
36722,Jinicuil,quelthalas,1307,priest,discipline,54,25,29
36723,Holyrotape,nemesis,1307,priest,discipline,63,28,35
36724,Dominie,area-52,1306,priest,discipline,18,14,4
36725,Priestgobrr,emerald-dream,1305,priest,discipline,50,30,20
36726,Mommyshere,vashj,1305,priest,discipline,71,41,30
36727,Bloo,draktharon,1305,priest,discipline,42,24,18
36728,Ruthlèss,ragnaros,1305,priest,discipline,54,28,26
36729,Filterd,azshara,1305,priest,discipline,30,14,16
36730,Exploded,moon-guard,1305,priest,discipline,85,34,51
36731,Vandaley,tichondrius,1304,priest,discipline,30,19,11
36732,Chinstrap,zuljin,1304,priest,discipline,24,14,10
36733,Nooice,dalaran,1304,priest,discipline,30,14,16
36734,Dahrwin,thrall,1303,priest,discipline,42,24,18
36735,Testament,greymane,1303,priest,discipline,182,90,92
36736,ßoogey,tichondrius,1303,priest,discipline,47,22,25
36737,Gustavustus,barthilas,1303,priest,discipline,42,14,28
36738,Dalowks,area-52,1302,priest,discipline,54,24,30
36739,Poorass,sargeras,1301,priest,discipline,30,19,11
36740,Aedarelyn,ysera,1301,priest,discipline,42,22,20
36741,Lampfood,alterac-mountains,1301,priest,discipline,36,17,19
36742,Helibix,bleeding-hollow,1301,priest,discipline,162,74,88
36743,Evilnyllah,stormrage,1300,priest,discipline,32,20,12
36744,Gurbooz,illidan,1300,priest,discipline,62,35,27
36745,Priést,stormrage,1300,priest,discipline,45,19,26
36746,Spõt,stormrage,1300,priest,discipline,48,19,29
36747,Morningzz,tichondrius,1299,priest,discipline,84,36,48
36748,Tarny,tichondrius,1298,priest,discipline,46,29,17
36749,Sofhya,ragnaros,1298,priest,discipline,124,66,58
36750,Sinnon,turalyon,1298,priest,discipline,36,19,17
36751,Bandagebabe,sargeras,1298,priest,discipline,36,15,21
36752,Timeglass,kelthuzad,1297,priest,discipline,47,26,21
36753,Mechahomo,dalaran,1297,priest,discipline,52,28,24
36754,Ahane,wyrmrest-accord,1297,priest,discipline,66,31,35
36755,Sæýfír,illidan,1296,priest,discipline,24,14,10
36756,Sòraka,tichondrius,1296,priest,discipline,130,65,65
36757,Dabbinton,chogall,1296,priest,discipline,52,26,26
36758,Hydramîst,ragnaros,1296,priest,discipline,36,15,21
36759,Pottime,tichondrius,1295,priest,discipline,50,30,20
36760,Boostvoid,terenas,1295,priest,discipline,245,132,113
36761,Fenian,frostmourne,1295,priest,discipline,123,60,63
36762,Flatëarth,tichondrius,1294,priest,discipline,376,179,197
36763,Travita,quelthalas,1293,priest,discipline,54,29,25
36764,Füuzin,stormrage,1293,priest,discipline,96,46,50
36765,Dadthegreat,bonechewer,1292,priest,discipline,42,25,17
36766,Usmond,azralon,1292,priest,discipline,48,23,25
36767,Unfriend,sargeras,1291,priest,discipline,48,22,26
36768,Rakket,moon-guard,1291,priest,discipline,36,16,20
36769,Soulclap,sargeras,1291,priest,discipline,35,14,21
36770,Voodooloa,tichondrius,1291,priest,discipline,90,35,55
36771,Lunett,area-52,1291,priest,discipline,52,19,33
36772,Lyxx,kelthuzad,1290,priest,discipline,22,15,7
36773,Xmasmiracle,korgath,1290,priest,discipline,112,65,47
36774,Elixia,maiev,1290,priest,discipline,70,38,32
36775,Avarice,magtheridon,1289,priest,discipline,40,24,16
36776,Cubski,darkspear,1289,priest,discipline,31,15,16
36777,Leprêtre,hakkar,1289,priest,discipline,42,20,22
36778,Moralism,moon-guard,1288,priest,discipline,56,36,20
36779,Troublmaker,illidan,1288,priest,discipline,46,24,22
36780,Webbii,frostmourne,1288,priest,discipline,60,29,31
36781,Bibops,area-52,1288,priest,discipline,37,15,22
36782,Nocturnalx,moon-guard,1287,priest,discipline,82,51,31
36783,Bbm,stormscale,1287,priest,discipline,105,52,53
36784,Iwonthealu,senjin,1286,priest,discipline,30,16,14
36785,Khaleth,suramar,1286,priest,discipline,48,20,28
36786,Prelate,moon-guard,1286,priest,discipline,36,15,21
36787,Rôxxy,thrall,1285,priest,discipline,48,27,21
36788,Snowinvan,tichondrius,1285,priest,discipline,47,26,21
36789,Brounly,drakkari,1285,priest,discipline,72,36,36
36790,Nenemsis,drakkari,1285,priest,discipline,38,16,22
36791,Boibussy,tichondrius,1285,priest,discipline,36,15,21
36792,Dolm,tichondrius,1284,priest,discipline,250,124,126
36793,Voidmaker,area-52,1284,priest,discipline,48,17,31
36794,Antxres,sargeras,1283,priest,discipline,29,14,15
36795,Penancepapi,stormrage,1283,priest,discipline,30,14,16
36796,Rotass,hyjal,1282,priest,discipline,96,51,45
36797,Boojanglez,exodar,1282,priest,discipline,48,25,23
36798,Canharm,tichondrius,1282,priest,discipline,73,29,44
36799,Presto,kalecgos,1281,priest,discipline,24,19,5
36800,Crackneesha,tichondrius,1281,priest,discipline,30,19,11
36801,Rashad,proudmoore,1281,priest,discipline,71,41,30
36802,Holymagic,lightnings-blade,1281,priest,discipline,53,29,24
36803,Zenthaz,thrall,1281,priest,discipline,80,40,40
36804,Dismybracket,tichondrius,1281,priest,discipline,42,20,22
36805,Lifeswap,area-52,1281,priest,discipline,54,21,33
36806,Invocational,moon-guard,1280,priest,discipline,129,66,63
36807,Touchér,whisperwind,1280,priest,discipline,29,14,15
36808,Pkriest,illidan,1279,priest,discipline,30,14,16
36809,Briefs,stormrage,1278,priest,discipline,21,15,6
36810,Wísh,emerald-dream,1278,priest,discipline,90,54,36
36811,Goingserious,frostmourne,1278,priest,discipline,189,104,85
36812,Bloodsorrow,ragnaros,1278,priest,discipline,72,39,33
36813,Slewt,aggramar,1278,priest,discipline,48,25,23
36814,Kakao,stormreaver,1278,priest,discipline,120,51,69
36815,Slimshieldy,illidan,1277,priest,discipline,28,15,13
36816,Phaille,chromaggus,1277,priest,discipline,170,91,79
36817,Gungagingong,queldorei,1276,priest,discipline,66,38,28
36818,Finake,kelthuzad,1276,priest,discipline,85,48,37
36819,Fairylìght,stormrage,1276,priest,discipline,67,24,43
36820,Ttakayasu,bleeding-hollow,1275,priest,discipline,180,102,78
36821,Lowkii,malfurion,1275,priest,discipline,35,17,18
36822,Orìsel,wyrmrest-accord,1274,priest,discipline,153,72,81
36823,Nylaza,kiljaeden,1274,priest,discipline,71,28,43
36824,Medo,dalaran,1272,priest,discipline,88,46,42
36825,Strict,the-forgotten-coast,1272,priest,discipline,29,14,15
36826,Lîghtsaber,illidan,1272,priest,discipline,46,16,30
36827,Drilbitt,jaedenar,1271,priest,discipline,21,15,6
36828,Kìn,tol-barad,1271,priest,discipline,54,22,32
36829,Healmegently,bonechewer,1271,priest,discipline,45,15,30
36830,Markspell,stormrage,1270,priest,discipline,145,77,68
36831,Derlanger,frostmourne,1270,priest,discipline,48,25,23
36832,Mythica,gurubashi,1270,priest,discipline,224,116,108
36833,Foose,suramar,1270,priest,discipline,48,23,25
36834,Cilpri,emerald-dream,1269,priest,discipline,25,14,11
36835,Twotimechamp,azshara,1269,priest,discipline,50,26,24
36836,Termiina,hyjal,1269,priest,discipline,85,41,44
36837,Glauga,azralon,1269,priest,discipline,66,24,42
36838,Theheal,ragnaros,1269,priest,discipline,63,21,42
36839,Eluko,tichondrius,1268,priest,discipline,33,18,15
36840,Forliang,proudmoore,1268,priest,discipline,27,14,13
36841,Lätöxïkä,alleria,1268,priest,discipline,65,33,32
36842,Jjayleroux,hyjal,1268,priest,discipline,54,26,28
36843,Franku,quelthalas,1267,priest,discipline,33,23,10
36844,Sojumike,proudmoore,1267,priest,discipline,60,31,29
36845,Köto,dalaran,1267,priest,discipline,77,39,38
36846,Aggravating,mugthol,1267,priest,discipline,176,89,87
36847,Thokrül,lightbringer,1266,priest,discipline,42,23,19
36848,Miraz,the-venture-co,1266,priest,discipline,53,29,24
36849,Boocharni,wyrmrest-accord,1266,priest,discipline,92,50,42
36850,Xavaat,nerzhul,1266,priest,discipline,84,38,46
36851,Nometh,emerald-dream,1266,priest,discipline,90,38,52
36852,Atemlos,malorne,1265,priest,discipline,42,24,18
36853,Penitentrowr,illidan,1265,priest,discipline,77,40,37
36854,Deadlykíss,sargeras,1265,priest,discipline,54,26,28
36855,Welorian,mannoroth,1265,priest,discipline,54,24,30
36856,Cromekolo,tichondrius,1264,priest,discipline,27,16,11
36857,Docvalentino,malganis,1264,priest,discipline,24,14,10
36858,Aipata,stormrage,1264,priest,discipline,74,41,33
36859,Karnival,aggramar,1264,priest,discipline,48,23,25
36860,Raisonpriest,tichondrius,1264,priest,discipline,182,87,95
36861,Keskima,malganis,1263,priest,discipline,87,54,33
36862,Kethal,area-52,1263,priest,discipline,37,19,18
36863,Toorshul,tichondrius,1262,priest,discipline,48,26,22
36864,Saràh,stormscale,1262,priest,discipline,94,43,51
36865,Reindharth,quelthalas,1262,priest,discipline,90,38,52
36866,Kristt,thrall,1262,priest,discipline,41,16,25
36867,Emlix,tichondrius,1262,priest,discipline,42,14,28
36868,Barrieroflig,tichondrius,1261,priest,discipline,45,25,20
36869,Vanszz,area-52,1260,priest,discipline,54,26,28
36870,Marhuana,stormreaver,1260,priest,discipline,47,19,28
36871,Greif,garrosh,1259,priest,discipline,54,25,29
36872,Heniupriest,tichondrius,1259,priest,discipline,48,22,26
36873,Alawn,wyrmrest-accord,1259,priest,discipline,120,52,68
36874,Atelios,azralon,1258,priest,discipline,30,20,10
36875,Quasenada,stormrage,1258,priest,discipline,23,14,9
36876,Nerzghoul,sargeras,1258,priest,discipline,42,24,18
36877,Kymosolop,sargeras,1258,priest,discipline,25,14,11
36878,Skall,kirin-tor,1258,priest,discipline,41,21,20
36879,Capricornio,nemesis,1258,priest,discipline,60,30,30
36880,Saadboii,thrall,1257,priest,discipline,61,31,30
36881,Themøn,quelthalas,1257,priest,discipline,36,18,18
36882,Dralaan,proudmoore,1257,priest,discipline,92,44,48
36883,Kenzao,nemesis,1257,priest,discipline,64,30,34
36884,Lge,kelthuzad,1257,priest,discipline,31,14,17
36885,Dartonya,thrall,1257,priest,discipline,36,15,21
36886,Hawktalonuke,moon-guard,1256,priest,discipline,90,50,40
36887,Nìght,trollbane,1256,priest,discipline,102,54,48
36888,Klingande,tichondrius,1255,priest,discipline,75,39,36
36889,Knifê,moon-guard,1255,priest,discipline,108,54,54
36890,Kauldër,illidan,1255,priest,discipline,58,21,37
36891,Norriam,moon-guard,1254,priest,discipline,41,27,14
36892,Thotznprayrz,bleeding-hollow,1254,priest,discipline,36,23,13
36893,Ðelight,ragnaros,1254,priest,discipline,72,36,36
36894,Chavkoraken,stormrage,1254,priest,discipline,38,15,23
36895,Educated,tichondrius,1254,priest,discipline,38,14,24
36896,Saviorsélf,tichondrius,1253,priest,discipline,162,76,86
36897,Cajl,dathremar,1253,priest,discipline,137,63,74
36898,Rbgeezus,lightnings-blade,1252,priest,discipline,113,57,56
36899,Nightmxs,tichondrius,1252,priest,discipline,54,25,29
36900,Këyglock,kelthuzad,1252,priest,discipline,252,111,141
36901,Bröke,nemesis,1251,priest,discipline,114,61,53
36902,Vynlanesh,illidan,1251,priest,discipline,66,34,32
36903,Mannius,tichondrius,1251,priest,discipline,106,49,57
36904,Slickbakk,illidan,1251,priest,discipline,74,32,42
36905,Dosarix,sargeras,1250,priest,discipline,40,23,17
36906,Pêrsephône,tichondrius,1250,priest,discipline,246,118,128
36907,Gorechop,aegwynn,1250,priest,discipline,71,29,42
36908,Zumanîty,zangarmarsh,1249,priest,discipline,24,15,9
36909,Zaroki,sargeras,1249,priest,discipline,24,14,10
36910,Jestiann,aegwynn,1249,priest,discipline,257,131,126
36911,Thoughtcrime,doomhammer,1249,priest,discipline,62,31,31
36912,Ktqt,moon-guard,1249,priest,discipline,253,125,128
36913,Tmspongwo,tichondrius,1248,priest,discipline,30,21,9
36914,Dispelbot,kelthuzad,1248,priest,discipline,160,90,70
36915,Allhubris,stormrage,1248,priest,discipline,24,13,11
36916,Frikapp,stormrage,1248,priest,discipline,24,13,11
36917,Lalaliza,kelthuzad,1248,priest,discipline,24,13,11
36918,Radgars,frostmourne,1248,priest,discipline,55,27,28
36919,Haø,stormrage,1248,priest,discipline,302,147,155
36920,Curiosities,kiljaeden,1248,priest,discipline,30,13,17
36921,Iatemykids,tichondrius,1247,priest,discipline,24,13,11
36922,Lvcia,thrall,1247,priest,discipline,70,35,35
36923,Pianohouse,illidan,1247,priest,discipline,30,13,17
36924,Calamithus,illidan,1247,priest,discipline,30,13,17
36925,Pce,korialstrasz,1247,priest,discipline,34,13,21
36926,Dottinu,area-52,1246,priest,discipline,24,19,5
36927,Furydos,zuljin,1246,priest,discipline,24,13,11
36928,Peacetreaty,bleeding-hollow,1246,priest,discipline,24,13,11
36929,Picurry,frostmourne,1246,priest,discipline,24,13,11
36930,Vancake,quelthalas,1246,priest,discipline,222,103,119
36931,Zumbaoqepdqt,quelthalas,1246,priest,discipline,66,30,36
36932,Bearz,the-underbog,1246,priest,discipline,30,13,17
36933,Iol,spinebreaker,1246,priest,discipline,30,13,17
36934,Keepfit,proudmoore,1245,priest,discipline,52,29,23
36935,Armspriest,stormrage,1245,priest,discipline,59,31,28
36936,Youaint,sargeras,1245,priest,discipline,30,13,17
36937,Epophy,stormrage,1244,priest,discipline,18,13,5
36938,Kellogss,magtheridon,1244,priest,discipline,18,13,5
36939,Elivice,ragnaros,1244,priest,discipline,24,13,11
36940,Kantareller,tichondrius,1244,priest,discipline,148,80,68
36941,Tubrisildris,zuljin,1244,priest,discipline,30,13,17
36942,Seí,barthilas,1244,priest,discipline,30,13,17
36943,Gomer,stormrage,1243,priest,discipline,24,14,10
36944,Bingoreferee,kelthuzad,1243,priest,discipline,24,13,11
36945,Crunchywater,stormrage,1243,priest,discipline,30,13,17
36946,Haetas,zuljin,1243,priest,discipline,30,13,17
36947,Cyaja,moon-guard,1243,priest,discipline,31,13,18
36948,Meiev,quelthalas,1243,priest,discipline,36,13,23
36949,Deagled,tichondrius,1243,priest,discipline,36,13,23
36950,Okiin,malganis,1243,priest,discipline,36,13,23
36951,Grapës,jubeithos,1242,priest,discipline,48,23,25
36952,Breeannà,doomhammer,1242,priest,discipline,34,16,18
36953,Cuddly,shandris,1242,priest,discipline,119,54,65
36954,Tassadaraiur,tichondrius,1242,priest,discipline,86,37,49
36955,Touchyouboy,stormrage,1242,priest,discipline,35,15,20
36956,Keleset,area-52,1242,priest,discipline,36,13,23
36957,Quickq,barthilas,1241,priest,discipline,42,24,18
36958,Dragndatwagn,malganis,1241,priest,discipline,27,15,12
36959,Healaryduff,skullcrusher,1241,priest,discipline,24,13,11
36960,Frotters,kiljaeden,1241,priest,discipline,24,13,11
36961,Moresex,azralon,1241,priest,discipline,85,43,42
36962,Harborcoat,whisperwind,1241,priest,discipline,35,14,21
36963,Tubz,boulderfist,1241,priest,discipline,36,13,23
36964,Wantsumcandy,illidan,1240,priest,discipline,102,61,41
36965,Ruaba,area-52,1240,priest,discipline,24,13,11
36966,Biggerstaff,icecrown,1240,priest,discipline,33,16,17
36967,Rando,shattered-halls,1240,priest,discipline,59,28,31
36968,Arodar,wyrmrest-accord,1240,priest,discipline,30,14,16
36969,Shadlo,chogall,1240,priest,discipline,30,13,17
36970,Spacegrassfx,bleeding-hollow,1239,priest,discipline,24,14,10
36971,Discrepancy,sargeras,1239,priest,discipline,24,14,10
36972,Sadury,tichondrius,1239,priest,discipline,246,135,111
36973,Sunwalken,stormrage,1239,priest,discipline,30,13,17
36974,Skylark,bronzebeard,1239,priest,discipline,36,13,23
36975,Dics,barthilas,1238,priest,discipline,18,13,5
36976,Daegal,malfurion,1238,priest,discipline,18,13,5
36977,Saviorkaï,barthilas,1238,priest,discipline,45,25,20
36978,Feloxi,lightnings-blade,1238,priest,discipline,24,13,11
36979,Tunare,dalaran,1238,priest,discipline,24,13,11
36980,Wisher,gorefiend,1238,priest,discipline,41,22,19
36981,Cvstodia,tichondrius,1238,priest,discipline,30,16,14
36982,Xsqt,stormrage,1238,priest,discipline,60,31,29
36983,Misaosan,azralon,1238,priest,discipline,60,29,31
36984,Fumes,ghostlands,1238,priest,discipline,138,66,72
36985,Masochist,barthilas,1237,priest,discipline,152,83,69
36986,Jesstor,frostmourne,1237,priest,discipline,24,13,11
36987,Pinkhandcuff,gorefiend,1237,priest,discipline,54,25,29
36988,Xuxao,azralon,1237,priest,discipline,35,15,20
36989,Tdmheals,zuluhed,1236,priest,discipline,36,25,11
36990,Holycoww,lightnings-blade,1236,priest,discipline,24,13,11
36991,Whitesharks,tichondrius,1236,priest,discipline,24,13,11
36992,Holyren,sargeras,1236,priest,discipline,134,69,65
36993,Gregorovich,ragnaros,1236,priest,discipline,59,27,32
36994,Hellsembrace,lightbringer,1236,priest,discipline,30,13,17
36995,Naniwa,ragnaros,1236,priest,discipline,39,16,23
36996,Mikori,tichondrius,1235,priest,discipline,18,13,5
36997,Nerylia,stormrage,1235,priest,discipline,18,13,5
36998,Deadlydocc,illidan,1235,priest,discipline,39,23,16
36999,Kideater,quelthalas,1235,priest,discipline,24,13,11
37000,Bonkerwaffle,kelthuzad,1235,priest,discipline,54,29,25
37001,Fesix,akama,1235,priest,discipline,42,22,20
37002,Betrthenadam,bleeding-hollow,1235,priest,discipline,66,32,34
37003,Duatneter,quelthalas,1235,priest,discipline,84,39,45
37004,Rhennythal,tichondrius,1235,priest,discipline,30,13,17
37005,Tossôff,proudmoore,1234,priest,discipline,18,13,5
37006,Undefiled,rexxar,1234,priest,discipline,42,24,18
37007,Awyn,elune,1234,priest,discipline,48,25,23
37008,Hobbs,trollbane,1234,priest,discipline,48,24,24
37009,Léto,burning-blade,1234,priest,discipline,48,21,27
37010,Chervz,chogall,1234,priest,discipline,30,13,17
37011,Beastpriest,dalvengyr,1234,priest,discipline,30,13,17
37012,Miznewbooty,garona,1233,priest,discipline,30,17,13
37013,Ickarus,anubarak,1233,priest,discipline,90,49,41
37014,Sichuankeith,frostmourne,1233,priest,discipline,24,13,11
37015,Kinkypriest,tichondrius,1233,priest,discipline,24,13,11
37016,Dårc,tichondrius,1233,priest,discipline,113,58,55
37017,Anöa,emerald-dream,1233,priest,discipline,36,16,20
37018,Glitterballs,khazgoroth,1232,priest,discipline,24,13,11
37019,Tigop,alleria,1232,priest,discipline,24,13,11
37020,Calcifer,drakkari,1232,priest,discipline,30,13,17
37021,Kuroyanagi,ragnaros,1232,priest,discipline,36,13,23
37022,Xora,frostmourne,1232,priest,discipline,36,13,23
37023,Nanabritches,moon-guard,1231,priest,discipline,163,84,79
37024,Ðiviniti,moon-guard,1231,priest,discipline,36,17,19
37025,Karamapang,illidan,1231,priest,discipline,122,56,66
37026,Demimang,emerald-dream,1231,priest,discipline,30,13,17
37027,Samàél,frostmourne,1231,priest,discipline,41,17,24
37028,Holyxb,bleeding-hollow,1231,priest,discipline,36,13,23
37029,Empty,frostmourne,1230,priest,discipline,18,13,5
37030,Shïtheals,frostmourne,1230,priest,discipline,42,25,17
37031,Alenio,sargeras,1230,priest,discipline,30,14,16
37032,Ón,tichondrius,1230,priest,discipline,30,13,17
37033,Riotgearmd,sargeras,1229,priest,discipline,30,17,13
37034,Wanaatlarboy,dark-iron,1229,priest,discipline,41,23,18
37035,Lichae,ragnaros,1229,priest,discipline,48,24,24
37036,Yürika,emerald-dream,1229,priest,discipline,168,73,95
37037,Kurtsheals,destromath,1228,priest,discipline,60,31,29
37038,Krypticus,tichondrius,1227,priest,discipline,54,31,23
37039,Aape,frostmourne,1227,priest,discipline,24,13,11
37040,Swolequadz,elune,1227,priest,discipline,38,20,18
37041,Senliastra,medivh,1226,priest,discipline,30,18,12
37042,Jeffo,baelgun,1226,priest,discipline,78,44,34
37043,Notdavido,illidan,1226,priest,discipline,48,26,22
37044,Yotinha,nemesis,1226,priest,discipline,24,13,11
37045,Healtomuch,nagrand,1226,priest,discipline,120,59,61
37046,Pavarotti,laughing-skull,1226,priest,discipline,44,19,25
37047,Gurbooz,tichondrius,1225,priest,discipline,77,35,42
37048,Bendoverbb,tichondrius,1225,priest,discipline,30,13,17
37049,Gäindalf,tichondrius,1224,priest,discipline,22,14,8
37050,Kapriestun,tichondrius,1224,priest,discipline,66,37,29
37051,Hanuloa,tichondrius,1224,priest,discipline,114,57,57
37052,Eneco,alleria,1223,priest,discipline,297,156,141
37053,Castnngcouch,tichondrius,1223,priest,discipline,217,103,114
37054,Fearufaraway,tichondrius,1223,priest,discipline,36,13,23
37055,Ahitaro,ragnaros,1223,priest,discipline,60,18,42
37056,Aud,kiljaeden,1222,priest,discipline,18,14,4
37057,Kummar,burning-blade,1222,priest,discipline,24,13,11
37058,Kosiris,stormrage,1222,priest,discipline,102,41,61
37059,Olêander,tichondrius,1221,priest,discipline,97,55,42
37060,Hoffmanx,emerald-dream,1221,priest,discipline,24,13,11
37061,Dittless,stormrage,1221,priest,discipline,60,29,31
37062,Beecakes,illidan,1220,priest,discipline,29,16,13
37063,Zadae,area-52,1220,priest,discipline,63,34,29
37064,Pòba,malganis,1220,priest,discipline,30,13,17
37065,Kessavannell,frostwolf,1219,priest,discipline,24,13,11
37066,Séraphin,proudmoore,1219,priest,discipline,37,16,21
37067,Jic,barthilas,1219,priest,discipline,66,25,41
37068,Snekboy,hakkar,1218,priest,discipline,78,45,33
37069,Nonamegame,sargeras,1218,priest,discipline,78,42,36
37070,Cypress,dreadmaul,1218,priest,discipline,162,87,75
37071,Pyper,medivh,1218,priest,discipline,29,14,15
37072,Chopstix,senjin,1218,priest,discipline,35,16,19
37073,Lanakill,hyjal,1218,priest,discipline,56,25,31
37074,Gdessairmed,exodar,1218,priest,discipline,37,16,21
37075,Gobnik,illidan,1217,priest,discipline,42,26,16
37076,Yvága,ragnaros,1217,priest,discipline,48,27,21
37077,Forestpriest,area-52,1217,priest,discipline,24,13,11
37078,Pacopriest,tichondrius,1217,priest,discipline,24,13,11
37079,Kinkykween,tichondrius,1216,priest,discipline,24,13,11
37080,Novous,area-52,1216,priest,discipline,68,29,39
37081,Göats,emerald-dream,1215,priest,discipline,24,13,11
37082,Alexena,senjin,1215,priest,discipline,37,17,20
37083,Russbell,ragnaros,1215,priest,discipline,131,57,74
37084,Plznokill,tichondrius,1215,priest,discipline,48,20,28
37085,Eîr,tichondrius,1215,priest,discipline,72,29,43
37086,Vandwrath,moon-guard,1214,priest,discipline,24,14,10
37087,Kadkne,stormrage,1214,priest,discipline,29,16,13
37088,Myvanwy,silvermoon,1214,priest,discipline,30,13,17
37089,Wise,wildhammer,1213,priest,discipline,129,65,64
37090,Xpera,dalaran,1212,priest,discipline,203,97,106
37091,Nóin,tichondrius,1212,priest,discipline,72,33,39
37092,Psïcopata,gallywix,1212,priest,discipline,60,20,40
37093,Dotersacer,quelthalas,1211,priest,discipline,31,15,16
37094,Anakou,emerald-dream,1210,priest,discipline,35,20,15
37095,Abhu,quelthalas,1210,priest,discipline,77,41,36
37096,Svrite,area-52,1210,priest,discipline,35,17,18
37097,Zulkmoon,ragnaros,1210,priest,discipline,84,31,53
37098,Stunsilence,malganis,1209,priest,discipline,26,14,12
37099,Keliedeyn,emerald-dream,1209,priest,discipline,60,28,32
37100,Deckardkane,stormrage,1209,priest,discipline,32,14,18
37101,Anthoras,stormrage,1208,priest,discipline,24,13,11
37102,Ariavish,area-52,1208,priest,discipline,48,25,23
37103,Kodaks,frostmourne,1208,priest,discipline,93,46,47
37104,Fatäl,moon-guard,1208,priest,discipline,64,23,41
37105,Stusy,tichondrius,1207,priest,discipline,18,13,5
37106,Pixa,tichondrius,1207,priest,discipline,72,33,39
37107,Xïlencer,tichondrius,1206,priest,discipline,96,56,40
37108,Nothinsexual,frostmourne,1206,priest,discipline,26,14,12
37109,Cast,bronzebeard,1206,priest,discipline,82,37,45
37110,Dpshealer,azralon,1206,priest,discipline,66,29,37
37111,Discotecno,tichondrius,1205,priest,discipline,48,25,23
37112,Gurkorr,boulderfist,1205,priest,discipline,57,24,33
37113,Discs,detheroc,1205,priest,discipline,31,13,18
37114,Kafzial,zuljin,1204,priest,discipline,80,48,32
37115,Laggin,queldorei,1204,priest,discipline,47,25,22
37116,Sureno,muradin,1204,priest,discipline,54,28,26
37117,Visse,auchindoun,1204,priest,discipline,435,209,226
37118,Rowman,frostmourne,1204,priest,discipline,47,22,25
37119,Libationz,area-52,1204,priest,discipline,108,49,59
37120,Psychiatrist,darkspear,1204,priest,discipline,58,25,33
37121,Nêcrô,tichondrius,1203,priest,discipline,22,13,9
37122,Ithvedriel,moon-guard,1203,priest,discipline,67,32,35
37123,Spellpower,azralon,1203,priest,discipline,47,22,25
37124,Whitezz,frostmourne,1202,priest,discipline,42,21,21
37125,Khamata,kelthuzad,1202,priest,discipline,40,19,21
37126,Kyrabon,ragnaros,1201,priest,discipline,30,17,13
37127,Wrathchildd,azralon,1201,priest,discipline,84,42,42
37128,Healzyew,dragonmaw,1201,priest,discipline,79,31,48
37129,Ohnotready,tichondrius,1200,priest,discipline,24,13,11
37130,Zephxd,illidan,1199,priest,discipline,64,31,33
37131,Burpees,dalaran,1199,priest,discipline,88,39,49
37132,Aladelre,aerie-peak,1199,priest,discipline,74,32,42
37133,Terenor,thrall,1199,priest,discipline,48,13,35
37134,Jawdypriest,barthilas,1198,priest,discipline,44,27,17
37135,Yukih,tichondrius,1198,priest,discipline,64,29,35
37136,Shinomiko,frostmourne,1198,priest,discipline,162,63,99
37137,Lebwonjamdi,tichondrius,1197,priest,discipline,28,13,15
37138,Paidessanto,azralon,1196,priest,discipline,134,69,65
37139,Docbek,illidan,1196,priest,discipline,83,40,43
37140,Healbilli,archimonde,1196,priest,discipline,30,13,17
37141,Adaele,ragnaros,1195,priest,discipline,66,32,34
37142,Metius,smolderthorn,1194,priest,discipline,21,14,7
37143,Fozil,area-52,1194,priest,discipline,62,33,29
37144,Karaasbull,tichondrius,1194,priest,discipline,46,22,24
37145,Sasafras,feathermoon,1193,priest,discipline,87,43,44
37146,Ricksanchez,moonrunner,1193,priest,discipline,30,13,17
37147,Brooklyn,draka,1192,priest,discipline,30,16,14
37148,Bladam,bleeding-hollow,1192,priest,discipline,27,13,14
37149,Babino,illidan,1192,priest,discipline,66,26,40
37150,Kriseria,moon-guard,1191,priest,discipline,24,17,7
37151,Psïren,quelthalas,1191,priest,discipline,107,56,51
37152,Healyoudead,draenor,1191,priest,discipline,41,15,26
37153,Rachia,barthilas,1190,priest,discipline,72,43,29
37154,Evelien,kiljaeden,1190,priest,discipline,66,31,35
37155,Sanitater,frostmourne,1190,priest,discipline,102,47,55
37156,Dzpi,azralon,1190,priest,discipline,96,43,53
37157,Azkillatroll,quelthalas,1190,priest,discipline,48,20,28
37158,Protega,illidan,1189,priest,discipline,22,14,8
37159,Decastro,silvermoon,1189,priest,discipline,23,13,10
37160,Holyycrit,kelthuzad,1189,priest,discipline,30,16,14
37161,Ödin,tichondrius,1189,priest,discipline,60,31,29
37162,Menorsita,tichondrius,1189,priest,discipline,120,57,63
37163,Maiyennefer,proudmoore,1189,priest,discipline,48,20,28
37164,Rinmaru,dark-iron,1188,priest,discipline,24,14,10
37165,Iltharaph,illidan,1188,priest,discipline,25,14,11
37166,Kruciphix,tichondrius,1187,priest,discipline,29,20,9
37167,Kaxleigh,emerald-dream,1187,priest,discipline,29,18,11
37168,Inarius,dragonblight,1187,priest,discipline,55,23,32
37169,Braindrip,thrall,1187,priest,discipline,36,14,22
37170,Sunael,quelthalas,1186,priest,discipline,29,20,9
37171,Yusarin,garona,1186,priest,discipline,30,14,16
37172,Sargasm,darkspear,1185,priest,discipline,21,14,7
37173,Eluv,area-52,1185,priest,discipline,44,25,19
37174,Nadjika,moon-guard,1185,priest,discipline,57,26,31
37175,Valonar,emerald-dream,1185,priest,discipline,47,20,27
37176,Tesserak,tichondrius,1184,priest,discipline,105,49,56
37177,Inferis,ragnaros,1183,priest,discipline,393,195,198
37178,Unwòke,dalaran,1182,priest,discipline,24,14,10
37179,Happydot,stormrage,1182,priest,discipline,30,14,16
37180,Belletrael,wyrmrest-accord,1182,priest,discipline,70,32,38
37181,Kßnstuff,area-52,1182,priest,discipline,37,15,22
37182,Doubtmyfaith,frostmourne,1181,priest,discipline,42,21,21
37183,Artermis,barthilas,1180,priest,discipline,85,37,48
37184,Kiaras,stormrage,1179,priest,discipline,48,25,23
37185,Omgpeeldude,akama,1179,priest,discipline,33,13,20
37186,Gabrieleron,quelthalas,1177,priest,discipline,30,18,12
37187,Runemidgard,illidan,1177,priest,discipline,24,13,11
37188,Aerîs,magtheridon,1177,priest,discipline,40,16,24
37189,Iwillsaveyou,tichondrius,1177,priest,discipline,40,16,24
37190,Damoclexz,area-52,1176,priest,discipline,72,38,34
37191,Feumanchu,area-52,1176,priest,discipline,32,14,18
37192,Goldenfatty,blackrock,1175,priest,discipline,26,13,13
37193,Jagelclam,gorefiend,1175,priest,discipline,47,22,25
37194,Matafuka,ragnaros,1175,priest,discipline,45,20,25
37195,Kethseth,ragnaros,1175,priest,discipline,102,45,57
37196,Onef,quelthalas,1175,priest,discipline,35,15,20
37197,Hiheals,anvilmar,1174,priest,discipline,36,20,16
37198,Mindlames,bleeding-hollow,1173,priest,discipline,68,30,38
37199,Minimelo,stormrage,1172,priest,discipline,23,13,10
37200,Spyzz,gilneas,1172,priest,discipline,36,18,18
37201,Aliciab,andorhal,1172,priest,discipline,78,36,42
37202,Darrong,darkspear,1172,priest,discipline,52,24,28
37203,Aynone,blood-furnace,1171,priest,discipline,149,70,79
37204,Anddori,moknathal,1171,priest,discipline,54,25,29
37205,Forprophet,proudmoore,1171,priest,discipline,34,13,21
37206,Näme,frostmourne,1170,priest,discipline,105,46,59
37207,Kerazul,sargeras,1169,priest,discipline,42,20,22
37208,Kostadinov,tichondrius,1169,priest,discipline,30,13,17
37209,Cathêlay,bleeding-hollow,1168,priest,discipline,118,56,62
37210,Audacy,azuremyst,1167,priest,discipline,51,29,22
37211,Pushap,blood-furnace,1167,priest,discipline,108,58,50
37212,Poilu,laughing-skull,1165,priest,discipline,25,15,10
37213,Junss,tichondrius,1165,priest,discipline,23,13,10
37214,Deadshöt,gorefiend,1163,priest,discipline,20,13,7
37215,Abalowpt,nemesis,1163,priest,discipline,48,22,26
37216,Ghettobarbie,kelthuzad,1162,priest,discipline,24,14,10
37217,Sontïx,sargeras,1162,priest,discipline,31,13,18
37218,Theryan,ragnaros,1161,priest,discipline,72,31,41
37219,Heallarious,stormrage,1160,priest,discipline,52,30,22
37220,Mxrru,stonemaul,1160,priest,discipline,143,68,75
37221,Mäy,greymane,1160,priest,discipline,36,14,22
37222,Eveilar,sargeras,1159,priest,discipline,24,15,9
37223,Semirg,moon-guard,1158,priest,discipline,30,13,17
37224,Velinna,tichondrius,1158,priest,discipline,42,16,26
37225,Toastanator,wyrmrest-accord,1156,priest,discipline,220,115,105
37226,Celf,ragnaros,1156,priest,discipline,36,13,23
37227,Tmpriest,tichondrius,1156,priest,discipline,68,20,48
37228,Xaerwolaeth,area-52,1155,priest,discipline,34,16,18
37229,Maraagsdad,tichondrius,1152,priest,discipline,18,12,6
37230,Bangseight,sargeras,1152,priest,discipline,18,12,6
37231,Souvlaki,amanthul,1152,priest,discipline,24,12,12
37232,Cindyloux,tichondrius,1152,priest,discipline,24,12,12
37233,Teddyy,tichondrius,1152,priest,discipline,24,12,12
37234,Swagdemøn,kelthuzad,1152,priest,discipline,24,12,12
37235,Çherish,stormrage,1152,priest,discipline,24,12,12
37236,Xinnie,illidan,1152,priest,discipline,108,48,60
37237,Ømegagødx,illidan,1152,priest,discipline,30,12,18
37238,Faithbuild,emerald-dream,1151,priest,discipline,18,12,6
37239,Woolly,tichondrius,1151,priest,discipline,18,12,6
37240,Souriel,tichondrius,1151,priest,discipline,96,51,45
37241,Word,korgath,1151,priest,discipline,24,12,12
37242,Marmintor,stormrage,1151,priest,discipline,24,12,12
37243,Pewwpew,malganis,1151,priest,discipline,24,12,12
37244,Sshhaaddooww,tichondrius,1151,priest,discipline,24,12,12
37245,Randrimm,stormrage,1151,priest,discipline,24,12,12
37246,Hyoeun,dragonmaw,1151,priest,discipline,24,12,12
37247,Kiriko,mannoroth,1151,priest,discipline,24,12,12
37248,Vampriest,frostmourne,1151,priest,discipline,31,14,17
37249,Kaztorz,tichondrius,1151,priest,discipline,28,12,16
37250,Graymorick,malganis,1151,priest,discipline,30,12,18
37251,Attenea,illidan,1151,priest,discipline,36,12,24
37252,Ilmx,illidan,1150,priest,discipline,12,12,0
37253,Agrolazor,frostwolf,1150,priest,discipline,12,12,0
37254,Tomp,tichondrius,1150,priest,discipline,18,12,6
37255,Wizeau,dalaran,1150,priest,discipline,18,12,6
37256,Celeztiah,area-52,1150,priest,discipline,18,12,6
37257,Rapturebtw,sargeras,1150,priest,discipline,18,12,6
37258,Aaff,tichondrius,1150,priest,discipline,18,12,6
37259,Chkashaa,emerald-dream,1150,priest,discipline,42,21,21
37260,Rhaist,sargeras,1150,priest,discipline,36,18,18
37261,Ahealer,alterac-mountains,1150,priest,discipline,24,12,12
37262,Icesnowli,tichondrius,1150,priest,discipline,24,12,12
37263,Glöws,area-52,1150,priest,discipline,24,12,12
37264,Longday,kelthuzad,1150,priest,discipline,24,12,12
37265,Cenrtrix,stormrage,1150,priest,discipline,24,12,12
37266,Wartrix,bonechewer,1150,priest,discipline,24,12,12
37267,Abercromby,malganis,1150,priest,discipline,25,12,13
37268,Yoxxoo,tichondrius,1150,priest,discipline,36,17,19
37269,Penancedeez,moon-guard,1150,priest,discipline,35,15,20
37270,Maxximuss,bleeding-hollow,1150,priest,discipline,42,17,25
37271,Profpepper,tichondrius,1149,priest,discipline,18,12,6
37272,Troubler,tichondrius,1149,priest,discipline,18,12,6
37273,Nerfholyplz,illidan,1149,priest,discipline,24,12,12
37274,Shadowchaos,malganis,1149,priest,discipline,24,12,12
37275,Ariste,tichondrius,1149,priest,discipline,24,12,12
37276,Vatikn,stormrage,1149,priest,discipline,24,12,12
37277,Pakc,tichondrius,1149,priest,discipline,24,12,12
37278,Whitenoiz,kiljaeden,1149,priest,discipline,24,12,12
37279,Kitenix,proudmoore,1149,priest,discipline,35,14,21
37280,Jacqueline,tichondrius,1149,priest,discipline,30,12,18
37281,Tslacalls,malganis,1148,priest,discipline,18,12,6
37282,Való,stormrage,1148,priest,discipline,18,12,6
37283,Nelf,warsong,1148,priest,discipline,26,14,12
37284,Dènalí,area-52,1148,priest,discipline,24,12,12
37285,Highelfpally,sargeras,1148,priest,discipline,24,12,12
37286,Littlegiirl,illidan,1148,priest,discipline,24,12,12
37287,Luminatio,quelthalas,1148,priest,discipline,76,36,40
37288,Revolki,azralon,1148,priest,discipline,48,12,36
37289,Zhuyin,illidan,1147,priest,discipline,12,12,0
37290,Rlkeyboard,sargeras,1147,priest,discipline,18,12,6
37291,Tegridyfarm,malganis,1147,priest,discipline,18,12,6
37292,Profetico,ragnaros,1147,priest,discipline,83,43,40
37293,Icykal,tichondrius,1147,priest,discipline,24,12,12
37294,Tranquilty,tichondrius,1147,priest,discipline,24,12,12
37295,Taboogie,tichondrius,1147,priest,discipline,30,12,18
37296,Katjaa,quelthalas,1147,priest,discipline,44,13,31
37297,Scrubgames,garrosh,1146,priest,discipline,12,12,0
37298,Bakerstr,tichondrius,1146,priest,discipline,18,12,6
37299,Níaa,ragnaros,1146,priest,discipline,24,12,12
37300,Smightful,garona,1146,priest,discipline,24,12,12
37301,Derowent,emerald-dream,1146,priest,discipline,30,13,17
37302,Fearthepain,lethon,1146,priest,discipline,30,12,18
37303,Kreon,tichondrius,1145,priest,discipline,18,12,6
37304,Namecusein,ragnaros,1145,priest,discipline,24,12,12
37305,Beansofdean,proudmoore,1145,priest,discipline,24,12,12
37306,Leensay,mannoroth,1145,priest,discipline,24,12,12
37307,Nenedada,tichondrius,1145,priest,discipline,24,12,12
37308,Halidiir,frostmourne,1144,priest,discipline,18,13,5
37309,Hoochiemomma,kelthuzad,1144,priest,discipline,24,13,11
37310,Mashpotato,aerie-peak,1144,priest,discipline,24,13,11
37311,Honeyweiss,cairne,1144,priest,discipline,30,16,14
37312,Voidwyrm,tichondrius,1144,priest,discipline,108,57,51
37313,Dumbboxx,emerald-dream,1144,priest,discipline,24,12,12
37314,Notskynet,tichondrius,1144,priest,discipline,24,12,12
37315,Tmchicken,tichondrius,1144,priest,discipline,24,12,12
37316,Nardhead,sargeras,1143,priest,discipline,42,24,18
37317,Depressedboy,wyrmrest-accord,1143,priest,discipline,24,12,12
37318,Tygrr,kelthuzad,1143,priest,discipline,24,12,12
37319,Qbanota,drakkari,1143,priest,discipline,156,63,93
37320,Inveritu,kiljaeden,1143,priest,discipline,30,12,18
37321,Vyvanse,azuremyst,1143,priest,discipline,99,32,67
37322,Unagidrop,malganis,1142,priest,discipline,22,13,9
37323,Telrane,aggramar,1142,priest,discipline,24,12,12
37324,Raivn,illidan,1142,priest,discipline,24,12,12
37325,Ferilla,illidan,1142,priest,discipline,24,12,12
37326,Múd,mannoroth,1142,priest,discipline,42,12,30
37327,Jivita,lightbringer,1141,priest,discipline,24,14,10
37328,Lumentusk,stormscale,1141,priest,discipline,24,12,12
37329,Vanhealsing,tichondrius,1141,priest,discipline,24,12,12
37330,Fantasyx,ragnaros,1140,priest,discipline,29,16,13
37331,Meddyglyn,area-52,1140,priest,discipline,24,13,11
37332,Stroodle,illidan,1140,priest,discipline,71,34,37
37333,Scalpell,tichondrius,1139,priest,discipline,18,12,6
37334,Núgz,tichondrius,1139,priest,discipline,47,31,16
37335,Tyrea,kiljaeden,1139,priest,discipline,24,12,12
37336,Osombra,azralon,1139,priest,discipline,36,17,19
37337,Amäo,illidan,1139,priest,discipline,29,13,16
37338,Padragon,tichondrius,1139,priest,discipline,30,12,18
37339,Kippin,frostmourne,1138,priest,discipline,18,12,6
37340,Draniev,azralon,1138,priest,discipline,83,44,39
37341,Shooshanaa,stormrage,1138,priest,discipline,24,12,12
37342,Elvspriesly,doomhammer,1138,priest,discipline,104,51,53
37343,Papergaruru,illidan,1138,priest,discipline,102,47,55
37344,Tetha,fizzcrank,1138,priest,discipline,48,22,26
37345,Claireredfld,lightbringer,1137,priest,discipline,18,12,6
37346,Drywàter,tichondrius,1137,priest,discipline,81,45,36
37347,Lynnar,stormrage,1137,priest,discipline,81,44,37
37348,Feelmyheels,frostmourne,1137,priest,discipline,48,24,24
37349,Donoras,ursin,1137,priest,discipline,36,17,19
37350,Barrysanders,zuljin,1136,priest,discipline,72,38,34
37351,Hanuroa,tichondrius,1136,priest,discipline,184,92,92
37352,Brotherheals,nagrand,1136,priest,discipline,66,33,33
37353,Holyhog,whisperwind,1136,priest,discipline,51,23,28
37354,Sprinkling,sargeras,1136,priest,discipline,34,15,19
37355,Sölemn,barthilas,1136,priest,discipline,59,26,33
37356,Gromkor,ragnaros,1135,priest,discipline,18,12,6
37357,Xarid,moon-guard,1135,priest,discipline,18,12,6
37358,Blessings,aerie-peak,1135,priest,discipline,72,37,35
37359,Leuviáh,ragnaros,1135,priest,discipline,24,12,12
37360,Skokie,area-52,1135,priest,discipline,30,12,18
37361,Calliah,moknathal,1134,priest,discipline,35,19,16
37362,Alizeë,illidan,1134,priest,discipline,137,74,63
37363,Senumbra,tichondrius,1134,priest,discipline,24,12,12
37364,Tkawesome,area-52,1134,priest,discipline,42,15,27
37365,Yddwin,quelthalas,1131,priest,discipline,52,27,25
37366,Theleena,malorne,1131,priest,discipline,36,17,19
37367,Ihealyoudeal,korgath,1130,priest,discipline,18,12,6
37368,Skruffles,black-dragonflight,1130,priest,discipline,29,17,12
37369,Looneý,drakkari,1130,priest,discipline,123,69,54
37370,Melithor,frostmourne,1130,priest,discipline,24,12,12
37371,Coachbombae,tichondrius,1129,priest,discipline,18,13,5
37372,Charybdis,bonechewer,1129,priest,discipline,92,56,36
37373,Makkima,area-52,1129,priest,discipline,48,20,28
37374,Corthien,thrall,1129,priest,discipline,30,12,18
37375,Hëstia,darkspear,1128,priest,discipline,30,18,12
37376,Nøfaith,area-52,1128,priest,discipline,24,12,12
37377,Galaxypepe,medivh,1128,priest,discipline,29,12,17
37378,Bornindeath,proudmoore,1128,priest,discipline,30,12,18
37379,Cyrilien,tichondrius,1127,priest,discipline,52,29,23
37380,Ragnarøk,warsong,1127,priest,discipline,30,12,18
37381,Killían,darkspear,1126,priest,discipline,61,31,30
37382,Pahdre,tichondrius,1125,priest,discipline,18,12,6
37383,Skeepsi,area-52,1125,priest,discipline,60,34,26
37384,Sänctus,emerald-dream,1125,priest,discipline,24,12,12
37385,Zolibeth,azshara,1124,priest,discipline,24,15,9
37386,Haidees,akama,1124,priest,discipline,46,28,18
37387,Thrudarkness,thrall,1124,priest,discipline,25,15,10
37388,Xuun,illidan,1124,priest,discipline,81,44,37
37389,Velriana,tichondrius,1124,priest,discipline,30,12,18
37390,Mucgib,frostmourne,1124,priest,discipline,74,27,47
37391,Jahsheer,kiljaeden,1123,priest,discipline,20,14,6
37392,Weregonnadie,stormrage,1123,priest,discipline,30,12,18
37393,Ðåmìéñ,tichondrius,1122,priest,discipline,24,12,12
37394,Imbot,ragnaros,1122,priest,discipline,24,12,12
37395,Exsufficate,frostmourne,1122,priest,discipline,34,15,19
37396,Islandpink,malganis,1122,priest,discipline,42,12,30
37397,Londog,vashj,1121,priest,discipline,78,36,42
37398,Primeevil,black-dragonflight,1119,priest,discipline,24,14,10
37399,Deehilie,illidan,1119,priest,discipline,49,25,24
37400,Kerith,ragnaros,1118,priest,discipline,46,34,12
37401,Youngboys,stormreaver,1118,priest,discipline,57,28,29
37402,Puralux,balnazzar,1117,priest,discipline,42,25,17
37403,Cyberpriest,stormrage,1117,priest,discipline,66,27,39
37404,Abbot,zangarmarsh,1115,priest,discipline,155,73,82
37405,Alimony,chogall,1114,priest,discipline,23,12,11
37406,Zinr,tichondrius,1114,priest,discipline,370,175,195
37407,Eirana,skywall,1114,priest,discipline,78,36,42
37408,Blackbubba,tichondrius,1114,priest,discipline,66,29,37
37409,Vitalizes,nagrand,1114,priest,discipline,30,13,17
37410,Kelelin,frostwolf,1114,priest,discipline,30,12,18
37411,Deadäss,sargeras,1113,priest,discipline,54,14,40
37412,Steezyy,black-dragonflight,1112,priest,discipline,71,33,38
37413,Yamahaz,lethon,1112,priest,discipline,30,13,17
37414,Foxyy,wildhammer,1112,priest,discipline,35,14,21
37415,Fushia,emerald-dream,1107,priest,discipline,45,16,29
37416,Enkognito,tichondrius,1106,priest,discipline,52,33,19
37417,Pûrplehaze,aegwynn,1106,priest,discipline,23,12,11
37418,Mchinder,tanaris,1106,priest,discipline,94,48,46
37419,Optîmuskrayt,tichondrius,1106,priest,discipline,83,40,43
37420,Tootsieroll,dark-iron,1106,priest,discipline,53,25,28
37421,Raihn,garrosh,1106,priest,discipline,37,14,23
37422,Kithlas,emerald-dream,1105,priest,discipline,32,17,15
37423,Cuckfist,darkspear,1105,priest,discipline,71,30,41
37424,Opri,andorhal,1104,priest,discipline,48,20,28
37425,Mosher,zuluhed,1103,priest,discipline,18,12,6
37426,Ataraksija,sargeras,1103,priest,discipline,21,13,8
37427,Averli,moon-guard,1103,priest,discipline,42,18,24
37428,Khallmir,goldrinn,1100,priest,discipline,120,56,64
37429,Mindkilla,area-52,1099,priest,discipline,214,109,105
37430,Jtewatch,zuljin,1098,priest,discipline,60,35,25
37431,Goodbyekiss,illidan,1098,priest,discipline,107,51,56
37432,Jaster,proudmoore,1097,priest,discipline,48,31,17
37433,Vákc,quelthalas,1096,priest,discipline,23,12,11
37434,Anäster,ragnaros,1096,priest,discipline,59,30,29
37435,Darkxrp,bleeding-hollow,1096,priest,discipline,30,13,17
37436,Draiger,quelthalas,1096,priest,discipline,36,14,22
37437,Fistavert,stormreaver,1095,priest,discipline,24,12,12
37438,Preezoo,tichondrius,1095,priest,discipline,64,25,39
37439,Tuoday,agamaggan,1094,priest,discipline,21,12,9
37440,Shadowpáin,ragnaros,1094,priest,discipline,24,12,12
37441,Zhaann,kelthuzad,1094,priest,discipline,48,23,25
37442,Happyholy,tichondrius,1094,priest,discipline,36,14,22
37443,Sístermary,stormrage,1093,priest,discipline,30,18,12
37444,Iseeyoulookn,stormrage,1093,priest,discipline,29,14,15
37445,Mcdizzle,bloodscalp,1093,priest,discipline,90,41,49
37446,Nuvea,tichondrius,1093,priest,discipline,27,12,15
37447,Annaphilaxis,sargeras,1091,priest,discipline,44,22,22
37448,Ketone,malganis,1090,priest,discipline,125,65,60
37449,Zacksnotcool,sargeras,1090,priest,discipline,33,13,20
37450,Saren,dethecus,1089,priest,discipline,15,13,2
37451,Priestøuchme,tichondrius,1089,priest,discipline,29,13,16
37452,Thinmintt,wyrmrest-accord,1089,priest,discipline,108,47,61
37453,Papipreach,sargeras,1088,priest,discipline,24,15,9
37454,Bigdaddyku,hyjal,1088,priest,discipline,34,20,14
37455,Mylkshakez,emerald-dream,1088,priest,discipline,31,13,18
37456,Bombmarley,azralon,1088,priest,discipline,30,12,18
37457,Salovoth,area-52,1088,priest,discipline,48,17,31
37458,Fhelurian,quelthalas,1088,priest,discipline,36,12,24
37459,Holysmokesx,tichondrius,1087,priest,discipline,22,12,10
37460,Antiraus,aerie-peak,1086,priest,discipline,24,13,11
37461,Fatherfilth,frostwolf,1086,priest,discipline,30,14,16
37462,Slaac,malfurion,1085,priest,discipline,23,12,11
37463,Quavö,tichondrius,1085,priest,discipline,68,29,39
37464,Elbowbeans,tichondrius,1085,priest,discipline,34,12,22
37465,Kidha,stormrage,1085,priest,discipline,60,19,41
37466,Ariyaned,quelthalas,1084,priest,discipline,18,12,6
37467,Todrecas,ragnaros,1084,priest,discipline,24,13,11
37468,Painpaws,moon-guard,1084,priest,discipline,28,12,16
37469,Nécrofear,drakkari,1083,priest,discipline,20,13,7
37470,Vaddaru,kirin-tor,1083,priest,discipline,66,38,28
37471,Tigrania,proudmoore,1083,priest,discipline,23,12,11
37472,Scirzzy,tichondrius,1083,priest,discipline,29,14,15
37473,Chroly,stormrage,1083,priest,discipline,65,29,36
37474,Watdahealydo,darkspear,1081,priest,discipline,24,13,11
37475,Nostrande,stormrage,1080,priest,discipline,21,12,9
37476,Synes,bleeding-hollow,1080,priest,discipline,34,12,22
37477,Benmem,illidan,1078,priest,discipline,141,68,73
37478,Fregè,ysera,1078,priest,discipline,30,12,18
37479,Mortecraft,sargeras,1076,priest,discipline,30,17,13
37480,Sheriff,lightbringer,1076,priest,discipline,153,80,73
37481,Justinagnpr,tichondrius,1072,priest,discipline,30,14,16
37482,Nervinia,tichondrius,1072,priest,discipline,30,12,18
37483,Redchord,kiljaeden,1072,priest,discipline,33,13,20
37484,Drtesak,illidan,1070,priest,discipline,17,12,5
37485,Chinsta,tichondrius,1069,priest,discipline,38,15,23
37486,Berzap,frostmourne,1068,priest,discipline,30,18,12
37487,Kloudypriest,moon-guard,1065,priest,discipline,53,26,27
37488,Twinkmuncher,proudmoore,1065,priest,discipline,25,12,13
37489,Newheal,quelthalas,1064,priest,discipline,30,16,14
37490,Trustheals,tichondrius,1064,priest,discipline,134,71,63
37491,Lytherina,aegwynn,1064,priest,discipline,36,19,17
37492,Vahlen,azralon,1062,priest,discipline,23,12,11
37493,Fulldesire,dalaran,1061,priest,discipline,69,39,30
37494,Xojelas,quelthalas,1060,priest,discipline,24,13,11
37495,Pochis,bleeding-hollow,1060,priest,discipline,87,42,45
37496,Chickadies,barthilas,1059,priest,discipline,18,12,6
37497,Linarelitha,area-52,1059,priest,discipline,80,39,41
37498,Rileau,tichondrius,1059,priest,discipline,30,12,18
37499,Kikyo,antonidas,1059,priest,discipline,31,12,19
37500,Sivamint,aerie-peak,1058,priest,discipline,42,16,26
37501,Littlehcl,tichondrius,1056,priest,discipline,18,11,7
37502,Roentgen,sargeras,1056,priest,discipline,18,11,7
37503,Lespaula,ragnaros,1056,priest,discipline,24,12,12
37504,Smiliebomb,tichondrius,1056,priest,discipline,24,11,13
37505,Dirtyone,dark-iron,1056,priest,discipline,30,12,18
37506,Lilbabynaga,stormrage,1056,priest,discipline,75,27,48
37507,Crucifer,proudmoore,1055,priest,discipline,12,11,1
37508,Ròen,tichondrius,1055,priest,discipline,18,11,7
37509,Neonpriest,tichondrius,1055,priest,discipline,18,11,7
37510,Piftw,illidan,1055,priest,discipline,18,11,7
37511,Elfgasmic,blackwater-raiders,1055,priest,discipline,18,11,7
37512,Chawp,kelthuzad,1055,priest,discipline,18,11,7
37513,Jonesy,tichondrius,1055,priest,discipline,24,11,13
37514,Arcosis,turalyon,1055,priest,discipline,24,11,13
37515,Cency,tichondrius,1055,priest,discipline,24,11,13
37516,Jangma,tichondrius,1055,priest,discipline,24,11,13
37517,Halcyonzx,tichondrius,1055,priest,discipline,24,11,13
37518,Ffej,bleeding-hollow,1055,priest,discipline,24,11,13
37519,Tooziq,stormrage,1055,priest,discipline,24,11,13
37520,Pro,proudmoore,1055,priest,discipline,24,11,13
37521,Victordaddy,illidan,1055,priest,discipline,24,11,13
37522,Carboload,thrall,1055,priest,discipline,24,11,13
37523,Wintrow,sargeras,1055,priest,discipline,30,11,19
37524,Voidgames,area-52,1055,priest,discipline,30,11,19
37525,Lampvpgerl,illidan,1055,priest,discipline,36,11,25
37526,Aiss,malganis,1054,priest,discipline,16,12,4
37527,Anneyann,fenris,1054,priest,discipline,30,19,11
37528,Missyoung,tichondrius,1054,priest,discipline,18,11,7
37529,Náñí,area-52,1054,priest,discipline,18,11,7
37530,Chastised,moon-guard,1054,priest,discipline,674,330,344
37531,Aguavenditaa,quelthalas,1054,priest,discipline,24,11,13
37532,Dpsmercy,sargeras,1054,priest,discipline,24,11,13
37533,Aikinorz,tichondrius,1054,priest,discipline,24,11,13
37534,Gumiho,drakkari,1054,priest,discipline,87,39,48
37535,Syndrox,kelthuzad,1053,priest,discipline,12,11,1
37536,Doubt,eredar,1053,priest,discipline,18,11,7
37537,Wale,akama,1053,priest,discipline,18,11,7
37538,Whitepigogo,tichondrius,1053,priest,discipline,18,11,7
37539,Kajhy,ragnaros,1053,priest,discipline,48,22,26
37540,Orisons,bleeding-hollow,1053,priest,discipline,24,11,13
37541,Polteageist,frostmourne,1053,priest,discipline,24,11,13
37542,Ayezex,tichondrius,1053,priest,discipline,48,21,27
37543,Màva,zuljin,1053,priest,discipline,30,11,19
37544,Rezy,darkspear,1053,priest,discipline,30,11,19
37545,Wâtermelon,stormrage,1052,priest,discipline,18,11,7
37546,Slavoj,gurubashi,1052,priest,discipline,41,19,22
37547,Kovie,twisting-nether,1052,priest,discipline,24,11,13
37548,Docpriestelf,kelthuzad,1052,priest,discipline,24,11,13
37549,Buffhpriest,tichondrius,1052,priest,discipline,24,11,13
37550,Chiri,tichondrius,1051,priest,discipline,18,11,7
37551,Oncemore,khazgoroth,1051,priest,discipline,18,11,7
37552,Holyshart,stonemaul,1051,priest,discipline,23,12,11
37553,Darkills,tichondrius,1051,priest,discipline,24,11,13
37554,Noxientp,bleeding-hollow,1051,priest,discipline,24,11,13
37555,Jayqwellen,bleeding-hollow,1051,priest,discipline,30,11,19
37556,Xanderp,thrall,1051,priest,discipline,30,11,19
37557,Saviorr,dalaran,1051,priest,discipline,30,11,19
37558,Moopha,zuljin,1050,priest,discipline,12,11,1
37559,Zarfel,ragnaros,1050,priest,discipline,18,11,7
37560,Healdog,thrall,1050,priest,discipline,18,11,7
37561,Neuro,barthilas,1050,priest,discipline,18,11,7
37562,Ajazz,zuljin,1050,priest,discipline,24,11,13
37563,Shiikari,terenas,1050,priest,discipline,24,11,13
37564,Darkmoonsun,frostmourne,1050,priest,discipline,24,11,13
37565,Thotsteal,lightbringer,1050,priest,discipline,24,11,13
37566,Lalight,tichondrius,1050,priest,discipline,30,11,19
37567,Sofunchode,illidan,1049,priest,discipline,30,11,19
37568,Inmortar,dalaran,1049,priest,discipline,30,11,19
37569,Exanthrope,stormrage,1048,priest,discipline,18,11,7
37570,Sajahsa,moon-guard,1048,priest,discipline,25,15,10
37571,Elexianpi,stormrage,1048,priest,discipline,30,11,19
37572,Jackflashh,hakkar,1047,priest,discipline,78,35,43
37573,Sinwifi,ragnaros,1047,priest,discipline,64,27,37
37574,Skinnyfat,azralon,1046,priest,discipline,18,11,7
37575,Classifiedcc,illidan,1046,priest,discipline,264,132,132
37576,Feff,shuhalo,1046,priest,discipline,30,11,19
37577,Oniizanagi,thrall,1046,priest,discipline,30,11,19
37578,Nippols,skullcrusher,1045,priest,discipline,18,11,7
37579,Hangingmeat,jubeithos,1045,priest,discipline,24,11,13
37580,Everluna,stormrage,1043,priest,discipline,12,11,1
37581,Rhapsodias,area-52,1043,priest,discipline,18,11,7
37582,Ahualol,tichondrius,1043,priest,discipline,18,11,7
37583,Lilbabe,stormrage,1043,priest,discipline,24,11,13
37584,Panelopie,maiev,1042,priest,discipline,18,11,7
37585,Sendia,hydraxis,1038,priest,discipline,66,31,35
37586,Merlynaah,azralon,1038,priest,discipline,36,11,25
37587,Lovetotouch,malganis,1037,priest,discipline,24,11,13
37588,Kuppel,tichondrius,1037,priest,discipline,30,11,19
37589,Kiilltic,sargeras,1037,priest,discipline,36,13,23
37590,Deusthanatos,medivh,1036,priest,discipline,70,36,34
37591,Lzzp,azralon,1036,priest,discipline,24,11,13
37592,Gongá,moon-guard,1035,priest,discipline,108,43,65
37593,Prignues,tichondrius,1033,priest,discipline,18,11,7
37594,Uchihalol,tichondrius,1032,priest,discipline,24,11,13
37595,Prawda,area-52,1031,priest,discipline,30,11,19
37596,Geulis,illidan,1030,priest,discipline,65,30,35
37597,Bubbleyo,shandris,1029,priest,discipline,18,11,7
37598,Erelim,durotan,1029,priest,discipline,89,36,53
37599,Yosicuro,ragnaros,1028,priest,discipline,24,13,11
37600,Crossbones,cenarion-circle,1027,priest,discipline,80,43,37
37601,Egraner,drakkari,1027,priest,discipline,24,11,13
37602,Priestvamp,azralon,1027,priest,discipline,36,13,23
37603,Throwinshadê,stormrage,1026,priest,discipline,219,116,103
37604,Cynthir,stormrage,1026,priest,discipline,24,11,13
37605,Efrem,tichondrius,1025,priest,discipline,69,32,37
37606,Chêrubim,arthas,1025,priest,discipline,24,11,13
37607,Clergy,arthas,1024,priest,discipline,21,14,7
37608,Elomszz,tichondrius,1024,priest,discipline,22,11,11
37609,Naxiest,stormrage,1024,priest,discipline,29,11,18
37610,Bakharftw,nemesis,1023,priest,discipline,28,17,11
37611,Harlei,tichondrius,1023,priest,discipline,24,14,10
37612,Mxd,bleeding-hollow,1021,priest,discipline,20,12,8
37613,Treenewbeems,tichondrius,1020,priest,discipline,49,25,24
37614,Mgfoxxie,scarlet-crusade,1020,priest,discipline,30,12,18
37615,Kenray,sargeras,1020,priest,discipline,48,18,30
37616,Deemmortii,stormrage,1020,priest,discipline,40,11,29
37617,Thadan,uldaman,1019,priest,discipline,24,11,13
37618,Sév,frostmane,1017,priest,discipline,190,89,101
37619,Rahna,azralon,1017,priest,discipline,30,11,19
37620,Steck,illidan,1016,priest,discipline,64,27,37
37621,Nightmxres,zuljin,1016,priest,discipline,30,11,19
37622,Jèf,stormrage,1015,priest,discipline,23,11,12
37623,Shaydeep,nagrand,1015,priest,discipline,28,12,16
37624,Profît,stormrage,1014,priest,discipline,24,12,12
37625,Hathamet,thrall,1013,priest,discipline,60,25,35
37626,Rigityrekt,aggramar,1012,priest,discipline,30,22,8
37627,Zatroux,ragnaros,1011,priest,discipline,74,34,40
37628,Drãith,magtheridon,1009,priest,discipline,24,12,12
37629,Uljinoo,blackwing-lair,1009,priest,discipline,92,41,51
37630,Azrïel,mannoroth,1007,priest,discipline,48,28,20
37631,Buschlatte,frostmane,1007,priest,discipline,23,11,12
37632,Dynopriest,kelthuzad,1007,priest,discipline,29,11,18
37633,Lesserfaith,sargeras,1006,priest,discipline,21,11,10
37634,Ehmacros,kelthuzad,1005,priest,discipline,35,11,24
37635,Noriniani,sargeras,1004,priest,discipline,18,13,5
37636,Bubblebuster,lightbringer,1004,priest,discipline,55,24,31
37637,Ioudas,ragnaros,1004,priest,discipline,35,11,24
37638,Vidzz,silvermoon,1003,priest,discipline,23,11,12
37639,Zeun,spinebreaker,1003,priest,discipline,40,14,26
37640,Lördgrim,stormrage,1002,priest,discipline,25,13,12
37641,Tikel,ragnaros,1001,priest,discipline,21,11,10
37642,Stinkyfingr,frostmourne,1000,priest,discipline,42,15,27
37643,Sharayu,madoran,999,priest,discipline,42,22,20
37644,Arianthe,darrowmere,998,priest,discipline,26,12,14
37645,Whitewidowx,eredar,997,priest,discipline,21,12,9
37646,Bårriër,darkspear,996,priest,discipline,23,12,11
37647,Futatsi,zuljin,996,priest,discipline,29,11,18
37648,Rbmxp,barthilas,994,priest,discipline,21,12,9
37649,Mottsarella,mugthol,994,priest,discipline,78,42,36
37650,Mikkik,zuljin,992,priest,discipline,42,26,16
37651,Robertsmurda,emerald-dream,992,priest,discipline,22,11,11
37652,Norastanne,moon-guard,992,priest,discipline,27,12,15
37653,Sharkda,frostmourne,989,priest,discipline,57,31,26
37654,Lilflexi,lightbringer,988,priest,discipline,22,11,11
37655,Taiji,whisperwind,987,priest,discipline,17,11,6
37656,Laeral,quelthalas,987,priest,discipline,35,14,21
37657,Carbonated,zuljin,986,priest,discipline,17,11,6
37658,Antonella,malganis,985,priest,discipline,33,12,21
37659,Mando,area-52,981,priest,discipline,146,78,68
37660,Diamontie,tichondrius,977,priest,discipline,26,16,10
37661,Alurand,bleeding-hollow,976,priest,discipline,18,11,7
37662,Ðrip,burning-legion,976,priest,discipline,22,11,11
37663,Kahari,perenolde,976,priest,discipline,22,11,11
37664,Hèáls,tichondrius,975,priest,discipline,66,29,37
37665,Covfefe,draka,972,priest,discipline,84,30,54
37666,Mëïsoön,quelthalas,969,priest,discipline,17,11,6
37667,Jebadiia,tichondrius,969,priest,discipline,75,34,41
37668,Leoi,fenris,968,priest,discipline,63,31,32
37669,Moomagic,sargeras,968,priest,discipline,59,28,31
37670,Cravex,stormrage,963,priest,discipline,36,18,18
37671,Åphrødite,bonechewer,961,priest,discipline,22,12,10
37672,Åz,quelthalas,961,priest,discipline,24,12,12
37673,Cezanne,tichondrius,961,priest,discipline,125,52,73
37674,Mxchsm,stormrage,960,priest,discipline,12,10,2
37675,Charón,tichondrius,960,priest,discipline,12,10,2
37676,Tapel,khazgoroth,960,priest,discipline,48,27,21
37677,Renghost,illidan,960,priest,discipline,18,10,8
37678,Ishyeboi,stormrage,960,priest,discipline,18,10,8
37679,Priesticules,illidan,960,priest,discipline,18,10,8
37680,Bswagxx,illidan,960,priest,discipline,18,10,8
37681,Tickleme,zuljin,960,priest,discipline,18,10,8
37682,Pissgóblin,stormrage,960,priest,discipline,18,10,8
37683,Belielosong,moon-guard,960,priest,discipline,57,29,28
37684,Fyne,kelthuzad,960,priest,discipline,21,10,11
37685,Notlowboy,area-52,960,priest,discipline,24,10,14
37686,Ajxoz,thrall,960,priest,discipline,24,10,14
37687,Nobodystarx,steamwheedle-cartel,960,priest,discipline,24,10,14
37688,Lilpurp,sargeras,960,priest,discipline,28,10,18
37689,Futuuncle,tichondrius,960,priest,discipline,30,10,20
37690,Luzhú,illidan,960,priest,discipline,30,10,20
37691,Henchwoman,stormrage,959,priest,discipline,12,10,2
37692,Strawberryzz,area-52,959,priest,discipline,12,10,2
37693,Trailmixx,bleeding-hollow,959,priest,discipline,12,10,2
37694,Kk,fizzcrank,959,priest,discipline,12,10,2
37695,Elimix,frostmourne,959,priest,discipline,12,10,2
37696,Jinforever,tichondrius,959,priest,discipline,12,10,2
37697,Oduum,tichondrius,959,priest,discipline,18,10,8
37698,Dudurr,zuluhed,959,priest,discipline,18,10,8
37699,Minnowhead,kelthuzad,959,priest,discipline,18,10,8
37700,Filthmaster,moon-guard,959,priest,discipline,18,10,8
37701,Olibreaker,tichondrius,959,priest,discipline,18,10,8
37702,Dubai,tichondrius,959,priest,discipline,18,10,8
37703,Bicardii,area-52,959,priest,discipline,18,10,8
37704,Slenden,illidan,959,priest,discipline,18,10,8
37705,Elphié,sargeras,959,priest,discipline,18,10,8
37706,Hundski,darkspear,959,priest,discipline,18,10,8
37707,Cigma,magtheridon,959,priest,discipline,18,10,8
37708,Floppeh,khazgoroth,959,priest,discipline,18,10,8
37709,Tamzy,eredar,959,priest,discipline,18,10,8
37710,Groove,kelthuzad,959,priest,discipline,18,10,8
37711,Recoverys,illidan,959,priest,discipline,18,10,8
37712,Budlyy,dalaran,959,priest,discipline,18,10,8
37713,Kelaara,gnomeregan,959,priest,discipline,19,10,9
37714,Stylébender,tichondrius,959,priest,discipline,24,10,14
37715,Tamtwo,the-forgotten-coast,959,priest,discipline,24,10,14
37716,Lindsanp,illidan,959,priest,discipline,24,10,14
37717,Calahra,malganis,959,priest,discipline,24,10,14
37718,Pontiffvelen,area-52,959,priest,discipline,24,10,14
37719,Abbyy,barthilas,959,priest,discipline,24,10,14
37720,Rum,kirin-tor,959,priest,discipline,24,10,14
37721,Mosquito,tichondrius,959,priest,discipline,24,10,14
37722,Döyöuliftbro,tichondrius,959,priest,discipline,24,10,14
37723,Johadorr,shadowsong,959,priest,discipline,24,10,14
37724,Tshik,ragnaros,959,priest,discipline,24,10,14
37725,Livin,kelthuzad,959,priest,discipline,30,10,20
37726,Azide,mannoroth,958,priest,discipline,12,10,2
37727,Janna,jubeithos,958,priest,discipline,18,10,8
37728,Chknhealer,darkspear,958,priest,discipline,18,10,8
37729,Phrìke,illidan,958,priest,discipline,18,10,8
37730,Amonerpriest,tichondrius,958,priest,discipline,18,10,8
37731,Tîg,nemesis,958,priest,discipline,21,10,11
37732,Câstiêl,malganis,958,priest,discipline,24,10,14
37733,Itha,illidan,958,priest,discipline,24,10,14
37734,Ritzien,jubeithos,958,priest,discipline,24,10,14
37735,Taedrid,stormrage,958,priest,discipline,89,35,54
37736,Gonchar,bleeding-hollow,958,priest,discipline,30,10,20
37737,Powerranger,senjin,957,priest,discipline,18,10,8
37738,Bigchalupaz,sargeras,957,priest,discipline,18,10,8
37739,Bubblebeasst,area-52,957,priest,discipline,18,10,8
37740,Wilburre,sargeras,957,priest,discipline,18,10,8
37741,Rescueherø,tichondrius,957,priest,discipline,38,20,18
37742,Jazmiine,ragnaros,957,priest,discipline,24,10,14
37743,Kinhilo,ragnaros,957,priest,discipline,24,10,14
37744,Rellington,frostwolf,957,priest,discipline,24,10,14
37745,Moc,jubeithos,957,priest,discipline,36,10,26
37746,Xøspëélls,ragnaros,956,priest,discipline,12,10,2
37747,Chanyt,azralon,956,priest,discipline,12,10,2
37748,Prilance,hyjal,956,priest,discipline,24,10,14
37749,Mottomami,nemesis,956,priest,discipline,24,10,14
37750,Mevix,firetree,956,priest,discipline,24,10,14
37751,Kissmyvoìd,frostmourne,956,priest,discipline,24,10,14
37752,Smallbrains,emerald-dream,956,priest,discipline,30,10,20
37753,Noopnoop,burning-blade,955,priest,discipline,18,10,8
37754,Dorlala,tichondrius,955,priest,discipline,18,10,8
37755,Synthas,tichondrius,955,priest,discipline,18,10,8
37756,Çõrlëøñè,illidan,955,priest,discipline,24,10,14
37757,Bachaterah,skullcrusher,955,priest,discipline,24,10,14
37758,Glassbones,kelthuzad,955,priest,discipline,30,10,20
37759,Felmnir,ragnaros,955,priest,discipline,30,10,20
37760,Fidalus,stormrage,955,priest,discipline,38,10,28
37761,Hanklin,lightnings-blade,954,priest,discipline,18,10,8
37762,Ihelp,altar-of-storms,954,priest,discipline,18,10,8
37763,Liloffended,sargeras,954,priest,discipline,18,10,8
37764,Febronia,aerie-peak,954,priest,discipline,18,10,8
37765,Hateznamez,bladefist,954,priest,discipline,18,10,8
37766,Xyberius,barthilas,954,priest,discipline,24,10,14
37767,Judgejudyx,tichondrius,954,priest,discipline,24,10,14
37768,Acésnóf,stormrage,954,priest,discipline,24,10,14
37769,Discjuice,tichondrius,954,priest,discipline,36,10,26
37770,Kajagoogoö,emerald-dream,953,priest,discipline,18,10,8
37771,Kirigäya,quelthalas,953,priest,discipline,18,10,8
37772,Lusch,stormscale,953,priest,discipline,70,37,33
37773,Ôvr,area-52,953,priest,discipline,26,11,15
37774,Flagged,azgalor,953,priest,discipline,24,10,14
37775,Xenonfaith,bleeding-hollow,952,priest,discipline,17,12,5
37776,Anonymoûs,silver-hand,952,priest,discipline,24,14,10
37777,Jessicä,malganis,952,priest,discipline,18,10,8
37778,Actiop,stormrage,952,priest,discipline,18,10,8
37779,Stennic,emerald-dream,952,priest,discipline,18,10,8
37780,Vazara,tichondrius,952,priest,discipline,18,10,8
37781,Unholyio,barthilas,952,priest,discipline,18,10,8
37782,Worthy,runetotem,952,priest,discipline,18,10,8
37783,Xiöm,quelthalas,952,priest,discipline,24,10,14
37784,Daijoubu,lightnings-blade,951,priest,discipline,24,10,14
37785,Possumvendor,dalaran,951,priest,discipline,30,10,20
37786,Ppinmuhbutt,tichondrius,951,priest,discipline,36,10,26
37787,Discbubbles,moonrunner,950,priest,discipline,18,10,8
37788,Artmend,malganis,950,priest,discipline,24,10,14
37789,Zeas,moon-guard,950,priest,discipline,66,23,43
37790,Threlad,elune,949,priest,discipline,18,10,8
37791,Zhadowbolts,thrall,949,priest,discipline,18,10,8
37792,Dreamskull,aegwynn,949,priest,discipline,26,11,15
37793,Dwennalous,stormrage,949,priest,discipline,24,10,14
37794,Novoc,blackhand,949,priest,discipline,54,22,32
37795,Hypnogypsy,malganis,948,priest,discipline,18,10,8
37796,Lasslìn,bonechewer,948,priest,discipline,18,10,8
37797,Filterz,korgath,948,priest,discipline,24,10,14
37798,Prófessór,tichondrius,948,priest,discipline,24,10,14
37799,Samsunglions,tichondrius,947,priest,discipline,18,10,8
37800,Braxxten,tichondrius,944,priest,discipline,50,21,29
37801,Tjxx,zuljin,944,priest,discipline,30,10,20
37802,Nikkazul,drakkari,943,priest,discipline,30,14,16
37803,Emmarîl,sargeras,943,priest,discipline,29,10,19
37804,Butdidüdie,tichondrius,943,priest,discipline,30,10,20
37805,Praiz,tichondrius,942,priest,discipline,24,15,9
37806,Kaladaz,destromath,941,priest,discipline,18,10,8
37807,Prlest,proudmoore,941,priest,discipline,60,26,34
37808,Lookfig,frostmourne,941,priest,discipline,24,10,14
37809,Discyple,ysera,941,priest,discipline,24,10,14
37810,Icemeilarda,illidan,940,priest,discipline,81,32,49
37811,Sinnz,emerald-dream,939,priest,discipline,30,11,19
37812,Sisterdeáth,area-52,938,priest,discipline,24,11,13
37813,Neehow,hyjal,936,priest,discipline,12,10,2
37814,Boosserbro,dawnbringer,936,priest,discipline,42,21,21
37815,Macoa,zuljin,936,priest,discipline,66,29,37
37816,Ophiuchus,jubeithos,936,priest,discipline,32,12,20
37817,Holywarrior,smolderthorn,935,priest,discipline,24,10,14
37818,Miel,kargath,935,priest,discipline,60,22,38
37819,Mcmorphy,stormrage,931,priest,discipline,53,23,30
37820,Alexz,area-52,927,priest,discipline,14,11,3
37821,Biggunsaint,icecrown,927,priest,discipline,20,11,9
37822,Toastedheal,stormreaver,927,priest,discipline,20,11,9
37823,Sublety,aerie-peak,927,priest,discipline,66,28,38
37824,Avipriest,area-52,927,priest,discipline,29,10,19
37825,Heladio,ragnaros,926,priest,discipline,20,11,9
37826,Fenders,stormrage,926,priest,discipline,23,10,13
37827,Gankchange,tichondrius,926,priest,discipline,26,11,15
37828,Touchmylight,suramar,925,priest,discipline,53,27,26
37829,Voidwulf,azgalor,924,priest,discipline,107,52,55
37830,Kaladîn,dark-iron,921,priest,discipline,20,11,9
37831,Shemhazai,ragnaros,921,priest,discipline,20,11,9
37832,Rymzxx,ragnaros,918,priest,discipline,19,11,8
37833,Thekingheals,draenor,918,priest,discipline,28,14,14
37834,Jeanmarc,aerie-peak,918,priest,discipline,78,32,46
37835,Xiaz,lightbringer,912,priest,discipline,18,12,6
37836,Twistedead,illidan,911,priest,discipline,21,11,10
37837,Katalla,spirestone,911,priest,discipline,27,10,17
37838,Mègadèath,area-52,911,priest,discipline,35,10,25
37839,Priestrix,frostmourne,910,priest,discipline,55,22,33
37840,Kencys,tichondrius,906,priest,discipline,22,11,11
37841,Shadowdeathx,bleeding-hollow,906,priest,discipline,23,10,13
37842,Brock,lightbringer,905,priest,discipline,27,11,16
37843,Ðanté,the-venture-co,904,priest,discipline,22,13,9
37844,Corrûpt,stormrage,904,priest,discipline,20,11,9
37845,Ohashi,ragnaros,902,priest,discipline,18,11,7
37846,Unholydomina,zuljin,901,priest,discipline,78,36,42
37847,Mvqjlm,tichondrius,895,priest,discipline,14,10,4
37848,Plaedito,stormscale,895,priest,discipline,23,10,13
37849,Bellack,emerald-dream,895,priest,discipline,73,31,42
37850,Càipirinha,tichondrius,895,priest,discipline,28,10,18
37851,Fujinpriest,azralon,894,priest,discipline,28,10,18
37852,Shayylii,stormrage,894,priest,discipline,32,10,22
37853,Aladdinlol,tichondrius,894,priest,discipline,34,10,24
37854,Chapitä,drakkari,893,priest,discipline,16,10,6
37855,Malhotra,amanthul,892,priest,discipline,21,12,9
37856,Kaizzen,gorgonnash,891,priest,discipline,17,10,7
37857,Tezcatyo,area-52,891,priest,discipline,17,10,7
37858,Archcerion,stormreaver,891,priest,discipline,28,11,17
37859,Frojasensei,tichondrius,879,priest,discipline,17,10,7
37860,Partypack,stormrage,878,priest,discipline,19,11,8
37861,Mixxd,shuhalo,877,priest,discipline,30,13,17
37862,Terric,shattered-hand,867,priest,discipline,24,10,14
37863,Dirtydickdan,sargeras,864,priest,discipline,12,9,3
37864,Squiddyjr,tichondrius,864,priest,discipline,12,9,3
37865,Photic,malganis,864,priest,discipline,12,9,3
37866,Gillette,thunderlord,864,priest,discipline,12,9,3
37867,Dinar,tichondrius,864,priest,discipline,12,9,3
37868,Elise,ravenholdt,864,priest,discipline,12,9,3
37869,Trinaty,senjin,864,priest,discipline,12,9,3
37870,Marcalus,garrosh,864,priest,discipline,15,9,6
37871,Omgnerfz,zuljin,864,priest,discipline,18,9,9
37872,Drbønghitmd,tichondrius,864,priest,discipline,18,9,9
37873,Shadooe,tichondrius,864,priest,discipline,18,9,9
37874,Phurbosjr,sargeras,864,priest,discipline,18,9,9
37875,Shoepooper,kelthuzad,864,priest,discipline,18,9,9
37876,Challengerz,suramar,864,priest,discipline,18,9,9
37877,Illstyles,tichondrius,864,priest,discipline,18,9,9
37878,Norikoo,malganis,864,priest,discipline,18,9,9
37879,Nißirøux,sargeras,864,priest,discipline,18,9,9
37880,Wv,kelthuzad,864,priest,discipline,18,9,9
37881,Dimanche,thunderlord,864,priest,discipline,18,9,9
37882,Arcmage,malganis,864,priest,discipline,18,9,9
37883,Rima,stormscale,864,priest,discipline,18,9,9
37884,Stubby,shadowsong,864,priest,discipline,18,9,9
37885,Ilovedailies,frostmourne,864,priest,discipline,18,9,9
37886,Toteme,proudmoore,864,priest,discipline,18,9,9
37887,Healthyadult,zuluhed,864,priest,discipline,18,9,9
37888,Cinnalite,darkspear,864,priest,discipline,18,9,9
37889,Seyvyur,black-dragonflight,864,priest,discipline,18,9,9
37890,Makdaddy,skullcrusher,864,priest,discipline,18,9,9
37891,Irar,tichondrius,864,priest,discipline,18,9,9
37892,Træway,tichondrius,864,priest,discipline,18,9,9
37893,Æßøäîètîÿ,sargeras,864,priest,discipline,18,9,9
37894,Celerisp,malganis,864,priest,discipline,18,9,9
37895,Abraz,kiljaeden,864,priest,discipline,18,9,9
37896,Trezz,aegwynn,864,priest,discipline,18,9,9
37897,Easywins,sargeras,864,priest,discipline,24,9,15
37898,Kfcchicken,proudmoore,864,priest,discipline,24,9,15
37899,Ninbará,stormrage,864,priest,discipline,24,9,15
37900,Physics,frostmane,864,priest,discipline,24,9,15
37901,Lostmind,malganis,864,priest,discipline,24,9,15
37902,Dakp,sargeras,864,priest,discipline,24,9,15
37903,Samsypriest,frostmourne,863,priest,discipline,12,9,3
37904,Maplesyrupz,moonrunner,863,priest,discipline,12,9,3
37905,Softqt,tichondrius,863,priest,discipline,12,9,3
37906,Stroserous,hyjal,863,priest,discipline,12,9,3
37907,Thirddps,illidan,863,priest,discipline,12,9,3
37908,Djxkidrock,moon-guard,863,priest,discipline,12,9,3
37909,Chillaxin,dreadmaul,863,priest,discipline,12,9,3
37910,Helleamh,tichondrius,863,priest,discipline,12,9,3
37911,Nightz,illidan,863,priest,discipline,12,9,3
37912,Maleklek,azralon,863,priest,discipline,12,9,3
37913,Dkarla,lightnings-blade,863,priest,discipline,16,10,6
37914,Pillböx,tichondrius,863,priest,discipline,18,9,9
37915,Sentenel,duskwood,863,priest,discipline,18,9,9
37916,Fila,azralon,863,priest,discipline,18,9,9
37917,Oprst,tichondrius,863,priest,discipline,18,9,9
37918,Darkrecovery,sargeras,863,priest,discipline,18,9,9
37919,Eyepod,bleeding-hollow,863,priest,discipline,18,9,9
37920,Deean,demon-soul,863,priest,discipline,18,9,9
37921,Iamrisen,tichondrius,863,priest,discipline,18,9,9
37922,Lemmiewinkzx,sargeras,863,priest,discipline,18,9,9
37923,Healsforcash,bleeding-hollow,863,priest,discipline,21,9,12
37924,Poonanixo,gundrak,863,priest,discipline,22,9,13
37925,Uhatetoseeit,malganis,863,priest,discipline,24,9,15
37926,Mudbuttman,kelthuzad,863,priest,discipline,24,9,15
37927,Kamasutra,drakthul,863,priest,discipline,24,9,15
37928,Løøtgoblin,skullcrusher,863,priest,discipline,24,9,15
37929,Kyüra,sargeras,863,priest,discipline,30,9,21
37930,Bugshott,tichondrius,863,priest,discipline,31,9,22
37931,Mothra,ragnaros,862,priest,discipline,12,9,3
37932,Tinyjunk,stormrage,862,priest,discipline,12,9,3
37933,Felina,maiev,862,priest,discipline,12,9,3
37934,Lacerating,illidan,862,priest,discipline,18,9,9
37935,Ocxpriest,azralon,862,priest,discipline,18,9,9
37936,Pandia,quelthalas,862,priest,discipline,18,9,9
37937,Zælya,stormrage,862,priest,discipline,18,9,9
37938,Ppomx,tichondrius,862,priest,discipline,18,9,9
37939,Satanshealer,terokkar,862,priest,discipline,18,9,9
37940,Neuroflex,proudmoore,862,priest,discipline,18,9,9
37941,Redclover,tichondrius,862,priest,discipline,18,9,9
37942,Jasolini,area-52,862,priest,discipline,18,9,9
37943,Aheneas,quelthalas,862,priest,discipline,18,9,9
37944,Runnow,area-52,862,priest,discipline,18,9,9
37945,Drerrdaytv,kelthuzad,862,priest,discipline,18,9,9
37946,Releknosleep,frostwolf,862,priest,discipline,19,9,10
37947,Monvireaux,area-52,862,priest,discipline,24,9,15
37948,Fäÿë,tichondrius,862,priest,discipline,24,9,15
37949,Giannis,garrosh,862,priest,discipline,24,9,15
37950,Çøçø,tichondrius,861,priest,discipline,12,9,3
37951,Zil,spinebreaker,861,priest,discipline,12,9,3
37952,Cremexo,tichondrius,861,priest,discipline,16,9,7
37953,Sorros,cenarion-circle,861,priest,discipline,18,10,8
37954,Adrameléch,area-52,861,priest,discipline,18,9,9
37955,Synapse,moon-guard,861,priest,discipline,18,9,9
37956,Kaldric,korgath,861,priest,discipline,18,9,9
37957,Discountay,burning-legion,861,priest,discipline,18,9,9
37958,Seader,alterac-mountains,861,priest,discipline,24,9,15
37959,Jeraphìm,tichondrius,860,priest,discipline,18,9,9
37960,Drzz,tichondrius,860,priest,discipline,18,9,9
37961,Griggleslol,tichondrius,859,priest,discipline,12,9,3
37962,Demonwizard,sargeras,859,priest,discipline,18,9,9
37963,Pizdük,stormrage,859,priest,discipline,18,9,9
37964,Selson,stormrage,859,priest,discipline,30,9,21
37965,Notahero,tichondrius,858,priest,discipline,12,9,3
37966,Jacktractive,area-52,858,priest,discipline,15,10,5
37967,Preachermang,laughing-skull,858,priest,discipline,18,9,9
37968,Asatruu,stormrage,858,priest,discipline,24,9,15
37969,Divinity,hellscream,858,priest,discipline,24,9,15
37970,Ricflayer,lothar,858,priest,discipline,24,9,15
37971,Roßyn,quelthalas,857,priest,discipline,18,9,9
37972,Rugaru,emerald-dream,857,priest,discipline,21,10,11
37973,Touchedbygud,frostmourne,857,priest,discipline,26,11,15
37974,Jhonka,nerzhul,856,priest,discipline,12,9,3
37975,Rohee,illidan,856,priest,discipline,18,9,9
37976,Damushi,frostmourne,856,priest,discipline,18,9,9
37977,Sipmemaster,tichondrius,856,priest,discipline,24,9,15
37978,Caiitlynn,quelthalas,856,priest,discipline,24,9,15
37979,Susannahh,goldrinn,854,priest,discipline,18,9,9
37980,Igotdots,scilla,854,priest,discipline,42,18,24
37981,Sunayriah,illidan,853,priest,discipline,12,9,3
37982,Mangoes,scilla,853,priest,discipline,20,9,11
37983,Alterboy,garrosh,852,priest,discipline,36,14,22
37984,Zathanel,ragnaros,852,priest,discipline,24,9,15
37985,Uckuck,illidan,851,priest,discipline,18,9,9
37986,Whitegirlirl,blackrock,850,priest,discipline,12,9,3
37987,Jikoguu,stormscale,850,priest,discipline,30,9,21
37988,Serana,maelstrom,848,priest,discipline,147,72,75
37989,Snevini,azralon,848,priest,discipline,30,11,19
37990,Nubzin,tichondrius,846,priest,discipline,18,9,9
37991,Brahskeet,illidan,841,priest,discipline,30,9,21
37992,Darkblesxd,quelthalas,837,priest,discipline,12,9,3
37993,Thelonioüs,tichondrius,832,priest,discipline,55,20,35
37994,Rockrock,zuljin,831,priest,discipline,14,11,3
37995,Creepa,kul-tiras,831,priest,discipline,16,9,7
37996,Healloween,stormrage,829,priest,discipline,21,11,10
37997,Supersede,sargeras,828,priest,discipline,173,80,93
37998,Delithara,tichondrius,826,priest,discipline,18,9,9
37999,Holyshield,jubeithos,825,priest,discipline,19,10,9
38000,Mydranol,tichondrius,824,priest,discipline,29,9,20
38001,Khinthazin,barthilas,815,priest,discipline,48,20,28
38002,Såx,stormreaver,814,priest,discipline,21,9,12
38003,Arizztocrat,tichondrius,814,priest,discipline,23,9,14
38004,Ipód,tichondrius,813,priest,discipline,15,10,5
38005,Mikebroowwnn,firetree,813,priest,discipline,22,11,11
38006,Perzeval,azshara,813,priest,discipline,23,9,14
38007,Breathkeeper,proudmoore,810,priest,discipline,27,10,17
38008,Ryukim,tichondrius,809,priest,discipline,26,12,14
38009,Enrika,stormrage,806,priest,discipline,29,13,16
38010,Wellheeled,norgannon,806,priest,discipline,21,9,12
38011,Wingchick,azshara,805,priest,discipline,66,24,42
38012,Acenthe,sargeras,800,priest,discipline,16,9,7
38013,Darkmolt,vashj,795,priest,discipline,20,9,11
38014,Winston,tichondrius,784,priest,discipline,19,9,10
38015,Jessikal,quelthalas,784,priest,discipline,19,9,10
38016,Fátima,tichondrius,783,priest,discipline,11,9,2
38017,Tidepodzxo,moon-guard,783,priest,discipline,11,9,2
38018,Butdidudied,sargeras,783,priest,discipline,17,9,8
38019,Bambi,dunemaul,768,priest,discipline,12,8,4
38020,Xactly,sargeras,768,priest,discipline,12,8,4
38021,Discipline,the-scryers,768,priest,discipline,12,8,4
38022,Sip,sargeras,768,priest,discipline,12,8,4
38023,Ñightelf,area-52,768,priest,discipline,12,8,4
38024,Fzz,queldorei,768,priest,discipline,12,8,4
38025,Qohoo,tichondrius,768,priest,discipline,12,8,4
38026,Abbyc,frostmourne,768,priest,discipline,12,8,4
38027,Bubbletrubbl,blackrock,768,priest,discipline,12,8,4
38028,Zenelu,tichondrius,768,priest,discipline,12,8,4
38029,Goofs,moon-guard,768,priest,discipline,12,8,4
38030,Bananass,sargeras,768,priest,discipline,12,8,4
38031,Nydrosia,frostmourne,768,priest,discipline,12,8,4
38032,Sweethole,illidan,768,priest,discipline,12,8,4
38033,Skerrz,illidan,768,priest,discipline,12,8,4
38034,Criiltwo,area-52,768,priest,discipline,12,8,4
38035,Sallydaddy,wyrmrest-accord,768,priest,discipline,12,8,4
38036,Slpox,sargeras,768,priest,discipline,12,8,4
38037,Nausitoo,ragnaros,768,priest,discipline,12,8,4
38038,Plosux,tichondrius,768,priest,discipline,12,8,4
38039,Evèlyn,dathremar,768,priest,discipline,12,8,4
38040,Spitonmejuli,illidan,768,priest,discipline,12,8,4
38041,Pws,azralon,768,priest,discipline,12,8,4
38042,Heeka,kelthuzad,768,priest,discipline,12,8,4
38043,Notsquishy,tichondrius,768,priest,discipline,12,8,4
38044,Dabû,tichondrius,768,priest,discipline,12,8,4
38045,Voltekkeh,tichondrius,768,priest,discipline,12,8,4
38046,Yansuanmu,tichondrius,768,priest,discipline,12,8,4
38047,Soloqqt,tichondrius,768,priest,discipline,12,8,4
38048,Xzliak,area-52,768,priest,discipline,12,8,4
38049,Sìkarìa,illidan,768,priest,discipline,12,8,4
38050,Twwety,thrall,768,priest,discipline,12,8,4
38051,Myòvó,tichondrius,768,priest,discipline,12,8,4
38052,Zeepew,tichondrius,768,priest,discipline,12,8,4
38053,Angeldúst,the-forgotten-coast,768,priest,discipline,12,8,4
38054,Spriestbro,emerald-dream,768,priest,discipline,12,8,4
38055,Melielectra,tichondrius,768,priest,discipline,18,8,10
38056,Yosps,tichondrius,768,priest,discipline,18,8,10
38057,Cowboydanpri,malganis,768,priest,discipline,18,8,10
38058,Alcoric,illidan,768,priest,discipline,18,8,10
38059,Sussywussy,stormrage,768,priest,discipline,18,8,10
38060,Dehf,bleeding-hollow,768,priest,discipline,18,8,10
38061,Jpgpng,tichondrius,768,priest,discipline,18,8,10
38062,Sotore,bleeding-hollow,768,priest,discipline,18,8,10
38063,Owlchubz,mannoroth,768,priest,discipline,18,8,10
38064,Punchyxz,illidan,768,priest,discipline,18,8,10
38065,Ifortalot,lothar,768,priest,discipline,18,8,10
38066,Immörtality,stormrage,768,priest,discipline,18,8,10
38067,Xtradotz,tichondrius,768,priest,discipline,18,8,10
38068,Mellisonant,stormrage,768,priest,discipline,18,8,10
38069,Jubinátor,tichondrius,768,priest,discipline,18,8,10
38070,Robinophelia,sargeras,768,priest,discipline,18,8,10
38071,Esseks,tichondrius,768,priest,discipline,18,8,10
38072,Shadowkenlol,tichondrius,768,priest,discipline,18,8,10
38073,Manbelow,bleeding-hollow,768,priest,discipline,27,9,18
38074,Minyeong,tichondrius,768,priest,discipline,24,8,16
38075,Nuditwo,malganis,768,priest,discipline,24,8,16
38076,Ayani,khadgar,768,priest,discipline,24,8,16
38077,Jinzp,area-52,768,priest,discipline,24,8,16
38078,Hugeshield,stormrage,768,priest,discipline,24,8,16
38079,Synnlawl,bleeding-hollow,768,priest,discipline,24,8,16
38080,Voidrisu,sargeras,768,priest,discipline,24,8,16
38081,Mavalie,zuljin,768,priest,discipline,24,8,16
38082,Dylan,shuhalo,768,priest,discipline,24,8,16
38083,Fréákk,ragnaros,768,priest,discipline,24,8,16
38084,Iulu,doomhammer,767,priest,discipline,12,8,4
38085,Mariels,quelthalas,767,priest,discipline,12,8,4
38086,Maga,laughing-skull,767,priest,discipline,12,8,4
38087,Piusxll,tichondrius,767,priest,discipline,12,8,4
38088,Ahnightmares,tichondrius,767,priest,discipline,12,8,4
38089,Pandaboots,illidan,767,priest,discipline,12,8,4
38090,Alarisa,chogall,767,priest,discipline,12,8,4
38091,Tubshark,moon-guard,767,priest,discipline,12,8,4
38092,Hölymöly,moon-guard,767,priest,discipline,12,8,4
38093,Miketython,chogall,767,priest,discipline,12,8,4
38094,Urgetopurge,dunemaul,767,priest,discipline,12,8,4
38095,Lelyna,stormrage,767,priest,discipline,12,8,4
38096,Geniusidiot,area-52,767,priest,discipline,12,8,4
38097,Shinemyhead,stormrage,767,priest,discipline,12,8,4
38098,Elkies,area-52,767,priest,discipline,12,8,4
38099,Clerkpriest,dragonmaw,767,priest,discipline,12,8,4
38100,Gawlas,azshara,767,priest,discipline,12,8,4
38101,Cassiuss,kelthuzad,767,priest,discipline,12,8,4
38102,Rainny,proudmoore,767,priest,discipline,12,8,4
38103,Lucènt,frostmourne,767,priest,discipline,12,8,4
38104,Vyndïllïn,tichondrius,767,priest,discipline,12,8,4
38105,Ryuuka,sargeras,767,priest,discipline,12,8,4
38106,Kynsias,stormrage,767,priest,discipline,15,8,7
38107,Datspice,stormrage,767,priest,discipline,18,8,10
38108,Grotti,ragnaros,767,priest,discipline,18,8,10
38109,Jùdas,ravencrest,767,priest,discipline,18,8,10
38110,Phobe,windrunner,767,priest,discipline,18,8,10
38111,Remuni,tichondrius,767,priest,discipline,18,8,10
38112,Triazolam,illidan,767,priest,discipline,18,8,10
38113,Analiesa,moon-guard,767,priest,discipline,18,8,10
38114,Pehkthree,hyjal,767,priest,discipline,18,8,10
38115,Hesus,deathwing,767,priest,discipline,18,8,10
38116,Holyslap,nerzhul,767,priest,discipline,18,8,10
38117,Doublesix,malganis,767,priest,discipline,18,8,10
38118,Dawnside,wyrmrest-accord,767,priest,discipline,24,8,16
38119,Providennce,tichondrius,767,priest,discipline,24,8,16
38120,Weston,bleeding-hollow,767,priest,discipline,24,8,16
38121,Fatherdan,blackrock,767,priest,discipline,24,8,16
38122,Hl,dalaran,767,priest,discipline,24,8,16
38123,Falro,tichondrius,767,priest,discipline,24,8,16
38124,Showakoi,ragnaros,767,priest,discipline,28,9,19
38125,Shirley,skywall,767,priest,discipline,30,8,22
38126,Imb,nagrand,766,priest,discipline,12,8,4
38127,Fakér,illidan,766,priest,discipline,12,8,4
38128,Dorós,coilfang,766,priest,discipline,12,8,4
38129,Juniorfloyd,tichondrius,766,priest,discipline,12,8,4
38130,Ariel,veknilash,766,priest,discipline,12,8,4
38131,Grizzblessed,sargeras,766,priest,discipline,12,8,4
38132,Mineral,sargeras,766,priest,discipline,12,8,4
38133,Spitefuldirk,dalaran,766,priest,discipline,12,8,4
38134,Jerserra,emerald-dream,766,priest,discipline,12,8,4
38135,Xhaajyh,area-52,766,priest,discipline,12,8,4
38136,Kynnen,mannoroth,766,priest,discipline,12,8,4
38137,Eiderwood,moon-guard,766,priest,discipline,12,8,4
38138,Abzorbed,stormrage,766,priest,discipline,12,8,4
38139,Shockalishus,stormrage,766,priest,discipline,12,8,4
38140,Purus,tichondrius,766,priest,discipline,18,8,10
38141,Shaerel,dalaran,766,priest,discipline,18,8,10
38142,Mondrielris,tichondrius,766,priest,discipline,18,8,10
38143,Nogetget,frostmourne,766,priest,discipline,18,8,10
38144,Gõd,zuluhed,766,priest,discipline,18,8,10
38145,Yarock,kelthuzad,766,priest,discipline,18,8,10
38146,Via,chogall,766,priest,discipline,18,8,10
38147,Invisapowa,hyjal,766,priest,discipline,18,8,10
38148,Spriest,kul-tiras,766,priest,discipline,18,8,10
38149,Saphet,draktharon,766,priest,discipline,18,8,10
38150,Bübbler,tichondrius,765,priest,discipline,12,8,4
38151,Tsunadae,hakkar,765,priest,discipline,12,8,4
38152,Pollyphia,kiljaeden,765,priest,discipline,12,8,4
38153,Rahmynpriest,tichondrius,765,priest,discipline,12,8,4
38154,Bandaidvibes,tichondrius,765,priest,discipline,12,8,4
38155,Aybaby,kiljaeden,765,priest,discipline,18,8,10
38156,Sahray,quelthalas,765,priest,discipline,18,8,10
38157,Nursébeardy,whisperwind,765,priest,discipline,18,8,10
38158,Frekigeri,dalaran,765,priest,discipline,18,8,10
38159,Dirtyprïest,bonechewer,765,priest,discipline,18,8,10
38160,Shalther,thrall,765,priest,discipline,18,8,10
38161,Elrywn,stormrage,765,priest,discipline,24,8,16
38162,Xiphz,stormrage,765,priest,discipline,24,8,16
38163,Brosbeforeho,tichondrius,765,priest,discipline,24,8,16
38164,Velinthra,proudmoore,764,priest,discipline,12,8,4
38165,Kathlick,thrall,764,priest,discipline,12,8,4
38166,Glepstein,emerald-dream,764,priest,discipline,18,8,10
38167,Chandrella,zuljin,764,priest,discipline,18,8,10
38168,Lobstersock,malganis,764,priest,discipline,18,8,10
38169,Healrat,thrall,764,priest,discipline,18,8,10
38170,Gudnewsevone,illidan,764,priest,discipline,18,8,10
38171,Iciana,proudmoore,764,priest,discipline,18,8,10
38172,Alinastarkov,area-52,764,priest,discipline,20,8,12
38173,Itchybubble,emerald-dream,763,priest,discipline,12,8,4
38174,Glownoodle,stormrage,763,priest,discipline,12,8,4
38175,Deadheadfred,bonechewer,763,priest,discipline,18,8,10
38176,Rókue,silvermoon,763,priest,discipline,18,8,10
38177,Casstiell,proudmoore,763,priest,discipline,18,8,10
38178,Ashlìe,moon-guard,763,priest,discipline,18,8,10
38179,Nsquared,illidan,763,priest,discipline,24,8,16
38180,Squatrack,tichondrius,763,priest,discipline,24,8,16
38181,Stumbelz,stormrage,762,priest,discipline,12,8,4
38182,Nuell,malganis,762,priest,discipline,12,8,4
38183,Yurick,garrosh,762,priest,discipline,12,8,4
38184,Badazzfrank,tichondrius,762,priest,discipline,18,8,10
38185,Manaburnout,blackhand,762,priest,discipline,30,8,22
38186,Criticaal,aegwynn,761,priest,discipline,18,8,10
38187,Oniyuri,dark-iron,760,priest,discipline,12,8,4
38188,Fluxus,sargeras,760,priest,discipline,12,8,4
38189,Cheuksin,korgath,759,priest,discipline,12,8,4
38190,Lifesavér,tichondrius,759,priest,discipline,12,8,4
38191,Tâmpîcö,ragnaros,759,priest,discipline,18,8,10
38192,Kasamm,nazjatar,756,priest,discipline,18,8,10
38193,Flannigan,veknilash,753,priest,discipline,12,8,4
38194,Alleviate,frostmourne,751,priest,discipline,17,8,9
38195,Chadeux,bleeding-hollow,751,priest,discipline,18,8,10
38196,Whitepi,tichondrius,751,priest,discipline,21,9,12
38197,Peacebewithu,echo-isles,749,priest,discipline,12,8,4
38198,Worldhealer,area-52,749,priest,discipline,18,8,10
38199,Knez,ragnaros,745,priest,discipline,21,11,10
38200,Phathighs,nagrand,739,priest,discipline,18,8,10
38201,Pokebox,frostmourne,735,priest,discipline,16,8,8
38202,Álûcard,illidan,734,priest,discipline,13,9,4
38203,Krewed,ravencrest,734,priest,discipline,14,9,5
38204,Unholyshield,frostmourne,734,priest,discipline,17,8,9
38205,Itssehctap,chogall,732,priest,discipline,14,9,5
38206,Aloragon,tichondrius,732,priest,discipline,17,8,9
38207,Priestmain,thrall,731,priest,discipline,17,8,9
38208,Sacredream,illidan,730,priest,discipline,17,8,9
38209,Notarealdoc,uldaman,726,priest,discipline,20,9,11
38210,Kloevu,stormrage,725,priest,discipline,17,8,9
38211,Itxo,quelthalas,723,priest,discipline,16,9,7
38212,Invoice,bloodscalp,719,priest,discipline,17,8,9
38213,Pðpë,area-52,718,priest,discipline,11,8,3
38214,Clarity,arthas,718,priest,discipline,15,9,6
38215,Asfw,chogall,717,priest,discipline,18,10,8
38216,Nikniknak,bleeding-hollow,715,priest,discipline,15,9,6
38217,Nås,elune,711,priest,discipline,22,10,12
38218,Sadier,moon-guard,708,priest,discipline,26,9,17
38219,Trashdiscx,stormrage,707,priest,discipline,25,11,14
38220,Cylocibin,kiljaeden,705,priest,discipline,23,10,13
38221,Sölei,tichondrius,704,priest,discipline,22,8,14
38222,Noneedruid,ragnaros,703,priest,discipline,11,8,3
38223,Aenbubble,tichondrius,703,priest,discipline,14,8,6
38224,Melancholies,moon-guard,703,priest,discipline,20,8,12
38225,Styléßéndérx,illidan,687,priest,discipline,11,8,3
38226,Zylemm,malganis,687,priest,discipline,17,8,9
38227,Väin,proudmoore,685,priest,discipline,27,10,17
38228,Läsombra,area-52,684,priest,discipline,17,9,8
38229,Absorbn,barthilas,672,priest,discipline,12,7,5
38230,Josephlin,quelthalas,672,priest,discipline,12,7,5
38231,Fronkeytko,tichondrius,672,priest,discipline,12,7,5
38232,Onipapae,frostmourne,672,priest,discipline,12,7,5
38233,Basedgód,arathor,672,priest,discipline,12,7,5
38234,Gucciboon,frostmourne,672,priest,discipline,12,7,5
38235,Holyhand,auchindoun,672,priest,discipline,12,7,5
38236,Djwienerbum,darkspear,672,priest,discipline,12,7,5
38237,Scandi,tichondrius,672,priest,discipline,12,7,5
38238,Ìceheals,tichondrius,672,priest,discipline,12,7,5
38239,Aeyde,proudmoore,672,priest,discipline,12,7,5
38240,Artirie,darkspear,672,priest,discipline,12,7,5
38241,Harrydisc,shattered-hand,672,priest,discipline,12,7,5
38242,Ogdisc,gallywix,672,priest,discipline,12,7,5
38243,Toyz,arthas,672,priest,discipline,12,7,5
38244,Horízon,illidan,672,priest,discipline,12,7,5
38245,Jnglpriestx,thrall,672,priest,discipline,12,7,5
38246,Xellda,azjolnerub,672,priest,discipline,12,7,5
38247,Ikkemen,tichondrius,672,priest,discipline,12,7,5
38248,Thewaker,tichondrius,672,priest,discipline,12,7,5
38249,Ahnit,azralon,672,priest,discipline,12,7,5
38250,Marejayne,tichondrius,672,priest,discipline,12,7,5
38251,Moondèx,maelstrom,672,priest,discipline,12,7,5
38252,Kripple,tichondrius,672,priest,discipline,12,7,5
38253,Nerfdisc,elune,672,priest,discipline,12,7,5
38254,Squigic,turalyon,672,priest,discipline,12,7,5
38255,Whataday,tichondrius,672,priest,discipline,12,7,5
38256,Rickmason,frostmane,672,priest,discipline,12,7,5
38257,Holyscuz,zuljin,672,priest,discipline,12,7,5
38258,Yodud,tichondrius,672,priest,discipline,12,7,5
38259,Penanced,tichondrius,672,priest,discipline,12,7,5
38260,Amoureuxz,bleeding-hollow,672,priest,discipline,12,7,5
38261,Xantard,malganis,672,priest,discipline,12,7,5
38262,Hly,frostmourne,672,priest,discipline,12,7,5
38263,Walpurgis,skywall,672,priest,discipline,12,7,5
38264,Burgersl,illidan,672,priest,discipline,12,7,5
38265,Gäüga,burning-legion,672,priest,discipline,12,7,5
38266,Pavesarii,proudmoore,672,priest,discipline,12,7,5
38267,Kiloe,tichondrius,672,priest,discipline,12,7,5
38268,Powerwôrdhug,destromath,672,priest,discipline,12,7,5
38269,Sideform,tichondrius,672,priest,discipline,12,7,5
38270,Dráugr,ragnaros,672,priest,discipline,12,7,5
38271,Tuladim,tichondrius,672,priest,discipline,12,7,5
38272,Interacts,darkspear,672,priest,discipline,12,7,5
38273,Shadion,sargeras,672,priest,discipline,12,7,5
38274,Tòodles,stormrage,672,priest,discipline,12,7,5
38275,Mixedprotein,tichondrius,672,priest,discipline,12,7,5
38276,Gothii,tichondrius,672,priest,discipline,12,7,5
38277,Sadsadge,sargeras,672,priest,discipline,12,7,5
38278,Pandaniaco,drakkari,672,priest,discipline,12,7,5
38279,Omsi,emerald-dream,672,priest,discipline,12,7,5
38280,Dwarfxomp,ragnaros,672,priest,discipline,12,7,5
38281,Greenteababy,tichondrius,672,priest,discipline,12,7,5
38282,Holyshiiet,area-52,672,priest,discipline,12,7,5
38283,Brehzy,zuljin,672,priest,discipline,12,7,5
38284,Jenhawkinsx,frostmourne,672,priest,discipline,12,7,5
38285,Eddic,wyrmrest-accord,672,priest,discipline,12,7,5
38286,Pinkprincess,tichondrius,672,priest,discipline,12,7,5
38287,Sabrino,azralon,672,priest,discipline,12,7,5
38288,Sevros,moon-guard,672,priest,discipline,12,7,5
38289,Eneldz,quelthalas,672,priest,discipline,12,7,5
38290,Clevelandboy,blackrock,672,priest,discipline,12,7,5
38291,Kymomeh,sargeras,672,priest,discipline,12,7,5
38292,Ninielly,stormrage,672,priest,discipline,14,8,6
38293,Photicz,thrall,672,priest,discipline,17,8,9
38294,Getgudwtrada,frostmourne,672,priest,discipline,15,7,8
38295,Rigotakx,illidan,672,priest,discipline,18,7,11
38296,Upsahl,area-52,672,priest,discipline,18,7,11
38297,Manbooty,illidan,672,priest,discipline,18,7,11
38298,Iwillrezguys,tichondrius,672,priest,discipline,18,7,11
38299,Mockr,kiljaeden,672,priest,discipline,18,7,11
38300,Brotheraram,kelthuzad,672,priest,discipline,18,7,11
38301,Hayna,emerald-dream,672,priest,discipline,18,7,11
38302,Aryeinna,illidan,672,priest,discipline,18,7,11
38303,Criminalsp,frostmourne,672,priest,discipline,18,7,11
38304,Xayda,area-52,672,priest,discipline,18,7,11
38305,Sagapriest,hyjal,672,priest,discipline,18,7,11
38306,Tisifone,ragnaros,672,priest,discipline,18,7,11
38307,Azari,illidan,672,priest,discipline,18,7,11
38308,Joeybats,frostwolf,672,priest,discipline,18,7,11
38309,Dingledot,sargeras,672,priest,discipline,18,7,11
38310,Nayng,tichondrius,672,priest,discipline,18,7,11
38311,Jugeum,proudmoore,672,priest,discipline,18,7,11
38312,Jagsp,area-52,672,priest,discipline,18,7,11
38313,Burblespue,burning-blade,672,priest,discipline,18,7,11
38314,Lidole,barthilas,672,priest,discipline,18,7,11
38315,Dxs,hydraxis,672,priest,discipline,18,7,11
38316,Ayumihamaski,tichondrius,672,priest,discipline,18,7,11
38317,Burkett,sargeras,672,priest,discipline,18,7,11
38318,Xalty,emerald-dream,672,priest,discipline,21,8,13
38319,Pïque,proudmoore,672,priest,discipline,24,7,17
38320,Ezrah,kelthuzad,672,priest,discipline,24,7,17
38321,Stríkes,emerald-dream,672,priest,discipline,24,7,17
38322,Polyesterp,frostmourne,672,priest,discipline,24,7,17
38323,Jbtytime,proudmoore,672,priest,discipline,24,7,17
38324,Autogenic,malganis,672,priest,discipline,24,7,17
38325,Teamz,illidan,672,priest,discipline,24,7,17
38326,Mindfak,bleeding-hollow,672,priest,discipline,24,7,17
38327,Diebetus,zuljin,672,priest,discipline,24,7,17
38328,Babymieo,illidan,672,priest,discipline,24,7,17
38329,Discpriestxo,malganis,672,priest,discipline,30,7,23
38330,Thalladori,area-52,671,priest,discipline,16,10,6
38331,Crossblèssèr,sargeras,671,priest,discipline,12,7,5
38332,Danílo,quelthalas,671,priest,discipline,12,7,5
38333,Mahelet,drakkari,671,priest,discipline,12,7,5
38334,Esohpr,frostmourne,671,priest,discipline,12,7,5
38335,Linlight,stormrage,671,priest,discipline,12,7,5
38336,Thattpriest,thrall,671,priest,discipline,12,7,5
38337,Jeremey,darkspear,671,priest,discipline,12,7,5
38338,Popeofdope,queldorei,671,priest,discipline,12,7,5
38339,Jasonlol,sargeras,671,priest,discipline,12,7,5
38340,Saintsnap,bleeding-hollow,671,priest,discipline,12,7,5
38341,Zarfs,burning-blade,671,priest,discipline,12,7,5
38342,Bombinburbon,durotan,671,priest,discipline,12,7,5
38343,Travakel,proudmoore,671,priest,discipline,12,7,5
38344,Curra,frostmourne,671,priest,discipline,12,7,5
38345,Trinidy,illidan,671,priest,discipline,12,7,5
38346,Atheenia,icecrown,671,priest,discipline,12,7,5
38347,Serafím,goldrinn,671,priest,discipline,12,7,5
38348,Synesth,area-52,671,priest,discipline,12,7,5
38349,Milkymommies,tichondrius,671,priest,discipline,12,7,5
38350,Windwolf,dalvengyr,671,priest,discipline,12,7,5
38351,Maenard,emerald-dream,671,priest,discipline,12,7,5
38352,Lumyra,malganis,671,priest,discipline,12,7,5
38353,Geyforpray,tichondrius,671,priest,discipline,12,7,5
38354,Moonpeace,tichondrius,671,priest,discipline,12,7,5
38355,Skgangmm,tichondrius,671,priest,discipline,12,7,5
38356,Beocca,nerzhul,671,priest,discipline,12,7,5
38357,Kenprizle,sargeras,671,priest,discipline,12,7,5
38358,Fatherjerry,kiljaeden,671,priest,discipline,12,7,5
38359,Altari,whisperwind,671,priest,discipline,12,7,5
38360,Sophistdew,proudmoore,671,priest,discipline,12,7,5
38361,Clerkbum,emerald-dream,671,priest,discipline,12,7,5
38362,Lightschosen,malganis,671,priest,discipline,12,7,5
38363,Fatherleem,tichondrius,671,priest,discipline,12,7,5
38364,Hammersholy,stormrage,671,priest,discipline,12,7,5
38365,Moirâ,silvermoon,671,priest,discipline,12,7,5
38366,Lebanese,frostmourne,671,priest,discipline,12,7,5
38367,Debigheal,stormrage,671,priest,discipline,12,7,5
38368,Donkeycube,tichondrius,671,priest,discipline,12,7,5
38369,Epik,moknathal,671,priest,discipline,15,8,7
38370,Painkiller,lightbringer,671,priest,discipline,17,7,10
38371,Pecadu,azralon,671,priest,discipline,18,7,11
38372,Adofthealer,illidan,671,priest,discipline,18,7,11
38373,Rillding,tichondrius,671,priest,discipline,18,7,11
38374,Merxy,bleeding-hollow,671,priest,discipline,18,7,11
38375,Noiri,aegwynn,671,priest,discipline,18,7,11
38376,Randomheal,dunemaul,671,priest,discipline,18,7,11
38377,Ganelm,vashj,671,priest,discipline,18,7,11
38378,Revivemepls,tichondrius,671,priest,discipline,18,7,11
38379,Slobmygnob,illidan,671,priest,discipline,18,7,11
38380,Soùlsista,sargeras,671,priest,discipline,18,7,11
38381,Vania,tortheldrin,671,priest,discipline,18,7,11
38382,Xalatath,stormrage,671,priest,discipline,18,7,11
38383,Xiaozhui,tichondrius,671,priest,discipline,24,7,17
38384,Caeda,icecrown,671,priest,discipline,24,7,17
38385,Floorpray,tichondrius,671,priest,discipline,24,7,17
38386,Malansuo,wyrmrest-accord,671,priest,discipline,30,7,23
38387,Dirtydogma,zuljin,671,priest,discipline,30,7,23
38388,Mitras,moon-guard,670,priest,discipline,12,7,5
38389,Scratchmyear,tichondrius,670,priest,discipline,12,7,5
38390,Mortïmer,alleria,670,priest,discipline,12,7,5
38391,Fatherhands,illidan,670,priest,discipline,12,7,5
38392,Donus,frostmane,670,priest,discipline,12,7,5
38393,Angelicduck,illidan,670,priest,discipline,12,7,5
38394,Triplekil,tichondrius,670,priest,discipline,12,7,5
38395,Kastwalker,earthen-ring,670,priest,discipline,12,7,5
38396,Cromagnøn,dalaran,670,priest,discipline,12,7,5
38397,Xð,jubeithos,670,priest,discipline,12,7,5
38398,Dotsrboe,illidan,670,priest,discipline,12,7,5
38399,Madskills,shadow-council,670,priest,discipline,12,7,5
38400,Antìdote,tichondrius,670,priest,discipline,12,7,5
38401,Fedge,kelthuzad,670,priest,discipline,12,7,5
38402,Brokennurse,area-52,670,priest,discipline,13,7,6
38403,Spiceenjoyer,emerald-dream,670,priest,discipline,15,8,7
38404,Xeras,ravencrest,670,priest,discipline,18,7,11
38405,Râku,area-52,670,priest,discipline,18,7,11
38406,Arkathus,stormrage,670,priest,discipline,18,7,11
38407,Zgzz,stormrage,670,priest,discipline,24,7,17
38408,Kerfos,azralon,669,priest,discipline,10,8,2
38409,Ðowörk,illidan,669,priest,discipline,12,7,5
38410,Gabryanna,emerald-dream,669,priest,discipline,18,7,11
38411,Dorst,bonechewer,669,priest,discipline,18,7,11
38412,Waterßoÿ,emerald-dream,669,priest,discipline,21,8,13
38413,Laj,proudmoore,669,priest,discipline,24,7,17
38414,Tílanga,azralon,668,priest,discipline,12,7,5
38415,Darthvalak,illidan,668,priest,discipline,12,7,5
38416,Nielic,arygos,668,priest,discipline,12,7,5
38417,Fallenängel,senjin,668,priest,discipline,12,7,5
38418,Butterflyblu,ragnaros,668,priest,discipline,13,7,6
38419,Albertth,ragnaros,668,priest,discipline,18,7,11
38420,Typhon,blackhand,668,priest,discipline,18,7,11
38421,Butterblessr,thunderlord,668,priest,discipline,19,7,12
38422,Viehweg,azralon,667,priest,discipline,18,7,11
38423,Nikasaur,azgalor,667,priest,discipline,18,7,11
38424,Healzutwo,tichondrius,667,priest,discipline,18,7,11
38425,Tassik,dalaran,667,priest,discipline,18,7,11
38426,Glisserin,zuljin,666,priest,discipline,12,7,5
38427,Sihua,illidan,666,priest,discipline,18,7,11
38428,Tenet,stormscale,666,priest,discipline,18,7,11
38429,Charlie,azshara,665,priest,discipline,12,7,5
38430,Pharaoh,deathwing,665,priest,discipline,18,7,11
38431,Grapedraankk,kelthuzad,664,priest,discipline,12,7,5
38432,Crossblesser,alleria,663,priest,discipline,12,7,5
38433,Laopao,proudmoore,663,priest,discipline,35,13,22
38434,Sezyks,stormrage,655,priest,discipline,17,7,10
38435,Rcx,sargeras,655,priest,discipline,17,7,10
38436,Plasticbag,frostmourne,654,priest,discipline,17,7,10
38437,Lonerush,hyjal,652,priest,discipline,19,7,12
38438,Pridesp,tichondrius,639,priest,discipline,14,8,6
38439,Dreadxshadow,stormrage,628,priest,discipline,24,12,12
38440,Swagacious,malganis,624,priest,discipline,13,8,5
38441,Elliepls,tichondrius,624,priest,discipline,15,7,8
38442,Holysmegma,dreadmaul,623,priest,discipline,11,7,4
38443,Ezpríest,kelthuzad,623,priest,discipline,11,7,4
38444,Azaleth,sargeras,623,priest,discipline,17,7,10
38445,Praisedalort,illidan,621,priest,discipline,15,8,7
38446,Tmnaarcanttv,tichondrius,618,priest,discipline,13,8,5
38447,Skellybells,sargeras,617,priest,discipline,22,12,10
38448,Elevatez,stormrage,608,priest,discipline,10,7,3
38449,Åffliction,sargeras,607,priest,discipline,11,7,4
38450,Coolzo,dethecus,607,priest,discipline,14,8,6
38451,Jimyo,tichondrius,607,priest,discipline,15,7,8
38452,Coutúre,illidan,606,priest,discipline,11,7,4
38453,Codiroli,tichondrius,606,priest,discipline,14,7,7
38454,Athzziry,ragnaros,599,priest,discipline,21,7,14
38455,Applekrisp,sargeras,589,priest,discipline,25,8,17
38456,Càptain,moon-guard,576,priest,discipline,6,6,0
38457,Kwx,tichondrius,576,priest,discipline,6,6,0
38458,Pearl,chogall,576,priest,discipline,6,6,0
38459,Gód,moonrunner,576,priest,discipline,6,6,0
38460,Healia,tichondrius,576,priest,discipline,6,6,0
38461,Madelyn,stormrage,576,priest,discipline,6,6,0
38462,Smashfacëwin,tichondrius,576,priest,discipline,6,6,0
38463,Porffy,malygos,576,priest,discipline,6,6,0
38464,Chop,kelthuzad,576,priest,discipline,6,6,0
38465,Darkxd,bleeding-hollow,576,priest,discipline,6,6,0
38466,Delai,dalaran,576,priest,discipline,6,6,0
38467,Illmatíc,malganis,576,priest,discipline,6,6,0
38468,Eldoras,zuljin,576,priest,discipline,6,6,0
38469,Biomadd,hellscream,576,priest,discipline,9,7,2
38470,Joanoarc,destromath,576,priest,discipline,12,6,6
38471,Bambucha,ragnaros,576,priest,discipline,12,6,6
38472,Nieni,wyrmrest-accord,576,priest,discipline,12,6,6
38473,Napr,proudmoore,576,priest,discipline,12,6,6
38474,Jopocket,bleeding-hollow,576,priest,discipline,12,6,6
38475,Missrachel,kiljaeden,576,priest,discipline,12,6,6
38476,Surletoit,tichondrius,576,priest,discipline,12,6,6
38477,Ahnassi,stormrage,576,priest,discipline,12,6,6
38478,Decades,moon-guard,576,priest,discipline,12,6,6
38479,Celypriest,moon-guard,576,priest,discipline,12,6,6
38480,Nineoneoneh,stormrage,576,priest,discipline,12,6,6
38481,Luun,bleeding-hollow,576,priest,discipline,12,6,6
38482,Flarkyllama,area-52,576,priest,discipline,12,6,6
38483,Johnnysyns,frostmourne,576,priest,discipline,12,6,6
38484,Altheria,malganis,576,priest,discipline,12,6,6
38485,Akinap,thrall,576,priest,discipline,12,6,6
38486,Seléne,tichondrius,576,priest,discipline,12,6,6
38487,Neep,turalyon,576,priest,discipline,12,6,6
38488,Rëy,bleeding-hollow,576,priest,discipline,12,6,6
38489,Tcfx,bleeding-hollow,576,priest,discipline,12,6,6
38490,Ikancastt,tichondrius,576,priest,discipline,12,6,6
38491,Kurtx,tichondrius,576,priest,discipline,12,6,6
38492,Kabutta,stormrage,576,priest,discipline,12,6,6
38493,Wøah,stormrage,576,priest,discipline,12,6,6
38494,Scrublahr,the-venture-co,576,priest,discipline,12,6,6
38495,Priesterson,tichondrius,576,priest,discipline,12,6,6
38496,Hereges,azralon,576,priest,discipline,12,6,6
38497,Raakun,stormrage,576,priest,discipline,12,6,6
38498,Taviesh,tichondrius,576,priest,discipline,12,6,6
38499,Datwunguy,sargeras,576,priest,discipline,12,6,6
38500,Obstetrician,tichondrius,576,priest,discipline,12,6,6
38501,Scripture,stormreaver,576,priest,discipline,12,6,6
38502,Purpskurp,stormrage,576,priest,discipline,12,6,6
38503,Helacia,jubeithos,576,priest,discipline,12,6,6
38504,Dimebahg,mugthol,576,priest,discipline,12,6,6
38505,Ereessea,hyjal,576,priest,discipline,12,6,6
38506,Moselol,tichondrius,576,priest,discipline,12,6,6
38507,Nokzo,dalaran,576,priest,discipline,12,6,6
38508,Electricdisc,korgath,576,priest,discipline,12,6,6
38509,Twinkøgøâøàd,azralon,576,priest,discipline,12,6,6
38510,Kzo,gnomeregan,576,priest,discipline,12,6,6
38511,Thelastfight,frostmourne,576,priest,discipline,12,6,6
38512,Ruinr,illidan,576,priest,discipline,12,6,6
38513,Bìgdisc,sargeras,576,priest,discipline,12,6,6
38514,Amphion,skullcrusher,576,priest,discipline,12,6,6
38515,Fatherjohnny,azuremyst,576,priest,discipline,12,6,6
38516,Puritykitty,zuljin,576,priest,discipline,12,6,6
38517,Johnio,tichondrius,576,priest,discipline,12,6,6
38518,Babburger,tichondrius,576,priest,discipline,12,6,6
38519,Velýs,moon-guard,576,priest,discipline,12,6,6
38520,Ripret,tichondrius,576,priest,discipline,12,6,6
38521,Wabie,illidan,576,priest,discipline,12,6,6
38522,Moqoro,azralon,576,priest,discipline,12,6,6
38523,Nethir,moon-guard,576,priest,discipline,12,6,6
38524,Prostrat,deathwing,576,priest,discipline,12,6,6
38525,Xiaochenchen,tichondrius,576,priest,discipline,12,6,6
38526,Treri,bleeding-hollow,576,priest,discipline,12,6,6
38527,Stat,thrall,576,priest,discipline,12,6,6
38528,Lisau,tichondrius,576,priest,discipline,12,6,6
38529,Saelomism,frostmourne,576,priest,discipline,12,6,6
38530,Raichu,blackrock,576,priest,discipline,12,6,6
38531,Riasgremøry,stormrage,576,priest,discipline,12,6,6
38532,Panikâ,thrall,576,priest,discipline,12,6,6
38533,Bernietopper,tichondrius,576,priest,discipline,12,6,6
38534,Annuli,stormrage,576,priest,discipline,12,6,6
38535,Yannigirl,area-52,576,priest,discipline,12,6,6
38536,Instaboned,sargeras,576,priest,discipline,12,6,6
38537,Boppdot,tichondrius,576,priest,discipline,12,6,6
38538,Bigsàd,proudmoore,576,priest,discipline,12,6,6
38539,Slouch,emerald-dream,576,priest,discipline,12,6,6
38540,Stankychimpo,malganis,576,priest,discipline,12,6,6
38541,Rin,ghostlands,576,priest,discipline,12,6,6
38542,Jrøc,sargeras,576,priest,discipline,12,6,6
38543,Wodpriestx,stormrage,576,priest,discipline,12,6,6
38544,Padrë,tichondrius,576,priest,discipline,12,6,6
38545,Bloodfaith,stormrage,576,priest,discipline,12,6,6
38546,Photicz,malganis,576,priest,discipline,12,6,6
38547,Bootypudding,moon-guard,576,priest,discipline,12,6,6
38548,Bumps,zuljin,576,priest,discipline,12,6,6
38549,Mediterranee,tichondrius,576,priest,discipline,12,6,6
38550,Kawasakix,tichondrius,576,priest,discipline,12,6,6
38551,Shwayp,zuljin,576,priest,discipline,12,6,6
38552,Skiza,stormrage,576,priest,discipline,12,6,6
38553,Armour,kelthuzad,576,priest,discipline,12,6,6
38554,Warlocks,lightbringer,576,priest,discipline,12,6,6
38555,Capriestsunx,malfurion,576,priest,discipline,12,6,6
38556,Saintjpii,tichondrius,576,priest,discipline,12,6,6
38557,Zaperama,tichondrius,576,priest,discipline,12,6,6
38558,Keldrii,sentinels,576,priest,discipline,12,6,6
38559,Syncope,garona,576,priest,discipline,12,6,6
38560,Randyortonn,tichondrius,576,priest,discipline,12,6,6
38561,Rïshloo,ragnaros,576,priest,discipline,12,6,6
38562,Redkiwi,illidan,576,priest,discipline,12,6,6
38563,Intrav,malganis,576,priest,discipline,12,6,6
38564,Chaotikx,kelthuzad,576,priest,discipline,12,6,6
38565,Saviorsëlf,tichondrius,576,priest,discipline,12,6,6
38566,Hínáta,kelthuzad,576,priest,discipline,12,6,6
38567,Imfresh,illidan,576,priest,discipline,12,6,6
38568,Darkinfusion,illidan,576,priest,discipline,12,6,6
38569,Asleep,sargeras,576,priest,discipline,12,6,6
38570,Astralshadow,barthilas,576,priest,discipline,12,6,6
38571,Chicoryx,illidan,576,priest,discipline,12,6,6
38572,Priil,emerald-dream,576,priest,discipline,12,6,6
38573,Inukimi,sargeras,576,priest,discipline,12,6,6
38574,Aenai,sargeras,576,priest,discipline,12,6,6
38575,Mayineedruid,ragnaros,576,priest,discipline,17,8,9
38576,Holytickles,stormrage,576,priest,discipline,15,7,8
38577,Bigfirebet,tichondrius,576,priest,discipline,15,7,8
38578,Preyforme,tichondrius,576,priest,discipline,13,6,7
38579,Holytitanzz,quelthalas,576,priest,discipline,16,7,9
38580,Speedboat,frostmourne,576,priest,discipline,14,6,8
38581,Mayzal,emerald-dream,576,priest,discipline,24,9,15
38582,Fiéstah,illidan,576,priest,discipline,21,7,14
38583,Priestmass,dalaran,576,priest,discipline,18,6,12
38584,Dgpriest,tichondrius,576,priest,discipline,18,6,12
38585,Junethegreat,tichondrius,576,priest,discipline,18,6,12
38586,Lildes,tichondrius,576,priest,discipline,18,6,12
38587,Dots,tichondrius,576,priest,discipline,18,6,12
38588,Ershackleton,illidan,576,priest,discipline,18,6,12
38589,Slimshadylp,illidan,576,priest,discipline,18,6,12
38590,Komicks,tichondrius,576,priest,discipline,18,6,12
38591,Purifyhoes,sargeras,576,priest,discipline,18,6,12
38592,Sojang,tichondrius,576,priest,discipline,18,6,12
38593,Synaptikk,proudmoore,576,priest,discipline,18,6,12
38594,Decokim,tichondrius,576,priest,discipline,18,6,12
38595,Drossv,shadowmoon,576,priest,discipline,18,6,12
38596,Fartnutts,dalaran,576,priest,discipline,18,6,12
38597,Fadedhalo,magtheridon,576,priest,discipline,18,6,12
38598,Averages,stormrage,576,priest,discipline,18,6,12
38599,Peaky,moonrunner,576,priest,discipline,18,6,12
38600,Jarzo,thunderhorn,576,priest,discipline,18,6,12
38601,Nupanda,tichondrius,576,priest,discipline,18,6,12
38602,Sandelios,aggramar,576,priest,discipline,18,6,12
38603,Keepsleepin,stormrage,576,priest,discipline,18,6,12
38604,Stepbrohelp,barthilas,576,priest,discipline,18,6,12
38605,Pekeatz,tichondrius,576,priest,discipline,18,6,12
38606,Oymay,illidan,576,priest,discipline,18,6,12
38607,Çørrúptíøñz,tichondrius,576,priest,discipline,18,6,12
38608,Plztrainme,spinebreaker,576,priest,discipline,18,6,12
38609,Spøokz,stormreaver,576,priest,discipline,18,6,12
38610,Xpenance,ragnaros,576,priest,discipline,18,6,12
38611,Asmødeus,bleeding-hollow,576,priest,discipline,18,6,12
38612,Fearles,thrall,576,priest,discipline,18,6,12
38613,Goobiesz,tichondrius,576,priest,discipline,18,6,12
38614,Snupyfangirl,area-52,576,priest,discipline,18,6,12
38615,Slthrysnake,area-52,576,priest,discipline,18,6,12
38616,Repriest,malganis,576,priest,discipline,18,6,12
38617,Voldenmort,dragonmaw,576,priest,discipline,18,6,12
38618,Ímgucci,malganis,576,priest,discipline,18,6,12
38619,Starp,tichondrius,576,priest,discipline,18,6,12
38620,Deadlylight,frostmourne,576,priest,discipline,18,6,12
38621,Jiedx,tichondrius,576,priest,discipline,18,6,12
38622,Thedeadheal,malganis,576,priest,discipline,18,6,12
38623,Mylà,ragnaros,576,priest,discipline,20,6,14
38624,Cûrry,bleeding-hollow,576,priest,discipline,24,6,18
38625,Felixfire,moon-guard,576,priest,discipline,24,6,18
38626,Drupith,dalaran,576,priest,discipline,24,6,18
38627,Bree,area-52,576,priest,discipline,24,6,18
38628,Nachòs,wildhammer,575,priest,discipline,6,6,0
38629,Kephrek,eonar,575,priest,discipline,6,6,0
38630,Astrìx,tichondrius,575,priest,discipline,6,6,0
38631,Aanora,illidan,575,priest,discipline,12,6,6
38632,Gdrf,sargeras,575,priest,discipline,12,6,6
38633,Imhotap,illidan,575,priest,discipline,12,6,6
38634,Hödü,tichondrius,575,priest,discipline,12,6,6
38635,Andriloveyou,barthilas,575,priest,discipline,12,6,6
38636,Brahmin,nazjatar,575,priest,discipline,12,6,6
38637,Supermelt,emerald-dream,575,priest,discipline,12,6,6
38638,Lúçíd,sargeras,575,priest,discipline,12,6,6
38639,Umbramortìs,tichondrius,575,priest,discipline,12,6,6
38640,Shaellito,goldrinn,575,priest,discipline,12,6,6
38641,Chowdä,kiljaeden,575,priest,discipline,12,6,6
38642,Wickedmoon,emerald-dream,575,priest,discipline,12,6,6
38643,Akapegando,ragnaros,575,priest,discipline,12,6,6
38644,Mcfluffin,aggramar,575,priest,discipline,12,6,6
38645,Nejisaiyan,sargeras,575,priest,discipline,12,6,6
38646,Spiritbear,thrall,575,priest,discipline,12,6,6
38647,Siabo,tichondrius,575,priest,discipline,12,6,6
38648,Forroc,stormrage,575,priest,discipline,12,6,6
38649,Juress,area-52,575,priest,discipline,12,6,6
38650,Uncensøred,tichondrius,575,priest,discipline,12,6,6
38651,Trienolone,emerald-dream,575,priest,discipline,12,6,6
38652,Amgen,bleeding-hollow,575,priest,discipline,12,6,6
38653,Haedn,azralon,575,priest,discipline,12,6,6
38654,Swaptohealer,misha,575,priest,discipline,12,6,6
38655,Nevertelsp,malganis,575,priest,discipline,12,6,6
38656,Spaddox,arathor,575,priest,discipline,12,6,6
38657,Khaibit,stormrage,575,priest,discipline,12,6,6
38658,Nineoneone,kilrogg,575,priest,discipline,12,6,6
38659,Nordheal,stormrage,575,priest,discipline,12,6,6
38660,Pulso,area-52,575,priest,discipline,12,6,6
38661,Moarhaste,kelthuzad,575,priest,discipline,12,6,6
38662,Paqwee,tichondrius,575,priest,discipline,12,6,6
38663,Herzattacken,malganis,575,priest,discipline,12,6,6
38664,Silveri,thrall,575,priest,discipline,12,6,6
38665,Eclipsos,dalaran,575,priest,discipline,12,6,6
38666,Pinaybebe,kiljaeden,575,priest,discipline,12,6,6
38667,Peeinbottles,stormrage,575,priest,discipline,16,7,9
38668,Biltpeter,tichondrius,575,priest,discipline,15,6,9
38669,Whoôx,khazgoroth,575,priest,discipline,17,6,11
38670,Mortaroth,doomhammer,575,priest,discipline,18,6,12
38671,Villageidiot,lightbringer,575,priest,discipline,18,6,12
38672,Snuzziest,darkspear,575,priest,discipline,18,6,12
38673,Scenekîd,moon-guard,575,priest,discipline,18,6,12
38674,Runecarver,anvilmar,575,priest,discipline,18,6,12
38675,Beymax,moon-guard,575,priest,discipline,24,6,18
38676,Baldpate,tichondrius,575,priest,discipline,24,6,18
38677,Epicaah,quelthalas,574,priest,discipline,12,6,6
38678,Chalmersyo,tichondrius,574,priest,discipline,12,6,6
38679,Mikol,eredar,574,priest,discipline,12,6,6
38680,Evilmajor,icecrown,574,priest,discipline,12,6,6
38681,Wilita,drakkari,574,priest,discipline,12,6,6
38682,Senareyn,thrall,574,priest,discipline,12,6,6
38683,Darkphoxy,azralon,574,priest,discipline,12,6,6
38684,Tenchü,azralon,574,priest,discipline,18,6,12
38685,Papadarkness,tichondrius,574,priest,discipline,24,6,18
38686,Mezervescent,thrall,574,priest,discipline,24,6,18
38687,Prebruisz,baelgun,573,priest,discipline,12,6,6
38688,Axhia,dentarg,573,priest,discipline,12,6,6
38689,Fanaeth,arathor,573,priest,discipline,12,6,6
38690,Reilean,sargeras,573,priest,discipline,12,6,6
38691,Myhealz,agamaggan,573,priest,discipline,12,6,6
38692,Ságrádá,area-52,573,priest,discipline,12,6,6
38693,Naimillia,stormrage,573,priest,discipline,18,6,12
38694,Izzymariepie,dragonmaw,573,priest,discipline,18,6,12
38695,Banepriest,sargeras,573,priest,discipline,18,6,12
38696,Phantoms,moon-guard,573,priest,discipline,18,6,12
38697,Bigchip,sargeras,573,priest,discipline,24,6,18
38698,Aragingclue,burning-legion,572,priest,discipline,12,6,6
38699,Marpi,quelthalas,572,priest,discipline,24,6,18
38700,Voidlordd,kelthuzad,571,priest,discipline,12,6,6
38701,Trialla,medivh,571,priest,discipline,18,6,12
38702,Grandraf,dreadmaul,570,priest,discipline,12,6,6
38703,Zanyp,akama,570,priest,discipline,18,6,12
38704,Eumalfa,dalaran,567,priest,discipline,12,6,6
38705,Antipreist,bonechewer,567,priest,discipline,12,6,6
38706,Gwynne,barthilas,559,priest,discipline,11,6,5
38707,Adeptphd,tichondrius,559,priest,discipline,23,6,17
38708,Garyhooves,zuljin,558,priest,discipline,17,6,11
38709,Justfaith,barthilas,558,priest,discipline,17,6,11
38710,Zeno,haomarush,557,priest,discipline,11,6,5
38711,Gringotaco,tichondrius,554,priest,discipline,26,9,17
38712,Ãdolfhealer,dalaran,544,priest,discipline,10,7,3
38713,Flavorgrave,tichondrius,544,priest,discipline,16,6,10
38714,Zaroff,turalyon,543,priest,discipline,11,6,5
38715,Awaken81B7AE,illidan,543,priest,discipline,17,6,11
38716,Mørbol,tichondrius,541,priest,discipline,20,7,13
38717,Moonlightx,destromath,528,priest,discipline,9,7,2
38718,Tealien,dalaran,527,priest,discipline,11,6,5
38719,Quartzolio,azralon,527,priest,discipline,17,6,11
38720,Pasquell,emerald-dream,526,priest,discipline,11,6,5
38721,Nosgoróth,quelthalas,522,priest,discipline,13,7,6
38722,Mesiausx,stormrage,522,priest,discipline,14,7,7
38723,Dotdotdead,earthen-ring,522,priest,discipline,16,7,9
38724,Balikina,stormrage,521,priest,discipline,17,7,10
38725,Onahaihu,tichondrius,521,priest,discipline,20,7,13
38726,Bhavu,tichondrius,521,priest,discipline,22,7,15
38727,Identìty,moon-guard,521,priest,discipline,28,7,21
38728,Øçñæøæçñøñçæ,sargeras,520,priest,discipline,12,7,5
38729,Ethari,crushridge,520,priest,discipline,21,7,14
38730,Safewurd,sargeras,511,priest,discipline,8,6,2
38731,Smíght,thrall,511,priest,discipline,11,6,5
38732,Enphý,quelthalas,511,priest,discipline,11,6,5
38733,Jinxheal,tichondrius,511,priest,discipline,14,6,8
38734,Bigtang,kiljaeden,511,priest,discipline,14,6,8
38735,Lilmad,stormrage,511,priest,discipline,20,6,14
38736,Germanica,area-52,509,priest,discipline,32,11,21
38737,Horridheals,shandris,505,priest,discipline,10,6,4
38738,Ibangedaqt,malganis,497,priest,discipline,29,12,17
38739,Earys,ragnaros,496,priest,discipline,22,6,16
38740,Aquandrelea,aegwynn,495,priest,discipline,7,6,1
38741,Leist,ragnaros,495,priest,discipline,11,6,5
38742,Yait,tichondrius,495,priest,discipline,14,7,7
38743,Silverspöön,bleeding-hollow,495,priest,discipline,13,6,7
38744,Pertril,stormrage,480,priest,discipline,6,5,1
38745,Emiyawagrano,tichondrius,480,priest,discipline,6,5,1
38746,Aetonyx,anvilmar,480,priest,discipline,6,5,1
38747,Corov,korgath,480,priest,discipline,6,5,1
38748,Káldorei,proudmoore,480,priest,discipline,6,5,1
38749,Hansa,ragnaros,480,priest,discipline,6,5,1
38750,Stegp,kelthuzad,480,priest,discipline,6,5,1
38751,Shadowgïrl,azralon,480,priest,discipline,6,5,1
38752,Elitejustin,area-52,480,priest,discipline,6,5,1
38753,Deathdreamer,azjolnerub,480,priest,discipline,6,5,1
38754,Kazedx,barthilas,480,priest,discipline,6,5,1
38755,Deacoderx,area-52,480,priest,discipline,6,5,1
38756,Dzikuss,aegwynn,480,priest,discipline,6,5,1
38757,Kénnypowers,tichondrius,480,priest,discipline,6,5,1
38758,Sharkbones,tichondrius,480,priest,discipline,6,5,1
38759,Hateutoo,sargeras,480,priest,discipline,6,5,1
38760,Kardinalkeso,frostmourne,480,priest,discipline,6,5,1
38761,Sixnoh,moonrunner,480,priest,discipline,6,5,1
38762,Phantømz,zuljin,480,priest,discipline,6,5,1
38763,Armanp,hyjal,480,priest,discipline,6,5,1
38764,Cxmplex,malganis,480,priest,discipline,6,5,1
38765,Uncletouchy,illidan,480,priest,discipline,6,5,1
38766,Danawhitex,thrall,480,priest,discipline,6,5,1
38767,Xorriz,bleeding-hollow,480,priest,discipline,6,5,1
38768,Privx,bleeding-hollow,480,priest,discipline,6,5,1
38769,Bulleitrye,emerald-dream,480,priest,discipline,6,5,1
38770,Thugliffe,frostmourne,480,priest,discipline,6,5,1
38771,Bebyyourside,malganis,480,priest,discipline,6,5,1
38772,Kumzamboni,dalaran,480,priest,discipline,6,5,1
38773,Xxmewo,sargeras,480,priest,discipline,6,5,1
38774,Noite,azralon,480,priest,discipline,6,5,1
38775,Unishooter,illidan,480,priest,discipline,6,5,1
38776,Djd,frostmourne,480,priest,discipline,6,5,1
38777,Nawtyforever,tichondrius,480,priest,discipline,6,5,1
38778,Mercedés,alleria,480,priest,discipline,6,5,1
38779,Pèngotnerfed,exodar,480,priest,discipline,6,5,1
38780,Imwithham,tichondrius,480,priest,discipline,10,6,4
38781,Aelriah,thrall,480,priest,discipline,12,5,7
38782,Sabela,moon-guard,480,priest,discipline,12,5,7
38783,Hopenä,dragonmaw,480,priest,discipline,12,5,7
38784,Iforted,sargeras,480,priest,discipline,12,5,7
38785,Alleeyy,tichondrius,480,priest,discipline,12,5,7
38786,Scyndar,bonechewer,480,priest,discipline,12,5,7
38787,Soulbane,frostmourne,480,priest,discipline,12,5,7
38788,Icarryozz,darkspear,480,priest,discipline,12,5,7
38789,Shadowcrash,zuljin,480,priest,discipline,12,5,7
38790,Rofrofmu,aegwynn,480,priest,discipline,12,5,7
38791,Lourrdz,tichondrius,480,priest,discipline,12,5,7
38792,Krazyapollo,tichondrius,480,priest,discipline,12,5,7
38793,Lchcl,tichondrius,480,priest,discipline,12,5,7
38794,Hotdice,bleeding-hollow,480,priest,discipline,12,5,7
38795,Tarwow,moon-guard,480,priest,discipline,12,5,7
38796,Toonahx,area-52,480,priest,discipline,12,5,7
38797,Giraffebaitt,zuljin,480,priest,discipline,12,5,7
38798,Ellipsiz,area-52,480,priest,discipline,12,5,7
38799,Cw,wildhammer,480,priest,discipline,12,5,7
38800,Anellas,sargeras,480,priest,discipline,12,5,7
38801,Yaheals,gorefiend,480,priest,discipline,12,5,7
38802,Altaeres,tichondrius,480,priest,discipline,12,5,7
38803,Seraphang,stormrage,480,priest,discipline,12,5,7
38804,Yauntoo,tichondrius,480,priest,discipline,12,5,7
38805,Lingt,drakkari,480,priest,discipline,12,5,7
38806,Makeshiftz,zuljin,480,priest,discipline,12,5,7
38807,Raslin,bonechewer,480,priest,discipline,12,5,7
38808,Discogs,frostmourne,480,priest,discipline,12,5,7
38809,Beetrap,wyrmrest-accord,480,priest,discipline,12,5,7
38810,Shwrma,bleeding-hollow,480,priest,discipline,12,5,7
38811,Voidquil,bonechewer,480,priest,discipline,12,5,7
38812,Whosjoe,tichondrius,480,priest,discipline,12,5,7
38813,Hello,tichondrius,480,priest,discipline,12,5,7
38814,Hotlink,daggerspine,480,priest,discipline,12,5,7
38815,Idryn,quelthalas,480,priest,discipline,12,5,7
38816,Shôta,kelthuzad,480,priest,discipline,12,5,7
38817,Inflate,frostmourne,480,priest,discipline,12,5,7
38818,Shelfedelf,gurubashi,480,priest,discipline,12,5,7
38819,Shädyönë,tichondrius,480,priest,discipline,12,5,7
38820,Castholy,nordrassil,480,priest,discipline,12,5,7
38821,Vyrah,area-52,480,priest,discipline,12,5,7
38822,Piffbadar,tichondrius,480,priest,discipline,12,5,7
38823,Jmanhealz,stormrage,480,priest,discipline,12,5,7
38824,Supernamp,sargeras,480,priest,discipline,12,5,7
38825,Spîteful,illidan,480,priest,discipline,12,5,7
38826,Angelvoid,chogall,480,priest,discipline,12,5,7
38827,Kurahashe,moon-guard,480,priest,discipline,12,5,7
38828,Gudóngmae,stormrage,480,priest,discipline,12,5,7
38829,Serenderpity,moon-guard,480,priest,discipline,12,5,7
38830,Ptam,tichondrius,480,priest,discipline,12,5,7
38831,Blackdeathx,tichondrius,480,priest,discipline,12,5,7
38832,Feyns,illidan,480,priest,discipline,12,5,7
38833,Fancycorpse,tichondrius,480,priest,discipline,12,5,7
38834,Tommyjr,tichondrius,480,priest,discipline,12,5,7
38835,Raeana,area-52,480,priest,discipline,12,5,7
38836,Townbicyclé,area-52,480,priest,discipline,12,5,7
38837,Eltanji,wyrmrest-accord,480,priest,discipline,12,5,7
38838,Lastbubble,area-52,480,priest,discipline,12,5,7
38839,Mistify,bleeding-hollow,480,priest,discipline,12,5,7
38840,Dweem,stormrage,480,priest,discipline,12,5,7
38841,Powerwordkfc,kelthuzad,480,priest,discipline,12,5,7
38842,Alpacasama,illidan,480,priest,discipline,12,5,7
38843,Wreklol,sargeras,480,priest,discipline,12,5,7
38844,Tigawoods,khaz-modan,480,priest,discipline,12,5,7
38845,Tòxìç,stormrage,480,priest,discipline,12,5,7
38846,Widewinks,thrall,480,priest,discipline,12,5,7
38847,Pillowfinger,illidan,480,priest,discipline,12,5,7
38848,Knowknows,tichondrius,480,priest,discipline,12,5,7
38849,Azngød,tichondrius,480,priest,discipline,12,5,7
38850,Soll,veknilash,480,priest,discipline,12,5,7
38851,Thadopepope,tichondrius,480,priest,discipline,12,5,7
38852,Justgoon,tichondrius,480,priest,discipline,12,5,7
38853,Canswersp,sargeras,480,priest,discipline,12,5,7
38854,Jackymv,kelthuzad,480,priest,discipline,12,5,7
38855,Goonie,spirestone,480,priest,discipline,12,5,7
38856,Vérse,stormrage,480,priest,discipline,12,5,7
38857,Istvala,zuljin,480,priest,discipline,12,5,7
38858,Pumice,destromath,480,priest,discipline,12,5,7
38859,Imhðtep,ragnaros,480,priest,discipline,12,5,7
38860,Meatytrash,area-52,480,priest,discipline,12,5,7
38861,Augus,velen,480,priest,discipline,12,5,7
38862,Derisha,ragnaros,480,priest,discipline,12,5,7
38863,Technetium,illidan,480,priest,discipline,12,5,7
38864,Amperx,wyrmrest-accord,480,priest,discipline,12,5,7
38865,Gstvsrrn,tichondrius,480,priest,discipline,12,5,7
38866,Saucelord,barthilas,480,priest,discipline,12,5,7
38867,Kopipriest,barthilas,480,priest,discipline,12,5,7
38868,Humblemumble,barthilas,480,priest,discipline,12,5,7
38869,Typhia,moon-guard,480,priest,discipline,12,5,7
38870,Barrist,wyrmrest-accord,480,priest,discipline,12,5,7
38871,Fatalpush,moon-guard,480,priest,discipline,12,5,7
38872,Younext,sargeras,480,priest,discipline,12,5,7
38873,Stambuff,tichondrius,480,priest,discipline,12,5,7
38874,Yukishield,illidan,480,priest,discipline,12,5,7
38875,Starzard,kelthuzad,480,priest,discipline,12,5,7
38876,Vikks,tichondrius,480,priest,discipline,12,5,7
38877,Mikes,sargeras,480,priest,discipline,12,5,7
38878,Robbailey,dalvengyr,480,priest,discipline,12,5,7
38879,Mywifesaidno,sargeras,480,priest,discipline,12,5,7
38880,Stunzeed,staghelm,480,priest,discipline,12,5,7
38881,Taikosqt,azralon,480,priest,discipline,12,5,7
38882,Htx,dunemaul,480,priest,discipline,12,5,7
38883,Drmattydubz,tichondrius,480,priest,discipline,12,5,7
38884,Thiella,azralon,480,priest,discipline,12,5,7
38885,Harrygazm,shattered-hand,480,priest,discipline,12,5,7
38886,Bluffzp,boulderfist,480,priest,discipline,12,5,7
38887,Apbrady,sargeras,480,priest,discipline,12,5,7
38888,Yujawang,sargeras,480,priest,discipline,12,5,7
38889,Äpriest,sargeras,480,priest,discipline,12,5,7
38890,Shadowjisha,emerald-dream,480,priest,discipline,12,5,7
38891,Kallenk,proudmoore,480,priest,discipline,12,5,7
38892,Gatty,kiljaeden,480,priest,discipline,13,5,8
38893,Jedmosby,korgath,480,priest,discipline,14,5,9
38894,Pasher,sargeras,480,priest,discipline,18,5,13
38895,Healiesuwu,kiljaeden,480,priest,discipline,18,5,13
38896,Levingurt,darkspear,480,priest,discipline,18,5,13
38897,Bebe,fizzcrank,480,priest,discipline,18,5,13
38898,Kershl,aegwynn,480,priest,discipline,18,5,13
38899,Sypii,stormrage,480,priest,discipline,18,5,13
38900,Ticheals,tichondrius,480,priest,discipline,18,5,13
38901,Sevenlions,stormrage,480,priest,discipline,18,5,13
38902,Cheekypriest,stormrage,480,priest,discipline,18,5,13
38903,Jahratu,tichondrius,480,priest,discipline,18,5,13
38904,Ollarlamente,zuljin,480,priest,discipline,18,5,13
38905,Vetisrx,thrall,480,priest,discipline,18,5,13
38906,Klerick,kiljaeden,480,priest,discipline,18,5,13
38907,Touchèr,sargeras,480,priest,discipline,18,5,13
38908,Ludens,bleeding-hollow,480,priest,discipline,18,5,13
38909,Aguadejamica,tichondrius,480,priest,discipline,18,5,13
38910,Kark,tichondrius,480,priest,discipline,18,5,13
38911,Mustyfribble,korgath,480,priest,discipline,18,5,13
38912,Georgepells,barthilas,480,priest,discipline,24,5,19
38913,Remixcandoit,malganis,479,priest,discipline,6,5,1
38914,Krisdavra,thrall,479,priest,discipline,6,5,1
38915,Confuses,area-52,479,priest,discipline,6,5,1
38916,Tonymòntana,area-52,479,priest,discipline,6,5,1
38917,Bossay,icecrown,479,priest,discipline,6,5,1
38918,Syrissa,thrall,479,priest,discipline,6,5,1
38919,Sevioletté,wyrmrest-accord,479,priest,discipline,6,5,1
38920,Priuhpism,tichondrius,479,priest,discipline,6,5,1
38921,Sanaconda,sargeras,479,priest,discipline,7,5,2
38922,Berzum,chogall,479,priest,discipline,10,6,4
38923,Grudgin,turalyon,479,priest,discipline,11,6,5
38924,Clerical,skullcrusher,479,priest,discipline,12,5,7
38925,Preesia,misha,479,priest,discipline,12,5,7
38926,Tubelight,sargeras,479,priest,discipline,12,5,7
38927,Pandaball,frostwolf,479,priest,discipline,12,5,7
38928,Mistnamed,emerald-dream,479,priest,discipline,12,5,7
38929,Chadlyfe,tichondrius,479,priest,discipline,12,5,7
38930,Atheíst,tichondrius,479,priest,discipline,12,5,7
38931,Photogirl,area-52,479,priest,discipline,12,5,7
38932,Azhaell,quelthalas,479,priest,discipline,12,5,7
38933,Ibuyfeetpics,tichondrius,479,priest,discipline,12,5,7
38934,Aalicya,tanaris,479,priest,discipline,12,5,7
38935,Coldvb,barthilas,479,priest,discipline,12,5,7
38936,Gaaq,stormrage,479,priest,discipline,12,5,7
38937,Krynoobz,senjin,479,priest,discipline,12,5,7
38938,Techninë,chogall,479,priest,discipline,12,5,7
38939,Drayen,korgath,479,priest,discipline,12,5,7
38940,Averageheals,stormrage,479,priest,discipline,12,5,7
38941,Fadêd,wildhammer,479,priest,discipline,12,5,7
38942,Kelody,zuljin,479,priest,discipline,12,5,7
38943,Greatzapan,tichondrius,479,priest,discipline,12,5,7
38944,Omgimissher,black-dragonflight,479,priest,discipline,12,5,7
38945,Mythine,moon-guard,479,priest,discipline,12,5,7
38946,Vynthorian,frostmourne,479,priest,discipline,12,5,7
38947,Selea,frostwolf,479,priest,discipline,12,5,7
38948,Frazzysparks,stormrage,479,priest,discipline,12,5,7
38949,Torrantt,bonechewer,479,priest,discipline,12,5,7
38950,Xenedart,quelthalas,479,priest,discipline,12,5,7
38951,Demished,zuljin,479,priest,discipline,12,5,7
38952,Dabrat,darkspear,479,priest,discipline,18,6,12
38953,Goodboyyoshi,tichondrius,479,priest,discipline,15,5,10
38954,Crusifixx,tichondrius,479,priest,discipline,18,5,13
38955,Cxview,sargeras,479,priest,discipline,18,5,13
38956,Wort,cairne,479,priest,discipline,18,5,13
38957,Asmitä,stormrage,479,priest,discipline,24,5,19
38958,Pylenn,emerald-dream,478,priest,discipline,12,5,7
38959,Ansgar,eonar,478,priest,discipline,12,5,7
38960,Liñkzq,frostmourne,478,priest,discipline,12,5,7
38961,Invisibler,tichondrius,478,priest,discipline,24,5,19
38962,Pingleangel,tichondrius,477,priest,discipline,12,5,7
38963,Solzal,korgath,477,priest,discipline,12,5,7
38964,Goldenlilly,moon-guard,477,priest,discipline,18,5,13
38965,Laydrel,sargeras,476,priest,discipline,12,5,7
38966,Lotzofhealz,wyrmrest-accord,476,priest,discipline,12,5,7
38967,Rescueworker,kelthuzad,473,priest,discipline,12,5,7
38968,Divinebones,gurubashi,473,priest,discipline,18,5,13
38969,Forober,queldorei,466,priest,discipline,39,14,25
38970,Devivi,malganis,463,priest,discipline,11,5,6
38971,Thehealinck,magtheridon,448,priest,discipline,10,5,5
38972,Faíthless,sargeras,447,priest,discipline,11,5,6
38973,Shadowkr,tichondrius,447,priest,discipline,11,5,6
38974,Hungzilla,malganis,447,priest,discipline,11,5,6
38975,Ihazhealzz,area-52,447,priest,discipline,11,5,6
38976,Darkascended,arthas,447,priest,discipline,14,6,8
38977,Guillotinee,ragnaros,447,priest,discipline,13,5,8
38978,Cuisino,tichondrius,446,priest,discipline,11,5,6
38979,Gnepe,sargeras,441,priest,discipline,17,7,10
38980,Sorzartluz,malganis,432,priest,discipline,9,6,3
38981,Proftimothy,tichondrius,432,priest,discipline,15,6,9
38982,Agrotothemax,tichondrius,432,priest,discipline,15,5,10
38983,Fxxkdamn,tichondrius,432,priest,discipline,21,6,15
38984,Nefastó,ragnaros,431,priest,discipline,12,6,6
38985,Bérzerk,dalvengyr,431,priest,discipline,11,5,6
38986,Frenchfries,sargeras,431,priest,discipline,11,5,6
38987,Texmix,stormrage,431,priest,discipline,21,6,15
38988,Shadowbishop,barthilas,427,priest,discipline,12,7,5
38989,Divìne,kiljaeden,426,priest,discipline,12,6,6
38990,Stickheal,tichondrius,425,priest,discipline,13,6,7
38991,Thøt,malganis,420,priest,discipline,14,6,8
38992,Discshady,tichondrius,416,priest,discipline,10,5,5
38993,Iloveshannon,stormrage,415,priest,discipline,8,5,3
38994,Felyreilyana,caelestrasz,415,priest,discipline,11,5,6
38995,Kuwapre,proudmoore,415,priest,discipline,14,6,8
38996,Mooray,thrall,415,priest,discipline,14,5,9
38997,Ramsakz,proudmoore,413,priest,discipline,10,5,5
38998,Esredarksun,sargeras,412,priest,discipline,16,5,11
38999,Whodatpriest,blackhand,399,priest,discipline,5,5,0
39000,Normill,bonechewer,399,priest,discipline,7,5,2
39001,Bunked,bleeding-hollow,392,priest,discipline,23,7,16
39002,Soupbeanx,zuljin,384,priest,discipline,6,4,2
39003,Granger,senjin,384,priest,discipline,6,4,2
39004,Norbert,zuljin,384,priest,discipline,6,4,2
39005,Ahleven,tichondrius,384,priest,discipline,6,4,2
39006,Pprriieesst,tichondrius,384,priest,discipline,6,4,2
39007,Aerlinn,tichondrius,384,priest,discipline,6,4,2
39008,Anasuzana,zuljin,384,priest,discipline,6,4,2
39009,Thugish,frostwolf,384,priest,discipline,6,4,2
39010,Fûsoya,zuljin,384,priest,discipline,6,4,2
39011,Pollitoasado,tichondrius,384,priest,discipline,6,4,2
39012,Bumbleedot,azralon,384,priest,discipline,6,4,2
39013,Taevier,ghostlands,384,priest,discipline,6,4,2
39014,Miniambá,tichondrius,384,priest,discipline,6,4,2
39015,Delloria,stormrage,384,priest,discipline,6,4,2
39016,Silentluna,tichondrius,384,priest,discipline,6,4,2
39017,Uhohmd,senjin,384,priest,discipline,6,4,2
39018,Giyom,tichondrius,384,priest,discipline,6,4,2
39019,Feminizm,tichondrius,384,priest,discipline,6,4,2
39020,Discotec,stormrage,384,priest,discipline,6,4,2
39021,Ritalyn,korgath,384,priest,discipline,6,4,2
39022,Jixxersp,malganis,384,priest,discipline,6,4,2
39023,Healscityy,tichondrius,384,priest,discipline,6,4,2
39024,Relicxz,firetree,384,priest,discipline,6,4,2
39025,Gladexp,tichondrius,384,priest,discipline,6,4,2
39026,Ihealfunny,blood-furnace,384,priest,discipline,6,4,2
39027,Lavigne,tichondrius,384,priest,discipline,6,4,2
39028,Merçy,zuljin,384,priest,discipline,6,4,2
39029,Optimism,frostmane,384,priest,discipline,6,4,2
39030,Otterblast,illidan,384,priest,discipline,6,4,2
39031,Holisticx,tichondrius,384,priest,discipline,6,4,2
39032,Subscribe,khazgoroth,384,priest,discipline,6,4,2
39033,Perkalicious,thrall,384,priest,discipline,6,4,2
39034,Potatopriest,frostmourne,384,priest,discipline,6,4,2
39035,Babe,aerie-peak,384,priest,discipline,6,4,2
39036,Mythuxxz,sargeras,384,priest,discipline,6,4,2
39037,Fadedyourgo,tichondrius,384,priest,discipline,6,4,2
39038,Lilvf,barthilas,384,priest,discipline,6,4,2
39039,Gdlsheretic,sargeras,384,priest,discipline,6,4,2
39040,Crode,bleeding-hollow,384,priest,discipline,6,4,2
39041,Deathrina,moon-guard,384,priest,discipline,6,4,2
39042,Gardiancloun,sargeras,384,priest,discipline,6,4,2
39043,Lithelin,frostmourne,384,priest,discipline,6,4,2
39044,Demongodtren,blackrock,384,priest,discipline,6,4,2
39045,Vladlèna,moon-guard,384,priest,discipline,6,4,2
39046,Tobaiss,arygos,384,priest,discipline,6,4,2
39047,Celanea,bleeding-hollow,384,priest,discipline,6,4,2
39048,Béépboop,tichondrius,384,priest,discipline,6,4,2
39049,Monkeyp,barthilas,384,priest,discipline,6,4,2
39050,Djchickpea,chogall,384,priest,discipline,6,4,2
39051,Blzy,area-52,384,priest,discipline,6,4,2
39052,Celani,gilneas,384,priest,discipline,6,4,2
39053,Mikèp,sargeras,384,priest,discipline,6,4,2
39054,Bubbleboi,malganis,384,priest,discipline,6,4,2
39055,Ghostz,alleria,384,priest,discipline,6,4,2
39056,Leebow,tichondrius,384,priest,discipline,6,4,2
39057,Ranthrough,tichondrius,384,priest,discipline,6,4,2
39058,Auntiegrimm,silvermoon,384,priest,discipline,6,4,2
39059,Uglydiego,quelthalas,384,priest,discipline,6,4,2
39060,Dioecesis,moon-guard,384,priest,discipline,6,4,2
39061,Ðyluxx,blackwater-raiders,384,priest,discipline,6,4,2
39062,Zelenka,whisperwind,384,priest,discipline,6,4,2
39063,Faithx,frostmourne,384,priest,discipline,6,4,2
39064,Hiphopanomis,arthas,384,priest,discipline,6,4,2
39065,Elcidd,tichondrius,384,priest,discipline,6,4,2
39066,Dimedaddy,tichondrius,384,priest,discipline,6,4,2
39067,Xanarcine,moon-guard,384,priest,discipline,6,4,2
39068,Kàobeini,tichondrius,384,priest,discipline,6,4,2
39069,Tosbanned,barthilas,384,priest,discipline,6,4,2
39070,Chü,dalaran,384,priest,discipline,6,4,2
39071,Chambler,aegwynn,384,priest,discipline,6,4,2
39072,Ruems,area-52,384,priest,discipline,6,4,2
39073,Rmpenjoyerx,area-52,384,priest,discipline,6,4,2
39074,Metéora,nemesis,384,priest,discipline,6,4,2
39075,Chemdawwg,aerie-peak,384,priest,discipline,6,4,2
39076,Holylover,illidan,384,priest,discipline,6,4,2
39077,Batface,frostmourne,384,priest,discipline,6,4,2
39078,Discospider,sargeras,384,priest,discipline,6,4,2
39079,Crueldotz,illidan,384,priest,discipline,6,4,2
39080,Flaytality,shadowsong,384,priest,discipline,6,4,2
39081,Yunggawd,illidan,384,priest,discipline,6,4,2
39082,Babygsuss,tichondrius,384,priest,discipline,6,4,2
39083,Otpp,sargeras,384,priest,discipline,6,4,2
39084,Yuntingmingo,tichondrius,384,priest,discipline,6,4,2
39085,Jaxthree,illidan,384,priest,discipline,6,4,2
39086,Dredgeflay,thrall,384,priest,discipline,6,4,2
39087,Äni,sargeras,384,priest,discipline,6,4,2
39088,Epiipen,area-52,384,priest,discipline,6,4,2
39089,Pándamonium,hyjal,384,priest,discipline,6,4,2
39090,Zäán,sargeras,384,priest,discipline,6,4,2
39091,Draehoe,kelthuzad,384,priest,discipline,6,4,2
39092,Popeachini,sargeras,384,priest,discipline,6,4,2
39093,Brácho,ragnaros,384,priest,discipline,6,4,2
39094,Tristanp,frostmourne,384,priest,discipline,6,4,2
39095,Jooback,kelthuzad,384,priest,discipline,6,4,2
39096,Terisar,emerald-dream,384,priest,discipline,6,4,2
39097,Killmeplzz,ragnaros,384,priest,discipline,6,4,2
39098,Papaheal,runetotem,384,priest,discipline,6,4,2
39099,Goyqqp,illidan,384,priest,discipline,6,4,2
39100,Spyderco,mugthol,384,priest,discipline,6,4,2
39101,Mafuyusan,proudmoore,384,priest,discipline,6,4,2
39102,Kwazshell,area-52,384,priest,discipline,7,4,3
39103,Shadp,tichondrius,384,priest,discipline,9,5,4
39104,Deckx,khazgoroth,384,priest,discipline,12,6,6
39105,Judeath,area-52,384,priest,discipline,8,4,4
39106,Brodel,dark-iron,384,priest,discipline,9,4,5
39107,Annoka,sargeras,384,priest,discipline,17,6,11
39108,Juvell,illidan,384,priest,discipline,15,5,10
39109,Nvøsuperstar,zuljin,384,priest,discipline,15,5,10
39110,Keepri,tichondrius,384,priest,discipline,12,4,8
39111,Fatherwyatt,bleeding-hollow,384,priest,discipline,12,4,8
39112,Dogeastwest,tichondrius,384,priest,discipline,12,4,8
39113,Danceofpales,bleeding-hollow,384,priest,discipline,12,4,8
39114,Awesomeguyx,tichondrius,384,priest,discipline,12,4,8
39115,Gokiburiuwu,illidan,384,priest,discipline,12,4,8
39116,Biubiubium,tichondrius,384,priest,discipline,12,4,8
39117,Littlean,frostmourne,384,priest,discipline,12,4,8
39118,Stilgeist,proudmoore,384,priest,discipline,12,4,8
39119,Priestcrys,quelthalas,384,priest,discipline,12,4,8
39120,Darkspearr,tichondrius,384,priest,discipline,12,4,8
39121,Thenamesnorm,tichondrius,384,priest,discipline,12,4,8
39122,Bobolaine,illidan,384,priest,discipline,12,4,8
39123,Vanagør,emerald-dream,384,priest,discipline,12,4,8
39124,Meshuggåh,khazgoroth,384,priest,discipline,12,4,8
39125,Valzzdor,zuljin,384,priest,discipline,12,4,8
39126,Stonemonkeyp,sargeras,384,priest,discipline,12,4,8
39127,Holyshiitzz,illidan,384,priest,discipline,12,4,8
39128,Suzono,hyjal,384,priest,discipline,12,4,8
39129,Gangshet,illidan,384,priest,discipline,12,4,8
39130,Alcoricc,illidan,384,priest,discipline,12,4,8
39131,Hokutos,tichondrius,384,priest,discipline,12,4,8
39132,Wìd,khazgoroth,384,priest,discipline,12,4,8
39133,Vyvivienx,tichondrius,384,priest,discipline,12,4,8
39134,Blighttyy,proudmoore,384,priest,discipline,12,4,8
39135,Cryptoccocus,zuljin,384,priest,discipline,12,4,8
39136,Voidscrypt,thrall,384,priest,discipline,12,4,8
39137,Shookones,malganis,384,priest,discipline,12,4,8
39138,Fades,hellscream,384,priest,discipline,12,4,8
39139,Eilana,tichondrius,384,priest,discipline,12,4,8
39140,Echoos,proudmoore,384,priest,discipline,12,4,8
39141,Daryldeath,tichondrius,384,priest,discipline,12,4,8
39142,Zaylahh,blackrock,384,priest,discipline,12,4,8
39143,Cezzko,tichondrius,384,priest,discipline,12,4,8
39144,Seyler,barthilas,384,priest,discipline,12,4,8
39145,Barclan,destromath,384,priest,discipline,12,4,8
39146,Tangykiwi,dalaran,384,priest,discipline,12,4,8
39147,Crazyfinley,dalaran,384,priest,discipline,12,4,8
39148,Qyotasa,zuljin,384,priest,discipline,12,4,8
39149,Templár,dalaran,384,priest,discipline,12,4,8
39150,Disperse,sargeras,384,priest,discipline,12,4,8
39151,Sugarlorde,destromath,384,priest,discipline,12,4,8
39152,Teehowdie,aegwynn,384,priest,discipline,12,4,8
39153,Lucet,aegwynn,384,priest,discipline,12,4,8
39154,Skydemons,malganis,384,priest,discipline,12,4,8
39155,Xavios,alexstrasza,384,priest,discipline,12,4,8
39156,Azuvah,alexstrasza,384,priest,discipline,12,4,8
39157,Srazul,azralon,384,priest,discipline,12,4,8
39158,Liljunky,zuljin,384,priest,discipline,12,4,8
39159,Jejer,moon-guard,384,priest,discipline,12,4,8
39160,Caèlum,area-52,384,priest,discipline,12,4,8
39161,Satelite,feathermoon,384,priest,discipline,12,4,8
39162,Lenigrast,blackrock,384,priest,discipline,12,4,8
39163,Meekheal,tichondrius,384,priest,discipline,12,4,8
39164,Zafti,laughing-skull,384,priest,discipline,12,4,8
39165,Qtpriestx,tichondrius,384,priest,discipline,12,4,8
39166,Pearlwing,area-52,384,priest,discipline,12,4,8
39167,Laqqet,sargeras,384,priest,discipline,12,4,8
39168,Psyclo,stormrage,384,priest,discipline,12,4,8
39169,Exisa,stormrage,384,priest,discipline,12,4,8
39170,Auttø,area-52,384,priest,discipline,12,4,8
39171,Jån,moon-guard,384,priest,discipline,12,4,8
39172,Insomnya,sargeras,384,priest,discipline,12,4,8
39173,Lankyschlong,frostmourne,384,priest,discipline,12,4,8
39174,Akewnón,stormrage,384,priest,discipline,12,4,8
39175,Billiard,stormrage,384,priest,discipline,12,4,8
39176,Bigarxidia,bleeding-hollow,384,priest,discipline,12,4,8
39177,Hrathren,caelestrasz,384,priest,discipline,12,4,8
39178,Crypticus,nazjatar,384,priest,discipline,12,4,8
39179,Selitos,executus,384,priest,discipline,12,4,8
39180,Amys,kargath,384,priest,discipline,12,4,8
39181,Kepptwo,korgath,384,priest,discipline,12,4,8
39182,Ranksix,area-52,384,priest,discipline,12,4,8
39183,Gooseundead,tichondrius,384,priest,discipline,12,4,8
39184,Holynova,nerzhul,384,priest,discipline,12,4,8
39185,Jonahas,sargeras,384,priest,discipline,12,4,8
39186,Kymil,deathwing,384,priest,discipline,12,4,8
39187,Killä,area-52,384,priest,discipline,12,4,8
39188,Sìrena,tichondrius,384,priest,discipline,12,4,8
39189,Nokhoron,eldrethalas,384,priest,discipline,12,4,8
39190,Skêptic,tichondrius,384,priest,discipline,12,4,8
39191,Sweetskittle,malganis,384,priest,discipline,12,4,8
39192,Huckdaddy,tichondrius,384,priest,discipline,12,4,8
39193,Zenjitsu,quelthalas,384,priest,discipline,12,4,8
39194,Zaphfkiel,ragnaros,384,priest,discipline,12,4,8
39195,Plebiss,burning-blade,384,priest,discipline,12,4,8
39196,Chaxiubao,stormrage,384,priest,discipline,12,4,8
39197,Biop,burning-blade,384,priest,discipline,12,4,8
39198,Zhanay,ragnaros,384,priest,discipline,12,4,8
39199,Urdaisyy,kelthuzad,384,priest,discipline,12,4,8
39200,Nha,stormrage,384,priest,discipline,12,4,8
39201,Discpi,illidan,384,priest,discipline,13,4,9
39202,Gottaheal,blood-furnace,384,priest,discipline,14,4,10
39203,Capixaba,stormrage,384,priest,discipline,18,4,14
39204,Antalian,wyrmrest-accord,384,priest,discipline,18,4,14
39205,Miandel,wildhammer,384,priest,discipline,18,4,14
39206,Disçxrespeçt,cairne,384,priest,discipline,18,4,14
39207,Fatzoid,the-forgotten-coast,384,priest,discipline,18,4,14
39208,Kymohek,sargeras,384,priest,discipline,18,4,14
39209,Diablomonk,warsong,384,priest,discipline,18,4,14
39210,Vikingkøng,ragnaros,384,priest,discipline,18,4,14
39211,Rainms,sargeras,384,priest,discipline,18,4,14
39212,Råd,illidan,384,priest,discipline,18,4,14
39213,Polythis,kelthuzad,384,priest,discipline,18,4,14
39214,Shadowdroid,tichondrius,384,priest,discipline,18,4,14
39215,Chemod,quelthalas,384,priest,discipline,18,4,14
39216,Heilige,uldum,384,priest,discipline,30,4,26
39217,Såviør,suramar,383,priest,discipline,6,4,2
39218,Jonnycanuckz,duskwood,383,priest,discipline,6,4,2
39219,Strithe,kiljaeden,383,priest,discipline,6,4,2
39220,Mirex,tichondrius,383,priest,discipline,6,4,2
39221,Needalung,stormrage,383,priest,discipline,6,4,2
39222,Hopfit,the-underbog,383,priest,discipline,6,4,2
39223,Loffthedabsl,tichondrius,383,priest,discipline,6,4,2
39224,Shialebuff,gundrak,383,priest,discipline,6,4,2
39225,Mythanex,bleeding-hollow,383,priest,discipline,6,4,2
39226,Discodork,bleeding-hollow,383,priest,discipline,6,4,2
39227,Shén,barthilas,383,priest,discipline,6,4,2
39228,Coorslite,proudmoore,383,priest,discipline,6,4,2
39229,Anoxic,kiljaeden,383,priest,discipline,12,4,8
39230,Whatisholy,bleeding-hollow,383,priest,discipline,12,4,8
39231,Bäldùr,moon-guard,383,priest,discipline,12,4,8
39232,Sybal,suramar,383,priest,discipline,12,4,8
39233,Mangaloochi,amanthul,383,priest,discipline,12,4,8
39234,Kimbeloria,bleeding-hollow,383,priest,discipline,12,4,8
39235,Fathergrey,emerald-dream,383,priest,discipline,12,4,8
39236,Ioharusame,quelthalas,383,priest,discipline,17,5,12
39237,Crozuhn,moon-guard,383,priest,discipline,18,4,14
39238,Linndy,illidan,382,priest,discipline,6,4,2
39239,Nocturnimal,grizzly-hills,382,priest,discipline,12,4,8
39240,Bunnychloe,sargeras,381,priest,discipline,12,4,8
39241,Primela,sargeras,381,priest,discipline,12,4,8
39242,Myobi,tichondrius,381,priest,discipline,12,4,8
39243,Mystexo,barthilas,367,priest,discipline,11,4,7
39244,Burtier,zuljin,367,priest,discipline,11,4,7
39245,Valdri,sargeras,367,priest,discipline,11,4,7
39246,Cøwbøycrytøø,azralon,367,priest,discipline,23,4,19
39247,Llaarrkkss,tichondrius,351,priest,discipline,11,4,7
39248,Scrïpt,thaurissan,351,priest,discipline,11,4,7
39249,Mcseven,sargeras,351,priest,discipline,11,4,7
39250,Mêga,illidan,351,priest,discipline,14,5,9
39251,Lightshizzle,illidan,351,priest,discipline,14,5,9
39252,Gamorâ,sargeras,349,priest,discipline,14,5,9
39253,Voidly,illidan,336,priest,discipline,9,5,4
39254,Kefkå,sargeras,336,priest,discipline,9,4,5
39255,Rosabell,ragnaros,336,priest,discipline,21,4,17
39256,Grianné,mannoroth,335,priest,discipline,9,4,5
39257,Siobhin,wyrmrest-accord,335,priest,discipline,11,4,7
39258,Causeoflife,eitrigg,335,priest,discipline,11,4,7
39259,Subvert,zuljin,330,priest,discipline,7,5,2
39260,Nymphomana,tichondrius,330,priest,discipline,10,6,4
39261,Prayanmantis,tichondrius,330,priest,discipline,14,5,9
39262,Takedisdisc,tichondrius,330,priest,discipline,17,6,11
39263,Xiangjiao,tichondrius,330,priest,discipline,17,6,11
39264,Qtgirlsofine,bleeding-hollow,330,priest,discipline,15,5,10
39265,Deeply,tichondrius,330,priest,discipline,17,5,12
39266,Lilgeek,kelthuzad,330,priest,discipline,21,5,16
39267,Mangshadoom,silvermoon,330,priest,discipline,22,5,17
39268,Sacredpatty,frostmane,319,priest,discipline,5,4,1
39269,Maccten,tichondrius,319,priest,discipline,9,5,4
39270,Smarttakka,emerald-dream,319,priest,discipline,8,4,4
39271,Manachai,the-forgotten-coast,319,priest,discipline,14,4,10
39272,Klizzy,tichondrius,319,priest,discipline,14,4,10
39273,Rancidcookie,tichondrius,304,priest,discipline,13,4,9
39274,Kayodee,stormrage,288,priest,discipline,8,4,4
39275,Alladys,shattered-hand,288,priest,discipline,6,3,3
39276,Sabene,greymane,288,priest,discipline,6,3,3
39277,Extremedp,blackwing-lair,288,priest,discipline,6,3,3
39278,Oxicontin,sargeras,288,priest,discipline,6,3,3
39279,Rocq,senjin,288,priest,discipline,6,3,3
39280,Popeofhope,queldorei,288,priest,discipline,6,3,3
39281,Hükk,kalecgos,288,priest,discipline,6,3,3
39282,Xusin,tichondrius,288,priest,discipline,6,3,3
39283,Bgundy,sargeras,288,priest,discipline,6,3,3
39284,Lashelin,sargeras,288,priest,discipline,6,3,3
39285,Midget,darkspear,288,priest,discipline,6,3,3
39286,Chav,kiljaeden,288,priest,discipline,6,3,3
39287,Xuxu,frostmourne,288,priest,discipline,6,3,3
39288,Bigpoppapwn,darkspear,288,priest,discipline,6,3,3
39289,Grafîx,frostmourne,288,priest,discipline,6,3,3
39290,Aia,frostwolf,288,priest,discipline,6,3,3
39291,Zuuji,frostmourne,288,priest,discipline,6,3,3
39292,Khaospriest,proudmoore,288,priest,discipline,6,3,3
39293,Wakandafev,frostmourne,288,priest,discipline,6,3,3
39294,Swollenarms,kiljaeden,288,priest,discipline,6,3,3
39295,Cheesemelt,kiljaeden,288,priest,discipline,6,3,3
39296,Kawesha,emerald-dream,288,priest,discipline,6,3,3
39297,Minatick,sargeras,288,priest,discipline,6,3,3
39298,Nikci,tichondrius,288,priest,discipline,6,3,3
39299,Demonsp,frostmourne,288,priest,discipline,6,3,3
39300,Chazzyy,frostmourne,288,priest,discipline,6,3,3
39301,Nokizzgrizz,sargeras,288,priest,discipline,6,3,3
39302,Guillotine,azralon,288,priest,discipline,6,3,3
39303,Jovon,frostmourne,288,priest,discipline,6,3,3
39304,Oofx,darkspear,288,priest,discipline,6,3,3
39305,Sasagui,bloodscalp,288,priest,discipline,6,3,3
39306,Tmall,tichondrius,288,priest,discipline,6,3,3
39307,Ìdiot,saurfang,288,priest,discipline,6,3,3
39308,Leya,kiljaeden,288,priest,discipline,6,3,3
39309,Illegalkill,tichondrius,288,priest,discipline,6,3,3
39310,Nutdrip,tichondrius,288,priest,discipline,6,3,3
39311,Mks,barthilas,288,priest,discipline,6,3,3
39312,Imjheals,frostmourne,288,priest,discipline,6,3,3
39313,Ìhatermp,tichondrius,288,priest,discipline,6,3,3
39314,Chavvy,tichondrius,288,priest,discipline,6,3,3
39315,Turdsyn,sargeras,288,priest,discipline,6,3,3
39316,Buc,barthilas,288,priest,discipline,6,3,3
39317,Diamondz,emerald-dream,288,priest,discipline,6,3,3
39318,Fure,mannoroth,288,priest,discipline,6,3,3
39319,Quefase,proudmoore,288,priest,discipline,6,3,3
39320,Adelda,nazjatar,288,priest,discipline,6,3,3
39321,Dìngobaby,stormrage,288,priest,discipline,6,3,3
39322,Callèèn,stormrage,288,priest,discipline,6,3,3
39323,Pumpkinpino,stormrage,288,priest,discipline,6,3,3
39324,Benance,tichondrius,288,priest,discipline,6,3,3
39325,Belarra,norgannon,288,priest,discipline,6,3,3
39326,Relianth,stormrage,288,priest,discipline,6,3,3
39327,Imagees,stormscale,288,priest,discipline,6,3,3
39328,Zdarkspeedz,stormrage,288,priest,discipline,6,3,3
39329,Ashidox,proudmoore,288,priest,discipline,6,3,3
39330,Skyfury,darkspear,288,priest,discipline,6,3,3
39331,Edmen,stormrage,288,priest,discipline,6,3,3
39332,Humps,sargeras,288,priest,discipline,6,3,3
39333,Zzavidwong,tichondrius,288,priest,discipline,6,3,3
39334,Coerce,tichondrius,288,priest,discipline,6,3,3
39335,Tethy,saurfang,288,priest,discipline,6,3,3
39336,Tempname,thunderhorn,288,priest,discipline,6,3,3
39337,Fouroneo,tichondrius,288,priest,discipline,6,3,3
39338,Poøpoopeepee,tichondrius,288,priest,discipline,6,3,3
39339,Healyhaney,stormrage,288,priest,discipline,6,3,3
39340,Zeroghp,tichondrius,288,priest,discipline,6,3,3
39341,Kleiâ,tichondrius,288,priest,discipline,6,3,3
39342,Maniacx,stormrage,288,priest,discipline,6,3,3
39343,Mesuki,malganis,288,priest,discipline,6,3,3
39344,Reanimater,bronzebeard,288,priest,discipline,6,3,3
39345,Bestworldxz,illidan,288,priest,discipline,6,3,3
39346,Sarafem,lothar,288,priest,discipline,6,3,3
39347,Éxploït,tichondrius,288,priest,discipline,6,3,3
39348,Slottie,malganis,288,priest,discipline,6,3,3
39349,Farnzz,malganis,288,priest,discipline,6,3,3
39350,Nazgúl,lothar,288,priest,discipline,6,3,3
39351,Deezdotz,alterac-mountains,288,priest,discipline,6,3,3
39352,Rockdroid,illidan,288,priest,discipline,6,3,3
39353,Drewsies,anvilmar,288,priest,discipline,6,3,3
39354,Luminarylily,tichondrius,288,priest,discipline,6,3,3
39355,Barackhobama,malganis,288,priest,discipline,6,3,3
39356,Zaradomin,kelthuzad,288,priest,discipline,6,3,3
39357,Illiteratex,sargeras,288,priest,discipline,6,3,3
39358,Kiazma,zuljin,288,priest,discipline,6,3,3
39359,Heratic,malganis,288,priest,discipline,6,3,3
39360,Ayoheals,zuljin,288,priest,discipline,6,3,3
39361,Milesa,korgath,288,priest,discipline,6,3,3
39362,Prazph,quelthalas,288,priest,discipline,6,3,3
39363,Julisof,quelthalas,288,priest,discipline,6,3,3
39364,Vìxèn,zuljin,288,priest,discipline,6,3,3
39365,Astraetus,zuljin,288,priest,discipline,6,3,3
39366,Frye,bleeding-hollow,288,priest,discipline,6,3,3
39367,Paradoxbot,kelthuzad,288,priest,discipline,6,3,3
39368,Hellokuti,silvermoon,288,priest,discipline,6,3,3
39369,Fackinheals,kelthuzad,288,priest,discipline,6,3,3
39370,Drrunk,bleeding-hollow,288,priest,discipline,6,3,3
39371,Sassygayboyx,bleeding-hollow,288,priest,discipline,6,3,3
39372,Nizr,bleeding-hollow,288,priest,discipline,6,3,3
39373,Zegron,rexxar,288,priest,discipline,6,3,3
39374,Nevermyndz,bleeding-hollow,288,priest,discipline,6,3,3
39375,Eiricka,kelthuzad,288,priest,discipline,6,3,3
39376,Roseriela,moon-guard,288,priest,discipline,6,3,3
39377,Lifeswaplol,kelthuzad,288,priest,discipline,6,3,3
39378,Nyxvoid,ragnaros,288,priest,discipline,6,3,3
39379,Powerchucha,area-52,288,priest,discipline,6,3,3
39380,Zaxxriee,malganis,288,priest,discipline,6,3,3
39381,Fausto,kiljaeden,288,priest,discipline,6,3,3
39382,Athlete,magtheridon,288,priest,discipline,6,3,3
39383,Lowfatsnack,aggramar,288,priest,discipline,6,3,3
39384,Dredre,aggramar,288,priest,discipline,6,3,3
39385,Animityz,illidan,288,priest,discipline,6,3,3
39386,Mindmelts,gallywix,288,priest,discipline,6,3,3
39387,Empyreanlite,dalaran,288,priest,discipline,6,3,3
39388,Yogosun,dalaran,288,priest,discipline,6,3,3
39389,Wiseguise,illidan,288,priest,discipline,6,3,3
39390,Mingoms,illidan,288,priest,discipline,6,3,3
39391,Strokingmydx,illidan,288,priest,discipline,6,3,3
39392,Plzdonthitme,turalyon,288,priest,discipline,6,3,3
39393,Idhealthat,tichondrius,288,priest,discipline,6,3,3
39394,Dradinx,illidan,288,priest,discipline,6,3,3
39395,Kovskii,blackrock,288,priest,discipline,6,3,3
39396,Bessias,area-52,288,priest,discipline,6,3,3
39397,Îcecube,sargeras,288,priest,discipline,6,3,3
39398,Iamsatan,illidan,288,priest,discipline,6,3,3
39399,Skeemask,moon-guard,288,priest,discipline,6,3,3
39400,Drinkmymilk,hakkar,288,priest,discipline,6,3,3
39401,Swinee,tichondrius,288,priest,discipline,6,3,3
39402,Tsukihí,ragnaros,288,priest,discipline,6,3,3
39403,Merylstreepz,illidan,288,priest,discipline,6,3,3
39404,Kujoh,tichondrius,288,priest,discipline,6,3,3
39405,Mindgamez,stormreaver,288,priest,discipline,6,3,3
39406,Pwrwordthicc,illidan,288,priest,discipline,6,3,3
39407,Hypoz,sargeras,288,priest,discipline,6,3,3
39408,Shadowform,illidan,288,priest,discipline,6,3,3
39409,Crocsnsocks,sargeras,288,priest,discipline,6,3,3
39410,Boogiê,illidan,288,priest,discipline,6,3,3
39411,Aspéct,aegwynn,288,priest,discipline,6,3,3
39412,Anzulupriest,alexstrasza,288,priest,discipline,6,3,3
39413,Havefaith,whisperwind,288,priest,discipline,6,3,3
39414,Magicbus,blackrock,288,priest,discipline,6,3,3
39415,Kaldoon,azjolnerub,288,priest,discipline,6,3,3
39416,Sandreth,bonechewer,288,priest,discipline,6,3,3
39417,Asilberixi,tichondrius,288,priest,discipline,6,3,3
39418,Àneres,illidan,288,priest,discipline,6,3,3
39419,Nellìel,whisperwind,288,priest,discipline,6,3,3
39420,Keyohh,tichondrius,288,priest,discipline,6,3,3
39421,Madalôn,nemesis,288,priest,discipline,6,3,3
39422,Liminality,illidan,288,priest,discipline,6,3,3
39423,Dumbthott,illidan,288,priest,discipline,6,3,3
39424,Ææae,nemesis,288,priest,discipline,6,3,3
39425,Mongatzuya,illidan,288,priest,discipline,6,3,3
39426,Arythor,tichondrius,288,priest,discipline,6,3,3
39427,Itzkü,malganis,288,priest,discipline,6,3,3
39428,Alucardibee,turalyon,288,priest,discipline,6,3,3
39429,Chigge,area-52,288,priest,discipline,6,3,3
39430,Lostnthought,aggramar,288,priest,discipline,6,3,3
39431,Numinous,wyrmrest-accord,288,priest,discipline,6,3,3
39432,Rotnn,thrall,288,priest,discipline,6,3,3
39433,Lyriczx,kelthuzad,288,priest,discipline,6,3,3
39434,Isto,aegwynn,288,priest,discipline,6,3,3
39435,Killduran,hellscream,288,priest,discipline,6,3,3
39436,Kaiah,gorefiend,288,priest,discipline,6,3,3
39437,Methandrial,hyjal,288,priest,discipline,6,3,3
39438,Vanzera,thrall,288,priest,discipline,6,3,3
39439,Ichheilen,thrall,288,priest,discipline,6,3,3
39440,Jadpad,gorefiend,288,priest,discipline,6,3,3
39441,Slaystation,wildhammer,288,priest,discipline,6,3,3
39442,Painful,arathor,288,priest,discipline,6,3,3
39443,Jüdaspriest,gorefiend,288,priest,discipline,6,3,3
39444,Fadèd,wildhammer,288,priest,discipline,6,3,3
39445,Bubblejunkie,lethon,288,priest,discipline,9,4,5
39446,Whackagnome,kelthuzad,288,priest,discipline,9,4,5
39447,Onegil,tichondrius,288,priest,discipline,7,3,4
39448,Jjaeminkim,area-52,288,priest,discipline,19,7,12
39449,Zodiá,dentarg,288,priest,discipline,14,4,10
39450,Bubblez,gorefiend,288,priest,discipline,12,3,9
39451,Kustem,tichondrius,288,priest,discipline,12,3,9
39452,Sibble,deathwing,288,priest,discipline,12,3,9
39453,Slackinhealz,thrall,288,priest,discipline,12,3,9
39454,Nuaghtyheals,illidan,288,priest,discipline,12,3,9
39455,Ricxaw,frostmourne,288,priest,discipline,12,3,9
39456,Discfigured,tichondrius,288,priest,discipline,12,3,9
39457,Gloomswrath,illidan,288,priest,discipline,12,3,9
39458,Fitzop,frostmourne,288,priest,discipline,12,3,9
39459,Die,crushridge,288,priest,discipline,12,3,9
39460,Vandi,moon-guard,288,priest,discipline,12,3,9
39461,Gwenoviere,whisperwind,288,priest,discipline,12,3,9
39462,Realheal,tichondrius,288,priest,discipline,12,3,9
39463,Járngreipr,nerzhul,288,priest,discipline,12,3,9
39464,Lovebbw,sargeras,288,priest,discipline,12,3,9
39465,Schüco,tichondrius,288,priest,discipline,12,3,9
39466,Miliotis,sargeras,288,priest,discipline,12,3,9
39467,Soleyxo,frostmourne,288,priest,discipline,12,3,9
39468,Hokon,tortheldrin,288,priest,discipline,12,3,9
39469,Phillyrivers,area-52,288,priest,discipline,12,3,9
39470,Minzyx,tichondrius,288,priest,discipline,12,3,9
39471,Doomageddon,thorium-brotherhood,288,priest,discipline,12,3,9
39472,Virydian,stormrage,288,priest,discipline,12,3,9
39473,Kurnak,arthas,288,priest,discipline,12,3,9
39474,Twohpriest,aerie-peak,288,priest,discipline,12,3,9
39475,Spampws,aerie-peak,288,priest,discipline,12,3,9
39476,Devili,wyrmrest-accord,288,priest,discipline,12,3,9
39477,Baldy,arthas,288,priest,discipline,12,3,9
39478,Disconelf,barthilas,288,priest,discipline,12,3,9
39479,Bewbeez,fizzcrank,288,priest,discipline,12,3,9
39480,Paztech,arthas,288,priest,discipline,12,3,9
39481,Zemms,tichondrius,288,priest,discipline,12,3,9
39482,Chen,chogall,288,priest,discipline,12,3,9
39483,Aoeprophet,area-52,288,priest,discipline,12,3,9
39484,Healinghaze,tichondrius,288,priest,discipline,12,3,9
39485,Awøaqexs,area-52,288,priest,discipline,12,3,9
39486,Chaddadbod,emerald-dream,288,priest,discipline,12,3,9
39487,Bobbybacala,velen,288,priest,discipline,12,3,9
39488,Googus,bleeding-hollow,288,priest,discipline,12,3,9
39489,Drhuhu,stormrage,288,priest,discipline,12,3,9
39490,Bån,ragnaros,288,priest,discipline,12,3,9
39491,Diviñetõuch,kelthuzad,288,priest,discipline,12,3,9
39492,Toppers,bladefist,288,priest,discipline,12,3,9
39493,Râven,proudmoore,288,priest,discipline,12,3,9
39494,Skimpdubs,bleeding-hollow,288,priest,discipline,12,3,9
39495,Ophindrip,zuljin,288,priest,discipline,12,3,9
39496,Chubbsxo,proudmoore,288,priest,discipline,12,3,9
39497,Lavéy,ragnaros,288,priest,discipline,12,3,9
39498,Freák,zuljin,288,priest,discipline,12,3,9
39499,Purify,sargeras,288,priest,discipline,12,3,9
39500,Phantøms,zuljin,288,priest,discipline,12,3,9
39501,Km,zuljin,288,priest,discipline,12,3,9
39502,Hail,kaelthas,288,priest,discipline,12,3,9
39503,Oyao,tichondrius,288,priest,discipline,12,3,9
39504,Aaxahfon,moon-guard,288,priest,discipline,12,3,9
39505,Dumplolz,quelthalas,288,priest,discipline,12,3,9
39506,Xìdís,vashj,288,priest,discipline,12,3,9
39507,Willica,stormrage,288,priest,discipline,12,3,9
39508,Numinous,lothar,288,priest,discipline,12,3,9
39509,Krewtoo,illidan,288,priest,discipline,12,3,9
39510,Abefromann,sargeras,288,priest,discipline,12,3,9
39511,Spspsp,illidan,288,priest,discipline,12,3,9
39512,Pedialyte,kiljaeden,288,priest,discipline,12,3,9
39513,Kaeso,magtheridon,288,priest,discipline,12,3,9
39514,Shattgreen,malganis,288,priest,discipline,12,3,9
39515,Muriaticacid,tichondrius,288,priest,discipline,12,3,9
39516,Balooch,frostmourne,288,priest,discipline,14,3,11
39517,Chirho,malganis,288,priest,discipline,18,3,15
39518,Laneska,stormrage,288,priest,discipline,18,3,15
39519,Pravant,illidan,288,priest,discipline,18,3,15
39520,Pheegawn,proudmoore,288,priest,discipline,18,3,15
39521,Zarøw,tichondrius,288,priest,discipline,24,3,21
39522,Orchidp,tichondrius,2334,priest,shadow,300,185,115
39523,Jennaôrtega,tichondrius,2321,priest,shadow,120,75,45
39524,Pboo,tichondrius,2315,priest,shadow,78,49,29
39525,Luvkak,tichondrius,2304,priest,shadow,100,55,45
39526,Yeazy,stormrage,2296,priest,shadow,108,62,46
39527,Kishoengi,sargeras,2238,priest,shadow,126,74,52
39528,Disembly,illidan,2223,priest,shadow,87,50,37
39529,Scandi,tichondrius,2215,priest,shadow,90,53,37
39530,Edd,tichondrius,2215,priest,shadow,158,84,74
39531,Yeona,tichondrius,2195,priest,shadow,101,60,41
39532,Mearas,kelthuzad,2189,priest,shadow,88,52,36
39533,Disemble,illidan,2186,priest,shadow,78,44,34
39534,Techbadar,tichondrius,2185,priest,shadow,125,65,60
39535,Targora,lightninghoof,2178,priest,shadow,156,88,68
39536,Ejr,altar-of-storms,2172,priest,shadow,127,64,63
39537,Apbrady,sargeras,2167,priest,shadow,126,67,59
39538,Strwbrynaner,sargeras,2159,priest,shadow,186,99,87
39539,Zçythe,tichondrius,2158,priest,shadow,84,51,33
39540,Oohhmágáá,azralon,2157,priest,shadow,84,60,24
39541,Painpaws,moon-guard,2154,priest,shadow,111,67,44
39542,Louloudots,malganis,2141,priest,shadow,178,98,80
39543,Moraver,kelthuzad,2141,priest,shadow,74,39,35
39544,Healingstats,tichondrius,2137,priest,shadow,71,38,33
39545,Zyrith,sargeras,2137,priest,shadow,111,58,53
39546,Sin,guldan,2135,priest,shadow,395,214,181
39547,Welplayedman,emerald-dream,2130,priest,shadow,88,53,35
39548,Eradication,frostmourne,2129,priest,shadow,111,69,42
39549,Geovanni,barthilas,2129,priest,shadow,101,52,49
39550,Claudiosip,tichondrius,2127,priest,shadow,79,51,28
39551,Zlipz,frostmourne,2125,priest,shadow,66,42,24
39552,Amyyds,illidan,2124,priest,shadow,161,101,60
39553,Palumorp,deathwing,2118,priest,shadow,90,57,33
39554,Kottun,stormrage,2110,priest,shadow,66,38,28
39555,Lìám,frostmourne,2110,priest,shadow,187,102,85
39556,Kuraga,bleeding-hollow,2107,priest,shadow,386,210,176
39557,Pdfileclass,tichondrius,2106,priest,shadow,72,47,25
39558,Bayter,frostmourne,2105,priest,shadow,181,97,84
39559,Yenïza,illidan,2104,priest,shadow,178,96,82
39560,Alisasa,tichondrius,2083,priest,shadow,72,40,32
39561,Omenx,emerald-dream,2078,priest,shadow,108,58,50
39562,Spamndam,tichondrius,2076,priest,shadow,78,45,33
39563,Dream,tichondrius,2066,priest,shadow,180,88,92
39564,Vtp,frostmourne,2052,priest,shadow,116,66,50
39565,Ombravuota,blades-edge,2052,priest,shadow,264,137,127
39566,Swswswswsw,stormrage,2050,priest,shadow,107,68,39
39567,Nekroscream,queldorei,2050,priest,shadow,95,53,42
39568,Criminalsp,frostmourne,2050,priest,shadow,83,42,41
39569,Xiaozhui,tichondrius,2046,priest,shadow,117,62,55
39570,Laundryday,korgath,2043,priest,shadow,96,51,45
39571,Shibuu,moon-guard,2024,priest,shadow,82,46,36
39572,Pbxx,tichondrius,2018,priest,shadow,64,36,28
39573,Cozies,stormreaver,2016,priest,shadow,166,89,77
39574,Expr,area-52,2011,priest,shadow,120,65,55
39575,Holydose,moon-guard,2004,priest,shadow,126,60,66
39576,Gâdzêd,kelthuzad,2003,priest,shadow,62,38,24
39577,Remixsp,malganis,1998,priest,shadow,60,33,27
39578,Metasp,sargeras,1996,priest,shadow,96,51,45
39579,Babyh,tichondrius,1994,priest,shadow,77,41,36
39580,Royx,stormreaver,1993,priest,shadow,71,38,33
39581,Bobbyvagene,area-52,1990,priest,shadow,92,46,46
39582,Talbadar,tichondrius,1985,priest,shadow,90,54,36
39583,Blackoss,sargeras,1985,priest,shadow,117,63,54
39584,Bibleblak,stormrage,1982,priest,shadow,138,78,60
39585,Gromkekz,area-52,1982,priest,shadow,131,67,64
39586,Heheheg,tichondrius,1980,priest,shadow,173,86,87
39587,Keygodx,illidan,1977,priest,shadow,60,36,24
39588,Ivn,tichondrius,1977,priest,shadow,77,43,34
39589,Kiriko,mannoroth,1977,priest,shadow,101,56,45
39590,Viyana,stormrage,1977,priest,shadow,204,104,100
39591,Erebusz,tichondrius,1976,priest,shadow,209,107,102
39592,Yoggsarodney,tichondrius,1973,priest,shadow,49,32,17
39593,Eunu,tichondrius,1967,priest,shadow,245,119,126
39594,Delasoul,malganis,1965,priest,shadow,111,64,47
39595,Mamísonga,ragnaros,1965,priest,shadow,71,35,36
39596,Taylorsp,tichondrius,1964,priest,shadow,94,55,39
39597,Aro,tichondrius,1964,priest,shadow,78,41,37
39598,Maskali,tichondrius,1963,priest,shadow,262,126,136
39599,Blax,stormscale,1959,priest,shadow,126,66,60
39600,Urelz,illidan,1956,priest,shadow,30,21,9
39601,Ousïa,quelthalas,1956,priest,shadow,135,67,68
39602,Soapee,illidan,1955,priest,shadow,221,113,108
39603,Stinkiez,area-52,1954,priest,shadow,270,142,128
39604,Psyfiend,alterac-mountains,1953,priest,shadow,81,46,35
39605,Greaterfade,stormrage,1952,priest,shadow,60,34,26
39606,Jugeumx,proudmoore,1951,priest,shadow,66,36,30
39607,Kydraah,ragnaros,1950,priest,shadow,71,41,30
39608,Garpd,tichondrius,1947,priest,shadow,138,80,58
39609,Niark,frostmourne,1946,priest,shadow,82,41,41
39610,Wetleaftx,chogall,1945,priest,shadow,42,29,13
39611,Zlips,frostmourne,1942,priest,shadow,116,54,62
39612,Helmsman,tichondrius,1940,priest,shadow,224,117,107
39613,Arobahn,tichondrius,1940,priest,shadow,148,76,72
39614,Yberisa,zuljin,1936,priest,shadow,155,81,74
39615,Fatherfeet,tichondrius,1932,priest,shadow,114,64,50
39616,Nozp,stormrage,1930,priest,shadow,48,28,20
39617,Ysuran,moon-guard,1930,priest,shadow,184,106,78
39618,Puppyboyx,moon-guard,1929,priest,shadow,80,41,39
39619,Katallyst,tichondrius,1926,priest,shadow,77,36,41
39620,Dyrr,barthilas,1921,priest,shadow,221,106,115
39621,Stresscube,tichondrius,1915,priest,shadow,46,28,18
39622,Cheesëburg,illidan,1915,priest,shadow,54,28,26
39623,Missyoung,tichondrius,1912,priest,shadow,73,42,31
39624,Asmødeus,bleeding-hollow,1912,priest,shadow,101,54,47
39625,Ilovevivien,spirestone,1911,priest,shadow,54,30,24
39626,Voidkay,tichondrius,1908,priest,shadow,48,38,10
39627,Ensanity,stormrage,1908,priest,shadow,149,76,73
39628,Zlowbly,ragnaros,1904,priest,shadow,178,95,83
39629,Vamp,proudmoore,1899,priest,shadow,82,52,30
39630,Knowknow,tichondrius,1897,priest,shadow,144,71,73
39631,Xaneo,kelthuzad,1895,priest,shadow,59,37,22
39632,Ssupasonic,tichondrius,1880,priest,shadow,103,63,40
39633,Mindblastx,kelthuzad,1880,priest,shadow,63,35,28
39634,Netheerix,tichondrius,1879,priest,shadow,51,30,21
39635,Metricdotem,terenas,1878,priest,shadow,48,30,18
39636,Marfas,illidan,1878,priest,shadow,104,49,55
39637,Johai,uldum,1873,priest,shadow,72,48,24
39638,Nutdrip,tichondrius,1872,priest,shadow,47,28,19
39639,Mythsnake,ragnaros,1872,priest,shadow,49,29,20
39640,Soar,ravencrest,1872,priest,shadow,47,26,21
39641,Drmuhammad,sargeras,1870,priest,shadow,46,28,18
39642,Cmg,sargeras,1869,priest,shadow,60,31,29
39643,Atarri,illidan,1868,priest,shadow,54,31,23
39644,Creapture,zuluhed,1864,priest,shadow,42,24,18
39645,Sênju,thrall,1864,priest,shadow,77,40,37
39646,Xayp,kelthuzad,1863,priest,shadow,101,73,28
39647,Theophobe,illidan,1862,priest,shadow,42,32,10
39648,Wizkxjwap,tichondrius,1862,priest,shadow,36,24,12
39649,Shortwombat,korgath,1860,priest,shadow,60,29,31
39650,Christmasgal,uldum,1859,priest,shadow,30,27,3
39651,Meehx,illidan,1859,priest,shadow,108,67,41
39652,Fungame,malganis,1855,priest,shadow,50,35,15
39653,Evenly,tichondrius,1855,priest,shadow,138,76,62
39654,Itkev,area-52,1854,priest,shadow,35,27,8
39655,Ericzssp,tichondrius,1854,priest,shadow,63,36,27
39656,Bubbyflay,area-52,1853,priest,shadow,53,32,21
39657,Couldntbeme,sargeras,1852,priest,shadow,54,31,23
39658,Ussmissouri,area-52,1852,priest,shadow,235,126,109
39659,Rileyreidx,ragnaros,1850,priest,shadow,48,32,16
39660,Echoos,proudmoore,1849,priest,shadow,42,28,14
39661,Nevertelsp,malganis,1848,priest,shadow,140,89,51
39662,Bagjoe,illidan,1848,priest,shadow,212,112,100
39663,Sodíum,wyrmrest-accord,1848,priest,shadow,107,51,56
39664,Yoggismydad,emerald-dream,1847,priest,shadow,48,29,19
39665,Wafflezsp,frostmourne,1847,priest,shadow,120,62,58
39666,Derisha,ragnaros,1845,priest,shadow,128,71,57
39667,Sapoopettas,quelthalas,1845,priest,shadow,54,26,28
39668,Griffsp,sargeras,1844,priest,shadow,203,101,102
39669,Xhadow,sargeras,1843,priest,shadow,96,50,46
39670,Bornagain,gundrak,1843,priest,shadow,53,27,26
39671,Vtplz,bleeding-hollow,1843,priest,shadow,65,33,32
39672,Kattallyst,tichondrius,1842,priest,shadow,89,45,44
39673,Psyphi,duskwood,1841,priest,shadow,84,40,44
39674,Ayumihamaski,tichondrius,1840,priest,shadow,57,39,18
39675,Voidgodtko,tichondrius,1840,priest,shadow,48,26,22
39676,Tidals,sargeras,1839,priest,shadow,60,38,22
39677,Dí,illidan,1839,priest,shadow,78,44,34
39678,Soyul,tichondrius,1838,priest,shadow,114,64,50
39679,Pnub,aggramar,1838,priest,shadow,65,34,31
39680,Snoog,tichondrius,1837,priest,shadow,54,28,26
39681,Keliarc,sargeras,1836,priest,shadow,102,54,48
39682,Stunsilence,sargeras,1835,priest,shadow,42,23,19
39683,Snookp,kiljaeden,1835,priest,shadow,267,139,128
39684,Stankychimpo,malganis,1834,priest,shadow,54,32,22
39685,Estéve,wyrmrest-accord,1834,priest,shadow,113,58,55
39686,Niurouchuan,tichondrius,1834,priest,shadow,62,31,31
39687,Furbog,area-52,1833,priest,shadow,42,31,11
39688,Priestpogger,tichondrius,1831,priest,shadow,48,31,17
39689,Phubar,stormreaver,1831,priest,shadow,78,34,44
39690,Remedio,emerald-dream,1830,priest,shadow,33,21,12
39691,Cøtt,emerald-dream,1829,priest,shadow,48,30,18
39692,Doma,malganis,1829,priest,shadow,43,26,17
39693,Yb,kelthuzad,1829,priest,shadow,54,32,22
39694,Auttø,area-52,1829,priest,shadow,45,26,19
39695,Maìden,sargeras,1829,priest,shadow,84,41,43
39696,Kalantris,ragnaros,1828,priest,shadow,64,41,23
39697,Throwshade,moon-guard,1828,priest,shadow,89,56,33
39698,Giriosp,thrall,1827,priest,shadow,31,22,9
39699,Kfcpriest,barthilas,1827,priest,shadow,54,26,28
39700,Ventusp,azralon,1826,priest,shadow,105,61,44
39701,Voiders,area-52,1826,priest,shadow,288,164,124
39702,Celypriest,moon-guard,1825,priest,shadow,30,25,5
39703,What,drakthul,1825,priest,shadow,54,35,19
39704,Carbsauce,tichondrius,1825,priest,shadow,60,37,23
39705,Ptam,tichondrius,1825,priest,shadow,47,26,21
39706,Silero,dalaran,1824,priest,shadow,116,76,40
39707,Idiotgarbage,moon-guard,1824,priest,shadow,48,26,22
39708,Hÿperion,quelthalas,1823,priest,shadow,60,38,22
39709,Insanity,azuremyst,1823,priest,shadow,137,77,60
39710,Snòzberry,illidan,1822,priest,shadow,66,36,30
39711,Samsypriest,frostmourne,1821,priest,shadow,64,38,26
39712,Mindslips,tichondrius,1821,priest,shadow,144,82,62
39713,Bearoom,frostmourne,1820,priest,shadow,66,39,27
39714,Plaguesus,dalaran,1820,priest,shadow,64,35,29
39715,Nhela,kelthuzad,1820,priest,shadow,60,29,31
39716,Vil,lightnings-blade,1819,priest,shadow,90,50,40
39717,Ellindria,spinebreaker,1818,priest,shadow,95,57,38
39718,Peggable,moon-guard,1818,priest,shadow,59,32,27
39719,Disxlyec,barthilas,1817,priest,shadow,142,79,63
39720,Dots,tichondrius,1816,priest,shadow,53,33,20
39721,Katarot,area-52,1816,priest,shadow,51,30,21
39722,Discipline,chogall,1816,priest,shadow,48,26,22
39723,Hollister,illidan,1816,priest,shadow,246,132,114
39724,Havocshadows,deathwing,1815,priest,shadow,94,58,36
39725,Jeseck,quelthalas,1815,priest,shadow,110,59,51
39726,Blissily,sargeras,1814,priest,shadow,75,47,28
39727,Manic,skywall,1814,priest,shadow,168,96,72
39728,Irasponsible,stormrage,1814,priest,shadow,42,23,19
39729,Holytalk,tichondrius,1814,priest,shadow,60,30,30
39730,Drupith,dalaran,1814,priest,shadow,54,27,27
39731,Nawzyh,emerald-dream,1813,priest,shadow,48,26,22
39732,Melonsoda,stormrage,1813,priest,shadow,48,26,22
39733,Headbrake,malganis,1813,priest,shadow,54,26,28
39734,Resonator,laughing-skull,1813,priest,shadow,46,22,24
39735,Invain,executus,1812,priest,shadow,30,24,6
39736,Felrynpr,malganis,1811,priest,shadow,47,28,19
39737,Chazzwizz,area-52,1811,priest,shadow,48,26,22
39738,Ðantex,thrall,1811,priest,shadow,296,155,141
39739,Xannè,tichondrius,1811,priest,shadow,60,30,30
39740,Relapse,emerald-dream,1810,priest,shadow,36,25,11
39741,Tomcruisé,zuljin,1810,priest,shadow,54,31,23
39742,Llamabush,malganis,1809,priest,shadow,39,26,13
39743,Doublesix,malganis,1809,priest,shadow,72,43,29
39744,Brokenspc,tichondrius,1809,priest,shadow,148,80,68
39745,Krelaeren,tichondrius,1809,priest,shadow,65,33,32
39746,Cixelpvp,area-52,1809,priest,shadow,54,26,28
39747,Arthrix,sargeras,1807,priest,shadow,72,46,26
39748,Bumps,zuljin,1807,priest,shadow,76,43,33
39749,Inflate,frostmourne,1807,priest,shadow,114,62,52
39750,Esteedees,bonechewer,1807,priest,shadow,132,71,61
39751,Mindgoblin,terokkar,1807,priest,shadow,96,48,48
39752,Ericxd,area-52,1807,priest,shadow,77,38,39
39753,Edai,malganis,1806,priest,shadow,229,124,105
39754,Exoticfather,stormrage,1806,priest,shadow,66,33,33
39755,Dispel,agamaggan,1805,priest,shadow,32,24,8
39756,Ghostz,alleria,1805,priest,shadow,60,39,21
39757,Invincible,ragnaros,1805,priest,shadow,72,41,31
39758,Jomm,area-52,1805,priest,shadow,69,37,32
39759,Brickzyhehe,dalaran,1805,priest,shadow,113,58,55
39760,Naosoupriest,azralon,1804,priest,shadow,53,40,13
39761,Healingstat,tichondrius,1804,priest,shadow,39,25,14
39762,Secrèt,tichondrius,1804,priest,shadow,30,19,11
39763,Manofmystery,dalaran,1804,priest,shadow,48,28,20
39764,Bearzugzug,frostmourne,1803,priest,shadow,36,23,13
39765,Panndaz,tichondrius,1803,priest,shadow,30,19,11
39766,Inmotion,tichondrius,1803,priest,shadow,30,19,11
39767,Euthanasìa,deathwing,1803,priest,shadow,70,31,39
39768,Potatopriest,stormrage,1802,priest,shadow,42,31,11
39769,Korrà,turalyon,1802,priest,shadow,30,19,11
39770,Dilonpi,area-52,1801,priest,shadow,66,47,19
39771,Eclipsë,malganis,1800,priest,shadow,24,19,5
39772,Sheiizy,azralon,1800,priest,shadow,90,52,38
39773,Hástür,quelthalas,1797,priest,shadow,151,82,69
39774,Darkvagician,malganis,1797,priest,shadow,47,25,22
39775,Jojotwo,illidan,1794,priest,shadow,102,52,50
39776,Sleepynuj,stormrage,1792,priest,shadow,78,48,30
39777,Axelrod,tichondrius,1792,priest,shadow,48,29,19
39778,Deuz,quelthalas,1789,priest,shadow,220,113,107
39779,Jthreetx,kelthuzad,1788,priest,shadow,40,23,17
39780,Zhiwanam,tichondrius,1786,priest,shadow,59,34,25
39781,Lillyp,malganis,1786,priest,shadow,42,21,21
39782,Milan,dalaran,1784,priest,shadow,93,57,36
39783,Jydge,tichondrius,1780,priest,shadow,39,22,17
39784,Pengwinxl,agamaggan,1779,priest,shadow,48,25,23
39785,Almycn,tichondrius,1776,priest,shadow,56,30,26
39786,Plztrainme,spinebreaker,1776,priest,shadow,124,65,59
39787,Ayniah,tichondrius,1775,priest,shadow,46,22,24
39788,Pinguisursi,kelthuzad,1774,priest,shadow,36,27,9
39789,Míslead,kelthuzad,1771,priest,shadow,36,27,9
39790,Shadowforsho,sargeras,1771,priest,shadow,64,30,34
39791,Griffsp,stormrage,1765,priest,shadow,77,44,33
39792,Kovie,twisting-nether,1758,priest,shadow,206,119,87
39793,Keser,kelthuzad,1758,priest,shadow,40,22,18
39794,Krovnp,stormrage,1756,priest,shadow,36,24,12
39795,Orgasmiq,frostmourne,1755,priest,shadow,84,45,39
39796,Eklunð,proudmoore,1754,priest,shadow,53,28,25
39797,Afromon,suramar,1750,priest,shadow,72,45,27
39798,Mepisth,sargeras,1748,priest,shadow,72,46,26
39799,Sukes,korgath,1747,priest,shadow,150,82,68
39800,Zanthix,tichondrius,1745,priest,shadow,54,26,28
39801,Impérial,stormrage,1744,priest,shadow,179,107,72
39802,Mindburn,nemesis,1742,priest,shadow,84,38,46
39803,Shalla,blackrock,1740,priest,shadow,96,53,43
39804,Bhadbhaabie,lethon,1738,priest,shadow,24,19,5
39805,Emopriestqt,tichondrius,1737,priest,shadow,144,79,65
39806,Saevita,area-52,1737,priest,shadow,66,34,32
39807,Iceveins,illidan,1736,priest,shadow,46,27,19
39808,Ticklefingrs,malganis,1734,priest,shadow,60,35,25
39809,Tamajka,the-forgotten-coast,1734,priest,shadow,117,57,60
39810,Plushys,emerald-dream,1733,priest,shadow,66,44,22
39811,Shelize,kirin-tor,1732,priest,shadow,307,156,151
39812,Laokele,tichondrius,1731,priest,shadow,48,29,19
39813,Dildocrates,darkspear,1730,priest,shadow,48,28,20
39814,Messiahp,illidan,1730,priest,shadow,53,25,28
39815,Aristedes,thrall,1729,priest,shadow,35,20,15
39816,Dispèrsion,darkspear,1729,priest,shadow,88,42,46
39817,Xmewo,sargeras,1728,priest,shadow,41,25,16
39818,Lebronjâmes,tichondrius,1726,priest,shadow,42,25,17
39819,Dxsc,tichondrius,1725,priest,shadow,72,41,31
39820,Drohung,sargeras,1723,priest,shadow,54,30,24
39821,Pesca,proudmoore,1721,priest,shadow,90,47,43
39822,Moralism,moon-guard,1719,priest,shadow,235,135,100
39823,Brokentrojan,moon-guard,1718,priest,shadow,48,23,25
39824,Perfectz,stormrage,1716,priest,shadow,42,24,18
39825,Álvarez,tichondrius,1716,priest,shadow,110,56,54
39826,Soný,stormrage,1715,priest,shadow,69,38,31
39827,Saintjudys,tichondrius,1714,priest,shadow,36,23,13
39828,Brownie,blackrock,1713,priest,shadow,41,23,18
39829,Krytical,illidan,1710,priest,shadow,166,97,69
39830,Alyndral,illidan,1710,priest,shadow,78,43,35
39831,Nishishabi,tichondrius,1707,priest,shadow,48,24,24
39832,Finfangfoom,laughing-skull,1707,priest,shadow,69,33,36
39833,Thaumaturgy,chogall,1706,priest,shadow,48,25,23
39834,Cathery,tichondrius,1704,priest,shadow,36,18,18
39835,Tidbitsy,malganis,1704,priest,shadow,151,71,80
39836,Snuffp,sargeras,1703,priest,shadow,125,81,44
39837,Jessticalz,frostmourne,1703,priest,shadow,48,24,24
39838,Shwayp,zuljin,1702,priest,shadow,36,22,14
39839,Moonideli,moon-guard,1702,priest,shadow,49,29,20
39840,Twoboo,bleeding-hollow,1701,priest,shadow,72,40,32
39841,Antìdote,tichondrius,1700,priest,shadow,176,101,75
39842,Darkenside,moon-guard,1699,priest,shadow,48,28,20
39843,Akuvurá,nemesis,1699,priest,shadow,137,78,59
39844,Ddark,tichondrius,1697,priest,shadow,66,41,25
39845,Palmerin,ravencrest,1697,priest,shadow,102,53,49
39846,Cavaliersr,ragnaros,1696,priest,shadow,90,53,37
39847,Badbwoi,frostmourne,1696,priest,shadow,61,29,32
39848,Nvøsuperstar,zuljin,1695,priest,shadow,72,37,35
39849,Nickdeath,tichondrius,1694,priest,shadow,54,28,26
39850,Mockr,kiljaeden,1693,priest,shadow,138,76,62
39851,Ikillfast,tichondrius,1692,priest,shadow,174,98,76
39852,Shadelink,tichondrius,1692,priest,shadow,42,22,20
39853,Madcaddies,bonechewer,1691,priest,shadow,108,53,55
39854,Arion,wyrmrest-accord,1689,priest,shadow,54,35,19
39855,Crbandit,moon-guard,1688,priest,shadow,103,62,41
39856,Sinning,kelthuzad,1686,priest,shadow,24,18,6
39857,Rizzle,emerald-dream,1684,priest,shadow,76,46,30
39858,Holyxb,bleeding-hollow,1683,priest,shadow,137,76,61
39859,Giveheadpats,moon-guard,1683,priest,shadow,222,121,101
39860,Iuka,emerald-dream,1683,priest,shadow,183,96,87
39861,Hadoka,ragnaros,1682,priest,shadow,28,19,9
39862,Nonamegame,sargeras,1681,priest,shadow,106,60,46
39863,Pettypriest,dalaran,1680,priest,shadow,195,102,93
39864,Himikko,illidan,1680,priest,shadow,40,19,21
39865,Alykus,emerald-dream,1679,priest,shadow,58,30,28
39866,Silkyx,tichondrius,1679,priest,shadow,36,18,18
39867,Yayonaise,tichondrius,1678,priest,shadow,36,21,15
39868,Delbringer,moon-guard,1678,priest,shadow,152,84,68
39869,Fxxkdamn,tichondrius,1676,priest,shadow,35,23,12
39870,Woodney,ragnaros,1676,priest,shadow,30,19,11
39871,Kultil,dalaran,1676,priest,shadow,84,49,35
39872,Littlewench,sargeras,1676,priest,shadow,86,49,37
39873,Girthed,bloodscalp,1676,priest,shadow,92,48,44
39874,Crayon,stormrage,1676,priest,shadow,48,25,23
39875,Tsmc,moon-guard,1675,priest,shadow,96,51,45
39876,Evx,demon-soul,1673,priest,shadow,96,50,46
39877,Sochron,stormrage,1672,priest,shadow,128,67,61
39878,Dirtyysanta,tichondrius,1671,priest,shadow,40,24,16
39879,Clownface,tichondrius,1671,priest,shadow,42,24,18
39880,Lauretânia,nemesis,1670,priest,shadow,84,41,43
39881,Fantasía,moon-guard,1670,priest,shadow,114,54,60
39882,Shadowblastx,sargeras,1668,priest,shadow,54,31,23
39883,Desaros,tichondrius,1668,priest,shadow,102,52,50
39884,Darkness,azralon,1668,priest,shadow,61,29,32
39885,Saintpleb,sargeras,1667,priest,shadow,137,82,55
39886,Slasheal,caelestrasz,1666,priest,shadow,90,47,43
39887,Lucsor,malganis,1665,priest,shadow,109,58,51
39888,Nuggs,mannoroth,1665,priest,shadow,42,21,21
39889,Luzira,stormrage,1662,priest,shadow,42,25,17
39890,Xdipi,proudmoore,1662,priest,shadow,44,25,19
39891,Swaggylee,tichondrius,1661,priest,shadow,40,22,18
39892,Avraf,sargeras,1660,priest,shadow,42,20,22
39893,Mscleo,lothar,1660,priest,shadow,173,81,92
39894,Qreckful,proudmoore,1658,priest,shadow,34,22,12
39895,Zachlol,area-52,1658,priest,shadow,66,36,30
39896,Cheereos,stormrage,1657,priest,shadow,42,27,15
39897,Deadsp,thrall,1657,priest,shadow,115,58,57
39898,Shadowkr,tichondrius,1656,priest,shadow,42,26,16
39899,Uploading,moon-guard,1655,priest,shadow,30,19,11
39900,Pluse,bonechewer,1655,priest,shadow,52,31,21
39901,Raptorjésus,azjolnerub,1654,priest,shadow,42,22,20
39902,Ilovealina,gorefiend,1653,priest,shadow,30,21,9
39903,Nottonightqt,barthilas,1652,priest,shadow,42,26,16
39904,Priestzerath,azralon,1652,priest,shadow,69,38,31
39905,Shadowlife,bonechewer,1652,priest,shadow,62,33,29
39906,Djcyrus,barthilas,1652,priest,shadow,54,28,26
39907,Ðemi,zuljin,1652,priest,shadow,108,55,53
39908,Brothofnzoth,emerald-dream,1651,priest,shadow,118,63,55
39909,Nevermôre,area-52,1650,priest,shadow,54,36,18
39910,Vaporachi,emerald-dream,1650,priest,shadow,42,28,14
39911,Dovoso,kargath,1650,priest,shadow,54,30,24
39912,Skrillô,emerald-dream,1650,priest,shadow,53,27,26
39913,Fenix,bloodhoof,1650,priest,shadow,52,25,27
39914,Caricius,ravenholdt,1649,priest,shadow,36,20,16
39915,Jags,area-52,1648,priest,shadow,48,19,29
39916,Docbek,illidan,1647,priest,shadow,44,28,16
39917,Griddly,alterac-mountains,1646,priest,shadow,72,41,31
39918,Partypriest,tichondrius,1646,priest,shadow,71,39,32
39919,Mimósa,quelthalas,1645,priest,shadow,49,29,20
39920,Painful,malganis,1645,priest,shadow,62,36,26
39921,Salvate,tichondrius,1645,priest,shadow,42,24,18
39922,Amarexlol,stormrage,1645,priest,shadow,66,37,29
39923,Imabeast,stormrage,1644,priest,shadow,71,39,32
39924,Vashrapani,stormrage,1644,priest,shadow,273,141,132
39925,Sigx,area-52,1643,priest,shadow,30,21,9
39926,Gaymalenurse,sargeras,1643,priest,shadow,48,25,23
39927,Swungzebra,stormrage,1642,priest,shadow,140,83,57
39928,Destta,stormrage,1641,priest,shadow,34,19,15
39929,Voidazepam,zuljin,1641,priest,shadow,96,53,43
39930,Deeaann,tichondrius,1641,priest,shadow,304,162,142
39931,Ajazz,zuljin,1640,priest,shadow,42,27,15
39932,Trenbologni,illidan,1639,priest,shadow,174,99,75
39933,Folesian,tichondrius,1638,priest,shadow,54,31,23
39934,Despairx,tichondrius,1638,priest,shadow,36,19,17
39935,Nullreferenc,frostmourne,1637,priest,shadow,81,45,36
39936,Scarabless,bleeding-hollow,1637,priest,shadow,90,47,43
39937,Pumpss,area-52,1636,priest,shadow,73,41,32
39938,Fancycorpse,tichondrius,1635,priest,shadow,60,27,33
39939,Alip,tichondrius,1633,priest,shadow,64,41,23
39940,Gìdem,aggramar,1633,priest,shadow,33,19,14
39941,Evelën,azralon,1633,priest,shadow,42,22,20
39942,Grimdox,tichondrius,1631,priest,shadow,48,36,12
39943,Aqurielen,turalyon,1631,priest,shadow,71,45,26
39944,Cixelp,area-52,1631,priest,shadow,42,23,19
39945,Mushill,tichondrius,1631,priest,shadow,102,51,51
39946,Safe,illidan,1629,priest,shadow,97,51,46
39947,Sempiternus,barthilas,1628,priest,shadow,46,24,22
39948,Kurindrize,illidan,1627,priest,shadow,30,18,12
39949,Sarâda,moon-guard,1626,priest,shadow,177,95,82
39950,Fireballingg,tichondrius,1625,priest,shadow,30,18,12
39951,Ightdoe,zuljin,1624,priest,shadow,57,36,21
39952,Whysoserious,duskwood,1624,priest,shadow,30,17,13
39953,Coral,stormscale,1624,priest,shadow,53,30,23
39954,Dontpvponme,illidan,1623,priest,shadow,36,24,12
39955,Mêdúsa,area-52,1621,priest,shadow,58,30,28
39956,Dorraheals,tichondrius,1620,priest,shadow,41,22,19
39957,Rhick,azralon,1619,priest,shadow,83,52,31
39958,Solstunn,moon-guard,1619,priest,shadow,48,24,24
39959,Ilostmybible,quelthalas,1619,priest,shadow,46,23,23
39960,Gershwinner,daggerspine,1619,priest,shadow,36,17,19
39961,Iogical,kelthuzad,1618,priest,shadow,116,70,46
39962,Hurtfeet,sargeras,1618,priest,shadow,90,45,45
39963,Thenamesnorm,tichondrius,1617,priest,shadow,59,36,23
39964,Dustnbonez,area-52,1617,priest,shadow,36,20,16
39965,Sècret,tichondrius,1617,priest,shadow,40,20,20
39966,Darkestzell,azralon,1616,priest,shadow,41,20,21
39967,Drossv,shadowmoon,1614,priest,shadow,42,20,22
39968,Healzium,blackwater-raiders,1613,priest,shadow,56,28,28
39969,Vallfiresp,malganis,1612,priest,shadow,40,22,18
39970,Biubiubium,tichondrius,1611,priest,shadow,42,26,16
39971,Gineska,tichondrius,1611,priest,shadow,36,22,14
39972,Pegwraith,sargeras,1611,priest,shadow,41,25,16
39973,Snackabre,moon-guard,1611,priest,shadow,36,20,16
39974,Benjamints,thrall,1610,priest,shadow,104,61,43
39975,Crazyherb,azralon,1610,priest,shadow,125,70,55
39976,Cxrsed,illidan,1610,priest,shadow,42,22,20
39977,Jeffgordo,tichondrius,1609,priest,shadow,86,52,34
39978,Kwõnc,tichondrius,1609,priest,shadow,56,29,27
39979,Warklaw,frostmourne,1609,priest,shadow,72,34,38
39980,Nodoubt,barthilas,1609,priest,shadow,58,26,32
39981,Adopted,wyrmrest-accord,1608,priest,shadow,66,37,29
39982,Wenger,crushridge,1608,priest,shadow,138,70,68
39983,Methandrial,hyjal,1607,priest,shadow,129,70,59
39984,Shmage,malganis,1606,priest,shadow,54,28,26
39985,Ludapriest,moon-guard,1606,priest,shadow,42,21,21
39986,Likesshadows,tichondrius,1605,priest,shadow,84,57,27
39987,Moc,jubeithos,1605,priest,shadow,36,22,14
39988,Fight,icecrown,1605,priest,shadow,60,33,27
39989,Cyanovoid,thrall,1605,priest,shadow,48,26,22
39990,Bubbzy,daggerspine,1605,priest,shadow,60,31,29
39991,Gelato,velen,1605,priest,shadow,36,17,19
39992,Krooked,kelthuzad,1604,priest,shadow,84,53,31
39993,Hriest,tichondrius,1604,priest,shadow,42,23,19
39994,Shadowdurps,area-52,1604,priest,shadow,66,36,30
39995,Murkqz,stormrage,1604,priest,shadow,54,29,25
39996,Clamchowdy,kiljaeden,1603,priest,shadow,27,18,9
39997,Ayooblitz,guldan,1603,priest,shadow,42,26,16
39998,Scalpell,tichondrius,1603,priest,shadow,263,135,128
39999,Fâêlyn,wyrmrest-accord,1603,priest,shadow,94,46,48
40000,Shadork,area-52,1602,priest,shadow,49,31,18
40001,Cloax,azgalor,1602,priest,shadow,48,29,19
40002,Aspéct,aegwynn,1602,priest,shadow,30,17,13
40003,Hotphoyou,moon-guard,1600,priest,shadow,60,39,21
40004,Manifestor,illidan,1600,priest,shadow,86,51,35
40005,Machinecoach,stormrage,1600,priest,shadow,40,20,20
40006,Gusho,frostmourne,1599,priest,shadow,175,88,87
40007,Wifegrip,tichondrius,1598,priest,shadow,42,19,23
40008,Ranthrough,tichondrius,1597,priest,shadow,78,48,30
40009,Radicional,azralon,1596,priest,shadow,36,20,16
40010,Minamy,tichondrius,1593,priest,shadow,30,17,13
40011,Priestine,dreadmaul,1593,priest,shadow,168,86,82
40012,Rhoku,nesingwary,1592,priest,shadow,74,43,31
40013,Ulqüiorra,azralon,1592,priest,shadow,42,23,19
40014,Graviton,tichondrius,1591,priest,shadow,72,40,32
40015,Xæl,tichondrius,1587,priest,shadow,96,60,36
40016,Shadowzypher,wyrmrest-accord,1586,priest,shadow,42,23,19
40017,Nihenben,illidan,1586,priest,shadow,72,38,34
40018,Chillypriest,azjolnerub,1585,priest,shadow,42,23,19
40019,Nexumbra,dunemaul,1585,priest,shadow,120,64,56
40020,Fluttershÿ,ragnaros,1584,priest,shadow,54,28,26
40021,Lolshadow,amanthul,1584,priest,shadow,78,39,39
40022,Occult,bloodscalp,1584,priest,shadow,99,48,51
40023,Faedyspriest,sargeras,1581,priest,shadow,42,23,19
40024,Pepps,proudmoore,1581,priest,shadow,572,294,278
40025,Greyyan,wyrmrest-accord,1580,priest,shadow,279,152,127
40026,Vaala,jubeithos,1580,priest,shadow,60,30,30
40027,Thiazine,kiljaeden,1578,priest,shadow,33,26,7
40028,Teddipriest,tichondrius,1578,priest,shadow,35,19,16
40029,Dillydackx,sargeras,1577,priest,shadow,114,61,53
40030,Voltétt,tichondrius,1576,priest,shadow,38,20,18
40031,Brotherrob,area-52,1576,priest,shadow,65,34,31
40032,Whitehandpr,tichondrius,1576,priest,shadow,402,204,198
40033,Brothercarl,stormrage,1576,priest,shadow,48,24,24
40034,Darkshadows,ravenholdt,1575,priest,shadow,30,20,10
40035,Çummiñs,malganis,1575,priest,shadow,36,21,15
40036,Kaldrir,malganis,1574,priest,shadow,42,27,15
40037,Boogiê,illidan,1574,priest,shadow,114,64,50
40038,Heàvenly,moon-guard,1573,priest,shadow,36,21,15
40039,Bandages,stormreaver,1573,priest,shadow,109,58,51
40040,Ratleen,malganis,1570,priest,shadow,212,103,109
40041,Mealmassttr,frostmourne,1569,priest,shadow,42,21,21
40042,Raahsty,malganis,1569,priest,shadow,36,17,19
40043,Nizeurflayzz,tichondrius,1568,priest,shadow,56,32,24
40044,Milkgrabber,bleeding-hollow,1567,priest,shadow,145,77,68
40045,Sorrentin,ragnaros,1566,priest,shadow,64,34,30
40046,Amentia,area-52,1565,priest,shadow,36,20,16
40047,Xiphoidz,frostmourne,1562,priest,shadow,49,23,26
40048,Iminyou,kelthuzad,1561,priest,shadow,84,50,34
40049,Voidork,tichondrius,1560,priest,shadow,42,26,16
40050,Healypants,eonar,1560,priest,shadow,41,23,18
40051,Bugsbright,tichondrius,1560,priest,shadow,177,96,81
40052,Frankeebutt,stormrage,1559,priest,shadow,54,33,21
40053,Vicara,moon-guard,1559,priest,shadow,101,50,51
40054,Ethandryl,kelthuzad,1558,priest,shadow,39,23,16
40055,Dahliá,frostmourne,1558,priest,shadow,83,45,38
40056,Alex,boulderfist,1557,priest,shadow,54,31,23
40057,Nightelffeet,stormrage,1557,priest,shadow,30,17,13
40058,Voidshift,tichondrius,1556,priest,shadow,336,171,165
40059,Sìnz,area-52,1555,priest,shadow,36,26,10
40060,Hieken,nemesis,1555,priest,shadow,64,38,26
40061,Dottydaddy,emerald-dream,1554,priest,shadow,36,24,12
40062,Juicymist,moon-guard,1554,priest,shadow,276,153,123
40063,Fig,nazgrel,1554,priest,shadow,84,42,42
40064,Nightcráwler,illidan,1553,priest,shadow,42,25,17
40065,Rhima,tichondrius,1552,priest,shadow,24,17,7
40066,Tënëbrë,nemesis,1552,priest,shadow,73,43,30
40067,Vyabl,thrall,1552,priest,shadow,48,25,23
40068,Krazé,tichondrius,1552,priest,shadow,78,39,39
40069,Sindawen,kiljaeden,1551,priest,shadow,66,38,28
40070,Suicider,emerald-dream,1550,priest,shadow,188,95,93
40071,Volkova,quelthalas,1549,priest,shadow,30,19,11
40072,Softs,area-52,1549,priest,shadow,83,42,41
40073,Deiz,tichondrius,1549,priest,shadow,36,18,18
40074,Kuazi,frostmourne,1548,priest,shadow,42,24,18
40075,Proudigy,lightninghoof,1547,priest,shadow,93,54,39
40076,Ibringgears,tichondrius,1547,priest,shadow,91,47,44
40077,Relicsa,proudmoore,1547,priest,shadow,71,36,35
40078,Terranle,tichondrius,1545,priest,shadow,124,63,61
40079,Nøfaith,area-52,1544,priest,shadow,118,53,65
40080,Khelleya,moon-guard,1543,priest,shadow,48,26,22
40081,Toddmund,tichondrius,1543,priest,shadow,167,84,83
40082,Powerwordcry,stormrage,1542,priest,shadow,60,32,28
40083,Suery,hyjal,1542,priest,shadow,84,37,47
40084,Deffaultz,turalyon,1541,priest,shadow,58,34,24
40085,Abientot,tichondrius,1539,priest,shadow,84,47,37
40086,Stepho,dalaran,1539,priest,shadow,42,19,23
40087,Bigboyadam,frostmourne,1538,priest,shadow,88,55,33
40088,Lilithice,moon-guard,1537,priest,shadow,48,25,23
40089,Carniosso,azralon,1537,priest,shadow,134,69,65
40090,Faeinia,elune,1534,priest,shadow,105,61,44
40091,Mightyp,malganis,1534,priest,shadow,42,19,23
40092,Jah,frostmourne,1533,priest,shadow,30,16,14
40093,Aethestan,zuljin,1533,priest,shadow,83,37,46
40094,Irangara,gorefiend,1532,priest,shadow,50,25,25
40095,Anrop,illidan,1531,priest,shadow,48,31,17
40096,Dotdotwin,illidan,1531,priest,shadow,71,43,28
40097,Dikdik,tichondrius,1531,priest,shadow,75,42,33
40098,Originull,emerald-dream,1531,priest,shadow,30,16,14
40099,Iuvrainee,area-52,1531,priest,shadow,96,50,46
40100,Debbie,cairne,1527,priest,shadow,54,32,22
40101,Büd,sargeras,1527,priest,shadow,30,17,13
40102,Slogger,illidan,1527,priest,shadow,35,17,18
40103,Tutuhx,quelthalas,1526,priest,shadow,24,16,8
40104,Skgangmm,tichondrius,1526,priest,shadow,29,18,11
40105,Púrg,frostmourne,1526,priest,shadow,42,24,18
40106,Jojoxxz,illidan,1526,priest,shadow,49,27,22
40107,Purpskurp,stormrage,1525,priest,shadow,42,20,22
40108,Teddysedai,tichondrius,1524,priest,shadow,24,16,8
40109,Jmanhealz,stormrage,1523,priest,shadow,24,16,8
40110,Mellow,tichondrius,1523,priest,shadow,44,24,20
40111,Beckðn,tichondrius,1523,priest,shadow,94,50,44
40112,Ravinny,nemesis,1523,priest,shadow,64,32,32
40113,Slottie,malganis,1521,priest,shadow,42,21,21
40114,Márceline,stormrage,1520,priest,shadow,64,40,24
40115,Emlix,tichondrius,1520,priest,shadow,86,46,40
40116,Spriesto,frostmourne,1520,priest,shadow,35,18,17
40117,Tíosam,ragnaros,1519,priest,shadow,30,16,14
40118,Xannis,thrall,1517,priest,shadow,68,38,30
40119,Pestee,quelthalas,1517,priest,shadow,167,93,74
40120,Pics,emerald-dream,1517,priest,shadow,46,25,21
40121,Keepitlegal,sargeras,1515,priest,shadow,30,16,14
40122,Èvil,tichondrius,1514,priest,shadow,24,16,8
40123,Zhadowbolts,thrall,1514,priest,shadow,41,20,21
40124,Kadralin,illidan,1513,priest,shadow,84,45,39
40125,Shadowflux,thunderlord,1512,priest,shadow,42,17,25
40126,Theorym,tichondrius,1509,priest,shadow,46,32,14
40127,Popejack,stormrage,1509,priest,shadow,45,24,21
40128,Thelordx,barthilas,1507,priest,shadow,66,34,32
40129,Amideus,dunemaul,1507,priest,shadow,42,18,24
40130,Lowkii,malfurion,1505,priest,shadow,63,41,22
40131,Wobbleskank,tichondrius,1505,priest,shadow,84,50,34
40132,Shadylotion,stormrage,1505,priest,shadow,30,16,14
40133,Prickled,zuljin,1505,priest,shadow,91,46,45
40134,Krythe,laughing-skull,1505,priest,shadow,41,19,22
40135,Csheweishan,aerie-peak,1504,priest,shadow,84,44,40
40136,Justfaith,barthilas,1504,priest,shadow,73,35,38
40137,Aeonar,alleria,1503,priest,shadow,57,34,23
40138,Lucael,durotan,1503,priest,shadow,60,33,27
40139,Shadowhazed,tichondrius,1503,priest,shadow,42,23,19
40140,Twistedtéa,garrosh,1503,priest,shadow,42,20,22
40141,Dreaminz,tichondrius,1501,priest,shadow,30,17,13
40142,Shadowthief,magtheridon,1501,priest,shadow,30,16,14
40143,Vynlanesh,illidan,1501,priest,shadow,132,65,67
40144,Danoc,tichondrius,1500,priest,shadow,108,53,55
40145,Marantbourge,frostmourne,1499,priest,shadow,108,65,43
40146,Goodlife,frostmourne,1499,priest,shadow,36,16,20
40147,Bullma,boulderfist,1494,priest,shadow,22,17,5
40148,Irritated,vashj,1494,priest,shadow,24,16,8
40149,Creedence,jubeithos,1493,priest,shadow,65,33,32
40150,Dischaffy,shadowmoon,1491,priest,shadow,42,29,13
40151,Bradythree,moon-guard,1491,priest,shadow,30,19,11
40152,Yeeko,kiljaeden,1491,priest,shadow,30,17,13
40153,Palutena,drakkari,1491,priest,shadow,42,22,20
40154,Nekkz,sargeras,1490,priest,shadow,29,21,8
40155,Stellur,kelthuzad,1490,priest,shadow,29,18,11
40156,Azheel,stormrage,1490,priest,shadow,65,26,39
40157,Harisleidy,quelthalas,1488,priest,shadow,50,28,22
40158,Uncletouches,thrall,1488,priest,shadow,58,31,27
40159,Fïonan,proudmoore,1488,priest,shadow,72,35,37
40160,Ivyslays,area-52,1487,priest,shadow,77,42,35
40161,Cpoppa,sargeras,1487,priest,shadow,72,39,33
40162,Suirr,tichondrius,1486,priest,shadow,36,22,14
40163,Bestwizardx,tichondrius,1484,priest,shadow,33,21,12
40164,Propumper,dalaran,1483,priest,shadow,47,27,20
40165,Numinous,wyrmrest-accord,1483,priest,shadow,74,39,35
40166,Revóra,kelthuzad,1478,priest,shadow,84,51,33
40167,Øbara,frostmourne,1478,priest,shadow,105,57,48
40168,Razzamun,lothar,1478,priest,shadow,36,19,17
40169,Azagthøth,ravenholdt,1478,priest,shadow,239,122,117
40170,Swp,sargeras,1476,priest,shadow,48,29,19
40171,Teeprie,drakthul,1476,priest,shadow,58,35,23
40172,Hypochondria,moon-guard,1475,priest,shadow,51,31,20
40173,Astoshan,moon-guard,1475,priest,shadow,125,73,52
40174,Arataxx,area-52,1474,priest,shadow,66,32,34
40175,Halselin,senjin,1471,priest,shadow,124,75,49
40176,Jeanbi,ragnaros,1469,priest,shadow,150,81,69
40177,Zeromisx,proudmoore,1469,priest,shadow,34,16,18
40178,Rida,zuljin,1467,priest,shadow,50,31,19
40179,Allsmite,aerie-peak,1467,priest,shadow,54,29,25
40180,Shädë,emerald-dream,1467,priest,shadow,54,23,31
40181,Shadowbee,kargath,1466,priest,shadow,32,18,14
40182,Eraseme,bleeding-hollow,1466,priest,shadow,36,18,18
40183,Olrightt,stormrage,1465,priest,shadow,36,19,17
40184,Cuaiminator,ragnaros,1463,priest,shadow,87,47,40
40185,Stivche,frostmourne,1463,priest,shadow,39,19,20
40186,Shadeven,nagrand,1463,priest,shadow,39,18,21
40187,Muurielle,quelthalas,1462,priest,shadow,183,96,87
40188,Plzdontlos,hyjal,1461,priest,shadow,36,22,14
40189,Fritzi,shattered-hand,1456,priest,shadow,30,17,13
40190,Healtheze,kelthuzad,1456,priest,shadow,44,22,22
40191,Maynard,ragnaros,1455,priest,shadow,101,55,46
40192,Whorticiå,area-52,1455,priest,shadow,161,76,85
40193,Malikeht,drakkari,1453,priest,shadow,60,33,27
40194,Mikeysp,tichondrius,1453,priest,shadow,48,26,22
40195,Sînkaî,demon-soul,1453,priest,shadow,166,88,78
40196,Ghedeloco,tichondrius,1451,priest,shadow,30,18,12
40197,Creata,frostmourne,1450,priest,shadow,25,16,9
40198,Spoõks,darkspear,1449,priest,shadow,50,21,29
40199,Kilal,sargeras,1445,priest,shadow,36,24,12
40200,Zatthanea,hellscream,1445,priest,shadow,24,16,8
40201,Grizzlysmite,stormrage,1445,priest,shadow,37,17,20
40202,Sezyks,stormrage,1444,priest,shadow,30,23,7
40203,Aghorï,sargeras,1444,priest,shadow,86,42,44
40204,Lelyna,stormrage,1443,priest,shadow,46,27,19
40205,Plebcakès,sargeras,1441,priest,shadow,55,28,27
40206,Wdnmmd,proudmoore,1441,priest,shadow,157,76,81
40207,Vizioz,tichondrius,1441,priest,shadow,36,16,20
40208,Kokai,area-52,1440,priest,shadow,18,15,3
40209,Mentalprison,khazgoroth,1439,priest,shadow,30,15,15
40210,Nüt,malganis,1437,priest,shadow,53,29,24
40211,Dawnkìn,bleeding-hollow,1437,priest,shadow,138,72,66
40212,ßarracuda,illidan,1436,priest,shadow,114,65,49
40213,Onegil,tichondrius,1436,priest,shadow,75,38,37
40214,Comana,frostmourne,1435,priest,shadow,18,15,3
40215,Moistfather,kelthuzad,1435,priest,shadow,47,29,18
40216,Theodorous,frostmourne,1435,priest,shadow,63,34,29
40217,Papadoll,malganis,1435,priest,shadow,38,20,18
40218,Mindfulness,tichondrius,1434,priest,shadow,24,15,9
40219,Bbeaie,tichondrius,1433,priest,shadow,30,15,15
40220,Ezrashade,tichondrius,1433,priest,shadow,95,44,51
40221,Cartus,emerald-dream,1432,priest,shadow,36,21,15
40222,Duatneter,quelthalas,1432,priest,shadow,66,38,28
40223,Niias,hyjal,1432,priest,shadow,87,50,37
40224,Stromile,tichondrius,1431,priest,shadow,24,17,7
40225,Årann,azralon,1431,priest,shadow,24,15,9
40226,Covidchamp,proudmoore,1431,priest,shadow,24,15,9
40227,Ciem,tichondrius,1431,priest,shadow,24,15,9
40228,Spacethug,illidan,1431,priest,shadow,30,15,15
40229,Fadedatm,illidan,1431,priest,shadow,36,15,21
40230,Umbrah,veknilash,1430,priest,shadow,24,15,9
40231,Wowgreatgame,tichondrius,1430,priest,shadow,59,31,28
40232,Kellsyo,hyjal,1429,priest,shadow,18,15,3
40233,Yuhstin,sargeras,1429,priest,shadow,24,15,9
40234,Synkiz,darkspear,1428,priest,shadow,95,51,44
40235,Sandrö,sargeras,1427,priest,shadow,24,15,9
40236,Supremezx,frostmourne,1427,priest,shadow,78,42,36
40237,Aguitardient,ragnaros,1426,priest,shadow,33,19,14
40238,Stusy,tichondrius,1425,priest,shadow,71,44,27
40239,Younext,sargeras,1425,priest,shadow,63,22,41
40240,Mitoloshi,ragnaros,1424,priest,shadow,42,19,23
40241,Zarøw,tichondrius,1423,priest,shadow,24,15,9
40242,Corthien,thrall,1422,priest,shadow,18,15,3
40243,Frorgnence,stormrage,1422,priest,shadow,36,26,10
40244,Fathersmits,area-52,1422,priest,shadow,24,15,9
40245,Anmu,illidan,1418,priest,shadow,29,16,13
40246,Lilmix,hydraxis,1417,priest,shadow,41,26,15
40247,Rotass,hyjal,1415,priest,shadow,23,16,7
40248,Strokkerx,azralon,1414,priest,shadow,110,59,51
40249,Moogyvoid,tichondrius,1414,priest,shadow,42,19,23
40250,Ramaven,arygos,1413,priest,shadow,78,39,39
40251,Showakoi,ragnaros,1412,priest,shadow,54,29,25
40252,Xammys,malganis,1410,priest,shadow,41,26,15
40253,Pastortee,sargeras,1409,priest,shadow,65,35,30
40254,Flickmybick,sargeras,1409,priest,shadow,93,44,49
40255,Wongÿ,tichondrius,1408,priest,shadow,30,24,6
40256,Sandelios,aggramar,1408,priest,shadow,42,28,14
40257,Shadzie,sargeras,1408,priest,shadow,53,30,23
40258,Vílja,moon-guard,1407,priest,shadow,135,68,67
40259,Chewthefat,darkspear,1406,priest,shadow,29,15,14
40260,Londy,area-52,1405,priest,shadow,477,238,239
40261,ßroßraßroski,sargeras,1403,priest,shadow,42,24,18
40262,Ed,crushridge,1402,priest,shadow,53,30,23
40263,Bastét,skullcrusher,1402,priest,shadow,108,60,48
40264,Ampela,dalaran,1402,priest,shadow,63,33,30
40265,Shirubamoya,gurubashi,1401,priest,shadow,41,23,18
40266,Pandarue,tichondrius,1401,priest,shadow,87,47,40
40267,Zeroghp,tichondrius,1401,priest,shadow,30,15,15
40268,Mindboink,malganis,1400,priest,shadow,82,44,38
40269,Chibii,kelthuzad,1398,priest,shadow,24,22,2
40270,Seedisc,kelthuzad,1398,priest,shadow,51,30,21
40271,Kuazi,khazgoroth,1398,priest,shadow,125,59,66
40272,Aabye,nemesis,1397,priest,shadow,23,16,7
40273,Imhðtep,ragnaros,1397,priest,shadow,84,40,44
40274,Aedaki,garona,1396,priest,shadow,154,85,69
40275,Naieth,aerie-peak,1396,priest,shadow,45,20,25
40276,Grianné,mannoroth,1395,priest,shadow,30,20,10
40277,Scarsdeath,azralon,1395,priest,shadow,52,27,25
40278,Elogant,frostmourne,1395,priest,shadow,112,47,65
40279,Haø,stormrage,1393,priest,shadow,98,50,48
40280,Ashtahius,ragnaros,1392,priest,shadow,113,65,48
40281,Habann,frostmourne,1392,priest,shadow,140,71,69
40282,Nyctelis,sargeras,1392,priest,shadow,40,19,21
40283,Fzz,tichondrius,1391,priest,shadow,29,16,13
40284,Daysgone,bleeding-hollow,1391,priest,shadow,293,154,139
40285,Holyren,sargeras,1391,priest,shadow,68,31,37
40286,Constentien,tichondrius,1390,priest,shadow,30,16,14
40287,Dipírex,azralon,1389,priest,shadow,84,40,44
40288,Mindeas,the-forgotten-coast,1387,priest,shadow,32,15,17
40289,Barelylegalx,tichondrius,1387,priest,shadow,36,16,20
40290,Fäÿë,tichondrius,1386,priest,shadow,54,26,28
40291,Vinasky,moon-guard,1386,priest,shadow,38,16,22
40292,Achíllesheal,stormrage,1385,priest,shadow,101,53,48
40293,Bloodify,azralon,1385,priest,shadow,53,26,27
40294,Healztonic,dalaran,1380,priest,shadow,72,32,40
40295,Tye,medivh,1378,priest,shadow,30,15,15
40296,Bigmollet,tichondrius,1378,priest,shadow,90,37,53
40297,Lawgiva,thrall,1377,priest,shadow,30,19,11
40298,Jadon,sargeras,1377,priest,shadow,38,22,16
40299,Xtcbtc,sargeras,1376,priest,shadow,29,15,14
40300,Miniimenx,azralon,1375,priest,shadow,41,29,12
40301,Voidscrypt,thrall,1374,priest,shadow,106,62,44
40302,Saphet,draktharon,1373,priest,shadow,94,58,36
40303,Coors,lightnings-blade,1371,priest,shadow,30,15,15
40304,ßluedreamx,tichondrius,1370,priest,shadow,23,15,8
40305,Urspareparts,sargeras,1370,priest,shadow,89,48,41
40306,Onixió,ragnaros,1369,priest,shadow,30,15,15
40307,Sylvane,silvermoon,1368,priest,shadow,53,31,22
40308,Spõõky,illidan,1368,priest,shadow,26,15,11
40309,Xionys,sargeras,1368,priest,shadow,60,29,31
40310,Tyisanity,tichondrius,1368,priest,shadow,68,32,36
40311,Stellaryn,moon-guard,1368,priest,shadow,42,17,25
40312,Bûdussy,bonechewer,1366,priest,shadow,73,36,37
40313,Saltheril,burning-blade,1366,priest,shadow,37,18,19
40314,Aránhell,ragnaros,1365,priest,shadow,48,28,20
40315,Nucypher,illidan,1365,priest,shadow,39,17,22
40316,Luminous,moon-guard,1364,priest,shadow,32,18,14
40317,Lolcrafthd,ragnaros,1364,priest,shadow,30,16,14
40318,Scenekîd,moon-guard,1364,priest,shadow,42,20,22
40319,Heihunüwang,kargath,1363,priest,shadow,26,15,11
40320,Phantomz,malganis,1362,priest,shadow,47,30,17
40321,Chaas,ragnaros,1361,priest,shadow,114,59,55
40322,Scadie,goldrinn,1360,priest,shadow,30,15,15
40323,Manofmystery,drenden,1359,priest,shadow,23,15,8
40324,Alvorr,ragnaros,1359,priest,shadow,76,41,35
40325,Shén,barthilas,1358,priest,shadow,95,61,34
40326,Mãstermerlin,frostmourne,1358,priest,shadow,41,20,21
40327,Beloriath,ragnaros,1356,priest,shadow,29,15,14
40328,Irilde,proudmoore,1356,priest,shadow,42,21,21
40329,Icytaken,frostmourne,1353,priest,shadow,48,22,26
40330,Discobish,sargeras,1350,priest,shadow,30,17,13
40331,Andso,azralon,1348,priest,shadow,36,17,19
40332,Janesville,tichondrius,1345,priest,shadow,24,16,8
40333,Littlebagel,nesingwary,1344,priest,shadow,57,32,25
40334,Poague,area-52,1343,priest,shadow,24,14,10
40335,Brwnricetuna,frostmourne,1343,priest,shadow,27,15,12
40336,Task,korgath,1343,priest,shadow,41,18,23
40337,Mcbot,illidan,1342,priest,shadow,18,14,4
40338,Ukishizumi,tichondrius,1342,priest,shadow,18,14,4
40339,Flay,dragonmaw,1342,priest,shadow,18,14,4
40340,Cixelp,tichondrius,1342,priest,shadow,30,14,16
40341,Duckdemon,ragnaros,1341,priest,shadow,101,49,52
40342,Yåmi,arthas,1340,priest,shadow,18,14,4
40343,Mudkrab,gundrak,1340,priest,shadow,18,14,4
40344,Pwrwordsquee,lightbringer,1339,priest,shadow,24,14,10
40345,Antorieth,area-52,1339,priest,shadow,24,14,10
40346,Verbeka,nemesis,1338,priest,shadow,18,14,4
40347,Cptnrockwèll,dalaran,1337,priest,shadow,98,53,45
40348,Labraidor,tichondrius,1336,priest,shadow,105,44,61
40349,Qadris,tichondrius,1336,priest,shadow,36,14,22
40350,Nobutter,archimonde,1335,priest,shadow,24,14,10
40351,Scriptö,fizzcrank,1334,priest,shadow,72,47,25
40352,Pikeysplol,illidan,1334,priest,shadow,24,14,10
40353,Hüde,stormrage,1334,priest,shadow,102,53,49
40354,Osmatspriest,firetree,1334,priest,shadow,33,15,18
40355,Boogle,frostmourne,1333,priest,shadow,59,26,33
40356,Chenny,darkspear,1332,priest,shadow,72,40,32
40357,Zeas,moon-guard,1331,priest,shadow,42,23,19
40358,Ellipses,bleeding-hollow,1331,priest,shadow,30,14,16
40359,Jhivagosp,tichondrius,1331,priest,shadow,34,15,19
40360,Leach,darkspear,1330,priest,shadow,77,33,44
40361,Nyktøs,quelthalas,1326,priest,shadow,42,18,24
40362,Nòemis,quelthalas,1325,priest,shadow,24,14,10
40363,Sacerthu,goldrinn,1325,priest,shadow,36,20,16
40364,Brshki,tichondrius,1324,priest,shadow,18,14,4
40365,Bibledave,whisperwind,1323,priest,shadow,33,17,16
40366,Reverendpope,tichondrius,1323,priest,shadow,48,19,29
40367,Badnfluence,kiljaeden,1322,priest,shadow,30,17,13
40368,Onipapae,frostmourne,1321,priest,shadow,113,58,55
40369,Pacmanlol,greymane,1319,priest,shadow,18,14,4
40370,Shadyvoodoo,barthilas,1319,priest,shadow,104,54,50
40371,Gnow,moon-guard,1319,priest,shadow,65,32,33
40372,Faithplusone,zuljin,1318,priest,shadow,24,15,9
40373,Mortivore,azralon,1318,priest,shadow,30,14,16
40374,Maniwa,dentarg,1317,priest,shadow,42,15,27
40375,Chádeervas,nemesis,1315,priest,shadow,39,24,15
40376,Etan,thrall,1314,priest,shadow,85,44,41
40377,Rammstèin,sargeras,1314,priest,shadow,30,14,16
40378,Lirien,kelthuzad,1312,priest,shadow,56,20,36
40379,Timreaper,barthilas,1311,priest,shadow,41,24,17
40380,Vanisa,hellscream,1309,priest,shadow,53,29,24
40381,Eskettit,korgath,1308,priest,shadow,24,14,10
40382,Alisaie,dalvengyr,1308,priest,shadow,52,27,25
40383,Uvebeendead,the-forgotten-coast,1306,priest,shadow,72,42,30
40384,Goodvybz,illidan,1306,priest,shadow,44,18,26
40385,Shadowtreta,azralon,1305,priest,shadow,42,26,16
40386,Bigvoidman,area-52,1305,priest,shadow,36,15,21
40387,Roylwcheese,illidan,1304,priest,shadow,24,16,8
40388,Kflexx,hydraxis,1303,priest,shadow,24,15,9
40389,Ilumus,lightnings-blade,1300,priest,shadow,24,14,10
40390,Dioscura,malganis,1298,priest,shadow,26,15,11
40391,Zyræl,stormrage,1298,priest,shadow,125,59,66
40392,Sekhen,area-52,1298,priest,shadow,49,23,26
40393,Bustmybubble,tichondrius,1297,priest,shadow,50,34,16
40394,Mamofwar,arthas,1296,priest,shadow,66,29,37
40395,Bobbeans,area-52,1295,priest,shadow,30,18,12
40396,Øvøxø,emerald-dream,1295,priest,shadow,33,15,18
40397,Blindingstar,area-52,1294,priest,shadow,17,14,3
40398,Beautifulgir,illidan,1294,priest,shadow,30,18,12
40399,Reos,jubeithos,1294,priest,shadow,54,32,22
40400,Minðgãmès,illidan,1291,priest,shadow,21,15,6
40401,Ancene,illidan,1290,priest,shadow,42,24,18
40402,Àx,draka,1290,priest,shadow,32,18,14
40403,Hervert,area-52,1289,priest,shadow,36,19,17
40404,Estelars,aggramar,1289,priest,shadow,210,109,101
40405,Thotsndots,blood-furnace,1288,priest,shadow,26,15,11
40406,Tjxx,zuljin,1287,priest,shadow,72,36,36
40407,Lilpika,illidan,1283,priest,shadow,66,31,35
40408,Puerquirri,quelthalas,1280,priest,shadow,36,19,17
40409,Likeleela,azshara,1279,priest,shadow,89,42,47
40410,Valloren,kalecgos,1278,priest,shadow,26,15,11
40411,Ketchuslipin,illidan,1277,priest,shadow,62,27,35
40412,Abolita,korgath,1276,priest,shadow,120,65,55
40413,Alphawon,area-52,1276,priest,shadow,105,51,54
40414,Omenous,area-52,1276,priest,shadow,52,22,30
40415,Furìøns,nemesis,1275,priest,shadow,24,15,9
40416,Ralphiez,tichondrius,1273,priest,shadow,52,27,25
40417,Marni,akama,1272,priest,shadow,91,42,49
40418,Healixd,area-52,1271,priest,shadow,36,14,22
40419,Shadøwheal,stormrage,1269,priest,shadow,36,22,14
40420,Layrissa,whisperwind,1266,priest,shadow,24,15,9
40421,Pozcas,blood-furnace,1265,priest,shadow,24,14,10
40422,Lyriczx,kelthuzad,1265,priest,shadow,42,18,24
40423,Maricotä,azralon,1263,priest,shadow,36,21,15
40424,Festær,area-52,1258,priest,shadow,64,34,30
40425,Synergize,korgath,1254,priest,shadow,60,30,30
40426,Raoel,proudmoore,1253,priest,shadow,24,15,9
40427,Stankylegz,tichondrius,1251,priest,shadow,30,16,14
40428,Zolgeta,exodar,1250,priest,shadow,47,31,16
40429,Gothii,tichondrius,1250,priest,shadow,47,16,31
40430,Zinr,tichondrius,1249,priest,shadow,36,16,20
40431,Jwx,malganis,1248,priest,shadow,18,13,5
40432,Verbane,frostmourne,1248,priest,shadow,24,13,11
40433,Madcuzyaknow,bleeding-hollow,1248,priest,shadow,24,13,11
40434,Envyion,sargeras,1248,priest,shadow,24,13,11
40435,Kristt,thrall,1247,priest,shadow,168,76,92
40436,Keicel,zuljin,1246,priest,shadow,24,13,11
40437,Quinlan,dreadmaul,1246,priest,shadow,40,19,21
40438,Bubblepop,blackhand,1245,priest,shadow,18,13,5
40439,Demples,darkspear,1245,priest,shadow,30,20,10
40440,Cheez,tichondrius,1245,priest,shadow,100,43,57
40441,Fanfansp,tichondrius,1244,priest,shadow,18,13,5
40442,Sakuraginero,illidan,1243,priest,shadow,24,13,11
40443,Shadowjisha,emerald-dream,1243,priest,shadow,33,14,19
40444,Aeingel,amanthul,1243,priest,shadow,47,16,31
40445,Pri,jubeithos,1242,priest,shadow,18,13,5
40446,Ashidox,proudmoore,1242,priest,shadow,27,14,13
40447,Nonbinary,trollbane,1242,priest,shadow,30,14,16
40448,Shadhoee,sargeras,1242,priest,shadow,36,13,23
40449,Jexso,tichondrius,1242,priest,shadow,37,13,24
40450,Houzz,frostmourne,1241,priest,shadow,18,13,5
40451,Xarid,moon-guard,1240,priest,shadow,24,13,11
40452,Xedus,mannoroth,1240,priest,shadow,74,37,37
40453,Nóin,tichondrius,1240,priest,shadow,83,34,49
40454,Shådøw,destromath,1239,priest,shadow,24,13,11
40455,Rucati,cenarius,1239,priest,shadow,39,17,22
40456,Ascian,daggerspine,1239,priest,shadow,30,13,17
40457,Dilly,tichondrius,1238,priest,shadow,21,14,7
40458,Csonka,stormrage,1238,priest,shadow,44,17,27
40459,Xijinping,chogall,1237,priest,shadow,24,13,11
40460,Kàiju,zuljin,1237,priest,shadow,42,19,23
40461,Nums,tichondrius,1236,priest,shadow,48,25,23
40462,Rykispriest,tichondrius,1234,priest,shadow,18,13,5
40463,Dernièreplac,blackrock,1234,priest,shadow,27,16,11
40464,Shadowyeti,illidan,1233,priest,shadow,18,13,5
40465,Cykle,blackrock,1233,priest,shadow,42,13,29
40466,Dockavok,bloodhoof,1232,priest,shadow,18,13,5
40467,Mortemus,drenden,1232,priest,shadow,26,16,10
40468,Hephiron,area-52,1232,priest,shadow,63,25,38
40469,Jiedx,tichondrius,1230,priest,shadow,35,14,21
40470,Elam,ragnaros,1229,priest,shadow,53,19,34
40471,Boill,illidan,1228,priest,shadow,18,13,5
40472,Fadedvoid,malorne,1228,priest,shadow,18,13,5
40473,Cowabungá,azralon,1227,priest,shadow,18,13,5
40474,Kaermor,stormrage,1227,priest,shadow,66,28,38
40475,Simplyfaded,black-dragonflight,1226,priest,shadow,24,13,11
40476,Pfl,area-52,1226,priest,shadow,146,71,75
40477,Payan,barthilas,1224,priest,shadow,54,27,27
40478,Bmô,stormrage,1223,priest,shadow,53,24,29
40479,Antoz,kelthuzad,1222,priest,shadow,49,28,21
40480,Chinchillin,demon-soul,1222,priest,shadow,171,89,82
40481,Brokenpriest,wyrmrest-accord,1220,priest,shadow,51,22,29
40482,Mindraker,turalyon,1217,priest,shadow,18,13,5
40483,Shinyspriest,tichondrius,1212,priest,shadow,89,44,45
40484,Sorrowful,mannoroth,1208,priest,shadow,29,13,16
40485,Castnngcouch,tichondrius,1207,priest,shadow,42,21,21
40486,Tylored,zuljin,1205,priest,shadow,42,16,26
40487,Discpi,illidan,1202,priest,shadow,78,34,44
40488,Senumbra,tichondrius,1200,priest,shadow,36,16,20
40489,Overcastedxo,kelthuzad,1199,priest,shadow,68,40,28
40490,Holydarkness,quelthalas,1196,priest,shadow,65,27,38
40491,Hairypenance,sargeras,1194,priest,shadow,23,13,10
40492,Dockani,sargeras,1194,priest,shadow,66,31,35
40493,Whisper,zuljin,1190,priest,shadow,43,23,20
40494,Lùcìd,dalaran,1189,priest,shadow,24,17,7
40495,Foli,zuljin,1187,priest,shadow,22,14,8
40496,Moon,moonrunner,1186,priest,shadow,47,23,24
40497,Aflstan,frostmourne,1185,priest,shadow,57,34,23
40498,Locjawbe,area-52,1183,priest,shadow,65,29,36
40499,Pristoleiro,azralon,1182,priest,shadow,17,13,4
40500,Anathamaz,stormrage,1182,priest,shadow,36,13,23
40501,Fullfear,lothar,1178,priest,shadow,26,13,13
40502,Darksheals,barthilas,1176,priest,shadow,30,22,8
40503,Mankbadar,tichondrius,1174,priest,shadow,34,13,21
40504,Vynardis,arygos,1173,priest,shadow,61,27,34
40505,Urmorphine,area-52,1170,priest,shadow,209,109,100
40506,Zelashan,proudmoore,1170,priest,shadow,30,14,16
40507,Thedarkshade,area-52,1168,priest,shadow,45,28,17
40508,Pootzy,malganis,1166,priest,shadow,25,13,12
40509,Amestroada,nemesis,1166,priest,shadow,27,14,13
40510,Tanthdrel,proudmoore,1166,priest,shadow,36,18,18
40511,Agraciada,illidan,1164,priest,shadow,57,32,25
40512,Beneficium,nazjatar,1163,priest,shadow,66,35,31
40513,Yaann,zuljin,1162,priest,shadow,42,22,20
40514,Trollypriest,darkspear,1157,priest,shadow,94,44,50
40515,Snakklè,illidan,1152,priest,shadow,18,13,5
40516,Taxzury,tichondrius,1152,priest,shadow,18,12,6
40517,Mmys,tichondrius,1152,priest,shadow,24,12,12
40518,Flamédøtz,ragnaros,1151,priest,shadow,18,12,6
40519,Wojangles,zuljin,1151,priest,shadow,18,12,6
40520,Haracka,quelthalas,1151,priest,shadow,24,12,12
40521,Mindtrip,korgath,1151,priest,shadow,54,23,31
40522,Rmpmeeper,kilrogg,1150,priest,shadow,12,12,0
40523,Airil,mugthol,1150,priest,shadow,18,12,6
40524,Calientaeggs,drakkari,1150,priest,shadow,18,12,6
40525,Shadowp,shattered-halls,1150,priest,shadow,24,12,12
40526,Bàttlepriest,caelestrasz,1150,priest,shadow,36,16,20
40527,Nùm,tichondrius,1147,priest,shadow,21,13,8
40528,Fouroneo,tichondrius,1146,priest,shadow,24,12,12
40529,Teccalil,tichondrius,1146,priest,shadow,24,12,12
40530,Abednego,area-52,1145,priest,shadow,21,13,8
40531,Growth,fizzcrank,1145,priest,shadow,24,12,12
40532,Nktxc,tichondrius,1145,priest,shadow,24,12,12
40533,Dayquills,illidan,1145,priest,shadow,24,12,12
40534,Lidole,barthilas,1145,priest,shadow,30,12,18
40535,Kk,fizzcrank,1144,priest,shadow,24,12,12
40536,Omnivoîd,tichondrius,1144,priest,shadow,24,12,12
40537,Luokni,illidan,1143,priest,shadow,18,12,6
40538,Dralaan,proudmoore,1143,priest,shadow,43,26,17
40539,Îcecube,sargeras,1142,priest,shadow,24,12,12
40540,ßuffysummer,illidan,1141,priest,shadow,30,12,18
40541,Srenity,zuljin,1140,priest,shadow,24,12,12
40542,Kibariyb,drakkari,1139,priest,shadow,30,12,18
40543,Faithhealing,zuljin,1136,priest,shadow,86,42,44
40544,Unholyreáper,magtheridon,1132,priest,shadow,24,12,12
40545,Kundalini,boulderfist,1132,priest,shadow,35,16,19
40546,Vvti,quelthalas,1125,priest,shadow,28,15,13
40547,Lilmermaid,laughing-skull,1118,priest,shadow,24,12,12
40548,Saura,aegwynn,1111,priest,shadow,22,12,10
40549,Knglizward,stormrage,1110,priest,shadow,71,38,33
40550,Matafuka,ragnaros,1109,priest,shadow,88,44,44
40551,Ëlliot,stormrage,1104,priest,shadow,33,15,18
40552,Võid,tichondrius,1103,priest,shadow,23,12,11
40553,Shämus,dalaran,1097,priest,shadow,82,41,41
40554,Thrilas,silver-hand,1092,priest,shadow,24,12,12
40555,Misslost,nerzhul,1081,priest,shadow,23,12,11
40556,Ssphex,tichondrius,1076,priest,shadow,48,26,22
40557,Khaibit,stormrage,1073,priest,shadow,39,23,16
40558,Scormm,runetotem,1073,priest,shadow,24,13,11
40559,Pestî,area-52,1073,priest,shadow,54,20,34
40560,Lyxorr,area-52,1068,priest,shadow,30,12,18
40561,Galice,archimonde,1066,priest,shadow,66,33,33
40562,Eslaughter,twisting-nether,1061,priest,shadow,24,16,8
40563,Valeknun,stormrage,1060,priest,shadow,36,24,12
40564,Khenshin,ragnaros,1058,priest,shadow,59,31,28
40565,Freebolte,frostmourne,1056,priest,shadow,12,11,1
40566,Lastbubble,area-52,1056,priest,shadow,24,11,13
40567,Hakirn,bleeding-hollow,1055,priest,shadow,12,11,1
40568,Patagoniabae,kelthuzad,1055,priest,shadow,12,11,1
40569,Mitogen,malganis,1055,priest,shadow,18,11,7
40570,Icychain,area-52,1055,priest,shadow,18,11,7
40571,Bearuwu,frostmourne,1055,priest,shadow,24,11,13
40572,Sleezi,emerald-dream,1054,priest,shadow,18,11,7
40573,Plenipotent,moon-guard,1054,priest,shadow,26,15,11
40574,Roterick,wyrmrest-accord,1053,priest,shadow,18,11,7
40575,Xdlolqt,sargeras,1053,priest,shadow,24,11,13
40576,Eatmyspells,malganis,1053,priest,shadow,24,11,13
40577,Voidhearted,tichondrius,1053,priest,shadow,30,11,19
40578,Abnormality,trollbane,1052,priest,shadow,12,11,1
40579,Talkura,tichondrius,1052,priest,shadow,12,11,1
40580,Tydïus,illidan,1052,priest,shadow,18,11,7
40581,Bhruno,proudmoore,1052,priest,shadow,18,11,7
40582,Fancyspork,illidan,1052,priest,shadow,24,11,13
40583,Legitgayirl,zuljin,1052,priest,shadow,24,11,13
40584,Féarlust,demon-soul,1051,priest,shadow,18,11,7
40585,Nerfmehard,tichondrius,1050,priest,shadow,18,11,7
40586,Norbon,mugthol,1050,priest,shadow,18,11,7
40587,Oldmanlou,spirestone,1049,priest,shadow,18,11,7
40588,Milojac,hyjal,1049,priest,shadow,18,11,7
40589,Semillion,tichondrius,1049,priest,shadow,24,11,13
40590,Jilt,aerie-peak,1048,priest,shadow,24,11,13
40591,Tinypuppyy,sargeras,1047,priest,shadow,37,14,23
40592,Nocturnalx,moon-guard,1045,priest,shadow,18,11,7
40593,Luzsombraa,stormrage,1042,priest,shadow,24,11,13
40594,Bec,khadgar,1042,priest,shadow,24,11,13
40595,Shadynasti,azshara,1041,priest,shadow,24,14,10
40596,Kushie,saurfang,1039,priest,shadow,24,11,13
40597,Floofball,medivh,1038,priest,shadow,18,11,7
40598,Demoñ,deathwing,1035,priest,shadow,24,11,13
40599,Alzu,ragnaros,1023,priest,shadow,23,11,12
40600,Thaedreu,area-52,1022,priest,shadow,29,11,18
40601,Oglilptown,thunderlord,1005,priest,shadow,60,33,27
40602,Angro,ragnaros,1005,priest,shadow,24,13,11
40603,Ipse,azshara,1004,priest,shadow,84,46,38
40604,Fedodesubaco,gallywix,1004,priest,shadow,51,27,24
40605,Nadrii,illidan,1002,priest,shadow,36,17,19
40606,Sinkz,ragnaros,992,priest,shadow,16,11,5
40607,Pocket,alleria,991,priest,shadow,22,11,11
40608,Janke,malganis,990,priest,shadow,20,11,9
40609,Coolbie,korgath,990,priest,shadow,26,11,15
40610,Daemoon,deathwing,973,priest,shadow,20,12,8
40611,Oxytoxin,sargeras,971,priest,shadow,19,11,8
40612,Soonya,arygos,966,priest,shadow,27,12,15
40613,Discountay,burning-legion,965,priest,shadow,20,11,9
40614,Robhàlford,ragnaros,964,priest,shadow,25,11,14
40615,Insindious,sargeras,963,priest,shadow,15,12,3
40616,Mmrassassin,stormrage,960,priest,shadow,12,10,2
40617,Icarryozz,darkspear,960,priest,shadow,12,10,2
40618,Abc,spirestone,960,priest,shadow,12,10,2
40619,Shadowkenlol,tichondrius,960,priest,shadow,23,13,10
40620,Kong,shandris,960,priest,shadow,18,10,8
40621,Anoumenon,tichondrius,960,priest,shadow,18,10,8
40622,Kissmyvoìd,frostmourne,960,priest,shadow,18,10,8
40623,Pèrona,tichondrius,960,priest,shadow,18,10,8
40624,Jugeum,proudmoore,960,priest,shadow,18,10,8
40625,Plumpkinn,kiljaeden,960,priest,shadow,18,10,8
40626,Evilgeniusx,area-52,960,priest,shadow,18,10,8
40627,Rendoss,arathor,959,priest,shadow,12,10,2
40628,Synergia,drakkari,959,priest,shadow,12,10,2
40629,Inflìctìøn,frostmourne,959,priest,shadow,12,10,2
40630,Jahz,zuljin,959,priest,shadow,12,10,2
40631,Diyel,area-52,959,priest,shadow,12,10,2
40632,Xtradotz,tichondrius,959,priest,shadow,18,10,8
40633,Bestpimp,frostmane,959,priest,shadow,18,10,8
40634,Saitii,dalaran,959,priest,shadow,18,10,8
40635,Ayzen,emerald-dream,959,priest,shadow,18,10,8
40636,Delai,dalaran,959,priest,shadow,18,10,8
40637,Vixova,illidan,959,priest,shadow,18,10,8
40638,Philmacrakn,stormrage,959,priest,shadow,18,10,8
40639,Luciellis,sargeras,959,priest,shadow,18,10,8
40640,Iamjakehill,area-52,959,priest,shadow,18,10,8
40641,Keepsleepin,stormrage,959,priest,shadow,24,10,14
40642,Terý,dalaran,959,priest,shadow,24,10,14
40643,Vikingkøng,ragnaros,958,priest,shadow,12,10,2
40644,Felskie,tichondrius,958,priest,shadow,12,10,2
40645,Deckx,khazgoroth,958,priest,shadow,16,11,5
40646,Bratty,hellscream,958,priest,shadow,15,10,5
40647,Cerriôus,baelgun,958,priest,shadow,18,10,8
40648,Porffy,malygos,958,priest,shadow,18,10,8
40649,Deawalker,khaz-modan,958,priest,shadow,18,10,8
40650,Tatzis,frostmourne,958,priest,shadow,18,10,8
40651,Iggyp,hyjal,958,priest,shadow,18,10,8
40652,Caramelos,moon-guard,958,priest,shadow,24,10,14
40653,Exigyo,quelthalas,957,priest,shadow,23,13,10
40654,Hecáte,dalaran,957,priest,shadow,18,10,8
40655,Holyfüry,ragnaros,956,priest,shadow,12,10,2
40656,Dyé,hydraxis,956,priest,shadow,18,10,8
40657,Såx,stormreaver,956,priest,shadow,24,10,14
40658,Gankdalf,draktharon,955,priest,shadow,18,10,8
40659,Mathertia,dalaran,954,priest,shadow,18,10,8
40660,Mettz,malganis,954,priest,shadow,18,10,8
40661,Slctivhealng,area-52,954,priest,shadow,18,10,8
40662,Lätöxïkä,alleria,954,priest,shadow,24,10,14
40663,Ragnálodbrok,ragnaros,953,priest,shadow,18,10,8
40664,Xora,frostmourne,952,priest,shadow,18,10,8
40665,Fearmongrol,bleeding-hollow,950,priest,shadow,24,10,14
40666,Hitful,azralon,949,priest,shadow,12,10,2
40667,Cymin,dalaran,943,priest,shadow,25,12,13
40668,Farnkxd,bleeding-hollow,925,priest,shadow,32,11,21
40669,Rassalor,frostmane,910,priest,shadow,17,10,7
40670,Flaytonmanin,korgath,910,priest,shadow,21,10,11
40671,Thrageqt,sargeras,908,priest,shadow,20,11,9
40672,Silmeriá,darkspear,904,priest,shadow,29,11,18
40673,Ràvn,emerald-dream,903,priest,shadow,16,12,4
40674,Beeds,sargeras,902,priest,shadow,105,44,61
40675,Khall,sargeras,895,priest,shadow,40,17,23
40676,Exen,moon-guard,894,priest,shadow,18,11,7
40677,Battlepope,the-scryers,890,priest,shadow,31,14,17
40678,Berixa,stormscale,883,priest,shadow,11,10,1
40679,Datcuban,illidan,874,priest,shadow,20,11,9
40680,Lockerest,sargeras,868,priest,shadow,41,13,28
40681,Æë,area-52,864,priest,shadow,12,9,3
40682,Beibeihang,tichondrius,864,priest,shadow,12,9,3
40683,Nutdrip,kelthuzad,864,priest,shadow,12,9,3
40684,Jâmïè,gurubashi,864,priest,shadow,12,9,3
40685,Feverx,tichondrius,864,priest,shadow,12,9,3
40686,Powerwordhim,malganis,864,priest,shadow,12,9,3
40687,Adeptphd,tichondrius,864,priest,shadow,12,9,3
40688,Voidcult,area-52,864,priest,shadow,18,9,9
40689,Slimfo,sargeras,864,priest,shadow,18,9,9
40690,Spookytorch,illidan,864,priest,shadow,18,9,9
40691,Wololo,emerald-dream,864,priest,shadow,18,9,9
40692,Tiernocookie,illidan,864,priest,shadow,18,9,9
40693,Achllia,proudmoore,864,priest,shadow,18,9,9
40694,Bumbleedot,azralon,864,priest,shadow,18,9,9
40695,Swurvexo,bleeding-hollow,864,priest,shadow,24,9,15
40696,Charity,maelstrom,863,priest,shadow,12,9,3
40697,Dyhm,gorgonnash,863,priest,shadow,12,9,3
40698,Melterdecara,tichondrius,863,priest,shadow,12,9,3
40699,Pumtootoot,tichondrius,863,priest,shadow,12,9,3
40700,Sadomyhusein,eitrigg,863,priest,shadow,12,9,3
40701,Ðecease,thrall,863,priest,shadow,18,9,9
40702,Küno,kelthuzad,863,priest,shadow,18,9,9
40703,Dnn,malganis,863,priest,shadow,18,9,9
40704,Iamgayx,kelthuzad,863,priest,shadow,18,9,9
40705,Woosanghong,tichondrius,863,priest,shadow,18,9,9
40706,Delrey,sargeras,863,priest,shadow,18,9,9
40707,Acpriest,tichondrius,863,priest,shadow,24,9,15
40708,Voidrisu,sargeras,863,priest,shadow,24,9,15
40709,Efxsp,sargeras,863,priest,shadow,24,9,15
40710,Everblack,executus,862,priest,shadow,12,9,3
40711,Tyreliy,eitrigg,862,priest,shadow,18,9,9
40712,Dóctóre,thrall,862,priest,shadow,18,9,9
40713,Touchypriest,jaedenar,862,priest,shadow,18,9,9
40714,Arzeuz,ragnaros,862,priest,shadow,18,9,9
40715,Vzell,kiljaeden,862,priest,shadow,18,9,9
40716,Faashrmpbtw,darkspear,861,priest,shadow,12,9,3
40717,Falsegodx,tichondrius,861,priest,shadow,24,9,15
40718,Fósho,khadgar,861,priest,shadow,24,9,15
40719,Melas,stormrage,861,priest,shadow,24,9,15
40720,Viejiyoh,ragnaros,860,priest,shadow,18,9,9
40721,Krypts,shadow-council,859,priest,shadow,18,9,9
40722,Wankenobi,stormrage,859,priest,shadow,18,9,9
40723,Nuttsope,kiljaeden,859,priest,shadow,18,9,9
40724,Willibald,eldrethalas,859,priest,shadow,24,9,15
40725,Methodist,sargeras,859,priest,shadow,24,9,15
40726,Beansontoast,wyrmrest-accord,857,priest,shadow,12,9,3
40727,Theophii,tichondrius,854,priest,shadow,24,9,15
40728,Drkvagician,tichondrius,854,priest,shadow,24,9,15
40729,Zaxine,moon-guard,854,priest,shadow,30,9,21
40730,Mazahr,stormrage,852,priest,shadow,12,9,3
40731,Tictactoejc,tichondrius,852,priest,shadow,12,9,3
40732,Hibot,illidan,849,priest,shadow,30,9,21
40733,Lightbanter,emerald-dream,846,priest,shadow,24,9,15
40734,Kagamì,frostmane,843,priest,shadow,31,9,22
40735,Romero,blood-furnace,837,priest,shadow,72,28,44
40736,Pipiwiwi,tichondrius,831,priest,shadow,16,9,7
40737,Maldicius,emerald-dream,830,priest,shadow,23,9,14
40738,Blonkie,azgalor,821,priest,shadow,24,10,14
40739,Jeängrey,tichondrius,815,priest,shadow,15,10,5
40740,Stylonious,hyjal,815,priest,shadow,15,9,6
40741,Buc,barthilas,813,priest,shadow,15,9,6
40742,Rigotakx,illidan,805,priest,shadow,27,10,17
40743,Fledgeling,frostmourne,799,priest,shadow,14,9,5
40744,Deadcode,frostmane,796,priest,shadow,52,18,34
40745,Lôvecraft,frostmourne,781,priest,shadow,19,9,10
40746,Reignsp,malganis,781,priest,shadow,19,9,10
40747,Silentólògy,malganis,768,priest,shadow,12,8,4
40748,Likeness,proudmoore,768,priest,shadow,12,8,4
40749,Ahleven,tichondrius,768,priest,shadow,12,8,4
40750,Nohealerhere,frostmourne,768,priest,shadow,12,8,4
40751,Hockula,kiljaeden,768,priest,shadow,12,8,4
40752,Härpocrates,area-52,768,priest,shadow,12,8,4
40753,Skraitbussin,tichondrius,768,priest,shadow,12,8,4
40754,Jhené,malganis,768,priest,shadow,12,8,4
40755,Oxycodex,thrall,768,priest,shadow,12,8,4
40756,Ruzhi,moon-guard,768,priest,shadow,12,8,4
40757,Nohesita,stormrage,768,priest,shadow,12,8,4
40758,Rattyp,barthilas,768,priest,shadow,12,8,4
40759,Mumsmilk,sargeras,768,priest,shadow,12,8,4
40760,Eridan,moon-guard,768,priest,shadow,12,8,4
40761,Darkascended,arthas,768,priest,shadow,12,8,4
40762,Púrplenurple,area-52,768,priest,shadow,12,8,4
40763,Ydonburi,tichondrius,768,priest,shadow,12,8,4
40764,Dazull,bleeding-hollow,768,priest,shadow,12,8,4
40765,Stungods,frostmourne,768,priest,shadow,12,8,4
40766,Quartzolio,azralon,768,priest,shadow,12,8,4
40767,Lnoh,area-52,768,priest,shadow,12,8,4
40768,Drosslolz,illidan,768,priest,shadow,18,8,10
40769,Heàl,akama,768,priest,shadow,18,8,10
40770,Iluvwizkx,malganis,768,priest,shadow,18,8,10
40771,Deacoderx,area-52,768,priest,shadow,18,8,10
40772,Pineappleqt,skullcrusher,768,priest,shadow,18,8,10
40773,Àústîn,moon-guard,768,priest,shadow,18,8,10
40774,Voidariah,tichondrius,768,priest,shadow,18,8,10
40775,Duhpriest,frostmourne,768,priest,shadow,18,8,10
40776,Ripchadman,tichondrius,768,priest,shadow,18,8,10
40777,Jdcii,tichondrius,768,priest,shadow,18,8,10
40778,Shadowylorka,sargeras,768,priest,shadow,18,8,10
40779,Skepix,lightbringer,768,priest,shadow,18,8,10
40780,Madmelter,emerald-dream,768,priest,shadow,18,8,10
40781,Mydixi,stormrage,768,priest,shadow,18,8,10
40782,Enchantrez,frostmourne,768,priest,shadow,18,8,10
40783,Alucardibee,turalyon,768,priest,shadow,24,8,16
40784,Synesis,bladefist,768,priest,shadow,24,8,16
40785,Homonid,moon-guard,767,priest,shadow,12,8,4
40786,Valsong,argent-dawn,767,priest,shadow,12,8,4
40787,Shadowlords,emerald-dream,767,priest,shadow,12,8,4
40788,Hairyboxx,frostmourne,767,priest,shadow,12,8,4
40789,Easyrevenge,kelthuzad,767,priest,shadow,12,8,4
40790,Sgssg,illidan,767,priest,shadow,12,8,4
40791,Viq,stormrage,767,priest,shadow,12,8,4
40792,Rogspriest,sargeras,767,priest,shadow,12,8,4
40793,Drteabaghaam,zuljin,767,priest,shadow,12,8,4
40794,Yackle,dawnbringer,767,priest,shadow,12,8,4
40795,Moojoke,zuljin,767,priest,shadow,12,8,4
40796,Tungus,shadowsong,767,priest,shadow,12,8,4
40797,Voidathon,sargeras,767,priest,shadow,12,8,4
40798,Mugiwarà,stormrage,767,priest,shadow,12,8,4
40799,Longlegs,garrosh,767,priest,shadow,14,8,6
40800,Valothrian,area-52,767,priest,shadow,18,8,10
40801,Badxjuju,frostmourne,767,priest,shadow,18,8,10
40802,Tuggyp,tichondrius,767,priest,shadow,18,8,10
40803,Smitepie,malganis,767,priest,shadow,18,8,10
40804,Zonozan,lightnings-blade,767,priest,shadow,18,8,10
40805,Igotubrah,malganis,767,priest,shadow,18,8,10
40806,Solrina,khazgoroth,766,priest,shadow,12,8,4
40807,Sãoleozinho,azralon,766,priest,shadow,12,8,4
40808,Jinzan,stormrage,766,priest,shadow,18,8,10
40809,Chroma,amanthul,766,priest,shadow,18,8,10
40810,Gorebones,emerald-dream,766,priest,shadow,18,8,10
40811,Sadinho,azralon,766,priest,shadow,24,8,16
40812,Rustinheber,stormscale,765,priest,shadow,12,8,4
40813,Clayphace,darkspear,765,priest,shadow,18,8,10
40814,Kumojorno,gilneas,765,priest,shadow,18,8,10
40815,Nachòs,wildhammer,765,priest,shadow,24,8,16
40816,Lotros,area-52,764,priest,shadow,12,8,4
40817,Uikaren,tichondrius,763,priest,shadow,18,8,10
40818,Pactosombrio,azralon,763,priest,shadow,24,8,16
40819,Drkwispers,stormrage,762,priest,shadow,18,8,10
40820,Speckilz,area-52,762,priest,shadow,26,8,18
40821,Hurrdurr,shattered-hand,761,priest,shadow,12,8,4
40822,Sôuljah,skywall,760,priest,shadow,26,10,16
40823,Priestmain,thrall,760,priest,shadow,24,8,16
40824,Aqusia,crushridge,753,priest,shadow,12,8,4
40825,Hydroman,black-dragonflight,753,priest,shadow,18,9,9
40826,Memoria,emerald-dream,751,priest,shadow,15,9,6
40827,Bublethenrun,cenarius,751,priest,shadow,17,9,8
40828,Gedtemanager,dalaran,749,priest,shadow,12,8,4
40829,Vorial,cenarion-circle,735,priest,shadow,17,8,9
40830,Harmlot,tichondrius,733,priest,shadow,14,9,5
40831,Strazloraz,baelgun,719,priest,shadow,11,8,3
40832,Meegoshy,azuremyst,718,priest,shadow,17,8,9
40833,Gorry,ragnaros,717,priest,shadow,18,9,9
40834,Mikó,dawnbringer,714,priest,shadow,29,10,19
40835,Yrrep,kelthuzad,703,priest,shadow,16,8,8
40836,Astari,illidan,702,priest,shadow,26,8,18
40837,Peazyqt,tichondrius,687,priest,shadow,13,8,5
40838,Nutzz,malganis,672,priest,shadow,12,7,5
40839,Cryptoccocus,zuljin,672,priest,shadow,12,7,5
40840,Salanzosp,bleeding-hollow,672,priest,shadow,12,7,5
40841,Wodturbo,bleeding-hollow,672,priest,shadow,12,7,5
40842,Scøøb,malganis,672,priest,shadow,12,7,5
40843,Phéonìx,zuljin,672,priest,shadow,12,7,5
40844,Naùtilus,icecrown,672,priest,shadow,12,7,5
40845,Didy,dark-iron,672,priest,shadow,12,7,5
40846,Lontra,zangarmarsh,672,priest,shadow,12,7,5
40847,Bucksp,zuljin,672,priest,shadow,12,7,5
40848,Kyerñ,stormrage,672,priest,shadow,12,7,5
40849,Diddlur,black-dragonflight,672,priest,shadow,12,7,5
40850,Chicoryx,illidan,672,priest,shadow,12,7,5
40851,Grëýmåttèr,moon-guard,672,priest,shadow,12,7,5
40852,Prizler,tichondrius,672,priest,shadow,12,7,5
40853,Freebolt,barthilas,672,priest,shadow,12,7,5
40854,Lilsweet,stonemaul,672,priest,shadow,12,7,5
40855,Blackaries,frostmourne,672,priest,shadow,12,7,5
40856,Xousa,area-52,672,priest,shadow,12,7,5
40857,Lillyspr,malganis,672,priest,shadow,12,7,5
40858,Fatzoid,the-forgotten-coast,672,priest,shadow,12,7,5
40859,Nazgúl,lothar,672,priest,shadow,12,7,5
40860,Ácÿd,nemesis,672,priest,shadow,12,7,5
40861,Javakhp,illidan,672,priest,shadow,12,7,5
40862,Hårper,area-52,672,priest,shadow,12,7,5
40863,Kwiksi,arthas,672,priest,shadow,12,7,5
40864,Aeøns,sargeras,672,priest,shadow,12,7,5
40865,Cheach,echo-isles,672,priest,shadow,12,7,5
40866,Moonlightx,destromath,672,priest,shadow,12,7,5
40867,Mabisyo,wyrmrest-accord,672,priest,shadow,12,7,5
40868,Esppx,barthilas,672,priest,shadow,12,7,5
40869,Holylip,frostmourne,672,priest,shadow,12,7,5
40870,Leorid,stormrage,672,priest,shadow,12,7,5
40871,Discs,detheroc,672,priest,shadow,12,7,5
40872,Zuuji,frostmourne,672,priest,shadow,12,7,5
40873,Twítch,bonechewer,672,priest,shadow,12,7,5
40874,Rottedjezus,dalaran,672,priest,shadow,12,7,5
40875,Negans,tichondrius,672,priest,shadow,12,7,5
40876,Kastwalker,earthen-ring,672,priest,shadow,12,7,5
40877,Karkoza,proudmoore,672,priest,shadow,12,7,5
40878,Bugweeb,sargeras,672,priest,shadow,12,7,5
40879,Gles,quelthalas,672,priest,shadow,13,7,6
40880,Mòrbídìtý,area-52,672,priest,shadow,13,7,6
40881,Aurilain,emerald-dream,672,priest,shadow,18,7,11
40882,Frúdgé,illidan,672,priest,shadow,18,7,11
40883,Helleamh,tichondrius,672,priest,shadow,18,7,11
40884,Nightious,malganis,672,priest,shadow,18,7,11
40885,Bigbrother,andorhal,672,priest,shadow,18,7,11
40886,Donmartin,tichondrius,672,priest,shadow,18,7,11
40887,Tenaebreu,tichondrius,672,priest,shadow,19,7,12
40888,Veressà,quelthalas,672,priest,shadow,22,8,14
40889,Chês,tichondrius,672,priest,shadow,24,7,17
40890,Preyforme,tichondrius,671,priest,shadow,12,7,5
40891,Webba,azshara,671,priest,shadow,12,7,5
40892,Gaho,tichondrius,671,priest,shadow,12,7,5
40893,Stasis,korialstrasz,671,priest,shadow,12,7,5
40894,Chinstrap,zuljin,671,priest,shadow,12,7,5
40895,Adíos,malganis,671,priest,shadow,12,7,5
40896,Moonpenance,windrunner,671,priest,shadow,12,7,5
40897,Darkrics,barthilas,671,priest,shadow,12,7,5
40898,Spshady,aegwynn,671,priest,shadow,12,7,5
40899,Voltstein,dalaran,671,priest,shadow,12,7,5
40900,Nastyyshadow,aegwynn,671,priest,shadow,12,7,5
40901,Socknapper,sargeras,671,priest,shadow,12,7,5
40902,Spamnhealz,illidan,671,priest,shadow,12,7,5
40903,Havefaith,whisperwind,671,priest,shadow,18,7,11
40904,Pottime,tichondrius,671,priest,shadow,18,7,11
40905,Hollowed,drakkari,671,priest,shadow,18,7,11
40906,Shimz,andorhal,671,priest,shadow,18,7,11
40907,Heion,detheroc,671,priest,shadow,18,7,11
40908,Torangi,tichondrius,671,priest,shadow,18,7,11
40909,Minarhy,moon-guard,671,priest,shadow,18,7,11
40910,Pokeyoobutt,hydraxis,671,priest,shadow,18,7,11
40911,Sagis,moon-guard,671,priest,shadow,18,7,11
40912,Influencing,moon-guard,671,priest,shadow,18,7,11
40913,Digitalangel,area-52,671,priest,shadow,18,7,11
40914,Montcrief,tichondrius,670,priest,shadow,12,7,5
40915,Nerfdisc,azralon,670,priest,shadow,12,7,5
40916,Tonybromoo,kelthuzad,670,priest,shadow,12,7,5
40917,Zaixse,illidan,670,priest,shadow,12,7,5
40918,Iseeyoulookn,stormrage,670,priest,shadow,16,8,8
40919,Bojanglings,undermine,670,priest,shadow,24,7,17
40920,Fruitbasketz,malganis,670,priest,shadow,24,7,17
40921,Sovix,sargeras,669,priest,shadow,12,7,5
40922,Voiddark,thrall,669,priest,shadow,13,7,6
40923,Rhapsidy,barthilas,669,priest,shadow,15,8,7
40924,Gabryanna,emerald-dream,669,priest,shadow,24,7,17
40925,Solraea,stormrage,668,priest,shadow,12,7,5
40926,Rijonkulous,area-52,668,priest,shadow,18,7,11
40927,Lõkî,malganis,667,priest,shadow,12,7,5
40928,Bellalugosi,auchindoun,667,priest,shadow,12,7,5
40929,Lampshayd,sargeras,665,priest,shadow,12,7,5
40930,Crashed,frostmourne,654,priest,shadow,23,7,16
40931,Metaila,aerie-peak,639,priest,shadow,11,7,4
40932,Lucifena,darkspear,639,priest,shadow,11,7,4
40933,Astraetus,zuljin,639,priest,shadow,17,7,10
40934,Holliebell,zuljin,639,priest,shadow,17,7,10
40935,Bouffantbibl,tichondrius,639,priest,shadow,20,8,12
40936,Wzrdtrx,tichondrius,638,priest,shadow,14,8,6
40937,Emmitson,scarlet-crusade,638,priest,shadow,28,7,21
40938,Chiliy,frostmourne,623,priest,shadow,11,7,4
40939,Schelleyyuki,tichondrius,623,priest,shadow,11,7,4
40940,Lzzp,azralon,623,priest,shadow,17,7,10
40941,Glek,tichondrius,608,priest,shadow,16,7,9
40942,Bingleboi,area-52,607,priest,shadow,14,7,7
40943,Dispersed,thrall,607,priest,shadow,14,7,7
40944,Hölyfury,illidan,607,priest,shadow,17,7,10
40945,Seniorpickle,emerald-dream,606,priest,shadow,14,7,7
40946,Bobe,sisters-of-elune,604,priest,shadow,32,12,20
40947,Flowerpetals,emerald-dream,599,priest,shadow,21,7,14
40948,Nylaza,kiljaeden,592,priest,shadow,19,7,12
40949,Mastahmind,illidan,591,priest,shadow,13,7,6
40950,Ìforted,zuljin,587,priest,shadow,19,7,12
40951,Umberries,dreadmaul,585,priest,shadow,19,10,9
40952,Sydgames,area-52,576,priest,shadow,6,6,0
40953,Moonwald,moon-guard,576,priest,shadow,6,6,0
40954,Innovate,dragonmaw,576,priest,shadow,6,6,0
40955,Playsoon,illidan,576,priest,shadow,6,6,0
40956,Nayzarh,darkspear,576,priest,shadow,6,6,0
40957,Lukuku,barthilas,576,priest,shadow,6,6,0
40958,Henrywhopper,fizzcrank,576,priest,shadow,6,6,0
40959,Applepiezz,tichondrius,576,priest,shadow,6,6,0
40960,Dradinx,illidan,576,priest,shadow,7,6,1
40961,Wheelson,wildhammer,576,priest,shadow,12,6,6
40962,Shiikari,terenas,576,priest,shadow,12,6,6
40963,Lleak,tichondrius,576,priest,shadow,12,6,6
40964,Spriestbro,emerald-dream,576,priest,shadow,12,6,6
40965,Jangbi,tichondrius,576,priest,shadow,12,6,6
40966,Rebdomine,magtheridon,576,priest,shadow,12,6,6
40967,Slpox,sargeras,576,priest,shadow,12,6,6
40968,Shadowspain,stormrage,576,priest,shadow,12,6,6
40969,Xpenance,ragnaros,576,priest,shadow,12,6,6
40970,Toddo,trollbane,576,priest,shadow,12,6,6
40971,Studiosxz,tichondrius,576,priest,shadow,12,6,6
40972,Missiønary,area-52,576,priest,shadow,12,6,6
40973,Ershackleton,illidan,576,priest,shadow,12,6,6
40974,Spookyman,malganis,576,priest,shadow,12,6,6
40975,Boxcombo,kelthuzad,576,priest,shadow,12,6,6
40976,Fitchbucker,sargeras,576,priest,shadow,12,6,6
40977,Mks,barthilas,576,priest,shadow,12,6,6
40978,Dellah,stormrage,576,priest,shadow,12,6,6
40979,Sped,saurfang,576,priest,shadow,12,6,6
40980,Imshadow,azralon,576,priest,shadow,12,6,6
40981,Whosjoe,tichondrius,576,priest,shadow,12,6,6
40982,Rahtals,malganis,576,priest,shadow,12,6,6
40983,Sacerdotick,gallywix,576,priest,shadow,12,6,6
40984,Valerift,moon-guard,576,priest,shadow,12,6,6
40985,Froackey,agamaggan,576,priest,shadow,12,6,6
40986,Vengep,sargeras,576,priest,shadow,12,6,6
40987,Tmspongwo,tichondrius,576,priest,shadow,12,6,6
40988,Jeremyissped,proudmoore,576,priest,shadow,12,6,6
40989,Drognar,lightbringer,576,priest,shadow,12,6,6
40990,Kessavannell,frostwolf,576,priest,shadow,12,6,6
40991,Lostnlight,aggramar,576,priest,shadow,12,6,6
40992,Evansong,frostmane,576,priest,shadow,12,6,6
40993,Carosene,thrall,576,priest,shadow,12,6,6
40994,Ôverweight,sargeras,576,priest,shadow,12,6,6
40995,Virsyti,area-52,576,priest,shadow,12,6,6
40996,Heb,thrall,576,priest,shadow,12,6,6
40997,Càipirinha,tichondrius,576,priest,shadow,12,6,6
40998,Nelfonshelf,hyjal,576,priest,shadow,12,6,6
40999,Faztwo,illidan,576,priest,shadow,12,6,6
41000,Zeacho,proudmoore,576,priest,shadow,12,6,6
41001,Jrøck,malganis,576,priest,shadow,12,6,6
41002,Faenzal,area-52,576,priest,shadow,12,6,6
41003,Rachelstarrx,hyjal,576,priest,shadow,12,6,6
41004,Yungjim,the-forgotten-coast,576,priest,shadow,12,6,6
41005,Pønt,sargeras,576,priest,shadow,12,6,6
41006,Lisau,tichondrius,576,priest,shadow,12,6,6
41007,Boneappletee,area-52,576,priest,shadow,12,6,6
41008,Secretpriest,tichondrius,576,priest,shadow,12,6,6
41009,Yiptawh,area-52,576,priest,shadow,12,6,6
41010,Silverblacks,quelthalas,576,priest,shadow,12,6,6
41011,Bipölar,area-52,576,priest,shadow,12,6,6
41012,Catmasters,area-52,576,priest,shadow,13,6,7
41013,Xz,black-dragonflight,576,priest,shadow,16,7,9
41014,Fruitjuice,arthas,576,priest,shadow,18,6,12
41015,Mindgamez,stormreaver,576,priest,shadow,18,6,12
41016,Caeda,icecrown,576,priest,shadow,18,6,12
41017,Soulrulerx,tichondrius,576,priest,shadow,18,6,12
41018,Evaldi,proudmoore,576,priest,shadow,18,6,12
41019,Thrie,ragnaros,576,priest,shadow,24,6,18
41020,Spriestes,thrall,575,priest,shadow,6,6,0
41021,Frëÿjä,proudmoore,575,priest,shadow,6,6,0
41022,Xinthra,stormrage,575,priest,shadow,12,6,6
41023,Boogieboop,frostmourne,575,priest,shadow,12,6,6
41024,Rtdarkcraft,ragnaros,575,priest,shadow,12,6,6
41025,Unclelively,dragonmaw,575,priest,shadow,12,6,6
41026,Linarastia,blackrock,575,priest,shadow,12,6,6
41027,Empower,garrosh,575,priest,shadow,12,6,6
41028,Ricksanchez,moonrunner,575,priest,shadow,12,6,6
41029,Xð,jubeithos,575,priest,shadow,12,6,6
41030,Rustydisc,area-52,575,priest,shadow,12,6,6
41031,Alienà,arthas,575,priest,shadow,12,6,6
41032,Vashyy,stormrage,575,priest,shadow,12,6,6
41033,Morboo,proudmoore,575,priest,shadow,12,6,6
41034,Mìdnìght,ragnaros,575,priest,shadow,12,6,6
41035,Mêrlin,duskwood,575,priest,shadow,12,6,6
41036,Drsonny,proudmoore,575,priest,shadow,12,6,6
41037,Grympriest,wyrmrest-accord,575,priest,shadow,12,6,6
41038,Çovidònenine,tichondrius,575,priest,shadow,12,6,6
41039,Juícifer,illidan,575,priest,shadow,18,6,12
41040,Vøíd,sargeras,575,priest,shadow,18,6,12
41041,Mäe,nemesis,575,priest,shadow,18,6,12
41042,Asmitä,stormrage,575,priest,shadow,18,6,12
41043,Healzahoe,sargeras,575,priest,shadow,18,6,12
41044,Makade,sargeras,575,priest,shadow,18,6,12
41045,Kapriestsun,malorne,574,priest,shadow,12,6,6
41046,Ðaddÿ,bleeding-hollow,574,priest,shadow,12,6,6
41047,Duhk,moon-guard,574,priest,shadow,12,6,6
41048,Papipreach,sargeras,574,priest,shadow,12,6,6
41049,Dhader,area-52,574,priest,shadow,20,6,14
41050,Galedry,ragnaros,574,priest,shadow,24,6,18
41051,Shadowpáin,ragnaros,573,priest,shadow,12,6,6
41052,Midboss,illidan,572,priest,shadow,12,6,6
41053,Jamashud,mannoroth,571,priest,shadow,12,6,6
41054,Raelintha,kelthuzad,571,priest,shadow,15,7,8
41055,Shadowbishop,barthilas,570,priest,shadow,12,6,6
41056,Daisydux,quelthalas,568,priest,shadow,10,7,3
41057,Kkpriest,frostmourne,566,priest,shadow,12,6,6
41058,Holysheht,icecrown,566,priest,shadow,12,6,6
41059,Sarkozzlol,tichondrius,543,priest,shadow,8,7,1
41060,Yourlife,baelgun,543,priest,shadow,11,6,5
41061,Chapyh,malganis,543,priest,shadow,11,6,5
41062,Anttila,ragnaros,543,priest,shadow,17,6,11
41063,Mcpopafeel,thrall,528,priest,shadow,11,7,4
41064,Shadolord,illidan,527,priest,shadow,17,6,11
41065,Holydestroyr,dentarg,527,priest,shadow,21,6,15
41066,Sársaukis,illidan,527,priest,shadow,21,6,15
41067,Totorostarp,tichondrius,521,priest,shadow,22,8,14
41068,Ceoofvoid,moon-guard,511,priest,shadow,8,6,2
41069,Hoshx,sargeras,496,priest,shadow,13,6,7
41070,Kaidow,wyrmrest-accord,480,priest,shadow,6,5,1
41071,Topg,icecrown,480,priest,shadow,6,5,1
41072,Chervz,chogall,480,priest,shadow,6,5,1
41073,Flynni,bleeding-hollow,480,priest,shadow,6,5,1
41074,Polarnight,zuljin,480,priest,shadow,6,5,1
41075,Keynath,burning-blade,480,priest,shadow,6,5,1
41076,Plaguepumper,sargeras,480,priest,shadow,6,5,1
41077,Liloffended,sargeras,480,priest,shadow,6,5,1
41078,Tricklee,tichondrius,480,priest,shadow,6,5,1
41079,Megamind,elune,480,priest,shadow,6,5,1
41080,Fiéstah,illidan,480,priest,shadow,6,5,1
41081,Altera,drakkari,480,priest,shadow,6,5,1
41082,Nawtyforever,tichondrius,480,priest,shadow,6,5,1
41083,Ãbelladanger,area-52,480,priest,shadow,6,5,1
41084,Bigpenance,illidan,480,priest,shadow,6,5,1
41085,Komy,tichondrius,480,priest,shadow,6,5,1
41086,Commotion,dalaran,480,priest,shadow,6,5,1
41087,Likelydapper,tichondrius,480,priest,shadow,6,5,1
41088,Myòvó,tichondrius,480,priest,shadow,6,5,1
41089,Atheistbtw,sargeras,480,priest,shadow,6,5,1
41090,Tensorflow,tichondrius,480,priest,shadow,6,5,1
41091,Death,firetree,480,priest,shadow,6,5,1
41092,Seanuts,emerald-dream,480,priest,shadow,6,5,1
41093,Novasp,sargeras,480,priest,shadow,6,5,1
41094,Jezebëll,nemesis,480,priest,shadow,6,5,1
41095,Minnowhead,kelthuzad,480,priest,shadow,12,5,7
41096,Yddwin,quelthalas,480,priest,shadow,12,5,7
41097,Lucariö,area-52,480,priest,shadow,12,5,7
41098,Faxingberlin,sargeras,480,priest,shadow,12,5,7
41099,Optimism,frostmane,480,priest,shadow,12,5,7
41100,Senadori,azjolnerub,480,priest,shadow,12,5,7
41101,Nås,elune,480,priest,shadow,12,5,7
41102,Seraphims,moon-guard,480,priest,shadow,12,5,7
41103,Ariellie,area-52,480,priest,shadow,12,5,7
41104,Müyrica,ragnaros,480,priest,shadow,12,5,7
41105,Hygeïa,lightbringer,480,priest,shadow,12,5,7
41106,Cryptron,tichondrius,480,priest,shadow,12,5,7
41107,Taofang,wyrmrest-accord,480,priest,shadow,12,5,7
41108,Littledog,velen,480,priest,shadow,12,5,7
41109,Clistyn,quelthalas,480,priest,shadow,12,5,7
41110,Zhangtanchi,moon-guard,480,priest,shadow,12,5,7
41111,Soulistic,arygos,480,priest,shadow,12,5,7
41112,Priestology,echo-isles,480,priest,shadow,12,5,7
41113,Gálfore,malganis,480,priest,shadow,12,5,7
41114,Jenastreaux,wyrmrest-accord,480,priest,shadow,12,5,7
41115,Shádôws,blackhand,480,priest,shadow,12,5,7
41116,Mookelina,stormrage,480,priest,shadow,12,5,7
41117,Rätcömpx,bleeding-hollow,480,priest,shadow,12,5,7
41118,Spriest,kul-tiras,480,priest,shadow,12,5,7
41119,Posest,darkspear,480,priest,shadow,12,5,7
41120,Flukex,tichondrius,480,priest,shadow,12,5,7
41121,Sohalexs,tichondrius,480,priest,shadow,12,5,7
41122,Dmlx,frostmourne,480,priest,shadow,12,5,7
41123,Kabutta,stormrage,480,priest,shadow,12,5,7
41124,Mdt,tichondrius,480,priest,shadow,12,5,7
41125,Everest,barthilas,480,priest,shadow,12,5,7
41126,Bomanic,sargeras,480,priest,shadow,12,5,7
41127,Rakÿna,nemesis,480,priest,shadow,12,5,7
41128,Sâltý,stormrage,480,priest,shadow,12,5,7
41129,Goblindruid,bleeding-hollow,480,priest,shadow,12,5,7
41130,Fatzzbtw,illidan,480,priest,shadow,12,5,7
41131,Mistweaver,tichondrius,480,priest,shadow,12,5,7
41132,Orderic,ragnaros,480,priest,shadow,12,5,7
41133,Onizukakeiji,hyjal,480,priest,shadow,12,5,7
41134,Bunked,bleeding-hollow,480,priest,shadow,12,5,7
41135,Moä,nemesis,480,priest,shadow,12,5,7
41136,Jesstical,frostmourne,480,priest,shadow,12,5,7
41137,Eazye,shadowmoon,480,priest,shadow,12,5,7
41138,Faydes,arthas,480,priest,shadow,13,5,8
41139,Stillmatick,tichondrius,480,priest,shadow,16,6,10
41140,Zerohoür,emerald-dream,480,priest,shadow,16,6,10
41141,Nedajoon,tichondrius,480,priest,shadow,17,6,11
41142,Drakracs,doomhammer,480,priest,shadow,18,5,13
41143,Azrothlol,kul-tiras,480,priest,shadow,18,5,13
41144,Spõt,stormrage,480,priest,shadow,18,5,13
41145,Sybal,suramar,480,priest,shadow,19,5,14
41146,Temnah,sargeras,480,priest,shadow,24,5,19
41147,Merlynaah,azralon,479,priest,shadow,6,5,1
41148,Paradoxbot,kelthuzad,479,priest,shadow,6,5,1
41149,Notahero,tichondrius,479,priest,shadow,6,5,1
41150,Devî,magtheridon,479,priest,shadow,12,5,7
41151,Knoxy,fizzcrank,479,priest,shadow,12,5,7
41152,Wolfeclipse,sargeras,479,priest,shadow,12,5,7
41153,Synisteria,sargeras,479,priest,shadow,12,5,7
41154,Brosbeforeho,tichondrius,479,priest,shadow,18,5,13
41155,Rippmmr,frostmourne,479,priest,shadow,18,5,13
41156,Noodloctopus,area-52,478,priest,shadow,10,6,4
41157,Murtrudin,andorhal,478,priest,shadow,12,5,7
41158,Antiraus,aerie-peak,478,priest,shadow,12,5,7
41159,Thehern,tichondrius,463,priest,shadow,11,5,6
41160,Estarì,proudmoore,463,priest,shadow,11,5,6
41161,Wiiuwiiu,malganis,447,priest,shadow,11,5,6
41162,Forober,queldorei,446,priest,shadow,10,6,4
41163,Aerena,anvilmar,442,priest,shadow,21,7,14
41164,Ryanrealz,tichondrius,432,priest,shadow,9,6,3
41165,Veilozity,tichondrius,432,priest,shadow,15,5,10
41166,Bernhard,azralon,431,priest,shadow,11,5,6
41167,Sohalex,tichondrius,431,priest,shadow,11,5,6
41168,Shietamazon,tichondrius,426,priest,shadow,16,6,10
41169,Shaurana,stormrage,412,priest,shadow,18,6,12
41170,Nizr,bleeding-hollow,399,priest,shadow,5,5,0
41171,Mäte,bleeding-hollow,384,priest,shadow,6,4,2
41172,Pootang,hyjal,384,priest,shadow,6,4,2
41173,Ikiteforhash,zuljin,384,priest,shadow,6,4,2
41174,Diskordia,stormrage,384,priest,shadow,6,4,2
41175,Sungsh,zuljin,384,priest,shadow,6,4,2
41176,Devinere,tichondrius,384,priest,shadow,6,4,2
41177,Priestodan,frostmourne,384,priest,shadow,6,4,2
41178,Choppery,laughing-skull,384,priest,shadow,6,4,2
41179,Dzikuss,aegwynn,384,priest,shadow,6,4,2
41180,Aladarian,tichondrius,384,priest,shadow,6,4,2
41181,Mindflay,tichondrius,384,priest,shadow,6,4,2
41182,Nimabe,tichondrius,384,priest,shadow,6,4,2
41183,Balverix,tichondrius,384,priest,shadow,6,4,2
41184,Dotznbubblez,zuljin,384,priest,shadow,6,4,2
41185,Cånnibäl,tichondrius,384,priest,shadow,6,4,2
41186,Kks,tichondrius,384,priest,shadow,6,4,2
41187,Rolettana,stormrage,384,priest,shadow,6,4,2
41188,Unclecam,tichondrius,384,priest,shadow,6,4,2
41189,Garbagépg,zuljin,384,priest,shadow,6,4,2
41190,Rôss,tichondrius,384,priest,shadow,6,4,2
41191,Prydas,tichondrius,384,priest,shadow,6,4,2
41192,Comoli,tichondrius,384,priest,shadow,6,4,2
41193,Robertlee,stormrage,384,priest,shadow,6,4,2
41194,Quiglius,tichondrius,384,priest,shadow,6,4,2
41195,Drinky,tichondrius,384,priest,shadow,6,4,2
41196,Mutedox,frostmourne,384,priest,shadow,6,4,2
41197,Jaysshadow,illidan,384,priest,shadow,6,4,2
41198,Magiccoon,tichondrius,384,priest,shadow,6,4,2
41199,Hèxxen,moon-guard,384,priest,shadow,6,4,2
41200,Judgejudyx,tichondrius,384,priest,shadow,6,4,2
41201,Bigpurple,crushridge,384,priest,shadow,6,4,2
41202,Træway,tichondrius,384,priest,shadow,6,4,2
41203,Valtres,tichondrius,384,priest,shadow,6,4,2
41204,Tiinkerbell,moon-guard,384,priest,shadow,6,4,2
41205,Fåtê,area-52,384,priest,shadow,6,4,2
41206,Bramstein,jubeithos,384,priest,shadow,6,4,2
41207,Kynyssaelz,proudmoore,384,priest,shadow,6,4,2
41208,Spôoky,illidan,384,priest,shadow,6,4,2
41209,Zork,wildhammer,384,priest,shadow,6,4,2
41210,Lgt,tichondrius,384,priest,shadow,6,4,2
41211,Yuricksus,malganis,384,priest,shadow,6,4,2
41212,Marcusalan,emerald-dream,384,priest,shadow,6,4,2
41213,Tethy,saurfang,384,priest,shadow,6,4,2
41214,Ferzhump,tichondrius,384,priest,shadow,6,4,2
41215,Bigskill,proudmoore,384,priest,shadow,6,4,2
41216,Prostrat,deathwing,384,priest,shadow,6,4,2
41217,Iifa,medivh,384,priest,shadow,6,4,2
41218,Guillotine,azralon,384,priest,shadow,6,4,2
41219,Haedn,azralon,384,priest,shadow,6,4,2
41220,Notlowboy,area-52,384,priest,shadow,6,4,2
41221,Káldorei,proudmoore,384,priest,shadow,6,4,2
41222,Næzha,thrall,384,priest,shadow,6,4,2
41223,Shoelacey,sargeras,384,priest,shadow,6,4,2
41224,Ðrip,burning-legion,384,priest,shadow,6,4,2
41225,Iemon,vashj,384,priest,shadow,6,4,2
41226,Rubymisfit,sargeras,384,priest,shadow,6,4,2
41227,Itha,illidan,384,priest,shadow,6,4,2
41228,Äni,sargeras,384,priest,shadow,6,4,2
41229,Shieldspamx,tichondrius,384,priest,shadow,6,4,2
41230,Shutkap,sargeras,384,priest,shadow,6,4,2
41231,Thänatós,quelthalas,384,priest,shadow,6,4,2
41232,Lenigrast,blackrock,384,priest,shadow,6,4,2
41233,Píty,ragnaros,384,priest,shadow,6,4,2
41234,Mygameslaggy,area-52,384,priest,shadow,6,4,2
41235,Killían,darkspear,384,priest,shadow,6,4,2
41236,Urdaisyy,kelthuzad,384,priest,shadow,6,4,2
41237,Moomoomilker,blackrock,384,priest,shadow,6,4,2
41238,Feminizm,tichondrius,384,priest,shadow,6,4,2
41239,Piftw,illidan,384,priest,shadow,6,4,2
41240,Didittouchme,sargeras,384,priest,shadow,6,4,2
41241,Bax,kilrogg,384,priest,shadow,6,4,2
41242,Capnjazz,illidan,384,priest,shadow,6,4,2
41243,Liquidhorror,tichondrius,384,priest,shadow,7,4,3
41244,Mfn,deathwing,384,priest,shadow,11,4,7
41245,Vaeryl,stormrage,384,priest,shadow,12,4,8
41246,Eeffoc,zuljin,384,priest,shadow,12,4,8
41247,Mìçah,fizzcrank,384,priest,shadow,12,4,8
41248,Fáll,bleeding-hollow,384,priest,shadow,12,4,8
41249,Vundead,tichondrius,384,priest,shadow,12,4,8
41250,Nèurósis,area-52,384,priest,shadow,12,4,8
41251,Mïndgames,kelthuzad,384,priest,shadow,12,4,8
41252,Syncopy,azshara,384,priest,shadow,12,4,8
41253,Dialis,frostmourne,384,priest,shadow,12,4,8
41254,Shademán,stormrage,384,priest,shadow,12,4,8
41255,Aliciari,illidan,384,priest,shadow,12,4,8
41256,Junethegreat,tichondrius,384,priest,shadow,12,4,8
41257,Aerith,barthilas,384,priest,shadow,12,4,8
41258,Thalladori,area-52,384,priest,shadow,12,4,8
41259,Grimmyreap,malygos,384,priest,shadow,12,4,8
41260,Prescella,sargeras,384,priest,shadow,12,4,8
41261,Éx,alterac-mountains,384,priest,shadow,12,4,8
41262,Jinbo,frostmane,384,priest,shadow,12,4,8
41263,Mannyelf,ragnaros,384,priest,shadow,12,4,8
41264,Zacksnotcool,sargeras,384,priest,shadow,12,4,8
41265,Aexdawg,malganis,384,priest,shadow,12,4,8
41266,Dipidorko,proudmoore,384,priest,shadow,12,4,8
41267,Deathbyhot,gorefiend,384,priest,shadow,12,4,8
41268,Jxkep,frostmourne,384,priest,shadow,12,4,8
41269,Oligan,quelthalas,384,priest,shadow,12,4,8
41270,Fatäl,moon-guard,384,priest,shadow,12,4,8
41271,Tokaru,frostmourne,384,priest,shadow,12,4,8
41272,Brickzy,dalaran,384,priest,shadow,12,4,8
41273,Fhelurian,quelthalas,384,priest,shadow,12,4,8
41274,Çïöÿêüäüöàüê,stormrage,384,priest,shadow,12,4,8
41275,Heretoflay,tichondrius,384,priest,shadow,12,4,8
41276,Nôtthehealer,sargeras,384,priest,shadow,12,4,8
41277,Holydrop,sargeras,384,priest,shadow,12,4,8
41278,Jikoguu,stormscale,384,priest,shadow,12,4,8
41279,Arca,cenarion-circle,384,priest,shadow,18,4,14
41280,Lunypriest,azralon,384,priest,shadow,18,4,14
41281,Aliorixa,stormrage,384,priest,shadow,18,4,14
41282,Amazo,nemesis,383,priest,shadow,6,4,2
41283,Skky,nagrand,383,priest,shadow,6,4,2
41284,Thefiveoh,malganis,383,priest,shadow,6,4,2
41285,Unfriend,sargeras,383,priest,shadow,12,4,8
41286,Jammý,burning-legion,383,priest,shadow,12,4,8
41287,Holydork,sargeras,383,priest,shadow,12,4,8
41288,Hermïs,stormrage,383,priest,shadow,12,4,8
41289,Zyte,stormrage,383,priest,shadow,14,4,10
41290,Nocappappy,tichondrius,383,priest,shadow,18,4,14
41291,Capitancook,ragnaros,383,priest,shadow,18,4,14
41292,Leshlight,azuremyst,383,priest,shadow,24,4,20
41293,Honeybunns,skywall,382,priest,shadow,6,4,2
41294,Geulis,illidan,382,priest,shadow,12,4,8
41295,Bwansandi,blackrock,370,priest,shadow,38,8,30
41296,Durgen,stormreaver,367,priest,shadow,17,4,13
41297,Deathzpirit,kiljaeden,352,priest,shadow,10,4,6
41298,Bionix,stormrage,330,priest,shadow,11,5,6
41299,Sgiath,alleria,330,priest,shadow,15,6,9
41300,Libationz,area-52,329,priest,shadow,19,7,12
41301,Hørçrùx,tichondrius,319,priest,shadow,5,4,1
41302,Vaynnx,stormrage,319,priest,shadow,5,4,1
41303,Dtbündertree,nordrassil,319,priest,shadow,5,4,1
41304,Earebus,dalaran,288,priest,shadow,6,3,3
41305,Russbell,ragnaros,288,priest,shadow,6,3,3
41306,Strokkerzin,azralon,288,priest,shadow,6,3,3
41307,Voidballs,tichondrius,288,priest,shadow,6,3,3
41308,Scaadoosh,dalaran,288,priest,shadow,6,3,3
41309,Nizanz,illidan,288,priest,shadow,6,3,3
41310,Quantumgoat,tichondrius,288,priest,shadow,6,3,3
41311,Ohmylaanta,stormrage,288,priest,shadow,6,3,3
41312,Ascundead,tichondrius,288,priest,shadow,6,3,3
41313,Pezziate,tichondrius,288,priest,shadow,6,3,3
41314,Whittysp,tichondrius,288,priest,shadow,6,3,3
41315,Moselol,tichondrius,288,priest,shadow,6,3,3
41316,Sumrand,frostmourne,288,priest,shadow,6,3,3
41317,Nuclease,turalyon,288,priest,shadow,6,3,3
41318,Banmi,tichondrius,288,priest,shadow,6,3,3
41319,Xuxu,frostmourne,288,priest,shadow,6,3,3
41320,Mynameis,dethecus,288,priest,shadow,6,3,3
41321,Amanopriest,illidan,288,priest,shadow,6,3,3
41322,Blakeak,hyjal,288,priest,shadow,6,3,3
41323,Dumpesitwo,frostmourne,288,priest,shadow,6,3,3
41324,Halleßerry,illidan,288,priest,shadow,6,3,3
41325,ßoy,amanthul,288,priest,shadow,6,3,3
41326,Pengwu,moon-guard,288,priest,shadow,6,3,3
41327,Exploded,moon-guard,288,priest,shadow,6,3,3
41328,Henrykane,azgalor,288,priest,shadow,6,3,3
41329,Adelen,illidan,288,priest,shadow,6,3,3
41330,Roommatethor,thaurissan,288,priest,shadow,6,3,3
41331,Suki,alleria,288,priest,shadow,6,3,3
41332,Shakarot,illidan,288,priest,shadow,6,3,3
41333,Oxxymoron,malganis,288,priest,shadow,6,3,3
41334,Auras,boulderfist,288,priest,shadow,6,3,3
41335,Kindyx,ragnaros,288,priest,shadow,6,3,3
41336,Runakk,stonemaul,288,priest,shadow,6,3,3
41337,Squatchlace,tichondrius,288,priest,shadow,6,3,3
41338,Sìkarìa,illidan,288,priest,shadow,6,3,3
41339,Spspsp,illidan,288,priest,shadow,6,3,3
41340,Elitë,frostmourne,288,priest,shadow,6,3,3
41341,Ozzx,stormrage,288,priest,shadow,6,3,3
41342,Enaan,proudmoore,288,priest,shadow,6,3,3
41343,Bubbleguppyx,tichondrius,288,priest,shadow,6,3,3
41344,Menorsita,tichondrius,288,priest,shadow,6,3,3
41345,Wrathhealer,hellscream,288,priest,shadow,6,3,3
41346,Clearclouds,tichondrius,288,priest,shadow,6,3,3
41347,Lolsodacans,malganis,288,priest,shadow,6,3,3
41348,Empyreanlite,dalaran,288,priest,shadow,6,3,3
41349,Soloqqt,tichondrius,288,priest,shadow,6,3,3
41350,Studpriest,tichondrius,288,priest,shadow,6,3,3
41351,Noanswerr,proudmoore,288,priest,shadow,6,3,3
41352,Limèria,emerald-dream,288,priest,shadow,6,3,3
41353,Egraner,drakkari,288,priest,shadow,6,3,3
41354,Shaðows,malganis,288,priest,shadow,6,3,3
41355,Pheegawn,proudmoore,288,priest,shadow,6,3,3
41356,Stroserous,hyjal,288,priest,shadow,6,3,3
41357,Reginaa,nemesis,288,priest,shadow,6,3,3
41358,Döllyy,illidan,288,priest,shadow,6,3,3
41359,Cappoo,tichondrius,288,priest,shadow,6,3,3
41360,Dovakhamut,illidan,288,priest,shadow,6,3,3
41361,Lucènt,frostmourne,288,priest,shadow,6,3,3
41362,Nzuth,dalaran,288,priest,shadow,6,3,3
41363,Pgpriest,kelthuzad,288,priest,shadow,6,3,3
41364,Intheway,bleeding-hollow,288,priest,shadow,6,3,3
41365,Dottiemcfee,alterac-mountains,288,priest,shadow,6,3,3
41366,Lucydrop,area-52,288,priest,shadow,6,3,3
41367,Ceebomb,tichondrius,288,priest,shadow,6,3,3
41368,Osarin,sargeras,288,priest,shadow,6,3,3
41369,Ossirus,emerald-dream,288,priest,shadow,6,3,3
41370,Austul,guldan,288,priest,shadow,6,3,3
41371,Monytrain,emerald-dream,288,priest,shadow,6,3,3
41372,Persimmons,lightbringer,288,priest,shadow,6,3,3
41373,Jaliera,malganis,288,priest,shadow,6,3,3
41374,Issaley,tichondrius,288,priest,shadow,6,3,3
41375,Randyortonn,tichondrius,288,priest,shadow,6,3,3
41376,Reâpêr,kelthuzad,288,priest,shadow,6,3,3
41377,Avadrah,tichondrius,288,priest,shadow,6,3,3
41378,Drelia,jubeithos,288,priest,shadow,6,3,3
41379,Vullena,moon-guard,288,priest,shadow,6,3,3
41380,Nellìel,whisperwind,288,priest,shadow,6,3,3
41381,Xxmewo,sargeras,288,priest,shadow,6,3,3
41382,Aliciab,andorhal,288,priest,shadow,6,3,3
41383,Worldhealer,area-52,288,priest,shadow,6,3,3
41384,Shadymac,sargeras,288,priest,shadow,6,3,3
41385,Judeath,area-52,288,priest,shadow,6,3,3
41386,Leya,kiljaeden,288,priest,shadow,6,3,3
41387,Champ,norgannon,288,priest,shadow,6,3,3
41388,Prignues,tichondrius,288,priest,shadow,6,3,3
41389,Khallmir,goldrinn,288,priest,shadow,6,3,3
41390,ßìrth,kelthuzad,288,priest,shadow,6,3,3
41391,Healiûm,bleeding-hollow,288,priest,shadow,6,3,3
41392,Chewit,kargath,288,priest,shadow,6,3,3
41393,Gospels,tichondrius,288,priest,shadow,6,3,3
41394,Tomseleck,frostmourne,288,priest,shadow,6,3,3
41395,Mhorkarion,quelthalas,288,priest,shadow,6,3,3
41396,Leyspring,moon-guard,288,priest,shadow,6,3,3
41397,Ontherise,kelthuzad,288,priest,shadow,6,3,3
41398,Mlkchocolate,kelthuzad,288,priest,shadow,6,3,3
41399,Halîth,terenas,288,priest,shadow,6,3,3
41400,Oongawa,sargeras,288,priest,shadow,6,3,3
41401,Mallox,quelthalas,288,priest,shadow,6,3,3
41402,Crazchinkin,tichondrius,288,priest,shadow,6,3,3
41403,Sealife,kelthuzad,288,priest,shadow,6,3,3
41404,Wâtermelon,stormrage,288,priest,shadow,6,3,3
41405,Brxddx,sargeras,288,priest,shadow,6,3,3
41406,Polyxenus,moon-guard,288,priest,shadow,6,3,3
41407,Etherrion,area-52,288,priest,shadow,6,3,3
41408,Whalexo,kelthuzad,288,priest,shadow,6,3,3
41409,Pepsí,kaelthas,288,priest,shadow,6,3,3
41410,Haransimongo,area-52,288,priest,shadow,6,3,3
41411,Raptorjesùs,azjolnerub,288,priest,shadow,6,3,3
41412,Samio,area-52,288,priest,shadow,6,3,3
41413,Çræmgøtsøçkd,blackrock,288,priest,shadow,6,3,3
41414,Prosight,tichondrius,288,priest,shadow,6,3,3
41415,Pogchamp,alterac-mountains,288,priest,shadow,6,3,3
41416,Ohsop,chogall,288,priest,shadow,6,3,3
41417,Eddysmokes,tichondrius,288,priest,shadow,6,3,3
41418,Knowufearme,auchindoun,288,priest,shadow,6,3,3
41419,Layyton,anvilmar,288,priest,shadow,6,3,3
41420,Ej,altar-of-storms,288,priest,shadow,6,3,3
41421,Xandir,kaelthas,288,priest,shadow,6,3,3
41422,Toxictampax,azjolnerub,288,priest,shadow,6,3,3
41423,Caiitlynn,quelthalas,288,priest,shadow,6,3,3
41424,Lemmecastpls,sargeras,288,priest,shadow,6,3,3
41425,Onahaihu,tichondrius,288,priest,shadow,9,4,5
41426,Epithet,moon-guard,288,priest,shadow,9,4,5
41427,Valuations,tichondrius,288,priest,shadow,12,3,9
41428,Airn,tichondrius,288,priest,shadow,12,3,9
41429,Shadowpain,the-underbog,288,priest,shadow,12,3,9
41430,Stantz,burning-legion,288,priest,shadow,12,3,9
41431,Maraquinn,bleeding-hollow,288,priest,shadow,12,3,9
41432,Zêrø,aerie-peak,288,priest,shadow,12,3,9
41433,Dunnbledore,area-52,288,priest,shadow,12,3,9
41434,Sybenela,proudmoore,288,priest,shadow,12,3,9
41435,Poppyp,stormrage,288,priest,shadow,12,3,9
41436,Tastyloads,illidan,288,priest,shadow,12,3,9
41437,Demonllama,duskwood,288,priest,shadow,12,3,9
41438,Giantqid,malganis,288,priest,shadow,12,3,9
41439,Mistmare,dalaran,288,priest,shadow,12,3,9
41440,Farnzz,malganis,288,priest,shadow,12,3,9
41441,Shadøwbølt,tichondrius,288,priest,shadow,12,3,9
41442,Mandisa,skywall,288,priest,shadow,12,3,9
41443,Xeras,ravencrest,288,priest,shadow,12,3,9
41444,Scaryspise,nathrezim,288,priest,shadow,12,3,9
41445,Malacanter,stormrage,288,priest,shadow,12,3,9
41446,Twistedbunny,zuljin,287,priest,shadow,6,3,3
41447,Neehow,hyjal,287,priest,shadow,6,3,3
41448,Grímmz,veknilash,287,priest,shadow,7,3,4
41449,Telamorstus,illidan,287,priest,shadow,12,3,9
41450,Kyriana,doomhammer,287,priest,shadow,18,3,15
41451,Runswithrain,lethon,271,priest,shadow,17,3,14
41452,Drzz,tichondrius,256,priest,shadow,4,4,0
41453,Nmm,ravencrest,239,priest,shadow,5,3,2
41454,Nuggetree,tichondrius,239,priest,shadow,5,3,2
41455,Kikkomán,tichondrius,239,priest,shadow,11,3,8
41456,Mindrip,illidan,234,priest,shadow,6,4,2
41457,Risedead,azralon,234,priest,shadow,10,4,6
41458,Actiop,stormrage,223,priest,shadow,8,3,5
41459,Beeffdaddy,tichondrius,223,priest,shadow,8,3,5
41460,Suppòrt,stormrage,192,priest,shadow,4,3,1
41461,Shadowblax,thrall,192,priest,shadow,4,3,1
41462,Donkeycube,tichondrius,192,priest,shadow,4,3,1
41463,Holyhand,auchindoun,192,priest,shadow,4,3,1
41464,Vladsacer,nemesis,192,priest,shadow,9,3,6
41465,Doctafuzz,muradin,192,priest,shadow,6,2,4
41466,Onlyphantoms,kelthuzad,192,priest,shadow,6,2,4
41467,Dogfrompark,illidan,192,priest,shadow,6,2,4
41468,Innergee,aegwynn,192,priest,shadow,6,2,4
41469,Lemmiewinkzx,sargeras,192,priest,shadow,6,2,4
41470,Löstský,azralon,192,priest,shadow,6,2,4
41471,Pandiwoodney,ragnaros,192,priest,shadow,6,2,4
41472,Hail,kaelthas,192,priest,shadow,6,2,4
41473,Kälashnikova,ragnaros,192,priest,shadow,6,2,4
41474,Murkqz,azralon,192,priest,shadow,6,2,4
41475,Dippyzs,alterac-mountains,192,priest,shadow,6,2,4
41476,Avanise,blackrock,192,priest,shadow,6,2,4
41477,Chen,chogall,192,priest,shadow,6,2,4
41478,Fatfinger,stormrage,192,priest,shadow,6,2,4
41479,Selspriest,kelthuzad,192,priest,shadow,6,2,4
41480,Kryoff,illidan,192,priest,shadow,6,2,4
41481,Thewizard,blackrock,192,priest,shadow,6,2,4
41482,Jjaeminkim,area-52,192,priest,shadow,6,2,4
41483,Orethon,thrall,192,priest,shadow,6,2,4
41484,Xyanydê,zuljin,192,priest,shadow,6,2,4
41485,Vanzera,thrall,192,priest,shadow,6,2,4
41486,Ptheld,tichondrius,192,priest,shadow,6,2,4
41487,Voidnoodles,area-52,192,priest,shadow,6,2,4
41488,Tomriddlle,sargeras,192,priest,shadow,6,2,4
41489,Chellelia,stormrage,192,priest,shadow,6,2,4
41490,Kapriestsun,sargeras,192,priest,shadow,6,2,4
41491,Edhelin,illidan,192,priest,shadow,6,2,4
41492,Spacepaq,bleeding-hollow,192,priest,shadow,6,2,4
41493,Slowbreeze,sargeras,192,priest,shadow,6,2,4
41494,Luísthian,quelthalas,192,priest,shadow,6,2,4
41495,Ateras,emerald-dream,192,priest,shadow,6,2,4
41496,Deprive,tichondrius,192,priest,shadow,6,2,4
41497,Thaldrum,tichondrius,192,priest,shadow,6,2,4
41498,Projectalice,ravencrest,192,priest,shadow,6,2,4
41499,Viroga,stormrage,192,priest,shadow,6,2,4
41500,Priést,stormrage,192,priest,shadow,6,2,4
41501,Nodorme,quelthalas,192,priest,shadow,6,2,4
41502,Horsegirls,kelthuzad,192,priest,shadow,6,2,4
41503,Pugsmugglerr,icecrown,192,priest,shadow,6,2,4
41504,Dagaen,thunderlord,192,priest,shadow,6,2,4
41505,Detainedz,malganis,192,priest,shadow,6,2,4
41506,Impur,zuljin,192,priest,shadow,6,2,4
41507,Sshhaaddooww,tichondrius,192,priest,shadow,6,2,4
41508,Quinnx,tichondrius,192,priest,shadow,6,2,4
41509,Sorojín,zuljin,192,priest,shadow,6,2,4
41510,Notgoodatsp,bleeding-hollow,192,priest,shadow,6,2,4
41511,Hgbvljag,proudmoore,192,priest,shadow,6,2,4
41512,Psychohazard,area-52,192,priest,shadow,6,2,4
41513,Kalibaby,darkspear,192,priest,shadow,6,2,4
41514,Hevnlyst,proudmoore,192,priest,shadow,6,2,4
41515,Laq,proudmoore,192,priest,shadow,6,2,4
41516,Vinatt,illidan,192,priest,shadow,6,2,4
41517,Fleshliight,area-52,192,priest,shadow,6,2,4
41518,Fatherleem,tichondrius,192,priest,shadow,6,2,4
41519,Midget,darkspear,192,priest,shadow,6,2,4
41520,Cxmplex,malganis,192,priest,shadow,6,2,4
41521,Sungai,thrall,192,priest,shadow,6,2,4
41522,Reckless,kirin-tor,192,priest,shadow,6,2,4
41523,Dotdotdead,earthen-ring,192,priest,shadow,6,2,4
41524,Sashatwo,proudmoore,192,priest,shadow,6,2,4
41525,Furryoflife,suramar,192,priest,shadow,6,2,4
41526,Layons,nemesis,192,priest,shadow,6,2,4
41527,Offwhit,azralon,192,priest,shadow,6,2,4
41528,Anxìetý,area-52,192,priest,shadow,6,2,4
41529,Massivepuss,illidan,192,priest,shadow,6,2,4
41530,Apâthy,area-52,192,priest,shadow,6,2,4
41531,Nynaeve,emerald-dream,192,priest,shadow,6,2,4
41532,Brounly,drakkari,192,priest,shadow,6,2,4
41533,Unholywood,lightbringer,192,priest,shadow,6,2,4
41534,Judis,barthilas,192,priest,shadow,6,2,4
41535,Lifejuice,tichondrius,192,priest,shadow,6,2,4
41536,Lolsithlord,tichondrius,192,priest,shadow,6,2,4
41537,Shrax,emerald-dream,192,priest,shadow,6,2,4
41538,Enochian,hyjal,192,priest,shadow,6,2,4
41539,Clairvoyantt,tichondrius,192,priest,shadow,6,2,4
41540,Meehow,lightninghoof,192,priest,shadow,6,2,4
41541,Sâishâ,proudmoore,192,priest,shadow,6,2,4
41542,Zarkos,area-52,192,priest,shadow,6,2,4
41543,Juliusceazer,skywall,192,priest,shadow,6,2,4
41544,Voidwyrm,tichondrius,192,priest,shadow,6,2,4
41545,Theono,sargeras,192,priest,shadow,6,2,4
41546,Fadestepx,stormrage,192,priest,shadow,6,2,4
41547,Aape,frostmourne,192,priest,shadow,6,2,4
41548,Clickbait,spirestone,192,priest,shadow,6,2,4
41549,Geoat,barthilas,192,priest,shadow,6,2,4
41550,Auntiegrimm,silvermoon,192,priest,shadow,6,2,4
41551,Trenance,barthilas,192,priest,shadow,6,2,4
41552,Melithor,frostmourne,192,priest,shadow,6,2,4
41553,Biggina,vashj,192,priest,shadow,6,2,4
41554,Alukel,moon-guard,192,priest,shadow,6,2,4
41555,Shmmoie,frostmourne,192,priest,shadow,6,2,4
41556,Byungsik,terenas,192,priest,shadow,6,2,4
41557,Purrpleelff,saurfang,192,priest,shadow,6,2,4
41558,Lyontnmetal,moon-guard,192,priest,shadow,6,2,4
41559,Beertriarch,frostmourne,192,priest,shadow,6,2,4
41560,Kahine,thaurissan,192,priest,shadow,6,2,4
41561,Apparìtions,khazgoroth,192,priest,shadow,6,2,4
41562,Pipete,frostmourne,192,priest,shadow,6,2,4
41563,Hrathren,caelestrasz,192,priest,shadow,6,2,4
41564,Fraggydaddy,frostmourne,192,priest,shadow,6,2,4
41565,Caristae,kelthuzad,192,priest,shadow,12,2,10
41566,Dalyeth,blackrock,192,priest,shadow,12,2,10
41567,Aphôtic,moon-guard,192,priest,shadow,12,2,10
41568,Alizhe,ragnaros,192,priest,shadow,12,2,10
41569,Painful,arathor,192,priest,shadow,12,2,10
41570,Killuminati,hyjal,192,priest,shadow,12,2,10
41571,Kodaks,frostmourne,192,priest,shadow,12,2,10
41572,Belfalst,shandris,192,priest,shadow,12,2,10
41573,Jimmyjangle,kelthuzad,192,priest,shadow,12,2,10
41574,Ozztwo,tichondrius,192,priest,shadow,12,2,10
41575,Kulrig,shuhalo,192,priest,shadow,12,2,10
41576,Tmpriest,tichondrius,175,priest,shadow,11,2,9
41577,Chü,dalaran,169,priest,shadow,12,5,7
41578,Nychka,kelthuzad,160,priest,shadow,10,2,8
41579,Xeevoos,nemesis,159,priest,shadow,5,2,3
41580,Tiizz,malganis,159,priest,shadow,5,2,3
41581,Juckerr,tichondrius,159,priest,shadow,5,2,3
41582,Lilpurp,sargeras,159,priest,shadow,5,2,3
41583,Pugadin,bleeding-hollow,159,priest,shadow,5,2,3
41584,Gobananas,bleeding-hollow,159,priest,shadow,5,2,3
41585,Tlolopolopo,quelthalas,159,priest,shadow,5,2,3
41586,Dekomori,quelthalas,159,priest,shadow,5,2,3
41587,Myndz,stormrage,159,priest,shadow,5,2,3
41588,Gaeira,azralon,159,priest,shadow,11,2,9
41589,Winss,tichondrius,128,priest,shadow,4,2,2
41590,Dingldangle,tichondrius,128,priest,shadow,4,2,2
41591,Cravex,stormrage,128,priest,shadow,4,2,2
41592,Sätîvá,tichondrius,96,priest,shadow,3,2,1
41593,Priestthingz,area-52,96,priest,shadow,8,2,6
41594,Jèf,stormrage,96,priest,shadow,6,1,5
41595,Omygawd,tichondrius,96,priest,shadow,6,1,5
41596,Cultists,tichondrius,96,priest,shadow,6,1,5
41597,Syrul,tichondrius,96,priest,shadow,6,1,5
41598,Onlysams,sargeras,96,priest,shadow,6,1,5
41599,Cáscá,stormrage,96,priest,shadow,6,1,5
41600,Manryu,tichondrius,96,priest,shadow,6,1,5
41601,Leliane,tichondrius,96,priest,shadow,6,1,5
41602,Baerybonds,kiljaeden,96,priest,shadow,6,1,5
41603,Nostrande,stormrage,96,priest,shadow,6,1,5
41604,Zway,moon-guard,96,priest,shadow,6,1,5
41605,Pmpn,tichondrius,96,priest,shadow,6,1,5
41606,Digop,azralon,96,priest,shadow,6,1,5
41607,Icespice,anvilmar,96,priest,shadow,6,1,5
41608,Dadsalad,zuljin,96,priest,shadow,6,1,5
41609,Dazzlems,tichondrius,96,priest,shadow,6,1,5
41610,Fámóus,stormrage,96,priest,shadow,6,1,5
41611,Zymmie,moon-guard,96,priest,shadow,6,1,5
41612,Torturex,zuljin,96,priest,shadow,6,1,5
41613,Kelody,zuljin,96,priest,shadow,6,1,5
41614,Wombitpurple,azgalor,96,priest,shadow,6,1,5
41615,Althlon,emerald-dream,96,priest,shadow,6,1,5
41616,Nightboxer,tichondrius,96,priest,shadow,6,1,5
41617,Mauriel,proudmoore,96,priest,shadow,6,1,5
41618,Mental,deathwing,96,priest,shadow,6,1,5
41619,Vyndictus,shattered-hand,96,priest,shadow,6,1,5
41620,Stunsilence,tichondrius,96,priest,shadow,6,1,5
41621,Voidzx,tichondrius,96,priest,shadow,6,1,5
41622,Poilu,laughing-skull,96,priest,shadow,6,1,5
41623,Squekp,laughing-skull,96,priest,shadow,6,1,5
41624,Cärdi,frostmourne,96,priest,shadow,6,1,5
41625,Marleylei,nesingwary,96,priest,shadow,6,1,5
41626,Tiskka,magtheridon,96,priest,shadow,6,1,5
41627,Psyward,tichondrius,96,priest,shadow,6,1,5
41628,Whatsittoya,tichondrius,96,priest,shadow,6,1,5
41629,Óst,tichondrius,96,priest,shadow,6,1,5
41630,Drippyjoones,sargeras,96,priest,shadow,6,1,5
41631,Slspookyx,tichondrius,96,priest,shadow,6,1,5
41632,Bigdaddios,dalaran,96,priest,shadow,6,1,5
41633,Lukaspriest,proudmoore,96,priest,shadow,6,1,5
41634,Sadury,tichondrius,96,priest,shadow,6,1,5
41635,Lilskizz,dalaran,96,priest,shadow,6,1,5
41636,Dawnbréaker,azralon,96,priest,shadow,6,1,5
41637,Paingivër,drakkari,96,priest,shadow,6,1,5
41638,Sprinkling,sargeras,96,priest,shadow,6,1,5
41639,Rays,drakkari,96,priest,shadow,6,1,5
41640,Mangemoélqc,darkspear,96,priest,shadow,6,1,5
41641,Vdip,illidan,96,priest,shadow,6,1,5
41642,Amikam,barthilas,96,priest,shadow,6,1,5
41643,Oxyy,aerie-peak,96,priest,shadow,6,1,5
41644,Galestick,illidan,96,priest,shadow,6,1,5
41645,Nancynibbler,bleeding-hollow,96,priest,shadow,6,1,5
41646,PlayerWDHGQY,illidan,96,priest,shadow,6,1,5
41647,Karamapang,illidan,96,priest,shadow,6,1,5
41648,Ibangedaqt,malganis,96,priest,shadow,6,1,5
41649,Dwarfxomp,ragnaros,96,priest,shadow,6,1,5
41650,Vineller,malganis,96,priest,shadow,6,1,5
41651,Powerwordwap,malganis,96,priest,shadow,6,1,5
41652,Jaquels,area-52,96,priest,shadow,6,1,5
41653,Beliál,ragnaros,96,priest,shadow,6,1,5
41654,Tusket,black-dragonflight,96,priest,shadow,6,1,5
41655,Wrinkletink,whisperwind,96,priest,shadow,6,1,5
41656,Milliyakk,area-52,96,priest,shadow,6,1,5
41657,Shadowftw,illidan,96,priest,shadow,6,1,5
41658,Iyanne,nemesis,96,priest,shadow,6,1,5
41659,Voidlordx,jubeithos,96,priest,shadow,6,1,5
41660,Releknosleep,frostwolf,96,priest,shadow,6,1,5
41661,Powerwordkfc,kelthuzad,96,priest,shadow,6,1,5
41662,Allaras,eldrethalas,96,priest,shadow,6,1,5
41663,Shadowreck,malganis,96,priest,shadow,6,1,5
41664,Syrillia,wildhammer,96,priest,shadow,6,1,5
41665,Burfdaycake,malganis,96,priest,shadow,6,1,5
41666,Yaelahi,illidan,96,priest,shadow,11,1,10
41667,Kellandis,jubeithos,96,priest,shadow,12,1,11
41668,Jpray,bleeding-hollow,96,priest,shadow,12,1,11
41669,Tallary,azralon,96,priest,shadow,12,1,11
41670,Xïlencer,tichondrius,96,priest,shadow,12,1,11
41671,Murdangus,moon-guard,96,priest,shadow,12,1,11
41672,ßugsy,illidan,96,priest,shadow,12,1,11
41673,Kunof,ragnaros,79,priest,shadow,5,1,4
41674,Xic,thrall,79,priest,shadow,5,1,4
41675,Cervasa,bleeding-hollow,63,priest,shadow,2,2,0
41676,Joktips,proudmoore,48,priest,shadow,3,1,2
41677,Richard,doomhammer,48,priest,shadow,3,1,2
41678,Fadehojx,illidan,42,priest,shadow,9,2,7
41679,Pulpitò,ragnaros,31,priest,shadow,2,1,1
41680,Turelim,illidan,31,priest,shadow,2,1,1
41681,Drpopepurp,tichondrius,31,priest,shadow,2,1,1
41682,Pilixil,bleeding-hollow,16,priest,shadow,1,1,0
41683,Trågédy,azjolnerub,16,priest,shadow,1,1,0
41684,Yellowrose,kelthuzad,2108,rogue,outlaw,121,69,52
41685,Weran,tichondrius,1976,rogue,outlaw,66,34,32
41686,Sadiator,illidan,1876,rogue,outlaw,65,36,29
41687,Dvn,stormrage,1844,rogue,outlaw,54,32,22
41688,Millspec,zuljin,1840,rogue,outlaw,54,33,21
41689,Onethiccboi,tichondrius,1796,rogue,outlaw,78,41,37
41690,Millspec,tichondrius,1762,rogue,outlaw,117,58,59
41691,Supherr,sargeras,1746,rogue,outlaw,83,46,37
41692,Gothamzzing,tichondrius,1738,rogue,outlaw,49,28,21
41693,Xylvána,kiljaeden,1728,rogue,outlaw,126,64,62
41694,Welinth,thunderlord,1724,rogue,outlaw,444,224,220
41695,Dennerdz,tichondrius,1688,rogue,outlaw,47,19,28
41696,Redimído,quelthalas,1674,rogue,outlaw,56,28,28
41697,Lycanthropî,illidan,1655,rogue,outlaw,80,37,43
41698,Arena,uldum,1631,rogue,outlaw,141,67,74
41699,Lardiconn,thrall,1628,rogue,outlaw,42,30,12
41700,Deadracer,moon-guard,1627,rogue,outlaw,60,32,28
41701,Lazeestab,sargeras,1618,rogue,outlaw,172,95,77
41702,Dogeggs,area-52,1609,rogue,outlaw,48,23,25
41703,Càgil,stormrage,1607,rogue,outlaw,34,19,15
41704,Jmaxx,wyrmrest-accord,1603,rogue,outlaw,51,32,19
41705,Gnover,ragnaros,1585,rogue,outlaw,88,45,43
41706,Corevis,moon-guard,1562,rogue,outlaw,60,28,32
41707,Swingonya,stormrage,1562,rogue,outlaw,42,19,23
41708,Blackmont,bleeding-hollow,1544,rogue,outlaw,111,63,48
41709,Supine,illidan,1539,rogue,outlaw,109,58,51
41710,Trêl,velen,1524,rogue,outlaw,141,71,70
41711,Omnïslash,stormrage,1519,rogue,outlaw,54,25,29
41712,Kentaki,tichondrius,1515,rogue,outlaw,60,33,27
41713,Karambit,frostmourne,1486,rogue,outlaw,120,54,66
41714,Trillkage,tichondrius,1483,rogue,outlaw,90,44,46
41715,Heliopolis,bleeding-hollow,1465,rogue,outlaw,36,17,19
41716,Mõtaru,stormrage,1449,rogue,outlaw,66,33,33
41717,Jenaki,gurubashi,1442,rogue,outlaw,62,32,30
41718,Bleaklord,emerald-dream,1440,rogue,outlaw,54,22,32
41719,Disrawen,ragnaros,1438,rogue,outlaw,485,239,246
41720,Mirâge,illidan,1432,rogue,outlaw,61,30,31
41721,Velskud,area-52,1430,rogue,outlaw,82,41,41
41722,Gotosor,quelthalas,1415,rogue,outlaw,144,73,71
41723,Jolly,frostmourne,1413,rogue,outlaw,71,30,41
41724,Fastblast,wyrmrest-accord,1411,rogue,outlaw,30,15,15
41725,Combo,norgannon,1409,rogue,outlaw,167,92,75
41726,Shadowstryfe,tichondrius,1409,rogue,outlaw,47,22,25
41727,Shindeiru,area-52,1399,rogue,outlaw,43,30,13
41728,Mgzx,tichondrius,1399,rogue,outlaw,165,87,78
41729,Fryphilip,dalaran,1397,rogue,outlaw,34,15,19
41730,Luolan,kargath,1378,rogue,outlaw,44,16,28
41731,Itsuksiko,quelthalas,1368,rogue,outlaw,63,30,33
41732,Snakeblisken,emerald-dream,1352,rogue,outlaw,36,15,21
41733,Cidi,moon-guard,1343,rogue,outlaw,48,18,30
41734,Hobblefoot,proudmoore,1340,rogue,outlaw,46,24,22
41735,Jakamungo,area-52,1329,rogue,outlaw,52,26,26
41736,Dross,shadowmoon,1325,rogue,outlaw,30,14,16
41737,Chrisdorner,area-52,1316,rogue,outlaw,25,14,11
41738,Reyskywalker,kelthuzad,1303,rogue,outlaw,24,15,9
41739,Shyzuku,drakkari,1303,rogue,outlaw,44,20,24
41740,Slitherex,thunderlord,1297,rogue,outlaw,51,27,24
41741,Ntrfighter,tichondrius,1258,rogue,outlaw,71,36,35
41742,Cheddery,dalaran,1247,rogue,outlaw,86,46,40
41743,Wátchyoúrbák,wyrmrest-accord,1247,rogue,outlaw,30,14,16
41744,Straite,area-52,1244,rogue,outlaw,24,13,11
41745,Houlton,moon-guard,1234,rogue,outlaw,24,13,11
41746,Aitreena,stormrage,1210,rogue,outlaw,24,13,11
41747,Zanith,wyrmrest-accord,1194,rogue,outlaw,28,15,13
41748,Lovedemtings,dark-iron,1191,rogue,outlaw,28,13,15
41749,Rynica,illidan,1151,rogue,outlaw,53,27,26
41750,Peteylee,stormrage,1150,rogue,outlaw,24,12,12
41751,Mabushi,sargeras,1135,rogue,outlaw,42,15,27
41752,Zogbu,stormrage,1128,rogue,outlaw,42,17,25
41753,Asdestroyerr,tichondrius,1114,rogue,outlaw,26,13,13
41754,Emoond,ragnaros,1110,rogue,outlaw,39,22,17
41755,Vanorn,aerie-peak,1109,rogue,outlaw,60,20,40
41756,Adevoir,hakkar,1099,rogue,outlaw,72,37,35
41757,Itricku,tichondrius,1093,rogue,outlaw,60,23,37
41758,Valefarr,emerald-dream,1090,rogue,outlaw,41,20,21
41759,Zarthrox,bladefist,1086,rogue,outlaw,42,21,21
41760,Johnnyelbows,tichondrius,1078,rogue,outlaw,27,13,14
41761,Azarha,zuljin,1060,rogue,outlaw,66,34,32
41762,Tanadoril,wyrmrest-accord,1051,rogue,outlaw,24,11,13
41763,Wujn,tichondrius,1050,rogue,outlaw,24,11,13
41764,Lumifer,quelthalas,1050,rogue,outlaw,54,18,36
41765,Xyleth,azgalor,1048,rogue,outlaw,53,20,33
41766,Cathat,area-52,1047,rogue,outlaw,24,11,13
41767,Thèory,sargeras,1044,rogue,outlaw,24,11,13
41768,Badpatatas,proudmoore,1043,rogue,outlaw,52,15,37
41769,Amorfirion,frostmourne,1041,rogue,outlaw,24,13,11
41770,Nicademos,bleeding-hollow,1037,rogue,outlaw,18,11,7
41771,Mechamind,draka,1034,rogue,outlaw,18,11,7
41772,Abatoire,wyrmrest-accord,1017,rogue,outlaw,66,31,35
41773,Thuganomics,dark-iron,1008,rogue,outlaw,27,12,15
41774,Lawyergamer,bonechewer,976,rogue,outlaw,44,18,26
41775,Farstrider,tichondrius,974,rogue,outlaw,84,33,51
41776,Hokagesasuke,bleeding-hollow,972,rogue,outlaw,36,14,22
41777,Listrew,stormrage,970,rogue,outlaw,24,12,12
41778,Larmx,tichondrius,960,rogue,outlaw,24,10,14
41779,Inhume,eredar,960,rogue,outlaw,24,10,14
41780,Quapi,tichondrius,959,rogue,outlaw,18,10,8
41781,Preceptor,azralon,956,rogue,outlaw,24,10,14
41782,Nitroxy,quelthalas,950,rogue,outlaw,24,10,14
41783,Stabbymcgee,duskwood,941,rogue,outlaw,24,11,13
41784,Bonizzi,stormrage,940,rogue,outlaw,18,10,8
41785,Shninzy,senjin,910,rogue,outlaw,31,11,20
41786,Pigshank,proudmoore,906,rogue,outlaw,18,10,8
41787,Zeed,ragnaros,866,rogue,outlaw,66,30,36
41788,Donstevano,frostmourne,864,rogue,outlaw,24,9,15
41789,Stabbythorus,stormrage,862,rogue,outlaw,18,9,9
41790,Bebesita,sisters-of-elune,860,rogue,outlaw,18,9,9
41791,Phraze,silvermoon,859,rogue,outlaw,30,14,16
41792,Vîllâîn,tichondrius,859,rogue,outlaw,24,9,15
41793,Yerehmi,quelthalas,852,rogue,outlaw,18,10,8
41794,Ningaturtle,korgath,844,rogue,outlaw,48,19,29
41795,Gfuel,azgalor,827,rogue,outlaw,22,9,13
41796,Fennick,tanaris,823,rogue,outlaw,31,9,22
41797,Tootled,wyrmrest-accord,822,rogue,outlaw,16,10,6
41798,Elitejigsaw,perenolde,822,rogue,outlaw,24,9,15
41799,Sabbathe,kargath,817,rogue,outlaw,26,10,16
41800,Coalie,tichondrius,816,rogue,outlaw,15,9,6
41801,Synj,frostmourne,798,rogue,outlaw,14,9,5
41802,Mhdz,tichondrius,789,rogue,outlaw,24,10,14
41803,Lesty,kelthuzad,768,rogue,outlaw,12,8,4
41804,Cireene,proudmoore,768,rogue,outlaw,12,8,4
41805,Deepsyo,frostmourne,768,rogue,outlaw,12,8,4
41806,Upcrazylol,area-52,768,rogue,outlaw,12,8,4
41807,Yodiegang,tichondrius,768,rogue,outlaw,12,8,4
41808,Airi,darkspear,768,rogue,outlaw,18,8,10
41809,Tarnished,ravenholdt,766,rogue,outlaw,24,8,16
41810,Nvirus,quelthalas,765,rogue,outlaw,18,8,10
41811,Nordedge,stormrage,756,rogue,outlaw,24,8,16
41812,Marraya,area-52,750,rogue,outlaw,18,8,10
41813,Zeetwntyeght,stormrage,747,rogue,outlaw,29,8,21
41814,Gnòme,frostmourne,701,rogue,outlaw,11,8,3
41815,Thompson,bloodscalp,672,rogue,outlaw,12,7,5
41816,Invisidubya,illidan,671,rogue,outlaw,12,7,5
41817,Minuss,rivendare,671,rogue,outlaw,12,7,5
41818,Drsinz,tichondrius,671,rogue,outlaw,18,7,11
41819,Slowtime,quelthalas,671,rogue,outlaw,18,7,11
41820,Vilthoon,sargeras,670,rogue,outlaw,12,7,5
41821,Uzell,sargeras,670,rogue,outlaw,12,7,5
41822,Cosmicò,trollbane,670,rogue,outlaw,12,7,5
41823,Evilkoreanz,tichondrius,670,rogue,outlaw,12,7,5
41824,Jamesallen,silvermoon,659,rogue,outlaw,12,7,5
41825,Adrala,thunderlord,657,rogue,outlaw,12,7,5
41826,Furrykneecap,hyjal,655,rogue,outlaw,12,9,3
41827,Roxy,ghostlands,623,rogue,outlaw,17,7,10
41828,Esky,tichondrius,576,rogue,outlaw,12,6,6
41829,Deeppockets,sargeras,576,rogue,outlaw,12,6,6
41830,Hezi,area-52,576,rogue,outlaw,12,6,6
41831,Sandorrogue,stormrage,576,rogue,outlaw,12,6,6
41832,Riprorin,stormrage,576,rogue,outlaw,18,6,12
41833,Dalaranxp,illidan,576,rogue,outlaw,18,6,12
41834,Drakariano,ragnaros,575,rogue,outlaw,18,6,12
41835,Sprork,kiljaeden,575,rogue,outlaw,18,6,12
41836,Shmoked,moon-guard,575,rogue,outlaw,18,6,12
41837,Geratyere,trollbane,574,rogue,outlaw,18,6,12
41838,Deddyy,zuljin,574,rogue,outlaw,18,6,12
41839,Maglove,nemesis,571,rogue,outlaw,12,6,6
41840,Walyo,stormrage,544,rogue,outlaw,16,7,9
41841,Chapex,ragnaros,511,rogue,outlaw,14,6,8
41842,Tsubamë,tichondrius,480,rogue,outlaw,6,5,1
41843,Sotypical,area-52,480,rogue,outlaw,6,5,1
41844,Tmpikaboo,tichondrius,480,rogue,outlaw,6,5,1
41845,Galfuran,burning-legion,480,rogue,outlaw,12,5,7
41846,Dicenslice,proudmoore,480,rogue,outlaw,12,5,7
41847,Skaven,dunemaul,480,rogue,outlaw,12,5,7
41848,Steviekìcks,frostmourne,480,rogue,outlaw,12,5,7
41849,Bootypie,hyjal,480,rogue,outlaw,12,5,7
41850,Sekkelx,moon-guard,480,rogue,outlaw,12,5,7
41851,Dultz,tichondrius,480,rogue,outlaw,12,5,7
41852,Violetrose,kelthuzad,480,rogue,outlaw,12,5,7
41853,Alexyy,blades-edge,480,rogue,outlaw,12,5,7
41854,Earthinhorn,frostmourne,480,rogue,outlaw,18,5,13
41855,Spikiera,silvermoon,480,rogue,outlaw,18,5,13
41856,Pez,barthilas,480,rogue,outlaw,18,5,13
41857,Falloran,nerzhul,479,rogue,outlaw,12,5,7
41858,Universalize,proudmoore,479,rogue,outlaw,12,5,7
41859,Sasskei,malganis,479,rogue,outlaw,12,5,7
41860,Kasharo,tichondrius,479,rogue,outlaw,12,5,7
41861,Aylyus,kiljaeden,478,rogue,outlaw,12,5,7
41862,Xzarfi,moon-guard,478,rogue,outlaw,30,5,25
41863,Mangaleón,wildhammer,475,rogue,outlaw,12,5,7
41864,Gnork,twisting-nether,475,rogue,outlaw,12,5,7
41865,Alerana,dathremar,474,rogue,outlaw,12,5,7
41866,Darthkelso,arathor,465,rogue,outlaw,24,5,19
41867,Velox,kiljaeden,384,rogue,outlaw,6,4,2
41868,Kents,tichondrius,384,rogue,outlaw,6,4,2
41869,Xylvana,kiljaeden,384,rogue,outlaw,6,4,2
41870,Krypticstab,malganis,384,rogue,outlaw,6,4,2
41871,Flashmob,zuljin,384,rogue,outlaw,6,4,2
41872,Alandoril,tichondrius,384,rogue,outlaw,6,4,2
41873,Xavar,malganis,384,rogue,outlaw,6,4,2
41874,Letty,area-52,384,rogue,outlaw,6,4,2
41875,Jsyn,kiljaeden,384,rogue,outlaw,12,4,8
41876,Sazor,ysera,384,rogue,outlaw,12,4,8
41877,Dayvanie,area-52,384,rogue,outlaw,12,4,8
41878,Showclass,stormrage,384,rogue,outlaw,12,4,8
41879,Darthol,muradin,384,rogue,outlaw,12,4,8
41880,Nello,runetotem,384,rogue,outlaw,12,4,8
41881,Nestha,quelthalas,384,rogue,outlaw,12,4,8
41882,Blingtronx,malganis,384,rogue,outlaw,12,4,8
41883,Subnini,kelthuzad,384,rogue,outlaw,18,4,14
41884,Gheez,quelthalas,383,rogue,outlaw,6,4,2
41885,Katanië,moon-guard,383,rogue,outlaw,12,4,8
41886,Keenstar,moon-guard,383,rogue,outlaw,18,4,14
41887,Houdinilogic,skullcrusher,381,rogue,outlaw,12,4,8
41888,Daftjack,bleeding-hollow,381,rogue,outlaw,12,4,8
41889,Hîzzÿ,ghostlands,350,rogue,outlaw,26,5,21
41890,Siamés,quelthalas,319,rogue,outlaw,14,4,10
41891,Daehyun,moknathal,288,rogue,outlaw,6,3,3
41892,Hepatocyte,anvilmar,288,rogue,outlaw,6,3,3
41893,Dookienotop,thunderhorn,288,rogue,outlaw,6,3,3
41894,Instructor,area-52,288,rogue,outlaw,6,3,3
41895,Bigcolumn,tichondrius,288,rogue,outlaw,6,3,3
41896,Karmagoodttv,stormrage,288,rogue,outlaw,6,3,3
41897,Vierhy,proudmoore,288,rogue,outlaw,6,3,3
41898,Homeschoolx,moon-guard,288,rogue,outlaw,6,3,3
41899,Bàndit,wyrmrest-accord,288,rogue,outlaw,6,3,3
41900,Lacero,bonechewer,288,rogue,outlaw,6,3,3
41901,Hachiwari,moon-guard,288,rogue,outlaw,6,3,3
41902,Whaazz,emerald-dream,288,rogue,outlaw,6,3,3
41903,Twnk,stormrage,288,rogue,outlaw,6,3,3
41904,Hobblefoot,tichondrius,288,rogue,outlaw,6,3,3
41905,Skoalr,thrall,288,rogue,outlaw,6,3,3
41906,Rotjaw,hydraxis,288,rogue,outlaw,6,3,3
41907,Alexdelion,tichondrius,288,rogue,outlaw,6,3,3
41908,Hellstabber,lightbringer,288,rogue,outlaw,6,3,3
41909,Pockettsand,firetree,288,rogue,outlaw,6,3,3
41910,Ghøstfäce,tichondrius,288,rogue,outlaw,6,3,3
41911,Movze,area-52,288,rogue,outlaw,6,3,3
41912,Pikartz,stormrage,288,rogue,outlaw,6,3,3
41913,Slapjak,dalaran,288,rogue,outlaw,6,3,3
41914,Rujkah,archimonde,288,rogue,outlaw,6,3,3
41915,Pilurfs,thrall,288,rogue,outlaw,6,3,3
41916,Machos,azralon,288,rogue,outlaw,6,3,3
41917,Drpibb,ghostlands,288,rogue,outlaw,12,3,9
41918,Ñinjå,alleria,288,rogue,outlaw,18,3,15
41919,Nippsy,aerie-peak,288,rogue,outlaw,18,3,15
41920,Stabyou,sentinels,287,rogue,outlaw,6,3,3
41921,Adysius,malganis,287,rogue,outlaw,6,3,3
41922,Vampireshade,bloodhoof,286,rogue,outlaw,12,3,9
41923,Fenrul,thunderlord,285,rogue,outlaw,12,3,9
41924,Grimthorn,icecrown,285,rogue,outlaw,12,3,9
41925,Smilinjack,ysera,284,rogue,outlaw,12,3,9
41926,Hotboxthefox,illidan,253,rogue,outlaw,11,3,8
41927,Slobernocker,stormrage,192,rogue,outlaw,6,2,4
41928,Eatcheese,sargeras,192,rogue,outlaw,6,2,4
41929,Kpr,sargeras,192,rogue,outlaw,6,2,4
41930,Nïck,korialstrasz,192,rogue,outlaw,6,2,4
41931,Dillwilly,moon-guard,192,rogue,outlaw,6,2,4
41932,Mud,saurfang,192,rogue,outlaw,6,2,4
41933,Creamcakepop,stormrage,192,rogue,outlaw,6,2,4
41934,Matheuzaum,goldrinn,192,rogue,outlaw,6,2,4
41935,Remonezero,moon-guard,192,rogue,outlaw,6,2,4
41936,Duskeron,cenarius,192,rogue,outlaw,6,2,4
41937,Jebubs,tichondrius,192,rogue,outlaw,6,2,4
41938,Touchthetip,bleeding-hollow,192,rogue,outlaw,6,2,4
41939,Squigglies,aerie-peak,192,rogue,outlaw,6,2,4
41940,ßuu,sargeras,192,rogue,outlaw,6,2,4
41941,Prisonshank,arthas,192,rogue,outlaw,6,2,4
41942,Shádyj,velen,192,rogue,outlaw,6,2,4
41943,Vizimyr,malganis,192,rogue,outlaw,12,2,10
41944,Nikosneako,tichondrius,192,rogue,outlaw,12,2,10
41945,Sxs,kiljaeden,192,rogue,outlaw,12,2,10
41946,Pelussy,kiljaeden,192,rogue,outlaw,15,2,13
41947,Manoq,drakkari,191,rogue,outlaw,6,2,4
41948,Landrik,trollbane,191,rogue,outlaw,6,2,4
41949,Òklahomie,frostwolf,191,rogue,outlaw,6,2,4
41950,Philliamson,azgalor,190,rogue,outlaw,12,2,10
41951,Hedillyan,azralon,138,rogue,outlaw,9,3,6
41952,Reginageorge,azuremyst,96,rogue,outlaw,6,1,5
41953,Leiffer,ragnaros,96,rogue,outlaw,6,1,5
41954,Loruk,ragnaros,96,rogue,outlaw,6,1,5
41955,Fateapocryph,azralon,96,rogue,outlaw,6,1,5
41956,Takeiapika,azralon,96,rogue,outlaw,6,1,5
41957,Neilyo,barthilas,96,rogue,outlaw,6,1,5
41958,Sindor,azralon,96,rogue,outlaw,6,1,5
41959,Whatsåpp,gallywix,96,rogue,outlaw,6,1,5
41960,Rinestiria,arthas,96,rogue,outlaw,6,1,5
41961,Denlox,moon-guard,96,rogue,outlaw,6,1,5
41962,Dessenia,illidan,96,rogue,outlaw,6,1,5
41963,Tegernako,firetree,96,rogue,outlaw,6,1,5
41964,Lu,lethon,96,rogue,outlaw,6,1,5
41965,Burt,akama,96,rogue,outlaw,6,1,5
41966,Happyslice,stormrage,96,rogue,outlaw,6,1,5
41967,Raimondo,frostmourne,96,rogue,outlaw,6,1,5
41968,Downsix,sargeras,96,rogue,outlaw,6,1,5
41969,Madge,area-52,96,rogue,outlaw,6,1,5
41970,Xm,sargeras,96,rogue,outlaw,6,1,5
41971,Sleepstryke,stormrage,96,rogue,outlaw,12,1,11
41972,Culpera,undermine,95,rogue,outlaw,6,1,5
41973,Vladdracc,quelthalas,48,rogue,outlaw,3,1,2
41974,Aliasfaker,stormrage,16,rogue,outlaw,1,1,0
41975,Erebüs,thunderlord,2373,rogue,subtlety,120,77,43
41976,Fotg,tichondrius,2265,rogue,subtlety,78,48,30
41977,Battzii,wyrmrest-accord,2170,rogue,subtlety,921,478,443
41978,Alexdelion,tichondrius,2142,rogue,subtlety,90,47,43
41979,Æsshayádlay,tichondrius,2131,rogue,subtlety,81,42,39
41980,Ymxxworld,tichondrius,2107,rogue,subtlety,96,49,47
41981,Thèllè,sargeras,2104,rogue,subtlety,78,46,32
41982,Røgüë,malganis,2100,rogue,subtlety,96,53,43
41983,Kenpàchi,kelthuzad,1995,rogue,subtlety,152,85,67
41984,Hiyõ,tichondrius,1995,rogue,subtlety,190,106,84
41985,Flashmob,zuljin,1991,rogue,subtlety,62,31,31
41986,Danrathm,sargeras,1990,rogue,subtlety,109,59,50
41987,Vendettita,quelthalas,1983,rogue,subtlety,84,47,37
41988,Roguesparrow,illidan,1978,rogue,subtlety,176,99,77
41989,Ajl,drenden,1973,rogue,subtlety,172,88,84
41990,Swadeecup,nagrand,1965,rogue,subtlety,84,41,43
41991,Lies,dalaran,1957,rogue,subtlety,111,53,58
41992,Kidcutti,proudmoore,1952,rogue,subtlety,92,49,43
41993,Zurza,proudmoore,1943,rogue,subtlety,95,44,51
41994,Incoherentz,frostmourne,1940,rogue,subtlety,60,34,26
41995,Rangoons,tichondrius,1938,rogue,subtlety,66,39,27
41996,Cydonian,ragnaros,1937,rogue,subtlety,154,87,67
41997,Yázim,tichondrius,1935,rogue,subtlety,79,48,31
41998,Maulline,tichondrius,1932,rogue,subtlety,60,27,33
41999,Esky,tichondrius,1918,rogue,subtlety,75,40,35
42000,Ulley,sargeras,1914,rogue,subtlety,150,85,65
42001,Norbury,tichondrius,1901,rogue,subtlety,136,67,69
42002,Minaciki,tichondrius,1898,rogue,subtlety,72,41,31
42003,Antoninez,tichondrius,1892,rogue,subtlety,54,29,25
42004,Wetit,illidan,1876,rogue,subtlety,90,60,30
42005,Slashthunder,blades-edge,1876,rogue,subtlety,54,29,25
42006,Needbuff,tichondrius,1865,rogue,subtlety,54,25,29
42007,Wizlysnipz,tichondrius,1859,rogue,subtlety,90,52,38
42008,Coopi,tichondrius,1853,rogue,subtlety,115,60,55
42009,Scuffedjr,tichondrius,1851,rogue,subtlety,96,43,53
42010,Himitu,tichondrius,1849,rogue,subtlety,89,46,43
42011,Stealthypoop,kelthuzad,1845,rogue,subtlety,136,67,69
42012,Coregx,tichondrius,1842,rogue,subtlety,36,24,12
42013,Rõý,area-52,1837,rogue,subtlety,42,23,19
42014,Wazowskiy,tichondrius,1837,rogue,subtlety,181,88,93
42015,Silentkush,arthas,1833,rogue,subtlety,54,33,21
42016,Stunsofpuns,sargeras,1833,rogue,subtlety,60,33,27
42017,Fátálíty,tichondrius,1827,rogue,subtlety,60,30,30
42018,Seengivenchy,zuljin,1825,rogue,subtlety,60,39,21
42019,Smkgpvp,stormrage,1823,rogue,subtlety,68,43,25
42020,Howton,kelthuzad,1822,rogue,subtlety,24,19,5
42021,Beanlord,spinebreaker,1820,rogue,subtlety,93,55,38
42022,Clern,emerald-dream,1818,rogue,subtlety,65,35,30
42023,Ðèãth,area-52,1818,rogue,subtlety,36,19,17
42024,Asoj,tichondrius,1817,rogue,subtlety,60,30,30
42025,Celèphaïs,tichondrius,1817,rogue,subtlety,63,30,33
42026,Stealthyxd,arthas,1815,rogue,subtlety,48,20,28
42027,Ganknvanish,tichondrius,1814,rogue,subtlety,189,96,93
42028,Votekanye,bleeding-hollow,1812,rogue,subtlety,36,28,8
42029,Zerogh,tichondrius,1811,rogue,subtlety,129,75,54
42030,Ideology,azgalor,1811,rogue,subtlety,52,26,26
42031,Sasugay,sargeras,1809,rogue,subtlety,98,61,37
42032,Bigpump,lothar,1809,rogue,subtlety,60,33,27
42033,Bruítzy,barthilas,1809,rogue,subtlety,156,82,74
42034,Dysxliec,dalaran,1808,rogue,subtlety,173,90,83
42035,Díor,azralon,1807,rogue,subtlety,124,70,54
42036,Turtlespeed,thrall,1803,rogue,subtlety,123,74,49
42037,ßaltø,bleeding-hollow,1799,rogue,subtlety,42,19,23
42038,Yunggodmalik,whisperwind,1799,rogue,subtlety,48,19,29
42039,Tyrrantxo,agamaggan,1797,rogue,subtlety,76,42,34
42040,Scuffedsr,tichondrius,1792,rogue,subtlety,48,25,23
42041,Airi,darkspear,1791,rogue,subtlety,85,44,41
42042,Okaylmao,tichondrius,1789,rogue,subtlety,74,41,33
42043,Nightcloud,tichondrius,1785,rogue,subtlety,80,44,36
42044,Kellenx,moon-guard,1780,rogue,subtlety,145,73,72
42045,Shinigâmì,tichondrius,1778,rogue,subtlety,138,83,55
42046,Dvin,stormrage,1770,rogue,subtlety,54,30,24
42047,Gyokkó,sargeras,1770,rogue,subtlety,36,20,16
42048,Gnover,ragnaros,1769,rogue,subtlety,234,136,98
42049,Queuethunder,blades-edge,1756,rogue,subtlety,34,28,6
42050,Greyyfox,illidan,1754,rogue,subtlety,69,33,36
42051,ßuu,sargeras,1749,rogue,subtlety,36,21,15
42052,Aaronjlol,tichondrius,1747,rogue,subtlety,36,23,13
42053,Trc,illidan,1746,rogue,subtlety,50,28,22
42054,Damrat,tichondrius,1743,rogue,subtlety,36,21,15
42055,Marcusr,tichondrius,1739,rogue,subtlety,60,33,27
42056,Lxw,frostmourne,1739,rogue,subtlety,61,29,32
42057,Stabem,moon-guard,1735,rogue,subtlety,99,55,44
42058,Onîkudaki,sargeras,1730,rogue,subtlety,54,23,31
42059,Assassìn,moon-guard,1729,rogue,subtlety,193,104,89
42060,Baeruto,thunderlord,1726,rogue,subtlety,24,18,6
42061,Decóm,zuljin,1725,rogue,subtlety,52,27,25
42062,Brucerogue,tichondrius,1724,rogue,subtlety,326,166,160
42063,Jsnlol,zuljin,1722,rogue,subtlety,30,22,8
42064,Shankntwist,malganis,1722,rogue,subtlety,42,26,16
42065,Axtually,proudmoore,1716,rogue,subtlety,126,69,57
42066,Saprìse,darkspear,1710,rogue,subtlety,72,44,28
42067,Pxb,sargeras,1705,rogue,subtlety,88,40,48
42068,Poizzon,emerald-dream,1704,rogue,subtlety,85,46,39
42069,Majk,eldrethalas,1703,rogue,subtlety,76,37,39
42070,Eekz,illidan,1702,rogue,subtlety,310,172,138
42071,Yoskit,tichondrius,1700,rogue,subtlety,36,21,15
42072,Whoox,khazgoroth,1695,rogue,subtlety,42,29,13
42073,Saltymann,bleeding-hollow,1695,rogue,subtlety,60,35,25
42074,Xiaozhi,tichondrius,1692,rogue,subtlety,52,26,26
42075,Kyubïx,ragnaros,1691,rogue,subtlety,108,66,42
42076,Siyeong,tichondrius,1688,rogue,subtlety,96,57,39
42077,Vellexsis,sargeras,1685,rogue,subtlety,79,41,38
42078,Roguetrix,stormrage,1685,rogue,subtlety,161,80,81
42079,Bobsaget,kiljaeden,1684,rogue,subtlety,94,48,46
42080,Blakezilla,tichondrius,1677,rogue,subtlety,72,42,30
42081,Buffsubrmp,tichondrius,1672,rogue,subtlety,30,19,11
42082,Cut,ragnaros,1672,rogue,subtlety,136,72,64
42083,Yesua,ragnaros,1672,rogue,subtlety,265,134,131
42084,Originalfake,sargeras,1669,rogue,subtlety,45,24,21
42085,Vavnmusic,illidan,1667,rogue,subtlety,78,49,29
42086,Bezeta,azralon,1667,rogue,subtlety,269,144,125
42087,Jaos,tichondrius,1667,rogue,subtlety,42,22,20
42088,Eekz,sargeras,1666,rogue,subtlety,269,139,130
42089,Incognitony,proudmoore,1666,rogue,subtlety,45,22,23
42090,Skitsöu,tichondrius,1665,rogue,subtlety,42,23,19
42091,Vanishcdc,area-52,1664,rogue,subtlety,48,29,19
42092,Chitovera,tichondrius,1663,rogue,subtlety,36,25,11
42093,Zeiss,tichondrius,1663,rogue,subtlety,54,27,27
42094,Yurasick,lightbringer,1657,rogue,subtlety,42,26,16
42095,Themosk,malganis,1656,rogue,subtlety,42,21,21
42096,Camlaw,area-52,1655,rogue,subtlety,90,52,38
42097,Aman,frostmourne,1653,rogue,subtlety,47,29,18
42098,Ðankbud,barthilas,1649,rogue,subtlety,39,19,20
42099,Esmeraldas,frostmourne,1644,rogue,subtlety,53,28,25
42100,Zipperx,tichondrius,1641,rogue,subtlety,65,34,31
42101,Steef,arygos,1636,rogue,subtlety,92,54,38
42102,Îzu,ysera,1636,rogue,subtlety,63,36,27
42103,Fence,moon-guard,1635,rogue,subtlety,48,28,20
42104,Tmskitsou,tichondrius,1634,rogue,subtlety,34,20,14
42105,Furt,frostmourne,1633,rogue,subtlety,44,25,19
42106,Mesqeets,kelthuzad,1632,rogue,subtlety,41,24,17
42107,Nicoaa,tichondrius,1631,rogue,subtlety,194,99,95
42108,Garrotte,tichondrius,1631,rogue,subtlety,140,67,73
42109,Lxke,stormrage,1630,rogue,subtlety,34,22,12
42110,Frusciante,nemesis,1630,rogue,subtlety,90,52,38
42111,Haiev,tichondrius,1630,rogue,subtlety,72,36,36
42112,Stepcurry,tichondrius,1629,rogue,subtlety,36,26,10
42113,Antos,tichondrius,1628,rogue,subtlety,24,17,7
42114,Shreddér,tichondrius,1628,rogue,subtlety,41,20,21
42115,Spookyboogie,aegwynn,1624,rogue,subtlety,64,36,28
42116,Gotto,icecrown,1623,rogue,subtlety,47,24,23
42117,Gptcodeplay,tichondrius,1622,rogue,subtlety,36,25,11
42118,Cuizhudi,tichondrius,1620,rogue,subtlety,50,31,19
42119,Bruitzygg,barthilas,1619,rogue,subtlety,44,20,24
42120,Klawz,norgannon,1618,rogue,subtlety,53,32,21
42121,Neonjk,ragnaros,1618,rogue,subtlety,78,43,35
42122,Astroz,sargeras,1615,rogue,subtlety,42,21,21
42123,Mirâge,illidan,1614,rogue,subtlety,108,59,49
42124,Preceptor,azralon,1614,rogue,subtlety,86,44,42
42125,Energy,auchindoun,1612,rogue,subtlety,56,34,22
42126,Frez,amanthul,1611,rogue,subtlety,30,20,10
42127,Rosoma,kelthuzad,1610,rogue,subtlety,65,38,27
42128,Ozzinton,kelthuzad,1609,rogue,subtlety,30,17,13
42129,Lululee,tichondrius,1609,rogue,subtlety,63,28,35
42130,Piscís,sargeras,1606,rogue,subtlety,60,31,29
42131,Kazzo,tichondrius,1605,rogue,subtlety,45,32,13
42132,Skoalr,thrall,1604,rogue,subtlety,64,43,21
42133,Bombman,tichondrius,1604,rogue,subtlety,125,62,63
42134,Taidath,area-52,1603,rogue,subtlety,42,20,22
42135,Runakó,kelthuzad,1603,rogue,subtlety,48,21,27
42136,Karmagoodttv,stormrage,1602,rogue,subtlety,34,22,12
42137,Dogpaws,moon-guard,1600,rogue,subtlety,46,30,16
42138,Techie,frostmane,1600,rogue,subtlety,68,38,30
42139,Hayzarc,malfurion,1598,rogue,subtlety,42,21,21
42140,Kalvish,dalaran,1597,rogue,subtlety,29,17,12
42141,Vyrenn,destromath,1597,rogue,subtlety,103,50,53
42142,Mtvcribs,emerald-dream,1596,rogue,subtlety,37,22,15
42143,Fancen,drakthul,1591,rogue,subtlety,54,31,23
42144,Saulgoodz,tichondrius,1590,rogue,subtlety,42,23,19
42145,Unshut,tichondrius,1588,rogue,subtlety,30,19,11
42146,Ateabug,wyrmrest-accord,1587,rogue,subtlety,30,17,13
42147,Wowamaze,aegwynn,1584,rogue,subtlety,118,64,54
42148,Tigerinu,stormreaver,1584,rogue,subtlety,52,26,26
42149,Cahlee,sargeras,1582,rogue,subtlety,147,70,77
42150,Saltypwncake,illidan,1580,rogue,subtlety,42,20,22
42151,Jolly,frostmourne,1574,rogue,subtlety,82,47,35
42152,Rufian,ursin,1574,rogue,subtlety,72,40,32
42153,Jawnrogue,tichondrius,1572,rogue,subtlety,30,22,8
42154,Jibdorf,destromath,1571,rogue,subtlety,60,38,22
42155,Åer,dalaran,1566,rogue,subtlety,135,71,64
42156,Overdríver,emerald-dream,1566,rogue,subtlety,36,17,19
42157,Trizin,frostmourne,1563,rogue,subtlety,84,45,39
42158,Amonn,arthas,1558,rogue,subtlety,125,60,65
42159,Tootsio,tichondrius,1557,rogue,subtlety,42,22,20
42160,Revelationzz,turalyon,1557,rogue,subtlety,133,68,65
42161,Acid,warsong,1555,rogue,subtlety,36,23,13
42162,Faelanna,stormrage,1554,rogue,subtlety,79,40,39
42163,Grelinho,stormrage,1554,rogue,subtlety,66,26,40
42164,Stunz,mugthol,1553,rogue,subtlety,62,41,21
42165,Ghyile,stormreaver,1552,rogue,subtlety,36,18,18
42166,Tarny,illidan,1551,rogue,subtlety,64,27,37
42167,Lurios,rivendare,1547,rogue,subtlety,88,48,40
42168,Zaszune,stormrage,1545,rogue,subtlety,30,18,12
42169,Whoô,khazgoroth,1545,rogue,subtlety,84,44,40
42170,Kinbaal,bleeding-hollow,1544,rogue,subtlety,42,26,16
42171,Sandorroguee,stormrage,1544,rogue,subtlety,36,18,18
42172,Danielsylerr,drakkari,1543,rogue,subtlety,42,18,24
42173,Threeplates,silvermoon,1538,rogue,subtlety,93,50,43
42174,Clownboots,tichondrius,1538,rogue,subtlety,145,72,73
42175,Prrey,hydraxis,1536,rogue,subtlety,103,46,57
42176,Mayhemghost,rexxar,1535,rogue,subtlety,72,40,32
42177,Mitsurí,sargeras,1534,rogue,subtlety,24,16,8
42178,Fela,crushridge,1534,rogue,subtlety,148,75,73
42179,Eviscerator,moon-guard,1532,rogue,subtlety,107,48,59
42180,Wansuiye,tichondrius,1528,rogue,subtlety,24,16,8
42181,Rhythmic,ysera,1526,rogue,subtlety,24,16,8
42182,Qq,doomhammer,1526,rogue,subtlety,36,18,18
42183,Axerax,draka,1525,rogue,subtlety,48,24,24
42184,ßeep,windrunner,1525,rogue,subtlety,48,24,24
42185,Corde,hyjal,1523,rogue,subtlety,32,20,12
42186,Dissociated,stormrage,1523,rogue,subtlety,47,17,30
42187,Worrglaive,dalaran,1517,rogue,subtlety,170,91,79
42188,Plado,tichondrius,1517,rogue,subtlety,83,44,39
42189,Whispx,malganis,1517,rogue,subtlety,36,18,18
42190,Lilshanker,tichondrius,1516,rogue,subtlety,62,30,32
42191,Taliwis,burning-blade,1516,rogue,subtlety,36,17,19
42192,Feinting,moon-guard,1514,rogue,subtlety,24,16,8
42193,Killmebaby,lightnings-blade,1514,rogue,subtlety,54,29,25
42194,Usernameqtxo,kelthuzad,1514,rogue,subtlety,135,68,67
42195,Broddz,sargeras,1512,rogue,subtlety,54,30,24
42196,Bugser,tichondrius,1511,rogue,subtlety,96,52,44
42197,Greasybbsea,illidan,1511,rogue,subtlety,126,63,63
42198,Laaggul,tichondrius,1509,rogue,subtlety,24,16,8
42199,Morriz,tichondrius,1505,rogue,subtlety,84,52,32
42200,Brangs,ragnaros,1505,rogue,subtlety,48,27,21
42201,Wongski,darkspear,1503,rogue,subtlety,34,23,11
42202,Illmatíc,kelthuzad,1502,rogue,subtlety,29,16,13
42203,Cerut,illidan,1499,rogue,subtlety,52,27,25
42204,Galaxybrain,icecrown,1498,rogue,subtlety,120,76,44
42205,Huskyi,dalaran,1498,rogue,subtlety,60,30,30
42206,Nargonis,illidan,1497,rogue,subtlety,38,23,15
42207,Eridian,tichondrius,1495,rogue,subtlety,115,58,57
42208,Errorless,moon-guard,1494,rogue,subtlety,66,34,32
42209,Nítzy,quelthalas,1493,rogue,subtlety,54,26,28
42210,Sit,frostwolf,1492,rogue,subtlety,70,39,31
42211,Linkzq,frostmourne,1492,rogue,subtlety,41,17,24
42212,Slap,icecrown,1491,rogue,subtlety,42,17,25
42213,Delphyax,azralon,1489,rogue,subtlety,30,16,14
42214,Pngöd,area-52,1488,rogue,subtlety,29,19,10
42215,Aghanaar,burning-legion,1488,rogue,subtlety,56,27,29
42216,Luradfate,dalaran,1486,rogue,subtlety,275,143,132
42217,Greasymarheo,area-52,1486,rogue,subtlety,66,32,34
42218,Swanl,stormrage,1483,rogue,subtlety,71,39,32
42219,Saraelith,moon-guard,1480,rogue,subtlety,51,29,22
42220,Pichichi,frostmourne,1479,rogue,subtlety,69,41,28
42221,Jinglez,frostmourne,1478,rogue,subtlety,36,22,14
42222,Kidneyisntop,illidan,1478,rogue,subtlety,30,16,14
42223,Speedboi,skullcrusher,1477,rogue,subtlety,134,80,54
42224,Mosedz,tichondrius,1474,rogue,subtlety,48,28,20
42225,Woollord,frostmourne,1474,rogue,subtlety,48,28,20
42226,Roguechamp,aggramar,1471,rogue,subtlety,41,20,21
42227,Pince,black-dragonflight,1470,rogue,subtlety,39,22,17
42228,Morpheûs,tichondrius,1470,rogue,subtlety,52,27,25
42229,Ctrlfreak,hellscream,1468,rogue,subtlety,96,55,41
42230,Swiftdeaths,queldorei,1468,rogue,subtlety,74,37,37
42231,Kaliasteddin,area-52,1467,rogue,subtlety,80,40,40
42232,Tulis,frostmourne,1462,rogue,subtlety,164,96,68
42233,Hotcarl,kiljaeden,1462,rogue,subtlety,46,26,20
42234,Oldgate,azralon,1462,rogue,subtlety,41,23,18
42235,Xandroesh,darkspear,1461,rogue,subtlety,54,31,23
42236,Stankyx,bleeding-hollow,1460,rogue,subtlety,66,37,29
42237,Vigílant,proudmoore,1460,rogue,subtlety,84,41,43
42238,Toxsith,tichondrius,1459,rogue,subtlety,74,43,31
42239,Scenna,stormrage,1457,rogue,subtlety,78,33,45
42240,Axiy,stormrage,1455,rogue,subtlety,65,35,30
42241,Rigotak,illidan,1453,rogue,subtlety,106,54,52
42242,Twotimed,magtheridon,1452,rogue,subtlety,48,27,21
42243,Vyll,stormrage,1452,rogue,subtlety,31,16,15
42244,Krolczz,tichondrius,1449,rogue,subtlety,76,46,30
42245,Murked,barthilas,1449,rogue,subtlety,54,31,23
42246,Trucidovaco,daggerspine,1449,rogue,subtlety,88,40,48
42247,Zernaz,thrall,1448,rogue,subtlety,66,33,33
42248,ßecomeðeath,tichondrius,1446,rogue,subtlety,47,24,23
42249,Welinth,thunderlord,1445,rogue,subtlety,60,28,32
42250,Géminis,sargeras,1444,rogue,subtlety,30,17,13
42251,Kainm,stormrage,1443,rogue,subtlety,272,139,133
42252,Rougething,bleeding-hollow,1443,rogue,subtlety,72,35,37
42253,Lagault,muradin,1442,rogue,subtlety,108,64,44
42254,Bloodylegend,altar-of-storms,1442,rogue,subtlety,36,21,15
42255,Saintt,khaz-modan,1439,rogue,subtlety,36,24,12
42256,Dismayx,tichondrius,1438,rogue,subtlety,42,21,21
42257,Kents,tichondrius,1438,rogue,subtlety,36,15,21
42258,Calebrogue,illidan,1436,rogue,subtlety,24,15,9
42259,Ricros,bleeding-hollow,1435,rogue,subtlety,43,20,23
42260,Smormu,bonechewer,1432,rogue,subtlety,36,17,19
42261,Epipenqt,dark-iron,1431,rogue,subtlety,42,26,16
42262,Hunchó,area-52,1431,rogue,subtlety,77,44,33
42263,Abacura,moon-guard,1431,rogue,subtlety,124,69,55
42264,Chãlons,tichondrius,1431,rogue,subtlety,84,42,42
42265,Deadguys,tichondrius,1430,rogue,subtlety,72,37,35
42266,Weenies,illidan,1425,rogue,subtlety,53,27,26
42267,Superharry,tichondrius,1423,rogue,subtlety,72,38,34
42268,Neilyo,barthilas,1423,rogue,subtlety,101,51,50
42269,Kibbs,korgath,1422,rogue,subtlety,60,30,30
42270,Xleo,drakkari,1422,rogue,subtlety,185,91,94
42271,Smolblade,nordrassil,1422,rogue,subtlety,35,17,18
42272,Humphugull,skullcrusher,1422,rogue,subtlety,47,18,29
42273,Ironfistofcn,tichondrius,1421,rogue,subtlety,72,40,32
42274,Pressuret,frostmourne,1420,rogue,subtlety,41,23,18
42275,Zefeckz,tichondrius,1420,rogue,subtlety,59,29,30
42276,Tolthe,hyjal,1418,rogue,subtlety,80,40,40
42277,Fulkrem,wyrmrest-accord,1410,rogue,subtlety,74,34,40
42278,Notty,kelthuzad,1408,rogue,subtlety,77,43,34
42279,Cv,proudmoore,1404,rogue,subtlety,42,23,19
42280,Pleodonis,tichondrius,1402,rogue,subtlety,77,39,38
42281,Quinity,wyrmrest-accord,1401,rogue,subtlety,186,94,92
42282,Klâng,tichondrius,1399,rogue,subtlety,148,72,76
42283,Arakine,uldaman,1398,rogue,subtlety,38,27,11
42284,Bakedpotato,garithos,1398,rogue,subtlety,66,33,33
42285,Hickery,frostmourne,1396,rogue,subtlety,36,21,15
42286,Sparqxx,tichondrius,1396,rogue,subtlety,45,26,19
42287,Fkrueger,thrall,1396,rogue,subtlety,63,33,30
42288,Hakuchi,tichondrius,1396,rogue,subtlety,31,15,16
42289,Seaki,illidan,1395,rogue,subtlety,23,15,8
42290,Lilplato,area-52,1395,rogue,subtlety,24,15,9
42291,Pãx,stormrage,1395,rogue,subtlety,24,15,9
42292,Yanh,tichondrius,1395,rogue,subtlety,36,16,20
42293,Harlyfknquin,jubeithos,1394,rogue,subtlety,100,55,45
42294,Ziyanbaby,thunderlord,1392,rogue,subtlety,24,15,9
42295,Darkìs,tichondrius,1390,rogue,subtlety,36,19,17
42296,Fofree,hyjal,1389,rogue,subtlety,76,41,35
42297,Odelöt,drakkari,1387,rogue,subtlety,108,59,49
42298,Loquen,ragnaros,1387,rogue,subtlety,66,36,30
42299,Neuschurke,warsong,1386,rogue,subtlety,42,23,19
42300,Sgtbuttfat,dalaran,1385,rogue,subtlety,41,20,21
42301,Tapwaterx,illidan,1385,rogue,subtlety,78,33,45
42302,Najohn,tichondrius,1384,rogue,subtlety,42,20,22
42303,Secrettecbot,barthilas,1383,rogue,subtlety,36,20,16
42304,Nooz,thrall,1382,rogue,subtlety,107,62,45
42305,Lyfallah,proudmoore,1381,rogue,subtlety,136,75,61
42306,Shaoriel,zuljin,1380,rogue,subtlety,24,15,9
42307,Søprøle,ragnaros,1380,rogue,subtlety,98,57,41
42308,Vanvanlords,azralon,1379,rogue,subtlety,78,34,44
42309,Pikabuu,bleeding-hollow,1377,rogue,subtlety,75,32,43
42310,Orîon,scilla,1376,rogue,subtlety,36,20,16
42311,Termkilledu,moon-guard,1375,rogue,subtlety,132,74,58
42312,Gloòm,stormrage,1373,rogue,subtlety,24,16,8
42313,Ojibwe,tichondrius,1373,rogue,subtlety,28,15,13
42314,Kolander,tichondrius,1373,rogue,subtlety,58,29,29
42315,Gøblìn,tichondrius,1373,rogue,subtlety,126,52,74
42316,Stanley,mugthol,1371,rogue,subtlety,39,23,16
42317,Goatforsale,tichondrius,1371,rogue,subtlety,28,16,12
42318,Suhwooh,area-52,1366,rogue,subtlety,67,37,30
42319,Stêf,zuljin,1365,rogue,subtlety,85,53,32
42320,Grinjuk,area-52,1365,rogue,subtlety,29,16,13
42321,Jadier,emerald-dream,1361,rogue,subtlety,47,24,23
42322,Sapyalater,thrall,1361,rogue,subtlety,192,98,94
42323,Jujudaddy,sargeras,1360,rogue,subtlety,42,23,19
42324,Emrogr,tichondrius,1360,rogue,subtlety,81,44,37
42325,Guiguzidr,illidan,1359,rogue,subtlety,124,69,55
42326,Raymga,tichondrius,1355,rogue,subtlety,48,29,19
42327,Denoms,area-52,1351,rogue,subtlety,54,23,31
42328,Hahaurblind,perenolde,1347,rogue,subtlety,62,31,31
42329,Narcoleptic,dalaran,1346,rogue,subtlety,84,40,44
42330,Clayton,frostmourne,1344,rogue,subtlety,49,24,25
42331,Leftyleaf,proudmoore,1343,rogue,subtlety,24,15,9
42332,Sketchyweas,sargeras,1342,rogue,subtlety,44,17,27
42333,Corrier,tichondrius,1340,rogue,subtlety,24,14,10
42334,Tiladar,tichondrius,1339,rogue,subtlety,24,14,10
42335,Adept,whisperwind,1338,rogue,subtlety,24,14,10
42336,Notxerian,stormrage,1338,rogue,subtlety,24,14,10
42337,Spacebase,illidan,1337,rogue,subtlety,24,14,10
42338,Eazyg,tichondrius,1336,rogue,subtlety,24,14,10
42339,Nines,icecrown,1336,rogue,subtlety,30,14,16
42340,Brendantko,arthas,1334,rogue,subtlety,30,14,16
42341,Genève,dreadmaul,1327,rogue,subtlety,24,14,10
42342,Frèyjä,bleeding-hollow,1327,rogue,subtlety,152,81,71
42343,Pegglerogue,fizzcrank,1326,rogue,subtlety,184,90,94
42344,Hollowshade,hydraxis,1323,rogue,subtlety,30,16,14
42345,Dustt,stormrage,1322,rogue,subtlety,30,21,9
42346,Luolan,kargath,1322,rogue,subtlety,30,15,15
42347,Sahima,tichondrius,1320,rogue,subtlety,210,111,99
42348,Gankolicious,nerzhul,1317,rogue,subtlety,18,14,4
42349,Sinnister,queldorei,1317,rogue,subtlety,24,18,6
42350,Kahlx,azralon,1317,rogue,subtlety,90,42,48
42351,Täy,thrall,1316,rogue,subtlety,89,45,44
42352,Tamsy,the-forgotten-coast,1315,rogue,subtlety,21,15,6
42353,Lozion,malganis,1315,rogue,subtlety,42,17,25
42354,Pgo,tichondrius,1314,rogue,subtlety,24,16,8
42355,Shilaya,dreadmaul,1311,rogue,subtlety,36,14,22
42356,Leprocy,tichondrius,1309,rogue,subtlety,22,15,7
42357,Riggz,burning-blade,1308,rogue,subtlety,68,35,33
42358,Thugspice,stormrage,1308,rogue,subtlety,59,30,29
42359,Faxingberlin,skullcrusher,1306,rogue,subtlety,36,15,21
42360,Lisnp,tichondrius,1304,rogue,subtlety,206,98,108
42361,Khorgan,mugthol,1301,rogue,subtlety,36,18,18
42362,Învîsîßull,illidan,1301,rogue,subtlety,34,14,20
42363,Sabedoria,barthilas,1300,rogue,subtlety,96,49,47
42364,Pocketman,barthilas,1299,rogue,subtlety,59,24,35
42365,Autumnsedge,area-52,1299,rogue,subtlety,48,18,30
42366,Bríng,illidan,1298,rogue,subtlety,47,29,18
42367,Eraticrogue,illidan,1298,rogue,subtlety,35,15,20
42368,Flockavelli,zuljin,1296,rogue,subtlety,79,39,40
42369,Vuye,moon-guard,1292,rogue,subtlety,53,21,32
42370,Vaith,wyrmrest-accord,1291,rogue,subtlety,78,33,45
42371,Turec,illidan,1290,rogue,subtlety,29,14,15
42372,Eryx,mugthol,1289,rogue,subtlety,30,19,11
42373,Orangez,malfurion,1289,rogue,subtlety,36,21,15
42374,Insanctus,malganis,1287,rogue,subtlety,23,14,9
42375,Vellkann,azralon,1284,rogue,subtlety,30,21,9
42376,Oatmealcrisp,thrall,1284,rogue,subtlety,36,21,15
42377,Oilyrock,tichondrius,1284,rogue,subtlety,78,44,34
42378,Lefteex,tichondrius,1282,rogue,subtlety,80,43,37
42379,Liryth,lightninghoof,1281,rogue,subtlety,51,29,22
42380,Ikmagine,icecrown,1281,rogue,subtlety,42,17,25
42381,Shellby,tichondrius,1277,rogue,subtlety,92,49,43
42382,Macsap,frostmourne,1277,rogue,subtlety,66,35,31
42383,Sapùwú,stormrage,1277,rogue,subtlety,112,56,56
42384,Hmmkek,frostmourne,1276,rogue,subtlety,23,14,9
42385,Lagula,ragnaros,1274,rogue,subtlety,23,17,6
42386,Ikerz,tichondrius,1272,rogue,subtlety,27,14,13
42387,Shigoo,sargeras,1271,rogue,subtlety,35,15,20
42388,Rezy,lightbringer,1270,rogue,subtlety,41,14,27
42389,Taroo,ragnaros,1268,rogue,subtlety,30,17,13
42390,Dionavelynn,area-52,1267,rogue,subtlety,42,19,23
42391,Pargo,quelthalas,1266,rogue,subtlety,67,30,37
42392,Hollfex,nemesis,1265,rogue,subtlety,44,22,22
42393,Ballflicker,malganis,1264,rogue,subtlety,42,17,25
42394,Hiarolson,stormrage,1263,rogue,subtlety,39,20,19
42395,Kawagreen,tichondrius,1260,rogue,subtlety,51,27,24
42396,Gothblade,malganis,1258,rogue,subtlety,30,15,15
42397,Xoltin,tichondrius,1258,rogue,subtlety,80,36,44
42398,Vap,azralon,1254,rogue,subtlety,36,15,21
42399,Mcromance,khadgar,1253,rogue,subtlety,57,25,32
42400,Glíz,bloodscalp,1250,rogue,subtlety,54,28,26
42401,Mendiant,azralon,1250,rogue,subtlety,125,63,62
42402,Arbitér,moonrunner,1250,rogue,subtlety,64,25,39
42403,Lilstab,hakkar,1249,rogue,subtlety,116,58,58
42404,Tmpikaboo,tichondrius,1248,rogue,subtlety,18,13,5
42405,Kalamarii,stormrage,1246,rogue,subtlety,53,21,32
42406,Seshtime,tichondrius,1245,rogue,subtlety,18,13,5
42407,Mirajoo,tichondrius,1245,rogue,subtlety,88,42,46
42408,Mylovejunex,tichondrius,1244,rogue,subtlety,18,13,5
42409,Harkknight,sargeras,1244,rogue,subtlety,237,129,108
42410,Bloodraina,hyjal,1244,rogue,subtlety,151,72,79
42411,Endlesswaltz,zuljin,1243,rogue,subtlety,30,13,17
42412,Towncar,kelthuzad,1242,rogue,subtlety,24,13,11
42413,Moonvertz,barthilas,1242,rogue,subtlety,24,13,11
42414,Quickxsilver,tichondrius,1240,rogue,subtlety,72,33,39
42415,Vlone,icecrown,1240,rogue,subtlety,30,13,17
42416,Aleh,exodar,1239,rogue,subtlety,24,13,11
42417,Yurkarogue,tichondrius,1238,rogue,subtlety,18,13,5
42418,Miraclesap,stormrage,1238,rogue,subtlety,130,76,54
42419,Stealthkid,tichondrius,1237,rogue,subtlety,24,13,11
42420,Hawwtkunnk,emerald-dream,1237,rogue,subtlety,24,13,11
42421,Mistnazgul,quelthalas,1236,rogue,subtlety,94,53,41
42422,Variat,azralon,1235,rogue,subtlety,54,25,29
42423,Rykojin,dalaran,1234,rogue,subtlety,48,28,20
42424,Pinksleep,sargeras,1234,rogue,subtlety,54,22,32
42425,Oddblade,stormrage,1232,rogue,subtlety,24,14,10
42426,Poolover,barthilas,1232,rogue,subtlety,24,13,11
42427,Kilerhid,quelthalas,1231,rogue,subtlety,42,14,28
42428,Noxik,blackrock,1229,rogue,subtlety,105,54,51
42429,Johnnymayhem,kelthuzad,1227,rogue,subtlety,30,13,17
42430,Dèàdly,korgath,1225,rogue,subtlety,24,13,11
42431,Lapuamagnum,illidan,1225,rogue,subtlety,30,13,17
42432,Draculà,wyrmrest-accord,1224,rogue,subtlety,93,50,43
42433,Hattrìck,area-52,1224,rogue,subtlety,56,28,28
42434,Draef,illidan,1223,rogue,subtlety,24,13,11
42435,Vangroen,quelthalas,1220,rogue,subtlety,36,23,13
42436,Drsinz,tichondrius,1217,rogue,subtlety,67,28,39
42437,Hypermix,tichondrius,1216,rogue,subtlety,48,20,28
42438,Trâshy,stormrage,1215,rogue,subtlety,25,14,11
42439,Riezzoo,malfurion,1214,rogue,subtlety,36,19,17
42440,Boredomkills,frostmane,1213,rogue,subtlety,24,13,11
42441,Sxs,kiljaeden,1213,rogue,subtlety,47,25,22
42442,Yellowdeep,tichondrius,1212,rogue,subtlety,20,14,6
42443,Suñg,tichondrius,1211,rogue,subtlety,30,14,16
42444,Dessenia,illidan,1208,rogue,subtlety,79,47,32
42445,Felistrien,wyrmrest-accord,1207,rogue,subtlety,36,13,23
42446,Gougemebaby,emerald-dream,1202,rogue,subtlety,36,15,21
42447,Vonyx,area-52,1196,rogue,subtlety,36,16,20
42448,Kylerxius,korgath,1192,rogue,subtlety,36,21,15
42449,Abatoire,wyrmrest-accord,1188,rogue,subtlety,51,25,26
42450,Demìurge,tichondrius,1188,rogue,subtlety,27,13,14
42451,Noriel,dathremar,1187,rogue,subtlety,42,21,21
42452,Geeo,emerald-dream,1187,rogue,subtlety,42,17,25
42453,Elmabrox,quelthalas,1183,rogue,subtlety,45,20,25
42454,Roxeni,tichondrius,1181,rogue,subtlety,28,13,15
42455,Tigbits,frostmourne,1181,rogue,subtlety,32,14,18
42456,Gatõ,quelthalas,1181,rogue,subtlety,60,24,36
42457,Cheapdeal,frostmourne,1178,rogue,subtlety,28,13,15
42458,Meer,balnazzar,1177,rogue,subtlety,40,29,11
42459,Maløkeirø,stormrage,1177,rogue,subtlety,79,34,45
42460,Winze,scilla,1176,rogue,subtlety,66,39,27
42461,Esker,dragonmaw,1172,rogue,subtlety,138,70,68
42462,Studders,kiljaeden,1172,rogue,subtlety,65,29,36
42463,Writhes,sargeras,1169,rogue,subtlety,20,13,7
42464,Wokemeup,bleeding-hollow,1168,rogue,subtlety,30,15,15
42465,Ambushr,tichondrius,1161,rogue,subtlety,30,16,14
42466,Gyrfalcon,spirestone,1156,rogue,subtlety,154,72,82
42467,Paulpitation,blood-furnace,1155,rogue,subtlety,39,15,24
42468,Håkünämãtåtä,stormrage,1152,rogue,subtlety,18,12,6
42469,Bèstworld,dalaran,1152,rogue,subtlety,24,12,12
42470,Abssall,tichondrius,1151,rogue,subtlety,18,12,6
42471,Gladlol,stormrage,1151,rogue,subtlety,24,12,12
42472,Allirra,ragnaros,1150,rogue,subtlety,48,32,16
42473,Ppdx,malganis,1150,rogue,subtlety,18,12,6
42474,Alrynik,stormrage,1150,rogue,subtlety,24,14,10
42475,Chakal,illidan,1148,rogue,subtlety,18,12,6
42476,Horyx,zuljin,1148,rogue,subtlety,24,12,12
42477,Itskanashi,frostmourne,1148,rogue,subtlety,81,36,45
42478,Drapezz,kelthuzad,1147,rogue,subtlety,59,32,27
42479,Dawkx,thrall,1147,rogue,subtlety,25,13,12
42480,Psÿchð,azralon,1147,rogue,subtlety,24,12,12
42481,Jalaroot,frostmourne,1146,rogue,subtlety,29,16,13
42482,Spèèd,proudmoore,1146,rogue,subtlety,24,12,12
42483,Dezly,tichondrius,1146,rogue,subtlety,42,12,30
42484,Abogansterr,ragnaros,1144,rogue,subtlety,164,84,80
42485,Wowtheskill,illidan,1144,rogue,subtlety,24,12,12
42486,Jirokun,illidan,1144,rogue,subtlety,24,12,12
42487,Kaminokage,barthilas,1144,rogue,subtlety,45,15,30
42488,Yesuz,illidan,1143,rogue,subtlety,34,19,15
42489,Oilydaimon,tichondrius,1143,rogue,subtlety,61,29,32
42490,Hattorikun,proudmoore,1142,rogue,subtlety,24,12,12
42491,Poohpants,frostmourne,1140,rogue,subtlety,81,38,43
42492,Smokepipe,nerzhul,1139,rogue,subtlety,24,14,10
42493,Pro,burning-legion,1138,rogue,subtlety,30,14,16
42494,Abdullahh,tichondrius,1137,rogue,subtlety,24,13,11
42495,Arÿaa,azralon,1136,rogue,subtlety,54,25,29
42496,Smashol,barthilas,1136,rogue,subtlety,54,23,31
42497,Salätzar,quelthalas,1135,rogue,subtlety,27,13,14
42498,Gank,jubeithos,1134,rogue,subtlety,24,12,12
42499,Zarkans,proudmoore,1133,rogue,subtlety,84,42,42
42500,Betrayerz,darkspear,1132,rogue,subtlety,33,17,16
42501,Micromoon,windrunner,1131,rogue,subtlety,36,13,23
42502,Sícarii,emerald-dream,1130,rogue,subtlety,18,12,6
42503,Ninjadoo,tichondrius,1128,rogue,subtlety,18,12,6
42504,Darkdevilx,tichondrius,1126,rogue,subtlety,36,12,24
42505,Vanishman,ragnaros,1125,rogue,subtlety,30,15,15
42506,Doklim,spinebreaker,1122,rogue,subtlety,74,42,32
42507,Dtelkham,tichondrius,1122,rogue,subtlety,33,13,20
42508,Cutthroat,aegwynn,1121,rogue,subtlety,45,20,25
42509,Sildin,sargeras,1116,rogue,subtlety,36,16,20
42510,Jhors,tichondrius,1114,rogue,subtlety,24,12,12
42511,Jeri,gundrak,1113,rogue,subtlety,30,17,13
42512,Witherblade,area-52,1110,rogue,subtlety,18,12,6
42513,Kelelor,kelthuzad,1108,rogue,subtlety,57,18,39
42514,Venace,agamaggan,1104,rogue,subtlety,23,12,11
42515,Misthios,chogall,1101,rogue,subtlety,29,12,17
42516,Hayatö,ragnaros,1098,rogue,subtlety,54,30,24
42517,Dyane,gilneas,1097,rogue,subtlety,48,21,27
42518,Iheyji,quelthalas,1094,rogue,subtlety,24,14,10
42519,Aynrand,drakkari,1094,rogue,subtlety,45,16,29
42520,Prisonshank,arthas,1093,rogue,subtlety,61,36,25
42521,Shadownibba,illidan,1091,rogue,subtlety,48,26,22
42522,Fangskin,dunemaul,1090,rogue,subtlety,36,19,17
42523,Favès,thrall,1087,rogue,subtlety,60,19,41
42524,Xzert,frostmourne,1085,rogue,subtlety,30,12,18
42525,Jaanmonty,frostmourne,1081,rogue,subtlety,24,12,12
42526,Zwielicht,quelthalas,1081,rogue,subtlety,30,14,16
42527,Lesliechow,sargeras,1080,rogue,subtlety,70,41,29
42528,Indivisible,thunderlord,1080,rogue,subtlety,60,30,30
42529,Stelarstop,drakkari,1080,rogue,subtlety,48,16,32
42530,Riskgo,frostwolf,1071,rogue,subtlety,24,12,12
42531,Imgunnacrumb,malganis,1070,rogue,subtlety,179,85,94
42532,Sixcombopts,area-52,1056,rogue,subtlety,18,11,7
42533,Elwynë,tichondrius,1054,rogue,subtlety,24,11,13
42534,Toestumper,sargeras,1054,rogue,subtlety,41,15,26
42535,Avizura,dragonmaw,1053,rogue,subtlety,18,11,7
42536,Rabe,nagrand,1053,rogue,subtlety,24,11,13
42537,Exacerbatê,mannoroth,1052,rogue,subtlety,18,11,7
42538,Ninetaildfox,arthas,1051,rogue,subtlety,18,11,7
42539,Brilliance,skywall,1051,rogue,subtlety,24,11,13
42540,Xvds,tichondrius,1051,rogue,subtlety,24,11,13
42541,Boonee,frostmourne,1051,rogue,subtlety,24,11,13
42542,Roguish,kiljaeden,1051,rogue,subtlety,38,14,24
42543,Distract,quelthalas,1050,rogue,subtlety,18,11,7
42544,Corntens,area-52,1050,rogue,subtlety,20,11,9
42545,Omgmoon,ragnaros,1048,rogue,subtlety,12,11,1
42546,Liquidmojo,tichondrius,1048,rogue,subtlety,18,11,7
42547,Négrá,ragnaros,1048,rogue,subtlety,18,11,7
42548,Nadari,cenarius,1048,rogue,subtlety,66,31,35
42549,Ðarkrøøxs,stormrage,1048,rogue,subtlety,24,11,13
42550,Trolladrão,goldrinn,1048,rogue,subtlety,24,11,13
42551,Mermm,burning-blade,1048,rogue,subtlety,24,11,13
42552,Waytoosext,tichondrius,1048,rogue,subtlety,24,11,13
42553,Weckful,kelthuzad,1047,rogue,subtlety,18,11,7
42554,Sneaknfizzle,dethecus,1047,rogue,subtlety,30,15,15
42555,Santyno,ragnaros,1047,rogue,subtlety,120,56,64
42556,Kilrogga,azshara,1046,rogue,subtlety,42,23,19
42557,Laotrec,nemesis,1045,rogue,subtlety,33,12,21
42558,Ivanapavlov,kelthuzad,1045,rogue,subtlety,41,14,27
42559,Srmazakre,ragnaros,1044,rogue,subtlety,30,12,18
42560,Olg,arathor,1043,rogue,subtlety,71,36,35
42561,Hyperdexia,stormrage,1042,rogue,subtlety,88,47,41
42562,Prõdigy,blackrock,1041,rogue,subtlety,20,13,7
42563,Lyliym,frostmourne,1041,rogue,subtlety,18,11,7
42564,Chancelör,illidan,1040,rogue,subtlety,18,11,7
42565,Soulvex,barthilas,1040,rogue,subtlety,18,11,7
42566,Nihue,terenas,1040,rogue,subtlety,30,11,19
42567,Glatzkaus,shattered-hand,1039,rogue,subtlety,24,11,13
42568,Yunaka,grizzly-hills,1039,rogue,subtlety,54,18,36
42569,Abaløne,tichondrius,1037,rogue,subtlety,55,22,33
42570,Siniel,scarlet-crusade,1035,rogue,subtlety,27,12,15
42571,Rarkalth,azralon,1033,rogue,subtlety,53,18,35
42572,Relidria,thrall,1032,rogue,subtlety,36,22,14
42573,Kachimodo,illidan,1029,rogue,subtlety,48,23,25
42574,Drpepzi,tichondrius,1025,rogue,subtlety,75,27,48
42575,Relaxsingh,tichondrius,1022,rogue,subtlety,84,33,51
42576,Topapple,mugthol,1021,rogue,subtlety,30,14,16
42577,Ayo,exodar,1019,rogue,subtlety,24,12,12
42578,Maewyn,aerie-peak,1019,rogue,subtlety,25,11,14
42579,Sneakyshots,emerald-dream,1017,rogue,subtlety,13,11,2
42580,Emøtions,darkspear,1016,rogue,subtlety,18,11,7
42581,Slackness,bleeding-hollow,1015,rogue,subtlety,61,35,26
42582,Fateapocryph,azralon,1014,rogue,subtlety,26,13,13
42583,Skallywagg,emerald-dream,1014,rogue,subtlety,63,31,32
42584,Bimbogirl,dalaran,1011,rogue,subtlety,52,29,23
42585,Topsailor,uther,1011,rogue,subtlety,36,16,20
42586,Korviz,area-52,1008,rogue,subtlety,60,30,30
42587,Bloodwish,tichondrius,1007,rogue,subtlety,23,11,12
42588,Lesty,kelthuzad,1006,rogue,subtlety,17,11,6
42589,Ghost,shattered-halls,1006,rogue,subtlety,68,27,41
42590,Log,blackhand,1004,rogue,subtlety,36,18,18
42591,Onara,quelthalas,1003,rogue,subtlety,30,18,12
42592,Kidcudi,bonechewer,1000,rogue,subtlety,48,18,30
42593,Mcghanhain,aegwynn,999,rogue,subtlety,48,21,27
42594,Silentmoralz,tichondrius,996,rogue,subtlety,47,15,32
42595,Feragho,tichondrius,992,rogue,subtlety,34,11,23
42596,Sadtears,thrall,990,rogue,subtlety,16,11,5
42597,Cutx,frostmourne,984,rogue,subtlety,22,11,11
42598,Bubblesr,whisperwind,980,rogue,subtlety,48,22,26
42599,Toe,boulderfist,964,rogue,subtlety,51,25,26
42600,Ascherx,veknilash,960,rogue,subtlety,12,10,2
42601,Geckø,sargeras,959,rogue,subtlety,12,10,2
42602,Geartrix,darkspear,959,rogue,subtlety,16,11,5
42603,Catatonic,moon-guard,959,rogue,subtlety,18,10,8
42604,Alts,tichondrius,959,rogue,subtlety,18,10,8
42605,Spaca,kelthuzad,959,rogue,subtlety,18,10,8
42606,Clerncc,emerald-dream,959,rogue,subtlety,18,10,8
42607,Nightthug,tichondrius,959,rogue,subtlety,24,10,14
42608,Caldø,tichondrius,958,rogue,subtlety,12,10,2
42609,Sapnfappqt,dalaran,958,rogue,subtlety,15,10,5
42610,Lucki,tichondrius,958,rogue,subtlety,18,10,8
42611,Gardianstep,stormrage,958,rogue,subtlety,18,10,8
42612,Fystrong,kelthuzad,958,rogue,subtlety,18,10,8
42613,Jannie,rexxar,958,rogue,subtlety,18,10,8
42614,Aszombie,tichondrius,957,rogue,subtlety,12,10,2
42615,Kløud,uther,957,rogue,subtlety,18,10,8
42616,Stuntedscamp,bleeding-hollow,957,rogue,subtlety,24,10,14
42617,Rooke,draktharon,957,rogue,subtlety,24,10,14
42618,Reclusivexo,tichondrius,956,rogue,subtlety,24,10,14
42619,Merkules,dalaran,955,rogue,subtlety,16,11,5
42620,Orteker,tichondrius,955,rogue,subtlety,18,10,8
42621,Atulano,wyrmrest-accord,955,rogue,subtlety,24,10,14
42622,Înfêrnô,emerald-dream,955,rogue,subtlety,24,10,14
42623,Flavored,bloodhoof,955,rogue,subtlety,24,10,14
42624,Poogodx,proudmoore,954,rogue,subtlety,12,10,2
42625,Keepitshadow,frostmourne,953,rogue,subtlety,18,10,8
42626,Moufwash,sargeras,952,rogue,subtlety,24,10,14
42627,Crucifur,anvilmar,952,rogue,subtlety,24,10,14
42628,Terpsaucey,tichondrius,952,rogue,subtlety,24,10,14
42629,Wolfsfang,frostmourne,951,rogue,subtlety,19,10,9
42630,Uchihaputin,tichondrius,951,rogue,subtlety,24,10,14
42631,Undreas,kiljaeden,950,rogue,subtlety,388,191,197
42632,Juanightstnd,bleeding-hollow,950,rogue,subtlety,24,10,14
42633,Burningfury,arthas,950,rogue,subtlety,24,10,14
42634,Arwy,stormrage,948,rogue,subtlety,19,11,8
42635,Wubbz,stormrage,947,rogue,subtlety,12,10,2
42636,Drspreader,area-52,946,rogue,subtlety,21,11,10
42637,Definitioni,area-52,945,rogue,subtlety,19,10,9
42638,Zelzaramor,ravenholdt,943,rogue,subtlety,30,10,20
42639,Suffêr,dalaran,942,rogue,subtlety,12,10,2
42640,Trinktick,doomhammer,931,rogue,subtlety,30,10,20
42641,Blindedu,dalaran,930,rogue,subtlety,24,10,14
42642,Zamji,tichondrius,928,rogue,subtlety,26,12,14
42643,Shadowspain,malganis,926,rogue,subtlety,24,10,14
42644,Timat,emerald-dream,924,rogue,subtlety,23,10,13
42645,Swayo,tichondrius,920,rogue,subtlety,18,10,8
42646,Beartøøth,stormrage,919,rogue,subtlety,18,10,8
42647,Rouzh,sargeras,910,rogue,subtlety,17,10,7
42648,Êxx,jubeithos,909,rogue,subtlety,17,10,7
42649,Deathben,tichondrius,908,rogue,subtlety,71,21,50
42650,Larmx,tichondrius,906,rogue,subtlety,15,12,3
42651,Spleen,aerie-peak,906,rogue,subtlety,21,10,11
42652,Cerel,baelgun,896,rogue,subtlety,48,13,35
42653,Ninjamf,bleeding-hollow,894,rogue,subtlety,14,10,4
42654,Mhün,malganis,891,rogue,subtlety,22,10,12
42655,Dagasombria,drakkari,890,rogue,subtlety,55,20,35
42656,Zenshin,tichondrius,889,rogue,subtlety,31,10,21
42657,Degrok,quelthalas,867,rogue,subtlety,59,28,31
42658,Nerfretnow,tichondrius,864,rogue,subtlety,12,9,3
42659,Scythix,firetree,864,rogue,subtlety,12,9,3
42660,Poonqtxo,frostmourne,864,rogue,subtlety,12,9,3
42661,Shadówl,tichondrius,864,rogue,subtlety,12,9,3
42662,Escapeartist,darkspear,864,rogue,subtlety,12,9,3
42663,Yodiegang,tichondrius,864,rogue,subtlety,12,9,3
42664,Chainsarogue,stormrage,864,rogue,subtlety,12,9,3
42665,Sitdownplz,darkspear,864,rogue,subtlety,15,10,5
42666,Sagatha,bleeding-hollow,863,rogue,subtlety,12,9,3
42667,Popss,whisperwind,863,rogue,subtlety,18,9,9
42668,Indiecompany,moon-guard,863,rogue,subtlety,18,9,9
42669,Wimpz,hyjal,863,rogue,subtlety,18,9,9
42670,Peacetou,kelthuzad,863,rogue,subtlety,18,9,9
42671,Lunatixz,emerald-dream,863,rogue,subtlety,18,9,9
42672,Revenantss,moon-guard,863,rogue,subtlety,18,9,9
42673,Uglysrogue,sargeras,863,rogue,subtlety,18,9,9
42674,Nemoye,tichondrius,863,rogue,subtlety,18,9,9
42675,Goopthicc,sargeras,863,rogue,subtlety,24,9,15
42676,Illoo,frostmourne,863,rogue,subtlety,24,9,15
42677,Jexy,barthilas,863,rogue,subtlety,24,9,15
42678,Proddivus,stormrage,863,rogue,subtlety,30,9,21
42679,Jamo,kiljaeden,862,rogue,subtlety,18,9,9
42680,Letsparty,malganis,862,rogue,subtlety,18,9,9
42681,Confianzudo,ragnaros,862,rogue,subtlety,54,24,30
42682,Oksanaastan,tichondrius,862,rogue,subtlety,30,9,21
42683,Cosmicò,trollbane,861,rogue,subtlety,12,9,3
42684,Blitzree,thrall,861,rogue,subtlety,12,9,3
42685,Filid,frostmourne,861,rogue,subtlety,18,9,9
42686,Donnice,area-52,861,rogue,subtlety,18,9,9
42687,Biggisdiggis,tichondrius,860,rogue,subtlety,12,9,3
42688,Lanres,stormrage,860,rogue,subtlety,12,9,3
42689,Raqed,eredar,860,rogue,subtlety,24,9,15
42690,Larceny,emerald-dream,860,rogue,subtlety,24,9,15
42691,Oío,ragnaros,859,rogue,subtlety,15,10,5
42692,Overzz,azralon,859,rogue,subtlety,21,9,12
42693,Aoki,tichondrius,859,rogue,subtlety,24,9,15
42694,Gannjalord,frostmane,858,rogue,subtlety,22,10,12
42695,Pumpp,dentarg,858,rogue,subtlety,24,9,15
42696,Bubblesrr,whisperwind,857,rogue,subtlety,32,9,23
42697,Calvin,moon-guard,856,rogue,subtlety,18,9,9
42698,Wrekstun,area-52,855,rogue,subtlety,24,9,15
42699,Drekha,tichondrius,854,rogue,subtlety,28,10,18
42700,Aitormenta,ragnaros,851,rogue,subtlety,12,9,3
42701,Dizzm,area-52,847,rogue,subtlety,12,9,3
42702,Shadowpunx,nemesis,846,rogue,subtlety,12,9,3
42703,Aelnoor,ragnaros,846,rogue,subtlety,24,9,15
42704,Caveil,stormrage,845,rogue,subtlety,17,9,8
42705,Cutindle,illidan,842,rogue,subtlety,18,9,9
42706,Brocolini,zuljin,841,rogue,subtlety,30,12,18
42707,Lemeeng,uldum,838,rogue,subtlety,30,12,18
42708,Elßronkas,quelthalas,836,rogue,subtlety,48,21,27
42709,Ýazim,tichondrius,832,rogue,subtlety,16,9,7
42710,Sorieg,azralon,831,rogue,subtlety,22,11,11
42711,Alexon,wyrmrest-accord,828,rogue,subtlety,84,35,49
42712,Sodomh,aegwynn,818,rogue,subtlety,48,21,27
42713,Eversincee,illidan,814,rogue,subtlety,15,9,6
42714,Gnomerogue,sargeras,811,rogue,subtlety,21,11,10
42715,Raylo,blackhand,807,rogue,subtlety,24,11,13
42716,Vandalyze,sargeras,805,rogue,subtlety,19,10,9
42717,Deathwishx,tichondrius,799,rogue,subtlety,16,9,7
42718,Zaghat,ragnaros,799,rogue,subtlety,22,9,13
42719,Mercaderps,frostmourne,798,rogue,subtlety,33,9,24
42720,Trillkage,tichondrius,797,rogue,subtlety,26,9,17
42721,Zelthy,frostmourne,790,rogue,subtlety,17,9,8
42722,Redtvco,blackrock,789,rogue,subtlety,17,9,8
42723,Samllnuts,area-52,789,rogue,subtlety,30,11,19
42724,Fearnomore,destromath,773,rogue,subtlety,84,29,55
42725,Austínrh,sargeras,768,rogue,subtlety,12,8,4
42726,Astutý,illidan,768,rogue,subtlety,12,8,4
42727,Evilthunder,illidan,768,rogue,subtlety,12,8,4
42728,Wîzz,bleeding-hollow,768,rogue,subtlety,12,8,4
42729,Nicørøbin,tichondrius,768,rogue,subtlety,12,8,4
42730,Czd,frostmourne,768,rogue,subtlety,12,8,4
42731,Khyrax,tichondrius,768,rogue,subtlety,12,8,4
42732,Cójáx,dalaran,768,rogue,subtlety,12,8,4
42733,Zeenxz,tichondrius,768,rogue,subtlety,12,8,4
42734,Commodore,arthas,768,rogue,subtlety,12,8,4
42735,Nuhiva,tichondrius,768,rogue,subtlety,15,9,6
42736,Köfy,quelthalas,768,rogue,subtlety,17,8,9
42737,Nlynn,veknilash,768,rogue,subtlety,18,8,10
42738,Wowcode,tichondrius,768,rogue,subtlety,18,8,10
42739,Bungou,tichondrius,768,rogue,subtlety,18,8,10
42740,Heegawn,proudmoore,768,rogue,subtlety,18,8,10
42741,Calxnnight,terenas,768,rogue,subtlety,18,8,10
42742,Getfkdkid,tichondrius,768,rogue,subtlety,24,8,16
42743,Swippz,tichondrius,768,rogue,subtlety,24,8,16
42744,Kiingspade,tichondrius,767,rogue,subtlety,12,8,4
42745,Gankbang,mugthol,767,rogue,subtlety,12,8,4
42746,Drunknclapz,bleeding-hollow,767,rogue,subtlety,12,8,4
42747,Assasinww,sargeras,767,rogue,subtlety,12,8,4
42748,Microcore,sargeras,767,rogue,subtlety,18,8,10
42749,Siyerogue,illidan,767,rogue,subtlety,18,8,10
42750,Candren,area-52,767,rogue,subtlety,18,8,10
42751,Antmang,bleeding-hollow,767,rogue,subtlety,18,8,10
42752,Ilesire,frostmourne,767,rogue,subtlety,18,8,10
42753,Chuckydoll,sargeras,767,rogue,subtlety,18,8,10
42754,Poisonstrike,khazgoroth,766,rogue,subtlety,12,8,4
42755,Zapstr,bleeding-hollow,766,rogue,subtlety,12,8,4
42756,Razmir,malfurion,766,rogue,subtlety,18,8,10
42757,Raidei,elune,766,rogue,subtlety,18,8,10
42758,Twinkrogue,firetree,766,rogue,subtlety,18,8,10
42759,Ntshaav,illidan,766,rogue,subtlety,18,8,10
42760,Kody,dalaran,765,rogue,subtlety,21,9,12
42761,Yato,mugthol,764,rogue,subtlety,12,8,4
42762,Subtlepuddle,bleeding-hollow,764,rogue,subtlety,24,8,16
42763,ßackshots,kelthuzad,763,rogue,subtlety,18,8,10
42764,Vexyz,tichondrius,763,rogue,subtlety,18,8,10
42765,Shadonas,maelstrom,763,rogue,subtlety,24,8,16
42766,Defaces,illidan,762,rogue,subtlety,12,8,4
42767,Wolfmans,trollbane,762,rogue,subtlety,12,8,4
42768,Shivlightnin,tichondrius,762,rogue,subtlety,24,8,16
42769,Píxíedúst,black-dragonflight,761,rogue,subtlety,24,8,16
42770,Swisha,dathremar,759,rogue,subtlety,18,8,10
42771,Mhasto,azralon,759,rogue,subtlety,18,8,10
42772,Sathrion,zuljin,758,rogue,subtlety,26,10,16
42773,Kerimoynihan,barthilas,757,rogue,subtlety,28,11,17
42774,Darthdad,bleeding-hollow,757,rogue,subtlety,30,8,22
42775,Nijanari,wyrmrest-accord,754,rogue,subtlety,24,8,16
42776,Screwzx,tichondrius,750,rogue,subtlety,17,8,9
42777,Nuff,emerald-dream,736,rogue,subtlety,16,8,8
42778,Stunjunky,area-52,733,rogue,subtlety,17,8,9
42779,Bladefang,quelthalas,732,rogue,subtlety,17,10,7
42780,Tyroshiv,area-52,732,rogue,subtlety,24,9,15
42781,Lilshortyaya,stormrage,719,rogue,subtlety,15,8,7
42782,Hellainuis,kelthuzad,719,rogue,subtlety,17,8,9
42783,Treeless,wyrmrest-accord,719,rogue,subtlety,25,9,16
42784,Reportlowdps,tichondrius,718,rogue,subtlety,11,8,3
42785,Foxolnite,illidan,718,rogue,subtlety,21,8,13
42786,Lerosi,malganis,718,rogue,subtlety,75,21,54
42787,Papiplunders,sargeras,687,rogue,subtlety,13,8,5
42788,Flaremagnet,whisperwind,672,rogue,subtlety,12,7,5
42789,Bledstepelin,frostmourne,672,rogue,subtlety,12,7,5
42790,Ustunned,stormrage,672,rogue,subtlety,12,7,5
42791,Adhd,ravencrest,672,rogue,subtlety,12,7,5
42792,Frooty,stormrage,672,rogue,subtlety,12,7,5
42793,Yangsol,stormrage,672,rogue,subtlety,12,7,5
42794,Àsgà,area-52,672,rogue,subtlety,12,7,5
42795,Orctheripper,garona,672,rogue,subtlety,12,7,5
42796,Syxs,sargeras,672,rogue,subtlety,12,7,5
42797,Bobbyflay,velen,672,rogue,subtlety,12,7,5
42798,Bobfoonk,tichondrius,672,rogue,subtlety,12,7,5
42799,Smang,mugthol,672,rogue,subtlety,12,7,5
42800,Bloodyhairy,area-52,672,rogue,subtlety,12,7,5
42801,Gertrix,darkspear,672,rogue,subtlety,12,7,5
42802,Spötty,stormrage,672,rogue,subtlety,12,7,5
42803,Coughsyrup,sargeras,672,rogue,subtlety,12,7,5
42804,Darkstár,bladefist,672,rogue,subtlety,12,7,5
42805,Joeyzord,stormrage,672,rogue,subtlety,12,7,5
42806,Voldir,cenarion-circle,672,rogue,subtlety,12,7,5
42807,Saraku,barthilas,672,rogue,subtlety,12,7,5
42808,Feyahni,wyrmrest-accord,672,rogue,subtlety,12,7,5
42809,Loria,cenarion-circle,672,rogue,subtlety,15,8,7
42810,Dycrons,lightbringer,672,rogue,subtlety,18,7,11
42811,Clicksbtns,area-52,672,rogue,subtlety,18,7,11
42812,Spytes,kiljaeden,672,rogue,subtlety,18,7,11
42813,Memoríst,frostmourne,672,rogue,subtlety,18,7,11
42814,Patey,malganis,672,rogue,subtlety,18,7,11
42815,Niwbor,azralon,672,rogue,subtlety,24,7,17
42816,Tekrul,area-52,672,rogue,subtlety,30,7,23
42817,Christiaan,area-52,671,rogue,subtlety,12,7,5
42818,Deadsilenth,daggerspine,671,rogue,subtlety,12,7,5
42819,Zetkx,tichondrius,671,rogue,subtlety,12,7,5
42820,Energetìc,stormrage,671,rogue,subtlety,12,7,5
42821,Shadowoog,tichondrius,671,rogue,subtlety,12,7,5
42822,Kidkillz,tichondrius,671,rogue,subtlety,12,7,5
42823,Xemnxnt,stormrage,671,rogue,subtlety,12,7,5
42824,Nezumikami,malganis,671,rogue,subtlety,18,7,11
42825,Sapzz,tichondrius,671,rogue,subtlety,18,7,11
42826,Xalsathoth,sargeras,671,rogue,subtlety,18,7,11
42827,Calimari,frostmourne,671,rogue,subtlety,18,7,11
42828,Multik,tichondrius,671,rogue,subtlety,18,7,11
42829,Beretta,nemesis,671,rogue,subtlety,18,7,11
42830,Vex,durotan,671,rogue,subtlety,24,7,17
42831,Brand,bonechewer,671,rogue,subtlety,30,7,23
42832,Jdmg,azralon,670,rogue,subtlety,12,7,5
42833,Zavrus,kelthuzad,670,rogue,subtlety,18,7,11
42834,Rotjaw,hydraxis,670,rogue,subtlety,18,7,11
42835,Takamoto,windrunner,670,rogue,subtlety,18,7,11
42836,Anteccessor,tichondrius,669,rogue,subtlety,18,7,11
42837,Bõjack,stormrage,669,rogue,subtlety,18,7,11
42838,Rovvo,queldorei,669,rogue,subtlety,24,7,17
42839,Jagó,malganis,667,rogue,subtlety,12,7,5
42840,Chompycat,tichondrius,667,rogue,subtlety,18,7,11
42841,Zapersapp,malygos,666,rogue,subtlety,24,7,17
42842,Schnozz,lightbringer,665,rogue,subtlety,12,7,5
42843,Gotchabak,stormrage,659,rogue,subtlety,12,7,5
42844,Zhuodouqiaga,tichondrius,655,rogue,subtlety,17,7,10
42845,Zaozaa,frostmourne,639,rogue,subtlety,14,8,6
42846,Phyzzi,kargath,639,rogue,subtlety,17,7,10
42847,Flazy,sargeras,623,rogue,subtlety,11,7,4
42848,Coldkill,bleeding-hollow,623,rogue,subtlety,11,7,4
42849,Undalack,ragnaros,621,rogue,subtlety,21,7,14
42850,Carpe,barthilas,618,rogue,subtlety,24,8,16
42851,Namig,cenarion-circle,608,rogue,subtlety,10,7,3
42852,Deadshank,bleeding-hollow,576,rogue,subtlety,6,6,0
42853,Manersi,akama,576,rogue,subtlety,6,6,0
42854,Donçorleone,stormrage,576,rogue,subtlety,6,6,0
42855,Homarx,quelthalas,576,rogue,subtlety,10,7,3
42856,Gibsons,quelthalas,576,rogue,subtlety,12,6,6
42857,Jòwtzy,ragnaros,576,rogue,subtlety,12,6,6
42858,Pamaaj,sargeras,576,rogue,subtlety,12,6,6
42859,Avelmire,sargeras,576,rogue,subtlety,12,6,6
42860,Donpeon,hellscream,576,rogue,subtlety,12,6,6
42861,Sivni,tichondrius,576,rogue,subtlety,12,6,6
42862,Tmpikaboo,mugthol,576,rogue,subtlety,12,6,6
42863,Pingwii,ragnaros,576,rogue,subtlety,12,6,6
42864,Draiygo,nerzhul,576,rogue,subtlety,12,6,6
42865,Palumor,deathwing,576,rogue,subtlety,12,6,6
42866,Unholydood,bonechewer,576,rogue,subtlety,12,6,6
42867,Fkq,emerald-dream,576,rogue,subtlety,12,6,6
42868,Mistrjack,kelthuzad,576,rogue,subtlety,12,6,6
42869,Kindasorry,illidan,576,rogue,subtlety,12,6,6
42870,Xedi,illidan,576,rogue,subtlety,12,6,6
42871,Littlescrub,frostmourne,576,rogue,subtlety,12,6,6
42872,Mutingall,tichondrius,576,rogue,subtlety,12,6,6
42873,Vyserate,malfurion,576,rogue,subtlety,12,6,6
42874,Dërpt,tichondrius,576,rogue,subtlety,12,6,6
42875,Revila,bleeding-hollow,576,rogue,subtlety,12,6,6
42876,Hykoo,tichondrius,576,rogue,subtlety,12,6,6
42877,Ãnimefãnx,moon-guard,576,rogue,subtlety,12,6,6
42878,Lymon,azralon,576,rogue,subtlety,12,6,6
42879,Wongcha,darkspear,576,rogue,subtlety,12,6,6
42880,Baßyøða,stormrage,576,rogue,subtlety,12,6,6
42881,Topfloorboss,illidan,576,rogue,subtlety,12,6,6
42882,Shadxr,tichondrius,576,rogue,subtlety,12,6,6
42883,Athletik,tichondrius,576,rogue,subtlety,12,6,6
42884,Pokekek,stormrage,576,rogue,subtlety,12,6,6
42885,Veterån,tichondrius,576,rogue,subtlety,18,6,12
42886,Ghosted,thrall,576,rogue,subtlety,18,6,12
42887,Snoogly,tichondrius,576,rogue,subtlety,18,6,12
42888,Cinnashank,darkspear,576,rogue,subtlety,18,6,12
42889,Drakariano,ragnaros,576,rogue,subtlety,18,6,12
42890,Jácket,area-52,576,rogue,subtlety,24,6,18
42891,Struggle,sargeras,576,rogue,subtlety,24,6,18
42892,Maulgryve,frostwolf,575,rogue,subtlety,12,6,6
42893,Projectx,tichondrius,575,rogue,subtlety,12,6,6
42894,Whothekilla,tichondrius,575,rogue,subtlety,12,6,6
42895,Mcnastier,dunemaul,575,rogue,subtlety,12,6,6
42896,Scallywag,illidan,575,rogue,subtlety,12,6,6
42897,Azanax,area-52,575,rogue,subtlety,12,6,6
42898,Smakkey,tichondrius,575,rogue,subtlety,12,6,6
42899,Jinxkiller,tichondrius,575,rogue,subtlety,12,6,6
42900,Hindpaw,wyrmrest-accord,575,rogue,subtlety,18,6,12
42901,Dreamcatcher,azralon,575,rogue,subtlety,18,6,12
42902,Zogbu,stormrage,575,rogue,subtlety,18,6,12
42903,Poofus,vashj,575,rogue,subtlety,18,6,12
42904,Karing,onyxia,574,rogue,subtlety,18,6,12
42905,Tòúka,stormrage,574,rogue,subtlety,18,6,12
42906,Dedrater,shadowmoon,574,rogue,subtlety,18,6,12
42907,Alttee,proudmoore,573,rogue,subtlety,12,6,6
42908,Strôbéy,tichondrius,573,rogue,subtlety,24,6,18
42909,Jowelyrandy,drakkari,573,rogue,subtlety,25,6,19
42910,Warghostpvp,illidan,572,rogue,subtlety,12,6,6
42911,Iapologize,area-52,572,rogue,subtlety,12,6,6
42912,Darkpaths,hyjal,572,rogue,subtlety,12,6,6
42913,Supminty,stormrage,571,rogue,subtlety,12,6,6
42914,Xylow,garona,571,rogue,subtlety,27,6,21
42915,Backstàb,durotan,566,rogue,subtlety,12,6,6
42916,Nakedps,garona,566,rogue,subtlety,12,6,6
42917,Pancakestab,saurfang,543,rogue,subtlety,14,7,7
42918,Respia,proudmoore,521,rogue,subtlety,14,7,7
42919,Dogedealer,ragnaros,515,rogue,subtlety,15,7,8
42920,Aruldyr,zuljin,510,rogue,subtlety,14,6,8
42921,Shadaux,frostmourne,480,rogue,subtlety,6,5,1
42922,Matek,darkspear,480,rogue,subtlety,6,5,1
42923,Lowkn,tichondrius,480,rogue,subtlety,6,5,1
42924,Progeriagodx,darkspear,480,rogue,subtlety,6,5,1
42925,Ghoarie,sargeras,480,rogue,subtlety,6,5,1
42926,Kwins,cenarion-circle,480,rogue,subtlety,6,5,1
42927,Natalya,stormreaver,480,rogue,subtlety,6,5,1
42928,Nodeßurglar,kelthuzad,480,rogue,subtlety,6,5,1
42929,Deepsyo,frostmourne,480,rogue,subtlety,6,5,1
42930,Alathir,tichondrius,480,rogue,subtlety,6,5,1
42931,Oceboomer,frostmourne,480,rogue,subtlety,6,5,1
42932,Söda,emerald-dream,480,rogue,subtlety,12,5,7
42933,Snewdaddy,malganis,480,rogue,subtlety,12,5,7
42934,Mitra,eredar,480,rogue,subtlety,12,5,7
42935,Uni,khadgar,480,rogue,subtlety,12,5,7
42936,Blakezillax,tichondrius,480,rogue,subtlety,12,5,7
42937,Recktzful,ragnaros,480,rogue,subtlety,12,5,7
42938,Jon,the-venture-co,480,rogue,subtlety,12,5,7
42939,Jean,tichondrius,480,rogue,subtlety,12,5,7
42940,Shizz,tichondrius,480,rogue,subtlety,12,5,7
42941,Twnice,tichondrius,480,rogue,subtlety,12,5,7
42942,Liqwid,stormrage,480,rogue,subtlety,12,5,7
42943,Sinary,cenarion-circle,480,rogue,subtlety,12,5,7
42944,Blinky,blades-edge,480,rogue,subtlety,12,5,7
42945,Ifríend,emerald-dream,480,rogue,subtlety,12,5,7
42946,Aldessa,draka,480,rogue,subtlety,12,5,7
42947,Chimpo,ravencrest,480,rogue,subtlety,12,5,7
42948,Isonlydosex,tichondrius,480,rogue,subtlety,12,5,7
42949,Pwnsauce,frostmourne,480,rogue,subtlety,12,5,7
42950,Pjh,sargeras,480,rogue,subtlety,12,5,7
42951,Henya,magtheridon,480,rogue,subtlety,12,5,7
42952,Invkill,azralon,480,rogue,subtlety,12,5,7
42953,Milafortnite,tichondrius,480,rogue,subtlety,12,5,7
42954,Defthands,tichondrius,480,rogue,subtlety,12,5,7
42955,Mikènuttz,sargeras,480,rogue,subtlety,12,5,7
42956,Wooluncle,tichondrius,480,rogue,subtlety,12,5,7
42957,Kenyel,frostmourne,480,rogue,subtlety,12,5,7
42958,Ricosap,frostmourne,480,rogue,subtlety,12,5,7
42959,Tizzyb,bleeding-hollow,480,rogue,subtlety,12,5,7
42960,Tessialith,azralon,480,rogue,subtlety,12,5,7
42961,Monkeykongr,lightnings-blade,480,rogue,subtlety,12,5,7
42962,Scrubzz,barthilas,480,rogue,subtlety,12,5,7
42963,Wadge,zuljin,480,rogue,subtlety,12,5,7
42964,Cbdoil,proudmoore,480,rogue,subtlety,12,5,7
42965,Drunknchaos,bleeding-hollow,480,rogue,subtlety,12,5,7
42966,Harasna,emerald-dream,480,rogue,subtlety,12,5,7
42967,Caras,tichondrius,480,rogue,subtlety,12,5,7
42968,Killdrunk,stormrage,480,rogue,subtlety,12,5,7
42969,Hassanssin,area-52,480,rogue,subtlety,12,5,7
42970,Steeldiesel,sargeras,480,rogue,subtlety,12,5,7
42971,Minimumwage,bleeding-hollow,480,rogue,subtlety,12,5,7
42972,Arsènè,whisperwind,480,rogue,subtlety,13,5,8
42973,Psychostabby,tichondrius,480,rogue,subtlety,18,5,13
42974,Greyleywin,azralon,480,rogue,subtlety,18,5,13
42975,Alaeá,stormrage,480,rogue,subtlety,18,5,13
42976,Highwire,stormrage,479,rogue,subtlety,6,5,1
42977,Zitihait,amanthul,479,rogue,subtlety,6,5,1
42978,Deathbeacøn,sargeras,479,rogue,subtlety,12,5,7
42979,Lacero,bonechewer,479,rogue,subtlety,12,5,7
42980,Minato,eredar,479,rogue,subtlety,12,5,7
42981,Smòkéd,tichondrius,479,rogue,subtlety,12,5,7
42982,Catoline,bleeding-hollow,479,rogue,subtlety,12,5,7
42983,Luoan,emerald-dream,479,rogue,subtlety,12,5,7
42984,Brettmckjnr,saurfang,479,rogue,subtlety,12,5,7
42985,Toodlles,stormrage,479,rogue,subtlety,12,5,7
42986,Qlog,tichondrius,479,rogue,subtlety,12,5,7
42987,Crypblade,sargeras,479,rogue,subtlety,12,5,7
42988,Killerupdown,muradin,479,rogue,subtlety,18,5,13
42989,Corchô,moon-guard,479,rogue,subtlety,18,5,13
42990,Gaiuscaesa,moon-guard,479,rogue,subtlety,18,5,13
42991,Frostybeers,kelthuzad,479,rogue,subtlety,18,5,13
42992,Kekdasneak,dragonmaw,479,rogue,subtlety,18,5,13
42993,Fouzz,stormrage,478,rogue,subtlety,15,6,9
42994,Falra,wyrmrest-accord,478,rogue,subtlety,18,5,13
42995,Muffens,alterac-mountains,476,rogue,subtlety,12,5,7
42996,Liamoz,amanthul,475,rogue,subtlety,12,5,7
42997,Hyunco,tichondrius,474,rogue,subtlety,12,5,7
42998,Murdistino,tichondrius,472,rogue,subtlety,12,5,7
42999,Zôliath,tichondrius,448,rogue,subtlety,16,5,11
43000,Fingolfin,terenas,447,rogue,subtlety,11,5,6
43001,Anbuartist,dalaran,447,rogue,subtlety,11,5,6
43002,Backtoch,sargeras,447,rogue,subtlety,11,5,6
43003,Bernardi,uther,447,rogue,subtlety,11,5,6
43004,Notlim,azralon,432,rogue,subtlety,15,5,10
43005,Pangppy,tichondrius,431,rogue,subtlety,11,5,6
43006,Akhila,stormrage,431,rogue,subtlety,11,5,6
43007,Picaropanda,quelthalas,425,rogue,subtlety,22,6,16
43008,Mdrogue,sargeras,416,rogue,subtlety,10,5,5
43009,Cayladin,tichondrius,416,rogue,subtlety,10,5,5
43010,Luriél,stormrage,415,rogue,subtlety,10,5,5
43011,Kathërïnë,azralon,415,rogue,subtlety,16,5,11
43012,Sighzy,sargeras,400,rogue,subtlety,19,5,14
43013,Xvic,bleeding-hollow,384,rogue,subtlety,6,4,2
43014,Rïddïck,tichondrius,384,rogue,subtlety,6,4,2
43015,Wrldstars,illidan,384,rogue,subtlety,6,4,2
43016,Unoshade,illidan,384,rogue,subtlety,6,4,2
43017,Djsyn,bleeding-hollow,384,rogue,subtlety,6,4,2
43018,Dåve,tichondrius,384,rogue,subtlety,6,4,2
43019,Memnõch,emerald-dream,384,rogue,subtlety,6,4,2
43020,Chauva,zuljin,384,rogue,subtlety,6,4,2
43021,Malgoria,tichondrius,384,rogue,subtlety,6,4,2
43022,Bootimus,illidan,384,rogue,subtlety,6,4,2
43023,Deejey,frostmourne,384,rogue,subtlety,6,4,2
43024,Snobbish,tichondrius,384,rogue,subtlety,6,4,2
43025,Altaureen,thrall,384,rogue,subtlety,6,4,2
43026,Starhound,kiljaeden,384,rogue,subtlety,6,4,2
43027,Sapafapa,illidan,384,rogue,subtlety,6,4,2
43028,Invokesap,area-52,384,rogue,subtlety,6,4,2
43029,Zerorog,zuljin,384,rogue,subtlety,6,4,2
43030,Chokonet,gurubashi,384,rogue,subtlety,6,4,2
43031,Prepcoin,malganis,384,rogue,subtlety,6,4,2
43032,Daradria,stormrage,384,rogue,subtlety,6,4,2
43033,Deadopps,stormrage,384,rogue,subtlety,6,4,2
43034,Roberto,darkspear,384,rogue,subtlety,6,4,2
43035,Foreverioi,tichondrius,384,rogue,subtlety,6,4,2
43036,Suggmadi,stormrage,384,rogue,subtlety,6,4,2
43037,Kurosh,kalecgos,384,rogue,subtlety,6,4,2
43038,Subgodx,stormrage,384,rogue,subtlety,6,4,2
43039,Onezik,stormrage,384,rogue,subtlety,6,4,2
43040,Sapntapx,malganis,384,rogue,subtlety,6,4,2
43041,Mirlol,stormrage,384,rogue,subtlety,6,4,2
43042,Fortie,moon-guard,384,rogue,subtlety,6,4,2
43043,Evasionx,tichondrius,384,rogue,subtlety,6,4,2
43044,Emvee,kelthuzad,384,rogue,subtlety,6,4,2
43045,Agilityrush,stormrage,384,rogue,subtlety,6,4,2
43046,Caliph,malganis,384,rogue,subtlety,6,4,2
43047,Bilbobagginz,malganis,384,rogue,subtlety,6,4,2
43048,Vexaryon,quelthalas,384,rogue,subtlety,6,4,2
43049,Nichala,tichondrius,384,rogue,subtlety,6,4,2
43050,Mastrshreddr,kelthuzad,384,rogue,subtlety,6,4,2
43051,Jasam,daggerspine,384,rogue,subtlety,9,5,4
43052,Moshington,kelthuzad,384,rogue,subtlety,8,4,4
43053,Velandros,eonar,384,rogue,subtlety,12,4,8
43054,Miamiganster,lothar,384,rogue,subtlety,12,4,8
43055,Flankks,sargeras,384,rogue,subtlety,12,4,8
43056,Elishadowed,proudmoore,384,rogue,subtlety,12,4,8
43057,Freshcakes,darkspear,384,rogue,subtlety,12,4,8
43058,Gotothegym,tichondrius,384,rogue,subtlety,12,4,8
43059,Nevermoon,gallywix,384,rogue,subtlety,12,4,8
43060,Zzffqsm,tichondrius,384,rogue,subtlety,12,4,8
43061,Tàlion,emerald-dream,384,rogue,subtlety,12,4,8
43062,Woodsapdat,sargeras,384,rogue,subtlety,12,4,8
43063,Restinpeacex,bleeding-hollow,384,rogue,subtlety,12,4,8
43064,Mãtthew,tichondrius,384,rogue,subtlety,12,4,8
43065,Maxparkhurst,moon-guard,384,rogue,subtlety,12,4,8
43066,Rictorr,ragnaros,384,rogue,subtlety,12,4,8
43067,Seutobinhaa,stormrage,384,rogue,subtlety,12,4,8
43068,Cron,arygos,384,rogue,subtlety,12,4,8
43069,Lolgoturbase,hyjal,384,rogue,subtlety,12,4,8
43070,Lazaruslong,stormrage,384,rogue,subtlety,12,4,8
43071,Etyop,azralon,384,rogue,subtlety,12,4,8
43072,Saberbane,tichondrius,384,rogue,subtlety,12,4,8
43073,Keylight,tichondrius,384,rogue,subtlety,12,4,8
43074,Tomas,bloodscalp,384,rogue,subtlety,12,4,8
43075,Blackstabyth,thrall,384,rogue,subtlety,12,4,8
43076,Cytôn,bleeding-hollow,384,rogue,subtlety,12,4,8
43077,Seerenai,moon-guard,384,rogue,subtlety,12,4,8
43078,Muggzy,emerald-dream,384,rogue,subtlety,12,4,8
43079,Dions,ragnaros,384,rogue,subtlety,12,4,8
43080,Xikoro,emerald-dream,384,rogue,subtlety,12,4,8
43081,Booitsdrew,sargeras,384,rogue,subtlety,12,4,8
43082,Hoodiesneaks,stormrage,384,rogue,subtlety,14,4,10
43083,Asneakyfox,thunderlord,384,rogue,subtlety,30,4,26
43084,Gentlesaop,blackrock,383,rogue,subtlety,6,4,2
43085,Morphina,gilneas,383,rogue,subtlety,6,4,2
43086,Vendettã,skullcrusher,383,rogue,subtlety,6,4,2
43087,Stabsolutely,moon-guard,383,rogue,subtlety,6,4,2
43088,Freego,quelthalas,383,rogue,subtlety,6,4,2
43089,Hènnéssy,frostmourne,383,rogue,subtlety,12,4,8
43090,Superhattie,tichondrius,383,rogue,subtlety,12,4,8
43091,Ràinê,dalaran,383,rogue,subtlety,12,4,8
43092,Majimae,sargeras,383,rogue,subtlety,12,4,8
43093,Toxiccarnage,ghostlands,383,rogue,subtlety,14,4,10
43094,Medalist,darkspear,383,rogue,subtlety,18,4,14
43095,Rascallion,tichondrius,381,rogue,subtlety,12,4,8
43096,Knife,moon-guard,381,rogue,subtlety,12,4,8
43097,Jjp,tichondrius,367,rogue,subtlety,11,4,7
43098,Sinice,draka,351,rogue,subtlety,8,5,3
43099,Samuraii,zuljin,335,rogue,subtlety,11,4,7
43100,Idsapdat,illidan,330,rogue,subtlety,9,6,3
43101,Earkeeper,wildhammer,330,rogue,subtlety,8,5,3
43102,Peeryl,daggerspine,327,rogue,subtlety,15,5,10
43103,Rawdawged,illidan,320,rogue,subtlety,16,4,12
43104,Grima,azralon,319,rogue,subtlety,14,4,10
43105,Lemíly,emerald-dream,319,rogue,subtlety,14,4,10
43106,Pvptóne,steamwheedle-cartel,288,rogue,subtlety,6,3,3
43107,Raego,frostmourne,288,rogue,subtlety,6,3,3
43108,Liljonx,tichondrius,288,rogue,subtlety,6,3,3
43109,Kelbrelor,stormrage,288,rogue,subtlety,6,3,3
43110,Zêrøghgødx,tichondrius,288,rogue,subtlety,6,3,3
43111,Amatoxin,tichondrius,288,rogue,subtlety,6,3,3
43112,Redspoison,dalaran,288,rogue,subtlety,6,3,3
43113,Jackcurtis,kelthuzad,288,rogue,subtlety,6,3,3
43114,Slilsp,sargeras,288,rogue,subtlety,6,3,3
43115,Tonjuras,uther,288,rogue,subtlety,6,3,3
43116,Ohnoyoudont,dragonmaw,288,rogue,subtlety,6,3,3
43117,Snackable,tichondrius,288,rogue,subtlety,6,3,3
43118,Gåñðøñ,stormscale,288,rogue,subtlety,6,3,3
43119,Compadrer,area-52,288,rogue,subtlety,6,3,3
43120,Metalz,exodar,288,rogue,subtlety,6,3,3
43121,Bumboklaat,bleeding-hollow,288,rogue,subtlety,6,3,3
43122,Asherian,wyrmrest-accord,288,rogue,subtlety,6,3,3
43123,Wikkihx,emerald-dream,288,rogue,subtlety,6,3,3
43124,Sonymf,frostmourne,288,rogue,subtlety,6,3,3
43125,Shaisty,malganis,288,rogue,subtlety,6,3,3
43126,Belialas,thrall,288,rogue,subtlety,6,3,3
43127,Antijax,stormrage,288,rogue,subtlety,6,3,3
43128,Gotkick,stormrage,288,rogue,subtlety,6,3,3
43129,Sharmoc,ragnaros,288,rogue,subtlety,6,3,3
43130,Rdt,durotan,288,rogue,subtlety,6,3,3
43131,Ralæriel,wyrmrest-accord,288,rogue,subtlety,6,3,3
43132,Hemorrhages,tichondrius,288,rogue,subtlety,6,3,3
43133,Ced,medivh,288,rogue,subtlety,6,3,3
43134,Japz,sargeras,288,rogue,subtlety,6,3,3
43135,Haeqn,azralon,288,rogue,subtlety,6,3,3
43136,Knifetalk,moon-guard,288,rogue,subtlety,6,3,3
43137,Zarrth,malganis,288,rogue,subtlety,6,3,3
43138,Creayuncle,area-52,288,rogue,subtlety,6,3,3
43139,Maliora,area-52,288,rogue,subtlety,6,3,3
43140,Driizzel,sargeras,288,rogue,subtlety,6,3,3
43141,Junemylove,tichondrius,288,rogue,subtlety,6,3,3
43142,Gongarn,thrall,288,rogue,subtlety,6,3,3
43143,Repatriate,dark-iron,288,rogue,subtlety,6,3,3
43144,Xaander,nazjatar,288,rogue,subtlety,6,3,3
43145,Machinshin,dalaran,288,rogue,subtlety,6,3,3
43146,Oj,frostmourne,288,rogue,subtlety,6,3,3
43147,Valaq,tichondrius,288,rogue,subtlety,6,3,3
43148,Dödoubleg,stormrage,288,rogue,subtlety,6,3,3
43149,Bøbinette,sargeras,288,rogue,subtlety,6,3,3
43150,Seanr,stormrage,288,rogue,subtlety,6,3,3
43151,Schneric,stormrage,288,rogue,subtlety,6,3,3
43152,Gangstsprdse,tichondrius,288,rogue,subtlety,6,3,3
43153,Castsequence,khaz-modan,288,rogue,subtlety,6,3,3
43154,Dìngapoof,tichondrius,288,rogue,subtlety,6,3,3
43155,Keytürns,frostmourne,288,rogue,subtlety,6,3,3
43156,Sinfate,bleeding-hollow,288,rogue,subtlety,6,3,3
43157,Woundzx,tichondrius,288,rogue,subtlety,6,3,3
43158,Ascherx,illidan,288,rogue,subtlety,6,3,3
43159,Thargal,tichondrius,288,rogue,subtlety,6,3,3
43160,Reverel,tichondrius,288,rogue,subtlety,6,3,3
43161,Shadowreapz,barthilas,288,rogue,subtlety,6,3,3
43162,Garnoghan,stormrage,288,rogue,subtlety,6,3,3
43163,Rogecoin,illidan,288,rogue,subtlety,6,3,3
43164,Powaah,emerald-dream,288,rogue,subtlety,6,3,3
43165,Izula,spirestone,288,rogue,subtlety,6,3,3
43166,Privz,sargeras,288,rogue,subtlety,6,3,3
43167,Thoxic,barthilas,288,rogue,subtlety,6,3,3
43168,Støné,azjolnerub,288,rogue,subtlety,6,3,3
43169,Mondeaux,moon-guard,288,rogue,subtlety,6,3,3
43170,Trainhealers,tichondrius,288,rogue,subtlety,6,3,3
43171,Taraminkadot,sargeras,288,rogue,subtlety,9,4,5
43172,ßutthead,malganis,288,rogue,subtlety,7,3,4
43173,Ünaru,sargeras,288,rogue,subtlety,7,3,4
43174,Keytonx,tichondrius,288,rogue,subtlety,7,3,4
43175,Terala,perenolde,288,rogue,subtlety,12,3,9
43176,Niujaky,illidan,288,rogue,subtlety,12,3,9
43177,Cincyhirou,exodar,288,rogue,subtlety,12,3,9
43178,Penguineater,tichondrius,288,rogue,subtlety,12,3,9
43179,Wrekage,emerald-dream,288,rogue,subtlety,12,3,9
43180,Woboi,area-52,288,rogue,subtlety,12,3,9
43181,Zeetwntyeght,stormrage,288,rogue,subtlety,12,3,9
43182,Veatrix,zuljin,288,rogue,subtlety,12,3,9
43183,Palla,tichondrius,288,rogue,subtlety,12,3,9
43184,Coolswag,tichondrius,288,rogue,subtlety,12,3,9
43185,Yülia,skywall,288,rogue,subtlety,12,3,9
43186,Yottsu,proudmoore,288,rogue,subtlety,12,3,9
43187,Foofz,kelthuzad,288,rogue,subtlety,12,3,9
43188,Grinz,sargeras,288,rogue,subtlety,12,3,9
43189,Nikkî,hyjal,288,rogue,subtlety,12,3,9
43190,Khazii,scilla,288,rogue,subtlety,12,3,9
43191,Eaxlol,sargeras,288,rogue,subtlety,12,3,9
43192,Hogstradamus,malganis,288,rogue,subtlety,12,3,9
43193,Miloandotis,malganis,288,rogue,subtlety,12,3,9
43194,Imbe,nagrand,288,rogue,subtlety,12,3,9
43195,Rassiter,stonemaul,288,rogue,subtlety,12,3,9
43196,Yamillpgk,ragnaros,288,rogue,subtlety,12,3,9
43197,Badonka,aggramar,288,rogue,subtlety,12,3,9
43198,Bumpamoose,aggramar,288,rogue,subtlety,12,3,9
43199,Smashfacewïn,tichondrius,288,rogue,subtlety,12,3,9
43200,Heretodance,tichondrius,288,rogue,subtlety,18,3,15
43201,Bajeebus,azshara,287,rogue,subtlety,6,3,3
43202,Urukzog,ragnaros,287,rogue,subtlety,6,3,3
43203,Framsteg,kelthuzad,287,rogue,subtlety,6,3,3
43204,Xsneakski,jubeithos,287,rogue,subtlety,6,3,3
43205,Stealheartsr,tichondrius,287,rogue,subtlety,7,3,4
43206,Namiic,thrall,287,rogue,subtlety,12,3,9
43207,Heserth,ragnaros,287,rogue,subtlety,12,3,9
43208,Bromen,ragnaros,287,rogue,subtlety,12,3,9
43209,Minnicent,amanthul,287,rogue,subtlety,18,3,15
43210,Teach,illidan,287,rogue,subtlety,18,3,15
43211,Aycaramba,skywall,286,rogue,subtlety,6,3,3
43212,Cerebrian,malygos,286,rogue,subtlety,6,3,3
43213,Tareduwu,area-52,286,rogue,subtlety,18,3,15
43214,Rotbreath,bleeding-hollow,271,rogue,subtlety,17,3,14
43215,Wickedstuns,malganis,271,rogue,subtlety,17,3,14
43216,Soultakerr,whisperwind,271,rogue,subtlety,17,3,14
43217,Reflexiv,malganis,256,rogue,subtlety,10,3,7
43218,Elsegador,tichondrius,240,rogue,subtlety,9,4,5
43219,Uncleblinker,proudmoore,239,rogue,subtlety,5,3,2
43220,Wulfcrest,moon-guard,239,rogue,subtlety,5,3,2
43221,Youngdraco,tichondrius,239,rogue,subtlety,5,3,2
43222,Radagon,fenris,234,rogue,subtlety,9,4,5
43223,Rocanról,quelthalas,234,rogue,subtlety,12,4,8
43224,Twinkasz,nemesis,234,rogue,subtlety,16,5,11
43225,Sappedwap,thrall,192,rogue,subtlety,4,3,1
43226,Nocte,goldrinn,192,rogue,subtlety,6,2,4
43227,Swingonya,stormrage,192,rogue,subtlety,6,2,4
43228,Runescape,frostmourne,192,rogue,subtlety,6,2,4
43229,Chêckmatê,darkspear,192,rogue,subtlety,6,2,4
43230,Anímosity,darkspear,192,rogue,subtlety,6,2,4
43231,Tryedge,moon-guard,192,rogue,subtlety,6,2,4
43232,Meadview,bleeding-hollow,192,rogue,subtlety,6,2,4
43233,Xyltann,bleeding-hollow,192,rogue,subtlety,6,2,4
43234,Sicksix,bleeding-hollow,192,rogue,subtlety,6,2,4
43235,Pixils,bleeding-hollow,192,rogue,subtlety,6,2,4
43236,Shankmcganks,chogall,192,rogue,subtlety,6,2,4
43237,Letsgobranon,sargeras,192,rogue,subtlety,6,2,4
43238,Skorsh,wyrmrest-accord,192,rogue,subtlety,6,2,4
43239,Lmorningstar,altar-of-storms,192,rogue,subtlety,6,2,4
43240,Dillwilly,moon-guard,192,rogue,subtlety,6,2,4
43241,Sneakyt,shadow-council,192,rogue,subtlety,6,2,4
43242,Gzl,frostmourne,192,rogue,subtlety,6,2,4
43243,Bloodhounder,illidan,192,rogue,subtlety,6,2,4
43244,Happyunhappy,illidan,192,rogue,subtlety,6,2,4
43245,Nubes,illidan,192,rogue,subtlety,6,2,4
43246,Ikthemon,khaz-modan,192,rogue,subtlety,6,2,4
43247,Jâm,nerzhul,192,rogue,subtlety,6,2,4
43248,Buddymelon,thrall,192,rogue,subtlety,6,2,4
43249,Pilurfs,thrall,192,rogue,subtlety,6,2,4
43250,Åaron,thrall,192,rogue,subtlety,6,2,4
43251,Rujkah,archimonde,192,rogue,subtlety,6,2,4
43252,Slycndice,tortheldrin,192,rogue,subtlety,6,2,4
43253,ßroke,emerald-dream,192,rogue,subtlety,6,2,4
43254,Valrec,stormrage,192,rogue,subtlety,6,2,4
43255,Tìlt,whisperwind,192,rogue,subtlety,6,2,4
43256,Gnoescape,burning-legion,192,rogue,subtlety,6,2,4
43257,Tothegravetv,sargeras,192,rogue,subtlety,6,2,4
43258,Pëaches,area-52,192,rogue,subtlety,6,2,4
43259,Smertin,area-52,192,rogue,subtlety,6,2,4
43260,Indicadeath,stormrage,192,rogue,subtlety,6,2,4
43261,Teribád,area-52,192,rogue,subtlety,6,2,4
43262,Bruitzyttv,barthilas,192,rogue,subtlety,6,2,4
43263,Shadowmagikk,sargeras,192,rogue,subtlety,6,2,4
43264,Macklittle,area-52,192,rogue,subtlety,6,2,4
43265,Grue,gundrak,192,rogue,subtlety,6,2,4
43266,Alcinah,sargeras,192,rogue,subtlety,6,2,4
43267,Ërëbus,greymane,192,rogue,subtlety,6,2,4
43268,Brustent,icecrown,192,rogue,subtlety,6,2,4
43269,Pizzarollplz,kelthuzad,192,rogue,subtlety,6,2,4
43270,Sizak,kelthuzad,192,rogue,subtlety,6,2,4
43271,Gannet,spirestone,192,rogue,subtlety,6,2,4
43272,Kami,kelthuzad,192,rogue,subtlety,6,2,4
43273,Elvesnknives,stormrage,192,rogue,subtlety,6,2,4
43274,Stateless,kelthuzad,192,rogue,subtlety,6,2,4
43275,Lenik,azuremyst,192,rogue,subtlety,6,2,4
43276,Wètdream,sargeras,192,rogue,subtlety,6,2,4
43277,Exwhite,proudmoore,192,rogue,subtlety,6,2,4
43278,Yurico,zuljin,192,rogue,subtlety,6,2,4
43279,Brutalpocket,malganis,192,rogue,subtlety,6,2,4
43280,Jeezy,shadowmoon,192,rogue,subtlety,6,2,4
43281,Zerø,barthilas,192,rogue,subtlety,6,2,4
43282,Toomuchcap,aggramar,192,rogue,subtlety,6,2,4
43283,Joegamer,sargeras,192,rogue,subtlety,6,2,4
43284,Pootymunchin,daggerspine,192,rogue,subtlety,6,2,4
43285,Ow,eldrethalas,192,rogue,subtlety,6,2,4
43286,Bambooßobby,area-52,192,rogue,subtlety,6,2,4
43287,Vanquief,sargeras,192,rogue,subtlety,6,2,4
43288,Wyyre,hyjal,192,rogue,subtlety,6,2,4
43289,Tleary,tichondrius,192,rogue,subtlety,6,2,4
43290,Usapped,tichondrius,192,rogue,subtlety,6,2,4
43291,Terrorstrike,tichondrius,192,rogue,subtlety,6,2,4
43292,Rogsky,tichondrius,192,rogue,subtlety,6,2,4
43293,Slíçk,tichondrius,192,rogue,subtlety,6,2,4
43294,Roastful,tichondrius,192,rogue,subtlety,6,2,4
43295,Sticksnstabs,tichondrius,192,rogue,subtlety,6,2,4
43296,Yourhomieaj,tichondrius,192,rogue,subtlety,6,2,4
43297,Sparklepuffy,tichondrius,192,rogue,subtlety,6,2,4
43298,Shadowstryfe,tichondrius,192,rogue,subtlety,6,2,4
43299,Stymie,malorne,192,rogue,subtlety,6,2,4
43300,Zzu,azralon,192,rogue,subtlety,6,2,4
43301,Opwanshinobi,azralon,192,rogue,subtlety,6,2,4
43302,Coalie,tichondrius,192,rogue,subtlety,6,2,4
43303,Lennysnephew,tichondrius,192,rogue,subtlety,6,2,4
43304,Rehze,area-52,192,rogue,subtlety,6,2,4
43305,Icantsleep,tichondrius,192,rogue,subtlety,6,2,4
43306,Mgzx,tichondrius,192,rogue,subtlety,6,2,4
43307,Alakie,cenarius,192,rogue,subtlety,6,2,4
43308,Rhayu,emerald-dream,192,rogue,subtlety,6,2,4
43309,Surplus,stormscale,192,rogue,subtlety,6,2,4
43310,Theweeknd,kiljaeden,192,rogue,subtlety,7,2,5
43311,Xenitech,bleeding-hollow,192,rogue,subtlety,8,2,6
43312,Bâerâ,bloodscalp,192,rogue,subtlety,8,2,6
43313,Krius,blood-furnace,192,rogue,subtlety,12,2,10
43314,Zeriek,stormrage,192,rogue,subtlety,12,2,10
43315,Barmiah,stormrage,192,rogue,subtlety,12,2,10
43316,Xô,lothar,192,rogue,subtlety,12,2,10
43317,Noxîc,zuljin,192,rogue,subtlety,12,2,10
43318,Pouet,caelestrasz,192,rogue,subtlety,12,2,10
43319,Kestor,barthilas,192,rogue,subtlety,12,2,10
43320,Jakeharvey,dalaran,192,rogue,subtlety,12,2,10
43321,Mitchrogue,barthilas,192,rogue,subtlety,12,2,10
43322,Ezmate,frostmourne,192,rogue,subtlety,12,2,10
43323,Bloodyblades,blackhand,192,rogue,subtlety,12,2,10
43324,Soupline,area-52,192,rogue,subtlety,12,2,10
43325,Diabsoule,amanthul,192,rogue,subtlety,12,2,10
43326,Gutpunch,kelthuzad,192,rogue,subtlety,12,2,10
43327,Zabava,malganis,192,rogue,subtlety,12,2,10
43328,Brickjohnson,illidan,192,rogue,subtlety,12,2,10
43329,Souporcereal,aegwynn,192,rogue,subtlety,12,2,10
43330,Nigthdead,nemesis,192,rogue,subtlety,12,2,10
43331,Rogmin,tichondrius,192,rogue,subtlety,12,2,10
43332,Jashyy,tichondrius,192,rogue,subtlety,12,2,10
43333,Wildstory,tichondrius,192,rogue,subtlety,12,2,10
43334,Ghostdragons,tichondrius,192,rogue,subtlety,12,2,10
43335,Myhandisfull,tichondrius,192,rogue,subtlety,12,2,10
43336,Onulyo,tichondrius,192,rogue,subtlety,12,2,10
43337,Flèè,illidan,192,rogue,subtlety,12,2,10
43338,Bleedszfreak,illidan,192,rogue,subtlety,18,2,16
43339,Roguessy,dalaran,192,rogue,subtlety,18,2,16
43340,Vitalz,bloodscalp,191,rogue,subtlety,6,2,4
43341,Seth,stonemaul,191,rogue,subtlety,6,2,4
43342,Lancarlorïus,ragnaros,191,rogue,subtlety,6,2,4
43343,Mccarter,bonechewer,191,rogue,subtlety,12,2,10
43344,Sheiv,shadow-council,190,rogue,subtlety,5,3,2
43345,Tenr,tichondrius,170,rogue,subtlety,13,4,9
43346,Opensap,tichondrius,159,rogue,subtlety,5,2,3
43347,Kanablis,tichondrius,159,rogue,subtlety,5,2,3
43348,Khrezin,stonemaul,159,rogue,subtlety,5,2,3
43349,Koobbo,tichondrius,159,rogue,subtlety,5,2,3
43350,Eliasael,moon-guard,159,rogue,subtlety,5,2,3
43351,Ganksterqt,dentarg,138,rogue,subtlety,10,3,7
43352,Ladelmono,tichondrius,138,rogue,subtlety,15,3,12
43353,Uhtrred,ragnaros,137,rogue,subtlety,10,3,7
43354,Uchihà,sargeras,134,rogue,subtlety,17,3,14
43355,Fadedx,darkspear,128,rogue,subtlety,4,2,2
43356,Earthinhorn,frostmourne,127,rogue,subtlety,8,2,6
43357,Swickwockdus,azralon,112,rogue,subtlety,7,2,5
43358,Rickgone,bleeding-hollow,96,rogue,subtlety,3,2,1
43359,Finlander,area-52,96,rogue,subtlety,5,2,3
43360,Lásko,area-52,96,rogue,subtlety,9,2,7
43361,Frootylol,stormrage,96,rogue,subtlety,6,1,5
43362,Eimr,stormrage,96,rogue,subtlety,6,1,5
43363,Dnb,warsong,96,rogue,subtlety,6,1,5
43364,Aitreena,stormrage,96,rogue,subtlety,6,1,5
43365,Mikea,stormrage,96,rogue,subtlety,6,1,5
43366,Bonizzi,stormrage,96,rogue,subtlety,6,1,5
43367,Thottie,bleeding-hollow,96,rogue,subtlety,6,1,5
43368,Skinnymayne,laughing-skull,96,rogue,subtlety,6,1,5
43369,Srrmortte,gallywix,96,rogue,subtlety,6,1,5
43370,Wrin,sargeras,96,rogue,subtlety,6,1,5
43371,Docheatt,dalaran,96,rogue,subtlety,6,1,5
43372,Originkorean,terenas,96,rogue,subtlety,6,1,5
43373,Vivas,dalaran,96,rogue,subtlety,6,1,5
43374,Deepcutz,barthilas,96,rogue,subtlety,6,1,5
43375,Anistreya,wyrmrest-accord,96,rogue,subtlety,6,1,5
43376,Rooster,muradin,96,rogue,subtlety,6,1,5
43377,Bloodbrawl,caelestrasz,96,rogue,subtlety,6,1,5
43378,Yoodoo,nemesis,96,rogue,subtlety,6,1,5
43379,Meatballjr,frostmane,96,rogue,subtlety,6,1,5
43380,Herian,caelestrasz,96,rogue,subtlety,6,1,5
43381,Grindaicha,dentarg,96,rogue,subtlety,6,1,5
43382,Nobarå,veknilash,96,rogue,subtlety,6,1,5
43383,Koraliya,kiljaeden,96,rogue,subtlety,6,1,5
43384,Ovrfivethosn,malganis,96,rogue,subtlety,6,1,5
43385,Dabrat,frostwolf,96,rogue,subtlety,6,1,5
43386,Sapstick,kiljaeden,96,rogue,subtlety,6,1,5
43387,Aenaesx,malygos,96,rogue,subtlety,6,1,5
43388,Borre,kiljaeden,96,rogue,subtlety,6,1,5
43389,Quackerjacks,lightnings-blade,96,rogue,subtlety,6,1,5
43390,Jokerr,proudmoore,96,rogue,subtlety,6,1,5
43391,Soggysenpai,kelthuzad,96,rogue,subtlety,6,1,5
43392,Akilesx,quelthalas,96,rogue,subtlety,6,1,5
43393,Toxína,quelthalas,96,rogue,subtlety,6,1,5
43394,Dagarah,quelthalas,96,rogue,subtlety,6,1,5
43395,Caalo,quelthalas,96,rogue,subtlety,6,1,5
43396,Slobernocker,stormrage,96,rogue,subtlety,6,1,5
43397,Treasy,malganis,96,rogue,subtlety,6,1,5
43398,Adysius,malganis,96,rogue,subtlety,6,1,5
43399,Nevatell,malganis,96,rogue,subtlety,6,1,5
43400,Halion,nagrand,96,rogue,subtlety,6,1,5
43401,Xone,saurfang,96,rogue,subtlety,6,1,5
43402,Valekk,stormscale,96,rogue,subtlety,6,1,5
43403,Páige,ragnaros,96,rogue,subtlety,6,1,5
43404,Kizakuo,moon-guard,96,rogue,subtlety,6,1,5
43405,Cotuffa,drakkari,96,rogue,subtlety,6,1,5
43406,Macc,khazgoroth,96,rogue,subtlety,6,1,5
43407,Reurog,garrosh,96,rogue,subtlety,6,1,5
43408,Mídnìght,aegwynn,96,rogue,subtlety,6,1,5
43409,Sawred,bonechewer,96,rogue,subtlety,6,1,5
43410,Soosung,moon-guard,96,rogue,subtlety,6,1,5
43411,Anadrol,sargeras,96,rogue,subtlety,6,1,5
43412,Lawyergamer,bonechewer,96,rogue,subtlety,6,1,5
43413,Liloudarog,tichondrius,96,rogue,subtlety,6,1,5
43414,Teleqraph,frostmourne,96,rogue,subtlety,6,1,5
43415,Satanicrizz,tichondrius,96,rogue,subtlety,6,1,5
43416,Dragosha,antonidas,96,rogue,subtlety,6,1,5
43417,Illidin,executus,96,rogue,subtlety,6,1,5
43418,Wabi,tichondrius,96,rogue,subtlety,6,1,5
43419,Spöke,dalvengyr,96,rogue,subtlety,6,1,5
43420,Scowl,dethecus,96,rogue,subtlety,6,1,5
43421,Whaazz,tichondrius,96,rogue,subtlety,6,1,5
43422,Ironrod,shadowmoon,96,rogue,subtlety,6,1,5
43423,Bigcolumn,tichondrius,96,rogue,subtlety,6,1,5
43424,Ghostyd,tichondrius,96,rogue,subtlety,6,1,5
43425,Solideoglria,tichondrius,96,rogue,subtlety,6,1,5
43426,Heimlichkeit,tichondrius,96,rogue,subtlety,6,1,5
43427,Steffmaister,tichondrius,96,rogue,subtlety,6,1,5
43428,Sudokill,tichondrius,96,rogue,subtlety,6,1,5
43429,Crÿptø,azralon,96,rogue,subtlety,6,1,5
43430,Onetwostep,tichondrius,96,rogue,subtlety,6,1,5
43431,Rolomon,tichondrius,96,rogue,subtlety,6,1,5
43432,Robomom,illidan,96,rogue,subtlety,6,1,5
43433,Mintirogue,sargeras,96,rogue,subtlety,6,1,5
43434,Wildtrick,greymane,96,rogue,subtlety,12,1,11
43435,Flelfo,quelthalas,96,rogue,subtlety,12,1,11
43436,Minkys,azralon,79,rogue,subtlety,5,1,4
43437,Zhaanth,bonechewer,79,rogue,subtlety,5,1,4
43438,Vetisx,thrall,64,rogue,subtlety,4,1,3
43439,Vùdõõ,area-52,64,rogue,subtlety,4,1,3
43440,Drpibb,ghostlands,63,rogue,subtlety,2,2,0
43441,Swøøpy,stormrage,48,rogue,subtlety,3,1,2
43442,Thenelis,dalaran,42,rogue,subtlety,11,2,9
43443,Archazx,sargeras,42,rogue,subtlety,12,2,10
43444,Rosê,daggerspine,41,rogue,subtlety,8,4,4
43445,Demonioverde,ragnaros,31,rogue,subtlety,2,1,1
43446,Betakong,quelthalas,31,rogue,subtlety,2,1,1
43447,Traumashears,proudmoore,31,rogue,subtlety,2,1,1
43448,Helzzit,ragnaros,31,rogue,subtlety,2,1,1
43449,Mirrorx,tichondrius,2227,rogue,assassination,234,119,115
43450,Zarkk,kelthuzad,2141,rogue,assassination,311,155,156
43451,Sllabymkcus,sargeras,2126,rogue,assassination,72,37,35
43452,Larmx,tichondrius,2111,rogue,assassination,78,40,38
43453,Xiaochulol,tichondrius,2097,rogue,assassination,96,51,45
43454,Ånko,tichondrius,2033,rogue,assassination,113,53,60
43455,Snortedgfuel,drenden,2015,rogue,assassination,83,41,42
43456,Sinepymkcus,illidan,1991,rogue,assassination,96,44,52
43457,Alethal,tichondrius,1972,rogue,assassination,90,48,42
43458,Ymxxlolz,tichondrius,1899,rogue,assassination,78,37,41
43459,Niarzz,tichondrius,1870,rogue,assassination,104,62,42
43460,Topfloorboss,illidan,1865,rogue,assassination,83,45,38
43461,Endlesswaltz,zuljin,1861,rogue,assassination,39,20,19
43462,Lemon,arygos,1851,rogue,assassination,47,20,27
43463,Sanira,illidan,1848,rogue,assassination,51,26,25
43464,Poonanixo,frostmourne,1846,rogue,assassination,78,38,40
43465,Alterfate,wyrmrest-accord,1839,rogue,assassination,66,33,33
43466,Feinting,moon-guard,1839,rogue,assassination,76,35,41
43467,Jon,the-venture-co,1838,rogue,assassination,54,27,27
43468,Sio,bleeding-hollow,1837,rogue,assassination,60,30,30
43469,Ajúmma,tichondrius,1831,rogue,assassination,57,23,34
43470,Jjp,tichondrius,1827,rogue,assassination,65,33,32
43471,Kenteenx,tichondrius,1823,rogue,assassination,60,28,32
43472,Omnìslash,area-52,1817,rogue,assassination,44,27,17
43473,Köfy,quelthalas,1813,rogue,assassination,87,41,46
43474,Raj,blood-furnace,1810,rogue,assassination,66,29,37
43475,Beaconlight,tichondrius,1808,rogue,assassination,77,31,46
43476,Relän,ragnaros,1805,rogue,assassination,59,33,26
43477,Sairak,tichondrius,1804,rogue,assassination,101,49,52
43478,Plumblossomx,tichondrius,1803,rogue,assassination,54,24,30
43479,Peepoclown,illidan,1782,rogue,assassination,58,29,29
43480,Thargal,tichondrius,1774,rogue,assassination,71,38,33
43481,Bloodlessftw,azralon,1765,rogue,assassination,152,71,81
43482,Lunatixz,emerald-dream,1749,rogue,assassination,59,31,28
43483,Doraz,tichondrius,1736,rogue,assassination,174,91,83
43484,Stealthdeath,quelthalas,1728,rogue,assassination,42,24,18
43485,Cutercarver,proudmoore,1721,rogue,assassination,117,56,61
43486,Bellamor,tichondrius,1711,rogue,assassination,114,66,48
43487,Impkasn,tichondrius,1710,rogue,assassination,84,33,51
43488,Slickyo,area-52,1705,rogue,assassination,42,23,19
43489,Pkkrevolt,archimonde,1704,rogue,assassination,99,50,49
43490,Bukaboo,tichondrius,1701,rogue,assassination,54,40,14
43491,Katmira,tichondrius,1699,rogue,assassination,72,30,42
43492,Vmoney,draenor,1685,rogue,assassination,30,18,12
43493,Inaniss,tichondrius,1678,rogue,assassination,56,30,26
43494,Girio,thrall,1675,rogue,assassination,41,22,19
43495,Vél,blackrock,1674,rogue,assassination,42,22,20
43496,Whooxx,khazgoroth,1673,rogue,assassination,66,29,37
43497,Viicky,ghostlands,1661,rogue,assassination,88,42,46
43498,Seroth,tichondrius,1656,rogue,assassination,36,23,13
43499,Ybby,tichondrius,1655,rogue,assassination,86,41,45
43500,Bellicoses,tichondrius,1651,rogue,assassination,155,84,71
43501,Ivanrah,zuljin,1648,rogue,assassination,45,20,25
43502,Hypnothot,tichondrius,1643,rogue,assassination,144,62,82
43503,Riventrix,zuljin,1640,rogue,assassination,101,47,54
43504,Shyzuku,drakkari,1640,rogue,assassination,48,21,27
43505,Kk,dalaran,1635,rogue,assassination,52,28,24
43506,Wujn,tichondrius,1635,rogue,assassination,197,103,94
43507,Rapcher,illidan,1632,rogue,assassination,148,75,73
43508,Josex,lightbringer,1632,rogue,assassination,48,20,28
43509,Stabasaurus,blood-furnace,1630,rogue,assassination,48,21,27
43510,Olé,azralon,1627,rogue,assassination,78,35,43
43511,Sheerlol,stormrage,1626,rogue,assassination,49,24,25
43512,Poisonous,emerald-dream,1620,rogue,assassination,51,25,26
43513,Assassìn,moon-guard,1618,rogue,assassination,48,27,21
43514,Ultranumb,sargeras,1618,rogue,assassination,51,27,24
43515,Zirkir,mannoroth,1615,rogue,assassination,50,27,23
43516,Vasherr,zuljin,1611,rogue,assassination,55,33,22
43517,Rîa,area-52,1611,rogue,assassination,48,21,27
43518,Lycanthropî,illidan,1611,rogue,assassination,48,20,28
43519,Rinhon,windrunner,1608,rogue,assassination,101,50,51
43520,Sanozü,azralon,1606,rogue,assassination,54,21,33
43521,Yenrab,illidan,1606,rogue,assassination,50,19,31
43522,Foreverioi,tichondrius,1603,rogue,assassination,54,31,23
43523,Elinarra,sargeras,1603,rogue,assassination,42,21,21
43524,Slapjak,dalaran,1600,rogue,assassination,74,33,41
43525,Johnnycryp,barthilas,1595,rogue,assassination,59,28,31
43526,Lucidstorm,tichondrius,1593,rogue,assassination,30,17,13
43527,Chêckmatê,darkspear,1589,rogue,assassination,54,25,29
43528,Devstrike,sargeras,1587,rogue,assassination,53,25,28
43529,Bladä,area-52,1585,rogue,assassination,70,35,35
43530,Nayle,dalaran,1585,rogue,assassination,65,31,34
43531,Katovo,tichondrius,1581,rogue,assassination,53,28,25
43532,Htez,frostmourne,1580,rogue,assassination,42,22,20
43533,Xagreth,illidan,1579,rogue,assassination,40,20,20
43534,Sparqxx,tichondrius,1577,rogue,assassination,233,117,116
43535,Happyslice,stormrage,1575,rogue,assassination,39,22,17
43536,Ãnimefãnx,moon-guard,1574,rogue,assassination,165,81,84
43537,Dairykeen,misha,1572,rogue,assassination,59,27,32
43538,Nightdelphya,azralon,1572,rogue,assassination,48,19,29
43539,Wxvi,tichondrius,1563,rogue,assassination,54,30,24
43540,Quefist,sargeras,1561,rogue,assassination,92,43,49
43541,Replayz,stormrage,1554,rogue,assassination,120,56,64
43542,Valaq,tichondrius,1551,rogue,assassination,136,67,69
43543,Miamiganster,lothar,1550,rogue,assassination,120,54,66
43544,Driprat,area-52,1549,rogue,assassination,36,23,13
43545,Kenyel,frostmourne,1543,rogue,assassination,90,40,50
43546,Isàputàp,tichondrius,1542,rogue,assassination,72,37,35
43547,Nhic,tichondrius,1542,rogue,assassination,57,23,34
43548,Gyutaro,black-dragonflight,1537,rogue,assassination,336,167,169
43549,Khrezin,stonemaul,1537,rogue,assassination,79,36,43
43550,Nsns,drenden,1536,rogue,assassination,236,119,117
43551,Sapmepapi,illidan,1533,rogue,assassination,30,17,13
43552,Purplechil,garrosh,1532,rogue,assassination,165,79,86
43553,Lyapunov,tichondrius,1532,rogue,assassination,66,30,36
43554,Turec,illidan,1532,rogue,assassination,42,16,26
43555,Kidneyshiv,stormrage,1531,rogue,assassination,36,20,16
43556,Skeezy,vashj,1531,rogue,assassination,70,28,42
43557,Strîkér,tichondrius,1529,rogue,assassination,43,20,23
43558,Youwho,kiljaeden,1528,rogue,assassination,195,101,94
43559,Cálí,azralon,1523,rogue,assassination,42,17,25
43560,Garrotte,tichondrius,1521,rogue,assassination,223,105,118
43561,Wxva,tichondrius,1515,rogue,assassination,42,18,24
43562,Spikiera,silvermoon,1513,rogue,assassination,63,31,32
43563,Tryedge,moon-guard,1512,rogue,assassination,36,19,17
43564,Zeth,frostmourne,1501,rogue,assassination,93,37,56
43565,Ulley,sargeras,1499,rogue,assassination,62,30,32
43566,Saiine,drenden,1498,rogue,assassination,66,32,34
43567,Stillsol,stormrage,1495,rogue,assassination,42,29,13
43568,Yanhuaa,illidan,1493,rogue,assassination,109,58,51
43569,Staabzz,thrall,1493,rogue,assassination,71,29,42
43570,Onetwostep,tichondrius,1492,rogue,assassination,39,17,22
43571,Stabem,moon-guard,1487,rogue,assassination,153,82,71
43572,Hickery,frostmourne,1487,rogue,assassination,107,47,60
43573,Brendantko,arthas,1486,rogue,assassination,30,16,14
43574,Osuba,proudmoore,1486,rogue,assassination,116,51,65
43575,Kiosh,tichondrius,1485,rogue,assassination,78,36,42
43576,Paraisbae,tichondrius,1484,rogue,assassination,42,23,19
43577,Sprigzey,frostmourne,1483,rogue,assassination,60,29,31
43578,Sizka,sargeras,1483,rogue,assassination,102,48,54
43579,Camlaw,area-52,1477,rogue,assassination,55,26,29
43580,Shizunö,stormrage,1473,rogue,assassination,56,27,29
43581,Gøblìn,tichondrius,1471,rogue,assassination,97,44,53
43582,Hookahrogue,area-52,1469,rogue,assassination,36,19,17
43583,Ezmate,frostmourne,1465,rogue,assassination,154,72,82
43584,Kidneyisntop,illidan,1463,rogue,assassination,54,28,26
43585,Notjawn,arthas,1459,rogue,assassination,196,102,94
43586,Smkgpvp,stormrage,1456,rogue,assassination,29,16,13
43587,Blackmont,bleeding-hollow,1456,rogue,assassination,60,26,34
43588,Dianiss,ragnaros,1452,rogue,assassination,30,17,13
43589,Madge,area-52,1451,rogue,assassination,82,39,43
43590,Shankeez,tichondrius,1437,rogue,assassination,36,17,19
43591,Øsi,icecrown,1433,rogue,assassination,36,15,21
43592,Cleam,darkspear,1432,rogue,assassination,36,19,17
43593,Lcl,proudmoore,1432,rogue,assassination,299,152,147
43594,Pirrow,moon-guard,1429,rogue,assassination,52,28,24
43595,Leônhart,thrall,1428,rogue,assassination,54,25,29
43596,Kindasorry,illidan,1426,rogue,assassination,155,78,77
43597,Boonee,frostmourne,1422,rogue,assassination,89,44,45
43598,Stabu,dalvengyr,1417,rogue,assassination,30,15,15
43599,Depressedx,illidan,1414,rogue,assassination,54,31,23
43600,Xilorio,skullcrusher,1407,rogue,assassination,66,30,36
43601,Lyliym,frostmourne,1405,rogue,assassination,32,16,16
43602,Shninzy,senjin,1404,rogue,assassination,30,15,15
43603,Evilsanta,sargeras,1404,rogue,assassination,40,18,22
43604,Creamypeach,stormrage,1401,rogue,assassination,81,36,45
43605,Vendëttä,quelthalas,1399,rogue,assassination,48,27,21
43606,Valråvn,bloodscalp,1399,rogue,assassination,29,16,13
43607,Swexee,area-52,1398,rogue,assassination,67,32,35
43608,Playmaker,frostwolf,1396,rogue,assassination,156,82,74
43609,Galaily,proudmoore,1387,rogue,assassination,90,44,46
43610,Kahlx,azralon,1382,rogue,assassination,167,83,84
43611,Xvds,tichondrius,1382,rogue,assassination,42,18,24
43612,Itokuri,ysera,1379,rogue,assassination,42,19,23
43613,Chakarr,stormrage,1374,rogue,assassination,32,22,10
43614,Páïgèvêntürã,bleeding-hollow,1367,rogue,assassination,32,15,17
43615,Pandrogue,shadowsong,1363,rogue,assassination,53,25,28
43616,Kzx,illidan,1356,rogue,assassination,30,16,14
43617,Theblindsap,dalaran,1354,rogue,assassination,30,16,14
43618,Hiddencosts,proudmoore,1345,rogue,assassination,123,63,60
43619,Liesll,thrall,1340,rogue,assassination,36,14,22
43620,Wansuiye,tichondrius,1340,rogue,assassination,42,14,28
43621,Røgüë,malganis,1338,rogue,assassination,30,14,16
43622,Urukzog,ragnaros,1334,rogue,assassination,60,31,29
43623,Apocalipto,barthilas,1332,rogue,assassination,89,38,51
43624,Wongcha,darkspear,1331,rogue,assassination,36,14,22
43625,Vannisshh,shattered-halls,1329,rogue,assassination,196,95,101
43626,Entrerí,illidan,1328,rogue,assassination,27,17,10
43627,Ykvo,illidan,1322,rogue,assassination,30,14,16
43628,Rêdrum,illidan,1313,rogue,assassination,108,39,69
43629,Ambushr,tichondrius,1312,rogue,assassination,24,16,8
43630,Sneakoh,illidan,1312,rogue,assassination,65,24,41
43631,Vimit,tichondrius,1310,rogue,assassination,66,29,37
43632,Harlyquinn,barthilas,1309,rogue,assassination,102,52,50
43633,Coquìn,proudmoore,1303,rogue,assassination,88,43,45
43634,Enyr,frostmourne,1300,rogue,assassination,103,50,53
43635,Powerjuicer,tichondrius,1300,rogue,assassination,66,31,35
43636,Uxaen,tichondrius,1291,rogue,assassination,44,26,18
43637,Skoorbals,tichondrius,1284,rogue,assassination,56,33,23
43638,Gorgdrake,illidan,1283,rogue,assassination,78,39,39
43639,Timat,emerald-dream,1282,rogue,assassination,48,22,26
43640,Aynrand,drakkari,1281,rogue,assassination,36,16,20
43641,Keepitshadow,frostmourne,1279,rogue,assassination,89,45,44
43642,Grasiel,tichondrius,1277,rogue,assassination,62,27,35
43643,Doomcore,barthilas,1276,rogue,assassination,41,21,20
43644,Thepitt,stormrage,1272,rogue,assassination,48,23,25
43645,Torshe,sargeras,1271,rogue,assassination,24,14,10
43646,Keylâ,thrall,1264,rogue,assassination,62,33,29
43647,Seengivenchy,zuljin,1262,rogue,assassination,26,14,12
43648,Engels,quelthalas,1262,rogue,assassination,72,33,39
43649,Ninjadoo,tichondrius,1262,rogue,assassination,68,27,41
43650,Eliasael,moon-guard,1258,rogue,assassination,39,18,21
43651,Lambs,blackhand,1258,rogue,assassination,35,14,21
43652,Regios,shadowmoon,1255,rogue,assassination,71,31,40
43653,Worlddark,quelthalas,1252,rogue,assassination,36,14,22
43654,Lemonlemon,arygos,1247,rogue,assassination,24,13,11
43655,Blindfun,emerald-dream,1247,rogue,assassination,39,21,18
43656,Lakeshark,stormrage,1246,rogue,assassination,36,13,23
43657,Sênorita,tichondrius,1246,rogue,assassination,36,13,23
43658,Beedie,malganis,1244,rogue,assassination,111,55,56
43659,Helecho,tichondrius,1244,rogue,assassination,30,13,17
43660,Jaganz,stormrage,1243,rogue,assassination,24,13,11
43661,Worm,demon-soul,1240,rogue,assassination,36,16,20
43662,Roollz,nemesis,1240,rogue,assassination,33,14,19
43663,Pál,quelthalas,1239,rogue,assassination,36,17,19
43664,Greenlemons,lightnings-blade,1237,rogue,assassination,60,31,29
43665,Papadopolous,zuluhed,1237,rogue,assassination,32,15,17
43666,Laotrec,nemesis,1231,rogue,assassination,43,19,24
43667,Raskapashan,moon-guard,1229,rogue,assassination,36,13,23
43668,Pst,spirestone,1227,rogue,assassination,24,14,10
43669,Stepper,aegwynn,1226,rogue,assassination,36,19,17
43670,Jarcus,aggramar,1225,rogue,assassination,36,13,23
43671,Senpaifuta,proudmoore,1222,rogue,assassination,24,14,10
43672,Shinobick,kelthuzad,1222,rogue,assassination,30,15,15
43673,Jagó,malganis,1215,rogue,assassination,36,17,19
43674,Andreals,ragnaros,1211,rogue,assassination,24,14,10
43675,Riggie,turalyon,1202,rogue,assassination,35,17,18
43676,Dismayx,tichondrius,1198,rogue,assassination,47,20,27
43677,Zxytox,hyjal,1191,rogue,assassination,33,17,16
43678,Jeshka,wyrmrest-accord,1189,rogue,assassination,42,20,22
43679,Lórdx,illidan,1189,rogue,assassination,56,25,31
43680,Xhau,moon-guard,1186,rogue,assassination,81,43,38
43681,Betakong,quelthalas,1180,rogue,assassination,30,15,15
43682,Stepic,illidan,1177,rogue,assassination,65,30,35
43683,Fakie,quelthalas,1176,rogue,assassination,37,21,16
43684,Kriszov,moon-guard,1174,rogue,assassination,154,78,76
43685,Rodanheim,burning-blade,1167,rogue,assassination,90,44,46
43686,Mìtsuru,proudmoore,1165,rogue,assassination,36,20,16
43687,Lycanthropì,illidan,1151,rogue,assassination,18,12,6
43688,Peaches,akama,1151,rogue,assassination,24,12,12
43689,Gùderman,tichondrius,1150,rogue,assassination,18,12,6
43690,Lesentixd,stormrage,1149,rogue,assassination,30,12,18
43691,Slycndice,tortheldrin,1148,rogue,assassination,78,45,33
43692,Odetodindel,nerzhul,1146,rogue,assassination,60,32,28
43693,Sergioz,quelthalas,1144,rogue,assassination,62,27,35
43694,Vindzl,azralon,1139,rogue,assassination,36,12,24
43695,Ixìa,vashj,1135,rogue,assassination,30,12,18
43696,Chingado,kaelthas,1132,rogue,assassination,64,27,37
43697,Peeryl,daggerspine,1129,rogue,assassination,130,74,56
43698,Ràinê,dalaran,1128,rogue,assassination,24,13,11
43699,Spooky,bleeding-hollow,1128,rogue,assassination,112,50,62
43700,Sgnome,quelthalas,1128,rogue,assassination,30,12,18
43701,Lakki,chromaggus,1127,rogue,assassination,30,12,18
43702,Eldan,moon-guard,1121,rogue,assassination,66,24,42
43703,Dothras,stormrage,1119,rogue,assassination,87,43,44
43704,Shivsac,tichondrius,1117,rogue,assassination,47,20,27
43705,Morgoophh,azralon,1116,rogue,assassination,216,110,106
43706,Indivisible,thunderlord,1115,rogue,assassination,102,51,51
43707,Sinnister,queldorei,1110,rogue,assassination,65,24,41
43708,Copler,tichondrius,1110,rogue,assassination,48,17,31
43709,Roguepvp,stormrage,1108,rogue,assassination,64,35,29
43710,Nikhlaus,ragnaros,1107,rogue,assassination,24,13,11
43711,Altarys,ragnaros,1103,rogue,assassination,27,15,12
43712,Respia,proudmoore,1103,rogue,assassination,40,16,24
43713,Dysxliec,dalaran,1101,rogue,assassination,35,12,23
43714,Esraxo,frostmourne,1100,rogue,assassination,20,13,7
43715,Velsad,sargeras,1093,rogue,assassination,35,14,21
43716,Smoketoad,tichondrius,1081,rogue,assassination,30,15,15
43717,Venefix,windrunner,1080,rogue,assassination,34,16,18
43718,Osiriko,thunderlord,1061,rogue,assassination,114,61,53
43719,Cashbigknife,area-52,1061,rogue,assassination,70,28,42
43720,Aiden,burning-legion,1056,rogue,assassination,18,11,7
43721,Ratlips,zuljin,1056,rogue,assassination,22,12,10
43722,Frez,amanthul,1056,rogue,assassination,30,11,19
43723,Vaporwavey,frostmourne,1055,rogue,assassination,18,11,7
43724,Ziggee,sargeras,1055,rogue,assassination,50,25,25
43725,Djfortníte,tichondrius,1055,rogue,assassination,24,11,13
43726,Grafting,tichondrius,1055,rogue,assassination,24,11,13
43727,Zipperx,tichondrius,1053,rogue,assassination,30,11,19
43728,Stuns,azshara,1052,rogue,assassination,18,11,7
43729,Effikacy,uldum,1051,rogue,assassination,24,11,13
43730,Shigoo,sargeras,1051,rogue,assassination,24,11,13
43731,Lefthook,kelthuzad,1051,rogue,assassination,37,15,22
43732,Swingonya,stormrage,1051,rogue,assassination,30,11,19
43733,Kazzo,tichondrius,1050,rogue,assassination,18,11,7
43734,Lancin,azjolnerub,1050,rogue,assassination,24,11,13
43735,Adrianstab,dalaran,1049,rogue,assassination,77,39,38
43736,Roguecity,tichondrius,1048,rogue,assassination,193,85,108
43737,Dochap,blackrock,1047,rogue,assassination,86,38,48
43738,Sinistro,bleeding-hollow,1046,rogue,assassination,30,14,16
43739,Tortador,quelthalas,1044,rogue,assassination,68,32,36
43740,Looprevil,andorhal,1043,rogue,assassination,24,14,10
43741,Caydeseis,stormrage,1031,rogue,assassination,18,11,7
43742,Ñovä,tichondrius,1030,rogue,assassination,30,16,14
43743,Cripstaet,spinebreaker,1029,rogue,assassination,25,12,13
43744,Cjayy,bleeding-hollow,1028,rogue,assassination,37,13,24
43745,Brobrando,tichondrius,1026,rogue,assassination,24,11,13
43746,Deathshadow,dethecus,1025,rogue,assassination,30,11,19
43747,Oddblade,stormrage,1025,rogue,assassination,36,11,25
43748,Vastørogue,azralon,1017,rogue,assassination,61,31,30
43749,Skigskag,shadowsong,1017,rogue,assassination,157,76,81
43750,Snoopdrogado,sargeras,1010,rogue,assassination,52,27,25
43751,Gygáx,terenas,1009,rogue,assassination,66,36,30
43752,Poisønous,tichondrius,1004,rogue,assassination,21,11,10
43753,Elithr,nemesis,1002,rogue,assassination,24,11,13
43754,Edvardd,moon-guard,1001,rogue,assassination,39,20,19
43755,Escape,elune,1001,rogue,assassination,30,14,16
43756,Sheinnér,ragnaros,999,rogue,assassination,49,21,28
43757,Artymesia,medivh,988,rogue,assassination,30,15,15
43758,Feote,ragnaros,986,rogue,assassination,18,12,6
43759,Karing,onyxia,977,rogue,assassination,22,11,11
43760,Pegglerogue,fizzcrank,977,rogue,assassination,84,37,47
43761,Wolgan,nemesis,975,rogue,assassination,61,30,31
43762,Gersonq,moon-guard,965,rogue,assassination,25,13,12
43763,Daggerback,bleeding-hollow,963,rogue,assassination,41,22,19
43764,Loligotyou,stormrage,962,rogue,assassination,64,20,44
43765,Jonuts,bleeding-hollow,960,rogue,assassination,18,10,8
43766,Lakeshark,tichondrius,960,rogue,assassination,18,10,8
43767,Gogothirteen,kiljaeden,960,rogue,assassination,32,15,17
43768,Dizzymoods,stormrage,960,rogue,assassination,24,10,14
43769,Kents,tichondrius,960,rogue,assassination,24,10,14
43770,Synixi,moon-guard,960,rogue,assassination,24,10,14
43771,Nikjawar,illidan,959,rogue,assassination,24,11,13
43772,Downsix,sargeras,959,rogue,assassination,24,10,14
43773,Jxxs,zuljin,959,rogue,assassination,24,10,14
43774,Cerut,illidan,957,rogue,assassination,18,10,8
43775,Combo,norgannon,956,rogue,assassination,24,10,14
43776,Tri,the-underbog,956,rogue,assassination,30,10,20
43777,Average,burning-blade,954,rogue,assassination,27,10,17
43778,Snuzzy,darkspear,954,rogue,assassination,36,10,26
43779,Sangreale,nemesis,953,rogue,assassination,18,10,8
43780,Dockside,stormrage,953,rogue,assassination,18,10,8
43781,Swiftbones,burning-blade,952,rogue,assassination,24,12,12
43782,Arlom,daggerspine,951,rogue,assassination,18,10,8
43783,Wolfsire,queldorei,949,rogue,assassination,24,10,14
43784,Problemchild,rexxar,949,rogue,assassination,24,10,14
43785,Vozzy,proudmoore,947,rogue,assassination,30,17,13
43786,Lilgoosie,korgath,947,rogue,assassination,66,25,41
43787,Xalsathoth,sargeras,946,rogue,assassination,36,10,26
43788,Hattrìck,area-52,943,rogue,assassination,30,10,20
43789,Kuntyou,barthilas,941,rogue,assassination,36,10,26
43790,Headless,dragonmaw,934,rogue,assassination,76,38,38
43791,Atomicgoat,tichondrius,928,rogue,assassination,33,12,21
43792,Euweu,azralon,914,rogue,assassination,24,10,14
43793,Pantypeelz,frostmourne,907,rogue,assassination,29,10,19
43794,Requiescat,bleeding-hollow,902,rogue,assassination,27,10,17
43795,Thenelis,dalaran,897,rogue,assassination,43,10,33
43796,Cryptixx,blades-edge,896,rogue,assassination,41,16,25
43797,Orcwarhammer,tichondrius,886,rogue,assassination,18,10,8
43798,Emrogue,ragnaros,876,rogue,assassination,30,15,15
43799,Turyx,azralon,871,rogue,assassination,90,28,62
43800,Unlucký,sargeras,864,rogue,assassination,12,9,3
43801,Ka,blackhand,864,rogue,assassination,12,9,3
43802,Endworldlife,stormrage,864,rogue,assassination,12,9,3
43803,Chizza,frostmourne,864,rogue,assassination,18,10,8
43804,Cmòón,tichondrius,864,rogue,assassination,18,9,9
43805,Dabrat,frostwolf,864,rogue,assassination,84,36,48
43806,Ahjii,malganis,864,rogue,assassination,30,9,21
43807,Aah,doomhammer,863,rogue,assassination,12,9,3
43808,Dezly,tichondrius,863,rogue,assassination,18,9,9
43809,Entropyphi,daggerspine,863,rogue,assassination,24,9,15
43810,Whoox,khazgoroth,863,rogue,assassination,30,9,21
43811,Mcskipa,sargeras,862,rogue,assassination,12,9,3
43812,Criptoniø,azralon,862,rogue,assassination,52,24,28
43813,Darkdessoft,ragnaros,861,rogue,assassination,24,9,15
43814,Moardner,dalaran,860,rogue,assassination,84,30,54
43815,Ballflicker,malganis,857,rogue,assassination,30,9,21
43816,Shumira,tichondrius,856,rogue,assassination,18,9,9
43817,Wreatus,moon-guard,853,rogue,assassination,108,44,64
43818,Teach,illidan,849,rogue,assassination,102,37,65
43819,Alkal,stormreaver,846,rogue,assassination,32,14,18
43820,Pokiri,wyrmrest-accord,845,rogue,assassination,30,9,21
43821,Thontz,sargeras,843,rogue,assassination,18,9,9
43822,Lanottee,sargeras,829,rogue,assassination,17,10,7
43823,Ripsaw,muradin,829,rogue,assassination,18,9,9
43824,Píxíedúst,black-dragonflight,812,rogue,assassination,34,10,24
43825,Chersy,tichondrius,810,rogue,assassination,32,10,22
43826,Zamorant,emerald-dream,806,rogue,assassination,53,11,42
43827,Zapersapp,malygos,803,rogue,assassination,28,10,18
43828,Luckycrit,frostwolf,788,rogue,assassination,36,14,22
43829,Ôñéèýèdkíñg,stormrage,768,rogue,assassination,12,8,4
43830,Elsegador,tichondrius,768,rogue,assassination,12,8,4
43831,Clairered,tichondrius,768,rogue,assassination,18,8,10
43832,Drakariano,ragnaros,768,rogue,assassination,18,8,10
43833,Macsap,frostmourne,768,rogue,assassination,18,8,10
43834,Snakegødx,sargeras,768,rogue,assassination,21,9,12
43835,Kdrx,thrall,768,rogue,assassination,24,8,16
43836,Atulano,wyrmrest-accord,768,rogue,assassination,24,8,16
43837,Pike,barthilas,767,rogue,assassination,12,8,4
43838,Exeg,tichondrius,767,rogue,assassination,12,8,4
43839,Warmode,zuluhed,767,rogue,assassination,12,8,4
43840,Gøblìn,stormrage,767,rogue,assassination,15,9,6
43841,Zetéra,ragnaros,767,rogue,assassination,18,8,10
43842,Kágé,ragnaros,767,rogue,assassination,18,8,10
43843,Gilbertgr,boulderfist,767,rogue,assassination,18,8,10
43844,Sagatha,bleeding-hollow,767,rogue,assassination,18,8,10
43845,Shiddlesz,area-52,767,rogue,assassination,18,8,10
43846,Drtypzzaknfe,kelthuzad,767,rogue,assassination,24,8,16
43847,Xshadowt,ragnaros,767,rogue,assassination,24,8,16
43848,Frëdlock,kelthuzad,767,rogue,assassination,24,8,16
43849,Sindor,azralon,767,rogue,assassination,30,8,22
43850,Mylovejunex,tichondrius,766,rogue,assassination,12,8,4
43851,ßackshots,kelthuzad,766,rogue,assassination,18,8,10
43852,Gábagool,kiljaeden,766,rogue,assassination,24,8,16
43853,Manersi,akama,764,rogue,assassination,24,8,16
43854,Ðisappéar,ragnaros,764,rogue,assassination,33,9,24
43855,Picaroxp,drakkari,762,rogue,assassination,12,8,4
43856,Skîttlês,kul-tiras,762,rogue,assassination,18,8,10
43857,Zropi,quelthalas,762,rogue,assassination,24,8,16
43858,Slashinsteev,dalaran,761,rogue,assassination,18,8,10
43859,Pikacuulo,ragnaros,760,rogue,assassination,31,9,22
43860,Pusufox,tichondrius,759,rogue,assassination,18,8,10
43861,Roguetwo,the-venture-co,758,rogue,assassination,12,8,4
43862,Núm,tichondrius,756,rogue,assassination,32,12,20
43863,Jaggeddagger,darrowmere,756,rogue,assassination,30,8,22
43864,Snoor,nemesis,753,rogue,assassination,21,9,12
43865,Killua,dalaran,752,rogue,assassination,18,8,10
43866,Anyiele,stormrage,747,rogue,assassination,18,8,10
43867,Vandalyze,sargeras,732,rogue,assassination,17,8,9
43868,Savagedeeps,stormreaver,730,rogue,assassination,18,8,10
43869,Sneakyfoot,gorgonnash,723,rogue,assassination,47,12,35
43870,Slickdude,stormrage,717,rogue,assassination,66,14,52
43871,Cruelworld,stormrage,713,rogue,assassination,30,10,20
43872,Snub,aerie-peak,713,rogue,assassination,28,8,20
43873,Cox,bleeding-hollow,708,rogue,assassination,14,10,4
43874,Ghoulzer,tichondrius,704,rogue,assassination,10,8,2
43875,Superharry,tichondrius,702,rogue,assassination,22,8,14
43876,Chriseanrock,illidan,672,rogue,assassination,12,7,5
43877,Skitsöu,tichondrius,672,rogue,assassination,12,7,5
43878,Sotypical,area-52,672,rogue,assassination,12,7,5
43879,Dzd,stormrage,672,rogue,assassination,12,7,5
43880,Carcass,moon-guard,672,rogue,assassination,12,7,5
43881,Toxicplyer,malganis,672,rogue,assassination,12,7,5
43882,Zunwick,tichondrius,672,rogue,assassination,12,7,5
43883,Lxw,frostmourne,672,rogue,assassination,12,7,5
43884,Zaszune,stormrage,672,rogue,assassination,18,7,11
43885,Elwynë,tichondrius,672,rogue,assassination,18,7,11
43886,Twoheaded,frostmourne,672,rogue,assassination,18,7,11
43887,Nogodplsno,stormrage,672,rogue,assassination,18,7,11
43888,Mydearest,tichondrius,672,rogue,assassination,18,7,11
43889,Slizard,boulderfist,671,rogue,assassination,12,7,5
43890,Mcstabbface,tichondrius,671,rogue,assassination,12,7,5
43891,Deepman,gorefiend,671,rogue,assassination,12,7,5
43892,Løgîc,tichondrius,671,rogue,assassination,12,7,5
43893,Jackbuster,area-52,671,rogue,assassination,12,7,5
43894,Alithileria,moon-guard,671,rogue,assassination,12,7,5
43895,Alizashea,stormrage,671,rogue,assassination,12,7,5
43896,Gucciboo,sargeras,671,rogue,assassination,18,7,11
43897,Johnthefum,malganis,671,rogue,assassination,18,7,11
43898,Ezzdeath,tichondrius,671,rogue,assassination,18,7,11
43899,Spectremg,azralon,671,rogue,assassination,18,7,11
43900,Showclass,stormrage,671,rogue,assassination,18,7,11
43901,Mhortai,stormrage,671,rogue,assassination,18,7,11
43902,Mõtaru,stormrage,671,rogue,assassination,24,7,17
43903,Vhiper,azralon,671,rogue,assassination,24,7,17
43904,Mayyhem,caelestrasz,671,rogue,assassination,24,7,17
43905,Tìnkerton,wyrmrest-accord,671,rogue,assassination,24,7,17
43906,Habock,ragnaros,670,rogue,assassination,17,7,10
43907,Sap,garrosh,670,rogue,assassination,18,7,11
43908,Xhampu,ragnaros,670,rogue,assassination,18,7,11
43909,Çrëeper,illidan,670,rogue,assassination,24,7,17
43910,Anyiel,stormrage,670,rogue,assassination,24,7,17
43911,Heimlichkeit,tichondrius,669,rogue,assassination,18,7,11
43912,Trebyoyoyo,haomarush,669,rogue,assassination,24,7,17
43913,Sneakynight,bleeding-hollow,668,rogue,assassination,18,7,11
43914,Jakkov,blackrock,666,rogue,assassination,18,7,11
43915,Diamondiâ,moon-guard,666,rogue,assassination,30,7,23
43916,Kiorz,tichondrius,665,rogue,assassination,12,7,5
43917,Soupspoon,terenas,664,rogue,assassination,18,7,11
43918,Bityellow,tichondrius,663,rogue,assassination,12,7,5
43919,Slootslayer,azshara,662,rogue,assassination,18,7,11
43920,Muffens,alterac-mountains,662,rogue,assassination,18,7,11
43921,Vladtsepesh,stormrage,662,rogue,assassination,30,7,23
43922,Tralisong,azshara,660,rogue,assassination,18,7,11
43923,Duonati,stormreaver,650,rogue,assassination,18,7,11
43924,Irunaway,thrall,639,rogue,assassination,17,7,10
43925,Tiptoez,bleeding-hollow,637,rogue,assassination,18,8,10
43926,Dragoonz,nemesis,637,rogue,assassination,23,7,16
43927,Runakó,kelthuzad,623,rogue,assassination,11,7,4
43928,Thoxic,barthilas,620,rogue,assassination,17,7,10
43929,Pochomän,ragnaros,618,rogue,assassination,16,9,7
43930,Onulyo,tichondrius,618,rogue,assassination,16,8,8
43931,Passoafaca,azralon,616,rogue,assassination,26,8,18
43932,Roguebasic,frostmourne,612,rogue,assassination,24,8,16
43933,Lethun,zuljin,607,rogue,assassination,14,7,7
43934,Geratyere,trollbane,590,rogue,assassination,19,7,12
43935,Kayriss,antonidas,576,rogue,assassination,12,6,6
43936,Luriél,stormrage,576,rogue,assassination,12,6,6
43937,Zareys,malorne,576,rogue,assassination,12,6,6
43938,Saltoss,frostmourne,576,rogue,assassination,12,6,6
43939,Chipetan,hyjal,576,rogue,assassination,12,6,6
43940,Bloodygoat,area-52,576,rogue,assassination,12,6,6
43941,Lsdlover,tichondrius,576,rogue,assassination,12,6,6
43942,Nicknasty,kelthuzad,576,rogue,assassination,12,6,6
43943,Dylan,frostmourne,576,rogue,assassination,12,6,6
43944,Jaywas,tichondrius,576,rogue,assassination,12,6,6
43945,Arcess,ragnaros,576,rogue,assassination,12,6,6
43946,Lgy,chogall,576,rogue,assassination,12,6,6
43947,Movze,area-52,576,rogue,assassination,12,6,6
43948,Smum,tichondrius,576,rogue,assassination,12,6,6
43949,Revlul,darkspear,576,rogue,assassination,12,6,6
43950,Mosedz,tichondrius,576,rogue,assassination,12,6,6
43951,Daggerthorne,sargeras,576,rogue,assassination,18,6,12
43952,Slipperydog,jubeithos,576,rogue,assassination,18,6,12
43953,Ahji,malganis,576,rogue,assassination,18,6,12
43954,Çõvìd,malganis,576,rogue,assassination,30,6,24
43955,Vayllie,zuljin,575,rogue,assassination,12,6,6
43956,Blaçkout,thrall,575,rogue,assassination,12,6,6
43957,Paradias,moonrunner,575,rogue,assassination,12,6,6
43958,Robinsony,tichondrius,575,rogue,assassination,12,6,6
43959,Alavennian,tichondrius,575,rogue,assassination,12,6,6
43960,Ethaniel,bronzebeard,575,rogue,assassination,15,6,9
43961,Slain,dark-iron,575,rogue,assassination,15,6,9
43962,Miloandotis,malganis,575,rogue,assassination,18,6,12
43963,Hoochzors,deathwing,575,rogue,assassination,18,6,12
43964,Goutetsu,area-52,575,rogue,assassination,24,6,18
43965,Aurrora,kiljaeden,574,rogue,assassination,17,6,11
43966,Mcvillain,kelthuzad,573,rogue,assassination,12,6,6
43967,Vegettaa,azralon,573,rogue,assassination,18,6,12
43968,Yslkyle,skullcrusher,572,rogue,assassination,12,6,6
43969,Akalio,laughing-skull,571,rogue,assassination,18,6,12
43970,Addvilpm,wyrmrest-accord,570,rogue,assassination,12,6,6
43971,Annastasiya,moon-guard,568,rogue,assassination,18,6,12
43972,Vitalz,bloodscalp,568,rogue,assassination,18,6,12
43973,Nektulos,illidan,566,rogue,assassination,13,6,7
43974,Hellwolf,azgalor,565,rogue,assassination,13,6,7
43975,Drpepzi,tichondrius,565,rogue,assassination,24,6,18
43976,Stabsizzle,tichondrius,558,rogue,assassination,23,6,17
43977,Julius,malganis,543,rogue,assassination,14,7,7
43978,Lvx,frostmourne,528,rogue,assassination,9,6,3
43979,Genève,dreadmaul,526,rogue,assassination,11,6,5
43980,Redspoison,dalaran,512,rogue,assassination,10,6,4
43981,Sìcarìus,tichondrius,512,rogue,assassination,22,6,16
43982,Offlinepk,area-52,511,rogue,assassination,12,7,5
43983,Cassini,gorefiend,488,rogue,assassination,21,8,13
43984,Purcius,moon-guard,480,rogue,assassination,6,5,1
43985,Macabre,the-forgotten-coast,480,rogue,assassination,6,5,1
43986,Bigchimpin,frostmourne,480,rogue,assassination,6,5,1
43987,Pwnsauce,frostmourne,480,rogue,assassination,7,5,2
43988,Carnagê,zuljin,480,rogue,assassination,11,5,6
43989,Tberg,emerald-dream,480,rogue,assassination,12,5,7
43990,Fuzzyslow,stormrage,480,rogue,assassination,12,5,7
43991,Váléntíná,tichondrius,480,rogue,assassination,12,5,7
43992,Jezus,ghostlands,480,rogue,assassination,12,5,7
43993,Bleedzbuttah,proudmoore,480,rogue,assassination,12,5,7
43994,Toxan,emerald-dream,480,rogue,assassination,12,5,7
43995,Sonymf,frostmourne,480,rogue,assassination,12,5,7
43996,Gomma,stormrage,480,rogue,assassination,12,5,7
43997,Outsap,tichondrius,480,rogue,assassination,12,5,7
43998,Mercenàrioh,azralon,480,rogue,assassination,12,5,7
43999,Vlayd,ragnaros,480,rogue,assassination,12,5,7
44000,Bloore,fizzcrank,480,rogue,assassination,12,5,7
44001,Roguespawn,dark-iron,480,rogue,assassination,12,5,7
44002,Surprises,azralon,480,rogue,assassination,12,5,7
44003,Cintan,barthilas,480,rogue,assassination,12,5,7
44004,Akayod,tichondrius,480,rogue,assassination,12,5,7
44005,Ppdx,malganis,480,rogue,assassination,12,5,7
44006,Breakxcvii,bleeding-hollow,480,rogue,assassination,12,5,7
44007,Venomsnáke,tichondrius,480,rogue,assassination,12,5,7
44008,Dtelkham,tichondrius,480,rogue,assassination,16,6,10
44009,Yellowdawt,stormrage,480,rogue,assassination,18,5,13
44010,Csguixuan,aerie-peak,480,rogue,assassination,18,5,13
44011,Xm,sargeras,480,rogue,assassination,18,5,13
44012,Limitbreakkz,tichondrius,480,rogue,assassination,18,5,13
44013,Paradise,smolderthorn,479,rogue,assassination,6,5,1
44014,Beartøøth,stormrage,479,rogue,assassination,6,5,1
44015,Dessenia,illidan,479,rogue,assassination,12,5,7
44016,Møfshanks,sargeras,479,rogue,assassination,12,5,7
44017,Scarrog,wyrmrest-accord,479,rogue,assassination,12,5,7
44018,Slayersama,ragnaros,479,rogue,assassination,12,5,7
44019,Meilh,emerald-dream,479,rogue,assassination,12,5,7
44020,Poofhottie,lightbringer,479,rogue,assassination,12,5,7
44021,Bigcolumn,tichondrius,479,rogue,assassination,12,5,7
44022,Mashad,moon-guard,479,rogue,assassination,12,5,7
44023,Prinseraegar,tichondrius,479,rogue,assassination,12,5,7
44024,Vore,elune,479,rogue,assassination,12,5,7
44025,Teeice,bladefist,479,rogue,assassination,12,5,7
44026,Cynalia,sargeras,479,rogue,assassination,15,5,10
44027,Rinestiria,arthas,479,rogue,assassination,18,5,13
44028,Bonzaipopo,stormrage,479,rogue,assassination,18,5,13
44029,Maison,ragnaros,478,rogue,assassination,12,5,7
44030,Bonizzi,stormrage,478,rogue,assassination,12,5,7
44031,Villainrogue,stormrage,478,rogue,assassination,12,5,7
44032,Lethalist,whisperwind,476,rogue,assassination,12,5,7
44033,Adysius,malganis,475,rogue,assassination,12,5,7
44034,Wìndrunner,dalaran,474,rogue,assassination,12,5,7
44035,Gurreth,zuljin,473,rogue,assassination,12,5,7
44036,Killdead,warsong,473,rogue,assassination,12,5,7
44037,Roadog,azralon,472,rogue,assassination,18,5,13
44038,Donamarillo,sargeras,462,rogue,assassination,11,5,6
44039,Gnaark,bleeding-hollow,447,rogue,assassination,11,5,6
44040,Shizz,tichondrius,447,rogue,assassination,14,6,8
44041,Twinkasz,nemesis,425,rogue,assassination,16,6,10
44042,Elixera,sargeras,425,rogue,assassination,16,6,10
44043,Minnicent,amanthul,413,rogue,assassination,10,5,5
44044,Taessin,kelthuzad,384,rogue,assassination,6,4,2
44045,Grima,azralon,384,rogue,assassination,6,4,2
44046,Ballchinian,tichondrius,384,rogue,assassination,6,4,2
44047,Endworldlife,tichondrius,384,rogue,assassination,6,4,2
44048,Buckbreaker,stormrage,384,rogue,assassination,6,4,2
44049,Vinrhayle,sargeras,384,rogue,assassination,6,4,2
44050,Silentzero,quelthalas,384,rogue,assassination,6,4,2
44051,Bungkhole,kiljaeden,384,rogue,assassination,6,4,2
44052,Yurkarogue,tichondrius,384,rogue,assassination,6,4,2
44053,Zervá,dalaran,384,rogue,assassination,6,4,2
44054,Fofree,hyjal,384,rogue,assassination,6,4,2
44055,Shaisty,malganis,384,rogue,assassination,6,4,2
44056,Chokonet,gurubashi,384,rogue,assassination,6,4,2
44057,Schleazy,emerald-dream,384,rogue,assassination,6,4,2
44058,Hollowtipzz,tichondrius,384,rogue,assassination,6,4,2
44059,Colom,moon-guard,384,rogue,assassination,6,4,2
44060,Tmpikaboo,tichondrius,384,rogue,assassination,6,4,2
44061,Nigthdead,nemesis,384,rogue,assassination,6,4,2
44062,Gaige,muradin,384,rogue,assassination,6,4,2
44063,Bootiebandit,tichondrius,384,rogue,assassination,6,4,2
44064,Ikerz,tichondrius,384,rogue,assassination,9,4,5
44065,Mirâge,illidan,384,rogue,assassination,12,4,8
44066,Hirian,misha,384,rogue,assassination,12,4,8
44067,Shadøw,the-forgotten-coast,384,rogue,assassination,12,4,8
44068,Cryoph,illidan,384,rogue,assassination,12,4,8
44069,Eski,kul-tiras,384,rogue,assassination,12,4,8
44070,Muwop,barthilas,384,rogue,assassination,12,4,8
44071,Stabbyboy,malganis,384,rogue,assassination,12,4,8
44072,Ninjamf,bleeding-hollow,384,rogue,assassination,12,4,8
44073,Gridisx,wyrmrest-accord,384,rogue,assassination,12,4,8
44074,Streetjudas,barthilas,384,rogue,assassination,12,4,8
44075,Ròry,dark-iron,384,rogue,assassination,12,4,8
44076,Kargargar,thrall,384,rogue,assassination,12,4,8
44077,Wowslayer,bleeding-hollow,384,rogue,assassination,12,4,8
44078,Señorcheddar,thrall,384,rogue,assassination,12,4,8
44079,Bu,zuljin,384,rogue,assassination,12,4,8
44080,Kehkoa,thrall,384,rogue,assassination,12,4,8
44081,Akhila,stormrage,384,rogue,assassination,12,4,8
44082,Mansa,zangarmarsh,384,rogue,assassination,12,4,8
44083,Poonaniqt,gundrak,384,rogue,assassination,12,4,8
44084,Sillikitti,tichondrius,384,rogue,assassination,12,4,8
44085,Psilocin,sargeras,384,rogue,assassination,12,4,8
44086,Sellers,tichondrius,384,rogue,assassination,12,4,8
44087,Aygon,laughing-skull,384,rogue,assassination,12,4,8
44088,Deepsyo,frostmourne,384,rogue,assassination,12,4,8
44089,Inunofun,stormrage,384,rogue,assassination,12,4,8
44090,Cv,proudmoore,384,rogue,assassination,12,4,8
44091,Celèphaïs,tichondrius,384,rogue,assassination,12,4,8
44092,Denoms,area-52,384,rogue,assassination,18,4,14
44093,Ssigma,tichondrius,384,rogue,assassination,18,4,14
44094,Skinnymayne,laughing-skull,384,rogue,assassination,18,4,14
44095,Escurecer,azralon,384,rogue,assassination,18,4,14
44096,Azrek,sargeras,384,rogue,assassination,18,4,14
44097,Gladlol,stormrage,384,rogue,assassination,18,4,14
44098,Ggassasin,tichondrius,384,rogue,assassination,18,4,14
44099,Wikkihx,emerald-dream,384,rogue,assassination,24,4,20
44100,Vanishman,ragnaros,383,rogue,assassination,6,4,2
44101,Eversincee,illidan,383,rogue,assassination,6,4,2
44102,Jestertyv,hyjal,383,rogue,assassination,12,4,8
44103,Ñinjå,alleria,383,rogue,assassination,12,4,8
44104,Corteleve,nemesis,383,rogue,assassination,12,4,8
44105,Sapstabdead,blackrock,383,rogue,assassination,12,4,8
44106,Steeldiesel,sargeras,383,rogue,assassination,12,4,8
44107,Moiatropos,ragnaros,383,rogue,assassination,12,4,8
44108,Setsu,sargeras,383,rogue,assassination,13,4,9
44109,Wrinklevoss,proudmoore,382,rogue,assassination,12,4,8
44110,Kalandar,moon-guard,382,rogue,assassination,12,4,8
44111,Hésta,moon-guard,382,rogue,assassination,12,4,8
44112,Slobernocker,stormrage,381,rogue,assassination,12,4,8
44113,Fllokii,arygos,381,rogue,assassination,12,4,8
44114,Ðerpius,proudmoore,381,rogue,assassination,12,4,8
44115,Revozy,azralon,381,rogue,assassination,12,4,8
44116,Tolthe,hyjal,351,rogue,assassination,11,4,7
44117,Atrreyu,lightninghoof,350,rogue,assassination,11,4,7
44118,Siniel,scarlet-crusade,336,rogue,assassination,9,4,5
44119,Griefs,tichondrius,330,rogue,assassination,17,5,12
44120,Coopi,tichondrius,320,rogue,assassination,10,4,6
44121,Whatsåpp,gallywix,320,rogue,assassination,10,4,6
44122,Streetjesuz,barthilas,320,rogue,assassination,10,4,6
44123,Pícáróóná,ragnaros,320,rogue,assassination,16,4,12
44124,Suffêr,dalaran,319,rogue,assassination,8,4,4
44125,Ziedrich,frostmourne,318,rogue,assassination,10,4,6
44126,Mügi,ragnaros,288,rogue,assassination,6,3,3
44127,Traviisto,sargeras,288,rogue,assassination,6,3,3
44128,Punkyass,azralon,288,rogue,assassination,6,3,3
44129,Jannie,rexxar,288,rogue,assassination,6,3,3
44130,Greasybbsea,illidan,288,rogue,assassination,6,3,3
44131,Ieu,tichondrius,288,rogue,assassination,6,3,3
44132,Bledstepelin,frostmourne,288,rogue,assassination,6,3,3
44133,Dïeb,zuljin,288,rogue,assassination,6,3,3
44134,Saltypwncake,illidan,288,rogue,assassination,6,3,3
44135,Shímira,azralon,288,rogue,assassination,6,3,3
44136,Worrglaive,dalaran,288,rogue,assassination,6,3,3
44137,Anímosity,darkspear,288,rogue,assassination,6,3,3
44138,Maciota,area-52,288,rogue,assassination,6,3,3
44139,Prodixybn,illidan,288,rogue,assassination,6,3,3
44140,Mcjagerx,darkspear,288,rogue,assassination,6,3,3
44141,Gbg,arathor,288,rogue,assassination,6,3,3
44142,Thâïßòÿgøóñ,jubeithos,288,rogue,assassination,6,3,3
44143,Deeshdosh,illidan,288,rogue,assassination,6,3,3
44144,Syxs,sargeras,288,rogue,assassination,6,3,3
44145,Corrier,tichondrius,288,rogue,assassination,6,3,3
44146,Usernameqtxo,kelthuzad,288,rogue,assassination,6,3,3
44147,Yggskuggi,moon-guard,288,rogue,assassination,6,3,3
44148,Rýuu,bleeding-hollow,288,rogue,assassination,6,3,3
44149,Brlsels,azralon,288,rogue,assassination,6,3,3
44150,Ubun,quelthalas,288,rogue,assassination,6,3,3
44151,Mgv,aegwynn,288,rogue,assassination,6,3,3
44152,Shninzy,stormrage,288,rogue,assassination,6,3,3
44153,Vahrheit,tichondrius,288,rogue,assassination,6,3,3
44154,Cron,arygos,288,rogue,assassination,6,3,3
44155,Chickfilaye,auchindoun,288,rogue,assassination,6,3,3
44156,Calebrogue,illidan,288,rogue,assassination,6,3,3
44157,Gutshøt,tichondrius,288,rogue,assassination,6,3,3
44158,Steffmaister,tichondrius,288,rogue,assassination,6,3,3
44159,Dannodan,proudmoore,288,rogue,assassination,6,3,3
44160,Bigtengu,tichondrius,288,rogue,assassination,6,3,3
44161,Ncb,bleeding-hollow,288,rogue,assassination,6,3,3
44162,Pantsed,sargeras,288,rogue,assassination,6,3,3
44163,Åmg,tichondrius,288,rogue,assassination,6,3,3
44164,Drapezz,kelthuzad,288,rogue,assassination,6,3,3
44165,Wowamaze,aegwynn,288,rogue,assassination,6,3,3
44166,Pikabuu,bleeding-hollow,288,rogue,assassination,6,3,3
44167,Crohnns,barthilas,288,rogue,assassination,6,3,3
44168,Bigheadtony,hellscream,288,rogue,assassination,6,3,3
44169,Emvee,kelthuzad,288,rogue,assassination,6,3,3
44170,Kurosh,kalecgos,288,rogue,assassination,6,3,3
44171,Velandros,eonar,288,rogue,assassination,6,3,3
44172,Gulvzer,tichondrius,288,rogue,assassination,6,3,3
44173,Redlïne,tichondrius,288,rogue,assassination,12,3,9
44174,Knav,destromath,288,rogue,assassination,12,3,9
44175,Brianä,quelthalas,288,rogue,assassination,12,3,9
44176,Shortcut,khadgar,288,rogue,assassination,12,3,9
44177,Tattoo,zuljin,288,rogue,assassination,12,3,9
44178,Benielfman,illidan,288,rogue,assassination,12,3,9
44179,Cydonian,ragnaros,288,rogue,assassination,12,3,9
44180,Brudashmurda,tichondrius,288,rogue,assassination,12,3,9
44181,Aevaela,duskwood,288,rogue,assassination,12,3,9
44182,Pezcore,illidan,288,rogue,assassination,12,3,9
44183,Înfêrnô,emerald-dream,288,rogue,assassination,12,3,9
44184,Karmagoodttv,stormrage,288,rogue,assassination,12,3,9
44185,Sunshinezx,frostmourne,288,rogue,assassination,12,3,9
44186,Axm,azralon,288,rogue,assassination,12,3,9
44187,Joeyzord,stormrage,288,rogue,assassination,12,3,9
44188,Rokkhan,blackrock,288,rogue,assassination,12,3,9
44189,Alttee,proudmoore,288,rogue,assassination,12,3,9
44190,Pintofwoc,area-52,288,rogue,assassination,12,3,9
44191,Finlander,area-52,288,rogue,assassination,12,3,9
44192,Tìlt,whisperwind,288,rogue,assassination,12,3,9
44193,Flattsr,tichondrius,288,rogue,assassination,12,3,9
44194,Arïa,drakkari,288,rogue,assassination,12,3,9
44195,Elevorra,frostmourne,288,rogue,assassination,12,3,9
44196,Bubbski,area-52,288,rogue,assassination,12,3,9
44197,Trinktick,doomhammer,288,rogue,assassination,12,3,9
44198,Virez,kelthuzad,288,rogue,assassination,18,3,15
44199,Ereshkigall,ragnaros,288,rogue,assassination,18,3,15
44200,Stunedya,destromath,287,rogue,assassination,6,3,3
44201,Ghutrencha,area-52,287,rogue,assassination,6,3,3
44202,Shadownibba,illidan,287,rogue,assassination,6,3,3
44203,Moridra,demon-soul,287,rogue,assassination,6,3,3
44204,Gilhela,bloodhoof,287,rogue,assassination,6,3,3
44205,Abuse,gundrak,287,rogue,assassination,6,3,3
44206,Clipp,wildhammer,287,rogue,assassination,6,3,3
44207,Loruk,ragnaros,287,rogue,assassination,6,3,3
44208,Chïdaruma,azralon,287,rogue,assassination,12,3,9
44209,Tracemakerr,emerald-dream,287,rogue,assassination,12,3,9
44210,Olg,arathor,287,rogue,assassination,12,3,9
44211,Talinô,moknathal,287,rogue,assassination,12,3,9
44212,Anarusekkusu,wyrmrest-accord,287,rogue,assassination,12,3,9
44213,Lyndra,thunderlord,287,rogue,assassination,12,3,9
44214,Cricketts,kalecgos,287,rogue,assassination,16,3,13
44215,Greekstryker,durotan,286,rogue,assassination,6,3,3
44216,Lupindathird,frostmane,285,rogue,assassination,12,3,9
44217,Clothies,zuljin,285,rogue,assassination,12,3,9
44218,Sanguinnar,nemesis,285,rogue,assassination,12,3,9
44219,Kiddmurphy,sargeras,271,rogue,assassination,11,3,8
44220,Synesh,moon-guard,255,rogue,assassination,11,3,8
44221,Fatass,tichondrius,255,rogue,assassination,11,3,8
44222,Drøverînsane,thrall,239,rogue,assassination,5,3,2
44223,Tamsy,the-forgotten-coast,239,rogue,assassination,5,3,2
44224,Pitfirex,area-52,239,rogue,assassination,5,3,2
44225,Shigoku,tichondrius,239,rogue,assassination,11,3,8
44226,Walnutrog,area-52,234,rogue,assassination,11,5,6
44227,Pãndã,stormrage,234,rogue,assassination,13,4,9
44228,Skairipa,agamaggan,232,rogue,assassination,7,4,3
44229,Estabo,daggerspine,223,rogue,assassination,8,3,5
44230,Borre,kiljaeden,206,rogue,assassination,13,3,10
44231,Roguegirl,alexstrasza,202,rogue,assassination,18,4,14
44232,Ryunøka,quelthalas,192,rogue,assassination,4,3,1
44233,Guazona,stormrage,192,rogue,assassination,6,2,4
44234,Cktko,stormrage,192,rogue,assassination,6,2,4
44235,Gentlesaop,blackrock,192,rogue,assassination,6,2,4
44236,Wildtrick,greymane,192,rogue,assassination,6,2,4
44237,Zogbu,stormrage,192,rogue,assassination,6,2,4
44238,Amysix,antonidas,192,rogue,assassination,6,2,4
44239,Zaozaa,frostmourne,192,rogue,assassination,6,2,4
44240,Itskanashi,frostmourne,192,rogue,assassination,6,2,4
44241,Kazúmi,stormrage,192,rogue,assassination,6,2,4
44242,Militant,tichondrius,192,rogue,assassination,6,2,4
44243,Karlemagne,blackrock,192,rogue,assassination,6,2,4
44244,Apssal,tichondrius,192,rogue,assassination,6,2,4
44245,Letmesap,lothar,192,rogue,assassination,6,2,4
44246,Ilesire,frostmourne,192,rogue,assassination,6,2,4
44247,Støné,azjolnerub,192,rogue,assassination,6,2,4
44248,Kwins,cenarion-circle,192,rogue,assassination,6,2,4
44249,Yanh,tichondrius,192,rogue,assassination,6,2,4
44250,Ýûñí,tichondrius,192,rogue,assassination,6,2,4
44251,Frostheartyy,azralon,192,rogue,assassination,6,2,4
44252,Omnilol,zuljin,192,rogue,assassination,6,2,4
44253,Sneakysharky,frostmourne,192,rogue,assassination,6,2,4
44254,Asyncore,tichondrius,192,rogue,assassination,6,2,4
44255,Swickwockdus,azralon,192,rogue,assassination,6,2,4
44256,Robomom,illidan,192,rogue,assassination,6,2,4
44257,Deathben,tichondrius,192,rogue,assassination,6,2,4
44258,Shini,malganis,192,rogue,assassination,6,2,4
44259,Asneakyfox,thunderlord,192,rogue,assassination,6,2,4
44260,Wyyre,hyjal,192,rogue,assassination,6,2,4
44261,Jpw,barthilas,192,rogue,assassination,6,2,4
44262,Roguemain,smolderthorn,192,rogue,assassination,6,2,4
44263,Wolfmother,nemesis,192,rogue,assassination,6,2,4
44264,Darkfalleng,azralon,192,rogue,assassination,6,2,4
44265,Poolover,barthilas,192,rogue,assassination,6,2,4
44266,Historymaker,tichondrius,192,rogue,assassination,6,2,4
44267,Quickflash,bloodhoof,192,rogue,assassination,6,2,4
44268,Thianir,emerald-dream,192,rogue,assassination,6,2,4
44269,Brand,bonechewer,192,rogue,assassination,6,2,4
44270,Ennmaa,azralon,192,rogue,assassination,6,2,4
44271,Yoodoo,nemesis,192,rogue,assassination,6,2,4
44272,Savyt,dalaran,192,rogue,assassination,6,2,4
44273,Novarra,tichondrius,192,rogue,assassination,6,2,4
44274,Haeqn,nemesis,192,rogue,assassination,6,2,4
44275,Ssjseem,sargeras,192,rogue,assassination,6,2,4
44276,Ryoushei,ragnaros,192,rogue,assassination,6,2,4
44277,Gabrielgray,firetree,192,rogue,assassination,6,2,4
44278,Märlboro,ragnaros,192,rogue,assassination,6,2,4
44279,Soizhiro,ragnaros,192,rogue,assassination,6,2,4
44280,Toestumper,sargeras,192,rogue,assassination,6,2,4
44281,Takeiapika,azralon,192,rogue,assassination,6,2,4
44282,Happyunhappy,illidan,192,rogue,assassination,6,2,4
44283,Ganksterqt,dentarg,192,rogue,assassination,6,2,4
44284,Garatan,nemesis,192,rogue,assassination,6,2,4
44285,Ninja,jubeithos,192,rogue,assassination,6,2,4
44286,Poohkié,malganis,192,rogue,assassination,6,2,4
44287,Tagerung,malganis,192,rogue,assassination,6,2,4
44288,Baalos,medivh,192,rogue,assassination,6,2,4
44289,Vanishcdc,area-52,192,rogue,assassination,6,2,4
44290,Kellthzard,goldrinn,192,rogue,assassination,6,2,4
44291,Karmakula,wildhammer,192,rogue,assassination,6,2,4
44292,Corchô,moon-guard,192,rogue,assassination,6,2,4
44293,Salätzar,quelthalas,192,rogue,assassination,6,2,4
44294,Lesty,kelthuzad,192,rogue,assassination,6,2,4
44295,Miklos,area-52,192,rogue,assassination,6,2,4
44296,Jaanmonty,frostmourne,192,rogue,assassination,6,2,4
44297,Nítzy,quelthalas,192,rogue,assassination,6,2,4
44298,Zenshin,tichondrius,192,rogue,assassination,6,2,4
44299,Ddeadlykiss,hydraxis,192,rogue,assassination,6,2,4
44300,Procz,kirin-tor,192,rogue,assassination,6,2,4
44301,Someone,ravencrest,192,rogue,assassination,6,2,4
44302,Mermm,burning-blade,192,rogue,assassination,6,2,4
44303,Liridor,quelthalas,192,rogue,assassination,11,2,9
44304,Joelpinkelit,illidan,192,rogue,assassination,11,2,9
44305,Youngtugger,daggerspine,192,rogue,assassination,11,2,9
44306,Pleodonis,tichondrius,192,rogue,assassination,12,2,10
44307,Leyff,stormrage,192,rogue,assassination,12,2,10
44308,Aghanaar,burning-legion,192,rogue,assassination,12,2,10
44309,Novocãin,draka,192,rogue,assassination,12,2,10
44310,Slowtime,quelthalas,192,rogue,assassination,12,2,10
44311,Triarc,area-52,192,rogue,assassination,12,2,10
44312,Seltzie,bleeding-hollow,192,rogue,assassination,12,2,10
44313,Stabsmcslice,laughing-skull,192,rogue,assassination,12,2,10
44314,Geradyn,stormrage,192,rogue,assassination,12,2,10
44315,Watto,ragnaros,192,rogue,assassination,12,2,10
44316,Nines,icecrown,192,rogue,assassination,12,2,10
44317,Dralax,ragnaros,192,rogue,assassination,12,2,10
44318,Bloodwish,tichondrius,192,rogue,assassination,12,2,10
44319,Subculture,emerald-dream,192,rogue,assassination,12,2,10
44320,Alts,tichondrius,192,rogue,assassination,12,2,10
44321,Nikosneako,tichondrius,192,rogue,assassination,12,2,10
44322,Manyt,alterac-mountains,192,rogue,assassination,12,2,10
44323,Jelloshots,blackhand,191,rogue,assassination,12,4,8
44324,Bekaa,nemesis,191,rogue,assassination,6,2,4
44325,Diatonic,illidan,191,rogue,assassination,6,2,4
44326,Cretos,jaedenar,191,rogue,assassination,6,2,4
44327,Donpablò,area-52,175,rogue,assassination,11,2,9
44328,ßalto,bleeding-hollow,160,rogue,assassination,10,2,8
44329,Chronisch,area-52,159,rogue,assassination,5,2,3
44330,Swiftchen,illidan,159,rogue,assassination,5,2,3
44331,Xavar,malganis,159,rogue,assassination,5,2,3
44332,Minato,eredar,138,rogue,assassination,9,4,5
44333,Stâbitha,bloodscalp,138,rogue,assassination,20,4,16
44334,Privz,sargeras,96,rogue,assassination,6,1,5
44335,Yohigo,quelthalas,96,rogue,assassination,6,1,5
44336,Khlapncheeks,emerald-dream,96,rogue,assassination,6,1,5
44337,Shhquiettime,norgannon,96,rogue,assassination,6,1,5
44338,Tzs,sargeras,96,rogue,assassination,6,1,5
44339,Vùdõõ,area-52,96,rogue,assassination,6,1,5
44340,Diser,quelthalas,96,rogue,assassination,6,1,5
44341,Sømeøne,malygos,96,rogue,assassination,6,1,5
44342,Spookyswap,blackrock,96,rogue,assassination,6,1,5
44343,Kiskapolyus,thrall,96,rogue,assassination,6,1,5
44344,Tmterminel,moon-guard,96,rogue,assassination,6,1,5
44345,Liesmith,kelthuzad,96,rogue,assassination,6,1,5
44346,Buhuhbles,area-52,96,rogue,assassination,6,1,5
44347,Elbryán,ragnaros,96,rogue,assassination,6,1,5
44348,Twinkrogue,firetree,96,rogue,assassination,6,1,5
44349,Rafikaa,ragnaros,96,rogue,assassination,6,1,5
44350,Nubes,illidan,96,rogue,assassination,6,1,5
44351,Ntshaav,illidan,96,rogue,assassination,6,1,5
44352,Troclar,quelthalas,96,rogue,assassination,6,1,5
44353,Meritra,ragnaros,96,rogue,assassination,6,1,5
44354,Nebiroth,illidan,96,rogue,assassination,6,1,5
44355,Flinchyy,dalaran,96,rogue,assassination,6,1,5
44356,Wuzi,azralon,96,rogue,assassination,6,1,5
44357,Docheatt,dalaran,96,rogue,assassination,6,1,5
44358,Burtonee,aegwynn,96,rogue,assassination,6,1,5
44359,Sevrow,wyrmrest-accord,96,rogue,assassination,6,1,5
44360,Nightmarës,frostmourne,96,rogue,assassination,6,1,5
44361,Greased,arthas,96,rogue,assassination,6,1,5
44362,Twotimed,magtheridon,96,rogue,assassination,6,1,5
44363,Giftschlange,azralon,96,rogue,assassination,6,1,5
44364,Gianniv,chogall,96,rogue,assassination,6,1,5
44365,Ninjasasory,azralon,96,rogue,assassination,6,1,5
44366,Preceptor,azralon,96,rogue,assassination,6,1,5
44367,Saintjon,bleeding-hollow,96,rogue,assassination,6,1,5
44368,Panamarojo,tichondrius,96,rogue,assassination,6,1,5
44369,Rykojin,dalaran,96,rogue,assassination,6,1,5
44370,Zitihait,amanthul,96,rogue,assassination,6,1,5
44371,Touchthetip,bleeding-hollow,96,rogue,assassination,6,1,5
44372,Assakiller,azralon,96,rogue,assassination,6,1,5
44373,Stêf,zuljin,96,rogue,assassination,6,1,5
44374,Lululee,tichondrius,96,rogue,assassination,6,1,5
44375,Jisatsu,undermine,96,rogue,assassination,6,1,5
44376,Slycraft,gorgonnash,96,rogue,assassination,6,1,5
44377,Icantsleep,tichondrius,96,rogue,assassination,6,1,5
44378,Lu,lethon,96,rogue,assassination,6,1,5
44379,Tòúka,stormrage,96,rogue,assassination,6,1,5
44380,Canesuckr,stormrage,96,rogue,assassination,6,1,5
44381,Detektor,stormrage,96,rogue,assassination,6,1,5
44382,Scylas,stormrage,96,rogue,assassination,6,1,5
44383,Erebüs,thunderlord,96,rogue,assassination,6,1,5
44384,Deathxx,destromath,96,rogue,assassination,6,1,5
44385,Clicksbtns,area-52,96,rogue,assassination,6,1,5
44386,Combøz,tichondrius,96,rogue,assassination,6,1,5
44387,Bourrasque,frostmourne,96,rogue,assassination,6,1,5
44388,Deejey,frostmourne,96,rogue,assassination,6,1,5
44389,Damídia,stormrage,96,rogue,assassination,10,1,9
44390,Lilko,daggerspine,96,rogue,assassination,12,1,11
44391,Acrona,dathremar,96,rogue,assassination,12,1,11
44392,Karparog,ragnaros,96,rogue,assassination,12,1,11
44393,Boogiedewitt,emerald-dream,96,rogue,assassination,12,1,11
44394,Xô,lothar,96,rogue,assassination,12,1,11
44395,Keljadian,black-dragonflight,96,rogue,assassination,12,1,11
44396,Rabidlynsane,deathwing,96,rogue,assassination,12,1,11
44397,Kistef,tichondrius,96,rogue,assassination,12,1,11
44398,Voidbrain,area-52,96,rogue,assassination,12,1,11
44399,Véndéttá,area-52,96,rogue,assassination,12,1,11
44400,Armonica,wyrmrest-accord,96,rogue,assassination,12,1,11
44401,Irotanin,thrall,95,rogue,assassination,6,1,5
44402,Euphylezz,garrosh,95,rogue,assassination,6,1,5
44403,Averagepimpn,tichondrius,79,rogue,assassination,5,1,4
44404,Radiantrogue,nordrassil,79,rogue,assassination,5,1,4
44405,Entriped,stormrage,48,rogue,assassination,3,1,2
44406,Botches,bonechewer,48,rogue,assassination,3,1,2
44407,Stabbindude,illidan,48,rogue,assassination,3,1,2
44408,Gilbarblo,skywall,48,rogue,assassination,9,1,8
44409,Sûshì,tichondrius,48,rogue,assassination,9,1,8
44410,Naoyuki,stormrage,42,rogue,assassination,7,2,5
44411,Nargonis,illidan,42,rogue,assassination,8,2,6
44412,Parmigianore,ragnaros,42,rogue,assassination,10,2,8
44413,Jerzs,tichondrius,42,rogue,assassination,11,2,9
44414,Ajy,tichondrius,31,rogue,assassination,2,1,1
44415,Dàmìan,mugthol,31,rogue,assassination,2,1,1
44416,Najmoiran,area-52,31,rogue,assassination,2,1,1
44417,Ascherx,illidan,16,rogue,assassination,1,1,0
44418,Rompoloyo,quelthalas,15,rogue,assassination,1,1,0
44419,Dyllbar,tichondrius,2283,shaman,restoration,157,89,68
44420,Dadbar,tichondrius,2281,shaman,restoration,108,67,41
44421,Samyeh,tichondrius,2252,shaman,restoration,83,55,28
44422,Yooseafood,tichondrius,2248,shaman,restoration,101,64,37
44423,Orochisháman,stormrage,2222,shaman,restoration,96,55,41
44424,Skipperx,thrall,2191,shaman,restoration,78,48,30
44425,Illiteratex,tichondrius,2168,shaman,restoration,88,49,39
44426,Ttvfoxyllama,tichondrius,2157,shaman,restoration,88,45,43
44427,Akwesy,stormrage,2156,shaman,restoration,135,76,59
44428,Xtremeorc,area-52,2148,shaman,restoration,72,41,31
44429,Aameng,tichondrius,2140,shaman,restoration,120,64,56
44430,Tréway,area-52,2135,shaman,restoration,66,41,25
44431,Crazyshamañ,akama,2131,shaman,restoration,127,69,58
44432,Restobyte,moon-guard,2124,shaman,restoration,72,44,28
44433,Plewt,zuljin,2114,shaman,restoration,178,94,84
44434,Svanteson,wyrmrest-accord,2110,shaman,restoration,126,67,59
44435,Selketh,area-52,2107,shaman,restoration,79,46,33
44436,Iissham,darkspear,2092,shaman,restoration,188,101,87
44437,Kantok,quelthalas,2051,shaman,restoration,89,55,34
44438,Nediar,tichondrius,2050,shaman,restoration,54,39,15
44439,Nemix,barthilas,2049,shaman,restoration,66,38,28
44440,Vicioushands,illidan,2047,shaman,restoration,66,37,29
44441,Madoka,llane,2035,shaman,restoration,107,57,50
44442,Jîneth,tichondrius,2021,shaman,restoration,101,54,47
44443,Zavoky,tichondrius,2020,shaman,restoration,174,92,82
44444,Chairstain,kelthuzad,2015,shaman,restoration,175,101,74
44445,Timpossible,tichondrius,2011,shaman,restoration,459,230,229
44446,Lötus,tichondrius,2010,shaman,restoration,110,61,49
44447,Itsallgoodx,tichondrius,2008,shaman,restoration,114,55,59
44448,Abovesky,proudmoore,2006,shaman,restoration,186,92,94
44449,Coreygunz,illidan,2001,shaman,restoration,60,32,28
44450,Spagetje,tichondrius,2001,shaman,restoration,323,162,161
44451,Smlz,garrosh,1998,shaman,restoration,68,38,30
44452,Sizure,frostmourne,1998,shaman,restoration,124,64,60
44453,Aureal,malganis,1990,shaman,restoration,180,111,69
44454,Boyfromhell,stormrage,1985,shaman,restoration,103,50,53
44455,Corianderism,tichondrius,1982,shaman,restoration,77,40,37
44456,Ravaburst,sargeras,1975,shaman,restoration,72,36,36
44457,Berquon,tichondrius,1974,shaman,restoration,78,40,38
44458,Üchihamadarâ,tichondrius,1968,shaman,restoration,67,37,30
44459,Kurtcx,tichondrius,1966,shaman,restoration,395,202,193
44460,Breuer,tichondrius,1966,shaman,restoration,128,64,64
44461,Caibeeshammy,tichondrius,1963,shaman,restoration,192,97,95
44462,Shamaen,kelthuzad,1952,shaman,restoration,119,60,59
44463,Flarkology,area-52,1951,shaman,restoration,48,25,23
44464,Bigbadsac,frostmourne,1941,shaman,restoration,179,91,88
44465,Blaiserpub,tichondrius,1940,shaman,restoration,76,39,37
44466,Ilavayoualot,malganis,1940,shaman,restoration,148,68,80
44467,Gratiens,zuljin,1939,shaman,restoration,108,51,57
44468,Cruv,thrall,1936,shaman,restoration,96,47,49
44469,Terapatrik,area-52,1935,shaman,restoration,170,87,83
44470,Plorenz,illidan,1934,shaman,restoration,60,36,24
44471,Yungtooth,emerald-dream,1934,shaman,restoration,101,54,47
44472,Jangbi,malganis,1934,shaman,restoration,246,129,117
44473,Oryxx,kiljaeden,1934,shaman,restoration,84,40,44
44474,Menc,frostmourne,1924,shaman,restoration,114,56,58
44475,Ratedpvp,thrall,1923,shaman,restoration,200,115,85
44476,Nayro,bleeding-hollow,1921,shaman,restoration,533,288,245
44477,Angrygochuxx,tichondrius,1920,shaman,restoration,35,21,14
44478,Kimflo,tichondrius,1920,shaman,restoration,466,238,228
44479,Slimdavey,tichondrius,1919,shaman,restoration,208,112,96
44480,Ogctkoy,illidan,1911,shaman,restoration,172,88,84
44481,Wâgu,moon-guard,1906,shaman,restoration,46,21,25
44482,Peyn,shadowsong,1905,shaman,restoration,72,34,38
44483,Shamanese,emerald-dream,1901,shaman,restoration,42,20,22
44484,Kafkaesk,tichondrius,1900,shaman,restoration,72,32,40
44485,Uncleilli,tichondrius,1893,shaman,restoration,65,30,35
44486,Nepos,dragonmaw,1891,shaman,restoration,66,34,32
44487,Huáxià,tichondrius,1888,shaman,restoration,166,86,80
44488,Däbü,tichondrius,1887,shaman,restoration,84,40,44
44489,Mandleman,tichondrius,1884,shaman,restoration,140,85,55
44490,Smrtdeath,zuljin,1884,shaman,restoration,53,30,23
44491,Gragomga,area-52,1882,shaman,restoration,150,75,75
44492,Epicthesloth,sargeras,1881,shaman,restoration,59,32,27
44493,Stormtitan,malganis,1881,shaman,restoration,86,42,44
44494,Eboy,thrall,1877,shaman,restoration,265,137,128
44495,Tisaa,illidan,1876,shaman,restoration,30,20,10
44496,Semtechs,tichondrius,1875,shaman,restoration,403,201,202
44497,Sewerperson,zuljin,1873,shaman,restoration,60,32,28
44498,Lignipzyo,doomhammer,1872,shaman,restoration,48,27,21
44499,Nanosec,tichondrius,1871,shaman,restoration,42,27,15
44500,Esqueue,sargeras,1871,shaman,restoration,48,29,19
44501,Muscleyuan,tichondrius,1866,shaman,restoration,59,27,32
44502,Hulan,tichondrius,1865,shaman,restoration,36,20,16
44503,Kellogsz,malganis,1864,shaman,restoration,96,43,53
44504,Patzog,area-52,1861,shaman,restoration,42,25,17
44505,Bômi,tichondrius,1861,shaman,restoration,184,96,88
44506,Laydboiyo,tichondrius,1861,shaman,restoration,66,32,34
44507,Badshock,tichondrius,1859,shaman,restoration,48,35,13
44508,Hódoong,tichondrius,1857,shaman,restoration,46,24,22
44509,Haedodae,tichondrius,1857,shaman,restoration,81,32,49
44510,Bigmontana,tichondrius,1856,shaman,restoration,54,31,23
44511,Cardïß,tichondrius,1854,shaman,restoration,48,26,22
44512,Moistbeans,tichondrius,1854,shaman,restoration,48,26,22
44513,Oridean,area-52,1854,shaman,restoration,42,22,20
44514,Cmsi,tichondrius,1852,shaman,restoration,48,26,22
44515,Baodan,azshara,1847,shaman,restoration,83,42,41
44516,Moldymeatbox,emerald-dream,1847,shaman,restoration,96,47,49
44517,Mybbro,kiljaeden,1846,shaman,restoration,98,49,49
44518,Wtbtotem,tichondrius,1846,shaman,restoration,66,33,33
44519,Helga,hellscream,1845,shaman,restoration,48,29,19
44520,Solam,greymane,1845,shaman,restoration,60,31,29
44521,Onlytides,malganis,1844,shaman,restoration,42,32,10
44522,Upyourtotem,illidan,1842,shaman,restoration,30,22,8
44523,Shamcena,the-scryers,1842,shaman,restoration,51,28,23
44524,Shamanbini,tichondrius,1839,shaman,restoration,47,26,21
44525,Chocopuff,bleeding-hollow,1838,shaman,restoration,66,33,33
44526,Fluxxy,tichondrius,1838,shaman,restoration,115,53,62
44527,Conjunction,azjolnerub,1837,shaman,restoration,65,29,36
44528,Exceedër,ragnaros,1835,shaman,restoration,60,34,26
44529,Stormlashx,sargeras,1835,shaman,restoration,36,20,16
44530,Zoeyzour,illidan,1835,shaman,restoration,415,221,194
44531,Sokta,azgalor,1834,shaman,restoration,163,81,82
44532,Stylesp,tichondrius,1833,shaman,restoration,60,32,28
44533,Laji,cairne,1833,shaman,restoration,215,110,105
44534,Splashz,illidan,1833,shaman,restoration,71,36,35
44535,Chontastic,darkspear,1833,shaman,restoration,60,27,33
44536,Kwesy,tichondrius,1832,shaman,restoration,42,23,19
44537,Suzhixie,akama,1831,shaman,restoration,175,82,93
44538,Wanghaisham,kelthuzad,1830,shaman,restoration,123,63,60
44539,Papatooties,tichondrius,1830,shaman,restoration,257,124,133
44540,Chobawn,tichondrius,1829,shaman,restoration,60,32,28
44541,Pingatronx,ragnaros,1829,shaman,restoration,60,29,31
44542,Bluekid,barthilas,1828,shaman,restoration,54,30,24
44543,Snoozeshaman,ragnaros,1826,shaman,restoration,36,21,15
44544,Beyoncé,lethon,1826,shaman,restoration,53,30,23
44545,Chazzwozza,area-52,1826,shaman,restoration,53,30,23
44546,Hathul,bleeding-hollow,1826,shaman,restoration,60,33,27
44547,Vlly,tichondrius,1826,shaman,restoration,59,27,32
44548,Tuskcrusher,dalaran,1825,shaman,restoration,72,30,42
44549,Gjök,nemesis,1824,shaman,restoration,54,22,32
44550,Dehsaw,illidan,1821,shaman,restoration,108,54,54
44551,Cryochemist,tichondrius,1819,shaman,restoration,29,23,6
44552,Tarròò,bleeding-hollow,1819,shaman,restoration,60,34,26
44553,Lavalavalava,eonar,1819,shaman,restoration,54,26,28
44554,Bigspaghetti,thrall,1818,shaman,restoration,66,31,35
44555,Terrasham,barthilas,1818,shaman,restoration,47,20,27
44556,Onagi,frostmourne,1817,shaman,restoration,84,53,31
44557,Purpose,nerzhul,1817,shaman,restoration,54,33,21
44558,Totempack,stormrage,1817,shaman,restoration,54,26,28
44559,Gyrogg,scilla,1816,shaman,restoration,525,278,247
44560,Ryuubi,illidan,1815,shaman,restoration,54,34,20
44561,Ogran,stormscale,1815,shaman,restoration,54,25,29
44562,Immabòt,tichondrius,1813,shaman,restoration,59,36,23
44563,Dadidun,tichondrius,1813,shaman,restoration,48,25,23
44564,Ericzlassoz,tichondrius,1812,shaman,restoration,66,42,24
44565,Grymn,sargeras,1812,shaman,restoration,264,132,132
44566,Kurtxc,tichondrius,1810,shaman,restoration,36,25,11
44567,Dantheman,twisting-nether,1810,shaman,restoration,42,23,19
44568,Seimitsu,tichondrius,1810,shaman,restoration,47,24,23
44569,Waterbro,tichondrius,1809,shaman,restoration,101,57,44
44570,Annte,stonemaul,1809,shaman,restoration,64,32,32
44571,Meatballs,kirin-tor,1809,shaman,restoration,62,31,31
44572,Desee,bleeding-hollow,1809,shaman,restoration,54,27,27
44573,Kandshamy,azralon,1807,shaman,restoration,118,69,49
44574,Ookmetide,bleeding-hollow,1807,shaman,restoration,52,29,23
44575,Ghomragar,antonidas,1807,shaman,restoration,82,42,40
44576,Willy,icecrown,1807,shaman,restoration,87,44,43
44577,Raeoki,area-52,1806,shaman,restoration,185,100,85
44578,Totemgripper,moon-guard,1804,shaman,restoration,65,39,26
44579,Hydrocheck,tichondrius,1804,shaman,restoration,94,54,40
44580,Astrøcyte,tichondrius,1804,shaman,restoration,96,46,50
44581,Tolík,ragnaros,1803,shaman,restoration,54,26,28
44582,Earthspeaker,bleeding-hollow,1802,shaman,restoration,54,33,21
44583,Lemmehex,illidan,1802,shaman,restoration,61,37,24
44584,Oceangrown,emerald-dream,1802,shaman,restoration,51,22,29
44585,Joyrex,spinebreaker,1802,shaman,restoration,75,30,45
44586,Jìmmybuckets,tichondrius,1801,shaman,restoration,59,37,22
44587,Stórmstruck,area-52,1800,shaman,restoration,72,41,31
44588,Nktx,tichondrius,1800,shaman,restoration,118,66,52
44589,Holdmytotum,tichondrius,1800,shaman,restoration,52,29,23
44590,Zaapi,dalaran,1800,shaman,restoration,108,60,48
44591,Nazugresha,bleeding-hollow,1800,shaman,restoration,42,23,19
44592,Baseballcap,sargeras,1800,shaman,restoration,78,37,41
44593,Shockmematty,tichondrius,1798,shaman,restoration,36,25,11
44594,Fàlc,stormrage,1798,shaman,restoration,42,22,20
44595,Ganvitchenko,illidan,1798,shaman,restoration,97,47,50
44596,Inmø,ragnaros,1797,shaman,restoration,36,19,17
44597,Kromgul,malfurion,1797,shaman,restoration,96,46,50
44598,Hodoongs,tichondrius,1797,shaman,restoration,49,23,26
44599,Dxxlol,tichondrius,1795,shaman,restoration,54,29,25
44600,Cigaretter,tichondrius,1793,shaman,restoration,56,25,31
44601,Éspresso,moon-guard,1790,shaman,restoration,48,32,16
44602,Fierymoo,frostmourne,1790,shaman,restoration,48,23,25
44603,Deephole,illidan,1788,shaman,restoration,217,110,107
44604,Itsyabøiwill,area-52,1787,shaman,restoration,84,50,34
44605,Vogaz,ragnaros,1785,shaman,restoration,64,33,31
44606,Rollintotems,bleeding-hollow,1785,shaman,restoration,84,39,45
44607,Drupman,dalaran,1784,shaman,restoration,48,24,24
44608,Petrafk,illidan,1783,shaman,restoration,161,72,89
44609,Bombadil,korgath,1782,shaman,restoration,42,22,20
44610,Bubbacheeks,area-52,1781,shaman,restoration,84,50,34
44611,Booramqt,tichondrius,1780,shaman,restoration,47,27,20
44612,Cpplol,tichondrius,1779,shaman,restoration,59,35,24
44613,Zingysham,tichondrius,1777,shaman,restoration,75,39,36
44614,Boxfour,tichondrius,1777,shaman,restoration,105,50,55
44615,Hiermy,tichondrius,1775,shaman,restoration,53,29,24
44616,Blazingtotem,dunemaul,1775,shaman,restoration,125,64,61
44617,Petzah,barthilas,1774,shaman,restoration,54,25,29
44618,Sleepysham,kelthuzad,1771,shaman,restoration,135,71,64
44619,Chessyc,ragnaros,1771,shaman,restoration,65,29,36
44620,Badhealerip,tichondrius,1770,shaman,restoration,86,47,39
44621,Shanasty,bleeding-hollow,1769,shaman,restoration,60,31,29
44622,Waymond,khadgar,1769,shaman,restoration,230,115,115
44623,Ränton,bleeding-hollow,1764,shaman,restoration,54,28,26
44624,Blackpïnk,tichondrius,1764,shaman,restoration,179,91,88
44625,Bozzyy,illidan,1761,shaman,restoration,114,56,58
44626,Linkandwink,nerzhul,1760,shaman,restoration,42,24,18
44627,Julíp,tichondrius,1760,shaman,restoration,58,23,35
44628,Rawdogginher,dalaran,1757,shaman,restoration,42,26,16
44629,Erbicklet,ragnaros,1755,shaman,restoration,166,88,78
44630,Chomang,stormreaver,1755,shaman,restoration,132,62,70
44631,Victorin,zuljin,1754,shaman,restoration,72,48,24
44632,Bobbybigdam,tichondrius,1752,shaman,restoration,93,50,43
44633,Sylicious,barthilas,1751,shaman,restoration,36,24,12
44634,Shawmen,zuljin,1748,shaman,restoration,208,110,98
44635,Gatorwavez,bleeding-hollow,1746,shaman,restoration,89,51,38
44636,Warríed,sargeras,1746,shaman,restoration,59,29,30
44637,Suyy,tichondrius,1746,shaman,restoration,54,26,28
44638,Camer,sargeras,1745,shaman,restoration,54,33,21
44639,Toazty,stormscale,1745,shaman,restoration,75,44,31
44640,Mastashamsta,illidan,1745,shaman,restoration,48,25,23
44641,Svondo,illidan,1744,shaman,restoration,37,25,12
44642,Blackfancy,thrall,1744,shaman,restoration,56,32,24
44643,Targhal,tichondrius,1742,shaman,restoration,254,141,113
44644,Taronì,zuljin,1742,shaman,restoration,72,32,40
44645,Chonchastic,darkspear,1741,shaman,restoration,54,27,27
44646,Diulama,tichondrius,1740,shaman,restoration,69,45,24
44647,Aiyoubro,tichondrius,1738,shaman,restoration,47,26,21
44648,Ftp,kelthuzad,1738,shaman,restoration,47,26,21
44649,Esqueue,tichondrius,1736,shaman,restoration,36,22,14
44650,Pookiexo,illidan,1736,shaman,restoration,41,25,16
44651,Hoshwear,azralon,1733,shaman,restoration,57,40,17
44652,Overtax,tichondrius,1733,shaman,restoration,36,20,16
44653,Gweemextreme,tichondrius,1733,shaman,restoration,88,46,42
44654,Rantòn,bleeding-hollow,1733,shaman,restoration,59,27,32
44655,Moorgl,tichondrius,1732,shaman,restoration,53,26,27
44656,Bacon,lightninghoof,1732,shaman,restoration,204,94,110
44657,Multiduelist,bleeding-hollow,1731,shaman,restoration,36,28,8
44658,Redds,tichondrius,1730,shaman,restoration,114,77,37
44659,Pèpé,sargeras,1730,shaman,restoration,50,30,20
44660,Groundingtot,hydraxis,1730,shaman,restoration,48,27,21
44661,Juicedbydad,kelthuzad,1730,shaman,restoration,48,25,23
44662,Muggz,sargeras,1729,shaman,restoration,60,27,33
44663,Hotknifez,tichondrius,1727,shaman,restoration,30,18,12
44664,Funkesapien,tichondrius,1727,shaman,restoration,54,27,27
44665,Mitchestic,illidan,1727,shaman,restoration,101,42,59
44666,Maloran,zuljin,1727,shaman,restoration,65,24,41
44667,Krazyc,sargeras,1726,shaman,restoration,90,47,43
44668,Héadshot,bleeding-hollow,1726,shaman,restoration,143,71,72
44669,Oninobu,sargeras,1724,shaman,restoration,70,44,26
44670,Hairyrichard,zuljin,1722,shaman,restoration,823,432,391
44671,Phxhouse,illidan,1722,shaman,restoration,324,159,165
44672,Spampurge,emerald-dream,1721,shaman,restoration,36,21,15
44673,Shamanesè,emerald-dream,1721,shaman,restoration,36,18,18
44674,Sìxnìne,tichondrius,1716,shaman,restoration,68,32,36
44675,Inpantsment,barthilas,1714,shaman,restoration,151,78,73
44676,Bizzarro,azgalor,1713,shaman,restoration,79,40,39
44677,Ðiglett,frostmourne,1713,shaman,restoration,146,72,74
44678,Fkwithme,burning-blade,1711,shaman,restoration,66,30,36
44679,Duregar,tichondrius,1709,shaman,restoration,60,35,25
44680,Dolshamizzy,tichondrius,1708,shaman,restoration,36,19,17
44681,Chiggys,area-52,1708,shaman,restoration,65,33,32
44682,Charlesby,tichondrius,1706,shaman,restoration,198,113,85
44683,Tobírama,bleeding-hollow,1705,shaman,restoration,54,23,31
44684,Slm,bleeding-hollow,1704,shaman,restoration,24,18,6
44685,Hustlenflow,tichondrius,1704,shaman,restoration,60,32,28
44686,Elementz,tichondrius,1703,shaman,restoration,222,116,106
44687,Naweiv,caelestrasz,1702,shaman,restoration,54,31,23
44688,Specifyz,arathor,1702,shaman,restoration,42,24,18
44689,Xzxz,sargeras,1701,shaman,restoration,187,105,82
44690,Torrentzx,sargeras,1701,shaman,restoration,36,18,18
44691,Abulailah,sargeras,1699,shaman,restoration,65,37,28
44692,Strives,icecrown,1698,shaman,restoration,66,33,33
44693,Renghostwolf,illidan,1698,shaman,restoration,36,18,18
44694,Lingduacn,tichondrius,1698,shaman,restoration,36,18,18
44695,Doubletåp,emerald-dream,1697,shaman,restoration,41,20,21
44696,Ozmats,malganis,1697,shaman,restoration,88,42,46
44697,Xoweeknd,bleeding-hollow,1697,shaman,restoration,42,19,23
44698,Magma,spirestone,1695,shaman,restoration,102,62,40
44699,Shockxd,illidan,1695,shaman,restoration,48,25,23
44700,Montageb,illidan,1694,shaman,restoration,39,29,10
44701,Bootybpoppin,mugthol,1694,shaman,restoration,120,72,48
44702,Møp,spirestone,1694,shaman,restoration,143,72,71
44703,Namso,tichondrius,1693,shaman,restoration,42,23,19
44704,Nessannix,stormrage,1692,shaman,restoration,223,125,98
44705,Ribbeye,tichondrius,1692,shaman,restoration,154,76,78
44706,Notmugg,sargeras,1691,shaman,restoration,42,24,18
44707,Drammah,malganis,1691,shaman,restoration,72,33,39
44708,Eletius,tichondrius,1690,shaman,restoration,29,26,3
44709,Vrom,whisperwind,1690,shaman,restoration,90,51,39
44710,Sin,bleeding-hollow,1690,shaman,restoration,36,20,16
44711,Wegoagain,tichondrius,1690,shaman,restoration,42,20,22
44712,Xruok,kelthuzad,1689,shaman,restoration,39,24,15
44713,Ittøki,tichondrius,1689,shaman,restoration,41,24,17
44714,Lilgeeh,kelthuzad,1689,shaman,restoration,46,24,22
44715,Shozen,bonechewer,1689,shaman,restoration,54,26,28
44716,Rockzoa,tichondrius,1688,shaman,restoration,60,27,33
44717,Devastaterr,bleeding-hollow,1687,shaman,restoration,110,57,53
44718,Shk,illidan,1686,shaman,restoration,42,27,15
44719,Yehbeen,tichondrius,1686,shaman,restoration,42,25,17
44720,Solidhomme,tichondrius,1684,shaman,restoration,42,23,19
44721,Wraethy,illidan,1683,shaman,restoration,326,167,159
44722,Flappygooch,illidan,1683,shaman,restoration,113,51,62
44723,Platewalrus,illidan,1682,shaman,restoration,42,24,18
44724,Bizzarra,azshara,1681,shaman,restoration,39,26,13
44725,Ibreakanklez,bleeding-hollow,1681,shaman,restoration,42,20,22
44726,Cosmô,sargeras,1679,shaman,restoration,48,20,28
44727,Tanta,gurubashi,1678,shaman,restoration,57,25,32
44728,Isagii,stormrage,1677,shaman,restoration,65,38,27
44729,Shadowz,alexstrasza,1676,shaman,restoration,74,48,26
44730,Dingfu,sargeras,1676,shaman,restoration,202,117,85
44731,Raywhiter,tichondrius,1676,shaman,restoration,62,29,33
44732,Bigdictuna,sargeras,1675,shaman,restoration,242,131,111
44733,Rynoh,dalaran,1675,shaman,restoration,121,64,57
44734,Shacewoman,altar-of-storms,1674,shaman,restoration,174,79,95
44735,Nethyxsoy,frostmourne,1673,shaman,restoration,48,33,15
44736,Urga,hyjal,1672,shaman,restoration,36,20,16
44737,Meepsham,kilrogg,1672,shaman,restoration,42,22,20
44738,Paoran,sargeras,1670,shaman,restoration,70,35,35
44739,Tpokes,sargeras,1669,shaman,restoration,42,22,20
44740,Qksilverz,nemesis,1669,shaman,restoration,83,43,40
44741,Thelphor,nemesis,1669,shaman,restoration,48,24,24
44742,Shamanceylol,barthilas,1668,shaman,restoration,134,73,61
44743,Tokuma,illidan,1667,shaman,restoration,58,26,32
44744,Drekkhal,area-52,1666,shaman,restoration,178,104,74
44745,Skipler,stormrage,1666,shaman,restoration,66,36,30
44746,Horizonsham,stormrage,1666,shaman,restoration,66,36,30
44747,Animus,dark-iron,1665,shaman,restoration,48,30,18
44748,Baern,thrall,1665,shaman,restoration,86,43,43
44749,Scroogz,emerald-dream,1665,shaman,restoration,102,50,52
44750,Sasgöb,illidan,1665,shaman,restoration,83,36,47
44751,Toxidizetkö,azralon,1664,shaman,restoration,48,26,22
44752,Semnicktotem,area-52,1663,shaman,restoration,72,36,36
44753,Heniu,tichondrius,1663,shaman,restoration,60,27,33
44754,Hamrok,moon-guard,1662,shaman,restoration,84,42,42
44755,Mastlau,tichondrius,1662,shaman,restoration,60,30,30
44756,Bogz,korgath,1662,shaman,restoration,209,96,113
44757,Reppinsix,sargeras,1662,shaman,restoration,58,24,34
44758,Bluepigo,tichondrius,1660,shaman,restoration,59,24,35
44759,Prêttylights,bleeding-hollow,1659,shaman,restoration,36,20,16
44760,Youliuhua,tichondrius,1659,shaman,restoration,36,19,17
44761,Belarix,emerald-dream,1659,shaman,restoration,205,96,109
44762,Exshocks,tichondrius,1658,shaman,restoration,54,30,24
44763,Imd,tichondrius,1658,shaman,restoration,42,21,21
44764,Lingdusm,tichondrius,1657,shaman,restoration,36,20,16
44765,Gorillox,chogall,1657,shaman,restoration,42,23,19
44766,Vayces,barthilas,1657,shaman,restoration,199,103,96
44767,Zuescannon,kelthuzad,1656,shaman,restoration,84,39,45
44768,Benjaminx,tichondrius,1655,shaman,restoration,101,63,38
44769,Fatdixb,illidan,1655,shaman,restoration,47,26,21
44770,Restosêxual,tichondrius,1655,shaman,restoration,42,21,21
44771,Mcwindyfists,zuljin,1655,shaman,restoration,48,23,25
44772,Meskthemage,barthilas,1654,shaman,restoration,47,23,24
44773,Novoz,tichondrius,1653,shaman,restoration,42,24,18
44774,Whameradetu,suramar,1653,shaman,restoration,71,31,40
44775,Goobie,crushridge,1651,shaman,restoration,68,43,25
44776,Win,blackwing-lair,1651,shaman,restoration,36,21,15
44777,Cmz,bleeding-hollow,1650,shaman,restoration,137,76,61
44778,Mixxt,illidan,1649,shaman,restoration,36,19,17
44779,Neosham,frostwolf,1649,shaman,restoration,66,31,35
44780,Bolteon,malganis,1648,shaman,restoration,30,21,9
44781,Okïòmó,proudmoore,1648,shaman,restoration,47,21,26
44782,Purgenx,tichondrius,1647,shaman,restoration,42,27,15
44783,Peegee,zuluhed,1647,shaman,restoration,66,28,38
44784,Jsell,zuljin,1646,shaman,restoration,56,28,28
44785,Amdshaman,thrall,1645,shaman,restoration,67,37,30
44786,Fuzzymuzzy,illidan,1644,shaman,restoration,54,29,25
44787,Gabant,azralon,1644,shaman,restoration,42,19,23
44788,Rugmat,tichondrius,1642,shaman,restoration,84,44,40
44789,Weoo,doomhammer,1642,shaman,restoration,48,23,25
44790,Ekss,tichondrius,1642,shaman,restoration,48,19,29
44791,Gordonramsai,sargeras,1641,shaman,restoration,272,148,124
44792,Squimbert,tichondrius,1641,shaman,restoration,48,21,27
44793,Singleorigin,tichondrius,1641,shaman,restoration,105,41,64
44794,Akheeta,tichondrius,1639,shaman,restoration,69,47,22
44795,Chainstuff,area-52,1639,shaman,restoration,53,29,24
44796,Ethikas,tichondrius,1638,shaman,restoration,42,24,18
44797,Erwin,bonechewer,1638,shaman,restoration,225,123,102
44798,Beastofmagic,illidan,1638,shaman,restoration,125,68,57
44799,Dgshaman,tichondrius,1637,shaman,restoration,32,20,12
44800,Cheddaman,kiljaeden,1637,shaman,restoration,48,21,27
44801,Daddybeaarr,thrall,1635,shaman,restoration,55,25,30
44802,Randomshammy,stormrage,1634,shaman,restoration,78,44,34
44803,Gjok,nemesis,1634,shaman,restoration,59,20,39
44804,Quitnectar,aggramar,1633,shaman,restoration,48,24,24
44805,Shortbusqt,hyjal,1631,shaman,restoration,42,23,19
44806,Wawsham,tichondrius,1631,shaman,restoration,48,19,29
44807,Biguaga,tichondrius,1629,shaman,restoration,42,24,18
44808,Shocksauce,tichondrius,1627,shaman,restoration,100,55,45
44809,Intruzionall,barthilas,1627,shaman,restoration,241,130,111
44810,Wonima,tichondrius,1627,shaman,restoration,34,18,16
44811,Foragorn,stormrage,1627,shaman,restoration,217,110,107
44812,Jbalvi,ragnaros,1626,shaman,restoration,141,82,59
44813,Grizze,bonechewer,1626,shaman,restoration,90,41,49
44814,Goranzo,emerald-dream,1626,shaman,restoration,54,24,30
44815,Shocknrot,maelstrom,1623,shaman,restoration,38,23,15
44816,Drfentanylx,emerald-dream,1623,shaman,restoration,30,17,13
44817,Thunderspark,tichondrius,1622,shaman,restoration,54,30,24
44818,Spiritry,tichondrius,1622,shaman,restoration,204,107,97
44819,Enfusiontv,tichondrius,1621,shaman,restoration,30,21,9
44820,Vanella,malganis,1621,shaman,restoration,42,25,17
44821,Texmawave,moon-guard,1621,shaman,restoration,125,71,54
44822,Thuntard,bleeding-hollow,1621,shaman,restoration,48,23,25
44823,Badclass,the-underbog,1618,shaman,restoration,29,21,8
44824,Hooldcool,tichondrius,1618,shaman,restoration,255,147,108
44825,Yoshìmìtsu,illidan,1618,shaman,restoration,102,53,49
44826,Stormstrikes,tichondrius,1618,shaman,restoration,64,26,38
44827,Zeonard,ragnaros,1617,shaman,restoration,252,129,123
44828,Angelbie,tichondrius,1617,shaman,restoration,74,33,41
44829,Kimchimi,tichondrius,1616,shaman,restoration,192,108,84
44830,Skoobasteeve,sargeras,1616,shaman,restoration,75,42,33
44831,Bigamez,azuremyst,1616,shaman,restoration,158,88,70
44832,Durogh,darkspear,1616,shaman,restoration,60,23,37
44833,Sorgal,area-52,1616,shaman,restoration,60,22,38
44834,Kobecoopper,sargeras,1615,shaman,restoration,42,21,21
44835,Sunyang,tichondrius,1615,shaman,restoration,36,17,19
44836,Gki,tichondrius,1614,shaman,restoration,49,34,15
44837,Dazu,drakkari,1614,shaman,restoration,57,38,19
44838,World,frostmourne,1614,shaman,restoration,47,25,22
44839,Quendella,aggramar,1613,shaman,restoration,42,25,17
44840,Polared,hyjal,1613,shaman,restoration,52,25,27
44841,Velar,frostwolf,1613,shaman,restoration,48,19,29
44842,Todems,kalecgos,1612,shaman,restoration,42,24,18
44843,Makocc,tichondrius,1611,shaman,restoration,48,24,24
44844,Unbreakable,illidan,1611,shaman,restoration,91,43,48
44845,Dreadxtotems,illidan,1610,shaman,restoration,77,42,35
44846,Cherryboy,illidan,1610,shaman,restoration,87,45,42
44847,Tesle,illidan,1609,shaman,restoration,54,24,30
44848,Ðoomed,kiljaeden,1608,shaman,restoration,30,19,11
44849,Alett,arathor,1608,shaman,restoration,60,29,31
44850,Plzdontlos,illidan,1607,shaman,restoration,113,69,44
44851,Tideful,area-52,1607,shaman,restoration,42,22,20
44852,Prowdt,azralon,1607,shaman,restoration,418,217,201
44853,Harigomi,tichondrius,1607,shaman,restoration,360,186,174
44854,Ssaotizi,tichondrius,1607,shaman,restoration,329,166,163
44855,Rainingheals,auchindoun,1607,shaman,restoration,44,19,25
44856,Randomshammy,area-52,1606,shaman,restoration,30,17,13
44857,Astrauk,nemesis,1606,shaman,restoration,76,43,33
44858,Raxshock,stormrage,1606,shaman,restoration,42,22,20
44859,Chingobling,illidan,1605,shaman,restoration,54,31,23
44860,Hexrz,area-52,1605,shaman,restoration,42,21,21
44861,Luckyscatter,frostmourne,1605,shaman,restoration,36,18,18
44862,Totemslol,ysera,1605,shaman,restoration,65,31,34
44863,Surginate,zuljin,1605,shaman,restoration,42,18,24
44864,Sliditin,tichondrius,1604,shaman,restoration,36,25,11
44865,Hurú,azralon,1604,shaman,restoration,36,21,15
44866,Spampurge,blackwing-lair,1604,shaman,restoration,37,19,18
44867,Improvize,malganis,1604,shaman,restoration,70,35,35
44868,Polarities,malganis,1604,shaman,restoration,54,21,33
44869,Kratór,kelthuzad,1603,shaman,restoration,47,31,16
44870,Fernetbrança,ragnaros,1603,shaman,restoration,48,26,22
44871,Telchar,quelthalas,1602,shaman,restoration,102,62,40
44872,Tarritos,ragnaros,1602,shaman,restoration,52,26,26
44873,Centalinkxox,frostmourne,1602,shaman,restoration,63,31,32
44874,Lacid,tichondrius,1601,shaman,restoration,68,42,26
44875,Purgebotx,bleeding-hollow,1601,shaman,restoration,114,70,44
44876,Belshiro,sargeras,1601,shaman,restoration,108,51,57
44877,Latorius,frostmourne,1600,shaman,restoration,171,99,72
44878,Shocksfuker,stormrage,1600,shaman,restoration,104,58,46
44879,Darcheros,quelthalas,1600,shaman,restoration,60,31,29
44880,Succmytotems,tichondrius,1600,shaman,restoration,93,47,46
44881,Foilcap,bonechewer,1600,shaman,restoration,296,144,152
44882,Improvedx,akama,1600,shaman,restoration,52,24,28
44883,Ddogz,illidan,1600,shaman,restoration,48,21,27
44884,Gulmuwu,zuljin,1599,shaman,restoration,38,22,16
44885,Yeeraldyn,quelthalas,1599,shaman,restoration,60,29,31
44886,Tevya,dalvengyr,1598,shaman,restoration,83,47,36
44887,Ryeqt,illidan,1598,shaman,restoration,47,23,24
44888,Gemoz,tichondrius,1597,shaman,restoration,30,22,8
44889,Steveyy,frostmourne,1597,shaman,restoration,39,24,15
44890,Hehew,kelthuzad,1597,shaman,restoration,146,76,70
44891,Óompaloompa,frostmourne,1596,shaman,restoration,36,17,19
44892,Bestbrook,tichondrius,1596,shaman,restoration,153,71,82
44893,Harth,zuljin,1594,shaman,restoration,122,70,52
44894,Tideoverdose,tichondrius,1594,shaman,restoration,36,19,17
44895,Dumerslayer,ragnaros,1594,shaman,restoration,42,22,20
44896,Rogrim,malganis,1592,shaman,restoration,54,28,26
44897,Asøg,emerald-dream,1592,shaman,restoration,75,35,40
44898,Yeamn,saurfang,1591,shaman,restoration,165,97,68
44899,Lazie,perenolde,1590,shaman,restoration,30,19,11
44900,Tzyorz,illidan,1589,shaman,restoration,150,79,71
44901,Jazzlightnin,tichondrius,1589,shaman,restoration,71,31,40
44902,Shamsom,tichondrius,1588,shaman,restoration,122,58,64
44903,Specify,arathor,1588,shaman,restoration,90,41,49
44904,Turborundat,area-52,1586,shaman,restoration,225,127,98
44905,Besylate,illidan,1586,shaman,restoration,80,39,41
44906,Snakesoul,area-52,1585,shaman,restoration,133,73,60
44907,Kolanji,akama,1585,shaman,restoration,41,22,19
44908,Vywolf,frostmourne,1583,shaman,restoration,80,46,34
44909,Lilcaju,sargeras,1581,shaman,restoration,29,18,11
44910,Okinn,malganis,1581,shaman,restoration,29,17,12
44911,Zechary,proudmoore,1580,shaman,restoration,48,29,19
44912,Gunrose,proudmoore,1580,shaman,restoration,109,55,54
44913,Pkx,eitrigg,1578,shaman,restoration,47,20,27
44914,Packspiritqt,tichondrius,1577,shaman,restoration,48,27,21
44915,Colterr,thunderhorn,1577,shaman,restoration,36,20,16
44916,Asnalda,emerald-dream,1576,shaman,restoration,57,32,25
44917,Onepunchsham,illidan,1576,shaman,restoration,189,98,91
44918,Rainz,aggramar,1574,shaman,restoration,42,22,20
44919,Arkerus,emerald-dream,1573,shaman,restoration,36,22,14
44920,Shamix,area-52,1573,shaman,restoration,84,39,45
44921,Dawnyshock,arygos,1573,shaman,restoration,41,19,22
44922,Draidosh,area-52,1572,shaman,restoration,89,53,36
44923,Chlckenx,tichondrius,1572,shaman,restoration,111,54,57
44924,Ivìxi,area-52,1571,shaman,restoration,64,30,34
44925,Sikotics,area-52,1568,shaman,restoration,111,58,53
44926,Moosk,zuluhed,1567,shaman,restoration,51,27,24
44927,Zuralah,nemesis,1566,shaman,restoration,160,85,75
44928,Dduddaddu,tichondrius,1565,shaman,restoration,72,37,35
44929,Halfinha,nemesis,1564,shaman,restoration,247,127,120
44930,Nyf,khazgoroth,1564,shaman,restoration,54,24,30
44931,Spurske,emerald-dream,1564,shaman,restoration,78,32,46
44932,Muruaic,dentarg,1563,shaman,restoration,142,75,67
44933,Bigdampurge,illidan,1563,shaman,restoration,95,49,46
44934,Hwyl,frostmourne,1563,shaman,restoration,96,45,51
44935,Waater,lightbringer,1562,shaman,restoration,86,49,37
44936,Wilmar,ragnaros,1560,shaman,restoration,66,33,33
44937,Stonetides,tichondrius,1560,shaman,restoration,78,33,45
44938,Dogecoincäsh,sargeras,1559,shaman,restoration,66,36,30
44939,Shulace,area-52,1558,shaman,restoration,78,38,40
44940,Rulf,proudmoore,1558,shaman,restoration,90,34,56
44941,Vzla,ragnaros,1555,shaman,restoration,96,54,42
44942,Kayadee,stormrage,1554,shaman,restoration,75,37,38
44943,Goatedsham,dalaran,1553,shaman,restoration,65,36,29
44944,Eatmymeatbal,illidan,1551,shaman,restoration,65,26,39
44945,Pherolex,tichondrius,1550,shaman,restoration,42,23,19
44946,Hexxercise,area-52,1549,shaman,restoration,65,46,19
44947,Goosha,tichondrius,1548,shaman,restoration,48,33,15
44948,Lanzero,chogall,1547,shaman,restoration,42,30,12
44949,Lustlolol,korgath,1547,shaman,restoration,167,86,81
44950,Mistarklean,malganis,1546,shaman,restoration,117,52,65
44951,Fujiyama,dark-iron,1545,shaman,restoration,135,70,65
44952,Deathwards,frostmane,1544,shaman,restoration,60,26,34
44953,Hennytides,zuljin,1543,shaman,restoration,42,22,20
44954,Trouvaille,tichondrius,1543,shaman,restoration,47,23,24
44955,Tyar,area-52,1543,shaman,restoration,137,64,73
44956,Shaminham,barthilas,1543,shaman,restoration,72,31,41
44957,Shakrakhan,tichondrius,1542,shaman,restoration,36,17,19
44958,Pedren,thrall,1541,shaman,restoration,33,25,8
44959,Shamxrob,sargeras,1541,shaman,restoration,78,46,32
44960,Tenyks,tichondrius,1537,shaman,restoration,75,42,33
44961,Brongar,bleeding-hollow,1537,shaman,restoration,107,45,62
44962,Wolfsokar,emerald-dream,1537,shaman,restoration,102,39,63
44963,Akubai,kelthuzad,1535,shaman,restoration,78,39,39
44964,Girthquake,agamaggan,1535,shaman,restoration,48,20,28
44965,Fwwrs,illidan,1534,shaman,restoration,31,19,12
44966,Tides,skullcrusher,1533,shaman,restoration,42,18,24
44967,Dbmx,tichondrius,1532,shaman,restoration,30,16,14
44968,Kacham,nerzhul,1530,shaman,restoration,36,20,16
44969,Rookieshaman,tichondrius,1528,shaman,restoration,24,16,8
44970,Oldguy,ragnaros,1526,shaman,restoration,227,114,113
44971,Kaytahn,proudmoore,1525,shaman,restoration,72,39,33
44972,Totesmcgoatz,arthas,1525,shaman,restoration,69,34,35
44973,Chacham,tichondrius,1524,shaman,restoration,91,49,42
44974,Repang,tichondrius,1523,shaman,restoration,36,19,17
44975,Vexxs,shadowmoon,1522,shaman,restoration,30,16,14
44976,Redek,sargeras,1521,shaman,restoration,226,121,105
44977,Riptideafk,sargeras,1521,shaman,restoration,66,34,32
44978,Moocatpie,illidan,1521,shaman,restoration,124,60,64
44979,Rocyt,sargeras,1520,shaman,restoration,66,35,31
44980,Luxiaa,tichondrius,1520,shaman,restoration,59,22,37
44981,Aleforj,quelthalas,1519,shaman,restoration,55,27,28
44982,Rsdyxjh,tichondrius,1519,shaman,restoration,51,22,29
44983,Glocksitotem,malganis,1517,shaman,restoration,140,80,60
44984,Fenrirfuryy,tichondrius,1514,shaman,restoration,54,25,29
44985,Reuxxe,area-52,1513,shaman,restoration,224,115,109
44986,Stylebenderx,frostmourne,1512,shaman,restoration,30,16,14
44987,Spongemama,tichondrius,1511,shaman,restoration,82,41,41
44988,Freesolo,barthilas,1510,shaman,restoration,200,102,98
44989,Bluedynamite,tichondrius,1510,shaman,restoration,66,32,34
44990,Dogood,tichondrius,1510,shaman,restoration,60,27,33
44991,Allcatraz,zuljin,1510,shaman,restoration,58,26,32
44992,Dadauera,azralon,1509,shaman,restoration,30,16,14
44993,Fuzbo,bleeding-hollow,1509,shaman,restoration,47,25,22
44994,Sellmysoul,kelthuzad,1509,shaman,restoration,87,43,44
44995,Bighaircut,darkspear,1509,shaman,restoration,120,55,65
44996,Shamansrock,tichondrius,1509,shaman,restoration,36,16,20
44997,Joltik,area-52,1508,shaman,restoration,225,112,113
44998,Plâto,stormrage,1507,shaman,restoration,30,16,14
44999,Cultsulyvahn,tichondrius,1507,shaman,restoration,73,37,36
45000,Trapghost,cenarius,1506,shaman,restoration,87,41,46
45001,Shamankïng,proudmoore,1505,shaman,restoration,89,46,43
45002,ßread,illidan,1505,shaman,restoration,133,62,71
45003,Purgedubx,tichondrius,1504,shaman,restoration,196,104,92
45004,Pawbed,aegwynn,1503,shaman,restoration,117,64,53
45005,Cokehealsx,tichondrius,1503,shaman,restoration,30,16,14
45006,Agharn,moon-guard,1503,shaman,restoration,51,26,25
45007,Mutaishammy,barthilas,1503,shaman,restoration,96,48,48
45008,Papatreb,haomarush,1503,shaman,restoration,78,39,39
45009,Ballistíc,boulderfist,1502,shaman,restoration,66,38,28
45010,Sphaerus,tichondrius,1501,shaman,restoration,54,30,24
45011,Orkshammy,illidan,1500,shaman,restoration,40,25,15
45012,Ekuku,tichondrius,1498,shaman,restoration,58,33,25
45013,Ban,blackrock,1498,shaman,restoration,39,21,18
45014,Lengin,bleeding-hollow,1497,shaman,restoration,36,21,15
45015,Sbrinz,thrall,1497,shaman,restoration,36,19,17
45016,Choochette,illidan,1497,shaman,restoration,144,67,77
45017,Elementàlius,quelthalas,1497,shaman,restoration,71,32,39
45018,Hruggol,bleeding-hollow,1496,shaman,restoration,90,46,44
45019,Szeav,tichondrius,1496,shaman,restoration,66,33,33
45020,Scamgame,tichondrius,1495,shaman,restoration,30,22,8
45021,Isekai,alterac-mountains,1495,shaman,restoration,90,42,48
45022,Shockszz,onyxia,1494,shaman,restoration,143,69,74
45023,Quakess,zuljin,1494,shaman,restoration,66,28,38
45024,Reformeddogs,tichondrius,1492,shaman,restoration,63,36,27
45025,Køtømine,ragnaros,1491,shaman,restoration,106,67,39
45026,Ärtful,illidan,1491,shaman,restoration,102,55,47
45027,Bwinthewomb,stormrage,1491,shaman,restoration,148,77,71
45028,Vanklayser,ragnaros,1491,shaman,restoration,108,54,54
45029,Mentyb,emerald-dream,1491,shaman,restoration,42,16,26
45030,Zombaschamy,ragnaros,1490,shaman,restoration,30,17,13
45031,Flamehorns,malganis,1490,shaman,restoration,83,44,39
45032,Thunderphury,proudmoore,1490,shaman,restoration,119,53,66
45033,Koomrog,frostmourne,1489,shaman,restoration,32,21,11
45034,Mkyz,tichondrius,1488,shaman,restoration,103,54,49
45035,Hoboman,chogall,1488,shaman,restoration,42,17,25
45036,Hyonkh,tichondrius,1487,shaman,restoration,77,45,32
45037,Yarl,ragnaros,1487,shaman,restoration,42,24,18
45038,Phrophetzee,altar-of-storms,1487,shaman,restoration,51,23,28
45039,Kaaying,tichondrius,1487,shaman,restoration,43,17,26
45040,Jaegertotem,stormrage,1486,shaman,restoration,42,21,21
45041,Damoclez,jubeithos,1486,shaman,restoration,57,23,34
45042,Boryndor,stormrage,1484,shaman,restoration,42,23,19
45043,Jizzlewizwiz,tichondrius,1484,shaman,restoration,181,89,92
45044,Sittinn,malganis,1484,shaman,restoration,78,37,41
45045,Slowpo,illidan,1484,shaman,restoration,47,16,31
45046,Worldx,barthilas,1483,shaman,restoration,162,79,83
45047,Trenhance,stormrage,1481,shaman,restoration,30,23,7
45048,Krewesham,uldaman,1481,shaman,restoration,28,17,11
45049,Abellone,tichondrius,1480,shaman,restoration,33,17,16
45050,Elementols,azralon,1480,shaman,restoration,48,23,25
45051,Hachikø,frostmourne,1480,shaman,restoration,95,44,51
45052,Vazlah,tichondrius,1479,shaman,restoration,24,16,8
45053,Rekashaki,illidan,1479,shaman,restoration,36,19,17
45054,Velesa,kiljaeden,1479,shaman,restoration,54,20,34
45055,Mlpz,black-dragonflight,1478,shaman,restoration,84,47,37
45056,Rumkin,malganis,1478,shaman,restoration,106,58,48
45057,Wuruizec,illidan,1478,shaman,restoration,65,32,33
45058,Boohaha,khadgar,1478,shaman,restoration,35,16,19
45059,Umadilia,area-52,1477,shaman,restoration,32,21,11
45060,Ryukims,tichondrius,1477,shaman,restoration,35,17,18
45061,Miroen,tichondrius,1477,shaman,restoration,146,70,76
45062,Sistronok,bleeding-hollow,1476,shaman,restoration,30,16,14
45063,Ellgric,emerald-dream,1476,shaman,restoration,48,21,27
45064,Defac,proudmoore,1475,shaman,restoration,72,42,30
45065,Maxchungie,azshara,1475,shaman,restoration,30,16,14
45066,Angelabaaby,proudmoore,1475,shaman,restoration,60,28,32
45067,Bakayarøu,tichondrius,1475,shaman,restoration,36,16,20
45068,Yossarabi,bleeding-hollow,1475,shaman,restoration,54,23,31
45069,Vewdew,guldan,1473,shaman,restoration,78,47,31
45070,Unchaman,ragnaros,1472,shaman,restoration,157,78,79
45071,Brainal,sargeras,1472,shaman,restoration,60,25,35
45072,Gluestix,bleeding-hollow,1471,shaman,restoration,43,26,17
45073,Upholderxo,shadowmoon,1471,shaman,restoration,48,25,23
45074,Pissticles,bleeding-hollow,1471,shaman,restoration,150,75,75
45075,Heebeegeebee,stormrage,1470,shaman,restoration,51,31,20
45076,Erthshawk,wildhammer,1470,shaman,restoration,84,44,40
45077,Sàuron,tichondrius,1467,shaman,restoration,180,100,80
45078,Krilick,blackrock,1467,shaman,restoration,107,57,50
45079,Keenie,shadow-council,1467,shaman,restoration,35,17,18
45080,Gangzmmsk,tichondrius,1466,shaman,restoration,24,18,6
45081,Philbert,boulderfist,1466,shaman,restoration,54,31,23
45082,Whoshealing,lightninghoof,1466,shaman,restoration,114,59,55
45083,Stylesp,area-52,1465,shaman,restoration,131,63,68
45084,Springtide,thrall,1464,shaman,restoration,83,43,40
45085,Kandin,icecrown,1462,shaman,restoration,94,51,43
45086,Xiwg,tichondrius,1462,shaman,restoration,72,31,41
45087,Gattious,illidan,1461,shaman,restoration,72,35,37
45088,Hirah,frostmourne,1460,shaman,restoration,23,16,7
45089,Sarkhanvol,aggramar,1460,shaman,restoration,42,27,15
45090,Smartakkar,emerald-dream,1460,shaman,restoration,57,36,21
45091,Thegil,tichondrius,1460,shaman,restoration,102,47,55
45092,Benta,zuljin,1459,shaman,restoration,72,36,36
45093,Nilstorm,quelthalas,1458,shaman,restoration,72,38,34
45094,Graveman,illidan,1457,shaman,restoration,142,79,63
45095,Kwzy,stormrage,1457,shaman,restoration,51,26,25
45096,Pickledegg,tichondrius,1456,shaman,restoration,51,27,24
45097,Teerex,tortheldrin,1456,shaman,restoration,75,38,37
45098,Tizz,quelthalas,1456,shaman,restoration,112,54,58
45099,Draüguss,azralon,1456,shaman,restoration,155,74,81
45100,Freakytiki,azshara,1455,shaman,restoration,52,34,18
45101,Furrytotems,darkspear,1455,shaman,restoration,126,56,70
45102,Trewlolz,sargeras,1454,shaman,restoration,48,24,24
45103,Juicypork,moon-guard,1453,shaman,restoration,44,24,20
45104,Ironcrag,moon-guard,1453,shaman,restoration,259,134,125
45105,Rinnan,malganis,1453,shaman,restoration,103,48,55
45106,Skelesham,zuljin,1452,shaman,restoration,48,33,15
45107,Crittingbull,veknilash,1452,shaman,restoration,214,111,103
45108,Carltonbanks,aggramar,1452,shaman,restoration,36,18,18
45109,Splonkydonky,stonemaul,1450,shaman,restoration,30,18,12
45110,Tidalstorm,ragnaros,1450,shaman,restoration,90,52,38
45111,Pamaj,kelthuzad,1450,shaman,restoration,99,44,55
45112,Jwondo,area-52,1450,shaman,restoration,56,23,33
45113,Mäjorlazer,lightbringer,1449,shaman,restoration,38,19,19
45114,Buffduude,shadowsong,1449,shaman,restoration,48,22,26
45115,Aguinha,azralon,1448,shaman,restoration,78,38,40
45116,Flubydont,icecrown,1448,shaman,restoration,96,44,52
45117,Blowurbubble,tichondrius,1447,shaman,restoration,42,24,18
45118,Anußis,stormrage,1447,shaman,restoration,65,25,40
45119,Circuits,malganis,1446,shaman,restoration,58,30,28
45120,Maakasarg,tichondrius,1445,shaman,restoration,54,24,30
45121,Rommel,azralon,1444,shaman,restoration,57,32,25
45122,Midew,proudmoore,1443,shaman,restoration,45,22,23
45123,Elementorx,stormrage,1443,shaman,restoration,80,38,42
45124,Milkkshake,illidan,1443,shaman,restoration,256,119,137
45125,Boozi,sargeras,1442,shaman,restoration,48,24,24
45126,Alexustexas,tichondrius,1441,shaman,restoration,90,50,40
45127,Wumx,tichondrius,1441,shaman,restoration,54,22,32
45128,Wuargh,area-52,1440,shaman,restoration,220,118,102
45129,Badjojò,ragnaros,1439,shaman,restoration,30,15,15
45130,Breadx,khaz-modan,1439,shaman,restoration,30,15,15
45131,Praxis,tichondrius,1437,shaman,restoration,154,79,75
45132,Miketheseal,bleeding-hollow,1437,shaman,restoration,36,15,21
45133,Jhakrï,tichondrius,1437,shaman,restoration,36,15,21
45134,Owtyobwol,area-52,1436,shaman,restoration,24,15,9
45135,Creatine,area-52,1436,shaman,restoration,71,37,34
45136,Fluiid,tichondrius,1435,shaman,restoration,30,15,15
45137,Jimmymaclroy,frostmourne,1435,shaman,restoration,114,56,58
45138,Dawny,arygos,1435,shaman,restoration,36,15,21
45139,Wardruna,andorhal,1434,shaman,restoration,24,15,9
45140,Ãrthor,stormrage,1434,shaman,restoration,78,42,36
45141,Klimax,tichondrius,1433,shaman,restoration,36,18,18
45142,Geser,silvermoon,1432,shaman,restoration,44,26,18
45143,Haard,area-52,1432,shaman,restoration,30,15,15
45144,Thormør,tichondrius,1432,shaman,restoration,31,15,16
45145,Zaxxrie,sargeras,1432,shaman,restoration,69,26,43
45146,Shamjam,moon-guard,1431,shaman,restoration,24,15,9
45147,Buffdestru,azralon,1431,shaman,restoration,116,66,50
45148,Bluebones,frostmane,1431,shaman,restoration,30,17,13
45149,Insertyzs,azralon,1431,shaman,restoration,66,36,30
45150,Kabasan,illidan,1431,shaman,restoration,60,27,33
45151,Totem,burning-legion,1431,shaman,restoration,36,16,20
45152,Hugebrain,proudmoore,1431,shaman,restoration,124,50,74
45153,Fatherrtime,illidan,1430,shaman,restoration,48,26,22
45154,Galeswind,sargeras,1430,shaman,restoration,72,36,36
45155,Joeschhmoe,tichondrius,1430,shaman,restoration,42,20,22
45156,Totembarx,illidan,1428,shaman,restoration,42,29,13
45157,Grimtar,burning-blade,1428,shaman,restoration,24,16,8
45158,Savs,tichondrius,1428,shaman,restoration,24,15,9
45159,Santiagodx,ragnaros,1427,shaman,restoration,277,135,142
45160,Harbert,black-dragonflight,1426,shaman,restoration,199,105,94
45161,Macdab,malganis,1425,shaman,restoration,42,23,19
45162,Arkuldash,tichondrius,1425,shaman,restoration,54,27,27
45163,Torric,kalecgos,1424,shaman,restoration,66,31,35
45164,Kelta,kelthuzad,1423,shaman,restoration,30,15,15
45165,Atorinà,tichondrius,1423,shaman,restoration,30,15,15
45166,Idowhatcdont,kelthuzad,1421,shaman,restoration,24,15,9
45167,Kephax,eonar,1421,shaman,restoration,123,62,61
45168,Boonno,tichondrius,1421,shaman,restoration,36,15,21
45169,Samanl,tichondrius,1420,shaman,restoration,77,44,33
45170,Nanishock,area-52,1420,shaman,restoration,57,30,27
45171,Cinematticz,tichondrius,1420,shaman,restoration,101,51,50
45172,Pýe,bleeding-hollow,1420,shaman,restoration,42,21,21
45173,Mcshocks,area-52,1419,shaman,restoration,66,37,29
45174,Slothstorm,barthilas,1419,shaman,restoration,59,31,28
45175,Pümba,azralon,1419,shaman,restoration,30,15,15
45176,Azumaa,tichondrius,1419,shaman,restoration,233,112,121
45177,Blaydin,elune,1416,shaman,restoration,24,15,9
45178,Tundertotem,tichondrius,1414,shaman,restoration,80,46,34
45179,Djshammy,barthilas,1414,shaman,restoration,80,42,38
45180,Lunds,tichondrius,1414,shaman,restoration,30,15,15
45181,Vajoku,proudmoore,1414,shaman,restoration,48,22,26
45182,Massif,emerald-dream,1414,shaman,restoration,37,16,21
45183,Bearmanshrek,tichondrius,1414,shaman,restoration,72,26,46
45184,Subnôize,bleeding-hollow,1412,shaman,restoration,129,71,58
45185,Tawahka,hyjal,1412,shaman,restoration,179,87,92
45186,Silhoustes,ragnaros,1411,shaman,restoration,24,15,9
45187,Voluptuous,mannoroth,1411,shaman,restoration,549,277,272
45188,Enflexi,lightbringer,1411,shaman,restoration,53,26,27
45189,Orkwa,bleeding-hollow,1410,shaman,restoration,68,32,36
45190,Otem,frostmourne,1410,shaman,restoration,50,23,27
45191,Goatpornbad,sargeras,1410,shaman,restoration,108,48,60
45192,Catchclause,eonar,1409,shaman,restoration,30,15,15
45193,Meshugga,scarlet-crusade,1409,shaman,restoration,48,23,25
45194,Farö,azralon,1409,shaman,restoration,47,18,29
45195,Xaltas,moon-guard,1407,shaman,restoration,52,33,19
45196,Kaili,illidan,1407,shaman,restoration,63,37,26
45197,Elenix,area-52,1406,shaman,restoration,42,22,20
45198,Odïn,tichondrius,1405,shaman,restoration,53,27,26
45199,Uwuxdlol,tichondrius,1404,shaman,restoration,35,20,15
45200,Sindury,tichondrius,1404,shaman,restoration,216,120,96
45201,Shamfold,illidan,1404,shaman,restoration,30,15,15
45202,Zizö,barthilas,1404,shaman,restoration,42,19,23
45203,Performix,sargeras,1404,shaman,restoration,36,15,21
45204,Ryùko,proudmoore,1404,shaman,restoration,78,30,48
45205,Yamazakì,nemesis,1404,shaman,restoration,51,19,32
45206,Meanbetty,illidan,1403,shaman,restoration,30,17,13
45207,Elex,frostmourne,1403,shaman,restoration,93,41,52
45208,Supdaug,vashj,1402,shaman,restoration,66,32,34
45209,Sploosh,norgannon,1401,shaman,restoration,36,20,16
45210,Reignz,moonrunner,1401,shaman,restoration,45,24,21
45211,Bluetooth,stormrage,1401,shaman,restoration,89,39,50
45212,Graymatterz,ysondre,1399,shaman,restoration,72,34,38
45213,Totemhype,tichondrius,1398,shaman,restoration,74,41,33
45214,Wazskood,stormrage,1398,shaman,restoration,137,66,71
45215,Jfrzd,tichondrius,1397,shaman,restoration,31,21,10
45216,Shaquillius,tichondrius,1397,shaman,restoration,72,35,37
45217,Totemgoddess,nemesis,1397,shaman,restoration,66,30,36
45218,Xdxs,norgannon,1397,shaman,restoration,36,16,20
45219,Drinkharder,stormrage,1395,shaman,restoration,34,16,18
45220,Arginine,tichondrius,1395,shaman,restoration,42,15,27
45221,Curador,nemesis,1394,shaman,restoration,39,24,15
45222,Aceshamm,kelthuzad,1394,shaman,restoration,90,49,41
45223,Jakjohnson,stormrage,1393,shaman,restoration,33,18,15
45224,Kakiscala,proudmoore,1393,shaman,restoration,30,16,14
45225,ßøvîn,thrall,1393,shaman,restoration,71,36,35
45226,Siyusm,illidan,1393,shaman,restoration,72,25,47
45227,Eggrollninja,illidan,1392,shaman,restoration,24,17,7
45228,Mikeyodinson,area-52,1392,shaman,restoration,41,20,21
45229,Windfrenzy,thrall,1392,shaman,restoration,36,15,21
45230,Largeshaman,zuljin,1391,shaman,restoration,30,15,15
45231,Rizam,malganis,1389,shaman,restoration,42,33,9
45232,Kirawindu,zuljin,1387,shaman,restoration,69,39,30
45233,Udungoofedd,the-underbog,1387,shaman,restoration,42,23,19
45234,Halloweenz,area-52,1387,shaman,restoration,30,16,14
45235,Cowtidetotem,thrall,1387,shaman,restoration,36,19,17
45236,Charmize,azralon,1387,shaman,restoration,103,54,49
45237,Woodrose,frostmourne,1387,shaman,restoration,94,46,48
45238,Killercam,maiev,1387,shaman,restoration,282,135,147
45239,Soowecide,tichondrius,1387,shaman,restoration,60,23,37
45240,Rykku,illidan,1386,shaman,restoration,30,16,14
45241,Shazik,spirestone,1386,shaman,restoration,54,21,33
45242,Jodalo,ragnaros,1385,shaman,restoration,173,92,81
45243,Fungus,firetree,1384,shaman,restoration,48,26,22
45244,Windpowa,blackrock,1384,shaman,restoration,42,19,23
45245,Fishman,exodar,1382,shaman,restoration,101,45,56
45246,Spiritwler,tichondrius,1381,shaman,restoration,42,20,22
45247,Çruces,illidan,1381,shaman,restoration,36,17,19
45248,Siggmaster,chogall,1381,shaman,restoration,48,19,29
45249,Indesham,drenden,1380,shaman,restoration,34,17,17
45250,Lanuur,moon-guard,1379,shaman,restoration,54,31,23
45251,Nyathera,barthilas,1378,shaman,restoration,90,50,40
45252,Ottoman,eredar,1378,shaman,restoration,75,32,43
45253,Leca,tichondrius,1378,shaman,restoration,90,38,52
45254,Destrino,area-52,1377,shaman,restoration,48,23,25
45255,Darado,kiljaeden,1377,shaman,restoration,45,20,25
45256,Hannamayzing,arathor,1377,shaman,restoration,36,16,20
45257,Libragirl,tichondrius,1375,shaman,restoration,148,75,73
45258,Psiexrcst,tichondrius,1375,shaman,restoration,72,29,43
45259,Ahaw,area-52,1374,shaman,restoration,78,47,31
45260,Roxzid,area-52,1374,shaman,restoration,57,33,24
45261,Jensenx,proudmoore,1374,shaman,restoration,82,38,44
45262,Shamicare,stormrage,1373,shaman,restoration,142,79,63
45263,Bitxxnumber,tichondrius,1372,shaman,restoration,287,151,136
45264,Earthsrage,illidan,1372,shaman,restoration,42,22,20
45265,Cameltótém,sargeras,1372,shaman,restoration,48,25,23
45266,Desgarcon,zuljin,1370,shaman,restoration,119,64,55
45267,Blackoutsx,stormreaver,1369,shaman,restoration,28,15,13
45268,Gromgrai,bleeding-hollow,1368,shaman,restoration,53,30,23
45269,Shamito,ragnaros,1368,shaman,restoration,51,24,27
45270,Treasonreno,area-52,1368,shaman,restoration,108,47,61
45271,Thenextcdew,illidan,1367,shaman,restoration,48,26,22
45272,Záheer,arthas,1367,shaman,restoration,77,38,39
45273,Onlytidez,area-52,1367,shaman,restoration,77,35,42
45274,Bazinguinha,azralon,1366,shaman,restoration,88,42,46
45275,Thunderborn,laughing-skull,1366,shaman,restoration,36,16,20
45276,Aargonos,tichondrius,1365,shaman,restoration,29,23,6
45277,Sheared,area-52,1365,shaman,restoration,66,34,32
45278,Krevsham,proudmoore,1364,shaman,restoration,56,23,33
45279,Ralinta,tichondrius,1364,shaman,restoration,77,27,50
45280,Kunchan,zuluhed,1362,shaman,restoration,24,16,8
45281,Edhance,area-52,1362,shaman,restoration,119,66,53
45282,Wyått,emerald-dream,1359,shaman,restoration,95,43,52
45283,Djbs,stormrage,1358,shaman,restoration,77,32,45
45284,Karmatide,malganis,1357,shaman,restoration,36,24,12
45285,Kiojin,ragnaros,1357,shaman,restoration,186,99,87
45286,Wagesisdeath,illidan,1357,shaman,restoration,36,17,19
45287,Ndz,anubarak,1356,shaman,restoration,72,41,31
45288,Tamzlol,the-forgotten-coast,1356,shaman,restoration,35,15,20
45289,Wooskier,tichondrius,1355,shaman,restoration,60,32,28
45290,Elementgodx,skullcrusher,1354,shaman,restoration,54,27,27
45291,Urin,emerald-dream,1354,shaman,restoration,39,17,22
45292,Hamshamwitch,shadowmoon,1353,shaman,restoration,36,17,19
45293,Atnaz,drakkari,1352,shaman,restoration,42,24,18
45294,Tumble,frostmourne,1352,shaman,restoration,105,51,54
45295,Amperage,spirestone,1352,shaman,restoration,70,33,37
45296,Asskrap,daggerspine,1350,shaman,restoration,46,25,21
45297,Chandye,proudmoore,1348,shaman,restoration,72,27,45
45298,Daddyk,gnomeregan,1347,shaman,restoration,53,30,23
45299,Greenenergy,tichondrius,1346,shaman,restoration,60,32,28
45300,Balsonz,zuljin,1346,shaman,restoration,30,16,14
45301,Lleonardo,tichondrius,1346,shaman,restoration,54,24,30
45302,Imaspirit,malganis,1346,shaman,restoration,60,25,35
45303,Lildunny,tichondrius,1346,shaman,restoration,36,15,21
45304,Zuljiba,illidan,1345,shaman,restoration,66,39,27
45305,Fàrrò,thrall,1345,shaman,restoration,66,39,27
45306,Cethun,amanthul,1345,shaman,restoration,67,32,35
45307,Xajsham,tichondrius,1344,shaman,restoration,102,54,48
45308,Kultirio,quelthalas,1344,shaman,restoration,61,32,29
45309,Elemen,quelthalas,1344,shaman,restoration,97,48,49
45310,Smniss,tichondrius,1344,shaman,restoration,49,23,26
45311,Zinns,dalaran,1344,shaman,restoration,105,49,56
45312,Orochishaman,stormrage,1343,shaman,restoration,24,14,10
45313,Quequin,quelthalas,1343,shaman,restoration,42,21,21
45314,Touchmytotmm,tichondrius,1342,shaman,restoration,24,14,10
45315,Dwârf,tichondrius,1342,shaman,restoration,24,14,10
45316,Weathersmell,sargeras,1341,shaman,restoration,24,14,10
45317,Crazytotems,dalaran,1341,shaman,restoration,138,71,67
45318,Juvîa,emerald-dream,1341,shaman,restoration,91,38,53
45319,Shockpanda,zuljin,1340,shaman,restoration,18,14,4
45320,Fallhazard,malganis,1340,shaman,restoration,40,24,16
45321,Mudlùst,moon-guard,1339,shaman,restoration,77,40,37
45322,Kachupinsito,ragnaros,1339,shaman,restoration,91,45,46
45323,Uhd,malganis,1339,shaman,restoration,44,21,23
45324,Rzzn,sargeras,1338,shaman,restoration,24,14,10
45325,Shockbot,stormscale,1338,shaman,restoration,67,30,37
45326,Foray,barthilas,1337,shaman,restoration,60,34,26
45327,Furiousnick,stormrage,1337,shaman,restoration,31,15,16
45328,Nagiska,ragnaros,1337,shaman,restoration,34,16,18
45329,Shamkack,kelthuzad,1337,shaman,restoration,89,41,48
45330,Enemyanemone,area-52,1336,shaman,restoration,24,14,10
45331,Earthentotem,tichondrius,1336,shaman,restoration,24,14,10
45332,Orbys,illidan,1335,shaman,restoration,24,14,10
45333,Tayictwo,tichondrius,1335,shaman,restoration,30,14,16
45334,Fläkky,tichondrius,1334,shaman,restoration,30,18,12
45335,Satrixss,ragnaros,1334,shaman,restoration,79,44,35
45336,Aseew,drakkari,1334,shaman,restoration,66,31,35
45337,Woof,agamaggan,1334,shaman,restoration,47,16,31
45338,Nagumi,ragnaros,1333,shaman,restoration,24,16,8
45339,Nerfmytotemz,frostmourne,1333,shaman,restoration,30,14,16
45340,Joyrider,sargeras,1332,shaman,restoration,54,28,26
45341,Totemrack,tichondrius,1332,shaman,restoration,64,32,32
45342,Alátreon,azralon,1332,shaman,restoration,66,30,36
45343,Mudtide,tichondrius,1331,shaman,restoration,72,42,30
45344,Ixis,bleeding-hollow,1331,shaman,restoration,24,14,10
45345,Mengemort,crushridge,1331,shaman,restoration,69,38,31
45346,Lurue,tichondrius,1331,shaman,restoration,42,21,21
45347,Edisto,darkspear,1331,shaman,restoration,30,14,16
45348,Getco,tichondrius,1330,shaman,restoration,42,18,24
45349,Tampíco,ragnaros,1330,shaman,restoration,36,14,22
45350,Joriko,magtheridon,1330,shaman,restoration,36,14,22
45351,Exussh,tichondrius,1329,shaman,restoration,18,15,3
45352,Eccentrix,mannoroth,1329,shaman,restoration,36,14,22
45353,Angron,barthilas,1328,shaman,restoration,34,21,13
45354,Elmoss,thrall,1328,shaman,restoration,36,14,22
45355,Huroth,proudmoore,1328,shaman,restoration,42,14,28
45356,Shimansham,aegwynn,1327,shaman,restoration,235,116,119
45357,Vibration,akama,1326,shaman,restoration,153,80,73
45358,Barbosina,stormrage,1326,shaman,restoration,226,116,110
45359,Azhen,ragnaros,1326,shaman,restoration,138,69,69
45360,Tchaishammy,tichondrius,1326,shaman,restoration,29,14,15
45361,Noobcrits,tichondrius,1325,shaman,restoration,48,27,21
45362,Meatballer,queldorei,1325,shaman,restoration,83,45,38
45363,Ginkuma,illidan,1325,shaman,restoration,30,14,16
45364,Afgoox,tichondrius,1324,shaman,restoration,84,47,37
45365,Klausnomi,jaedenar,1324,shaman,restoration,48,21,27
45366,Oriyani,sargeras,1323,shaman,restoration,30,14,16
45367,Fedinho,azralon,1322,shaman,restoration,30,19,11
45368,Orcaninja,zuljin,1322,shaman,restoration,28,15,13
45369,Restosud,crushridge,1320,shaman,restoration,30,18,12
45370,Ondra,frostmourne,1320,shaman,restoration,48,24,24
45371,Kisimi,proudmoore,1319,shaman,restoration,30,18,12
45372,Cleanfossil,stormrage,1319,shaman,restoration,41,24,17
45373,Bearlysober,draka,1319,shaman,restoration,68,37,31
45374,Boggins,dalaran,1318,shaman,restoration,52,25,27
45375,Clutchinbuds,malganis,1318,shaman,restoration,54,24,30
45376,Badião,azralon,1318,shaman,restoration,131,58,73
45377,Latosos,dalaran,1317,shaman,restoration,36,15,21
45378,Tidalchief,dalaran,1316,shaman,restoration,58,40,18
45379,Aemi,tichondrius,1316,shaman,restoration,120,57,63
45380,Roostershama,tichondrius,1316,shaman,restoration,115,50,65
45381,Phtalid,dalaran,1314,shaman,restoration,88,45,43
45382,Beardcramps,tichondrius,1314,shaman,restoration,84,42,42
45383,Schav,stormrage,1313,shaman,restoration,33,19,14
45384,Raikages,whisperwind,1312,shaman,restoration,48,22,26
45385,Darrann,kiljaeden,1311,shaman,restoration,30,20,10
45386,Goub,skullcrusher,1310,shaman,restoration,24,14,10
45387,Ithappens,senjin,1310,shaman,restoration,30,16,14
45388,Prøduce,tichondrius,1310,shaman,restoration,66,34,32
45389,Orlá,moon-guard,1310,shaman,restoration,54,18,36
45390,Kazino,stormrage,1309,shaman,restoration,28,18,10
45391,Yeetle,gorefiend,1309,shaman,restoration,52,27,25
45392,Sharmut,bleeding-hollow,1309,shaman,restoration,136,68,68
45393,Hefestos,nemesis,1309,shaman,restoration,30,14,16
45394,Absorblife,barthilas,1309,shaman,restoration,69,31,38
45395,Mooshi,exodar,1309,shaman,restoration,69,27,42
45396,Brosidan,anvilmar,1308,shaman,restoration,62,38,24
45397,Medzoe,tichondrius,1307,shaman,restoration,28,15,13
45398,Sukthistotem,kelthuzad,1306,shaman,restoration,30,20,10
45399,Fencepost,bleeding-hollow,1306,shaman,restoration,114,61,53
45400,Cónò,tichondrius,1306,shaman,restoration,108,52,56
45401,Toteapole,malganis,1305,shaman,restoration,94,51,43
45402,Torgah,tichondrius,1305,shaman,restoration,90,44,46
45403,Fíxer,tichondrius,1304,shaman,restoration,85,44,41
45404,Solaraa,proudmoore,1304,shaman,restoration,64,31,33
45405,Genjuu,proudmoore,1304,shaman,restoration,42,20,22
45406,Hüsky,dalaran,1303,shaman,restoration,42,14,28
45407,Babytiramisu,stormrage,1302,shaman,restoration,46,24,22
45408,Tumble,barthilas,1302,shaman,restoration,52,26,26
45409,Badgeshock,area-52,1301,shaman,restoration,108,48,60
45410,Cæl,azralon,1300,shaman,restoration,35,20,15
45411,Tedmosbe,tichondrius,1300,shaman,restoration,84,37,47
45412,Tartar,lightbringer,1299,shaman,restoration,99,60,39
45413,Pushaheal,tichondrius,1299,shaman,restoration,54,31,23
45414,Enalen,argent-dawn,1299,shaman,restoration,61,35,26
45415,Teardrinker,korgath,1299,shaman,restoration,94,46,48
45416,Yarockheal,malganis,1298,shaman,restoration,54,27,27
45417,Bigtoy,frostmane,1296,shaman,restoration,42,14,28
45418,Tequíla,quelthalas,1295,shaman,restoration,24,14,10
45419,Krishshammy,azshara,1295,shaman,restoration,171,86,85
45420,Sòlemn,burning-legion,1295,shaman,restoration,61,22,39
45421,Qitian,tichondrius,1294,shaman,restoration,36,14,22
45422,Defnotheals,kelthuzad,1293,shaman,restoration,90,42,48
45423,Dewstorm,tichondrius,1293,shaman,restoration,41,18,23
45424,Jetstream,shadow-council,1293,shaman,restoration,42,16,26
45425,Izarmona,bleeding-hollow,1292,shaman,restoration,24,15,9
45426,Valst,kiljaeden,1292,shaman,restoration,69,33,36
45427,Slaggdaddy,durotan,1292,shaman,restoration,30,14,16
45428,Murata,tichondrius,1291,shaman,restoration,30,16,14
45429,Totemist,tichondrius,1291,shaman,restoration,54,23,31
45430,Aviator,muradin,1288,shaman,restoration,36,19,17
45431,Problamatic,tichondrius,1288,shaman,restoration,30,14,16
45432,Belgrom,tichondrius,1287,shaman,restoration,42,23,19
45433,Tacho,bleeding-hollow,1287,shaman,restoration,114,56,58
45434,Zetli,tichondrius,1287,shaman,restoration,72,30,42
45435,Twinkolava,nemesis,1286,shaman,restoration,37,23,14
45436,Drazic,area-52,1286,shaman,restoration,49,28,21
45437,Mynigabob,zuljin,1285,shaman,restoration,148,83,65
45438,Uhfishuhl,bleeding-hollow,1285,shaman,restoration,30,16,14
45439,Shamorrhoids,frostmourne,1285,shaman,restoration,137,70,67
45440,Nezzuk,quelthalas,1285,shaman,restoration,96,42,54
45441,Lollzerz,the-forgotten-coast,1285,shaman,restoration,42,16,26
45442,Turblix,tichondrius,1284,shaman,restoration,69,44,25
45443,Ketaminedrip,illidan,1284,shaman,restoration,42,22,20
45444,Stargun,korgath,1284,shaman,restoration,147,76,71
45445,Shämwow,agamaggan,1284,shaman,restoration,838,417,421
45446,Feldstar,stormrage,1284,shaman,restoration,103,47,56
45447,Sparks,ragnaros,1284,shaman,restoration,95,43,52
45448,Strohz,undermine,1282,shaman,restoration,42,21,21
45449,Tym,sargeras,1281,shaman,restoration,42,22,20
45450,Karrydoskftw,ragnaros,1281,shaman,restoration,151,74,77
45451,Alraxion,ragnaros,1281,shaman,restoration,84,41,43
45452,Jabjor,malganis,1281,shaman,restoration,66,25,41
45453,Ulala,azshara,1280,shaman,restoration,72,31,41
45454,Hasselshock,area-52,1280,shaman,restoration,94,40,54
45455,Mudeng,tichondrius,1276,shaman,restoration,60,30,30
45456,Eekumbokum,bleeding-hollow,1275,shaman,restoration,74,39,35
45457,Wunderwaffe,the-underbog,1274,shaman,restoration,102,48,54
45458,Surgedarknes,sargeras,1273,shaman,restoration,27,15,12
45459,Trúnks,magtheridon,1273,shaman,restoration,102,48,54
45460,Retgarr,tichondrius,1272,shaman,restoration,30,17,13
45461,Foodlust,sargeras,1272,shaman,restoration,108,57,51
45462,Tákhisis,darkspear,1271,shaman,restoration,72,33,39
45463,Zugpug,emerald-dream,1271,shaman,restoration,36,14,22
45464,Mythshaman,tichondrius,1270,shaman,restoration,81,33,48
45465,Angelicrain,stormrage,1269,shaman,restoration,30,16,14
45466,Twoflower,frostmourne,1269,shaman,restoration,200,100,100
45467,Derkx,thrall,1268,shaman,restoration,30,22,8
45468,Thomastides,tichondrius,1268,shaman,restoration,78,36,42
45469,Ragerax,trollbane,1266,shaman,restoration,29,18,11
45470,Killdeaderer,barthilas,1266,shaman,restoration,136,79,57
45471,Kripnotik,nathrezim,1266,shaman,restoration,42,16,26
45472,Rahkani,kiljaeden,1265,shaman,restoration,77,39,38
45473,Joocer,emerald-dream,1265,shaman,restoration,102,48,54
45474,Shiestys,tichondrius,1264,shaman,restoration,33,23,10
45475,Shohzegky,azralon,1264,shaman,restoration,97,43,54
45476,Dodirt,laughing-skull,1263,shaman,restoration,30,17,13
45477,Kunio,proudmoore,1261,shaman,restoration,42,22,20
45478,Taò,tichondrius,1261,shaman,restoration,138,65,73
45479,Menah,moon-guard,1260,shaman,restoration,36,20,16
45480,Chagun,illidan,1259,shaman,restoration,36,20,16
45481,Shammimane,tichondrius,1259,shaman,restoration,185,95,90
45482,Hateshifter,kul-tiras,1259,shaman,restoration,36,14,22
45483,Hauby,zuljin,1259,shaman,restoration,48,15,33
45484,Jru,tichondrius,1257,shaman,restoration,31,14,17
45485,Abcmbx,illidan,1255,shaman,restoration,47,20,27
45486,Hicys,azralon,1253,shaman,restoration,161,81,80
45487,Tigrains,proudmoore,1252,shaman,restoration,29,15,14
45488,Ironcaulk,kelthuzad,1252,shaman,restoration,54,26,28
45489,Mòo,barthilas,1252,shaman,restoration,30,14,16
45490,Luto,tichondrius,1251,shaman,restoration,130,71,59
45491,Grandbunder,tichondrius,1251,shaman,restoration,30,14,16
45492,Blodbar,kiljaeden,1249,shaman,restoration,36,24,12
45493,Evilabev,bonechewer,1248,shaman,restoration,24,13,11
45494,Toroph,azralon,1248,shaman,restoration,30,16,14
45495,Jaandar,saurfang,1248,shaman,restoration,171,86,85
45496,Bigwave,zuluhed,1248,shaman,restoration,30,15,15
45497,Swinginwilly,barthilas,1248,shaman,restoration,36,14,22
45498,Bubbert,illidan,1248,shaman,restoration,60,21,39
45499,Tôôz,stormrage,1247,shaman,restoration,18,13,5
45500,Kosiee,frostmourne,1247,shaman,restoration,24,13,11
45501,Peanutto,illidan,1246,shaman,restoration,156,87,69
45502,Graebrah,tichondrius,1246,shaman,restoration,24,13,11
45503,Momolagbbit,tichondrius,1246,shaman,restoration,24,13,11
45504,Crakmane,kelthuzad,1245,shaman,restoration,18,13,5
45505,Tays,tichondrius,1245,shaman,restoration,18,13,5
45506,Scape,emerald-dream,1244,shaman,restoration,18,13,5
45507,Aelwydx,quelthalas,1244,shaman,restoration,287,145,142
45508,Tonka,area-52,1244,shaman,restoration,30,13,17
45509,Shoxx,wyrmrest-accord,1243,shaman,restoration,24,13,11
45510,Orjamba,barthilas,1243,shaman,restoration,88,42,46
45511,Zqshaman,tichondrius,1243,shaman,restoration,30,14,16
45512,Jsoto,ghostlands,1243,shaman,restoration,30,13,17
45513,Stackinheals,thrall,1243,shaman,restoration,42,15,27
45514,Wastedlink,tichondrius,1242,shaman,restoration,24,13,11
45515,Darkn,cenarion-circle,1242,shaman,restoration,36,18,18
45516,Blueteam,blackrock,1242,shaman,restoration,30,13,17
45517,Youarenothim,area-52,1241,shaman,restoration,18,13,5
45518,Savjsh,illidan,1241,shaman,restoration,30,13,17
45519,Chenguanxi,tichondrius,1240,shaman,restoration,18,13,5
45520,Rocksbury,malganis,1240,shaman,restoration,24,13,11
45521,Quady,zuljin,1240,shaman,restoration,24,13,11
45522,Droni,emerald-dream,1240,shaman,restoration,30,16,14
45523,Keekballx,tichondrius,1240,shaman,restoration,30,13,17
45524,Nomediocur,moknathal,1240,shaman,restoration,61,24,37
45525,Spekgawd,emerald-dream,1239,shaman,restoration,18,13,5
45526,Rzul,tichondrius,1239,shaman,restoration,24,13,11
45527,Jnzz,area-52,1239,shaman,restoration,24,13,11
45528,Hearthx,perenolde,1239,shaman,restoration,30,13,17
45529,Battleobobby,medivh,1239,shaman,restoration,41,13,28
45530,Beefstocks,area-52,1238,shaman,restoration,66,32,34
45531,Entropey,daggerspine,1238,shaman,restoration,65,28,37
45532,Cheliz,thrall,1238,shaman,restoration,93,40,53
45533,Lastdwarf,tichondrius,1237,shaman,restoration,18,13,5
45534,Shamakazi,tichondrius,1237,shaman,restoration,31,14,17
45535,Wugmuk,illidan,1236,shaman,restoration,149,73,76
45536,Êdge,quelthalas,1235,shaman,restoration,69,33,36
45537,Turtleinmud,frostmourne,1234,shaman,restoration,24,13,11
45538,Zad,spinebreaker,1234,shaman,restoration,30,13,17
45539,Krolii,tichondrius,1234,shaman,restoration,80,33,47
45540,Kinjin,dragonmaw,1232,shaman,restoration,30,13,17
45541,Kommotion,proudmoore,1232,shaman,restoration,36,13,23
45542,Fênrisulfer,area-52,1231,shaman,restoration,89,37,52
45543,Klaital,boulderfist,1230,shaman,restoration,36,22,14
45544,Kikkóman,malganis,1230,shaman,restoration,48,25,23
45545,Brislin,sargeras,1230,shaman,restoration,238,117,121
45546,Kinshaman,lightnings-blade,1230,shaman,restoration,103,49,54
45547,Peppito,illidan,1229,shaman,restoration,51,29,22
45548,Edemental,area-52,1229,shaman,restoration,129,61,68
45549,Lhost,tanaris,1228,shaman,restoration,30,17,13
45550,Terdsammich,malganis,1227,shaman,restoration,51,27,24
45551,Lüca,wyrmrest-accord,1226,shaman,restoration,357,187,170
45552,Truemooin,wyrmrest-accord,1226,shaman,restoration,557,276,281
45553,Bäsedgód,tichondrius,1225,shaman,restoration,30,13,17
45554,Ozzai,ragnaros,1225,shaman,restoration,42,15,27
45555,Mishalla,tichondrius,1224,shaman,restoration,72,27,45
45556,Delíta,quelthalas,1222,shaman,restoration,71,28,43
45557,Rétt,barthilas,1220,shaman,restoration,24,15,9
45558,Hammerme,barthilas,1220,shaman,restoration,107,40,67
45559,Dcãicer,quelthalas,1219,shaman,restoration,37,23,14
45560,Hoong,garrosh,1219,shaman,restoration,32,17,15
45561,Thizzasta,blackhand,1219,shaman,restoration,40,18,22
45562,Keiox,ragnaros,1218,shaman,restoration,24,13,11
45563,Yamishka,dalaran,1218,shaman,restoration,66,29,37
45564,Donmills,tichondrius,1218,shaman,restoration,54,23,31
45565,Lavablurst,stormrage,1218,shaman,restoration,59,23,36
45566,Exportgold,barthilas,1218,shaman,restoration,42,16,26
45567,Damador,tichondrius,1218,shaman,restoration,36,13,23
45568,Shokxx,malganis,1217,shaman,restoration,72,38,34
45569,Booyahshaman,area-52,1216,shaman,restoration,36,19,17
45570,Infsham,hyjal,1216,shaman,restoration,147,66,81
45571,Spiritbear,zuljin,1215,shaman,restoration,42,27,15
45572,Valentinê,stormrage,1215,shaman,restoration,24,13,11
45573,Fenny,proudmoore,1215,shaman,restoration,41,21,20
45574,Turksham,tichondrius,1213,shaman,restoration,41,22,19
45575,Flametide,proudmoore,1212,shaman,restoration,47,27,20
45576,Mandinga,warsong,1212,shaman,restoration,92,45,47
45577,Väsain,wyrmrest-accord,1212,shaman,restoration,36,16,20
45578,Gallikano,tichondrius,1212,shaman,restoration,48,16,32
45579,Madvillainny,thrall,1211,shaman,restoration,50,26,24
45580,Smashtheface,nagrand,1211,shaman,restoration,54,27,27
45581,Chitoss,gorgonnash,1210,shaman,restoration,132,61,71
45582,Llgll,tichondrius,1210,shaman,restoration,61,24,37
45583,Dabmarinø,tichondrius,1209,shaman,restoration,30,18,12
45584,Freyttreyn,garrosh,1209,shaman,restoration,60,31,29
45585,Certz,dark-iron,1209,shaman,restoration,39,15,24
45586,Paniczone,madoran,1208,shaman,restoration,36,15,21
45587,Voodoototems,frostmourne,1207,shaman,restoration,51,25,26
45588,Alphamael,lightbringer,1207,shaman,restoration,50,20,30
45589,Plausibility,moon-guard,1206,shaman,restoration,24,13,11
45590,Paratroop,bonechewer,1206,shaman,restoration,63,27,36
45591,Watchmytrem,ragnaros,1205,shaman,restoration,72,23,49
45592,Patoron,proudmoore,1204,shaman,restoration,34,17,17
45593,Beardedone,durotan,1203,shaman,restoration,42,24,18
45594,Bluffin,stormrage,1201,shaman,restoration,24,17,7
45595,Saicey,zuljin,1201,shaman,restoration,92,48,44
45596,Magnethor,frostmourne,1200,shaman,restoration,42,24,18
45597,Thräll,shuhalo,1200,shaman,restoration,202,103,99
45598,Ogtrippleog,blackwing-lair,1200,shaman,restoration,47,19,28
45599,Phatheelz,tichondrius,1199,shaman,restoration,35,21,14
45600,Sizbo,thrall,1199,shaman,restoration,42,20,22
45601,Redbulls,azralon,1198,shaman,restoration,96,54,42
45602,Urb,moknathal,1197,shaman,restoration,32,14,18
45603,Cruelface,sargeras,1196,shaman,restoration,26,14,12
45604,Jaegeer,azralon,1195,shaman,restoration,30,16,14
45605,Taekhala,moon-guard,1192,shaman,restoration,42,13,29
45606,Grimmzhul,daggerspine,1191,shaman,restoration,133,69,64
45607,Synkrona,tichondrius,1191,shaman,restoration,38,16,22
45608,Furti,daggerspine,1190,shaman,restoration,34,16,18
45609,Thorsén,ursin,1190,shaman,restoration,54,23,31
45610,Nobiggy,tichondrius,1190,shaman,restoration,33,13,20
45611,Lankae,quelthalas,1188,shaman,restoration,24,15,9
45612,Babibolo,duskwood,1187,shaman,restoration,24,13,11
45613,Lokhtar,zuljin,1184,shaman,restoration,36,17,19
45614,Mochiko,frostmourne,1184,shaman,restoration,86,40,46
45615,Flõp,dalaran,1182,shaman,restoration,20,13,7
45616,Kencyzz,tichondrius,1182,shaman,restoration,23,13,10
45617,Getwetand,quelthalas,1182,shaman,restoration,109,54,55
45618,Reezy,draktharon,1181,shaman,restoration,23,13,10
45619,Stabix,tichondrius,1181,shaman,restoration,66,31,35
45620,Lavamama,sargeras,1180,shaman,restoration,41,15,26
45621,Rimmington,frostmourne,1179,shaman,restoration,54,24,30
45622,Shaokhang,emerald-dream,1179,shaman,restoration,82,33,49
45623,Rajin,sentinels,1178,shaman,restoration,36,18,18
45624,Houhei,stormrage,1178,shaman,restoration,36,14,22
45625,Maserati,korialstrasz,1175,shaman,restoration,64,27,37
45626,Churgarm,zuljin,1174,shaman,restoration,43,24,19
45627,Xolkrem,stormrage,1173,shaman,restoration,36,13,23
45628,Milkmeforhp,frostmourne,1170,shaman,restoration,174,87,87
45629,Vanty,proudmoore,1170,shaman,restoration,29,13,16
45630,Winry,korgath,1169,shaman,restoration,30,14,16
45631,Hedbang,kiljaeden,1169,shaman,restoration,60,24,36
45632,Wazöö,sargeras,1168,shaman,restoration,63,28,35
45633,Oomshamm,area-52,1167,shaman,restoration,130,68,62
45634,Shazikial,illidan,1167,shaman,restoration,44,21,23
45635,Rokogg,thrall,1167,shaman,restoration,43,13,30
45636,Onpoint,frostmourne,1165,shaman,restoration,23,13,10
45637,Bigfatpus,illidan,1164,shaman,restoration,26,14,12
45638,Restoramen,frostmourne,1164,shaman,restoration,43,20,23
45639,Talroh,malganis,1164,shaman,restoration,86,32,54
45640,Grakkah,thrall,1162,shaman,restoration,30,13,17
45641,Dibatotenz,azralon,1160,shaman,restoration,58,22,36
45642,Stahlman,blackhand,1160,shaman,restoration,48,17,31
45643,Youneverknow,frostmourne,1157,shaman,restoration,161,81,80
45644,Hatethetotem,bleeding-hollow,1156,shaman,restoration,52,27,25
45645,Drboidzerg,tichondrius,1154,shaman,restoration,32,20,12
45646,Lulers,cenarius,1154,shaman,restoration,48,22,26
45647,Bekrogh,azralon,1153,shaman,restoration,23,14,9
45648,Dahmerjr,area-52,1153,shaman,restoration,78,43,35
45649,Luckalicious,proudmoore,1152,shaman,restoration,18,12,6
45650,Creativemind,arathor,1152,shaman,restoration,18,12,6
45651,Tripsit,illidan,1152,shaman,restoration,30,12,18
45652,Rawdòggin,emerald-dream,1152,shaman,restoration,33,13,20
45653,Sensibleqt,tichondrius,1151,shaman,restoration,18,12,6
45654,Ruupaul,kiljaeden,1151,shaman,restoration,18,12,6
45655,Booramz,tichondrius,1151,shaman,restoration,18,12,6
45656,Xxchamana,ragnaros,1151,shaman,restoration,18,12,6
45657,Femdorfxo,frostmourne,1151,shaman,restoration,24,12,12
45658,Iightning,frostwolf,1151,shaman,restoration,30,12,18
45659,Hoatboiz,magtheridon,1151,shaman,restoration,54,14,40
45660,Gödöfbüdå,tichondrius,1150,shaman,restoration,18,12,6
45661,Scrototëm,azralon,1150,shaman,restoration,36,21,15
45662,Uglybastrd,stormrage,1150,shaman,restoration,24,12,12
45663,Ponyi,frostmourne,1150,shaman,restoration,30,12,18
45664,Oxicleanxo,sargeras,1150,shaman,restoration,30,12,18
45665,Skrubbles,mugthol,1149,shaman,restoration,18,12,6
45666,Shayprime,tichondrius,1149,shaman,restoration,24,12,12
45667,Loanomi,zuljin,1148,shaman,restoration,30,16,14
45668,Noolube,barthilas,1148,shaman,restoration,24,12,12
45669,Jineluki,emerald-dream,1148,shaman,restoration,53,23,30
45670,Funktotem,zuluhed,1148,shaman,restoration,36,12,24
45671,Adventstrike,tichondrius,1148,shaman,restoration,45,14,31
45672,Ricn,tichondrius,1147,shaman,restoration,24,12,12
45673,Xiaoxiboy,tichondrius,1147,shaman,restoration,24,12,12
45674,Branasou,emerald-dream,1147,shaman,restoration,30,12,18
45675,Nosekandyz,chogall,1147,shaman,restoration,30,12,18
45676,Tizm,stormrage,1146,shaman,restoration,24,12,12
45677,Bitruff,tichondrius,1146,shaman,restoration,24,12,12
45678,Foghoran,quelthalas,1144,shaman,restoration,24,13,11
45679,Boltadeez,tichondrius,1144,shaman,restoration,24,12,12
45680,Aegaeonlol,tichondrius,1144,shaman,restoration,24,12,12
45681,Shockalama,tichondrius,1144,shaman,restoration,84,35,49
45682,Glizzyfeast,illidan,1143,shaman,restoration,18,12,6
45683,Maheva,ragnaros,1142,shaman,restoration,18,12,6
45684,Shockburst,dalaran,1141,shaman,restoration,27,14,13
45685,Skylet,azralon,1140,shaman,restoration,24,12,12
45686,Drumman,skullcrusher,1140,shaman,restoration,66,27,39
45687,Vinceshamwow,lightbringer,1139,shaman,restoration,18,12,6
45688,Laterallus,nagrand,1139,shaman,restoration,92,47,45
45689,Twistah,firetree,1139,shaman,restoration,24,12,12
45690,Docshamwow,malganis,1137,shaman,restoration,18,12,6
45691,Totemfizzle,spirestone,1137,shaman,restoration,24,12,12
45692,Elecpod,frostmourne,1137,shaman,restoration,32,12,20
45693,Gsync,tichondrius,1136,shaman,restoration,76,45,31
45694,Winchi,stormrage,1136,shaman,restoration,24,12,12
45695,Devipersham,frostmourne,1135,shaman,restoration,24,12,12
45696,Charr,nemesis,1133,shaman,restoration,30,14,16
45697,Orcstain,moknathal,1132,shaman,restoration,106,36,70
45698,Smooths,bloodscalp,1131,shaman,restoration,30,16,14
45699,Shampane,arathor,1131,shaman,restoration,24,12,12
45700,Mordzan,area-52,1131,shaman,restoration,26,12,14
45701,Ladilloso,zuljin,1131,shaman,restoration,59,24,35
45702,Lechaman,hakkar,1131,shaman,restoration,66,22,44
45703,Cameltotêm,frostmourne,1130,shaman,restoration,30,17,13
45704,Dragonsauce,grizzly-hills,1130,shaman,restoration,47,19,28
45705,Sannyasin,azralon,1126,shaman,restoration,24,12,12
45706,Uluwatu,bleeding-hollow,1126,shaman,restoration,42,20,22
45707,Dinaliia,lothar,1126,shaman,restoration,36,16,20
45708,Käck,tichondrius,1122,shaman,restoration,62,28,34
45709,Sephyros,ragnaros,1121,shaman,restoration,24,12,12
45710,Eyris,dathremar,1121,shaman,restoration,89,42,47
45711,Bóòchainz,tichondrius,1120,shaman,restoration,22,13,9
45712,Kime,tichondrius,1120,shaman,restoration,78,41,37
45713,Rocksteddy,area-52,1120,shaman,restoration,24,12,12
45714,Allegrata,sargeras,1119,shaman,restoration,30,16,14
45715,Bloodytotems,dethecus,1118,shaman,restoration,24,12,12
45716,Saxaboom,tichondrius,1115,shaman,restoration,30,12,18
45717,Etherys,frostmourne,1114,shaman,restoration,36,21,15
45718,Phira,tichondrius,1114,shaman,restoration,78,40,38
45719,Bikutali,kiljaeden,1114,shaman,restoration,24,12,12
45720,Powerpress,thunderlord,1109,shaman,restoration,24,12,12
45721,Senzxlolxz,lightbringer,1106,shaman,restoration,57,33,24
45722,Mvpstorm,darkspear,1106,shaman,restoration,30,12,18
45723,Shammyguy,stormreaver,1103,shaman,restoration,50,23,27
45724,Ttass,dalaran,1102,shaman,restoration,35,13,22
45725,Eledogg,mannoroth,1099,shaman,restoration,28,13,15
45726,Vinnydsham,tichondrius,1098,shaman,restoration,23,12,11
45727,Moowik,emerald-dream,1098,shaman,restoration,24,12,12
45728,Qüickeze,khazgoroth,1097,shaman,restoration,22,15,7
45729,Lezzer,ragnaros,1097,shaman,restoration,88,35,53
45730,Htsu,quelthalas,1093,shaman,restoration,28,13,15
45731,Shocksamdi,malganis,1093,shaman,restoration,36,13,23
45732,Stormburst,sargeras,1092,shaman,restoration,42,20,22
45733,Tremór,frostmourne,1091,shaman,restoration,30,17,13
45734,Còsmos,illidan,1090,shaman,restoration,130,63,67
45735,Baygone,tichondrius,1088,shaman,restoration,30,14,16
45736,Taquitho,quelthalas,1088,shaman,restoration,75,32,43
45737,Turbluscious,frostmourne,1087,shaman,restoration,79,42,37
45738,Mikeisbadwow,tichondrius,1086,shaman,restoration,16,12,4
45739,Topa,magtheridon,1085,shaman,restoration,36,15,21
45740,Lebs,barthilas,1084,shaman,restoration,20,12,8
45741,Chungie,laughing-skull,1082,shaman,restoration,24,12,12
45742,Belínski,azralon,1080,shaman,restoration,48,26,22
45743,Lavatotem,stormrage,1078,shaman,restoration,47,25,22
45744,Delayy,destromath,1075,shaman,restoration,77,32,45
45745,Narikó,aggramar,1073,shaman,restoration,100,56,44
45746,Umbrood,area-52,1073,shaman,restoration,28,13,15
45747,Grullander,hakkar,1072,shaman,restoration,41,23,18
45748,Racsors,ragnaros,1072,shaman,restoration,36,19,17
45749,Elharm,ragnaros,1072,shaman,restoration,36,13,23
45750,Hazorele,nagrand,1069,shaman,restoration,48,23,25
45751,Zhyrouvstorm,stormrage,1068,shaman,restoration,60,27,33
45752,Arjen,kelthuzad,1066,shaman,restoration,23,15,8
45753,Tharapita,bleeding-hollow,1064,shaman,restoration,54,24,30
45754,Shamanzinh,azralon,1063,shaman,restoration,35,12,23
45755,Shammysham,zuljin,1062,shaman,restoration,37,13,24
45756,Sekkuo,kiljaeden,1061,shaman,restoration,60,28,32
45757,Littledream,quelthalas,1061,shaman,restoration,58,26,32
45758,Omegalmao,sargeras,1056,shaman,restoration,18,11,7
45759,Lfgzookeeper,malganis,1056,shaman,restoration,18,11,7
45760,Nickwoper,emerald-dream,1056,shaman,restoration,18,11,7
45761,Biofly,thrall,1056,shaman,restoration,18,11,7
45762,Handzum,blades-edge,1056,shaman,restoration,18,11,7
45763,Kensyz,tichondrius,1056,shaman,restoration,18,11,7
45764,Brocules,aerie-peak,1056,shaman,restoration,24,11,13
45765,Censyzz,tichondrius,1056,shaman,restoration,24,11,13
45766,Laodo,tichondrius,1056,shaman,restoration,28,12,16
45767,Jukedlawl,illidan,1056,shaman,restoration,30,11,19
45768,Restoele,tichondrius,1055,shaman,restoration,18,11,7
45769,Ophitotem,zuljin,1055,shaman,restoration,18,11,7
45770,Localxhero,stormrage,1055,shaman,restoration,24,11,13
45771,Pericazo,sargeras,1055,shaman,restoration,24,11,13
45772,Sweetpotatoe,malganis,1055,shaman,restoration,24,11,13
45773,Jtrxs,tichondrius,1055,shaman,restoration,24,11,13
45774,Hordeoeuvre,zuljin,1055,shaman,restoration,24,11,13
45775,Mindgooblin,sargeras,1055,shaman,restoration,36,11,25
45776,Cháningtotem,frostmourne,1054,shaman,restoration,18,11,7
45777,Sipo,tichondrius,1054,shaman,restoration,18,11,7
45778,Earthfirex,ragnaros,1054,shaman,restoration,18,11,7
45779,Ituma,tichondrius,1054,shaman,restoration,18,11,7
45780,Vixeen,kelthuzad,1054,shaman,restoration,24,11,13
45781,Keybordternr,tichondrius,1054,shaman,restoration,24,11,13
45782,Elmonkeyloco,bleeding-hollow,1053,shaman,restoration,18,11,7
45783,Murm,burning-blade,1053,shaman,restoration,24,11,13
45784,Possessing,illidan,1053,shaman,restoration,24,11,13
45785,Glark,tichondrius,1051,shaman,restoration,24,11,13
45786,Alfrigg,stormrage,1051,shaman,restoration,30,11,19
45787,Kissmeslowly,zuljin,1050,shaman,restoration,18,11,7
45788,Chebbs,bleeding-hollow,1050,shaman,restoration,18,11,7
45789,Kuhdos,caelestrasz,1050,shaman,restoration,24,11,13
45790,Dragum,blackrock,1050,shaman,restoration,30,11,19
45791,Paradigm,sargeras,1049,shaman,restoration,18,11,7
45792,Millionvoltz,tichondrius,1049,shaman,restoration,24,11,13
45793,Speedranger,stormrage,1049,shaman,restoration,48,20,28
45794,Groundded,tichondrius,1049,shaman,restoration,35,11,24
45795,Totemism,warsong,1048,shaman,restoration,18,11,7
45796,Ryuukas,illidan,1047,shaman,restoration,18,11,7
45797,Pohtayto,darkspear,1047,shaman,restoration,24,11,13
45798,Kaleska,area-52,1047,shaman,restoration,32,11,21
45799,Mcstop,tanaris,1046,shaman,restoration,36,15,21
45800,Eleshortal,azuremyst,1046,shaman,restoration,51,21,30
45801,Lawlsham,korgath,1045,shaman,restoration,18,11,7
45802,Tràuma,caelestrasz,1045,shaman,restoration,45,13,32
45803,Tsünade,anubarak,1044,shaman,restoration,12,11,1
45804,Elpide,area-52,1044,shaman,restoration,18,11,7
45805,Kronko,frostmourne,1044,shaman,restoration,24,11,13
45806,Leogi,daggerspine,1044,shaman,restoration,27,11,16
45807,Gl,nordrassil,1043,shaman,restoration,18,11,7
45808,Cazlukz,demon-soul,1043,shaman,restoration,36,18,18
45809,Kymosoloshm,sargeras,1043,shaman,restoration,24,11,13
45810,Enzÿte,tichondrius,1043,shaman,restoration,24,11,13
45811,Saraguthix,dalaran,1043,shaman,restoration,30,11,19
45812,Pootergash,shadowmoon,1041,shaman,restoration,24,11,13
45813,Volcanô,area-52,1041,shaman,restoration,30,11,19
45814,Adrô,barthilas,1040,shaman,restoration,117,48,69
45815,Geoleo,stormrage,1040,shaman,restoration,42,17,25
45816,Zugzugthug,moon-guard,1040,shaman,restoration,84,33,51
45817,Chablez,shattered-hand,1036,shaman,restoration,42,17,25
45818,Aimiréal,nagrand,1030,shaman,restoration,30,17,13
45819,Zoodoo,nagrand,1027,shaman,restoration,59,21,38
45820,Rekiem,quelthalas,1025,shaman,restoration,28,15,13
45821,Plop,tichondrius,1024,shaman,restoration,16,12,4
45822,Anttoekneeoh,thrall,1024,shaman,restoration,24,12,12
45823,Vaginix,tichondrius,1023,shaman,restoration,30,11,19
45824,Mastrionilol,stormrage,1023,shaman,restoration,34,11,23
45825,Slëvin,frostmourne,1023,shaman,restoration,42,13,29
45826,Kulgur,ravenholdt,1022,shaman,restoration,29,19,10
45827,Dextex,azralon,1022,shaman,restoration,47,26,21
45828,Zonsham,drakkari,1017,shaman,restoration,24,11,13
45829,Frizzie,barthilas,1015,shaman,restoration,89,23,66
45830,Nupi,thaurissan,1013,shaman,restoration,59,26,33
45831,Mikeoxxgigg,kelthuzad,1011,shaman,restoration,75,39,36
45832,Rebbecablack,malganis,1008,shaman,restoration,18,12,6
45833,Lazi,frostmourne,1008,shaman,restoration,27,12,15
45834,Kawixxi,ysondre,1007,shaman,restoration,65,35,30
45835,Volsdeep,illidan,1007,shaman,restoration,21,11,10
45836,Grêgg,area-52,1006,shaman,restoration,22,11,11
45837,Totori,stormscale,1006,shaman,restoration,30,11,19
45838,Illeh,illidan,1005,shaman,restoration,42,19,23
45839,Hoghlinn,stormrage,1003,shaman,restoration,14,12,2
45840,Ttukilowatts,stormrage,1003,shaman,restoration,84,21,63
45841,Smolder,magtheridon,1000,shaman,restoration,54,32,22
45842,Vogelbach,ragnaros,999,shaman,restoration,30,19,11
45843,Shamankie,tichondrius,999,shaman,restoration,40,13,27
45844,Hentaistorm,kiljaeden,998,shaman,restoration,80,41,39
45845,Mythruxx,sargeras,993,shaman,restoration,26,12,14
45846,Betorc,azralon,993,shaman,restoration,36,11,25
45847,Nottrhall,azralon,990,shaman,restoration,14,11,3
45848,Superchunk,shattered-hand,990,shaman,restoration,132,68,64
45849,Dùffman,jubeithos,988,shaman,restoration,29,13,16
45850,Cakinha,stormrage,985,shaman,restoration,42,24,18
45851,Faegle,area-52,984,shaman,restoration,24,11,13
45852,Doomgodx,tichondrius,983,shaman,restoration,36,16,20
45853,Bettoo,ragnaros,980,shaman,restoration,29,12,17
45854,Banterx,emerald-dream,979,shaman,restoration,35,12,23
45855,Laggythought,malganis,977,shaman,restoration,46,14,32
45856,Andrastia,thrall,976,shaman,restoration,24,15,9
45857,Shamadran,hyjal,971,shaman,restoration,23,11,12
45858,Ayahuassca,illidan,971,shaman,restoration,56,25,31
45859,Monorim,barthilas,969,shaman,restoration,30,14,16
45860,Njjshamm,thrall,969,shaman,restoration,36,16,20
45861,Robis,thrall,968,shaman,restoration,161,79,82
45862,Donkeydrill,elune,965,shaman,restoration,24,15,9
45863,Klâus,fizzcrank,960,shaman,restoration,12,10,2
45864,Gabbin,dalaran,960,shaman,restoration,12,10,2
45865,Devilsham,tichondrius,960,shaman,restoration,12,10,2
45866,Sagester,illidan,960,shaman,restoration,16,11,5
45867,Hst,barthilas,960,shaman,restoration,18,10,8
45868,Victusk,tichondrius,960,shaman,restoration,18,10,8
45869,Paperbot,barthilas,960,shaman,restoration,18,10,8
45870,Naisayyds,tichondrius,960,shaman,restoration,18,10,8
45871,Yunotho,sargeras,960,shaman,restoration,18,10,8
45872,Burstekka,tichondrius,960,shaman,restoration,18,10,8
45873,Freerath,tichondrius,960,shaman,restoration,22,10,12
45874,Liquidcdew,illidan,960,shaman,restoration,24,10,14
45875,Enhancex,frostwolf,960,shaman,restoration,24,10,14
45876,Shield,lightnings-blade,960,shaman,restoration,24,10,14
45877,Nisthesham,tichondrius,960,shaman,restoration,24,10,14
45878,Woobsz,sargeras,959,shaman,restoration,12,10,2
45879,Farfar,tichondrius,959,shaman,restoration,12,10,2
45880,Joryu,tichondrius,959,shaman,restoration,18,10,8
45881,Esoterikk,malganis,959,shaman,restoration,18,10,8
45882,Lodekimm,tichondrius,959,shaman,restoration,18,10,8
45883,Awsika,lethon,959,shaman,restoration,18,10,8
45884,Service,llane,959,shaman,restoration,18,10,8
45885,Zensarg,tichondrius,959,shaman,restoration,18,10,8
45886,Jisthexx,senjin,959,shaman,restoration,24,10,14
45887,Matzuga,bleeding-hollow,959,shaman,restoration,24,10,14
45888,Forcè,bleeding-hollow,959,shaman,restoration,24,10,14
45889,Valcn,moon-guard,959,shaman,restoration,24,10,14
45890,Ggoong,tichondrius,959,shaman,restoration,36,10,26
45891,Shyva,frostmourne,958,shaman,restoration,18,10,8
45892,Felzbirt,uldum,958,shaman,restoration,30,14,16
45893,Weirdboi,area-52,958,shaman,restoration,24,10,14
45894,Thundershade,deathwing,958,shaman,restoration,24,10,14
45895,Totomayo,tichondrius,957,shaman,restoration,12,10,2
45896,Humpvack,tichondrius,957,shaman,restoration,18,10,8
45897,Resonence,bleeding-hollow,957,shaman,restoration,18,10,8
45898,Clytiae,arthas,957,shaman,restoration,18,10,8
45899,Athayis,malorne,957,shaman,restoration,59,31,28
45900,Rsham,dragonmaw,956,shaman,restoration,18,10,8
45901,Kroggath,area-52,956,shaman,restoration,18,10,8
45902,Karaaka,ysera,956,shaman,restoration,30,10,20
45903,Oohkillemm,silvermoon,955,shaman,restoration,18,10,8
45904,Askortus,stormrage,955,shaman,restoration,24,10,14
45905,Shammystic,quelthalas,955,shaman,restoration,54,19,35
45906,Booz,caelestrasz,955,shaman,restoration,36,12,24
45907,Volzuna,wyrmrest-accord,954,shaman,restoration,24,10,14
45908,Johnnyblue,barthilas,954,shaman,restoration,30,10,20
45909,Raininwishes,aegwynn,952,shaman,restoration,18,10,8
45910,Santral,ragnaros,952,shaman,restoration,25,10,15
45911,Bruhh,khadgar,951,shaman,restoration,18,10,8
45912,Romcomx,tichondrius,951,shaman,restoration,24,10,14
45913,Soulmiracle,tichondrius,951,shaman,restoration,24,10,14
45914,Overcåst,barthilas,951,shaman,restoration,36,10,26
45915,Castte,ragnaros,950,shaman,restoration,86,38,48
45916,Psilocypher,nazjatar,949,shaman,restoration,36,19,17
45917,Skaehj,saurfang,949,shaman,restoration,56,29,27
45918,Tabby,emerald-dream,948,shaman,restoration,24,10,14
45919,Daxetan,area-52,947,shaman,restoration,18,10,8
45920,Recyclicrab,skullcrusher,945,shaman,restoration,12,10,2
45921,Vulkova,illidan,945,shaman,restoration,24,10,14
45922,Skippe,hyjal,943,shaman,restoration,18,10,8
45923,Matrìx,sargeras,941,shaman,restoration,92,45,47
45924,Mhuns,malganis,940,shaman,restoration,24,10,14
45925,Urao,stormrage,936,shaman,restoration,36,10,26
45926,Boppshock,tichondrius,928,shaman,restoration,16,11,5
45927,Wûbbie,emerald-dream,927,shaman,restoration,35,10,25
45928,Thrallblade,burning-blade,926,shaman,restoration,16,11,5
45929,Haether,madoran,926,shaman,restoration,101,50,51
45930,Colberton,dalaran,926,shaman,restoration,23,10,13
45931,Rastablaze,darkspear,926,shaman,restoration,70,27,43
45932,Artsha,tol-barad,925,shaman,restoration,18,11,7
45933,Shoomas,tichondrius,923,shaman,restoration,23,10,13
45934,Mikeyshockus,hydraxis,922,shaman,restoration,47,19,28
45935,Klev,frostmourne,921,shaman,restoration,33,12,21
45936,Cositax,tichondrius,919,shaman,restoration,18,10,8
45937,Jorko,dathremar,918,shaman,restoration,26,16,10
45938,Brokkghul,illidan,917,shaman,restoration,28,14,14
45939,Malløry,mugthol,917,shaman,restoration,30,12,18
45940,Bakedpototem,magtheridon,913,shaman,restoration,24,10,14
45941,Tineer,tichondrius,912,shaman,restoration,27,10,17
45942,Flexexpress,stormrage,911,shaman,restoration,17,10,7
45943,Privxd,bleeding-hollow,910,shaman,restoration,17,10,7
45944,Mainstreamx,sargeras,908,shaman,restoration,33,10,23
45945,Bitflip,jubeithos,907,shaman,restoration,21,10,11
45946,Jessestevens,kiljaeden,905,shaman,restoration,17,10,7
45947,Tyrión,aggramar,905,shaman,restoration,27,12,15
45948,Alestorm,nemesis,899,shaman,restoration,28,12,16
45949,Señordoge,malganis,895,shaman,restoration,26,10,16
45950,Lyshar,laughing-skull,894,shaman,restoration,20,10,10
45951,Oldhar,kirin-tor,891,shaman,restoration,24,10,14
45952,Shämpäin,moon-guard,891,shaman,restoration,26,10,16
45953,Imperiumrum,azuremyst,887,shaman,restoration,77,41,36
45954,Jenniferlynn,tichondrius,886,shaman,restoration,48,15,33
45955,Swifteyy,area-52,883,shaman,restoration,22,10,12
45956,Astàròth,malganis,880,shaman,restoration,13,10,3
45957,Thrawl,deathwing,875,shaman,restoration,24,11,13
45958,Muur,zangarmarsh,872,shaman,restoration,25,10,15
45959,Orouboros,area-52,869,shaman,restoration,72,25,47
45960,Galarix,nerzhul,867,shaman,restoration,60,16,44
45961,Seiunsky,area-52,864,shaman,restoration,12,9,3
45962,Bakenquake,tichondrius,864,shaman,restoration,12,9,3
45963,ßonevoyage,malganis,864,shaman,restoration,12,9,3
45964,Genesiis,stormrage,864,shaman,restoration,12,9,3
45965,Electricsham,archimonde,864,shaman,restoration,12,9,3
45966,Pangniu,illidan,864,shaman,restoration,12,9,3
45967,Iadyboi,kiljaeden,864,shaman,restoration,12,9,3
45968,Washedupty,illidan,864,shaman,restoration,12,9,3
45969,Èmaxx,barthilas,864,shaman,restoration,12,9,3
45970,Neviahz,illidan,864,shaman,restoration,18,9,9
45971,Kirschblute,proudmoore,864,shaman,restoration,18,9,9
45972,Awyiss,dreadmaul,864,shaman,restoration,18,9,9
45973,Biased,sargeras,864,shaman,restoration,18,9,9
45974,Fiizix,malganis,864,shaman,restoration,18,9,9
45975,Gargrax,malganis,864,shaman,restoration,18,9,9
45976,Flatt,uther,864,shaman,restoration,18,9,9
45977,Plotwave,bleeding-hollow,864,shaman,restoration,18,9,9
45978,Medullarum,suramar,864,shaman,restoration,18,9,9
45979,Hexcalibur,laughing-skull,864,shaman,restoration,18,9,9
45980,Humiliated,stormrage,864,shaman,restoration,24,9,15
45981,Wildmaster,ragnaros,864,shaman,restoration,30,9,21
45982,Køre,tichondrius,863,shaman,restoration,12,9,3
45983,Kzxs,illidan,863,shaman,restoration,12,9,3
45984,Rockemsockem,frostmourne,863,shaman,restoration,12,9,3
45985,Deosculation,tichondrius,863,shaman,restoration,12,9,3
45986,Ajvl,tichondrius,863,shaman,restoration,12,9,3
45987,Shamanology,echo-isles,863,shaman,restoration,15,10,5
45988,Airenne,vashj,863,shaman,restoration,18,9,9
45989,Ataia,tichondrius,863,shaman,restoration,18,9,9
45990,Hoofpics,dalaran,863,shaman,restoration,18,9,9
45991,Multran,stormscale,863,shaman,restoration,18,9,9
45992,Snoff,burning-blade,863,shaman,restoration,18,9,9
45993,Potf,illidan,863,shaman,restoration,18,9,9
45994,Exiledsham,area-52,863,shaman,restoration,18,9,9
45995,Murica,area-52,863,shaman,restoration,18,9,9
45996,Kassper,tichondrius,863,shaman,restoration,18,9,9
45997,Grimmick,area-52,863,shaman,restoration,18,9,9
45998,Gornu,nemesis,863,shaman,restoration,18,9,9
45999,Chlknx,tichondrius,863,shaman,restoration,18,9,9
46000,Thungo,thaurissan,863,shaman,restoration,18,9,9
46001,Buffele,tichondrius,863,shaman,restoration,18,9,9
46002,Discofoot,wyrmrest-accord,863,shaman,restoration,24,9,15
46003,Memorix,stonemaul,863,shaman,restoration,24,9,15
46004,Mastrionilol,dragonmaw,863,shaman,restoration,24,9,15
46005,Yoloswage,tichondrius,863,shaman,restoration,33,10,23
46006,Tycho,skullcrusher,862,shaman,restoration,12,9,3
46007,Obrahma,burning-legion,862,shaman,restoration,18,9,9
46008,Drünk,hyjal,862,shaman,restoration,18,9,9
46009,Mâdy,quelthalas,861,shaman,restoration,12,9,3
46010,Soppin,bleeding-hollow,861,shaman,restoration,18,9,9
46011,Milkstress,whisperwind,861,shaman,restoration,24,9,15
46012,Esanim,tichondrius,860,shaman,restoration,18,9,9
46013,Bacnbitz,hellscream,860,shaman,restoration,24,9,15
46014,Duza,frostmourne,859,shaman,restoration,18,9,9
46015,Xtremedwarf,frostmourne,859,shaman,restoration,18,9,9
46016,Blavan,area-52,859,shaman,restoration,24,9,15
46017,Ironfart,destromath,858,shaman,restoration,18,9,9
46018,Blois,thunderlord,857,shaman,restoration,18,9,9
46019,Vulcanuzz,ragnaros,856,shaman,restoration,24,9,15
46020,Stormblast,stormrage,856,shaman,restoration,42,9,33
46021,Yakella,trollbane,854,shaman,restoration,12,9,3
46022,Donix,destromath,854,shaman,restoration,30,11,19
46023,Lauralai,sargeras,853,shaman,restoration,12,9,3
46024,Mtnju,eredar,852,shaman,restoration,18,9,9
46025,Uggbootz,amanthul,851,shaman,restoration,37,13,24
46026,Çatastrophe,dalaran,849,shaman,restoration,18,9,9
46027,Elementium,azshara,847,shaman,restoration,29,9,20
46028,Fio,nerzhul,846,shaman,restoration,246,111,135
46029,Xinz,guldan,845,shaman,restoration,20,10,10
46030,Danil,emerald-dream,831,shaman,restoration,17,9,8
46031,Sittingwolf,stormreaver,825,shaman,restoration,17,9,8
46032,Juksi,the-scryers,820,shaman,restoration,23,9,14
46033,Insidetrader,illidan,815,shaman,restoration,15,10,5
46034,Zitan,tichondrius,813,shaman,restoration,17,9,8
46035,Slimshaddy,tichondrius,809,shaman,restoration,21,9,12
46036,Deadlyshocks,gilneas,800,shaman,restoration,57,25,32
46037,Importmodule,frostmourne,796,shaman,restoration,23,9,14
46038,Brahsbro,icecrown,789,shaman,restoration,96,46,50
46039,Frankenstien,proudmoore,777,shaman,restoration,25,9,16
46040,Hudepohl,alexstrasza,776,shaman,restoration,23,9,14
46041,Shxl,zuljin,768,shaman,restoration,12,8,4
46042,Kìttý,malganis,768,shaman,restoration,12,8,4
46043,Floofs,kelthuzad,768,shaman,restoration,12,8,4
46044,Xiaoshaman,tichondrius,768,shaman,restoration,12,8,4
46045,Xannysnapper,zuljin,768,shaman,restoration,12,8,4
46046,Hexistential,tichondrius,768,shaman,restoration,12,8,4
46047,Plznostepmom,tichondrius,768,shaman,restoration,12,8,4
46048,Thictoxicity,tichondrius,768,shaman,restoration,12,8,4
46049,Hoonjojjyans,tichondrius,768,shaman,restoration,12,8,4
46050,Vernzi,laughing-skull,768,shaman,restoration,12,8,4
46051,Xiaoshaman,frostmourne,768,shaman,restoration,12,8,4
46052,Kaskä,tichondrius,768,shaman,restoration,12,8,4
46053,Ggdumpy,tichondrius,768,shaman,restoration,12,8,4
46054,Tidesurge,tichondrius,768,shaman,restoration,12,8,4
46055,Steverz,daggerspine,768,shaman,restoration,12,8,4
46056,Xbk,tichondrius,768,shaman,restoration,12,8,4
46057,Yarzin,azjolnerub,768,shaman,restoration,12,8,4
46058,Longlivecrit,exodar,768,shaman,restoration,12,8,4
46059,Lavamon,illidan,768,shaman,restoration,12,8,4
46060,Fyc,wyrmrest-accord,768,shaman,restoration,18,8,10
46061,Wolvez,tichondrius,768,shaman,restoration,18,8,10
46062,Artotem,barthilas,768,shaman,restoration,18,8,10
46063,Sgtsosix,zuljin,768,shaman,restoration,18,8,10
46064,Rhazul,barthilas,768,shaman,restoration,18,8,10
46065,Skymarshal,tichondrius,768,shaman,restoration,18,8,10
46066,Songo,frostmane,768,shaman,restoration,18,8,10
46067,Ändiroba,azralon,768,shaman,restoration,18,8,10
46068,Kaddya,mannoroth,768,shaman,restoration,18,8,10
46069,Toastjr,frostmourne,768,shaman,restoration,18,8,10
46070,Xotheweeknd,bleeding-hollow,768,shaman,restoration,18,8,10
46071,Earthuncle,illidan,768,shaman,restoration,24,8,16
46072,Shampoø,shattered-halls,767,shaman,restoration,12,8,4
46073,Jesuisbatman,zuljin,767,shaman,restoration,12,8,4
46074,Iarepotato,tichondrius,767,shaman,restoration,12,8,4
46075,Gerberbaby,chogall,767,shaman,restoration,12,8,4
46076,Elamentz,bleeding-hollow,767,shaman,restoration,12,8,4
46077,Watergirl,thaurissan,767,shaman,restoration,12,8,4
46078,Raspberri,kelthuzad,767,shaman,restoration,12,8,4
46079,Vindícated,area-52,767,shaman,restoration,12,8,4
46080,Mymojo,tichondrius,767,shaman,restoration,12,8,4
46081,Squirtrussel,boulderfist,767,shaman,restoration,12,8,4
46082,Vernacks,area-52,767,shaman,restoration,12,8,4
46083,Lepoow,illidan,767,shaman,restoration,12,8,4
46084,Hexoffender,thunderlord,767,shaman,restoration,12,8,4
46085,Veeve,kelthuzad,767,shaman,restoration,12,8,4
46086,Tholkt,ragnaros,767,shaman,restoration,15,9,6
46087,Regisphilman,bonechewer,767,shaman,restoration,17,10,7
46088,Tigs,alleria,767,shaman,restoration,18,8,10
46089,Myrakh,zuljin,767,shaman,restoration,18,8,10
46090,Nehpets,kiljaeden,767,shaman,restoration,18,8,10
46091,Chrigshock,black-dragonflight,767,shaman,restoration,18,8,10
46092,Jazziefae,arygos,767,shaman,restoration,18,8,10
46093,Agrîm,tichondrius,767,shaman,restoration,24,8,16
46094,Thunderfucj,tichondrius,767,shaman,restoration,24,8,16
46095,Totemlord,lightnings-blade,766,shaman,restoration,18,8,10
46096,Rapwnzel,tichondrius,766,shaman,restoration,18,8,10
46097,Nooch,malganis,766,shaman,restoration,27,9,18
46098,Magatotem,sargeras,766,shaman,restoration,24,8,16
46099,Gohex,saurfang,765,shaman,restoration,12,8,4
46100,Finaire,queldorei,765,shaman,restoration,12,8,4
46101,Trickyjf,dalaran,765,shaman,restoration,18,8,10
46102,Kanagawa,illidan,765,shaman,restoration,24,8,16
46103,Josiahsham,kelthuzad,764,shaman,restoration,18,8,10
46104,Zuljincj,zuljin,764,shaman,restoration,18,8,10
46105,Moistydank,tichondrius,764,shaman,restoration,24,8,16
46106,Vulcanik,quelthalas,764,shaman,restoration,24,8,16
46107,Vínnie,tichondrius,763,shaman,restoration,18,8,10
46108,Furbiddên,area-52,763,shaman,restoration,24,8,16
46109,ßøn,altar-of-storms,762,shaman,restoration,12,8,4
46110,Shamnnoodlez,area-52,762,shaman,restoration,18,8,10
46111,Extenzz,area-52,761,shaman,restoration,18,8,10
46112,Cremecheese,crushridge,760,shaman,restoration,12,8,4
46113,Groonix,blood-furnace,759,shaman,restoration,12,8,4
46114,Tiä,quelthalas,758,shaman,restoration,24,8,16
46115,Shamanlesa,azralon,757,shaman,restoration,18,8,10
46116,Kordir,kiljaeden,756,shaman,restoration,24,8,16
46117,Amonamarth,tichondrius,753,shaman,restoration,18,8,10
46118,Getpurged,thrall,751,shaman,restoration,17,8,9
46119,Shubba,thrall,747,shaman,restoration,12,8,4
46120,Msooli,tichondrius,745,shaman,restoration,15,10,5
46121,Siksika,bloodscalp,744,shaman,restoration,130,56,74
46122,Ryforges,frostmourne,734,shaman,restoration,14,9,5
46123,Interwebzz,tichondrius,734,shaman,restoration,66,17,49
46124,Picklefartsh,tichondrius,720,shaman,restoration,15,8,7
46125,Unishamx,malganis,720,shaman,restoration,15,8,7
46126,Treris,bleeding-hollow,719,shaman,restoration,11,8,3
46127,Notragii,kelthuzad,719,shaman,restoration,17,8,9
46128,Kencysz,tichondrius,714,shaman,restoration,23,9,14
46129,Stitchez,illidan,714,shaman,restoration,27,9,18
46130,Kyma,black-dragonflight,713,shaman,restoration,25,9,16
46131,Poundmaker,cairne,707,shaman,restoration,15,8,7
46132,Kenithwest,tichondrius,703,shaman,restoration,11,8,3
46133,Purgelordx,proudmoore,703,shaman,restoration,11,8,3
46134,Wasuwant,frostmourne,703,shaman,restoration,14,8,6
46135,Garbagedump,burning-legion,703,shaman,restoration,14,8,6
46136,Kikahna,stormreaver,683,shaman,restoration,22,9,13
46137,Naturescandy,alterac-mountains,676,shaman,restoration,19,8,11
46138,Dizzyswift,tichondrius,672,shaman,restoration,12,7,5
46139,Akurai,stormrage,672,shaman,restoration,12,7,5
46140,Acdc,zuljin,672,shaman,restoration,12,7,5
46141,Toltem,bleeding-hollow,672,shaman,restoration,12,7,5
46142,Zarly,bleeding-hollow,672,shaman,restoration,12,7,5
46143,Kencyi,tichondrius,672,shaman,restoration,12,7,5
46144,Zerwyn,senjin,672,shaman,restoration,12,7,5
46145,Dektide,zuljin,672,shaman,restoration,12,7,5
46146,Joè,bleeding-hollow,672,shaman,restoration,12,7,5
46147,Kustum,tichondrius,672,shaman,restoration,12,7,5
46148,Wreckaholic,alterac-mountains,672,shaman,restoration,12,7,5
46149,Jxx,nordrassil,672,shaman,restoration,12,7,5
46150,Symbox,tichondrius,672,shaman,restoration,12,7,5
46151,Boltekka,tichondrius,672,shaman,restoration,12,7,5
46152,Micgarnagul,illidan,672,shaman,restoration,12,7,5
46153,Mastashambtw,illidan,672,shaman,restoration,12,7,5
46154,Macksimas,tichondrius,672,shaman,restoration,12,7,5
46155,Mørgénstérn,area-52,672,shaman,restoration,12,7,5
46156,Gruestorm,illidan,672,shaman,restoration,12,7,5
46157,Çdñ,tichondrius,672,shaman,restoration,12,7,5
46158,Daxotv,sargeras,672,shaman,restoration,12,7,5
46159,Farmër,illidan,672,shaman,restoration,12,7,5
46160,Heckinpurges,area-52,672,shaman,restoration,12,7,5
46161,Ballofduty,tichondrius,672,shaman,restoration,12,7,5
46162,Paaman,proudmoore,672,shaman,restoration,12,7,5
46163,Dopey,twisting-nether,672,shaman,restoration,12,7,5
46164,Yusbe,ragnaros,672,shaman,restoration,12,7,5
46165,Knockedup,tichondrius,672,shaman,restoration,12,7,5
46166,Invokeesorin,area-52,672,shaman,restoration,12,7,5
46167,Mayim,sargeras,672,shaman,restoration,12,7,5
46168,Mugiwára,ragnaros,672,shaman,restoration,12,7,5
46169,Ghiscar,tichondrius,672,shaman,restoration,12,7,5
46170,Bloodlustxo,frostmourne,672,shaman,restoration,12,7,5
46171,Quiksilvero,khazgoroth,672,shaman,restoration,12,7,5
46172,Iliillililli,tichondrius,672,shaman,restoration,12,7,5
46173,Viprus,nerzhul,672,shaman,restoration,12,7,5
46174,Hexmix,muradin,672,shaman,restoration,12,7,5
46175,Elîas,tichondrius,672,shaman,restoration,12,7,5
46176,Strykked,illidan,672,shaman,restoration,12,7,5
46177,Xueticsham,tichondrius,672,shaman,restoration,12,7,5
46178,Envy,korialstrasz,672,shaman,restoration,12,7,5
46179,Befree,thunderlord,672,shaman,restoration,15,8,7
46180,Zrosurge,stormrage,672,shaman,restoration,14,7,7
46181,Hardlyfe,frostmourne,672,shaman,restoration,18,7,11
46182,Smeagles,ragnaros,672,shaman,restoration,18,7,11
46183,Nikeshocks,detheroc,672,shaman,restoration,18,7,11
46184,Meeb,emerald-dream,672,shaman,restoration,18,7,11
46185,Zanderpla,kelthuzad,672,shaman,restoration,18,7,11
46186,Lindsanx,illidan,672,shaman,restoration,18,7,11
46187,Silverkitty,tichondrius,672,shaman,restoration,18,7,11
46188,Trippzs,barthilas,672,shaman,restoration,18,7,11
46189,Oprawindfuri,whisperwind,672,shaman,restoration,18,7,11
46190,Lildik,tichondrius,672,shaman,restoration,18,7,11
46191,Pjtremblay,frostmourne,672,shaman,restoration,18,7,11
46192,Morphose,tichondrius,672,shaman,restoration,18,7,11
46193,Macavell,tichondrius,672,shaman,restoration,18,7,11
46194,History,burning-blade,672,shaman,restoration,18,7,11
46195,Aromental,sargeras,672,shaman,restoration,18,7,11
46196,Huashiren,illidan,672,shaman,restoration,18,7,11
46197,Stumpyjoe,terokkar,672,shaman,restoration,19,7,12
46198,Foxymama,the-forgotten-coast,672,shaman,restoration,24,7,17
46199,Drathos,azralon,671,shaman,restoration,12,7,5
46200,Flekzs,blackhand,671,shaman,restoration,12,7,5
46201,Wishpool,stormrage,671,shaman,restoration,12,7,5
46202,Sixzo,tichondrius,671,shaman,restoration,12,7,5
46203,Shamiggels,sargeras,671,shaman,restoration,12,7,5
46204,Thormodin,destromath,671,shaman,restoration,12,7,5
46205,Rokvahn,illidan,671,shaman,restoration,12,7,5
46206,Pakdis,sargeras,671,shaman,restoration,12,7,5
46207,Kustys,tichondrius,671,shaman,restoration,12,7,5
46208,Arkilios,tichondrius,671,shaman,restoration,12,7,5
46209,Curtrex,amanthul,671,shaman,restoration,12,7,5
46210,Antysham,emerald-dream,671,shaman,restoration,12,7,5
46211,Blayze,stormscale,671,shaman,restoration,17,8,9
46212,Cheeziee,thrall,671,shaman,restoration,18,7,11
46213,Lvcianrs,thrall,671,shaman,restoration,18,7,11
46214,Caobuloso,azralon,671,shaman,restoration,18,7,11
46215,Kamltoetm,proudmoore,671,shaman,restoration,18,7,11
46216,Bintopean,boulderfist,671,shaman,restoration,18,7,11
46217,Sheariously,sargeras,671,shaman,restoration,18,7,11
46218,Cavolt,stormrage,671,shaman,restoration,18,7,11
46219,Dochavoc,tichondrius,671,shaman,restoration,18,7,11
46220,Riptiddles,nordrassil,671,shaman,restoration,30,7,23
46221,Zevexx,tichondrius,670,shaman,restoration,12,7,5
46222,Jaws,skullcrusher,670,shaman,restoration,12,7,5
46223,Shamanastic,tichondrius,670,shaman,restoration,12,7,5
46224,Bethorá,suramar,670,shaman,restoration,12,7,5
46225,Crynoobs,senjin,670,shaman,restoration,12,7,5
46226,Xuesu,tichondrius,670,shaman,restoration,12,7,5
46227,Flameism,sargeras,670,shaman,restoration,12,7,5
46228,Stormcallerr,sargeras,670,shaman,restoration,12,7,5
46229,Saulgudmon,area-52,670,shaman,restoration,18,7,11
46230,Oprawîndfury,tichondrius,670,shaman,restoration,18,7,11
46231,Hopetotem,zuljin,670,shaman,restoration,18,7,11
46232,Víì,tichondrius,670,shaman,restoration,24,7,17
46233,Toedims,bonechewer,669,shaman,restoration,12,7,5
46234,Knowknown,tichondrius,669,shaman,restoration,12,7,5
46235,Thordan,lothar,669,shaman,restoration,18,7,11
46236,Todem,stormrage,669,shaman,restoration,18,7,11
46237,Nahualtt,quelthalas,669,shaman,restoration,18,7,11
46238,Rrakk,proudmoore,669,shaman,restoration,18,7,11
46239,Logich,dalaran,669,shaman,restoration,18,7,11
46240,Farku,illidan,669,shaman,restoration,36,7,29
46241,Waterspinach,tichondrius,668,shaman,restoration,18,7,11
46242,Evilraven,tichondrius,668,shaman,restoration,18,7,11
46243,Detropolis,illidan,668,shaman,restoration,48,7,41
46244,Wÿrd,illidan,667,shaman,restoration,12,7,5
46245,Kaliøs,ragnaros,667,shaman,restoration,12,7,5
46246,Youngneal,sargeras,667,shaman,restoration,18,7,11
46247,Villainousx,illidan,667,shaman,restoration,18,7,11
46248,Caferino,area-52,666,shaman,restoration,12,7,5
46249,Dennwoop,sargeras,666,shaman,restoration,28,8,20
46250,Dîabeetus,moon-guard,665,shaman,restoration,11,9,2
46251,Ruadhri,moon-guard,665,shaman,restoration,12,7,5
46252,Trodor,tichondrius,665,shaman,restoration,12,7,5
46253,Lamente,ragnaros,655,shaman,restoration,17,7,10
46254,Kihlubra,frostmourne,655,shaman,restoration,25,7,18
46255,Mâyo,thrall,654,shaman,restoration,17,7,10
46256,Wragnus,tichondrius,651,shaman,restoration,31,10,21
46257,Slimcube,illidan,649,shaman,restoration,24,8,16
46258,Stormsurgë,bleeding-hollow,640,shaman,restoration,10,8,2
46259,Healingtime,nerzhul,638,shaman,restoration,14,8,6
46260,Flíx,stormrage,638,shaman,restoration,14,8,6
46261,Cdewschair,tichondrius,623,shaman,restoration,17,7,10
46262,Deacoderz,area-52,618,shaman,restoration,14,8,6
46263,Royblue,illidan,618,shaman,restoration,14,8,6
46264,Îvôry,bloodhoof,618,shaman,restoration,22,10,12
46265,Tolvashoc,emerald-dream,608,shaman,restoration,16,7,9
46266,Bigbrenx,tichondrius,607,shaman,restoration,14,7,7
46267,Drfate,kargath,604,shaman,restoration,16,7,9
46268,Xlash,zuljin,598,shaman,restoration,26,7,19
46269,Grony,malganis,592,shaman,restoration,7,7,0
46270,Vaderung,emerald-dream,592,shaman,restoration,13,7,6
46271,Paraplexed,blackrock,585,shaman,restoration,16,10,6
46272,Kassix,illidan,576,shaman,restoration,6,6,0
46273,Jinyara,malganis,576,shaman,restoration,6,6,0
46274,Limburger,zuljin,576,shaman,restoration,6,6,0
46275,Vrangr,uther,576,shaman,restoration,6,6,0
46276,ßlessthefall,malganis,576,shaman,restoration,6,6,0
46277,Jimmyapple,illidan,576,shaman,restoration,6,6,0
46278,Zontas,illidan,576,shaman,restoration,6,6,0
46279,Tommoorello,lightnings-blade,576,shaman,restoration,6,6,0
46280,Jaygodx,blades-edge,576,shaman,restoration,6,6,0
46281,Duckhead,tichondrius,576,shaman,restoration,6,6,0
46282,Jordnöt,moon-guard,576,shaman,restoration,9,6,3
46283,Mocksy,eredar,576,shaman,restoration,12,6,6
46284,Rlzshaman,tichondrius,576,shaman,restoration,12,6,6
46285,Oppaswag,tichondrius,576,shaman,restoration,12,6,6
46286,Wulfey,sargeras,576,shaman,restoration,12,6,6
46287,Earthside,ragnaros,576,shaman,restoration,12,6,6
46288,Triyourong,proudmoore,576,shaman,restoration,12,6,6
46289,Weqeqwqwqex,ragnaros,576,shaman,restoration,12,6,6
46290,Subhealth,tichondrius,576,shaman,restoration,12,6,6
46291,Mazekheen,barthilas,576,shaman,restoration,12,6,6
46292,Akamâ,stormrage,576,shaman,restoration,12,6,6
46293,Mariansaurus,ragnaros,576,shaman,restoration,12,6,6
46294,Fevolution,dreadmaul,576,shaman,restoration,12,6,6
46295,Nymrose,stormrage,576,shaman,restoration,12,6,6
46296,Unclexflex,tichondrius,576,shaman,restoration,12,6,6
46297,Pikapiko,tichondrius,576,shaman,restoration,12,6,6
46298,Tcurts,stormrage,576,shaman,restoration,12,6,6
46299,Pex,sargeras,576,shaman,restoration,12,6,6
46300,Gullirachad,stormrage,576,shaman,restoration,12,6,6
46301,Aespeon,stormrage,576,shaman,restoration,12,6,6
46302,Callabash,mugthol,576,shaman,restoration,12,6,6
46303,Patmar,dragonmaw,576,shaman,restoration,12,6,6
46304,Spiritbb,area-52,576,shaman,restoration,12,6,6
46305,Abev,bonechewer,576,shaman,restoration,12,6,6
46306,Motatos,malganis,576,shaman,restoration,12,6,6
46307,Iamg,kilrogg,576,shaman,restoration,12,6,6
46308,Ccmeifbald,moon-guard,576,shaman,restoration,12,6,6
46309,Chogramm,illidan,576,shaman,restoration,12,6,6
46310,Dameyo,tichondrius,576,shaman,restoration,12,6,6
46311,Hhex,tichondrius,576,shaman,restoration,12,6,6
46312,Adrec,quelthalas,576,shaman,restoration,12,6,6
46313,Vyy,perenolde,576,shaman,restoration,12,6,6
46314,Scadouche,korgath,576,shaman,restoration,12,6,6
46315,Apathcat,the-forgotten-coast,576,shaman,restoration,12,6,6
46316,Rawdogginit,malfurion,576,shaman,restoration,12,6,6
46317,Xenvale,illidan,576,shaman,restoration,12,6,6
46318,Todayqt,malganis,576,shaman,restoration,12,6,6
46319,Cencyzz,tichondrius,576,shaman,restoration,12,6,6
46320,Lindnerx,malganis,576,shaman,restoration,12,6,6
46321,Sweatshirtz,tanaris,576,shaman,restoration,12,6,6
46322,Ajj,thrall,576,shaman,restoration,12,6,6
46323,Fourinchsham,tichondrius,576,shaman,restoration,12,6,6
46324,Nickbosa,illidan,576,shaman,restoration,12,6,6
46325,Surph,zuljin,576,shaman,restoration,12,6,6
46326,Diptide,bleeding-hollow,576,shaman,restoration,12,6,6
46327,Echoelements,tichondrius,576,shaman,restoration,12,6,6
46328,Bravezf,tichondrius,576,shaman,restoration,12,6,6
46329,Jimmybutler,tichondrius,576,shaman,restoration,12,6,6
46330,Lavawurst,tichondrius,576,shaman,restoration,12,6,6
46331,Deevviouss,barthilas,576,shaman,restoration,12,6,6
46332,Caprise,tichondrius,576,shaman,restoration,12,6,6
46333,Atsukaia,tichondrius,576,shaman,restoration,12,6,6
46334,Brotem,barthilas,576,shaman,restoration,15,7,8
46335,Goodzilla,aegwynn,576,shaman,restoration,18,6,12
46336,Rubmytiki,skywall,576,shaman,restoration,18,6,12
46337,Heysteptotem,tichondrius,576,shaman,restoration,18,6,12
46338,Dhalishama,thrall,576,shaman,restoration,18,6,12
46339,Shäman,anetheron,576,shaman,restoration,18,6,12
46340,Aiyinsitan,illidan,576,shaman,restoration,18,6,12
46341,Shockandmaul,tichondrius,576,shaman,restoration,18,6,12
46342,Sheeno,blackrock,576,shaman,restoration,18,6,12
46343,Kÿlé,darkspear,576,shaman,restoration,18,6,12
46344,Icehole,kelthuzad,576,shaman,restoration,18,6,12
46345,Zâppý,dalaran,576,shaman,restoration,18,6,12
46346,Adodo,tichondrius,576,shaman,restoration,18,6,12
46347,Oscer,tichondrius,576,shaman,restoration,18,6,12
46348,Greensween,thrall,576,shaman,restoration,19,6,13
46349,Blck,malorne,576,shaman,restoration,23,7,16
46350,Shampowl,jaedenar,576,shaman,restoration,20,6,14
46351,Dukaman,malganis,576,shaman,restoration,24,6,18
46352,Froglok,boulderfist,575,shaman,restoration,6,6,0
46353,Ladash,ragnaros,575,shaman,restoration,12,6,6
46354,Xhod,zuljin,575,shaman,restoration,12,6,6
46355,Thuggliife,frostmourne,575,shaman,restoration,12,6,6
46356,Shamàc,tichondrius,575,shaman,restoration,12,6,6
46357,Râine,stormreaver,575,shaman,restoration,12,6,6
46358,Twistedteas,tichondrius,575,shaman,restoration,12,6,6
46359,Sarevoc,sargeras,575,shaman,restoration,12,6,6
46360,Dylie,tichondrius,575,shaman,restoration,12,6,6
46361,Totescamel,tichondrius,575,shaman,restoration,12,6,6
46362,Gushaman,area-52,575,shaman,restoration,12,6,6
46363,Donojo,zuljin,575,shaman,restoration,12,6,6
46364,Cùìó,barthilas,575,shaman,restoration,12,6,6
46365,Hexegin,kelthuzad,575,shaman,restoration,12,6,6
46366,Tagliatelle,kelthuzad,575,shaman,restoration,15,7,8
46367,Numbreseven,frostmourne,575,shaman,restoration,14,6,8
46368,Ragnarüz,ragnaros,575,shaman,restoration,19,7,12
46369,Fouroclock,drakthul,575,shaman,restoration,18,6,12
46370,Girafasuarx,korgath,575,shaman,restoration,18,6,12
46371,Loec,thrall,575,shaman,restoration,18,6,12
46372,Deunan,ragnaros,575,shaman,restoration,18,6,12
46373,Martabakasin,frostmourne,575,shaman,restoration,24,6,18
46374,Shamncheddar,bleeding-hollow,575,shaman,restoration,24,6,18
46375,Shyeahmon,drenden,574,shaman,restoration,12,6,6
46376,Sweatysheet,emerald-dream,574,shaman,restoration,12,6,6
46377,Killerphreak,mannoroth,574,shaman,restoration,12,6,6
46378,Luciuzz,tichondrius,574,shaman,restoration,12,6,6
46379,Snowship,sargeras,574,shaman,restoration,12,6,6
46380,Kunshíí,bleeding-hollow,574,shaman,restoration,15,6,9
46381,Topazlight,thrall,574,shaman,restoration,18,6,12
46382,Camdoc,destromath,574,shaman,restoration,18,6,12
46383,Naishi,mannoroth,573,shaman,restoration,18,6,12
46384,Ctrlaltelite,burning-blade,573,shaman,restoration,18,6,12
46385,Monspiett,azralon,573,shaman,restoration,18,6,12
46386,Spookyosa,dalaran,573,shaman,restoration,36,6,30
46387,Jibberp,tichondrius,572,shaman,restoration,12,6,6
46388,Fogden,alleria,572,shaman,restoration,12,6,6
46389,Killuminatti,nathrezim,572,shaman,restoration,18,6,12
46390,Teebob,hyjal,572,shaman,restoration,18,6,12
46391,Bombsb,tichondrius,572,shaman,restoration,18,6,12
46392,Gimlyman,madoran,567,shaman,restoration,12,6,6
46393,Trustfall,rexxar,566,shaman,restoration,12,6,6
46394,Bloodmoôn,frostmourne,566,shaman,restoration,18,6,12
46395,Kàmï,illidan,559,shaman,restoration,11,6,5
46396,Betterthanya,tichondrius,544,shaman,restoration,10,7,3
46397,Reddleman,stormrage,544,shaman,restoration,22,6,16
46398,Earthnsky,bleeding-hollow,543,shaman,restoration,11,6,5
46399,Brogetic,cenarius,543,shaman,restoration,11,6,5
46400,Saviørkai,barthilas,543,shaman,restoration,14,7,7
46401,Tsunamic,sargeras,528,shaman,restoration,15,6,9
46402,Cornroll,tichondrius,527,shaman,restoration,11,6,5
46403,Thetotemtaco,tichondrius,527,shaman,restoration,11,6,5
46404,Galaxiya,blackhand,525,shaman,restoration,21,7,14
46405,Shamyshame,quelthalas,522,shaman,restoration,12,7,5
46406,Xändra,ragnaros,521,shaman,restoration,18,7,11
46407,Vsvs,tichondrius,521,shaman,restoration,22,7,15
46408,Tyealer,frostwolf,518,shaman,restoration,13,7,6
46409,Gohral,wyrmrest-accord,512,shaman,restoration,16,6,10
46410,Fengfeism,tichondrius,511,shaman,restoration,14,6,8
46411,Watoos,area-52,511,shaman,restoration,20,6,14
46412,Shamining,illidan,510,shaman,restoration,8,6,2
46413,Haldeir,frostmourne,510,shaman,restoration,17,6,11
46414,Rikswordfire,wyrmrest-accord,509,shaman,restoration,16,6,10
46415,Cantshear,zuljin,480,shaman,restoration,6,5,1
46416,Binestein,tichondrius,480,shaman,restoration,6,5,1
46417,Mahevagodx,ragnaros,480,shaman,restoration,6,5,1
46418,Cheddatotz,illidan,480,shaman,restoration,6,5,1
46419,Oopy,icecrown,480,shaman,restoration,6,5,1
46420,Msool,tichondrius,480,shaman,restoration,6,5,1
46421,Çhïcagø,aegwynn,480,shaman,restoration,6,5,1
46422,Fastaslight,bleeding-hollow,480,shaman,restoration,6,5,1
46423,Oprawinfuryy,thrall,480,shaman,restoration,6,5,1
46424,Nuggsfxce,frostmourne,480,shaman,restoration,6,5,1
46425,Bluepenguin,kelthuzad,480,shaman,restoration,6,5,1
46426,Banshaman,tichondrius,480,shaman,restoration,6,5,1
46427,Hellstabbers,lightbringer,480,shaman,restoration,6,5,1
46428,Binishaman,tichondrius,480,shaman,restoration,6,5,1
46429,Reèzx,illidan,480,shaman,restoration,6,5,1
46430,Blueclass,akama,480,shaman,restoration,6,5,1
46431,Esterosa,tichondrius,480,shaman,restoration,6,5,1
46432,Crowingraven,queldorei,480,shaman,restoration,6,5,1
46433,Alasierg,stonemaul,480,shaman,restoration,6,5,1
46434,Shamamsx,illidan,480,shaman,restoration,6,5,1
46435,Zêüs,dragonmaw,480,shaman,restoration,6,5,1
46436,Dankestmemes,illidan,480,shaman,restoration,6,5,1
46437,Boogiefever,area-52,480,shaman,restoration,6,5,1
46438,Hexgodx,illidan,480,shaman,restoration,6,5,1
46439,Fidelityfx,sargeras,480,shaman,restoration,12,5,7
46440,Devastian,quelthalas,480,shaman,restoration,12,5,7
46441,Shambuddy,moon-guard,480,shaman,restoration,12,5,7
46442,Lesnar,area-52,480,shaman,restoration,12,5,7
46443,Nathaan,tichondrius,480,shaman,restoration,12,5,7
46444,Baltarian,emerald-dream,480,shaman,restoration,12,5,7
46445,Synkronaqt,tichondrius,480,shaman,restoration,12,5,7
46446,Nagish,alexstrasza,480,shaman,restoration,12,5,7
46447,Shockwall,stormrage,480,shaman,restoration,12,5,7
46448,Sâxman,stormreaver,480,shaman,restoration,12,5,7
46449,Azrlol,illidan,480,shaman,restoration,12,5,7
46450,Astotems,tichondrius,480,shaman,restoration,12,5,7
46451,Dókki,tichondrius,480,shaman,restoration,12,5,7
46452,Vegaslights,tichondrius,480,shaman,restoration,12,5,7
46453,Teftx,area-52,480,shaman,restoration,12,5,7
46454,Bignutters,bleeding-hollow,480,shaman,restoration,12,5,7
46455,Rouzy,area-52,480,shaman,restoration,12,5,7
46456,Masatotem,burning-blade,480,shaman,restoration,12,5,7
46457,Flaggedname,frostmane,480,shaman,restoration,12,5,7
46458,Sixtyninelol,thunderlord,480,shaman,restoration,12,5,7
46459,Weebzealot,kelthuzad,480,shaman,restoration,12,5,7
46460,Sln,bleeding-hollow,480,shaman,restoration,12,5,7
46461,Dyllbat,illidan,480,shaman,restoration,12,5,7
46462,Nizzarrathur,emerald-dream,480,shaman,restoration,12,5,7
46463,Shimta,kiljaeden,480,shaman,restoration,12,5,7
46464,Goresx,tichondrius,480,shaman,restoration,12,5,7
46465,Latoques,quelthalas,480,shaman,restoration,12,5,7
46466,Illmental,kelthuzad,480,shaman,restoration,12,5,7
46467,Daintydan,illidan,480,shaman,restoration,12,5,7
46468,Drcopafeel,stormrage,480,shaman,restoration,12,5,7
46469,Avelmiré,sargeras,480,shaman,restoration,12,5,7
46470,Krupto,tichondrius,480,shaman,restoration,12,5,7
46471,Ongob,kelthuzad,480,shaman,restoration,12,5,7
46472,Tmkaldärýs,tichondrius,480,shaman,restoration,12,5,7
46473,Needneed,tichondrius,480,shaman,restoration,12,5,7
46474,Doop,kiljaeden,480,shaman,restoration,12,5,7
46475,Thonty,sargeras,480,shaman,restoration,12,5,7
46476,Srbski,emerald-dream,480,shaman,restoration,12,5,7
46477,Saw,ghostlands,480,shaman,restoration,12,5,7
46478,Nøzurbo,area-52,480,shaman,restoration,12,5,7
46479,Teestuh,proudmoore,480,shaman,restoration,12,5,7
46480,Stedi,moon-guard,480,shaman,restoration,12,5,7
46481,Tankseven,tichondrius,480,shaman,restoration,12,5,7
46482,Huulu,blades-edge,480,shaman,restoration,12,5,7
46483,Rykkar,kiljaeden,480,shaman,restoration,12,5,7
46484,Xypress,tichondrius,480,shaman,restoration,12,5,7
46485,Larvabust,azralon,480,shaman,restoration,12,5,7
46486,Trizzeh,moon-guard,480,shaman,restoration,12,5,7
46487,Seukstinyne,frostmourne,480,shaman,restoration,12,5,7
46488,Spiritshocks,tichondrius,480,shaman,restoration,12,5,7
46489,Gomeimsoft,magtheridon,480,shaman,restoration,12,5,7
46490,Kaidis,jubeithos,480,shaman,restoration,12,5,7
46491,Totolorraine,tichondrius,480,shaman,restoration,12,5,7
46492,Bröxigâr,tichondrius,480,shaman,restoration,12,5,7
46493,Deyodin,illidan,480,shaman,restoration,12,5,7
46494,Juked,aegwynn,480,shaman,restoration,12,5,7
46495,Simpinbeen,frostmourne,480,shaman,restoration,12,5,7
46496,Jixxerele,malganis,480,shaman,restoration,12,5,7
46497,Kergan,fenris,480,shaman,restoration,12,5,7
46498,Tingletotem,tichondrius,480,shaman,restoration,12,5,7
46499,Nøir,drakkari,480,shaman,restoration,12,5,7
46500,Kupnicki,zuljin,480,shaman,restoration,12,5,7
46501,Hijodelrayo,drakkari,480,shaman,restoration,12,5,7
46502,Derbain,caelestrasz,480,shaman,restoration,12,5,7
46503,Scrumbum,tichondrius,480,shaman,restoration,16,6,10
46504,Zezlek,malganis,480,shaman,restoration,18,5,13
46505,Animac,bleeding-hollow,480,shaman,restoration,18,5,13
46506,Stoompz,kiljaeden,480,shaman,restoration,18,5,13
46507,Andiamo,deathwing,480,shaman,restoration,18,5,13
46508,Decm,area-52,480,shaman,restoration,18,5,13
46509,Krisu,kelthuzad,480,shaman,restoration,18,5,13
46510,Oilburner,malganis,480,shaman,restoration,18,5,13
46511,Noveske,arthas,480,shaman,restoration,18,5,13
46512,Tehbeast,khadgar,480,shaman,restoration,24,5,19
46513,Danimalls,stormrage,479,shaman,restoration,6,5,1
46514,Terrusguard,thrall,479,shaman,restoration,6,5,1
46515,Greenberry,bonechewer,479,shaman,restoration,10,6,4
46516,Gagonmatotem,skullcrusher,479,shaman,restoration,9,5,4
46517,Beardsworth,emerald-dream,479,shaman,restoration,12,5,7
46518,Welled,area-52,479,shaman,restoration,12,5,7
46519,Highmountain,tichondrius,479,shaman,restoration,12,5,7
46520,Øliverxd,lightbringer,479,shaman,restoration,12,5,7
46521,Kamehamekazi,blackhand,479,shaman,restoration,12,5,7
46522,Estheriea,moon-guard,479,shaman,restoration,12,5,7
46523,Tattoö,elune,479,shaman,restoration,12,5,7
46524,Maczo,kiljaeden,479,shaman,restoration,12,5,7
46525,Aimsely,area-52,479,shaman,restoration,12,5,7
46526,Killonsight,tichondrius,479,shaman,restoration,12,5,7
46527,Sâvage,zuljin,479,shaman,restoration,12,5,7
46528,Arastour,bronzebeard,479,shaman,restoration,12,5,7
46529,Yngvii,tichondrius,479,shaman,restoration,12,5,7
46530,Blkpowerfist,malganis,479,shaman,restoration,12,5,7
46531,Bayonett,wyrmrest-accord,479,shaman,restoration,12,5,7
46532,Piaopiao,skywall,479,shaman,restoration,12,5,7
46533,Uncleg,frostmourne,479,shaman,restoration,12,5,7
46534,Bobaflexqt,korgath,479,shaman,restoration,12,5,7
46535,Drmundo,icecrown,479,shaman,restoration,12,5,7
46536,Smearedbeard,bleeding-hollow,479,shaman,restoration,18,5,13
46537,Beanshammy,stormrage,479,shaman,restoration,18,5,13
46538,Nytestalker,sargeras,479,shaman,restoration,18,5,13
46539,Guronna,arthas,479,shaman,restoration,18,5,13
46540,Haymaker,bleeding-hollow,479,shaman,restoration,24,5,19
46541,Typo,skullcrusher,478,shaman,restoration,6,5,1
46542,Grubbyy,tichondrius,478,shaman,restoration,13,6,7
46543,Samac,ravencrest,478,shaman,restoration,12,5,7
46544,Oregano,korgath,478,shaman,restoration,12,5,7
46545,Stahlye,proudmoore,477,shaman,restoration,6,5,1
46546,Lysergicacid,proudmoore,477,shaman,restoration,6,5,1
46547,Timprecu,azralon,477,shaman,restoration,12,5,7
46548,Furyshock,tichondrius,477,shaman,restoration,18,5,13
46549,Vazan,arthas,476,shaman,restoration,12,5,7
46550,Healcacatoi,zuljin,475,shaman,restoration,12,5,7
46551,Pileef,thrall,473,shaman,restoration,13,7,6
46552,Uderlol,tichondrius,448,shaman,restoration,10,5,5
46553,Brocklee,farstriders,447,shaman,restoration,16,5,11
46554,Lequandarius,sargeras,447,shaman,restoration,17,5,12
46555,Akhae,duskwood,445,shaman,restoration,14,6,8
46556,Shocktopus,emerald-dream,442,shaman,restoration,22,12,10
46557,Sidnii,tichondrius,432,shaman,restoration,9,5,4
46558,Voltzwagon,vashj,431,shaman,restoration,9,6,3
46559,Lampstand,wildhammer,431,shaman,restoration,11,5,6
46560,Zelzus,moon-guard,431,shaman,restoration,11,5,6
46561,Rensel,drakkari,429,shaman,restoration,17,5,12
46562,Littleshasha,tichondrius,426,shaman,restoration,15,6,9
46563,Swampy,tanaris,426,shaman,restoration,15,6,9
46564,Ggezlmao,bleeding-hollow,426,shaman,restoration,16,6,10
46565,Drowsbad,tichondrius,426,shaman,restoration,22,7,15
46566,Zio,akama,425,shaman,restoration,14,6,8
46567,Thelôpen,tichondrius,425,shaman,restoration,23,7,16
46568,Hannibol,tichondrius,416,shaman,restoration,10,5,5
46569,Shockjoy,malganis,415,shaman,restoration,11,5,6
46570,Chûnk,tichondrius,400,shaman,restoration,13,5,8
46571,Clapton,darkspear,400,shaman,restoration,19,5,14
46572,Thua,moon-guard,384,shaman,restoration,6,4,2
46573,Phado,tichondrius,384,shaman,restoration,6,4,2
46574,Excaliburumb,tichondrius,384,shaman,restoration,6,4,2
46575,Telnos,emerald-dream,384,shaman,restoration,6,4,2
46576,Intravz,tichondrius,384,shaman,restoration,6,4,2
46577,Shiriloster,ragnaros,384,shaman,restoration,6,4,2
46578,Djbluex,tichondrius,384,shaman,restoration,6,4,2
46579,Xiaoya,tichondrius,384,shaman,restoration,6,4,2
46580,Xraiduh,area-52,384,shaman,restoration,6,4,2
46581,Famikzmeypro,stormrage,384,shaman,restoration,6,4,2
46582,Elrik,khadgar,384,shaman,restoration,6,4,2
46583,Nepshock,stormrage,384,shaman,restoration,6,4,2
46584,Castia,sargeras,384,shaman,restoration,6,4,2
46585,Wecookin,frostwolf,384,shaman,restoration,6,4,2
46586,Wìnì,dalaran,384,shaman,restoration,6,4,2
46587,Tyshaman,sargeras,384,shaman,restoration,6,4,2
46588,Gotmolk,illidan,384,shaman,restoration,6,4,2
46589,Smeeza,frostmourne,384,shaman,restoration,6,4,2
46590,Ârtík,tichondrius,384,shaman,restoration,6,4,2
46591,Éarl,sargeras,384,shaman,restoration,6,4,2
46592,Skumnasty,tichondrius,384,shaman,restoration,6,4,2
46593,Notretro,uldum,384,shaman,restoration,6,4,2
46594,Aletcheoddox,sargeras,384,shaman,restoration,6,4,2
46595,Bhann,tichondrius,384,shaman,restoration,6,4,2
46596,Xillicit,sargeras,384,shaman,restoration,6,4,2
46597,Kaîowas,malganis,384,shaman,restoration,6,4,2
46598,Bigboorst,kelthuzad,384,shaman,restoration,6,4,2
46599,Shamankofwa,tichondrius,384,shaman,restoration,6,4,2
46600,Shearhands,illidan,384,shaman,restoration,6,4,2
46601,Blazedblue,tichondrius,384,shaman,restoration,6,4,2
46602,Dînk,stormrage,384,shaman,restoration,6,4,2
46603,Aeølus,tichondrius,384,shaman,restoration,6,4,2
46604,Príde,ragnaros,384,shaman,restoration,6,4,2
46605,Shöckäzulu,nazgrel,384,shaman,restoration,6,4,2
46606,Sacroshaman,frostmourne,384,shaman,restoration,6,4,2
46607,Rhox,azralon,384,shaman,restoration,6,4,2
46608,Tisaa,tichondrius,384,shaman,restoration,6,4,2
46609,Drackmon,illidan,384,shaman,restoration,6,4,2
46610,Gumballin,sargeras,384,shaman,restoration,8,4,4
46611,Pomelol,tichondrius,384,shaman,restoration,12,4,8
46612,Babbz,sargeras,384,shaman,restoration,12,4,8
46613,Twiztedwayz,tichondrius,384,shaman,restoration,12,4,8
46614,Saksa,garrosh,384,shaman,restoration,12,4,8
46615,Grüncks,azralon,384,shaman,restoration,12,4,8
46616,Belazeus,tichondrius,384,shaman,restoration,12,4,8
46617,Misakism,sargeras,384,shaman,restoration,12,4,8
46618,Trölencio,quelthalas,384,shaman,restoration,12,4,8
46619,Dallìa,tichondrius,384,shaman,restoration,12,4,8
46620,Shâmbulance,hyjal,384,shaman,restoration,12,4,8
46621,Gbe,tichondrius,384,shaman,restoration,12,4,8
46622,Smashyz,nerzhul,384,shaman,restoration,12,4,8
46623,Ngentotem,frostmourne,384,shaman,restoration,12,4,8
46624,Dikedwarf,burning-blade,384,shaman,restoration,12,4,8
46625,Eternaltotem,darkspear,384,shaman,restoration,12,4,8
46626,Inhale,sargeras,384,shaman,restoration,12,4,8
46627,Lixir,destromath,384,shaman,restoration,12,4,8
46628,Naturasol,quelthalas,384,shaman,restoration,12,4,8
46629,Toobeastly,deathwing,384,shaman,restoration,12,4,8
46630,Dankprotein,tichondrius,384,shaman,restoration,12,4,8
46631,Ciroc,sargeras,384,shaman,restoration,12,4,8
46632,Juraf,malganis,384,shaman,restoration,12,4,8
46633,Flexi,senjin,384,shaman,restoration,12,4,8
46634,Healswin,sargeras,384,shaman,restoration,12,4,8
46635,Yggiz,stormrage,384,shaman,restoration,12,4,8
46636,Naturelover,mugthol,384,shaman,restoration,12,4,8
46637,Rabajood,korgath,384,shaman,restoration,12,4,8
46638,Ayev,illidan,384,shaman,restoration,12,4,8
46639,Boyyo,maiev,384,shaman,restoration,12,4,8
46640,Geontha,drakkari,384,shaman,restoration,12,4,8
46641,Bayslaps,tichondrius,384,shaman,restoration,12,4,8
46642,Spokytv,azralon,384,shaman,restoration,12,4,8
46643,Cgq,tichondrius,384,shaman,restoration,12,4,8
46644,Celements,malganis,384,shaman,restoration,12,4,8
46645,Porkbrains,emerald-dream,384,shaman,restoration,16,5,11
46646,Kezzër,azralon,384,shaman,restoration,16,4,12
46647,Conductivity,frostmourne,384,shaman,restoration,18,4,14
46648,Kermut,frostmourne,384,shaman,restoration,18,4,14
46649,Djoko,tichondrius,384,shaman,restoration,18,4,14
46650,Sèrb,mugthol,384,shaman,restoration,19,4,15
46651,Ilion,nemesis,383,shaman,restoration,6,4,2
46652,Rockyisback,illidan,383,shaman,restoration,6,4,2
46653,Hexnation,frostmourne,383,shaman,restoration,6,4,2
46654,Bøx,ragnaros,383,shaman,restoration,6,4,2
46655,Ozsham,burning-blade,383,shaman,restoration,8,4,4
46656,Snowtem,moonrunner,383,shaman,restoration,12,5,7
46657,Shamamanana,staghelm,383,shaman,restoration,12,4,8
46658,Huugsnkissez,sargeras,383,shaman,restoration,12,4,8
46659,Zìfu,darkspear,383,shaman,restoration,12,4,8
46660,Herteitr,blood-furnace,383,shaman,restoration,12,4,8
46661,Surgetankian,malorne,383,shaman,restoration,12,4,8
46662,Sndtome,tichondrius,383,shaman,restoration,12,4,8
46663,Ânûbis,sargeras,383,shaman,restoration,12,4,8
46664,Tandarin,burning-legion,383,shaman,restoration,12,4,8
46665,Gaboola,tichondrius,383,shaman,restoration,12,4,8
46666,Foogus,tichondrius,383,shaman,restoration,12,4,8
46667,Akharis,frostmane,383,shaman,restoration,21,5,16
46668,Huukron,emerald-dream,382,shaman,restoration,12,4,8
46669,Caulkshock,tichondrius,382,shaman,restoration,12,4,8
46670,Turbö,hyjal,382,shaman,restoration,12,4,8
46671,Shockshow,zuljin,382,shaman,restoration,12,4,8
46672,Chamorro,quelthalas,382,shaman,restoration,18,4,14
46673,Laveidem,frostmourne,382,shaman,restoration,18,4,14
46674,Valien,kiljaeden,381,shaman,restoration,12,4,8
46675,Bubmack,tichondrius,379,shaman,restoration,12,4,8
46676,Andrewot,aerie-peak,378,shaman,restoration,29,4,25
46677,Alwinaa,kiljaeden,367,shaman,restoration,11,4,7
46678,Flavortrash,the-underbog,367,shaman,restoration,11,4,7
46679,Pche,tichondrius,367,shaman,restoration,11,4,7
46680,Aceventuura,hyjal,352,shaman,restoration,22,4,18
46681,Shamanakin,emerald-dream,351,shaman,restoration,8,5,3
46682,Bunnyele,tichondrius,351,shaman,restoration,17,4,13
46683,Avidas,malganis,331,shaman,restoration,15,4,11
46684,Vudu,terokkar,330,shaman,restoration,13,5,8
46685,Hitchsláp,tichondrius,330,shaman,restoration,16,5,11
46686,Intress,moon-guard,329,shaman,restoration,10,6,4
46687,Záika,sargeras,318,shaman,restoration,10,4,6
46688,Elevatezxo,stormrage,304,shaman,restoration,7,4,3
46689,Shomon,khazgoroth,288,shaman,restoration,6,3,3
46690,Gunx,darkspear,288,shaman,restoration,6,3,3
46691,Drwsham,ragnaros,288,shaman,restoration,6,3,3
46692,Forloren,zuljin,288,shaman,restoration,6,3,3
46693,Nondracil,ragnaros,288,shaman,restoration,6,3,3
46694,Shomminn,tichondrius,288,shaman,restoration,6,3,3
46695,Pressyocds,darkspear,288,shaman,restoration,6,3,3
46696,Puntress,barthilas,288,shaman,restoration,6,3,3
46697,Sumyl,ragnaros,288,shaman,restoration,6,3,3
46698,Zoltide,sargeras,288,shaman,restoration,6,3,3
46699,Hungy,wyrmrest-accord,288,shaman,restoration,6,3,3
46700,Millkmachine,daggerspine,288,shaman,restoration,6,3,3
46701,Xxamba,tichondrius,288,shaman,restoration,6,3,3
46702,Goongoon,zuljin,288,shaman,restoration,6,3,3
46703,Nyroh,zuljin,288,shaman,restoration,6,3,3
46704,Beatsmaker,tichondrius,288,shaman,restoration,6,3,3
46705,Pôpamolly,saurfang,288,shaman,restoration,6,3,3
46706,Vitchzestein,ragnaros,288,shaman,restoration,6,3,3
46707,Youngie,dathremar,288,shaman,restoration,6,3,3
46708,Floods,frostmourne,288,shaman,restoration,6,3,3
46709,Megafin,tichondrius,288,shaman,restoration,6,3,3
46710,Bigbadpercy,frostmourne,288,shaman,restoration,6,3,3
46711,Smackzs,sargeras,288,shaman,restoration,6,3,3
46712,Gucciblunts,sargeras,288,shaman,restoration,6,3,3
46713,Maana,dragonmaw,288,shaman,restoration,6,3,3
46714,Cloudycloud,tichondrius,288,shaman,restoration,6,3,3
46715,Jupider,nathrezim,288,shaman,restoration,6,3,3
46716,Snowkingx,illidan,288,shaman,restoration,6,3,3
46717,Owoken,illidan,288,shaman,restoration,6,3,3
46718,Megadabs,malganis,288,shaman,restoration,6,3,3
46719,Shammich,vashj,288,shaman,restoration,6,3,3
46720,Totumstroker,thrall,288,shaman,restoration,6,3,3
46721,Moonrider,nerzhul,288,shaman,restoration,6,3,3
46722,Rollînçoàl,malganis,288,shaman,restoration,6,3,3
46723,Uthprotekta,daggerspine,288,shaman,restoration,6,3,3
46724,Skrubbles,bleeding-hollow,288,shaman,restoration,6,3,3
46725,Stymiedxs,zuljin,288,shaman,restoration,6,3,3
46726,Solitarysham,moon-guard,288,shaman,restoration,6,3,3
46727,Headcrackx,sargeras,288,shaman,restoration,6,3,3
46728,Electriqt,barthilas,288,shaman,restoration,6,3,3
46729,Herpeaz,kelthuzad,288,shaman,restoration,6,3,3
46730,Eleresto,tichondrius,288,shaman,restoration,6,3,3
46731,Mítchconnor,tichondrius,288,shaman,restoration,6,3,3
46732,Sreve,malganis,288,shaman,restoration,6,3,3
46733,Sumdumshaman,illidan,288,shaman,restoration,6,3,3
46734,Fruityrudyy,area-52,288,shaman,restoration,6,3,3
46735,Teladoy,kelthuzad,288,shaman,restoration,6,3,3
46736,Ñoobshaman,tichondrius,288,shaman,restoration,6,3,3
46737,Fwap,bleeding-hollow,288,shaman,restoration,6,3,3
46738,Voron,kiljaeden,288,shaman,restoration,6,3,3
46739,Cowboydans,malganis,288,shaman,restoration,6,3,3
46740,Memetide,daggerspine,288,shaman,restoration,6,3,3
46741,Rakkasham,blackrock,288,shaman,restoration,6,3,3
46742,Laucian,malganis,288,shaman,restoration,6,3,3
46743,Akupapu,illidan,288,shaman,restoration,6,3,3
46744,Siox,zuljin,288,shaman,restoration,6,3,3
46745,Kanntok,quelthalas,288,shaman,restoration,6,3,3
46746,Chocothicc,bleeding-hollow,288,shaman,restoration,6,3,3
46747,Meatboi,khaz-modan,288,shaman,restoration,6,3,3
46748,Jubie,proudmoore,288,shaman,restoration,6,3,3
46749,Spencêrf,illidan,288,shaman,restoration,6,3,3
46750,Nüt,wyrmrest-accord,288,shaman,restoration,6,3,3
46751,Ililiiïiili,tichondrius,288,shaman,restoration,6,3,3
46752,Wolfguts,thrall,288,shaman,restoration,6,3,3
46753,Phinoi,tichondrius,288,shaman,restoration,6,3,3
46754,Totemtots,illidan,288,shaman,restoration,6,3,3
46755,Digglr,tichondrius,288,shaman,restoration,6,3,3
46756,Daggonet,sargeras,288,shaman,restoration,6,3,3
46757,Catnïp,maelstrom,288,shaman,restoration,6,3,3
46758,Dwarfers,emerald-dream,288,shaman,restoration,6,3,3
46759,Yunqboichay,kelthuzad,288,shaman,restoration,6,3,3
46760,Danyax,malganis,288,shaman,restoration,6,3,3
46761,Taproots,ursin,288,shaman,restoration,6,3,3
46762,Shearx,illidan,288,shaman,restoration,6,3,3
46763,Sonsii,tichondrius,288,shaman,restoration,6,3,3
46764,Soloqstayer,tichondrius,288,shaman,restoration,6,3,3
46765,Fete,malganis,288,shaman,restoration,6,3,3
46766,Dimitrio,azralon,288,shaman,restoration,6,3,3
46767,Cloudsh,silvermoon,288,shaman,restoration,6,3,3
46768,Justdeadman,tichondrius,288,shaman,restoration,6,3,3
46769,Zaios,area-52,288,shaman,restoration,6,3,3
46770,Dyxlol,tichondrius,288,shaman,restoration,6,3,3
46771,Squog,sargeras,288,shaman,restoration,6,3,3
46772,Drwaters,lightnings-blade,288,shaman,restoration,6,3,3
46773,Stormshadowx,proudmoore,288,shaman,restoration,6,3,3
46774,Naughtylol,malganis,288,shaman,restoration,6,3,3
46775,Shoota,tichondrius,288,shaman,restoration,6,3,3
46776,Squidazzle,tichondrius,288,shaman,restoration,8,3,5
46777,Ðrunkentotem,tichondrius,288,shaman,restoration,11,4,7
46778,Rebelutioni,lothar,288,shaman,restoration,11,3,8
46779,Malthor,terenas,288,shaman,restoration,12,3,9
46780,Jumpc,ragnaros,288,shaman,restoration,12,3,9
46781,Zéwel,tichondrius,288,shaman,restoration,12,3,9
46782,Moresbythicc,frostmourne,288,shaman,restoration,12,3,9
46783,Bobthashaman,tichondrius,288,shaman,restoration,12,3,9
46784,Strawberryz,sargeras,288,shaman,restoration,12,3,9
46785,Plaboii,magtheridon,288,shaman,restoration,12,3,9
46786,Trysts,wyrmrest-accord,288,shaman,restoration,12,3,9
46787,Cheefgrief,shadowsong,288,shaman,restoration,12,3,9
46788,Equinsuochha,silvermoon,288,shaman,restoration,12,3,9
46789,Shamle,azuremyst,288,shaman,restoration,12,3,9
46790,Sooweecide,tichondrius,288,shaman,restoration,12,3,9
46791,Liltex,malganis,288,shaman,restoration,12,3,9
46792,Emaric,sargeras,288,shaman,restoration,12,3,9
46793,Chocobomb,burning-blade,288,shaman,restoration,12,3,9
46794,Makogo,earthen-ring,288,shaman,restoration,12,3,9
46795,Mochomò,ragnaros,288,shaman,restoration,12,3,9
46796,Juggerr,thunderlord,288,shaman,restoration,12,3,9
46797,Calliope,burning-legion,288,shaman,restoration,12,3,9
46798,Mondaymood,illidan,288,shaman,restoration,12,3,9
46799,Sliccricc,doomhammer,288,shaman,restoration,12,3,9
46800,Bovinefever,kiljaeden,288,shaman,restoration,12,3,9
46801,Oomme,area-52,288,shaman,restoration,12,3,9
46802,Meatyball,tichondrius,288,shaman,restoration,12,3,9
46803,Malenhncemnt,illidan,288,shaman,restoration,12,3,9
46804,Atmospheric,frostmourne,288,shaman,restoration,12,3,9
46805,Shockathot,stormrage,288,shaman,restoration,12,3,9
46806,Scion,thaurissan,288,shaman,restoration,12,3,9
46807,Karratquake,sargeras,288,shaman,restoration,12,3,9
46808,Showkinho,azralon,288,shaman,restoration,12,3,9
46809,Semasham,khazgoroth,288,shaman,restoration,12,3,9
46810,Shamonalisa,altar-of-storms,288,shaman,restoration,12,3,9
46811,Stornbreiker,thrall,288,shaman,restoration,12,3,9
46812,Adosistoxic,zuljin,288,shaman,restoration,14,3,11
46813,Boodaa,stormscale,288,shaman,restoration,18,3,15
46814,Trøuble,deathwing,288,shaman,restoration,18,3,15
46815,Trovac,azralon,287,shaman,restoration,6,3,3
46816,Thean,wyrmrest-accord,287,shaman,restoration,6,3,3
46817,Altryn,shuhalo,287,shaman,restoration,6,3,3
46818,Lïet,quelthalas,287,shaman,restoration,12,3,9
46819,Heatexchange,burning-blade,287,shaman,restoration,12,3,9
46820,Alagorn,icecrown,287,shaman,restoration,12,3,9
46821,Grimnur,bleeding-hollow,287,shaman,restoration,12,3,9
46822,Nottoshammy,dalaran,287,shaman,restoration,12,3,9
46823,Criticalthry,garrosh,287,shaman,restoration,12,3,9
46824,Hawpch,area-52,287,shaman,restoration,19,3,16
46825,Riverrun,shattered-halls,287,shaman,restoration,24,3,21
46826,Garurt,daggerspine,286,shaman,restoration,12,6,6
46827,Kider,drakkari,286,shaman,restoration,6,3,3
46828,Ranek,shuhalo,286,shaman,restoration,6,3,3
46829,Tarlonygg,malganis,281,shaman,restoration,15,6,9
46830,Eloquent,emerald-dream,273,shaman,restoration,19,6,13
46831,Dmoneyswag,illidan,255,shaman,restoration,11,3,8
46832,Hilung,lightnings-blade,255,shaman,restoration,11,3,8
46833,Shamanship,haomarush,239,shaman,restoration,5,3,2
46834,Lickerman,stormreaver,239,shaman,restoration,5,3,2
46835,Hurky,sargeras,239,shaman,restoration,5,3,2
46836,Shåmwiches,tichondrius,234,shaman,restoration,8,4,4
46837,Båndø,tichondrius,234,shaman,restoration,9,4,5
46838,Succies,emerald-dream,234,shaman,restoration,16,4,12
46839,Bigripnow,sargeras,234,shaman,restoration,20,4,16
46840,Tokelahoma,stormrage,234,shaman,restoration,22,4,18
46841,Bigbone,laughing-skull,192,shaman,restoration,9,3,6
46842,Kshock,hyjal,192,shaman,restoration,6,2,4
46843,Jurafxdqt,malganis,192,shaman,restoration,6,2,4
46844,Twistër,illidan,192,shaman,restoration,6,2,4
46845,Sid,frostmourne,192,shaman,restoration,6,2,4
46846,Thunderbleem,hyjal,192,shaman,restoration,6,2,4
46847,Notviscent,illidan,192,shaman,restoration,6,2,4
46848,Rockøh,tichondrius,192,shaman,restoration,6,2,4
46849,Guabanva,wyrmrest-accord,192,shaman,restoration,6,2,4
46850,Fanatix,moon-guard,192,shaman,restoration,6,2,4
46851,Ghostrida,blackrock,192,shaman,restoration,6,2,4
46852,Chainandrain,frostmourne,192,shaman,restoration,6,2,4
46853,Sheems,shadowmoon,192,shaman,restoration,6,2,4
46854,Chungxs,illidan,192,shaman,restoration,6,2,4
46855,Stormwalk,ragnaros,192,shaman,restoration,6,2,4
46856,Mangeegee,malganis,192,shaman,restoration,6,2,4
46857,Kumboi,frostmourne,192,shaman,restoration,6,2,4
46858,Griph,shattered-hand,192,shaman,restoration,6,2,4
46859,Thefurrybox,tichondrius,192,shaman,restoration,6,2,4
46860,Nbax,tichondrius,192,shaman,restoration,6,2,4
46861,Cheesepufs,illidan,192,shaman,restoration,6,2,4
46862,Gwenstifani,sargeras,192,shaman,restoration,6,2,4
46863,Keldara,aerie-peak,192,shaman,restoration,6,2,4
46864,Duality,shattered-halls,192,shaman,restoration,6,2,4
46865,Cvoa,bonechewer,192,shaman,restoration,6,2,4
46866,Aishel,area-52,192,shaman,restoration,6,2,4
46867,Blackaxe,wyrmrest-accord,192,shaman,restoration,6,2,4
46868,Legomyleg,tichondrius,192,shaman,restoration,6,2,4
46869,Cpkzlol,tichondrius,192,shaman,restoration,6,2,4
46870,Alexxspurge,ragnaros,192,shaman,restoration,6,2,4
46871,Gagging,gundrak,192,shaman,restoration,6,2,4
46872,Shikane,hyjal,192,shaman,restoration,6,2,4
46873,Lolcàt,tichondrius,192,shaman,restoration,6,2,4
46874,Dylangs,frostmourne,192,shaman,restoration,6,2,4
46875,Monkeysauce,tichondrius,192,shaman,restoration,6,2,4
46876,Googurt,barthilas,192,shaman,restoration,6,2,4
46877,Khidea,barthilas,192,shaman,restoration,6,2,4
46878,Pandl,frostmourne,192,shaman,restoration,6,2,4
46879,Aderra,garrosh,192,shaman,restoration,6,2,4
46880,Mjxholland,aegwynn,192,shaman,restoration,6,2,4
46881,Hottesthands,barthilas,192,shaman,restoration,6,2,4
46882,Boohoo,dethecus,192,shaman,restoration,6,2,4
46883,Lewse,tichondrius,192,shaman,restoration,6,2,4
46884,Snapertun,tichondrius,192,shaman,restoration,6,2,4
46885,Healyourself,sargeras,192,shaman,restoration,6,2,4
46886,Halfzugzug,sargeras,192,shaman,restoration,6,2,4
46887,Shamsky,tichondrius,192,shaman,restoration,6,2,4
46888,Jamarcuss,tichondrius,192,shaman,restoration,6,2,4
46889,Oaken,spirestone,192,shaman,restoration,6,2,4
46890,Shinydiglett,area-52,192,shaman,restoration,6,2,4
46891,Shamansz,stormrage,192,shaman,restoration,6,2,4
46892,Konga,korialstrasz,192,shaman,restoration,6,2,4
46893,Eye,kelthuzad,192,shaman,restoration,6,2,4
46894,Lakeshow,tichondrius,192,shaman,restoration,6,2,4
46895,Ezeya,area-52,192,shaman,restoration,6,2,4
46896,Zhangyider,illidan,192,shaman,restoration,6,2,4
46897,Hellfiresham,kiljaeden,192,shaman,restoration,6,2,4
46898,Bon,ravencrest,192,shaman,restoration,6,2,4
46899,Karnnages,cenarion-circle,192,shaman,restoration,6,2,4
46900,Cawlin,stormrage,192,shaman,restoration,6,2,4
46901,Magwølfe,area-52,192,shaman,restoration,6,2,4
46902,Toketime,thrall,192,shaman,restoration,6,2,4
46903,Plutoshaker,tichondrius,192,shaman,restoration,6,2,4
46904,Nxboy,proudmoore,192,shaman,restoration,6,2,4
46905,Totemzlol,sargeras,192,shaman,restoration,6,2,4
46906,Hughwang,kelthuzad,192,shaman,restoration,6,2,4
46907,Mauiiei,sargeras,192,shaman,restoration,6,2,4
46908,Raxxom,tichondrius,192,shaman,restoration,6,2,4
46909,Splewtsham,thrall,192,shaman,restoration,6,2,4
46910,Dabrat,lightnings-blade,192,shaman,restoration,6,2,4
46911,Relâx,icecrown,192,shaman,restoration,6,2,4
46912,Ioki,spirestone,192,shaman,restoration,6,2,4
46913,Thundertusks,norgannon,192,shaman,restoration,6,2,4
46914,Firesurge,sargeras,192,shaman,restoration,6,2,4
46915,Zugzugpurge,thrall,192,shaman,restoration,6,2,4
46916,Timbosteve,thrall,192,shaman,restoration,6,2,4
46917,Suspend,gorgonnash,192,shaman,restoration,9,2,7
46918,Kitanoo,kiljaeden,192,shaman,restoration,12,2,10
46919,Bizzy,black-dragonflight,192,shaman,restoration,12,2,10
46920,Lomínark,stormrage,192,shaman,restoration,12,2,10
46921,Paveron,stormrage,192,shaman,restoration,12,2,10
46922,Aoiiro,dentarg,192,shaman,restoration,12,2,10
46923,Rhaksh,sargeras,192,shaman,restoration,12,2,10
46924,Saithô,quelthalas,192,shaman,restoration,12,2,10
46925,Wasiri,illidan,192,shaman,restoration,12,2,10
46926,Kumquat,draka,192,shaman,restoration,12,2,10
46927,Raisongreen,tichondrius,192,shaman,restoration,12,2,10
46928,Danila,blackrock,192,shaman,restoration,12,2,10
46929,Soomer,frostmourne,192,shaman,restoration,12,2,10
46930,Skingreen,nemesis,192,shaman,restoration,12,2,10
46931,Birdizdawerd,shuhalo,192,shaman,restoration,12,2,10
46932,Actios,stormrage,192,shaman,restoration,12,2,10
46933,Ara,zuljin,192,shaman,restoration,12,2,10
46934,Awool,lightbringer,192,shaman,restoration,12,2,10
46935,Rueem,area-52,192,shaman,restoration,12,2,10
46936,Elva,malganis,192,shaman,restoration,12,2,10
46937,Sharish,mannoroth,192,shaman,restoration,12,2,10
46938,Wolpfh,area-52,192,shaman,restoration,12,2,10
46939,Monchsham,area-52,192,shaman,restoration,13,2,11
46940,Schmutz,emerald-dream,192,shaman,restoration,18,2,16
46941,Bootsix,area-52,192,shaman,restoration,18,2,16
46942,Kicksave,illidan,192,shaman,restoration,18,2,16
46943,Doctermoo,daggerspine,192,shaman,restoration,28,3,25
46944,Roogys,emerald-dream,192,shaman,restoration,22,2,20
46945,Thudthudzap,darkspear,191,shaman,restoration,6,2,4
46946,Pwrhouse,ravenholdt,191,shaman,restoration,6,2,4
46947,Machalo,sargeras,191,shaman,restoration,6,2,4
46948,Fóurelements,malganis,191,shaman,restoration,6,2,4
46949,Malsturm,stormrage,191,shaman,restoration,6,2,4
46950,Jammylol,frostmourne,180,shaman,restoration,21,6,15
46951,Ambevsulfr,tichondrius,175,shaman,restoration,11,2,9
46952,Nolij,sargeras,159,shaman,restoration,5,2,3
46953,Restomilk,tichondrius,159,shaman,restoration,5,2,3
46954,Ttvozzyxy,tichondrius,144,shaman,restoration,8,4,4
46955,Stormsanta,emerald-dream,138,shaman,restoration,8,3,5
46956,Waterfaller,tichondrius,138,shaman,restoration,9,3,6
46957,Bigdaddyion,thrall,138,shaman,restoration,9,3,6
46958,Uggerz,barthilas,138,shaman,restoration,9,3,6
46959,Bigbøss,stormrage,138,shaman,restoration,20,3,17
46960,Lyv,stormscale,126,shaman,restoration,25,7,18
46961,Hueymagoo,firetree,112,shaman,restoration,13,2,11
46962,Aricer,proudmoore,112,shaman,restoration,13,2,11
46963,Flêùrs,zuljin,96,shaman,restoration,3,2,1
46964,Downerr,malganis,96,shaman,restoration,3,2,1
46965,Jbahr,hyjal,96,shaman,restoration,3,2,1
46966,Shamtoots,aerie-peak,96,shaman,restoration,9,2,7
46967,Drzeuss,illidan,96,shaman,restoration,6,1,5
46968,Tchamí,blackrock,96,shaman,restoration,6,1,5
46969,Mufflër,the-venture-co,96,shaman,restoration,6,1,5
46970,Crassian,illidan,96,shaman,restoration,6,1,5
46971,Babehmakr,lightnings-blade,96,shaman,restoration,6,1,5
46972,Célty,moon-guard,96,shaman,restoration,6,1,5
46973,Sleepysham,anubarak,96,shaman,restoration,6,1,5
46974,Sshhammann,tichondrius,96,shaman,restoration,6,1,5
46975,Ashborn,archimonde,96,shaman,restoration,6,1,5
46976,Slacken,kiljaeden,96,shaman,restoration,6,1,5
46977,Nøtørious,thrall,96,shaman,restoration,6,1,5
46978,Twizzhurp,bleeding-hollow,96,shaman,restoration,6,1,5
46979,Daiablo,barthilas,96,shaman,restoration,6,1,5
46980,Erii,undermine,96,shaman,restoration,6,1,5
46981,Stickshaman,sargeras,96,shaman,restoration,6,1,5
46982,Shamoover,kelthuzad,96,shaman,restoration,6,1,5
46983,Meramin,illidan,96,shaman,restoration,6,1,5
46984,Thenewsherek,maelstrom,96,shaman,restoration,6,1,5
46985,Kwaztotem,area-52,96,shaman,restoration,6,1,5
46986,Zorg,area-52,96,shaman,restoration,6,1,5
46987,Galiffa,area-52,96,shaman,restoration,6,1,5
46988,Phéônîxgodx,zuljin,96,shaman,restoration,6,1,5
46989,Milkyduds,area-52,96,shaman,restoration,6,1,5
46990,Dasckisham,area-52,96,shaman,restoration,6,1,5
46991,Toyletpaper,mugthol,96,shaman,restoration,6,1,5
46992,Tofuji,barthilas,96,shaman,restoration,6,1,5
46993,Movemaker,shattered-hand,96,shaman,restoration,6,1,5
46994,Statikrage,eonar,96,shaman,restoration,6,1,5
46995,Shamouranth,barthilas,96,shaman,restoration,6,1,5
46996,Churdoodle,area-52,96,shaman,restoration,6,1,5
46997,Ashamanist,barthilas,96,shaman,restoration,6,1,5
46998,Wannabecdeww,kelthuzad,96,shaman,restoration,6,1,5
46999,Daku,tichondrius,96,shaman,restoration,6,1,5
47000,Asanako,illidan,96,shaman,restoration,6,1,5
47001,Lennylemons,stormrage,96,shaman,restoration,6,1,5
47002,Restoz,thrall,96,shaman,restoration,6,1,5
47003,Yggd,zuljin,96,shaman,restoration,6,1,5
47004,Yaola,kiljaeden,96,shaman,restoration,6,1,5
47005,Hadèes,zuljin,96,shaman,restoration,6,1,5
47006,Eleshamanz,tichondrius,96,shaman,restoration,6,1,5
47007,Ogeez,area-52,96,shaman,restoration,6,1,5
47008,Conflïcted,emerald-dream,96,shaman,restoration,6,1,5
47009,Sharmalama,illidan,96,shaman,restoration,6,1,5
47010,Blmqt,stormrage,96,shaman,restoration,6,1,5
47011,Ddolsx,tichondrius,96,shaman,restoration,6,1,5
47012,Blazinowls,illidan,96,shaman,restoration,6,1,5
47013,Swartzqt,tichondrius,96,shaman,restoration,6,1,5
47014,Teathin,ragnaros,96,shaman,restoration,6,1,5
47015,Restorates,tichondrius,96,shaman,restoration,6,1,5
47016,Meattoilet,tichondrius,96,shaman,restoration,6,1,5
47017,Cyberheler,quelthalas,96,shaman,restoration,6,1,5
47018,Restonomnom,the-underbog,96,shaman,restoration,6,1,5
47019,Goblintrap,area-52,96,shaman,restoration,6,1,5
47020,Gadzêd,kelthuzad,96,shaman,restoration,6,1,5
47021,Vulpyr,ragnaros,96,shaman,restoration,6,1,5
47022,Shambita,azralon,96,shaman,restoration,6,1,5
47023,Cluffatty,tichondrius,96,shaman,restoration,6,1,5
47024,Shapaman,tichondrius,96,shaman,restoration,6,1,5
47025,Guildhealer,darkspear,96,shaman,restoration,6,1,5
47026,Finnaburstt,tichondrius,96,shaman,restoration,6,1,5
47027,Groundfaults,bleeding-hollow,96,shaman,restoration,6,1,5
47028,Average,bonechewer,96,shaman,restoration,6,1,5
47029,Dodey,malganis,96,shaman,restoration,6,1,5
47030,Drgiggleheim,tichondrius,96,shaman,restoration,6,1,5
47031,Totempixie,barthilas,96,shaman,restoration,6,1,5
47032,Calicø,durotan,96,shaman,restoration,7,1,6
47033,Finark,tichondrius,96,shaman,restoration,7,1,6
47034,Jips,illidan,96,shaman,restoration,11,1,10
47035,Lucapapa,tichondrius,96,shaman,restoration,12,1,11
47036,Meatlog,dalaran,96,shaman,restoration,12,1,11
47037,Tinytiddies,chogall,96,shaman,restoration,12,1,11
47038,Njolmir,khazgoroth,96,shaman,restoration,12,1,11
47039,Forzeus,zuluhed,96,shaman,restoration,12,1,11
47040,Hexpert,firetree,96,shaman,restoration,12,1,11
47041,Lór,onyxia,96,shaman,restoration,12,1,11
47042,Latishas,alleria,96,shaman,restoration,18,1,17
47043,Okdopey,area-52,95,shaman,restoration,6,1,5
47044,Lupog,illidan,89,shaman,restoration,8,4,4
47045,Vashidda,stormrage,79,shaman,restoration,5,1,4
47046,Varnol,emerald-dream,79,shaman,restoration,5,1,4
47047,Dirtyshammy,mugthol,79,shaman,restoration,11,1,10
47048,Totèm,tichondrius,64,shaman,restoration,4,1,3
47049,Annöying,ysera,42,shaman,restoration,6,2,4
47050,Applicable,tichondrius,42,shaman,restoration,9,2,7
47051,Hatemønger,medivh,42,shaman,restoration,11,2,9
47052,Ttvozzyxy,tichondrius,2385,shaman,elemental,139,89,50
47053,Bronzer,tichondrius,2325,shaman,elemental,75,53,22
47054,Selenna,tichondrius,2305,shaman,elemental,150,90,60
47055,Ranjeesh,frostmourne,2233,shaman,elemental,174,100,74
47056,Bøøgaa,proudmoore,2215,shaman,elemental,143,78,65
47057,Meatbeaterx,aggramar,2189,shaman,elemental,135,70,65
47058,Itzgucci,illidan,2185,shaman,elemental,86,49,37
47059,Beyoncé,lethon,2181,shaman,elemental,80,45,35
47060,Thegloc,illidan,2168,shaman,elemental,59,36,23
47061,Jimmysporty,malganis,2168,shaman,elemental,90,47,43
47062,Mercs,frostmourne,2159,shaman,elemental,86,50,36
47063,Bøulderfist,tichondrius,2157,shaman,elemental,72,44,28
47064,Crøwgød,tichondrius,2156,shaman,elemental,109,65,44
47065,Khazger,area-52,2150,shaman,elemental,113,65,48
47066,Jgmbs,dalaran,2134,shaman,elemental,106,64,42
47067,Axelsteel,illidan,2132,shaman,elemental,66,45,21
47068,Glochaswon,illidan,2131,shaman,elemental,84,51,33
47069,Hitzz,malganis,2127,shaman,elemental,78,49,29
47070,Jazuul,zuljin,2125,shaman,elemental,72,38,34
47071,Lardaz,darkspear,2118,shaman,elemental,60,37,23
47072,Blmqt,stormrage,2117,shaman,elemental,126,83,43
47073,Jeasham,malganis,2114,shaman,elemental,143,75,68
47074,Billycool,tichondrius,2112,shaman,elemental,66,42,24
47075,Benanderson,tichondrius,2111,shaman,elemental,110,61,49
47076,Zoeytur,sargeras,2107,shaman,elemental,84,45,39
47077,Shiggenbasta,tichondrius,2107,shaman,elemental,119,63,56
47078,Hexecute,tichondrius,2106,shaman,elemental,84,42,42
47079,Hollowbaby,tichondrius,2101,shaman,elemental,73,48,25
47080,Luhz,tichondrius,2081,shaman,elemental,209,102,107
47081,Nanosec,tichondrius,2079,shaman,elemental,94,50,44
47082,Strongele,illidan,2063,shaman,elemental,69,40,29
47083,Kaandel,azralon,2054,shaman,elemental,185,93,92
47084,Missedkick,tichondrius,2050,shaman,elemental,175,103,72
47085,Bronzers,tichondrius,2046,shaman,elemental,54,33,21
47086,Tisaa,tichondrius,2025,shaman,elemental,66,32,34
47087,Orçhid,tichondrius,2020,shaman,elemental,60,42,18
47088,Dxxlol,tichondrius,2013,shaman,elemental,102,59,43
47089,Meatbeaterx,bleeding-hollow,2009,shaman,elemental,72,36,36
47090,Iavalash,bleeding-hollow,1995,shaman,elemental,210,103,107
47091,Pikopiko,tichondrius,1989,shaman,elemental,60,36,24
47092,Trenzix,sargeras,1989,shaman,elemental,196,100,96
47093,Reckfulq,proudmoore,1986,shaman,elemental,137,84,53
47094,Kimkar,bleeding-hollow,1982,shaman,elemental,90,48,42
47095,Yejinok,tichondrius,1982,shaman,elemental,126,66,60
47096,Zipzsham,maiev,1979,shaman,elemental,69,50,19
47097,Manofsand,drenden,1970,shaman,elemental,213,109,104
47098,Mazadu,malganis,1967,shaman,elemental,47,27,20
47099,Joedna,tichondrius,1962,shaman,elemental,118,61,57
47100,Ãmg,tichondrius,1960,shaman,elemental,76,50,26
47101,Chunchünmaru,area-52,1957,shaman,elemental,71,40,31
47102,Boomsele,tichondrius,1952,shaman,elemental,61,42,19
47103,Bakenquake,tichondrius,1947,shaman,elemental,92,48,44
47104,Bujii,frostmourne,1929,shaman,elemental,239,119,120
47105,Foudre,malganis,1925,shaman,elemental,42,27,15
47106,Depression,baelgun,1921,shaman,elemental,84,51,33
47107,Hexxás,bloodscalp,1920,shaman,elemental,68,40,28
47108,Safeword,nesingwary,1919,shaman,elemental,74,42,32
47109,Johnsju,sargeras,1915,shaman,elemental,111,57,54
47110,Tenyks,tichondrius,1913,shaman,elemental,117,67,50
47111,Emppege,tichondrius,1911,shaman,elemental,133,64,69
47112,Geodude,executus,1909,shaman,elemental,53,33,20
47113,Dipilga,proudmoore,1908,shaman,elemental,46,35,11
47114,Elefusion,sargeras,1908,shaman,elemental,42,27,15
47115,Scaman,tichondrius,1903,shaman,elemental,36,23,13
47116,Makazar,tichondrius,1901,shaman,elemental,42,26,16
47117,Funuser,hellscream,1895,shaman,elemental,146,81,65
47118,Ultron,deathwing,1890,shaman,elemental,143,74,69
47119,Zò,zuljin,1890,shaman,elemental,66,32,34
47120,Molbeato,uldum,1888,shaman,elemental,102,51,51
47121,Hedeadxs,illidan,1882,shaman,elemental,60,30,30
47122,Matikz,boulderfist,1878,shaman,elemental,142,78,64
47123,Powerdown,blackrock,1878,shaman,elemental,65,32,33
47124,Tremordrfear,lightbringer,1877,shaman,elemental,30,20,10
47125,Sleepysham,kelthuzad,1877,shaman,elemental,126,67,59
47126,Orksham,tichondrius,1877,shaman,elemental,60,30,30
47127,Tyar,area-52,1876,shaman,elemental,45,31,14
47128,Àspect,aegwynn,1875,shaman,elemental,36,20,16
47129,Sasageyo,tichondrius,1873,shaman,elemental,93,51,42
47130,Zynt,illidan,1870,shaman,elemental,36,23,13
47131,Cùìó,barthilas,1868,shaman,elemental,54,25,29
47132,Zapmavz,area-52,1865,shaman,elemental,89,49,40
47133,Jalgago,tichondrius,1865,shaman,elemental,47,20,27
47134,Fàlç,stormrage,1863,shaman,elemental,54,32,22
47135,Uglytotem,tichondrius,1863,shaman,elemental,59,32,27
47136,Illchayqt,frostmourne,1861,shaman,elemental,65,35,30
47137,Shockay,tichondrius,1861,shaman,elemental,56,30,26
47138,Skkarz,malganis,1858,shaman,elemental,158,88,70
47139,Gangmembr,illidan,1857,shaman,elemental,42,25,17
47140,Jøey,nesingwary,1854,shaman,elemental,30,20,10
47141,Shøckys,tichondrius,1849,shaman,elemental,108,49,59
47142,Handzum,blades-edge,1848,shaman,elemental,72,41,31
47143,Dampenedxx,bleeding-hollow,1848,shaman,elemental,151,85,66
47144,Juicébox,tichondrius,1848,shaman,elemental,92,49,43
47145,Sshaman,tichondrius,1846,shaman,elemental,82,40,42
47146,Snookìe,sargeras,1846,shaman,elemental,88,41,47
47147,Hecstacy,dalaran,1842,shaman,elemental,66,42,24
47148,Utilitytotem,moon-guard,1838,shaman,elemental,154,83,71
47149,Chemjenn,korgath,1838,shaman,elemental,84,37,47
47150,Saphlare,tichondrius,1836,shaman,elemental,36,22,14
47151,Rahtal,malganis,1834,shaman,elemental,48,25,23
47152,Starmaker,malganis,1833,shaman,elemental,44,23,21
47153,Planetwaves,malganis,1832,shaman,elemental,42,23,19
47154,Nayro,bleeding-hollow,1828,shaman,elemental,48,32,16
47155,Gaymakaí,sargeras,1828,shaman,elemental,48,27,21
47156,Zzarit,tichondrius,1825,shaman,elemental,48,24,24
47157,Humorlava,tichondrius,1820,shaman,elemental,30,19,11
47158,Magtark,frostwolf,1820,shaman,elemental,61,38,23
47159,Carondes,proudmoore,1820,shaman,elemental,69,38,31
47160,Shôcky,tichondrius,1819,shaman,elemental,54,33,21
47161,Hotdogwaterx,tichondrius,1817,shaman,elemental,62,42,20
47162,Meatyball,tichondrius,1816,shaman,elemental,65,42,23
47163,Baddaboom,sargeras,1816,shaman,elemental,97,54,43
47164,Shockjob,frostmourne,1815,shaman,elemental,36,19,17
47165,Smiteums,sargeras,1813,shaman,elemental,42,24,18
47166,Wangyinanmin,tichondrius,1812,shaman,elemental,30,19,11
47167,Whameradetu,suramar,1809,shaman,elemental,80,38,42
47168,Hadèes,zuljin,1808,shaman,elemental,198,108,90
47169,Dràgoon,thrall,1807,shaman,elemental,30,19,11
47170,Coffinpls,illidan,1806,shaman,elemental,54,33,21
47171,Swigadee,tichondrius,1806,shaman,elemental,84,39,45
47172,Molerat,illidan,1806,shaman,elemental,158,73,85
47173,Bismarks,frostmourne,1805,shaman,elemental,66,38,28
47174,Zuescannon,kelthuzad,1805,shaman,elemental,59,32,27
47175,Drazziqt,malganis,1803,shaman,elemental,45,27,18
47176,Nonomori,frostmourne,1802,shaman,elemental,48,30,18
47177,Torchic,drakkari,1801,shaman,elemental,60,31,29
47178,Monkeysham,dathremar,1800,shaman,elemental,48,30,18
47179,Elementàlius,quelthalas,1800,shaman,elemental,80,46,34
47180,Mackq,tichondrius,1800,shaman,elemental,103,54,49
47181,Osev,stormrage,1795,shaman,elemental,48,26,22
47182,Cepheí,bleeding-hollow,1792,shaman,elemental,77,38,39
47183,Ñîmåbè,tichondrius,1787,shaman,elemental,36,21,15
47184,Ralae,zuljin,1782,shaman,elemental,29,19,10
47185,Donkeyteeth,bleeding-hollow,1779,shaman,elemental,97,54,43
47186,Earthclap,tichondrius,1779,shaman,elemental,79,38,41
47187,Ieeguen,tichondrius,1778,shaman,elemental,48,22,26
47188,Soyboyxxo,barthilas,1774,shaman,elemental,127,65,62
47189,Hazzathxy,tichondrius,1771,shaman,elemental,41,22,19
47190,Zqsyyds,illidan,1770,shaman,elemental,35,19,16
47191,Deathblasts,zuljin,1770,shaman,elemental,48,22,26
47192,Møp,spirestone,1766,shaman,elemental,66,39,27
47193,Swiatek,ragnaros,1764,shaman,elemental,76,42,34
47194,Vkzz,sargeras,1763,shaman,elemental,67,27,40
47195,Groundme,malganis,1756,shaman,elemental,35,19,16
47196,Damadar,zuljin,1754,shaman,elemental,94,49,45
47197,Brezel,azralon,1740,shaman,elemental,42,27,15
47198,Minigible,tichondrius,1739,shaman,elemental,54,23,31
47199,Ktshammy,frostmourne,1738,shaman,elemental,30,21,9
47200,Gravygumdrop,tichondrius,1737,shaman,elemental,98,51,47
47201,Scrymax,area-52,1733,shaman,elemental,72,39,33
47202,Hexistential,tichondrius,1731,shaman,elemental,34,26,8
47203,Taranís,sargeras,1730,shaman,elemental,54,25,29
47204,Hüsky,dalaran,1725,shaman,elemental,53,27,26
47205,Windfurygød,tichondrius,1724,shaman,elemental,60,44,16
47206,Däbü,tichondrius,1724,shaman,elemental,30,18,12
47207,Beibeihangh,tichondrius,1720,shaman,elemental,36,21,15
47208,Apyôn,tichondrius,1719,shaman,elemental,42,24,18
47209,Triknolov,dalaran,1719,shaman,elemental,77,40,37
47210,ßævis,magtheridon,1715,shaman,elemental,60,37,23
47211,Liquidmagma,deathwing,1711,shaman,elemental,100,50,50
47212,Vixeen,kelthuzad,1711,shaman,elemental,42,21,21
47213,Pubechin,jubeithos,1711,shaman,elemental,42,21,21
47214,Scherzer,frostwolf,1711,shaman,elemental,108,48,60
47215,Ayumihamasai,tichondrius,1710,shaman,elemental,60,33,27
47216,Ryanxo,azjolnerub,1709,shaman,elemental,35,21,14
47217,Miroen,tichondrius,1708,shaman,elemental,36,18,18
47218,Flüke,tichondrius,1704,shaman,elemental,54,31,23
47219,Notahappyone,area-52,1703,shaman,elemental,48,34,14
47220,Kustys,tichondrius,1699,shaman,elemental,36,18,18
47221,Trïggerr,blackrock,1695,shaman,elemental,30,18,12
47222,Mytotemisbig,lothar,1694,shaman,elemental,59,38,21
47223,Notbpage,burning-blade,1694,shaman,elemental,102,51,51
47224,Tupacshocker,zuljin,1692,shaman,elemental,30,18,12
47225,Krumpits,barthilas,1685,shaman,elemental,45,26,19
47226,Trnzx,sargeras,1684,shaman,elemental,36,21,15
47227,Shockyshock,emerald-dream,1683,shaman,elemental,46,29,17
47228,Billydreams,drakkari,1683,shaman,elemental,140,69,71
47229,Caserguy,sargeras,1683,shaman,elemental,58,24,34
47230,Ryukims,tichondrius,1682,shaman,elemental,76,41,35
47231,Enkix,drakkari,1681,shaman,elemental,42,23,19
47232,Cyhren,illidan,1679,shaman,elemental,54,33,21
47233,Kigoros,bleeding-hollow,1679,shaman,elemental,60,33,27
47234,Gorjun,stormrage,1679,shaman,elemental,81,38,43
47235,Ptee,tichondrius,1677,shaman,elemental,45,23,22
47236,Zugzugdogg,destromath,1674,shaman,elemental,42,23,19
47237,Zeroclue,area-52,1673,shaman,elemental,40,22,18
47238,Buffele,tichondrius,1672,shaman,elemental,42,18,24
47239,Jerkdaddy,aggramar,1668,shaman,elemental,30,19,11
47240,Sonire,tichondrius,1668,shaman,elemental,227,111,116
47241,Hengler,emerald-dream,1666,shaman,elemental,53,28,25
47242,Deckìn,proudmoore,1663,shaman,elemental,160,85,75
47243,Buju,bleeding-hollow,1662,shaman,elemental,152,84,68
47244,Dewoverload,garithos,1657,shaman,elemental,33,23,10
47245,Letronix,azralon,1656,shaman,elemental,71,34,37
47246,Kawj,eonar,1652,shaman,elemental,36,21,15
47247,Creativemind,ragnaros,1652,shaman,elemental,74,40,34
47248,Dyxlol,tichondrius,1652,shaman,elemental,56,25,31
47249,Thaelia,azgalor,1650,shaman,elemental,40,23,17
47250,Caninius,sargeras,1649,shaman,elemental,48,24,24
47251,Walabi,tichondrius,1649,shaman,elemental,50,22,28
47252,Zeylhe,proudmoore,1647,shaman,elemental,54,26,28
47253,Squealer,sargeras,1644,shaman,elemental,98,50,48
47254,Smoketide,stormrage,1644,shaman,elemental,47,21,26
47255,Shockisha,sisters-of-elune,1644,shaman,elemental,52,23,29
47256,Xodeus,frostmourne,1642,shaman,elemental,42,21,21
47257,Shlmmyjimmy,tichondrius,1642,shaman,elemental,90,33,57
47258,Streetmeat,crushridge,1640,shaman,elemental,125,64,61
47259,Shambergler,tichondrius,1639,shaman,elemental,30,20,10
47260,Waterground,tichondrius,1636,shaman,elemental,43,24,19
47261,Dilonsham,area-52,1635,shaman,elemental,52,32,20
47262,Uglymuger,tichondrius,1635,shaman,elemental,128,60,68
47263,Imense,sargeras,1634,shaman,elemental,77,44,33
47264,Lasso,shattered-hand,1632,shaman,elemental,42,21,21
47265,Semasham,khazgoroth,1631,shaman,elemental,49,25,24
47266,Imnumberl,sargeras,1630,shaman,elemental,78,51,27
47267,Bubbert,illidan,1630,shaman,elemental,72,31,41
47268,Óompaloompa,frostmourne,1628,shaman,elemental,52,32,20
47269,Stormsage,jubeithos,1627,shaman,elemental,54,31,23
47270,Fiftybeers,frostmourne,1627,shaman,elemental,35,19,16
47271,Lff,stormrage,1626,shaman,elemental,24,17,7
47272,Hexlexic,stormrage,1625,shaman,elemental,57,34,23
47273,Shaymîn,malganis,1624,shaman,elemental,38,21,17
47274,Chandye,proudmoore,1620,shaman,elemental,48,22,26
47275,Fruityrudyy,area-52,1618,shaman,elemental,30,22,8
47276,Oldcregg,emerald-dream,1618,shaman,elemental,24,17,7
47277,Eimear,kelthuzad,1618,shaman,elemental,33,20,13
47278,Faygodream,illidan,1618,shaman,elemental,220,119,101
47279,Thunderfaker,tichondrius,1618,shaman,elemental,36,17,19
47280,Conjury,tichondrius,1618,shaman,elemental,48,22,26
47281,Popsoot,area-52,1617,shaman,elemental,36,17,19
47282,Mulak,frostmourne,1616,shaman,elemental,110,54,56
47283,Duality,shattered-halls,1615,shaman,elemental,59,38,21
47284,Chajaa,ragnaros,1615,shaman,elemental,171,86,85
47285,Catdontcare,tichondrius,1613,shaman,elemental,30,17,13
47286,Electriik,kiljaeden,1611,shaman,elemental,66,38,28
47287,Gangstà,stormrage,1611,shaman,elemental,66,30,36
47288,Shamans,zuljin,1610,shaman,elemental,42,31,11
47289,Uglymugshock,tichondrius,1610,shaman,elemental,90,46,44
47290,Orkuss,illidan,1609,shaman,elemental,29,19,10
47291,Sweatshock,frostmourne,1608,shaman,elemental,206,112,94
47292,Thündermoose,tichondrius,1608,shaman,elemental,42,21,21
47293,Xakaeri,hyjal,1607,shaman,elemental,59,32,27
47294,Setò,quelthalas,1607,shaman,elemental,66,35,31
47295,Roxxiggom,aggramar,1605,shaman,elemental,24,19,5
47296,Üchihamadarâ,tichondrius,1605,shaman,elemental,87,48,39
47297,Taxd,sargeras,1605,shaman,elemental,40,21,19
47298,Soo,kiljaeden,1605,shaman,elemental,84,39,45
47299,Jaimenohex,illidan,1603,shaman,elemental,36,19,17
47300,Nutty,dentarg,1602,shaman,elemental,42,24,18
47301,Tulol,tichondrius,1602,shaman,elemental,114,54,60
47302,Illbuyurmom,tichondrius,1602,shaman,elemental,87,41,46
47303,Everspell,lightnings-blade,1602,shaman,elemental,72,33,39
47304,Novajersey,azralon,1601,shaman,elemental,62,33,29
47305,Ssjgreen,illidan,1601,shaman,elemental,66,33,33
47306,Opaltsing,tichondrius,1601,shaman,elemental,39,19,20
47307,Feetfungus,area-52,1601,shaman,elemental,78,35,43
47308,Tidedown,dark-iron,1600,shaman,elemental,36,25,11
47309,Mugumbo,frostmourne,1599,shaman,elemental,61,34,27
47310,Emaric,sargeras,1599,shaman,elemental,36,20,16
47311,Ggoong,tichondrius,1597,shaman,elemental,42,25,17
47312,Datbigthing,frostmourne,1596,shaman,elemental,60,24,36
47313,Igotu,tichondrius,1595,shaman,elemental,30,17,13
47314,Kymo,tichondrius,1591,shaman,elemental,30,17,13
47315,Honeybean,tichondrius,1591,shaman,elemental,96,50,46
47316,Lottogodx,area-52,1590,shaman,elemental,48,28,20
47317,Hurìon,coilfang,1589,shaman,elemental,62,35,27
47318,Zelthakaru,emerald-dream,1587,shaman,elemental,42,18,24
47319,Moodizzle,tichondrius,1586,shaman,elemental,96,51,45
47320,Cornivore,malganis,1582,shaman,elemental,36,19,17
47321,Grimmson,emerald-dream,1578,shaman,elemental,48,20,28
47322,Zap,wyrmrest-accord,1576,shaman,elemental,78,39,39
47323,Talonga,moon-guard,1575,shaman,elemental,66,31,35
47324,Pacapinchhit,azgalor,1574,shaman,elemental,57,34,23
47325,Illmental,kelthuzad,1570,shaman,elemental,109,53,56
47326,Totemsmacker,quelthalas,1569,shaman,elemental,72,38,34
47327,Rodbert,sargeras,1568,shaman,elemental,41,20,21
47328,Muffïn,moon-guard,1561,shaman,elemental,42,24,18
47329,Hexzy,moon-guard,1561,shaman,elemental,73,33,40
47330,Indika,stormrage,1560,shaman,elemental,30,18,12
47331,Krimzs,executus,1560,shaman,elemental,81,37,44
47332,Targhal,tichondrius,1559,shaman,elemental,56,34,22
47333,Climhazard,senjin,1555,shaman,elemental,36,18,18
47334,Dook,ghostlands,1555,shaman,elemental,35,17,18
47335,Stitchis,black-dragonflight,1554,shaman,elemental,69,41,28
47336,Shellshocka,korgath,1554,shaman,elemental,38,20,18
47337,Simada,tichondrius,1554,shaman,elemental,36,17,19
47338,Dtab,tichondrius,1552,shaman,elemental,36,18,18
47339,Volcanoboxer,tichondrius,1552,shaman,elemental,90,44,46
47340,Meatballpie,frostmourne,1548,shaman,elemental,42,25,17
47341,Topax,vashj,1548,shaman,elemental,41,23,18
47342,Doodleburger,dathremar,1545,shaman,elemental,50,41,9
47343,Badandbooshi,stormreaver,1544,shaman,elemental,42,20,22
47344,Drogues,tichondrius,1543,shaman,elemental,47,26,21
47345,Afw,darkspear,1542,shaman,elemental,94,53,41
47346,Døutrina,azralon,1542,shaman,elemental,49,21,28
47347,Huskër,tichondrius,1541,shaman,elemental,94,55,39
47348,Borheals,tichondrius,1537,shaman,elemental,44,21,23
47349,Zappynips,frostmourne,1536,shaman,elemental,51,30,21
47350,Ratson,ragnaros,1535,shaman,elemental,36,19,17
47351,Robot,illidan,1534,shaman,elemental,30,16,14
47352,Tulnak,kelthuzad,1532,shaman,elemental,129,66,63
47353,Lovesthegear,blackrock,1529,shaman,elemental,30,16,14
47354,Xpire,ragnaros,1528,shaman,elemental,30,16,14
47355,Gambezee,kelthuzad,1528,shaman,elemental,36,16,20
47356,Harrypotqueu,zuljin,1527,shaman,elemental,30,16,14
47357,Doxshaman,tichondrius,1525,shaman,elemental,117,65,52
47358,Jamieslays,korgath,1525,shaman,elemental,107,54,53
47359,Generators,area-52,1524,shaman,elemental,265,132,133
47360,Mzzar,tichondrius,1523,shaman,elemental,30,16,14
47361,Tunegrote,ragnaros,1523,shaman,elemental,66,35,31
47362,Daddykooll,tichondrius,1521,shaman,elemental,78,40,38
47363,Draghul,frostwolf,1520,shaman,elemental,43,24,19
47364,Sheman,galakrond,1520,shaman,elemental,58,29,29
47365,Dwarfdude,gorefiend,1517,shaman,elemental,41,24,17
47366,Yasmiel,zuljin,1517,shaman,elemental,60,27,33
47367,Cacahuates,suramar,1516,shaman,elemental,96,55,41
47368,Loxshox,gnomeregan,1516,shaman,elemental,401,199,202
47369,Clapton,darkspear,1515,shaman,elemental,47,21,26
47370,Tawambji,kiljaeden,1509,shaman,elemental,30,16,14
47371,Univearth,emerald-dream,1509,shaman,elemental,90,45,45
47372,Gerrkiing,amanthul,1508,shaman,elemental,35,22,13
47373,Bycrax,ragnaros,1507,shaman,elemental,88,45,43
47374,Evilraven,tichondrius,1506,shaman,elemental,183,91,92
47375,Seventeen,blackrock,1506,shaman,elemental,36,16,20
47376,Busterbrounz,queldorei,1505,shaman,elemental,48,32,16
47377,Kakaaroto,nemesis,1504,shaman,elemental,87,49,38
47378,Cgq,tichondrius,1504,shaman,elemental,114,61,53
47379,Friedmans,illidan,1502,shaman,elemental,138,70,68
47380,Pipelord,destromath,1494,shaman,elemental,30,18,12
47381,Legthul,tichondrius,1493,shaman,elemental,36,17,19
47382,Keldinraz,stormrage,1492,shaman,elemental,48,22,26
47383,Sheriffbj,emerald-dream,1489,shaman,elemental,65,29,36
47384,Cowish,illidan,1487,shaman,elemental,42,23,19
47385,Tuntar,ragnaros,1487,shaman,elemental,174,91,83
47386,Vulkuro,quelthalas,1485,shaman,elemental,48,27,21
47387,Soartotes,sargeras,1484,shaman,elemental,34,19,15
47388,Olboy,thrall,1483,shaman,elemental,30,19,11
47389,Innvious,sargeras,1483,shaman,elemental,60,28,32
47390,Gloi,ragnaros,1481,shaman,elemental,31,19,12
47391,Rss,barthilas,1481,shaman,elemental,77,39,38
47392,Dadadabang,frostmourne,1478,shaman,elemental,40,18,22
47393,Defrout,kelthuzad,1469,shaman,elemental,68,32,36
47394,Genericheat,tichondrius,1468,shaman,elemental,59,31,28
47395,Gahaa,tichondrius,1464,shaman,elemental,23,16,7
47396,Isekai,alterac-mountains,1461,shaman,elemental,268,130,138
47397,Washedupty,illidan,1460,shaman,elemental,118,56,62
47398,Cavolt,stormrage,1459,shaman,elemental,41,21,20
47399,Makocc,tichondrius,1458,shaman,elemental,97,48,49
47400,Soulrak,tichondrius,1457,shaman,elemental,114,53,61
47401,Vktr,drakkari,1456,shaman,elemental,64,33,31
47402,Rinnobunen,wyrmrest-accord,1452,shaman,elemental,100,50,50
47403,Engara,frostmane,1451,shaman,elemental,35,17,18
47404,Thundermatt,aegwynn,1451,shaman,elemental,87,39,48
47405,Fwwrs,illidan,1450,shaman,elemental,26,16,10
47406,Tørosentado,quelthalas,1450,shaman,elemental,94,47,47
47407,Malosa,hyjal,1449,shaman,elemental,65,27,38
47408,Georgejr,thunderlord,1445,shaman,elemental,54,31,23
47409,Syile,stormrage,1445,shaman,elemental,80,37,43
47410,Giversham,bleeding-hollow,1437,shaman,elemental,24,15,9
47411,Kumer,tichondrius,1436,shaman,elemental,34,19,15
47412,Dodona,sargeras,1435,shaman,elemental,86,40,46
47413,Biberom,kelthuzad,1434,shaman,elemental,57,32,25
47414,Stèpbro,sargeras,1432,shaman,elemental,36,18,18
47415,Latoques,quelthalas,1431,shaman,elemental,24,15,9
47416,Pipesable,ragnaros,1430,shaman,elemental,24,15,9
47417,Bikáchu,tichondrius,1429,shaman,elemental,24,15,9
47418,Saraguthix,dalaran,1427,shaman,elemental,60,27,33
47419,Kkangsiki,tichondrius,1427,shaman,elemental,36,16,20
47420,Drazzella,arthas,1422,shaman,elemental,47,21,26
47421,Nøir,drakkari,1422,shaman,elemental,60,26,34
47422,Bramah,bonechewer,1420,shaman,elemental,36,16,20
47423,Joehogan,stormrage,1419,shaman,elemental,73,42,31
47424,Snapstr,illidan,1419,shaman,elemental,36,15,21
47425,Scryerman,area-52,1418,shaman,elemental,30,16,14
47426,Srbski,emerald-dream,1416,shaman,elemental,32,17,15
47427,Blacklm,tichondrius,1413,shaman,elemental,24,15,9
47428,Plotious,antonidas,1413,shaman,elemental,36,19,17
47429,Dumpweed,stormscale,1413,shaman,elemental,42,21,21
47430,Gumballin,sargeras,1412,shaman,elemental,85,41,44
47431,Darizzler,bleeding-hollow,1408,shaman,elemental,48,28,20
47432,Shampainn,demon-soul,1407,shaman,elemental,72,38,34
47433,Morluné,tichondrius,1407,shaman,elemental,54,26,28
47434,Chonkymilk,illidan,1407,shaman,elemental,50,22,28
47435,Conductivity,frostmourne,1406,shaman,elemental,48,24,24
47436,Ectomee,tichondrius,1403,shaman,elemental,30,16,14
47437,Mittss,sargeras,1401,shaman,elemental,106,57,49
47438,Pepîllo,ragnaros,1401,shaman,elemental,126,51,75
47439,Wfb,sargeras,1398,shaman,elemental,30,20,10
47440,Zugzugthug,moon-guard,1395,shaman,elemental,131,69,62
47441,Sweetbabyraé,bleeding-hollow,1391,shaman,elemental,66,42,24
47442,Vuhdu,barthilas,1391,shaman,elemental,24,15,9
47443,Liloggie,illidan,1385,shaman,elemental,23,15,8
47444,Redlava,turalyon,1384,shaman,elemental,31,19,12
47445,Everyst,darkspear,1383,shaman,elemental,65,34,31
47446,Golozok,zuljin,1382,shaman,elemental,35,16,19
47447,Ceedlamb,kelthuzad,1381,shaman,elemental,66,34,32
47448,Richode,burning-legion,1376,shaman,elemental,30,17,13
47449,Shuñk,frostmourne,1376,shaman,elemental,60,27,33
47450,Hurky,sargeras,1375,shaman,elemental,152,78,74
47451,Hansolorz,tichondrius,1375,shaman,elemental,56,26,30
47452,Rolltìde,tichondrius,1372,shaman,elemental,153,85,68
47453,Luvstospooj,thaurissan,1372,shaman,elemental,73,34,39
47454,Zechary,proudmoore,1372,shaman,elemental,48,19,29
47455,Ffaísca,azralon,1371,shaman,elemental,44,22,22
47456,Nuofu,illidan,1367,shaman,elemental,59,30,29
47457,Venekk,shattered-hand,1366,shaman,elemental,29,17,12
47458,Ghorokk,azralon,1363,shaman,elemental,42,31,11
47459,Rythia,elune,1363,shaman,elemental,40,18,22
47460,Telain,quelthalas,1360,shaman,elemental,84,42,42
47461,Baodan,azshara,1356,shaman,elemental,97,51,46
47462,Porkfririe,kelthuzad,1356,shaman,elemental,52,21,31
47463,Stormsanta,emerald-dream,1349,shaman,elemental,35,15,20
47464,Moartotems,kelthuzad,1347,shaman,elemental,30,18,12
47465,Minusshaman,dalaran,1346,shaman,elemental,144,80,64
47466,Snewboii,malganis,1346,shaman,elemental,30,15,15
47467,Spoonforkorc,thrall,1342,shaman,elemental,24,14,10
47468,Bagele,tichondrius,1342,shaman,elemental,30,14,16
47469,Shadowowl,tanaris,1339,shaman,elemental,39,19,20
47470,Oontuk,illidan,1337,shaman,elemental,66,31,35
47471,Laelyk,kiljaeden,1336,shaman,elemental,30,14,16
47472,Alphamael,lightbringer,1333,shaman,elemental,65,38,27
47473,Cocainbear,emerald-dream,1332,shaman,elemental,39,20,19
47474,Arukz,tichondrius,1332,shaman,elemental,30,14,16
47475,Onnyx,proudmoore,1330,shaman,elemental,24,14,10
47476,Exoticz,barthilas,1330,shaman,elemental,53,19,34
47477,Drzhong,frostmourne,1329,shaman,elemental,40,22,18
47478,Totems,the-underbog,1327,shaman,elemental,24,14,10
47479,Totem,burning-legion,1327,shaman,elemental,24,14,10
47480,Ekstasiel,azralon,1323,shaman,elemental,54,28,26
47481,Hufflefluffs,kiljaeden,1323,shaman,elemental,56,29,27
47482,Ragnards,ragnaros,1323,shaman,elemental,79,35,44
47483,Zuldroth,frostmourne,1319,shaman,elemental,30,18,12
47484,Shocks,alleria,1318,shaman,elemental,30,14,16
47485,Lenin,nathrezim,1316,shaman,elemental,62,24,38
47486,Endorovich,mannoroth,1309,shaman,elemental,30,14,16
47487,Yippeekiyay,zuluhed,1307,shaman,elemental,57,25,32
47488,Toho,ragnaros,1304,shaman,elemental,48,25,23
47489,Drvoodoo,tichondrius,1301,shaman,elemental,30,15,15
47490,Ayahuaskah,illidan,1300,shaman,elemental,43,20,23
47491,Pozcaster,tichondrius,1299,shaman,elemental,70,24,46
47492,Hueymagoo,firetree,1295,shaman,elemental,24,14,10
47493,Totempoke,frostmourne,1292,shaman,elemental,23,14,9
47494,Synerggy,hakkar,1291,shaman,elemental,297,151,146
47495,Budgetseaan,stormrage,1290,shaman,elemental,66,38,28
47496,Totemtown,darkspear,1286,shaman,elemental,60,28,32
47497,Seinnome,azralon,1276,shaman,elemental,37,16,21
47498,Bushdeedit,stormrage,1274,shaman,elemental,35,14,21
47499,Madelements,tichondrius,1270,shaman,elemental,32,17,15
47500,Rokogg,thrall,1267,shaman,elemental,29,14,15
47501,Shammany,stormrage,1264,shaman,elemental,48,24,24
47502,Jaapo,barthilas,1259,shaman,elemental,98,48,50
47503,Sugirukifuja,stormrage,1258,shaman,elemental,23,16,7
47504,Baltharzhard,saurfang,1257,shaman,elemental,36,16,20
47505,Moacmathi,quelthalas,1253,shaman,elemental,60,27,33
47506,Destroçadorx,azralon,1249,shaman,elemental,32,15,17
47507,Okïòmó,proudmoore,1248,shaman,elemental,30,13,17
47508,Siò,barthilas,1247,shaman,elemental,15,14,1
47509,Funnysa,tichondrius,1247,shaman,elemental,18,13,5
47510,Ëìê,tichondrius,1247,shaman,elemental,36,13,23
47511,Beerofdoom,proudmoore,1245,shaman,elemental,36,19,17
47512,Lugak,ragnaros,1245,shaman,elemental,41,15,26
47513,Battleshammy,nagrand,1243,shaman,elemental,30,15,15
47514,Maldini,tol-barad,1242,shaman,elemental,36,17,19
47515,Clarix,quelthalas,1241,shaman,elemental,24,13,11
47516,Yodahh,daggerspine,1236,shaman,elemental,39,22,17
47517,Marduul,azralon,1236,shaman,elemental,35,16,19
47518,Kanasya,quelthalas,1234,shaman,elemental,41,17,24
47519,Edenorion,ragnaros,1232,shaman,elemental,48,23,25
47520,Sabtifa,proudmoore,1232,shaman,elemental,30,13,17
47521,Forgediniron,stormrage,1225,shaman,elemental,54,27,27
47522,Chaposz,tichondrius,1221,shaman,elemental,30,13,17
47523,Nírnez,ragnaros,1220,shaman,elemental,42,14,28
47524,Malrom,kelthuzad,1218,shaman,elemental,387,194,193
47525,Saulgudmon,area-52,1215,shaman,elemental,36,19,17
47526,Smithereen,area-52,1215,shaman,elemental,36,16,20
47527,Rafiki,haomarush,1215,shaman,elemental,60,26,34
47528,Øten,area-52,1214,shaman,elemental,30,20,10
47529,Mhaal,wyrmrest-accord,1213,shaman,elemental,106,42,64
47530,Eze,tichondrius,1211,shaman,elemental,58,33,25
47531,Amonita,stonemaul,1210,shaman,elemental,18,13,5
47532,Grezzkall,malganis,1207,shaman,elemental,39,19,20
47533,Bazinguinha,azralon,1207,shaman,elemental,60,28,32
47534,Omegaman,lightninghoof,1204,shaman,elemental,69,35,34
47535,Shamanzinh,azralon,1204,shaman,elemental,42,20,22
47536,Deggle,frostwolf,1201,shaman,elemental,30,14,16
47537,Strugs,area-52,1201,shaman,elemental,59,25,34
47538,Killeniis,tichondrius,1192,shaman,elemental,72,31,41
47539,Araghok,ragnaros,1191,shaman,elemental,36,15,21
47540,Konndor,malganis,1184,shaman,elemental,48,19,29
47541,Lezzer,ragnaros,1167,shaman,elemental,102,45,57
47542,Zhokal,quelthalas,1166,shaman,elemental,125,65,60
47543,Cptnmagma,bleeding-hollow,1162,shaman,elemental,124,57,67
47544,Jaycobb,area-52,1159,shaman,elemental,30,13,17
47545,Zugdabou,bonechewer,1155,shaman,elemental,66,30,36
47546,Kebboz,frostmourne,1152,shaman,elemental,18,12,6
47547,Bovinebeauty,tichondrius,1152,shaman,elemental,18,12,6
47548,Pasto,bleeding-hollow,1152,shaman,elemental,18,12,6
47549,Lilbabyapy,sargeras,1152,shaman,elemental,24,12,12
47550,Councilman,illidan,1152,shaman,elemental,24,12,12
47551,Chenjiawei,tichondrius,1152,shaman,elemental,24,12,12
47552,Krupto,tichondrius,1151,shaman,elemental,24,12,12
47553,Àspec,aegwynn,1151,shaman,elemental,24,12,12
47554,Kang,terenas,1150,shaman,elemental,18,12,6
47555,Poonqtx,frostmourne,1149,shaman,elemental,18,12,6
47556,Skyten,quelthalas,1148,shaman,elemental,27,13,14
47557,Eluulne,silvermoon,1147,shaman,elemental,24,12,12
47558,Kilydily,destromath,1147,shaman,elemental,30,12,18
47559,Motorrad,azralon,1146,shaman,elemental,22,13,9
47560,Shockerfist,thunderlord,1144,shaman,elemental,18,12,6
47561,Enhancers,sargeras,1144,shaman,elemental,24,12,12
47562,Kowabounga,ragnaros,1140,shaman,elemental,24,12,12
47563,Beatryx,the-scryers,1140,shaman,elemental,24,12,12
47564,Yasuriyamile,illidan,1139,shaman,elemental,126,55,71
47565,Thunderblood,nerzhul,1138,shaman,elemental,24,12,12
47566,Muggs,cairne,1137,shaman,elemental,18,12,6
47567,Nuggitz,tichondrius,1136,shaman,elemental,31,20,11
47568,Vodord,arathor,1130,shaman,elemental,24,12,12
47569,Tribalmood,illidan,1130,shaman,elemental,36,14,22
47570,Jashar,spinebreaker,1127,shaman,elemental,24,13,11
47571,Blacklust,tichondrius,1127,shaman,elemental,30,13,17
47572,Shmoo,deathwing,1126,shaman,elemental,27,14,13
47573,Madeleines,goldrinn,1124,shaman,elemental,24,14,10
47574,Firecracker,warsong,1123,shaman,elemental,88,47,41
47575,Johnwilke,area-52,1123,shaman,elemental,43,17,26
47576,Bravederp,kelthuzad,1120,shaman,elemental,63,31,32
47577,Akó,quelthalas,1120,shaman,elemental,36,13,23
47578,Skwiglz,tichondrius,1113,shaman,elemental,90,44,46
47579,Premium,nagrand,1112,shaman,elemental,30,12,18
47580,Karashamy,ragnaros,1107,shaman,elemental,85,40,45
47581,Chanix,ragnaros,1106,shaman,elemental,23,12,11
47582,Afgoox,tichondrius,1105,shaman,elemental,36,24,12
47583,Xoelement,borean-tundra,1103,shaman,elemental,54,25,29
47584,Bulljay,bleeding-hollow,1101,shaman,elemental,27,13,14
47585,Discokid,norgannon,1100,shaman,elemental,30,12,18
47586,Yunow,ragnaros,1096,shaman,elemental,48,20,28
47587,Axelrose,ragnaros,1090,shaman,elemental,36,16,20
47588,Meteorah,kelthuzad,1088,shaman,elemental,63,30,33
47589,Omnath,zuluhed,1083,shaman,elemental,35,19,16
47590,Zappz,thunderlord,1082,shaman,elemental,60,34,26
47591,Shammpain,barthilas,1081,shaman,elemental,59,31,28
47592,Justballs,stormscale,1078,shaman,elemental,48,27,21
47593,Coffee,mugthol,1073,shaman,elemental,48,19,29
47594,Shamarock,stonemaul,1071,shaman,elemental,48,25,23
47595,Shockazulu,vashj,1070,shaman,elemental,47,23,24
47596,Tideborn,azralon,1068,shaman,elemental,28,14,14
47597,Sàuron,tichondrius,1066,shaman,elemental,25,12,13
47598,Bobbymooshay,area-52,1065,shaman,elemental,31,12,19
47599,Afri,tichondrius,1056,shaman,elemental,16,12,4
47600,Szes,tichondrius,1056,shaman,elemental,18,11,7
47601,Redpocket,zuluhed,1056,shaman,elemental,18,11,7
47602,Bestshamus,sargeras,1056,shaman,elemental,18,11,7
47603,Biggiechief,illidan,1056,shaman,elemental,18,11,7
47604,Palcyon,eonar,1056,shaman,elemental,18,11,7
47605,Petrafk,illidan,1056,shaman,elemental,18,11,7
47606,Highsteakss,tichondrius,1055,shaman,elemental,12,11,1
47607,Bootietootie,bleeding-hollow,1055,shaman,elemental,18,11,7
47608,Fanatix,moon-guard,1055,shaman,elemental,18,11,7
47609,Smooths,bloodscalp,1055,shaman,elemental,18,11,7
47610,Shakron,dalaran,1055,shaman,elemental,18,11,7
47611,Ndndurkadurk,malganis,1055,shaman,elemental,18,11,7
47612,Shockalot,emerald-dream,1055,shaman,elemental,24,11,13
47613,Jeffspicele,emerald-dream,1055,shaman,elemental,24,11,13
47614,Thuntard,bleeding-hollow,1055,shaman,elemental,24,11,13
47615,Thathurts,thrall,1054,shaman,elemental,18,11,7
47616,Ayetex,kelthuzad,1054,shaman,elemental,18,11,7
47617,Sumnah,sargeras,1054,shaman,elemental,42,22,20
47618,Lilmollet,tichondrius,1054,shaman,elemental,25,13,12
47619,Traindablue,illidan,1054,shaman,elemental,24,11,13
47620,Blobberino,tichondrius,1054,shaman,elemental,24,11,13
47621,Blastuh,kiljaeden,1053,shaman,elemental,18,11,7
47622,Shocksrus,arthas,1053,shaman,elemental,24,11,13
47623,Madmartiggen,scilla,1051,shaman,elemental,21,12,9
47624,Ôprawindfury,mugthol,1050,shaman,elemental,18,11,7
47625,Taeilendar,ragnaros,1050,shaman,elemental,24,11,13
47626,Drmeangreen,tichondrius,1049,shaman,elemental,43,19,24
47627,Nazz,cenarion-circle,1048,shaman,elemental,18,11,7
47628,Metlar,sargeras,1048,shaman,elemental,24,11,13
47629,Vashidda,stormrage,1048,shaman,elemental,24,11,13
47630,Luxenor,kelthuzad,1046,shaman,elemental,18,11,7
47631,Minzysm,illidan,1045,shaman,elemental,24,11,13
47632,Bonevykin,area-52,1044,shaman,elemental,21,12,9
47633,Enflexi,lightbringer,1044,shaman,elemental,24,11,13
47634,Grandwolf,ragnaros,1040,shaman,elemental,24,11,13
47635,Hodonsin,tichondrius,1039,shaman,elemental,23,11,12
47636,Darkrock,echo-isles,1033,shaman,elemental,24,12,12
47637,Rollypolli,gnomeregan,1022,shaman,elemental,72,36,36
47638,Olani,nesingwary,1022,shaman,elemental,38,12,26
47639,Treesntotemz,darkspear,1020,shaman,elemental,18,11,7
47640,Bigrider,nemesis,1009,shaman,elemental,48,19,29
47641,Geladoo,gallywix,1008,shaman,elemental,68,29,39
47642,Mîkâ,area-52,1007,shaman,elemental,24,11,13
47643,Wälee,sargeras,1004,shaman,elemental,77,37,40
47644,Shambix,illidan,1002,shaman,elemental,19,12,7
47645,Sanlu,tichondrius,991,shaman,elemental,71,34,37
47646,Dizzytotem,dalaran,991,shaman,elemental,24,11,13
47647,Cheweydadawg,shandris,990,shaman,elemental,23,11,12
47648,Shàmpow,darkspear,988,shaman,elemental,23,11,12
47649,Piloncho,ragnaros,983,shaman,elemental,60,24,36
47650,Cîmm,stormrage,972,shaman,elemental,22,11,11
47651,Mistayl,bleeding-hollow,968,shaman,elemental,30,12,18
47652,Asanako,illidan,967,shaman,elemental,88,38,50
47653,Bronan,laughing-skull,961,shaman,elemental,72,29,43
47654,Guybeingdude,sargeras,960,shaman,elemental,12,10,2
47655,Smrtdeath,zuljin,960,shaman,elemental,12,10,2
47656,Graveshocks,illidan,960,shaman,elemental,12,10,2
47657,Folus,azjolnerub,960,shaman,elemental,18,10,8
47658,Hydroponicz,sargeras,960,shaman,elemental,18,10,8
47659,Ðøææøð,stormrage,960,shaman,elemental,18,10,8
47660,Bigdaddyion,thrall,960,shaman,elemental,18,10,8
47661,Lividelemnts,area-52,960,shaman,elemental,18,10,8
47662,Smeagles,ragnaros,960,shaman,elemental,18,10,8
47663,Withinfinity,stormrage,960,shaman,elemental,24,10,14
47664,Aishel,area-52,959,shaman,elemental,18,10,8
47665,Kodyaj,illidan,959,shaman,elemental,18,10,8
47666,Hexoffend,zuljin,959,shaman,elemental,18,10,8
47667,Tidalstorm,thrall,959,shaman,elemental,18,10,8
47668,Ehhmacros,doomhammer,959,shaman,elemental,24,10,14
47669,Aingry,darkspear,958,shaman,elemental,18,10,8
47670,Korlog,tichondrius,957,shaman,elemental,12,10,2
47671,Charabon,ragnaros,957,shaman,elemental,18,10,8
47672,Shockshammy,kiljaeden,956,shaman,elemental,18,10,8
47673,Bigway,area-52,956,shaman,elemental,30,10,20
47674,Chamuko,kelthuzad,955,shaman,elemental,18,10,8
47675,Avni,silver-hand,954,shaman,elemental,18,10,8
47676,Saanrixa,jubeithos,954,shaman,elemental,121,49,72
47677,Tinkd,stormrage,953,shaman,elemental,18,10,8
47678,Izreborn,tichondrius,953,shaman,elemental,24,10,14
47679,Tuksha,alleria,951,shaman,elemental,30,10,20
47680,Karvr,tichondrius,950,shaman,elemental,18,10,8
47681,Brickzilla,dalaran,947,shaman,elemental,18,10,8
47682,Bricx,dalaran,947,shaman,elemental,18,10,8
47683,Elektrå,dalaran,947,shaman,elemental,24,10,14
47684,Shamanic,dunemaul,947,shaman,elemental,89,33,56
47685,Bröly,thunderhorn,946,shaman,elemental,30,10,20
47686,Káládin,malganis,944,shaman,elemental,24,10,14
47687,Duckmasick,tichondrius,941,shaman,elemental,30,10,20
47688,Proignite,drakthul,934,shaman,elemental,35,17,18
47689,Gorron,frostwolf,929,shaman,elemental,24,10,14
47690,Dooman,area-52,927,shaman,elemental,30,10,20
47691,Matria,tanaris,921,shaman,elemental,30,16,14
47692,Lavablaster,kelthuzad,917,shaman,elemental,29,18,11
47693,Sarahfe,wyrmrest-accord,910,shaman,elemental,17,10,7
47694,Aragog,malygos,899,shaman,elemental,32,16,16
47695,Notsock,zuljin,894,shaman,elemental,17,10,7
47696,Threehandz,bleeding-hollow,886,shaman,elemental,55,20,35
47697,Trilz,barthilas,880,shaman,elemental,19,10,9
47698,Helga,hellscream,864,shaman,elemental,12,9,3
47699,Vitaminc,garona,864,shaman,elemental,12,9,3
47700,Jer,tichondrius,864,shaman,elemental,12,9,3
47701,Totey,nemesis,864,shaman,elemental,12,9,3
47702,Notragii,kelthuzad,864,shaman,elemental,12,9,3
47703,Koalatricks,shadow-council,864,shaman,elemental,12,9,3
47704,Bowlcutgodx,sargeras,864,shaman,elemental,12,9,3
47705,Shockbalboa,stormrage,864,shaman,elemental,12,9,3
47706,Drewzie,anvilmar,864,shaman,elemental,18,9,9
47707,Owtyobwol,area-52,864,shaman,elemental,18,9,9
47708,Doorti,area-52,864,shaman,elemental,18,9,9
47709,Exceedër,ragnaros,864,shaman,elemental,18,9,9
47710,Tampíco,ragnaros,864,shaman,elemental,24,9,15
47711,Ratedpvp,thrall,863,shaman,elemental,12,9,3
47712,Ðomzy,tichondrius,863,shaman,elemental,12,9,3
47713,Blöw,tichondrius,863,shaman,elemental,18,9,9
47714,Karagra,tichondrius,863,shaman,elemental,18,9,9
47715,Astrostorm,darkspear,863,shaman,elemental,18,9,9
47716,Hexellént,kiljaeden,863,shaman,elemental,18,9,9
47717,Poseidon,kiljaeden,863,shaman,elemental,18,9,9
47718,Earthfirex,ragnaros,863,shaman,elemental,18,9,9
47719,Lovebody,zuljin,863,shaman,elemental,24,9,15
47720,Stormcop,kelthuzad,863,shaman,elemental,24,9,15
47721,Dtrumpx,tichondrius,863,shaman,elemental,24,9,15
47722,Tecnein,tichondrius,863,shaman,elemental,24,9,15
47723,Thaél,proudmoore,863,shaman,elemental,24,9,15
47724,Dehsaw,illidan,863,shaman,elemental,24,9,15
47725,Elemastery,windrunner,862,shaman,elemental,12,9,3
47726,Tottemic,blackrock,862,shaman,elemental,18,9,9
47727,Zro,ysera,862,shaman,elemental,18,9,9
47728,Cónò,tichondrius,861,shaman,elemental,18,9,9
47729,Phagocytosis,illidan,861,shaman,elemental,18,9,9
47730,Aleysha,dreadmaul,861,shaman,elemental,18,9,9
47731,Jensenx,proudmoore,861,shaman,elemental,24,9,15
47732,Grukall,galakrond,860,shaman,elemental,12,9,3
47733,Galabanjø,malganis,860,shaman,elemental,24,9,15
47734,Nomahuata,cenarion-circle,859,shaman,elemental,24,9,15
47735,Bluetape,azshara,858,shaman,elemental,12,9,3
47736,Velekar,moon-guard,858,shaman,elemental,24,9,15
47737,Xantoor,area-52,857,shaman,elemental,18,9,9
47738,Gorakh,illidan,856,shaman,elemental,18,9,9
47739,Edalandd,zuljin,856,shaman,elemental,24,9,15
47740,Eboy,thrall,847,shaman,elemental,17,9,8
47741,Dellnar,nagrand,847,shaman,elemental,18,9,9
47742,Daiskei,nordrassil,838,shaman,elemental,18,9,9
47743,Mðna,zuluhed,838,shaman,elemental,18,9,9
47744,Vegaslights,tichondrius,816,shaman,elemental,21,9,12
47745,Insanelol,tichondrius,815,shaman,elemental,21,9,12
47746,Mindfields,barthilas,812,shaman,elemental,20,10,10
47747,Zerium,nemesis,810,shaman,elemental,27,10,17
47748,Maxchamo,ragnaros,810,shaman,elemental,31,10,21
47749,Thanwirn,ragnaros,809,shaman,elemental,24,9,15
47750,Relâx,icecrown,779,shaman,elemental,19,9,10
47751,Cduck,zuljin,768,shaman,elemental,12,8,4
47752,Supbrø,zuluhed,768,shaman,elemental,12,8,4
47753,Yurp,illidan,768,shaman,elemental,12,8,4
47754,Synkronaqt,tichondrius,768,shaman,elemental,12,8,4
47755,Bagovs,tichondrius,768,shaman,elemental,12,8,4
47756,Xammaa,illidan,768,shaman,elemental,12,8,4
47757,Artaiva,zuljin,768,shaman,elemental,12,8,4
47758,Squidzy,tichondrius,768,shaman,elemental,12,8,4
47759,Genesisz,tichondrius,768,shaman,elemental,12,8,4
47760,Morabebi,tichondrius,768,shaman,elemental,12,8,4
47761,Groundfaults,bleeding-hollow,768,shaman,elemental,18,8,10
47762,Stayz,tichondrius,768,shaman,elemental,18,8,10
47763,Storminlorka,sargeras,768,shaman,elemental,18,8,10
47764,Thestromp,quelthalas,767,shaman,elemental,12,8,4
47765,Johntrabølta,zuljin,767,shaman,elemental,12,8,4
47766,Blazintotems,arthas,767,shaman,elemental,12,8,4
47767,Uninfluenced,firetree,767,shaman,elemental,12,8,4
47768,Marcøvich,ragnaros,767,shaman,elemental,12,8,4
47769,Tierrox,tichondrius,767,shaman,elemental,12,8,4
47770,Graymatterz,ysondre,767,shaman,elemental,12,8,4
47771,Momothewolf,malganis,767,shaman,elemental,12,8,4
47772,Thandius,arygos,767,shaman,elemental,12,8,4
47773,Barokoshama,area-52,767,shaman,elemental,12,8,4
47774,Flowerchild,proudmoore,767,shaman,elemental,12,8,4
47775,Urb,moknathal,767,shaman,elemental,18,8,10
47776,Mazdamundï,ragnaros,767,shaman,elemental,24,8,16
47777,Fênrisulfer,area-52,766,shaman,elemental,18,8,10
47778,Fearoshimä,drakthul,765,shaman,elemental,18,8,10
47779,Procdepartme,area-52,765,shaman,elemental,18,8,10
47780,Cheddatotz,illidan,764,shaman,elemental,12,8,4
47781,Pãníç,bladefist,764,shaman,elemental,18,8,10
47782,Neebon,jubeithos,763,shaman,elemental,12,8,4
47783,Shachone,zuljin,763,shaman,elemental,18,8,10
47784,Teekona,tichondrius,763,shaman,elemental,18,8,10
47785,Shamofshame,garrosh,763,shaman,elemental,24,8,16
47786,Aeromarius,ragnaros,733,shaman,elemental,13,10,3
47787,Lowiqpleb,tichondrius,719,shaman,elemental,17,8,9
47788,Downerr,malganis,712,shaman,elemental,17,10,7
47789,Pileef,thrall,704,shaman,elemental,10,8,2
47790,Dmt,exodar,704,shaman,elemental,22,8,14
47791,Makogo,earthen-ring,686,shaman,elemental,13,8,5
47792,Thermopile,wildhammer,680,shaman,elemental,25,8,17
47793,Lagroupie,ragnaros,672,shaman,elemental,12,7,5
47794,Hanaruk,ragnaros,672,shaman,elemental,12,7,5
47795,Chazzwozza,area-52,672,shaman,elemental,12,7,5
47796,Cuban,kelthuzad,672,shaman,elemental,12,7,5
47797,Linkzz,malganis,672,shaman,elemental,12,7,5
47798,Toetum,hyjal,672,shaman,elemental,12,7,5
47799,Smellyogre,area-52,672,shaman,elemental,12,7,5
47800,Willy,icecrown,672,shaman,elemental,12,7,5
47801,Drmeatballmd,tichondrius,672,shaman,elemental,12,7,5
47802,Plebshammy,bleeding-hollow,672,shaman,elemental,12,7,5
47803,Thoraq,bleeding-hollow,672,shaman,elemental,12,7,5
47804,Merkal,illidan,672,shaman,elemental,12,7,5
47805,Elemelons,stormrage,672,shaman,elemental,12,7,5
47806,Rahkarg,korgath,672,shaman,elemental,12,7,5
47807,Farku,illidan,672,shaman,elemental,12,7,5
47808,Glizzyjamon,sargeras,672,shaman,elemental,12,7,5
47809,Mesdew,tichondrius,672,shaman,elemental,12,7,5
47810,Tatespeech,barthilas,672,shaman,elemental,12,7,5
47811,Totemzie,illidan,672,shaman,elemental,12,7,5
47812,Varnol,emerald-dream,672,shaman,elemental,12,7,5
47813,Pericazo,sargeras,672,shaman,elemental,12,7,5
47814,Boogielust,frostmourne,672,shaman,elemental,12,7,5
47815,Sèèr,tichondrius,672,shaman,elemental,12,7,5
47816,Ftp,kelthuzad,672,shaman,elemental,15,8,7
47817,Alwaysbulkin,tichondrius,672,shaman,elemental,18,7,11
47818,Xinz,guldan,672,shaman,elemental,18,7,11
47819,Shamigo,tichondrius,672,shaman,elemental,18,7,11
47820,Risker,tichondrius,672,shaman,elemental,18,7,11
47821,Neotrad,proudmoore,672,shaman,elemental,18,7,11
47822,Desdìnova,tortheldrin,672,shaman,elemental,18,7,11
47823,Eravas,thrall,672,shaman,elemental,18,7,11
47824,Dansham,zuljin,672,shaman,elemental,24,7,17
47825,Jacori,malganis,671,shaman,elemental,12,7,5
47826,Stormha,illidan,671,shaman,elemental,12,7,5
47827,Lilthrall,skullcrusher,671,shaman,elemental,12,7,5
47828,Canute,bonechewer,671,shaman,elemental,12,7,5
47829,Oukami,area-52,671,shaman,elemental,12,7,5
47830,Hairyrichard,zuljin,671,shaman,elemental,12,7,5
47831,Lenå,moon-guard,671,shaman,elemental,12,7,5
47832,Trashpandaa,deathwing,671,shaman,elemental,12,7,5
47833,Malito,ursin,671,shaman,elemental,18,7,11
47834,Alariaa,sargeras,670,shaman,elemental,12,7,5
47835,Neukims,nemesis,670,shaman,elemental,20,7,13
47836,Grimlên,skullcrusher,669,shaman,elemental,18,7,11
47837,Idiotstaff,dreadmaul,669,shaman,elemental,24,7,17
47838,Slothycrit,emerald-dream,668,shaman,elemental,30,7,23
47839,Phuamya,dalaran,667,shaman,elemental,12,7,5
47840,Saffoo,frostmourne,667,shaman,elemental,12,7,5
47841,Shamadan,proudmoore,665,shaman,elemental,12,7,5
47842,Warmak,hyjal,664,shaman,elemental,12,7,5
47843,Jyster,area-52,664,shaman,elemental,24,7,17
47844,Cardanø,illidan,652,shaman,elemental,29,7,22
47845,Cheesewheelz,arthas,651,shaman,elemental,22,7,15
47846,Aestheticsx,thrall,640,shaman,elemental,16,7,9
47847,Megalithic,moon-guard,639,shaman,elemental,14,8,6
47848,Koongram,area-52,623,shaman,elemental,11,7,4
47849,Shizzänk,illidan,606,shaman,elemental,11,7,4
47850,Oznog,bleeding-hollow,590,shaman,elemental,19,7,12
47851,Boltadeez,tichondrius,576,shaman,elemental,6,6,0
47852,Dornmawhide,sargeras,576,shaman,elemental,6,6,0
47853,Sxxr,moon-guard,576,shaman,elemental,6,6,0
47854,Adutchcowboy,tichondrius,576,shaman,elemental,6,6,0
47855,Pikapiko,tichondrius,576,shaman,elemental,6,6,0
47856,Kasparøv,tichondrius,576,shaman,elemental,6,6,0
47857,Jinukia,malganis,576,shaman,elemental,12,6,6
47858,Undaunte,sargeras,576,shaman,elemental,12,6,6
47859,Mcgraff,frostmourne,576,shaman,elemental,12,6,6
47860,Getwetand,quelthalas,576,shaman,elemental,12,6,6
47861,Smoketide,illidan,576,shaman,elemental,12,6,6
47862,Deeznuts,the-forgotten-coast,576,shaman,elemental,12,6,6
47863,Darkcharles,illidan,576,shaman,elemental,12,6,6
47864,Cowboy,executus,576,shaman,elemental,12,6,6
47865,Reppinsix,sargeras,576,shaman,elemental,12,6,6
47866,Frosh,nazgrel,576,shaman,elemental,12,6,6
47867,Rubmytotêm,tichondrius,576,shaman,elemental,12,6,6
47868,Shaokhan,azjolnerub,576,shaman,elemental,12,6,6
47869,Jnzz,area-52,576,shaman,elemental,12,6,6
47870,Zunden,illidan,576,shaman,elemental,12,6,6
47871,Riseon,illidan,576,shaman,elemental,12,6,6
47872,Zlateral,malganis,576,shaman,elemental,12,6,6
47873,Bustinbooty,kiljaeden,576,shaman,elemental,12,6,6
47874,Mistysham,illidan,576,shaman,elemental,12,6,6
47875,Littz,malganis,576,shaman,elemental,12,6,6
47876,Spaceghost,illidan,576,shaman,elemental,12,6,6
47877,Doommjölnir,sargeras,576,shaman,elemental,12,6,6
47878,Feuerbart,dalaran,576,shaman,elemental,12,6,6
47879,Dxycollapse,illidan,576,shaman,elemental,12,6,6
47880,Ezevia,stormrage,576,shaman,elemental,12,6,6
47881,Consolx,area-52,576,shaman,elemental,12,6,6
47882,Tairen,ragnaros,576,shaman,elemental,12,6,6
47883,Finark,tichondrius,576,shaman,elemental,12,6,6
47884,Deyodin,illidan,576,shaman,elemental,12,6,6
47885,Orkshammy,illidan,576,shaman,elemental,12,6,6
47886,Fuseillar,illidan,576,shaman,elemental,12,6,6
47887,Torosmile,tichondrius,576,shaman,elemental,18,6,12
47888,Oxdrog,malganis,576,shaman,elemental,18,6,12
47889,Highvoltagex,frostmourne,576,shaman,elemental,18,6,12
47890,Shamamas,area-52,576,shaman,elemental,18,6,12
47891,Bitamin,frostmourne,576,shaman,elemental,18,6,12
47892,Cowtidetotem,thrall,576,shaman,elemental,18,6,12
47893,Wonima,tichondrius,576,shaman,elemental,19,6,13
47894,Hallion,frostmourne,576,shaman,elemental,24,6,18
47895,Asuni,illidan,576,shaman,elemental,24,6,18
47896,Moctezumma,area-52,575,shaman,elemental,12,6,6
47897,Wrathantula,thrall,575,shaman,elemental,12,6,6
47898,Skribblez,tichondrius,575,shaman,elemental,12,6,6
47899,Satup,ragnaros,575,shaman,elemental,12,6,6
47900,Nemei,zuljin,575,shaman,elemental,12,6,6
47901,Drewshammy,zuljin,575,shaman,elemental,12,6,6
47902,Apocalypsehb,quelthalas,575,shaman,elemental,12,6,6
47903,Shøckolate,whisperwind,575,shaman,elemental,12,6,6
47904,Grimitt,suramar,575,shaman,elemental,18,6,12
47905,Ulamøgg,proudmoore,575,shaman,elemental,21,6,15
47906,Dugomik,malganis,574,shaman,elemental,12,6,6
47907,Chanintotem,shattered-halls,574,shaman,elemental,12,6,6
47908,Bcs,lightbringer,573,shaman,elemental,12,6,6
47909,Nezzuk,quelthalas,573,shaman,elemental,12,6,6
47910,Thuggliife,frostmourne,573,shaman,elemental,18,6,12
47911,Totempaul,frostmourne,570,shaman,elemental,18,6,12
47912,Ryudark,stormrage,569,shaman,elemental,24,6,18
47913,Asy,tichondrius,559,shaman,elemental,11,6,5
47914,Frostshear,maiev,557,shaman,elemental,17,6,11
47915,Esbet,echo-isles,555,shaman,elemental,23,6,17
47916,Aitex,kelthuzad,543,shaman,elemental,15,7,8
47917,Thanen,the-scryers,541,shaman,elemental,16,6,10
47918,Aseew,drakkari,522,shaman,elemental,21,9,12
47919,Devipersham,frostmourne,511,shaman,elemental,11,6,5
47920,Love,tichondrius,480,shaman,elemental,6,5,1
47921,Axaxaxaxaxax,illidan,480,shaman,elemental,6,5,1
47922,Sxr,moon-guard,480,shaman,elemental,6,5,1
47923,Immashammyx,area-52,480,shaman,elemental,6,5,1
47924,Riptideafk,sargeras,480,shaman,elemental,6,5,1
47925,Furiousnick,stormrage,480,shaman,elemental,6,5,1
47926,Dîabeetus,moon-guard,480,shaman,elemental,6,5,1
47927,Fenny,proudmoore,480,shaman,elemental,6,5,1
47928,Meatballsx,tichondrius,480,shaman,elemental,6,5,1
47929,Shinydiglett,area-52,480,shaman,elemental,6,5,1
47930,Kultirio,quelthalas,480,shaman,elemental,6,5,1
47931,Azzula,tichondrius,480,shaman,elemental,6,5,1
47932,Shoxz,korgath,480,shaman,elemental,6,5,1
47933,Vulcansh,azralon,480,shaman,elemental,6,5,1
47934,Shamxrob,sargeras,480,shaman,elemental,6,5,1
47935,Josiahsham,kelthuzad,480,shaman,elemental,7,5,2
47936,Firedchips,tichondrius,480,shaman,elemental,17,8,9
47937,Boodissy,tichondrius,480,shaman,elemental,12,5,7
47938,Flamestrife,illidan,480,shaman,elemental,12,5,7
47939,Flukz,nazjatar,480,shaman,elemental,12,5,7
47940,Jènova,whisperwind,480,shaman,elemental,12,5,7
47941,Zeebouzy,illidan,480,shaman,elemental,12,5,7
47942,Wobbleshock,tichondrius,480,shaman,elemental,12,5,7
47943,Trickytotems,stormrage,480,shaman,elemental,12,5,7
47944,Fonsestrelly,emerald-dream,480,shaman,elemental,12,5,7
47945,Slumpinator,tichondrius,480,shaman,elemental,12,5,7
47946,Hexxercise,area-52,480,shaman,elemental,12,5,7
47947,Gjaj,tichondrius,480,shaman,elemental,12,5,7
47948,Shamberheard,kelthuzad,480,shaman,elemental,12,5,7
47949,Grêgg,area-52,480,shaman,elemental,12,5,7
47950,Chomolungma,azralon,480,shaman,elemental,12,5,7
47951,Kissmywalnut,frostmourne,480,shaman,elemental,12,5,7
47952,Thadx,illidan,480,shaman,elemental,12,5,7
47953,Mariarlee,proudmoore,480,shaman,elemental,12,5,7
47954,Drakhe,proudmoore,480,shaman,elemental,12,5,7
47955,Daerönn,azralon,480,shaman,elemental,12,5,7
47956,Jaedrick,chogall,480,shaman,elemental,12,5,7
47957,Zenan,stormreaver,480,shaman,elemental,12,5,7
47958,Sgorr,illidan,480,shaman,elemental,12,5,7
47959,Delement,ragnaros,480,shaman,elemental,12,5,7
47960,Athymus,dragonmaw,480,shaman,elemental,12,5,7
47961,Twistedteas,tichondrius,480,shaman,elemental,12,5,7
47962,Zajashuna,malganis,480,shaman,elemental,12,5,7
47963,Wempa,moon-guard,480,shaman,elemental,12,5,7
47964,Ferdi,kelthuzad,480,shaman,elemental,12,5,7
47965,Junkygreens,proudmoore,480,shaman,elemental,12,5,7
47966,Totemchucker,stormrage,480,shaman,elemental,15,6,9
47967,Flamelink,tichondrius,480,shaman,elemental,20,6,14
47968,Hazznokicks,bleeding-hollow,480,shaman,elemental,21,6,15
47969,Advìl,area-52,480,shaman,elemental,18,5,13
47970,Dwârf,tichondrius,480,shaman,elemental,18,5,13
47971,Firesurge,sargeras,480,shaman,elemental,18,5,13
47972,Arialial,hyjal,480,shaman,elemental,18,5,13
47973,Helapoon,area-52,480,shaman,elemental,18,5,13
47974,Zevelynne,wyrmrest-accord,480,shaman,elemental,24,5,19
47975,Vjeze,frostmourne,480,shaman,elemental,24,5,19
47976,Virô,sargeras,479,shaman,elemental,6,5,1
47977,Shanão,nemesis,479,shaman,elemental,6,5,1
47978,Killdeaderer,barthilas,479,shaman,elemental,6,5,1
47979,Carrbide,malganis,479,shaman,elemental,12,5,7
47980,Ðarkvolts,stormrage,479,shaman,elemental,12,5,7
47981,Sparkyy,kelthuzad,479,shaman,elemental,12,5,7
47982,Olthorson,kelthuzad,479,shaman,elemental,18,5,13
47983,Doughboy,khadgar,478,shaman,elemental,14,6,8
47984,Santee,frostmourne,478,shaman,elemental,12,5,7
47985,Diokles,skywall,478,shaman,elemental,12,5,7
47986,Talraviebor,stormrage,478,shaman,elemental,12,5,7
47987,Tulwah,shadowmoon,447,shaman,elemental,11,6,5
47988,Slogre,tichondrius,447,shaman,elemental,11,5,6
47989,Frequency,kiljaeden,447,shaman,elemental,17,5,12
47990,Adesaa,illidan,426,shaman,elemental,22,6,16
47991,Gunai,malganis,416,shaman,elemental,10,5,5
47992,Kinjin,dragonmaw,415,shaman,elemental,14,5,9
47993,Ripklanian,blood-furnace,400,shaman,elemental,13,5,8
47994,Dgshaman,tichondrius,384,shaman,elemental,6,4,2
47995,Nerfele,tichondrius,384,shaman,elemental,6,4,2
47996,Thunderfuk,exodar,384,shaman,elemental,6,4,2
47997,Ruugo,malganis,384,shaman,elemental,6,4,2
47998,Clamson,tichondrius,384,shaman,elemental,6,4,2
47999,Boøsty,bleeding-hollow,384,shaman,elemental,6,4,2
48000,Coldbeer,frostmourne,384,shaman,elemental,6,4,2
48001,Ryùko,proudmoore,384,shaman,elemental,6,4,2
48002,Weebdestroyr,illidan,384,shaman,elemental,6,4,2
48003,Stormflow,dalaran,384,shaman,elemental,6,4,2
48004,Yeoldkobb,kiljaeden,384,shaman,elemental,6,4,2
48005,Synkrona,tichondrius,384,shaman,elemental,6,4,2
48006,Elebro,emerald-dream,384,shaman,elemental,6,4,2
48007,Ginnagangus,mugthol,384,shaman,elemental,6,4,2
48008,Shammyqua,tichondrius,384,shaman,elemental,6,4,2
48009,Riicc,stormrage,384,shaman,elemental,6,4,2
48010,Jimmyapple,illidan,384,shaman,elemental,6,4,2
48011,Novoz,tichondrius,384,shaman,elemental,6,4,2
48012,Enil,kiljaeden,384,shaman,elemental,6,4,2
48013,Ktom,runetotem,384,shaman,elemental,6,4,2
48014,Dromus,dalvengyr,384,shaman,elemental,6,4,2
48015,Simped,bleeding-hollow,384,shaman,elemental,6,4,2
48016,Dingfu,sargeras,384,shaman,elemental,6,4,2
48017,Oscarmike,auchindoun,384,shaman,elemental,6,4,2
48018,Greensween,thrall,384,shaman,elemental,6,4,2
48019,Wolfgangz,illidan,384,shaman,elemental,6,4,2
48020,Munchies,madoran,384,shaman,elemental,6,4,2
48021,Boogiefever,area-52,384,shaman,elemental,6,4,2
48022,Checkmâte,emerald-dream,384,shaman,elemental,6,4,2
48023,Dragaru,illidan,384,shaman,elemental,6,4,2
48024,Terapatrik,area-52,384,shaman,elemental,6,4,2
48025,Zezlek,malganis,384,shaman,elemental,6,4,2
48026,Knowknown,tichondrius,384,shaman,elemental,6,4,2
48027,Semnicktotem,area-52,384,shaman,elemental,6,4,2
48028,Seraøth,area-52,384,shaman,elemental,6,4,2
48029,Sammila,tichondrius,384,shaman,elemental,6,4,2
48030,Hulan,tichondrius,384,shaman,elemental,6,4,2
48031,Nyroh,zuljin,384,shaman,elemental,6,4,2
48032,Borgmash,chogall,384,shaman,elemental,6,4,2
48033,Ryuubi,illidan,384,shaman,elemental,6,4,2
48034,Kranif,tichondrius,384,shaman,elemental,6,4,2
48035,Wodgodx,sargeras,384,shaman,elemental,6,4,2
48036,Meatballman,malganis,384,shaman,elemental,6,4,2
48037,Lukora,stonemaul,384,shaman,elemental,6,4,2
48038,Trickyjf,dalaran,384,shaman,elemental,6,4,2
48039,Yshi,kelthuzad,384,shaman,elemental,6,4,2
48040,Thorlottie,stormrage,384,shaman,elemental,6,4,2
48041,Mcßooger,tichondrius,384,shaman,elemental,6,4,2
48042,Zappithorus,stormrage,384,shaman,elemental,6,4,2
48043,Drcopafeel,stormrage,384,shaman,elemental,6,4,2
48044,Blueku,tichondrius,384,shaman,elemental,6,4,2
48045,Paltalk,the-forgotten-coast,384,shaman,elemental,6,4,2
48046,Super,azshara,384,shaman,elemental,14,5,9
48047,Nobosham,tichondrius,384,shaman,elemental,12,4,8
48048,Kushnations,chogall,384,shaman,elemental,12,4,8
48049,Natorr,dalaran,384,shaman,elemental,12,4,8
48050,Sin,bleeding-hollow,384,shaman,elemental,12,4,8
48051,Jhivone,tichondrius,384,shaman,elemental,12,4,8
48052,Manitbaggins,earthen-ring,384,shaman,elemental,12,4,8
48053,Duza,frostmourne,384,shaman,elemental,12,4,8
48054,Yukishock,illidan,384,shaman,elemental,12,4,8
48055,Fatherrtime,illidan,384,shaman,elemental,12,4,8
48056,Chainz,illidan,384,shaman,elemental,12,4,8
48057,Ayatsu,thrall,384,shaman,elemental,12,4,8
48058,Lavasurge,area-52,384,shaman,elemental,12,4,8
48059,Rudoboy,ragnaros,384,shaman,elemental,12,4,8
48060,Elryl,sargeras,384,shaman,elemental,12,4,8
48061,Benserkr,lightbringer,384,shaman,elemental,12,4,8
48062,Oohkillemm,silvermoon,384,shaman,elemental,12,4,8
48063,Gomaliquida,quelthalas,384,shaman,elemental,12,4,8
48064,Aiggiggigne,sargeras,384,shaman,elemental,12,4,8
48065,Fouroclock,drakthul,384,shaman,elemental,12,4,8
48066,Shrektar,cenarius,384,shaman,elemental,12,4,8
48067,Naweiv,caelestrasz,384,shaman,elemental,12,4,8
48068,Zizö,barthilas,384,shaman,elemental,12,4,8
48069,Sjostrom,proudmoore,384,shaman,elemental,12,4,8
48070,Rosettee,stormrage,384,shaman,elemental,12,4,8
48071,Anahvee,moon-guard,384,shaman,elemental,12,4,8
48072,Volcanic,azuremyst,384,shaman,elemental,12,4,8
48073,Tdub,frostmourne,384,shaman,elemental,18,4,14
48074,Rickin,hyjal,384,shaman,elemental,18,4,14
48075,Beazel,moon-guard,384,shaman,elemental,18,4,14
48076,Bigstormz,fenris,384,shaman,elemental,18,4,14
48077,Zappyshorty,sargeras,383,shaman,elemental,6,4,2
48078,Hëïmdall,stormrage,383,shaman,elemental,12,4,8
48079,Enroks,greymane,383,shaman,elemental,12,4,8
48080,Machalo,sargeras,383,shaman,elemental,12,4,8
48081,Stórmfuryz,tichondrius,382,shaman,elemental,12,4,8
48082,Roxastir,shattered-halls,382,shaman,elemental,12,4,8
48083,Potatopirate,burning-legion,381,shaman,elemental,18,4,14
48084,Coffeeblacc,magtheridon,379,shaman,elemental,12,4,8
48085,Babyblake,malganis,351,shaman,elemental,8,5,3
48086,Branasou,emerald-dream,351,shaman,elemental,11,4,7
48087,Shk,illidan,351,shaman,elemental,11,4,7
48088,Råys,turalyon,350,shaman,elemental,11,4,7
48089,Stormfronts,kelthuzad,336,shaman,elemental,9,4,5
48090,Trashaman,garona,336,shaman,elemental,9,4,5
48091,Nondracil,ragnaros,336,shaman,elemental,14,4,10
48092,Taraneh,garrosh,325,shaman,elemental,15,5,10
48093,Shamankie,tichondrius,319,shaman,elemental,5,4,1
48094,Orochishaman,stormrage,319,shaman,elemental,5,4,1
48095,Shup,chogall,319,shaman,elemental,5,4,1
48096,Charr,nemesis,304,shaman,elemental,7,4,3
48097,Tsunamibrew,moon-guard,302,shaman,elemental,9,4,5
48098,Iloverina,stormrage,288,shaman,elemental,6,3,3
48099,Awesomeus,barthilas,288,shaman,elemental,6,3,3
48100,Tokelahoma,stormrage,288,shaman,elemental,6,3,3
48101,Fluffyhex,sargeras,288,shaman,elemental,6,3,3
48102,Corneador,ragnaros,288,shaman,elemental,6,3,3
48103,Passion,sargeras,288,shaman,elemental,6,3,3
48104,Oxforcefairy,tichondrius,288,shaman,elemental,6,3,3
48105,Altryn,shuhalo,288,shaman,elemental,6,3,3
48106,Trenhance,stormrage,288,shaman,elemental,6,3,3
48107,Woepost,tichondrius,288,shaman,elemental,6,3,3
48108,Dì,barthilas,288,shaman,elemental,6,3,3
48109,Headshake,malganis,288,shaman,elemental,6,3,3
48110,Aerôv,area-52,288,shaman,elemental,6,3,3
48111,Jaxlightning,nemesis,288,shaman,elemental,6,3,3
48112,Malgrave,ragnaros,288,shaman,elemental,6,3,3
48113,Mønønøke,tichondrius,288,shaman,elemental,6,3,3
48114,Exsh,area-52,288,shaman,elemental,6,3,3
48115,Jurafxdqt,malganis,288,shaman,elemental,6,3,3
48116,Fattizer,sargeras,288,shaman,elemental,6,3,3
48117,Ioki,spirestone,288,shaman,elemental,6,3,3
48118,Dazu,drakkari,288,shaman,elemental,6,3,3
48119,Atokirina,drakkari,288,shaman,elemental,6,3,3
48120,Oingo,destromath,288,shaman,elemental,6,3,3
48121,Spacemilk,stormrage,288,shaman,elemental,6,3,3
48122,Arckos,thrall,288,shaman,elemental,6,3,3
48123,Hedeadx,illidan,288,shaman,elemental,6,3,3
48124,Garalath,bleeding-hollow,288,shaman,elemental,6,3,3
48125,Wabiex,illidan,288,shaman,elemental,6,3,3
48126,Raikages,whisperwind,288,shaman,elemental,6,3,3
48127,Improvize,malganis,288,shaman,elemental,6,3,3
48128,Mabite,frostmourne,288,shaman,elemental,6,3,3
48129,Éarl,sargeras,288,shaman,elemental,6,3,3
48130,Zon,laughing-skull,288,shaman,elemental,6,3,3
48131,Frenchy,hyjal,288,shaman,elemental,6,3,3
48132,Scarshamxn,frostmourne,288,shaman,elemental,6,3,3
48133,Autisty,sargeras,288,shaman,elemental,6,3,3
48134,Moosk,zuluhed,288,shaman,elemental,6,3,3
48135,Nybrax,moknathal,288,shaman,elemental,6,3,3
48136,Groink,kiljaeden,288,shaman,elemental,6,3,3
48137,Blaydin,elune,288,shaman,elemental,6,3,3
48138,Zemleroynoyy,magtheridon,288,shaman,elemental,6,3,3
48139,Largerwang,sargeras,288,shaman,elemental,6,3,3
48140,Vozi,magtheridon,288,shaman,elemental,6,3,3
48141,Hamrok,moon-guard,288,shaman,elemental,6,3,3
48142,Floon,barthilas,288,shaman,elemental,6,3,3
48143,Applicable,tichondrius,288,shaman,elemental,6,3,3
48144,Cvoa,bonechewer,288,shaman,elemental,6,3,3
48145,Raiden,gorgonnash,288,shaman,elemental,6,3,3
48146,Shizamm,hyjal,288,shaman,elemental,6,3,3
48147,Shàman,durotan,288,shaman,elemental,6,3,3
48148,Bigdumb,blackrock,288,shaman,elemental,6,3,3
48149,Shamtactic,thrall,288,shaman,elemental,6,3,3
48150,Vanëssão,stormrage,288,shaman,elemental,6,3,3
48151,Axshaman,darkspear,288,shaman,elemental,6,3,3
48152,Shamyuna,dalaran,288,shaman,elemental,6,3,3
48153,Gödöfbüdå,tichondrius,288,shaman,elemental,6,3,3
48154,Ragor,quelthalas,288,shaman,elemental,6,3,3
48155,Thelphor,nemesis,288,shaman,elemental,6,3,3
48156,Earthfurÿ,quelthalas,288,shaman,elemental,6,3,3
48157,Kurzee,kelthuzad,288,shaman,elemental,6,3,3
48158,Niarkx,frostmourne,288,shaman,elemental,6,3,3
48159,Healingtime,nerzhul,288,shaman,elemental,6,3,3
48160,Dialtone,blackrock,288,shaman,elemental,6,3,3
48161,Tethai,moon-guard,288,shaman,elemental,6,3,3
48162,Blakki,barthilas,288,shaman,elemental,6,3,3
48163,Josephor,lightnings-blade,288,shaman,elemental,6,3,3
48164,Grwarf,korgath,288,shaman,elemental,6,3,3
48165,Häzel,nerzhul,288,shaman,elemental,6,3,3
48166,Daiablo,barthilas,288,shaman,elemental,6,3,3
48167,Arakimara,tichondrius,288,shaman,elemental,6,3,3
48168,Elereeper,area-52,288,shaman,elemental,6,3,3
48169,Talfur,area-52,288,shaman,elemental,6,3,3
48170,Fobb,area-52,288,shaman,elemental,6,3,3
48171,Shajay,area-52,288,shaman,elemental,6,3,3
48172,Bens,malganis,288,shaman,elemental,6,3,3
48173,Barlonso,illidan,288,shaman,elemental,6,3,3
48174,Xhamankng,quelthalas,288,shaman,elemental,6,3,3
48175,Shadeele,cenarius,288,shaman,elemental,6,3,3
48176,Doop,kiljaeden,288,shaman,elemental,6,3,3
48177,Bizle,jaedenar,288,shaman,elemental,6,3,3
48178,Rampàge,ragnaros,288,shaman,elemental,6,3,3
48179,Bolteon,malganis,288,shaman,elemental,6,3,3
48180,Neesta,ragnaros,288,shaman,elemental,6,3,3
48181,Jamsham,tichondrius,288,shaman,elemental,6,3,3
48182,Curtrex,amanthul,288,shaman,elemental,6,3,3
48183,Vibration,akama,288,shaman,elemental,6,3,3
48184,Grimnur,bleeding-hollow,288,shaman,elemental,11,3,8
48185,Honix,area-52,288,shaman,elemental,12,3,9
48186,Healsquish,area-52,288,shaman,elemental,12,3,9
48187,Sumyl,ragnaros,288,shaman,elemental,12,3,9
48188,Coercè,tichondrius,288,shaman,elemental,12,3,9
48189,Juicemcroose,zuljin,288,shaman,elemental,12,3,9
48190,Tawahka,hyjal,288,shaman,elemental,12,3,9
48191,Bloodytotemz,emerald-dream,288,shaman,elemental,12,3,9
48192,Stormklepter,fizzcrank,288,shaman,elemental,12,3,9
48193,Taquitho,quelthalas,288,shaman,elemental,12,3,9
48194,Bitflip,jubeithos,288,shaman,elemental,12,3,9
48195,Lumpyshaman,tichondrius,288,shaman,elemental,12,3,9
48196,Døcholliday,zuluhed,288,shaman,elemental,12,3,9
48197,Onicharm,frostmourne,288,shaman,elemental,12,3,9
48198,Emptee,area-52,288,shaman,elemental,12,3,9
48199,Frakk,silvermoon,288,shaman,elemental,12,3,9
48200,Birdizdawerd,shuhalo,288,shaman,elemental,12,3,9
48201,Winiethepoöh,stormrage,288,shaman,elemental,12,3,9
48202,Selexi,skywall,288,shaman,elemental,12,3,9
48203,Zarîks,kelthuzad,288,shaman,elemental,12,3,9
48204,Olex,zuluhed,288,shaman,elemental,12,3,9
48205,Rìddles,malygos,288,shaman,elemental,18,3,15
48206,Stîînck,azralon,288,shaman,elemental,18,3,15
48207,Strikzjr,frostmourne,287,shaman,elemental,6,3,3
48208,Arakye,stormrage,287,shaman,elemental,6,3,3
48209,Juanisan,stormrage,287,shaman,elemental,6,3,3
48210,Balrog,vashj,287,shaman,elemental,12,3,9
48211,Slåpntickle,darkspear,287,shaman,elemental,12,3,9
48212,Trabolta,hyjal,287,shaman,elemental,12,3,9
48213,Brokahantas,misha,287,shaman,elemental,14,3,11
48214,Awakarn,emerald-dream,287,shaman,elemental,24,4,20
48215,Cropdustr,sargeras,286,shaman,elemental,6,3,3
48216,Hannibol,tichondrius,255,shaman,elemental,11,3,8
48217,Hexytimexoqt,thrall,255,shaman,elemental,11,3,8
48218,Oxxnabatko,amanthul,240,shaman,elemental,9,3,6
48219,Liamus,amanthul,239,shaman,elemental,5,3,2
48220,Ppepe,boulderfist,239,shaman,elemental,5,3,2
48221,Spunjie,frostmourne,239,shaman,elemental,5,3,2
48222,Nikeshocks,detheroc,239,shaman,elemental,5,3,2
48223,Zeldrys,emerald-dream,192,shaman,elemental,6,2,4
48224,Kanbar,emerald-dream,192,shaman,elemental,6,2,4
48225,Chadious,illidan,192,shaman,elemental,6,2,4
48226,Shockt,wyrmrest-accord,192,shaman,elemental,6,2,4
48227,Blaiserpub,tichondrius,192,shaman,elemental,6,2,4
48228,Grandpatits,illidan,192,shaman,elemental,6,2,4
48229,Killtotem,illidan,192,shaman,elemental,6,2,4
48230,Krilick,blackrock,192,shaman,elemental,6,2,4
48231,Jbahr,hyjal,192,shaman,elemental,6,2,4
48232,Yagers,illidan,192,shaman,elemental,6,2,4
48233,Yssyyds,illidan,192,shaman,elemental,6,2,4
48234,Vööbrew,illidan,192,shaman,elemental,6,2,4
48235,Elîas,tichondrius,192,shaman,elemental,6,2,4
48236,Naextramus,ragnaros,192,shaman,elemental,6,2,4
48237,Shablam,daggerspine,192,shaman,elemental,6,2,4
48238,Oriyani,sargeras,192,shaman,elemental,6,2,4
48239,Oppaswag,tichondrius,192,shaman,elemental,6,2,4
48240,Redbulls,azralon,192,shaman,elemental,6,2,4
48241,Dantheman,twisting-nether,192,shaman,elemental,6,2,4
48242,Yangsangchu,tichondrius,192,shaman,elemental,6,2,4
48243,Ric,malganis,192,shaman,elemental,6,2,4
48244,Piffzorz,tichondrius,192,shaman,elemental,6,2,4
48245,Saltywap,proudmoore,192,shaman,elemental,6,2,4
48246,Drünk,hyjal,192,shaman,elemental,6,2,4
48247,Flappygooch,illidan,192,shaman,elemental,6,2,4
48248,Lenxd,dalaran,192,shaman,elemental,6,2,4
48249,Thormzz,tichondrius,192,shaman,elemental,6,2,4
48250,Stickshaman,sargeras,192,shaman,elemental,6,2,4
48251,Ladash,ragnaros,192,shaman,elemental,6,2,4
48252,Zugharder,illidan,192,shaman,elemental,6,2,4
48253,Zaxibow,area-52,192,shaman,elemental,6,2,4
48254,Hehew,kelthuzad,192,shaman,elemental,6,2,4
48255,Ahwahsahdood,stormreaver,192,shaman,elemental,6,2,4
48256,Feels,arthas,192,shaman,elemental,6,2,4
48257,Doomberrie,thrall,192,shaman,elemental,6,2,4
48258,Gorillox,chogall,192,shaman,elemental,6,2,4
48259,Noether,sargeras,192,shaman,elemental,6,2,4
48260,Hruggol,bleeding-hollow,192,shaman,elemental,6,2,4
48261,Yellowfev,thrall,192,shaman,elemental,6,2,4
48262,Nevershockx,kirin-tor,192,shaman,elemental,6,2,4
48263,Eekumbokum,bleeding-hollow,192,shaman,elemental,6,2,4
48264,Sharmut,bleeding-hollow,192,shaman,elemental,6,2,4
48265,Shamantimes,ragnaros,192,shaman,elemental,6,2,4
48266,Alleys,tichondrius,192,shaman,elemental,6,2,4
48267,Rokhnar,zuljin,192,shaman,elemental,6,2,4
48268,Blastj,tichondrius,192,shaman,elemental,6,2,4
48269,Fromundcheez,kelthuzad,192,shaman,elemental,6,2,4
48270,Tartar,lightbringer,192,shaman,elemental,6,2,4
48271,Gulmuwu,zuljin,192,shaman,elemental,6,2,4
48272,Bigbadbolt,malganis,192,shaman,elemental,6,2,4
48273,Funeropolis,stormrage,192,shaman,elemental,6,2,4
48274,Goblarnit,gorefiend,192,shaman,elemental,6,2,4
48275,Stormysteve,hyjal,192,shaman,elemental,6,2,4
48276,Artnatu,nemesis,192,shaman,elemental,6,2,4
48277,Niian,skullcrusher,192,shaman,elemental,6,2,4
48278,Snoocher,kelthuzad,192,shaman,elemental,6,2,4
48279,Rinjio,zuljin,192,shaman,elemental,6,2,4
48280,Shåmwowz,sargeras,192,shaman,elemental,6,2,4
48281,Britisy,stormrage,192,shaman,elemental,6,2,4
48282,Praisegodx,stormrage,192,shaman,elemental,6,2,4
48283,Quakestorm,stormrage,192,shaman,elemental,6,2,4
48284,Heniu,tichondrius,192,shaman,elemental,6,2,4
48285,Ínfected,azralon,192,shaman,elemental,6,2,4
48286,Shamsky,tichondrius,192,shaman,elemental,6,2,4
48287,Matzahmeal,skywall,192,shaman,elemental,6,2,4
48288,Tacotastic,malganis,192,shaman,elemental,6,2,4
48289,Wrestleman,drakthul,192,shaman,elemental,6,2,4
48290,Whitecake,frostmourne,192,shaman,elemental,6,2,4
48291,Kayzee,malganis,192,shaman,elemental,6,2,4
48292,Dirtyprocs,tichondrius,192,shaman,elemental,6,2,4
48293,Puntress,barthilas,192,shaman,elemental,6,2,4
48294,Plasticity,spirestone,192,shaman,elemental,6,2,4
48295,Sid,frostmourne,192,shaman,elemental,6,2,4
48296,Trizzeh,moon-guard,192,shaman,elemental,6,2,4
48297,Shockbot,stormscale,192,shaman,elemental,6,2,4
48298,Grandmaster,frostmourne,192,shaman,elemental,6,2,4
48299,Zuroster,kiljaeden,192,shaman,elemental,7,2,5
48300,Martisor,barthilas,192,shaman,elemental,16,3,13
48301,Electrïck,tichondrius,192,shaman,elemental,12,2,10
48302,Gaboola,tichondrius,192,shaman,elemental,12,2,10
48303,Jedley,azshara,192,shaman,elemental,12,2,10
48304,Fulingyu,moon-guard,192,shaman,elemental,12,2,10
48305,Golemagg,frostmourne,192,shaman,elemental,12,2,10
48306,Harrìson,tichondrius,192,shaman,elemental,12,2,10
48307,Jazzblast,tichondrius,192,shaman,elemental,12,2,10
48308,Fluffy,smolderthorn,192,shaman,elemental,12,2,10
48309,Mega,azralon,192,shaman,elemental,12,2,10
48310,Azl,guldan,192,shaman,elemental,13,2,11
48311,Telryndas,hyjal,192,shaman,elemental,18,2,16
48312,Cyrah,azjolnerub,192,shaman,elemental,18,2,16
48313,Eleveil,emerald-dream,191,shaman,elemental,9,2,7
48314,Hakaskry,caelestrasz,191,shaman,elemental,12,2,10
48315,Statikrage,eonar,180,shaman,elemental,20,5,15
48316,Ramonsanchez,ragnaros,160,shaman,elemental,16,2,14
48317,Mentàl,baelgun,159,shaman,elemental,5,2,3
48318,Hazzardttvz,illidan,159,shaman,elemental,5,2,3
48319,Kidkovid,illidan,159,shaman,elemental,17,2,15
48320,Noslol,bronzebeard,138,shaman,elemental,9,3,6
48321,Uracemytotem,kiljaeden,138,shaman,elemental,10,3,7
48322,Mynigabob,zuljin,128,shaman,elemental,4,2,2
48323,Rahloo,sargeras,127,shaman,elemental,8,2,6
48324,Kobecoopper,sargeras,96,shaman,elemental,6,1,5
48325,Teathin,ragnaros,96,shaman,elemental,6,1,5
48326,Mugiwára,ragnaros,96,shaman,elemental,6,1,5
48327,Orruddon,thaurissan,96,shaman,elemental,6,1,5
48328,Hexondabeach,barthilas,96,shaman,elemental,6,1,5
48329,Staticshok,moon-guard,96,shaman,elemental,6,1,5
48330,Ravaburst,sargeras,96,shaman,elemental,6,1,5
48331,Parallels,blackrock,96,shaman,elemental,6,1,5
48332,Khoden,emerald-dream,96,shaman,elemental,6,1,5
48333,Mdawwg,kelthuzad,96,shaman,elemental,6,1,5
48334,Nerfmytotemz,frostmourne,96,shaman,elemental,6,1,5
48335,Succies,emerald-dream,96,shaman,elemental,6,1,5
48336,Bouje,frostmourne,96,shaman,elemental,6,1,5
48337,Gan,silvermoon,96,shaman,elemental,6,1,5
48338,Thunderbudx,stonemaul,96,shaman,elemental,6,1,5
48339,Ludacrìtz,stormrage,96,shaman,elemental,6,1,5
48340,Drmn,frostmourne,96,shaman,elemental,6,1,5
48341,Snowzy,icecrown,96,shaman,elemental,6,1,5
48342,Tipedc,sargeras,96,shaman,elemental,6,1,5
48343,Macdiesel,tichondrius,96,shaman,elemental,6,1,5
48344,Oakshield,darkspear,96,shaman,elemental,6,1,5
48345,Zral,emerald-dream,96,shaman,elemental,6,1,5
48346,Girafasuarx,korgath,96,shaman,elemental,6,1,5
48347,Bullcowsby,darkspear,96,shaman,elemental,6,1,5
48348,Macdab,malganis,96,shaman,elemental,6,1,5
48349,Zorgen,anvilmar,96,shaman,elemental,6,1,5
48350,Detair,malganis,96,shaman,elemental,6,1,5
48351,Ognerkish,black-dragonflight,96,shaman,elemental,6,1,5
48352,Ggsggs,akama,96,shaman,elemental,6,1,5
48353,Toxidizetkö,azralon,96,shaman,elemental,6,1,5
48354,Cathxy,kelthuzad,96,shaman,elemental,6,1,5
48355,Obiwonsamdi,illidan,96,shaman,elemental,6,1,5
48356,Seanie,bleeding-hollow,96,shaman,elemental,6,1,5
48357,Youngmulakek,area-52,96,shaman,elemental,6,1,5
48358,Nazgore,jubeithos,96,shaman,elemental,6,1,5
48359,Aegaeonlol,tichondrius,96,shaman,elemental,6,1,5
48360,Tatius,stormreaver,96,shaman,elemental,6,1,5
48361,Muruaic,dentarg,96,shaman,elemental,6,1,5
48362,Buckshott,chogall,96,shaman,elemental,6,1,5
48363,Mcshockturds,tichondrius,96,shaman,elemental,6,1,5
48364,Oldshammy,eldrethalas,96,shaman,elemental,6,1,5
48365,Crigga,dalaran,96,shaman,elemental,6,1,5
48366,Firevag,hakkar,96,shaman,elemental,6,1,5
48367,Sinsar,illidan,96,shaman,elemental,6,1,5
48368,Staticshock,darkspear,96,shaman,elemental,12,1,11
48369,Eleshamanz,tichondrius,79,shaman,elemental,5,1,4
48370,Necrolords,tichondrius,79,shaman,elemental,5,1,4
48371,Docadams,chogall,79,shaman,elemental,5,1,4
48372,Camltotem,tichondrius,79,shaman,elemental,5,1,4
48373,Mcstop,tanaris,64,shaman,elemental,4,1,3
48374,Gurdle,frostwolf,48,shaman,elemental,3,1,2
48375,Hbjj,illidan,48,shaman,elemental,3,1,2
48376,Hentaistorm,kiljaeden,48,shaman,elemental,3,1,2
48377,Keyarga,ravencrest,42,shaman,elemental,11,2,9
48378,Dermbo,frostmourne,31,shaman,elemental,2,1,1
48379,Hothouse,malganis,31,shaman,elemental,2,1,1
48380,Elementium,azshara,16,shaman,elemental,1,1,0
48381,Djskinflute,bleeding-hollow,16,shaman,elemental,1,1,0
48382,Deldoduro,azralon,16,shaman,elemental,1,1,0
48383,Jumoma,thrall,16,shaman,elemental,1,1,0
48384,Hizúrú,tichondrius,2282,shaman,enhancement,132,74,58
48385,Vanhalestorm,frostmourne,2264,shaman,enhancement,106,58,48
48386,Mítsurí,tichondrius,2244,shaman,enhancement,210,109,101
48387,Rauthgar,dalaran,2221,shaman,enhancement,114,66,48
48388,Saul,tichondrius,2218,shaman,enhancement,66,42,24
48389,Zarktwo,azralon,2205,shaman,enhancement,153,83,70
48390,Aýanokoji,tichondrius,2201,shaman,enhancement,137,74,63
48391,Alleys,tichondrius,2185,shaman,enhancement,231,118,113
48392,Musclebrains,tichondrius,2176,shaman,enhancement,84,48,36
48393,Axegerd,quelthalas,2147,shaman,enhancement,242,132,110
48394,Bøulderfist,tichondrius,2142,shaman,enhancement,120,76,44
48395,Opoy,sargeras,2142,shaman,enhancement,201,112,89
48396,Musclebrain,tichondrius,2140,shaman,enhancement,174,89,85
48397,Stew,illidan,2138,shaman,enhancement,125,67,58
48398,Crowns,tichondrius,2136,shaman,enhancement,114,59,55
48399,Nopnopajnin,tichondrius,2135,shaman,enhancement,112,57,55
48400,Skydre,area-52,2131,shaman,enhancement,89,54,35
48401,Jimmyjobs,tichondrius,2129,shaman,enhancement,114,70,44
48402,Futeuncle,tichondrius,2123,shaman,enhancement,78,41,37
48403,Swolé,emerald-dream,2122,shaman,enhancement,424,214,210
48404,Stormnala,zuljin,2116,shaman,enhancement,162,92,70
48405,Ftyue,area-52,2116,shaman,enhancement,112,59,53
48406,Rawdòggin,emerald-dream,2113,shaman,enhancement,71,45,26
48407,Proctopus,moon-guard,2112,shaman,enhancement,172,98,74
48408,Musclebrainz,tichondrius,2112,shaman,enhancement,84,41,43
48409,Shapaman,tichondrius,2110,shaman,enhancement,77,53,24
48410,Bjorengahr,emerald-dream,2110,shaman,enhancement,83,53,30
48411,Smxxn,tichondrius,2110,shaman,enhancement,107,52,55
48412,Doomwìnds,stormrage,2108,shaman,enhancement,168,93,75
48413,Shamsz,frostmourne,2106,shaman,enhancement,72,48,24
48414,Wetdraenei,moon-guard,2102,shaman,enhancement,271,152,119
48415,Baseballcap,sargeras,2070,shaman,enhancement,96,58,38
48416,Lashandtrash,tichondrius,2064,shaman,enhancement,54,35,19
48417,Peynful,shadowsong,2063,shaman,enhancement,87,54,33
48418,Shakeys,tichondrius,2060,shaman,enhancement,77,49,28
48419,Realypump,area-52,2046,shaman,enhancement,215,111,104
48420,Zarasvati,tichondrius,2029,shaman,enhancement,167,88,79
48421,Xiaoxiboy,tichondrius,2026,shaman,enhancement,60,38,22
48422,Tastydonut,blackrock,2026,shaman,enhancement,116,70,46
48423,Jazzlightnin,tichondrius,2018,shaman,enhancement,58,36,22
48424,Lustingchery,area-52,2017,shaman,enhancement,123,63,60
48425,Algresh,muradin,2015,shaman,enhancement,66,33,33
48426,Rozboiclique,frostmourne,2012,shaman,enhancement,150,101,49
48427,Windshearbøt,tichondrius,2006,shaman,enhancement,77,47,30
48428,Shamguards,tichondrius,2004,shaman,enhancement,42,31,11
48429,Stronghit,tichondrius,2004,shaman,enhancement,60,32,28
48430,Enhancex,frostwolf,2001,shaman,enhancement,68,36,32
48431,Oosheratchet,illidan,1992,shaman,enhancement,64,44,20
48432,Thiccsha,moon-guard,1985,shaman,enhancement,78,42,36
48433,Beañ,barthilas,1983,shaman,enhancement,352,182,170
48434,Shylabuffkin,area-52,1981,shaman,enhancement,295,159,136
48435,Crownsx,tichondrius,1980,shaman,enhancement,91,41,50
48436,Dopeysimida,illidan,1976,shaman,enhancement,92,57,35
48437,Pizzashaman,illidan,1970,shaman,enhancement,109,64,45
48438,Windfury,chogall,1968,shaman,enhancement,96,51,45
48439,Futeboy,tichondrius,1967,shaman,enhancement,63,32,31
48440,Gatorwaves,bleeding-hollow,1965,shaman,enhancement,54,32,22
48441,Shk,illidan,1964,shaman,enhancement,66,38,28
48442,Zootywild,tichondrius,1963,shaman,enhancement,123,69,54
48443,Grum,zuljin,1961,shaman,enhancement,48,27,21
48444,Spippippin,illidan,1958,shaman,enhancement,92,47,45
48445,Swrdfsh,tichondrius,1955,shaman,enhancement,276,143,133
48446,Typhe,bleeding-hollow,1954,shaman,enhancement,42,27,15
48447,Imchuckbass,tichondrius,1954,shaman,enhancement,122,64,58
48448,Rukagar,barthilas,1951,shaman,enhancement,90,53,37
48449,Dalianyen,bladefist,1951,shaman,enhancement,104,54,50
48450,Balgron,emerald-dream,1949,shaman,enhancement,52,26,26
48451,Tokyofresh,malganis,1947,shaman,enhancement,222,128,94
48452,Ohmálley,tichondrius,1944,shaman,enhancement,62,40,22
48453,Temar,sargeras,1937,shaman,enhancement,89,59,30
48454,Ogeezkush,zuljin,1935,shaman,enhancement,160,93,67
48455,Shakeysham,tichondrius,1934,shaman,enhancement,48,29,19
48456,Kaediea,moon-guard,1932,shaman,enhancement,36,27,9
48457,Artenior,stormrage,1930,shaman,enhancement,135,70,65
48458,Revtide,thrall,1927,shaman,enhancement,72,40,32
48459,Xiaoxiaoxi,tichondrius,1924,shaman,enhancement,60,34,26
48460,Grommi,proudmoore,1924,shaman,enhancement,405,201,204
48461,Fwwrs,illidan,1919,shaman,enhancement,79,51,28
48462,Hallofcost,illidan,1918,shaman,enhancement,150,89,61
48463,Bestshamus,sargeras,1913,shaman,enhancement,83,49,34
48464,Ballinhance,illidan,1908,shaman,enhancement,54,31,23
48465,Earlainn,stormrage,1905,shaman,enhancement,84,48,36
48466,Scaman,tichondrius,1904,shaman,enhancement,24,20,4
48467,Chillpoppin,emerald-dream,1904,shaman,enhancement,42,31,11
48468,Cowaii,illidan,1904,shaman,enhancement,60,37,23
48469,Greenydapooh,nerzhul,1903,shaman,enhancement,60,40,20
48470,Meataballa,the-underbog,1902,shaman,enhancement,72,45,27
48471,Interruptbøt,tichondrius,1901,shaman,enhancement,44,28,16
48472,Sasageyo,tichondrius,1900,shaman,enhancement,37,24,13
48473,Keyturn,tichondrius,1899,shaman,enhancement,78,36,42
48474,Bluntboy,zuljin,1895,shaman,enhancement,62,43,19
48475,Eletastic,tichondrius,1894,shaman,enhancement,72,42,30
48476,Olxsixsm,illidan,1884,shaman,enhancement,74,48,26
48477,Gìmli,tichondrius,1882,shaman,enhancement,65,37,28
48478,Electricity,tichondrius,1880,shaman,enhancement,127,63,64
48479,Daysub,crushridge,1877,shaman,enhancement,60,34,26
48480,Plsnerfret,stormrage,1876,shaman,enhancement,48,33,15
48481,Stormrageman,tichondrius,1875,shaman,enhancement,81,49,32
48482,Harrypotqueu,zuljin,1875,shaman,enhancement,72,40,32
48483,Youngmulakek,area-52,1870,shaman,enhancement,125,83,42
48484,Vonvulviln,emerald-dream,1868,shaman,enhancement,76,41,35
48485,Dano,tichondrius,1867,shaman,enhancement,124,64,60
48486,Napski,cenarius,1866,shaman,enhancement,90,44,46
48487,Jayhastotems,area-52,1864,shaman,enhancement,102,71,31
48488,Zarrka,tichondrius,1864,shaman,enhancement,36,20,16
48489,Superchief,altar-of-storms,1864,shaman,enhancement,104,56,48
48490,Taowth,tichondrius,1862,shaman,enhancement,35,20,15
48491,Ëxceeder,ragnaros,1861,shaman,enhancement,138,78,60
48492,Lavamon,illidan,1860,shaman,enhancement,84,49,35
48493,Blumengarten,stormrage,1858,shaman,enhancement,114,73,41
48494,Wonima,tichondrius,1858,shaman,enhancement,35,20,15
48495,Doomberrie,thrall,1858,shaman,enhancement,138,77,61
48496,Kiddfurious,kelthuzad,1858,shaman,enhancement,132,67,65
48497,Zizö,barthilas,1857,shaman,enhancement,78,54,24
48498,Shamikazi,crushridge,1857,shaman,enhancement,194,115,79
48499,Taikø,area-52,1856,shaman,enhancement,42,25,17
48500,Loabud,tichondrius,1855,shaman,enhancement,58,37,21
48501,Lavitris,illidan,1854,shaman,enhancement,42,29,13
48502,Mcshockturds,tichondrius,1849,shaman,enhancement,143,82,61
48503,Gïrthquake,tichondrius,1849,shaman,enhancement,84,45,39
48504,Antek,quelthalas,1847,shaman,enhancement,165,97,68
48505,Undertów,area-52,1847,shaman,enhancement,48,26,22
48506,Zeûs,lightbringer,1846,shaman,enhancement,72,41,31
48507,Xakaeri,hyjal,1844,shaman,enhancement,60,36,24
48508,Koalakisses,shadow-council,1842,shaman,enhancement,54,32,22
48509,Wautyriex,area-52,1842,shaman,enhancement,54,28,26
48510,Ishano,area-52,1839,shaman,enhancement,48,23,25
48511,Bodai,magtheridon,1838,shaman,enhancement,54,36,18
48512,Bikboisteez,barthilas,1838,shaman,enhancement,98,51,47
48513,Dcg,hyjal,1838,shaman,enhancement,65,33,32
48514,Vulcänyr,quelthalas,1837,shaman,enhancement,60,34,26
48515,Berxek,tichondrius,1835,shaman,enhancement,48,27,21
48516,Thuntard,bleeding-hollow,1835,shaman,enhancement,66,33,33
48517,Kltz,sargeras,1832,shaman,enhancement,53,30,23
48518,Blueraccoon,tichondrius,1830,shaman,enhancement,63,38,25
48519,Turbowolf,sargeras,1829,shaman,enhancement,104,47,57
48520,Yucasinmojo,illidan,1827,shaman,enhancement,55,35,20
48521,Eityhdz,tichondrius,1827,shaman,enhancement,425,216,209
48522,Nomoreswap,zuljin,1825,shaman,enhancement,54,38,16
48523,Shamanabuser,illidan,1825,shaman,enhancement,60,27,33
48524,Flabby,lightbringer,1823,shaman,enhancement,54,26,28
48525,Jokerxksx,tichondrius,1822,shaman,enhancement,72,43,29
48526,Midwestern,emerald-dream,1822,shaman,enhancement,44,26,18
48527,Metako,sargeras,1822,shaman,enhancement,83,47,36
48528,Hooftoface,moon-guard,1822,shaman,enhancement,78,43,35
48529,Pinechanga,ragnaros,1822,shaman,enhancement,78,42,36
48530,Struck,emerald-dream,1821,shaman,enhancement,226,136,90
48531,Gladdorta,azralon,1821,shaman,enhancement,54,30,24
48532,Judgesfotm,bleeding-hollow,1821,shaman,enhancement,75,40,35
48533,Turdfergesen,destromath,1821,shaman,enhancement,88,46,42
48534,Btruez,tichondrius,1819,shaman,enhancement,63,35,28
48535,Thunderlaw,area-52,1819,shaman,enhancement,82,44,38
48536,Whírlwínd,area-52,1818,shaman,enhancement,30,19,11
48537,Hooluu,frostmourne,1818,shaman,enhancement,54,30,24
48538,Addroi,tichondrius,1818,shaman,enhancement,60,28,32
48539,Thromjin,ragnaros,1817,shaman,enhancement,83,51,32
48540,Léxar,sargeras,1817,shaman,enhancement,72,33,39
48541,Movemaker,shattered-hand,1815,shaman,enhancement,30,21,9
48542,Cunkinator,stormrage,1815,shaman,enhancement,115,74,41
48543,Riptiedx,barthilas,1815,shaman,enhancement,48,29,19
48544,Sarthuul,emerald-dream,1814,shaman,enhancement,48,30,18
48545,Thrallas,frostmourne,1814,shaman,enhancement,54,33,21
48546,Boombigshaq,ysera,1813,shaman,enhancement,38,25,13
48547,Louiev,bleeding-hollow,1812,shaman,enhancement,48,28,20
48548,Faultline,khadgar,1811,shaman,enhancement,73,47,26
48549,Legendslayar,area-52,1811,shaman,enhancement,42,27,15
48550,Drakhe,proudmoore,1811,shaman,enhancement,232,128,104
48551,Nygiants,tichondrius,1810,shaman,enhancement,24,19,5
48552,Xibalba,khaz-modan,1810,shaman,enhancement,96,57,39
48553,Sassyx,steamwheedle-cartel,1810,shaman,enhancement,48,27,21
48554,Iamashaman,malganis,1810,shaman,enhancement,302,154,148
48555,Timzero,tichondrius,1809,shaman,enhancement,133,66,67
48556,Adalid,thrall,1808,shaman,enhancement,66,46,20
48557,Yakora,stormrage,1805,shaman,enhancement,114,66,48
48558,Boboyaga,emerald-dream,1805,shaman,enhancement,54,29,25
48559,Enhance,bleeding-hollow,1805,shaman,enhancement,41,20,21
48560,Niuniudada,illidan,1805,shaman,enhancement,84,39,45
48561,Stonetides,tichondrius,1804,shaman,enhancement,36,26,10
48562,Nibrax,moknathal,1804,shaman,enhancement,78,41,37
48563,Elefornoobs,area-52,1803,shaman,enhancement,48,36,12
48564,Mercó,bleeding-hollow,1803,shaman,enhancement,54,31,23
48565,Madonion,zuljin,1803,shaman,enhancement,60,31,29
48566,Blakki,barthilas,1801,shaman,enhancement,66,40,26
48567,Dønkx,tichondrius,1801,shaman,enhancement,71,39,32
48568,Riptideafk,sargeras,1800,shaman,enhancement,75,46,29
48569,Landlordxx,area-52,1795,shaman,enhancement,52,32,20
48570,Norlak,antonidas,1794,shaman,enhancement,90,44,46
48571,Muisor,quelthalas,1792,shaman,enhancement,72,40,32
48572,Dorta,azralon,1792,shaman,enhancement,54,30,24
48573,Jyupaonaiwa,tichondrius,1792,shaman,enhancement,48,25,23
48574,Konfuzious,emerald-dream,1791,shaman,enhancement,141,79,62
48575,Darkcnight,stormrage,1789,shaman,enhancement,93,53,40
48576,Pingatronx,ragnaros,1786,shaman,enhancement,90,64,26
48577,Fujinx,medivh,1786,shaman,enhancement,39,27,12
48578,Dä,tichondrius,1786,shaman,enhancement,42,23,19
48579,Freyía,illidan,1784,shaman,enhancement,30,22,8
48580,Cammeez,area-52,1781,shaman,enhancement,121,62,59
48581,Xaltas,moon-guard,1779,shaman,enhancement,96,60,36
48582,Heisna,stormrage,1779,shaman,enhancement,289,153,136
48583,Díesel,azralon,1777,shaman,enhancement,59,32,27
48584,Garai,emerald-dream,1775,shaman,enhancement,135,69,66
48585,Krovn,stormrage,1772,shaman,enhancement,60,33,27
48586,Mobi,tichondrius,1769,shaman,enhancement,54,31,23
48587,Deandre,illidan,1768,shaman,enhancement,42,22,20
48588,Novedz,illidan,1767,shaman,enhancement,62,32,30
48589,Forksin,tichondrius,1767,shaman,enhancement,70,30,40
48590,Shinian,tichondrius,1765,shaman,enhancement,63,38,25
48591,Sheared,emerald-dream,1763,shaman,enhancement,84,51,33
48592,Worthquake,illidan,1758,shaman,enhancement,84,48,36
48593,Stewtwo,illidan,1758,shaman,enhancement,45,25,20
48594,Durozu,tichondrius,1758,shaman,enhancement,53,27,26
48595,Biubiuz,tichondrius,1757,shaman,enhancement,102,63,39
48596,Gorgonash,magtheridon,1756,shaman,enhancement,48,27,21
48597,Halfzugzug,sargeras,1754,shaman,enhancement,42,29,13
48598,Tdlz,tichondrius,1752,shaman,enhancement,110,67,43
48599,Nonomori,frostmourne,1751,shaman,enhancement,72,41,31
48600,Bigsquatzy,bleeding-hollow,1750,shaman,enhancement,42,23,19
48601,Soshatsumi,tichondrius,1749,shaman,enhancement,76,42,34
48602,Zappithorus,stormrage,1748,shaman,enhancement,54,35,19
48603,Shocksrus,arthas,1747,shaman,enhancement,78,44,34
48604,Kalvishdam,dalaran,1746,shaman,enhancement,36,25,11
48605,Kushnations,chogall,1746,shaman,enhancement,38,20,18
48606,Overpowered,korgath,1745,shaman,enhancement,40,21,19
48607,Sin,bleeding-hollow,1740,shaman,enhancement,35,19,16
48608,Watergirl,thaurissan,1739,shaman,enhancement,212,101,111
48609,Valkriie,tichondrius,1736,shaman,enhancement,37,22,15
48610,Nøtørious,thrall,1735,shaman,enhancement,24,22,2
48611,Onlyshams,dalaran,1732,shaman,enhancement,42,25,17
48612,Badshock,tichondrius,1730,shaman,enhancement,24,22,2
48613,Doex,thrall,1723,shaman,enhancement,48,26,22
48614,Reflexsivx,malganis,1722,shaman,enhancement,48,29,19
48615,Shearx,illidan,1722,shaman,enhancement,75,43,32
48616,Zanderpla,kelthuzad,1720,shaman,enhancement,96,48,48
48617,Speedrush,nagrand,1717,shaman,enhancement,128,76,52
48618,Poizele,tichondrius,1717,shaman,enhancement,294,164,130
48619,Cwippin,tichondrius,1712,shaman,enhancement,134,77,57
48620,Jàro,thrall,1708,shaman,enhancement,48,21,27
48621,Keyturns,tichondrius,1707,shaman,enhancement,24,18,6
48622,Rngena,trollbane,1706,shaman,enhancement,30,18,12
48623,Shamom,silver-hand,1706,shaman,enhancement,160,91,69
48624,Krûde,tichondrius,1703,shaman,enhancement,131,79,52
48625,Asumo,azralon,1703,shaman,enhancement,131,73,58
48626,Clappadactyl,frostmourne,1703,shaman,enhancement,254,136,118
48627,Electrica,quelthalas,1702,shaman,enhancement,36,18,18
48628,Sonofabat,spirestone,1701,shaman,enhancement,230,121,109
48629,Plzbuffme,dalaran,1700,shaman,enhancement,78,46,32
48630,Anadal,kargath,1700,shaman,enhancement,54,26,28
48631,Bbshock,stormrage,1698,shaman,enhancement,84,50,34
48632,Wingshaman,illidan,1698,shaman,enhancement,226,120,106
48633,Axelsteel,illidan,1697,shaman,enhancement,48,21,27
48634,Toobeastly,deathwing,1696,shaman,enhancement,87,48,39
48635,Bitsuey,frostmourne,1696,shaman,enhancement,84,46,38
48636,Stonetrog,blackrock,1695,shaman,enhancement,24,19,5
48637,Synivabyatch,eonar,1695,shaman,enhancement,78,44,34
48638,Clasm,tichondrius,1694,shaman,enhancement,30,22,8
48639,Tkarfuno,exodar,1694,shaman,enhancement,66,34,32
48640,Miketideson,proudmoore,1693,shaman,enhancement,72,38,34
48641,Beaviis,frostmourne,1693,shaman,enhancement,72,37,35
48642,Seltheran,tichondrius,1691,shaman,enhancement,42,29,13
48643,Megalithic,moon-guard,1690,shaman,enhancement,66,44,22
48644,Kamusham,azralon,1690,shaman,enhancement,85,45,40
48645,Shamezee,stormreaver,1689,shaman,enhancement,47,22,25
48646,Nyckysh,illidan,1688,shaman,enhancement,106,56,50
48647,Somebozo,darkspear,1687,shaman,enhancement,157,84,73
48648,Elryl,sargeras,1686,shaman,enhancement,116,64,52
48649,Shamgawd,illidan,1686,shaman,enhancement,51,28,23
48650,Justkitettv,stormrage,1684,shaman,enhancement,42,28,14
48651,Vjeze,frostmourne,1684,shaman,enhancement,30,18,12
48652,Geeblast,area-52,1683,shaman,enhancement,79,47,32
48653,Tuugo,mannoroth,1682,shaman,enhancement,36,24,12
48654,Meewo,sargeras,1682,shaman,enhancement,30,18,12
48655,Vortexfury,area-52,1682,shaman,enhancement,42,20,22
48656,Pla,tichondrius,1681,shaman,enhancement,174,97,77
48657,Täcti,tichondrius,1681,shaman,enhancement,93,51,42
48658,Shamungodc,tichondrius,1681,shaman,enhancement,50,25,25
48659,Tarazhim,kelthuzad,1678,shaman,enhancement,30,19,11
48660,Haishoe,stormrage,1677,shaman,enhancement,58,35,23
48661,Lagroupie,ragnaros,1675,shaman,enhancement,35,23,12
48662,Anzet,ragnaros,1673,shaman,enhancement,36,22,14
48663,Atthegates,illidan,1673,shaman,enhancement,186,92,94
48664,Melifesham,tichondrius,1672,shaman,enhancement,45,28,17
48665,Ioiotete,tichondrius,1671,shaman,enhancement,36,21,15
48666,Volkuul,zuljin,1669,shaman,enhancement,72,40,32
48667,Gorillahazed,tichondrius,1669,shaman,enhancement,183,93,90
48668,Nøname,azshara,1665,shaman,enhancement,239,122,117
48669,Aibheit,area-52,1664,shaman,enhancement,30,28,2
48670,Akormu,tichondrius,1664,shaman,enhancement,58,39,19
48671,Hecks,malorne,1664,shaman,enhancement,96,51,45
48672,Hurrikaine,dalaran,1663,shaman,enhancement,158,84,74
48673,Shockmehard,area-52,1661,shaman,enhancement,95,73,22
48674,Olíndo,tichondrius,1659,shaman,enhancement,42,27,15
48675,Tyranitaur,frostmourne,1659,shaman,enhancement,84,42,42
48676,Shakerina,azralon,1658,shaman,enhancement,122,59,63
48677,Sinestario,illidan,1657,shaman,enhancement,148,83,65
48678,Pashå,norgannon,1656,shaman,enhancement,36,24,12
48679,Swaplord,area-52,1656,shaman,enhancement,30,18,12
48680,Harrìson,tichondrius,1656,shaman,enhancement,41,21,20
48681,Dadadabang,frostmourne,1655,shaman,enhancement,70,43,27
48682,Furrybâstard,wyrmrest-accord,1654,shaman,enhancement,102,59,43
48683,Rêngoku,dalaran,1653,shaman,enhancement,36,26,10
48684,Døømsdáy,thrall,1653,shaman,enhancement,126,67,59
48685,Platanos,proudmoore,1653,shaman,enhancement,170,89,81
48686,Khormac,moon-guard,1652,shaman,enhancement,87,59,28
48687,Windflex,emerald-dream,1651,shaman,enhancement,85,43,42
48688,Ara,barthilas,1650,shaman,enhancement,48,32,16
48689,Meiku,emerald-dream,1649,shaman,enhancement,36,22,14
48690,Darwynz,zuljin,1649,shaman,enhancement,53,28,25
48691,Slapnarp,wyrmrest-accord,1649,shaman,enhancement,90,43,47
48692,Seltherann,tichondrius,1646,shaman,enhancement,36,25,11
48693,Dratna,sisters-of-elune,1645,shaman,enhancement,29,22,7
48694,Vultan,winterhoof,1645,shaman,enhancement,36,25,11
48695,Tandrian,daggerspine,1644,shaman,enhancement,54,25,29
48696,Elemores,tichondrius,1642,shaman,enhancement,66,40,26
48697,Swartzqt,tichondrius,1641,shaman,enhancement,58,28,30
48698,Tyven,tichondrius,1640,shaman,enhancement,94,50,44
48699,Çhïcagø,aegwynn,1640,shaman,enhancement,59,24,35
48700,Murig,bladefist,1638,shaman,enhancement,57,34,23
48701,Ràntòn,bleeding-hollow,1637,shaman,enhancement,35,24,11
48702,Shinydiglett,area-52,1637,shaman,enhancement,36,20,16
48703,Slothycrit,emerald-dream,1637,shaman,enhancement,36,20,16
48704,Lividelement,area-52,1636,shaman,enhancement,30,21,9
48705,Wortwort,tichondrius,1636,shaman,enhancement,111,59,52
48706,Seanan,tichondrius,1635,shaman,enhancement,48,31,17
48707,Askpuntee,sargeras,1635,shaman,enhancement,42,25,17
48708,Egirlshmu,stormrage,1634,shaman,enhancement,54,32,22
48709,Deww,sargeras,1632,shaman,enhancement,76,39,37
48710,Orkuss,illidan,1631,shaman,enhancement,48,25,23
48711,Thunderchad,jubeithos,1631,shaman,enhancement,50,25,25
48712,Tettnanger,azralon,1630,shaman,enhancement,31,19,12
48713,Slashpity,stormrage,1630,shaman,enhancement,63,33,30
48714,Olani,nesingwary,1630,shaman,enhancement,43,22,21
48715,Shámdemons,area-52,1629,shaman,enhancement,96,58,38
48716,Omaguap,tichondrius,1628,shaman,enhancement,50,29,21
48717,Kohatan,moon-guard,1627,shaman,enhancement,98,58,40
48718,Ironaddictz,kiljaeden,1627,shaman,enhancement,70,39,31
48719,Thewindman,sargeras,1626,shaman,enhancement,90,46,44
48720,Hxzard,stormrage,1626,shaman,enhancement,36,17,19
48721,Åvarice,shattered-halls,1626,shaman,enhancement,54,22,32
48722,Alablast,malganis,1625,shaman,enhancement,36,21,15
48723,Shockdome,daggerspine,1624,shaman,enhancement,33,23,10
48724,Zapnclap,tichondrius,1623,shaman,enhancement,42,24,18
48725,Dankthunda,stormrage,1622,shaman,enhancement,126,71,55
48726,Jofstrom,tichondrius,1620,shaman,enhancement,24,18,6
48727,Mokho,stormrage,1620,shaman,enhancement,30,19,11
48728,Venmoo,illidan,1620,shaman,enhancement,42,20,22
48729,Deyodin,illidan,1619,shaman,enhancement,26,18,8
48730,Ceasebelief,tichondrius,1619,shaman,enhancement,36,24,12
48731,Totegoat,nazjatar,1618,shaman,enhancement,54,28,26
48732,Ryziax,tichondrius,1616,shaman,enhancement,41,23,18
48733,Fhenh,proudmoore,1615,shaman,enhancement,131,76,55
48734,Ðr,earthen-ring,1615,shaman,enhancement,122,68,54
48735,Split,zuljin,1614,shaman,enhancement,196,108,88
48736,Stýlébéñdér,kelthuzad,1613,shaman,enhancement,24,17,7
48737,Zmogon,quelthalas,1611,shaman,enhancement,59,30,29
48738,Ryuuraix,area-52,1610,shaman,enhancement,27,18,9
48739,Feroxture,frostmourne,1610,shaman,enhancement,66,38,28
48740,Xlianah,zuljin,1609,shaman,enhancement,54,28,26
48741,Bräindëad,hyjal,1608,shaman,enhancement,131,74,57
48742,Robdaman,tichondrius,1607,shaman,enhancement,24,18,6
48743,Daddymacktv,malganis,1607,shaman,enhancement,74,39,35
48744,Smash,fenris,1606,shaman,enhancement,91,47,44
48745,Smartbunny,illidan,1606,shaman,enhancement,318,160,158
48746,Stormbash,ragnaros,1606,shaman,enhancement,72,30,42
48747,Totemnikiel,stormrage,1602,shaman,enhancement,90,42,48
48748,Shamwik,frostmourne,1601,shaman,enhancement,65,38,27
48749,Volsdeep,illidan,1600,shaman,enhancement,70,38,32
48750,Frëdstorm,kelthuzad,1599,shaman,enhancement,215,108,107
48751,Torgami,tichondrius,1598,shaman,enhancement,49,30,19
48752,Hellamental,malganis,1598,shaman,enhancement,42,22,20
48753,Eliteshamann,tichondrius,1597,shaman,enhancement,96,51,45
48754,Eyecandi,barthilas,1595,shaman,enhancement,151,76,75
48755,Hehew,kelthuzad,1594,shaman,enhancement,83,49,34
48756,Roysoy,stormrage,1591,shaman,enhancement,78,46,32
48757,Mobiediqônú,skywall,1586,shaman,enhancement,36,19,17
48758,Tootshock,illidan,1585,shaman,enhancement,54,27,27
48759,Niceshoe,tichondrius,1582,shaman,enhancement,47,23,24
48760,Shabenn,proudmoore,1580,shaman,enhancement,151,76,75
48761,Zavar,tichondrius,1579,shaman,enhancement,77,40,37
48762,Moistydank,tichondrius,1578,shaman,enhancement,78,51,27
48763,Blackenergy,stormrage,1578,shaman,enhancement,92,48,44
48764,Artsha,tol-barad,1576,shaman,enhancement,35,17,18
48765,Jerykco,drakkari,1575,shaman,enhancement,78,40,38
48766,Jumoma,thrall,1574,shaman,enhancement,54,34,20
48767,Kindaretro,tichondrius,1574,shaman,enhancement,48,29,19
48768,Gambazzlok,terokkar,1574,shaman,enhancement,48,28,20
48769,Zeroshocks,kelthuzad,1573,shaman,enhancement,42,25,17
48770,Dreddfoxy,illidan,1573,shaman,enhancement,36,19,17
48771,Shamanees,area-52,1572,shaman,enhancement,153,76,77
48772,ßlessedx,tichondrius,1571,shaman,enhancement,59,38,21
48773,Nÿh,quelthalas,1569,shaman,enhancement,48,27,21
48774,Shamwows,dalaran,1569,shaman,enhancement,183,91,92
48775,Aoshiferuzz,ragnaros,1566,shaman,enhancement,78,43,35
48776,Shmnsm,kiljaeden,1565,shaman,enhancement,42,18,24
48777,Zugzugenh,stormrage,1564,shaman,enhancement,58,32,26
48778,Lyrzsa,blackwing-lair,1562,shaman,enhancement,74,46,28
48779,Uracemytotem,kiljaeden,1562,shaman,enhancement,84,51,33
48780,Tumble,frostmourne,1562,shaman,enhancement,144,78,66
48781,Juliojones,trollbane,1562,shaman,enhancement,36,18,18
48782,Shamcowhah,frostmourne,1562,shaman,enhancement,36,17,19
48783,Thunda,black-dragonflight,1561,shaman,enhancement,36,22,14
48784,Shockszz,onyxia,1561,shaman,enhancement,36,20,16
48785,Keeba,wyrmrest-accord,1558,shaman,enhancement,60,31,29
48786,ßurstmedaddy,bleeding-hollow,1557,shaman,enhancement,36,27,9
48787,Loadiez,frostmourne,1556,shaman,enhancement,42,28,14
48788,Soupi,illidan,1556,shaman,enhancement,126,68,58
48789,Ephraalin,frostmourne,1556,shaman,enhancement,42,22,20
48790,Deemmorti,stormrage,1555,shaman,enhancement,52,28,24
48791,Cayed,stormscale,1553,shaman,enhancement,90,47,43
48792,Armîn,moon-guard,1544,shaman,enhancement,54,33,21
48793,Lavawreckage,malganis,1544,shaman,enhancement,122,66,56
48794,Heäven,malganis,1543,shaman,enhancement,198,105,93
48795,Udb,the-scryers,1542,shaman,enhancement,53,32,21
48796,Mindfields,barthilas,1542,shaman,enhancement,73,42,31
48797,Rexoss,hyjal,1541,shaman,enhancement,146,79,67
48798,Killbro,blackrock,1540,shaman,enhancement,187,99,88
48799,Elementalïst,durotan,1538,shaman,enhancement,30,19,11
48800,Lenin,nathrezim,1538,shaman,enhancement,54,30,24
48801,Small,alleria,1538,shaman,enhancement,60,32,28
48802,Cowely,madoran,1536,shaman,enhancement,48,29,19
48803,Pedaphil,frostmourne,1534,shaman,enhancement,24,16,8
48804,Feesstt,malganis,1534,shaman,enhancement,48,27,21
48805,Thilv,ravenholdt,1534,shaman,enhancement,48,27,21
48806,Clenlift,emerald-dream,1534,shaman,enhancement,216,114,102
48807,Shamgødx,dalaran,1533,shaman,enhancement,18,16,2
48808,Derzwaz,draka,1532,shaman,enhancement,29,17,12
48809,Killavicious,area-52,1531,shaman,enhancement,84,39,45
48810,Larrylardazz,tichondrius,1530,shaman,enhancement,86,52,34
48811,Azumaa,tichondrius,1530,shaman,enhancement,42,21,21
48812,Dimitrio,azralon,1527,shaman,enhancement,124,63,61
48813,Gordonramsai,sargeras,1526,shaman,enhancement,30,21,9
48814,Deshamann,illidan,1522,shaman,enhancement,100,45,55
48815,Grx,tichondrius,1521,shaman,enhancement,50,25,25
48816,Arlikai,arthas,1520,shaman,enhancement,153,69,84
48817,Dirtyunique,tichondrius,1519,shaman,enhancement,90,51,39
48818,Slapchainz,tichondrius,1519,shaman,enhancement,36,18,18
48819,Solka,illidan,1518,shaman,enhancement,54,32,22
48820,Abigdude,frostmourne,1518,shaman,enhancement,167,89,78
48821,Vásh,quelthalas,1517,shaman,enhancement,24,16,8
48822,Killswitch,bonechewer,1516,shaman,enhancement,30,16,14
48823,Boomershock,stormrage,1516,shaman,enhancement,42,20,22
48824,Vapus,area-52,1515,shaman,enhancement,142,81,61
48825,Ginjij,thrall,1514,shaman,enhancement,30,18,12
48826,Mixn,frostmourne,1513,shaman,enhancement,113,66,47
48827,Balldo,stormrage,1513,shaman,enhancement,36,16,20
48828,Chungussy,blackrock,1512,shaman,enhancement,35,21,14
48829,Flirstatic,nemesis,1512,shaman,enhancement,135,73,62
48830,Delxx,tichondrius,1511,shaman,enhancement,24,16,8
48831,Stormblast,stormrage,1510,shaman,enhancement,41,23,18
48832,Mihrion,moon-guard,1508,shaman,enhancement,41,22,19
48833,Prymalfury,illidan,1508,shaman,enhancement,120,62,58
48834,Daikí,ragnaros,1507,shaman,enhancement,37,21,16
48835,Töpg,garrosh,1506,shaman,enhancement,40,21,19
48836,Elementin,kelthuzad,1503,shaman,enhancement,96,46,50
48837,Yildiri,area-52,1501,shaman,enhancement,18,16,2
48838,Kronkxd,malganis,1501,shaman,enhancement,30,16,14
48839,Kandin,icecrown,1498,shaman,enhancement,54,27,27
48840,Pockethealer,emerald-dream,1494,shaman,enhancement,149,80,69
48841,Sugarpapa,bonechewer,1493,shaman,enhancement,69,42,27
48842,Earthfirex,ragnaros,1493,shaman,enhancement,48,25,23
48843,Hephron,area-52,1493,shaman,enhancement,72,32,40
48844,Shockolatte,sargeras,1492,shaman,enhancement,103,45,58
48845,Quakenbake,emerald-dream,1491,shaman,enhancement,33,20,13
48846,Jäyp,thrall,1490,shaman,enhancement,68,38,30
48847,Amasaei,bleeding-hollow,1488,shaman,enhancement,72,36,36
48848,Bòómz,stormrage,1488,shaman,enhancement,370,179,191
48849,Hungnuts,sargeras,1487,shaman,enhancement,124,67,57
48850,Jamieslays,korgath,1487,shaman,enhancement,53,24,29
48851,Chaposz,tichondrius,1486,shaman,enhancement,91,48,43
48852,Dilfmaster,tichondrius,1486,shaman,enhancement,71,36,35
48853,Shoresy,kaelthas,1485,shaman,enhancement,54,28,26
48854,Arázi,wyrmrest-accord,1485,shaman,enhancement,41,16,25
48855,Casualsham,illidan,1484,shaman,enhancement,48,30,18
48856,Konga,korialstrasz,1483,shaman,enhancement,38,22,16
48857,Saphage,tichondrius,1482,shaman,enhancement,42,22,20
48858,Scrototëm,azralon,1481,shaman,enhancement,81,42,39
48859,Terrible,illidan,1481,shaman,enhancement,36,16,20
48860,Stubbywayne,area-52,1479,shaman,enhancement,207,106,101
48861,Ragnarocck,sargeras,1479,shaman,enhancement,75,36,39
48862,Dashmmy,dalaran,1478,shaman,enhancement,54,26,28
48863,Iamurfather,magtheridon,1477,shaman,enhancement,143,74,69
48864,Armønixx,ragnaros,1476,shaman,enhancement,120,65,55
48865,Falasha,bloodscalp,1475,shaman,enhancement,46,27,19
48866,Forloren,zuljin,1475,shaman,enhancement,52,28,24
48867,Maribain,barthilas,1472,shaman,enhancement,112,65,47
48868,Vøllttz,azralon,1471,shaman,enhancement,24,16,8
48869,Spacex,velen,1470,shaman,enhancement,42,21,21
48870,Lakindrentv,gorefiend,1467,shaman,enhancement,30,17,13
48871,Mackandal,tichondrius,1466,shaman,enhancement,86,43,43
48872,Lavalavalava,dentarg,1465,shaman,enhancement,30,21,9
48873,Skyzik,area-52,1465,shaman,enhancement,54,34,20
48874,Beaversniper,tichondrius,1465,shaman,enhancement,84,38,46
48875,Hyjixtv,stormrage,1464,shaman,enhancement,24,18,6
48876,Woof,agamaggan,1464,shaman,enhancement,30,16,14
48877,Earthlsflat,tichondrius,1463,shaman,enhancement,31,21,10
48878,Daddyzap,stormrage,1462,shaman,enhancement,104,58,46
48879,Àspec,aegwynn,1460,shaman,enhancement,22,16,6
48880,Lavabone,dalaran,1459,shaman,enhancement,66,28,38
48881,Sndhlp,tichondrius,1457,shaman,enhancement,46,29,17
48882,Raxabico,nemesis,1457,shaman,enhancement,38,17,21
48883,Getacho,stormrage,1454,shaman,enhancement,150,72,78
48884,Tictactotem,stormreaver,1452,shaman,enhancement,42,24,18
48885,Xillas,moon-guard,1451,shaman,enhancement,48,28,20
48886,Tigolbittie,sargeras,1451,shaman,enhancement,54,23,31
48887,Scrötotem,saurfang,1450,shaman,enhancement,89,50,39
48888,Lamagra,nemesis,1449,shaman,enhancement,30,19,11
48889,Goribash,wyrmrest-accord,1449,shaman,enhancement,42,26,16
48890,Vanklayser,ragnaros,1449,shaman,enhancement,55,24,31
48891,Surtel,tichondrius,1448,shaman,enhancement,77,36,41
48892,Calich,kelthuzad,1447,shaman,enhancement,62,35,27
48893,Shamann,azshara,1447,shaman,enhancement,63,34,29
48894,Roidzsham,area-52,1446,shaman,enhancement,42,25,17
48895,Zheúz,azralon,1446,shaman,enhancement,56,31,25
48896,Odïn,tichondrius,1444,shaman,enhancement,54,33,21
48897,Drakkaa,tichondrius,1439,shaman,enhancement,31,20,11
48898,Sswf,auchindoun,1439,shaman,enhancement,24,15,9
48899,Cyclrin,sargeras,1439,shaman,enhancement,24,15,9
48900,Teeroll,frostmourne,1439,shaman,enhancement,41,25,16
48901,Exxosenh,tichondrius,1438,shaman,enhancement,18,15,3
48902,Exsh,area-52,1438,shaman,enhancement,18,15,3
48903,Tamtam,gorefiend,1438,shaman,enhancement,24,15,9
48904,Seltz,illidan,1438,shaman,enhancement,30,15,15
48905,Nohandslost,tichondrius,1437,shaman,enhancement,43,30,13
48906,Gundar,chogall,1436,shaman,enhancement,56,31,25
48907,Kinzle,tichondrius,1436,shaman,enhancement,36,15,21
48908,Qvibin,tichondrius,1435,shaman,enhancement,30,21,9
48909,Arque,stormrage,1435,shaman,enhancement,78,49,29
48910,Tungusk,tichondrius,1435,shaman,enhancement,24,15,9
48911,Däbü,tichondrius,1435,shaman,enhancement,30,15,15
48912,Friednocap,kelthuzad,1435,shaman,enhancement,48,21,27
48913,Jummyman,area-52,1434,shaman,enhancement,47,30,17
48914,Wecookin,frostwolf,1433,shaman,enhancement,18,15,3
48915,Vonnsmallpp,area-52,1433,shaman,enhancement,24,15,9
48916,Rojhaz,stormrage,1433,shaman,enhancement,48,28,20
48917,Meattoilet,tichondrius,1431,shaman,enhancement,23,16,7
48918,Cuzcuz,tichondrius,1431,shaman,enhancement,24,15,9
48919,Doomfury,magtheridon,1431,shaman,enhancement,36,21,15
48920,Whydead,sargeras,1431,shaman,enhancement,72,40,32
48921,Pahtaklol,tichondrius,1431,shaman,enhancement,30,15,15
48922,Justincasé,sargeras,1431,shaman,enhancement,96,43,53
48923,Djasura,blackhand,1430,shaman,enhancement,53,29,24
48924,Kushgodd,kiljaeden,1429,shaman,enhancement,60,31,29
48925,Defiant,azgalor,1429,shaman,enhancement,30,15,15
48926,Shalkahn,malganis,1429,shaman,enhancement,53,22,31
48927,Roz,khaz-modan,1428,shaman,enhancement,18,15,3
48928,Earfshock,thrall,1428,shaman,enhancement,74,41,33
48929,Zêus,sargeras,1427,shaman,enhancement,30,17,13
48930,Convolutedx,tichondrius,1427,shaman,enhancement,30,15,15
48931,Texmawave,moon-guard,1425,shaman,enhancement,24,15,9
48932,Grippysockz,dalaran,1424,shaman,enhancement,24,15,9
48933,Drumman,skullcrusher,1423,shaman,enhancement,118,66,52
48934,Sockittooya,bleeding-hollow,1422,shaman,enhancement,54,34,20
48935,Rtÿo,area-52,1422,shaman,enhancement,24,15,9
48936,Raazzasham,moon-guard,1422,shaman,enhancement,65,34,31
48937,Silyshamshyt,stormrage,1421,shaman,enhancement,24,15,9
48938,Zaydax,altar-of-storms,1421,shaman,enhancement,24,15,9
48939,Shamcharles,proudmoore,1421,shaman,enhancement,50,17,33
48940,Tinysha,tichondrius,1420,shaman,enhancement,24,15,9
48941,Dwightjr,emerald-dream,1417,shaman,enhancement,48,23,25
48942,Shamrockcawk,malganis,1415,shaman,enhancement,54,35,19
48943,Clownshòes,tichondrius,1415,shaman,enhancement,42,26,16
48944,Mudroller,moon-guard,1414,shaman,enhancement,52,24,28
48945,Hvalleyranch,area-52,1411,shaman,enhancement,59,27,32
48946,Zere,cenarius,1410,shaman,enhancement,20,17,3
48947,Makocc,tichondrius,1410,shaman,enhancement,92,41,51
48948,Raylord,ragnaros,1406,shaman,enhancement,131,72,59
48949,Firevag,hakkar,1405,shaman,enhancement,135,73,62
48950,Nankdug,tichondrius,1405,shaman,enhancement,47,25,22
48951,Zzar,daggerspine,1404,shaman,enhancement,42,23,19
48952,Orcshamen,tichondrius,1403,shaman,enhancement,60,35,25
48953,Neyter,azralon,1402,shaman,enhancement,90,57,33
48954,Brëw,tichondrius,1402,shaman,enhancement,37,21,16
48955,Goonxdz,illidan,1402,shaman,enhancement,63,26,37
48956,Fyahchaming,drakkari,1401,shaman,enhancement,82,46,36
48957,Lüca,wyrmrest-accord,1401,shaman,enhancement,211,109,102
48958,Talfur,area-52,1400,shaman,enhancement,42,23,19
48959,Nyxxus,tichondrius,1399,shaman,enhancement,30,19,11
48960,Djelemental,darkspear,1394,shaman,enhancement,27,17,10
48961,Zaboomafoo,emerald-dream,1392,shaman,enhancement,69,37,32
48962,Zugzugthug,moon-guard,1392,shaman,enhancement,34,18,16
48963,Stickysham,illidan,1391,shaman,enhancement,42,26,16
48964,Dashinra,stormrage,1391,shaman,enhancement,38,20,18
48965,Orcmanshamn,moon-guard,1390,shaman,enhancement,92,47,45
48966,Groundfaults,bleeding-hollow,1389,shaman,enhancement,35,15,20
48967,Mortzor,frostmourne,1387,shaman,enhancement,35,22,13
48968,Shipmatekev,sargeras,1386,shaman,enhancement,54,29,25
48969,Zktz,warsong,1385,shaman,enhancement,31,17,14
48970,Zute,frostmourne,1384,shaman,enhancement,70,41,29
48971,Zügz,illidan,1383,shaman,enhancement,55,33,22
48972,Rhass,ragnaros,1380,shaman,enhancement,72,34,38
48973,Lazugga,area-52,1378,shaman,enhancement,80,42,38
48974,Katojune,tichondrius,1378,shaman,enhancement,33,16,17
48975,Borwald,dalaran,1377,shaman,enhancement,148,76,72
48976,Tyzek,illidan,1375,shaman,enhancement,42,26,16
48977,Gettatotem,frostmourne,1373,shaman,enhancement,30,17,13
48978,Prasu,spirestone,1372,shaman,enhancement,70,33,37
48979,Froglok,boulderfist,1371,shaman,enhancement,35,17,18
48980,Grendinbal,moon-guard,1370,shaman,enhancement,33,15,18
48981,Tamzlol,the-forgotten-coast,1367,shaman,enhancement,48,26,22
48982,Ventus,thrall,1366,shaman,enhancement,78,35,43
48983,Tigtotem,malganis,1365,shaman,enhancement,24,16,8
48984,Nìke,nazgrel,1364,shaman,enhancement,47,21,26
48985,Psilocypher,nazjatar,1362,shaman,enhancement,42,28,14
48986,Montí,moon-guard,1361,shaman,enhancement,83,51,32
48987,Grohltusk,barthilas,1360,shaman,enhancement,42,24,18
48988,Usul,frostmane,1360,shaman,enhancement,109,56,53
48989,Johnwilke,area-52,1356,shaman,enhancement,119,59,60
48990,Mëister,stormrage,1355,shaman,enhancement,137,70,67
48991,Murlook,sargeras,1354,shaman,enhancement,67,44,23
48992,Brreeaadd,tichondrius,1354,shaman,enhancement,57,25,32
48993,Isbabani,moon-guard,1353,shaman,enhancement,30,16,14
48994,Trenbolone,maiev,1351,shaman,enhancement,77,46,31
48995,Monadazs,ragnaros,1351,shaman,enhancement,50,26,24
48996,Trashfarmer,tichondrius,1351,shaman,enhancement,114,54,60
48997,Mybadshawty,tichondrius,1347,shaman,enhancement,72,32,40
48998,Bessame,sargeras,1346,shaman,enhancement,94,48,46
48999,Døømwinds,tichondrius,1342,shaman,enhancement,24,14,10
49000,Tsaheylu,barthilas,1342,shaman,enhancement,48,22,26
49001,Capershock,sargeras,1341,shaman,enhancement,18,14,4
49002,Magmao,quelthalas,1341,shaman,enhancement,71,43,28
49003,Stormwolf,emerald-dream,1341,shaman,enhancement,42,23,19
49004,Joeschno,bleeding-hollow,1341,shaman,enhancement,41,16,25
49005,Crøwgød,tichondrius,1340,shaman,enhancement,24,14,10
49006,Gaelfury,malganis,1339,shaman,enhancement,54,24,30
49007,Stormgraves,moon-guard,1337,shaman,enhancement,24,14,10
49008,Leaning,wyrmrest-accord,1335,shaman,enhancement,24,14,10
49009,Clumpen,thunderhorn,1335,shaman,enhancement,47,25,22
49010,Electabuzz,arygos,1335,shaman,enhancement,30,15,15
49011,Khorgan,emerald-dream,1334,shaman,enhancement,24,14,10
49012,Vlackz,quelthalas,1334,shaman,enhancement,42,22,20
49013,Kamíhameha,stormrage,1333,shaman,enhancement,110,57,53
49014,Aldinatir,ragnaros,1332,shaman,enhancement,24,14,10
49015,Tizzl,kelthuzad,1332,shaman,enhancement,78,39,39
49016,Atroll,moonrunner,1332,shaman,enhancement,66,30,36
49017,Chapope,quelthalas,1329,shaman,enhancement,46,30,16
49018,Raijû,illidan,1329,shaman,enhancement,24,14,10
49019,Niteshammy,lothar,1328,shaman,enhancement,24,14,10
49020,Hagass,tichondrius,1328,shaman,enhancement,61,28,33
49021,Lazygemini,illidan,1327,shaman,enhancement,78,39,39
49022,Unezx,tichondrius,1326,shaman,enhancement,18,14,4
49023,Shomani,madoran,1326,shaman,enhancement,41,17,24
49024,Leschaises,skullcrusher,1325,shaman,enhancement,27,18,9
49025,Volcanoboxer,tichondrius,1325,shaman,enhancement,21,14,7
49026,Winiethepoöh,stormrage,1325,shaman,enhancement,36,14,22
49027,Doomvin,stormrage,1324,shaman,enhancement,54,29,25
49028,Baloneyfiveo,kiljaeden,1322,shaman,enhancement,56,31,25
49029,Sleekish,moon-guard,1319,shaman,enhancement,30,14,16
49030,Shawkedu,tichondrius,1317,shaman,enhancement,36,16,20
49031,Canabal,eonar,1315,shaman,enhancement,24,14,10
49032,Totesmagotes,scilla,1314,shaman,enhancement,36,22,14
49033,Kungfuvoodoo,tichondrius,1314,shaman,enhancement,24,14,10
49034,Argrax,sargeras,1314,shaman,enhancement,71,41,30
49035,Rokogg,thrall,1312,shaman,enhancement,133,69,64
49036,Blasho,ragnaros,1312,shaman,enhancement,110,50,60
49037,Shamorrhoids,frostmourne,1311,shaman,enhancement,118,62,56
49038,Dugomik,malganis,1311,shaman,enhancement,100,49,51
49039,Harvesting,azralon,1311,shaman,enhancement,30,14,16
49040,Beogar,moon-guard,1310,shaman,enhancement,27,15,12
49041,Mairn,tichondrius,1310,shaman,enhancement,66,33,33
49042,Piffenstien,malganis,1310,shaman,enhancement,66,32,34
49043,Sasori,stormrage,1309,shaman,enhancement,48,31,17
49044,Hanhze,quelthalas,1306,shaman,enhancement,93,54,39
49045,Yâmz,area-52,1306,shaman,enhancement,57,25,32
49046,Burrst,thrall,1305,shaman,enhancement,24,14,10
49047,Vöödooranger,stormrage,1305,shaman,enhancement,24,14,10
49048,Emelectric,quelthalas,1304,shaman,enhancement,66,31,35
49049,Tabellarium,tichondrius,1303,shaman,enhancement,36,21,15
49050,Whichdoctah,proudmoore,1302,shaman,enhancement,30,14,16
49051,Cbomberz,tichondrius,1301,shaman,enhancement,85,42,43
49052,Pumpz,magtheridon,1301,shaman,enhancement,30,14,16
49053,Lightnessx,stormrage,1301,shaman,enhancement,42,17,25
49054,Microwavbakn,emerald-dream,1300,shaman,enhancement,70,38,32
49055,Astrò,illidan,1299,shaman,enhancement,18,14,4
49056,Triní,ragnaros,1296,shaman,enhancement,69,40,29
49057,Rongkhan,tichondrius,1296,shaman,enhancement,41,23,18
49058,Shrektar,cenarius,1296,shaman,enhancement,48,21,27
49059,Neyavv,tichondrius,1294,shaman,enhancement,181,87,94
49060,Kasukaga,shadowmoon,1291,shaman,enhancement,72,34,38
49061,Sigir,darrowmere,1290,shaman,enhancement,48,22,26
49062,Obeilius,illidan,1288,shaman,enhancement,61,31,30
49063,Kulnash,auchindoun,1287,shaman,enhancement,28,17,11
49064,Pandashamnda,area-52,1287,shaman,enhancement,58,31,27
49065,Forgediniron,stormrage,1286,shaman,enhancement,53,27,26
49066,Dàfèng,wyrmrest-accord,1286,shaman,enhancement,41,14,27
49067,Jackofstorms,veknilash,1285,shaman,enhancement,56,25,31
49068,Taò,tichondrius,1283,shaman,enhancement,87,44,43
49069,Thorodinsson,proudmoore,1280,shaman,enhancement,55,21,34
49070,Bobaflexqt,korgath,1279,shaman,enhancement,24,15,9
49071,Vanmaichet,azshara,1276,shaman,enhancement,29,14,15
49072,Parallels,blackrock,1275,shaman,enhancement,112,54,58
49073,Beardcramps,tichondrius,1275,shaman,enhancement,75,29,46
49074,Zerium,nemesis,1274,shaman,enhancement,42,25,17
49075,Zechary,proudmoore,1273,shaman,enhancement,54,33,21
49076,Flaméy,stormrage,1273,shaman,enhancement,51,21,30
49077,Kigorami,nerzhul,1271,shaman,enhancement,42,21,21
49078,Thorlottie,stormrage,1269,shaman,enhancement,30,15,15
49079,Majhrakova,stormrage,1266,shaman,enhancement,30,15,15
49080,Popsmoke,gnomeregan,1265,shaman,enhancement,23,14,9
49081,Datblueboi,dalaran,1263,shaman,enhancement,76,39,37
49082,Dì,barthilas,1262,shaman,enhancement,30,19,11
49083,Umbrood,area-52,1262,shaman,enhancement,48,23,25
49084,Gorebog,feathermoon,1259,shaman,enhancement,42,23,19
49085,Obrahma,burning-legion,1258,shaman,enhancement,24,16,8
49086,Chalked,stormrage,1257,shaman,enhancement,103,48,55
49087,Deathjoker,icecrown,1255,shaman,enhancement,66,34,32
49088,Holosoul,bleeding-hollow,1254,shaman,enhancement,67,27,40
49089,Lerajje,tichondrius,1251,shaman,enhancement,42,22,20
49090,Rikswordfire,wyrmrest-accord,1251,shaman,enhancement,35,16,19
49091,Extraguacpls,tichondrius,1249,shaman,enhancement,23,14,9
49092,Hexoffnder,zuljin,1246,shaman,enhancement,18,13,5
49093,Lizardhusk,barthilas,1246,shaman,enhancement,24,13,11
49094,Lilpump,boulderfist,1246,shaman,enhancement,66,34,32
49095,Care,silvermoon,1245,shaman,enhancement,18,13,5
49096,Arckos,thrall,1245,shaman,enhancement,18,13,5
49097,Torvi,saurfang,1244,shaman,enhancement,18,13,5
49098,Doitclap,stormrage,1243,shaman,enhancement,18,15,3
49099,Zêûs,moon-guard,1240,shaman,enhancement,24,13,11
49100,Dalthragoz,tichondrius,1239,shaman,enhancement,24,13,11
49101,Dylangs,frostmourne,1238,shaman,enhancement,24,13,11
49102,Dalsun,turalyon,1237,shaman,enhancement,30,13,17
49103,Shokaria,frostwolf,1237,shaman,enhancement,35,14,21
49104,Eze,tichondrius,1234,shaman,enhancement,64,36,28
49105,Githealed,kelthuzad,1234,shaman,enhancement,27,15,12
49106,Zugxo,area-52,1233,shaman,enhancement,20,15,5
49107,Vozs,proudmoore,1233,shaman,enhancement,60,34,26
49108,Argena,bonechewer,1233,shaman,enhancement,24,13,11
49109,Twansom,tichondrius,1233,shaman,enhancement,66,35,31
49110,Thromir,blackwing-lair,1233,shaman,enhancement,48,22,26
49111,Slowgrath,burning-legion,1232,shaman,enhancement,45,26,19
49112,Manthozshami,ragnaros,1232,shaman,enhancement,30,13,17
49113,Shamwickk,tichondrius,1231,shaman,enhancement,48,26,22
49114,Willy,icecrown,1230,shaman,enhancement,23,13,10
49115,Shamikkazee,illidan,1228,shaman,enhancement,67,36,31
49116,Drahlos,tichondrius,1227,shaman,enhancement,30,13,17
49117,Shamgoddam,illidan,1225,shaman,enhancement,58,24,34
49118,Shawhammy,illidan,1225,shaman,enhancement,48,19,29
49119,Uglykunt,barthilas,1224,shaman,enhancement,111,62,49
49120,Bhaelfury,moon-guard,1224,shaman,enhancement,36,20,16
49121,Netherfury,illidan,1224,shaman,enhancement,51,28,23
49122,Shamantwo,windrunner,1223,shaman,enhancement,24,13,11
49123,Súrtr,sargeras,1221,shaman,enhancement,24,13,11
49124,Gdiafplox,thunderhorn,1220,shaman,enhancement,66,34,32
49125,Mullten,sargeras,1219,shaman,enhancement,36,15,21
49126,Crigga,dalaran,1216,shaman,enhancement,24,13,11
49127,Taowth,area-52,1214,shaman,enhancement,35,13,22
49128,Sevare,area-52,1213,shaman,enhancement,27,14,13
49129,Spicyballs,coilfang,1213,shaman,enhancement,30,13,17
49130,Hammeredd,hyjal,1212,shaman,enhancement,36,18,18
49131,Fireclaws,bleeding-hollow,1206,shaman,enhancement,36,16,20
49132,Lutheran,dragonmaw,1200,shaman,enhancement,47,21,26
49133,Sinsar,illidan,1200,shaman,enhancement,35,13,22
49134,Zaxibow,area-52,1196,shaman,enhancement,34,15,19
49135,Iamegirl,moon-guard,1191,shaman,enhancement,29,13,16
49136,Djshammy,barthilas,1183,shaman,enhancement,28,15,13
49137,Helohk,wyrmrest-accord,1182,shaman,enhancement,22,13,9
49138,Amärök,area-52,1181,shaman,enhancement,62,26,36
49139,ßigðåddy,ghostlands,1179,shaman,enhancement,60,19,41
49140,Spiderjohn,sargeras,1177,shaman,enhancement,36,20,16
49141,Enhancementz,azralon,1174,shaman,enhancement,68,37,31
49142,Thorre,the-scryers,1171,shaman,enhancement,30,19,11
49143,Litchuckie,thrall,1169,shaman,enhancement,46,25,21
49144,Keytürnz,frostmourne,1167,shaman,enhancement,48,21,27
49145,Bluëwafflë,tichondrius,1165,shaman,enhancement,31,16,15
49146,Cseril,bonechewer,1164,shaman,enhancement,83,49,34
49147,Yelpreviewer,dalaran,1164,shaman,enhancement,29,14,15
49148,Shometrin,tichondrius,1164,shaman,enhancement,59,21,38
49149,Finnaburstt,tichondrius,1162,shaman,enhancement,54,29,25
49150,Tarresh,azralon,1161,shaman,enhancement,42,16,26
49151,Splendapapi,stormrage,1155,shaman,enhancement,38,13,25
49152,Onezap,trollbane,1153,shaman,enhancement,55,21,34
49153,Tactíc,chromaggus,1152,shaman,enhancement,18,12,6
49154,Gangmember,shadowmoon,1152,shaman,enhancement,18,12,6
49155,Shamakhazi,stormrage,1151,shaman,enhancement,18,12,6
49156,Scrib,dawnbringer,1151,shaman,enhancement,18,12,6
49157,Deixw,tichondrius,1151,shaman,enhancement,18,12,6
49158,Jinxicle,illidan,1151,shaman,enhancement,18,12,6
49159,Purgegodryuu,area-52,1151,shaman,enhancement,24,12,12
49160,Mcb,barthilas,1151,shaman,enhancement,24,12,12
49161,Nyknicks,tichondrius,1150,shaman,enhancement,18,12,6
49162,Dialtone,blackrock,1150,shaman,enhancement,30,12,18
49163,Angrymán,ragnaros,1149,shaman,enhancement,12,12,0
49164,Rainjig,emerald-dream,1149,shaman,enhancement,21,12,9
49165,Hordeymaori,jubeithos,1149,shaman,enhancement,156,82,74
49166,Stoneseed,steamwheedle-cartel,1147,shaman,enhancement,30,12,18
49167,Zèus,draka,1146,shaman,enhancement,24,12,12
49168,Tosil,tichondrius,1144,shaman,enhancement,24,12,12
49169,Têach,ragnaros,1142,shaman,enhancement,18,12,6
49170,Saraguthix,dalaran,1141,shaman,enhancement,18,12,6
49171,Fourstorms,gundrak,1141,shaman,enhancement,37,19,18
49172,Vokxulsin,tichondrius,1139,shaman,enhancement,30,12,18
49173,Wagar,dawnbringer,1139,shaman,enhancement,36,12,24
49174,Corkrain,sargeras,1138,shaman,enhancement,30,12,18
49175,Sydstorm,frostmourne,1137,shaman,enhancement,18,12,6
49176,Beanerburst,frostwolf,1136,shaman,enhancement,48,26,22
49177,Ashida,stormrage,1129,shaman,enhancement,43,22,21
49178,Popz,dark-iron,1128,shaman,enhancement,18,12,6
49179,ßøn,altar-of-storms,1125,shaman,enhancement,33,16,17
49180,Astroglyde,emerald-dream,1123,shaman,enhancement,24,12,12
49181,Camdoc,destromath,1122,shaman,enhancement,53,24,29
49182,Skizzymars,malganis,1120,shaman,enhancement,30,12,18
49183,Lukora,stonemaul,1119,shaman,enhancement,18,12,6
49184,Ryb,sargeras,1119,shaman,enhancement,20,13,7
49185,Shøxic,perenolde,1118,shaman,enhancement,18,12,6
49186,Googurt,barthilas,1118,shaman,enhancement,23,12,11
49187,Drokron,azralon,1118,shaman,enhancement,48,23,25
49188,Cydarta,ragnaros,1117,shaman,enhancement,60,34,26
49189,Catiçero,azralon,1117,shaman,enhancement,30,12,18
49190,Floon,barthilas,1116,shaman,enhancement,66,27,39
49191,Schlemiel,barthilas,1112,shaman,enhancement,82,36,46
49192,Lassoway,illidan,1110,shaman,enhancement,30,12,18
49193,Golkork,quelthalas,1108,shaman,enhancement,24,13,11
49194,Blaçktide,thrall,1104,shaman,enhancement,26,16,10
49195,Shaminism,chromaggus,1103,shaman,enhancement,23,12,11
49196,Wigwog,hyjal,1102,shaman,enhancement,61,35,26
49197,Shayymann,exodar,1101,shaman,enhancement,60,28,32
49198,Robis,thrall,1096,shaman,enhancement,90,39,51
49199,Ahzar,stormrage,1093,shaman,enhancement,60,26,34
49200,Hazak,nemesis,1088,shaman,enhancement,78,39,39
49201,Oreahsham,tichondrius,1085,shaman,enhancement,30,12,18
49202,Karlpoppa,thunderhorn,1081,shaman,enhancement,30,17,13
49203,Kalashnikov,maiev,1081,shaman,enhancement,36,14,22
49204,Nîghtstalker,vashj,1081,shaman,enhancement,52,20,32
49205,Shammybreakx,malganis,1067,shaman,enhancement,74,43,31
49206,Lovetides,area-52,1060,shaman,enhancement,30,18,12
49207,Tekashi,muradin,1060,shaman,enhancement,31,12,19
49208,Okïòmó,proudmoore,1056,shaman,enhancement,18,11,7
49209,Gamergirlx,area-52,1056,shaman,enhancement,18,11,7
49210,Jyster,area-52,1056,shaman,enhancement,65,27,38
49211,Shambostik,thrall,1056,shaman,enhancement,36,13,23
49212,Shamawolf,stormrage,1055,shaman,enhancement,12,11,1
49213,Zelinsky,sargeras,1055,shaman,enhancement,18,11,7
49214,Jayes,zuljin,1055,shaman,enhancement,18,11,7
49215,Blöw,tichondrius,1055,shaman,enhancement,18,11,7
49216,Bigboorst,tichondrius,1055,shaman,enhancement,18,11,7
49217,Shampowl,jaedenar,1055,shaman,enhancement,30,11,19
49218,Möuthbläster,malganis,1054,shaman,enhancement,12,11,1
49219,Syraak,elune,1054,shaman,enhancement,15,12,3
49220,Fishsham,zuljin,1054,shaman,enhancement,18,11,7
49221,Totemclass,bleeding-hollow,1054,shaman,enhancement,18,11,7
49222,Jirig,tichondrius,1054,shaman,enhancement,18,11,7
49223,Kyrz,ragnaros,1054,shaman,enhancement,18,11,7
49224,Hagie,moon-guard,1053,shaman,enhancement,21,11,10
49225,Slowdown,malganis,1053,shaman,enhancement,30,11,19
49226,Windzorn,tichondrius,1052,shaman,enhancement,18,11,7
49227,Peepingtotem,tichondrius,1052,shaman,enhancement,24,11,13
49228,Buffdudé,illidan,1052,shaman,enhancement,24,11,13
49229,Kuull,thunderlord,1052,shaman,enhancement,30,11,19
49230,Faminex,dragonmaw,1051,shaman,enhancement,12,11,1
49231,Swapxylee,tichondrius,1051,shaman,enhancement,24,11,13
49232,Naesala,thunderlord,1050,shaman,enhancement,24,11,13
49233,Dronesum,tichondrius,1050,shaman,enhancement,24,11,13
49234,Scams,bleeding-hollow,1049,shaman,enhancement,30,18,12
49235,Grindl,stormrage,1047,shaman,enhancement,18,11,7
49236,Sparkqt,sargeras,1047,shaman,enhancement,18,11,7
49237,Emptyy,azralon,1047,shaman,enhancement,24,11,13
49238,Johnnygeh,stormrage,1047,shaman,enhancement,30,11,19
49239,Îvôry,bloodhoof,1046,shaman,enhancement,24,11,13
49240,Ctrlaltelite,burning-blade,1044,shaman,enhancement,76,30,46
49241,Svddëndëath,sargeras,1044,shaman,enhancement,72,27,45
49242,Jamblee,sargeras,1043,shaman,enhancement,18,11,7
49243,Cvoa,bonechewer,1043,shaman,enhancement,24,11,13
49244,Trulos,stormrage,1041,shaman,enhancement,18,11,7
49245,Thunderfuri,thrall,1037,shaman,enhancement,18,11,7
49246,Hannibol,tichondrius,1036,shaman,enhancement,72,25,47
49247,Allmeatie,hyjal,1035,shaman,enhancement,18,11,7
49248,Zalkran,area-52,1034,shaman,enhancement,24,15,9
49249,Currentx,darkspear,1030,shaman,enhancement,33,12,21
49250,Goondruka,area-52,1023,shaman,enhancement,20,12,8
49251,Bigbólts,emerald-dream,1021,shaman,enhancement,20,13,7
49252,Felbrick,area-52,1021,shaman,enhancement,36,18,18
49253,Morderus,aegwynn,1021,shaman,enhancement,24,11,13
49254,Tøtëm,tichondrius,1021,shaman,enhancement,28,12,16
49255,Facebooksux,sargeras,1019,shaman,enhancement,18,13,5
49256,Dizzytotem,dalaran,1013,shaman,enhancement,30,17,13
49257,Pùffball,anvilmar,1011,shaman,enhancement,75,38,37
49258,Xapoxy,nemesis,1008,shaman,enhancement,20,12,8
49259,Rhagnar,warsong,1004,shaman,enhancement,17,11,6
49260,Dedlystorm,dalaran,1003,shaman,enhancement,18,12,6
49261,PlayerJRRTZR,tichondrius,1002,shaman,enhancement,23,11,12
49262,Stroheim,warsong,1000,shaman,enhancement,21,12,9
49263,Poseidonxd,lightbringer,1000,shaman,enhancement,23,13,10
49264,Korgen,area-52,999,shaman,enhancement,25,12,13
49265,Bloodytotemz,emerald-dream,999,shaman,enhancement,24,11,13
49266,Slaughterdog,coilfang,995,shaman,enhancement,22,13,9
49267,Prinkipíssa,tichondrius,995,shaman,enhancement,48,22,26
49268,Reavs,illidan,995,shaman,enhancement,40,12,28
49269,Synshenrongt,thrall,990,shaman,enhancement,178,70,108
49270,Pwnôgraphy,kelthuzad,989,shaman,enhancement,14,11,3
49271,Zelzus,moon-guard,989,shaman,enhancement,22,11,11
49272,Megumi,aggramar,988,shaman,enhancement,26,11,15
49273,Deckìn,proudmoore,987,shaman,enhancement,14,11,3
49274,Mudpwet,borean-tundra,982,shaman,enhancement,54,30,24
49275,Shamvandám,kiljaeden,978,shaman,enhancement,30,13,17
49276,Stormwolf,azjolnerub,976,shaman,enhancement,60,30,30
49277,Kyness,area-52,963,shaman,enhancement,31,17,14
49278,Violat,area-52,960,shaman,enhancement,12,10,2
49279,Enhance,sargeras,960,shaman,enhancement,18,10,8
49280,Zatchbell,lightnings-blade,960,shaman,enhancement,30,13,17
49281,Lokrath,zangarmarsh,959,shaman,enhancement,12,10,2
49282,Pikachil,tichondrius,959,shaman,enhancement,15,11,4
49283,Electrik,stormrage,959,shaman,enhancement,18,10,8
49284,Anlukla,gilneas,959,shaman,enhancement,18,10,8
49285,Daddyzmilk,bleeding-hollow,959,shaman,enhancement,18,10,8
49286,Kumboi,frostmourne,959,shaman,enhancement,24,10,14
49287,Ambevsulfr,deathwing,958,shaman,enhancement,12,10,2
49288,Igarmaul,bonechewer,958,shaman,enhancement,18,10,8
49289,Marginalized,tichondrius,958,shaman,enhancement,18,10,8
49290,Ggsggs,akama,958,shaman,enhancement,18,10,8
49291,Jimorrison,wyrmrest-accord,958,shaman,enhancement,18,10,8
49292,Thoramgar,malganis,958,shaman,enhancement,18,10,8
49293,Kelce,stormrage,958,shaman,enhancement,18,10,8
49294,Evidence,thrall,958,shaman,enhancement,18,10,8
49295,Stormsanta,emerald-dream,958,shaman,enhancement,24,10,14
49296,Chesos,tichondrius,958,shaman,enhancement,90,33,57
49297,Chavezlives,area-52,957,shaman,enhancement,18,10,8
49298,Leotis,tichondrius,957,shaman,enhancement,18,10,8
49299,Ffaísca,azralon,956,shaman,enhancement,12,10,2
49300,Keroh,blackrock,956,shaman,enhancement,18,10,8
49301,Azl,guldan,956,shaman,enhancement,27,11,16
49302,Tukkutz,moon-guard,955,shaman,enhancement,48,19,29
49303,Aelpian,emerald-dream,954,shaman,enhancement,18,10,8
49304,Smokedemtree,stormrage,954,shaman,enhancement,18,10,8
49305,Painfury,zuljin,954,shaman,enhancement,18,10,8
49306,Ryntyntyn,blood-furnace,954,shaman,enhancement,24,10,14
49307,Shomminn,tichondrius,953,shaman,enhancement,18,10,8
49308,Rhez,frostmourne,951,shaman,enhancement,24,10,14
49309,Mcgraff,frostmourne,949,shaman,enhancement,18,10,8
49310,Loec,thrall,947,shaman,enhancement,18,10,8
49311,Esko,magtheridon,943,shaman,enhancement,24,10,14
49312,Thanwirn,ragnaros,932,shaman,enhancement,42,19,23
49313,Orfelix,nemesis,925,shaman,enhancement,42,17,25
49314,Zandya,nemesis,924,shaman,enhancement,30,10,20
49315,Golozok,zuljin,923,shaman,enhancement,22,12,10
49316,Wälee,sargeras,921,shaman,enhancement,18,10,8
49317,Gammacide,sargeras,921,shaman,enhancement,29,10,19
49318,Oct,thrall,912,shaman,enhancement,36,18,18
49319,Shockshack,illidan,911,shaman,enhancement,17,10,7
49320,Grimlên,skullcrusher,910,shaman,enhancement,32,12,20
49321,Duality,shattered-halls,909,shaman,enhancement,23,10,13
49322,Garabashi,boulderfist,908,shaman,enhancement,24,11,13
49323,Thanen,the-scryers,897,shaman,enhancement,48,21,27
49324,Bqo,nemesis,892,shaman,enhancement,14,10,4
49325,Icedogg,malganis,889,shaman,enhancement,42,20,22
49326,Poagrious,bonechewer,876,shaman,enhancement,40,17,23
49327,Vekku,ragnaros,872,shaman,enhancement,19,10,9
49328,Fiercegoblin,drakkari,866,shaman,enhancement,25,10,15
49329,Shakazz,malganis,864,shaman,enhancement,12,9,3
49330,Elefusion,sargeras,864,shaman,enhancement,12,9,3
49331,Kaandel,nemesis,864,shaman,enhancement,12,9,3
49332,Mílkthis,tichondrius,864,shaman,enhancement,12,9,3
49333,Conorfotm,tichondrius,864,shaman,enhancement,12,9,3
49334,Twotapped,sargeras,864,shaman,enhancement,12,9,3
49335,Frantìk,tichondrius,864,shaman,enhancement,12,9,3
49336,Raídyn,sargeras,864,shaman,enhancement,12,9,3
49337,Solbis,tichondrius,864,shaman,enhancement,12,9,3
49338,Gódsgíft,tichondrius,864,shaman,enhancement,18,9,9
49339,Shlongers,illidan,864,shaman,enhancement,18,9,9
49340,Yejinok,tichondrius,864,shaman,enhancement,18,9,9
49341,Luluzada,azralon,864,shaman,enhancement,18,9,9
49342,Sethbrogen,vashj,864,shaman,enhancement,24,9,15
49343,Lickerman,stormreaver,863,shaman,enhancement,12,9,3
49344,Thicctotes,tichondrius,863,shaman,enhancement,12,9,3
49345,Crnosham,area-52,863,shaman,enhancement,12,9,3
49346,Cluffatty,tichondrius,863,shaman,enhancement,12,9,3
49347,Biggem,nazjatar,863,shaman,enhancement,18,9,9
49348,Flukz,nazjatar,863,shaman,enhancement,18,9,9
49349,Dreamers,anvilmar,863,shaman,enhancement,18,9,9
49350,Sluggox,bleeding-hollow,863,shaman,enhancement,18,9,9
49351,Rubious,cenarius,863,shaman,enhancement,19,9,10
49352,Okkoto,malfurion,862,shaman,enhancement,12,9,3
49353,Kakiscala,proudmoore,862,shaman,enhancement,17,9,8
49354,Murdokr,quelthalas,862,shaman,enhancement,18,9,9
49355,Stankydad,tichondrius,862,shaman,enhancement,18,9,9
49356,Bioshocked,korgath,862,shaman,enhancement,18,9,9
49357,Bjôrn,bonechewer,862,shaman,enhancement,18,9,9
49358,Kelx,stormreaver,862,shaman,enhancement,36,9,27
49359,Chiëfslapaho,tichondrius,861,shaman,enhancement,12,9,3
49360,Gorgrom,thunderlord,861,shaman,enhancement,12,9,3
49361,Nuofu,illidan,861,shaman,enhancement,22,10,12
49362,Bargen,thunderlord,860,shaman,enhancement,12,9,3
49363,Hoann,tichondrius,860,shaman,enhancement,18,9,9
49364,Shocksqt,malganis,860,shaman,enhancement,24,9,15
49365,Schnellhund,tichondrius,859,shaman,enhancement,18,9,9
49366,Bôjack,stormrage,858,shaman,enhancement,12,9,3
49367,Denki,nesingwary,858,shaman,enhancement,18,9,9
49368,Hazorele,nagrand,857,shaman,enhancement,18,9,9
49369,Mydus,kiljaeden,855,shaman,enhancement,18,9,9
49370,Bilbobaggenz,sargeras,854,shaman,enhancement,18,9,9
49371,Windfuryshm,emerald-dream,853,shaman,enhancement,18,9,9
49372,Cdont,zuljin,853,shaman,enhancement,18,9,9
49373,Srgarrobo,drakkari,850,shaman,enhancement,30,14,16
49374,Halajo,thrall,849,shaman,enhancement,27,10,17
49375,Catchclause,eonar,846,shaman,enhancement,18,10,8
49376,Ongruge,hyjal,846,shaman,enhancement,83,33,50
49377,Charr,nemesis,838,shaman,enhancement,18,9,9
49378,Columan,frostmourne,834,shaman,enhancement,137,68,69
49379,Scherzer,frostwolf,831,shaman,enhancement,20,10,10
49380,Grosgars,burning-blade,830,shaman,enhancement,20,10,10
49381,Relyts,tichondrius,825,shaman,enhancement,24,11,13
49382,Britisy,stormrage,825,shaman,enhancement,24,10,14
49383,Sharmut,bleeding-hollow,816,shaman,enhancement,21,10,11
49384,Azzula,tichondrius,809,shaman,enhancement,25,10,15
49385,Maicer,goldrinn,809,shaman,enhancement,35,9,26
49386,Gesundrian,kelthuzad,800,shaman,enhancement,16,9,7
49387,Notglads,thrall,799,shaman,enhancement,14,9,5
49388,Thorael,borean-tundra,798,shaman,enhancement,11,9,2
49389,Shamtopus,anubarak,798,shaman,enhancement,17,9,8
49390,Slumb,stormrage,781,shaman,enhancement,19,9,10
49391,Jamz,lightbringer,768,shaman,enhancement,12,8,4
49392,Ennoku,khadgar,768,shaman,enhancement,12,8,4
49393,Plznostepmom,tichondrius,768,shaman,enhancement,12,8,4
49394,Humiliated,stormrage,768,shaman,enhancement,12,8,4
49395,Onamakawash,black-dragonflight,768,shaman,enhancement,12,8,4
49396,Aceventuura,hyjal,768,shaman,enhancement,12,8,4
49397,Mazaar,kul-tiras,768,shaman,enhancement,12,8,4
49398,Cinderfury,magtheridon,768,shaman,enhancement,12,8,4
49399,Illchayqt,frostmourne,768,shaman,enhancement,12,8,4
49400,Botu,malorne,768,shaman,enhancement,12,8,4
49401,Jelebeans,tichondrius,768,shaman,enhancement,12,8,4
49402,Còsmos,illidan,768,shaman,enhancement,12,8,4
49403,Lindsanx,illidan,768,shaman,enhancement,18,8,10
49404,Neeman,malganis,768,shaman,enhancement,18,8,10
49405,Mastrioni,dragonmaw,768,shaman,enhancement,18,8,10
49406,Athropos,malganis,768,shaman,enhancement,18,8,10
49407,Muyg,staghelm,768,shaman,enhancement,24,8,16
49408,Nekorii,bleeding-hollow,767,shaman,enhancement,12,8,4
49409,Barrakum,darrowmere,767,shaman,enhancement,12,8,4
49410,Zunjix,tichondrius,767,shaman,enhancement,12,8,4
49411,Elevatezxo,stormrage,767,shaman,enhancement,12,8,4
49412,Troon,lightbringer,767,shaman,enhancement,12,8,4
49413,Lohnash,area-52,767,shaman,enhancement,12,8,4
49414,Xamaobomberø,azralon,767,shaman,enhancement,12,8,4
49415,Dontbeshockd,nagrand,767,shaman,enhancement,14,8,6
49416,Obombyas,sargeras,767,shaman,enhancement,18,8,10
49417,Finaplex,spirestone,767,shaman,enhancement,18,8,10
49418,Cuban,kelthuzad,767,shaman,enhancement,18,8,10
49419,Doughchino,darkspear,767,shaman,enhancement,18,8,10
49420,Lamorandrict,icecrown,767,shaman,enhancement,18,8,10
49421,Suejitsue,malganis,767,shaman,enhancement,18,8,10
49422,Jags,baelgun,767,shaman,enhancement,18,8,10
49423,Wæver,tichondrius,767,shaman,enhancement,18,8,10
49424,Volrog,magtheridon,767,shaman,enhancement,18,8,10
49425,Beast,mannoroth,767,shaman,enhancement,18,8,10
49426,Loliqueenfae,illidan,767,shaman,enhancement,18,8,10
49427,Cutedraenei,destromath,767,shaman,enhancement,24,8,16
49428,Reptimus,sargeras,767,shaman,enhancement,24,8,16
49429,Pipers,frostmourne,767,shaman,enhancement,30,8,22
49430,Bigtotempole,stormreaver,766,shaman,enhancement,12,8,4
49431,Chamxz,ragnaros,766,shaman,enhancement,12,8,4
49432,Xhenra,proudmoore,766,shaman,enhancement,12,8,4
49433,Adhdeeznuts,frostmourne,766,shaman,enhancement,18,8,10
49434,Gluestick,shadowmoon,766,shaman,enhancement,24,8,16
49435,Weatherboy,dalaran,765,shaman,enhancement,18,8,10
49436,Jonatasele,stormrage,765,shaman,enhancement,24,8,16
49437,Beul,wyrmrest-accord,764,shaman,enhancement,18,8,10
49438,Shaminja,kiljaeden,763,shaman,enhancement,12,8,4
49439,Meatballman,malganis,763,shaman,enhancement,24,8,16
49440,Endme,zuljin,758,shaman,enhancement,12,8,4
49441,Orendail,jubeithos,758,shaman,enhancement,24,8,16
49442,Rocktor,alleria,757,shaman,enhancement,12,8,4
49443,Shimshak,destromath,756,shaman,enhancement,18,8,10
49444,Kumu,stormscale,735,shaman,enhancement,11,8,3
49445,Morgoph,bleeding-hollow,735,shaman,enhancement,14,9,5
49446,Rakfnaruk,zuljin,735,shaman,enhancement,16,8,8
49447,Radan,kelthuzad,735,shaman,enhancement,17,8,9
49448,Darshidarsh,emerald-dream,735,shaman,enhancement,22,8,14
49449,Emaric,sargeras,735,shaman,enhancement,23,8,15
49450,Vinara,drenden,732,shaman,enhancement,18,8,10
49451,Omnipresent,malganis,719,shaman,enhancement,17,8,9
49452,Succies,emerald-dream,719,shaman,enhancement,17,8,9
49453,Blackshami,quelthalas,718,shaman,enhancement,18,8,10
49454,Shockedya,destromath,714,shaman,enhancement,23,10,13
49455,Pwnskillz,area-52,712,shaman,enhancement,17,8,9
49456,Hammerdog,illidan,703,shaman,enhancement,16,8,8
49457,Paulenia,quelthalas,699,shaman,enhancement,29,8,21
49458,Õhmÿ,emerald-dream,687,shaman,enhancement,11,8,3
49459,Grìmlock,lightbringer,687,shaman,enhancement,13,8,5
49460,Eimear,kelthuzad,672,shaman,enhancement,12,7,5
49461,Akwar,greymane,672,shaman,enhancement,12,7,5
49462,Shòckaholic,bleeding-hollow,672,shaman,enhancement,12,7,5
49463,Wojnar,zuljin,672,shaman,enhancement,12,7,5
49464,Olujakal,emerald-dream,672,shaman,enhancement,12,7,5
49465,Battleimp,kelthuzad,672,shaman,enhancement,12,7,5
49466,Windführer,illidan,672,shaman,enhancement,12,7,5
49467,Vlal,tichondrius,672,shaman,enhancement,12,7,5
49468,Oneripemango,illidan,672,shaman,enhancement,12,7,5
49469,Zapstrike,stormrage,672,shaman,enhancement,12,7,5
49470,Bawkbagawk,bleeding-hollow,672,shaman,enhancement,12,7,5
49471,Asy,tichondrius,672,shaman,enhancement,12,7,5
49472,Yaytotems,sargeras,672,shaman,enhancement,12,7,5
49473,Lïnc,sargeras,672,shaman,enhancement,12,7,5
49474,Dwârf,tichondrius,672,shaman,enhancement,12,7,5
49475,Lavalinks,malganis,672,shaman,enhancement,12,7,5
49476,Sourcreamqtx,stormrage,672,shaman,enhancement,12,7,5
49477,Ogsmolsham,zuljin,672,shaman,enhancement,12,7,5
49478,Skylîne,sargeras,672,shaman,enhancement,12,7,5
49479,Xoxoxø,area-52,672,shaman,enhancement,12,7,5
49480,Mattzander,kiljaeden,672,shaman,enhancement,12,7,5
49481,Ftp,kelthuzad,672,shaman,enhancement,12,7,5
49482,Ceromental,frostmane,672,shaman,enhancement,12,7,5
49483,Yungcreampie,bleeding-hollow,672,shaman,enhancement,18,7,11
49484,Ayahuaskah,illidan,672,shaman,enhancement,18,7,11
49485,Jeuno,gnomeregan,672,shaman,enhancement,18,7,11
49486,Kidkovid,illidan,672,shaman,enhancement,18,7,11
49487,Raywhiter,tichondrius,672,shaman,enhancement,22,8,14
49488,Yudo,stormrage,672,shaman,enhancement,24,7,17
49489,Hexondabeach,barthilas,671,shaman,enhancement,12,7,5
49490,Ayahuaska,darkspear,671,shaman,enhancement,12,7,5
49491,Gonarosh,area-52,671,shaman,enhancement,12,7,5
49492,Jigawatt,doomhammer,671,shaman,enhancement,12,7,5
49493,Thiccpedro,andorhal,671,shaman,enhancement,12,7,5
49494,Jènova,whisperwind,671,shaman,enhancement,12,7,5
49495,Hypersomnia,icecrown,671,shaman,enhancement,12,7,5
49496,Killercam,maiev,671,shaman,enhancement,12,7,5
49497,Murm,burning-blade,671,shaman,enhancement,12,7,5
49498,Checkmâte,emerald-dream,671,shaman,enhancement,12,7,5
49499,Garshok,tichondrius,671,shaman,enhancement,12,7,5
49500,Nondracil,ragnaros,671,shaman,enhancement,18,7,11
49501,Gwyste,moon-guard,671,shaman,enhancement,18,7,11
49502,Hellothere,drenden,671,shaman,enhancement,18,7,11
49503,Enhancee,bonechewer,671,shaman,enhancement,18,7,11
49504,Atlli,zuljin,671,shaman,enhancement,18,7,11
49505,Coronavirrus,hydraxis,671,shaman,enhancement,18,7,11
49506,Jëks,azjolnerub,671,shaman,enhancement,18,7,11
49507,Sâxman,stormreaver,671,shaman,enhancement,18,7,11
49508,Hroth,tanaris,671,shaman,enhancement,18,7,11
49509,Wickyz,moon-guard,671,shaman,enhancement,18,7,11
49510,Hrotah,wyrmrest-accord,671,shaman,enhancement,18,7,11
49511,Zald,shattered-halls,671,shaman,enhancement,18,7,11
49512,Wildslammer,khazgoroth,671,shaman,enhancement,18,7,11
49513,Velekar,moon-guard,671,shaman,enhancement,21,8,13
49514,Hablarocas,ragnaros,671,shaman,enhancement,24,7,17
49515,Radiology,garithos,670,shaman,enhancement,12,7,5
49516,Drewshammy,zuljin,670,shaman,enhancement,12,7,5
49517,Morehammeerr,thunderlord,670,shaman,enhancement,12,7,5
49518,Spankì,kelthuzad,670,shaman,enhancement,12,7,5
49519,Orcgirth,kiljaeden,670,shaman,enhancement,21,8,13
49520,Hexoffénder,tichondrius,669,shaman,enhancement,9,8,1
49521,Thunderod,destromath,669,shaman,enhancement,12,7,5
49522,Vladd,hellscream,669,shaman,enhancement,18,7,11
49523,Motylek,ragnaros,669,shaman,enhancement,18,7,11
49524,Helljumper,illidan,669,shaman,enhancement,21,8,13
49525,Zeebouzy,illidan,669,shaman,enhancement,21,8,13
49526,Mugnar,alleria,669,shaman,enhancement,24,7,17
49527,Jacniclstorm,frostmourne,668,shaman,enhancement,12,7,5
49528,Funkyshock,dalaran,667,shaman,enhancement,18,7,11
49529,Karisaatara,moon-guard,665,shaman,enhancement,15,8,7
49530,Gbankzz,ghostlands,664,shaman,enhancement,24,7,17
49531,Lobovulpino,quelthalas,663,shaman,enhancement,12,7,5
49532,Shammich,vashj,655,shaman,enhancement,11,7,4
49533,Speedmonster,hellscream,655,shaman,enhancement,19,8,11
49534,Shablam,daggerspine,640,shaman,enhancement,28,7,21
49535,Creamcheeser,tichondrius,639,shaman,enhancement,11,7,4
49536,Fligmos,llane,639,shaman,enhancement,20,8,12
49537,Shampainn,demon-soul,638,shaman,enhancement,20,8,12
49538,Cram,frostmourne,638,shaman,enhancement,23,7,16
49539,Heaties,tichondrius,623,shaman,enhancement,11,7,4
49540,Smeeza,frostmourne,617,shaman,enhancement,21,9,12
49541,Intress,moon-guard,607,shaman,enhancement,10,7,3
49542,Eanne,moon-guard,592,shaman,enhancement,19,7,12
49543,Vuduü,stormrage,576,shaman,enhancement,6,6,0
49544,Meadamemnon,tichondrius,576,shaman,enhancement,6,6,0
49545,Dånydevito,moonrunner,576,shaman,enhancement,6,6,0
49546,Chachmon,ursin,576,shaman,enhancement,6,6,0
49547,Clear,darkspear,576,shaman,enhancement,6,6,0
49548,Mèrkk,misha,576,shaman,enhancement,6,6,0
49549,Ftierspec,frostmourne,576,shaman,enhancement,6,6,0
49550,Shockpanda,zuljin,576,shaman,enhancement,6,6,0
49551,Shamane,onyxia,576,shaman,enhancement,6,6,0
49552,Spotbeard,shadowsong,576,shaman,enhancement,6,6,0
49553,Pikoom,tichondrius,576,shaman,enhancement,6,6,0
49554,Mcumshot,ragnaros,576,shaman,enhancement,12,6,6
49555,Stormdancer,elune,576,shaman,enhancement,12,6,6
49556,Stylebenderx,frostmourne,576,shaman,enhancement,12,6,6
49557,Fischerman,barthilas,576,shaman,enhancement,12,6,6
49558,Orkshammy,illidan,576,shaman,enhancement,12,6,6
49559,Uggoluga,dalaran,576,shaman,enhancement,12,6,6
49560,Agpx,tichondrius,576,shaman,enhancement,12,6,6
49561,Kêtchpup,wyrmrest-accord,576,shaman,enhancement,12,6,6
49562,Cooperation,kelthuzad,576,shaman,enhancement,12,6,6
49563,Nyvka,ragnaros,576,shaman,enhancement,12,6,6
49564,Skrankles,illidan,576,shaman,enhancement,12,6,6
49565,Onlyfanslink,darkspear,576,shaman,enhancement,12,6,6
49566,Kyzen,tichondrius,576,shaman,enhancement,12,6,6
49567,Strønklesøn,drakthul,576,shaman,enhancement,12,6,6
49568,Crucybletv,korgath,576,shaman,enhancement,12,6,6
49569,Måståçåstå,bleeding-hollow,576,shaman,enhancement,12,6,6
49570,Owtyobwol,area-52,576,shaman,enhancement,12,6,6
49571,Coraamia,nerzhul,576,shaman,enhancement,12,6,6
49572,Scarlo,bleeding-hollow,576,shaman,enhancement,12,6,6
49573,Karagra,tichondrius,576,shaman,enhancement,12,6,6
49574,Blazefury,stormrage,576,shaman,enhancement,12,6,6
49575,Firetrucks,area-52,576,shaman,enhancement,12,6,6
49576,Xaspen,skullcrusher,576,shaman,enhancement,12,6,6
49577,Enhpower,area-52,576,shaman,enhancement,12,6,6
49578,Gamba,kargath,576,shaman,enhancement,12,6,6
49579,Thunderøus,stormrage,576,shaman,enhancement,12,6,6
49580,Hruggol,bleeding-hollow,576,shaman,enhancement,12,6,6
49581,Stnky,cairne,576,shaman,enhancement,12,6,6
49582,Dtrumpx,tichondrius,576,shaman,enhancement,12,6,6
49583,Cptsnarf,tichondrius,576,shaman,enhancement,12,6,6
49584,Bussybutter,sargeras,576,shaman,enhancement,12,6,6
49585,Trashcam,illidan,576,shaman,enhancement,12,6,6
49586,Neuralînk,tichondrius,576,shaman,enhancement,15,7,8
49587,Unrezolved,hyjal,576,shaman,enhancement,13,6,7
49588,Groovesh,thrall,576,shaman,enhancement,14,6,8
49589,Ikiteforlsd,zuljin,576,shaman,enhancement,14,6,8
49590,Washedupty,illidan,576,shaman,enhancement,18,6,12
49591,Ferdashock,tichondrius,576,shaman,enhancement,18,6,12
49592,Earthclap,tichondrius,576,shaman,enhancement,24,6,18
49593,Somethingdop,sargeras,575,shaman,enhancement,12,6,6
49594,Argues,tichondrius,575,shaman,enhancement,12,6,6
49595,Royvaz,guldan,575,shaman,enhancement,12,6,6
49596,Darkvx,quelthalas,575,shaman,enhancement,12,6,6
49597,Naextramus,ragnaros,575,shaman,enhancement,12,6,6
49598,Tumble,barthilas,575,shaman,enhancement,12,6,6
49599,Oaktar,bleeding-hollow,575,shaman,enhancement,12,6,6
49600,Dacota,emerald-dream,575,shaman,enhancement,12,6,6
49601,Eternalife,khazgoroth,575,shaman,enhancement,12,6,6
49602,Gingeroo,stonemaul,575,shaman,enhancement,12,6,6
49603,Frèya,uldaman,575,shaman,enhancement,12,6,6
49604,Fevolution,dreadmaul,575,shaman,enhancement,12,6,6
49605,Kobeshio,destromath,575,shaman,enhancement,21,7,14
49606,Møp,spirestone,575,shaman,enhancement,18,6,12
49607,Regeneration,darkspear,575,shaman,enhancement,18,6,12
49608,Rockbass,sargeras,575,shaman,enhancement,18,6,12
49609,Zentius,thunderhorn,575,shaman,enhancement,18,6,12
49610,Sartikiria,wyrmrest-accord,575,shaman,enhancement,18,6,12
49611,Ummyea,dreadmaul,574,shaman,enhancement,12,6,6
49612,Okdopey,area-52,574,shaman,enhancement,18,6,12
49613,Størmbreäker,tichondrius,572,shaman,enhancement,12,6,6
49614,Hazreti,zuljin,572,shaman,enhancement,18,6,12
49615,Fadesrp,moon-guard,571,shaman,enhancement,12,6,6
49616,Kylnadra,silvermoon,571,shaman,enhancement,12,6,6
49617,Ðg,tichondrius,569,shaman,enhancement,18,6,12
49618,Maxsimiliano,emerald-dream,559,shaman,enhancement,18,6,12
49619,Rykutu,lightbringer,544,shaman,enhancement,10,7,3
49620,Meshrek,tichondrius,543,shaman,enhancement,11,6,5
49621,Toastsshaman,tichondrius,528,shaman,enhancement,9,6,3
49622,Partypurge,malganis,527,shaman,enhancement,11,6,5
49623,Boozecruz,silvermoon,527,shaman,enhancement,11,6,5
49624,Noveske,arthas,522,shaman,enhancement,15,7,8
49625,Ayangat,darkspear,511,shaman,enhancement,10,6,4
49626,Beelzeburst,sargeras,511,shaman,enhancement,11,6,5
49627,Streetacus,tichondrius,510,shaman,enhancement,20,6,14
49628,Dangguagua,illidan,480,shaman,enhancement,6,5,1
49629,Krunggar,azralon,480,shaman,enhancement,6,5,1
49630,Bluepenguin,kelthuzad,480,shaman,enhancement,6,5,1
49631,Arrok,bleeding-hollow,480,shaman,enhancement,6,5,1
49632,Remi,tichondrius,480,shaman,enhancement,6,5,1
49633,Iava,dalaran,480,shaman,enhancement,6,5,1
49634,Tremordrfear,lightbringer,480,shaman,enhancement,6,5,1
49635,Dörnèr,malganis,480,shaman,enhancement,6,5,1
49636,Fwap,bleeding-hollow,480,shaman,enhancement,6,5,1
49637,Guybeingdude,sargeras,480,shaman,enhancement,6,5,1
49638,Rokudo,dragonmaw,480,shaman,enhancement,6,5,1
49639,Taintvapor,stormrage,480,shaman,enhancement,6,5,1
49640,Bofah,draktharon,480,shaman,enhancement,6,5,1
49641,Zappiiboii,malganis,480,shaman,enhancement,6,5,1
49642,Beatmán,blades-edge,480,shaman,enhancement,6,5,1
49643,Durkh,ragnaros,480,shaman,enhancement,6,5,1
49644,Mynigabob,zuljin,480,shaman,enhancement,6,5,1
49645,Wugmuk,illidan,480,shaman,enhancement,6,5,1
49646,Seraøth,area-52,480,shaman,enhancement,6,5,1
49647,Nakamora,tichondrius,480,shaman,enhancement,6,5,1
49648,Setek,barthilas,480,shaman,enhancement,6,5,1
49649,Tekdar,kiljaeden,480,shaman,enhancement,10,6,4
49650,Gohsham,hyjal,480,shaman,enhancement,12,5,7
49651,Kamisenhance,illidan,480,shaman,enhancement,12,5,7
49652,Sleepysham,anubarak,480,shaman,enhancement,12,5,7
49653,Keltarget,malganis,480,shaman,enhancement,12,5,7
49654,Meatlog,dalaran,480,shaman,enhancement,12,5,7
49655,Berasham,aerie-peak,480,shaman,enhancement,12,5,7
49656,Osunutai,ragnaros,480,shaman,enhancement,12,5,7
49657,Mustachex,kelthuzad,480,shaman,enhancement,12,5,7
49658,Mawcus,zuljin,480,shaman,enhancement,12,5,7
49659,Tótemicotl,quelthalas,480,shaman,enhancement,12,5,7
49660,Macumbolo,nemesis,480,shaman,enhancement,12,5,7
49661,Rabbitlol,tichondrius,480,shaman,enhancement,12,5,7
49662,Killamanjaro,alterac-mountains,480,shaman,enhancement,12,5,7
49663,Hornyratchet,bleeding-hollow,480,shaman,enhancement,12,5,7
49664,Electrikz,moonrunner,480,shaman,enhancement,12,5,7
49665,Kultirio,quelthalas,480,shaman,enhancement,12,5,7
49666,Scrototæm,area-52,480,shaman,enhancement,12,5,7
49667,Sèktor,dalaran,480,shaman,enhancement,12,5,7
49668,Spencesham,sargeras,480,shaman,enhancement,12,5,7
49669,Tiostroke,stormrage,480,shaman,enhancement,12,5,7
49670,Dennwoop,sargeras,480,shaman,enhancement,12,5,7
49671,Gorehouse,kiljaeden,480,shaman,enhancement,12,5,7
49672,Nordstorm,stormrage,480,shaman,enhancement,12,5,7
49673,Choquinho,azralon,480,shaman,enhancement,12,5,7
49674,Shango,kalecgos,480,shaman,enhancement,12,5,7
49675,Jorgim,frostmourne,480,shaman,enhancement,12,5,7
49676,Waterground,tichondrius,480,shaman,enhancement,12,5,7
49677,Laquica,sargeras,480,shaman,enhancement,12,5,7
49678,Bôrghâ,sargeras,480,shaman,enhancement,12,5,7
49679,Indaka,kiljaeden,480,shaman,enhancement,12,5,7
49680,Kwizal,stormrage,480,shaman,enhancement,12,5,7
49681,Capivarãão,stormrage,480,shaman,enhancement,12,5,7
49682,Matzahmeal,skywall,480,shaman,enhancement,12,5,7
49683,Gyokuken,stormrage,480,shaman,enhancement,18,5,13
49684,Fíren,area-52,480,shaman,enhancement,18,5,13
49685,Zarzlek,destromath,480,shaman,enhancement,25,5,20
49686,Wokoe,tichondrius,479,shaman,enhancement,6,5,1
49687,Tugnar,ragnaros,479,shaman,enhancement,12,5,7
49688,Dushkanar,barthilas,479,shaman,enhancement,12,5,7
49689,Bwandamian,emerald-dream,479,shaman,enhancement,12,5,7
49690,Böc,tichondrius,479,shaman,enhancement,12,5,7
49691,Youngthùg,frostmourne,479,shaman,enhancement,18,5,13
49692,Aegaeonlol,tichondrius,479,shaman,enhancement,18,5,13
49693,Tirtok,laughing-skull,479,shaman,enhancement,18,5,13
49694,Brorogan,aerie-peak,478,shaman,enhancement,12,5,7
49695,Ellynnu,frostmourne,478,shaman,enhancement,12,5,7
49696,Flie,tichondrius,478,shaman,enhancement,18,5,13
49697,Enkkiz,ragnaros,477,shaman,enhancement,12,5,7
49698,Curtrex,amanthul,472,shaman,enhancement,19,8,11
49699,Grogakk,moon-guard,447,shaman,enhancement,12,6,6
49700,Shazikial,illidan,447,shaman,enhancement,11,5,6
49701,Jazzyy,korgath,447,shaman,enhancement,11,5,6
49702,Flamestrife,illidan,426,shaman,enhancement,28,8,20
49703,Totojar,alexstrasza,426,shaman,enhancement,22,6,16
49704,Furiousnick,stormrage,415,shaman,enhancement,8,5,3
49705,Rykku,illidan,400,shaman,enhancement,7,5,2
49706,Bigbb,tichondrius,400,shaman,enhancement,10,6,4
49707,Touchovlife,dragonblight,384,shaman,enhancement,6,4,2
49708,Protoaster,tichondrius,384,shaman,enhancement,6,4,2
49709,Ezzroz,guldan,384,shaman,enhancement,6,4,2
49710,Skybender,silvermoon,384,shaman,enhancement,6,4,2
49711,Meramin,illidan,384,shaman,enhancement,6,4,2
49712,Sorgal,area-52,384,shaman,enhancement,6,4,2
49713,Tokyotimxxo,malganis,384,shaman,enhancement,6,4,2
49714,Bigboyjones,thrall,384,shaman,enhancement,6,4,2
49715,Thegil,tichondrius,384,shaman,enhancement,6,4,2
49716,Donogal,aerie-peak,384,shaman,enhancement,6,4,2
49717,Drmn,frostmourne,384,shaman,enhancement,6,4,2
49718,Elemastery,windrunner,384,shaman,enhancement,6,4,2
49719,Urao,stormrage,384,shaman,enhancement,6,4,2
49720,Wools,frostmourne,384,shaman,enhancement,6,4,2
49721,Anime,azralon,384,shaman,enhancement,6,4,2
49722,Utilitytotem,moon-guard,384,shaman,enhancement,6,4,2
49723,Drugdòér,tichondrius,384,shaman,enhancement,6,4,2
49724,Stormysteve,hyjal,384,shaman,enhancement,6,4,2
49725,Heavy,ragnaros,384,shaman,enhancement,6,4,2
49726,Dingfu,sargeras,384,shaman,enhancement,6,4,2
49727,Omomo,shadowmoon,384,shaman,enhancement,6,4,2
49728,Slurslinger,area-52,384,shaman,enhancement,6,4,2
49729,Birkenshock,tichondrius,384,shaman,enhancement,6,4,2
49730,Angrytotems,ragnaros,384,shaman,enhancement,6,4,2
49731,Crowingraven,queldorei,384,shaman,enhancement,6,4,2
49732,Kylani,thrall,384,shaman,enhancement,6,4,2
49733,Wheath,tichondrius,384,shaman,enhancement,6,4,2
49734,Kisseyfaçaí,kelthuzad,384,shaman,enhancement,6,4,2
49735,Goldshîre,tichondrius,384,shaman,enhancement,6,4,2
49736,Bronzers,tichondrius,384,shaman,enhancement,6,4,2
49737,Mastrionilol,dragonmaw,384,shaman,enhancement,6,4,2
49738,Orcswole,tichondrius,384,shaman,enhancement,6,4,2
49739,Grimwind,tichondrius,384,shaman,enhancement,6,4,2
49740,Skipler,stormrage,384,shaman,enhancement,6,4,2
49741,Aureal,malganis,384,shaman,enhancement,6,4,2
49742,Eleshortal,azuremyst,384,shaman,enhancement,9,4,5
49743,Bloudabadee,emerald-dream,384,shaman,enhancement,12,4,8
49744,Gaurudon,zuljin,384,shaman,enhancement,12,4,8
49745,Nehrakgu,wyrmrest-accord,384,shaman,enhancement,12,4,8
49746,Merrìtt,area-52,384,shaman,enhancement,12,4,8
49747,Gangdan,emerald-dream,384,shaman,enhancement,12,4,8
49748,Flamefüry,azralon,384,shaman,enhancement,12,4,8
49749,Ironloins,kelthuzad,384,shaman,enhancement,12,4,8
49750,Smackzs,sargeras,384,shaman,enhancement,12,4,8
49751,Cariix,maelstrom,384,shaman,enhancement,12,4,8
49752,Globad,tichondrius,384,shaman,enhancement,12,4,8
49753,Kinnarlan,sargeras,384,shaman,enhancement,12,4,8
49754,Emppege,tichondrius,384,shaman,enhancement,12,4,8
49755,Newele,thrall,384,shaman,enhancement,12,4,8
49756,Kaalyssia,moon-guard,384,shaman,enhancement,12,4,8
49757,Piril,moon-guard,384,shaman,enhancement,12,4,8
49758,Doorti,area-52,384,shaman,enhancement,12,4,8
49759,Bigstormz,fenris,384,shaman,enhancement,12,4,8
49760,Wabfurrie,twisting-nether,384,shaman,enhancement,12,4,8
49761,Kooj,frostmourne,384,shaman,enhancement,12,4,8
49762,Nokrosao,aegwynn,384,shaman,enhancement,12,4,8
49763,Vertrág,malganis,384,shaman,enhancement,12,4,8
49764,Tictactotem,lothar,384,shaman,enhancement,12,4,8
49765,Omaboa,azgalor,384,shaman,enhancement,12,4,8
49766,Enanomka,drakkari,384,shaman,enhancement,12,4,8
49767,Naturebøy,bleeding-hollow,384,shaman,enhancement,12,4,8
49768,Odhin,mannoroth,384,shaman,enhancement,12,4,8
49769,Foray,barthilas,384,shaman,enhancement,12,4,8
49770,Styrmic,frostmourne,384,shaman,enhancement,12,4,8
49771,Brenqt,nemesis,384,shaman,enhancement,18,4,14
49772,Xoelement,borean-tundra,384,shaman,enhancement,18,4,14
49773,Stormmän,stormrage,384,shaman,enhancement,18,4,14
49774,Illdelph,crushridge,384,shaman,enhancement,18,4,14
49775,Çatastrophe,dalaran,384,shaman,enhancement,18,4,14
49776,Grimdil,quelthalas,384,shaman,enhancement,18,4,14
49777,Ipponhim,saurfang,383,shaman,enhancement,6,4,2
49778,Vectos,bleeding-hollow,383,shaman,enhancement,6,4,2
49779,Rhal,ragnaros,383,shaman,enhancement,6,4,2
49780,Ugaboogah,thrall,383,shaman,enhancement,6,4,2
49781,Toeto,darrowmere,383,shaman,enhancement,6,4,2
49782,Cakinha,stormrage,383,shaman,enhancement,6,4,2
49783,Ghogann,bleeding-hollow,383,shaman,enhancement,6,4,2
49784,Kurzee,kelthuzad,383,shaman,enhancement,12,4,8
49785,Smolder,magtheridon,383,shaman,enhancement,12,4,8
49786,Drokán,ragnaros,383,shaman,enhancement,20,5,15
49787,Ikora,crushridge,381,shaman,enhancement,12,4,8
49788,Notahealz,zuljin,367,shaman,enhancement,11,4,7
49789,Jonfckingear,zuljin,351,shaman,enhancement,8,5,3
49790,Pyanir,thrall,351,shaman,enhancement,11,4,7
49791,Engorgdshock,tichondrius,351,shaman,enhancement,14,5,9
49792,Admetis,vashj,351,shaman,enhancement,17,4,13
49793,Airiem,tichondrius,336,shaman,enhancement,9,5,4
49794,Thorsén,ursin,335,shaman,enhancement,17,4,13
49795,Jeaunoo,darkspear,330,shaman,enhancement,14,5,9
49796,Ýup,tichondrius,320,shaman,enhancement,10,4,6
49797,Lardaz,darkspear,319,shaman,enhancement,5,4,1
49798,Xulangshammy,illidan,319,shaman,enhancement,11,4,7
49799,Habrith,proudmoore,319,shaman,enhancement,11,4,7
49800,Tempestsmash,tichondrius,304,shaman,enhancement,7,4,3
49801,Bimbly,eitrigg,303,shaman,enhancement,13,4,9
49802,Toyletpaper,mugthol,288,shaman,enhancement,6,3,3
49803,Trickytotems,stormrage,288,shaman,enhancement,6,3,3
49804,Shear,bleeding-hollow,288,shaman,enhancement,6,3,3
49805,Ulala,azshara,288,shaman,enhancement,6,3,3
49806,Zeroshears,tichondrius,288,shaman,enhancement,6,3,3
49807,Tideqt,tichondrius,288,shaman,enhancement,6,3,3
49808,Beefdrapesz,tichondrius,288,shaman,enhancement,6,3,3
49809,Sabtifa,proudmoore,288,shaman,enhancement,6,3,3
49810,Drgreek,barthilas,288,shaman,enhancement,6,3,3
49811,Ethikas,tichondrius,288,shaman,enhancement,6,3,3
49812,Freshoranges,blood-furnace,288,shaman,enhancement,6,3,3
49813,Thunnor,tichondrius,288,shaman,enhancement,6,3,3
49814,Zoma,elune,288,shaman,enhancement,6,3,3
49815,Puffjin,zuljin,288,shaman,enhancement,6,3,3
49816,Ëvëlyn,chogall,288,shaman,enhancement,6,3,3
49817,Vøødøøboy,hyjal,288,shaman,enhancement,6,3,3
49818,Glexhex,tichondrius,288,shaman,enhancement,6,3,3
49819,Plebshammy,bleeding-hollow,288,shaman,enhancement,6,3,3
49820,Sanachan,blood-furnace,288,shaman,enhancement,6,3,3
49821,Lennylemons,stormrage,288,shaman,enhancement,6,3,3
49822,Kubisham,warsong,288,shaman,enhancement,6,3,3
49823,Hottesthands,barthilas,288,shaman,enhancement,6,3,3
49824,Dogcompany,tichondrius,288,shaman,enhancement,6,3,3
49825,Jumanji,zuljin,288,shaman,enhancement,6,3,3
49826,Mzzar,tichondrius,288,shaman,enhancement,6,3,3
49827,Harshest,stormrage,288,shaman,enhancement,6,3,3
49828,Shambergler,tichondrius,288,shaman,enhancement,6,3,3
49829,Subbyxd,tichondrius,288,shaman,enhancement,6,3,3
49830,Gojiras,barthilas,288,shaman,enhancement,6,3,3
49831,Totemtantrum,tichondrius,288,shaman,enhancement,6,3,3
49832,Jibbajabber,laughing-skull,288,shaman,enhancement,6,3,3
49833,Haititnahtou,kaelthas,288,shaman,enhancement,6,3,3
49834,Antahanu,ragnaros,288,shaman,enhancement,6,3,3
49835,Emtflakes,darkspear,288,shaman,enhancement,6,3,3
49836,Wreçkitralph,sargeras,288,shaman,enhancement,6,3,3
49837,Nirmek,amanthul,288,shaman,enhancement,6,3,3
49838,Ezpzprime,bloodscalp,288,shaman,enhancement,6,3,3
49839,Bovinefony,blackrock,288,shaman,enhancement,6,3,3
49840,Nkrumah,sargeras,288,shaman,enhancement,6,3,3
49841,Charleschwab,proudmoore,288,shaman,enhancement,6,3,3
49842,Popsoot,area-52,288,shaman,enhancement,6,3,3
49843,Getwetand,quelthalas,288,shaman,enhancement,6,3,3
49844,Redpocket,zuluhed,288,shaman,enhancement,6,3,3
49845,Helapoon,area-52,288,shaman,enhancement,6,3,3
49846,Slowkeeper,azralon,288,shaman,enhancement,6,3,3
49847,Grimmick,area-52,288,shaman,enhancement,6,3,3
49848,Ban,blackrock,288,shaman,enhancement,6,3,3
49849,Mhuns,malganis,288,shaman,enhancement,6,3,3
49850,Shammateur,malganis,288,shaman,enhancement,6,3,3
49851,Xantíd,wyrmrest-accord,288,shaman,enhancement,6,3,3
49852,Owiez,sargeras,288,shaman,enhancement,6,3,3
49853,Shamaro,malganis,288,shaman,enhancement,6,3,3
49854,Cars,jaedenar,288,shaman,enhancement,6,3,3
49855,Thiccwater,frostmourne,288,shaman,enhancement,6,3,3
49856,Gumballin,sargeras,288,shaman,enhancement,6,3,3
49857,Gimpanzee,kiljaeden,288,shaman,enhancement,6,3,3
49858,Aruçar,drakkari,288,shaman,enhancement,6,3,3
49859,Swifteyy,area-52,288,shaman,enhancement,6,3,3
49860,Playdohz,frostmourne,288,shaman,enhancement,6,3,3
49861,Mundi,madoran,288,shaman,enhancement,6,3,3
49862,Gorszu,proudmoore,288,shaman,enhancement,6,3,3
49863,Vivean,kelthuzad,288,shaman,enhancement,6,3,3
49864,Sleekshammy,frostmourne,288,shaman,enhancement,6,3,3
49865,Failsy,darkspear,288,shaman,enhancement,6,3,3
49866,Luxenor,kelthuzad,288,shaman,enhancement,6,3,3
49867,Zapmavz,area-52,288,shaman,enhancement,6,3,3
49868,Dwarfmaro,sargeras,288,shaman,enhancement,6,3,3
49869,Puddlecakes,lightbringer,288,shaman,enhancement,6,3,3
49870,Sleepysham,kelthuzad,288,shaman,enhancement,6,3,3
49871,Gulgortz,ragnaros,288,shaman,enhancement,6,3,3
49872,Robot,illidan,288,shaman,enhancement,6,3,3
49873,Bottlez,sargeras,288,shaman,enhancement,6,3,3
49874,Humper,korgath,288,shaman,enhancement,6,3,3
49875,Xzxz,sargeras,288,shaman,enhancement,6,3,3
49876,Wildernez,whisperwind,288,shaman,enhancement,6,3,3
49877,Tempestarii,ragnaros,288,shaman,enhancement,6,3,3
49878,Littleshammy,aggramar,288,shaman,enhancement,6,3,3
49879,Fadeshy,illidan,288,shaman,enhancement,6,3,3
49880,Bon,ravencrest,288,shaman,enhancement,6,3,3
49881,Jaftter,quelthalas,288,shaman,enhancement,9,4,5
49882,Putinsdad,tichondrius,288,shaman,enhancement,10,4,6
49883,Gudac,tichondrius,288,shaman,enhancement,12,3,9
49884,Drekkhal,area-52,288,shaman,enhancement,12,3,9
49885,Mambaz,tichondrius,288,shaman,enhancement,12,3,9
49886,Fishmoley,zuljin,288,shaman,enhancement,12,3,9
49887,Drgiggleheim,tichondrius,288,shaman,enhancement,12,3,9
49888,Smeagðl,tichondrius,288,shaman,enhancement,12,3,9
49889,Bobbymooshay,area-52,288,shaman,enhancement,12,3,9
49890,Actios,stormrage,288,shaman,enhancement,12,3,9
49891,Samo,the-underbog,288,shaman,enhancement,12,3,9
49892,Immunize,tichondrius,288,shaman,enhancement,12,3,9
49893,Thunderblood,nerzhul,288,shaman,enhancement,12,3,9
49894,Shockfreak,stormrage,288,shaman,enhancement,12,3,9
49895,Jireñ,area-52,288,shaman,enhancement,12,3,9
49896,Jajxshammy,rivendare,288,shaman,enhancement,12,3,9
49897,Yaazz,frostmourne,288,shaman,enhancement,12,3,9
49898,Jhivone,tichondrius,288,shaman,enhancement,12,3,9
49899,Azão,stormrage,288,shaman,enhancement,12,3,9
49900,Malsturm,stormrage,288,shaman,enhancement,12,3,9
49901,Hammaam,illidan,288,shaman,enhancement,12,3,9
49902,Unhapintadaa,azralon,288,shaman,enhancement,12,3,9
49903,Xrag,sargeras,288,shaman,enhancement,12,3,9
49904,Faelzão,nemesis,288,shaman,enhancement,12,3,9
49905,Silverwolf,eredar,288,shaman,enhancement,12,3,9
49906,Shocksnbonds,zuljin,288,shaman,enhancement,12,3,9
49907,Khazy,skullcrusher,288,shaman,enhancement,12,3,9
49908,Melåån,jubeithos,288,shaman,enhancement,12,3,9
49909,Aerôv,area-52,288,shaman,enhancement,18,3,15
49910,Xaryu,shuhalo,287,shaman,enhancement,12,3,9
49911,Dnttazemebro,area-52,286,shaman,enhancement,6,3,3
49912,Nargen,tichondrius,271,shaman,enhancement,11,3,8
49913,Lagamental,frostmourne,240,shaman,enhancement,9,3,6
49914,ßodycount,area-52,240,shaman,enhancement,9,3,6
49915,Elementalqti,frostmourne,239,shaman,enhancement,5,3,2
49916,Deeznuts,the-forgotten-coast,239,shaman,enhancement,5,3,2
49917,Caobuloso,azralon,239,shaman,enhancement,5,3,2
49918,Sølbi,tichondrius,239,shaman,enhancement,5,3,2
49919,Kryms,chogall,234,shaman,enhancement,17,6,11
49920,Smooths,bloodscalp,234,shaman,enhancement,19,5,14
49921,Forge,maelstrom,223,shaman,enhancement,8,3,5
49922,Kayadee,stormrage,192,shaman,enhancement,9,3,6
49923,Shamnick,malganis,192,shaman,enhancement,6,2,4
49924,Jamsham,tichondrius,192,shaman,enhancement,6,2,4
49925,Detair,malganis,192,shaman,enhancement,6,2,4
49926,Thünderstrük,tichondrius,192,shaman,enhancement,6,2,4
49927,Ôprawindfury,mugthol,192,shaman,enhancement,6,2,4
49928,Pissticles,bleeding-hollow,192,shaman,enhancement,6,2,4
49929,Víì,tichondrius,192,shaman,enhancement,6,2,4
49930,Afri,tichondrius,192,shaman,enhancement,6,2,4
49931,Picolö,bleeding-hollow,192,shaman,enhancement,6,2,4
49932,Vywolf,frostmourne,192,shaman,enhancement,6,2,4
49933,Texaspumper,sargeras,192,shaman,enhancement,6,2,4
49934,Daiablo,barthilas,192,shaman,enhancement,6,2,4
49935,Sparklebunny,dark-iron,192,shaman,enhancement,6,2,4
49936,Elecpod,frostmourne,192,shaman,enhancement,6,2,4
49937,Jbahr,hyjal,192,shaman,enhancement,6,2,4
49938,Galarix,nerzhul,192,shaman,enhancement,6,2,4
49939,Ageegee,sargeras,192,shaman,enhancement,6,2,4
49940,Freesolo,barthilas,192,shaman,enhancement,6,2,4
49941,Scarshamxn,frostmourne,192,shaman,enhancement,6,2,4
49942,Moisttaco,azshara,192,shaman,enhancement,6,2,4
49943,Xantorn,illidan,192,shaman,enhancement,6,2,4
49944,Furywolf,bleeding-hollow,192,shaman,enhancement,6,2,4
49945,Bearmanshrek,tichondrius,192,shaman,enhancement,6,2,4
49946,Buttermelk,bleeding-hollow,192,shaman,enhancement,6,2,4
49947,Maxchiquito,ragnaros,192,shaman,enhancement,6,2,4
49948,Khuufu,fizzcrank,192,shaman,enhancement,6,2,4
49949,Kumer,tichondrius,192,shaman,enhancement,6,2,4
49950,Stallos,zuljin,192,shaman,enhancement,6,2,4
49951,Dadajuju,azralon,192,shaman,enhancement,6,2,4
49952,Twistër,illidan,192,shaman,enhancement,6,2,4
49953,Jammylol,frostmourne,192,shaman,enhancement,6,2,4
49954,Meatyball,tichondrius,192,shaman,enhancement,6,2,4
49955,Shamflu,tichondrius,192,shaman,enhancement,6,2,4
49956,Friedshammy,frostmourne,192,shaman,enhancement,6,2,4
49957,Milkmeforhp,frostmourne,192,shaman,enhancement,6,2,4
49958,Mishalla,tichondrius,192,shaman,enhancement,6,2,4
49959,Totemzie,illidan,192,shaman,enhancement,6,2,4
49960,Huiracøcha,quelthalas,192,shaman,enhancement,6,2,4
49961,Kermut,frostmourne,192,shaman,enhancement,6,2,4
49962,Raidjin,tichondrius,192,shaman,enhancement,6,2,4
49963,Szael,durotan,192,shaman,enhancement,6,2,4
49964,Jahahahamon,arthas,192,shaman,enhancement,6,2,4
49965,Boj,magtheridon,192,shaman,enhancement,6,2,4
49966,Eraali,stormrage,192,shaman,enhancement,6,2,4
49967,Saltt,proudmoore,192,shaman,enhancement,6,2,4
49968,Ârcanjo,azralon,192,shaman,enhancement,6,2,4
49969,Skyshamy,azralon,192,shaman,enhancement,6,2,4
49970,Slugstout,moon-guard,192,shaman,enhancement,6,2,4
49971,Hothandxo,illidan,192,shaman,enhancement,6,2,4
49972,Contraponto,azralon,192,shaman,enhancement,6,2,4
49973,Skyten,quelthalas,192,shaman,enhancement,6,2,4
49974,Thrallzballz,firetree,192,shaman,enhancement,6,2,4
49975,Loused,wyrmrest-accord,192,shaman,enhancement,6,2,4
49976,Quequin,quelthalas,192,shaman,enhancement,6,2,4
49977,Pozcaster,tichondrius,192,shaman,enhancement,6,2,4
49978,Shamutari,sargeras,192,shaman,enhancement,6,2,4
49979,Fatluma,zuljin,192,shaman,enhancement,6,2,4
49980,Netflixnfeet,moonrunner,192,shaman,enhancement,6,2,4
49981,Amzurs,area-52,192,shaman,enhancement,6,2,4
49982,Ectomee,tichondrius,192,shaman,enhancement,6,2,4
49983,Blooddtears,stormrage,192,shaman,enhancement,6,2,4
49984,Durogh,darkspear,192,shaman,enhancement,6,2,4
49985,Jungsa,tichondrius,192,shaman,enhancement,6,2,4
49986,Brofessor,frostwolf,192,shaman,enhancement,6,2,4
49987,Shockazulu,vashj,192,shaman,enhancement,6,2,4
49988,Soapmactavis,sargeras,192,shaman,enhancement,6,2,4
49989,Pandancement,thrall,192,shaman,enhancement,6,2,4
49990,Spoke,emerald-dream,192,shaman,enhancement,6,2,4
49991,Bullcowsby,darkspear,192,shaman,enhancement,6,2,4
49992,Swigadee,tichondrius,192,shaman,enhancement,6,2,4
49993,Virô,sargeras,192,shaman,enhancement,6,2,4
49994,Bootsix,area-52,192,shaman,enhancement,6,2,4
49995,Stormfronts,kelthuzad,192,shaman,enhancement,6,2,4
49996,Ceedlamb,kelthuzad,192,shaman,enhancement,6,2,4
49997,Pericazo,sargeras,192,shaman,enhancement,6,2,4
49998,Bitxxnumber,tichondrius,192,shaman,enhancement,6,2,4
49999,Shamanakin,emerald-dream,192,shaman,enhancement,6,2,4
50000,Totemrecalld,zuljin,192,shaman,enhancement,6,2,4
50001,Hèllzpyro,sargeras,192,shaman,enhancement,6,2,4
50002,Jashiik,tichondrius,192,shaman,enhancement,6,2,4
50003,Insanelol,tichondrius,192,shaman,enhancement,6,2,4
50004,Møostrom,thrall,192,shaman,enhancement,6,2,4
50005,Thejoshuwua,icecrown,192,shaman,enhancement,6,2,4
50006,Uwitduhfeds,moon-guard,192,shaman,enhancement,6,2,4
50007,Zeldrys,emerald-dream,192,shaman,enhancement,6,2,4
50008,Zenitsue,sargeras,192,shaman,enhancement,6,2,4
50009,Whameradetu,suramar,192,shaman,enhancement,6,2,4
50010,Badjujubruh,thrall,192,shaman,enhancement,6,2,4
50011,Valcannos,area-52,192,shaman,enhancement,6,2,4
50012,Rayjamalblk,tichondrius,192,shaman,enhancement,6,2,4
50013,ßeesy,emerald-dream,192,shaman,enhancement,6,2,4
50014,Brewstoned,kargath,192,shaman,enhancement,6,2,4
50015,Jasonnworb,tichondrius,192,shaman,enhancement,6,2,4
50016,Olboy,thrall,192,shaman,enhancement,6,2,4
50017,Crankzilla,area-52,192,shaman,enhancement,6,2,4
50018,Dibbydogtote,tichondrius,192,shaman,enhancement,6,2,4
50019,Wìzz,zuljin,192,shaman,enhancement,6,2,4
50020,Synyshok,tichondrius,192,shaman,enhancement,6,2,4
50021,Kass,area-52,192,shaman,enhancement,6,2,4
50022,Käshqt,tichondrius,192,shaman,enhancement,6,2,4
50023,Stèpbro,sargeras,192,shaman,enhancement,6,2,4
50024,Rinjio,zuljin,192,shaman,enhancement,6,2,4
50025,Vitaminc,garona,192,shaman,enhancement,6,2,4
50026,Jwondo,area-52,192,shaman,enhancement,6,2,4
50027,Girthquake,agamaggan,192,shaman,enhancement,6,2,4
50028,Nawoma,quelthalas,192,shaman,enhancement,8,2,6
50029,Feär,ysera,192,shaman,enhancement,9,2,7
50030,Feels,arthas,192,shaman,enhancement,16,3,13
50031,Manemon,quelthalas,192,shaman,enhancement,12,2,10
50032,Gunai,malganis,192,shaman,enhancement,12,2,10
50033,Legendmatic,illidan,192,shaman,enhancement,12,2,10
50034,Zuljiba,illidan,192,shaman,enhancement,12,2,10
50035,Gusgusgus,laughing-skull,192,shaman,enhancement,12,2,10
50036,Îlikêdinos,aggramar,192,shaman,enhancement,12,2,10
50037,Rhazer,cenarion-circle,192,shaman,enhancement,12,2,10
50038,Vashidda,stormrage,192,shaman,enhancement,12,2,10
50039,Stylebend,area-52,192,shaman,enhancement,12,2,10
50040,Chontu,area-52,192,shaman,enhancement,12,2,10
50041,Tictactotum,hyjal,192,shaman,enhancement,12,2,10
50042,Ophine,illidan,191,shaman,enhancement,6,2,4
50043,Dahmerjr,area-52,191,shaman,enhancement,6,2,4
50044,Calmconflict,daggerspine,191,shaman,enhancement,6,2,4
50045,Baktolumby,tichondrius,175,shaman,enhancement,11,2,9
50046,Dønßlack,thunderhorn,159,shaman,enhancement,5,2,3
50047,Healingtime,nerzhul,159,shaman,enhancement,5,2,3
50048,Skuffedx,spirestone,159,shaman,enhancement,5,2,3
50049,Nuggitz,tichondrius,159,shaman,enhancement,5,2,3
50050,Shamto,zuljin,144,shaman,enhancement,3,3,0
50051,Khaylaa,tichondrius,138,shaman,enhancement,11,6,5
50052,Bogz,korgath,128,shaman,enhancement,4,2,2
50053,Badgeshock,area-52,128,shaman,enhancement,4,2,2
50054,Flashyjoe,tichondrius,128,shaman,enhancement,4,2,2
50055,Ludacrìtz,stormrage,112,shaman,enhancement,7,2,5
50056,Tsuchekk,tichondrius,111,shaman,enhancement,5,3,2
50057,Hephæstus,maiev,96,shaman,enhancement,3,2,1
50058,Shamcakes,kilrogg,96,shaman,enhancement,17,3,14
50059,Adosistoxic,zuljin,96,shaman,enhancement,6,1,5
50060,Meatballbag,thrall,96,shaman,enhancement,6,1,5
50061,Zapsquidzap,illidan,96,shaman,enhancement,6,1,5
50062,Shockd,icecrown,96,shaman,enhancement,6,1,5
50063,Nommymilkers,stormrage,96,shaman,enhancement,6,1,5
50064,Trynr,ragnaros,96,shaman,enhancement,6,1,5
50065,Youliuhua,tichondrius,96,shaman,enhancement,6,1,5
50066,Saesenthesis,barthilas,96,shaman,enhancement,6,1,5
50067,Alferian,moon-guard,96,shaman,enhancement,6,1,5
50068,Aiggiggigne,sargeras,96,shaman,enhancement,6,1,5
50069,Sureofname,frostmourne,96,shaman,enhancement,6,1,5
50070,Firefíst,area-52,96,shaman,enhancement,6,1,5
50071,Beazel,moon-guard,96,shaman,enhancement,6,1,5
50072,Bunnyele,tichondrius,96,shaman,enhancement,6,1,5
50073,Paramecium,sargeras,96,shaman,enhancement,6,1,5
50074,Trøuble,deathwing,96,shaman,enhancement,6,1,5
50075,Karmar,proudmoore,96,shaman,enhancement,6,1,5
50076,Kàrlx,tichondrius,96,shaman,enhancement,6,1,5
50077,Killuminatti,nathrezim,96,shaman,enhancement,6,1,5
50078,Sweettooth,area-52,96,shaman,enhancement,6,1,5
50079,Ohtoro,zuljin,96,shaman,enhancement,6,1,5
50080,Tritun,proudmoore,96,shaman,enhancement,6,1,5
50081,Pileef,thrall,96,shaman,enhancement,6,1,5
50082,Sandmanatee,crushridge,96,shaman,enhancement,6,1,5
50083,Neveroom,cenarius,96,shaman,enhancement,6,1,5
50084,Chopmynuts,illidan,96,shaman,enhancement,6,1,5
50085,Frostyshock,hellscream,96,shaman,enhancement,6,1,5
50086,Udÿr,drakkari,96,shaman,enhancement,6,1,5
50087,Juvîa,emerald-dream,96,shaman,enhancement,6,1,5
50088,Totemtîme,frostmourne,96,shaman,enhancement,6,1,5
50089,Zugnuz,sargeras,96,shaman,enhancement,6,1,5
50090,Zuitianshi,tichondrius,96,shaman,enhancement,6,1,5
50091,Kranif,tichondrius,96,shaman,enhancement,6,1,5
50092,Beefsham,eitrigg,96,shaman,enhancement,6,1,5
50093,Spaceghost,illidan,96,shaman,enhancement,6,1,5
50094,Toyotatron,tichondrius,96,shaman,enhancement,6,1,5
50095,Axshaman,darkspear,96,shaman,enhancement,6,1,5
50096,Baelgoth,moon-guard,96,shaman,enhancement,6,1,5
50097,Geladoo,gallywix,96,shaman,enhancement,6,1,5
50098,Mugiwärä,area-52,96,shaman,enhancement,6,1,5
50099,Aezst,illidan,96,shaman,enhancement,6,1,5
50100,Zoeyzour,illidan,96,shaman,enhancement,6,1,5
50101,Shamamas,area-52,96,shaman,enhancement,6,1,5
50102,Ulfgarn,stormrage,96,shaman,enhancement,6,1,5
50103,Feuerbart,dalaran,96,shaman,enhancement,6,1,5
50104,Javinoo,tichondrius,96,shaman,enhancement,6,1,5
50105,Uttertrash,illidan,96,shaman,enhancement,6,1,5
50106,Hangellyca,azralon,96,shaman,enhancement,6,1,5
50107,Boogey,khazgoroth,96,shaman,enhancement,6,1,5
50108,Littz,malganis,96,shaman,enhancement,6,1,5
50109,Trouvaille,tichondrius,96,shaman,enhancement,6,1,5
50110,Fourever,ragnaros,96,shaman,enhancement,6,1,5
50111,Volaarn,area-52,96,shaman,enhancement,6,1,5
50112,Shamofshame,garrosh,96,shaman,enhancement,6,1,5
50113,Blackjackxx,frostmourne,96,shaman,enhancement,6,1,5
50114,Tetonka,tichondrius,96,shaman,enhancement,6,1,5
50115,Wangbangjr,mugthol,96,shaman,enhancement,6,1,5
50116,Kinjin,dragonmaw,96,shaman,enhancement,6,1,5
50117,Yungmeaty,tichondrius,96,shaman,enhancement,7,1,6
50118,Threehandz,bleeding-hollow,96,shaman,enhancement,8,1,7
50119,Immutef,tichondrius,96,shaman,enhancement,12,1,11
50120,Chäningtotem,kiljaeden,96,shaman,enhancement,12,1,11
50121,Thallor,stormrage,96,shaman,enhancement,12,1,11
50122,Smokeymcpots,khazgoroth,95,shaman,enhancement,6,1,5
50123,Dilldoughnut,sargeras,79,shaman,enhancement,5,1,4
50124,Oakshield,darkspear,64,shaman,enhancement,4,1,3
50125,Stórmfuryz,tichondrius,64,shaman,enhancement,4,1,3
50126,Njórd,sargeras,63,shaman,enhancement,2,2,0
50127,Bluberi,nazjatar,48,shaman,enhancement,3,1,2
50128,Ekatonkiro,ragnaros,48,shaman,enhancement,3,1,2
50129,Grauldron,illidan,48,shaman,enhancement,3,1,2
50130,Rondru,zuljin,48,shaman,enhancement,3,1,2
50131,Pocoloco,blades-edge,48,shaman,enhancement,3,1,2
50132,Splewtsham,thrall,48,shaman,enhancement,3,1,2
50133,Totemlord,lightnings-blade,31,shaman,enhancement,2,1,1
50134,Stumpyjoe,terokkar,16,shaman,enhancement,7,1,6
50135,Cidkagenou,sargeras,2353,warlock,demonology,63,47,16
50136,Bronzerl,tichondrius,2347,warlock,demonology,69,47,22
50137,Wildimp,aerie-peak,2323,warlock,demonology,108,66,42
50138,Wildimpx,sargeras,2322,warlock,demonology,208,113,95
50139,Btsfangirl,moon-guard,2267,warlock,demonology,110,63,47
50140,Xygg,tichondrius,2256,warlock,demonology,78,48,30
50141,Iordozzy,malganis,2245,warlock,demonology,84,56,28
50142,Bahamas,bleeding-hollow,2236,warlock,demonology,84,50,34
50143,Miredö,tichondrius,2223,warlock,demonology,84,48,36
50144,Wzxx,tichondrius,2222,warlock,demonology,84,46,38
50145,Lilballz,tichondrius,2221,warlock,demonology,65,39,26
50146,Ediya,tichondrius,2203,warlock,demonology,178,94,84
50147,Babyaga,illidan,2201,warlock,demonology,84,47,37
50148,Beyourselff,tichondrius,2195,warlock,demonology,151,80,71
50149,Hrrpeuh,zuljin,2191,warlock,demonology,66,40,26
50150,Mixtape,stormrage,2178,warlock,demonology,77,47,30
50151,Mlx,proudmoore,2176,warlock,demonology,149,81,68
50152,Bigfatballz,tichondrius,2171,warlock,demonology,76,48,28
50153,Jojofann,nemesis,2165,warlock,demonology,53,37,16
50154,Newmanz,nerzhul,2155,warlock,demonology,71,41,30
50155,Evildeath,tichondrius,2154,warlock,demonology,78,44,34
50156,Gentleq,tichondrius,2149,warlock,demonology,99,53,46
50157,Gianni,chogall,2149,warlock,demonology,107,57,50
50158,Abrocket,alleria,2143,warlock,demonology,72,45,27
50159,Erock,korgath,2138,warlock,demonology,60,47,13
50160,Shinyballz,tichondrius,2133,warlock,demonology,71,41,30
50161,Wesyane,anetheron,2130,warlock,demonology,148,78,70
50162,Xadge,tichondrius,2128,warlock,demonology,79,43,36
50163,Fishorz,tichondrius,2128,warlock,demonology,89,47,42
50164,Harambê,sargeras,2127,warlock,demonology,36,27,9
50165,Lemmefear,illidan,2127,warlock,demonology,47,32,15
50166,Chanigay,tichondrius,2127,warlock,demonology,65,39,26
50167,Kaossqt,azralon,2121,warlock,demonology,120,64,56
50168,Bigdaddylol,ragnaros,2120,warlock,demonology,83,45,38
50169,Ziffy,emerald-dream,2118,warlock,demonology,78,41,37
50170,Maadhum,illidan,2116,warlock,demonology,92,50,42
50171,Zuelu,tichondrius,2116,warlock,demonology,163,88,75
50172,Fatass,cairne,2114,warlock,demonology,66,38,28
50173,Awdam,tichondrius,2114,warlock,demonology,96,50,46
50174,Ensebado,azralon,2111,warlock,demonology,140,78,62
50175,Falco,azshara,2110,warlock,demonology,66,38,28
50176,Synkz,blood-furnace,2110,warlock,demonology,72,38,34
50177,Cosmosxx,illidan,2110,warlock,demonology,112,58,54
50178,Ogchaos,tichondrius,2107,warlock,demonology,78,45,33
50179,Erlandesher,tichondrius,2107,warlock,demonology,149,75,74
50180,Tessarath,area-52,2106,warlock,demonology,59,38,21
50181,Boltqt,tichondrius,2103,warlock,demonology,60,36,24
50182,Spicyfingers,illidan,2103,warlock,demonology,78,44,34
50183,Nðm,tichondrius,2100,warlock,demonology,72,44,28
50184,Aoepump,tichondrius,2094,warlock,demonology,78,43,35
50185,Unhòólylck,ragnaros,2082,warlock,demonology,105,56,49
50186,Kymochaos,sargeras,2080,warlock,demonology,53,27,26
50187,Ofc,malganis,2068,warlock,demonology,60,35,25
50188,Patoquenn,azralon,2061,warlock,demonology,66,37,29
50189,Toiletghost,tichondrius,2060,warlock,demonology,86,54,32
50190,Persistencss,tichondrius,2047,warlock,demonology,48,29,19
50191,Oymmander,illidan,2046,warlock,demonology,56,37,19
50192,Coèrce,tichondrius,2040,warlock,demonology,53,35,18
50193,Broccoleh,area-52,2033,warlock,demonology,59,36,23
50194,Etuskaa,tichondrius,2032,warlock,demonology,167,83,84
50195,Eazyw,stormrage,2024,warlock,demonology,95,47,48
50196,Iselltacos,dalaran,2015,warlock,demonology,43,29,14
50197,Debao,malganis,2014,warlock,demonology,107,51,56
50198,Cosmosxi,illidan,2008,warlock,demonology,91,50,41
50199,Sslock,sargeras,2008,warlock,demonology,71,37,34
50200,Nocrackrocks,stormrage,2007,warlock,demonology,117,66,51
50201,Atheô,ragnaros,2004,warlock,demonology,106,57,49
50202,Vexxes,malganis,2002,warlock,demonology,246,126,120
50203,Ztlivid,area-52,2000,warlock,demonology,175,91,84
50204,Awangdemon,tichondrius,1997,warlock,demonology,54,27,27
50205,Dotman,tichondrius,1991,warlock,demonology,70,39,31
50206,Teivlol,mugthol,1980,warlock,demonology,96,51,45
50207,Extreme,blackwing-lair,1978,warlock,demonology,78,53,25
50208,Spreadlove,emerald-dream,1978,warlock,demonology,234,129,105
50209,Bwonsamdijin,tichondrius,1970,warlock,demonology,142,70,72
50210,Procalypse,stormrage,1966,warlock,demonology,54,32,22
50211,Canobio,tichondrius,1957,warlock,demonology,65,43,22
50212,Megamindx,tichondrius,1957,warlock,demonology,48,31,17
50213,Voidbb,tichondrius,1957,warlock,demonology,53,30,23
50214,Snuufels,area-52,1950,warlock,demonology,60,37,23
50215,Ihaveapowers,maiev,1944,warlock,demonology,120,60,60
50216,Naughtybolts,sargeras,1941,warlock,demonology,80,46,34
50217,Rôsé,tichondrius,1941,warlock,demonology,130,73,57
50218,Baka,moon-guard,1938,warlock,demonology,60,32,28
50219,Precogfear,tichondrius,1936,warlock,demonology,78,39,39
50220,Littlerod,tichondrius,1934,warlock,demonology,90,48,42
50221,Stopdot,lightnings-blade,1934,warlock,demonology,76,38,38
50222,Paygo,tichondrius,1930,warlock,demonology,57,32,25
50223,Arckádia,stormrage,1923,warlock,demonology,66,31,35
50224,Shadowmoonon,tichondrius,1921,warlock,demonology,43,21,22
50225,Bronzel,tichondrius,1920,warlock,demonology,48,30,18
50226,Ketahole,warsong,1918,warlock,demonology,117,58,59
50227,Bleachkk,tichondrius,1915,warlock,demonology,95,56,39
50228,Invalid,frostmourne,1914,warlock,demonology,36,25,11
50229,Ceeloftw,tichondrius,1914,warlock,demonology,113,60,53
50230,Ökïlôck,proudmoore,1912,warlock,demonology,48,27,21
50231,Iruffcarla,cairne,1909,warlock,demonology,54,32,22
50232,Lilgigs,stormrage,1909,warlock,demonology,60,30,30
50233,Zjxy,tichondrius,1908,warlock,demonology,30,20,10
50234,Inmøtion,tichondrius,1906,warlock,demonology,60,33,27
50235,Scalpelexis,stormrage,1905,warlock,demonology,36,23,13
50236,Sofan,dalaran,1905,warlock,demonology,58,33,25
50237,Dyenamik,stormrage,1904,warlock,demonology,30,24,6
50238,Lockedinn,mannoroth,1904,warlock,demonology,91,54,37
50239,Huajianmanwu,tichondrius,1904,warlock,demonology,286,148,138
50240,Daerde,malganis,1900,warlock,demonology,47,27,20
50241,Siphoned,darkspear,1900,warlock,demonology,53,27,26
50242,Deadlpoo,stormscale,1899,warlock,demonology,81,41,40
50243,Xiyangpvp,tichondrius,1898,warlock,demonology,54,31,23
50244,Elbrujon,sargeras,1897,warlock,demonology,142,69,73
50245,Lemmepvponu,illidan,1896,warlock,demonology,48,30,18
50246,Alisa,moon-guard,1896,warlock,demonology,60,28,32
50247,Lowrcase,zuljin,1895,warlock,demonology,48,28,20
50248,Lrry,dalaran,1893,warlock,demonology,144,84,60
50249,Gamecover,azralon,1889,warlock,demonology,122,72,50
50250,Rakshama,chogall,1885,warlock,demonology,42,25,17
50251,Percadu,barthilas,1885,warlock,demonology,97,50,47
50252,Mongobros,illidan,1881,warlock,demonology,54,33,21
50253,Maral,kelthuzad,1878,warlock,demonology,63,35,28
50254,Petattack,nerzhul,1878,warlock,demonology,125,60,65
50255,Kimchiblast,tichondrius,1876,warlock,demonology,48,28,20
50256,Avery,mannoroth,1876,warlock,demonology,42,22,20
50257,Lambe,tichondrius,1874,warlock,demonology,53,31,22
50258,Demondisco,tichondrius,1873,warlock,demonology,95,45,50
50259,Zydiva,sargeras,1872,warlock,demonology,118,62,56
50260,Dätura,tichondrius,1871,warlock,demonology,68,43,25
50261,Sàill,tichondrius,1871,warlock,demonology,35,22,13
50262,Lockiator,moon-guard,1870,warlock,demonology,71,35,36
50263,Dowal,whisperwind,1866,warlock,demonology,60,31,29
50264,Scatach,area-52,1864,warlock,demonology,60,32,28
50265,Klol,proudmoore,1861,warlock,demonology,54,26,28
50266,Thranlock,area-52,1860,warlock,demonology,156,77,79
50267,ßøßßÿßøûçhêr,tichondrius,1859,warlock,demonology,48,32,16
50268,Ministàff,ursin,1857,warlock,demonology,60,32,28
50269,Voidxx,tichondrius,1856,warlock,demonology,30,21,9
50270,Mhael,lightninghoof,1856,warlock,demonology,54,32,22
50271,Playßøy,area-52,1856,warlock,demonology,42,24,18
50272,Playtoy,moon-guard,1856,warlock,demonology,154,78,76
50273,Amazingamez,sargeras,1855,warlock,demonology,149,69,80
50274,Atheø,ragnaros,1854,warlock,demonology,42,23,19
50275,Aramith,tichondrius,1854,warlock,demonology,118,60,58
50276,Demyo,tichondrius,1849,warlock,demonology,38,21,17
50277,Díablo,bleeding-hollow,1848,warlock,demonology,53,36,17
50278,Redfish,tichondrius,1847,warlock,demonology,34,20,14
50279,Buymymixtåpe,ursin,1846,warlock,demonology,57,34,23
50280,Xitokaiba,tichondrius,1844,warlock,demonology,67,46,21
50281,Phóbòs,tichondrius,1843,warlock,demonology,54,40,14
50282,Feldren,wyrmrest-accord,1843,warlock,demonology,85,50,35
50283,Metic,firetree,1842,warlock,demonology,48,33,15
50284,Kerrigan,the-venture-co,1842,warlock,demonology,66,38,28
50285,Larixpotanin,tichondrius,1842,warlock,demonology,102,58,44
50286,Darkzell,azralon,1841,warlock,demonology,48,30,18
50287,Dlhmlock,tichondrius,1840,warlock,demonology,41,25,16
50288,Juleno,quelthalas,1837,warlock,demonology,57,31,26
50289,Alndron,thrall,1837,warlock,demonology,78,38,40
50290,Ccona,tichondrius,1835,warlock,demonology,42,23,19
50291,Speakeasy,malygos,1835,warlock,demonology,58,29,29
50292,Beatinu,draenor,1834,warlock,demonology,54,32,22
50293,Domenic,sentinels,1833,warlock,demonology,58,32,26
50294,Necronemesis,arthas,1833,warlock,demonology,162,88,74
50295,Bbangtimo,tichondrius,1833,warlock,demonology,77,40,37
50296,Åmön,zuljin,1832,warlock,demonology,66,32,34
50297,Drakatattwo,tichondrius,1831,warlock,demonology,42,23,19
50298,Bic,thrall,1828,warlock,demonology,66,45,21
50299,Xoboroz,moon-guard,1827,warlock,demonology,60,29,31
50300,Cendit,malganis,1825,warlock,demonology,54,34,20
50301,Jerclard,proudmoore,1825,warlock,demonology,90,51,39
50302,Castingfear,barthilas,1825,warlock,demonology,48,27,21
50303,Tazlock,blackrock,1825,warlock,demonology,64,32,32
50304,Greasymario,area-52,1824,warlock,demonology,60,42,18
50305,Malatharr,quelthalas,1824,warlock,demonology,52,34,18
50306,Axelrodx,tichondrius,1824,warlock,demonology,54,35,19
50307,Actualjoke,frostmourne,1824,warlock,demonology,59,31,28
50308,Douzz,frostmourne,1821,warlock,demonology,47,28,19
50309,Idoovoodoo,burning-legion,1820,warlock,demonology,36,23,13
50310,Sharaßha,moon-guard,1820,warlock,demonology,69,41,28
50311,Scarysherri,aggramar,1819,warlock,demonology,54,36,18
50312,Búmchúm,frostmourne,1818,warlock,demonology,60,38,22
50313,Dëvïl,ragnaros,1818,warlock,demonology,92,58,34
50314,Dapete,malorne,1818,warlock,demonology,53,30,23
50315,Lockedlock,nemesis,1818,warlock,demonology,48,27,21
50316,Villaìn,moon-guard,1818,warlock,demonology,117,55,62
50317,Arcinian,kelthuzad,1817,warlock,demonology,66,39,27
50318,Wls,frostmourne,1817,warlock,demonology,89,50,39
50319,Hellbraive,queldorei,1817,warlock,demonology,54,30,24
50320,Overlard,illidan,1816,warlock,demonology,42,24,18
50321,Gigabiga,area-52,1815,warlock,demonology,36,23,13
50322,Flocka,agamaggan,1814,warlock,demonology,54,41,13
50323,Tít,malganis,1814,warlock,demonology,41,31,10
50324,Wearelegionx,frostmourne,1814,warlock,demonology,84,49,35
50325,Tinkerfell,sargeras,1814,warlock,demonology,72,36,36
50326,Fearmebro,bleeding-hollow,1813,warlock,demonology,114,75,39
50327,Richards,thrall,1812,warlock,demonology,42,32,10
50328,Ltr,moon-guard,1811,warlock,demonology,30,22,8
50329,Kronii,jubeithos,1811,warlock,demonology,35,25,10
50330,Voidxo,tichondrius,1811,warlock,demonology,36,22,14
50331,Krumlax,thrall,1810,warlock,demonology,60,42,18
50332,Deboltzaru,ragnaros,1810,warlock,demonology,36,20,16
50333,Errogant,area-52,1810,warlock,demonology,60,30,30
50334,Nüts,blackrock,1810,warlock,demonology,50,23,27
50335,Beckypls,zuljin,1809,warlock,demonology,36,27,9
50336,Mcjoy,akama,1809,warlock,demonology,145,91,54
50337,Dounutlock,area-52,1809,warlock,demonology,54,33,21
50338,Saevitar,area-52,1809,warlock,demonology,45,24,21
50339,Gengar,dalaran,1809,warlock,demonology,186,97,89
50340,Zzooxxqt,area-52,1809,warlock,demonology,48,25,23
50341,Hadoukën,hyjal,1809,warlock,demonology,108,56,52
50342,Chilipeppa,wyrmrest-accord,1808,warlock,demonology,60,34,26
50343,Mälwaré,tichondrius,1808,warlock,demonology,58,29,29
50344,Qwêrty,ursin,1807,warlock,demonology,47,32,15
50345,Chaosthekid,malganis,1807,warlock,demonology,40,25,15
50346,Reneqtxo,jubeithos,1806,warlock,demonology,30,19,11
50347,Evelyne,tichondrius,1805,warlock,demonology,30,19,11
50348,Xacayth,ragnaros,1804,warlock,demonology,80,47,33
50349,Cappadonna,azralon,1804,warlock,demonology,118,69,49
50350,Rakudemon,ragnaros,1804,warlock,demonology,147,77,70
50351,Darkborkain,tichondrius,1803,warlock,demonology,30,19,11
50352,Mbhlol,illidan,1803,warlock,demonology,42,23,19
50353,Wachifurro,drakkari,1802,warlock,demonology,53,28,25
50354,Quetzâlcoâtl,sargeras,1801,warlock,demonology,47,28,19
50355,Lockeslock,sargeras,1801,warlock,demonology,118,62,56
50356,Thelockzx,azralon,1801,warlock,demonology,60,28,32
50357,Bonetangler,thrall,1798,warlock,demonology,119,54,65
50358,Salaszar,illidan,1797,warlock,demonology,48,31,17
50359,Raegon,kiljaeden,1797,warlock,demonology,44,25,19
50360,Tarth,sargeras,1797,warlock,demonology,102,51,51
50361,Zehzet,area-52,1796,warlock,demonology,36,26,10
50362,Lcomi,tichondrius,1796,warlock,demonology,54,30,24
50363,Tiná,tichondrius,1796,warlock,demonology,51,27,24
50364,Overclocked,destromath,1795,warlock,demonology,30,21,9
50365,Hugebolt,tichondrius,1793,warlock,demonology,48,28,20
50366,Jaganshi,tichondrius,1791,warlock,demonology,52,29,23
50367,Dreadlock,tichondrius,1789,warlock,demonology,42,24,18
50368,Babydots,stormreaver,1786,warlock,demonology,136,67,69
50369,Keylloggz,sargeras,1780,warlock,demonology,126,65,61
50370,Hitwarlock,tichondrius,1775,warlock,demonology,78,39,39
50371,Amgs,frostmourne,1773,warlock,demonology,54,38,16
50372,Qp,thrall,1771,warlock,demonology,38,28,10
50373,Abomasnow,frostmourne,1768,warlock,demonology,67,32,35
50374,Dogegg,tichondrius,1765,warlock,demonology,84,40,44
50375,Sicksick,tichondrius,1762,warlock,demonology,45,22,23
50376,Döremi,tichondrius,1760,warlock,demonology,35,21,14
50377,Wrathh,stormscale,1753,warlock,demonology,51,24,27
50378,Aidadeshu,tichondrius,1750,warlock,demonology,72,33,39
50379,Zörkô,zuljin,1748,warlock,demonology,114,54,60
50380,ßállin,illidan,1745,warlock,demonology,35,22,13
50381,Graendol,tichondrius,1745,warlock,demonology,36,22,14
50382,Melisândre,kiljaeden,1744,warlock,demonology,53,26,27
50383,Eastwitch,ragnaros,1743,warlock,demonology,120,55,65
50384,Magë,ursin,1743,warlock,demonology,114,50,64
50385,Orgcontroler,hyjal,1742,warlock,demonology,67,29,38
50386,Mcpickls,illidan,1740,warlock,demonology,48,26,22
50387,Michae,tichondrius,1740,warlock,demonology,48,25,23
50388,Arityy,tichondrius,1738,warlock,demonology,33,23,10
50389,Missalice,nesingwary,1738,warlock,demonology,42,23,19
50390,Dreadlõck,malganis,1737,warlock,demonology,78,39,39
50391,Saeph,burning-legion,1731,warlock,demonology,72,41,31
50392,Ðëâthløck,tichondrius,1729,warlock,demonology,47,25,22
50393,Brightmoonhw,tichondrius,1729,warlock,demonology,54,27,27
50394,Skullsoul,arthas,1725,warlock,demonology,88,49,39
50395,Lemmewin,illidan,1724,warlock,demonology,24,18,6
50396,Eriebos,area-52,1724,warlock,demonology,60,35,25
50397,Slantsix,tichondrius,1722,warlock,demonology,36,21,15
50398,Lazymongoose,frostmourne,1721,warlock,demonology,167,91,76
50399,Kogath,thunderlord,1721,warlock,demonology,63,32,31
50400,Devilman,darkspear,1720,warlock,demonology,129,64,65
50401,Muchas,area-52,1717,warlock,demonology,30,18,12
50402,Fadedemon,area-52,1716,warlock,demonology,42,32,10
50403,Doomdm,zuljin,1710,warlock,demonology,30,18,12
50404,Sasaology,frostmourne,1706,warlock,demonology,78,41,37
50405,Milkybøng,area-52,1705,warlock,demonology,99,61,38
50406,Shooterg,tichondrius,1704,warlock,demonology,66,32,34
50407,Dìablo,area-52,1702,warlock,demonology,78,43,35
50408,Nethron,the-venture-co,1700,warlock,demonology,72,35,37
50409,Cinderwhip,moon-guard,1696,warlock,demonology,225,112,113
50410,Ourlegacy,tichondrius,1695,warlock,demonology,40,24,16
50411,Necroabuser,area-52,1692,warlock,demonology,40,24,16
50412,Fksm,tichondrius,1692,warlock,demonology,36,20,16
50413,Stopdottroll,zuljin,1690,warlock,demonology,30,18,12
50414,Hulkyy,illidan,1690,warlock,demonology,95,55,40
50415,Tazerr,sargeras,1690,warlock,demonology,57,26,31
50416,Metrow,area-52,1688,warlock,demonology,30,18,12
50417,Leeka,tichondrius,1687,warlock,demonology,48,23,25
50418,Gørb,wyrmrest-accord,1686,warlock,demonology,48,30,18
50419,Notomorrow,tichondrius,1686,warlock,demonology,146,87,59
50420,Ciprýan,azralon,1684,warlock,demonology,82,37,45
50421,Paparoxy,illidan,1681,warlock,demonology,65,30,35
50422,Almostoogood,illidan,1680,warlock,demonology,36,24,12
50423,Scalpelx,tichondrius,1677,warlock,demonology,29,18,11
50424,Daxxter,tichondrius,1677,warlock,demonology,54,28,26
50425,Døtyou,area-52,1676,warlock,demonology,35,18,17
50426,Juswannarock,tichondrius,1676,warlock,demonology,51,25,26
50427,Dlchem,tichondrius,1674,warlock,demonology,88,47,41
50428,Spicyfingerx,illidan,1673,warlock,demonology,36,22,14
50429,Narmazulnn,area-52,1673,warlock,demonology,53,31,22
50430,Fearedu,thunderhorn,1671,warlock,demonology,149,73,76
50431,Zver,drakkari,1669,warlock,demonology,108,57,51
50432,Gløcked,area-52,1666,warlock,demonology,48,26,22
50433,Altairo,illidan,1666,warlock,demonology,82,42,40
50434,Gromy,lightnings-blade,1664,warlock,demonology,113,71,42
50435,Aroug,aggramar,1664,warlock,demonology,102,50,52
50436,Lamdyn,moon-guard,1663,warlock,demonology,84,51,33
50437,Doties,bleeding-hollow,1663,warlock,demonology,42,23,19
50438,Møbscene,bleeding-hollow,1662,warlock,demonology,43,22,21
50439,Mcpickl,illidan,1662,warlock,demonology,54,25,29
50440,Houdneeznuts,tichondrius,1659,warlock,demonology,162,86,76
50441,Eatsleepgame,barthilas,1657,warlock,demonology,50,20,30
50442,Edzeá,frostmourne,1656,warlock,demonology,48,24,24
50443,Archibalding,area-52,1654,warlock,demonology,66,38,28
50444,Rathul,bonechewer,1654,warlock,demonology,61,30,31
50445,Yuengling,illidan,1653,warlock,demonology,144,73,71
50446,Vcain,stormrage,1652,warlock,demonology,66,31,35
50447,Gimmeprecog,tichondrius,1651,warlock,demonology,30,21,9
50448,Fears,norgannon,1651,warlock,demonology,48,29,19
50449,Gihaewon,tichondrius,1650,warlock,demonology,30,20,10
50450,Pikme,bleeding-hollow,1650,warlock,demonology,48,22,26
50451,Bosongo,boulderfist,1648,warlock,demonology,52,31,21
50452,Exofilth,thrall,1648,warlock,demonology,92,54,38
50453,Minichompei,frostmourne,1645,warlock,demonology,41,24,17
50454,Funkminot,illidan,1644,warlock,demonology,295,153,142
50455,Phogy,bleeding-hollow,1644,warlock,demonology,71,35,36
50456,Shuffler,tichondrius,1643,warlock,demonology,36,24,12
50457,Ðåntë,thrall,1643,warlock,demonology,36,22,14
50458,Invisibles,barthilas,1642,warlock,demonology,35,20,15
50459,Juxsr,nerzhul,1642,warlock,demonology,42,22,20
50460,Skanckqt,malganis,1638,warlock,demonology,59,31,28
50461,Bigdotenergi,tichondrius,1637,warlock,demonology,36,25,11
50462,Thelocker,stormrage,1637,warlock,demonology,83,48,35
50463,Torghast,bloodhoof,1637,warlock,demonology,42,21,21
50464,Sobadhahaha,azralon,1635,warlock,demonology,36,23,13
50465,Suzüki,tichondrius,1635,warlock,demonology,36,19,17
50466,Theseance,dalaran,1635,warlock,demonology,60,31,29
50467,Geauxst,tichondrius,1633,warlock,demonology,56,29,27
50468,Oluluo,andorhal,1633,warlock,demonology,41,21,20
50469,Ptwo,illidan,1632,warlock,demonology,30,18,12
50470,Venticm,tichondrius,1631,warlock,demonology,24,17,7
50471,Harrydotterr,bonechewer,1629,warlock,demonology,71,36,35
50472,Azrezzael,area-52,1628,warlock,demonology,36,22,14
50473,Discordance,zuljin,1628,warlock,demonology,30,17,13
50474,Badstepbro,sargeras,1627,warlock,demonology,30,17,13
50475,Ggooudan,tichondrius,1625,warlock,demonology,29,21,8
50476,Turbocleave,blackwater-raiders,1624,warlock,demonology,24,17,7
50477,Jokerxks,tichondrius,1624,warlock,demonology,24,17,7
50478,Séptima,illidan,1623,warlock,demonology,24,17,7
50479,Kreâtor,tichondrius,1623,warlock,demonology,83,46,37
50480,Demonicsmoke,darrowmere,1622,warlock,demonology,104,56,48
50481,Omertà,staghelm,1621,warlock,demonology,64,36,28
50482,Bagn,tichondrius,1620,warlock,demonology,42,23,19
50483,Doombaby,zuljin,1619,warlock,demonology,66,40,26
50484,Mcpickles,illidan,1618,warlock,demonology,30,19,11
50485,Säbrine,zuljin,1617,warlock,demonology,79,36,43
50486,Epinetheus,stormrage,1617,warlock,demonology,54,23,31
50487,Soreanus,illidan,1615,warlock,demonology,48,30,18
50488,Dotzor,area-52,1615,warlock,demonology,52,32,20
50489,Zantology,frostmourne,1615,warlock,demonology,54,31,23
50490,Krýptizl,frostmourne,1615,warlock,demonology,81,45,36
50491,Raisa,chogall,1615,warlock,demonology,48,23,25
50492,Perfectíon,tichondrius,1614,warlock,demonology,30,19,11
50493,Xlilgee,kelthuzad,1614,warlock,demonology,30,17,13
50494,Abismoarmdr,ragnaros,1613,warlock,demonology,115,66,49
50495,Sickmade,zuljin,1612,warlock,demonology,126,72,54
50496,Eternalsmile,tichondrius,1612,warlock,demonology,48,27,21
50497,Garcheros,ragnaros,1612,warlock,demonology,51,27,24
50498,Yükina,stormrage,1611,warlock,demonology,54,29,25
50499,Xanetor,illidan,1611,warlock,demonology,58,31,27
50500,Vawns,zuljin,1611,warlock,demonology,47,24,23
50501,Rasildur,ragnaros,1611,warlock,demonology,61,27,34
50502,Celestialock,tichondrius,1609,warlock,demonology,55,38,17
50503,Hers,vashj,1608,warlock,demonology,54,34,20
50504,Hentry,sargeras,1608,warlock,demonology,47,25,22
50505,Gulßad,tichondrius,1607,warlock,demonology,36,24,12
50506,Diabolock,proudmoore,1607,warlock,demonology,48,26,22
50507,Kronicdotz,bleeding-hollow,1606,warlock,demonology,38,20,18
50508,Vews,firetree,1606,warlock,demonology,36,18,18
50509,Mamabolts,kelthuzad,1605,warlock,demonology,29,18,11
50510,Georky,ragnaros,1605,warlock,demonology,60,36,24
50511,Varian,quelthalas,1604,warlock,demonology,93,53,40
50512,Cambolts,tichondrius,1604,warlock,demonology,36,20,16
50513,Ktlock,frostmourne,1603,warlock,demonology,114,65,49
50514,Emperator,quelthalas,1603,warlock,demonology,46,25,21
50515,Sarcophagus,duskwood,1602,warlock,demonology,33,18,15
50516,Innocentius,illidan,1602,warlock,demonology,82,42,40
50517,Middot,area-52,1601,warlock,demonology,83,39,44
50518,Toestye,lightbringer,1600,warlock,demonology,108,56,52
50519,Pollodelight,deathwing,1598,warlock,demonology,30,21,9
50520,Th,kiljaeden,1596,warlock,demonology,71,33,38
50521,Valkynaris,chogall,1594,warlock,demonology,30,20,10
50522,Warlocklmao,malganis,1594,warlock,demonology,36,19,17
50523,Stonelocke,area-52,1594,warlock,demonology,79,40,39
50524,Thalsiani,moon-guard,1592,warlock,demonology,51,27,24
50525,Yanlexx,stormrage,1592,warlock,demonology,86,44,42
50526,Amour,wyrmrest-accord,1592,warlock,demonology,58,26,32
50527,Yazonics,area-52,1585,warlock,demonology,91,49,42
50528,Creepydotman,mannoroth,1584,warlock,demonology,28,18,10
50529,Ioroselmi,illidan,1583,warlock,demonology,68,45,23
50530,Tsunamibaby,anvilmar,1583,warlock,demonology,138,77,61
50531,Raidspot,bleeding-hollow,1581,warlock,demonology,72,40,32
50532,Goorock,area-52,1581,warlock,demonology,78,40,38
50533,Silentfears,tichondrius,1580,warlock,demonology,39,26,13
50534,Curseifier,frostmourne,1579,warlock,demonology,62,33,29
50535,Dreamsw,frostmourne,1578,warlock,demonology,36,18,18
50536,Agertis,frostmourne,1578,warlock,demonology,42,18,24
50537,Ashlëen,ragnaros,1577,warlock,demonology,114,54,60
50538,Condevil,quelthalas,1576,warlock,demonology,72,39,33
50539,Smallj,zuljin,1576,warlock,demonology,54,27,27
50540,Uwantpeach,tichondrius,1576,warlock,demonology,35,17,18
50541,Nttslock,tichondrius,1575,warlock,demonology,48,24,24
50542,Sadgellation,arthas,1574,warlock,demonology,42,27,15
50543,Redbullsz,bleeding-hollow,1573,warlock,demonology,68,34,34
50544,Wawrlock,stormrage,1572,warlock,demonology,38,27,11
50545,Seekma,gallywix,1572,warlock,demonology,42,25,17
50546,Davekoresh,dunemaul,1571,warlock,demonology,50,27,23
50547,Empiratore,quelthalas,1569,warlock,demonology,59,26,33
50548,Xephostwo,area-52,1567,warlock,demonology,42,20,22
50549,Xaryl,stormrage,1564,warlock,demonology,108,52,56
50550,Caesaros,quelthalas,1563,warlock,demonology,87,40,47
50551,Miryem,illidan,1556,warlock,demonology,67,36,31
50552,Blastfinger,tichondrius,1556,warlock,demonology,66,33,33
50553,Spicyfingerx,zangarmarsh,1554,warlock,demonology,30,17,13
50554,Rococo,emerald-dream,1554,warlock,demonology,30,17,13
50555,Smartpimp,tichondrius,1553,warlock,demonology,44,25,19
50556,Fullxd,quelthalas,1551,warlock,demonology,54,31,23
50557,Voltshot,tichondrius,1549,warlock,demonology,475,242,233
50558,Kìllèrgf,area-52,1549,warlock,demonology,249,124,125
50559,Spooknjuke,bleeding-hollow,1546,warlock,demonology,41,26,15
50560,Wickdways,daggerspine,1546,warlock,demonology,54,32,22
50561,Bauchalain,area-52,1541,warlock,demonology,36,21,15
50562,Nyhn,bleeding-hollow,1540,warlock,demonology,32,21,11
50563,Spookyfurry,area-52,1538,warlock,demonology,89,52,37
50564,Lamo,dawnbringer,1537,warlock,demonology,232,117,115
50565,Maldinath,sargeras,1535,warlock,demonology,24,16,8
50566,Soulrulerxc,tichondrius,1534,warlock,demonology,30,16,14
50567,Isometrics,barthilas,1534,warlock,demonology,30,16,14
50568,Heartpvp,tichondrius,1532,warlock,demonology,92,48,44
50569,Cilium,illidan,1531,warlock,demonology,62,33,29
50570,Forsâken,tichondrius,1531,warlock,demonology,95,42,53
50571,Giantgobrin,zuljin,1529,warlock,demonology,30,16,14
50572,Gigagnomer,kelthuzad,1528,warlock,demonology,65,30,35
50573,Deathcyth,crushridge,1523,warlock,demonology,179,96,83
50574,Wollylock,dark-iron,1520,warlock,demonology,52,25,27
50575,Volanti,bleeding-hollow,1516,warlock,demonology,42,24,18
50576,Fãttyqt,sargeras,1513,warlock,demonology,52,35,17
50577,Kandrus,moon-guard,1508,warlock,demonology,158,79,79
50578,Comina,kelthuzad,1507,warlock,demonology,36,16,20
50579,Krolczdots,tichondrius,1505,warlock,demonology,30,18,12
50580,Proletariat,moon-guard,1503,warlock,demonology,64,38,26
50581,Parmenides,tichondrius,1502,warlock,demonology,112,56,56
50582,Icemanliddel,area-52,1500,warlock,demonology,35,16,19
50583,Hoana,azralon,1495,warlock,demonology,111,60,51
50584,Thekook,illidan,1495,warlock,demonology,43,21,22
50585,Shigero,tichondrius,1494,warlock,demonology,30,19,11
50586,Reczy,azralon,1494,warlock,demonology,30,16,14
50587,Prägä,drakkari,1493,warlock,demonology,51,27,24
50588,Zuulusi,stormrage,1491,warlock,demonology,36,16,20
50589,Damerus,illidan,1487,warlock,demonology,57,24,33
50590,Dárklórd,dalaran,1485,warlock,demonology,214,110,104
50591,Eriand,nordrassil,1482,warlock,demonology,108,54,54
50592,Mindfulchimp,sargeras,1480,warlock,demonology,49,27,22
50593,Zhoull,thrall,1479,warlock,demonology,48,23,25
50594,Grixis,zuluhed,1478,warlock,demonology,36,23,13
50595,Sacrilege,zuljin,1474,warlock,demonology,30,18,12
50596,Fabriziø,ragnaros,1472,warlock,demonology,31,21,10
50597,Mssy,illidan,1470,warlock,demonology,29,16,13
50598,Kyller,quelthalas,1470,warlock,demonology,30,16,14
50599,Jyhoona,chromaggus,1468,warlock,demonology,473,237,236
50600,Tubarão,azralon,1467,warlock,demonology,42,26,16
50601,Fluffylockk,bloodscalp,1466,warlock,demonology,58,32,26
50602,Khanaan,illidan,1466,warlock,demonology,30,16,14
50603,Dcpwns,arthas,1461,warlock,demonology,96,47,49
50604,Blavindy,illidan,1461,warlock,demonology,54,26,28
50605,Sugarwaffles,area-52,1460,warlock,demonology,60,33,27
50606,Immortallock,tichondrius,1454,warlock,demonology,96,48,48
50607,Kothoped,wyrmrest-accord,1451,warlock,demonology,41,20,21
50608,Musgrin,gallywix,1448,warlock,demonology,76,38,38
50609,Malegnant,proudmoore,1442,warlock,demonology,42,20,22
50610,Imgxyz,frostmourne,1441,warlock,demonology,54,32,22
50611,Shadowsloc,tichondrius,1439,warlock,demonology,18,15,3
50612,Darkwîngduck,illidan,1439,warlock,demonology,24,15,9
50613,Epícburn,illidan,1439,warlock,demonology,28,16,12
50614,Exuslock,tichondrius,1438,warlock,demonology,24,15,9
50615,Ötì,altar-of-storms,1437,warlock,demonology,30,18,12
50616,Sosahawk,stormrage,1437,warlock,demonology,30,15,15
50617,Dottcha,blackrock,1436,warlock,demonology,24,15,9
50618,Zorah,quelthalas,1436,warlock,demonology,42,22,20
50619,Chaosboltlol,tichondrius,1436,warlock,demonology,30,15,15
50620,Helyana,illidan,1433,warlock,demonology,53,31,22
50621,Feinnx,dalaran,1433,warlock,demonology,36,15,21
50622,Synisterlock,moon-guard,1432,warlock,demonology,36,18,18
50623,Eminence,stormrage,1428,warlock,demonology,30,15,15
50624,Aomniloltv,zuljin,1426,warlock,demonology,24,15,9
50625,Zxyastra,hyjal,1426,warlock,demonology,30,17,13
50626,Mothapucka,thrall,1426,warlock,demonology,47,21,26
50627,Løcalplugxø,barthilas,1425,warlock,demonology,24,15,9
50628,Boltsfordays,dalaran,1423,warlock,demonology,42,16,26
50629,Diosban,malganis,1422,warlock,demonology,36,16,20
50630,Hibíky,ragnaros,1422,warlock,demonology,36,15,21
50631,Arlenna,sargeras,1419,warlock,demonology,128,60,68
50632,Zrò,bleeding-hollow,1416,warlock,demonology,24,15,9
50633,Mixolydian,malganis,1416,warlock,demonology,30,15,15
50634,Bïcho,queldorei,1414,warlock,demonology,30,15,15
50635,Mysteryannie,tichondrius,1411,warlock,demonology,88,53,35
50636,Kuyog,illidan,1411,warlock,demonology,60,30,30
50637,Ganknãmstyle,illidan,1411,warlock,demonology,65,31,34
50638,Laggyturbo,barthilas,1409,warlock,demonology,66,38,28
50639,Rotsndotss,thrall,1408,warlock,demonology,48,20,28
50640,Valerik,azralon,1407,warlock,demonology,60,28,32
50641,Guisls,azralon,1407,warlock,demonology,60,26,34
50642,Siaokuai,tichondrius,1403,warlock,demonology,36,15,21
50643,Adlfcritler,emerald-dream,1402,warlock,demonology,36,19,17
50644,Lockeem,jubeithos,1397,warlock,demonology,42,24,18
50645,Monstir,sargeras,1396,warlock,demonology,31,16,15
50646,Munick,spirestone,1394,warlock,demonology,30,21,9
50647,Suminl,tichondrius,1392,warlock,demonology,24,15,9
50648,Kuroyt,drakkari,1390,warlock,demonology,67,32,35
50649,Avoidence,tanaris,1389,warlock,demonology,36,19,17
50650,Intura,burning-legion,1386,warlock,demonology,30,17,13
50651,Marowyth,ragnaros,1380,warlock,demonology,36,20,16
50652,Kotica,stormrage,1377,warlock,demonology,34,17,17
50653,Gandorf,alleria,1376,warlock,demonology,36,17,19
50654,Guldorum,kiljaeden,1375,warlock,demonology,48,28,20
50655,Nezsarek,sargeras,1373,warlock,demonology,41,22,19
50656,Sayatar,ragnaros,1373,warlock,demonology,30,16,14
50657,Destrokk,gorefiend,1372,warlock,demonology,42,24,18
50658,Catarina,kaelthas,1371,warlock,demonology,28,15,13
50659,Mocreia,azralon,1370,warlock,demonology,34,16,18
50660,Medallok,laughing-skull,1363,warlock,demonology,119,58,61
50661,Felorc,wyrmrest-accord,1358,warlock,demonology,63,39,24
50662,Narcan,arthas,1358,warlock,demonology,35,16,19
50663,Tizzy,malganis,1356,warlock,demonology,38,25,13
50664,Conilus,malganis,1354,warlock,demonology,48,20,28
50665,Lintlickin,bonechewer,1353,warlock,demonology,20,15,5
50666,Lemongillo,stormrage,1349,warlock,demonology,47,25,22
50667,Ellynaria,nemesis,1343,warlock,demonology,18,14,4
50668,Gnomechomski,magtheridon,1343,warlock,demonology,24,14,10
50669,Biubius,tichondrius,1343,warlock,demonology,24,14,10
50670,Haunt,mugthol,1343,warlock,demonology,24,14,10
50671,Idotû,tichondrius,1343,warlock,demonology,30,14,16
50672,Joung,tichondrius,1342,warlock,demonology,24,14,10
50673,Slothycrip,emerald-dream,1342,warlock,demonology,36,14,22
50674,Demonalien,malganis,1339,warlock,demonology,18,14,4
50675,Fearbarx,illidan,1339,warlock,demonology,24,14,10
50676,Tickleskin,windrunner,1337,warlock,demonology,111,57,54
50677,Sphîñx,sargeras,1337,warlock,demonology,50,21,29
50678,Antigotenent,sargeras,1336,warlock,demonology,24,14,10
50679,Djvetis,blackhand,1336,warlock,demonology,24,14,10
50680,Ezgamejr,tichondrius,1334,warlock,demonology,18,14,4
50681,Jamesiyah,moon-guard,1333,warlock,demonology,60,29,31
50682,Smôkedsôul,area-52,1330,warlock,demonology,24,14,10
50683,Ézman,tichondrius,1330,warlock,demonology,24,14,10
50684,Bestwarlock,skywall,1328,warlock,demonology,30,14,16
50685,Eldriptch,kelthuzad,1325,warlock,demonology,27,15,12
50686,Stormrift,sargeras,1325,warlock,demonology,36,14,22
50687,Memon,frostmane,1324,warlock,demonology,65,29,36
50688,Es,velen,1321,warlock,demonology,144,74,70
50689,Superjuno,sargeras,1319,warlock,demonology,18,14,4
50690,Warlockluo,tichondrius,1319,warlock,demonology,24,14,10
50691,Dawdrax,gallywix,1313,warlock,demonology,22,15,7
50692,Jokerks,tichondrius,1310,warlock,demonology,23,14,9
50693,Mechamaca,black-dragonflight,1308,warlock,demonology,96,45,51
50694,Andlerock,emerald-dream,1305,warlock,demonology,37,22,15
50695,Brawndelock,stormrage,1304,warlock,demonology,60,26,34
50696,Sû,stormrage,1301,warlock,demonology,84,40,44
50697,Bashel,sargeras,1300,warlock,demonology,24,15,9
50698,Shadowflame,skullcrusher,1299,warlock,demonology,91,48,43
50699,Critthis,illidan,1297,warlock,demonology,30,14,16
50700,Daesire,moon-guard,1295,warlock,demonology,30,14,16
50701,Valerilma,azralon,1284,warlock,demonology,40,18,22
50702,Warlockdelux,thrall,1282,warlock,demonology,54,20,34
50703,Gauul,illidan,1281,warlock,demonology,70,39,31
50704,Heathncraig,illidan,1279,warlock,demonology,50,29,21
50705,Screampied,sargeras,1279,warlock,demonology,53,24,29
50706,Yoyoling,illidan,1277,warlock,demonology,258,129,129
50707,Regime,deathwing,1275,warlock,demonology,24,14,10
50708,Cornboil,tichondrius,1274,warlock,demonology,57,27,30
50709,Dôctor,tichondrius,1274,warlock,demonology,64,30,34
50710,Voidwarlord,tichondrius,1271,warlock,demonology,107,56,51
50711,Spicydots,arthas,1270,warlock,demonology,54,28,26
50712,Willsayan,ragnaros,1266,warlock,demonology,42,16,26
50713,Bluffzlock,boulderfist,1260,warlock,demonology,23,14,9
50714,Owwie,malganis,1258,warlock,demonology,22,14,8
50715,Bänno,bleeding-hollow,1256,warlock,demonology,29,14,15
50716,Wazog,jubeithos,1250,warlock,demonology,30,16,14
50717,Salacia,chogall,1249,warlock,demonology,171,83,88
50718,Adonege,tichondrius,1248,warlock,demonology,24,13,11
50719,Drakatat,tichondrius,1248,warlock,demonology,24,13,11
50720,Deathboltx,zuljin,1248,warlock,demonology,24,13,11
50721,Welpxd,tichondrius,1247,warlock,demonology,18,13,5
50722,Pfhear,area-52,1247,warlock,demonology,24,13,11
50723,Mukkamuk,shadowmoon,1246,warlock,demonology,18,13,5
50724,Evianne,skywall,1244,warlock,demonology,30,13,17
50725,Homeschooler,darkspear,1243,warlock,demonology,24,13,11
50726,Warlockafk,darkspear,1242,warlock,demonology,24,17,7
50727,Beerbolt,dalaran,1242,warlock,demonology,24,13,11
50728,Pardoned,stormrage,1241,warlock,demonology,36,13,23
50729,Demonkiiller,kelthuzad,1237,warlock,demonology,30,13,17
50730,Esdreel,ragnaros,1236,warlock,demonology,24,13,11
50731,Drain,proudmoore,1233,warlock,demonology,18,13,5
50732,Tomzombe,durotan,1233,warlock,demonology,18,13,5
50733,Lpharji,tichondrius,1231,warlock,demonology,24,13,11
50734,Alaren,korgath,1231,warlock,demonology,36,13,23
50735,Welendiock,malganis,1228,warlock,demonology,43,21,22
50736,Ipickcotton,barthilas,1223,warlock,demonology,30,13,17
50737,Gotfear,zuljin,1222,warlock,demonology,280,139,141
50738,Symplicìty,area-52,1219,warlock,demonology,24,13,11
50739,Naydene,moon-guard,1219,warlock,demonology,66,31,35
50740,Aniie,nemesis,1212,warlock,demonology,78,35,43
50741,Arcaangell,sargeras,1206,warlock,demonology,69,36,33
50742,Zeeref,stormrage,1206,warlock,demonology,30,13,17
50743,Demophile,bleeding-hollow,1204,warlock,demonology,24,18,6
50744,Lockdlhm,tichondrius,1197,warlock,demonology,23,13,10
50745,Bazeni,frostmourne,1193,warlock,demonology,24,13,11
50746,Jezzika,azralon,1183,warlock,demonology,57,22,35
50747,Adistril,bleeding-hollow,1182,warlock,demonology,48,14,34
50748,Syndrielle,emerald-dream,1181,warlock,demonology,54,22,32
50749,Artmaster,nordrassil,1174,warlock,demonology,30,20,10
50750,Snuffer,detheroc,1164,warlock,demonology,30,13,17
50751,Stankidanky,illidan,1156,warlock,demonology,30,18,12
50752,Thefunk,tichondrius,1152,warlock,demonology,18,12,6
50753,Voidxz,tichondrius,1152,warlock,demonology,18,12,6
50754,Medzor,tichondrius,1152,warlock,demonology,24,12,12
50755,Blliizz,aegwynn,1151,warlock,demonology,18,12,6
50756,Demise,azuremyst,1151,warlock,demonology,24,12,12
50757,Demonia,dathremar,1151,warlock,demonology,30,12,18
50758,Spectaclol,crushridge,1150,warlock,demonology,18,12,6
50759,Lentil,zuljin,1150,warlock,demonology,18,12,6
50760,Emurog,icecrown,1150,warlock,demonology,18,12,6
50761,Bellatriks,nemesis,1149,warlock,demonology,18,12,6
50762,Chipt,kelthuzad,1149,warlock,demonology,30,12,18
50763,Urfucct,burning-blade,1148,warlock,demonology,18,12,6
50764,Drkdestro,boulderfist,1148,warlock,demonology,42,12,30
50765,Moryan,malfurion,1136,warlock,demonology,33,13,20
50766,Bizcochito,thrall,1134,warlock,demonology,24,12,12
50767,Saltiernuts,malganis,1128,warlock,demonology,48,22,26
50768,Xtralyfe,hyjal,1117,warlock,demonology,22,12,10
50769,Löksöflöve,sargeras,1101,warlock,demonology,60,25,35
50770,Nellon,azralon,1087,warlock,demonology,26,13,13
50771,Elipsis,bloodhoof,1086,warlock,demonology,23,12,11
50772,Sumondeznuts,wyrmrest-accord,1080,warlock,demonology,23,12,11
50773,Politepvperx,kelthuzad,1070,warlock,demonology,17,12,5
50774,Maroth,elune,1070,warlock,demonology,30,12,18
50775,Lilmollyboy,demon-soul,1068,warlock,demonology,13,12,1
50776,Netherhigh,tichondrius,1061,warlock,demonology,66,32,34
50777,Bøltqt,tichondrius,1056,warlock,demonology,12,11,1
50778,Igortrikadva,zuljin,1056,warlock,demonology,12,11,1
50779,Waii,emerald-dream,1056,warlock,demonology,12,11,1
50780,Starta,tichondrius,1056,warlock,demonology,18,11,7
50781,Itzlandox,emerald-dream,1056,warlock,demonology,18,11,7
50782,Samsara,akama,1056,warlock,demonology,18,11,7
50783,Betterone,azralon,1055,warlock,demonology,18,11,7
50784,Decolock,tichondrius,1055,warlock,demonology,18,11,7
50785,Blastyboat,terenas,1055,warlock,demonology,18,11,7
50786,Fotmspec,area-52,1055,warlock,demonology,18,11,7
50787,Minervini,kiljaeden,1054,warlock,demonology,12,11,1
50788,Praemonium,dalaran,1054,warlock,demonology,18,11,7
50789,Jblock,zuljin,1053,warlock,demonology,21,12,9
50790,Devilin,drakkari,1052,warlock,demonology,24,11,13
50791,Choas,jaedenar,1051,warlock,demonology,18,11,7
50792,Menedemus,amanthul,1050,warlock,demonology,24,11,13
50793,Mêdìvh,tichondrius,1050,warlock,demonology,24,11,13
50794,Zinkro,quelthalas,1049,warlock,demonology,22,12,10
50795,Tròll,moon-guard,1049,warlock,demonology,54,25,29
50796,Prahvstein,shuhalo,1047,warlock,demonology,18,11,7
50797,Tartamuda,ragnaros,1037,warlock,demonology,30,11,19
50798,Yozzik,illidan,1036,warlock,demonology,29,11,18
50799,Rickrock,gnomeregan,1034,warlock,demonology,18,11,7
50800,Teron,stonemaul,1031,warlock,demonology,18,11,7
50801,Westhøf,sargeras,1023,warlock,demonology,17,11,6
50802,Rannieck,dark-iron,1022,warlock,demonology,16,12,4
50803,Elyshia,illidan,1008,warlock,demonology,33,12,21
50804,Tichondrus,ragnaros,1007,warlock,demonology,29,11,18
50805,Lukelock,azralon,990,warlock,demonology,22,11,11
50806,Uzag,mugthol,975,warlock,demonology,26,11,15
50807,Hecataeus,stormrage,960,warlock,demonology,12,10,2
50808,Phyxylock,stormrage,960,warlock,demonology,12,10,2
50809,Meltlordqt,mannoroth,960,warlock,demonology,12,10,2
50810,Suwook,tichondrius,960,warlock,demonology,12,10,2
50811,Felegance,proudmoore,960,warlock,demonology,18,10,8
50812,Spacedots,illidan,960,warlock,demonology,18,10,8
50813,Idiocy,stormrage,960,warlock,demonology,18,10,8
50814,Vexice,firetree,960,warlock,demonology,18,10,8
50815,Xyguoguo,tichondrius,960,warlock,demonology,18,10,8
50816,Wdc,illidan,960,warlock,demonology,24,10,14
50817,Millions,barthilas,960,warlock,demonology,24,10,14
50818,Syraxi,illidan,959,warlock,demonology,18,10,8
50819,Tesil,tichondrius,959,warlock,demonology,18,10,8
50820,Purraisa,tichondrius,959,warlock,demonology,18,10,8
50821,Firemarshall,stormrage,959,warlock,demonology,18,10,8
50822,Lockman,frostwolf,959,warlock,demonology,24,12,12
50823,Criptix,bleeding-hollow,959,warlock,demonology,24,10,14
50824,Lefteexd,tichondrius,959,warlock,demonology,24,10,14
50825,Conely,barthilas,959,warlock,demonology,24,10,14
50826,Hâm,dalaran,959,warlock,demonology,36,10,26
50827,Nêlson,area-52,958,warlock,demonology,18,10,8
50828,Lynnha,wyrmrest-accord,958,warlock,demonology,24,10,14
50829,Shâdowman,stormrage,957,warlock,demonology,18,10,8
50830,Nurglea,proudmoore,957,warlock,demonology,18,10,8
50831,Lockswagger,stormrage,956,warlock,demonology,18,10,8
50832,Zaintv,illidan,955,warlock,demonology,18,10,8
50833,Kaertis,emerald-dream,955,warlock,demonology,21,11,10
50834,Anjkh,skullcrusher,955,warlock,demonology,24,10,14
50835,Leine,proudmoore,955,warlock,demonology,24,10,14
50836,Sytrick,bleeding-hollow,955,warlock,demonology,24,10,14
50837,Canning,shuhalo,954,warlock,demonology,24,10,14
50838,Methrocks,emerald-dream,953,warlock,demonology,24,10,14
50839,Sørceress,bonechewer,948,warlock,demonology,18,10,8
50840,Shadowndko,ragnaros,937,warlock,demonology,18,10,8
50841,Bugbugg,tichondrius,927,warlock,demonology,17,10,7
50842,Pellah,malganis,926,warlock,demonology,20,11,9
50843,Voldamorte,tichondrius,925,warlock,demonology,23,10,13
50844,Voodootidies,proudmoore,922,warlock,demonology,27,13,14
50845,Demonicdayer,area-52,921,warlock,demonology,19,11,8
50846,Sheara,silver-hand,905,warlock,demonology,24,10,14
50847,Cslice,magtheridon,896,warlock,demonology,16,10,6
50848,Twinklockxx,mannoroth,895,warlock,demonology,23,10,13
50849,Apples,ravencrest,894,warlock,demonology,17,10,7
50850,Idoturmum,frostmourne,889,warlock,demonology,27,11,16
50851,Muchø,emerald-dream,864,warlock,demonology,12,9,3
50852,Leleth,nordrassil,864,warlock,demonology,12,9,3
50853,Maxice,zuljin,864,warlock,demonology,12,9,3
50854,Impenjoyer,tichondrius,864,warlock,demonology,12,9,3
50855,Wamage,malganis,864,warlock,demonology,12,9,3
50856,Peterdotz,whisperwind,864,warlock,demonology,13,9,4
50857,Soorisoori,tichondrius,864,warlock,demonology,18,9,9
50858,Djdemolordx,bleeding-hollow,864,warlock,demonology,18,9,9
50859,Bewær,deathwing,864,warlock,demonology,18,9,9
50860,Luku,kiljaeden,864,warlock,demonology,18,9,9
50861,Caduz,stormrage,864,warlock,demonology,18,9,9
50862,Evanylock,proudmoore,864,warlock,demonology,18,9,9
50863,Dxhusky,tichondrius,864,warlock,demonology,18,9,9
50864,Jæja,wyrmrest-accord,864,warlock,demonology,18,9,9
50865,Imbooms,blackrock,864,warlock,demonology,18,9,9
50866,Louu,emerald-dream,864,warlock,demonology,18,9,9
50867,Jorloz,ragnaros,863,warlock,demonology,12,9,3
50868,Crujonez,sargeras,863,warlock,demonology,12,9,3
50869,Fatals,thrall,863,warlock,demonology,12,9,3
50870,Demic,thrall,863,warlock,demonology,18,9,9
50871,Dudebrø,zuluhed,863,warlock,demonology,18,9,9
50872,Hermania,sargeras,863,warlock,demonology,18,9,9
50873,Criticalpets,stormrage,863,warlock,demonology,18,9,9
50874,Freadle,sargeras,863,warlock,demonology,24,9,15
50875,Päpï,tichondrius,862,warlock,demonology,12,9,3
50876,Harleyjames,ravenholdt,862,warlock,demonology,12,9,3
50877,Oopsíe,nagrand,860,warlock,demonology,24,9,15
50878,Easymac,thunderlord,860,warlock,demonology,24,9,15
50879,Mementomøri,quelthalas,858,warlock,demonology,24,9,15
50880,Braylon,azuremyst,856,warlock,demonology,18,9,9
50881,Wakkundoe,tichondrius,846,warlock,demonology,17,9,8
50882,Orbvoid,sargeras,845,warlock,demonology,24,9,15
50883,Demoniclily,kiljaeden,816,warlock,demonology,21,9,12
50884,Cleavüs,stormrage,815,warlock,demonology,11,9,2
50885,Keturáh,garrosh,794,warlock,demonology,28,12,16
50886,Westhofs,sargeras,768,warlock,demonology,12,8,4
50887,Asmion,earthen-ring,768,warlock,demonology,12,8,4
50888,Menemies,malganis,768,warlock,demonology,12,8,4
50889,Pvtpotato,tichondrius,768,warlock,demonology,12,8,4
50890,Gnumbnutz,blades-edge,768,warlock,demonology,12,8,4
50891,Famelol,tichondrius,768,warlock,demonology,12,8,4
50892,Lhordeign,area-52,768,warlock,demonology,12,8,4
50893,Vølt,illidan,768,warlock,demonology,12,8,4
50894,Bigboltkazar,tichondrius,768,warlock,demonology,12,8,4
50895,Rizzofsparta,stormrage,768,warlock,demonology,12,8,4
50896,Tydar,bleeding-hollow,768,warlock,demonology,12,8,4
50897,Gigabiga,tol-barad,768,warlock,demonology,12,8,4
50898,Marshyxd,tichondrius,768,warlock,demonology,12,8,4
50899,Moramont,stormrage,768,warlock,demonology,12,8,4
50900,Wrathzn,azralon,768,warlock,demonology,12,8,4
50901,Possapp,azralon,768,warlock,demonology,12,8,4
50902,Dunni,area-52,768,warlock,demonology,18,8,10
50903,Vasqu,stormrage,768,warlock,demonology,18,8,10
50904,Niava,tichondrius,768,warlock,demonology,18,8,10
50905,Joseph,draktharon,768,warlock,demonology,18,8,10
50906,Nismo,trollbane,768,warlock,demonology,18,8,10
50907,Torowasabi,tichondrius,768,warlock,demonology,21,8,13
50908,Puchador,sargeras,768,warlock,demonology,24,8,16
50909,Neutrinowal,tichondrius,768,warlock,demonology,24,8,16
50910,Rosacrutian,tichondrius,767,warlock,demonology,12,8,4
50911,Gibberishss,tichondrius,767,warlock,demonology,12,8,4
50912,Grendael,area-52,767,warlock,demonology,12,8,4
50913,Juankkii,bonechewer,767,warlock,demonology,12,8,4
50914,Aboode,blackrock,767,warlock,demonology,18,8,10
50915,Fullmelt,azjolnerub,767,warlock,demonology,18,8,10
50916,Ritzhul,nordrassil,766,warlock,demonology,12,8,4
50917,Bojàck,stormrage,766,warlock,demonology,12,8,4
50918,Elioknight,area-52,766,warlock,demonology,18,8,10
50919,Lustyclam,tichondrius,765,warlock,demonology,12,8,4
50920,Xenagos,antonidas,765,warlock,demonology,18,8,10
50921,Cvntpvntcans,kelthuzad,764,warlock,demonology,18,8,10
50922,Pulentinskin,quelthalas,764,warlock,demonology,24,8,16
50923,Grimrizz,ragnaros,763,warlock,demonology,12,8,4
50924,Griffoz,frostwolf,763,warlock,demonology,18,8,10
50925,Dundreavan,area-52,763,warlock,demonology,18,8,10
50926,Eeso,stormrage,754,warlock,demonology,24,8,16
50927,Pestileus,bleeding-hollow,749,warlock,demonology,12,8,4
50928,Doobielock,kelthuzad,734,warlock,demonology,14,9,5
50929,Getavoided,azralon,714,warlock,demonology,13,9,4
50930,Bâppo,antonidas,714,warlock,demonology,24,11,13
50931,Eklypso,kelthuzad,714,warlock,demonology,20,9,11
50932,Nurnok,ragnaros,713,warlock,demonology,18,9,9
50933,Tikz,magtheridon,703,warlock,demonology,11,8,3
50934,Demofliction,stormrage,687,warlock,demonology,11,8,3
50935,Nockdreal,azralon,672,warlock,demonology,12,7,5
50936,Løckyun,tichondrius,672,warlock,demonology,12,7,5
50937,Bestcookies,malganis,672,warlock,demonology,12,7,5
50938,Jweezy,malganis,672,warlock,demonology,12,7,5
50939,Lánathel,ragnaros,672,warlock,demonology,12,7,5
50940,Agla,quelthalas,672,warlock,demonology,12,7,5
50941,Lifeinsuranc,tichondrius,672,warlock,demonology,12,7,5
50942,Syen,quelthalas,672,warlock,demonology,12,7,5
50943,Dadtired,tichondrius,672,warlock,demonology,12,7,5
50944,Aruotnof,nemesis,672,warlock,demonology,12,7,5
50945,Blaxzlock,stormscale,672,warlock,demonology,12,7,5
50946,Sauronne,illidan,672,warlock,demonology,12,7,5
50947,Smoogzi,tichondrius,672,warlock,demonology,12,7,5
50948,Gearboxx,tichondrius,672,warlock,demonology,12,7,5
50949,Demonmal,frostmourne,672,warlock,demonology,12,7,5
50950,Playandlock,illidan,672,warlock,demonology,12,7,5
50951,Drix,wyrmrest-accord,672,warlock,demonology,12,7,5
50952,Isömetrics,barthilas,672,warlock,demonology,12,7,5
50953,Deammon,tichondrius,672,warlock,demonology,12,7,5
50954,Juppup,tichondrius,672,warlock,demonology,12,7,5
50955,Zeexi,illidan,672,warlock,demonology,12,7,5
50956,Ðamndaddy,sargeras,672,warlock,demonology,12,7,5
50957,Laiquisha,zuljin,672,warlock,demonology,12,7,5
50958,Fearmore,bleeding-hollow,672,warlock,demonology,12,7,5
50959,Expiredonion,bleeding-hollow,672,warlock,demonology,12,7,5
50960,Sorenbjerga,zuljin,672,warlock,demonology,12,7,5
50961,Protomán,agamaggan,672,warlock,demonology,12,7,5
50962,Matrriixx,proudmoore,672,warlock,demonology,18,7,11
50963,Nefertarie,illidan,672,warlock,demonology,18,7,11
50964,Staywrong,malganis,672,warlock,demonology,18,7,11
50965,Acejerk,the-forgotten-coast,672,warlock,demonology,18,7,11
50966,Demodar,tol-barad,672,warlock,demonology,18,7,11
50967,Urïk,stormrage,672,warlock,demonology,18,7,11
50968,Evarona,gorefiend,672,warlock,demonology,18,7,11
50969,Ranil,mannoroth,672,warlock,demonology,18,7,11
50970,Nigthdeath,nemesis,671,warlock,demonology,12,7,5
50971,Saldori,malganis,671,warlock,demonology,12,7,5
50972,Snoosnoo,exodar,671,warlock,demonology,12,7,5
50973,Lockmau,azralon,671,warlock,demonology,12,7,5
50974,Celindeyn,stormrage,671,warlock,demonology,12,7,5
50975,Faraday,laughing-skull,671,warlock,demonology,12,7,5
50976,Felynrith,khadgar,671,warlock,demonology,12,7,5
50977,Nëcrophil,area-52,671,warlock,demonology,12,7,5
50978,Damagexx,the-underbog,671,warlock,demonology,12,7,5
50979,Glortheeb,spirestone,671,warlock,demonology,12,7,5
50980,Dotsfired,crushridge,671,warlock,demonology,18,7,11
50981,Chelythalle,tichondrius,671,warlock,demonology,19,7,12
50982,Sanastik,laughing-skull,670,warlock,demonology,12,7,5
50983,Deanwarlock,sargeras,670,warlock,demonology,12,7,5
50984,Belloch,frostmourne,669,warlock,demonology,12,7,5
50985,Lokiiee,azuremyst,664,warlock,demonology,12,7,5
50986,Tsmcfker,tichondrius,654,warlock,demonology,17,7,10
50987,Blunder,frostmourne,623,warlock,demonology,11,7,4
50988,Heilcyon,illidan,622,warlock,demonology,11,7,4
50989,Chlomakï,azralon,622,warlock,demonology,11,7,4
50990,Chaosboltex,tichondrius,618,warlock,demonology,14,8,6
50991,Mssyy,illidan,608,warlock,demonology,10,7,3
50992,Vueltoachote,stormrage,592,warlock,demonology,13,7,6
50993,Comply,frostmane,592,warlock,demonology,13,7,6
50994,Hof,bloodscalp,576,warlock,demonology,6,6,0
50995,Dazevil,burning-blade,576,warlock,demonology,6,6,0
50996,Spectro,laughing-skull,576,warlock,demonology,6,6,0
50997,Spook,steamwheedle-cartel,576,warlock,demonology,6,6,0
50998,Grimløck,khadgar,576,warlock,demonology,6,6,0
50999,Fakemagician,tichondrius,576,warlock,demonology,6,6,0
51000,Vìqtìm,kelthuzad,576,warlock,demonology,6,6,0
51001,Lillpfudd,area-52,576,warlock,demonology,6,6,0
51002,Toxik,zuljin,576,warlock,demonology,6,6,0
51003,Wâg,moon-guard,576,warlock,demonology,6,6,0
51004,Dingis,bloodscalp,576,warlock,demonology,6,6,0
51005,Hank,azgalor,576,warlock,demonology,6,6,0
51006,Honne,sargeras,576,warlock,demonology,10,7,3
51007,Backseatn,tichondrius,576,warlock,demonology,12,6,6
51008,Graveland,frostwolf,576,warlock,demonology,12,6,6
51009,Marothredd,nathrezim,576,warlock,demonology,12,6,6
51010,Exxosl,tichondrius,576,warlock,demonology,12,6,6
51011,Bellath,azralon,576,warlock,demonology,12,6,6
51012,Sorath,blackrock,576,warlock,demonology,12,6,6
51013,Oniyooshi,kelthuzad,576,warlock,demonology,12,6,6
51014,Hoonjojjyanl,tichondrius,576,warlock,demonology,12,6,6
51015,Zoerina,fizzcrank,576,warlock,demonology,12,6,6
51016,Westhofz,tichondrius,576,warlock,demonology,12,6,6
51017,Destructio,tichondrius,576,warlock,demonology,12,6,6
51018,Pumpkeenky,hyjal,576,warlock,demonology,12,6,6
51019,Dalah,illidan,576,warlock,demonology,12,6,6
51020,Eddybigbolts,tichondrius,576,warlock,demonology,12,6,6
51021,Babybolt,frostmourne,576,warlock,demonology,12,6,6
51022,Rottenhell,kelthuzad,576,warlock,demonology,12,6,6
51023,Projectpump,kelthuzad,576,warlock,demonology,12,6,6
51024,Davidofbowie,burning-legion,576,warlock,demonology,12,6,6
51025,Kyralena,stormrage,576,warlock,demonology,12,6,6
51026,Linestrazsa,daggerspine,576,warlock,demonology,12,6,6
51027,Yaldin,nemesis,576,warlock,demonology,12,6,6
51028,Scarletdemon,malganis,576,warlock,demonology,12,6,6
51029,Threedotfivu,proudmoore,576,warlock,demonology,12,6,6
51030,Radii,bladefist,576,warlock,demonology,12,6,6
51031,Chaosblade,burning-blade,576,warlock,demonology,12,6,6
51032,Kossnen,shandris,576,warlock,demonology,12,6,6
51033,Conboii,tichondrius,576,warlock,demonology,12,6,6
51034,Therru,tichondrius,576,warlock,demonology,12,6,6
51035,Meelady,tichondrius,576,warlock,demonology,12,6,6
51036,Vexria,wyrmrest-accord,576,warlock,demonology,12,6,6
51037,Nolb,tichondrius,576,warlock,demonology,12,6,6
51038,Diabhlaí,tichondrius,576,warlock,demonology,12,6,6
51039,Muchopower,ragnaros,576,warlock,demonology,12,6,6
51040,Artzul,tichondrius,576,warlock,demonology,15,7,8
51041,Mucholock,azralon,576,warlock,demonology,18,6,12
51042,Tribulatiön,moon-guard,576,warlock,demonology,18,6,12
51043,Shadowhax,area-52,576,warlock,demonology,18,6,12
51044,Dreadful,frostmourne,576,warlock,demonology,18,6,12
51045,Yungwilly,silvermoon,576,warlock,demonology,18,6,12
51046,Ragnalock,laughing-skull,576,warlock,demonology,20,6,14
51047,Shadü,tichondrius,576,warlock,demonology,25,6,19
51048,Lockazo,quelthalas,575,warlock,demonology,6,6,0
51049,Sylvanes,emerald-dream,575,warlock,demonology,12,6,6
51050,Lollilock,area-52,575,warlock,demonology,12,6,6
51051,Ronacq,norgannon,575,warlock,demonology,12,6,6
51052,Sinaman,barthilas,575,warlock,demonology,12,6,6
51053,Twototheone,illidan,575,warlock,demonology,12,6,6
51054,Abantes,area-52,575,warlock,demonology,12,6,6
51055,Voidgown,moon-guard,575,warlock,demonology,12,6,6
51056,Syndel,drakkari,575,warlock,demonology,12,6,6
51057,Doomczar,frostmane,575,warlock,demonology,12,6,6
51058,Szell,caelestrasz,575,warlock,demonology,12,6,6
51059,Daliadark,sargeras,575,warlock,demonology,21,6,15
51060,Xanlel,deathwing,574,warlock,demonology,18,6,12
51061,Nécromonster,illidan,574,warlock,demonology,18,6,12
51062,Yury,scarlet-crusade,574,warlock,demonology,18,6,12
51063,Undeadcurse,frostmourne,574,warlock,demonology,24,6,18
51064,Algard,emerald-dream,573,warlock,demonology,12,6,6
51065,Däemön,area-52,573,warlock,demonology,12,6,6
51066,Velondris,illidan,566,warlock,demonology,24,6,18
51067,Thoroxa,stormrage,558,warlock,demonology,17,6,11
51068,ßaphomet,blackrock,543,warlock,demonology,11,6,5
51069,Jafi,coilfang,543,warlock,demonology,17,6,11
51070,Penzer,stormrage,528,warlock,demonology,15,6,9
51071,Ceeloww,illidan,527,warlock,demonology,11,6,5
51072,Constantine,exodar,527,warlock,demonology,17,6,11
51073,Mourdera,ragnaros,522,warlock,demonology,14,7,7
51074,Nostractus,azralon,517,warlock,demonology,15,7,8
51075,Sixv,barthilas,480,warlock,demonology,6,5,1
51076,Salsong,draka,480,warlock,demonology,6,5,1
51077,Necrotko,malganis,480,warlock,demonology,6,5,1
51078,Charlieo,barthilas,480,warlock,demonology,6,5,1
51079,Dodgebolts,khaz-modan,480,warlock,demonology,6,5,1
51080,Valraths,arthas,480,warlock,demonology,6,5,1
51081,Conboi,tichondrius,480,warlock,demonology,6,5,1
51082,Sinixx,tichondrius,480,warlock,demonology,6,5,1
51083,Floorlamp,anvilmar,480,warlock,demonology,6,5,1
51084,Conboee,tichondrius,480,warlock,demonology,6,5,1
51085,Gavvi,frostmourne,480,warlock,demonology,6,5,1
51086,Rotkid,barthilas,480,warlock,demonology,6,5,1
51087,Mitchosx,frostmourne,480,warlock,demonology,6,5,1
51088,Aînzooalgown,ragnaros,480,warlock,demonology,6,5,1
51089,Khaozx,ragnaros,480,warlock,demonology,6,5,1
51090,Reneqtxo,frostmourne,480,warlock,demonology,6,5,1
51091,Niadmer,gnomeregan,480,warlock,demonology,6,5,1
51092,Leyzer,stormrage,480,warlock,demonology,6,5,1
51093,Seutóóbinha,stormrage,480,warlock,demonology,6,5,1
51094,Velrose,thrall,480,warlock,demonology,6,5,1
51095,Tiatiatia,illidan,480,warlock,demonology,6,5,1
51096,Huloo,blades-edge,480,warlock,demonology,6,5,1
51097,Viralwashbrn,illidan,480,warlock,demonology,6,5,1
51098,Wybbukk,wyrmrest-accord,480,warlock,demonology,6,5,1
51099,Drainedd,blades-edge,480,warlock,demonology,6,5,1
51100,Justganmore,tichondrius,480,warlock,demonology,6,5,1
51101,Vapeboi,bleeding-hollow,480,warlock,demonology,6,5,1
51102,Igniz,tichondrius,480,warlock,demonology,6,5,1
51103,Sêrok,tichondrius,480,warlock,demonology,6,5,1
51104,Druzzaj,thrall,480,warlock,demonology,6,5,1
51105,Lafuke,tichondrius,480,warlock,demonology,6,5,1
51106,Linctowncar,sargeras,480,warlock,demonology,6,5,1
51107,Nos,bleeding-hollow,480,warlock,demonology,6,5,1
51108,Bepis,emerald-dream,480,warlock,demonology,12,5,7
51109,Grandpapapa,tichondrius,480,warlock,demonology,12,5,7
51110,Evilmilf,tichondrius,480,warlock,demonology,12,5,7
51111,Dkdakìng,dalaran,480,warlock,demonology,12,5,7
51112,Beaknstein,sargeras,480,warlock,demonology,12,5,7
51113,Dewandoritos,kelthuzad,480,warlock,demonology,12,5,7
51114,Sinápsís,ragnaros,480,warlock,demonology,12,5,7
51115,Aniuk,bloodhoof,480,warlock,demonology,12,5,7
51116,Beaknasty,sargeras,480,warlock,demonology,12,5,7
51117,Demonâ,ragnaros,480,warlock,demonology,12,5,7
51118,Rumpology,illidan,480,warlock,demonology,12,5,7
51119,Rooms,sargeras,480,warlock,demonology,12,5,7
51120,Breeak,sargeras,480,warlock,demonology,12,5,7
51121,Wheremyshoes,area-52,480,warlock,demonology,12,5,7
51122,Aellorie,proudmoore,480,warlock,demonology,12,5,7
51123,Meisy,quelthalas,480,warlock,demonology,12,5,7
51124,Zarinista,veknilash,480,warlock,demonology,12,5,7
51125,Mânuel,akama,480,warlock,demonology,12,5,7
51126,Lockonthc,korgath,480,warlock,demonology,12,5,7
51127,Grineed,emerald-dream,480,warlock,demonology,12,5,7
51128,Dapperdanxy,tichondrius,480,warlock,demonology,12,5,7
51129,Alataar,sargeras,480,warlock,demonology,12,5,7
51130,Démoniaque,garrosh,480,warlock,demonology,12,5,7
51131,Ragdoll,illidan,480,warlock,demonology,12,5,7
51132,Klumzey,tichondrius,480,warlock,demonology,12,5,7
51133,Fshi,frostmourne,480,warlock,demonology,12,5,7
51134,Zelxor,tichondrius,480,warlock,demonology,12,5,7
51135,Liuh,tichondrius,480,warlock,demonology,12,5,7
51136,Perkz,moon-guard,480,warlock,demonology,12,5,7
51137,Søcks,tichondrius,480,warlock,demonology,12,5,7
51138,Gandreleda,wyrmrest-accord,480,warlock,demonology,16,6,10
51139,Flangy,kiljaeden,480,warlock,demonology,14,5,9
51140,Paleontology,moon-guard,480,warlock,demonology,14,5,9
51141,Durgamon,kirin-tor,480,warlock,demonology,18,5,13
51142,Sagaema,silvermoon,479,warlock,demonology,6,5,1
51143,Eflock,barthilas,479,warlock,demonology,12,5,7
51144,Damelon,gurubashi,479,warlock,demonology,12,5,7
51145,Deathlowkz,area-52,479,warlock,demonology,12,5,7
51146,Stinkmeaner,chogall,479,warlock,demonology,12,5,7
51147,Lockybalbowa,amanthul,479,warlock,demonology,18,5,13
51148,Omegawarlock,quelthalas,479,warlock,demonology,18,5,13
51149,Iolitee,khazgoroth,477,warlock,demonology,12,5,7
51150,Sathorastus,spirestone,448,warlock,demonology,10,6,4
51151,Rentacletape,kelthuzad,447,warlock,demonology,9,6,3
51152,Agaros,zuljin,426,warlock,demonology,17,6,11
51153,Rosalynda,azralon,398,warlock,demonology,10,5,5
51154,Quonton,tichondrius,384,warlock,demonology,6,4,2
51155,Famington,tichondrius,384,warlock,demonology,6,4,2
51156,Sakuin,bonechewer,384,warlock,demonology,6,4,2
51157,Kernlberton,tichondrius,384,warlock,demonology,6,4,2
51158,Jorit,argent-dawn,384,warlock,demonology,6,4,2
51159,Drekka,bleeding-hollow,384,warlock,demonology,6,4,2
51160,Vesaloth,zuljin,384,warlock,demonology,6,4,2
51161,Curpt,the-scryers,384,warlock,demonology,6,4,2
51162,Mädzy,azralon,384,warlock,demonology,6,4,2
51163,Helheim,haomarush,384,warlock,demonology,6,4,2
51164,Khalamar,steamwheedle-cartel,384,warlock,demonology,6,4,2
51165,Fokâi,sargeras,384,warlock,demonology,6,4,2
51166,Poppadot,korgath,384,warlock,demonology,6,4,2
51167,Leekeeaynis,frostmourne,384,warlock,demonology,6,4,2
51168,Brujever,ragnaros,384,warlock,demonology,6,4,2
51169,Vilebrute,illidan,384,warlock,demonology,6,4,2
51170,Ethero,emerald-dream,384,warlock,demonology,6,4,2
51171,Bigmancam,illidan,384,warlock,demonology,6,4,2
51172,Mazzaleen,area-52,384,warlock,demonology,6,4,2
51173,Lhorgainz,area-52,384,warlock,demonology,6,4,2
51174,Il,nerzhul,384,warlock,demonology,6,4,2
51175,Meep,madoran,384,warlock,demonology,6,4,2
51176,Frustration,darkspear,384,warlock,demonology,6,4,2
51177,Dashaad,illidan,384,warlock,demonology,6,4,2
51178,Hordefella,malganis,384,warlock,demonology,6,4,2
51179,Lockniel,skullcrusher,384,warlock,demonology,6,4,2
51180,Karmalock,malganis,384,warlock,demonology,6,4,2
51181,Zidus,tichondrius,384,warlock,demonology,6,4,2
51182,Nerolock,frostmourne,384,warlock,demonology,6,4,2
51183,Lizlock,stormrage,384,warlock,demonology,6,4,2
51184,Conjur,barthilas,384,warlock,demonology,6,4,2
51185,Ardam,cenarion-circle,384,warlock,demonology,6,4,2
51186,Coomerdoomer,stormrage,384,warlock,demonology,6,4,2
51187,Movvo,queldorei,384,warlock,demonology,6,4,2
51188,Retaruko,illidan,384,warlock,demonology,6,4,2
51189,Moräl,frostmourne,384,warlock,demonology,6,4,2
51190,Tiddliwinx,nordrassil,384,warlock,demonology,6,4,2
51191,Alchan,tichondrius,384,warlock,demonology,6,4,2
51192,Nightblloom,illidan,384,warlock,demonology,6,4,2
51193,Hélà,sargeras,384,warlock,demonology,6,4,2
51194,Remusdark,exodar,384,warlock,demonology,6,4,2
51195,Crayonchewer,alleria,384,warlock,demonology,6,4,2
51196,Fanzhiyi,illidan,384,warlock,demonology,6,4,2
51197,Kyrionn,azralon,384,warlock,demonology,6,4,2
51198,Thanock,illidan,384,warlock,demonology,6,4,2
51199,Hauntedhøuse,area-52,384,warlock,demonology,6,4,2
51200,Xekk,wyrmrest-accord,384,warlock,demonology,6,4,2
51201,Ahp,stormrage,384,warlock,demonology,6,4,2
51202,Viejitaa,quelthalas,384,warlock,demonology,6,4,2
51203,Rodneyjones,emerald-dream,384,warlock,demonology,6,4,2
51204,Deatthmoon,stormrage,384,warlock,demonology,6,4,2
51205,Logixo,sargeras,384,warlock,demonology,7,4,3
51206,Warlooch,area-52,384,warlock,demonology,9,5,4
51207,Woudini,malganis,384,warlock,demonology,10,5,5
51208,Jvilla,tichondrius,384,warlock,demonology,8,4,4
51209,Diekast,tichondrius,384,warlock,demonology,12,4,8
51210,Ven,dalaran,384,warlock,demonology,12,4,8
51211,Bigdaddyborr,arthas,384,warlock,demonology,12,4,8
51212,Dogcookie,moon-guard,384,warlock,demonology,12,4,8
51213,Çheesestick,dalaran,384,warlock,demonology,12,4,8
51214,Monstermime,wildhammer,384,warlock,demonology,12,4,8
51215,Frezy,stormrage,384,warlock,demonology,12,4,8
51216,Naz,shadowsong,384,warlock,demonology,12,4,8
51217,Warlack,jubeithos,384,warlock,demonology,12,4,8
51218,Ddorangmoon,tichondrius,384,warlock,demonology,12,4,8
51219,Tahmrin,quelthalas,384,warlock,demonology,12,4,8
51220,Kytae,malygos,384,warlock,demonology,12,4,8
51221,Picklecatz,barthilas,384,warlock,demonology,12,4,8
51222,Nazare,tichondrius,384,warlock,demonology,12,4,8
51223,Dotsandpot,malfurion,384,warlock,demonology,12,4,8
51224,Rumjugs,barthilas,384,warlock,demonology,12,4,8
51225,Rylal,illidan,384,warlock,demonology,12,4,8
51226,Pìnto,illidan,384,warlock,demonology,12,4,8
51227,Uarus,tichondrius,384,warlock,demonology,12,4,8
51228,Soulrman,tichondrius,384,warlock,demonology,12,4,8
51229,Srz,stormrage,384,warlock,demonology,12,4,8
51230,Shadococo,tichondrius,384,warlock,demonology,12,4,8
51231,Arsaurelica,blackrock,384,warlock,demonology,12,4,8
51232,Deatt,deathwing,384,warlock,demonology,12,4,8
51233,Xoxoxu,frostmourne,384,warlock,demonology,12,4,8
51234,Tofulery,tichondrius,384,warlock,demonology,18,4,14
51235,Dagadon,arathor,384,warlock,demonology,24,4,20
51236,Trilleon,eldrethalas,383,warlock,demonology,6,4,2
51237,Greems,tichondrius,383,warlock,demonology,6,4,2
51238,Meminissemus,ragnaros,383,warlock,demonology,12,4,8
51239,Xandemic,tichondrius,383,warlock,demonology,12,4,8
51240,Daggondai,tichondrius,383,warlock,demonology,12,4,8
51241,Freshimps,blood-furnace,367,warlock,demonology,11,4,7
51242,Sharee,azuremyst,363,warlock,demonology,11,4,7
51243,Ärminvßuurën,barthilas,351,warlock,demonology,11,4,7
51244,Manosverdes,tichondrius,336,warlock,demonology,9,4,5
51245,Rycho,tichondrius,319,warlock,demonology,5,4,1
51246,Pizzanipple,illidan,319,warlock,demonology,5,4,1
51247,Pulpfliction,kiljaeden,304,warlock,demonology,13,4,9
51248,Shìnedown,eonar,288,warlock,demonology,6,3,3
51249,Naokishi,stormrage,288,warlock,demonology,6,3,3
51250,Crtyodautr,skullcrusher,288,warlock,demonology,6,3,3
51251,Soulruler,tichondrius,288,warlock,demonology,6,3,3
51252,Feartool,stormrage,288,warlock,demonology,6,3,3
51253,Zhul,nerzhul,288,warlock,demonology,6,3,3
51254,Ëfera,nemesis,288,warlock,demonology,6,3,3
51255,Darthael,stormrage,288,warlock,demonology,6,3,3
51256,Keezus,area-52,288,warlock,demonology,6,3,3
51257,Capslock,arthas,288,warlock,demonology,6,3,3
51258,Areolaz,kelthuzad,288,warlock,demonology,6,3,3
51259,Aeonss,stormrage,288,warlock,demonology,6,3,3
51260,Diebydots,blackrock,288,warlock,demonology,6,3,3
51261,Malthaél,kelthuzad,288,warlock,demonology,6,3,3
51262,Wasca,kelthuzad,288,warlock,demonology,6,3,3
51263,Superbroly,area-52,288,warlock,demonology,6,3,3
51264,Chaøsbolt,area-52,288,warlock,demonology,6,3,3
51265,Bertnasty,tichondrius,288,warlock,demonology,6,3,3
51266,Gotty,stormrage,288,warlock,demonology,6,3,3
51267,Domwarlock,uther,288,warlock,demonology,6,3,3
51268,Locksoul,area-52,288,warlock,demonology,6,3,3
51269,Emeary,kelthuzad,288,warlock,demonology,6,3,3
51270,Azland,proudmoore,288,warlock,demonology,6,3,3
51271,Élio,quelthalas,288,warlock,demonology,6,3,3
51272,Tynks,mannoroth,288,warlock,demonology,6,3,3
51273,Leonito,tichondrius,288,warlock,demonology,6,3,3
51274,Asiopdu,tichondrius,288,warlock,demonology,6,3,3
51275,Wiredftwx,illidan,288,warlock,demonology,6,3,3
51276,Viejita,quelthalas,288,warlock,demonology,6,3,3
51277,Hauntsin,hyjal,288,warlock,demonology,6,3,3
51278,Disgustingfk,illidan,288,warlock,demonology,6,3,3
51279,Bral,hyjal,288,warlock,demonology,6,3,3
51280,Muldan,stormrage,288,warlock,demonology,6,3,3
51281,Wiredftw,illidan,288,warlock,demonology,6,3,3
51282,Hgma,tichondrius,288,warlock,demonology,6,3,3
51283,Kodyconner,darkspear,288,warlock,demonology,6,3,3
51284,Fancynuts,kiljaeden,288,warlock,demonology,6,3,3
51285,Drerrday,kelthuzad,288,warlock,demonology,6,3,3
51286,Gholra,wyrmrest-accord,288,warlock,demonology,6,3,3
51287,Sooshi,malganis,288,warlock,demonology,6,3,3
51288,Shutupthug,illidan,288,warlock,demonology,6,3,3
51289,Dispator,tichondrius,288,warlock,demonology,6,3,3
51290,Dotomizer,moonrunner,288,warlock,demonology,6,3,3
51291,Sangala,malganis,288,warlock,demonology,6,3,3
51292,Agonie,tichondrius,288,warlock,demonology,6,3,3
51293,Jèdi,drenden,288,warlock,demonology,6,3,3
51294,Greenbukakky,tichondrius,288,warlock,demonology,6,3,3
51295,Neruvian,tichondrius,288,warlock,demonology,6,3,3
51296,Asmodeun,malganis,288,warlock,demonology,6,3,3
51297,Feelthefearx,ragnaros,288,warlock,demonology,6,3,3
51298,Guldylox,kiljaeden,288,warlock,demonology,6,3,3
51299,Fëlgibson,illidan,288,warlock,demonology,6,3,3
51300,Molguzano,ragnaros,288,warlock,demonology,6,3,3
51301,Poggun,tichondrius,288,warlock,demonology,6,3,3
51302,Impbiscuit,stormrage,288,warlock,demonology,6,3,3
51303,Brothadoinks,zuljin,288,warlock,demonology,6,3,3
51304,Iamfear,shuhalo,288,warlock,demonology,6,3,3
51305,Archleon,smolderthorn,288,warlock,demonology,6,3,3
51306,Gulvandan,dathremar,288,warlock,demonology,6,3,3
51307,Zanlockos,dalaran,288,warlock,demonology,6,3,3
51308,Dippndotz,bleeding-hollow,288,warlock,demonology,6,3,3
51309,Drelgun,aerie-peak,288,warlock,demonology,6,3,3
51310,Ðemented,bleeding-hollow,288,warlock,demonology,6,3,3
51311,Nightterrour,frostmourne,288,warlock,demonology,6,3,3
51312,Psyløck,bleeding-hollow,288,warlock,demonology,6,3,3
51313,Pikslol,bleeding-hollow,288,warlock,demonology,6,3,3
51314,Khamzatt,proudmoore,288,warlock,demonology,6,3,3
51315,Stargasms,blackrock,288,warlock,demonology,6,3,3
51316,Yanned,hakkar,288,warlock,demonology,6,3,3
51317,Deadlylock,gilneas,288,warlock,demonology,6,3,3
51318,Okul,frostmourne,288,warlock,demonology,6,3,3
51319,Nerfdemo,chogall,288,warlock,demonology,6,3,3
51320,Schrader,sargeras,288,warlock,demonology,6,3,3
51321,Chody,sargeras,288,warlock,demonology,6,3,3
51322,Lilthicy,sargeras,288,warlock,demonology,6,3,3
51323,Jennifear,sargeras,288,warlock,demonology,6,3,3
51324,Nipz,korialstrasz,288,warlock,demonology,6,3,3
51325,Whydemono,tichondrius,288,warlock,demonology,6,3,3
51326,Drsauce,sargeras,288,warlock,demonology,6,3,3
51327,Fatuglyegirl,sargeras,288,warlock,demonology,6,3,3
51328,Notprint,sargeras,288,warlock,demonology,6,3,3
51329,Elementzero,malorne,288,warlock,demonology,6,3,3
51330,Saffuky,frostmourne,288,warlock,demonology,6,3,3
51331,Widenose,agamaggan,288,warlock,demonology,6,3,3
51332,Srcorvo,azralon,288,warlock,demonology,6,3,3
51333,Voldmorto,azralon,288,warlock,demonology,6,3,3
51334,Symaitiel,azralon,288,warlock,demonology,6,3,3
51335,Khatrat,azralon,288,warlock,demonology,6,3,3
51336,Nookíe,azralon,288,warlock,demonology,6,3,3
51337,Cyrillus,moon-guard,288,warlock,demonology,6,3,3
51338,Lockinha,azralon,288,warlock,demonology,6,3,3
51339,Insanemids,tichondrius,288,warlock,demonology,6,3,3
51340,Sweetmeat,madoran,288,warlock,demonology,6,3,3
51341,Devi,executus,288,warlock,demonology,6,3,3
51342,Alprazoläm,illidan,288,warlock,demonology,14,6,8
51343,Ofcurse,stormrage,288,warlock,demonology,10,3,7
51344,Xephine,proudmoore,288,warlock,demonology,12,3,9
51345,Reckluss,shattered-hand,288,warlock,demonology,12,3,9
51346,Legïõn,uldaman,288,warlock,demonology,12,3,9
51347,Laklin,stormscale,288,warlock,demonology,12,3,9
51348,Jagni,stormrage,288,warlock,demonology,12,3,9
51349,Albbanoo,tichondrius,288,warlock,demonology,12,3,9
51350,Iamlavon,area-52,288,warlock,demonology,12,3,9
51351,Pachips,zuljin,288,warlock,demonology,12,3,9
51352,Westhofs,tichondrius,288,warlock,demonology,12,3,9
51353,Tatemor,barthilas,288,warlock,demonology,12,3,9
51354,Dàmagicman,drakthul,288,warlock,demonology,12,3,9
51355,Wineburger,frostmourne,288,warlock,demonology,12,3,9
51356,Erc,alterac-mountains,288,warlock,demonology,12,3,9
51357,Killvilock,kelthuzad,288,warlock,demonology,12,3,9
51358,Crispee,azuremyst,288,warlock,demonology,12,3,9
51359,Strax,shattered-hand,288,warlock,demonology,12,3,9
51360,Kajayak,nazjatar,288,warlock,demonology,12,3,9
51361,Kwrhitom,zuljin,288,warlock,demonology,12,3,9
51362,Didntflush,blood-furnace,288,warlock,demonology,18,3,15
51363,Gbow,malygos,287,warlock,demonology,6,3,3
51364,Ijustsharded,area-52,255,warlock,demonology,11,3,8
51365,Tenletters,kirin-tor,239,warlock,demonology,5,3,2
51366,Slugworth,rivendare,239,warlock,demonology,5,3,2
51367,Frankandbean,dawnbringer,234,warlock,demonology,7,4,3
51368,Predictions,sargeras,234,warlock,demonology,10,5,5
51369,Apøçàlÿpsè,firetree,234,warlock,demonology,11,5,6
51370,Schofen,tichondrius,234,warlock,demonology,13,4,9
51371,Annubyz,quelthalas,208,warlock,demonology,7,3,4
51372,Cocoabuttâ,stormrage,192,warlock,demonology,4,3,1
51373,Squibley,sargeras,192,warlock,demonology,4,3,1
51374,Javirr,ragnaros,192,warlock,demonology,15,5,10
51375,Knobbynobbas,stormrage,192,warlock,demonology,6,2,4
51376,Infecçäo,stormrage,192,warlock,demonology,6,2,4
51377,Xblessed,stormrage,192,warlock,demonology,6,2,4
51378,Xuker,tichondrius,192,warlock,demonology,6,2,4
51379,Sheshð,stormrage,192,warlock,demonology,6,2,4
51380,Marty,stormrage,192,warlock,demonology,6,2,4
51381,Shipmatelock,stormrage,192,warlock,demonology,6,2,4
51382,Reckzet,stormrage,192,warlock,demonology,6,2,4
51383,Cursedkash,stormrage,192,warlock,demonology,6,2,4
51384,Incaseoffire,moon-guard,192,warlock,demonology,6,2,4
51385,Leônidos,ghostlands,192,warlock,demonology,6,2,4
51386,Tomathus,moon-guard,192,warlock,demonology,6,2,4
51387,Koffay,bleeding-hollow,192,warlock,demonology,6,2,4
51388,Zerowarlock,stormrage,192,warlock,demonology,6,2,4
51389,Lilbiackguy,stormrage,192,warlock,demonology,6,2,4
51390,Feardr,frostmourne,192,warlock,demonology,6,2,4
51391,Trippednfel,stormrage,192,warlock,demonology,6,2,4
51392,Boon,spirestone,192,warlock,demonology,6,2,4
51393,Buboñic,area-52,192,warlock,demonology,6,2,4
51394,Cozu,tichondrius,192,warlock,demonology,6,2,4
51395,Darkboltz,area-52,192,warlock,demonology,6,2,4
51396,Shadow,frostwolf,192,warlock,demonology,6,2,4
51397,Vexidus,moon-guard,192,warlock,demonology,6,2,4
51398,Vendareth,earthen-ring,192,warlock,demonology,6,2,4
51399,Bagelandlock,tichondrius,192,warlock,demonology,6,2,4
51400,Pinkypay,ragnaros,192,warlock,demonology,6,2,4
51401,Tikdotlock,silvermoon,192,warlock,demonology,6,2,4
51402,Sinissa,ysondre,192,warlock,demonology,6,2,4
51403,Ceelowtf,sargeras,192,warlock,demonology,6,2,4
51404,Barbieelf,sargeras,192,warlock,demonology,6,2,4
51405,Wreckquiem,draka,192,warlock,demonology,6,2,4
51406,Draindeez,sargeras,192,warlock,demonology,6,2,4
51407,Kelifan,sargeras,192,warlock,demonology,6,2,4
51408,Ggaayyooii,anubarak,192,warlock,demonology,6,2,4
51409,Caesis,illidan,192,warlock,demonology,6,2,4
51410,Síkaría,malganis,192,warlock,demonology,6,2,4
51411,Ðeimøn,azralon,192,warlock,demonology,6,2,4
51412,Karlangax,illidan,192,warlock,demonology,6,2,4
51413,Pikkon,malorne,192,warlock,demonology,6,2,4
51414,Frodosagginz,illidan,192,warlock,demonology,6,2,4
51415,Felnoxx,dragonmaw,192,warlock,demonology,6,2,4
51416,Irene,nagrand,192,warlock,demonology,6,2,4
51417,Albright,azralon,192,warlock,demonology,6,2,4
51418,Felforyouu,illidan,192,warlock,demonology,6,2,4
51419,Capïrota,nemesis,192,warlock,demonology,6,2,4
51420,Zevoc,tichondrius,192,warlock,demonology,6,2,4
51421,Kaosqt,nemesis,192,warlock,demonology,6,2,4
51422,Feldotz,illidan,192,warlock,demonology,6,2,4
51423,Jiiggyjones,sargeras,192,warlock,demonology,6,2,4
51424,Doomtome,moon-guard,192,warlock,demonology,6,2,4
51425,Greenbeanzs,tichondrius,192,warlock,demonology,6,2,4
51426,Destructo,illidan,192,warlock,demonology,6,2,4
51427,Réliok,quelthalas,192,warlock,demonology,6,2,4
51428,Ziroken,crushridge,192,warlock,demonology,6,2,4
51429,Wtb,blackrock,192,warlock,demonology,6,2,4
51430,Isømetrics,frostmourne,192,warlock,demonology,6,2,4
51431,Stuffs,wyrmrest-accord,192,warlock,demonology,6,2,4
51432,Warfeen,malganis,192,warlock,demonology,6,2,4
51433,Hootenanny,korialstrasz,192,warlock,demonology,6,2,4
51434,Firemike,kelthuzad,192,warlock,demonology,6,2,4
51435,Brough,illidan,192,warlock,demonology,6,2,4
51436,Jkun,malganis,192,warlock,demonology,6,2,4
51437,Zelnokt,thrall,192,warlock,demonology,6,2,4
51438,Agamendoir,frostmane,192,warlock,demonology,6,2,4
51439,Borudo,thrall,192,warlock,demonology,6,2,4
51440,Rokdas,area-52,192,warlock,demonology,6,2,4
51441,Wesy,earthen-ring,192,warlock,demonology,6,2,4
51442,Zalissel,proudmoore,192,warlock,demonology,6,2,4
51443,Hentailust,kiljaeden,192,warlock,demonology,6,2,4
51444,Dedology,area-52,192,warlock,demonology,6,2,4
51445,Lopenx,korgath,192,warlock,demonology,6,2,4
51446,Soulbane,tol-barad,192,warlock,demonology,6,2,4
51447,Watchmeport,onyxia,192,warlock,demonology,6,2,4
51448,Felpuppet,barthilas,192,warlock,demonology,6,2,4
51449,Promancer,drakkari,192,warlock,demonology,6,2,4
51450,Sakyameil,area-52,192,warlock,demonology,6,2,4
51451,Qic,runetotem,192,warlock,demonology,6,2,4
51452,Aceej,nazgrel,192,warlock,demonology,6,2,4
51453,Anukh,emerald-dream,192,warlock,demonology,6,2,4
51454,Yuckytoetoe,emerald-dream,192,warlock,demonology,6,2,4
51455,Xmogfarmer,sargeras,192,warlock,demonology,6,2,4
51456,Shadows,arygos,192,warlock,demonology,6,2,4
51457,Draino,tichondrius,192,warlock,demonology,6,2,4
51458,Phylox,cenarius,192,warlock,demonology,6,2,4
51459,Psykana,barthilas,192,warlock,demonology,6,2,4
51460,Evilempire,sargeras,192,warlock,demonology,6,2,4
51461,Nanicide,kelthuzad,192,warlock,demonology,6,2,4
51462,Starwitch,darkspear,192,warlock,demonology,12,2,10
51463,Umadbruhh,tichondrius,192,warlock,demonology,12,2,10
51464,Gàtór,kiljaeden,192,warlock,demonology,12,2,10
51465,Miamarin,ragnaros,192,warlock,demonology,12,2,10
51466,Vielkä,ragnaros,192,warlock,demonology,12,2,10
51467,Sinful,darkspear,192,warlock,demonology,12,2,10
51468,Nameflagged,arathor,192,warlock,demonology,12,2,10
51469,Timerad,maelstrom,192,warlock,demonology,14,2,12
51470,Taeden,jubeithos,175,warlock,demonology,11,3,8
51471,Wårloçk,tichondrius,159,warlock,demonology,5,2,3
51472,Tunacanthicc,moon-guard,159,warlock,demonology,5,2,3
51473,Gartlarrey,daggerspine,158,warlock,demonology,14,3,11
51474,Urmami,frostwolf,127,warlock,demonology,8,2,6
51475,Africanlock,sargeras,96,warlock,demonology,3,2,1
51476,Malleus,drakkari,96,warlock,demonology,3,2,1
51477,Quinsnyder,zuljin,96,warlock,demonology,6,1,5
51478,Fashon,barthilas,96,warlock,demonology,6,1,5
51479,Injera,tichondrius,96,warlock,demonology,6,1,5
51480,Felsparkz,tichondrius,96,warlock,demonology,6,1,5
51481,Asetiks,tichondrius,96,warlock,demonology,6,1,5
51482,Somethingud,tichondrius,96,warlock,demonology,6,1,5
51483,Bfaclâssic,zuljin,96,warlock,demonology,6,1,5
51484,Clarton,tichondrius,96,warlock,demonology,6,1,5
51485,Halloweèn,kelthuzad,96,warlock,demonology,6,1,5
51486,Fearedit,bleeding-hollow,96,warlock,demonology,6,1,5
51487,Sidiouss,dreadmaul,96,warlock,demonology,6,1,5
51488,Lazzarros,area-52,96,warlock,demonology,6,1,5
51489,Jessewheels,tichondrius,96,warlock,demonology,6,1,5
51490,Harukay,tichondrius,96,warlock,demonology,6,1,5
51491,Tonyxx,tichondrius,96,warlock,demonology,6,1,5
51492,Hsxcx,stonemaul,96,warlock,demonology,6,1,5
51493,Osteogenesis,quelthalas,96,warlock,demonology,6,1,5
51494,Solöw,tichondrius,96,warlock,demonology,6,1,5
51495,Eriss,exodar,96,warlock,demonology,6,1,5
51496,Repláced,thrall,96,warlock,demonology,6,1,5
51497,Glizzÿ,thrall,96,warlock,demonology,6,1,5
51498,Tormentor,malganis,96,warlock,demonology,6,1,5
51499,Isthismeta,tichondrius,96,warlock,demonology,6,1,5
51500,Amauder,moon-guard,96,warlock,demonology,6,1,5
51501,Hutchyw,tichondrius,96,warlock,demonology,6,1,5
51502,Yora,illidan,96,warlock,demonology,6,1,5
51503,Uggaboogga,malganis,96,warlock,demonology,6,1,5
51504,Oreo,velen,96,warlock,demonology,6,1,5
51505,Zerosix,sargeras,96,warlock,demonology,6,1,5
51506,Krilkore,kiljaeden,96,warlock,demonology,6,1,5
51507,Skured,maiev,96,warlock,demonology,6,1,5
51508,Lockz,illidan,96,warlock,demonology,6,1,5
51509,Damdochael,bleeding-hollow,96,warlock,demonology,6,1,5
51510,Shortbuhz,tichondrius,96,warlock,demonology,6,1,5
51511,Borthrel,moon-guard,96,warlock,demonology,6,1,5
51512,Thinkchair,sargeras,96,warlock,demonology,6,1,5
51513,Bilidin,azralon,96,warlock,demonology,6,1,5
51514,Hâunted,khazgoroth,96,warlock,demonology,6,1,5
51515,Thugpenus,frostmane,96,warlock,demonology,6,1,5
51516,Jazzycj,bleeding-hollow,96,warlock,demonology,6,1,5
51517,Decrepticus,kargath,96,warlock,demonology,6,1,5
51518,Halsonis,smolderthorn,96,warlock,demonology,6,1,5
51519,Zíppen,proudmoore,96,warlock,demonology,6,1,5
51520,Nùts,frostmourne,96,warlock,demonology,6,1,5
51521,Bmó,stormrage,96,warlock,demonology,6,1,5
51522,Erimegara,ragnaros,96,warlock,demonology,6,1,5
51523,Wakingdead,mugthol,96,warlock,demonology,6,1,5
51524,Cynnd,tichondrius,96,warlock,demonology,6,1,5
51525,Malzahard,ragnaros,96,warlock,demonology,6,1,5
51526,Varvanta,proudmoore,96,warlock,demonology,6,1,5
51527,Ñinelyfe,frostmourne,96,warlock,demonology,6,1,5
51528,Xalithra,moon-guard,96,warlock,demonology,6,1,5
51529,Fluximilian,azralon,96,warlock,demonology,7,1,6
51530,Vèigarr,frostmourne,96,warlock,demonology,9,1,8
51531,Albus,skywall,96,warlock,demonology,12,1,11
51532,Resima,stormscale,96,warlock,demonology,13,1,12
51533,Kecca,azralon,96,warlock,demonology,15,1,14
51534,Jancilianna,stormrage,96,warlock,demonology,18,1,17
51535,Hecataeus,proudmoore,63,warlock,demonology,8,2,6
51536,Aerindell,dalaran,48,warlock,demonology,3,1,2
51537,Shaurial,zuljin,48,warlock,demonology,3,1,2
51538,Eternitty,nemesis,42,warlock,demonology,11,3,8
51539,Synysta,tichondrius,31,warlock,demonology,2,1,1
51540,Locksyy,tichondrius,31,warlock,demonology,2,1,1
51541,Warlow,mugthol,31,warlock,demonology,8,1,7
51542,Camila,lightnings-blade,16,warlock,demonology,1,1,0
51543,Nosw,bleeding-hollow,2395,warlock,destruction,114,72,42
51544,Voidchaos,whisperwind,2392,warlock,destruction,241,144,97
51545,Slipnslide,malganis,2357,warlock,destruction,83,55,28
51546,Hahahahahha,stormrage,2357,warlock,destruction,95,62,33
51547,Nos,bleeding-hollow,2351,warlock,destruction,100,64,36
51548,Drexia,tichondrius,2349,warlock,destruction,131,88,43
51549,Rightwaylovê,illidan,2334,warlock,destruction,203,121,82
51550,Reverence,tichondrius,2283,warlock,destruction,101,64,37
51551,Mengqil,tichondrius,2267,warlock,destruction,114,64,50
51552,Solwl,shandris,2256,warlock,destruction,66,37,29
51553,Singleaf,stormrage,2255,warlock,destruction,98,57,41
51554,Isodjdojk,sargeras,2246,warlock,destruction,100,56,44
51555,Dannyl,tichondrius,2241,warlock,destruction,78,50,28
51556,Turiggyjr,tichondrius,2221,warlock,destruction,94,52,42
51557,Diabolicalz,sargeras,2220,warlock,destruction,123,69,54
51558,Quinsnyder,zuljin,2219,warlock,destruction,258,135,123
51559,Demonicxs,area-52,2218,warlock,destruction,185,101,84
51560,Mclovn,suramar,2217,warlock,destruction,221,118,103
51561,Alucarduo,emerald-dream,2216,warlock,destruction,108,61,47
51562,Ihavestds,tichondrius,2213,warlock,destruction,66,40,26
51563,Kamohoalii,bleeding-hollow,2210,warlock,destruction,102,62,40
51564,Slantsix,tichondrius,2198,warlock,destruction,90,50,40
51565,Mcdudebro,malganis,2192,warlock,destruction,72,45,27
51566,Butteredbun,stormrage,2179,warlock,destruction,192,111,81
51567,Stingzz,azralon,2169,warlock,destruction,72,45,27
51568,Heckindoggø,tichondrius,2165,warlock,destruction,87,48,39
51569,Disgustingfk,illidan,2162,warlock,destruction,120,74,46
51570,Søülætër,bleeding-hollow,2161,warlock,destruction,66,42,24
51571,Sourslock,shadowsong,2158,warlock,destruction,108,70,38
51572,Impenjoyer,tichondrius,2154,warlock,destruction,66,41,25
51573,Playßøy,area-52,2154,warlock,destruction,78,45,33
51574,Sonlyc,tichondrius,2153,warlock,destruction,114,60,54
51575,Cc,hellscream,2152,warlock,destruction,202,123,79
51576,Rizzofsparta,stormrage,2148,warlock,destruction,72,45,27
51577,Forestfruit,tichondrius,2147,warlock,destruction,54,35,19
51578,Truetime,tichondrius,2147,warlock,destruction,84,46,38
51579,Woahlock,thrall,2146,warlock,destruction,64,40,24
51580,Ihatemyson,tichondrius,2144,warlock,destruction,59,33,26
51581,Gimmeprecog,tichondrius,2143,warlock,destruction,74,45,29
51582,Ellynaria,nemesis,2142,warlock,destruction,78,51,27
51583,Usainboltzz,tichondrius,2137,warlock,destruction,71,49,22
51584,Notprint,sargeras,2136,warlock,destruction,66,42,24
51585,Tomatobob,thrall,2136,warlock,destruction,84,44,40
51586,Pillçosby,bleeding-hollow,2136,warlock,destruction,234,120,114
51587,Igortrikadva,zuljin,2135,warlock,destruction,72,43,29
51588,Leredi,stormrage,2135,warlock,destruction,146,78,68
51589,Yifaruhún,illidan,2132,warlock,destruction,78,58,20
51590,Bakko,tichondrius,2131,warlock,destruction,89,59,30
51591,Cux,malganis,2131,warlock,destruction,89,47,42
51592,Deideimeow,illidan,2130,warlock,destruction,65,42,23
51593,Darthael,stormrage,2130,warlock,destruction,188,112,76
51594,Butterboyx,stormrage,2129,warlock,destruction,83,51,32
51595,Drâkedog,illidan,2128,warlock,destruction,66,38,28
51596,Medzor,tichondrius,2128,warlock,destruction,93,53,40
51597,Etuskaa,tichondrius,2128,warlock,destruction,199,110,89
51598,Loopsy,stormrage,2126,warlock,destruction,115,64,51
51599,Sockems,guldan,2125,warlock,destruction,90,51,39
51600,Demonman,kirin-tor,2124,warlock,destruction,72,41,31
51601,Rizzard,lightnings-blade,2123,warlock,destruction,107,64,43
51602,Oopsprecog,tichondrius,2123,warlock,destruction,120,64,56
51603,Horror,moon-guard,2123,warlock,destruction,93,47,46
51604,Zyzx,malganis,2120,warlock,destruction,59,37,22
51605,Ztlivid,area-52,2120,warlock,destruction,173,103,70
51606,Neruvian,tichondrius,2120,warlock,destruction,66,39,27
51607,Insanetroll,stormrage,2119,warlock,destruction,78,54,24
51608,Hudwinx,illidan,2119,warlock,destruction,78,47,31
51609,Drakedogee,illidan,2119,warlock,destruction,66,35,31
51610,Äran,azralon,2119,warlock,destruction,72,36,36
51611,Drböb,area-52,2118,warlock,destruction,70,43,27
51612,Jonboyy,illidan,2118,warlock,destruction,189,97,92
51613,Ðlrwêcïûj,stormrage,2117,warlock,destruction,84,56,28
51614,Bananapan,tichondrius,2116,warlock,destruction,66,44,22
51615,Starta,tichondrius,2116,warlock,destruction,66,39,27
51616,Kyranu,tichondrius,2116,warlock,destruction,138,77,61
51617,Dyenamik,stormrage,2116,warlock,destruction,65,36,29
51618,Realization,illidan,2115,warlock,destruction,42,30,12
51619,Epícburn,illidan,2115,warlock,destruction,66,40,26
51620,Minglocked,proudmoore,2114,warlock,destruction,54,37,17
51621,Usurpest,bleeding-hollow,2114,warlock,destruction,79,50,29
51622,Realgodlock,proudmoore,2114,warlock,destruction,170,94,76
51623,Luvana,kelthuzad,2111,warlock,destruction,143,83,60
51624,Dean,frostmourne,2111,warlock,destruction,66,33,33
51625,Instabilityx,tichondrius,2110,warlock,destruction,77,48,29
51626,Ghoul,demon-soul,2109,warlock,destruction,60,35,25
51627,Dxxz,tichondrius,2109,warlock,destruction,115,63,52
51628,Thumperrz,frostmourne,2108,warlock,destruction,89,47,42
51629,Xavier,wyrmrest-accord,2107,warlock,destruction,111,62,49
51630,Mjn,tichondrius,2107,warlock,destruction,100,51,49
51631,Chaosboltex,tichondrius,2106,warlock,destruction,72,41,31
51632,Vapeboi,bleeding-hollow,2106,warlock,destruction,84,47,37
51633,Jcm,hyjal,2104,warlock,destruction,59,41,18
51634,Dottle,frostmourne,2104,warlock,destruction,66,39,27
51635,Whodatman,illidan,2103,warlock,destruction,60,41,19
51636,Dae,burning-legion,2103,warlock,destruction,59,38,21
51637,Bufflockmore,tichondrius,2103,warlock,destruction,112,62,50
51638,Kaytoxic,tichondrius,2103,warlock,destruction,72,39,33
51639,Ohmend,thrall,2102,warlock,destruction,69,45,24
51640,Disembolt,illidan,2102,warlock,destruction,66,41,25
51641,Breeped,tichondrius,2102,warlock,destruction,150,91,59
51642,Rainbowdate,tichondrius,2101,warlock,destruction,36,29,7
51643,Felfeels,area-52,2101,warlock,destruction,114,68,46
51644,Abrocket,alleria,2101,warlock,destruction,112,58,54
51645,Implify,tichondrius,2101,warlock,destruction,142,73,69
51646,Dodgeykun,khaz-modan,2100,warlock,destruction,89,55,34
51647,Kryl,kiljaeden,2100,warlock,destruction,66,39,27
51648,Grandmama,tichondrius,2095,warlock,destruction,77,47,30
51649,Colombø,gallywix,2090,warlock,destruction,175,93,82
51650,Spicywhite,tichondrius,2089,warlock,destruction,126,65,61
51651,Drugmuffin,tichondrius,2084,warlock,destruction,77,43,34
51652,Marcelium,greymane,2082,warlock,destruction,59,38,21
51653,Xiyangpvp,tichondrius,2079,warlock,destruction,90,46,44
51654,Locean,tichondrius,2074,warlock,destruction,112,60,52
51655,Babyaga,illidan,2073,warlock,destruction,103,50,53
51656,Hollowl,tichondrius,2072,warlock,destruction,95,64,31
51657,Thugonomicz,demon-soul,2071,warlock,destruction,54,37,17
51658,Sinápsís,ragnaros,2067,warlock,destruction,60,38,22
51659,Mayelinvail,moon-guard,2067,warlock,destruction,166,94,72
51660,Warzog,wyrmrest-accord,2066,warlock,destruction,96,54,42
51661,Mjndewb,tichondrius,2064,warlock,destruction,78,58,20
51662,Demofire,tichondrius,2063,warlock,destruction,63,39,24
51663,Ribman,stormrage,2061,warlock,destruction,78,38,40
51664,Nightmanx,sargeras,2057,warlock,destruction,101,54,47
51665,Revenid,tichondrius,2049,warlock,destruction,72,42,30
51666,Scørrgx,azralon,2049,warlock,destruction,102,53,49
51667,Alchandil,tichondrius,2047,warlock,destruction,60,39,21
51668,Koitis,tichondrius,2046,warlock,destruction,74,45,29
51669,Tichonkimc,tichondrius,2045,warlock,destruction,101,54,47
51670,Foresthills,sargeras,2044,warlock,destruction,102,53,49
51671,Uwantpeach,tichondrius,2043,warlock,destruction,46,34,12
51672,Brainless,tichondrius,2040,warlock,destruction,109,66,43
51673,Marshyw,tichondrius,2039,warlock,destruction,54,31,23
51674,Napiersdot,tichondrius,2039,warlock,destruction,78,41,37
51675,Salanzø,bleeding-hollow,2030,warlock,destruction,60,35,25
51676,Payn,kiljaeden,2030,warlock,destruction,138,71,67
51677,Idotû,tichondrius,2025,warlock,destruction,221,116,105
51678,Nvlnx,tichondrius,2023,warlock,destruction,143,77,66
51679,Destroyy,greymane,2021,warlock,destruction,60,33,27
51680,Hrrpeuh,zuljin,2017,warlock,destruction,88,46,42
51681,Sweatystain,tichondrius,2015,warlock,destruction,129,77,52
51682,Duukka,malganis,2015,warlock,destruction,96,53,43
51683,Zeari,sargeras,2014,warlock,destruction,115,59,56
51684,Genzy,tichondrius,2010,warlock,destruction,148,76,72
51685,Reallymagic,malganis,2008,warlock,destruction,167,100,67
51686,Kaidow,tichondrius,2006,warlock,destruction,114,67,47
51687,Babybolt,frostmourne,2005,warlock,destruction,102,50,52
51688,Biubius,tichondrius,2001,warlock,destruction,86,56,30
51689,Vyrecks,hyjal,2001,warlock,destruction,83,47,36
51690,Eqx,illidan,2000,warlock,destruction,86,52,34
51691,Venticm,tichondrius,1997,warlock,destruction,60,36,24
51692,Dàmagicman,drakthul,1996,warlock,destruction,84,52,32
51693,Darkmagicc,tichondrius,1995,warlock,destruction,96,48,48
51694,Eav,area-52,1991,warlock,destruction,66,41,25
51695,Xertling,sargeras,1990,warlock,destruction,67,46,21
51696,Qp,thrall,1989,warlock,destruction,36,27,9
51697,Kaytoxics,tichondrius,1988,warlock,destruction,24,21,3
51698,Sarcophagus,duskwood,1987,warlock,destruction,168,83,85
51699,Kruxxqt,illidan,1986,warlock,destruction,337,174,163
51700,Sitomey,emerald-dream,1982,warlock,destruction,66,38,28
51701,Dragonixs,ragnaros,1980,warlock,destruction,136,78,58
51702,Tacobelf,magtheridon,1980,warlock,destruction,129,73,56
51703,Zhul,nerzhul,1979,warlock,destruction,63,40,23
51704,Sereniaa,sargeras,1977,warlock,destruction,56,32,24
51705,Fotmspec,area-52,1976,warlock,destruction,66,46,20
51706,Narila,firetree,1976,warlock,destruction,48,29,19
51707,Zuelu,tichondrius,1975,warlock,destruction,84,54,30
51708,Hàrrydotter,darkspear,1975,warlock,destruction,94,52,42
51709,Maureenn,mannoroth,1973,warlock,destruction,109,57,52
51710,Stankybootie,malganis,1970,warlock,destruction,79,53,26
51711,Calvarr,bleeding-hollow,1970,warlock,destruction,77,45,32
51712,Marware,quelthalas,1970,warlock,destruction,72,37,35
51713,Trengodx,area-52,1968,warlock,destruction,66,47,19
51714,Pigii,tichondrius,1967,warlock,destruction,42,28,14
51715,Salival,chogall,1965,warlock,destruction,51,36,15
51716,Dazu,illidan,1965,warlock,destruction,125,66,59
51717,Mizmagius,moon-guard,1965,warlock,destruction,65,31,34
51718,Hellsparks,malganis,1964,warlock,destruction,54,33,21
51719,Boltsnhoes,illidan,1961,warlock,destruction,78,46,32
51720,Radicalz,ragnaros,1959,warlock,destruction,55,30,25
51721,Blackyeonnam,tichondrius,1959,warlock,destruction,86,46,40
51722,Cvoaw,bonechewer,1958,warlock,destruction,90,49,41
51723,Albbanoo,tichondrius,1958,warlock,destruction,149,78,71
51724,Vexe,tichondrius,1957,warlock,destruction,110,67,43
51725,Wzxx,tichondrius,1956,warlock,destruction,206,112,94
51726,Mazewl,illidan,1955,warlock,destruction,117,71,46
51727,Seangnong,tichondrius,1953,warlock,destruction,54,34,20
51728,Soulbane,tol-barad,1951,warlock,destruction,33,22,11
51729,Deadlpoo,stormscale,1951,warlock,destruction,188,97,91
51730,Truenatestes,proudmoore,1950,warlock,destruction,175,88,87
51731,Daddybolt,blackrock,1948,warlock,destruction,52,28,24
51732,Heresucacok,frostmourne,1947,warlock,destruction,36,22,14
51733,Rakshama,chogall,1944,warlock,destruction,45,26,19
51734,Zyltan,tichondrius,1938,warlock,destruction,36,25,11
51735,Vileröze,zuljin,1938,warlock,destruction,114,62,52
51736,Balveer,tichondrius,1937,warlock,destruction,35,21,14
51737,Demondisco,tichondrius,1937,warlock,destruction,57,34,23
51738,Zchenboom,tichondrius,1935,warlock,destruction,48,32,16
51739,Sosahawk,stormrage,1933,warlock,destruction,149,94,55
51740,Roxmysox,darkspear,1930,warlock,destruction,102,54,48
51741,Beegbeechy,nesingwary,1929,warlock,destruction,72,41,31
51742,Dommön,ragnaros,1929,warlock,destruction,96,50,46
51743,Bismorc,frostmourne,1928,warlock,destruction,52,31,21
51744,Dazedl,stormrage,1928,warlock,destruction,39,23,16
51745,Chaosbolt,bloodhoof,1927,warlock,destruction,96,50,46
51746,Yuoalx,tichondrius,1922,warlock,destruction,72,38,34
51747,Intentionz,sargeras,1921,warlock,destruction,65,39,26
51748,Deathair,tichondrius,1918,warlock,destruction,54,31,23
51749,Il,nerzhul,1915,warlock,destruction,30,25,5
51750,Warlockwars,amanthul,1915,warlock,destruction,267,134,133
51751,Ignorai,illidan,1913,warlock,destruction,148,82,66
51752,Dxhusky,tichondrius,1912,warlock,destruction,66,37,29
51753,Nðm,tichondrius,1912,warlock,destruction,120,58,62
51754,Freddiewill,tichondrius,1911,warlock,destruction,113,67,46
51755,Feetsampler,stormrage,1911,warlock,destruction,87,44,43
51756,Skynflute,tichondrius,1910,warlock,destruction,40,21,19
51757,Audition,ragnaros,1910,warlock,destruction,114,55,59
51758,Dreadful,frostmourne,1907,warlock,destruction,81,49,32
51759,Reneqtxo,frostmourne,1906,warlock,destruction,92,60,32
51760,Whatisthis,tichondrius,1906,warlock,destruction,36,20,16
51761,Bronzel,tichondrius,1905,warlock,destruction,30,23,7
51762,Yoyoyosup,stormrage,1905,warlock,destruction,48,32,16
51763,Coilsinfive,tichondrius,1904,warlock,destruction,42,27,15
51764,Famerap,tichondrius,1902,warlock,destruction,42,29,13
51765,Almostoogood,illidan,1902,warlock,destruction,42,25,17
51766,Laiquisha,zuljin,1900,warlock,destruction,49,29,20
51767,Ozmat,spirestone,1900,warlock,destruction,36,20,16
51768,Amez,grizzly-hills,1900,warlock,destruction,60,33,27
51769,Bigjmmywiggl,illidan,1898,warlock,destruction,109,67,42
51770,Tott,hellscream,1898,warlock,destruction,50,26,24
51771,Scatz,sargeras,1897,warlock,destruction,36,33,3
51772,Fingerslock,malganis,1897,warlock,destruction,102,52,50
51773,Bod,bleeding-hollow,1896,warlock,destruction,59,34,25
51774,Boxtrolls,ragnaros,1896,warlock,destruction,54,31,23
51775,Jaspieno,illidan,1895,warlock,destruction,54,34,20
51776,Belandyr,stormrage,1893,warlock,destruction,36,20,16
51777,Stilltrilly,tichondrius,1892,warlock,destruction,36,25,11
51778,Oldwing,illidan,1892,warlock,destruction,143,75,68
51779,Moosejockey,stormrage,1890,warlock,destruction,30,20,10
51780,Warsmock,tichondrius,1887,warlock,destruction,49,28,21
51781,Wwlock,area-52,1887,warlock,destruction,164,86,78
51782,Naughtybolts,sargeras,1884,warlock,destruction,59,41,18
51783,Toggafputuhs,illidan,1884,warlock,destruction,42,26,16
51784,Darkjambii,tichondrius,1884,warlock,destruction,76,46,30
51785,Madthelock,sargeras,1884,warlock,destruction,42,20,22
51786,Maadhum,illidan,1884,warlock,destruction,78,33,45
51787,Jfet,sargeras,1883,warlock,destruction,35,24,11
51788,Zettian,quelthalas,1883,warlock,destruction,54,30,24
51789,Warcalk,stormrage,1882,warlock,destruction,60,37,23
51790,Benafflockz,kelthuzad,1882,warlock,destruction,77,46,31
51791,Wampeter,azshara,1882,warlock,destruction,92,50,42
51792,Bigulinhos,nemesis,1881,warlock,destruction,48,27,21
51793,Çxb,tichondrius,1879,warlock,destruction,89,50,39
51794,Humanwarlock,spirestone,1879,warlock,destruction,57,32,25
51795,Neverending,malganis,1878,warlock,destruction,49,28,21
51796,Drazh,area-52,1876,warlock,destruction,63,36,27
51797,Tommybahama,velen,1875,warlock,destruction,76,45,31
51798,Evilclass,tichondrius,1874,warlock,destruction,60,42,18
51799,Illinkin,illidan,1874,warlock,destruction,144,84,60
51800,Pikslol,bleeding-hollow,1874,warlock,destruction,48,27,21
51801,Løckyun,tichondrius,1873,warlock,destruction,30,24,6
51802,Shinjuro,stormrage,1873,warlock,destruction,60,37,23
51803,Dottcha,blackrock,1873,warlock,destruction,90,48,42
51804,Locodwarf,frostmourne,1873,warlock,destruction,274,136,138
51805,Zarinista,veknilash,1872,warlock,destruction,91,47,44
51806,Twinklockxx,mannoroth,1872,warlock,destruction,143,66,77
51807,Millidots,bleeding-hollow,1871,warlock,destruction,60,35,25
51808,Hommer,tichondrius,1870,warlock,destruction,57,34,23
51809,Bigdamege,tichondrius,1870,warlock,destruction,67,39,28
51810,Ñpç,bleeding-hollow,1870,warlock,destruction,89,48,41
51811,Gucciflops,bleeding-hollow,1870,warlock,destruction,66,33,33
51812,Espanyolo,zuljin,1868,warlock,destruction,84,58,26
51813,Nasn,black-dragonflight,1868,warlock,destruction,80,51,29
51814,Slurper,frostwolf,1867,warlock,destruction,36,23,13
51815,Amazingamez,sargeras,1867,warlock,destruction,78,42,36
51816,Inmøtion,tichondrius,1867,warlock,destruction,48,25,23
51817,Lopenx,korgath,1866,warlock,destruction,182,91,91
51818,Farathos,ragnaros,1865,warlock,destruction,166,98,68
51819,Pheadas,deathwing,1865,warlock,destruction,42,20,22
51820,Footyl,stormrage,1864,warlock,destruction,54,39,15
51821,Palumorl,deathwing,1864,warlock,destruction,36,23,13
51822,Darkwidow,sargeras,1863,warlock,destruction,200,102,98
51823,Scathey,area-52,1862,warlock,destruction,168,99,69
51824,Headbolterx,tichondrius,1860,warlock,destruction,39,24,15
51825,Drakwlya,tichondrius,1859,warlock,destruction,48,30,18
51826,Shutkax,sargeras,1858,warlock,destruction,42,30,12
51827,Necrosade,tichondrius,1858,warlock,destruction,48,30,18
51828,Aryoc,ragnaros,1857,warlock,destruction,126,74,52
51829,Dottx,frostmourne,1856,warlock,destruction,48,32,16
51830,Luhgëek,tichondrius,1856,warlock,destruction,47,29,18
51831,Zadelyn,whisperwind,1855,warlock,destruction,30,23,7
51832,Snerp,frostmourne,1855,warlock,destruction,135,78,57
51833,Soulrulerxc,tichondrius,1854,warlock,destruction,42,27,15
51834,Aeaea,bleeding-hollow,1854,warlock,destruction,89,52,37
51835,Mongobros,illidan,1853,warlock,destruction,54,35,19
51836,Darksummoner,kaelthas,1853,warlock,destruction,84,46,38
51837,Immolate,eitrigg,1852,warlock,destruction,48,29,19
51838,Odjure,zuljin,1852,warlock,destruction,47,27,20
51839,Milkdrunk,blackrock,1852,warlock,destruction,119,61,58
51840,Dragoska,kiljaeden,1851,warlock,destruction,60,38,22
51841,Homeboyardee,the-venture-co,1851,warlock,destruction,72,37,35
51842,Naughtybôlts,sargeras,1850,warlock,destruction,57,39,18
51843,Ændrew,darkspear,1850,warlock,destruction,59,37,22
51844,Wodwarlock,thrall,1850,warlock,destruction,45,27,18
51845,Mistrnesbitt,malganis,1850,warlock,destruction,48,25,23
51846,Panna,tichondrius,1850,warlock,destruction,296,148,148
51847,Synkz,blood-furnace,1849,warlock,destruction,42,24,18
51848,Pernicious,bladefist,1849,warlock,destruction,221,104,117
51849,Gløcked,area-52,1848,warlock,destruction,30,20,10
51850,Lamaso,area-52,1848,warlock,destruction,78,50,28
51851,Róckroad,lightnings-blade,1848,warlock,destruction,54,33,21
51852,Threeinches,kelthuzad,1848,warlock,destruction,170,100,70
51853,Mycelium,greymane,1848,warlock,destruction,34,20,14
51854,Kaelith,kelthuzad,1848,warlock,destruction,109,53,56
51855,Löcked,illidan,1846,warlock,destruction,42,36,6
51856,Brazlem,blackrock,1846,warlock,destruction,49,34,15
51857,Verbzz,tichondrius,1846,warlock,destruction,36,23,13
51858,Krokusx,illidan,1846,warlock,destruction,156,88,68
51859,Corkeý,azuremyst,1846,warlock,destruction,90,49,41
51860,Lemmepvponu,illidan,1846,warlock,destruction,59,28,31
51861,Demonicsnap,bleeding-hollow,1845,warlock,destruction,130,75,55
51862,Barbieelf,sargeras,1845,warlock,destruction,226,120,106
51863,Omegapasta,illidan,1845,warlock,destruction,84,42,42
51864,Eskyx,tichondrius,1845,warlock,destruction,53,26,27
51865,Eldenjohn,proudmoore,1844,warlock,destruction,30,24,6
51866,Zírds,stormrage,1844,warlock,destruction,60,33,27
51867,Destructo,illidan,1844,warlock,destruction,72,37,35
51868,Kartharian,wyrmrest-accord,1844,warlock,destruction,184,93,91
51869,Sithaholic,wildhammer,1843,warlock,destruction,72,39,33
51870,Chilipeppa,wyrmrest-accord,1842,warlock,destruction,36,27,9
51871,Jierd,tichondrius,1842,warlock,destruction,52,32,20
51872,Herpalock,illidan,1842,warlock,destruction,78,34,44
51873,Rocketman,hydraxis,1841,warlock,destruction,48,32,16
51874,Vialdkaseun,muradin,1841,warlock,destruction,47,28,19
51875,Kayersoul,tichondrius,1841,warlock,destruction,36,20,16
51876,Cosmosxx,illidan,1840,warlock,destruction,54,37,17
51877,Benafflockzz,kelthuzad,1840,warlock,destruction,66,44,22
51878,Mindheist,stormrage,1840,warlock,destruction,48,29,19
51879,Indelock,drenden,1840,warlock,destruction,42,24,18
51880,Rotfull,burning-legion,1840,warlock,destruction,51,29,22
51881,Razlock,moon-guard,1839,warlock,destruction,224,123,101
51882,Enter,saurfang,1838,warlock,destruction,36,24,12
51883,Zimer,moon-guard,1837,warlock,destruction,84,52,32
51884,Philsbad,lightbringer,1837,warlock,destruction,122,70,52
51885,Dxhusky,illidan,1837,warlock,destruction,60,32,28
51886,Kekbolt,tichondrius,1836,warlock,destruction,53,33,20
51887,Deathcoill,frostmourne,1836,warlock,destruction,54,32,22
51888,Wife,bleeding-hollow,1836,warlock,destruction,60,31,29
51889,Sibëria,quelthalas,1835,warlock,destruction,48,35,13
51890,Klumzey,tichondrius,1835,warlock,destruction,67,42,25
51891,Badstep,tichondrius,1835,warlock,destruction,51,30,21
51892,Charlieo,barthilas,1835,warlock,destruction,132,74,58
51893,Tonyxx,tichondrius,1835,warlock,destruction,112,58,54
51894,Goal,malganis,1835,warlock,destruction,50,25,25
51895,Gigabiga,area-52,1834,warlock,destruction,24,20,4
51896,Soragen,barthilas,1834,warlock,destruction,54,37,17
51897,Curse,agamaggan,1834,warlock,destruction,120,69,51
51898,Gotthmog,nerzhul,1833,warlock,destruction,48,30,18
51899,Dustywlx,area-52,1833,warlock,destruction,79,46,33
51900,Dotorama,sargeras,1832,warlock,destruction,53,33,20
51901,Sidgnosis,stormrage,1831,warlock,destruction,237,127,110
51902,Cumbledor,bleeding-hollow,1831,warlock,destruction,44,23,21
51903,Shadowhax,area-52,1831,warlock,destruction,122,60,62
51904,Scarified,illidan,1831,warlock,destruction,72,34,38
51905,Barovir,tichondrius,1830,warlock,destruction,54,33,21
51906,Buu,veknilash,1830,warlock,destruction,54,33,21
51907,Rhelialock,stormrage,1830,warlock,destruction,36,21,15
51908,Gigglywiggly,illidan,1829,warlock,destruction,48,33,15
51909,Brillina,windrunner,1829,warlock,destruction,60,30,30
51910,Nezlock,moon-guard,1829,warlock,destruction,92,45,47
51911,Denotate,zuljin,1828,warlock,destruction,115,65,50
51912,Koramoz,area-52,1828,warlock,destruction,176,92,84
51913,Chaosbôlt,proudmoore,1827,warlock,destruction,120,66,54
51914,Evanylock,proudmoore,1826,warlock,destruction,75,45,30
51915,Shequita,stormrage,1825,warlock,destruction,48,37,11
51916,Agaros,zuljin,1825,warlock,destruction,49,30,19
51917,Necroboi,alterac-mountains,1825,warlock,destruction,52,29,23
51918,Kissmybolts,frostmourne,1825,warlock,destruction,83,42,41
51919,Vulcke,kelthuzad,1825,warlock,destruction,59,29,30
51920,Emospec,chogall,1824,warlock,destruction,54,35,19
51921,Exilegd,proudmoore,1824,warlock,destruction,89,57,32
51922,Dipicrowcaw,tichondrius,1822,warlock,destruction,24,19,5
51923,Vilebeing,frostmourne,1822,warlock,destruction,66,46,20
51924,Hakai,bleeding-hollow,1822,warlock,destruction,92,57,35
51925,Badhombre,tichondrius,1821,warlock,destruction,48,31,17
51926,Dadtired,tichondrius,1820,warlock,destruction,54,37,17
51927,Chaøz,bleeding-hollow,1820,warlock,destruction,48,32,16
51928,Tm,dalaran,1820,warlock,destruction,53,34,19
51929,Soulbane,jubeithos,1820,warlock,destruction,30,19,11
51930,Evilempire,sargeras,1820,warlock,destruction,54,30,24
51931,Nahalmaeim,tichondrius,1819,warlock,destruction,37,25,12
51932,Azaradx,sargeras,1819,warlock,destruction,84,54,30
51933,Yipláw,stormrage,1819,warlock,destruction,36,23,13
51934,Puginlock,illidan,1819,warlock,destruction,60,38,22
51935,Chazzlock,area-52,1819,warlock,destruction,30,19,11
51936,Slurpme,stormscale,1819,warlock,destruction,48,30,18
51937,Thegodd,nemesis,1819,warlock,destruction,66,31,35
51938,Vamprixlz,illidan,1818,warlock,destruction,49,34,15
51939,Haì,illidan,1818,warlock,destruction,60,37,23
51940,Veklen,tichondrius,1818,warlock,destruction,64,36,28
51941,Bumbleebolt,azralon,1817,warlock,destruction,24,19,5
51942,Firenzy,dalaran,1817,warlock,destruction,67,39,28
51943,Antinurse,bleeding-hollow,1817,warlock,destruction,78,45,33
51944,Dralok,area-52,1817,warlock,destruction,66,38,28
51945,Lockonomicz,tichondrius,1817,warlock,destruction,42,24,18
51946,Feinnx,dalaran,1817,warlock,destruction,70,38,32
51947,Zehoc,thrall,1817,warlock,destruction,102,55,47
51948,Derok,bleeding-hollow,1817,warlock,destruction,277,144,133
51949,Dampenedx,bleeding-hollow,1817,warlock,destruction,58,30,28
51950,Wraithlord,chogall,1816,warlock,destruction,51,32,19
51951,Screampies,tichondrius,1816,warlock,destruction,52,30,22
51952,Brujoalfa,ragnaros,1816,warlock,destruction,169,95,74
51953,Doclove,destromath,1816,warlock,destruction,149,83,66
51954,Tribulatiön,moon-guard,1816,warlock,destruction,440,235,205
51955,Noxfear,azralon,1815,warlock,destruction,72,51,21
51956,Dunnin,dalaran,1815,warlock,destruction,36,22,14
51957,Savlonicsego,stormrage,1815,warlock,destruction,78,45,33
51958,Frappucino,wyrmrest-accord,1814,warlock,destruction,30,23,7
51959,Nozyroh,emerald-dream,1814,warlock,destruction,41,25,16
51960,Slpxoxo,sargeras,1814,warlock,destruction,54,30,24
51961,Mythdot,ragnaros,1814,warlock,destruction,245,133,112
51962,Crayonchewer,alleria,1814,warlock,destruction,60,31,29
51963,Zaef,kelthuzad,1814,warlock,destruction,88,45,43
51964,Starwitch,darkspear,1814,warlock,destruction,125,59,66
51965,Archimondee,rivendare,1814,warlock,destruction,114,53,61
51966,Kymamd,sargeras,1813,warlock,destruction,32,21,11
51967,Wiredftw,illidan,1813,warlock,destruction,30,19,11
51968,Sacalawia,drakkari,1813,warlock,destruction,45,27,18
51969,Monika,anetheron,1813,warlock,destruction,58,32,26
51970,Lokintots,darkspear,1812,warlock,destruction,36,29,7
51971,Bodhisage,kelthuzad,1812,warlock,destruction,24,19,5
51972,Zauber,magtheridon,1812,warlock,destruction,44,29,15
51973,Destructio,tichondrius,1812,warlock,destruction,54,31,23
51974,Galfear,malganis,1812,warlock,destruction,207,116,91
51975,Deammon,tichondrius,1811,warlock,destruction,60,40,20
51976,Bellaswans,hyjal,1811,warlock,destruction,54,33,21
51977,Naroy,malygos,1811,warlock,destruction,38,21,17
51978,Mcrfan,illidan,1810,warlock,destruction,29,24,5
51979,Fenriakshog,zuljin,1810,warlock,destruction,36,23,13
51980,Tìdals,zuljin,1810,warlock,destruction,44,28,16
51981,Alchan,tichondrius,1810,warlock,destruction,65,38,27
51982,Fartymårty,tichondrius,1810,warlock,destruction,36,21,15
51983,Embrz,area-52,1810,warlock,destruction,54,31,23
51984,Omnireaper,tichondrius,1810,warlock,destruction,54,29,25
51985,Berkz,stormrage,1810,warlock,destruction,66,33,33
51986,Oof,dalaran,1809,warlock,destruction,30,22,8
51987,Ashlet,kelthuzad,1809,warlock,destruction,48,30,18
51988,Brutalsummon,frostmourne,1809,warlock,destruction,105,59,46
51989,Kyrmax,malganis,1809,warlock,destruction,138,68,70
51990,Emeraldflame,turalyon,1808,warlock,destruction,60,44,16
51991,Fanzhiyi,illidan,1808,warlock,destruction,43,27,16
51992,Daimonic,bronzebeard,1808,warlock,destruction,84,52,32
51993,Blackchinese,zuljin,1808,warlock,destruction,138,73,65
51994,Niava,tichondrius,1808,warlock,destruction,54,28,26
51995,Drthiccbolts,malganis,1807,warlock,destruction,47,29,18
51996,Drdoom,sargeras,1807,warlock,destruction,36,22,14
51997,Cheqmate,moon-guard,1807,warlock,destruction,61,36,25
51998,Xivra,thrall,1807,warlock,destruction,59,34,25
51999,Aidadeshu,tichondrius,1807,warlock,destruction,60,32,28
52000,Elfwarlock,aerie-peak,1806,warlock,destruction,40,25,15
52001,Zakhim,zuljin,1806,warlock,destruction,124,74,50
52002,Åbyssal,stormrage,1806,warlock,destruction,159,94,65
52003,Belenas,tichondrius,1806,warlock,destruction,48,28,20
52004,Amgs,frostmourne,1806,warlock,destruction,167,88,79
52005,Nigthdeath,nemesis,1806,warlock,destruction,173,91,82
52006,Rotshtëin,tichondrius,1806,warlock,destruction,173,91,82
52007,Döremi,tichondrius,1805,warlock,destruction,48,28,20
52008,Veleza,kiljaeden,1805,warlock,destruction,82,47,35
52009,Cenich,darkspear,1804,warlock,destruction,67,43,24
52010,Trixtah,illidan,1804,warlock,destruction,36,23,13
52011,Meatmanxtrem,sargeras,1804,warlock,destruction,60,33,27
52012,Xhrine,frostmourne,1803,warlock,destruction,47,31,16
52013,Expiredfood,stormreaver,1803,warlock,destruction,42,26,16
52014,Pillçosby,tichondrius,1803,warlock,destruction,36,22,14
52015,Neghros,illidan,1803,warlock,destruction,101,52,49
52016,Scârecrow,stormrage,1802,warlock,destruction,72,46,26
52017,Vexidus,moon-guard,1802,warlock,destruction,102,60,42
52018,Mamosa,stormrage,1801,warlock,destruction,72,52,20
52019,Romdi,tichondrius,1801,warlock,destruction,52,32,20
52020,Geekmonster,tichondrius,1801,warlock,destruction,54,33,21
52021,Ghettobeluga,area-52,1801,warlock,destruction,53,30,23
52022,Rettek,bleeding-hollow,1801,warlock,destruction,48,27,21
52023,Karimbenzema,tichondrius,1801,warlock,destruction,54,30,24
52024,Frightbright,sargeras,1801,warlock,destruction,45,25,20
52025,Enkryption,dalaran,1801,warlock,destruction,42,23,19
52026,Seltzi,illidan,1801,warlock,destruction,47,25,22
52027,Dauntx,proudmoore,1801,warlock,destruction,66,33,33
52028,Necrochemist,frostmane,1800,warlock,destruction,24,19,5
52029,Xervas,frostmourne,1800,warlock,destruction,54,33,21
52030,Soulbane,nemesis,1800,warlock,destruction,36,22,14
52031,Warmstreak,blackrock,1800,warlock,destruction,48,28,20
52032,Lapidate,malganis,1800,warlock,destruction,59,33,26
52033,Leruss,zangarmarsh,1800,warlock,destruction,55,30,25
52034,Matafé,kelthuzad,1799,warlock,destruction,42,28,14
52035,Cowboydann,malganis,1799,warlock,destruction,30,19,11
52036,Missinhim,shattered-halls,1798,warlock,destruction,24,19,5
52037,Doughnut,mugthol,1798,warlock,destruction,90,50,40
52038,Gianni,chogall,1798,warlock,destruction,66,36,30
52039,Sherlóck,duskwood,1798,warlock,destruction,54,28,26
52040,Cróhns,bleeding-hollow,1797,warlock,destruction,139,86,53
52041,Glôck,lightbringer,1797,warlock,destruction,103,51,52
52042,Kogath,thunderlord,1796,warlock,destruction,116,66,50
52043,Vonsteevan,area-52,1795,warlock,destruction,51,33,18
52044,Ruination,cenarius,1795,warlock,destruction,42,22,20
52045,Puchador,sargeras,1795,warlock,destruction,144,74,70
52046,Krikxy,tichondrius,1793,warlock,destruction,56,31,25
52047,Feardotjpg,stormrage,1791,warlock,destruction,42,29,13
52048,Shadøwy,nemesis,1791,warlock,destruction,184,102,82
52049,Kyleslock,illidan,1790,warlock,destruction,29,21,8
52050,Daylyt,sargeras,1790,warlock,destruction,33,22,11
52051,Lockdotsftw,illidan,1790,warlock,destruction,54,28,26
52052,Løcalplugxø,barthilas,1786,warlock,destruction,137,86,51
52053,Whitexzz,tichondrius,1786,warlock,destruction,42,24,18
52054,Leeroydots,area-52,1785,warlock,destruction,66,42,24
52055,Yeepzbytre,bleeding-hollow,1785,warlock,destruction,102,62,40
52056,Birez,kelthuzad,1785,warlock,destruction,104,58,46
52057,Deathhawkz,ravencrest,1784,warlock,destruction,36,24,12
52058,Wreyz,mannoroth,1783,warlock,destruction,72,39,33
52059,Nevermindxd,barthilas,1783,warlock,destruction,66,32,34
52060,Finalboss,tichondrius,1782,warlock,destruction,48,33,15
52061,Positivity,thunderhorn,1782,warlock,destruction,48,30,18
52062,Øutbreak,thrall,1782,warlock,destruction,56,33,23
52063,Tonnon,stormrage,1782,warlock,destruction,84,47,37
52064,Killabeesack,tichondrius,1780,warlock,destruction,73,45,28
52065,Duckboji,tichondrius,1780,warlock,destruction,56,33,23
52066,Latchlock,malganis,1780,warlock,destruction,203,109,94
52067,Dupapad,stormrage,1780,warlock,destruction,65,31,34
52068,Wineburger,frostmourne,1779,warlock,destruction,60,40,20
52069,Nahz,tichondrius,1779,warlock,destruction,42,24,18
52070,Jakjub,kelthuzad,1778,warlock,destruction,54,31,23
52071,Eggpower,tichondrius,1776,warlock,destruction,52,27,25
52072,Ralerhard,kelthuzad,1775,warlock,destruction,64,40,24
52073,Grq,stormrage,1775,warlock,destruction,69,43,26
52074,Hellparks,malganis,1774,warlock,destruction,42,27,15
52075,Suaveaye,tichondrius,1774,warlock,destruction,60,32,28
52076,Loksoflove,tichondrius,1773,warlock,destruction,30,21,9
52077,Screwed,tichondrius,1773,warlock,destruction,96,49,47
52078,Tenaciousd,malganis,1772,warlock,destruction,42,21,21
52079,Alùcärd,tichondrius,1772,warlock,destruction,54,25,29
52080,Azlloa,tichondrius,1771,warlock,destruction,42,27,15
52081,Plasticware,korgath,1771,warlock,destruction,48,29,19
52082,Andelaylas,tichondrius,1771,warlock,destruction,95,57,38
52083,Twilson,moon-guard,1771,warlock,destruction,54,29,25
52084,Anujy,moon-guard,1769,warlock,destruction,78,53,25
52085,Nùts,frostmourne,1769,warlock,destruction,42,27,15
52086,Urukái,dalaran,1769,warlock,destruction,117,65,52
52087,Gladyr,frostmourne,1768,warlock,destruction,54,28,26
52088,Lifeinsuranc,tichondrius,1767,warlock,destruction,30,19,11
52089,Donutd,stormrage,1767,warlock,destruction,36,22,14
52090,Zunexx,malganis,1764,warlock,destruction,48,27,21
52091,Punstable,tichondrius,1763,warlock,destruction,121,65,56
52092,Kakistocracy,kelthuzad,1761,warlock,destruction,30,23,7
52093,Mursay,tichondrius,1761,warlock,destruction,42,30,12
52094,Paparoxy,illidan,1761,warlock,destruction,60,30,30
52095,Marshyxd,tichondrius,1759,warlock,destruction,48,23,25
52096,Gottawiz,illidan,1758,warlock,destruction,60,32,28
52097,Nick,llane,1757,warlock,destruction,36,23,13
52098,Eggós,sargeras,1757,warlock,destruction,333,164,169
52099,Chêrrypopper,proudmoore,1755,warlock,destruction,67,41,26
52100,Squishyboy,tichondrius,1755,warlock,destruction,57,30,27
52101,Ravëncläw,quelthalas,1755,warlock,destruction,67,35,32
52102,Isoldmysoul,stormrage,1755,warlock,destruction,114,54,60
52103,Flattsl,tichondrius,1755,warlock,destruction,84,39,45
52104,Obliceress,crushridge,1754,warlock,destruction,42,26,16
52105,Ibrroski,proudmoore,1753,warlock,destruction,24,20,4
52106,Symaitiel,azralon,1751,warlock,destruction,96,51,45
52107,Éx,jubeithos,1748,warlock,destruction,47,30,17
52108,Bolsheivik,dentarg,1748,warlock,destruction,94,52,42
52109,Lockfaceguy,agamaggan,1747,warlock,destruction,75,39,36
52110,Qualio,thrall,1746,warlock,destruction,129,62,67
52111,Devi,executus,1745,warlock,destruction,30,19,11
52112,Magnetix,arthas,1744,warlock,destruction,181,93,88
52113,Podda,shuhalo,1743,warlock,destruction,53,33,20
52114,Thinktank,tichondrius,1743,warlock,destruction,42,25,17
52115,Kairiesmirk,illidan,1743,warlock,destruction,123,65,58
52116,Raxxis,moon-guard,1742,warlock,destruction,29,19,10
52117,Dewandoritos,kelthuzad,1742,warlock,destruction,36,22,14
52118,Flake,kelthuzad,1741,warlock,destruction,62,37,25
52119,Halloweèn,kelthuzad,1741,warlock,destruction,131,74,57
52120,Pkzy,azralon,1741,warlock,destruction,36,19,17
52121,Vallàx,area-52,1741,warlock,destruction,150,78,72
52122,Bouldrlickr,dragonmaw,1740,warlock,destruction,48,30,18
52123,Darknessgodd,goldrinn,1739,warlock,destruction,121,75,46
52124,Jeffreyw,tichondrius,1738,warlock,destruction,65,38,27
52125,Zrok,bleeding-hollow,1738,warlock,destruction,60,29,31
52126,Rollup,turalyon,1737,warlock,destruction,36,20,16
52127,Darkmagician,kelthuzad,1735,warlock,destruction,30,22,8
52128,Radalyn,icecrown,1735,warlock,destruction,37,22,15
52129,Chaoticchaos,kelthuzad,1735,warlock,destruction,35,20,15
52130,Hädes,frostwolf,1734,warlock,destruction,45,31,14
52131,Plaintive,moon-guard,1733,warlock,destruction,48,27,21
52132,Mânuel,akama,1731,warlock,destruction,30,22,8
52133,Keniiwood,quelthalas,1730,warlock,destruction,42,21,21
52134,Midoolock,proudmoore,1729,warlock,destruction,60,40,20
52135,Sdiaz,illidan,1729,warlock,destruction,42,26,16
52136,Loadybigbolt,dalaran,1729,warlock,destruction,89,51,38
52137,Teesolinia,stormrage,1728,warlock,destruction,75,50,25
52138,Harmfuul,illidan,1728,warlock,destruction,45,28,17
52139,Painful,mannoroth,1728,warlock,destruction,162,86,76
52140,Swapsfour,area-52,1727,warlock,destruction,30,19,11
52141,Cloudynightz,tichondrius,1727,warlock,destruction,161,88,73
52142,Uarus,tichondrius,1725,warlock,destruction,42,26,16
52143,Popdotdropit,frostwolf,1725,warlock,destruction,84,48,36
52144,Perfidious,altar-of-storms,1723,warlock,destruction,40,30,10
52145,Mindrekt,azralon,1723,warlock,destruction,60,44,16
52146,Ensanaty,dalaran,1721,warlock,destruction,48,27,21
52147,Destructing,hyjal,1721,warlock,destruction,48,25,23
52148,Covidmaster,frostmourne,1720,warlock,destruction,118,63,55
52149,Drwongmd,sargeras,1719,warlock,destruction,30,21,9
52150,Michae,tichondrius,1718,warlock,destruction,24,18,6
52151,Verminosa,nemesis,1718,warlock,destruction,30,19,11
52152,Agni,gurubashi,1718,warlock,destruction,126,66,60
52153,Jenda,blackrock,1717,warlock,destruction,128,67,61
52154,Chaosjedi,stormrage,1717,warlock,destruction,117,53,64
52155,Spooked,khadgar,1716,warlock,destruction,36,24,12
52156,Naiyuan,tichondrius,1716,warlock,destruction,36,18,18
52157,Drakedog,ragnaros,1714,warlock,destruction,30,21,9
52158,Lockfoxyy,tichondrius,1714,warlock,destruction,30,21,9
52159,Carcøsa,malganis,1714,warlock,destruction,72,40,32
52160,Sixv,barthilas,1713,warlock,destruction,48,32,16
52161,Richãrdjr,area-52,1713,warlock,destruction,36,22,14
52162,Lotussama,anetheron,1712,warlock,destruction,24,18,6
52163,Evatar,malganis,1712,warlock,destruction,36,21,15
52164,Keylloggz,sargeras,1712,warlock,destruction,102,56,46
52165,Hehimx,bleeding-hollow,1711,warlock,destruction,24,18,6
52166,Mchawi,tichondrius,1711,warlock,destruction,59,35,24
52167,Crimpy,dathremar,1711,warlock,destruction,59,34,25
52168,Trundle,area-52,1711,warlock,destruction,59,34,25
52169,Mastasnipah,illidan,1711,warlock,destruction,42,22,20
52170,Serveq,tichondrius,1710,warlock,destruction,103,58,45
52171,Nt,burning-legion,1709,warlock,destruction,44,36,8
52172,Richãrd,area-52,1709,warlock,destruction,49,26,23
52173,Ercaz,frostmourne,1709,warlock,destruction,48,20,28
52174,Shulol,tichondrius,1708,warlock,destruction,30,18,12
52175,Pigmahz,malganis,1708,warlock,destruction,72,39,33
52176,Wårløck,stormrage,1707,warlock,destruction,24,18,6
52177,Cokeparty,tichondrius,1707,warlock,destruction,53,29,24
52178,Dbf,sargeras,1706,warlock,destruction,90,45,45
52179,Tacticalderp,bleeding-hollow,1706,warlock,destruction,36,18,18
52180,Freejakejone,tichondrius,1704,warlock,destruction,34,20,14
52181,Wolfstein,tichondrius,1699,warlock,destruction,24,18,6
52182,Conradlenoir,illidan,1699,warlock,destruction,36,23,13
52183,Giantgobrin,zuljin,1699,warlock,destruction,60,31,29
52184,Struggles,emerald-dream,1699,warlock,destruction,183,94,89
52185,Daartaru,quelthalas,1698,warlock,destruction,90,48,42
52186,Sairic,azralon,1697,warlock,destruction,78,51,27
52187,Azazil,malganis,1697,warlock,destruction,36,22,14
52188,Fredwinsta,laughing-skull,1697,warlock,destruction,54,29,25
52189,Harukay,tichondrius,1696,warlock,destruction,29,20,9
52190,Hiddentech,saurfang,1696,warlock,destruction,36,20,16
52191,Teivlol,mugthol,1696,warlock,destruction,36,18,18
52192,Ägnar,nemesis,1693,warlock,destruction,28,19,9
52193,Viralwashbrn,illidan,1693,warlock,destruction,60,31,29
52194,Pk,azralon,1691,warlock,destruction,24,18,6
52195,Dotandforget,tichondrius,1691,warlock,destruction,36,24,12
52196,Chrönic,azralon,1691,warlock,destruction,45,26,19
52197,Cbx,kelthuzad,1690,warlock,destruction,36,28,8
52198,Aluaris,earthen-ring,1690,warlock,destruction,30,23,7
52199,Chaosbeard,korgath,1690,warlock,destruction,62,36,26
52200,Taneverah,wyrmrest-accord,1689,warlock,destruction,47,30,17
52201,Yidhra,aerie-peak,1689,warlock,destruction,105,57,48
52202,Missmonday,tichondrius,1689,warlock,destruction,83,44,39
52203,Hauntsin,hyjal,1689,warlock,destruction,42,21,21
52204,Aggrodesiac,wyrmrest-accord,1688,warlock,destruction,66,36,30
52205,Kâyn,area-52,1687,warlock,destruction,89,46,43
52206,Lønewølf,sargeras,1687,warlock,destruction,90,45,45
52207,Wafflezcb,frostmourne,1687,warlock,destruction,43,21,22
52208,Dautenit,illidan,1687,warlock,destruction,66,32,34
52209,Bfadestro,tichondrius,1686,warlock,destruction,36,24,12
52210,Drain,proudmoore,1686,warlock,destruction,60,38,22
52211,Bobbyshmurdå,frostmourne,1686,warlock,destruction,48,29,19
52212,Contagion,dragonmaw,1685,warlock,destruction,36,20,16
52213,Veerdz,area-52,1685,warlock,destruction,54,24,30
52214,Melôck,area-52,1684,warlock,destruction,42,28,14
52215,Urukaix,sargeras,1683,warlock,destruction,36,23,13
52216,Maggotworm,sargeras,1683,warlock,destruction,189,104,85
52217,Droptopp,malganis,1680,warlock,destruction,42,27,15
52218,Guldansbicep,illidan,1679,warlock,destruction,45,26,19
52219,Yaresly,kelthuzad,1678,warlock,destruction,38,25,13
52220,Gavrhin,area-52,1678,warlock,destruction,41,26,15
52221,Sakyameil,area-52,1678,warlock,destruction,42,25,17
52222,Lïttle,stormrage,1678,warlock,destruction,81,48,33
52223,Chaotixbolt,sargeras,1677,warlock,destruction,30,20,10
52224,Getoffmedawg,illidan,1677,warlock,destruction,66,38,28
52225,Breeak,sargeras,1676,warlock,destruction,48,31,17
52226,Gekku,ragnaros,1676,warlock,destruction,36,22,14
52227,Kbolt,barthilas,1676,warlock,destruction,95,55,40
52228,Terrorbytes,frostmourne,1676,warlock,destruction,114,61,53
52229,Dipixd,tichondrius,1675,warlock,destruction,24,22,2
52230,Revenus,tichondrius,1675,warlock,destruction,195,97,98
52231,Feardadots,tichondrius,1674,warlock,destruction,69,46,23
52232,Gasgrassnass,sargeras,1674,warlock,destruction,83,46,37
52233,Jpepps,perenolde,1673,warlock,destruction,77,48,29
52234,Knockknock,llane,1673,warlock,destruction,42,22,20
52235,Razzakka,stormrage,1673,warlock,destruction,171,87,84
52236,Juicestarr,barthilas,1673,warlock,destruction,93,44,49
52237,Booßiemiles,area-52,1672,warlock,destruction,157,92,65
52238,Bytezlk,area-52,1672,warlock,destruction,36,21,15
52239,Cairo,emerald-dream,1672,warlock,destruction,225,119,106
52240,Gëngar,malganis,1671,warlock,destruction,31,23,8
52241,Pyatpree,bleeding-hollow,1671,warlock,destruction,30,19,11
52242,Mlxd,tichondrius,1670,warlock,destruction,24,19,5
52243,Critthis,illidan,1670,warlock,destruction,47,32,15
52244,Nocrackrocks,stormrage,1670,warlock,destruction,34,22,12
52245,Ðòm,tichondrius,1670,warlock,destruction,42,24,18
52246,Balepyre,moon-guard,1670,warlock,destruction,94,51,43
52247,Ðiêsel,malganis,1668,warlock,destruction,57,32,25
52248,Manapouli,area-52,1667,warlock,destruction,33,21,12
52249,Levantine,barthilas,1667,warlock,destruction,45,24,21
52250,Drksøul,barthilas,1666,warlock,destruction,77,52,25
52251,Ifearjoo,vashj,1666,warlock,destruction,48,25,23
52252,Iskiplegday,illidan,1666,warlock,destruction,107,45,62
52253,Làsko,area-52,1665,warlock,destruction,102,51,51
52254,Degred,tichondrius,1664,warlock,destruction,45,34,11
52255,Nocchi,amanthul,1664,warlock,destruction,40,19,21
52256,Sauzith,area-52,1663,warlock,destruction,36,26,10
52257,Olgee,tortheldrin,1663,warlock,destruction,53,30,23
52258,Chnos,mugthol,1663,warlock,destruction,41,23,18
52259,Lockz,illidan,1662,warlock,destruction,54,27,27
52260,Khølek,ragnaros,1661,warlock,destruction,41,30,11
52261,Dartthvader,azralon,1661,warlock,destruction,92,45,47
52262,Silone,tichondrius,1659,warlock,destruction,30,24,6
52263,Scxut,zuljin,1658,warlock,destruction,24,19,5
52264,Fabiusbilex,tichondrius,1658,warlock,destruction,39,23,16
52265,Sendnudez,nemesis,1657,warlock,destruction,53,30,23
52266,Sîthfu,tichondrius,1657,warlock,destruction,195,105,90
52267,Cbolt,tichondrius,1656,warlock,destruction,90,52,38
52268,Pikme,bleeding-hollow,1656,warlock,destruction,42,23,19
52269,Mephizar,moon-guard,1656,warlock,destruction,56,30,26
52270,Deangood,tichondrius,1656,warlock,destruction,152,77,75
52271,Steebi,tichondrius,1655,warlock,destruction,36,23,13
52272,Favorite,malfurion,1655,warlock,destruction,36,21,15
52273,Nooko,frostmourne,1655,warlock,destruction,48,25,23
52274,Zhvim,stormrage,1654,warlock,destruction,41,23,18
52275,Hellwish,tichondrius,1654,warlock,destruction,108,53,55
52276,Egirlgamer,sargeras,1653,warlock,destruction,72,43,29
52277,Nickie,azralon,1653,warlock,destruction,60,33,27
52278,Dobbythelock,zuljin,1653,warlock,destruction,42,23,19
52279,Wayce,burning-blade,1653,warlock,destruction,166,88,78
52280,Fece,area-52,1652,warlock,destruction,38,24,14
52281,Warmandei,dalaran,1652,warlock,destruction,72,42,30
52282,Jennifear,sargeras,1652,warlock,destruction,60,35,25
52283,Fearlord,shattered-hand,1651,warlock,destruction,54,28,26
52284,Zoagen,ragnaros,1650,warlock,destruction,28,20,8
52285,Doombaby,zuljin,1650,warlock,destruction,138,79,59
52286,Lemonfire,area-52,1650,warlock,destruction,49,26,23
52287,Lockniel,skullcrusher,1649,warlock,destruction,60,37,23
52288,Absoluté,nemesis,1649,warlock,destruction,36,19,17
52289,Royalmace,dethecus,1648,warlock,destruction,46,25,21
52290,Jaythuzad,stormrage,1648,warlock,destruction,146,79,67
52291,Teefgap,sargeras,1648,warlock,destruction,36,19,17
52292,Uranusa,proudmoore,1648,warlock,destruction,108,50,58
52293,Trewlocke,sargeras,1647,warlock,destruction,42,25,17
52294,Noggét,frostmourne,1647,warlock,destruction,114,67,47
52295,Muffîn,moon-guard,1647,warlock,destruction,109,64,45
52296,Reppedlock,illidan,1647,warlock,destruction,94,55,39
52297,Javirr,ragnaros,1645,warlock,destruction,65,39,26
52298,Neverportx,kirin-tor,1645,warlock,destruction,36,21,15
52299,Jussmollett,arygos,1645,warlock,destruction,119,63,56
52300,Dëstró,tichondrius,1645,warlock,destruction,65,34,31
52301,Misolock,sargeras,1644,warlock,destruction,105,56,49
52302,Revérence,sargeras,1644,warlock,destruction,41,21,20
52303,Oblivious,firetree,1644,warlock,destruction,195,98,97
52304,Ðemented,bleeding-hollow,1643,warlock,destruction,33,19,14
52305,Sagatt,illidan,1643,warlock,destruction,71,39,32
52306,Debigbolt,area-52,1642,warlock,destruction,30,22,8
52307,Fiddlesticks,draka,1642,warlock,destruction,54,36,18
52308,Tahmrin,quelthalas,1642,warlock,destruction,58,30,28
52309,Skrublockz,area-52,1642,warlock,destruction,41,21,20
52310,Imports,tichondrius,1641,warlock,destruction,34,21,13
52311,Chaosage,sargeras,1640,warlock,destruction,42,28,14
52312,Luckehlock,firetree,1640,warlock,destruction,65,34,31
52313,Fearmebro,bleeding-hollow,1639,warlock,destruction,139,72,67
52314,Thirsts,tichondrius,1638,warlock,destruction,46,27,19
52315,Belford,tichondrius,1638,warlock,destruction,67,35,32
52316,Pyralock,malfurion,1638,warlock,destruction,48,25,23
52317,Demonclock,sargeras,1637,warlock,destruction,39,24,15
52318,Kurifodo,illidan,1637,warlock,destruction,77,43,34
52319,Ardentia,malganis,1637,warlock,destruction,54,30,24
52320,Reficul,frostmourne,1637,warlock,destruction,50,23,27
52321,Parishiltoon,frostmourne,1637,warlock,destruction,52,22,30
52322,Arenis,stormrage,1636,warlock,destruction,36,25,11
52323,Xylâ,emerald-dream,1636,warlock,destruction,39,22,17
52324,Eyoeyo,tichondrius,1636,warlock,destruction,42,18,24
52325,Cursedstales,stormrage,1635,warlock,destruction,42,30,12
52326,Flággedname,area-52,1635,warlock,destruction,36,21,15
52327,Sëcond,azralon,1635,warlock,destruction,36,19,17
52328,Kylaria,emerald-dream,1635,warlock,destruction,48,24,24
52329,Hugechungusw,frostmourne,1634,warlock,destruction,50,31,19
52330,Bénâfflock,area-52,1634,warlock,destruction,54,32,22
52331,Ezdagor,quelthalas,1634,warlock,destruction,152,85,67
52332,Identiti,tichondrius,1634,warlock,destruction,49,27,22
52333,Iconicxo,thrall,1634,warlock,destruction,84,43,41
52334,Dìpndots,wyrmrest-accord,1633,warlock,destruction,54,32,22
52335,Zhaphrax,frostmourne,1633,warlock,destruction,85,43,42
52336,Meraz,zuljin,1632,warlock,destruction,34,20,14
52337,Evapilot,tichondrius,1632,warlock,destruction,54,31,23
52338,Siellisele,illidan,1632,warlock,destruction,60,29,31
52339,Azaradx,azralon,1632,warlock,destruction,79,33,46
52340,Guldoom,tichondrius,1631,warlock,destruction,18,17,1
52341,Demonista,illidan,1631,warlock,destruction,31,22,9
52342,Oxylock,magtheridon,1631,warlock,destruction,42,24,18
52343,Lóckdówn,frostmourne,1631,warlock,destruction,60,32,28
52344,Shendù,stormrage,1631,warlock,destruction,48,23,25
52345,Hynnis,nemesis,1630,warlock,destruction,60,37,23
52346,Ddorangmoon,tichondrius,1630,warlock,destruction,42,25,17
52347,Dipixyz,tichondrius,1630,warlock,destruction,30,17,13
52348,Infecçäo,stormrage,1630,warlock,destruction,131,73,58
52349,Kjazz,tichondrius,1630,warlock,destruction,42,23,19
52350,Holunging,illidan,1630,warlock,destruction,36,19,17
52351,Stormrift,sargeras,1629,warlock,destruction,74,39,35
52352,Ltoplaylock,area-52,1628,warlock,destruction,24,17,7
52353,Soranpotter,tichondrius,1628,warlock,destruction,24,17,7
52354,Tuugadark,echo-isles,1628,warlock,destruction,85,51,34
52355,Exgenshinpro,proudmoore,1628,warlock,destruction,30,17,13
52356,Dmacxl,tichondrius,1627,warlock,destruction,36,20,16
52357,Cöpeñhagen,illidan,1627,warlock,destruction,48,26,22
52358,Undeadzx,tichondrius,1627,warlock,destruction,36,19,17
52359,Devilman,darkspear,1627,warlock,destruction,163,83,80
52360,Shadowlifts,kelthuzad,1626,warlock,destruction,48,29,19
52361,Meep,madoran,1626,warlock,destruction,59,35,24
52362,Katastrophïk,area-52,1626,warlock,destruction,36,20,16
52363,Døomsday,hyjal,1626,warlock,destruction,42,21,21
52364,Zandõx,jubeithos,1625,warlock,destruction,48,30,18
52365,Byndedlock,dragonmaw,1625,warlock,destruction,33,20,13
52366,Vvivienx,tichondrius,1625,warlock,destruction,30,17,13
52367,Babydots,stormreaver,1625,warlock,destruction,80,44,36
52368,Dovahkini,stormrage,1625,warlock,destruction,47,23,24
52369,Shadowsloc,tichondrius,1625,warlock,destruction,48,22,26
52370,Stølo,deathwing,1624,warlock,destruction,112,73,39
52371,Ruknài,barthilas,1624,warlock,destruction,36,21,15
52372,Coomerius,zuljin,1624,warlock,destruction,54,29,25
52373,Xephine,proudmoore,1623,warlock,destruction,46,30,16
52374,Alizondemdik,azralon,1623,warlock,destruction,67,37,30
52375,Thotblood,stormrage,1622,warlock,destruction,24,18,6
52376,Friendd,frostmourne,1622,warlock,destruction,41,30,11
52377,Doomswitch,sargeras,1622,warlock,destruction,48,33,15
52378,Permaslowed,kiljaeden,1622,warlock,destruction,40,22,18
52379,Golock,tichondrius,1621,warlock,destruction,24,17,7
52380,Deathmask,alleria,1621,warlock,destruction,52,30,22
52381,Ticklebolts,tichondrius,1621,warlock,destruction,52,21,31
52382,Elmobolt,thrall,1620,warlock,destruction,37,27,10
52383,Flûké,tichondrius,1620,warlock,destruction,30,17,13
52384,Annereyn,stormrage,1620,warlock,destruction,119,62,57
52385,Tít,malganis,1619,warlock,destruction,90,46,44
52386,Tougetsu,tichondrius,1618,warlock,destruction,42,26,16
52387,Penzer,stormrage,1618,warlock,destruction,36,20,16
52388,Sundrín,mugthol,1618,warlock,destruction,37,17,20
52389,Dolut,azralon,1617,warlock,destruction,54,31,23
52390,Restolock,destromath,1617,warlock,destruction,60,34,26
52391,Resuah,tichondrius,1617,warlock,destruction,124,65,59
52392,Wickedry,antonidas,1617,warlock,destruction,48,23,25
52393,Rainymood,frostmourne,1616,warlock,destruction,85,53,32
52394,Ðarkñess,burning-legion,1615,warlock,destruction,66,38,28
52395,Malagas,tichondrius,1615,warlock,destruction,81,46,35
52396,Dotgonewrong,malganis,1615,warlock,destruction,71,32,39
52397,Notspeedy,tichondrius,1615,warlock,destruction,91,41,50
52398,Ãids,khadgar,1614,warlock,destruction,54,36,18
52399,Trastham,malganis,1614,warlock,destruction,90,46,44
52400,Saltiez,sargeras,1613,warlock,destruction,24,18,6
52401,Shïrõ,tichondrius,1613,warlock,destruction,30,22,8
52402,Mokulock,tichondrius,1613,warlock,destruction,54,31,23
52403,Avelmi,daggerspine,1613,warlock,destruction,120,64,56
52404,Belzebud,area-52,1612,warlock,destruction,99,59,40
52405,Ko,nordrassil,1612,warlock,destruction,66,34,32
52406,Grandpa,daggerspine,1612,warlock,destruction,97,49,48
52407,Hypnotikal,illidan,1611,warlock,destruction,30,22,8
52408,Draenil,eredar,1611,warlock,destruction,24,17,7
52409,Corruptblxck,tichondrius,1611,warlock,destruction,45,28,17
52410,Escapefromtw,tichondrius,1611,warlock,destruction,42,24,18
52411,Chrishasnen,moon-guard,1611,warlock,destruction,54,27,27
52412,Idrannell,illidan,1610,warlock,destruction,98,56,42
52413,Cptsaveahoe,skullcrusher,1610,warlock,destruction,36,20,16
52414,Omleaf,malganis,1610,warlock,destruction,36,18,18
52415,Gigabiga,tol-barad,1609,warlock,destruction,24,17,7
52416,Funnysoxx,caelestrasz,1609,warlock,destruction,52,30,22
52417,Momshutup,sargeras,1609,warlock,destruction,35,20,15
52418,Horloc,moon-guard,1609,warlock,destruction,74,41,33
52419,Stocktonslap,saurfang,1609,warlock,destruction,145,80,65
52420,Nightshan,draenor,1609,warlock,destruction,66,32,34
52421,Isarac,zuljin,1608,warlock,destruction,78,50,28
52422,Zuyumin,ragnaros,1608,warlock,destruction,89,57,32
52423,Ayrr,zuljin,1608,warlock,destruction,30,17,13
52424,Gnomlette,smolderthorn,1608,warlock,destruction,98,53,45
52425,Kály,azralon,1608,warlock,destruction,69,37,32
52426,Lhandus,drakkari,1608,warlock,destruction,86,42,44
52427,Saruon,proudmoore,1607,warlock,destruction,24,17,7
52428,Pugnatwo,kelthuzad,1607,warlock,destruction,42,18,24
52429,Soloart,tichondrius,1606,warlock,destruction,54,30,24
52430,Katrisse,aegwynn,1606,warlock,destruction,72,37,35
52431,Bugha,ravencrest,1605,warlock,destruction,31,21,10
52432,Macdeezylock,sargeras,1605,warlock,destruction,36,23,13
52433,Vugaddi,illidan,1605,warlock,destruction,30,19,11
52434,Brdsflynhigh,garrosh,1604,warlock,destruction,33,23,10
52435,Dferreira,azralon,1604,warlock,destruction,117,64,53
52436,Darkÿoda,malganis,1604,warlock,destruction,86,47,39
52437,Hordeadlock,illidan,1604,warlock,destruction,60,31,29
52438,Powertrîp,sargeras,1604,warlock,destruction,36,18,18
52439,Brickedx,malfurion,1604,warlock,destruction,101,50,51
52440,Honchoe,illidan,1603,warlock,destruction,42,29,13
52441,Nosferatu,arthas,1602,warlock,destruction,26,20,6
52442,Bourrasq,illidan,1602,warlock,destruction,24,17,7
52443,Sslock,sargeras,1602,warlock,destruction,46,26,20
52444,Khurze,area-52,1602,warlock,destruction,97,51,46
52445,Espyn,silvermoon,1602,warlock,destruction,105,51,54
52446,Gavlock,tichondrius,1602,warlock,destruction,42,17,25
52447,Vafa,kelthuzad,1601,warlock,destruction,32,21,11
52448,Chachanoobx,sargeras,1601,warlock,destruction,132,82,50
52449,Lyonesse,frostmourne,1601,warlock,destruction,34,21,13
52450,Reportmenerd,tichondrius,1601,warlock,destruction,126,71,55
52451,Daenon,kiljaeden,1601,warlock,destruction,42,23,19
52452,Lafourche,tichondrius,1601,warlock,destruction,60,31,29
52453,Pauldiesel,ragnaros,1601,warlock,destruction,42,21,21
52454,Hâm,dalaran,1601,warlock,destruction,96,46,50
52455,Dapete,malorne,1600,warlock,destruction,36,26,10
52456,Watchmegate,darkspear,1600,warlock,destruction,72,45,27
52457,Locknug,tichondrius,1600,warlock,destruction,132,74,58
52458,Dapperdanxy,tichondrius,1600,warlock,destruction,38,21,17
52459,Adouken,ragnaros,1600,warlock,destruction,36,19,17
52460,Sauromann,sargeras,1599,warlock,destruction,108,62,46
52461,Xdta,frostmourne,1599,warlock,destruction,72,38,34
52462,Rxjr,sargeras,1599,warlock,destruction,81,39,42
52463,Johnnybegood,frostmourne,1598,warlock,destruction,54,32,22
52464,Boltsnhoez,tichondrius,1598,warlock,destruction,34,20,14
52465,Xoxoxu,frostmourne,1597,warlock,destruction,44,25,19
52466,Predictions,sargeras,1597,warlock,destruction,77,40,37
52467,Closetslut,moon-guard,1596,warlock,destruction,24,20,4
52468,Lifelock,auchindoun,1596,warlock,destruction,34,23,11
52469,Maddotts,malganis,1596,warlock,destruction,42,28,14
52470,Guula,alexstrasza,1595,warlock,destruction,42,22,20
52471,Dotcoin,tichondrius,1594,warlock,destruction,30,17,13
52472,Lockforyou,frostmourne,1594,warlock,destruction,66,37,29
52473,Jnxzlock,sargeras,1593,warlock,destruction,67,37,30
52474,Wheremyshoes,area-52,1593,warlock,destruction,141,68,73
52475,Jerearderedo,thrall,1592,warlock,destruction,54,30,24
52476,Kernlberton,tichondrius,1592,warlock,destruction,48,25,23
52477,Necrotic,mannoroth,1592,warlock,destruction,107,48,59
52478,Larryfisher,drenden,1591,warlock,destruction,30,19,11
52479,Yisuschríst,quelthalas,1591,warlock,destruction,41,21,20
52480,Akolite,tichondrius,1591,warlock,destruction,62,31,31
52481,Demonkiiller,kelthuzad,1591,warlock,destruction,48,19,29
52482,Romminus,zuljin,1589,warlock,destruction,43,30,13
52483,Lockdogg,mannoroth,1588,warlock,destruction,36,22,14
52484,Sladez,tichondrius,1588,warlock,destruction,47,20,27
52485,Caustikk,malganis,1587,warlock,destruction,44,25,19
52486,Buffwarlocks,senjin,1587,warlock,destruction,48,26,22
52487,Raykun,quelthalas,1587,warlock,destruction,66,34,32
52488,Doobielock,kelthuzad,1586,warlock,destruction,57,33,24
52489,Calidaze,tichondrius,1586,warlock,destruction,122,64,58
52490,Dots,haomarush,1586,warlock,destruction,96,49,47
52491,Tothegrave,sargeras,1585,warlock,destruction,35,22,13
52492,Rottenhell,kelthuzad,1585,warlock,destruction,108,61,47
52493,Webrar,frostmourne,1584,warlock,destruction,42,24,18
52494,Kuroyt,drakkari,1583,warlock,destruction,42,26,16
52495,Caseau,frostmourne,1581,warlock,destruction,30,19,11
52496,Dewars,aggramar,1580,warlock,destruction,108,60,48
52497,Brockdot,tichondrius,1579,warlock,destruction,38,27,11
52498,Gerthclas,aggramar,1579,warlock,destruction,35,24,11
52499,Bbclover,thrall,1579,warlock,destruction,29,19,10
52500,Matilla,tichondrius,1579,warlock,destruction,30,19,11
52501,Evilmilf,tichondrius,1579,warlock,destruction,73,39,34
52502,Yanned,hakkar,1579,warlock,destruction,201,107,94
52503,Grindwald,echo-isles,1579,warlock,destruction,85,44,41
52504,Lostanubis,tichondrius,1578,warlock,destruction,51,29,22
52505,Yaldin,nemesis,1578,warlock,destruction,197,109,88
52506,Woezz,tichondrius,1578,warlock,destruction,105,55,50
52507,Gluestik,shadowmoon,1578,warlock,destruction,84,42,42
52508,Thirdsol,stormrage,1577,warlock,destruction,59,31,28
52509,Charnoob,kelthuzad,1577,warlock,destruction,54,26,28
52510,Soreanus,illidan,1576,warlock,destruction,28,20,8
52511,Harambê,sargeras,1576,warlock,destruction,34,19,15
52512,Flor,khadgar,1575,warlock,destruction,237,122,115
52513,Kliera,stormscale,1574,warlock,destruction,36,20,16
52514,Tanskeeh,sargeras,1574,warlock,destruction,70,36,34
52515,Leônidos,ghostlands,1574,warlock,destruction,120,61,59
52516,Borthrel,moon-guard,1573,warlock,destruction,132,75,57
52517,Xiáoyan,tichondrius,1571,warlock,destruction,54,34,20
52518,Bunnyhugs,gorefiend,1571,warlock,destruction,36,22,14
52519,Stankbigly,thrall,1571,warlock,destruction,38,23,15
52520,Carmelasin,moon-guard,1570,warlock,destruction,60,39,21
52521,Versariki,frostmourne,1568,warlock,destruction,72,39,33
52522,Spliffxl,stormrage,1568,warlock,destruction,36,19,17
52523,Burnzul,bleeding-hollow,1567,warlock,destruction,42,22,20
52524,Khrom,illidan,1565,warlock,destruction,64,32,32
52525,Widdleywahh,area-52,1564,warlock,destruction,137,74,63
52526,Whathurts,tichondrius,1564,warlock,destruction,86,42,44
52527,Uow,stormrage,1564,warlock,destruction,42,20,22
52528,Fenexia,hyjal,1563,warlock,destruction,83,52,31
52529,Felnightz,area-52,1562,warlock,destruction,48,23,25
52530,Alfaflux,tol-barad,1562,warlock,destruction,65,30,35
52531,Juswannarock,tichondrius,1561,warlock,destruction,45,26,19
52532,Canobio,tichondrius,1559,warlock,destruction,36,18,18
52533,Blklavender,darkspear,1558,warlock,destruction,37,20,17
52534,Vasago,jubeithos,1558,warlock,destruction,71,36,35
52535,Ìzanamí,area-52,1558,warlock,destruction,36,18,18
52536,Deathteller,tichondrius,1558,warlock,destruction,35,17,18
52537,Jarasseck,malganis,1557,warlock,destruction,109,54,55
52538,Mattypatty,the-forgotten-coast,1557,warlock,destruction,42,20,22
52539,Boodizz,frostmourne,1557,warlock,destruction,36,17,19
52540,Promethian,proudmoore,1556,warlock,destruction,59,26,33
52541,Lilbiackguy,stormrage,1555,warlock,destruction,72,45,27
52542,Jerclard,proudmoore,1555,warlock,destruction,48,23,25
52543,Josaith,moon-guard,1554,warlock,destruction,101,55,46
52544,Niked,sargeras,1553,warlock,destruction,114,67,47
52545,Brettmackson,area-52,1552,warlock,destruction,99,53,46
52546,Tunacangirth,mannoroth,1551,warlock,destruction,24,17,7
52547,Wiildgoose,area-52,1551,warlock,destruction,42,27,15
52548,Xêlsnåp,steamwheedle-cartel,1551,warlock,destruction,97,57,40
52549,Magiaoscurax,quelthalas,1551,warlock,destruction,123,68,55
52550,Løvesick,zuljin,1550,warlock,destruction,58,30,28
52551,Cioxius,stormrage,1550,warlock,destruction,57,28,29
52552,Kossnen,shandris,1550,warlock,destruction,76,35,41
52553,Ciprýan,azralon,1549,warlock,destruction,36,19,17
52554,Neph,malganis,1549,warlock,destruction,38,19,19
52555,Kyoarnez,quelthalas,1547,warlock,destruction,54,29,25
52556,Forsâken,tichondrius,1547,warlock,destruction,67,35,32
52557,Darksolace,dalaran,1547,warlock,destruction,42,21,21
52558,Medusaqn,tichondrius,1547,warlock,destruction,36,18,18
52559,Domson,area-52,1546,warlock,destruction,60,42,18
52560,Pestilocks,area-52,1546,warlock,destruction,61,40,21
52561,Beelzibub,firetree,1546,warlock,destruction,65,41,24
52562,Bayfayth,zuljin,1546,warlock,destruction,92,52,40
52563,Agonie,tichondrius,1546,warlock,destruction,279,144,135
52564,Buboñic,area-52,1545,warlock,destruction,77,36,41
52565,Sidious,jubeithos,1544,warlock,destruction,49,30,19
52566,Plexwl,sargeras,1544,warlock,destruction,75,37,38
52567,Gorontar,kelthuzad,1544,warlock,destruction,62,30,32
52568,Mixolydian,malganis,1543,warlock,destruction,30,19,11
52569,Strykerliath,bleeding-hollow,1541,warlock,destruction,55,29,26
52570,Remua,tichondrius,1540,warlock,destruction,29,18,11
52571,Warlockmf,sargeras,1540,warlock,destruction,121,66,55
52572,Impdad,destromath,1539,warlock,destruction,96,61,35
52573,Nybeth,malganis,1539,warlock,destruction,80,39,41
52574,Cryptos,kalecgos,1538,warlock,destruction,38,22,16
52575,Flxmin,area-52,1538,warlock,destruction,58,29,29
52576,Kazinox,area-52,1538,warlock,destruction,42,20,22
52577,Rerolledfotm,sargeras,1537,warlock,destruction,60,36,24
52578,Hadouh,stormrage,1537,warlock,destruction,29,17,12
52579,Manthos,sargeras,1537,warlock,destruction,63,24,39
52580,Celistia,wyrmrest-accord,1535,warlock,destruction,24,17,7
52581,Chadica,malganis,1534,warlock,destruction,18,16,2
52582,Threk,quelthalas,1534,warlock,destruction,30,16,14
52583,Littledúck,azralon,1533,warlock,destruction,18,16,2
52584,Scarletdemon,malganis,1532,warlock,destruction,65,35,30
52585,Excusey,tichondrius,1532,warlock,destruction,30,16,14
52586,Shatteroidz,darkspear,1531,warlock,destruction,24,16,8
52587,Fearem,tichondrius,1530,warlock,destruction,27,17,10
52588,Youkeyoh,illidan,1530,warlock,destruction,36,21,15
52589,Badmagic,area-52,1529,warlock,destruction,81,44,37
52590,Beetlejoos,stormreaver,1529,warlock,destruction,30,16,14
52591,Shadowmoonon,tichondrius,1529,warlock,destruction,30,16,14
52592,Nattydots,sargeras,1529,warlock,destruction,71,37,34
52593,Brucelock,proudmoore,1528,warlock,destruction,24,16,8
52594,Gharlock,tichondrius,1528,warlock,destruction,62,36,26
52595,Zalord,mannoroth,1528,warlock,destruction,124,54,70
52596,Daracon,thrall,1527,warlock,destruction,36,21,15
52597,Lustyclam,tichondrius,1527,warlock,destruction,95,55,40
52598,Liritasu,illidan,1527,warlock,destruction,30,16,14
52599,Asetiks,tichondrius,1526,warlock,destruction,30,16,14
52600,Babyhzz,tichondrius,1525,warlock,destruction,18,16,2
52601,Repláced,thrall,1525,warlock,destruction,101,58,43
52602,Tulu,muradin,1524,warlock,destruction,53,35,18
52603,Darthðotspam,mugthol,1524,warlock,destruction,102,60,42
52604,Kevin,moon-guard,1524,warlock,destruction,111,59,52
52605,Warluckie,zuljin,1523,warlock,destruction,24,18,6
52606,Hadit,malganis,1523,warlock,destruction,55,30,25
52607,Zetsu,zuljin,1523,warlock,destruction,263,135,128
52608,Obscurity,tichondrius,1523,warlock,destruction,72,36,36
52609,Conspiration,sargeras,1522,warlock,destruction,24,19,5
52610,Cesily,frostmourne,1522,warlock,destruction,30,16,14
52611,Tunacanthicc,moon-guard,1522,warlock,destruction,136,70,66
52612,Morcegø,azralon,1522,warlock,destruction,63,32,31
52613,Yungncapable,malganis,1521,warlock,destruction,27,22,5
52614,Killvilock,kelthuzad,1521,warlock,destruction,79,37,42
52615,Baldandugly,illidan,1520,warlock,destruction,30,18,12
52616,Kascade,drakkari,1520,warlock,destruction,50,27,23
52617,Warlockgomes,azralon,1520,warlock,destruction,228,116,112
52618,Numerical,frostmourne,1519,warlock,destruction,24,16,8
52619,Azracore,illidan,1519,warlock,destruction,51,31,20
52620,Hellbòund,mugthol,1519,warlock,destruction,42,24,18
52621,Blorgaflob,thaurissan,1518,warlock,destruction,19,16,3
52622,Thravis,tichondrius,1518,warlock,destruction,36,20,16
52623,Katsby,moon-guard,1518,warlock,destruction,35,19,16
52624,Aliciayd,andorhal,1517,warlock,destruction,30,19,11
52625,Glad,fenris,1517,warlock,destruction,55,31,24
52626,Kajayak,nazjatar,1517,warlock,destruction,59,33,26
52627,Grammapatty,tichondrius,1517,warlock,destruction,30,16,14
52628,Iockgodtkoz,tichondrius,1516,warlock,destruction,54,27,27
52629,Rotsndotss,thrall,1516,warlock,destruction,39,18,21
52630,Sylrath,illidan,1516,warlock,destruction,69,30,39
52631,Austeeny,wyrmrest-accord,1513,warlock,destruction,31,21,10
52632,Politex,malganis,1513,warlock,destruction,64,40,24
52633,Freggen,shadowsong,1513,warlock,destruction,48,29,19
52634,Squatchamp,sargeras,1512,warlock,destruction,54,31,23
52635,Kongal,tichondrius,1512,warlock,destruction,30,16,14
52636,Adelrinn,frostmourne,1512,warlock,destruction,181,96,85
52637,Psyløck,bleeding-hollow,1511,warlock,destruction,72,37,35
52638,Hootenanny,korialstrasz,1511,warlock,destruction,72,34,38
52639,Grimby,malganis,1511,warlock,destruction,42,18,24
52640,Hawklock,ragnaros,1510,warlock,destruction,24,17,7
52641,Stonnerz,ragnaros,1509,warlock,destruction,81,46,35
52642,Valvravé,malganis,1509,warlock,destruction,41,22,19
52643,Joseph,draktharon,1509,warlock,destruction,66,35,31
52644,Lockybalboah,turalyon,1509,warlock,destruction,120,63,57
52645,Fearsntears,stormrage,1509,warlock,destruction,42,16,26
52646,Chaosmorty,tichondrius,1508,warlock,destruction,51,32,19
52647,Guldåniel,tichondrius,1508,warlock,destruction,30,16,14
52648,Honne,sargeras,1507,warlock,destruction,32,19,13
52649,Shaneyxd,bleeding-hollow,1504,warlock,destruction,24,16,8
52650,Pyresworn,wyrmrest-accord,1504,warlock,destruction,48,31,17
52651,Thralord,blackrock,1503,warlock,destruction,36,23,13
52652,Dinglerdots,tichondrius,1502,warlock,destruction,27,21,6
52653,Jugaa,arthas,1502,warlock,destruction,41,29,12
52654,Bosongo,boulderfist,1501,warlock,destruction,65,37,28
52655,Deboltzaru,ragnaros,1501,warlock,destruction,91,45,46
52656,Mordranan,thrall,1500,warlock,destruction,48,29,19
52657,Marcedlc,ragnaros,1500,warlock,destruction,72,41,31
52658,Ironsightsl,dalaran,1499,warlock,destruction,42,21,21
52659,Soulicit,kelthuzad,1499,warlock,destruction,64,30,34
52660,Odiums,area-52,1498,warlock,destruction,77,44,33
52661,Korose,tichondrius,1498,warlock,destruction,183,90,93
52662,Dippidydot,illidan,1497,warlock,destruction,84,39,45
52663,Destruição,zuljin,1496,warlock,destruction,35,20,15
52664,Firewõrks,moon-guard,1496,warlock,destruction,30,17,13
52665,Mateekabr,malganis,1495,warlock,destruction,24,16,8
52666,Lessance,dalaran,1495,warlock,destruction,36,21,15
52667,Daremyth,azralon,1494,warlock,destruction,36,24,12
52668,Trobgol,bleeding-hollow,1494,warlock,destruction,30,19,11
52669,Mongdot,frostmourne,1494,warlock,destruction,51,30,21
52670,Memnøch,emerald-dream,1492,warlock,destruction,41,24,17
52671,Wizlox,illidan,1491,warlock,destruction,160,79,81
52672,Goomgoom,doomhammer,1489,warlock,destruction,114,50,64
52673,Titusvorenus,runetotem,1488,warlock,destruction,50,30,20
52674,Dunbu,illidan,1488,warlock,destruction,139,76,63
52675,Terrival,illidan,1487,warlock,destruction,41,22,19
52676,Lockssy,tichondrius,1486,warlock,destruction,141,82,59
52677,Dotte,tichondrius,1486,warlock,destruction,59,31,28
52678,Vigius,dalaran,1486,warlock,destruction,53,24,29
52679,Nytefels,skullcrusher,1485,warlock,destruction,30,20,10
52680,Daddybolt,stormrage,1485,warlock,destruction,30,17,13
52681,Hornetbee,tichondrius,1483,warlock,destruction,24,16,8
52682,Kalellock,azralon,1483,warlock,destruction,120,63,57
52683,Dynamó,tichondrius,1483,warlock,destruction,74,37,37
52684,Ellneggro,zuljin,1482,warlock,destruction,36,25,11
52685,Chaoticman,tichondrius,1482,warlock,destruction,63,38,25
52686,Fshi,frostmourne,1482,warlock,destruction,102,58,44
52687,Gingery,the-underbog,1482,warlock,destruction,125,61,64
52688,Cutewarlock,draktharon,1481,warlock,destruction,50,30,20
52689,Aomniloltv,zuljin,1481,warlock,destruction,106,59,47
52690,Barathron,tichondrius,1480,warlock,destruction,84,40,44
52691,Pescador,tichondrius,1479,warlock,destruction,37,22,15
52692,Voltshot,tichondrius,1479,warlock,destruction,96,52,44
52693,Beyourselff,tichondrius,1479,warlock,destruction,35,16,19
52694,Dloq,azgalor,1478,warlock,destruction,117,70,47
52695,Kecca,azralon,1477,warlock,destruction,190,101,89
52696,Chàõs,tichondrius,1477,warlock,destruction,54,27,27
52697,Avae,frostmourne,1476,warlock,destruction,108,61,47
52698,Boltybarnes,area-52,1475,warlock,destruction,42,31,11
52699,Nefandous,malganis,1475,warlock,destruction,179,95,84
52700,Ioroselmi,illidan,1475,warlock,destruction,131,64,67
52701,Tofulery,tichondrius,1475,warlock,destruction,50,23,27
52702,Hargol,azralon,1475,warlock,destruction,42,19,23
52703,Wdc,illidan,1474,warlock,destruction,54,27,27
52704,Bauchalain,area-52,1474,warlock,destruction,38,19,19
52705,Doublebolt,illidan,1473,warlock,destruction,123,72,51
52706,Warwand,tichondrius,1472,warlock,destruction,24,16,8
52707,Priiscilá,drakkari,1472,warlock,destruction,66,32,34
52708,Raizël,ragnaros,1471,warlock,destruction,56,34,22
52709,Privin,sargeras,1471,warlock,destruction,36,18,18
52710,Demondots,sargeras,1469,warlock,destruction,54,31,23
52711,Medeia,tichondrius,1469,warlock,destruction,29,16,13
52712,Celash,barthilas,1469,warlock,destruction,60,32,28
52713,Laylowl,tichondrius,1468,warlock,destruction,36,22,14
52714,Shadowxlock,misha,1468,warlock,destruction,95,51,44
52715,Slipfallx,tichondrius,1468,warlock,destruction,64,33,31
52716,Magy,deathwing,1467,warlock,destruction,48,30,18
52717,Dialalock,frostmourne,1467,warlock,destruction,54,29,25
52718,Addonic,hyjal,1466,warlock,destruction,48,26,22
52719,Dotsnrots,frostmourne,1466,warlock,destruction,42,20,22
52720,Esså,jaedenar,1466,warlock,destruction,47,20,27
52721,Pwz,azralon,1465,warlock,destruction,108,60,48
52722,Noxdolor,stormreaver,1465,warlock,destruction,36,20,16
52723,Prelick,illidan,1465,warlock,destruction,41,17,24
52724,Zver,drakkari,1464,warlock,destruction,24,16,8
52725,Lotusx,tichondrius,1464,warlock,destruction,48,30,18
52726,Swaelee,area-52,1464,warlock,destruction,54,27,27
52727,Zemphius,illidan,1463,warlock,destruction,55,27,28
52728,Vindicated,azgalor,1462,warlock,destruction,49,33,16
52729,Kkokko,tichondrius,1462,warlock,destruction,78,39,39
52730,Shipmatelock,stormrage,1461,warlock,destruction,54,36,18
52731,Jakeyboii,frostmourne,1459,warlock,destruction,51,33,18
52732,Falcorr,area-52,1459,warlock,destruction,34,19,15
52733,Garbagefarts,aegwynn,1459,warlock,destruction,94,48,46
52734,Captrollol,tichondrius,1459,warlock,destruction,100,47,53
52735,Jezwazerox,area-52,1458,warlock,destruction,93,50,43
52736,Sñeed,sargeras,1456,warlock,destruction,55,31,24
52737,Filthypumper,proudmoore,1455,warlock,destruction,43,28,15
52738,Tharki,darkspear,1453,warlock,destruction,245,122,123
52739,Loçk,zuljin,1453,warlock,destruction,117,57,60
52740,Cozu,tichondrius,1450,warlock,destruction,30,20,10
52741,Monkeylock,dathremar,1449,warlock,destruction,33,22,11
52742,Perfectylock,azralon,1447,warlock,destruction,34,17,17
52743,Gatewayoncd,frostmourne,1447,warlock,destruction,102,48,54
52744,Eriess,burning-blade,1447,warlock,destruction,54,24,30
52745,Ðeãdman,bleeding-hollow,1446,warlock,destruction,26,17,9
52746,Sickmade,zuljin,1445,warlock,destruction,24,16,8
52747,Demonicus,thunderlord,1445,warlock,destruction,51,24,27
52748,Maleficmango,tichondrius,1444,warlock,destruction,36,23,13
52749,Mcjoy,akama,1444,warlock,destruction,242,123,119
52750,Dotsfired,crushridge,1442,warlock,destruction,63,38,25
52751,Munar,quelthalas,1442,warlock,destruction,93,47,46
52752,Atrofourth,tichondrius,1442,warlock,destruction,54,26,28
52753,Xbqss,illidan,1442,warlock,destruction,36,16,20
52754,Newty,zuljin,1441,warlock,destruction,24,19,5
52755,Jaboltz,tichondrius,1441,warlock,destruction,25,16,9
52756,Mantis,proudmoore,1441,warlock,destruction,43,23,20
52757,Nttslock,tichondrius,1441,warlock,destruction,42,22,20
52758,Eldriptch,kelthuzad,1441,warlock,destruction,47,23,24
52759,Elcidoo,tichondrius,1440,warlock,destruction,24,15,9
52760,Badufin,azralon,1440,warlock,destruction,30,18,12
52761,Zezkin,alexstrasza,1440,warlock,destruction,39,21,18
52762,Newmanz,nerzhul,1439,warlock,destruction,18,15,3
52763,Printwo,sargeras,1439,warlock,destruction,24,15,9
52764,Maldivà,tichondrius,1439,warlock,destruction,24,15,9
52765,Dimanel,moon-guard,1439,warlock,destruction,24,15,9
52766,Janeciap,tichondrius,1439,warlock,destruction,24,15,9
52767,Discordant,trollbane,1439,warlock,destruction,48,29,19
52768,Twototheone,illidan,1439,warlock,destruction,131,67,64
52769,Manã,wyrmrest-accord,1439,warlock,destruction,36,18,18
52770,Danaowns,spirestone,1439,warlock,destruction,30,15,15
52771,Beastsuper,tichondrius,1439,warlock,destruction,30,15,15
52772,Sâlâñzø,bleeding-hollow,1438,warlock,destruction,18,15,3
52773,Selwitch,dalaran,1438,warlock,destruction,18,15,3
52774,Spectro,laughing-skull,1438,warlock,destruction,18,15,3
52775,Mykiel,sargeras,1438,warlock,destruction,42,21,21
52776,Goofycupcake,drakthul,1437,warlock,destruction,18,15,3
52777,Lostlock,sargeras,1437,warlock,destruction,18,15,3
52778,Deathmásk,ragnaros,1437,warlock,destruction,18,15,3
52779,Krokodiil,tichondrius,1437,warlock,destruction,56,35,21
52780,Wildimp,aerie-peak,1437,warlock,destruction,24,15,9
52781,Phreekish,bleeding-hollow,1437,warlock,destruction,24,15,9
52782,Amoranlenus,sargeras,1437,warlock,destruction,36,21,15
52783,Imbooms,blackrock,1437,warlock,destruction,30,15,15
52784,Rzlrot,tichondrius,1436,warlock,destruction,30,18,12
52785,Nebulox,stormrage,1436,warlock,destruction,42,24,18
52786,Jämeson,tichondrius,1436,warlock,destruction,30,15,15
52787,Artzul,tichondrius,1436,warlock,destruction,60,25,35
52788,Zerfall,area-52,1435,warlock,destruction,24,15,9
52789,Sonnagalook,sargeras,1435,warlock,destruction,48,27,21
52790,Mikaelbolton,tichondrius,1435,warlock,destruction,52,24,28
52791,Stizzy,eredar,1434,warlock,destruction,24,15,9
52792,Plagueîs,area-52,1434,warlock,destruction,33,18,15
52793,Év,azralon,1434,warlock,destruction,53,27,26
52794,Kuoma,boulderfist,1434,warlock,destruction,121,57,64
52795,Loçky,area-52,1433,warlock,destruction,24,15,9
52796,Felacid,tichondrius,1433,warlock,destruction,48,28,20
52797,Picklepuller,arthas,1433,warlock,destruction,60,34,26
52798,Mldxd,undermine,1432,warlock,destruction,34,17,17
52799,Dance,sargeras,1431,warlock,destruction,18,15,3
52800,Jokerzz,tichondrius,1431,warlock,destruction,24,16,8
52801,Domwarlock,uther,1431,warlock,destruction,30,15,15
52802,Masefield,moon-guard,1431,warlock,destruction,68,33,35
52803,Spaceghóst,bleeding-hollow,1430,warlock,destruction,291,142,149
52804,Kyle,shandris,1429,warlock,destruction,63,36,27
52805,Dotsyu,frostmourne,1429,warlock,destruction,50,28,22
52806,Javaspooky,nemesis,1429,warlock,destruction,39,18,21
52807,Conorloco,tichondrius,1429,warlock,destruction,36,15,21
52808,Soukinomicz,sargeras,1428,warlock,destruction,24,15,9
52809,Naome,cenarius,1428,warlock,destruction,36,16,20
52810,Yükina,stormrage,1427,warlock,destruction,176,86,90
52811,Ledrlpxlx,bleeding-hollow,1426,warlock,destruction,65,31,34
52812,Humanreapers,malganis,1425,warlock,destruction,43,26,17
52813,Shadowfork,illidan,1424,warlock,destruction,24,15,9
52814,Dercair,korgath,1424,warlock,destruction,48,25,23
52815,Straightlock,sargeras,1424,warlock,destruction,53,22,31
52816,Arthyr,twisting-nether,1424,warlock,destruction,41,17,24
52817,Kanekiskid,mannoroth,1423,warlock,destruction,42,29,13
52818,Saddestboi,proudmoore,1423,warlock,destruction,66,40,26
52819,Gvvo,tichondrius,1423,warlock,destruction,30,15,15
52820,Çrayoneater,tichondrius,1423,warlock,destruction,52,22,30
52821,Soiedentaire,illidan,1422,warlock,destruction,36,30,6
52822,Ptheven,area-52,1422,warlock,destruction,64,40,24
52823,Chéztér,proudmoore,1422,warlock,destruction,124,62,62
52824,Jhivtwo,tichondrius,1422,warlock,destruction,36,18,18
52825,Rickyspanish,malygos,1422,warlock,destruction,47,21,26
52826,Yarrz,kelthuzad,1421,warlock,destruction,36,25,11
52827,Wediditjoe,kelthuzad,1421,warlock,destruction,24,15,9
52828,Nergoul,stormrage,1421,warlock,destruction,30,16,14
52829,Yuh,moon-guard,1420,warlock,destruction,18,15,3
52830,Boltster,destromath,1420,warlock,destruction,69,43,26
52831,Toonbolt,sargeras,1420,warlock,destruction,48,28,20
52832,Fearloom,tichondrius,1420,warlock,destruction,151,78,73
52833,Valrena,rivendare,1419,warlock,destruction,24,15,9
52834,Decrepticus,kargath,1419,warlock,destruction,44,26,18
52835,Vandammed,silvermoon,1419,warlock,destruction,30,15,15
52836,Destruction,frostmourne,1418,warlock,destruction,45,25,20
52837,Memon,frostmane,1418,warlock,destruction,102,55,47
52838,Wawfw,bleeding-hollow,1417,warlock,destruction,27,18,9
52839,Fiftydkps,azralon,1417,warlock,destruction,87,51,36
52840,Desconjuro,nemesis,1416,warlock,destruction,50,29,21
52841,Mickylock,tichondrius,1416,warlock,destruction,222,120,102
52842,Apøçàlÿpsè,firetree,1416,warlock,destruction,75,37,38
52843,Deatthmoon,stormrage,1415,warlock,destruction,24,15,9
52844,Evillyñ,tichondrius,1415,warlock,destruction,66,35,31
52845,Locker,lightnings-blade,1414,warlock,destruction,30,18,12
52846,Exofilth,thrall,1414,warlock,destruction,58,25,33
52847,Budgetkroozz,illidan,1413,warlock,destruction,30,15,15
52848,Bilidin,azralon,1413,warlock,destruction,93,41,52
52849,Sharkweek,zuljin,1412,warlock,destruction,24,15,9
52850,Overlock,ragnaros,1412,warlock,destruction,74,43,31
52851,Yorchziel,ragnaros,1412,warlock,destruction,88,47,41
52852,Jhop,sargeras,1411,warlock,destruction,92,52,40
52853,Greedy,garrosh,1410,warlock,destruction,24,15,9
52854,Thicclöcc,tichondrius,1410,warlock,destruction,30,15,15
52855,Caplock,barthilas,1410,warlock,destruction,67,31,36
52856,Parmenides,tichondrius,1410,warlock,destruction,42,19,23
52857,Becà,stormrage,1408,warlock,destruction,30,19,11
52858,Lôrdslug,bleeding-hollow,1408,warlock,destruction,24,15,9
52859,Nazgal,tichondrius,1408,warlock,destruction,35,21,14
52860,Basicwitch,malganis,1406,warlock,destruction,23,15,8
52861,Yahihlock,silver-hand,1406,warlock,destruction,30,17,13
52862,Blackguldan,illidan,1405,warlock,destruction,24,15,9
52863,Meatybolts,nagrand,1405,warlock,destruction,84,46,38
52864,Exupery,emerald-dream,1405,warlock,destruction,101,53,48
52865,Lightname,arthas,1404,warlock,destruction,24,17,7
52866,Catdog,bleeding-hollow,1404,warlock,destruction,30,15,15
52867,Fatals,thrall,1404,warlock,destruction,30,15,15
52868,Daliron,moon-guard,1404,warlock,destruction,30,15,15
52869,Bellanomikus,stormrage,1404,warlock,destruction,60,25,35
52870,Nezsarek,sargeras,1403,warlock,destruction,187,84,103
52871,Adderall,altar-of-storms,1402,warlock,destruction,42,20,22
52872,Vacuole,uther,1401,warlock,destruction,24,15,9
52873,Killafornia,runetotem,1401,warlock,destruction,48,28,20
52874,Balfast,quelthalas,1401,warlock,destruction,93,42,51
52875,Chuwhee,sargeras,1401,warlock,destruction,54,18,36
52876,Cynwise,arathor,1400,warlock,destruction,30,20,10
52877,Antistar,barthilas,1400,warlock,destruction,43,27,16
52878,Perples,dalaran,1399,warlock,destruction,60,30,30
52879,Shadow,frostwolf,1399,warlock,destruction,44,17,27
52880,Azöd,tichondrius,1398,warlock,destruction,117,69,48
52881,Jaydow,illidan,1398,warlock,destruction,29,15,14
52882,Drudotzz,hyjal,1398,warlock,destruction,36,18,18
52883,Kurudios,ragnaros,1397,warlock,destruction,30,18,12
52884,Georky,ragnaros,1397,warlock,destruction,67,32,35
52885,Iongestpp,bleeding-hollow,1395,warlock,destruction,42,22,20
52886,Soultrain,sargeras,1394,warlock,destruction,26,16,10
52887,Crashcrash,area-52,1394,warlock,destruction,30,15,15
52888,Notchinese,kiljaeden,1394,warlock,destruction,64,31,33
52889,Glenfarclas,tichondrius,1394,warlock,destruction,79,34,45
52890,Shadococo,tichondrius,1393,warlock,destruction,36,16,20
52891,Pvping,illidan,1392,warlock,destruction,26,18,8
52892,Mariscoveloz,stormrage,1392,warlock,destruction,108,58,50
52893,Hellcon,area-52,1391,warlock,destruction,88,51,37
52894,Vexedconvex,area-52,1391,warlock,destruction,365,179,186
52895,Adhauto,illidan,1390,warlock,destruction,113,62,51
52896,Sauronne,illidan,1390,warlock,destruction,54,24,30
52897,Esteedees,moon-guard,1389,warlock,destruction,48,20,28
52898,Bustednut,nerzhul,1388,warlock,destruction,92,53,39
52899,Wadoom,tichondrius,1388,warlock,destruction,62,33,29
52900,Gnomerky,stormrage,1388,warlock,destruction,42,19,23
52901,Dvorakk,frostmourne,1387,warlock,destruction,27,17,10
52902,Nazzlock,bleeding-hollow,1387,warlock,destruction,29,16,13
52903,Blayzen,elune,1386,warlock,destruction,35,16,19
52904,Umdur,zuljin,1385,warlock,destruction,74,35,39
52905,Rangmar,ragnaros,1385,warlock,destruction,39,18,21
52906,Gorelami,tichondrius,1384,warlock,destruction,42,23,19
52907,Iceameri,tichondrius,1384,warlock,destruction,68,36,32
52908,Spreadnhiv,thrall,1383,warlock,destruction,66,31,35
52909,Poxnhub,tichondrius,1381,warlock,destruction,23,15,8
52910,Neodron,thrall,1380,warlock,destruction,69,45,24
52911,Necrotic,antonidas,1379,warlock,destruction,66,33,33
52912,Warlo,moonrunner,1378,warlock,destruction,30,20,10
52913,Coreleron,proudmoore,1378,warlock,destruction,61,29,32
52914,Siccwidit,area-52,1378,warlock,destruction,74,34,40
52915,Mèrlin,aerie-peak,1377,warlock,destruction,42,26,16
52916,Aksness,stormrage,1377,warlock,destruction,48,21,27
52917,Theporkchunk,nordrassil,1376,warlock,destruction,100,62,38
52918,Blankdots,sargeras,1375,warlock,destruction,42,27,15
52919,Sunkuna,aerie-peak,1375,warlock,destruction,176,89,87
52920,Lockonthc,korgath,1375,warlock,destruction,32,16,16
52921,Wasrenai,tichondrius,1375,warlock,destruction,47,21,26
52922,Dealcloud,tichondrius,1374,warlock,destruction,83,44,39
52923,Hobblefoòt,proudmoore,1374,warlock,destruction,46,23,23
52924,Nmelock,malganis,1374,warlock,destruction,30,15,15
52925,Demontos,darkspear,1374,warlock,destruction,66,31,35
52926,Zinkro,quelthalas,1374,warlock,destruction,77,32,45
52927,Batär,area-52,1372,warlock,destruction,36,26,10
52928,Connect,borean-tundra,1371,warlock,destruction,35,18,17
52929,Dessoft,ragnaros,1371,warlock,destruction,36,17,19
52930,Somethingud,tichondrius,1370,warlock,destruction,79,31,48
52931,Foxfoxfel,thrall,1369,warlock,destruction,24,16,8
52932,Lockerdoo,aegwynn,1369,warlock,destruction,78,39,39
52933,Ravikk,dalaran,1369,warlock,destruction,48,21,27
52934,Regent,nemesis,1368,warlock,destruction,60,31,29
52935,Ppoonlock,tichondrius,1367,warlock,destruction,35,15,20
52936,Ebølarot,tichondrius,1365,warlock,destruction,24,15,9
52937,Getpissed,emerald-dream,1365,warlock,destruction,65,32,33
52938,Critneyfearz,stormscale,1365,warlock,destruction,53,25,28
52939,Ilvvll,proudmoore,1365,warlock,destruction,65,30,35
52940,Blindingsun,kiljaeden,1365,warlock,destruction,72,27,45
52941,Gilgameshs,stormrage,1364,warlock,destruction,41,20,21
52942,Lynnilock,area-52,1363,warlock,destruction,24,15,9
52943,Luxenna,malganis,1363,warlock,destruction,84,40,44
52944,Wackykid,azralon,1360,warlock,destruction,86,39,47
52945,Buildsuccess,tichondrius,1359,warlock,destruction,41,16,25
52946,Lafuke,tichondrius,1358,warlock,destruction,25,15,10
52947,Fireballingx,illidan,1358,warlock,destruction,26,15,11
52948,Locksyy,tichondrius,1357,warlock,destruction,59,24,35
52949,Kelifan,sargeras,1356,warlock,destruction,96,52,44
52950,Matdamon,barthilas,1354,warlock,destruction,60,33,27
52951,Sylestrio,feathermoon,1354,warlock,destruction,54,27,27
52952,Stunresistin,tichondrius,1353,warlock,destruction,132,66,66
52953,Laklin,stormscale,1353,warlock,destruction,122,58,64
52954,Finnickk,blackrock,1353,warlock,destruction,36,16,20
52955,Methandmmkay,illidan,1352,warlock,destruction,27,18,9
52956,Skazza,bleeding-hollow,1352,warlock,destruction,29,16,13
52957,Patagucci,bleeding-hollow,1351,warlock,destruction,40,21,19
52958,Ørfna,zuljin,1351,warlock,destruction,66,33,33
52959,Davnport,frostmourne,1351,warlock,destruction,62,27,35
52960,Sugmabone,zuluhed,1349,warlock,destruction,42,26,16
52961,Zénth,kiljaeden,1349,warlock,destruction,52,28,24
52962,Karadelice,stormrage,1349,warlock,destruction,54,29,25
52963,Nøvah,tichondrius,1348,warlock,destruction,25,15,10
52964,Lagcursed,frostmourne,1347,warlock,destruction,30,20,10
52965,Pruevolf,tichondrius,1346,warlock,destruction,116,57,59
52966,Jannus,wyrmrest-accord,1346,warlock,destruction,62,30,32
52967,Razizzles,malganis,1345,warlock,destruction,72,42,30
52968,Stallrooks,moon-guard,1345,warlock,destruction,29,16,13
52969,Retwarr,tichondrius,1344,warlock,destruction,18,14,4
52970,Shortstacki,tichondrius,1344,warlock,destruction,24,17,7
52971,Soulruler,tichondrius,1344,warlock,destruction,24,14,10
52972,Felpsychosis,illidan,1344,warlock,destruction,134,71,63
52973,Súpersonic,tichondrius,1343,warlock,destruction,24,14,10
52974,Sktfäker,sargeras,1343,warlock,destruction,24,14,10
52975,Cælohin,tichondrius,1343,warlock,destruction,36,18,18
52976,Austen,tichondrius,1343,warlock,destruction,55,24,31
52977,Ganosh,aggramar,1341,warlock,destruction,134,73,61
52978,Miniime,azgalor,1341,warlock,destruction,50,23,27
52979,Mocreia,azralon,1340,warlock,destruction,164,84,80
52980,Bobbygoulant,tichondrius,1340,warlock,destruction,259,128,131
52981,Haxlock,azralon,1339,warlock,destruction,64,26,38
52982,Aemma,proudmoore,1338,warlock,destruction,18,14,4
52983,Extinção,azralon,1338,warlock,destruction,64,39,25
52984,Pantypeeler,barthilas,1338,warlock,destruction,60,35,25
52985,Sofan,dalaran,1338,warlock,destruction,24,14,10
52986,Asiloas,shattered-hand,1338,warlock,destruction,24,14,10
52987,Xlilgee,kelthuzad,1337,warlock,destruction,18,14,4
52988,Jackscar,windrunner,1337,warlock,destruction,23,16,7
52989,Punishment,jubeithos,1337,warlock,destruction,23,15,8
52990,Sketchytat,stormrage,1337,warlock,destruction,24,14,10
52991,Lladyyheartt,nesingwary,1337,warlock,destruction,66,34,32
52992,Gingerspise,nathrezim,1337,warlock,destruction,30,14,16
52993,Devastation,senjin,1336,warlock,destruction,21,15,6
52994,Scãryz,jubeithos,1336,warlock,destruction,62,35,27
52995,Pabloescobr,tichondrius,1335,warlock,destruction,24,14,10
52996,Nueleth,frostmourne,1335,warlock,destruction,75,35,40
52997,Theredwoman,emerald-dream,1335,warlock,destruction,30,14,16
52998,Condevil,quelthalas,1334,warlock,destruction,119,64,55
52999,Lòthloria,mannoroth,1334,warlock,destruction,149,74,75
53000,Majinbuû,malganis,1334,warlock,destruction,30,14,16
53001,Atrabiliario,quelthalas,1334,warlock,destruction,42,17,25
53002,Bcxz,illidan,1333,warlock,destruction,24,14,10
53003,Fazzlock,nagrand,1333,warlock,destruction,52,28,24
53004,Aroris,silver-hand,1333,warlock,destruction,30,15,15
53005,Staudt,mugthol,1332,warlock,destruction,24,16,8
53006,Mailerdaemön,proudmoore,1332,warlock,destruction,30,14,16
53007,Brenda,bleeding-hollow,1331,warlock,destruction,48,29,19
53008,Yibbel,area-52,1331,warlock,destruction,24,14,10
53009,Gukky,misha,1331,warlock,destruction,137,79,58
53010,Spongebobjrj,tichondrius,1331,warlock,destruction,36,20,16
53011,Ahp,stormrage,1331,warlock,destruction,27,15,12
53012,Avadakedavra,warsong,1330,warlock,destruction,30,18,12
53013,Lefteexd,tichondrius,1330,warlock,destruction,24,14,10
53014,Chamansy,darkspear,1330,warlock,destruction,54,28,26
53015,Grandpapapa,tichondrius,1330,warlock,destruction,60,25,35
53016,Zogs,stonemaul,1330,warlock,destruction,36,14,22
53017,Freestyle,blackwater-raiders,1328,warlock,destruction,54,34,20
53018,Gingerlocky,barthilas,1328,warlock,destruction,106,50,56
53019,Oony,quelthalas,1328,warlock,destruction,66,27,39
53020,Celeden,emerald-dream,1327,warlock,destruction,30,18,12
53021,Monson,warsong,1327,warlock,destruction,30,14,16
53022,Cursedoll,ragnaros,1327,warlock,destruction,36,15,21
53023,Salties,magtheridon,1326,warlock,destruction,24,14,10
53024,Dasati,frostmourne,1324,warlock,destruction,24,16,8
53025,Tergale,illidan,1323,warlock,destruction,96,41,55
53026,Drcameron,zuljin,1322,warlock,destruction,24,15,9
53027,Musgrin,gallywix,1322,warlock,destruction,24,14,10
53028,Lockednloade,tichondrius,1322,warlock,destruction,57,33,24
53029,Zephee,queldorei,1322,warlock,destruction,60,34,26
53030,Wizdom,turalyon,1322,warlock,destruction,33,17,16
53031,Jill,thunderhorn,1322,warlock,destruction,36,17,19
53032,Gòtti,frostmourne,1320,warlock,destruction,24,14,10
53033,Jugerdotz,sargeras,1320,warlock,destruction,30,14,16
53034,Spite,thrall,1319,warlock,destruction,18,14,4
53035,Sweetmeat,madoran,1319,warlock,destruction,37,14,23
53036,Strawberryz,boulderfist,1318,warlock,destruction,24,14,10
53037,Provilock,moon-guard,1318,warlock,destruction,31,17,14
53038,Munick,spirestone,1317,warlock,destruction,30,15,15
53039,Jeramie,darkspear,1317,warlock,destruction,38,17,21
53040,Zyhq,stormrage,1317,warlock,destruction,48,18,30
53041,Castngcouch,tichondrius,1316,warlock,destruction,69,35,34
53042,Sepültüra,quelthalas,1316,warlock,destruction,97,44,53
53043,Undies,demon-soul,1314,warlock,destruction,72,39,33
53044,Ganknãmstyle,illidan,1313,warlock,destruction,89,42,47
53045,Sickgurl,stormrage,1312,warlock,destruction,65,37,28
53046,Jecklez,tichondrius,1312,warlock,destruction,135,70,65
53047,Shedara,ragnaros,1311,warlock,destruction,23,14,9
53048,Kabroom,boulderfist,1311,warlock,destruction,24,14,10
53049,Buttkins,tichondrius,1311,warlock,destruction,36,18,18
53050,Covírus,azralon,1310,warlock,destruction,29,18,11
53051,Epicgaymer,zuljin,1310,warlock,destruction,32,15,17
53052,Unstablê,ragnaros,1309,warlock,destruction,37,19,18
53053,Striga,staghelm,1309,warlock,destruction,65,28,37
53054,Dotyoazz,tichondrius,1308,warlock,destruction,38,22,16
53055,Sayatar,ragnaros,1308,warlock,destruction,30,14,16
53056,Covenslave,nemesis,1307,warlock,destruction,323,160,163
53057,Muchoprecogo,tichondrius,1306,warlock,destruction,24,14,10
53058,Sû,stormrage,1306,warlock,destruction,72,31,41
53059,Downbad,ysera,1305,warlock,destruction,37,16,21
53060,Thizzmaa,area-52,1304,warlock,destruction,119,61,58
53061,Gscar,area-52,1303,warlock,destruction,48,28,20
53062,Drdotngo,tichondrius,1301,warlock,destruction,32,15,17
53063,Voidchaos,korgath,1300,warlock,destruction,18,14,4
53064,Tsmcfker,tichondrius,1298,warlock,destruction,24,14,10
53065,Shivalx,tichondrius,1292,warlock,destruction,30,15,15
53066,Rauwërrs,azralon,1292,warlock,destruction,55,26,29
53067,Kombat,amanthul,1292,warlock,destruction,71,32,39
53068,Bigdoinks,nagrand,1290,warlock,destruction,34,19,15
53069,Boltsfordays,dalaran,1289,warlock,destruction,104,55,49
53070,Cvntpvntcans,kelthuzad,1289,warlock,destruction,36,16,20
53071,Dogetrash,tichondrius,1287,warlock,destruction,39,25,14
53072,Lolimalock,bleeding-hollow,1286,warlock,destruction,35,19,16
53073,Sevokk,stormrage,1285,warlock,destruction,36,17,19
53074,Darkboltz,area-52,1283,warlock,destruction,45,26,19
53075,Malchiev,area-52,1282,warlock,destruction,36,17,19
53076,Awfeelya,sargeras,1281,warlock,destruction,29,17,12
53077,Zuldar,tichondrius,1281,warlock,destruction,36,21,15
53078,Zoluraan,proudmoore,1280,warlock,destruction,51,33,18
53079,Hurriicane,stormrage,1280,warlock,destruction,92,48,44
53080,Imprecátion,tichondrius,1279,warlock,destruction,65,24,41
53081,Rustý,illidan,1278,warlock,destruction,71,41,30
53082,Ozgwad,thunderhorn,1277,warlock,destruction,42,19,23
53083,Ahrimus,area-52,1275,warlock,destruction,28,14,14
53084,Lilibe,tichondrius,1275,warlock,destruction,66,29,37
53085,Potatostew,dalaran,1273,warlock,destruction,36,14,22
53086,Deseo,moon-guard,1272,warlock,destruction,48,30,18
53087,Telvanni,sargeras,1270,warlock,destruction,43,24,19
53088,Derfflinger,tichondrius,1270,warlock,destruction,118,49,69
53089,Felryssa,kiljaeden,1269,warlock,destruction,60,29,31
53090,Juwi,frostmourne,1269,warlock,destruction,36,17,19
53091,Tartamuda,ragnaros,1269,warlock,destruction,42,16,26
53092,Tiqs,stormrage,1268,warlock,destruction,23,14,9
53093,Prinzheinric,quelthalas,1267,warlock,destruction,33,21,12
53094,Gyxx,exodar,1267,warlock,destruction,27,14,13
53095,Diabhlaí,tichondrius,1266,warlock,destruction,108,57,51
53096,Griget,runetotem,1265,warlock,destruction,59,28,31
53097,Klapincheeks,malganis,1262,warlock,destruction,87,31,56
53098,Zehr,malganis,1261,warlock,destruction,58,32,26
53099,Alktrz,azralon,1260,warlock,destruction,25,14,11
53100,Stinkychef,hyjal,1259,warlock,destruction,30,19,11
53101,Melodyh,laughing-skull,1259,warlock,destruction,36,14,22
53102,Gattsonn,kiljaeden,1259,warlock,destruction,42,15,27
53103,Pikkon,malorne,1258,warlock,destruction,30,15,15
53104,Dotdoctor,thrall,1257,warlock,destruction,69,34,35
53105,Mordekhay,tichondrius,1255,warlock,destruction,62,30,32
53106,Felancholy,illidan,1254,warlock,destruction,32,22,10
53107,Ticktóck,ghostlands,1253,warlock,destruction,19,14,5
53108,Ogawalation,stormrage,1253,warlock,destruction,24,14,10
53109,Siliconsnipe,tichondrius,1252,warlock,destruction,24,17,7
53110,Kortinanga,tichondrius,1252,warlock,destruction,54,30,24
53111,Eurygnomous,thrall,1252,warlock,destruction,30,14,16
53112,Krýstál,ragnaros,1251,warlock,destruction,61,32,29
53113,Drwolfman,bonechewer,1251,warlock,destruction,66,32,34
53114,Xtwistedteas,tichondrius,1249,warlock,destruction,31,14,17
53115,Dottzie,malganis,1247,warlock,destruction,18,13,5
53116,Pressurë,tichondrius,1247,warlock,destruction,18,13,5
53117,Drainerx,kelthuzad,1247,warlock,destruction,18,13,5
53118,Voqo,shandris,1247,warlock,destruction,18,13,5
53119,Cyrus,akama,1247,warlock,destruction,24,16,8
53120,Moonsoaps,moon-guard,1247,warlock,destruction,24,13,11
53121,Rèdrùm,tichondrius,1247,warlock,destruction,24,13,11
53122,Oymmander,illidan,1247,warlock,destruction,24,13,11
53123,Thragèqt,sargeras,1247,warlock,destruction,24,13,11
53124,Kimsoul,zuljin,1247,warlock,destruction,24,13,11
53125,Jandorace,anetheron,1247,warlock,destruction,24,13,11
53126,Grenswood,arathor,1247,warlock,destruction,27,14,13
53127,Djdemolordx,bleeding-hollow,1246,warlock,destruction,18,13,5
53128,Synmari,tichondrius,1246,warlock,destruction,18,13,5
53129,Felqueenn,windrunner,1246,warlock,destruction,48,26,22
53130,Skanckqt,malganis,1246,warlock,destruction,24,13,11
53131,Mitryc,illidan,1246,warlock,destruction,24,13,11
53132,Inaane,thrall,1246,warlock,destruction,24,13,11
53133,Stainn,gallywix,1245,warlock,destruction,27,17,10
53134,Toastwl,tichondrius,1244,warlock,destruction,18,13,5
53135,Riptyler,illidan,1244,warlock,destruction,24,13,11
53136,Dreadxbolts,stormrage,1244,warlock,destruction,24,13,11
53137,Kemchaos,illidan,1244,warlock,destruction,94,46,48
53138,Catodo,ragnaros,1244,warlock,destruction,36,13,23
53139,Luciffer,windrunner,1242,warlock,destruction,22,16,6
53140,Nigsy,nagrand,1242,warlock,destruction,24,13,11
53141,Spòngwò,tichondrius,1242,warlock,destruction,24,13,11
53142,Kvxkxvxvk,bleeding-hollow,1242,warlock,destruction,31,13,18
53143,Tirzah,frostmourne,1241,warlock,destruction,18,13,5
53144,Sutra,tichondrius,1241,warlock,destruction,29,19,10
53145,Mothmayhem,moon-guard,1241,warlock,destruction,24,13,11
53146,Soulwipe,dethecus,1241,warlock,destruction,24,13,11
53147,Badmir,area-52,1241,warlock,destruction,24,13,11
53148,Shadü,tichondrius,1241,warlock,destruction,36,14,22
53149,Rodimus,hyjal,1240,warlock,destruction,221,120,101
53150,Jnzi,area-52,1239,warlock,destruction,18,13,5
53151,Darthzugzug,gorefiend,1239,warlock,destruction,48,28,20
53152,Bowltz,chogall,1239,warlock,destruction,24,13,11
53153,Insanemids,tichondrius,1239,warlock,destruction,26,14,12
53154,Teahourse,tichondrius,1239,warlock,destruction,31,14,17
53155,Abracadavers,ragnaros,1237,warlock,destruction,33,16,17
53156,Léarníng,nemesis,1236,warlock,destruction,18,13,5
53157,Hazbussy,kelthuzad,1236,warlock,destruction,24,13,11
53158,Fearndot,draenor,1236,warlock,destruction,63,29,34
53159,Azrezzael,area-52,1233,warlock,destruction,24,13,11
53160,Blastyboat,terenas,1233,warlock,destruction,39,15,24
53161,Dalruk,wyrmrest-accord,1232,warlock,destruction,18,13,5
53162,Klatuu,stonemaul,1232,warlock,destruction,24,15,9
53163,Ehcsrop,doomhammer,1232,warlock,destruction,92,44,48
53164,Keraj,quelthalas,1232,warlock,destruction,30,14,16
53165,Sylvine,korgath,1232,warlock,destruction,30,13,17
53166,Kärên,proudmoore,1231,warlock,destruction,31,23,8
53167,Millyvanilly,tichondrius,1231,warlock,destruction,24,13,11
53168,Iiferna,sargeras,1231,warlock,destruction,179,86,93
53169,Jelluz,ghostlands,1230,warlock,destruction,33,16,17
53170,Mcscrotie,tichondrius,1229,warlock,destruction,28,14,14
53171,Heathncraig,illidan,1229,warlock,destruction,179,83,96
53172,Dmox,darkspear,1229,warlock,destruction,30,13,17
53173,Radamantîs,ragnaros,1229,warlock,destruction,36,13,23
53174,Thotsanddots,area-52,1228,warlock,destruction,18,13,5
53175,Bénn,moon-guard,1228,warlock,destruction,77,49,28
53176,Graced,dalaran,1228,warlock,destruction,24,13,11
53177,Jjesie,tichondrius,1228,warlock,destruction,30,13,17
53178,Sumondeznuts,wyrmrest-accord,1228,warlock,destruction,33,14,19
53179,Impieties,emerald-dream,1228,warlock,destruction,36,14,22
53180,Faldoras,kalecgos,1227,warlock,destruction,18,13,5
53181,Shaggster,stormrage,1226,warlock,destruction,72,39,33
53182,Xdyourd,tichondrius,1225,warlock,destruction,18,13,5
53183,Kyrionn,azralon,1225,warlock,destruction,24,13,11
53184,Dirtybóy,tichondrius,1224,warlock,destruction,24,13,11
53185,Candykrush,tichondrius,1224,warlock,destruction,26,13,13
53186,Raebolts,area-52,1222,warlock,destruction,24,13,11
53187,Pancakestack,stormrage,1222,warlock,destruction,119,62,57
53188,Pocserlock,drakkari,1221,warlock,destruction,21,13,8
53189,Vikkter,tichondrius,1221,warlock,destruction,30,14,16
53190,Florryn,barthilas,1220,warlock,destruction,30,14,16
53191,Enaria,queldorei,1218,warlock,destruction,24,13,11
53192,Ktlock,frostmourne,1217,warlock,destruction,42,20,22
53193,Gambel,duskwood,1217,warlock,destruction,36,16,20
53194,Cursedtool,quelthalas,1216,warlock,destruction,21,14,7
53195,Schmok,terenas,1216,warlock,destruction,64,33,31
53196,Hawkstalker,thaurissan,1215,warlock,destruction,82,42,40
53197,Totti,tol-barad,1214,warlock,destruction,30,17,13
53198,Erevas,area-52,1213,warlock,destruction,24,14,10
53199,Tatemor,barthilas,1213,warlock,destruction,36,13,23
53200,Prototyp,azralon,1212,warlock,destruction,18,13,5
53201,Felinå,hyjal,1206,warlock,destruction,39,24,15
53202,Superbroly,area-52,1204,warlock,destruction,30,16,14
53203,Daeykras,crushridge,1203,warlock,destruction,45,25,20
53204,Luulloo,proudmoore,1203,warlock,destruction,60,32,28
53205,Semyaza,zuluhed,1202,warlock,destruction,24,14,10
53206,Gouldon,sargeras,1202,warlock,destruction,40,20,20
53207,Dotess,illidan,1202,warlock,destruction,35,16,19
53208,Verybaked,sargeras,1201,warlock,destruction,33,21,12
53209,Blew,bleeding-hollow,1200,warlock,destruction,15,14,1
53210,Mysophobia,frostmourne,1200,warlock,destruction,131,67,64
53211,Alyarn,greymane,1198,warlock,destruction,24,13,11
53212,Burnedout,proudmoore,1196,warlock,destruction,26,17,9
53213,Sitra,ragnaros,1196,warlock,destruction,24,15,9
53214,Dokue,kaelthas,1195,warlock,destruction,15,14,1
53215,Rentblod,azralon,1195,warlock,destruction,23,13,10
53216,Zydaria,stormrage,1195,warlock,destruction,36,20,16
53217,Zaeloc,ragnaros,1195,warlock,destruction,42,13,29
53218,Goldieloc,sargeras,1192,warlock,destruction,42,26,16
53219,Spookyfurry,area-52,1192,warlock,destruction,30,13,17
53220,Aboode,blackrock,1190,warlock,destruction,59,26,33
53221,Cørruption,emerald-dream,1188,warlock,destruction,47,22,25
53222,Arredivh,blackhand,1183,warlock,destruction,17,13,4
53223,Chodetamer,lethon,1180,warlock,destruction,29,18,11
53224,Necrodeath,malygos,1180,warlock,destruction,30,15,15
53225,Maldíta,quelthalas,1180,warlock,destruction,117,52,65
53226,Kidsoul,illidan,1178,warlock,destruction,97,46,51
53227,Nanodingo,tichondrius,1176,warlock,destruction,59,30,29
53228,Notäçultist,nagrand,1173,warlock,destruction,110,57,53
53229,Tarnish,medivh,1173,warlock,destruction,90,38,52
53230,Prinsessdie,proudmoore,1173,warlock,destruction,36,15,21
53231,Phreaky,area-52,1169,warlock,destruction,75,40,35
53232,Cascades,icecrown,1169,warlock,destruction,132,61,71
53233,Ilovedemons,aegwynn,1168,warlock,destruction,42,26,16
53234,Vamperro,thrall,1168,warlock,destruction,22,13,9
53235,Westy,drenden,1167,warlock,destruction,24,16,8
53236,Bawldimort,stormrage,1165,warlock,destruction,89,46,43
53237,Juniorsalanu,quelthalas,1164,warlock,destruction,48,27,21
53238,Fearlok,malorne,1164,warlock,destruction,28,13,15
53239,Aerozyn,wyrmrest-accord,1161,warlock,destruction,30,16,14
53240,Scaryðreams,malganis,1155,warlock,destruction,62,22,40
53241,Dudda,sargeras,1152,warlock,destruction,12,12,0
53242,Osmatz,area-52,1152,warlock,destruction,18,12,6
53243,Falsaqt,area-52,1152,warlock,destruction,18,12,6
53244,Livinpink,zuljin,1152,warlock,destruction,18,12,6
53245,Ztc,dalaran,1152,warlock,destruction,18,12,6
53246,Sphoo,tichondrius,1152,warlock,destruction,18,12,6
53247,Blodrain,tichondrius,1152,warlock,destruction,18,12,6
53248,Kazam,quelthalas,1152,warlock,destruction,30,17,13
53249,Koei,tichondrius,1152,warlock,destruction,24,12,12
53250,Shutupthug,illidan,1151,warlock,destruction,18,12,6
53251,Soulfinder,tichondrius,1151,warlock,destruction,18,12,6
53252,Liuh,tichondrius,1151,warlock,destruction,18,12,6
53253,Angrydestro,tichondrius,1151,warlock,destruction,18,12,6
53254,Wargllock,tichondrius,1151,warlock,destruction,18,12,6
53255,Crucyblettv,korgath,1151,warlock,destruction,18,12,6
53256,Blastamastah,tichondrius,1151,warlock,destruction,18,12,6
53257,Oceangrownx,emerald-dream,1151,warlock,destruction,24,12,12
53258,Asmit,firetree,1151,warlock,destruction,28,13,15
53259,Zaiocian,tichondrius,1151,warlock,destruction,26,12,14
53260,Pndasrntlegt,burning-blade,1150,warlock,destruction,12,12,0
53261,Ggooudan,tichondrius,1150,warlock,destruction,18,12,6
53262,Dëception,ragnaros,1150,warlock,destruction,18,12,6
53263,Ñigorshedøn,area-52,1150,warlock,destruction,18,12,6
53264,Pratticus,stormrage,1150,warlock,destruction,18,12,6
53265,Soulripped,area-52,1150,warlock,destruction,24,12,12
53266,Khalynd,azralon,1150,warlock,destruction,47,22,25
53267,Kracky,tichondrius,1149,warlock,destruction,216,114,102
53268,Iggyiggy,sargeras,1149,warlock,destruction,24,12,12
53269,Hávìk,malganis,1149,warlock,destruction,24,12,12
53270,Árkadiano,drakkari,1149,warlock,destruction,24,12,12
53271,Ole,area-52,1149,warlock,destruction,27,13,14
53272,Beldiinlock,khazgoroth,1149,warlock,destruction,75,36,39
53273,Pardoned,stormrage,1149,warlock,destruction,30,12,18
53274,Poock,goldrinn,1148,warlock,destruction,18,12,6
53275,Omarlil,kelthuzad,1147,warlock,destruction,18,12,6
53276,Joromojo,zuljin,1146,warlock,destruction,18,12,6
53277,Nadirius,shadowmoon,1146,warlock,destruction,18,12,6
53278,Superbvious,lothar,1145,warlock,destruction,83,40,43
53279,Mordror,azralon,1145,warlock,destruction,53,25,28
53280,Deebeel,sargeras,1145,warlock,destruction,30,12,18
53281,Alyndraxia,malganis,1144,warlock,destruction,18,13,5
53282,Soulsurvivor,tichondrius,1144,warlock,destruction,30,12,18
53283,Thânàtös,malganis,1144,warlock,destruction,30,12,18
53284,Carcine,frostwolf,1143,warlock,destruction,24,12,12
53285,Adramelech,thrall,1143,warlock,destruction,24,12,12
53286,Mispickle,kelthuzad,1143,warlock,destruction,24,12,12
53287,Handler,earthen-ring,1142,warlock,destruction,42,28,14
53288,Yëët,wildhammer,1142,warlock,destruction,18,12,6
53289,Escro,azgalor,1142,warlock,destruction,80,47,33
53290,Gridwild,drakkari,1142,warlock,destruction,24,12,12
53291,Nadek,tichondrius,1140,warlock,destruction,24,12,12
53292,Bmó,stormrage,1139,warlock,destruction,18,12,6
53293,Nhen,daggerspine,1138,warlock,destruction,143,76,67
53294,Cogitoergo,stormrage,1136,warlock,destruction,18,12,6
53295,Klaríon,ragnaros,1136,warlock,destruction,21,13,8
53296,Taylôr,proudmoore,1136,warlock,destruction,30,12,18
53297,Saraphina,maiev,1135,warlock,destruction,375,181,194
53298,Sankestones,burning-legion,1134,warlock,destruction,30,12,18
53299,Skullsoul,arthas,1132,warlock,destruction,24,12,12
53300,Dlchem,tichondrius,1126,warlock,destruction,18,12,6
53301,Huskir,tichondrius,1125,warlock,destruction,30,12,18
53302,Rageraff,trollbane,1121,warlock,destruction,30,18,12
53303,Sylorelol,stormreaver,1121,warlock,destruction,42,15,27
53304,Viejitaa,quelthalas,1118,warlock,destruction,22,13,9
53305,Zêphyr,gilneas,1117,warlock,destruction,18,12,6
53306,Trïnîty,tichondrius,1117,warlock,destruction,71,31,40
53307,Dettocs,emerald-dream,1116,warlock,destruction,26,13,13
53308,Hookslinger,barthilas,1116,warlock,destruction,24,12,12
53309,Josemb,ragnaros,1114,warlock,destruction,26,14,12
53310,Marvolö,darkspear,1112,warlock,destruction,24,15,9
53311,Mshyde,gurubashi,1107,warlock,destruction,30,17,13
53312,Esomy,sargeras,1107,warlock,destruction,33,17,16
53313,Gentleq,tichondrius,1104,warlock,destruction,21,12,9
53314,Anstik,area-52,1103,warlock,destruction,15,13,2
53315,Infortunium,sargeras,1103,warlock,destruction,18,12,6
53316,Hulion,kiljaeden,1100,warlock,destruction,54,21,33
53317,Gwar,khazgoroth,1099,warlock,destruction,177,81,96
53318,Myshadow,gorefiend,1097,warlock,destruction,42,19,23
53319,Tempestzone,barthilas,1096,warlock,destruction,29,16,13
53320,Darthlockz,illidan,1095,warlock,destruction,24,13,11
53321,Madgettike,stormrage,1094,warlock,destruction,36,22,14
53322,Ðòt,nagrand,1094,warlock,destruction,28,13,15
53323,Cãsh,aegwynn,1094,warlock,destruction,41,14,27
53324,Varuuss,ragnaros,1092,warlock,destruction,21,12,9
53325,Mindfulchimp,sargeras,1092,warlock,destruction,23,12,11
53326,Timmerstar,tichondrius,1091,warlock,destruction,54,25,29
53327,Blockk,moknathal,1091,warlock,destruction,127,55,72
53328,Lerooux,hyjal,1090,warlock,destruction,66,28,38
53329,Snéed,sargeras,1088,warlock,destruction,29,15,14
53330,Taìnted,lightbringer,1088,warlock,destruction,28,12,16
53331,Ctierwarlock,tichondrius,1087,warlock,destruction,16,12,4
53332,Ilfucyobit,kelthuzad,1087,warlock,destruction,77,24,53
53333,Necrotiá,tichondrius,1085,warlock,destruction,17,12,5
53334,Dualipy,ragnaros,1084,warlock,destruction,20,12,8
53335,Rentacletape,kelthuzad,1084,warlock,destruction,22,12,10
53336,Spicý,sargeras,1084,warlock,destruction,63,31,32
53337,Liltoastii,illidan,1084,warlock,destruction,27,13,14
53338,Nathalyâ,drakkari,1077,warlock,destruction,72,36,36
53339,Glifosáto,quelthalas,1075,warlock,destruction,22,14,8
53340,Valval,moon-guard,1074,warlock,destruction,72,22,50
53341,Wolfib,tichondrius,1072,warlock,destruction,19,12,7
53342,Caramelgodx,stormrage,1072,warlock,destruction,34,12,22
53343,Merji,area-52,1071,warlock,destruction,23,12,11
53344,Lockedyaup,skullcrusher,1068,warlock,destruction,30,13,17
53345,Toby,azralon,1066,warlock,destruction,25,12,13
53346,Luke,lightnings-blade,1062,warlock,destruction,18,12,6
53347,Mogran,twisting-nether,1059,warlock,destruction,30,15,15
53348,Caesaros,quelthalas,1057,warlock,destruction,25,12,13
53349,Bumbleebolts,azralon,1056,warlock,destruction,12,11,1
53350,Redsolojdc,tichondrius,1056,warlock,destruction,12,11,1
53351,Rubybestlol,tichondrius,1056,warlock,destruction,12,11,1
53352,Lockâsf,tichondrius,1056,warlock,destruction,18,11,7
53353,Søulswap,tichondrius,1056,warlock,destruction,18,11,7
53354,Xidothewitch,stormrage,1056,warlock,destruction,18,11,7
53355,Thinkchair,sargeras,1056,warlock,destruction,18,11,7
53356,Hdys,tichondrius,1056,warlock,destruction,18,11,7
53357,Drsmegmaz,dreadmaul,1056,warlock,destruction,24,11,13
53358,Bbangtimo,tichondrius,1056,warlock,destruction,24,11,13
53359,Edeklock,frostmourne,1055,warlock,destruction,12,11,1
53360,Feardotzrun,illidan,1055,warlock,destruction,18,11,7
53361,Fatass,cairne,1055,warlock,destruction,18,11,7
53362,Tuzadin,tichondrius,1055,warlock,destruction,18,11,7
53363,Pedestal,bleeding-hollow,1055,warlock,destruction,18,11,7
53364,Hellfires,ragnaros,1055,warlock,destruction,18,11,7
53365,Sahdude,illidan,1055,warlock,destruction,18,11,7
53366,Shadowflux,winterhoof,1055,warlock,destruction,18,11,7
53367,Itstista,proudmoore,1055,warlock,destruction,24,11,13
53368,Virûs,vashj,1054,warlock,destruction,12,11,1
53369,Vasqu,stormrage,1054,warlock,destruction,18,11,7
53370,Friggus,azralon,1054,warlock,destruction,18,11,7
53371,Yze,sargeras,1054,warlock,destruction,18,11,7
53372,Dunkindots,dalaran,1054,warlock,destruction,18,11,7
53373,Aureboros,sargeras,1054,warlock,destruction,18,11,7
53374,Locksolo,tichondrius,1054,warlock,destruction,18,11,7
53375,Spudzies,bleeding-hollow,1054,warlock,destruction,24,11,13
53376,Liability,zuljin,1054,warlock,destruction,24,11,13
53377,Brough,illidan,1054,warlock,destruction,36,11,25
53378,Buffwarlockz,stormrage,1053,warlock,destruction,18,11,7
53379,Faënn,zuljin,1053,warlock,destruction,18,11,7
53380,Dipz,zuljin,1053,warlock,destruction,18,11,7
53381,Dëvïl,ragnaros,1053,warlock,destruction,24,11,13
53382,Thotorina,tichondrius,1053,warlock,destruction,29,12,17
53383,Nibala,aegwynn,1053,warlock,destruction,30,11,19
53384,Ranil,mannoroth,1052,warlock,destruction,18,11,7
53385,Vocarion,stormrage,1052,warlock,destruction,18,11,7
53386,Aashes,doomhammer,1052,warlock,destruction,24,11,13
53387,Blanklee,tichondrius,1051,warlock,destruction,12,11,1
53388,Nessro,stormrage,1051,warlock,destruction,18,15,3
53389,Domenic,sentinels,1051,warlock,destruction,16,12,4
53390,Flemball,aegwynn,1051,warlock,destruction,21,12,9
53391,Windwolff,dalvengyr,1051,warlock,destruction,24,11,13
53392,Glortheeb,spirestone,1051,warlock,destruction,24,11,13
53393,Kurmenos,uldum,1050,warlock,destruction,50,31,19
53394,Microd,tichondrius,1050,warlock,destruction,18,11,7
53395,Toxec,barthilas,1050,warlock,destruction,18,11,7
53396,Sathorastus,spirestone,1050,warlock,destruction,24,11,13
53397,Unprønuncea,azralon,1050,warlock,destruction,25,11,14
53398,Dotsandchill,dalaran,1049,warlock,destruction,24,11,13
53399,Nobuyori,tichondrius,1049,warlock,destruction,36,13,23
53400,Lindrasta,proudmoore,1048,warlock,destruction,12,11,1
53401,Aswrislock,tichondrius,1048,warlock,destruction,12,11,1
53402,Shadowy,dragonblight,1048,warlock,destruction,18,11,7
53403,Tirp,illidan,1048,warlock,destruction,24,11,13
53404,Irunaways,stormrage,1047,warlock,destruction,18,11,7
53405,Pokemebutt,hydraxis,1046,warlock,destruction,18,11,7
53406,Dex,jubeithos,1046,warlock,destruction,159,60,99
53407,Altazor,thunderlord,1046,warlock,destruction,30,11,19
53408,Ltr,moon-guard,1045,warlock,destruction,18,11,7
53409,Haloren,moon-guard,1044,warlock,destruction,18,11,7
53410,Veditä,goldrinn,1043,warlock,destruction,18,11,7
53411,Xenagos,antonidas,1043,warlock,destruction,30,11,19
53412,Xmochahollic,tichondrius,1040,warlock,destruction,152,65,87
53413,Seeword,sargeras,1039,warlock,destruction,18,11,7
53414,Baiss,tichondrius,1030,warlock,destruction,18,11,7
53415,Danoinfelizz,nemesis,1029,warlock,destruction,15,12,3
53416,Fidobiu,stormrage,1028,warlock,destruction,42,20,22
53417,Neurotoxiina,azralon,1027,warlock,destruction,84,28,56
53418,Noriaeradra,illidan,1025,warlock,destruction,24,13,11
53419,Valintine,khadgar,1024,warlock,destruction,21,12,9
53420,Getsmoked,moknathal,1023,warlock,destruction,23,11,12
53421,Consumed,area-52,1022,warlock,destruction,21,12,9
53422,Plaugewolf,azgalor,1021,warlock,destruction,24,13,11
53423,Sìddy,frostmourne,1019,warlock,destruction,18,12,6
53424,Locksoul,area-52,1019,warlock,destruction,54,25,29
53425,Sylersa,malganis,1018,warlock,destruction,30,11,19
53426,Cheiff,tichondrius,1017,warlock,destruction,63,24,39
53427,Rnicu,bonechewer,1016,warlock,destruction,99,49,50
53428,Bobthedoc,sargeras,1011,warlock,destruction,23,11,12
53429,Solrad,illidan,1010,warlock,destruction,78,38,40
53430,Kklock,frostmourne,1007,warlock,destruction,45,26,19
53431,Thugpenus,frostmane,1006,warlock,destruction,24,11,13
53432,Faliceu,sargeras,1006,warlock,destruction,26,11,15
53433,Plagué,barthilas,1004,warlock,destruction,21,11,10
53434,Docwildest,area-52,1003,warlock,destruction,17,11,6
53435,Zhujiu,illidan,1002,warlock,destruction,23,12,11
53436,Panyc,tichondrius,1002,warlock,destruction,23,11,12
53437,Valerilma,azralon,998,warlock,destruction,23,11,12
53438,Shardgodx,barthilas,997,warlock,destruction,23,11,12
53439,Lowkei,stonemaul,997,warlock,destruction,48,16,32
53440,Gwarlocassh,quelthalas,992,warlock,destruction,33,11,22
53441,Wingzerø,tichondrius,988,warlock,destruction,23,11,12
53442,Ozric,quelthalas,987,warlock,destruction,20,12,8
53443,Nevermorde,area-52,986,warlock,destruction,23,11,12
53444,Wìckedelf,area-52,986,warlock,destruction,81,38,43
53445,Mystikcloak,lightbringer,980,warlock,destruction,19,13,6
53446,Hanoaa,tichondrius,975,warlock,destruction,11,11,0
53447,Zíppen,proudmoore,970,warlock,destruction,61,30,31
53448,Plagueis,zuluhed,969,warlock,destruction,25,11,14
53449,Kimis,azralon,963,warlock,destruction,24,14,10
53450,Afrikenx,tichondrius,960,warlock,destruction,12,10,2
53451,Lilshedon,kelthuzad,960,warlock,destruction,12,10,2
53452,Letmecastpls,tichondrius,960,warlock,destruction,12,10,2
53453,Defukd,proudmoore,960,warlock,destruction,12,10,2
53454,Lockbtw,altar-of-storms,960,warlock,destruction,12,10,2
53455,Fxckyuo,tichondrius,960,warlock,destruction,12,10,2
53456,Goldielocks,eredar,960,warlock,destruction,12,10,2
53457,Kammuany,sargeras,960,warlock,destruction,12,10,2
53458,Nino,barthilas,960,warlock,destruction,12,10,2
53459,Wolfibi,tichondrius,960,warlock,destruction,12,10,2
53460,Jaboy,dragonmaw,960,warlock,destruction,12,10,2
53461,Mesw,tichondrius,960,warlock,destruction,12,10,2
53462,Icecokepeach,black-dragonflight,960,warlock,destruction,12,10,2
53463,Adonegege,tichondrius,960,warlock,destruction,12,10,2
53464,Wanglock,blackrock,960,warlock,destruction,12,10,2
53465,Renatis,malganis,960,warlock,destruction,15,11,4
53466,Areufearious,sargeras,960,warlock,destruction,18,10,8
53467,Asamsbinladn,illidan,960,warlock,destruction,18,10,8
53468,Extreme,blackwing-lair,960,warlock,destruction,18,10,8
53469,Yuvirayz,illidan,960,warlock,destruction,18,10,8
53470,Klol,proudmoore,960,warlock,destruction,18,10,8
53471,Baka,moon-guard,960,warlock,destruction,18,10,8
53472,Veryezgame,tichondrius,960,warlock,destruction,18,10,8
53473,Phøbøs,hyjal,960,warlock,destruction,18,10,8
53474,Busterbob,tichondrius,960,warlock,destruction,18,10,8
53475,Spicyfingerx,illidan,960,warlock,destruction,18,10,8
53476,Tjdotter,stormrage,960,warlock,destruction,21,11,10
53477,Gneçro,area-52,960,warlock,destruction,24,10,14
53478,Contägion,bleeding-hollow,960,warlock,destruction,24,10,14
53479,Foxar,stormrage,959,warlock,destruction,12,10,2
53480,Dkdakìng,dalaran,959,warlock,destruction,12,10,2
53481,Hexxorcism,bleeding-hollow,959,warlock,destruction,12,10,2
53482,Daisyridley,frostmourne,959,warlock,destruction,12,10,2
53483,Candylock,blackrock,959,warlock,destruction,12,10,2
53484,Percaddict,illidan,959,warlock,destruction,12,10,2
53485,Gregfearnrun,area-52,959,warlock,destruction,16,11,5
53486,Zazyi,azralon,959,warlock,destruction,16,11,5
53487,Juiçédaddy,aggramar,959,warlock,destruction,18,10,8
53488,Bktheruler,tichondrius,959,warlock,destruction,18,10,8
53489,Shequita,thrall,959,warlock,destruction,18,10,8
53490,Maral,kelthuzad,959,warlock,destruction,18,10,8
53491,Years,moon-guard,959,warlock,destruction,18,10,8
53492,Tevonsonte,tichondrius,959,warlock,destruction,18,10,8
53493,Sixonenine,boulderfist,959,warlock,destruction,18,10,8
53494,Neccross,azralon,959,warlock,destruction,18,10,8
53495,Peeberson,tichondrius,959,warlock,destruction,18,10,8
53496,Dotnrunn,kelthuzad,959,warlock,destruction,18,10,8
53497,Kxäs,ragnaros,959,warlock,destruction,18,10,8
53498,Maquedonia,quelthalas,959,warlock,destruction,18,10,8
53499,Roblockz,illidan,959,warlock,destruction,18,10,8
53500,Zelophobiaz,crushridge,959,warlock,destruction,18,10,8
53501,Notatryhard,emerald-dream,959,warlock,destruction,18,10,8
53502,Pykorrg,ragnaros,959,warlock,destruction,24,10,14
53503,Delarae,frostmourne,958,warlock,destruction,12,10,2
53504,Helraz,darkspear,958,warlock,destruction,12,10,2
53505,Metafin,quelthalas,958,warlock,destruction,18,10,8
53506,Wondon,tichondrius,958,warlock,destruction,18,10,8
53507,Taye,barthilas,958,warlock,destruction,18,10,8
53508,Meleemetabtw,emerald-dream,958,warlock,destruction,18,10,8
53509,Mørgoth,thrall,958,warlock,destruction,18,10,8
53510,Sourmilkz,zuljin,958,warlock,destruction,24,10,14
53511,Diabolous,malganis,957,warlock,destruction,18,10,8
53512,Hellwalker,illidan,957,warlock,destruction,18,10,8
53513,Dercrow,quelthalas,957,warlock,destruction,18,10,8
53514,Kåos,kelthuzad,957,warlock,destruction,18,10,8
53515,Shelocks,sargeras,957,warlock,destruction,18,10,8
53516,Daesire,moon-guard,957,warlock,destruction,18,10,8
53517,Xerozus,tichondrius,957,warlock,destruction,18,10,8
53518,Dragonlordy,proudmoore,957,warlock,destruction,18,10,8
53519,Greasymario,area-52,957,warlock,destruction,22,11,11
53520,Sieghert,frostmourne,957,warlock,destruction,24,10,14
53521,Tromeo,sargeras,957,warlock,destruction,24,10,14
53522,Pøwertrîp,sargeras,957,warlock,destruction,30,10,20
53523,Sacrifices,sargeras,956,warlock,destruction,12,10,2
53524,Creambun,barthilas,956,warlock,destruction,18,10,8
53525,Wømanizer,azralon,956,warlock,destruction,18,10,8
53526,Ragnalock,laughing-skull,956,warlock,destruction,18,10,8
53527,Dårkfyre,kiljaeden,956,warlock,destruction,18,10,8
53528,Raidspot,bleeding-hollow,956,warlock,destruction,24,10,14
53529,Zaintv,illidan,955,warlock,destruction,18,10,8
53530,Chaoticstorm,area-52,955,warlock,destruction,18,10,8
53531,Hellslayer,frostmourne,955,warlock,destruction,24,10,14
53532,Pachips,zuljin,955,warlock,destruction,24,10,14
53533,Thediaz,quelthalas,954,warlock,destruction,24,12,12
53534,Mybadyo,dalaran,953,warlock,destruction,16,11,5
53535,Harleyjames,ravenholdt,953,warlock,destruction,18,10,8
53536,Punjj,jubeithos,952,warlock,destruction,18,10,8
53537,Jezzabell,amanthul,952,warlock,destruction,24,10,14
53538,Huuchie,moon-guard,951,warlock,destruction,18,10,8
53539,Puscifear,azralon,951,warlock,destruction,30,10,20
53540,Sojupain,kaelthas,950,warlock,destruction,12,10,2
53541,Mäléficø,nemesis,950,warlock,destruction,30,10,20
53542,Yury,scarlet-crusade,949,warlock,destruction,24,10,14
53543,Moreedotss,malganis,947,warlock,destruction,30,10,20
53544,Hamadan,azralon,946,warlock,destruction,24,10,14
53545,Cursé,stormrage,944,warlock,destruction,18,10,8
53546,Zudre,tanaris,942,warlock,destruction,16,11,5
53547,Dista,bleeding-hollow,941,warlock,destruction,31,10,21
53548,Jonuts,korgath,939,warlock,destruction,67,30,37
53549,Albus,skywall,933,warlock,destruction,24,10,14
53550,Imsupercool,bleeding-hollow,927,warlock,destruction,17,10,7
53551,Aliceðupree,darkspear,927,warlock,destruction,69,29,40
53552,Astarõth,zuljin,926,warlock,destruction,26,11,15
53553,Twohandedkil,stormrage,920,warlock,destruction,26,11,15
53554,Keleiron,velen,916,warlock,destruction,18,10,8
53555,Xekk,wyrmrest-accord,910,warlock,destruction,23,10,13
53556,Lockyy,khaz-modan,904,warlock,destruction,26,11,15
53557,Earllock,sargeras,895,warlock,destruction,14,10,4
53558,Steav,quelthalas,894,warlock,destruction,16,10,6
53559,Fiennx,dalaran,894,warlock,destruction,17,10,7
53560,Rakudemon,ragnaros,894,warlock,destruction,20,10,10
53561,Prägä,drakkari,892,warlock,destruction,14,10,4
53562,Zzat,area-52,892,warlock,destruction,14,10,4
53563,Marlett,destromath,890,warlock,destruction,113,58,55
53564,Ilovedabs,aerie-peak,890,warlock,destruction,22,10,12
53565,Savagetheron,korgath,887,warlock,destruction,18,10,8
53566,Pyria,boulderfist,877,warlock,destruction,13,10,3
53567,Nikôlas,stormrage,871,warlock,destruction,66,26,40
53568,Moóndust,bleeding-hollow,864,warlock,destruction,12,9,3
53569,Voidsoda,whisperwind,864,warlock,destruction,12,9,3
53570,Frustration,darkspear,864,warlock,destruction,12,9,3
53571,Bonita,garona,864,warlock,destruction,12,9,3
53572,Lysitheä,moon-guard,864,warlock,destruction,12,9,3
53573,Demoabuser,lightnings-blade,864,warlock,destruction,12,9,3
53574,Matthewx,stormrage,864,warlock,destruction,12,9,3
53575,Animarex,tichondrius,864,warlock,destruction,12,9,3
53576,Baddummy,tichondrius,864,warlock,destruction,12,9,3
53577,Grendaldots,tichondrius,864,warlock,destruction,12,9,3
53578,Tstlsl,area-52,864,warlock,destruction,12,9,3
53579,Drezx,frostmourne,864,warlock,destruction,12,9,3
53580,Wtfcowisownz,illidan,864,warlock,destruction,12,9,3
53581,Dabú,tichondrius,864,warlock,destruction,12,9,3
53582,Lokiy,ragnaros,864,warlock,destruction,12,9,3
53583,Alphaeus,hydraxis,864,warlock,destruction,12,9,3
53584,Whaad,tichondrius,864,warlock,destruction,12,9,3
53585,Zipanadblcup,thrall,864,warlock,destruction,12,9,3
53586,Nynx,stormrage,864,warlock,destruction,12,9,3
53587,Rice,lothar,864,warlock,destruction,12,9,3
53588,Crnowarlock,area-52,864,warlock,destruction,12,9,3
53589,Shokran,frostmourne,864,warlock,destruction,12,9,3
53590,Rumplefust,thrall,864,warlock,destruction,12,9,3
53591,Pengliyuaner,illidan,864,warlock,destruction,12,9,3
53592,Quickzmaster,blackrock,864,warlock,destruction,12,9,3
53593,Cirï,hellscream,864,warlock,destruction,12,9,3
53594,Particles,proudmoore,864,warlock,destruction,16,10,6
53595,Deatthwish,ragnaros,864,warlock,destruction,21,11,10
53596,Voidxo,tichondrius,864,warlock,destruction,18,9,9
53597,Reflexlock,malganis,864,warlock,destruction,18,9,9
53598,Truepain,tichondrius,864,warlock,destruction,18,9,9
53599,Bigolehogger,area-52,864,warlock,destruction,18,9,9
53600,Biggbolts,tichondrius,864,warlock,destruction,18,9,9
53601,Eazyw,stormrage,864,warlock,destruction,18,9,9
53602,Rezial,illidan,864,warlock,destruction,18,9,9
53603,Doties,bleeding-hollow,864,warlock,destruction,18,9,9
53604,Blair,wildhammer,864,warlock,destruction,18,9,9
53605,Enmama,malganis,864,warlock,destruction,18,9,9
53606,Rorvask,area-52,864,warlock,destruction,18,9,9
53607,Drossx,illidan,864,warlock,destruction,18,9,9
53608,Miroir,illidan,864,warlock,destruction,18,9,9
53609,Woopie,malfurion,864,warlock,destruction,18,9,9
53610,Sonovabeech,winterhoof,864,warlock,destruction,18,9,9
53611,Stuffs,wyrmrest-accord,864,warlock,destruction,18,9,9
53612,Ezgamejr,tichondrius,864,warlock,destruction,24,9,15
53613,Dottemup,dalvengyr,863,warlock,destruction,12,9,3
53614,Ahrimaan,illidan,863,warlock,destruction,12,9,3
53615,Skrunkz,illidan,863,warlock,destruction,12,9,3
53616,Slicktrik,stormrage,863,warlock,destruction,12,9,3
53617,Kathriss,frostmane,863,warlock,destruction,12,9,3
53618,Gent,stormrage,863,warlock,destruction,12,9,3
53619,Shooff,area-52,863,warlock,destruction,12,9,3
53620,Pacopico,illidan,863,warlock,destruction,12,9,3
53621,Pleaseno,tichondrius,863,warlock,destruction,12,9,3
53622,Zycas,tichondrius,863,warlock,destruction,12,9,3
53623,Glergarby,stormscale,863,warlock,destruction,15,10,5
53624,Manethail,aegwynn,863,warlock,destruction,18,9,9
53625,Kunshii,bleeding-hollow,863,warlock,destruction,18,9,9
53626,Firemike,kelthuzad,863,warlock,destruction,18,9,9
53627,Lessthanjake,zuljin,863,warlock,destruction,18,9,9
53628,Arremon,thrall,863,warlock,destruction,18,9,9
53629,Minzyw,illidan,863,warlock,destruction,18,9,9
53630,Cyio,zuljin,863,warlock,destruction,18,9,9
53631,Nethron,the-venture-co,863,warlock,destruction,18,9,9
53632,Rhabdo,ravenholdt,863,warlock,destruction,18,9,9
53633,Fearedit,bleeding-hollow,863,warlock,destruction,18,9,9
53634,Durgamon,kirin-tor,863,warlock,destruction,18,9,9
53635,Notdiesel,thrall,863,warlock,destruction,18,9,9
53636,Ðarkbat,ragnaros,863,warlock,destruction,18,9,9
53637,Maxdamage,blackwater-raiders,863,warlock,destruction,18,9,9
53638,Rothmar,bleeding-hollow,863,warlock,destruction,18,9,9
53639,Goarage,tichondrius,863,warlock,destruction,22,10,12
53640,Rokdas,area-52,863,warlock,destruction,24,9,15
53641,Cigárillo,thrall,863,warlock,destruction,24,9,15
53642,Namig,aerie-peak,862,warlock,destruction,12,9,3
53643,Çhåos,destromath,862,warlock,destruction,12,9,3
53644,Locklockdead,earthen-ring,862,warlock,destruction,12,9,3
53645,Mourinhoftw,illidan,862,warlock,destruction,12,9,3
53646,Thewkama,tichondrius,862,warlock,destruction,18,9,9
53647,Artheás,azralon,862,warlock,destruction,18,9,9
53648,Duhdotsbruh,trollbane,862,warlock,destruction,18,9,9
53649,Sanzofunke,area-52,862,warlock,destruction,18,9,9
53650,Rainali,tichondrius,862,warlock,destruction,18,9,9
53651,Dìabolos,frostmourne,862,warlock,destruction,18,9,9
53652,Breaad,tichondrius,862,warlock,destruction,24,9,15
53653,Tanathoz,thrall,862,warlock,destruction,28,10,18
53654,Aveeda,malganis,861,warlock,destruction,12,9,3
53655,Frdchickiana,tichondrius,861,warlock,destruction,18,9,9
53656,Funnelcakies,area-52,861,warlock,destruction,18,9,9
53657,Snapp,kelthuzad,861,warlock,destruction,24,9,15
53658,Morganith,ravenholdt,861,warlock,destruction,30,9,21
53659,Damdochael,bleeding-hollow,860,warlock,destruction,24,9,15
53660,Botoslap,dragonmaw,860,warlock,destruction,24,9,15
53661,Githany,hyjal,859,warlock,destruction,18,9,9
53662,Gorskij,frostwolf,859,warlock,destruction,19,9,10
53663,Damerus,illidan,859,warlock,destruction,24,9,15
53664,Wybbukk,wyrmrest-accord,858,warlock,destruction,12,9,3
53665,Lestant,moon-guard,858,warlock,destruction,18,9,9
53666,Anubrikhan,wyrmrest-accord,858,warlock,destruction,18,9,9
53667,Thulium,dawnbringer,857,warlock,destruction,12,9,3
53668,Rudeuss,kiljaeden,857,warlock,destruction,18,9,9
53669,Sykosenpai,zuljin,856,warlock,destruction,12,9,3
53670,Shadohz,lightnings-blade,855,warlock,destruction,12,9,3
53671,Shickeri,thunderlord,855,warlock,destruction,12,9,3
53672,Scentient,jubeithos,855,warlock,destruction,12,9,3
53673,Klummzy,tichondrius,850,warlock,destruction,18,9,9
53674,Vampir,hellscream,850,warlock,destruction,24,9,15
53675,Juan,borean-tundra,850,warlock,destruction,24,9,15
53676,Doomtome,moon-guard,850,warlock,destruction,38,9,29
53677,Elyzier,gallywix,839,warlock,destruction,48,20,28
53678,Freakdoa,blades-edge,834,warlock,destruction,53,20,33
53679,Hayhatchie,nagrand,831,warlock,destruction,17,9,8
53680,Ovosound,tichondrius,815,warlock,destruction,11,9,2
53681,Chaospump,frostmourne,815,warlock,destruction,17,9,8
53682,Cheêsyx,tichondrius,815,warlock,destruction,17,9,8
53683,Üziel,nemesis,814,warlock,destruction,15,9,6
53684,Brútek,moon-guard,811,warlock,destruction,23,9,14
53685,Metamòrph,malganis,810,warlock,destruction,16,10,6
53686,Richactress,tichondrius,799,warlock,destruction,17,9,8
53687,Conboii,tichondrius,768,warlock,destruction,10,9,1
53688,Annantu,area-52,768,warlock,destruction,12,8,4
53689,Elldiablo,darkspear,768,warlock,destruction,12,8,4
53690,Ceeloftw,tichondrius,768,warlock,destruction,12,8,4
53691,Clorvenna,zuljin,768,warlock,destruction,12,8,4
53692,Smeezles,frostmourne,768,warlock,destruction,12,8,4
53693,Diznei,nemesis,768,warlock,destruction,12,8,4
53694,Elcidz,tichondrius,768,warlock,destruction,12,8,4
53695,Bhalthazar,staghelm,768,warlock,destruction,12,8,4
53696,Kápz,darkspear,768,warlock,destruction,12,8,4
53697,Stíngz,nemesis,768,warlock,destruction,12,8,4
53698,Shinagae,tichondrius,768,warlock,destruction,12,8,4
53699,Necroferal,whisperwind,768,warlock,destruction,12,8,4
53700,Flavakid,malganis,768,warlock,destruction,12,8,4
53701,Aexsion,moon-guard,768,warlock,destruction,12,8,4
53702,Searinox,scilla,768,warlock,destruction,12,8,4
53703,Rebolting,tichondrius,768,warlock,destruction,12,8,4
53704,Aptukk,archimonde,768,warlock,destruction,12,8,4
53705,Levee,spirestone,768,warlock,destruction,12,8,4
53706,Xevari,zuljin,768,warlock,destruction,12,8,4
53707,Korash,kilrogg,768,warlock,destruction,12,8,4
53708,Slackjaww,kiljaeden,768,warlock,destruction,12,8,4
53709,Warcoc,bleeding-hollow,768,warlock,destruction,12,8,4
53710,Fearsponce,dragonmaw,768,warlock,destruction,12,8,4
53711,Idoovoodoo,burning-legion,768,warlock,destruction,12,8,4
53712,Ayedss,dalaran,768,warlock,destruction,12,8,4
53713,Wickiedalice,vashj,768,warlock,destruction,12,8,4
53714,Narzhul,drakkari,768,warlock,destruction,12,8,4
53715,Flackory,tichondrius,768,warlock,destruction,12,8,4
53716,Bopplock,tichondrius,768,warlock,destruction,12,8,4
53717,Rhelialock,icecrown,768,warlock,destruction,12,8,4
53718,Dumbfknclass,malganis,768,warlock,destruction,12,8,4
53719,Munje,bleeding-hollow,768,warlock,destruction,12,8,4
53720,Cheylock,stormrage,768,warlock,destruction,12,8,4
53721,Pandasrlegit,burning-blade,768,warlock,destruction,12,8,4
53722,Chaoscoach,sargeras,768,warlock,destruction,12,8,4
53723,Discordance,zuljin,768,warlock,destruction,12,8,4
53724,Famington,tichondrius,768,warlock,destruction,12,8,4
53725,Beckypls,zuljin,768,warlock,destruction,12,8,4
53726,Esolock,malganis,768,warlock,destruction,12,8,4
53727,Wizxin,emerald-dream,768,warlock,destruction,12,8,4
53728,Fischh,hyjal,768,warlock,destruction,12,8,4
53729,Warlocknroll,frostmourne,768,warlock,destruction,12,8,4
53730,Felegance,proudmoore,768,warlock,destruction,12,8,4
53731,Soliaa,stormrage,768,warlock,destruction,12,8,4
53732,Hipnus,drakkari,768,warlock,destruction,12,8,4
53733,Elprup,tichondrius,768,warlock,destruction,12,8,4
53734,Nicorot,malganis,768,warlock,destruction,12,8,4
53735,Westtung,tichondrius,768,warlock,destruction,13,8,5
53736,Nyhn,bleeding-hollow,768,warlock,destruction,13,8,5
53737,Metic,firetree,768,warlock,destruction,16,9,7
53738,Pãni,area-52,768,warlock,destruction,18,8,10
53739,Joung,tichondrius,768,warlock,destruction,18,8,10
53740,Iniboltquity,tichondrius,768,warlock,destruction,18,8,10
53741,Demfearslol,terokkar,768,warlock,destruction,18,8,10
53742,Kallym,azralon,768,warlock,destruction,18,8,10
53743,Dethknell,stormrage,768,warlock,destruction,18,8,10
53744,Tarth,sargeras,768,warlock,destruction,18,8,10
53745,Oppaijuggler,tichondrius,768,warlock,destruction,18,8,10
53746,Rashiko,bleeding-hollow,768,warlock,destruction,18,8,10
53747,Westhofxx,sargeras,768,warlock,destruction,18,8,10
53748,Vexxes,malganis,768,warlock,destruction,18,8,10
53749,Digylock,kelthuzad,768,warlock,destruction,30,8,22
53750,Doman,thorium-brotherhood,767,warlock,destruction,12,8,4
53751,Feldune,sargeras,767,warlock,destruction,12,8,4
53752,Alastoorx,ragnaros,767,warlock,destruction,12,8,4
53753,Coil,kiljaeden,767,warlock,destruction,12,8,4
53754,Kboydots,sargeras,767,warlock,destruction,12,8,4
53755,Matrriixx,proudmoore,767,warlock,destruction,12,8,4
53756,Accentuate,tichondrius,767,warlock,destruction,12,8,4
53757,Kruder,tichondrius,767,warlock,destruction,12,8,4
53758,Yonz,area-52,767,warlock,destruction,12,8,4
53759,Imadotyasan,shandris,767,warlock,destruction,12,8,4
53760,Rickthelock,tichondrius,767,warlock,destruction,12,8,4
53761,Darthtequila,stormrage,767,warlock,destruction,12,8,4
53762,Haardmode,area-52,767,warlock,destruction,12,8,4
53763,Char,jubeithos,767,warlock,destruction,12,8,4
53764,Xaviier,sargeras,767,warlock,destruction,12,8,4
53765,Blackwlk,tichondrius,767,warlock,destruction,12,8,4
53766,Lokkup,dalaran,767,warlock,destruction,18,8,10
53767,Redbro,darkspear,767,warlock,destruction,18,8,10
53768,Shikyo,lightnings-blade,767,warlock,destruction,18,8,10
53769,Mêdìvh,tichondrius,767,warlock,destruction,18,8,10
53770,Vlk,barthilas,767,warlock,destruction,18,8,10
53771,Misscháos,malganis,767,warlock,destruction,18,8,10
53772,Plutö,thrall,767,warlock,destruction,18,8,10
53773,Mangdaemon,silvermoon,767,warlock,destruction,18,8,10
53774,Says,gorefiend,767,warlock,destruction,18,8,10
53775,Aldaill,moon-guard,767,warlock,destruction,18,8,10
53776,Babubabub,azralon,767,warlock,destruction,18,8,10
53777,Felpuppet,barthilas,767,warlock,destruction,18,8,10
53778,Katsurägi,tichondrius,767,warlock,destruction,18,8,10
53779,Abramerlin,tichondrius,767,warlock,destruction,18,8,10
53780,Síkaría,malganis,767,warlock,destruction,18,8,10
53781,Slysdexia,sargeras,767,warlock,destruction,18,8,10
53782,Bohnd,elune,767,warlock,destruction,18,8,10
53783,Draxxus,barthilas,767,warlock,destruction,18,8,10
53784,Spicytaters,malganis,767,warlock,destruction,24,8,16
53785,Necrófear,tichondrius,767,warlock,destruction,24,8,16
53786,Itsmeagain,area-52,767,warlock,destruction,24,8,16
53787,Feoona,hyjal,767,warlock,destruction,24,8,16
53788,Veleseth,stormrage,767,warlock,destruction,24,8,16
53789,Raglans,amanthul,766,warlock,destruction,12,8,4
53790,Opëth,thrall,766,warlock,destruction,12,8,4
53791,Enur,malganis,766,warlock,destruction,12,8,4
53792,Razdarin,proudmoore,766,warlock,destruction,12,8,4
53793,Doomers,frostmourne,766,warlock,destruction,12,8,4
53794,Dinkydeen,area-52,766,warlock,destruction,12,8,4
53795,Dmgcrit,destromath,766,warlock,destruction,12,8,4
53796,Assaulttron,wyrmrest-accord,766,warlock,destruction,12,8,4
53797,Devdolittle,tichondrius,766,warlock,destruction,12,8,4
53798,Abyssamcdoom,sargeras,766,warlock,destruction,18,8,10
53799,Mandley,nazgrel,766,warlock,destruction,18,8,10
53800,Seniorshneef,emerald-dream,766,warlock,destruction,18,8,10
53801,Corezach,proudmoore,766,warlock,destruction,24,8,16
53802,Spiritofodin,grizzly-hills,765,warlock,destruction,12,8,4
53803,Rurnt,bloodhoof,765,warlock,destruction,12,8,4
53804,Pipeo,quelthalas,765,warlock,destruction,12,8,4
53805,Rottgodqt,area-52,765,warlock,destruction,24,8,16
53806,Lilitht,drakkari,764,warlock,destruction,18,8,10
53807,Guinegobbler,hyjal,764,warlock,destruction,20,8,12
53808,Esoo,kul-tiras,763,warlock,destruction,12,8,4
53809,Caryn,dalaran,763,warlock,destruction,18,8,10
53810,Disrespex,kelthuzad,762,warlock,destruction,18,8,10
53811,Djfear,tichondrius,762,warlock,destruction,18,8,10
53812,Terminall,quelthalas,762,warlock,destruction,18,8,10
53813,Nightblloom,illidan,762,warlock,destruction,18,8,10
53814,Degynlock,wyrmrest-accord,762,warlock,destruction,24,8,16
53815,Shooterg,tichondrius,761,warlock,destruction,18,8,10
53816,Feladrae,wyrmrest-accord,761,warlock,destruction,30,8,22
53817,Valyona,moon-guard,760,warlock,destruction,12,8,4
53818,Schwaan,bladefist,757,warlock,destruction,12,8,4
53819,Voidsoul,garithos,754,warlock,destruction,18,8,10
53820,Shendotigans,illidan,735,warlock,destruction,23,8,15
53821,Fellraiser,bleeding-hollow,720,warlock,destruction,15,8,7
53822,Notoriusmma,illidan,720,warlock,destruction,19,10,9
53823,Thuglovex,sargeras,719,warlock,destruction,11,8,3
53824,Sotera,bleeding-hollow,719,warlock,destruction,11,8,3
53825,Lökdown,dalaran,714,warlock,destruction,15,11,4
53826,Júbeka,drakkari,714,warlock,destruction,20,9,11
53827,Lilsquirts,kelthuzad,704,warlock,destruction,16,8,8
53828,Ihaveapowers,maiev,703,warlock,destruction,11,8,3
53829,Bäbz,barthilas,703,warlock,destruction,11,8,3
53830,Tinyjo,sargeras,703,warlock,destruction,11,8,3
53831,Demotional,wyrmrest-accord,703,warlock,destruction,14,8,6
53832,Yikës,stormrage,703,warlock,destruction,14,8,6
53833,Celestîne,sargeras,703,warlock,destruction,16,8,8
53834,Liljamie,stormrage,703,warlock,destruction,17,8,9
53835,Darchrow,frostmourne,703,warlock,destruction,23,8,15
53836,Screampied,sargeras,699,warlock,destruction,20,8,12
53837,Surleshilla,malganis,688,warlock,destruction,19,8,11
53838,Dihva,malganis,687,warlock,destruction,17,9,8
53839,Getfeared,emerald-dream,672,warlock,destruction,10,8,2
53840,Zlippery,barthilas,672,warlock,destruction,10,8,2
53841,Bigjersey,illidan,672,warlock,destruction,12,7,5
53842,Tomathus,moon-guard,672,warlock,destruction,12,7,5
53843,Synisterlock,moon-guard,672,warlock,destruction,12,7,5
53844,Méphisto,emerald-dream,672,warlock,destruction,12,7,5
53845,Drakatat,tichondrius,672,warlock,destruction,12,7,5
53846,Dealindoug,bonechewer,672,warlock,destruction,12,7,5
53847,Furryfears,gurubashi,672,warlock,destruction,12,7,5
53848,Glizzÿ,thrall,672,warlock,destruction,12,7,5
53849,Flicks,arthas,672,warlock,destruction,12,7,5
53850,Puvvo,tichondrius,672,warlock,destruction,12,7,5
53851,Revdog,sargeras,672,warlock,destruction,12,7,5
53852,Fantumz,illidan,672,warlock,destruction,12,7,5
53853,Suminl,tichondrius,672,warlock,destruction,12,7,5
53854,Phishdots,tichondrius,672,warlock,destruction,12,7,5
53855,Mokfernal,tichondrius,672,warlock,destruction,12,7,5
53856,Pillock,bleeding-hollow,672,warlock,destruction,12,7,5
53857,Luciusvrenus,tichondrius,672,warlock,destruction,12,7,5
53858,Snikpan,silver-hand,672,warlock,destruction,12,7,5
53859,Rockalock,burning-blade,672,warlock,destruction,12,7,5
53860,Afflackxl,sargeras,672,warlock,destruction,12,7,5
53861,Buypork,tichondrius,672,warlock,destruction,12,7,5
53862,Callofzevoid,tichondrius,672,warlock,destruction,12,7,5
53863,Dotlockndrop,stormreaver,672,warlock,destruction,12,7,5
53864,Milkybøng,area-52,672,warlock,destruction,12,7,5
53865,Monkeyasslol,sargeras,672,warlock,destruction,12,7,5
53866,Dipgodx,bleeding-hollow,672,warlock,destruction,12,7,5
53867,Uggaboogga,malganis,672,warlock,destruction,12,7,5
53868,Alterity,kelthuzad,672,warlock,destruction,12,7,5
53869,Kuaa,illidan,672,warlock,destruction,12,7,5
53870,Clingrita,tichondrius,672,warlock,destruction,12,7,5
53871,Tamzin,kelthuzad,672,warlock,destruction,12,7,5
53872,Stîgz,stormrage,672,warlock,destruction,12,7,5
53873,Aegywn,gorgonnash,672,warlock,destruction,12,7,5
53874,Fsx,malganis,672,warlock,destruction,12,7,5
53875,Insànity,bleeding-hollow,672,warlock,destruction,12,7,5
53876,Brujoroba,drakkari,672,warlock,destruction,12,7,5
53877,Tatordotzz,tichondrius,672,warlock,destruction,12,7,5
53878,Cancer,bloodscalp,672,warlock,destruction,12,7,5
53879,Sylvarri,stormrage,672,warlock,destruction,12,7,5
53880,Qayin,azralon,672,warlock,destruction,12,7,5
53881,Iboltudie,tichondrius,672,warlock,destruction,12,7,5
53882,Elanfel,thrall,672,warlock,destruction,12,7,5
53883,Morganach,moon-guard,672,warlock,destruction,12,7,5
53884,Warpstar,area-52,672,warlock,destruction,12,7,5
53885,Demí,zuljin,672,warlock,destruction,12,7,5
53886,Shredlock,tichondrius,672,warlock,destruction,12,7,5
53887,Walleyemike,kelthuzad,672,warlock,destruction,12,7,5
53888,Dplexs,jubeithos,672,warlock,destruction,12,7,5
53889,Westhofz,sargeras,672,warlock,destruction,12,7,5
53890,Sasaology,frostmourne,672,warlock,destruction,12,7,5
53891,Rothslock,tichondrius,672,warlock,destruction,12,7,5
53892,Schlutty,malganis,672,warlock,destruction,12,7,5
53893,Karmalock,malganis,672,warlock,destruction,12,7,5
53894,Kountdrakula,tichondrius,672,warlock,destruction,12,7,5
53895,Alìen,barthilas,672,warlock,destruction,12,7,5
53896,Dötkill,illidan,672,warlock,destruction,12,7,5
53897,Dotcòm,illidan,672,warlock,destruction,12,7,5
53898,Felforyouu,illidan,672,warlock,destruction,12,7,5
53899,Cilium,illidan,672,warlock,destruction,12,7,5
53900,Locker,darkspear,672,warlock,destruction,12,7,5
53901,Nicsb,caelestrasz,672,warlock,destruction,12,7,5
53902,Lorenzojrr,sargeras,672,warlock,destruction,12,7,5
53903,Bosswarlock,tichondrius,672,warlock,destruction,13,7,6
53904,Axetoss,stormrage,672,warlock,destruction,17,9,8
53905,Anasúi,quelthalas,672,warlock,destruction,18,7,11
53906,Lilintrovert,illidan,672,warlock,destruction,18,7,11
53907,Dilonlock,area-52,672,warlock,destruction,18,7,11
53908,Spacedots,illidan,672,warlock,destruction,18,7,11
53909,Zareke,silvermoon,672,warlock,destruction,18,7,11
53910,Vihxy,moon-guard,672,warlock,destruction,18,7,11
53911,Ivanux,quelthalas,672,warlock,destruction,18,7,11
53912,Modot,tichondrius,672,warlock,destruction,18,7,11
53913,Butterbolts,aerie-peak,672,warlock,destruction,18,7,11
53914,Sibome,stormrage,672,warlock,destruction,18,7,11
53915,Gritzixx,frostmourne,672,warlock,destruction,18,7,11
53916,Dedremus,korialstrasz,672,warlock,destruction,18,7,11
53917,Zantology,frostmourne,672,warlock,destruction,18,7,11
53918,Marshyl,tichondrius,672,warlock,destruction,18,7,11
53919,Evalovia,hyjal,672,warlock,destruction,24,7,17
53920,Grimzo,mugthol,671,warlock,destruction,12,7,5
53921,Drskeeters,malganis,671,warlock,destruction,12,7,5
53922,Darthgoku,area-52,671,warlock,destruction,12,7,5
53923,Valthorion,dathremar,671,warlock,destruction,12,7,5
53924,Leroybrown,alterac-mountains,671,warlock,destruction,12,7,5
53925,Azâziel,ragnaros,671,warlock,destruction,12,7,5
53926,Demosthenes,nazjatar,671,warlock,destruction,12,7,5
53927,Saicinxd,darkspear,671,warlock,destruction,12,7,5
53928,Bhupzy,barthilas,671,warlock,destruction,12,7,5
53929,Bradella,proudmoore,671,warlock,destruction,12,7,5
53930,Fapchat,silvermoon,671,warlock,destruction,12,7,5
53931,Zhing,frostmourne,671,warlock,destruction,12,7,5
53932,Mérli,quelthalas,671,warlock,destruction,12,7,5
53933,Boltondahoes,sargeras,671,warlock,destruction,12,7,5
53934,Krillz,quelthalas,671,warlock,destruction,12,7,5
53935,Actiow,stormrage,671,warlock,destruction,12,7,5
53936,Zyraxx,moon-guard,671,warlock,destruction,12,7,5
53937,Choas,jaedenar,671,warlock,destruction,12,7,5
53938,Shadowpainn,the-underbog,671,warlock,destruction,12,7,5
53939,Briside,malganis,671,warlock,destruction,12,7,5
53940,Zms,ragnaros,671,warlock,destruction,12,7,5
53941,Pendïng,area-52,671,warlock,destruction,12,7,5
53942,Cytosine,medivh,671,warlock,destruction,12,7,5
53943,Naba,malorne,671,warlock,destruction,12,7,5
53944,Hudsonse,eitrigg,671,warlock,destruction,12,7,5
53945,Soulinite,fizzcrank,671,warlock,destruction,18,7,11
53946,Vetislock,thrall,671,warlock,destruction,18,7,11
53947,Purplehatred,area-52,671,warlock,destruction,18,7,11
53948,Fulc,area-52,671,warlock,destruction,18,7,11
53949,Wollylock,dark-iron,671,warlock,destruction,18,7,11
53950,Acribal,quelthalas,671,warlock,destruction,18,7,11
53951,Jvilla,tichondrius,671,warlock,destruction,18,7,11
53952,Kachauwoo,kiljaeden,671,warlock,destruction,18,7,11
53953,Yungwilly,silvermoon,671,warlock,destruction,18,7,11
53954,Deadlockz,stormrage,671,warlock,destruction,18,7,11
53955,Trìplock,area-52,671,warlock,destruction,18,7,11
53956,Lübelock,illidan,671,warlock,destruction,18,7,11
53957,Vorituuray,moon-guard,671,warlock,destruction,18,7,11
53958,Tørturë,tichondrius,670,warlock,destruction,12,7,5
53959,Iamfear,shuhalo,670,warlock,destruction,12,7,5
53960,Amilkman,area-52,670,warlock,destruction,12,7,5
53961,Dipndøtz,illidan,670,warlock,destruction,12,7,5
53962,Noteko,korgath,670,warlock,destruction,12,7,5
53963,Cynissel,sargeras,670,warlock,destruction,13,7,6
53964,Cazadorius,jubeithos,670,warlock,destruction,13,7,6
53965,Kurtcodrain,blackhand,670,warlock,destruction,18,7,11
53966,Siphos,proudmoore,670,warlock,destruction,18,7,11
53967,Heartpvp,tichondrius,670,warlock,destruction,18,7,11
53968,Graced,stormrage,670,warlock,destruction,18,7,11
53969,Revenancer,smolderthorn,669,warlock,destruction,12,7,5
53970,Kristenßell,senjin,669,warlock,destruction,12,7,5
53971,Otus,echo-isles,669,warlock,destruction,12,7,5
53972,Sumonníng,tichondrius,669,warlock,destruction,18,7,11
53973,Esmaldo,tichondrius,669,warlock,destruction,19,7,12
53974,Llu,tichondrius,668,warlock,destruction,12,7,5
53975,Sneakywarlok,dalaran,668,warlock,destruction,19,7,12
53976,Anahaldever,fenris,667,warlock,destruction,12,7,5
53977,Deathjerky,thrall,667,warlock,destruction,12,7,5
53978,Xargeras,emerald-dream,667,warlock,destruction,18,7,11
53979,Nicestrike,barthilas,666,warlock,destruction,12,7,5
53980,Markov,goldrinn,666,warlock,destruction,30,7,23
53981,Giiada,korgath,665,warlock,destruction,15,8,7
53982,Fartonomus,illidan,658,warlock,destruction,18,7,11
53983,Saltboi,azjolnerub,640,warlock,destruction,16,7,9
53984,Truffleseed,tichondrius,640,warlock,destruction,16,7,9
53985,Felse,stormrage,640,warlock,destruction,22,7,15
53986,Voidxx,tichondrius,639,warlock,destruction,11,7,4
53987,Greenwarlock,bleeding-hollow,639,warlock,destruction,14,8,6
53988,Demondan,magtheridon,638,warlock,destruction,23,7,16
53989,Hateslocks,bladefist,637,warlock,destruction,22,7,15
53990,Pandemone,proudmoore,624,warlock,destruction,15,7,8
53991,Seregå,skywall,623,warlock,destruction,11,7,4
53992,Conboee,tichondrius,623,warlock,destruction,11,7,4
53993,Cassetes,tichondrius,622,warlock,destruction,11,7,4
53994,Helpimdýing,sargeras,622,warlock,destruction,21,7,14
53995,Ashdan,area-52,621,warlock,destruction,17,7,10
53996,Ganondolph,sargeras,618,warlock,destruction,15,8,7
53997,Lazzarros,area-52,618,warlock,destruction,22,8,14
53998,Pontoontim,mugthol,617,warlock,destruction,20,8,12
53999,Fancynuts,kiljaeden,607,warlock,destruction,11,7,4
54000,Perfsx,bleeding-hollow,607,warlock,destruction,14,7,7
54001,Furrlokc,tichondrius,607,warlock,destruction,16,7,9
54002,Prahvstein,shuhalo,602,warlock,destruction,14,7,7
54003,Studathlete,tichondrius,592,warlock,destruction,13,7,6
54004,Pandemik,turalyon,591,warlock,destruction,11,8,3
54005,Freyanna,moon-guard,588,warlock,destruction,19,7,12
54006,Jblock,zuljin,576,warlock,destruction,6,6,0
54007,Damn,stormreaver,576,warlock,destruction,6,6,0
54008,Raghnor,illidan,576,warlock,destruction,6,6,0
54009,Gretlock,emerald-dream,576,warlock,destruction,6,6,0
54010,Fears,norgannon,576,warlock,destruction,6,6,0
54011,Lockoutz,illidan,576,warlock,destruction,6,6,0
54012,Baiw,tichondrius,576,warlock,destruction,6,6,0
54013,Winipuhmalo,quelthalas,576,warlock,destruction,6,6,0
54014,Magik,balnazzar,576,warlock,destruction,6,6,0
54015,Baconmuffin,tichondrius,576,warlock,destruction,6,6,0
54016,Dancedark,tichondrius,576,warlock,destruction,6,6,0
54017,Mitchosx,frostmourne,576,warlock,destruction,6,6,0
54018,Usainboltzz,kelthuzad,576,warlock,destruction,6,6,0
54019,Gabbagoul,sargeras,576,warlock,destruction,6,6,0
54020,Guitarpick,kelthuzad,576,warlock,destruction,6,6,0
54021,Yzqer,stormrage,576,warlock,destruction,6,6,0
54022,Hypexis,area-52,576,warlock,destruction,6,6,0
54023,Lockhippo,illidan,576,warlock,destruction,6,6,0
54024,Bivvix,malganis,576,warlock,destruction,6,6,0
54025,Impbisqit,stormrage,576,warlock,destruction,6,6,0
54026,Malevolent,velen,576,warlock,destruction,6,6,0
54027,Alexiosy,area-52,576,warlock,destruction,6,6,0
54028,Kòngal,tichondrius,576,warlock,destruction,6,6,0
54029,Schrader,sargeras,576,warlock,destruction,6,6,0
54030,Menggoth,tichondrius,576,warlock,destruction,6,6,0
54031,Paratex,thrall,576,warlock,destruction,6,6,0
54032,Paddywacker,azgalor,576,warlock,destruction,6,6,0
54033,Notstingz,azralon,576,warlock,destruction,6,6,0
54034,Deliverances,kelthuzad,576,warlock,destruction,9,7,2
54035,Crewee,tichondrius,576,warlock,destruction,9,6,3
54036,Broovid,tichondrius,576,warlock,destruction,13,7,6
54037,Kerës,sargeras,576,warlock,destruction,12,6,6
54038,Maèlstrom,area-52,576,warlock,destruction,12,6,6
54039,Ðáyshéll,kelthuzad,576,warlock,destruction,12,6,6
54040,Athronak,malganis,576,warlock,destruction,12,6,6
54041,Beamin,dentarg,576,warlock,destruction,12,6,6
54042,Zedonius,dragonmaw,576,warlock,destruction,12,6,6
54043,Vravras,kelthuzad,576,warlock,destruction,12,6,6
54044,Chipt,kelthuzad,576,warlock,destruction,12,6,6
54045,Zephidel,thrall,576,warlock,destruction,12,6,6
54046,Sumrule,dreadmaul,576,warlock,destruction,12,6,6
54047,Gagitha,black-dragonflight,576,warlock,destruction,12,6,6
54048,Riskydemon,azralon,576,warlock,destruction,12,6,6
54049,Porsimorgis,firetree,576,warlock,destruction,12,6,6
54050,Lüçian,ragnaros,576,warlock,destruction,12,6,6
54051,Kreemy,ysera,576,warlock,destruction,12,6,6
54052,Cunalia,sargeras,576,warlock,destruction,12,6,6
54053,Beerbolt,dalaran,576,warlock,destruction,12,6,6
54054,Sn,dalaran,576,warlock,destruction,12,6,6
54055,Salentsia,malganis,576,warlock,destruction,12,6,6
54056,Chabolt,tichondrius,576,warlock,destruction,12,6,6
54057,Imortalchaos,dentarg,576,warlock,destruction,12,6,6
54058,Innerforce,tichondrius,576,warlock,destruction,12,6,6
54059,Massivebolts,area-52,576,warlock,destruction,12,6,6
54060,Charmandfarm,nerzhul,576,warlock,destruction,12,6,6
54061,Velvalla,chogall,576,warlock,destruction,12,6,6
54062,Tlock,azjolnerub,576,warlock,destruction,12,6,6
54063,Zeromech,sargeras,576,warlock,destruction,12,6,6
54064,Imbadatpvp,tichondrius,576,warlock,destruction,12,6,6
54065,Graingrippin,malganis,576,warlock,destruction,12,6,6
54066,Kmüz,drakkari,576,warlock,destruction,12,6,6
54067,Tomato,azjolnerub,576,warlock,destruction,12,6,6
54068,Eboknight,area-52,576,warlock,destruction,12,6,6
54069,Bolèyn,moon-guard,576,warlock,destruction,12,6,6
54070,Smashfacelck,tichondrius,576,warlock,destruction,12,6,6
54071,Lockmeupuwu,malganis,576,warlock,destruction,12,6,6
54072,Emptysoul,illidan,576,warlock,destruction,12,6,6
54073,Lucíela,ragnaros,576,warlock,destruction,12,6,6
54074,Hiro,steamwheedle-cartel,576,warlock,destruction,12,6,6
54075,Cosmosxi,illidan,576,warlock,destruction,12,6,6
54076,Lri,frostmourne,576,warlock,destruction,12,6,6
54077,Aikus,quelthalas,576,warlock,destruction,12,6,6
54078,Pavél,ragnaros,576,warlock,destruction,12,6,6
54079,Ryzhen,area-52,576,warlock,destruction,12,6,6
54080,Iemonv,vashj,576,warlock,destruction,12,6,6
54081,Bhris,wildhammer,576,warlock,destruction,12,6,6
54082,Nutgobblerxo,sargeras,576,warlock,destruction,12,6,6
54083,Doomhauzer,kiljaeden,576,warlock,destruction,12,6,6
54084,Gengar,dalaran,576,warlock,destruction,12,6,6
54085,Ritua,dragonmaw,576,warlock,destruction,12,6,6
54086,Viejita,quelthalas,576,warlock,destruction,12,6,6
54087,Sadist,area-52,576,warlock,destruction,12,6,6
54088,Geegas,malganis,576,warlock,destruction,12,6,6
54089,Coffeezx,malganis,576,warlock,destruction,12,6,6
54090,Wrongname,hakkar,576,warlock,destruction,12,6,6
54091,Kulgar,aerie-peak,576,warlock,destruction,12,6,6
54092,Souldrain,malganis,576,warlock,destruction,12,6,6
54093,Adøràßøltz,tichondrius,576,warlock,destruction,12,6,6
54094,Girthlock,tichondrius,576,warlock,destruction,12,6,6
54095,Shigero,tichondrius,576,warlock,destruction,12,6,6
54096,Flu,darkspear,576,warlock,destruction,12,6,6
54097,Ïmpdance,tichondrius,576,warlock,destruction,12,6,6
54098,Ronnietherat,tichondrius,576,warlock,destruction,12,6,6
54099,Jessewheels,tichondrius,576,warlock,destruction,12,6,6
54100,Lambe,tichondrius,576,warlock,destruction,12,6,6
54101,Justignoreme,tichondrius,576,warlock,destruction,12,6,6
54102,Chaosboltss,tichondrius,576,warlock,destruction,12,6,6
54103,Limeriax,emerald-dream,576,warlock,destruction,12,6,6
54104,Vietoutlaw,bronzebeard,576,warlock,destruction,12,6,6
54105,Tinked,stormrage,576,warlock,destruction,12,6,6
54106,Quadrillion,stormrage,576,warlock,destruction,12,6,6
54107,Huajianmanwu,tichondrius,576,warlock,destruction,12,6,6
54108,Srcorvo,azralon,576,warlock,destruction,12,6,6
54109,Andrewpg,zuljin,576,warlock,destruction,12,6,6
54110,Crimsonela,emerald-dream,576,warlock,destruction,12,6,6
54111,Betrili,tichondrius,576,warlock,destruction,12,6,6
54112,Kentus,moonrunner,576,warlock,destruction,12,6,6
54113,Gagh,tichondrius,576,warlock,destruction,12,6,6
54114,Legallydan,tichondrius,576,warlock,destruction,12,6,6
54115,Tonifortnite,emerald-dream,576,warlock,destruction,12,6,6
54116,Pepperbolt,emerald-dream,576,warlock,destruction,12,6,6
54117,Manalis,zuljin,576,warlock,destruction,12,6,6
54118,Baconmarty,emerald-dream,576,warlock,destruction,12,6,6
54119,Gibkii,tichondrius,576,warlock,destruction,15,7,8
54120,Ellipsispain,bleeding-hollow,576,warlock,destruction,13,6,7
54121,Marinw,azralon,576,warlock,destruction,16,7,9
54122,Indrah,tichondrius,576,warlock,destruction,14,6,8
54123,Møs,proudmoore,576,warlock,destruction,18,6,12
54124,Wzrdtrx,deathwing,576,warlock,destruction,18,6,12
54125,Tenletters,kirin-tor,576,warlock,destruction,18,6,12
54126,Plutheros,stormrage,576,warlock,destruction,18,6,12
54127,Esoteríc,sargeras,576,warlock,destruction,18,6,12
54128,Jinxdacat,shandris,576,warlock,destruction,18,6,12
54129,Lõck,tichondrius,576,warlock,destruction,18,6,12
54130,Tharax,moon-guard,576,warlock,destruction,18,6,12
54131,Lenestus,stormrage,576,warlock,destruction,18,6,12
54132,Klisman,azralon,576,warlock,destruction,18,6,12
54133,Coviddotsrot,sargeras,576,warlock,destruction,18,6,12
54134,Familjia,nagrand,576,warlock,destruction,18,6,12
54135,Bêlthazor,kelthuzad,576,warlock,destruction,18,6,12
54136,Berszerk,quelthalas,576,warlock,destruction,18,6,12
54137,Lamdyn,moon-guard,576,warlock,destruction,18,6,12
54138,Kkuldan,tichondrius,576,warlock,destruction,24,6,18
54139,Muldan,stormrage,575,warlock,destruction,6,6,0
54140,Rosebolt,nemesis,575,warlock,destruction,6,6,0
54141,Drlocktastic,vashj,575,warlock,destruction,6,6,0
54142,Spamfearftw,sargeras,575,warlock,destruction,6,6,0
54143,Gauul,illidan,575,warlock,destruction,12,6,6
54144,Feldubya,illidan,575,warlock,destruction,12,6,6
54145,Deathage,crushridge,575,warlock,destruction,12,6,6
54146,Ifeludead,sargeras,575,warlock,destruction,12,6,6
54147,Williwallace,stormrage,575,warlock,destruction,12,6,6
54148,Méhoe,bleeding-hollow,575,warlock,destruction,12,6,6
54149,Rathianna,sargeras,575,warlock,destruction,12,6,6
54150,Naparima,stormreaver,575,warlock,destruction,12,6,6
54151,Mium,bronzebeard,575,warlock,destruction,12,6,6
54152,Baphomët,tichondrius,575,warlock,destruction,12,6,6
54153,Edielyth,proudmoore,575,warlock,destruction,12,6,6
54154,Crankshaft,nordrassil,575,warlock,destruction,12,6,6
54155,Lockswagger,stormrage,575,warlock,destruction,12,6,6
54156,Daimon,kaelthas,575,warlock,destruction,12,6,6
54157,Pactman,sargeras,575,warlock,destruction,12,6,6
54158,Cheekzz,illidan,575,warlock,destruction,12,6,6
54159,Kdoggydogg,azshara,575,warlock,destruction,12,6,6
54160,Mastroguise,illidan,575,warlock,destruction,15,6,9
54161,Leno,twisting-nether,575,warlock,destruction,18,6,12
54162,Oluluo,andorhal,575,warlock,destruction,18,6,12
54163,Yetiaids,tichondrius,575,warlock,destruction,18,6,12
54164,Selitose,illidan,575,warlock,destruction,18,6,12
54165,Ëliphas,tichondrius,575,warlock,destruction,24,6,18
54166,Trayga,illidan,574,warlock,destruction,6,6,0
54167,Tesdeez,tichondrius,574,warlock,destruction,12,6,6
54168,Kronman,zuluhed,574,warlock,destruction,12,6,6
54169,Ggumx,tichondrius,574,warlock,destruction,12,6,6
54170,Persephoné,blackrock,574,warlock,destruction,12,6,6
54171,Hungovermate,barthilas,574,warlock,destruction,12,6,6
54172,Anúbis,farstriders,574,warlock,destruction,18,6,12
54173,Träzyn,kiljaeden,574,warlock,destruction,18,6,12
54174,Zahba,stormrage,572,warlock,destruction,12,6,6
54175,Supercracker,bleeding-hollow,572,warlock,destruction,18,6,12
54176,Chewpawcabra,tichondrius,569,warlock,destruction,17,8,9
54177,Rôver,crushridge,568,warlock,destruction,12,6,6
54178,Expiredonion,bleeding-hollow,559,warlock,destruction,11,6,5
54179,Friend,frostmourne,559,warlock,destruction,17,6,11
54180,Mìrä,kelthuzad,558,warlock,destruction,17,6,11
54181,Märshall,quelthalas,543,warlock,destruction,10,7,3
54182,Aoepump,tichondrius,543,warlock,destruction,12,6,6
54183,Promancer,drakkari,528,warlock,destruction,9,6,3
54184,Loch,destromath,527,warlock,destruction,11,6,5
54185,Exillis,barthilas,527,warlock,destruction,17,6,11
54186,Ebo,bloodscalp,527,warlock,destruction,21,6,15
54187,Tangslock,skullcrusher,526,warlock,destruction,17,6,11
54188,Catraca,sargeras,524,warlock,destruction,15,7,8
54189,Tesowenn,tichondrius,522,warlock,destruction,15,7,8
54190,Marty,stormrage,522,warlock,destruction,15,7,8
54191,Dotznfearz,zuljin,521,warlock,destruction,16,8,8
54192,Redmil,quelthalas,520,warlock,destruction,35,7,28
54193,Locdup,sargeras,512,warlock,destruction,22,6,16
54194,Cs,icecrown,511,warlock,destruction,9,7,2
54195,Lunazz,tichondrius,511,warlock,destruction,11,7,4
54196,Dixynormis,zuljin,510,warlock,destruction,11,6,5
54197,Ràistlin,madoran,494,warlock,destruction,11,6,5
54198,Leîa,tichondrius,480,warlock,destruction,6,5,1
54199,Onidium,area-52,480,warlock,destruction,6,5,1
54200,Vuittøn,barthilas,480,warlock,destruction,6,5,1
54201,Babyvet,stormreaver,480,warlock,destruction,6,5,1
54202,Mørøs,tichondrius,480,warlock,destruction,6,5,1
54203,Unicornspit,tichondrius,480,warlock,destruction,6,5,1
54204,Johndazombie,zuljin,480,warlock,destruction,6,5,1
54205,Jalean,illidan,480,warlock,destruction,6,5,1
54206,Patoquenz,azralon,480,warlock,destruction,6,5,1
54207,Ohthemisery,sargeras,480,warlock,destruction,6,5,1
54208,Akudama,dalaran,480,warlock,destruction,6,5,1
54209,Wakøzi,mugthol,480,warlock,destruction,6,5,1
54210,Kopium,tichondrius,480,warlock,destruction,6,5,1
54211,Theovohn,thrall,480,warlock,destruction,6,5,1
54212,Frogdance,stormrage,480,warlock,destruction,6,5,1
54213,Paindge,senjin,480,warlock,destruction,6,5,1
54214,Púp,bleeding-hollow,480,warlock,destruction,6,5,1
54215,Ikite,zuljin,480,warlock,destruction,6,5,1
54216,Malékíth,ragnaros,480,warlock,destruction,6,5,1
54217,Oreganow,icecrown,480,warlock,destruction,6,5,1
54218,Zoljinn,frostwolf,480,warlock,destruction,6,5,1
54219,Evilforce,area-52,480,warlock,destruction,6,5,1
54220,Poonanifotm,gundrak,480,warlock,destruction,6,5,1
54221,Novah,balnazzar,480,warlock,destruction,6,5,1
54222,Yuckytoetoe,emerald-dream,480,warlock,destruction,6,5,1
54223,Yateshall,illidan,480,warlock,destruction,6,5,1
54224,Meddsurgx,emerald-dream,480,warlock,destruction,6,5,1
54225,Cloperry,area-52,480,warlock,destruction,6,5,1
54226,Efuc,tichondrius,480,warlock,destruction,6,5,1
54227,Panndadots,tichondrius,480,warlock,destruction,6,5,1
54228,Djae,frostmourne,480,warlock,destruction,6,5,1
54229,Awdam,tichondrius,480,warlock,destruction,6,5,1
54230,Pickles,kaelthas,480,warlock,destruction,6,5,1
54231,Nerflocks,azralon,480,warlock,destruction,6,5,1
54232,Chewybolt,illidan,480,warlock,destruction,6,5,1
54233,Cheesëbolt,illidan,480,warlock,destruction,6,5,1
54234,Destructium,stormrage,480,warlock,destruction,6,5,1
54235,Beranflakes,darkspear,480,warlock,destruction,6,5,1
54236,Geeßoogie,laughing-skull,480,warlock,destruction,6,5,1
54237,Ricemachinex,grizzly-hills,480,warlock,destruction,6,5,1
54238,Humblegodd,illidan,480,warlock,destruction,6,5,1
54239,Evierine,zuljin,480,warlock,destruction,6,5,1
54240,Khaozx,ragnaros,480,warlock,destruction,6,5,1
54241,Zerefel,stormrage,480,warlock,destruction,6,5,1
54242,Cuteasianpov,kiljaeden,480,warlock,destruction,6,5,1
54243,Phyxylock,stormrage,480,warlock,destruction,6,5,1
54244,Mathindis,ragnaros,480,warlock,destruction,6,5,1
54245,Cannaboltzz,icecrown,480,warlock,destruction,6,5,1
54246,Frylockx,mugthol,480,warlock,destruction,6,5,1
54247,Dingis,bloodscalp,480,warlock,destruction,6,5,1
54248,Popnloc,tichondrius,480,warlock,destruction,6,5,1
54249,Bâppo,antonidas,480,warlock,destruction,6,5,1
54250,Dippindotz,scilla,480,warlock,destruction,6,5,1
54251,Shortnproud,tichondrius,480,warlock,destruction,6,5,1
54252,Matdemonn,barthilas,480,warlock,destruction,6,5,1
54253,Arnan,korgath,480,warlock,destruction,6,5,1
54254,Foxbolt,tichondrius,480,warlock,destruction,6,5,1
54255,Kimchiblast,tichondrius,480,warlock,destruction,6,5,1
54256,Balencinaga,frostmourne,480,warlock,destruction,6,5,1
54257,Donutx,illidan,480,warlock,destruction,6,5,1
54258,Lucro,emerald-dream,480,warlock,destruction,6,5,1
54259,Pantubølt,stormrage,480,warlock,destruction,6,5,1
54260,Halftism,sargeras,480,warlock,destruction,6,5,1
54261,Salaszar,illidan,480,warlock,destruction,6,5,1
54262,Kargos,bonechewer,480,warlock,destruction,6,5,1
54263,Wartoyy,uldum,480,warlock,destruction,6,5,1
54264,Nutted,dentarg,480,warlock,destruction,6,5,1
54265,Zerocastspec,tichondrius,480,warlock,destruction,6,5,1
54266,Tiddliwinx,nordrassil,480,warlock,destruction,7,5,2
54267,Elementzero,malorne,480,warlock,destruction,11,5,6
54268,Chaoz,aggramar,480,warlock,destruction,12,5,7
54269,Eneraxg,proudmoore,480,warlock,destruction,12,5,7
54270,Pikvas,darkspear,480,warlock,destruction,12,5,7
54271,Nelamona,moon-guard,480,warlock,destruction,12,5,7
54272,Gruldan,drakkari,480,warlock,destruction,12,5,7
54273,Smokiilock,proudmoore,480,warlock,destruction,12,5,7
54274,Zalurk,emerald-dream,480,warlock,destruction,12,5,7
54275,Locknes,kiljaeden,480,warlock,destruction,12,5,7
54276,Warcrimes,silvermoon,480,warlock,destruction,12,5,7
54277,Dalanllan,wyrmrest-accord,480,warlock,destruction,12,5,7
54278,Gameface,garrosh,480,warlock,destruction,12,5,7
54279,Soulswap,deathwing,480,warlock,destruction,12,5,7
54280,Curaven,emerald-dream,480,warlock,destruction,12,5,7
54281,Yurick,frostmourne,480,warlock,destruction,12,5,7
54282,Seraphserius,laughing-skull,480,warlock,destruction,12,5,7
54283,Toxishk,tichondrius,480,warlock,destruction,12,5,7
54284,Gabagøøl,illidan,480,warlock,destruction,12,5,7
54285,Darezs,frostmourne,480,warlock,destruction,12,5,7
54286,Ascendant,amanthul,480,warlock,destruction,12,5,7
54287,Lockandload,malfurion,480,warlock,destruction,12,5,7
54288,Aurdra,thunderhorn,480,warlock,destruction,12,5,7
54289,Archleon,smolderthorn,480,warlock,destruction,12,5,7
54290,Virt,anubarak,480,warlock,destruction,12,5,7
54291,Cycaeria,moon-guard,480,warlock,destruction,12,5,7
54292,Qfear,tichondrius,480,warlock,destruction,12,5,7
54293,Hellweaver,amanthul,480,warlock,destruction,12,5,7
54294,Gallynna,moon-guard,480,warlock,destruction,12,5,7
54295,Imhereforrbg,moon-guard,480,warlock,destruction,12,5,7
54296,Gnimms,sargeras,480,warlock,destruction,12,5,7
54297,Jakd,frostmourne,480,warlock,destruction,12,5,7
54298,Vansa,caelestrasz,480,warlock,destruction,12,5,7
54299,Skirnir,tichondrius,480,warlock,destruction,12,5,7
54300,Hyjixy,stormrage,480,warlock,destruction,12,5,7
54301,Souljäboy,bleeding-hollow,480,warlock,destruction,12,5,7
54302,Halfmade,tichondrius,480,warlock,destruction,12,5,7
54303,Hoonjojjyanl,tichondrius,480,warlock,destruction,12,5,7
54304,Bludlock,illidan,480,warlock,destruction,12,5,7
54305,Psionyde,barthilas,480,warlock,destruction,12,5,7
54306,Geists,emerald-dream,480,warlock,destruction,12,5,7
54307,Richards,thrall,480,warlock,destruction,12,5,7
54308,Rytaint,emerald-dream,480,warlock,destruction,12,5,7
54309,Respecter,kelthuzad,480,warlock,destruction,12,5,7
54310,Actualjoke,frostmourne,480,warlock,destruction,12,5,7
54311,Lockmycawk,stormrage,480,warlock,destruction,12,5,7
54312,Daemonixx,vashj,480,warlock,destruction,12,5,7
54313,Pabloqlx,ragnaros,480,warlock,destruction,12,5,7
54314,Speakeasy,malygos,480,warlock,destruction,12,5,7
54315,Totsdots,blackrock,480,warlock,destruction,12,5,7
54316,Justganmore,tichondrius,480,warlock,destruction,12,5,7
54317,Topboypepito,tichondrius,480,warlock,destruction,12,5,7
54318,Balden,fenris,480,warlock,destruction,12,5,7
54319,Avoidahoe,sargeras,480,warlock,destruction,12,5,7
54320,Icemanliddel,area-52,480,warlock,destruction,12,5,7
54321,Wombogombo,malganis,480,warlock,destruction,12,5,7
54322,Darksdot,barthilas,480,warlock,destruction,12,5,7
54323,Shadowflame,skullcrusher,480,warlock,destruction,12,5,7
54324,Murphyslawl,skullcrusher,480,warlock,destruction,12,5,7
54325,Gundrillas,area-52,480,warlock,destruction,12,5,7
54326,Zugzor,shadowmoon,480,warlock,destruction,12,5,7
54327,Enforcer,hellscream,480,warlock,destruction,12,5,7
54328,Kubera,mannoroth,480,warlock,destruction,12,5,7
54329,Jankity,kelthuzad,480,warlock,destruction,12,5,7
54330,Bellgrande,shadowmoon,480,warlock,destruction,12,5,7
54331,Errogant,area-52,480,warlock,destruction,12,5,7
54332,Marbuldan,frostmourne,480,warlock,destruction,12,5,7
54333,Macnab,malganis,480,warlock,destruction,12,5,7
54334,Pveisboring,tichondrius,480,warlock,destruction,12,5,7
54335,Exitiumm,malygos,480,warlock,destruction,12,5,7
54336,Lockwell,tichondrius,480,warlock,destruction,12,5,7
54337,Lildottythot,malganis,480,warlock,destruction,12,5,7
54338,Galeirria,stormrage,480,warlock,destruction,12,5,7
54339,Dôkgo,tichondrius,480,warlock,destruction,12,5,7
54340,Myidas,quelthalas,480,warlock,destruction,12,5,7
54341,Arkangel,dalvengyr,480,warlock,destruction,12,5,7
54342,Jenová,uldaman,480,warlock,destruction,12,5,7
54343,Sukmalock,proudmoore,480,warlock,destruction,15,6,9
54344,Maarzil,malygos,480,warlock,destruction,16,6,10
54345,Vicnutz,tichondrius,480,warlock,destruction,18,5,13
54346,Ionithvia,tichondrius,480,warlock,destruction,18,5,13
54347,Crypticwl,proudmoore,480,warlock,destruction,24,5,19
54348,Yelabanxtown,thaurissan,479,warlock,destruction,6,5,1
54349,Skrillhex,dragonmaw,479,warlock,destruction,6,5,1
54350,Dipindottz,tichondrius,479,warlock,destruction,6,5,1
54351,Lockystar,malganis,479,warlock,destruction,6,5,1
54352,Clizarisa,moon-guard,479,warlock,destruction,6,5,1
54353,Osteogenesis,quelthalas,479,warlock,destruction,12,5,7
54354,Aluridan,azralon,479,warlock,destruction,12,5,7
54355,Grix,uldaman,479,warlock,destruction,12,5,7
54356,Vordz,amanthul,479,warlock,destruction,12,5,7
54357,Apothokary,stormrage,479,warlock,destruction,12,5,7
54358,Kelici,borean-tundra,479,warlock,destruction,12,5,7
54359,Loccdawg,laughing-skull,479,warlock,destruction,12,5,7
54360,Karkloc,stormrage,479,warlock,destruction,18,5,13
54361,Daemonddred,hakkar,479,warlock,destruction,18,5,13
54362,Moorrt,dragonblight,478,warlock,destruction,12,5,7
54363,Giled,runetotem,478,warlock,destruction,12,5,7
54364,Saintvil,drakkari,477,warlock,destruction,6,5,1
54365,Warrogoblin,ragnaros,476,warlock,destruction,9,6,3
54366,Blázê,illidan,476,warlock,destruction,12,5,7
54367,Raven,baelgun,463,warlock,destruction,11,5,6
54368,Anubís,vashj,462,warlock,destruction,11,5,6
54369,Bitblack,tichondrius,453,warlock,destruction,13,7,6
54370,Magniwl,zuljin,447,warlock,destruction,11,5,6
54371,Døtbomb,stormrage,447,warlock,destruction,11,5,6
54372,Theshattered,kiljaeden,447,warlock,destruction,11,5,6
54373,Britnyfears,korgath,447,warlock,destruction,16,5,11
54374,Djvetis,blackhand,442,warlock,destruction,15,7,8
54375,Fengfeiss,tichondrius,432,warlock,destruction,15,6,9
54376,Heizx,area-52,432,warlock,destruction,15,5,10
54377,Silverfire,ragnaros,431,warlock,destruction,11,5,6
54378,Berathelok,aerie-peak,426,warlock,destruction,17,6,11
54379,Empowerdlock,garrosh,416,warlock,destruction,10,5,5
54380,Velsona,moon-guard,415,warlock,destruction,14,5,9
54381,Dysxliea,dalaran,415,warlock,destruction,14,5,9
54382,Krozu,bleeding-hollow,415,warlock,destruction,14,5,9
54383,Lockdlhm,tichondrius,400,warlock,destruction,13,5,8
54384,ßenafflock,wyrmrest-accord,399,warlock,destruction,14,5,9
54385,Wiredftwx,illidan,384,warlock,destruction,6,4,2
54386,Sylvahh,sargeras,384,warlock,destruction,6,4,2
54387,Darkfæ,kaelthas,384,warlock,destruction,6,4,2
54388,Carielict,sargeras,384,warlock,destruction,6,4,2
54389,Zuroghar,azralon,384,warlock,destruction,6,4,2
54390,Sprenn,bleeding-hollow,384,warlock,destruction,6,4,2
54391,Necrotko,malganis,384,warlock,destruction,6,4,2
54392,Smnslock,emerald-dream,384,warlock,destruction,6,4,2
54393,Wrathfull,malganis,384,warlock,destruction,6,4,2
54394,Woofbolt,malganis,384,warlock,destruction,6,4,2
54395,Pegorn,illidan,384,warlock,destruction,6,4,2
54396,Rodneyjones,emerald-dream,384,warlock,destruction,6,4,2
54397,Warfeen,malganis,384,warlock,destruction,6,4,2
54398,Crackhammer,sargeras,384,warlock,destruction,6,4,2
54399,Quetzâlcoâtl,sargeras,384,warlock,destruction,6,4,2
54400,Zonss,tichondrius,384,warlock,destruction,6,4,2
54401,Demonchurch,area-52,384,warlock,destruction,6,4,2
54402,Gordoxin,area-52,384,warlock,destruction,6,4,2
54403,Ceeloww,illidan,384,warlock,destruction,6,4,2
54404,Apoklock,area-52,384,warlock,destruction,6,4,2
54405,Wallzz,gnomeregan,384,warlock,destruction,6,4,2
54406,Bertnasty,tichondrius,384,warlock,destruction,6,4,2
54407,Outkãst,illidan,384,warlock,destruction,6,4,2
54408,Asukakira,tichondrius,384,warlock,destruction,6,4,2
54409,Vilebrute,illidan,384,warlock,destruction,6,4,2
54410,Syraxi,illidan,384,warlock,destruction,6,4,2
54411,Biger,nemesis,384,warlock,destruction,6,4,2
54412,Hawtchili,illidan,384,warlock,destruction,6,4,2
54413,Eatmybeef,ravencrest,384,warlock,destruction,6,4,2
54414,Lazarùs,zuljin,384,warlock,destruction,6,4,2
54415,Fatuglyegirl,sargeras,384,warlock,destruction,6,4,2
54416,Lockiana,zuljin,384,warlock,destruction,6,4,2
54417,Alwysoom,aegwynn,384,warlock,destruction,6,4,2
54418,Ardamelech,quelthalas,384,warlock,destruction,6,4,2
54419,Mithlock,azralon,384,warlock,destruction,6,4,2
54420,Dematic,illidan,384,warlock,destruction,6,4,2
54421,Methrocks,emerald-dream,384,warlock,destruction,6,4,2
54422,Sakeer,quelthalas,384,warlock,destruction,6,4,2
54423,Marrowsipper,tichondrius,384,warlock,destruction,6,4,2
54424,Kractdlk,tichondrius,384,warlock,destruction,6,4,2
54425,Roota,dalaran,384,warlock,destruction,6,4,2
54426,Cursebolt,tichondrius,384,warlock,destruction,6,4,2
54427,Ozidus,tichondrius,384,warlock,destruction,6,4,2
54428,Gamenine,tichondrius,384,warlock,destruction,6,4,2
54429,Tumßle,stormreaver,384,warlock,destruction,6,4,2
54430,Oldgodkiller,kelthuzad,384,warlock,destruction,6,4,2
54431,Moramont,stormrage,384,warlock,destruction,6,4,2
54432,Chumbing,sargeras,384,warlock,destruction,6,4,2
54433,Anthaxel,dalaran,384,warlock,destruction,6,4,2
54434,Saitibolty,dalaran,384,warlock,destruction,6,4,2
54435,Rendori,the-scryers,384,warlock,destruction,6,4,2
54436,Mattybolts,tichondrius,384,warlock,destruction,6,4,2
54437,Evolda,tichondrius,384,warlock,destruction,6,4,2
54438,Moistpoodle,the-underbog,384,warlock,destruction,6,4,2
54439,Laytome,stormreaver,384,warlock,destruction,6,4,2
54440,Tizzy,malganis,384,warlock,destruction,6,4,2
54441,Slappndemons,mugthol,384,warlock,destruction,6,4,2
54442,Tichondrus,ragnaros,384,warlock,destruction,6,4,2
54443,Agla,quelthalas,384,warlock,destruction,6,4,2
54444,Asalaviik,illidan,384,warlock,destruction,6,4,2
54445,Zërlina,area-52,384,warlock,destruction,6,4,2
54446,Arckádia,stormrage,384,warlock,destruction,6,4,2
54447,Cønsfèáracy,sargeras,384,warlock,destruction,6,4,2
54448,Drgiggles,tichondrius,384,warlock,destruction,6,4,2
54449,Leyzer,stormrage,384,warlock,destruction,6,4,2
54450,Asiopdu,tichondrius,384,warlock,destruction,6,4,2
54451,Naginikill,zuljin,384,warlock,destruction,6,4,2
54452,Instababe,stormrage,384,warlock,destruction,6,4,2
54453,Gilfhunter,hellscream,384,warlock,destruction,6,4,2
54454,Dçíöçk,tichondrius,384,warlock,destruction,6,4,2
54455,Fearoshimá,thrall,384,warlock,destruction,6,4,2
54456,Warlocksz,kelthuzad,384,warlock,destruction,6,4,2
54457,Bugbugg,tichondrius,384,warlock,destruction,6,4,2
54458,Fyahwalka,aggramar,384,warlock,destruction,6,4,2
54459,Décalisse,eonar,384,warlock,destruction,6,4,2
54460,Zevoc,tichondrius,384,warlock,destruction,6,4,2
54461,Litemeatlary,kelthuzad,384,warlock,destruction,6,4,2
54462,Brokenaf,stormrage,384,warlock,destruction,6,4,2
54463,Sheetzlock,azgalor,384,warlock,destruction,6,4,2
54464,Fearann,ragnaros,384,warlock,destruction,6,4,2
54465,Incantation,moon-guard,384,warlock,destruction,6,4,2
54466,Mmrceo,azgalor,384,warlock,destruction,6,4,2
54467,Galtur,azralon,384,warlock,destruction,6,4,2
54468,Hoana,azralon,384,warlock,destruction,6,4,2
54469,Toomanymind,stormrage,384,warlock,destruction,6,4,2
54470,Flayaz,bleeding-hollow,384,warlock,destruction,6,4,2
54471,Espanol,magtheridon,384,warlock,destruction,6,4,2
54472,Antagony,bleeding-hollow,384,warlock,destruction,6,4,2
54473,Solöw,tichondrius,384,warlock,destruction,6,4,2
54474,Norastrum,area-52,384,warlock,destruction,6,4,2
54475,Stambye,ragnaros,384,warlock,destruction,6,4,2
54476,Smallj,zuljin,384,warlock,destruction,6,4,2
54477,Xijp,illidan,384,warlock,destruction,6,4,2
54478,Thelynx,chogall,384,warlock,destruction,6,4,2
54479,Frem,eonar,384,warlock,destruction,6,4,2
54480,Donttouchme,azralon,384,warlock,destruction,6,4,2
54481,Fatherbolt,tichondrius,384,warlock,destruction,6,4,2
54482,Bedtimes,tichondrius,384,warlock,destruction,6,4,2
54483,Dottcom,laughing-skull,384,warlock,destruction,6,4,2
54484,Magvezx,kelthuzad,384,warlock,destruction,6,4,2
54485,Deathtones,moon-guard,384,warlock,destruction,6,4,2
54486,Doubledigit,tichondrius,384,warlock,destruction,6,4,2
54487,Calcadius,zuljin,384,warlock,destruction,6,4,2
54488,Kroshuto,ragnaros,384,warlock,destruction,6,4,2
54489,Lîlý,bleeding-hollow,384,warlock,destruction,6,4,2
54490,Gamecover,azralon,384,warlock,destruction,6,4,2
54491,Pokendot,illidan,384,warlock,destruction,6,4,2
54492,Wreckquiem,burning-blade,384,warlock,destruction,6,4,2
54493,Khaos,norgannon,384,warlock,destruction,6,4,2
54494,Erock,korgath,384,warlock,destruction,6,4,2
54495,Underchicken,blackrock,384,warlock,destruction,6,4,2
54496,Darkguile,kiljaeden,384,warlock,destruction,6,4,2
54497,Kerrigan,the-venture-co,384,warlock,destruction,6,4,2
54498,Damienn,wyrmrest-accord,384,warlock,destruction,6,4,2
54499,Siltharious,senjin,384,warlock,destruction,6,4,2
54500,Leekeeaynis,frostmourne,384,warlock,destruction,6,4,2
54501,Charognart,lightninghoof,384,warlock,destruction,6,4,2
54502,Ñever,winterhoof,384,warlock,destruction,6,4,2
54503,Vaynnei,kiljaeden,384,warlock,destruction,6,4,2
54504,Menedemus,amanthul,384,warlock,destruction,6,4,2
54505,Buccs,barthilas,384,warlock,destruction,6,4,2
54506,Jerothia,lethon,384,warlock,destruction,6,4,2
54507,Clamdischarg,frostmourne,384,warlock,destruction,6,4,2
54508,Eliquis,frostmane,384,warlock,destruction,6,4,2
54509,Souwantwar,kiljaeden,384,warlock,destruction,6,4,2
54510,Deathboltx,zuljin,384,warlock,destruction,9,5,4
54511,Meathat,gorefiend,384,warlock,destruction,9,5,4
54512,Soulfired,kiljaeden,384,warlock,destruction,11,5,6
54513,Rhaègar,kiljaeden,384,warlock,destruction,15,5,10
54514,Fullmelt,azjolnerub,384,warlock,destruction,12,4,8
54515,Medraut,wyrmrest-accord,384,warlock,destruction,12,4,8
54516,Offendor,stormrage,384,warlock,destruction,12,4,8
54517,Blumercricet,stormrage,384,warlock,destruction,12,4,8
54518,Demowolock,area-52,384,warlock,destruction,12,4,8
54519,Veyra,malganis,384,warlock,destruction,12,4,8
54520,Darksòúl,stormrage,384,warlock,destruction,12,4,8
54521,Poisondeepnu,malganis,384,warlock,destruction,12,4,8
54522,Bjarke,malganis,384,warlock,destruction,12,4,8
54523,Crafterism,barthilas,384,warlock,destruction,12,4,8
54524,Kelthutard,area-52,384,warlock,destruction,12,4,8
54525,Madamenapalm,wyrmrest-accord,384,warlock,destruction,12,4,8
54526,Dotington,frostmourne,384,warlock,destruction,12,4,8
54527,Lockandestro,tichondrius,384,warlock,destruction,12,4,8
54528,Catastrophk,malganis,384,warlock,destruction,12,4,8
54529,Mostlyundead,darkspear,384,warlock,destruction,12,4,8
54530,Nintendøt,malganis,384,warlock,destruction,12,4,8
54531,Nazrakin,malganis,384,warlock,destruction,12,4,8
54532,Snailbite,tichondrius,384,warlock,destruction,12,4,8
54533,Daedayus,frostwolf,384,warlock,destruction,12,4,8
54534,Capïrota,nemesis,384,warlock,destruction,12,4,8
54535,Greenbolts,area-52,384,warlock,destruction,12,4,8
54536,Sailuhh,frostwolf,384,warlock,destruction,12,4,8
54537,Jxstinl,tichondrius,384,warlock,destruction,12,4,8
54538,Letsfckingo,tichondrius,384,warlock,destruction,12,4,8
54539,Freezâ,stormrage,384,warlock,destruction,12,4,8
54540,Panicmode,darkspear,384,warlock,destruction,12,4,8
54541,Perfidien,tichondrius,384,warlock,destruction,12,4,8
54542,Stonelocke,area-52,384,warlock,destruction,12,4,8
54543,Fowll,frostwolf,384,warlock,destruction,12,4,8
54544,Lila,kaelthas,384,warlock,destruction,12,4,8
54545,Lockeando,ragnaros,384,warlock,destruction,12,4,8
54546,Mokushiroku,trollbane,384,warlock,destruction,12,4,8
54547,Kholdstarev,thunderlord,384,warlock,destruction,12,4,8
54548,Puddulz,thrall,384,warlock,destruction,12,4,8
54549,Alexmeister,jubeithos,384,warlock,destruction,12,4,8
54550,Evarona,gorefiend,384,warlock,destruction,12,4,8
54551,Jáws,zuljin,384,warlock,destruction,12,4,8
54552,Pitou,akama,384,warlock,destruction,12,4,8
54553,Antigotenent,sargeras,384,warlock,destruction,12,4,8
54554,Dotsamoray,frostmourne,384,warlock,destruction,12,4,8
54555,Aededa,proudmoore,384,warlock,destruction,12,4,8
54556,Persianloc,tichondrius,384,warlock,destruction,12,4,8
54557,Awangdemon,tichondrius,384,warlock,destruction,12,4,8
54558,Capslockfury,frostmourne,384,warlock,destruction,12,4,8
54559,Speedlock,daggerspine,384,warlock,destruction,12,4,8
54560,Maleficist,bleeding-hollow,384,warlock,destruction,12,4,8
54561,Overlard,illidan,384,warlock,destruction,12,4,8
54562,Flocka,agamaggan,384,warlock,destruction,12,4,8
54563,Malavik,moon-guard,384,warlock,destruction,12,4,8
54564,Syileria,frostmourne,384,warlock,destruction,12,4,8
54565,Dpz,darkspear,384,warlock,destruction,12,4,8
54566,Stepmommie,moon-guard,384,warlock,destruction,12,4,8
54567,Giggideez,bleeding-hollow,384,warlock,destruction,12,4,8
54568,Rumpology,illidan,384,warlock,destruction,12,4,8
54569,Praemonium,dalaran,384,warlock,destruction,12,4,8
54570,Twospliff,sargeras,384,warlock,destruction,16,5,11
54571,Mozbet,kiljaeden,384,warlock,destruction,13,4,9
54572,Pvman,onyxia,384,warlock,destruction,18,4,14
54573,Destroyaz,stormreaver,383,warlock,destruction,6,4,2
54574,Pointproven,tichondrius,383,warlock,destruction,6,4,2
54575,Stonelocker,stormrage,383,warlock,destruction,6,4,2
54576,Fëâr,trollbane,383,warlock,destruction,6,4,2
54577,Halkroz,nathrezim,383,warlock,destruction,6,4,2
54578,Gorski,frostwolf,383,warlock,destruction,6,4,2
54579,Gängrëna,azralon,383,warlock,destruction,12,4,8
54580,Asheräh,stormrage,383,warlock,destruction,12,4,8
54581,Eliphas,bronzebeard,383,warlock,destruction,12,4,8
54582,Loçkshow,hyjal,383,warlock,destruction,12,4,8
54583,Fearanddots,moon-guard,383,warlock,destruction,12,4,8
54584,Coheatt,hyjal,383,warlock,destruction,12,4,8
54585,Arthürr,thrall,383,warlock,destruction,12,4,8
54586,Downing,drakkari,383,warlock,destruction,12,4,8
54587,Albuuss,daggerspine,383,warlock,destruction,12,4,8
54588,Covidbussin,cenarius,383,warlock,destruction,12,4,8
54589,Trilleon,eldrethalas,383,warlock,destruction,12,4,8
54590,Yesmistress,thrall,383,warlock,destruction,14,4,10
54591,Necromaniac,nerzhul,383,warlock,destruction,18,4,14
54592,Mageline,thrall,382,warlock,destruction,18,4,14
54593,Sargrath,ragnaros,381,warlock,destruction,12,4,8
54594,Ðêcimatê,frostmourne,361,warlock,destruction,12,6,6
54595,Plaguelnc,illidan,352,warlock,destruction,10,5,5
54596,Startx,tichondrius,351,warlock,destruction,11,4,7
54597,Voodoowan,bleeding-hollow,351,warlock,destruction,11,4,7
54598,Vanvídd,ragnaros,351,warlock,destruction,11,4,7
54599,Vetic,area-52,351,warlock,destruction,11,4,7
54600,Cyrillus,moon-guard,351,warlock,destruction,11,4,7
54601,Auntzhang,tichondrius,351,warlock,destruction,23,4,19
54602,Gobbledeez,moknathal,349,warlock,destruction,19,5,14
54603,Kidneystone,emerald-dream,346,warlock,destruction,17,8,9
54604,Amaroth,spinebreaker,335,warlock,destruction,11,4,7
54605,Sooshi,malganis,330,warlock,destruction,11,6,5
54606,Lockazo,quelthalas,330,warlock,destruction,11,6,5
54607,Casusita,area-52,322,warlock,destruction,16,6,10
54608,Sojulord,sargeras,320,warlock,destruction,10,4,6
54609,Nozixx,thrall,320,warlock,destruction,16,4,12
54610,Saintläurent,bleeding-hollow,319,warlock,destruction,5,4,1
54611,Valkynaris,chogall,319,warlock,destruction,14,4,10
54612,Nòpê,tichondrius,288,warlock,destruction,6,3,3
54613,Geofar,bleeding-hollow,288,warlock,destruction,6,3,3
54614,Shädowflame,bleeding-hollow,288,warlock,destruction,6,3,3
54615,Reallygud,tichondrius,288,warlock,destruction,6,3,3
54616,Uncann,bleeding-hollow,288,warlock,destruction,6,3,3
54617,Demtros,tichondrius,288,warlock,destruction,6,3,3
54618,Oleg,bleeding-hollow,288,warlock,destruction,6,3,3
54619,Mystrix,illidan,288,warlock,destruction,6,3,3
54620,Jangbii,tichondrius,288,warlock,destruction,6,3,3
54621,Chaosßolts,illidan,288,warlock,destruction,6,3,3
54622,Minos,tichondrius,288,warlock,destruction,6,3,3
54623,Kiami,destromath,288,warlock,destruction,6,3,3
54624,ßolts,frostmourne,288,warlock,destruction,6,3,3
54625,Dashaad,illidan,288,warlock,destruction,6,3,3
54626,Dohmie,argent-dawn,288,warlock,destruction,6,3,3
54627,Rexington,hyjal,288,warlock,destruction,6,3,3
54628,Marothredd,nathrezim,288,warlock,destruction,6,3,3
54629,Xoroth,crushridge,288,warlock,destruction,6,3,3
54630,Skýnët,tichondrius,288,warlock,destruction,6,3,3
54631,Weaselherder,illidan,288,warlock,destruction,6,3,3
54632,Papablasty,nagrand,288,warlock,destruction,6,3,3
54633,Anastadora,proudmoore,288,warlock,destruction,6,3,3
54634,Ratedtorgast,illidan,288,warlock,destruction,6,3,3
54635,Feeltheviibe,zuljin,288,warlock,destruction,6,3,3
54636,Sàill,tichondrius,288,warlock,destruction,6,3,3
54637,Famouslos,anetheron,288,warlock,destruction,6,3,3
54638,Begelock,illidan,288,warlock,destruction,6,3,3
54639,Bunami,kiljaeden,288,warlock,destruction,6,3,3
54640,Meltingface,bleeding-hollow,288,warlock,destruction,6,3,3
54641,Karter,anetheron,288,warlock,destruction,6,3,3
54642,Felsgoodman,illidan,288,warlock,destruction,6,3,3
54643,Noslock,aegwynn,288,warlock,destruction,6,3,3
54644,Conboi,tichondrius,288,warlock,destruction,6,3,3
54645,Jishtructo,frostmourne,288,warlock,destruction,6,3,3
54646,Thelock,tichondrius,288,warlock,destruction,6,3,3
54647,Worstname,hakkar,288,warlock,destruction,6,3,3
54648,Gümbÿ,illidan,288,warlock,destruction,6,3,3
54649,Tiptonb,tichondrius,288,warlock,destruction,6,3,3
54650,Massta,tichondrius,288,warlock,destruction,6,3,3
54651,Xocxusegeic,illidan,288,warlock,destruction,6,3,3
54652,Amuros,illidan,288,warlock,destruction,6,3,3
54653,Drelgun,aerie-peak,288,warlock,destruction,6,3,3
54654,Gurlock,illidan,288,warlock,destruction,6,3,3
54655,Voldamorte,tichondrius,288,warlock,destruction,6,3,3
54656,Gotfear,zuljin,288,warlock,destruction,6,3,3
54657,Jaazmin,ragnaros,288,warlock,destruction,6,3,3
54658,Æsidius,tichondrius,288,warlock,destruction,6,3,3
54659,Râsh,tichondrius,288,warlock,destruction,6,3,3
54660,Sweetjezuz,barthilas,288,warlock,destruction,6,3,3
54661,Nbayoungbolt,altar-of-storms,288,warlock,destruction,6,3,3
54662,Unquit,frostmourne,288,warlock,destruction,6,3,3
54663,Borudo,thrall,288,warlock,destruction,6,3,3
54664,Signalnine,thrall,288,warlock,destruction,6,3,3
54665,Shawzyy,tichondrius,288,warlock,destruction,6,3,3
54666,Nihilus,anvilmar,288,warlock,destruction,6,3,3
54667,Bonermarrow,tichondrius,288,warlock,destruction,6,3,3
54668,Lockabeesha,chogall,288,warlock,destruction,6,3,3
54669,Atheô,ragnaros,288,warlock,destruction,6,3,3
54670,Hëctic,nerzhul,288,warlock,destruction,6,3,3
54671,Vetadul,proudmoore,288,warlock,destruction,6,3,3
54672,Eiram,ragnaros,288,warlock,destruction,6,3,3
54673,Eh,laughing-skull,288,warlock,destruction,6,3,3
54674,Nismo,trollbane,288,warlock,destruction,6,3,3
54675,Deejaye,frostmourne,288,warlock,destruction,6,3,3
54676,Muchopower,ragnaros,288,warlock,destruction,6,3,3
54677,Ladaa,tichondrius,288,warlock,destruction,6,3,3
54678,Ragnorök,medivh,288,warlock,destruction,6,3,3
54679,Neversoft,bleeding-hollow,288,warlock,destruction,6,3,3
54680,Souldotz,proudmoore,288,warlock,destruction,6,3,3
54681,Slothdots,tichondrius,288,warlock,destruction,6,3,3
54682,Feardr,frostmourne,288,warlock,destruction,6,3,3
54683,Coret,moonrunner,288,warlock,destruction,6,3,3
54684,Toastyybone,hellscream,288,warlock,destruction,6,3,3
54685,Ökïlôck,proudmoore,288,warlock,destruction,6,3,3
54686,Bléssédx,tichondrius,288,warlock,destruction,6,3,3
54687,Blastindotz,frostmane,288,warlock,destruction,6,3,3
54688,Aruotnof,nemesis,288,warlock,destruction,6,3,3
54689,Xbendover,proudmoore,288,warlock,destruction,6,3,3
54690,Cleptomain,tichondrius,288,warlock,destruction,6,3,3
54691,Bazeni,frostmourne,288,warlock,destruction,6,3,3
54692,Xblessed,stormrage,288,warlock,destruction,6,3,3
54693,Krazyjay,bleeding-hollow,288,warlock,destruction,6,3,3
54694,Astarothe,proudmoore,288,warlock,destruction,6,3,3
54695,Pennydrop,barthilas,288,warlock,destruction,6,3,3
54696,Cocoabuttâ,stormrage,288,warlock,destruction,6,3,3
54697,Carpedemon,malganis,288,warlock,destruction,6,3,3
54698,Hamdulla,tichondrius,288,warlock,destruction,6,3,3
54699,Warlockluo,tichondrius,288,warlock,destruction,6,3,3
54700,Peterdotz,whisperwind,288,warlock,destruction,6,3,3
54701,Maledictivus,stormrage,288,warlock,destruction,6,3,3
54702,Bellwulf,goldrinn,288,warlock,destruction,6,3,3
54703,Metaphors,stormrage,288,warlock,destruction,6,3,3
54704,Saffuky,frostmourne,288,warlock,destruction,6,3,3
54705,Picklecatz,barthilas,288,warlock,destruction,6,3,3
54706,Voldormort,uldaman,288,warlock,destruction,6,3,3
54707,Moxilli,malganis,288,warlock,destruction,6,3,3
54708,Ärminvßuurën,barthilas,288,warlock,destruction,6,3,3
54709,Feartool,stormrage,288,warlock,destruction,6,3,3
54710,Hairydottr,malganis,288,warlock,destruction,6,3,3
54711,Gingerlock,stonemaul,288,warlock,destruction,6,3,3
54712,Lillpfudd,area-52,288,warlock,destruction,6,3,3
54713,Stretchmark,stormrage,288,warlock,destruction,6,3,3
54714,Hauntgød,tichondrius,288,warlock,destruction,6,3,3
54715,Nvmb,frostmourne,288,warlock,destruction,6,3,3
54716,Spacemonkey,malganis,288,warlock,destruction,6,3,3
54717,Shâdowman,stormrage,288,warlock,destruction,6,3,3
54718,Embraces,tichondrius,288,warlock,destruction,6,3,3
54719,Babylung,bleeding-hollow,288,warlock,destruction,6,3,3
54720,Crucifieds,tichondrius,288,warlock,destruction,6,3,3
54721,Poggyjones,tichondrius,288,warlock,destruction,6,3,3
54722,Itsawarlock,thunderlord,288,warlock,destruction,6,3,3
54723,Chesterfear,quelthalas,288,warlock,destruction,6,3,3
54724,Vampydark,quelthalas,288,warlock,destruction,6,3,3
54725,Phénom,tichondrius,288,warlock,destruction,6,3,3
54726,Pennÿ,quelthalas,288,warlock,destruction,6,3,3
54727,Shadøwcrits,quelthalas,288,warlock,destruction,6,3,3
54728,Ovoíd,area-52,288,warlock,destruction,6,3,3
54729,Warlooch,area-52,288,warlock,destruction,6,3,3
54730,Vìqtìm,kelthuzad,288,warlock,destruction,6,3,3
54731,Sorath,blackrock,288,warlock,destruction,6,3,3
54732,Lcomi,tichondrius,288,warlock,destruction,6,3,3
54733,Xephostwo,area-52,288,warlock,destruction,6,3,3
54734,Attackbird,area-52,288,warlock,destruction,6,3,3
54735,Odelgabiana,area-52,288,warlock,destruction,6,3,3
54736,Ðëâthløck,tichondrius,288,warlock,destruction,6,3,3
54737,Devi,destromath,288,warlock,destruction,6,3,3
54738,Thisisturtle,area-52,288,warlock,destruction,6,3,3
54739,Ijustsharded,area-52,288,warlock,destruction,6,3,3
54740,Bushmelded,tichondrius,288,warlock,destruction,6,3,3
54741,Drßöb,area-52,288,warlock,destruction,6,3,3
54742,Fungiforest,kelthuzad,288,warlock,destruction,6,3,3
54743,Mylock,andorhal,288,warlock,destruction,6,3,3
54744,Tacolock,azshara,288,warlock,destruction,6,3,3
54745,Merlinsbeard,zuluhed,288,warlock,destruction,6,3,3
54746,Mamabolts,kelthuzad,288,warlock,destruction,6,3,3
54747,Mileyswift,kelthuzad,288,warlock,destruction,6,3,3
54748,Vxms,barthilas,288,warlock,destruction,6,3,3
54749,Famelol,tichondrius,288,warlock,destruction,6,3,3
54750,Lochek,stonemaul,288,warlock,destruction,6,3,3
54751,Ÿoucantwin,kiljaeden,288,warlock,destruction,6,3,3
54752,Tamzlock,the-forgotten-coast,288,warlock,destruction,6,3,3
54753,Päinoth,wyrmrest-accord,288,warlock,destruction,6,3,3
54754,Nutzosaurus,darkspear,288,warlock,destruction,6,3,3
54755,Watchdatfear,dragonmaw,288,warlock,destruction,6,3,3
54756,Toxicatedz,azralon,288,warlock,destruction,6,3,3
54757,Héllboy,akama,288,warlock,destruction,6,3,3
54758,Homeschooler,darkspear,288,warlock,destruction,6,3,3
54759,Turbocleave,blackwater-raiders,288,warlock,destruction,6,3,3
54760,Lockhomes,azralon,288,warlock,destruction,6,3,3
54761,Shifulock,azralon,288,warlock,destruction,6,3,3
54762,Evianne,skywall,288,warlock,destruction,6,3,3
54763,Trainwreck,sargeras,288,warlock,destruction,6,3,3
54764,Pheríe,sargeras,288,warlock,destruction,6,3,3
54765,Niétzsché,emerald-dream,288,warlock,destruction,6,3,3
54766,Blaxzlock,stormscale,288,warlock,destruction,6,3,3
54767,Háydn,azuremyst,288,warlock,destruction,6,3,3
54768,Larsiezwei,spirestone,288,warlock,destruction,6,3,3
54769,Siphoned,darkspear,288,warlock,destruction,6,3,3
54770,Dluttysots,emerald-dream,288,warlock,destruction,6,3,3
54771,Ñevaeh,emerald-dream,288,warlock,destruction,6,3,3
54772,Ashtak,coilfang,288,warlock,destruction,6,3,3
54773,Graveland,frostwolf,288,warlock,destruction,6,3,3
54774,Amauder,moon-guard,288,warlock,destruction,6,3,3
54775,Gouzenko,emerald-dream,288,warlock,destruction,6,3,3
54776,Lockaloga,azralon,288,warlock,destruction,6,3,3
54777,Mfcalamity,uldum,288,warlock,destruction,6,3,3
54778,Dotbot,blades-edge,288,warlock,destruction,6,3,3
54779,Dogcookie,moon-guard,288,warlock,destruction,6,3,3
54780,Silkxy,frostwolf,288,warlock,destruction,6,3,3
54781,Reyaena,moon-guard,288,warlock,destruction,6,3,3
54782,Dolcex,sargeras,288,warlock,destruction,6,3,3
54783,Miratrix,moon-guard,288,warlock,destruction,6,3,3
54784,Youngblood,maelstrom,288,warlock,destruction,6,3,3
54785,Creedmore,sargeras,288,warlock,destruction,6,3,3
54786,Uwubolt,moon-guard,288,warlock,destruction,6,3,3
54787,Ouijafaps,sargeras,288,warlock,destruction,6,3,3
54788,Ministàff,ursin,288,warlock,destruction,9,4,5
54789,Lycanthropi,illidan,288,warlock,destruction,9,4,5
54790,Taldaroth,moon-guard,288,warlock,destruction,7,3,4
54791,Cult,smolderthorn,288,warlock,destruction,7,3,4
54792,Fluximilian,azralon,288,warlock,destruction,10,4,6
54793,Amidone,bleeding-hollow,288,warlock,destruction,10,4,6
54794,Malleus,drakkari,288,warlock,destruction,8,3,5
54795,Fex,hyjal,288,warlock,destruction,8,3,5
54796,Verminperson,illidan,288,warlock,destruction,8,3,5
54797,Trotndot,dragonmaw,288,warlock,destruction,12,3,9
54798,Shaddaj,illidan,288,warlock,destruction,12,3,9
54799,Wyrelock,hyjal,288,warlock,destruction,12,3,9
54800,Amour,wyrmrest-accord,288,warlock,destruction,12,3,9
54801,Reluxify,dalaran,288,warlock,destruction,12,3,9
54802,Methology,wyrmrest-accord,288,warlock,destruction,12,3,9
54803,Mireffect,auchindoun,288,warlock,destruction,12,3,9
54804,Sulívan,azralon,288,warlock,destruction,12,3,9
54805,Fearfactory,lethon,288,warlock,destruction,12,3,9
54806,Rabiesdot,tichondrius,288,warlock,destruction,12,3,9
54807,Huskee,sargeras,288,warlock,destruction,12,3,9
54808,Gotty,stormrage,288,warlock,destruction,12,3,9
54809,Belfomént,ragnaros,288,warlock,destruction,12,3,9
54810,Teedub,thrall,288,warlock,destruction,12,3,9
54811,Wickedt,ragnaros,288,warlock,destruction,12,3,9
54812,Gorgaron,zuljin,288,warlock,destruction,12,3,9
54813,Demonâ,ragnaros,288,warlock,destruction,12,3,9
54814,Vickerzz,barthilas,288,warlock,destruction,12,3,9
54815,Zeshlo,firetree,288,warlock,destruction,12,3,9
54816,Gdpx,malganis,288,warlock,destruction,12,3,9
54817,Demondays,sargeras,288,warlock,destruction,12,3,9
54818,Hachiui,galakrond,288,warlock,destruction,12,3,9
54819,Héstia,area-52,288,warlock,destruction,12,3,9
54820,Sambodeemon,proudmoore,288,warlock,destruction,12,3,9
54821,Dopamine,antonidas,288,warlock,destruction,12,3,9
54822,Mageus,blood-furnace,288,warlock,destruction,12,3,9
54823,Darkhadouken,sargeras,288,warlock,destruction,12,3,9
54824,Voidmãngõ,stormrage,288,warlock,destruction,12,3,9
54825,Zeeref,stormrage,288,warlock,destruction,12,3,9
54826,Taoloni,stormrage,288,warlock,destruction,12,3,9
54827,Cexdragon,tichondrius,288,warlock,destruction,14,3,11
54828,Gulliftonan,zuljin,288,warlock,destruction,18,3,15
54829,Báál,bleeding-hollow,288,warlock,destruction,18,3,15
54830,Sykolock,lethon,287,warlock,destruction,6,3,3
54831,Izmadara,frostmane,287,warlock,destruction,6,3,3
54832,Brenmen,tichondrius,287,warlock,destruction,6,3,3
54833,Trrolling,jubeithos,287,warlock,destruction,12,5,7
54834,Alvatio,tichondrius,287,warlock,destruction,12,3,9
54835,Evilbacon,stormrage,287,warlock,destruction,12,3,9
54836,Deathwishiz,tichondrius,287,warlock,destruction,12,3,9
54837,Drunklockdot,tichondrius,271,warlock,destruction,11,3,8
54838,Ainzeal,nagrand,256,warlock,destruction,10,4,6
54839,Sophia,wildhammer,255,warlock,destruction,8,4,4
54840,Mikejones,dawnbringer,255,warlock,destruction,14,4,10
54841,Draisien,moon-guard,250,warlock,destruction,7,5,2
54842,Warakaso,ragnaros,240,warlock,destruction,9,3,6
54843,Nawtychannel,aegwynn,239,warlock,destruction,5,3,2
54844,Blightbeast,area-52,239,warlock,destruction,5,3,2
54845,Infectionl,ragnaros,239,warlock,destruction,5,3,2
54846,Alliciia,area-52,234,warlock,destruction,11,5,6
54847,Wàtchmebolt,dalvengyr,223,warlock,destruction,8,3,5
54848,Nokturnal,norgannon,208,warlock,destruction,7,3,4
54849,Amaia,nathrezim,207,warlock,destruction,7,3,4
54850,Portalgun,tichondrius,192,warlock,destruction,4,3,1
54851,Draindeez,sargeras,192,warlock,destruction,9,3,6
54852,Benbuttons,sargeras,192,warlock,destruction,9,3,6
54853,Demiloy,stormrage,192,warlock,destruction,9,3,6
54854,Dramylock,sargeras,192,warlock,destruction,6,2,4
54855,Outlanderr,tichondrius,192,warlock,destruction,6,2,4
54856,Nolb,tichondrius,192,warlock,destruction,6,2,4
54857,Srz,stormrage,192,warlock,destruction,6,2,4
54858,Zivira,stormrage,192,warlock,destruction,6,2,4
54859,Jaydero,lightbringer,192,warlock,destruction,6,2,4
54860,Nüts,blackrock,192,warlock,destruction,6,2,4
54861,Gadalann,area-52,192,warlock,destruction,6,2,4
54862,Locksama,area-52,192,warlock,destruction,6,2,4
54863,Lhorgainz,area-52,192,warlock,destruction,6,2,4
54864,Tirisfel,tichondrius,192,warlock,destruction,6,2,4
54865,Riiselock,shadow-council,192,warlock,destruction,6,2,4
54866,Bigballslock,ragnaros,192,warlock,destruction,6,2,4
54867,Yordich,kelthuzad,192,warlock,destruction,6,2,4
54868,Afflicmindz,azralon,192,warlock,destruction,6,2,4
54869,Cronobolts,stormrage,192,warlock,destruction,6,2,4
54870,Montaine,malganis,192,warlock,destruction,6,2,4
54871,Oprahofbolts,area-52,192,warlock,destruction,6,2,4
54872,Msdotfire,nazjatar,192,warlock,destruction,6,2,4
54873,Guisls,azralon,192,warlock,destruction,6,2,4
54874,Dotzlol,jubeithos,192,warlock,destruction,6,2,4
54875,Medusablood,area-52,192,warlock,destruction,6,2,4
54876,Konarik,nagrand,192,warlock,destruction,6,2,4
54877,Zephiy,kelthuzad,192,warlock,destruction,6,2,4
54878,Oopsíe,nagrand,192,warlock,destruction,6,2,4
54879,Drkdestro,boulderfist,192,warlock,destruction,6,2,4
54880,Biznam,tichondrius,192,warlock,destruction,6,2,4
54881,Omegawarlock,quelthalas,192,warlock,destruction,6,2,4
54882,Njunx,queldorei,192,warlock,destruction,6,2,4
54883,Mortallicus,proudmoore,192,warlock,destruction,6,2,4
54884,Seizuresauce,stormrage,192,warlock,destruction,6,2,4
54885,Lexist,darkspear,192,warlock,destruction,6,2,4
54886,Sinsky,darkspear,192,warlock,destruction,6,2,4
54887,Gaijin,stormrage,192,warlock,destruction,6,2,4
54888,Hadeys,amanthul,192,warlock,destruction,6,2,4
54889,Demonia,dathremar,192,warlock,destruction,6,2,4
54890,Fluffylockk,bloodscalp,192,warlock,destruction,6,2,4
54891,Bleachkk,tichondrius,192,warlock,destruction,6,2,4
54892,Gvz,tichondrius,192,warlock,destruction,6,2,4
54893,Percadu,barthilas,192,warlock,destruction,6,2,4
54894,Hollows,burning-blade,192,warlock,destruction,6,2,4
54895,Moistdank,tichondrius,192,warlock,destruction,6,2,4
54896,Brawndelock,stormrage,192,warlock,destruction,6,2,4
54897,Ganggu,tichondrius,192,warlock,destruction,6,2,4
54898,Ðamndaddy,sargeras,192,warlock,destruction,6,2,4
54899,Lilthicy,sargeras,192,warlock,destruction,6,2,4
54900,Diablox,silvermoon,192,warlock,destruction,6,2,4
54901,Mlx,proudmoore,192,warlock,destruction,6,2,4
54902,Fstndantilus,moonrunner,192,warlock,destruction,6,2,4
54903,Theyfearbuda,kelthuzad,192,warlock,destruction,6,2,4
54904,Amz,grizzly-hills,192,warlock,destruction,6,2,4
54905,Aksanaa,area-52,192,warlock,destruction,6,2,4
54906,Corruptious,frostmourne,192,warlock,destruction,6,2,4
54907,Reckzet,stormrage,192,warlock,destruction,6,2,4
54908,Mutexlock,whisperwind,192,warlock,destruction,6,2,4
54909,Dedrae,silvermoon,192,warlock,destruction,6,2,4
54910,Ðuckworth,azralon,192,warlock,destruction,6,2,4
54911,Înfèçtìön,emerald-dream,192,warlock,destruction,6,2,4
54912,Maxice,zuljin,192,warlock,destruction,6,2,4
54913,Herewegoagai,zuljin,192,warlock,destruction,6,2,4
54914,Nightterrour,frostmourne,192,warlock,destruction,6,2,4
54915,Flixon,tichondrius,192,warlock,destruction,6,2,4
54916,Valydri,stormrage,192,warlock,destruction,6,2,4
54917,Cthuga,frostmourne,192,warlock,destruction,6,2,4
54918,Theredwolf,zuljin,192,warlock,destruction,6,2,4
54919,Cauldron,tichondrius,192,warlock,destruction,6,2,4
54920,Yêrfdog,proudmoore,192,warlock,destruction,6,2,4
54921,Diabolock,proudmoore,192,warlock,destruction,6,2,4
54922,Lolokayhaha,vashj,192,warlock,destruction,6,2,4
54923,Toxik,zuljin,192,warlock,destruction,6,2,4
54924,Checkit,zuljin,192,warlock,destruction,6,2,4
54925,Sugarfire,nemesis,192,warlock,destruction,6,2,4
54926,Dchichi,tichondrius,192,warlock,destruction,6,2,4
54927,Geauxst,tichondrius,192,warlock,destruction,6,2,4
54928,Disapoin,stormrage,192,warlock,destruction,6,2,4
54929,Itzlandox,emerald-dream,192,warlock,destruction,6,2,4
54930,Leine,proudmoore,192,warlock,destruction,6,2,4
54931,Sorenbjerga,zuljin,192,warlock,destruction,6,2,4
54932,Zoboo,zuljin,192,warlock,destruction,6,2,4
54933,Cityswimmer,malganis,192,warlock,destruction,6,2,4
54934,Qbl,wyrmrest-accord,192,warlock,destruction,6,2,4
54935,Baalock,frostmourne,192,warlock,destruction,6,2,4
54936,Adalaya,emerald-dream,192,warlock,destruction,6,2,4
54937,Gihaewon,tichondrius,192,warlock,destruction,6,2,4
54938,Zlocks,scilla,192,warlock,destruction,6,2,4
54939,Rickystuart,tichondrius,192,warlock,destruction,6,2,4
54940,Fbgmel,emerald-dream,192,warlock,destruction,6,2,4
54941,Imindanger,frostmourne,192,warlock,destruction,6,2,4
54942,Pepzz,emerald-dream,192,warlock,destruction,6,2,4
54943,Rococo,emerald-dream,192,warlock,destruction,6,2,4
54944,Fjklock,nemesis,192,warlock,destruction,6,2,4
54945,Xalcezar,sargeras,192,warlock,destruction,6,2,4
54946,Pinguswalrus,stormrage,192,warlock,destruction,6,2,4
54947,Petez,sargeras,192,warlock,destruction,6,2,4
54948,Asaveyous,wyrmrest-accord,192,warlock,destruction,6,2,4
54949,Dach,moon-guard,192,warlock,destruction,6,2,4
54950,Ibanez,bleeding-hollow,192,warlock,destruction,6,2,4
54951,Deiformis,malganis,192,warlock,destruction,6,2,4
54952,Mothapucka,thrall,192,warlock,destruction,6,2,4
54953,Lynnha,wyrmrest-accord,192,warlock,destruction,6,2,4
54954,Åchse,ragnaros,192,warlock,destruction,6,2,4
54955,Vorkaz,moon-guard,192,warlock,destruction,6,2,4
54956,Nonamehero,tichondrius,192,warlock,destruction,6,2,4
54957,Lazzie,thrall,192,warlock,destruction,6,2,4
54958,Encanis,dalaran,192,warlock,destruction,6,2,4
54959,Darkbaron,khadgar,192,warlock,destruction,6,2,4
54960,Maniacal,shattered-halls,192,warlock,destruction,6,2,4
54961,Xaraki,skullcrusher,192,warlock,destruction,6,2,4
54962,Plzdont,blades-edge,192,warlock,destruction,6,2,4
54963,Ourlegacy,tichondrius,192,warlock,destruction,6,2,4
54964,Amazeus,tichondrius,192,warlock,destruction,6,2,4
54965,Idoturmum,frostmourne,192,warlock,destruction,6,2,4
54966,Apokálipse,frostmourne,192,warlock,destruction,6,2,4
54967,Raisa,chogall,192,warlock,destruction,6,2,4
54968,Infant,agamaggan,192,warlock,destruction,6,2,4
54969,Ozie,proudmoore,192,warlock,destruction,6,2,4
54970,Constantine,exodar,192,warlock,destruction,6,2,4
54971,Nazug,dark-iron,192,warlock,destruction,6,2,4
54972,Erimegara,ragnaros,192,warlock,destruction,6,2,4
54973,Sinissa,ysondre,192,warlock,destruction,6,2,4
54974,Gschism,ragnaros,192,warlock,destruction,6,2,4
54975,Theboss,arygos,192,warlock,destruction,6,2,4
54976,Nianas,ysondre,192,warlock,destruction,6,2,4
54977,Ruellia,tichondrius,192,warlock,destruction,6,2,4
54978,Wodinskol,sargeras,192,warlock,destruction,6,2,4
54979,Ðemõn,area-52,192,warlock,destruction,6,2,4
54980,Ballpain,sargeras,192,warlock,destruction,6,2,4
54981,Raghog,kelthuzad,192,warlock,destruction,6,2,4
54982,Savemykoalas,tichondrius,192,warlock,destruction,6,2,4
54983,Shanelle,korgath,192,warlock,destruction,6,2,4
54984,Blliizz,aegwynn,192,warlock,destruction,6,2,4
54985,Yellowfevr,thrall,192,warlock,destruction,6,2,4
54986,Cynnd,tichondrius,192,warlock,destruction,6,2,4
54987,Spicyfingers,illidan,192,warlock,destruction,6,2,4
54988,Æonas,bladefist,192,warlock,destruction,6,2,4
54989,Cholock,anubarak,192,warlock,destruction,6,2,4
54990,Gradek,dalaran,192,warlock,destruction,6,2,4
54991,Lostlove,moon-guard,192,warlock,destruction,6,2,4
54992,Dôctor,tichondrius,192,warlock,destruction,6,2,4
54993,Iadminl,moon-guard,192,warlock,destruction,6,2,4
54994,Muffinlol,frostmourne,192,warlock,destruction,6,2,4
54995,Abbyshapiro,kelthuzad,192,warlock,destruction,6,2,4
54996,Diabloisekai,ragnaros,192,warlock,destruction,6,2,4
54997,Deanwarlock,sargeras,192,warlock,destruction,6,2,4
54998,Nefertarie,illidan,192,warlock,destruction,6,2,4
54999,Nameflagged,arathor,192,warlock,destruction,6,2,4
55000,Eliraa,frostmourne,192,warlock,destruction,6,2,4
55001,Dotsin,wyrmrest-accord,192,warlock,destruction,6,2,4
55002,Sinnâcle,illidan,192,warlock,destruction,6,2,4
55003,Camila,lightnings-blade,192,warlock,destruction,6,2,4
55004,Ricklock,aggramar,192,warlock,destruction,6,2,4
55005,Mythh,hyjal,192,warlock,destruction,6,2,4
55006,Nuradzec,illidan,192,warlock,destruction,6,2,4
55007,Poltergiiest,korgath,192,warlock,destruction,6,2,4
55008,Ramone,turalyon,192,warlock,destruction,6,2,4
55009,Lîch,thunderlord,192,warlock,destruction,8,2,6
55010,Altairo,illidan,192,warlock,destruction,8,2,6
55011,Tsunamibaby,anvilmar,192,warlock,destruction,9,2,7
55012,Whydemono,tichondrius,192,warlock,destruction,10,2,8
55013,Daggondai,tichondrius,192,warlock,destruction,12,2,10
55014,Bladebank,kirin-tor,192,warlock,destruction,12,2,10
55015,Asumi,nemesis,192,warlock,destruction,12,2,10
55016,Hadés,aerie-peak,192,warlock,destruction,12,2,10
55017,Moknuhg,emerald-dream,192,warlock,destruction,12,2,10
55018,Luntrazz,arthas,192,warlock,destruction,12,2,10
55019,Wizie,arthas,192,warlock,destruction,12,2,10
55020,Kandrus,moon-guard,192,warlock,destruction,12,2,10
55021,Beamac,cenarius,192,warlock,destruction,14,2,12
55022,Ledmann,tichondrius,192,warlock,destruction,18,2,16
55023,Pangppi,tichondrius,192,warlock,destruction,24,2,22
55024,Mystickittie,aerie-peak,191,warlock,destruction,6,2,4
55025,Eldrien,spirestone,191,warlock,destruction,12,2,10
55026,Erindevil,demon-soul,191,warlock,destruction,12,2,10
55027,Lowvalue,illidan,159,warlock,destruction,5,2,3
55028,Lockycharms,sargeras,159,warlock,destruction,5,2,3
55029,Zarson,illidan,159,warlock,destruction,5,2,3
55030,Eatmyboltz,hyjal,159,warlock,destruction,5,2,3
55031,Prds,illidan,159,warlock,destruction,5,2,3
55032,Dotyoazz,stormrage,159,warlock,destruction,5,2,3
55033,Fearfeaster,tichondrius,159,warlock,destruction,5,2,3
55034,Katarameni,tortheldrin,138,warlock,destruction,7,4,3
55035,Blakedogx,tichondrius,138,warlock,destruction,8,3,5
55036,Gildedknight,arthas,138,warlock,destruction,10,3,7
55037,Thegoatmen,stormrage,128,warlock,destruction,4,2,2
55038,Catarina,kaelthas,128,warlock,destruction,4,2,2
55039,Miggazzizle,senjin,128,warlock,destruction,4,2,2
55040,Conilus,malganis,128,warlock,destruction,4,2,2
55041,Hentailust,kiljaeden,128,warlock,destruction,4,2,2
55042,Rosacrutian,tichondrius,128,warlock,destruction,4,2,2
55043,Disclamer,tichondrius,128,warlock,destruction,4,2,2
55044,Oreo,velen,112,warlock,destruction,7,2,5
55045,Savubaloo,blackrock,96,warlock,destruction,3,2,1
55046,Goodforyou,stormscale,96,warlock,destruction,3,2,1
55047,Crankak,zuljin,96,warlock,destruction,3,2,1
55048,Willsayan,ragnaros,96,warlock,destruction,3,2,1
55049,Lukgar,azralon,96,warlock,destruction,3,2,1
55050,Darkestholy,illidan,96,warlock,destruction,6,1,5
55051,Ursuxus,moon-guard,96,warlock,destruction,6,1,5
55052,Chilevael,sargeras,96,warlock,destruction,6,1,5
55053,Yuengling,illidan,96,warlock,destruction,6,1,5
55054,Proletariat,moon-guard,96,warlock,destruction,6,1,5
55055,Kraguenöth,drakkari,96,warlock,destruction,6,1,5
55056,Sheara,silver-hand,96,warlock,destruction,6,1,5
55057,Rennik,haomarush,96,warlock,destruction,6,1,5
55058,Lánathel,ragnaros,96,warlock,destruction,6,1,5
55059,Druzzaj,thrall,96,warlock,destruction,6,1,5
55060,Radii,bladefist,96,warlock,destruction,6,1,5
55061,Wetweenies,illidan,96,warlock,destruction,6,1,5
55062,Pspot,kiljaeden,96,warlock,destruction,6,1,5
55063,Heffyboi,frostmourne,96,warlock,destruction,6,1,5
55064,Toelickerx,illidan,96,warlock,destruction,6,1,5
55065,Monstir,sargeras,96,warlock,destruction,6,1,5
55066,Spellbøund,malorne,96,warlock,destruction,6,1,5
55067,Yallsdead,frostmourne,96,warlock,destruction,6,1,5
55068,Rëappér,ragnaros,96,warlock,destruction,6,1,5
55069,Siaokuai,tichondrius,96,warlock,destruction,6,1,5
55070,Basticor,moon-guard,96,warlock,destruction,6,1,5
55071,Pwnasaurus,barthilas,96,warlock,destruction,6,1,5
55072,Darkmatter,frostmourne,96,warlock,destruction,6,1,5
55073,Medivhz,tichondrius,96,warlock,destruction,6,1,5
55074,Cursenkill,sargeras,96,warlock,destruction,6,1,5
55075,Lawkdown,dark-iron,96,warlock,destruction,6,1,5
55076,Wesyane,anetheron,96,warlock,destruction,6,1,5
55077,Robertloblah,sargeras,96,warlock,destruction,6,1,5
55078,Demonellea,frostmourne,96,warlock,destruction,6,1,5
55079,Projecto,tichondrius,96,warlock,destruction,6,1,5
55080,Winstonblack,moon-guard,96,warlock,destruction,6,1,5
55081,Karpawarlock,ragnaros,96,warlock,destruction,6,1,5
55082,Wickedicky,alleria,96,warlock,destruction,6,1,5
55083,Varix,frostmourne,96,warlock,destruction,6,1,5
55084,Mcpickl,illidan,96,warlock,destruction,6,1,5
55085,Demonist,moon-guard,96,warlock,destruction,6,1,5
55086,Alcorick,moon-guard,96,warlock,destruction,6,1,5
55087,Vexria,wyrmrest-accord,96,warlock,destruction,6,1,5
55088,Vendareth,earthen-ring,96,warlock,destruction,6,1,5
55089,Koillock,bleeding-hollow,96,warlock,destruction,6,1,5
55090,Delaye,tichondrius,96,warlock,destruction,6,1,5
55091,Brothadoinks,zuljin,96,warlock,destruction,6,1,5
55092,Bfaclâssic,zuljin,96,warlock,destruction,6,1,5
55093,Mílkduds,zuljin,96,warlock,destruction,6,1,5
55094,Lilcarmy,emerald-dream,96,warlock,destruction,6,1,5
55095,Thehempress,magtheridon,96,warlock,destruction,6,1,5
55096,Bosshoglock,whisperwind,96,warlock,destruction,6,1,5
55097,Saytiri,tichondrius,96,warlock,destruction,6,1,5
55098,Adlfcritler,emerald-dream,96,warlock,destruction,6,1,5
55099,Bitrot,jubeithos,96,warlock,destruction,6,1,5
55100,Voky,whisperwind,96,warlock,destruction,6,1,5
55101,Skeemer,azuremyst,96,warlock,destruction,6,1,5
55102,Kuasta,shadowmoon,96,warlock,destruction,6,1,5
55103,Mazip,vashj,96,warlock,destruction,6,1,5
55104,Dotomizer,moonrunner,96,warlock,destruction,6,1,5
55105,Lucifuhrerr,tichondrius,96,warlock,destruction,6,1,5
55106,Jiwonpark,goldrinn,96,warlock,destruction,6,1,5
55107,Seutóóbinha,stormrage,96,warlock,destruction,6,1,5
55108,Crushbucket,stormreaver,96,warlock,destruction,6,1,5
55109,Lizlock,stormrage,96,warlock,destruction,6,1,5
55110,Charlîe,vashj,96,warlock,destruction,6,1,5
55111,Resima,stormscale,96,warlock,destruction,6,1,5
55112,Clias,galakrond,96,warlock,destruction,6,1,5
55113,Gamecobra,greymane,96,warlock,destruction,6,1,5
55114,Réliok,quelthalas,96,warlock,destruction,6,1,5
55115,Ilxxllxxll,area-52,96,warlock,destruction,6,1,5
55116,Eldïablo,stormrage,96,warlock,destruction,6,1,5
55117,Kothoped,wyrmrest-accord,96,warlock,destruction,6,1,5
55118,Hinatasu,greymane,96,warlock,destruction,6,1,5
55119,Meinhundin,stormrage,96,warlock,destruction,6,1,5
55120,Plaguedoctor,stormrage,96,warlock,destruction,6,1,5
55121,Alyxandros,illidan,96,warlock,destruction,6,1,5
55122,Niubeelol,tichondrius,96,warlock,destruction,6,1,5
55123,Lokinzz,tichondrius,96,warlock,destruction,6,1,5
55124,Däemön,area-52,96,warlock,destruction,6,1,5
55125,Tubarão,azralon,96,warlock,destruction,6,1,5
55126,Lazymongoose,frostmourne,96,warlock,destruction,6,1,5
55127,Lokiiee,azuremyst,96,warlock,destruction,6,1,5
55128,Vandenso,stormrage,96,warlock,destruction,6,1,5
55129,Kaotiq,area-52,96,warlock,destruction,6,1,5
55130,Gsr,bleeding-hollow,96,warlock,destruction,6,1,5
55131,Siinistuh,tichondrius,96,warlock,destruction,6,1,5
55132,Shidded,lightbringer,96,warlock,destruction,6,1,5
55133,Chermonalbur,draka,96,warlock,destruction,6,1,5
55134,Lockedinn,mannoroth,96,warlock,destruction,6,1,5
55135,Elaïla,area-52,96,warlock,destruction,6,1,5
55136,Meanda,boulderfist,96,warlock,destruction,6,1,5
55137,Xaryus,barthilas,96,warlock,destruction,6,1,5
55138,Fearxd,maiev,96,warlock,destruction,6,1,5
55139,Aflictiyon,azralon,96,warlock,destruction,6,1,5
55140,Cornboil,tichondrius,96,warlock,destruction,6,1,5
55141,Killulock,area-52,96,warlock,destruction,6,1,5
55142,Taddedlock,kelthuzad,96,warlock,destruction,6,1,5
55143,Gulgrin,eldrethalas,96,warlock,destruction,6,1,5
55144,Infear,area-52,96,warlock,destruction,6,1,5
55145,Mônkêy,kelthuzad,96,warlock,destruction,6,1,5
55146,Scatach,area-52,96,warlock,destruction,6,1,5
55147,Biigdaddyy,kelthuzad,96,warlock,destruction,6,1,5
55148,Wherelock,area-52,96,warlock,destruction,7,1,6
55149,Nekranis,thrall,96,warlock,destruction,12,1,11
55150,Diddy,arygos,96,warlock,destruction,12,1,11
55151,Ashlëen,ragnaros,96,warlock,destruction,12,1,11
55152,Mythsubpar,tichondrius,96,warlock,destruction,12,1,11
55153,Moz,sargeras,79,warlock,destruction,5,1,4
55154,Thiccdoinkz,tichondrius,63,warlock,destruction,2,2,0
55155,Bagn,tichondrius,63,warlock,destruction,2,2,0
55156,Cokelime,sargeras,63,warlock,destruction,2,2,0
55157,Aoneandatwo,proudmoore,48,warlock,destruction,3,1,2
55158,Clevingert,frostmourne,48,warlock,destruction,3,1,2
55159,Kosugi,kelthuzad,42,warlock,destruction,8,2,6
55160,Jusmessin,tichondrius,31,warlock,destruction,2,1,1
55161,Morêdots,malganis,31,warlock,destruction,2,1,1
55162,Amarexd,stormrage,31,warlock,destruction,2,1,1
55163,Moräl,frostmourne,31,warlock,destruction,2,1,1
55164,Emurog,icecrown,30,warlock,destruction,12,6,6
55165,Amonthuzad,blackrock,16,warlock,destruction,1,1,0
55166,Lazygnom,azshara,16,warlock,destruction,1,1,0
55167,Goofhu,sargeras,2270,warlock,affliction,102,62,40
55168,Exgenshinpro,proudmoore,2257,warlock,affliction,160,89,71
55169,Yandhi,bronzebeard,2129,warlock,affliction,46,30,16
55170,Dewandoritos,kelthuzad,2127,warlock,affliction,153,76,77
55171,Dotdzdotdoze,tichondrius,2106,warlock,affliction,245,131,114
55172,Goofgg,sargeras,1987,warlock,affliction,335,162,173
55173,Rangz,tichondrius,1983,warlock,affliction,84,45,39
55174,Tcchiu,tichondrius,1982,warlock,affliction,35,24,11
55175,Sphoo,tichondrius,1974,warlock,affliction,94,48,46
55176,Kålêïðøsçøpê,sargeras,1965,warlock,affliction,42,24,18
55177,Exódia,tichondrius,1961,warlock,affliction,195,100,95
55178,Shanyanghuxu,tichondrius,1933,warlock,affliction,42,26,16
55179,Diminish,sargeras,1923,warlock,affliction,108,54,54
55180,Gekku,ragnaros,1917,warlock,affliction,83,49,34
55181,Dyenamik,stormrage,1891,warlock,affliction,60,33,27
55182,Arityy,tichondrius,1887,warlock,affliction,90,46,44
55183,Cumbledora,kelthuzad,1878,warlock,affliction,48,30,18
55184,Rangrang,tichondrius,1873,warlock,affliction,108,51,57
55185,Octopus,nerzhul,1872,warlock,affliction,64,33,31
55186,Yellowfevr,thrall,1870,warlock,affliction,48,27,21
55187,Hyoozy,illidan,1869,warlock,affliction,105,58,47
55188,Jukethisxo,tichondrius,1866,warlock,affliction,105,62,43
55189,Pardoned,stormrage,1859,warlock,affliction,41,20,21
55190,Oymmander,illidan,1850,warlock,affliction,36,25,11
55191,Prnhbgødx,sargeras,1850,warlock,affliction,48,26,22
55192,Lostlock,sargeras,1847,warlock,affliction,120,68,52
55193,Beetlejoos,stormreaver,1843,warlock,affliction,116,65,51
55194,Hiro,steamwheedle-cartel,1829,warlock,affliction,99,56,43
55195,Burtreynolds,shattered-hand,1827,warlock,affliction,60,31,29
55196,Fallenis,proudmoore,1825,warlock,affliction,54,31,23
55197,Forestfruit,tichondrius,1819,warlock,affliction,58,31,27
55198,Renosa,illidan,1818,warlock,affliction,57,32,25
55199,Lockhippo,illidan,1818,warlock,affliction,58,30,28
55200,Widenose,agamaggan,1817,warlock,affliction,53,30,23
55201,Bugbugg,tichondrius,1814,warlock,affliction,51,38,13
55202,Woopie,malfurion,1809,warlock,affliction,53,29,24
55203,Knothy,proudmoore,1807,warlock,affliction,78,36,42
55204,Dotplaystyle,blackrock,1806,warlock,affliction,90,42,48
55205,Warlocknroll,frostmourne,1803,warlock,affliction,47,21,26
55206,Dröwzy,sargeras,1801,warlock,affliction,48,25,23
55207,Conradlenoir,illidan,1800,warlock,affliction,41,24,17
55208,Phlares,stormrage,1798,warlock,affliction,71,30,41
55209,Wardyn,dragonmaw,1795,warlock,affliction,72,29,43
55210,Slendyman,stormrage,1794,warlock,affliction,42,25,17
55211,Limeriax,emerald-dream,1782,warlock,affliction,120,65,55
55212,Lockprocz,kirin-tor,1779,warlock,affliction,48,24,24
55213,Lucyloux,sargeras,1775,warlock,affliction,40,23,17
55214,Strudelfears,tichondrius,1772,warlock,affliction,95,66,29
55215,Gry,malganis,1767,warlock,affliction,34,19,15
55216,Purp,vashj,1767,warlock,affliction,44,23,21
55217,Portalgun,tichondrius,1764,warlock,affliction,54,30,24
55218,Duukka,malganis,1763,warlock,affliction,47,28,19
55219,Fancynuts,kiljaeden,1754,warlock,affliction,54,27,27
55220,Salival,chogall,1748,warlock,affliction,72,38,34
55221,Ezgamejr,tichondrius,1740,warlock,affliction,52,30,22
55222,Baxmoney,malganis,1740,warlock,affliction,48,19,29
55223,Fatals,thrall,1737,warlock,affliction,72,39,33
55224,Jimmyvagene,area-52,1736,warlock,affliction,59,26,33
55225,Boyahancook,tichondrius,1735,warlock,affliction,136,67,69
55226,Matrielan,azshara,1730,warlock,affliction,114,70,44
55227,Àfflìction,tichondrius,1719,warlock,affliction,149,79,70
55228,Eh,laughing-skull,1717,warlock,affliction,138,68,70
55229,Înfy,sargeras,1703,warlock,affliction,30,18,12
55230,Imadotyasan,shandris,1702,warlock,affliction,60,31,29
55231,Swath,firetree,1700,warlock,affliction,60,30,30
55232,Locklist,frostmourne,1695,warlock,affliction,78,41,37
55233,Cslice,magtheridon,1686,warlock,affliction,36,20,16
55234,Leach,draktharon,1685,warlock,affliction,60,31,29
55235,Beamin,dentarg,1683,warlock,affliction,42,27,15
55236,Hilzin,area-52,1679,warlock,affliction,90,47,43
55237,Amazeus,tichondrius,1677,warlock,affliction,30,18,12
55238,Bigdammich,bleeding-hollow,1674,warlock,affliction,54,29,25
55239,Liarz,tichondrius,1667,warlock,affliction,72,36,36
55240,Sâltylôck,tichondrius,1651,warlock,affliction,41,21,20
55241,Kopium,tichondrius,1645,warlock,affliction,36,24,12
55242,Dpz,spirestone,1645,warlock,affliction,30,18,12
55243,Dottcha,blackrock,1643,warlock,affliction,60,37,23
55244,Ticktickdoom,sargeras,1641,warlock,affliction,80,38,42
55245,Wojii,kelthuzad,1636,warlock,affliction,44,24,20
55246,Hauntx,bonechewer,1632,warlock,affliction,45,22,23
55247,Blackchinese,zuljin,1627,warlock,affliction,119,69,50
55248,Vardros,moon-guard,1626,warlock,affliction,60,33,27
55249,Venticm,tichondrius,1623,warlock,affliction,24,17,7
55250,Unsee,sargeras,1623,warlock,affliction,54,33,21
55251,Grimdreams,malganis,1622,warlock,affliction,37,21,16
55252,Cuteboy,tichondrius,1611,warlock,affliction,84,57,27
55253,Cokeparty,tichondrius,1611,warlock,affliction,108,52,56
55254,Lessthanjake,zuljin,1610,warlock,affliction,48,31,17
55255,Urwjoa,tichondrius,1609,warlock,affliction,74,39,35
55256,Mornnah,dalaran,1609,warlock,affliction,204,91,113
55257,Jkun,malganis,1608,warlock,affliction,126,70,56
55258,Slothycrip,emerald-dream,1606,warlock,affliction,59,33,26
55259,Catarina,kaelthas,1605,warlock,affliction,33,18,15
55260,Muffîn,moon-guard,1604,warlock,affliction,55,31,24
55261,Fasteddywow,arygos,1603,warlock,affliction,71,41,30
55262,Autotheism,whisperwind,1601,warlock,affliction,48,24,24
55263,Tjdotter,stormrage,1600,warlock,affliction,30,19,11
55264,Pykorrg,ragnaros,1600,warlock,affliction,47,23,24
55265,Sventka,ragnaros,1599,warlock,affliction,352,178,174
55266,Chilipeppa,wyrmrest-accord,1598,warlock,affliction,94,47,47
55267,Demonkiiller,kelthuzad,1597,warlock,affliction,49,25,24
55268,Uggaboogga,malganis,1597,warlock,affliction,36,17,19
55269,Waifucandy,tichondrius,1588,warlock,affliction,60,29,31
55270,Mechnite,sargeras,1586,warlock,affliction,67,31,36
55271,Xentzor,auchindoun,1585,warlock,affliction,90,45,45
55272,Parmenides,tichondrius,1584,warlock,affliction,210,110,100
55273,Damage,khadgar,1584,warlock,affliction,66,33,33
55274,Babydots,stormreaver,1579,warlock,affliction,29,18,11
55275,Nightkiss,sargeras,1578,warlock,affliction,48,22,26
55276,Deangood,tichondrius,1576,warlock,affliction,42,27,15
55277,Aroug,aggramar,1574,warlock,affliction,92,52,40
55278,Vialdkaseun,muradin,1572,warlock,affliction,138,63,75
55279,Felegance,proudmoore,1570,warlock,affliction,37,18,19
55280,Sìnister,nazgrel,1569,warlock,affliction,77,49,28
55281,Evarona,gorefiend,1568,warlock,affliction,72,34,38
55282,Mørøs,tichondrius,1566,warlock,affliction,102,65,37
55283,Stalezz,barthilas,1559,warlock,affliction,62,33,29
55284,Aomniloltv,zuljin,1559,warlock,affliction,140,74,66
55285,Hauntgød,tichondrius,1558,warlock,affliction,66,38,28
55286,Freddiewill,tichondrius,1557,warlock,affliction,41,26,15
55287,Laurela,aegwynn,1553,warlock,affliction,96,48,48
55288,Soulripped,area-52,1544,warlock,affliction,70,40,30
55289,Squirtwee,frostmourne,1542,warlock,affliction,72,33,39
55290,Mitryc,illidan,1540,warlock,affliction,55,26,29
55291,Zeraedify,bleeding-hollow,1540,warlock,affliction,36,17,19
55292,Disneytoon,moon-guard,1536,warlock,affliction,36,18,18
55293,Elend,elune,1534,warlock,affliction,36,25,11
55294,Ðåntë,thrall,1532,warlock,affliction,62,32,30
55295,Methrocks,emerald-dream,1529,warlock,affliction,64,39,25
55296,Idotû,tichondrius,1526,warlock,affliction,36,16,20
55297,Zod,burning-legion,1525,warlock,affliction,36,17,19
55298,Dirtydotting,nerzhul,1524,warlock,affliction,30,17,13
55299,Thecat,shattered-hand,1523,warlock,affliction,18,16,2
55300,Stopdot,lightnings-blade,1522,warlock,affliction,77,41,36
55301,Erolidra,blackrock,1519,warlock,affliction,30,16,14
55302,Dotte,tichondrius,1514,warlock,affliction,42,27,15
55303,Yanned,hakkar,1514,warlock,affliction,99,51,48
55304,Xoxoxoxoxo,lightnings-blade,1513,warlock,affliction,70,33,37
55305,Tyicuslok,tichondrius,1510,warlock,affliction,60,31,29
55306,Sheboy,moon-guard,1509,warlock,affliction,96,52,44
55307,Glifosáto,quelthalas,1508,warlock,affliction,42,24,18
55308,Forcedbeejay,sargeras,1502,warlock,affliction,48,24,24
55309,Lemdul,thrall,1494,warlock,affliction,26,17,9
55310,Loodle,moon-guard,1494,warlock,affliction,47,23,24
55311,Arcziz,tichondrius,1490,warlock,affliction,42,21,21
55312,Dautenit,illidan,1490,warlock,affliction,71,34,37
55313,Razlock,moon-guard,1489,warlock,affliction,48,27,21
55314,Dghuldahn,bleeding-hollow,1486,warlock,affliction,66,40,26
55315,Tsalagi,sargeras,1478,warlock,affliction,145,78,67
55316,Adeadsaint,boulderfist,1475,warlock,affliction,35,19,16
55317,Locker,lightnings-blade,1471,warlock,affliction,30,20,10
55318,Moräl,frostmourne,1470,warlock,affliction,51,25,26
55319,Mattypatty,the-forgotten-coast,1466,warlock,affliction,68,38,30
55320,Juleno,quelthalas,1458,warlock,affliction,30,17,13
55321,Infecçäo,stormrage,1455,warlock,affliction,46,23,23
55322,Yisuschríst,quelthalas,1453,warlock,affliction,39,23,16
55323,Justganmore,tichondrius,1449,warlock,affliction,54,29,25
55324,Sillyrabbut,kelthuzad,1449,warlock,affliction,192,96,96
55325,Fowll,frostwolf,1440,warlock,affliction,109,67,42
55326,Benaffllock,turalyon,1439,warlock,affliction,30,18,12
55327,Xicó,tichondrius,1435,warlock,affliction,64,31,33
55328,Crazikrix,area-52,1434,warlock,affliction,79,40,39
55329,Fatherbolt,tichondrius,1433,warlock,affliction,24,15,9
55330,Fearfaze,tichondrius,1433,warlock,affliction,60,27,33
55331,Snuffe,vashj,1432,warlock,affliction,103,60,43
55332,Dlarenn,kelthuzad,1432,warlock,affliction,30,15,15
55333,Torowasabi,tichondrius,1432,warlock,affliction,65,29,36
55334,Wizxin,emerald-dream,1431,warlock,affliction,60,27,33
55335,Percadu,barthilas,1431,warlock,affliction,36,16,20
55336,Livingdead,dreadmaul,1429,warlock,affliction,35,18,17
55337,Maxcorrupted,sargeras,1428,warlock,affliction,41,23,18
55338,Sinápsís,ragnaros,1423,warlock,affliction,24,15,9
55339,Daëmön,stormrage,1421,warlock,affliction,30,15,15
55340,Kimis,proudmoore,1421,warlock,affliction,42,20,22
55341,Vaalac,tichondrius,1420,warlock,affliction,450,216,234
55342,Varvanta,proudmoore,1420,warlock,affliction,48,18,30
55343,Droppindots,frostmane,1419,warlock,affliction,42,23,19
55344,Garthbrookz,bleeding-hollow,1418,warlock,affliction,63,29,34
55345,Soulcore,area-52,1416,warlock,affliction,24,15,9
55346,Nutzosaurus,darkspear,1414,warlock,affliction,42,23,19
55347,Tizl,tichondrius,1411,warlock,affliction,162,79,83
55348,Skoobler,tichondrius,1409,warlock,affliction,99,54,45
55349,Sîthfu,tichondrius,1409,warlock,affliction,71,34,37
55350,Marà,ragnaros,1409,warlock,affliction,45,18,27
55351,Benafflock,kaelthas,1408,warlock,affliction,30,15,15
55352,Dårkfyre,kiljaeden,1406,warlock,affliction,24,15,9
55353,Elliarquet,akama,1404,warlock,affliction,106,52,54
55354,Yuckytoetoe,emerald-dream,1400,warlock,affliction,42,24,18
55355,Cantibor,illidan,1398,warlock,affliction,112,60,52
55356,Buckéthéad,arathor,1397,warlock,affliction,30,15,15
55357,Nookíe,azralon,1394,warlock,affliction,60,31,29
55358,Hottyscotty,tichondrius,1392,warlock,affliction,42,18,24
55359,Tuerie,illidan,1391,warlock,affliction,43,26,17
55360,Diosban,malganis,1391,warlock,affliction,48,20,28
55361,Äffie,aerie-peak,1390,warlock,affliction,144,70,74
55362,Morgil,suramar,1389,warlock,affliction,39,20,19
55363,Chachanoobx,sargeras,1387,warlock,affliction,48,23,25
55364,Munch,khadgar,1386,warlock,affliction,36,17,19
55365,Captrollol,tichondrius,1385,warlock,affliction,44,27,17
55366,Soloart,tichondrius,1385,warlock,affliction,36,15,21
55367,Winipuhmalo,quelthalas,1384,warlock,affliction,59,33,26
55368,Sweetjuly,area-52,1378,warlock,affliction,48,31,17
55369,Aerumna,barthilas,1378,warlock,affliction,30,15,15
55370,Gordaroth,barthilas,1376,warlock,affliction,41,24,17
55371,Boreo,ragnaros,1376,warlock,affliction,42,20,22
55372,Frylock,frostmourne,1372,warlock,affliction,74,33,41
55373,Lockneo,stormrage,1370,warlock,affliction,138,77,61
55374,Nicodareus,hellscream,1369,warlock,affliction,45,25,20
55375,Søül,tichondrius,1368,warlock,affliction,42,21,21
55376,Zinkro,quelthalas,1367,warlock,affliction,124,72,52
55377,Hairydotter,doomhammer,1365,warlock,affliction,42,24,18
55378,Dankdôtz,stormrage,1365,warlock,affliction,42,18,24
55379,Arillus,thrall,1364,warlock,affliction,53,29,24
55380,Bbangtimo,tichondrius,1363,warlock,affliction,26,15,11
55381,Jumlock,illidan,1363,warlock,affliction,43,24,19
55382,Koiboii,tichondrius,1362,warlock,affliction,24,16,8
55383,Acceptdeath,stormrage,1362,warlock,affliction,30,17,13
55384,Sinesta,bleeding-hollow,1355,warlock,affliction,36,20,16
55385,Feoona,hyjal,1354,warlock,affliction,72,41,31
55386,Chadre,feathermoon,1353,warlock,affliction,40,19,21
55387,Eilethen,cenarion-circle,1350,warlock,affliction,34,15,19
55388,Nutted,dentarg,1342,warlock,affliction,24,14,10
55389,Steven,firetree,1342,warlock,affliction,24,14,10
55390,Dotpocket,runetotem,1342,warlock,affliction,36,14,22
55391,Irene,nagrand,1341,warlock,affliction,37,23,14
55392,Albright,azralon,1340,warlock,affliction,24,14,10
55393,Ialfizzle,dethecus,1340,warlock,affliction,72,33,39
55394,Karpawarlock,ragnaros,1334,warlock,affliction,66,36,30
55395,Nazrakin,malganis,1333,warlock,affliction,54,26,28
55396,Fatuglyegirl,sargeras,1331,warlock,affliction,63,30,33
55397,Mèsut,malganis,1327,warlock,affliction,36,24,12
55398,Warakaso,ragnaros,1327,warlock,affliction,60,37,23
55399,Pepzz,emerald-dream,1327,warlock,affliction,48,23,25
55400,Aights,zuljin,1325,warlock,affliction,92,38,54
55401,Dippindots,boulderfist,1324,warlock,affliction,104,49,55
55402,Yyoyo,tichondrius,1318,warlock,affliction,36,24,12
55403,Munick,spirestone,1318,warlock,affliction,54,27,27
55404,Mïer,tichondrius,1315,warlock,affliction,89,47,42
55405,Dercrow,quelthalas,1314,warlock,affliction,38,21,17
55406,Valtimorh,ragnaros,1309,warlock,affliction,36,19,17
55407,Hemmlock,moknathal,1306,warlock,affliction,57,26,31
55408,Atraedes,moon-guard,1305,warlock,affliction,80,43,37
55409,Côp,tichondrius,1303,warlock,affliction,71,31,40
55410,Violentx,tichondrius,1301,warlock,affliction,45,20,25
55411,Castngcouch,tichondrius,1296,warlock,affliction,117,62,55
55412,Fluffylockk,bloodscalp,1295,warlock,affliction,52,26,26
55413,Punished,arthas,1293,warlock,affliction,56,30,26
55414,Pipeo,quelthalas,1288,warlock,affliction,126,72,54
55415,Whathurts,tichondrius,1287,warlock,affliction,32,23,9
55416,Eyedot,stormscale,1285,warlock,affliction,24,18,6
55417,Ouijafaps,sargeras,1285,warlock,affliction,30,14,16
55418,Ysnou,nemesis,1283,warlock,affliction,42,24,18
55419,Avatar,uldum,1283,warlock,affliction,60,26,34
55420,Beelzismurph,emerald-dream,1281,warlock,affliction,63,31,32
55421,Gregg,laughing-skull,1276,warlock,affliction,150,80,70
55422,Novichok,amanthul,1276,warlock,affliction,36,15,21
55423,Moxz,garona,1275,warlock,affliction,54,20,34
55424,Aalkaid,dathremar,1273,warlock,affliction,54,31,23
55425,Zamorakk,nemesis,1272,warlock,affliction,58,33,25
55426,Ragnalock,laughing-skull,1270,warlock,affliction,24,14,10
55427,Volsace,moon-guard,1267,warlock,affliction,30,14,16
55428,Fshi,frostmourne,1266,warlock,affliction,50,30,20
55429,Baiano,nagrand,1265,warlock,affliction,46,19,27
55430,Lisaleda,stormrage,1263,warlock,affliction,30,16,14
55431,Wallow,thunderhorn,1258,warlock,affliction,65,34,31
55432,Snuzzock,darkspear,1254,warlock,affliction,35,14,21
55433,Aikonor,stormrage,1253,warlock,affliction,72,33,39
55434,Spi,chogall,1250,warlock,affliction,134,63,71
55435,Squasum,sargeras,1249,warlock,affliction,147,77,70
55436,Barovir,tichondrius,1247,warlock,affliction,18,13,5
55437,Gurlock,illidan,1246,warlock,affliction,42,26,16
55438,Mindfulchimp,sargeras,1246,warlock,affliction,50,21,29
55439,Quitxmanlm,tichondrius,1245,warlock,affliction,24,13,11
55440,Kreatur,ragnaros,1244,warlock,affliction,60,28,32
55441,Balveer,tichondrius,1243,warlock,affliction,28,14,14
55442,Stonelocke,area-52,1242,warlock,affliction,30,14,16
55443,Eraticlock,illidan,1237,warlock,affliction,25,13,12
55444,Lotdon,blackrock,1235,warlock,affliction,89,38,51
55445,Reckzet,stormrage,1234,warlock,affliction,24,13,11
55446,Lilliara,korgath,1232,warlock,affliction,41,16,25
55447,Onmyioji,dalaran,1228,warlock,affliction,18,13,5
55448,Cascades,icecrown,1228,warlock,affliction,37,19,18
55449,Dotsarehot,dreadmaul,1227,warlock,affliction,30,13,17
55450,Aeonss,stormrage,1222,warlock,affliction,48,22,26
55451,Killernix,drakkari,1219,warlock,affliction,54,29,25
55452,Juniorsalanu,quelthalas,1219,warlock,affliction,97,43,54
55453,Ciprýan,azralon,1218,warlock,affliction,24,14,10
55454,Mysoultotake,sargeras,1212,warlock,affliction,24,13,11
55455,Kogath,thunderlord,1209,warlock,affliction,53,29,24
55456,Tohkisaeki,dalaran,1209,warlock,affliction,60,31,29
55457,Phelly,frostmourne,1205,warlock,affliction,75,41,34
55458,Coolwipp,demon-soul,1201,warlock,affliction,157,76,81
55459,Yoyoling,illidan,1200,warlock,affliction,82,43,39
55460,Zaliki,hellscream,1191,warlock,affliction,30,20,10
55461,Curaven,emerald-dream,1189,warlock,affliction,29,13,16
55462,Bashel,sargeras,1185,warlock,affliction,51,32,19
55463,Thoxy,barthilas,1182,warlock,affliction,36,14,22
55464,Slakiejr,darkspear,1180,warlock,affliction,22,13,9
55465,Eightyfall,barthilas,1180,warlock,affliction,40,17,23
55466,Critthis,illidan,1175,warlock,affliction,42,21,21
55467,Candykrush,tichondrius,1173,warlock,affliction,30,18,12
55468,Batär,area-52,1171,warlock,affliction,62,26,36
55469,Saltyfries,wildhammer,1165,warlock,affliction,42,14,28
55470,Poltergiiest,korgath,1164,warlock,affliction,24,13,11
55471,Khatrat,azralon,1164,warlock,affliction,106,43,63
55472,Sammythebull,frostwolf,1159,warlock,affliction,32,17,15
55473,Mymmic,ragnaros,1158,warlock,affliction,88,37,51
55474,Finnek,moon-guard,1155,warlock,affliction,30,17,13
55475,Lilpewpeww,bleeding-hollow,1154,warlock,affliction,123,60,63
55476,Promann,drakkari,1151,warlock,affliction,12,12,0
55477,Háydn,azuremyst,1151,warlock,affliction,18,12,6
55478,Guldåniel,tichondrius,1150,warlock,affliction,18,12,6
55479,Kruxxqt,illidan,1150,warlock,affliction,24,12,12
55480,Nestpas,tichondrius,1150,warlock,affliction,33,14,19
55481,Kyugin,goldrinn,1148,warlock,affliction,24,12,12
55482,Rakshama,chogall,1148,warlock,affliction,24,12,12
55483,Zeviaem,quelthalas,1146,warlock,affliction,24,12,12
55484,Necroñomicon,malganis,1145,warlock,affliction,18,12,6
55485,Iainmbanks,barthilas,1143,warlock,affliction,226,104,122
55486,Fyahwalka,aggramar,1143,warlock,affliction,48,19,29
55487,Millyvanilly,tichondrius,1140,warlock,affliction,24,12,12
55488,Studious,sargeras,1139,warlock,affliction,26,15,11
55489,Skrufenjoyer,sargeras,1137,warlock,affliction,81,38,43
55490,Buucocky,proudmoore,1136,warlock,affliction,30,16,14
55491,Sugarwaffles,area-52,1135,warlock,affliction,18,12,6
55492,Ikis,cenarion-circle,1134,warlock,affliction,24,15,9
55493,Fearocity,argent-dawn,1130,warlock,affliction,33,15,18
55494,Azâziel,ragnaros,1128,warlock,affliction,35,17,18
55495,Doombaby,zuljin,1124,warlock,affliction,24,12,12
55496,Flangy,kiljaeden,1123,warlock,affliction,84,33,51
55497,Mothapucka,thrall,1123,warlock,affliction,36,12,24
55498,Päinoth,wyrmrest-accord,1122,warlock,affliction,42,26,16
55499,Nedrien,moon-guard,1120,warlock,affliction,54,28,26
55500,Drskeeters,malganis,1116,warlock,affliction,26,13,13
55501,Zrx,proudmoore,1115,warlock,affliction,69,27,42
55502,Beetlegiese,doomhammer,1114,warlock,affliction,40,19,21
55503,Sylencia,demon-soul,1107,warlock,affliction,36,13,23
55504,Kokoto,azralon,1102,warlock,affliction,60,37,23
55505,Auntzhang,tichondrius,1101,warlock,affliction,29,12,17
55506,Phøbøs,hyjal,1099,warlock,affliction,24,13,11
55507,Dipdip,illidan,1097,warlock,affliction,63,25,38
55508,Yosuljaengi,stormrage,1095,warlock,affliction,84,38,46
55509,Rickrock,gnomeregan,1091,warlock,affliction,34,16,18
55510,Littlepain,goldrinn,1071,warlock,affliction,30,14,16
55511,Elander,azuremyst,1067,warlock,affliction,30,17,13
55512,Swinefrommud,zuljin,1056,warlock,affliction,24,11,13
55513,Calculator,tichondrius,1055,warlock,affliction,24,11,13
55514,Wreyz,mannoroth,1053,warlock,affliction,18,11,7
55515,Asetiks,tichondrius,1052,warlock,affliction,24,11,13
55516,Gateor,zuljin,1051,warlock,affliction,24,11,13
55517,Belaflore,moon-guard,1050,warlock,affliction,24,11,13
55518,Beitrice,barthilas,1050,warlock,affliction,30,11,19
55519,Psx,frostmourne,1049,warlock,affliction,24,11,13
55520,Naburn,tichondrius,1049,warlock,affliction,24,11,13
55521,Eastwitch,ragnaros,1048,warlock,affliction,24,11,13
55522,Pauldiesel,ragnaros,1048,warlock,affliction,26,11,15
55523,Guacamolock,drakkari,1045,warlock,affliction,24,11,13
55524,Cozu,tichondrius,1045,warlock,affliction,30,11,19
55525,Mangku,frostmourne,1042,warlock,affliction,46,19,27
55526,Teaset,hellscream,1039,warlock,affliction,66,33,33
55527,Krïttzïe,proudmoore,1039,warlock,affliction,58,28,30
55528,Deusita,kelthuzad,1039,warlock,affliction,24,11,13
55529,Rorrlex,muradin,1037,warlock,affliction,42,20,22
55530,Berszerk,quelthalas,1037,warlock,affliction,30,11,19
55531,Hungovermate,barthilas,1036,warlock,affliction,18,13,5
55532,Donnellus,frostmane,1028,warlock,affliction,24,14,10
55533,Basticor,moon-guard,1024,warlock,affliction,42,18,24
55534,Medallok,laughing-skull,1021,warlock,affliction,54,28,26
55535,Aerozyn,wyrmrest-accord,1013,warlock,affliction,30,17,13
55536,Dirtydeikan,stormrage,1010,warlock,affliction,65,29,36
55537,Duuka,malganis,1008,warlock,affliction,15,12,3
55538,Halzarn,agamaggan,1008,warlock,affliction,36,19,17
55539,Darkestholy,illidan,1006,warlock,affliction,23,11,12
55540,Shadöwdancer,uldum,1005,warlock,affliction,24,16,8
55541,Corvos,garrosh,1001,warlock,affliction,32,12,20
55542,Medran,azralon,996,warlock,affliction,62,34,28
55543,Wizlox,illidan,996,warlock,affliction,33,11,22
55544,Miredö,tichondrius,991,warlock,affliction,23,11,12
55545,Whydemono,tichondrius,982,warlock,affliction,26,11,15
55546,Dreadloxx,whisperwind,979,warlock,affliction,48,23,25
55547,Malleus,drakkari,975,warlock,affliction,24,11,13
55548,Avelmi,daggerspine,964,warlock,affliction,31,11,20
55549,Wardocc,sargeras,962,warlock,affliction,66,31,35
55550,Dotymania,aegwynn,959,warlock,affliction,18,10,8
55551,Lapandemica,gorefiend,959,warlock,affliction,24,10,14
55552,Shadowhax,area-52,959,warlock,affliction,24,10,14
55553,Niubeelol,tichondrius,959,warlock,affliction,24,10,14
55554,Cvoaw,bonechewer,958,warlock,affliction,12,10,2
55555,Bobbyross,garrosh,958,warlock,affliction,16,11,5
55556,Wtb,blackrock,958,warlock,affliction,18,10,8
55557,Malagas,tichondrius,958,warlock,affliction,18,10,8
55558,Makumbeiro,sargeras,958,warlock,affliction,18,10,8
55559,Mxd,ragnaros,958,warlock,affliction,18,10,8
55560,Downing,drakkari,958,warlock,affliction,71,26,45
55561,Xdq,malganis,957,warlock,affliction,27,12,15
55562,Qualio,thrall,957,warlock,affliction,24,10,14
55563,Caustikk,malganis,956,warlock,affliction,18,10,8
55564,Arzenexx,malganis,954,warlock,affliction,36,20,16
55565,Lockinha,azralon,953,warlock,affliction,18,10,8
55566,Jennifear,sargeras,952,warlock,affliction,18,10,8
55567,Victani,gallywix,946,warlock,affliction,18,10,8
55568,Oreo,velen,942,warlock,affliction,30,10,20
55569,Avadakedávra,darkspear,941,warlock,affliction,18,10,8
55570,Mpm,dragonmaw,906,warlock,affliction,30,15,15
55571,Thetopg,bronzebeard,896,warlock,affliction,21,11,10
55572,Popdotdropit,frostwolf,895,warlock,affliction,17,10,7
55573,Britainwl,azshara,892,warlock,affliction,30,13,17
55574,Ioroselmi,illidan,871,warlock,affliction,25,10,15
55575,Ruphilin,fizzcrank,864,warlock,affliction,12,9,3
55576,Conboee,tichondrius,864,warlock,affliction,12,9,3
55577,Nöxïöüs,sargeras,864,warlock,affliction,12,9,3
55578,Quitxman,tichondrius,864,warlock,affliction,12,9,3
55579,Minglocked,proudmoore,864,warlock,affliction,18,9,9
55580,Crayonchewer,alleria,864,warlock,affliction,18,9,9
55581,Jfet,sargeras,864,warlock,affliction,18,9,9
55582,Dejagu,tichondrius,864,warlock,affliction,24,9,15
55583,Halloweèn,kelthuzad,863,warlock,affliction,12,9,3
55584,Demonycc,archimonde,863,warlock,affliction,12,9,3
55585,Bjarke,malganis,863,warlock,affliction,12,9,3
55586,Búmchúm,frostmourne,863,warlock,affliction,18,9,9
55587,Sslock,sargeras,863,warlock,affliction,18,9,9
55588,Devdolittle,tichondrius,863,warlock,affliction,18,9,9
55589,Twilson,moon-guard,863,warlock,affliction,18,9,9
55590,Nerd,fizzcrank,862,warlock,affliction,12,9,3
55591,Astralrunner,moon-guard,862,warlock,affliction,18,9,9
55592,Sesyid,tichondrius,862,warlock,affliction,18,9,9
55593,Scarysherri,aggramar,862,warlock,affliction,24,9,15
55594,Sarkahn,sargeras,862,warlock,affliction,24,9,15
55595,Thisist,kiljaeden,861,warlock,affliction,12,9,3
55596,Vyntras,kelthuzad,861,warlock,affliction,18,9,9
55597,Bignoselock,illidan,861,warlock,affliction,18,9,9
55598,Abyssisle,malygos,860,warlock,affliction,20,10,10
55599,Awp,malganis,860,warlock,affliction,18,9,9
55600,Holloch,bonechewer,860,warlock,affliction,18,9,9
55601,Smockalock,proudmoore,857,warlock,affliction,18,9,9
55602,Tinydotz,hydraxis,856,warlock,affliction,18,10,8
55603,Mörgana,quelthalas,856,warlock,affliction,19,10,9
55604,Yratiprocs,ysera,853,warlock,affliction,18,9,9
55605,Obertito,kelthuzad,828,warlock,affliction,16,9,7
55606,Mustacheguy,tichondrius,805,warlock,affliction,29,9,20
55607,Buccs,barthilas,799,warlock,affliction,11,9,2
55608,Maelganis,thrall,796,warlock,affliction,17,9,8
55609,Handlevil,stormrage,787,warlock,affliction,16,9,7
55610,Hexxüs,area-52,784,warlock,affliction,19,9,10
55611,Kåléïðøsçøpè,sargeras,768,warlock,affliction,12,8,4
55612,Dötsonurpp,stormrage,768,warlock,affliction,12,8,4
55613,Hutchyw,tichondrius,768,warlock,affliction,12,8,4
55614,Púp,bleeding-hollow,768,warlock,affliction,12,8,4
55615,Sadoldman,malganis,768,warlock,affliction,12,8,4
55616,Dethklokx,tichondrius,768,warlock,affliction,12,8,4
55617,Slothdots,tichondrius,768,warlock,affliction,12,8,4
55618,Richãrdjr,area-52,768,warlock,affliction,12,8,4
55619,Herladytha,aegwynn,767,warlock,affliction,12,8,4
55620,Antigotenent,sargeras,767,warlock,affliction,12,8,4
55621,Wreckquiem,draka,767,warlock,affliction,12,8,4
55622,Losecontrol,illidan,767,warlock,affliction,12,8,4
55623,Brujoalfa,ragnaros,767,warlock,affliction,12,8,4
55624,Pokendot,illidan,767,warlock,affliction,18,8,10
55625,Yeepzbytre,bleeding-hollow,767,warlock,affliction,18,8,10
55626,Buboñic,area-52,767,warlock,affliction,18,8,10
55627,Oblivious,firetree,767,warlock,affliction,18,8,10
55628,Fearharder,stormrage,767,warlock,affliction,24,8,16
55629,Arkterris,doomhammer,766,warlock,affliction,18,8,10
55630,Flixon,tichondrius,765,warlock,affliction,12,8,4
55631,Çheesestick,dalaran,765,warlock,affliction,18,8,10
55632,Bëëlzebub,crushridge,765,warlock,affliction,18,8,10
55633,Aksness,stormrage,765,warlock,affliction,24,8,16
55634,Dowglips,area-52,763,warlock,affliction,18,8,10
55635,Cássandra,ragnaros,761,warlock,affliction,12,8,4
55636,Radamantîs,ragnaros,761,warlock,affliction,18,8,10
55637,Jakedbtw,crushridge,759,warlock,affliction,12,8,4
55638,Covidkillerr,tichondrius,759,warlock,affliction,13,8,5
55639,Rotfull,burning-legion,751,warlock,affliction,17,8,9
55640,Seecurse,kelthuzad,735,warlock,affliction,17,8,9
55641,Hiddentech,saurfang,719,warlock,affliction,11,8,3
55642,Apéx,frostmourne,716,warlock,affliction,17,8,9
55643,Amgs,frostmourne,714,warlock,affliction,23,11,12
55644,Nuckz,whisperwind,687,warlock,affliction,14,9,5
55645,Modot,tichondrius,685,warlock,affliction,23,9,14
55646,Charïs,ragnaros,679,warlock,affliction,13,8,5
55647,Dotfearspam,alterac-mountains,679,warlock,affliction,21,8,13
55648,Miratrix,moon-guard,672,warlock,affliction,12,7,5
55649,Bakko,tichondrius,672,warlock,affliction,12,7,5
55650,Geofar,bleeding-hollow,672,warlock,affliction,12,7,5
55651,Delaye,tichondrius,672,warlock,affliction,12,7,5
55652,Ellneggro,zuljin,672,warlock,affliction,12,7,5
55653,Casslight,tichondrius,672,warlock,affliction,12,7,5
55654,Halethadro,emerald-dream,672,warlock,affliction,12,7,5
55655,Drowzy,undermine,672,warlock,affliction,12,7,5
55656,Kuhio,korgath,672,warlock,affliction,12,7,5
55657,Garbocan,area-52,672,warlock,affliction,12,7,5
55658,Glortheeb,spirestone,672,warlock,affliction,18,7,11
55659,Necromâncer,stormreaver,672,warlock,affliction,18,7,11
55660,Icemanliddel,area-52,672,warlock,affliction,18,7,11
55661,Oogren,korgath,672,warlock,affliction,18,7,11
55662,Djminuterice,bleeding-hollow,671,warlock,affliction,12,7,5
55663,Killhorde,thunderlord,671,warlock,affliction,12,7,5
55664,Zurp,wyrmrest-accord,671,warlock,affliction,12,7,5
55665,Ãids,khadgar,671,warlock,affliction,12,7,5
55666,Aruotnof,nemesis,671,warlock,affliction,12,7,5
55667,Tekkiez,barthilas,671,warlock,affliction,12,7,5
55668,Foxyloxy,hakkar,671,warlock,affliction,14,7,7
55669,Korguji,tichondrius,671,warlock,affliction,18,7,11
55670,Jìbril,stormrage,671,warlock,affliction,18,7,11
55671,Skyvre,tichondrius,670,warlock,affliction,12,7,5
55672,Lockaloga,azralon,670,warlock,affliction,12,7,5
55673,Afflicmindz,azralon,670,warlock,affliction,12,7,5
55674,Kuoma,boulderfist,670,warlock,affliction,12,7,5
55675,Miermortal,tichondrius,670,warlock,affliction,18,7,11
55676,Magicbones,tichondrius,669,warlock,affliction,15,8,7
55677,Tsmcfker,tichondrius,669,warlock,affliction,22,9,13
55678,Mefound,nerzhul,668,warlock,affliction,12,7,5
55679,Larlock,black-dragonflight,667,warlock,affliction,12,7,5
55680,Zipstream,dark-iron,667,warlock,affliction,24,7,17
55681,Balmir,tichondrius,658,warlock,affliction,18,7,11
55682,Gummylock,frostmourne,623,warlock,affliction,11,7,4
55683,Paparoxy,illidan,623,warlock,affliction,15,8,7
55684,Bludshadow,duskwood,620,warlock,affliction,21,7,14
55685,Radiscul,dragonmaw,619,warlock,affliction,17,7,10
55686,Yury,scarlet-crusade,617,warlock,affliction,17,7,10
55687,Cezarz,tichondrius,592,warlock,affliction,13,7,6
55688,Sikmagic,kelthuzad,576,warlock,affliction,12,6,6
55689,Brunemon,proudmoore,576,warlock,affliction,12,6,6
55690,Xtremegirth,zuljin,576,warlock,affliction,12,6,6
55691,Lilcarmy,emerald-dream,576,warlock,affliction,12,6,6
55692,Løcalplugxø,barthilas,576,warlock,affliction,12,6,6
55693,Sluglishphsh,stormrage,576,warlock,affliction,12,6,6
55694,Khil,darkspear,576,warlock,affliction,12,6,6
55695,Biubius,tichondrius,576,warlock,affliction,12,6,6
55696,Parishiltoon,frostmourne,576,warlock,affliction,12,6,6
55697,Kryllua,tichondrius,576,warlock,affliction,12,6,6
55698,Lokkup,dalaran,576,warlock,affliction,12,6,6
55699,Gianni,chogall,576,warlock,affliction,12,6,6
55700,Rainmakers,moon-guard,576,warlock,affliction,12,6,6
55701,Shadøwy,nemesis,576,warlock,affliction,12,6,6
55702,Toelickerx,illidan,576,warlock,affliction,12,6,6
55703,Goofgoof,sargeras,576,warlock,affliction,12,6,6
55704,Neevius,barthilas,576,warlock,affliction,12,6,6
55705,Fearophobic,illidan,576,warlock,affliction,12,6,6
55706,Chrishasnen,moon-guard,576,warlock,affliction,12,6,6
55707,Nihilus,anvilmar,576,warlock,affliction,12,6,6
55708,Dogfiend,spirestone,576,warlock,affliction,12,6,6
55709,Nadablast,tichondrius,576,warlock,affliction,12,6,6
55710,Abrocket,alleria,576,warlock,affliction,12,6,6
55711,Datazdotcom,illidan,576,warlock,affliction,12,6,6
55712,Haross,darkspear,576,warlock,affliction,18,6,12
55713,Demiloy,stormrage,576,warlock,affliction,18,6,12
55714,Catdrugs,kelthuzad,576,warlock,affliction,18,6,12
55715,Muchø,emerald-dream,576,warlock,affliction,24,6,18
55716,Infortunium,sargeras,575,warlock,affliction,12,6,6
55717,Drivercurses,terenas,575,warlock,affliction,12,6,6
55718,Lomeron,sargeras,575,warlock,affliction,12,6,6
55719,Leroybrown,alterac-mountains,575,warlock,affliction,12,6,6
55720,Shadowbo,aggramar,575,warlock,affliction,12,6,6
55721,Jhop,sargeras,575,warlock,affliction,12,6,6
55722,Kunozonbi,malganis,575,warlock,affliction,12,6,6
55723,Deatthmoon,stormrage,575,warlock,affliction,12,6,6
55724,Gødmôde,tichondrius,575,warlock,affliction,12,6,6
55725,Valvravé,malganis,575,warlock,affliction,12,6,6
55726,Blacadder,azgalor,575,warlock,affliction,18,6,12
55727,Zuldar,tichondrius,575,warlock,affliction,18,6,12
55728,Holdmybeard,senjin,575,warlock,affliction,18,6,12
55729,Bloodybooger,area-52,574,warlock,affliction,12,6,6
55730,Conrii,burning-blade,574,warlock,affliction,18,6,12
55731,Sind,garona,573,warlock,affliction,12,6,6
55732,Lockë,thunderlord,572,warlock,affliction,12,6,6
55733,Hâunted,khazgoroth,571,warlock,affliction,12,6,6
55734,Justero,kelthuzad,569,warlock,affliction,12,6,6
55735,Kflexxpt,hydraxis,569,warlock,affliction,12,6,6
55736,Socketriver,bleeding-hollow,568,warlock,affliction,18,6,12
55737,Gnock,garona,543,warlock,affliction,11,6,5
55738,Raff,detheroc,527,warlock,affliction,11,6,5
55739,Louuis,barthilas,521,warlock,affliction,13,7,6
55740,Vrajitor,ragnaros,511,warlock,affliction,11,6,5
55741,Markuss,boulderfist,511,warlock,affliction,14,6,8
55742,Dotdoctor,thrall,511,warlock,affliction,16,6,10
55743,Oluluo,andorhal,510,warlock,affliction,8,6,2
55744,Beexy,sargeras,510,warlock,affliction,14,6,8
55745,Halciyon,dalvengyr,495,warlock,affliction,19,6,13
55746,Misolock,sargeras,480,warlock,affliction,6,5,1
55747,Satunir,shadowsong,480,warlock,affliction,6,5,1
55748,Varix,frostmourne,480,warlock,affliction,6,5,1
55749,Bigdamege,tichondrius,480,warlock,affliction,6,5,1
55750,Lucro,emerald-dream,480,warlock,affliction,6,5,1
55751,Bobthedragqn,proudmoore,480,warlock,affliction,6,5,1
55752,Lunazz,tichondrius,480,warlock,affliction,6,5,1
55753,Flòwstate,tichondrius,480,warlock,affliction,6,5,1
55754,Fruityß,kaelthas,480,warlock,affliction,6,5,1
55755,Ttub,stormrage,480,warlock,affliction,6,5,1
55756,Conkeldurr,tichondrius,480,warlock,affliction,6,5,1
55757,Faschom,tichondrius,480,warlock,affliction,6,5,1
55758,Ribman,stormrage,480,warlock,affliction,6,5,1
55759,Perfectwar,tichondrius,480,warlock,affliction,12,5,7
55760,Poogâ,tichondrius,480,warlock,affliction,12,5,7
55761,Rexuss,velen,480,warlock,affliction,12,5,7
55762,Artzul,tichondrius,480,warlock,affliction,12,5,7
55763,Chaoz,aggramar,480,warlock,affliction,12,5,7
55764,Andrewpg,zuljin,480,warlock,affliction,12,5,7
55765,Goldface,frostmourne,480,warlock,affliction,12,5,7
55766,Cryolock,nagrand,480,warlock,affliction,12,5,7
55767,Yogurtslingr,tichondrius,480,warlock,affliction,12,5,7
55768,Prarkmur,illidan,480,warlock,affliction,12,5,7
55769,Itsmedirt,malganis,480,warlock,affliction,12,5,7
55770,Frylockk,mugthol,480,warlock,affliction,12,5,7
55771,Tvfazedorito,kelthuzad,480,warlock,affliction,12,5,7
55772,Bwup,tichondrius,480,warlock,affliction,12,5,7
55773,Wanglock,blackrock,480,warlock,affliction,12,5,7
55774,Necrosith,ragnaros,480,warlock,affliction,15,6,9
55775,Lockboxx,stormscale,480,warlock,affliction,18,5,13
55776,Lockring,zuljin,480,warlock,affliction,18,5,13
55777,Daesire,moon-guard,480,warlock,affliction,18,5,13
55778,Symplicìty,area-52,479,warlock,affliction,6,5,1
55779,Tatemor,barthilas,479,warlock,affliction,12,5,7
55780,Ruegger,stormscale,479,warlock,affliction,12,5,7
55781,Pruevolf,tichondrius,479,warlock,affliction,12,5,7
55782,Morepetss,saurfang,479,warlock,affliction,12,5,7
55783,Hélà,sargeras,479,warlock,affliction,18,5,13
55784,Whitchpoison,nagrand,479,warlock,affliction,30,5,25
55785,Fearfactory,lethon,478,warlock,affliction,12,5,7
55786,Cityswimmer,malganis,478,warlock,affliction,12,5,7
55787,Redbro,darkspear,478,warlock,affliction,12,5,7
55788,Dravin,alleria,478,warlock,affliction,12,5,7
55789,Skellisama,moon-guard,478,warlock,affliction,18,5,13
55790,Suzüki,tichondrius,463,warlock,affliction,11,5,6
55791,Demfearslol,terokkar,447,warlock,affliction,11,5,6
55792,Puddlepiimp,illidan,431,warlock,affliction,11,5,6
55793,Verrøkel,sargeras,426,warlock,affliction,11,7,4
55794,Khaozx,ragnaros,416,warlock,affliction,10,5,5
55795,Fublizz,black-dragonflight,416,warlock,affliction,10,5,5
55796,Onlytoez,tichondrius,416,warlock,affliction,16,5,11
55797,Kuroyt,drakkari,415,warlock,affliction,12,6,6
55798,Amaroth,spinebreaker,415,warlock,affliction,20,5,15
55799,Calvärr,bleeding-hollow,384,warlock,affliction,6,4,2
55800,Demoiceman,bleeding-hollow,384,warlock,affliction,6,4,2
55801,Siller,azralon,384,warlock,affliction,6,4,2
55802,Cowboydann,malganis,384,warlock,affliction,6,4,2
55803,Jotkbe,ragnaros,384,warlock,affliction,6,4,2
55804,Purplelambox,illidan,384,warlock,affliction,6,4,2
55805,Tonickush,area-52,384,warlock,affliction,6,4,2
55806,Vamperro,thrall,384,warlock,affliction,6,4,2
55807,Astarõth,zuljin,384,warlock,affliction,6,4,2
55808,Bliztivision,proudmoore,384,warlock,affliction,6,4,2
55809,Discordance,zuljin,384,warlock,affliction,6,4,2
55810,Bänno,bleeding-hollow,384,warlock,affliction,6,4,2
55811,Soulrman,tichondrius,384,warlock,affliction,6,4,2
55812,Blliizz,aegwynn,384,warlock,affliction,6,4,2
55813,Gasgrassnass,sargeras,384,warlock,affliction,6,4,2
55814,Methrocks,tichondrius,384,warlock,affliction,6,4,2
55815,Gümbÿ,illidan,384,warlock,affliction,6,4,2
55816,Celin,rivendare,384,warlock,affliction,6,4,2
55817,Omleaf,malganis,384,warlock,affliction,6,4,2
55818,Eupheriia,thaurissan,384,warlock,affliction,6,4,2
55819,Demonug,area-52,384,warlock,affliction,6,4,2
55820,Breeped,tichondrius,384,warlock,affliction,6,4,2
55821,Flippinfear,illidan,384,warlock,affliction,6,4,2
55822,Superbroly,area-52,384,warlock,affliction,6,4,2
55823,Omegapasta,illidan,384,warlock,affliction,6,4,2
55824,Walterrør,nemesis,384,warlock,affliction,6,4,2
55825,Plsdontcrit,tichondrius,384,warlock,affliction,6,4,2
55826,Tylandér,nordrassil,384,warlock,affliction,6,4,2
55827,Jessndistres,stormrage,384,warlock,affliction,6,4,2
55828,Rbnz,kiljaeden,384,warlock,affliction,6,4,2
55829,Torchie,moon-guard,384,warlock,affliction,6,4,2
55830,Silkxy,frostwolf,384,warlock,affliction,6,4,2
55831,Locker,darkspear,384,warlock,affliction,6,4,2
55832,Hypnotikal,illidan,384,warlock,affliction,6,4,2
55833,Redmist,arthas,384,warlock,affliction,6,4,2
55834,Åbyssal,stormrage,384,warlock,affliction,6,4,2
55835,Necroraise,boulderfist,384,warlock,affliction,9,5,4
55836,Lockie,skywall,384,warlock,affliction,12,4,8
55837,Bharim,quelthalas,384,warlock,affliction,12,4,8
55838,Bmó,stormrage,384,warlock,affliction,12,4,8
55839,Nethron,the-venture-co,384,warlock,affliction,12,4,8
55840,Afflicktion,frostmourne,384,warlock,affliction,12,4,8
55841,Yagumi,crushridge,384,warlock,affliction,12,4,8
55842,Sosomaa,kelthuzad,384,warlock,affliction,12,4,8
55843,Fearedit,bleeding-hollow,384,warlock,affliction,12,4,8
55844,Bigheadjr,gorgonnash,384,warlock,affliction,12,4,8
55845,Bïcho,queldorei,384,warlock,affliction,12,4,8
55846,Emptysoul,illidan,384,warlock,affliction,12,4,8
55847,Dotsfìred,tichondrius,384,warlock,affliction,12,4,8
55848,Tichonkimc,tichondrius,384,warlock,affliction,12,4,8
55849,Duckboji,tichondrius,384,warlock,affliction,12,4,8
55850,Promancer,drakkari,384,warlock,affliction,12,4,8
55851,Velanthra,skullcrusher,384,warlock,affliction,12,4,8
55852,Punstable,tichondrius,384,warlock,affliction,12,4,8
55853,Emptyx,tichondrius,384,warlock,affliction,12,4,8
55854,Fksm,tichondrius,384,warlock,affliction,12,4,8
55855,Necromaniac,nerzhul,384,warlock,affliction,18,4,14
55856,Lockazo,quelthalas,383,warlock,affliction,6,4,2
55857,Persianloc,tichondrius,383,warlock,affliction,12,4,8
55858,Luciffer,windrunner,383,warlock,affliction,12,4,8
55859,Wirthless,area-52,383,warlock,affliction,12,4,8
55860,Slord,bonechewer,382,warlock,affliction,6,4,2
55861,Darkdestine,emerald-dream,382,warlock,affliction,12,4,8
55862,Damint,sargeras,351,warlock,affliction,11,4,7
55863,Xaemog,tichondrius,351,warlock,affliction,17,4,13
55864,Gattsonn,kiljaeden,350,warlock,affliction,12,5,7
55865,Felmort,bleeding-hollow,319,warlock,affliction,17,4,13
55866,Marinw,azralon,304,warlock,affliction,7,4,3
55867,Brujildå,area-52,304,warlock,affliction,13,4,9
55868,Shadows,arygos,288,warlock,affliction,6,3,3
55869,Impbiscuit,stormrage,288,warlock,affliction,6,3,3
55870,Vintagepoop,sargeras,288,warlock,affliction,6,3,3
55871,Bajheerafan,illidan,288,warlock,affliction,6,3,3
55872,Kamai,frostwolf,288,warlock,affliction,6,3,3
55873,Leônidos,ghostlands,288,warlock,affliction,6,3,3
55874,Chaôtic,daggerspine,288,warlock,affliction,6,3,3
55875,Warlockmf,sargeras,288,warlock,affliction,6,3,3
55876,Warfeen,malganis,288,warlock,affliction,6,3,3
55877,Freseate,quelthalas,288,warlock,affliction,6,3,3
55878,Berathelok,aerie-peak,288,warlock,affliction,6,3,3
55879,Róckroad,lightnings-blade,288,warlock,affliction,6,3,3
55880,Blockk,moknathal,288,warlock,affliction,6,3,3
55881,Yanlexx,stormrage,288,warlock,affliction,6,3,3
55882,Emurog,icecrown,288,warlock,affliction,6,3,3
55883,Diablox,silvermoon,288,warlock,affliction,6,3,3
55884,Frylockx,mugthol,288,warlock,affliction,6,3,3
55885,Stepzxo,sargeras,288,warlock,affliction,6,3,3
55886,Tìdals,zuljin,288,warlock,affliction,6,3,3
55887,Sinaman,barthilas,288,warlock,affliction,6,3,3
55888,Drdoom,sargeras,288,warlock,affliction,6,3,3
55889,Hachiui,galakrond,288,warlock,affliction,6,3,3
55890,Chåndler,nemesis,288,warlock,affliction,6,3,3
55891,Nozyroh,emerald-dream,288,warlock,affliction,6,3,3
55892,Hauntu,stormreaver,288,warlock,affliction,6,3,3
55893,Sidiouss,dreadmaul,288,warlock,affliction,6,3,3
55894,Kokushu,burning-legion,288,warlock,affliction,6,3,3
55895,Kossnen,shandris,288,warlock,affliction,6,3,3
55896,Arnan,korgath,288,warlock,affliction,6,3,3
55897,Conboii,tichondrius,288,warlock,affliction,6,3,3
55898,Capïrota,nemesis,288,warlock,affliction,6,3,3
55899,Alarauca,nerzhul,288,warlock,affliction,6,3,3
55900,Crucifieds,tichondrius,288,warlock,affliction,6,3,3
55901,Feldubya,illidan,288,warlock,affliction,6,3,3
55902,Naag,tichondrius,288,warlock,affliction,6,3,3
55903,Lockfold,illidan,288,warlock,affliction,6,3,3
55904,Knäbue,tichondrius,288,warlock,affliction,6,3,3
55905,Boltqt,tichondrius,288,warlock,affliction,6,3,3
55906,Wizie,arthas,288,warlock,affliction,6,3,3
55907,Harleyjames,ravenholdt,288,warlock,affliction,6,3,3
55908,Liliasintera,dentarg,288,warlock,affliction,6,3,3
55909,Aanx,dark-iron,288,warlock,affliction,6,3,3
55910,Redsolojdc,tichondrius,288,warlock,affliction,6,3,3
55911,Stormrift,sargeras,288,warlock,affliction,6,3,3
55912,Dodgebolts,khaz-modan,288,warlock,affliction,6,3,3
55913,Phishdots,tichondrius,288,warlock,affliction,6,3,3
55914,Voltshot,tichondrius,288,warlock,affliction,6,3,3
55915,Schofen,tichondrius,288,warlock,affliction,6,3,3
55916,Chermonalbur,draka,288,warlock,affliction,9,3,6
55917,Imien,moknathal,288,warlock,affliction,9,3,6
55918,Felno,emerald-dream,288,warlock,affliction,12,3,9
55919,Aluridan,azralon,288,warlock,affliction,12,3,9
55920,Denji,galakrond,288,warlock,affliction,12,3,9
55921,Avii,drakthul,288,warlock,affliction,12,3,9
55922,Culture,arthas,288,warlock,affliction,12,3,9
55923,Ezzako,area-52,288,warlock,affliction,12,3,9
55924,Camila,lightnings-blade,288,warlock,affliction,12,3,9
55925,Mynerve,velen,288,warlock,affliction,12,3,9
55926,Davnport,frostmourne,288,warlock,affliction,12,3,9
55927,Lithani,ragnaros,288,warlock,affliction,12,3,9
55928,Llkoreall,tichondrius,288,warlock,affliction,12,3,9
55929,Provilock,moon-guard,288,warlock,affliction,12,3,9
55930,Ÿoucantwin,kiljaeden,288,warlock,affliction,12,3,9
55931,Feelthefearx,ragnaros,288,warlock,affliction,12,3,9
55932,Tromeo,sargeras,288,warlock,affliction,12,3,9
55933,Grendaldots,tichondrius,288,warlock,affliction,12,3,9
55934,Castshadow,nordrassil,288,warlock,affliction,18,3,15
55935,Jjesie,tichondrius,288,warlock,affliction,18,3,15
55936,Condevil,quelthalas,288,warlock,affliction,18,3,15
55937,Angel,sargeras,288,warlock,affliction,18,3,15
55938,Vizkopnik,bleeding-hollow,287,warlock,affliction,6,3,3
55939,Nhen,daggerspine,287,warlock,affliction,6,3,3
55940,Nessima,jubeithos,287,warlock,affliction,12,3,9
55941,Lowkei,stonemaul,286,warlock,affliction,6,3,3
55942,Lilthicy,sargeras,271,warlock,affliction,14,3,11
55943,Kentus,moonrunner,255,warlock,affliction,14,4,10
55944,Niava,tichondrius,239,warlock,affliction,5,3,2
55945,Matzoball,zuljin,234,warlock,affliction,14,4,10
55946,Hoana,azralon,233,warlock,affliction,8,4,4
55947,Siltharious,dalaran,232,warlock,affliction,15,5,10
55948,Lifelock,auchindoun,223,warlock,affliction,8,3,5
55949,Spookytrev,stormrage,223,warlock,affliction,14,3,11
55950,Meelady,tichondrius,192,warlock,affliction,6,2,4
55951,Thumperrz,frostmourne,192,warlock,affliction,6,2,4
55952,Bóózér,tichondrius,192,warlock,affliction,6,2,4
55953,Fearsntears,stormrage,192,warlock,affliction,6,2,4
55954,Soularonomy,tichondrius,192,warlock,affliction,6,2,4
55955,Karmalock,malganis,192,warlock,affliction,6,2,4
55956,Lcomi,tichondrius,192,warlock,affliction,6,2,4
55957,Xoxoxu,frostmourne,192,warlock,affliction,6,2,4
55958,Noggét,frostmourne,192,warlock,affliction,6,2,4
55959,Nerolock,frostmourne,192,warlock,affliction,6,2,4
55960,Hellfires,ragnaros,192,warlock,affliction,6,2,4
55961,Yurick,frostmourne,192,warlock,affliction,6,2,4
55962,Dawaatisme,zuljin,192,warlock,affliction,6,2,4
55963,Lilitht,drakkari,192,warlock,affliction,6,2,4
55964,Narsdemons,tichondrius,192,warlock,affliction,6,2,4
55965,Asmodeun,malganis,192,warlock,affliction,6,2,4
55966,Khurze,area-52,192,warlock,affliction,6,2,4
55967,Veerdz,area-52,192,warlock,affliction,6,2,4
55968,Raínstilted,area-52,192,warlock,affliction,6,2,4
55969,Lockednloade,tichondrius,192,warlock,affliction,6,2,4
55970,Abomasnow,frostmourne,192,warlock,affliction,6,2,4
55971,Zörkô,zuljin,192,warlock,affliction,6,2,4
55972,Plaguedoctor,stormrage,192,warlock,affliction,6,2,4
55973,Yolandahadid,gilneas,192,warlock,affliction,6,2,4
55974,Apolodys,garona,192,warlock,affliction,6,2,4
55975,Screwed,tichondrius,192,warlock,affliction,6,2,4
55976,Leruss,zangarmarsh,192,warlock,affliction,6,2,4
55977,Ðeãdman,bleeding-hollow,192,warlock,affliction,6,2,4
55978,Vorlos,bonechewer,192,warlock,affliction,6,2,4
55979,Jacorian,illidan,192,warlock,affliction,6,2,4
55980,Grixis,zuluhed,192,warlock,affliction,6,2,4
55981,Mhael,lightninghoof,192,warlock,affliction,6,2,4
55982,Willogan,gurubashi,192,warlock,affliction,6,2,4
55983,Damerus,illidan,192,warlock,affliction,6,2,4
55984,Scepti,area-52,192,warlock,affliction,6,2,4
55985,Ministàff,ursin,192,warlock,affliction,6,2,4
55986,Pk,azralon,192,warlock,affliction,6,2,4
55987,Sylorelol,stormreaver,192,warlock,affliction,6,2,4
55988,Døtyou,area-52,192,warlock,affliction,6,2,4
55989,Es,velen,192,warlock,affliction,6,2,4
55990,Anastadora,proudmoore,192,warlock,affliction,6,2,4
55991,Sebss,proudmoore,192,warlock,affliction,6,2,4
55992,Jèdi,drenden,192,warlock,affliction,6,2,4
55993,Nightterrour,frostmourne,192,warlock,affliction,6,2,4
55994,Yahihlock,silver-hand,192,warlock,affliction,6,2,4
55995,Fondlemydot,stormscale,192,warlock,affliction,6,2,4
55996,Rerollx,firetree,192,warlock,affliction,6,2,4
55997,Payn,kiljaeden,192,warlock,affliction,6,2,4
55998,Trillas,illidan,192,warlock,affliction,6,2,4
55999,Charmandfarm,nerzhul,192,warlock,affliction,6,2,4
56000,Cheesëbolt,illidan,192,warlock,affliction,6,2,4
56001,Carcine,frostwolf,192,warlock,affliction,6,2,4
56002,Fearanddots,moon-guard,192,warlock,affliction,6,2,4
56003,Dotdottgoose,kiljaeden,192,warlock,affliction,6,2,4
56004,Destructo,illidan,192,warlock,affliction,6,2,4
56005,Vessires,darkspear,192,warlock,affliction,6,2,4
56006,Thralord,blackrock,192,warlock,affliction,6,2,4
56007,Deanwarlock,sargeras,192,warlock,affliction,6,2,4
56008,Omagg,malorne,192,warlock,affliction,12,2,10
56009,Refîk,sargeras,192,warlock,affliction,12,2,10
56010,Sürfacing,malganis,192,warlock,affliction,12,2,10
56011,Leviathen,shattered-hand,192,warlock,affliction,12,2,10
56012,Tribulatiön,moon-guard,192,warlock,affliction,12,2,10
56013,Dloq,azgalor,192,warlock,affliction,12,2,10
56014,Tormentedcat,nazjatar,192,warlock,affliction,12,2,10
56015,Rurnt,bloodhoof,192,warlock,affliction,13,2,11
56016,Ferich,azralon,159,warlock,affliction,5,2,3
56017,Ramone,turalyon,159,warlock,affliction,5,2,3
56018,Dotlockndrop,stormreaver,159,warlock,affliction,5,2,3
56019,Gutterxfox,malganis,159,warlock,affliction,11,2,9
56020,Pwnasaurus,barthilas,128,warlock,affliction,10,2,8
56021,Mickylock,tichondrius,96,warlock,affliction,6,1,5
56022,Frdchickiana,tichondrius,96,warlock,affliction,6,1,5
56023,Apocryphh,stormrage,96,warlock,affliction,6,1,5
56024,Cornboil,tichondrius,96,warlock,affliction,6,1,5
56025,Sylvahh,sargeras,96,warlock,affliction,6,1,5
56026,Mobilecherpn,frostmourne,96,warlock,affliction,6,1,5
56027,Ailliforlune,illidan,96,warlock,affliction,6,1,5
56028,Guinegobbler,hyjal,96,warlock,affliction,6,1,5
56029,Gamecobra,greymane,96,warlock,affliction,6,1,5
56030,Olgreg,daggerspine,96,warlock,affliction,6,1,5
56031,Carabelois,aegwynn,96,warlock,affliction,6,1,5
56032,Haedn,stormrage,96,warlock,affliction,6,1,5
56033,Tailsy,proudmoore,96,warlock,affliction,6,1,5
56034,Sunkuna,aerie-peak,96,warlock,affliction,6,1,5
56035,Alfemale,dalaran,96,warlock,affliction,6,1,5
56036,Imhereforrbg,moon-guard,96,warlock,affliction,6,1,5
56037,Smôkedsôul,area-52,96,warlock,affliction,6,1,5
56038,Volturnus,wildhammer,96,warlock,affliction,6,1,5
56039,Drainedd,blades-edge,96,warlock,affliction,6,1,5
56040,Superbvious,lothar,96,warlock,affliction,6,1,5
56041,Fabiusbilex,tichondrius,96,warlock,affliction,6,1,5
56042,Efg,illidan,96,warlock,affliction,6,1,5
56043,Malchiev,area-52,96,warlock,affliction,6,1,5
56044,Nêcro,moon-guard,96,warlock,affliction,6,1,5
56045,Menedemus,amanthul,96,warlock,affliction,6,1,5
56046,Tuhdah,frostwolf,96,warlock,affliction,6,1,5
56047,Pinkypay,ragnaros,96,warlock,affliction,6,1,5
56048,Conspiration,sargeras,96,warlock,affliction,6,1,5
56049,Atticassasin,stormrage,96,warlock,affliction,6,1,5
56050,Chaøsbolt,area-52,96,warlock,affliction,6,1,5
56051,Ehcsrop,doomhammer,96,warlock,affliction,6,1,5
56052,Locktimes,ragnaros,96,warlock,affliction,6,1,5
56053,Kammuany,sargeras,96,warlock,affliction,6,1,5
56054,Bluffzlock,boulderfist,96,warlock,affliction,6,1,5
56055,Ørthox,malganis,96,warlock,affliction,6,1,5
56056,Shennaniganz,bleeding-hollow,96,warlock,affliction,6,1,5
56057,Malignant,tichondrius,96,warlock,affliction,6,1,5
56058,Feár,emerald-dream,96,warlock,affliction,6,1,5
56059,Frem,eonar,96,warlock,affliction,6,1,5
56060,Krozu,bleeding-hollow,96,warlock,affliction,6,1,5
56061,Joseph,draktharon,96,warlock,affliction,6,1,5
56062,Aedarine,uldum,96,warlock,affliction,6,1,5
56063,Xylõck,sargeras,96,warlock,affliction,6,1,5
56064,Fenrinozil,tichondrius,96,warlock,affliction,12,1,11
56065,Shendù,stormrage,79,warlock,affliction,5,1,4
56066,Zuelu,tichondrius,64,warlock,affliction,4,1,3
56067,Amaia,nathrezim,48,warlock,affliction,3,1,2
56068,Mìrä,kelthuzad,48,warlock,affliction,3,1,2
56069,Voldmorto,azralon,42,warlock,affliction,8,2,6
56070,Delete,greymane,16,warlock,affliction,1,1,0
56071,Halix,emerald-dream,16,warlock,affliction,1,1,0
56072,Ttvdjrio,area-52,2200,warrior,fury,84,54,30
56073,Grimgrip,frostmane,2131,warrior,fury,92,53,39
56074,Joshiman,area-52,2124,warrior,fury,78,42,36
56075,Cabelastwo,tichondrius,2124,warrior,fury,87,46,41
56076,Americanbull,moon-guard,2119,warrior,fury,253,134,119
56077,Takeda,sargeras,2117,warrior,fury,107,61,46
56078,Cabelas,tichondrius,2112,warrior,fury,89,45,44
56079,Thrator,wyrmrest-accord,2110,warrior,fury,108,55,53
56080,Braxxínn,tichondrius,2107,warrior,fury,54,39,15
56081,Riproarin,stormrage,2105,warrior,fury,92,53,39
56082,Coldlòve,akama,2076,warrior,fury,106,61,45
56083,Furrytakeda,kelthuzad,2063,warrior,fury,140,78,62
56084,Orclog,illidan,2058,warrior,fury,107,57,50
56085,Biaa,tichondrius,2055,warrior,fury,78,38,40
56086,Eazyc,tichondrius,2034,warrior,fury,207,112,95
56087,Ðêed,area-52,2023,warrior,fury,66,37,29
56088,Sworda,sargeras,2018,warrior,fury,89,54,35
56089,Warqt,kelthuzad,2011,warrior,fury,105,58,47
56090,Veevz,proudmoore,2010,warrior,fury,114,52,62
56091,Notwarried,sargeras,1994,warrior,fury,89,41,48
56092,Rôxi,malganis,1987,warrior,fury,246,130,116
56093,Chillawigs,kelthuzad,1983,warrior,fury,84,47,37
56094,Lahired,drakkari,1973,warrior,fury,227,112,115
56095,Wienertoes,tichondrius,1963,warrior,fury,114,63,51
56096,Ragwreck,bleeding-hollow,1959,warrior,fury,68,35,33
56097,Taras,blackhand,1948,warrior,fury,147,68,79
56098,Hìm,tichondrius,1939,warrior,fury,66,36,30
56099,Sandronb,illidan,1938,warrior,fury,83,41,42
56100,Eno,ragnaros,1937,warrior,fury,69,46,23
56101,Gazzef,thrall,1935,warrior,fury,120,63,57
56102,Cannabiddies,illidan,1932,warrior,fury,60,31,29
56103,Alabamá,sargeras,1925,warrior,fury,36,21,15
56104,Chopemupp,area-52,1912,warrior,fury,89,55,34
56105,Turboboy,tichondrius,1911,warrior,fury,36,24,12
56106,Tøpg,sargeras,1897,warrior,fury,67,39,28
56107,Vèév,proudmoore,1894,warrior,fury,62,41,21
56108,Blgjb,tichondrius,1894,warrior,fury,90,41,49
56109,Mphx,tichondrius,1888,warrior,fury,48,30,18
56110,Okme,tichondrius,1882,warrior,fury,66,36,30
56111,Killbørn,azralon,1880,warrior,fury,48,29,19
56112,Ásúrá,quelthalas,1879,warrior,fury,48,29,19
56113,Brodestar,sargeras,1874,warrior,fury,48,31,17
56114,Badvelic,tichondrius,1874,warrior,fury,46,28,18
56115,Zanzaa,sargeras,1870,warrior,fury,85,47,38
56116,Hlt,tichondrius,1869,warrior,fury,66,38,28
56117,Shîzu,moon-guard,1868,warrior,fury,102,67,35
56118,Trackstarz,llane,1862,warrior,fury,60,39,21
56119,Negleçt,stormrage,1861,warrior,fury,36,23,13
56120,Kevy,arygos,1860,warrior,fury,54,33,21
56121,ßdm,illidan,1860,warrior,fury,54,26,28
56122,Damonadrann,proudmoore,1859,warrior,fury,66,34,32
56123,Nilah,tichondrius,1858,warrior,fury,112,66,46
56124,Zak,feathermoon,1852,warrior,fury,41,30,11
56125,Dowser,goldrinn,1852,warrior,fury,131,69,62
56126,Gorehardt,illidan,1848,warrior,fury,54,26,28
56127,Mchamstring,stormrage,1846,warrior,fury,51,30,21
56128,Gromkhor,tichondrius,1840,warrior,fury,36,22,14
56129,Esilox,area-52,1836,warrior,fury,42,28,14
56130,Ethyrie,ragnaros,1836,warrior,fury,61,34,27
56131,Lokityr,tichondrius,1834,warrior,fury,36,26,10
56132,Jenjang,proudmoore,1834,warrior,fury,83,52,31
56133,Brainhaze,tichondrius,1829,warrior,fury,36,21,15
56134,Ggull,tichondrius,1827,warrior,fury,47,28,19
56135,Kennäy,azralon,1827,warrior,fury,52,29,23
56136,Ragwreckz,bleeding-hollow,1826,warrior,fury,52,32,20
56137,Soymong,frostmourne,1825,warrior,fury,116,74,42
56138,Mty,tichondrius,1824,warrior,fury,54,35,19
56139,Szauren,stormrage,1824,warrior,fury,63,31,32
56140,Cleavxy,sargeras,1823,warrior,fury,54,37,17
56141,Gooberbear,frostmourne,1823,warrior,fury,145,82,63
56142,Lingho,illidan,1822,warrior,fury,36,20,16
56143,Apocalyptist,stormrage,1821,warrior,fury,99,58,41
56144,Thadamaja,kiljaeden,1821,warrior,fury,48,26,22
56145,Bosswin,tichondrius,1820,warrior,fury,53,28,25
56146,Skyja,quelthalas,1820,warrior,fury,42,22,20
56147,Druzhinik,moon-guard,1819,warrior,fury,137,78,59
56148,Illmindofpoo,kelthuzad,1818,warrior,fury,42,28,14
56149,Sayjaki,stormrage,1818,warrior,fury,102,62,40
56150,Veyrin,stormrage,1818,warrior,fury,138,81,57
56151,Isahri,moon-guard,1818,warrior,fury,110,64,46
56152,Orchilles,illidan,1817,warrior,fury,60,35,25
56153,Damiansuv,moon-guard,1817,warrior,fury,154,89,65
56154,Openhardest,stormrage,1816,warrior,fury,41,27,14
56155,Jírky,ragnaros,1816,warrior,fury,240,134,106
56156,Zujuzo,moon-guard,1815,warrior,fury,111,64,47
56157,Neôn,frostmourne,1815,warrior,fury,66,37,29
56158,Onionsauce,frostmourne,1815,warrior,fury,161,90,71
56159,Unbreakkable,tichondrius,1815,warrior,fury,78,43,35
56160,Slughorn,moon-guard,1814,warrior,fury,102,53,49
56161,Kazora,zuljin,1813,warrior,fury,48,33,15
56162,Darkduke,tichondrius,1813,warrior,fury,33,21,12
56163,Gentlehugs,illidan,1813,warrior,fury,35,20,15
56164,Donutwar,proudmoore,1813,warrior,fury,54,30,24
56165,Crankyhorn,stormrage,1813,warrior,fury,60,31,29
56166,Duxor,sargeras,1811,warrior,fury,70,41,29
56167,Barafang,wyrmrest-accord,1811,warrior,fury,234,125,109
56168,Ragemane,illidan,1811,warrior,fury,90,47,43
56169,Psychogenic,barthilas,1810,warrior,fury,102,60,42
56170,Zyzz,scarlet-crusade,1807,warrior,fury,72,41,31
56171,Killuall,sargeras,1807,warrior,fury,42,23,19
56172,Wagù,moon-guard,1805,warrior,fury,48,32,16
56173,Yawdamper,illidan,1805,warrior,fury,51,32,19
56174,Starshattr,bleeding-hollow,1805,warrior,fury,108,64,44
56175,Seoní,wyrmrest-accord,1805,warrior,fury,76,43,33
56176,Maximad,moon-guard,1805,warrior,fury,108,58,50
56177,Girioo,thrall,1802,warrior,fury,24,19,5
56178,Franticlol,tichondrius,1802,warrior,fury,90,59,31
56179,Cubie,malganis,1802,warrior,fury,89,47,42
56180,Burger,the-underbog,1800,warrior,fury,24,19,5
56181,Saîyanroyce,barthilas,1793,warrior,fury,113,64,49
56182,Shadax,bleeding-hollow,1793,warrior,fury,263,139,124
56183,Zoldian,tichondrius,1792,warrior,fury,89,49,40
56184,Smexxin,tichondrius,1790,warrior,fury,36,21,15
56185,Melifehorde,tichondrius,1790,warrior,fury,222,111,111
56186,Jimjinjin,tichondrius,1787,warrior,fury,90,45,45
56187,Nailah,illidan,1783,warrior,fury,116,62,54
56188,Rekatron,area-52,1783,warrior,fury,49,25,24
56189,Rynkae,moon-guard,1782,warrior,fury,42,21,21
56190,Onîkudakì,sargeras,1775,warrior,fury,109,67,42
56191,Sàndman,malganis,1775,warrior,fury,39,23,16
56192,Larrybiscuit,moon-guard,1771,warrior,fury,180,105,75
56193,Volgarr,zuljin,1767,warrior,fury,51,30,21
56194,Choppiechop,area-52,1763,warrior,fury,42,26,16
56195,Holuntung,illidan,1763,warrior,fury,73,38,35
56196,Dahakawar,malganis,1757,warrior,fury,53,32,21
56197,Elkojack,nemesis,1757,warrior,fury,35,21,14
56198,Crøm,tichondrius,1752,warrior,fury,96,50,46
56199,Basedaf,frostmourne,1751,warrior,fury,171,92,79
56200,Chopped,wyrmrest-accord,1750,warrior,fury,93,43,50
56201,Cheiftain,dalaran,1747,warrior,fury,48,26,22
56202,Lootacris,illidan,1746,warrior,fury,42,20,22
56203,Zugyu,tichondrius,1745,warrior,fury,24,19,5
56204,Alarìon,malganis,1745,warrior,fury,45,31,14
56205,Sonyanalogue,frostmourne,1745,warrior,fury,54,29,25
56206,Bigfatork,area-52,1739,warrior,fury,94,47,47
56207,Sixtydolla,kelthuzad,1738,warrior,fury,45,26,19
56208,Dripgodx,malganis,1736,warrior,fury,54,30,24
56209,Illaedan,quelthalas,1733,warrior,fury,95,47,48
56210,Invinciblé,tichondrius,1730,warrior,fury,36,22,14
56211,Kinseb,doomhammer,1730,warrior,fury,78,47,31
56212,Beanstrom,tichondrius,1729,warrior,fury,77,39,38
56213,Escånor,moon-guard,1728,warrior,fury,25,19,6
56214,Akaínu,area-52,1728,warrior,fury,48,27,21
56215,Daedrion,dalaran,1726,warrior,fury,90,49,41
56216,Splasch,kelthuzad,1725,warrior,fury,65,29,36
56217,Statistic,skullcrusher,1724,warrior,fury,52,25,27
56218,Giannï,chogall,1723,warrior,fury,66,36,30
56219,Budgetclap,nordrassil,1723,warrior,fury,72,36,36
56220,Moelolita,illidan,1723,warrior,fury,41,19,22
56221,Bigdude,frostwolf,1721,warrior,fury,48,24,24
56222,Slamurai,moon-guard,1719,warrior,fury,24,18,6
56223,Duochuanjun,illidan,1719,warrior,fury,48,26,22
56224,Tastý,moon-guard,1716,warrior,fury,36,23,13
56225,Noramed,moon-guard,1715,warrior,fury,113,63,50
56226,Smache,tichondrius,1714,warrior,fury,29,19,10
56227,Mulish,frostmourne,1712,warrior,fury,79,47,32
56228,Wång,bonechewer,1710,warrior,fury,30,19,11
56229,Käggai,khadgar,1709,warrior,fury,89,48,41
56230,Ágsgøðx,bleeding-hollow,1707,warrior,fury,132,69,63
56231,Riggs,stonemaul,1706,warrior,fury,59,32,27
56232,Thänatøs,nemesis,1706,warrior,fury,68,35,33
56233,Oddyseey,moon-guard,1706,warrior,fury,54,27,27
56234,Warroiser,quelthalas,1705,warrior,fury,135,73,62
56235,Bulgrim,moon-guard,1705,warrior,fury,103,52,51
56236,Pepétí,azralon,1704,warrior,fury,90,53,37
56237,Modì,sargeras,1703,warrior,fury,125,69,56
56238,Faytful,thrall,1703,warrior,fury,60,27,33
56239,Flarkin,area-52,1699,warrior,fury,30,18,12
56240,Blazingfury,area-52,1699,warrior,fury,115,59,56
56241,Mezw,tichondrius,1698,warrior,fury,77,42,35
56242,Márcellus,illidan,1696,warrior,fury,90,51,39
56243,Mochigome,moon-guard,1696,warrior,fury,97,49,48
56244,Scolpi,stormrage,1695,warrior,fury,76,42,34
56245,Âragorn,tichondrius,1693,warrior,fury,76,39,37
56246,Keltanas,quelthalas,1692,warrior,fury,119,63,56
56247,Nordama,stormrage,1691,warrior,fury,48,33,15
56248,Eggroll,emerald-dream,1691,warrior,fury,183,100,83
56249,Brimstoné,wyrmrest-accord,1685,warrior,fury,84,47,37
56250,Berawar,tichondrius,1683,warrior,fury,78,41,37
56251,Ciege,illidan,1682,warrior,fury,48,27,21
56252,Ðowser,area-52,1680,warrior,fury,24,18,6
56253,Scrotedog,area-52,1680,warrior,fury,55,24,31
56254,Tyroe,thunderhorn,1679,warrior,fury,36,22,14
56255,Moistmoocow,thrall,1678,warrior,fury,61,35,26
56256,Torbajhorn,moon-guard,1676,warrior,fury,66,34,32
56257,Thugdorr,sargeras,1675,warrior,fury,102,53,49
56258,Furíous,thunderhorn,1675,warrior,fury,90,46,44
56259,Ediann,elune,1674,warrior,fury,95,56,39
56260,Coldshots,stormreaver,1674,warrior,fury,96,54,42
56261,Morfoggore,ragnaros,1673,warrior,fury,55,25,30
56262,Bwandøn,moon-guard,1671,warrior,fury,41,26,15
56263,Nikon,bleeding-hollow,1671,warrior,fury,48,28,20
56264,Tigas,icecrown,1671,warrior,fury,56,30,26
56265,Koei,illidan,1670,warrior,fury,48,28,20
56266,Youaredafeds,moon-guard,1669,warrior,fury,131,75,56
56267,Oxitowocina,quelthalas,1667,warrior,fury,42,25,17
56268,Raveve,area-52,1665,warrior,fury,38,25,13
56269,Bopwar,malganis,1665,warrior,fury,48,29,19
56270,Påpi,sargeras,1663,warrior,fury,90,54,36
56271,Vinvivenna,emerald-dream,1663,warrior,fury,40,23,17
56272,Moistt,nesingwary,1662,warrior,fury,44,28,16
56273,Râvik,illidan,1662,warrior,fury,69,35,34
56274,Velarrine,illidan,1661,warrior,fury,121,64,57
56275,Sperow,malygos,1660,warrior,fury,62,37,25
56276,Alteryx,sargeras,1658,warrior,fury,244,132,112
56277,Gladheateher,bonechewer,1658,warrior,fury,60,28,32
56278,Onionlord,wyrmrest-accord,1657,warrior,fury,41,26,15
56279,Calder,malganis,1656,warrior,fury,72,36,36
56280,Gaazhel,quelthalas,1655,warrior,fury,109,57,52
56281,Zuggrok,zuljin,1655,warrior,fury,196,97,99
56282,Kolosaltwo,tichondrius,1654,warrior,fury,77,41,36
56283,Swiftslaýer,vashj,1654,warrior,fury,117,61,56
56284,Gnomageddon,anetheron,1653,warrior,fury,82,39,43
56285,Aotha,moon-guard,1652,warrior,fury,38,23,15
56286,Conflíct,illidan,1652,warrior,fury,88,52,36
56287,Graverot,burning-legion,1651,warrior,fury,46,22,24
56288,Zoomgar,barthilas,1650,warrior,fury,36,23,13
56289,Rinima,tichondrius,1650,warrior,fury,124,65,59
56290,Coalpit,emerald-dream,1650,warrior,fury,66,31,35
56291,Jarheadz,bleeding-hollow,1649,warrior,fury,48,32,16
56292,Rikki,frostmourne,1649,warrior,fury,60,32,28
56293,Oiledman,emerald-dream,1649,warrior,fury,46,24,22
56294,Axesage,tichondrius,1648,warrior,fury,72,41,31
56295,Ashwalker,malganis,1648,warrior,fury,56,30,26
56296,Eggdoubles,sargeras,1647,warrior,fury,33,19,14
56297,Eregor,sargeras,1647,warrior,fury,54,27,27
56298,Tinyexcute,tichondrius,1644,warrior,fury,48,25,23
56299,Agragar,zuljin,1643,warrior,fury,30,18,12
56300,Ssamba,shattered-hand,1643,warrior,fury,36,20,16
56301,Faren,agamaggan,1643,warrior,fury,167,91,76
56302,Traka,stormrage,1642,warrior,fury,36,19,17
56303,Mandragorn,kelthuzad,1642,warrior,fury,71,37,34
56304,Lowz,hyjal,1641,warrior,fury,32,23,9
56305,Wangjianguo,illidan,1641,warrior,fury,53,28,25
56306,Larosfan,tichondrius,1640,warrior,fury,42,24,18
56307,Tádakatsu,sargeras,1640,warrior,fury,147,79,68
56308,Jhalma,stormrage,1640,warrior,fury,42,20,22
56309,Smarthulk,tichondrius,1639,warrior,fury,60,34,26
56310,Nogèt,frostmourne,1638,warrior,fury,47,28,19
56311,Cupper,tichondrius,1638,warrior,fury,47,25,22
56312,Festergrin,area-52,1637,warrior,fury,66,34,32
56313,Vuraxx,area-52,1635,warrior,fury,30,22,8
56314,Drashi,nazjatar,1635,warrior,fury,72,42,30
56315,Ohdang,dark-iron,1635,warrior,fury,209,114,95
56316,Dardash,ragnaros,1634,warrior,fury,30,21,9
56317,Udmwarrior,zuljin,1633,warrior,fury,54,24,30
56318,Ianprime,the-scryers,1632,warrior,fury,48,27,21
56319,Fearlessxq,tichondrius,1631,warrior,fury,148,85,63
56320,Thiccyb,area-52,1628,warrior,fury,24,17,7
56321,Skollyd,tichondrius,1628,warrior,fury,32,20,12
56322,Hoodlark,lightbringer,1628,warrior,fury,69,42,27
56323,Fearlessly,moon-guard,1628,warrior,fury,209,113,96
56324,Naelynh,quelthalas,1628,warrior,fury,54,26,28
56325,Kellyboitv,frostmourne,1628,warrior,fury,42,20,22
56326,Darkbunny,thaurissan,1627,warrior,fury,84,44,40
56327,Colorx,sargeras,1625,warrior,fury,52,30,22
56328,Kintarra,malygos,1625,warrior,fury,41,22,19
56329,Feetmann,illidan,1624,warrior,fury,84,53,31
56330,Ugriker,skullcrusher,1623,warrior,fury,42,26,16
56331,Scrümp,illidan,1622,warrior,fury,65,41,24
56332,Quinntis,anvilmar,1622,warrior,fury,42,23,19
56333,Klieterious,bleeding-hollow,1622,warrior,fury,78,41,37
56334,Ðåddý,stormrage,1620,warrior,fury,149,73,76
56335,Joog,kalecgos,1619,warrior,fury,52,23,29
56336,Warrmachine,mannoroth,1618,warrior,fury,197,111,86
56337,Zarxc,quelthalas,1618,warrior,fury,60,31,29
56338,Akkar,gilneas,1617,warrior,fury,49,25,24
56339,Snugglebuggs,stormrage,1615,warrior,fury,101,51,50
56340,Hârambe,kiljaeden,1614,warrior,fury,41,25,16
56341,Dawx,thrall,1614,warrior,fury,30,17,13
56342,Hairygrundel,area-52,1614,warrior,fury,101,55,46
56343,Evilkorean,tichondrius,1614,warrior,fury,146,78,68
56344,Andorane,bleeding-hollow,1614,warrior,fury,60,32,28
56345,Råmpågë,tichondrius,1613,warrior,fury,42,26,16
56346,Zangetsy,sargeras,1612,warrior,fury,111,59,52
56347,Rücküs,tichondrius,1611,warrior,fury,110,68,42
56348,Damburga,tichondrius,1609,warrior,fury,48,30,18
56349,Khrull,khazgoroth,1609,warrior,fury,74,40,34
56350,Kholusia,kul-tiras,1609,warrior,fury,148,70,78
56351,Misakizs,sargeras,1609,warrior,fury,36,17,19
56352,Guerreraa,ragnaros,1609,warrior,fury,83,37,46
56353,Wrniss,tichondrius,1608,warrior,fury,48,31,17
56354,Leviqt,moon-guard,1606,warrior,fury,36,21,15
56355,Trôca,ragnaros,1603,warrior,fury,54,29,25
56356,Fearless,moon-guard,1603,warrior,fury,132,68,64
56357,Lilgucci,stonemaul,1602,warrior,fury,36,20,16
56358,Islik,stormrage,1601,warrior,fury,30,17,13
56359,Genesisblade,illidan,1601,warrior,fury,58,25,33
56360,Krovikân,area-52,1600,warrior,fury,30,19,11
56361,Soulfang,stormscale,1600,warrior,fury,36,20,16
56362,Gorrtog,stormrage,1600,warrior,fury,213,108,105
56363,Ystk,tichondrius,1598,warrior,fury,29,23,6
56364,Brutality,kirin-tor,1598,warrior,fury,107,57,50
56365,Jimseung,tichondrius,1598,warrior,fury,60,29,31
56366,Strëngth,aggramar,1597,warrior,fury,88,48,40
56367,Flexid,tichondrius,1597,warrior,fury,80,41,39
56368,Koffray,malfurion,1596,warrior,fury,59,30,29
56369,Filamon,dentarg,1595,warrior,fury,71,30,41
56370,Neurötic,ragnaros,1594,warrior,fury,30,20,10
56371,Gigatroll,tichondrius,1592,warrior,fury,59,30,29
56372,Vapyr,moon-guard,1591,warrior,fury,41,20,21
56373,Wampzug,azshara,1591,warrior,fury,78,37,41
56374,Easons,tichondrius,1591,warrior,fury,71,33,38
56375,Hammerock,ragnaros,1587,warrior,fury,35,18,17
56376,Jadeemerald,kelthuzad,1585,warrior,fury,66,34,32
56377,Shapur,tichondrius,1583,warrior,fury,41,22,19
56378,Torv,frostmourne,1581,warrior,fury,68,38,30
56379,Kroozy,thrall,1580,warrior,fury,42,24,18
56380,Cokespoon,frostmourne,1579,warrior,fury,72,44,28
56381,Shaøkahn,azralon,1579,warrior,fury,68,40,28
56382,Tithousand,tichondrius,1578,warrior,fury,65,38,27
56383,Zugzugtime,tichondrius,1577,warrior,fury,52,29,23
56384,Ezeji,area-52,1577,warrior,fury,42,23,19
56385,Sithlõrd,moon-guard,1577,warrior,fury,84,42,42
56386,Fluffyarm,sargeras,1576,warrior,fury,115,62,53
56387,Brøsk,azralon,1574,warrior,fury,108,58,50
56388,Mers,garrosh,1572,warrior,fury,54,30,24
56389,Wolfcultist,moon-guard,1572,warrior,fury,117,54,63
56390,Baeowar,area-52,1572,warrior,fury,87,40,47
56391,Sálieri,ragnaros,1570,warrior,fury,84,49,35
56392,Sigiswald,cenarion-circle,1570,warrior,fury,48,23,25
56393,Dann,ragnaros,1569,warrior,fury,59,35,24
56394,Bloodfist,tichondrius,1568,warrior,fury,30,19,11
56395,Dcashmoney,moon-guard,1566,warrior,fury,85,48,37
56396,Gûard,stormrage,1566,warrior,fury,121,62,59
56397,Dwarlan,stormrage,1563,warrior,fury,71,44,27
56398,Philsbbqnow,dark-iron,1563,warrior,fury,36,18,18
56399,Tanorai,area-52,1562,warrior,fury,48,29,19
56400,Romus,spirestone,1562,warrior,fury,48,29,19
56401,Rekill,emerald-dream,1562,warrior,fury,36,19,17
56402,Mäjka,dalaran,1560,warrior,fury,36,20,16
56403,Jimmfro,zuljin,1559,warrior,fury,64,33,31
56404,Nvzah,area-52,1556,warrior,fury,66,28,38
56405,Igoboom,bleeding-hollow,1555,warrior,fury,52,27,25
56406,Arágorn,sargeras,1554,warrior,fury,60,33,27
56407,Khargrok,ragnaros,1554,warrior,fury,147,80,67
56408,Æwarrìor,tichondrius,1554,warrior,fury,36,19,17
56409,Bigßiceps,tichondrius,1552,warrior,fury,42,23,19
56410,Garobber,stormrage,1552,warrior,fury,36,17,19
56411,Harkeigh,wyrmrest-accord,1551,warrior,fury,60,33,27
56412,Stavsie,tichondrius,1548,warrior,fury,35,18,17
56413,Tempusbane,proudmoore,1548,warrior,fury,56,24,32
56414,Kombatwombat,kaelthas,1547,warrior,fury,32,20,12
56415,Wöûlöû,trollbane,1546,warrior,fury,91,48,43
56416,Morguez,tichondrius,1545,warrior,fury,84,46,38
56417,Sugmad,area-52,1545,warrior,fury,48,22,26
56418,Pitchman,tichondrius,1544,warrior,fury,59,32,27
56419,Zuggyboi,moon-guard,1544,warrior,fury,48,25,23
56420,Raggnarsøøn,ragnaros,1543,warrior,fury,101,47,54
56421,Bigbungus,frostmourne,1542,warrior,fury,50,27,23
56422,Varrian,rivendare,1539,warrior,fury,36,21,15
56423,Zibby,malganis,1539,warrior,fury,36,18,18
56424,Thraig,moon-guard,1538,warrior,fury,36,17,19
56425,Mezmer,sargeras,1537,warrior,fury,36,25,11
56426,Pootyspootz,warsong,1536,warrior,fury,53,31,22
56427,Antei,thunderlord,1535,warrior,fury,53,31,22
56428,Jingson,moon-guard,1535,warrior,fury,39,21,18
56429,Iceice,dalaran,1535,warrior,fury,76,38,38
56430,Wouili,zuljin,1533,warrior,fury,48,24,24
56431,Clumhaku,dalaran,1533,warrior,fury,37,17,20
56432,Ballinx,illidan,1533,warrior,fury,36,16,20
56433,Impalle,nazjatar,1531,warrior,fury,54,33,21
56434,Shibaraku,tichondrius,1531,warrior,fury,381,186,195
56435,Sleazedog,kelthuzad,1529,warrior,fury,36,21,15
56436,Zombad,azralon,1529,warrior,fury,62,34,28
56437,Linker,ragnaros,1528,warrior,fury,48,28,20
56438,Sensho,azralon,1527,warrior,fury,70,40,30
56439,Ðow,burning-blade,1526,warrior,fury,47,25,22
56440,Hellamoist,tichondrius,1526,warrior,fury,66,30,36
56441,Tctc,emerald-dream,1524,warrior,fury,41,22,19
56442,Cornmaster,darkspear,1524,warrior,fury,104,50,54
56443,Getthechoppa,aegwynn,1523,warrior,fury,57,31,26
56444,Cohëëd,kelthuzad,1523,warrior,fury,119,64,55
56445,Horvv,frostmourne,1520,warrior,fury,54,31,23
56446,Gomachi,moon-guard,1520,warrior,fury,60,25,35
56447,Abomlnatlon,tichondrius,1517,warrior,fury,60,34,26
56448,Hazknar,azralon,1517,warrior,fury,54,27,27
56449,Invdeath,azralon,1517,warrior,fury,46,23,23
56450,Orphasmic,moon-guard,1515,warrior,fury,29,17,12
56451,Celere,azralon,1515,warrior,fury,66,32,34
56452,Zitfrlt,wildhammer,1515,warrior,fury,87,39,48
56453,Rafurk,area-52,1514,warrior,fury,48,28,20
56454,Rendwarchief,garrosh,1514,warrior,fury,155,80,75
56455,Magnis,stormrage,1514,warrior,fury,78,39,39
56456,Playbox,area-52,1514,warrior,fury,83,37,46
56457,Kârzâ,dawnbringer,1513,warrior,fury,113,61,52
56458,Rikbielo,dragonmaw,1513,warrior,fury,73,39,34
56459,Vhalden,quelthalas,1512,warrior,fury,24,16,8
56460,Fkt,frostmourne,1512,warrior,fury,31,17,14
56461,Mytharion,sargeras,1511,warrior,fury,30,18,12
56462,Machomanran,zuljin,1509,warrior,fury,89,47,42
56463,Mayonnaise,ragnaros,1509,warrior,fury,36,18,18
56464,Grumok,tichondrius,1509,warrior,fury,44,20,24
56465,Gurukakko,ragnaros,1508,warrior,fury,42,24,18
56466,Jorked,drakkari,1508,warrior,fury,80,41,39
56467,Líl,gorgonnash,1508,warrior,fury,48,20,28
56468,Hôdû,tichondrius,1505,warrior,fury,85,48,37
56469,Zerkxi,kelthuzad,1504,warrior,fury,45,25,20
56470,Crohdey,madoran,1504,warrior,fury,148,78,70
56471,Anandamide,frostwolf,1503,warrior,fury,51,27,24
56472,Statistical,area-52,1500,warrior,fury,24,19,5
56473,Rodahn,emerald-dream,1500,warrior,fury,54,31,23
56474,Grômm,tichondrius,1500,warrior,fury,63,33,30
56475,Nimna,moon-guard,1499,warrior,fury,59,29,30
56476,Panterra,azralon,1497,warrior,fury,64,34,30
56477,Koppo,kelthuzad,1496,warrior,fury,42,18,24
56478,Lujzika,stormreaver,1495,warrior,fury,80,47,33
56479,Venirith,moon-guard,1495,warrior,fury,82,43,39
56480,Stoopkid,uldum,1494,warrior,fury,58,29,29
56481,Wardeád,quelthalas,1493,warrior,fury,36,21,15
56482,Varith,sargeras,1493,warrior,fury,54,26,28
56483,Thunderfurry,drakkari,1491,warrior,fury,87,42,45
56484,Albinosword,azralon,1488,warrior,fury,74,37,37
56485,Wolurog,emerald-dream,1485,warrior,fury,30,21,9
56486,Viagraliker,tichondrius,1484,warrior,fury,93,52,41
56487,Carnemølida,thrall,1484,warrior,fury,58,28,30
56488,Goon,frostmourne,1483,warrior,fury,48,26,22
56489,Grommrosh,azralon,1482,warrior,fury,30,16,14
56490,Hjomura,quelthalas,1482,warrior,fury,48,24,24
56491,Ronok,ghostlands,1481,warrior,fury,42,26,16
56492,Know,anetheron,1480,warrior,fury,39,25,14
56493,Daelganis,blood-furnace,1480,warrior,fury,83,40,43
56494,Berthibar,dalaran,1480,warrior,fury,111,52,59
56495,Shádo,darkspear,1479,warrior,fury,48,29,19
56496,Genrÿuusai,azralon,1478,warrior,fury,35,19,16
56497,Lavablood,moon-guard,1478,warrior,fury,48,22,26
56498,Warborn,agamaggan,1475,warrior,fury,54,24,30
56499,Benchpress,bleeding-hollow,1474,warrior,fury,72,35,37
56500,Karusuke,stormrage,1472,warrior,fury,36,21,15
56501,Dieselsauce,stormscale,1470,warrior,fury,29,16,13
56502,Ruuthless,sargeras,1470,warrior,fury,121,60,61
56503,Hughmungús,frostmourne,1469,warrior,fury,36,20,16
56504,Headsour,thunderhorn,1469,warrior,fury,71,37,34
56505,Himiko,kaelthas,1469,warrior,fury,69,34,35
56506,Rageorade,area-52,1467,warrior,fury,48,32,16
56507,Braxtön,moon-guard,1467,warrior,fury,66,32,34
56508,Badoosh,kaelthas,1466,warrior,fury,40,26,14
56509,Xannypatrol,tichondrius,1466,warrior,fury,125,68,57
56510,Jubeithos,draktharon,1466,warrior,fury,60,28,32
56511,Iskandr,amanthul,1465,warrior,fury,111,56,55
56512,Cliveswife,frostmourne,1462,warrior,fury,23,16,7
56513,Selathiel,burning-blade,1462,warrior,fury,101,55,46
56514,Teyroporah,azralon,1462,warrior,fury,63,34,29
56515,Eatmyblade,wyrmrest-accord,1462,warrior,fury,283,137,146
56516,Violençe,malganis,1462,warrior,fury,42,19,23
56517,Azázyel,quelthalas,1461,warrior,fury,54,23,31
56518,Mág,burning-legion,1460,warrior,fury,33,20,13
56519,Commandó,proudmoore,1460,warrior,fury,71,42,29
56520,Mòrgo,agamaggan,1458,warrior,fury,30,20,10
56521,Nornogin,tichondrius,1458,warrior,fury,48,24,24
56522,Dtrumpo,moon-guard,1457,warrior,fury,48,22,26
56523,Mandremin,moon-guard,1456,warrior,fury,24,17,7
56524,Cogsbixby,aerie-peak,1455,warrior,fury,30,21,9
56525,Rhann,kelthuzad,1454,warrior,fury,44,23,21
56526,Corbray,frostmourne,1454,warrior,fury,42,20,22
56527,Bruttallis,frostmane,1452,warrior,fury,38,20,18
56528,Murderwalk,shadowmoon,1452,warrior,fury,45,23,22
56529,Bigjier,proudmoore,1452,warrior,fury,104,53,51
56530,Ragnararagor,ragnaros,1452,warrior,fury,257,126,131
56531,Machâ,illidan,1451,warrior,fury,35,17,18
56532,Calzonez,bloodscalp,1449,warrior,fury,53,31,22
56533,Kortera,malganis,1449,warrior,fury,59,33,26
56534,Wazy,ragnaros,1448,warrior,fury,66,31,35
56535,Connero,stormrage,1448,warrior,fury,54,25,29
56536,Bestgrunt,tichondrius,1446,warrior,fury,102,46,56
56537,Moriax,azralon,1445,warrior,fury,136,71,65
56538,Siegfriéd,bleeding-hollow,1444,warrior,fury,48,28,20
56539,Biggbudzz,sargeras,1441,warrior,fury,47,23,24
56540,Bòne,frostmourne,1440,warrior,fury,36,17,19
56541,Monreale,area-52,1439,warrior,fury,24,16,8
56542,Saabre,tichondrius,1438,warrior,fury,72,36,36
56543,Sarovek,thrall,1437,warrior,fury,48,27,21
56544,Nikomasked,kelthuzad,1436,warrior,fury,24,15,9
56545,Vheraxes,sargeras,1435,warrior,fury,24,15,9
56546,Xenogears,boulderfist,1435,warrior,fury,60,23,37
56547,Elken,haomarush,1434,warrior,fury,48,26,22
56548,Kenpachì,kelthuzad,1433,warrior,fury,25,16,9
56549,Trco,quelthalas,1433,warrior,fury,48,28,20
56550,Lemondrake,sargeras,1432,warrior,fury,24,15,9
56551,Døppiø,area-52,1432,warrior,fury,28,16,12
56552,Cenanuandra,gnomeregan,1432,warrior,fury,70,39,31
56553,Mankus,tichondrius,1432,warrior,fury,90,45,45
56554,Apeal,skullcrusher,1431,warrior,fury,96,51,45
56555,Chlord,proudmoore,1430,warrior,fury,30,15,15
56556,Wishayzka,drakkari,1430,warrior,fury,42,20,22
56557,Progesterone,bleeding-hollow,1429,warrior,fury,36,15,21
56558,Impaling,moon-guard,1428,warrior,fury,59,35,24
56559,Décapitator,area-52,1428,warrior,fury,36,15,21
56560,Vnw,illidan,1427,warrior,fury,24,15,9
56561,Toberino,illidan,1427,warrior,fury,24,15,9
56562,Kaladbolg,tichondrius,1427,warrior,fury,84,47,37
56563,Thyssara,moon-guard,1427,warrior,fury,99,51,48
56564,Limpninny,dalaran,1426,warrior,fury,39,17,22
56565,Ikoré,saurfang,1425,warrior,fury,87,45,42
56566,Dözer,icecrown,1424,warrior,fury,36,20,16
56567,Extremerogu,tichondrius,1423,warrior,fury,47,25,22
56568,Tenger,velen,1422,warrior,fury,101,56,45
56569,Maciste,exodar,1422,warrior,fury,30,15,15
56570,Ruktar,akama,1422,warrior,fury,89,43,46
56571,Aarmii,ragnaros,1421,warrior,fury,77,38,39
56572,Nixe,caelestrasz,1421,warrior,fury,92,43,49
56573,Attractive,silvermoon,1420,warrior,fury,103,57,46
56574,Gokkuu,dragonblight,1420,warrior,fury,60,33,27
56575,Asuna,burning-blade,1420,warrior,fury,46,24,22
56576,Heenguer,azralon,1420,warrior,fury,60,31,29
56577,Äléx,frostmourne,1418,warrior,fury,36,22,14
56578,Majindoom,illidan,1418,warrior,fury,47,27,20
56579,Gromarth,wyrmrest-accord,1418,warrior,fury,70,38,32
56580,Lechonk,suramar,1415,warrior,fury,30,16,14
56581,Bhutjolokia,ragnaros,1415,warrior,fury,48,23,25
56582,Zareshi,sargeras,1412,warrior,fury,140,71,69
56583,Eamonvalda,dalaran,1410,warrior,fury,45,25,20
56584,Warsongwolf,tichondrius,1409,warrior,fury,78,36,42
56585,Galigiggs,emerald-dream,1407,warrior,fury,24,15,9
56586,Burtiera,wyrmrest-accord,1407,warrior,fury,60,36,24
56587,Noppô,tichondrius,1406,warrior,fury,47,30,17
56588,Errejota,illidan,1406,warrior,fury,54,26,28
56589,Bloodhârdt,area-52,1404,warrior,fury,70,35,35
56590,Howlofang,bleeding-hollow,1404,warrior,fury,54,23,31
56591,Exëqt,area-52,1404,warrior,fury,60,25,35
56592,Alecsten,tichondrius,1403,warrior,fury,30,15,15
56593,Tacomeat,malorne,1403,warrior,fury,46,22,24
56594,Cevadix,azralon,1402,warrior,fury,42,22,20
56595,Noten,thunderlord,1401,warrior,fury,76,42,34
56596,Sindarin,eitrigg,1400,warrior,fury,54,32,22
56597,Kolgrim,hyjal,1400,warrior,fury,27,16,11
56598,Xurug,zuljin,1400,warrior,fury,30,15,15
56599,Panicbutton,proudmoore,1397,warrior,fury,66,35,31
56600,Lovehandlez,proudmoore,1396,warrior,fury,54,30,24
56601,Thren,tichondrius,1396,warrior,fury,30,15,15
56602,Fluffytaco,illidan,1395,warrior,fury,60,32,28
56603,Modzilla,aerie-peak,1395,warrior,fury,60,28,32
56604,Lyonele,moon-guard,1394,warrior,fury,50,28,22
56605,Mervyn,aegwynn,1393,warrior,fury,24,15,9
56606,Ourhero,malganis,1392,warrior,fury,27,16,11
56607,Zekken,blades-edge,1392,warrior,fury,77,39,38
56608,Destructör,nagrand,1392,warrior,fury,72,34,38
56609,Sïxsnacks,stormrage,1389,warrior,fury,26,16,10
56610,Youserg,khazgoroth,1386,warrior,fury,117,59,58
56611,Tinyterror,sargeras,1386,warrior,fury,48,22,26
56612,Zerríck,moon-guard,1385,warrior,fury,78,38,40
56613,Spaceburied,illidan,1385,warrior,fury,129,59,70
56614,Rhohan,ysera,1384,warrior,fury,52,28,24
56615,Quuavo,tichondrius,1384,warrior,fury,48,25,23
56616,Ayrifik,tichondrius,1383,warrior,fury,21,15,6
56617,Rageinc,jubeithos,1383,warrior,fury,62,28,34
56618,Perserve,thunderlord,1383,warrior,fury,96,41,55
56619,Vedrikk,ragnaros,1382,warrior,fury,30,16,14
56620,Kratøz,tichondrius,1382,warrior,fury,36,18,18
56621,Whitetaure,arthas,1382,warrior,fury,60,24,36
56622,Thywub,proudmoore,1380,warrior,fury,36,17,19
56623,Weesten,aerie-peak,1378,warrior,fury,178,99,79
56624,Swiffy,stormrage,1375,warrior,fury,46,29,17
56625,Brugo,area-52,1374,warrior,fury,91,56,35
56626,Originalkhan,stormrage,1373,warrior,fury,54,23,31
56627,Aladrynne,dalaran,1372,warrior,fury,183,88,95
56628,Jarvîs,moon-guard,1371,warrior,fury,55,25,30
56629,Zootonius,bloodscalp,1368,warrior,fury,36,20,16
56630,Kross,illidan,1368,warrior,fury,80,39,41
56631,Firmware,illidan,1368,warrior,fury,34,15,19
56632,Chounshiryu,drakkari,1367,warrior,fury,283,142,141
56633,Áres,spinebreaker,1366,warrior,fury,48,24,24
56634,Hêllseeker,ragnaros,1365,warrior,fury,52,24,28
56635,Crushanater,tichondrius,1364,warrior,fury,33,17,16
56636,Ísrafel,ragnaros,1363,warrior,fury,36,21,15
56637,Rageraz,trollbane,1362,warrior,fury,30,19,11
56638,Valkwar,tichondrius,1362,warrior,fury,54,28,26
56639,Nebgleb,bleeding-hollow,1360,warrior,fury,24,16,8
56640,Reesse,eonar,1360,warrior,fury,30,17,13
56641,Emotionaldps,malygos,1360,warrior,fury,141,74,67
56642,Ivanzaytsev,ragnaros,1360,warrior,fury,78,40,38
56643,Johnnysnowx,sargeras,1359,warrior,fury,107,54,53
56644,Barntley,illidan,1358,warrior,fury,44,24,20
56645,Matthegreat,area-52,1354,warrior,fury,51,25,26
56646,Arbeon,emerald-dream,1348,warrior,fury,19,15,4
56647,Ryukendo,stormrage,1346,warrior,fury,123,65,58
56648,Ghostwalker,akama,1344,warrior,fury,56,27,29
56649,Rerollrogue,thrall,1344,warrior,fury,95,42,53
56650,Contradict,thrall,1343,warrior,fury,42,20,22
56651,Rawheadrex,sargeras,1342,warrior,fury,24,14,10
56652,Varlekt,frostmourne,1342,warrior,fury,65,34,31
56653,Elbetoques,ragnaros,1341,warrior,fury,53,32,21
56654,Fendimonster,tichondrius,1341,warrior,fury,226,123,103
56655,Slughörn,moon-guard,1341,warrior,fury,30,14,16
56656,Deseroth,illidan,1341,warrior,fury,30,14,16
56657,Setseno,stormrage,1340,warrior,fury,32,16,16
56658,Noteko,tichondrius,1340,warrior,fury,30,15,15
56659,Teresabelle,proudmoore,1338,warrior,fury,40,20,20
56660,Xiaoyujin,proudmoore,1337,warrior,fury,24,14,10
56661,Michaela,moon-guard,1336,warrior,fury,24,14,10
56662,Ciellë,proudmoore,1334,warrior,fury,27,17,10
56663,Ensïs,moon-guard,1333,warrior,fury,72,31,41
56664,Shino,garona,1332,warrior,fury,22,15,7
56665,Zartren,khazgoroth,1331,warrior,fury,24,14,10
56666,Breaker,undermine,1331,warrior,fury,30,14,16
56667,Rusteazy,bleeding-hollow,1331,warrior,fury,36,15,21
56668,Kelandrin,illidan,1330,warrior,fury,36,21,15
56669,Sulze,tichondrius,1330,warrior,fury,27,15,12
56670,Alysson,moon-guard,1329,warrior,fury,24,14,10
56671,Dabier,bleeding-hollow,1329,warrior,fury,68,30,38
56672,Ludicrous,dreadmaul,1327,warrior,fury,74,40,34
56673,Bingin,stormrage,1327,warrior,fury,36,17,19
56674,Timer,nagrand,1325,warrior,fury,30,18,12
56675,Samuwrigh,tichondrius,1325,warrior,fury,30,17,13
56676,Bondeye,stormrage,1325,warrior,fury,83,38,45
56677,Arfzz,zangarmarsh,1325,warrior,fury,42,17,25
56678,Boryndin,caelestrasz,1324,warrior,fury,18,14,4
56679,Leturen,area-52,1324,warrior,fury,35,19,16
56680,Hewman,aerie-peak,1321,warrior,fury,30,17,13
56681,Uggtrick,zuljin,1321,warrior,fury,86,41,45
56682,Galaxarr,bonechewer,1319,warrior,fury,65,32,33
56683,Venóm,moon-guard,1317,warrior,fury,24,14,10
56684,Cougaloo,sargeras,1317,warrior,fury,66,31,35
56685,Slaggdad,illidan,1317,warrior,fury,132,60,72
56686,Jichelei,tichondrius,1316,warrior,fury,30,14,16
56687,Maarilayne,wyrmrest-accord,1315,warrior,fury,36,20,16
56688,Zenrrei,ragnaros,1315,warrior,fury,31,15,16
56689,Hellframe,ysondre,1315,warrior,fury,42,17,25
56690,Kahuwuna,tichondrius,1314,warrior,fury,30,14,16
56691,Wurrukattezz,tichondrius,1314,warrior,fury,62,28,34
56692,Dissx,illidan,1308,warrior,fury,54,23,31
56693,Crixsullus,sargeras,1307,warrior,fury,36,20,16
56694,Tüssèll,khazgoroth,1306,warrior,fury,97,48,49
56695,Assaulttank,drenden,1306,warrior,fury,48,20,28
56696,Eatafrank,tichondrius,1305,warrior,fury,37,20,17
56697,Makcumba,ragnaros,1305,warrior,fury,41,19,22
56698,Sansãocore,nemesis,1304,warrior,fury,70,30,40
56699,Lighttaker,proudmoore,1302,warrior,fury,96,51,45
56700,Washim,area-52,1301,warrior,fury,49,27,22
56701,Osannd,tichondrius,1301,warrior,fury,66,31,35
56702,Kujø,wyrmrest-accord,1301,warrior,fury,66,28,38
56703,Dhaemom,azralon,1300,warrior,fury,108,53,55
56704,Arrad,sargeras,1299,warrior,fury,74,38,36
56705,Goleus,emerald-dream,1299,warrior,fury,42,17,25
56706,Tranos,zuljin,1299,warrior,fury,36,14,22
56707,Maytrix,bleeding-hollow,1298,warrior,fury,66,33,33
56708,Xeto,ragnaros,1296,warrior,fury,34,20,14
56709,Fabian,kelthuzad,1296,warrior,fury,76,40,36
56710,Vornicar,moon-guard,1296,warrior,fury,50,23,27
56711,Chash,frostmourne,1293,warrior,fury,24,14,10
56712,Joxer,nordrassil,1293,warrior,fury,48,25,23
56713,Farklesnarf,tichondrius,1292,warrior,fury,30,14,16
56714,Ganzar,nesingwary,1292,warrior,fury,35,14,21
56715,Spicywagyu,tichondrius,1291,warrior,fury,36,22,14
56716,Iblith,sargeras,1291,warrior,fury,42,23,19
56717,Mcburger,barthilas,1290,warrior,fury,36,18,18
56718,Bdm,mugthol,1290,warrior,fury,34,15,19
56719,Hup,dethecus,1290,warrior,fury,36,14,22
56720,Syaon,moon-guard,1288,warrior,fury,36,21,15
56721,Wuushang,area-52,1288,warrior,fury,62,31,31
56722,Grommasth,jubeithos,1286,warrior,fury,30,17,13
56723,Hescobarrier,dalaran,1286,warrior,fury,30,16,14
56724,Heavymetalyo,sargeras,1285,warrior,fury,36,20,16
56725,Raskmeth,zuljin,1285,warrior,fury,36,20,16
56726,Funk,illidan,1285,warrior,fury,42,14,28
56727,Zweihänder,nemesis,1284,warrior,fury,23,14,9
56728,Chippurrz,illidan,1284,warrior,fury,77,43,34
56729,Ironpanzer,thrall,1283,warrior,fury,92,45,47
56730,Metalstorms,firetree,1283,warrior,fury,72,35,37
56731,Sheerwill,wyrmrest-accord,1281,warrior,fury,42,18,24
56732,Smasher,garona,1277,warrior,fury,36,16,20
56733,Kitto,malganis,1277,warrior,fury,56,22,34
56734,Blackpro,sargeras,1275,warrior,fury,48,30,18
56735,Slashen,sargeras,1274,warrior,fury,23,14,9
56736,Leviathanl,bleeding-hollow,1274,warrior,fury,37,21,16
56737,Rsage,lightbringer,1274,warrior,fury,116,59,57
56738,Warföx,stormrage,1273,warrior,fury,54,23,31
56739,Thorfjin,stormrage,1272,warrior,fury,30,15,15
56740,Spaceguybro,whisperwind,1272,warrior,fury,47,20,27
56741,Mikejustice,kelthuzad,1269,warrior,fury,142,65,77
56742,Ivoryana,kelthuzad,1266,warrior,fury,48,25,23
56743,Orrof,antonidas,1266,warrior,fury,135,61,74
56744,Paí,nemesis,1265,warrior,fury,24,15,9
56745,Ghazzghkull,illidan,1263,warrior,fury,53,27,26
56746,Lilcha,stormrage,1258,warrior,fury,36,15,21
56747,Tiqokz,sargeras,1257,warrior,fury,24,14,10
56748,Swággýc,tichondrius,1257,warrior,fury,46,25,21
56749,Savikk,earthen-ring,1256,warrior,fury,42,23,19
56750,Rakshata,destromath,1256,warrior,fury,30,15,15
56751,Garce,aerie-peak,1253,warrior,fury,31,16,15
56752,Splints,nesingwary,1252,warrior,fury,44,25,19
56753,Vandrad,stormrage,1252,warrior,fury,123,56,67
56754,Renseven,frostmourne,1251,warrior,fury,42,23,19
56755,Kurishjadar,tichondrius,1251,warrior,fury,66,31,35
56756,Elonownesme,zuljin,1251,warrior,fury,56,26,30
56757,Wiimaann,quelthalas,1250,warrior,fury,31,14,17
56758,Nezzarek,sargeras,1250,warrior,fury,97,40,57
56759,Wariorphilip,moon-guard,1248,warrior,fury,33,19,14
56760,Wakkawar,stormrage,1248,warrior,fury,48,24,24
56761,Cryposlice,malganis,1247,warrior,fury,30,13,17
56762,Carnemontana,shadowsong,1246,warrior,fury,24,17,7
56763,Jutank,sargeras,1245,warrior,fury,18,13,5
56764,Verigan,barthilas,1244,warrior,fury,18,13,5
56765,Draxxarlol,zuljin,1244,warrior,fury,24,13,11
56766,Taiine,moon-guard,1243,warrior,fury,24,13,11
56767,Torkscreww,bleeding-hollow,1243,warrior,fury,24,13,11
56768,Liltom,sargeras,1242,warrior,fury,24,13,11
56769,Buckleboot,illidan,1242,warrior,fury,24,13,11
56770,Rendard,sargeras,1242,warrior,fury,24,13,11
56771,Ironsavage,frostmourne,1242,warrior,fury,24,13,11
56772,Mammo,khazgoroth,1241,warrior,fury,24,13,11
56773,Warhand,frostmourne,1241,warrior,fury,30,13,17
56774,Tripichin,sargeras,1240,warrior,fury,22,16,6
56775,Icrìtmypants,dragonmaw,1240,warrior,fury,18,13,5
56776,Cidrick,stormrage,1240,warrior,fury,18,13,5
56777,Copinhodagua,azralon,1240,warrior,fury,25,15,10
56778,Smeshyou,kelthuzad,1240,warrior,fury,24,13,11
56779,Robocöp,quelthalas,1239,warrior,fury,24,13,11
56780,Derr,tichondrius,1239,warrior,fury,30,13,17
56781,Bártho,area-52,1237,warrior,fury,24,13,11
56782,Skipowawa,area-52,1237,warrior,fury,30,16,14
56783,Phandrosa,ragnaros,1237,warrior,fury,31,14,17
56784,Lucicicia,bronzebeard,1236,warrior,fury,18,13,5
56785,Atracasöl,ragnaros,1236,warrior,fury,24,13,11
56786,Agonistes,emerald-dream,1236,warrior,fury,42,16,26
56787,Maydie,illidan,1235,warrior,fury,24,13,11
56788,Xanåtos,moon-guard,1234,warrior,fury,36,21,15
56789,Kaíroz,quelthalas,1233,warrior,fury,54,31,23
56790,Therealflex,zuljin,1233,warrior,fury,24,13,11
56791,Zephyron,moonrunner,1231,warrior,fury,38,18,20
56792,Murotamaka,malganis,1231,warrior,fury,30,13,17
56793,Greenugly,tichondrius,1229,warrior,fury,54,24,30
56794,Chilledflex,stormrage,1229,warrior,fury,30,13,17
56795,Cjay,bleeding-hollow,1229,warrior,fury,30,13,17
56796,Tlâloque,quelthalas,1228,warrior,fury,42,21,21
56797,Kyle,kargath,1227,warrior,fury,34,21,13
56798,Groggam,illidan,1226,warrior,fury,24,13,11
56799,Tupacsback,stormrage,1224,warrior,fury,48,26,22
56800,Tdaddy,lightbringer,1224,warrior,fury,168,84,84
56801,Furiousangel,area-52,1223,warrior,fury,36,19,17
56802,Mnoga,azralon,1222,warrior,fury,58,27,31
56803,Beryrn,farstriders,1220,warrior,fury,47,28,19
56804,Warbane,barthilas,1220,warrior,fury,36,19,17
56805,Zerkules,frostmane,1220,warrior,fury,30,13,17
56806,Grosjambes,turalyon,1214,warrior,fury,30,18,12
56807,Screwz,blackrock,1214,warrior,fury,104,52,52
56808,Tenebrocity,stormrage,1213,warrior,fury,42,19,23
56809,Tryndamere,nagrand,1212,warrior,fury,41,18,23
56810,Tayne,ragnaros,1208,warrior,fury,30,14,16
56811,Wyrmscream,moon-guard,1207,warrior,fury,138,73,65
56812,Breinan,ragnaros,1205,warrior,fury,51,26,25
56813,Dawrzel,tichondrius,1201,warrior,fury,51,23,28
56814,Zèldris,gallywix,1199,warrior,fury,121,68,53
56815,Rendus,hyjal,1198,warrior,fury,54,21,33
56816,Bigglyjoobs,tichondrius,1195,warrior,fury,23,13,10
56817,Wraithvlad,moon-guard,1194,warrior,fury,97,43,54
56818,Lidia,windrunner,1194,warrior,fury,38,14,24
56819,Tinycutty,frostmourne,1189,warrior,fury,23,13,10
56820,Koraciá,illidan,1188,warrior,fury,42,19,23
56821,Kevinhårt,sargeras,1186,warrior,fury,36,13,23
56822,Akusenshi,dragonblight,1184,warrior,fury,114,54,60
56823,Nemesioh,tichondrius,1184,warrior,fury,59,25,34
56824,Honduranhary,sargeras,1183,warrior,fury,34,17,17
56825,Serviettski,zuljin,1181,warrior,fury,36,19,17
56826,Furyknight,velen,1180,warrior,fury,79,41,38
56827,Freakin,ragnaros,1180,warrior,fury,58,27,31
56828,Ragemarley,dalaran,1180,warrior,fury,41,19,22
56829,Ventréss,bleeding-hollow,1179,warrior,fury,29,14,15
56830,Akarì,emerald-dream,1176,warrior,fury,30,15,15
56831,Liljon,windrunner,1166,warrior,fury,36,17,19
56832,Zorhn,skywall,1161,warrior,fury,24,18,6
56833,Lucymay,kelthuzad,1159,warrior,fury,48,28,20
56834,Darthwarr,bleeding-hollow,1156,warrior,fury,35,23,12
56835,Lawyer,quelthalas,1152,warrior,fury,48,20,28
56836,Yepkorean,tichondrius,1151,warrior,fury,18,12,6
56837,Notfaytful,thrall,1151,warrior,fury,21,13,8
56838,Líliúm,ragnaros,1151,warrior,fury,31,19,12
56839,Calmebigfeet,tichondrius,1151,warrior,fury,24,12,12
56840,Skrognoth,malganis,1150,warrior,fury,18,12,6
56841,Brutalloli,thrall,1150,warrior,fury,25,13,12
56842,Choppin,sargeras,1150,warrior,fury,24,12,12
56843,Ganzism,tichondrius,1150,warrior,fury,24,12,12
56844,Notcoverage,tichondrius,1150,warrior,fury,24,12,12
56845,Ganzi,tichondrius,1150,warrior,fury,24,12,12
56846,Lethu,tichondrius,1149,warrior,fury,18,12,6
56847,Vulnscan,tichondrius,1149,warrior,fury,30,12,18
56848,Flaapjack,malganis,1147,warrior,fury,18,12,6
56849,Justicwar,area-52,1147,warrior,fury,24,12,12
56850,Synalia,sargeras,1147,warrior,fury,24,12,12
56851,Stånnis,moon-guard,1146,warrior,fury,18,12,6
56852,Lòrdnasher,tichondrius,1146,warrior,fury,21,13,8
56853,Faywarsong,area-52,1145,warrior,fury,24,12,12
56854,Midweststuna,kul-tiras,1144,warrior,fury,18,12,6
56855,Okkin,cairne,1143,warrior,fury,18,12,6
56856,Reäl,dalaran,1143,warrior,fury,24,12,12
56857,Kanekhy,ragnaros,1143,warrior,fury,28,13,15
56858,Casmier,tichondrius,1141,warrior,fury,18,12,6
56859,Sixtyboost,tichondrius,1139,warrior,fury,24,12,12
56860,Balbyo,shattered-hand,1139,warrior,fury,30,12,18
56861,Shééylias,moon-guard,1137,warrior,fury,30,12,18
56862,Aitadon,sargeras,1136,warrior,fury,24,12,12
56863,Kaladïn,ragnaros,1135,warrior,fury,18,12,6
56864,Talismantate,quelthalas,1135,warrior,fury,18,12,6
56865,Madaroy,stormrage,1135,warrior,fury,38,19,19
56866,Curvinito,emerald-dream,1135,warrior,fury,24,12,12
56867,Kreyonz,hyjal,1129,warrior,fury,24,12,12
56868,Stinkyfuq,area-52,1128,warrior,fury,18,12,6
56869,Valdemär,stormrage,1128,warrior,fury,30,12,18
56870,Icon,tichondrius,1128,warrior,fury,30,12,18
56871,Lykon,echo-isles,1127,warrior,fury,30,17,13
56872,Chahta,shadowsong,1125,warrior,fury,18,12,6
56873,Nondracio,ragnaros,1125,warrior,fury,36,12,24
56874,Nutwax,korgath,1123,warrior,fury,36,14,22
56875,Warkinit,proudmoore,1120,warrior,fury,68,30,38
56876,Trendxx,stormrage,1118,warrior,fury,42,14,28
56877,Rekitralph,tichondrius,1116,warrior,fury,30,13,17
56878,Evergardens,saurfang,1115,warrior,fury,30,15,15
56879,Irontarkus,garrosh,1112,warrior,fury,18,12,6
56880,Welgo,moon-guard,1112,warrior,fury,24,13,11
56881,Starplatinum,aerie-peak,1112,warrior,fury,60,26,34
56882,Legionário,sargeras,1111,warrior,fury,29,15,14
56883,Droun,rexxar,1110,warrior,fury,75,37,38
56884,Awell,azralon,1109,warrior,fury,42,21,21
56885,Sphílly,thrall,1107,warrior,fury,36,19,17
56886,Garmeg,nemesis,1105,warrior,fury,78,36,42
56887,Tyraelius,kiljaeden,1103,warrior,fury,39,24,15
56888,Brolgo,quelthalas,1103,warrior,fury,54,22,32
56889,Danastus,icecrown,1102,warrior,fury,63,27,36
56890,Zokrásh,quelthalas,1102,warrior,fury,42,13,29
56891,Jankalmojo,proudmoore,1101,warrior,fury,32,12,20
56892,Jellyjamz,zuljin,1100,warrior,fury,36,19,17
56893,Rocketcayton,veknilash,1096,warrior,fury,54,30,24
56894,Warriorlee,jubeithos,1096,warrior,fury,27,13,14
56895,Roxon,hellscream,1095,warrior,fury,95,47,48
56896,Hyperdevil,ragnaros,1094,warrior,fury,30,14,16
56897,Outrage,the-forgotten-coast,1093,warrior,fury,26,13,13
56898,Goinberserk,tichondrius,1093,warrior,fury,34,16,18
56899,Xfootman,quelthalas,1092,warrior,fury,42,25,17
56900,Dodiru,azralon,1084,warrior,fury,27,13,14
56901,Brodîn,tichondrius,1083,warrior,fury,54,30,24
56902,Elsee,drakkari,1080,warrior,fury,26,12,14
56903,Undmyaxe,shattered-halls,1078,warrior,fury,24,13,11
56904,Assmut,stormrage,1074,warrior,fury,35,15,20
56905,Fatguy,tichondrius,1067,warrior,fury,84,41,43
56906,Creedz,dreadmaul,1064,warrior,fury,48,21,27
56907,Zankets,area-52,1056,warrior,fury,12,11,1
56908,Yermalx,tichondrius,1055,warrior,fury,18,11,7
56909,Xgraves,sargeras,1055,warrior,fury,18,11,7
56910,Ragingboner,aggramar,1055,warrior,fury,18,11,7
56911,Nertharul,zuljin,1055,warrior,fury,18,11,7
56912,Xcuses,area-52,1055,warrior,fury,18,11,7
56913,Nicfury,alterac-mountains,1055,warrior,fury,18,11,7
56914,Flaco,tichondrius,1055,warrior,fury,21,12,9
56915,Gorbagglúk,azralon,1055,warrior,fury,30,15,15
56916,Uhtred,moonrunner,1055,warrior,fury,24,12,12
56917,Bobu,area-52,1055,warrior,fury,24,11,13
56918,Bornclueless,illidan,1055,warrior,fury,24,11,13
56919,Bearlornan,frostmourne,1054,warrior,fury,18,11,7
56920,Claymation,tichondrius,1054,warrior,fury,18,11,7
56921,Madwolf,tichondrius,1053,warrior,fury,18,11,7
56922,Mogghul,azralon,1053,warrior,fury,18,11,7
56923,Sako,amanthul,1052,warrior,fury,18,11,7
56924,Chumbinhu,stormrage,1052,warrior,fury,18,11,7
56925,Mightypikel,illidan,1051,warrior,fury,16,12,4
56926,Cptnchocmilk,thrall,1051,warrior,fury,18,11,7
56927,Hydrolisk,area-52,1051,warrior,fury,18,11,7
56928,Radisa,sargeras,1051,warrior,fury,30,11,19
56929,Orson,lothar,1050,warrior,fury,18,11,7
56930,Xakp,tichondrius,1050,warrior,fury,27,12,15
56931,Shrekshomie,zuljin,1049,warrior,fury,18,11,7
56932,Villäïness,daggerspine,1049,warrior,fury,22,13,9
56933,Ráionshin,quelthalas,1049,warrior,fury,24,11,13
56934,Marcuss,bonechewer,1043,warrior,fury,18,11,7
56935,Cåfe,tichondrius,1043,warrior,fury,18,11,7
56936,Mercurial,mugthol,1042,warrior,fury,18,12,6
56937,Djfredsd,tichondrius,1041,warrior,fury,24,11,13
56938,Offthecharts,mannoroth,1040,warrior,fury,44,22,22
56939,Smallestwar,zuljin,1040,warrior,fury,89,37,52
56940,Owwycowwy,area-52,1032,warrior,fury,36,15,21
56941,Studsrus,aegwynn,1030,warrior,fury,92,46,46
56942,Nelissa,runetotem,1030,warrior,fury,24,12,12
56943,Shoteiotoshi,ragnaros,1028,warrior,fury,47,25,22
56944,Learila,moon-guard,1027,warrior,fury,30,14,16
56945,Munanio,stormrage,1024,warrior,fury,24,11,13
56946,Axekill,bleeding-hollow,1019,warrior,fury,30,11,19
56947,Lodog,proudmoore,1012,warrior,fury,28,12,16
56948,Bothar,sargeras,1012,warrior,fury,30,11,19
56949,Markodarko,gilneas,1011,warrior,fury,29,16,13
56950,Grimfàng,moon-guard,1009,warrior,fury,44,19,25
56951,Éeu,anubarak,1008,warrior,fury,112,58,54
56952,Shiddoshi,ragnaros,1006,warrior,fury,24,14,10
56953,Crazysharpz,thaurissan,1001,warrior,fury,29,12,17
56954,Xauce,queldorei,999,warrior,fury,42,12,30
56955,Warchine,malganis,994,warrior,fury,27,12,15
56956,Splurger,thrall,991,warrior,fury,17,11,6
56957,Yêawen,tichondrius,990,warrior,fury,20,11,9
56958,Tyranatusk,malganis,989,warrior,fury,18,12,6
56959,Jonÿ,sargeras,989,warrior,fury,84,44,40
56960,Muufasa,nerzhul,988,warrior,fury,24,13,11
56961,Curacao,dark-iron,987,warrior,fury,26,11,15
56962,Rahj,caelestrasz,985,warrior,fury,23,11,12
56963,Bèèfcake,shattered-hand,984,warrior,fury,20,11,9
56964,Bonebreakr,tichondrius,982,warrior,fury,48,18,30
56965,Pulp,sargeras,976,warrior,fury,19,11,8
56966,Elmosmash,thrall,974,warrior,fury,25,11,14
56967,Judessi,kiljaeden,971,warrior,fury,20,11,9
56968,Alexthar,drakkari,967,warrior,fury,86,37,49
56969,Painfulangel,nesingwary,966,warrior,fury,50,29,21
56970,Wargoph,burning-legion,960,warrior,fury,12,10,2
56971,Youngmoneyd,illidan,960,warrior,fury,12,10,2
56972,Gavrien,wyrmrest-accord,960,warrior,fury,12,10,2
56973,Ramseyx,dalaran,960,warrior,fury,16,11,5
56974,Warreeper,area-52,959,warrior,fury,12,10,2
56975,Ooze,darkspear,959,warrior,fury,12,10,2
56976,Dontlookup,tichondrius,959,warrior,fury,15,11,4
56977,Jonhy,illidan,959,warrior,fury,18,10,8
56978,Orrkky,jubeithos,959,warrior,fury,18,10,8
56979,Tigo,khaz-modan,959,warrior,fury,18,10,8
56980,Ankhxiety,sargeras,959,warrior,fury,18,10,8
56981,Vaider,bleeding-hollow,959,warrior,fury,18,10,8
56982,Gryl,stormrage,959,warrior,fury,18,10,8
56983,Akenox,area-52,959,warrior,fury,18,10,8
56984,Hasbullaa,proudmoore,959,warrior,fury,18,10,8
56985,Prestico,ragnaros,959,warrior,fury,24,10,14
56986,Ymìr,moon-guard,959,warrior,fury,24,10,14
56987,Gahenk,chogall,958,warrior,fury,12,10,2
56988,Worclin,illidan,958,warrior,fury,18,10,8
56989,Bigshett,sargeras,958,warrior,fury,18,10,8
56990,Blxckbeard,hyjal,958,warrior,fury,24,10,14
56991,Squishmello,hyjal,957,warrior,fury,12,10,2
56992,Semiru,zuljin,957,warrior,fury,12,10,2
56993,Qicha,tichondrius,957,warrior,fury,24,10,14
56994,Gorcker,hellscream,955,warrior,fury,18,10,8
56995,Sinkale,moon-guard,955,warrior,fury,18,10,8
56996,Harlow,spirestone,955,warrior,fury,24,10,14
56997,Aggravation,bleeding-hollow,955,warrior,fury,24,10,14
56998,Lessandro,quelthalas,954,warrior,fury,18,10,8
56999,Luckychaos,bleeding-hollow,954,warrior,fury,18,10,8
57000,Alerish,quelthalas,954,warrior,fury,18,10,8
57001,Lurtras,exodar,954,warrior,fury,24,10,14
57002,Jcßot,exodar,954,warrior,fury,24,10,14
57003,Nordrages,stormrage,953,warrior,fury,18,10,8
57004,Zépileque,azralon,953,warrior,fury,30,10,20
57005,Brutalpløx,illidan,953,warrior,fury,30,10,20
57006,Ironbark,elune,952,warrior,fury,18,10,8
57007,Hadowar,thrall,952,warrior,fury,18,10,8
57008,Mfgodofwar,kelthuzad,951,warrior,fury,24,10,14
57009,Maytrixx,stormrage,950,warrior,fury,12,10,2
57010,Jellybomb,sargeras,950,warrior,fury,24,10,14
57011,Slumdawgg,andorhal,948,warrior,fury,24,10,14
57012,Cannan,the-underbog,948,warrior,fury,81,28,53
57013,Rumka,draktharon,943,warrior,fury,71,26,45
57014,Croxxs,aegwynn,934,warrior,fury,18,10,8
57015,Gushee,medivh,927,warrior,fury,23,12,11
57016,Darkarus,drakkari,925,warrior,fury,36,14,22
57017,Hùlksmâsh,zuljin,924,warrior,fury,23,13,10
57018,Afelhia,moon-guard,924,warrior,fury,25,11,14
57019,Ghostlyedge,turalyon,918,warrior,fury,72,25,47
57020,Qfiend,stormrage,911,warrior,fury,17,10,7
57021,Obiwun,azgalor,910,warrior,fury,17,10,7
57022,Nïckböï,misha,909,warrior,fury,41,21,20
57023,Dolsorae,malganis,905,warrior,fury,28,11,17
57024,Pigonhae,zuljin,904,warrior,fury,25,12,13
57025,Lokiullr,tichondrius,900,warrior,fury,27,11,16
57026,Samdarkblade,kilrogg,898,warrior,fury,33,10,23
57027,Shyliar,thrall,896,warrior,fury,20,10,10
57028,Grievouz,nemesis,894,warrior,fury,17,10,7
57029,Xtargaryen,stormrage,893,warrior,fury,20,10,10
57030,Tankieone,aggramar,883,warrior,fury,85,31,54
57031,Zambonibob,eonar,876,warrior,fury,54,25,29
57032,Urnitemare,hyjal,872,warrior,fury,66,22,44
57033,Gbrz,stormrage,864,warrior,fury,12,9,3
57034,Beifong,barthilas,864,warrior,fury,12,9,3
57035,Shadowstingg,tichondrius,864,warrior,fury,12,9,3
57036,Pkgdtko,tichondrius,864,warrior,fury,12,9,3
57037,Notacop,malygos,864,warrior,fury,12,9,3
57038,Genderfluuid,trollbane,864,warrior,fury,12,9,3
57039,Nukemdown,darkspear,864,warrior,fury,18,9,9
57040,Chainsa,stormrage,864,warrior,fury,18,9,9
57041,Riftgar,hyjal,864,warrior,fury,18,9,9
57042,Astrëa,quelthalas,864,warrior,fury,18,9,9
57043,Fayttful,area-52,864,warrior,fury,18,9,9
57044,Lindsanv,illidan,864,warrior,fury,18,9,9
57045,Baylîfe,illidan,864,warrior,fury,18,9,9
57046,Shimizuken,tichondrius,864,warrior,fury,24,9,15
57047,Verrynasty,area-52,863,warrior,fury,12,9,3
57048,Virillius,wyrmrest-accord,863,warrior,fury,12,9,3
57049,Ishtalar,sargeras,863,warrior,fury,12,9,3
57050,Flanrych,illidan,863,warrior,fury,12,9,3
57051,Likelygood,tichondrius,863,warrior,fury,12,9,3
57052,Squonks,kelthuzad,863,warrior,fury,12,9,3
57053,Mywarr,andorhal,863,warrior,fury,18,9,9
57054,Zastrow,dalaran,863,warrior,fury,18,9,9
57055,Tyrannus,chogall,863,warrior,fury,18,9,9
57056,Broksampson,stormrage,863,warrior,fury,18,9,9
57057,Elfdestroyer,wyrmrest-accord,863,warrior,fury,18,9,9
57058,Kiladrew,korgath,863,warrior,fury,18,9,9
57059,Youjumpijump,frostmourne,863,warrior,fury,24,9,15
57060,Xclusive,area-52,863,warrior,fury,24,9,15
57061,Yahnjee,stormrage,863,warrior,fury,24,9,15
57062,Gzilla,queldorei,863,warrior,fury,24,9,15
57063,Orsex,ragnaros,863,warrior,fury,24,9,15
57064,Tylerdurdenx,dalaran,862,warrior,fury,12,9,3
57065,Iskandër,quelthalas,862,warrior,fury,12,9,3
57066,Nowarriororc,thrall,862,warrior,fury,18,9,9
57067,Lox,blades-edge,862,warrior,fury,18,9,9
57068,Kåyotix,proudmoore,862,warrior,fury,18,9,9
57069,Archibaldo,darkspear,862,warrior,fury,18,9,9
57070,Kreigër,area-52,862,warrior,fury,18,9,9
57071,Exsolacyst,sargeras,862,warrior,fury,18,9,9
57072,Kiaonlinn,ragnaros,862,warrior,fury,18,9,9
57073,Crammed,tichondrius,862,warrior,fury,24,9,15
57074,Cannonballz,sargeras,861,warrior,fury,18,9,9
57075,Virrainy,stormrage,861,warrior,fury,18,9,9
57076,Painquin,boulderfist,861,warrior,fury,24,9,15
57077,Hamandaxe,amanthul,861,warrior,fury,24,9,15
57078,Nerjinzul,bloodscalp,860,warrior,fury,15,10,5
57079,Maddzspin,tichondrius,860,warrior,fury,18,9,9
57080,Jarmog,tichondrius,860,warrior,fury,18,9,9
57081,Rodorn,frostmourne,860,warrior,fury,22,10,12
57082,Groguu,windrunner,859,warrior,fury,18,9,9
57083,Fartden,tichondrius,859,warrior,fury,18,9,9
57084,Stunninchaos,shattered-hand,859,warrior,fury,24,9,15
57085,Figurefour,tichondrius,858,warrior,fury,12,9,3
57086,Papasmurff,zuljin,858,warrior,fury,18,9,9
57087,Melankoma,sargeras,856,warrior,fury,18,9,9
57088,Jendal,ragnaros,856,warrior,fury,24,11,13
57089,Kræzee,kelthuzad,856,warrior,fury,24,9,15
57090,Nukee,tichondrius,853,warrior,fury,24,9,15
57091,Cüba,nemesis,851,warrior,fury,36,14,22
57092,Boitoróh,azralon,850,warrior,fury,24,9,15
57093,Altharos,drakkari,845,warrior,fury,19,9,10
57094,Trufsoturi,bleeding-hollow,845,warrior,fury,23,9,14
57095,Xiing,azshara,842,warrior,fury,24,9,15
57096,Flywar,nesingwary,838,warrior,fury,60,25,35
57097,Kajing,boulderfist,836,warrior,fury,19,10,9
57098,Cønan,stormrage,830,warrior,fury,14,10,4
57099,Ghonad,windrunner,821,warrior,fury,23,9,14
57100,Kessahh,moon-guard,820,warrior,fury,18,9,9
57101,Likeachimpx,sargeras,816,warrior,fury,15,10,5
57102,Magdar,daggerspine,813,warrior,fury,28,9,19
57103,Haelerostus,moon-guard,811,warrior,fury,60,25,35
57104,Futtmebuck,emerald-dream,810,warrior,fury,18,10,8
57105,Franklinmvrd,stormrage,810,warrior,fury,18,10,8
57106,Rediger,aggramar,805,warrior,fury,40,16,24
57107,Bargorengar,skullcrusher,797,warrior,fury,108,48,60
57108,Liquidbagel,frostmourne,794,warrior,fury,22,9,13
57109,Stompgnomes,malganis,791,warrior,fury,20,9,11
57110,Doominustwo,tichondrius,784,warrior,fury,19,9,10
57111,Verallyn,area-52,783,warrior,fury,19,9,10
57112,Klim,grizzly-hills,781,warrior,fury,25,9,16
57113,Stimm,blood-furnace,768,warrior,fury,12,8,4
57114,Colonclogger,proudmoore,768,warrior,fury,12,8,4
57115,Controlololx,hyjal,768,warrior,fury,12,8,4
57116,Bamag,dethecus,768,warrior,fury,12,8,4
57117,Collosalx,stormrage,768,warrior,fury,12,8,4
57118,Thelma,archimonde,768,warrior,fury,12,8,4
57119,Zadrak,whisperwind,768,warrior,fury,12,8,4
57120,Swìll,illidan,768,warrior,fury,12,8,4
57121,Humanlog,illidan,768,warrior,fury,12,8,4
57122,Angryexe,zuljin,768,warrior,fury,12,8,4
57123,Narwhål,tichondrius,768,warrior,fury,12,8,4
57124,Beforever,kiljaeden,768,warrior,fury,12,8,4
57125,Kruma,stormscale,768,warrior,fury,12,8,4
57126,Baultenaz,draenor,768,warrior,fury,12,8,4
57127,Ryse,aegwynn,768,warrior,fury,12,8,4
57128,Bbcapitalist,blackrock,768,warrior,fury,12,8,4
57129,Beerstorm,stormrage,768,warrior,fury,12,8,4
57130,Rimshotts,sargeras,768,warrior,fury,12,8,4
57131,Idranel,nordrassil,768,warrior,fury,12,8,4
57132,Tehsuperhero,norgannon,768,warrior,fury,12,8,4
57133,Bozwar,tichondrius,768,warrior,fury,18,8,10
57134,Doczz,malganis,768,warrior,fury,18,8,10
57135,Oohsht,tichondrius,768,warrior,fury,18,8,10
57136,Asstastic,bonechewer,768,warrior,fury,18,8,10
57137,Coltyn,illidan,768,warrior,fury,18,8,10
57138,Seanpaiuwu,zuljin,768,warrior,fury,24,8,16
57139,Icebringer,frostmourne,768,warrior,fury,24,8,16
57140,Kyres,moon-guard,767,warrior,fury,12,8,4
57141,Trickyshield,durotan,767,warrior,fury,12,8,4
57142,Spraten,bonechewer,767,warrior,fury,12,8,4
57143,Drunkwarriôr,malygos,767,warrior,fury,12,8,4
57144,Zhangetsu,emerald-dream,767,warrior,fury,12,8,4
57145,Mittyroar,khazgoroth,767,warrior,fury,12,8,4
57146,Moggos,firetree,767,warrior,fury,12,8,4
57147,Varenkä,drakkari,767,warrior,fury,12,8,4
57148,Dagrone,drakkari,767,warrior,fury,12,8,4
57149,Mlau,tichondrius,767,warrior,fury,12,8,4
57150,Enzothebaker,thrall,767,warrior,fury,12,8,4
57151,Wíldcat,illidan,767,warrior,fury,18,8,10
57152,Furyann,frostmourne,767,warrior,fury,18,8,10
57153,Zêtt,drakkari,767,warrior,fury,18,8,10
57154,Gízzmo,tichondrius,767,warrior,fury,18,8,10
57155,Warriorox,illidan,767,warrior,fury,18,8,10
57156,Gorethrax,tichondrius,767,warrior,fury,18,8,10
57157,Maintarget,malganis,767,warrior,fury,18,8,10
57158,Stoneball,kiljaeden,767,warrior,fury,18,8,10
57159,Irallianaa,daggerspine,767,warrior,fury,18,8,10
57160,Potan,thrall,767,warrior,fury,18,8,10
57161,Ungabunga,frostwolf,767,warrior,fury,18,8,10
57162,Zaràki,area-52,767,warrior,fury,18,8,10
57163,Erdres,kelthuzad,767,warrior,fury,22,9,13
57164,Darkirondadi,frostmourne,766,warrior,fury,12,8,4
57165,Theßull,frostmourne,766,warrior,fury,12,8,4
57166,Ugrak,frostmourne,766,warrior,fury,12,8,4
57167,Menelaau,nemesis,766,warrior,fury,12,8,4
57168,Alrekur,moon-guard,766,warrior,fury,12,8,4
57169,Droggo,cenarius,766,warrior,fury,12,8,4
57170,Drumann,hyjal,766,warrior,fury,12,8,4
57171,Gromtalin,sargeras,766,warrior,fury,18,8,10
57172,Genjis,quelthalas,766,warrior,fury,18,8,10
57173,Arågòrn,stormrage,766,warrior,fury,18,8,10
57174,Ayn,llane,766,warrior,fury,18,8,10
57175,Åsc,area-52,766,warrior,fury,18,8,10
57176,Warpaint,azuremyst,766,warrior,fury,18,8,10
57177,Racknon,ragnaros,766,warrior,fury,24,9,15
57178,Alanoria,skywall,765,warrior,fury,18,8,10
57179,Xanthchaser,stormrage,765,warrior,fury,18,8,10
57180,Lourdadmiwal,aegwynn,765,warrior,fury,35,11,24
57181,Hellsinga,stormrage,764,warrior,fury,18,8,10
57182,Zeerohkool,tichondrius,764,warrior,fury,24,8,16
57183,Hishika,quelthalas,763,warrior,fury,15,9,6
57184,Huri,nemesis,763,warrior,fury,30,8,22
57185,Frettyhooman,blood-furnace,762,warrior,fury,12,8,4
57186,Çampbêll,area-52,762,warrior,fury,24,8,16
57187,Buffygramp,kelthuzad,762,warrior,fury,24,8,16
57188,Alandris,icecrown,760,warrior,fury,18,10,8
57189,Vicegripp,misha,759,warrior,fury,18,8,10
57190,Kilp,thrall,751,warrior,fury,17,8,9
57191,Riddickx,dragonblight,746,warrior,fury,30,10,20
57192,Marleau,bleeding-hollow,742,warrior,fury,21,9,12
57193,Slughórn,moon-guard,735,warrior,fury,14,9,5
57194,Arngrimm,area-52,735,warrior,fury,14,9,5
57195,Heater,stormrage,735,warrior,fury,16,8,8
57196,Azmael,sargeras,735,warrior,fury,17,8,9
57197,Alaricck,quelthalas,735,warrior,fury,26,9,17
57198,Vlark,eredar,725,warrior,fury,18,8,10
57199,Sedition,borean-tundra,719,warrior,fury,11,8,3
57200,Zaraki,moon-guard,704,warrior,fury,16,8,8
57201,Eleronogoth,draka,704,warrior,fury,16,8,8
57202,Akj,sargeras,701,warrior,fury,23,9,14
57203,Dagaraha,quelthalas,693,warrior,fury,22,8,14
57204,Cjz,tichondrius,672,warrior,fury,12,7,5
57205,Ðrëäd,area-52,672,warrior,fury,12,7,5
57206,Stonksi,shadowmoon,672,warrior,fury,12,7,5
57207,Notzyeal,area-52,672,warrior,fury,12,7,5
57208,Executefreak,illidan,672,warrior,fury,12,7,5
57209,Tnknspnk,magtheridon,672,warrior,fury,12,7,5
57210,Gazah,skullcrusher,672,warrior,fury,12,7,5
57211,Heyzulnut,whisperwind,672,warrior,fury,12,7,5
57212,Grandorth,moon-guard,672,warrior,fury,12,7,5
57213,Ruckw,stormrage,672,warrior,fury,12,7,5
57214,Funsyze,garona,672,warrior,fury,12,7,5
57215,Dós,emerald-dream,672,warrior,fury,12,7,5
57216,Nylissia,blood-furnace,672,warrior,fury,12,7,5
57217,Tonios,stormrage,672,warrior,fury,12,7,5
57218,Linara,shandris,672,warrior,fury,12,7,5
57219,Ladderx,area-52,672,warrior,fury,12,7,5
57220,Canduin,queldorei,672,warrior,fury,12,7,5
57221,Showtimè,thrall,672,warrior,fury,12,7,5
57222,Riechst,quelthalas,672,warrior,fury,12,7,5
57223,Evanx,sargeras,672,warrior,fury,12,7,5
57224,Maar,lightbringer,672,warrior,fury,12,7,5
57225,Krunas,quelthalas,672,warrior,fury,12,7,5
57226,Kryptonite,illidan,672,warrior,fury,12,7,5
57227,Malatov,moon-guard,672,warrior,fury,12,7,5
57228,Vongrave,moonrunner,672,warrior,fury,12,7,5
57229,Vvarcry,sargeras,672,warrior,fury,12,7,5
57230,Mereleona,quelthalas,672,warrior,fury,12,7,5
57231,Liltotey,frostmourne,672,warrior,fury,12,7,5
57232,Sypii,malganis,672,warrior,fury,12,7,5
57233,Dustywx,area-52,672,warrior,fury,12,7,5
57234,Xårren,stormrage,672,warrior,fury,12,7,5
57235,Oggrend,dalaran,672,warrior,fury,12,7,5
57236,Eino,llane,672,warrior,fury,12,7,5
57237,Souserkill,ragnaros,672,warrior,fury,12,7,5
57238,Iinnocence,frostmourne,672,warrior,fury,12,7,5
57239,Kowboy,stormrage,672,warrior,fury,12,7,5
57240,Mardrex,korgath,672,warrior,fury,18,7,11
57241,Endlesskilla,destromath,672,warrior,fury,18,7,11
57242,Okgotchax,kelthuzad,672,warrior,fury,18,7,11
57243,Belena,barthilas,672,warrior,fury,18,7,11
57244,Ëdwärd,moon-guard,672,warrior,fury,18,7,11
57245,Ðìbs,moon-guard,672,warrior,fury,18,7,11
57246,Rustylugnut,area-52,672,warrior,fury,18,7,11
57247,Radnod,tichondrius,672,warrior,fury,18,7,11
57248,Iwillcrushyo,darkspear,672,warrior,fury,18,7,11
57249,Goaco,drakkari,672,warrior,fury,18,7,11
57250,Dotlom,wyrmrest-accord,672,warrior,fury,24,7,17
57251,Kwelve,proudmoore,671,warrior,fury,12,7,5
57252,Zikeno,dalaran,671,warrior,fury,12,7,5
57253,Bjarkyy,azralon,671,warrior,fury,12,7,5
57254,Demobox,malganis,671,warrior,fury,12,7,5
57255,Greenmachine,twisting-nether,671,warrior,fury,12,7,5
57256,Pancárcho,quelthalas,671,warrior,fury,12,7,5
57257,Nokak,borean-tundra,671,warrior,fury,12,7,5
57258,Lísterfiend,illidan,671,warrior,fury,12,7,5
57259,Ahmorok,moon-guard,671,warrior,fury,12,7,5
57260,Quintonious,dark-iron,671,warrior,fury,12,7,5
57261,Potjiekos,lightninghoof,671,warrior,fury,12,7,5
57262,Gigantx,tichondrius,671,warrior,fury,12,7,5
57263,Yagluth,illidan,671,warrior,fury,12,7,5
57264,Idestroy,exodar,671,warrior,fury,12,7,5
57265,Cellyndia,area-52,671,warrior,fury,12,7,5
57266,Seksyme,darkspear,671,warrior,fury,12,7,5
57267,Methodicaly,aerie-peak,671,warrior,fury,12,7,5
57268,Pelikanesis,arthas,671,warrior,fury,12,7,5
57269,Mullf,stormrage,671,warrior,fury,12,7,5
57270,Iorak,queldorei,671,warrior,fury,12,7,5
57271,Chacca,suramar,671,warrior,fury,18,7,11
57272,Smokiiwar,proudmoore,671,warrior,fury,18,7,11
57273,Neak,kelthuzad,671,warrior,fury,18,7,11
57274,Wårrior,kelthuzad,671,warrior,fury,18,7,11
57275,Rockadoodle,tichondrius,671,warrior,fury,18,7,11
57276,Barsol,ragnaros,671,warrior,fury,18,7,11
57277,Xochicotzin,mugthol,671,warrior,fury,18,7,11
57278,Ragnir,kelthuzad,671,warrior,fury,18,7,11
57279,Ghurrk,hyjal,671,warrior,fury,18,7,11
57280,Chieef,illidan,671,warrior,fury,18,7,11
57281,Hurtless,area-52,671,warrior,fury,18,7,11
57282,Cthumoo,moonrunner,671,warrior,fury,18,7,11
57283,Remudan,tichondrius,671,warrior,fury,18,7,11
57284,Xiosè,ragnaros,671,warrior,fury,24,7,17
57285,Thradek,proudmoore,671,warrior,fury,24,7,17
57286,Dragnol,quelthalas,670,warrior,fury,12,7,5
57287,Chaiwar,ghostlands,670,warrior,fury,12,7,5
57288,Ganon,garrosh,670,warrior,fury,12,7,5
57289,Boneskull,zuljin,669,warrior,fury,12,7,5
57290,Stoneddragon,spinebreaker,669,warrior,fury,12,7,5
57291,Rafaeldantas,azralon,669,warrior,fury,12,7,5
57292,Lyzan,stormrage,669,warrior,fury,12,7,5
57293,Sealee,area-52,669,warrior,fury,12,7,5
57294,Khorvesh,burning-legion,669,warrior,fury,18,7,11
57295,Gamoosh,illidan,669,warrior,fury,20,7,13
57296,Deáthwing,steamwheedle-cartel,669,warrior,fury,24,7,17
57297,Shadowtitanx,korgath,669,warrior,fury,30,7,23
57298,Misgnomer,farstriders,667,warrior,fury,12,7,5
57299,Genesis,zangarmarsh,667,warrior,fury,12,7,5
57300,Sworne,nordrassil,667,warrior,fury,12,7,5
57301,Siiss,stormrage,665,warrior,fury,21,9,12
57302,Keateane,frostmourne,662,warrior,fury,12,7,5
57303,Shhiraq,zuljin,661,warrior,fury,30,7,23
57304,Nighttoker,lightnings-blade,659,warrior,fury,12,7,5
57305,Crashacorn,stormrage,659,warrior,fury,18,7,11
57306,Trailsend,dalaran,658,warrior,fury,12,7,5
57307,Damnge,zuljin,656,warrior,fury,24,10,14
57308,Ayvha,wyrmrest-accord,654,warrior,fury,18,7,11
57309,Naughtytwat,tichondrius,639,warrior,fury,14,8,6
57310,Beardedretz,durotan,639,warrior,fury,16,7,9
57311,Ngu,eldrethalas,639,warrior,fury,17,7,10
57312,Zovudo,area-52,638,warrior,fury,14,8,6
57313,Wintz,dreadmaul,638,warrior,fury,14,8,6
57314,Donjuan,skullcrusher,637,warrior,fury,20,8,12
57315,Nanor,zuljin,635,warrior,fury,14,8,6
57316,Fenmok,khazgoroth,623,warrior,fury,11,7,4
57317,Starcade,executus,623,warrior,fury,11,7,4
57318,Greenwell,area-52,623,warrior,fury,15,7,8
57319,Soypingu,the-scryers,623,warrior,fury,21,7,14
57320,Leónard,moon-guard,622,warrior,fury,17,7,10
57321,Iozhua,wyrmrest-accord,617,warrior,fury,22,9,13
57322,Furryhorv,frostmourne,608,warrior,fury,22,7,15
57323,Rohkvan,illidan,607,warrior,fury,14,7,7
57324,Vorthax,korgath,607,warrior,fury,14,7,7
57325,Riguini,tol-barad,606,warrior,fury,14,7,7
57326,Lilreese,tichondrius,592,warrior,fury,13,7,6
57327,Noktyn,haomarush,591,warrior,fury,11,7,4
57328,Grimfate,boulderfist,576,warrior,fury,6,6,0
57329,Grïnk,stormrage,576,warrior,fury,6,6,0
57330,Seulrene,sargeras,576,warrior,fury,6,6,0
57331,Contented,illidan,576,warrior,fury,9,7,2
57332,Yükana,quelthalas,576,warrior,fury,12,6,6
57333,Disarmed,proudmoore,576,warrior,fury,12,6,6
57334,Gtrain,barthilas,576,warrior,fury,12,6,6
57335,Majaya,area-52,576,warrior,fury,12,6,6
57336,Bigmagron,azralon,576,warrior,fury,12,6,6
57337,Erogorn,dawnbringer,576,warrior,fury,12,6,6
57338,Rigil,the-forgotten-coast,576,warrior,fury,12,6,6
57339,Timbermack,moon-guard,576,warrior,fury,12,6,6
57340,Marfas,hyjal,576,warrior,fury,12,6,6
57341,Benieswar,frostmourne,576,warrior,fury,12,6,6
57342,Shieldchain,dalaran,576,warrior,fury,12,6,6
57343,Râgê,moon-guard,576,warrior,fury,12,6,6
57344,Skoll,illidan,576,warrior,fury,12,6,6
57345,Zatarra,azralon,576,warrior,fury,12,6,6
57346,Ðrënch,tichondrius,576,warrior,fury,12,6,6
57347,Zertok,ravencrest,576,warrior,fury,12,6,6
57348,Emv,area-52,576,warrior,fury,12,6,6
57349,Kennie,malganis,576,warrior,fury,12,6,6
57350,Tortag,malganis,576,warrior,fury,12,6,6
57351,Youngmop,eitrigg,576,warrior,fury,12,6,6
57352,Durrandal,stormrage,576,warrior,fury,12,6,6
57353,Shaolin,duskwood,576,warrior,fury,12,6,6
57354,Kaivax,tichondrius,576,warrior,fury,12,6,6
57355,Ezcharger,kelthuzad,576,warrior,fury,12,6,6
57356,Dangerousd,kiljaeden,576,warrior,fury,12,6,6
57357,Dëåth,azgalor,576,warrior,fury,12,6,6
57358,Yadiig,illidan,576,warrior,fury,12,6,6
57359,Krispykreme,uldum,576,warrior,fury,12,6,6
57360,Freÿdis,zuljin,576,warrior,fury,12,6,6
57361,Atruis,area-52,576,warrior,fury,12,6,6
57362,Snowflakee,jaedenar,576,warrior,fury,12,6,6
57363,Feedzz,area-52,576,warrior,fury,12,6,6
57364,Whateverzhan,tichondrius,576,warrior,fury,12,6,6
57365,Tacrolimus,thrall,576,warrior,fury,12,6,6
57366,Strongerjaw,tichondrius,576,warrior,fury,12,6,6
57367,Gamelagged,area-52,576,warrior,fury,12,6,6
57368,Bestseason,kelthuzad,576,warrior,fury,12,6,6
57369,Mordoo,zuljin,576,warrior,fury,12,6,6
57370,Sunamys,illidan,576,warrior,fury,12,6,6
57371,Fooko,lethon,576,warrior,fury,12,6,6
57372,Matrias,tichondrius,576,warrior,fury,12,6,6
57373,Whittyxc,tichondrius,576,warrior,fury,12,6,6
57374,Raeyth,twisting-nether,576,warrior,fury,12,6,6
57375,Ggludan,area-52,576,warrior,fury,12,6,6
57376,Serzull,area-52,576,warrior,fury,12,6,6
57377,New,sargeras,576,warrior,fury,12,6,6
57378,Bonafidesimp,stormrage,576,warrior,fury,12,6,6
57379,Rezhan,area-52,576,warrior,fury,12,6,6
57380,Iluvhugz,tichondrius,576,warrior,fury,12,6,6
57381,Endurefen,sargeras,576,warrior,fury,12,6,6
57382,Lilkrome,illidan,576,warrior,fury,12,6,6
57383,Oppos,lightnings-blade,576,warrior,fury,12,6,6
57384,Flynnstone,tichondrius,576,warrior,fury,12,6,6
57385,Assamith,nemesis,576,warrior,fury,18,6,12
57386,Kritsg,azgalor,576,warrior,fury,18,6,12
57387,Himer,tichondrius,576,warrior,fury,18,6,12
57388,Flexo,moon-guard,576,warrior,fury,18,6,12
57389,Forks,malganis,576,warrior,fury,18,6,12
57390,Tinfinitee,frostwolf,576,warrior,fury,18,6,12
57391,Digitaldj,frostmourne,576,warrior,fury,18,6,12
57392,Elleaux,bloodscalp,575,warrior,fury,12,6,6
57393,Lorelie,malganis,575,warrior,fury,12,6,6
57394,Kratthos,azralon,575,warrior,fury,12,6,6
57395,Trackhawk,moon-guard,575,warrior,fury,12,6,6
57396,Plidan,shuhalo,575,warrior,fury,12,6,6
57397,Isitorganic,nesingwary,575,warrior,fury,12,6,6
57398,Mordelona,ragnaros,575,warrior,fury,12,6,6
57399,Berario,garrosh,575,warrior,fury,12,6,6
57400,Hoarahløux,trollbane,575,warrior,fury,12,6,6
57401,Xenyn,malganis,575,warrior,fury,12,6,6
57402,Burninated,tichondrius,575,warrior,fury,12,6,6
57403,Redblade,bleeding-hollow,575,warrior,fury,18,6,12
57404,Docmoriarty,malygos,575,warrior,fury,18,6,12
57405,Honorloxo,bleeding-hollow,575,warrior,fury,24,6,18
57406,Betametazone,ragnaros,574,warrior,fury,13,8,5
57407,Waterboylol,malganis,574,warrior,fury,12,6,6
57408,Rageroni,tichondrius,574,warrior,fury,12,6,6
57409,Badairplane,gilneas,574,warrior,fury,12,6,6
57410,Oralo,tichondrius,574,warrior,fury,18,6,12
57411,Siegeshatter,moon-guard,574,warrior,fury,24,6,18
57412,Vethronis,dalaran,572,warrior,fury,12,6,6
57413,Worc,aggramar,572,warrior,fury,12,6,6
57414,Olokrash,dalaran,570,warrior,fury,12,6,6
57415,Deltong,bonechewer,569,warrior,fury,12,6,6
57416,Beccabutcher,tichondrius,566,warrior,fury,12,6,6
57417,Boothtowolf,the-forgotten-coast,566,warrior,fury,12,6,6
57418,Finnin,nathrezim,559,warrior,fury,11,6,5
57419,Tochixchaos,illidan,543,warrior,fury,14,7,7
57420,Surge,eredar,543,warrior,fury,16,6,10
57421,Loosypoosy,magtheridon,542,warrior,fury,11,6,5
57422,Sheluh,illidan,542,warrior,fury,17,6,11
57423,Thorkéll,proudmoore,541,warrior,fury,23,6,17
57424,Dionran,nemesis,533,warrior,fury,16,6,10
57425,Tatërs,zuljin,527,warrior,fury,11,6,5
57426,Sinbãd,sargeras,527,warrior,fury,11,6,5
57427,Agarto,illidan,526,warrior,fury,11,6,5
57428,Coffeebottom,wyrmrest-accord,526,warrior,fury,11,6,5
57429,Dhefinator,moknathal,512,warrior,fury,10,6,4
57430,Ángron,ragnaros,511,warrior,fury,11,6,5
57431,Noblêsix,dalaran,480,warrior,fury,6,5,1
57432,Onyx,auchindoun,480,warrior,fury,6,5,1
57433,Vennoe,proudmoore,480,warrior,fury,6,5,1
57434,Orkussw,illidan,480,warrior,fury,6,5,1
57435,Kiritarokila,area-52,480,warrior,fury,6,5,1
57436,Devaya,ragnaros,480,warrior,fury,6,5,1
57437,Àxcx,moon-guard,480,warrior,fury,6,5,1
57438,Soggynapkin,proudmoore,480,warrior,fury,6,5,1
57439,Çhloee,the-underbog,480,warrior,fury,6,5,1
57440,Sinjino,proudmoore,480,warrior,fury,6,5,1
57441,Smorc,stormrage,480,warrior,fury,6,5,1
57442,Kaitlanzhan,malganis,480,warrior,fury,6,5,1
57443,Swingretzky,zuljin,480,warrior,fury,6,5,1
57444,Tryhardr,sargeras,480,warrior,fury,6,5,1
57445,Thorado,nemesis,480,warrior,fury,6,5,1
57446,Dex,saurfang,480,warrior,fury,6,5,1
57447,Tazmanianfur,akama,480,warrior,fury,6,5,1
57448,Korsarro,frostmourne,480,warrior,fury,6,5,1
57449,Balrog,firetree,480,warrior,fury,6,5,1
57450,Theseuse,tichondrius,480,warrior,fury,6,5,1
57451,Falconheart,wyrmrest-accord,480,warrior,fury,6,5,1
57452,Didinosaur,azralon,480,warrior,fury,6,5,1
57453,Bromgarr,crushridge,480,warrior,fury,6,5,1
57454,Beleña,dalaran,480,warrior,fury,6,5,1
57455,Ramranch,dawnbringer,480,warrior,fury,8,5,3
57456,Victoriaöus,emerald-dream,480,warrior,fury,9,5,4
57457,Trekk,azralon,480,warrior,fury,12,5,7
57458,Testees,senjin,480,warrior,fury,12,5,7
57459,Warkaiser,ragnaros,480,warrior,fury,12,5,7
57460,Buhurt,sargeras,480,warrior,fury,12,5,7
57461,Marimadelene,aegwynn,480,warrior,fury,12,5,7
57462,Izhansheni,illidan,480,warrior,fury,12,5,7
57463,Angrystepdad,moon-guard,480,warrior,fury,12,5,7
57464,Zultråk,quelthalas,480,warrior,fury,12,5,7
57465,Cubanßûrst,stormrage,480,warrior,fury,12,5,7
57466,Arthurston,tichondrius,480,warrior,fury,12,5,7
57467,Kiingkratoz,ragnaros,480,warrior,fury,12,5,7
57468,Hexmaul,zuljin,480,warrior,fury,12,5,7
57469,Pneumasmash,tichondrius,480,warrior,fury,12,5,7
57470,Crímewave,zuljin,480,warrior,fury,12,5,7
57471,Resize,wyrmrest-accord,480,warrior,fury,12,5,7
57472,Zelglory,dalaran,480,warrior,fury,12,5,7
57473,Rowdyanders,area-52,480,warrior,fury,12,5,7
57474,Lilsweet,moon-guard,480,warrior,fury,12,5,7
57475,Dtherockj,kiljaeden,480,warrior,fury,12,5,7
57476,Slamuëladams,bleeding-hollow,480,warrior,fury,12,5,7
57477,Grantlol,illidan,480,warrior,fury,12,5,7
57478,Carnith,arthas,480,warrior,fury,12,5,7
57479,Dalinare,area-52,480,warrior,fury,12,5,7
57480,Maltrate,hyjal,480,warrior,fury,12,5,7
57481,Río,area-52,480,warrior,fury,12,5,7
57482,Oprampage,illidan,480,warrior,fury,12,5,7
57483,Teqniq,kelthuzad,480,warrior,fury,12,5,7
57484,Vvârriôr,barthilas,480,warrior,fury,12,5,7
57485,Momlover,area-52,480,warrior,fury,12,5,7
57486,Swollenbicep,tichondrius,480,warrior,fury,12,5,7
57487,Genesisxp,barthilas,480,warrior,fury,12,5,7
57488,Loktarmabras,dreadmaul,480,warrior,fury,12,5,7
57489,Sabers,mannoroth,480,warrior,fury,12,5,7
57490,Clansy,moon-guard,480,warrior,fury,12,5,7
57491,Bgwinnier,shuhalo,480,warrior,fury,12,5,7
57492,Pápý,ragnaros,480,warrior,fury,12,5,7
57493,Aladarith,moon-guard,480,warrior,fury,12,5,7
57494,Axesomebody,tichondrius,480,warrior,fury,12,5,7
57495,Còlòssal,moknathal,480,warrior,fury,12,5,7
57496,Klen,kelthuzad,480,warrior,fury,12,5,7
57497,Taurenosaur,illidan,480,warrior,fury,12,5,7
57498,Outo,stormrage,480,warrior,fury,12,5,7
57499,Pisini,illidan,480,warrior,fury,12,5,7
57500,Vallkÿria,goldrinn,480,warrior,fury,12,5,7
57501,Pingolona,nemesis,480,warrior,fury,12,5,7
57502,Chop,khadgar,480,warrior,fury,12,5,7
57503,Orcveinz,tichondrius,480,warrior,fury,17,7,10
57504,Caststeel,nordrassil,480,warrior,fury,15,6,9
57505,Zoowarr,illidan,480,warrior,fury,15,6,9
57506,Àndrewceo,illidan,480,warrior,fury,16,6,10
57507,Gadlfuerte,ragnaros,480,warrior,fury,14,5,9
57508,Georgedubya,illidan,480,warrior,fury,18,5,13
57509,Rampagejin,tichondrius,480,warrior,fury,18,5,13
57510,Thiccsauce,wyrmrest-accord,480,warrior,fury,18,5,13
57511,Saltyniples,aegwynn,480,warrior,fury,18,5,13
57512,Laloman,ragnaros,480,warrior,fury,18,5,13
57513,Spinspin,borean-tundra,480,warrior,fury,18,5,13
57514,Dragonrage,tanaris,480,warrior,fury,18,5,13
57515,Zulex,dathremar,480,warrior,fury,18,5,13
57516,Vonkinky,sargeras,479,warrior,fury,6,5,1
57517,Morshaz,drakkari,479,warrior,fury,6,5,1
57518,Zirtag,proudmoore,479,warrior,fury,6,5,1
57519,Buckets,chogall,479,warrior,fury,12,5,7
57520,Butterbutt,area-52,479,warrior,fury,12,5,7
57521,Guantid,sargeras,479,warrior,fury,12,5,7
57522,Morasar,area-52,479,warrior,fury,12,5,7
57523,Olegg,laughing-skull,479,warrior,fury,12,5,7
57524,Warsero,tichondrius,479,warrior,fury,12,5,7
57525,Liavana,jubeithos,479,warrior,fury,12,5,7
57526,Ksubîî,frostmourne,479,warrior,fury,12,5,7
57527,Vengxdor,stormrage,479,warrior,fury,12,5,7
57528,Gros,exodar,479,warrior,fury,12,5,7
57529,Yasser,ragnaros,479,warrior,fury,12,5,7
57530,Cômmander,ragnaros,479,warrior,fury,12,5,7
57531,Shoresy,korgath,479,warrior,fury,12,5,7
57532,Dorathorn,azralon,479,warrior,fury,18,5,13
57533,Supersquish,moon-guard,479,warrior,fury,18,5,13
57534,Màgs,moon-guard,479,warrior,fury,18,5,13
57535,Døøm,malganis,478,warrior,fury,12,5,7
57536,Beilian,quelthalas,478,warrior,fury,24,5,19
57537,Drovik,malygos,477,warrior,fury,18,5,13
57538,Dathrand,aerie-peak,476,warrior,fury,12,5,7
57539,Fabszord,nemesis,476,warrior,fury,12,5,7
57540,Faladoris,thrall,476,warrior,fury,12,5,7
57541,Leotonywar,tichondrius,476,warrior,fury,12,5,7
57542,Áryon,stormrage,474,warrior,fury,12,5,7
57543,Veganwarrior,quelthalas,469,warrior,fury,18,5,13
57544,Blazeowlglad,area-52,463,warrior,fury,17,5,12
57545,Erdnase,ragnaros,447,warrior,fury,11,5,6
57546,Rageverd,malganis,432,warrior,fury,9,5,4
57547,Chiffonade,kelthuzad,432,warrior,fury,11,6,5
57548,Kitiará,area-52,432,warrior,fury,15,6,9
57549,Thalloom,thaurissan,432,warrior,fury,15,5,10
57550,Avatarl,ragnaros,432,warrior,fury,15,5,10
57551,Hugz,thrall,431,warrior,fury,11,5,6
57552,Daydayfight,illidan,431,warrior,fury,11,5,6
57553,Sukstofuk,frostmourne,431,warrior,fury,11,5,6
57554,Glaros,blood-furnace,431,warrior,fury,11,5,6
57555,Stealheads,dalaran,431,warrior,fury,15,6,9
57556,Forerunner,tichondrius,416,warrior,fury,10,5,5
57557,Akêwñon,stormrage,416,warrior,fury,10,5,5
57558,Israelelel,azralon,416,warrior,fury,10,5,5
57559,Digitalblade,illidan,415,warrior,fury,14,5,9
57560,Husyuzhi,tichondrius,400,warrior,fury,7,5,2
57561,Janoski,chogall,384,warrior,fury,6,4,2
57562,Machutron,quelthalas,384,warrior,fury,6,4,2
57563,Painedd,stormrage,384,warrior,fury,6,4,2
57564,Pz,ravencrest,384,warrior,fury,6,4,2
57565,Brendan,llane,384,warrior,fury,6,4,2
57566,Scripper,stormrage,384,warrior,fury,6,4,2
57567,Tomatogodx,sargeras,384,warrior,fury,6,4,2
57568,Fornido,quelthalas,384,warrior,fury,6,4,2
57569,Hasbullá,ragnaros,384,warrior,fury,6,4,2
57570,Nunu,firetree,384,warrior,fury,6,4,2
57571,Vilgaxx,area-52,384,warrior,fury,6,4,2
57572,Axazel,drakkari,384,warrior,fury,6,4,2
57573,Sickwidit,kiljaeden,384,warrior,fury,6,4,2
57574,Smokes,sargeras,384,warrior,fury,6,4,2
57575,Tobaccocat,stormreaver,384,warrior,fury,6,4,2
57576,Amphyctionis,zuljin,384,warrior,fury,6,4,2
57577,Techanina,aerie-peak,384,warrior,fury,6,4,2
57578,Atuey,area-52,384,warrior,fury,6,4,2
57579,Mommystrasza,kelthuzad,384,warrior,fury,6,4,2
57580,Tazgar,draka,384,warrior,fury,6,4,2
57581,Mortalstrike,chogall,384,warrior,fury,6,4,2
57582,Inocencius,ragnaros,384,warrior,fury,6,4,2
57583,Bloodscream,magtheridon,384,warrior,fury,6,4,2
57584,Dualslong,malygos,384,warrior,fury,6,4,2
57585,Greeplol,arthas,384,warrior,fury,6,4,2
57586,Trashman,frostwolf,384,warrior,fury,6,4,2
57587,Antecubital,burning-blade,384,warrior,fury,6,4,2
57588,Thistou,quelthalas,384,warrior,fury,6,4,2
57589,Iwooglybool,icecrown,384,warrior,fury,6,4,2
57590,Ymirock,area-52,384,warrior,fury,6,4,2
57591,Cujø,tichondrius,384,warrior,fury,6,4,2
57592,Walterwhîte,tichondrius,384,warrior,fury,6,4,2
57593,Youdumbaut,tichondrius,384,warrior,fury,6,4,2
57594,Kamidaren,tichondrius,384,warrior,fury,6,4,2
57595,Superbest,tichondrius,384,warrior,fury,6,4,2
57596,Mcfatstuffs,boulderfist,384,warrior,fury,6,4,2
57597,Affeine,malganis,384,warrior,fury,6,4,2
57598,Sarachnis,area-52,384,warrior,fury,6,4,2
57599,Hêroìnê,tichondrius,384,warrior,fury,6,4,2
57600,Glowstick,tichondrius,384,warrior,fury,6,4,2
57601,Suzushi,tichondrius,384,warrior,fury,6,4,2
57602,Joshiguy,area-52,384,warrior,fury,6,4,2
57603,Xirexa,bleeding-hollow,384,warrior,fury,6,4,2
57604,Psyrush,area-52,384,warrior,fury,6,4,2
57605,Samuluo,tichondrius,384,warrior,fury,6,4,2
57606,Unpaused,kelthuzad,384,warrior,fury,6,4,2
57607,Willcharge,tichondrius,384,warrior,fury,6,4,2
57608,Carfal,spirestone,384,warrior,fury,6,4,2
57609,Gorgoz,area-52,384,warrior,fury,6,4,2
57610,Braxxinn,tichondrius,384,warrior,fury,6,4,2
57611,Murghol,malganis,384,warrior,fury,6,4,2
57612,Jàmiè,wyrmrest-accord,384,warrior,fury,6,4,2
57613,Iripuanewone,illidan,384,warrior,fury,6,4,2
57614,Biggwall,sargeras,384,warrior,fury,6,4,2
57615,Darkoil,illidan,384,warrior,fury,6,4,2
57616,Brogdar,moon-guard,384,warrior,fury,6,4,2
57617,Eor,greymane,384,warrior,fury,6,4,2
57618,Olaqwarraso,sargeras,384,warrior,fury,6,4,2
57619,Wolfdurotan,azralon,384,warrior,fury,6,4,2
57620,Skarkla,thrall,384,warrior,fury,6,4,2
57621,Varkiren,moon-guard,384,warrior,fury,6,4,2
57622,Qram,illidan,384,warrior,fury,6,4,2
57623,Laferrari,illidan,384,warrior,fury,6,4,2
57624,Sbplaywar,akama,384,warrior,fury,6,4,2
57625,Speakeassy,dalaran,384,warrior,fury,6,4,2
57626,Hamcan,dalaran,384,warrior,fury,6,4,2
57627,Daemòn,dalaran,384,warrior,fury,6,4,2
57628,Wooney,emerald-dream,384,warrior,fury,6,4,2
57629,Tjuanalpha,illidan,384,warrior,fury,6,4,2
57630,Bakadoom,illidan,384,warrior,fury,6,4,2
57631,Joebo,thrall,384,warrior,fury,6,4,2
57632,Vlaren,stormrage,384,warrior,fury,6,4,2
57633,Junaid,frostmourne,384,warrior,fury,6,4,2
57634,Xjpig,frostmourne,384,warrior,fury,6,4,2
57635,Vaughan,azuremyst,384,warrior,fury,6,4,2
57636,Ludakritz,moon-guard,384,warrior,fury,6,4,2
57637,Ricksanches,shadowmoon,384,warrior,fury,6,4,2
57638,Blackbaba,illidan,384,warrior,fury,6,4,2
57639,Breké,moon-guard,384,warrior,fury,6,4,2
57640,Danield,illidan,384,warrior,fury,11,4,7
57641,Negrus,sargeras,384,warrior,fury,11,4,7
57642,Beetcoyne,azuremyst,384,warrior,fury,12,4,8
57643,Avoraçado,nemesis,384,warrior,fury,12,4,8
57644,Pigblind,azralon,384,warrior,fury,12,4,8
57645,Goremack,hellscream,384,warrior,fury,12,4,8
57646,Metalhaed,thrall,384,warrior,fury,12,4,8
57647,Wanderlie,zangarmarsh,384,warrior,fury,12,4,8
57648,Goatmanee,tichondrius,384,warrior,fury,12,4,8
57649,Gallowes,elune,384,warrior,fury,12,4,8
57650,Shinshido,tichondrius,384,warrior,fury,12,4,8
57651,Gorm,greymane,384,warrior,fury,12,4,8
57652,Apollos,alleria,384,warrior,fury,12,4,8
57653,Drengarusk,area-52,384,warrior,fury,12,4,8
57654,Rezzett,wyrmrest-accord,384,warrior,fury,12,4,8
57655,Muradinpica,stormrage,384,warrior,fury,12,4,8
57656,Sakutarou,lightbringer,384,warrior,fury,12,4,8
57657,Hukzula,illidan,384,warrior,fury,12,4,8
57658,Nasrôth,korialstrasz,384,warrior,fury,12,4,8
57659,Truegit,illidan,384,warrior,fury,12,4,8
57660,Cýnz,frostmourne,384,warrior,fury,12,4,8
57661,Luosifen,tichondrius,384,warrior,fury,12,4,8
57662,Nobowar,tichondrius,384,warrior,fury,12,4,8
57663,Gravo,ragnaros,384,warrior,fury,12,4,8
57664,Syntra,area-52,384,warrior,fury,12,4,8
57665,Kanosukai,emerald-dream,384,warrior,fury,12,4,8
57666,Jhalakni,quelthalas,384,warrior,fury,12,4,8
57667,Aislistraee,moon-guard,384,warrior,fury,12,4,8
57668,Empriux,quelthalas,384,warrior,fury,12,4,8
57669,Bighamm,tichondrius,384,warrior,fury,12,4,8
57670,Kevinersaa,frostmourne,384,warrior,fury,12,4,8
57671,Dáïñ,sargeras,384,warrior,fury,12,4,8
57672,Agamere,stormrage,384,warrior,fury,12,4,8
57673,Sîn,sargeras,384,warrior,fury,12,4,8
57674,Appleleon,ragnaros,384,warrior,fury,12,4,8
57675,Skrot,stormrage,384,warrior,fury,12,4,8
57676,Corazondleón,ragnaros,384,warrior,fury,12,4,8
57677,Rägnarök,stormrage,384,warrior,fury,12,4,8
57678,Bladetko,tichondrius,384,warrior,fury,12,4,8
57679,Krodah,quelthalas,384,warrior,fury,12,4,8
57680,Worgasum,black-dragonflight,384,warrior,fury,12,4,8
57681,Seppukush,quelthalas,384,warrior,fury,18,4,14
57682,Lsays,tichondrius,384,warrior,fury,18,4,14
57683,Kuragdem,trollbane,384,warrior,fury,18,4,14
57684,Captnwrink,ysera,383,warrior,fury,6,4,2
57685,Galvar,frostmourne,383,warrior,fury,6,4,2
57686,Dalînar,quelthalas,383,warrior,fury,6,4,2
57687,Hæmomancy,moon-guard,383,warrior,fury,12,4,8
57688,Greggor,frostmourne,383,warrior,fury,12,4,8
57689,Rahmholz,bonechewer,383,warrior,fury,12,4,8
57690,Galadon,amanthul,383,warrior,fury,12,4,8
57691,Anger,zuljin,383,warrior,fury,24,4,20
57692,Ünö,proudmoore,382,warrior,fury,6,4,2
57693,Fangerbiter,destromath,382,warrior,fury,6,4,2
57694,Lámuérté,frostmourne,382,warrior,fury,6,4,2
57695,Buakaaw,gallywix,382,warrior,fury,6,4,2
57696,Solveighelga,drakkari,381,warrior,fury,12,4,8
57697,Glennyballs,dalaran,379,warrior,fury,12,4,8
57698,Baxel,arthas,367,warrior,fury,11,4,7
57699,Gotrekson,azralon,351,warrior,fury,11,4,7
57700,Pappin,malganis,351,warrior,fury,11,4,7
57701,Snowwsaint,sargeras,351,warrior,fury,11,4,7
57702,Koaltank,illidan,351,warrior,fury,14,5,9
57703,Weepingdeath,burning-legion,336,warrior,fury,15,4,11
57704,Darkrevel,dalvengyr,335,warrior,fury,11,4,7
57705,Boonn,frostmourne,330,warrior,fury,13,7,6
57706,Kíngkaisér,azralon,330,warrior,fury,15,6,9
57707,Huleo,tichondrius,330,warrior,fury,14,5,9
57708,Mataviejitos,ragnaros,329,warrior,fury,16,7,9
57709,Rohde,nemesis,319,warrior,fury,8,4,4
57710,Fancyboo,malganis,319,warrior,fury,8,4,4
57711,Wallzar,sargeras,304,warrior,fury,13,4,9
57712,Thaann,illidan,288,warrior,fury,6,3,3
57713,Goyqqw,illidan,288,warrior,fury,6,3,3
57714,Brøly,sargeras,288,warrior,fury,6,3,3
57715,Govosh,thrall,288,warrior,fury,6,3,3
57716,Chubw,tichondrius,288,warrior,fury,6,3,3
57717,Cocó,sargeras,288,warrior,fury,6,3,3
57718,Taywar,sargeras,288,warrior,fury,6,3,3
57719,Heavydoody,moon-guard,288,warrior,fury,6,3,3
57720,Kreamyumyums,tichondrius,288,warrior,fury,6,3,3
57721,Warriorbrain,wyrmrest-accord,288,warrior,fury,6,3,3
57722,Durres,tichondrius,288,warrior,fury,6,3,3
57723,Xragnar,area-52,288,warrior,fury,6,3,3
57724,Grimlòck,area-52,288,warrior,fury,6,3,3
57725,Ruffless,skullcrusher,288,warrior,fury,6,3,3
57726,Madblackcat,illidan,288,warrior,fury,6,3,3
57727,Zerrekarr,wyrmrest-accord,288,warrior,fury,6,3,3
57728,Raygé,malygos,288,warrior,fury,6,3,3
57729,Guillotinè,area-52,288,warrior,fury,6,3,3
57730,Wolfsbanne,khadgar,288,warrior,fury,6,3,3
57731,Akrian,hellscream,288,warrior,fury,6,3,3
57732,Júmmy,area-52,288,warrior,fury,6,3,3
57733,Scylall,area-52,288,warrior,fury,6,3,3
57734,Çhocothunder,area-52,288,warrior,fury,6,3,3
57735,Decimateme,tichondrius,288,warrior,fury,6,3,3
57736,Cassetto,icecrown,288,warrior,fury,6,3,3
57737,Jethrix,kelthuzad,288,warrior,fury,6,3,3
57738,Tobyrendrson,area-52,288,warrior,fury,6,3,3
57739,Skynitez,area-52,288,warrior,fury,6,3,3
57740,Corvesio,wyrmrest-accord,288,warrior,fury,6,3,3
57741,Zugsok,thrall,288,warrior,fury,6,3,3
57742,Kahn,andorhal,288,warrior,fury,6,3,3
57743,Swíshersweét,kelthuzad,288,warrior,fury,6,3,3
57744,Durist,tichondrius,288,warrior,fury,6,3,3
57745,Aùstin,moon-guard,288,warrior,fury,6,3,3
57746,Morelz,stormrage,288,warrior,fury,6,3,3
57747,Kàli,kiljaeden,288,warrior,fury,6,3,3
57748,Executie,duskwood,288,warrior,fury,6,3,3
57749,Bloodthornx,quelthalas,288,warrior,fury,6,3,3
57750,Kazek,sargeras,288,warrior,fury,6,3,3
57751,Strongboii,tichondrius,288,warrior,fury,6,3,3
57752,Goywarr,illidan,288,warrior,fury,6,3,3
57753,Vodak,daggerspine,288,warrior,fury,6,3,3
57754,Hijjiup,ysera,288,warrior,fury,6,3,3
57755,Nukeworker,durotan,288,warrior,fury,6,3,3
57756,Shadalloo,azralon,288,warrior,fury,6,3,3
57757,Zemi,sargeras,288,warrior,fury,6,3,3
57758,Brôm,emerald-dream,288,warrior,fury,6,3,3
57759,Swiftÿ,gurubashi,288,warrior,fury,6,3,3
57760,Warmaghar,azralon,288,warrior,fury,6,3,3
57761,Tenfury,proudmoore,288,warrior,fury,6,3,3
57762,Seymourbot,illidan,288,warrior,fury,6,3,3
57763,Tâlos,ysondre,288,warrior,fury,6,3,3
57764,Tâlos,magtheridon,288,warrior,fury,6,3,3
57765,Santhvel,jubeithos,288,warrior,fury,6,3,3
57766,Corgii,khaz-modan,288,warrior,fury,6,3,3
57767,Aruia,proudmoore,288,warrior,fury,6,3,3
57768,Warbringerr,hydraxis,288,warrior,fury,6,3,3
57769,Kamigoroshi,crushridge,288,warrior,fury,6,3,3
57770,Satedqq,illidan,288,warrior,fury,6,3,3
57771,Cronrow,thunderlord,288,warrior,fury,6,3,3
57772,Miyamashi,stormrage,288,warrior,fury,6,3,3
57773,Deepsplitter,illidan,288,warrior,fury,6,3,3
57774,Hithen,quelthalas,288,warrior,fury,6,3,3
57775,Abuse,nordrassil,288,warrior,fury,6,3,3
57776,Mildsauce,illidan,288,warrior,fury,6,3,3
57777,Glexecute,sargeras,288,warrior,fury,6,3,3
57778,Smxrf,hyjal,288,warrior,fury,6,3,3
57779,Mcdowëll,moon-guard,288,warrior,fury,6,3,3
57780,Barbarìan,bleeding-hollow,288,warrior,fury,6,3,3
57781,Milkmebby,bleeding-hollow,288,warrior,fury,6,3,3
57782,Victoria,malganis,288,warrior,fury,6,3,3
57783,Ciz,emerald-dream,288,warrior,fury,6,3,3
57784,Dunkmate,malganis,288,warrior,fury,6,3,3
57785,Uncritable,dalaran,288,warrior,fury,6,3,3
57786,Nginx,queldorei,288,warrior,fury,6,3,3
57787,Dirtypin,shadowmoon,288,warrior,fury,6,3,3
57788,Oven,tichondrius,288,warrior,fury,6,3,3
57789,Protstitute,hyjal,288,warrior,fury,6,3,3
57790,Rí,moon-guard,288,warrior,fury,6,3,3
57791,Griimhoof,malganis,288,warrior,fury,6,3,3
57792,Peterheater,emerald-dream,288,warrior,fury,6,3,3
57793,Egoist,malganis,288,warrior,fury,6,3,3
57794,Thegoodson,zuljin,288,warrior,fury,6,3,3
57795,Kénblock,tichondrius,288,warrior,fury,6,3,3
57796,Kimed,nordrassil,288,warrior,fury,6,3,3
57797,Säbeër,ragnaros,288,warrior,fury,6,3,3
57798,Anticiðe,zuljin,288,warrior,fury,6,3,3
57799,Scran,sargeras,288,warrior,fury,6,3,3
57800,Joarmyman,proudmoore,288,warrior,fury,6,3,3
57801,Lechee,silvermoon,288,warrior,fury,6,3,3
57802,Benw,dawnbringer,288,warrior,fury,6,3,3
57803,Wargasms,alterac-mountains,288,warrior,fury,6,3,3
57804,Razzik,emerald-dream,288,warrior,fury,6,3,3
57805,Fury,frostmourne,288,warrior,fury,6,3,3
57806,Tsathoggua,kiljaeden,288,warrior,fury,6,3,3
57807,Painfulsin,tichondrius,288,warrior,fury,6,3,3
57808,Gongos,doomhammer,288,warrior,fury,6,3,3
57809,Galachad,jubeithos,288,warrior,fury,6,3,3
57810,Verydanger,emerald-dream,288,warrior,fury,6,3,3
57811,Beârz,the-underbog,288,warrior,fury,6,3,3
57812,Gläedr,dalaran,288,warrior,fury,6,3,3
57813,Wescer,frostmourne,288,warrior,fury,6,3,3
57814,Orcly,kilrogg,288,warrior,fury,6,3,3
57815,Peeb,tichondrius,288,warrior,fury,6,3,3
57816,Slãmpiece,stormrage,288,warrior,fury,6,3,3
57817,Carborr,frostmourne,288,warrior,fury,6,3,3
57818,Wwesheamus,frostmourne,288,warrior,fury,6,3,3
57819,Slitt,azralon,288,warrior,fury,6,3,3
57820,Instakill,garrosh,288,warrior,fury,6,3,3
57821,Mubun,tichondrius,288,warrior,fury,6,3,3
57822,Smashr,tichondrius,288,warrior,fury,6,3,3
57823,Wisslogia,ragnaros,288,warrior,fury,6,3,3
57824,Herkja,barthilas,288,warrior,fury,6,3,3
57825,Zangre,stormrage,288,warrior,fury,6,3,3
57826,Elix,stormscale,288,warrior,fury,6,3,3
57827,Makeranbing,barthilas,288,warrior,fury,6,3,3
57828,Bigdickgomez,frostmourne,288,warrior,fury,6,3,3
57829,Chapublin,ragnaros,288,warrior,fury,6,3,3
57830,Demøletiøn,stormrage,288,warrior,fury,6,3,3
57831,Malystik,ragnaros,288,warrior,fury,6,3,3
57832,Colössal,moon-guard,288,warrior,fury,6,3,3
57833,Pongk,tichondrius,288,warrior,fury,6,3,3
57834,Kurowar,drakkari,288,warrior,fury,6,3,3
57835,Unng,emerald-dream,288,warrior,fury,6,3,3
57836,Daddyd,sargeras,288,warrior,fury,6,3,3
57837,Bruzerk,ragnaros,288,warrior,fury,6,3,3
57838,Lightswords,stormrage,288,warrior,fury,6,3,3
57839,Caynos,stormrage,288,warrior,fury,6,3,3
57840,Harthan,stormscale,288,warrior,fury,6,3,3
57841,Aeros,winterhoof,288,warrior,fury,6,3,3
57842,Sejunz,ragnaros,288,warrior,fury,6,3,3
57843,Terazova,tichondrius,288,warrior,fury,6,3,3
57844,Rogorof,azralon,288,warrior,fury,6,3,3
57845,Nikey,tichondrius,288,warrior,fury,6,3,3
57846,Stellabear,aggramar,288,warrior,fury,6,3,3
57847,Martrek,amanthul,288,warrior,fury,6,3,3
57848,Crowsfall,aggramar,288,warrior,fury,6,3,3
57849,Twilightrain,tichondrius,288,warrior,fury,6,3,3
57850,Korland,aerie-peak,288,warrior,fury,6,3,3
57851,Bled,quelthalas,288,warrior,fury,10,4,6
57852,Loadmaster,dragonmaw,288,warrior,fury,8,3,5
57853,Duudoo,stormrage,288,warrior,fury,8,3,5
57854,Cøpperpøt,bleeding-hollow,288,warrior,fury,9,3,6
57855,Urion,illidan,288,warrior,fury,11,3,8
57856,Warseed,ragnaros,288,warrior,fury,12,3,9
57857,Krilles,tichondrius,288,warrior,fury,12,3,9
57858,Davien,tichondrius,288,warrior,fury,12,3,9
57859,Kromgrall,tichondrius,288,warrior,fury,12,3,9
57860,Rageroidz,area-52,288,warrior,fury,12,3,9
57861,Bladeweaver,illidan,288,warrior,fury,12,3,9
57862,Rólex,tichondrius,288,warrior,fury,12,3,9
57863,Shínkicker,area-52,288,warrior,fury,12,3,9
57864,Gristly,sargeras,288,warrior,fury,12,3,9
57865,Stromkiller,stormrage,288,warrior,fury,12,3,9
57866,Pastorpeen,thrall,288,warrior,fury,12,3,9
57867,Barcëlð,frostmourne,288,warrior,fury,12,3,9
57868,Tríxman,moon-guard,288,warrior,fury,12,3,9
57869,Kimuraa,hyjal,288,warrior,fury,12,3,9
57870,Ratface,frostmourne,288,warrior,fury,12,3,9
57871,Flexìn,tichondrius,288,warrior,fury,12,3,9
57872,Zelekron,emerald-dream,288,warrior,fury,12,3,9
57873,Krimmjðw,sargeras,288,warrior,fury,12,3,9
57874,Leonz,undermine,288,warrior,fury,12,3,9
57875,Blackscale,grizzly-hills,288,warrior,fury,12,3,9
57876,Andro,arthas,288,warrior,fury,12,3,9
57877,Banggo,frostmourne,288,warrior,fury,12,3,9
57878,Monkeybrain,azralon,288,warrior,fury,12,3,9
57879,Lynn,zangarmarsh,288,warrior,fury,12,3,9
57880,Serrabella,illidan,288,warrior,fury,12,3,9
57881,Apolio,magtheridon,288,warrior,fury,12,3,9
57882,Jujuassgeter,darkspear,288,warrior,fury,18,3,15
57883,Norru,moon-guard,288,warrior,fury,18,3,15
57884,Halobender,emerald-dream,287,warrior,fury,6,3,3
57885,Disclone,tichondrius,287,warrior,fury,6,3,3
57886,Eadsmasher,jubeithos,287,warrior,fury,6,3,3
57887,Monsterpepe,tichondrius,287,warrior,fury,12,3,9
57888,Daymancometh,proudmoore,271,warrior,fury,11,3,8
57889,Zolpidem,nemesis,255,warrior,fury,11,3,8
57890,Bigdaddyzees,bleeding-hollow,255,warrior,fury,11,3,8
57891,Asteríon,sargeras,239,warrior,fury,5,3,2
57892,Chupelo,tichondrius,239,warrior,fury,5,3,2
57893,Ramaraparoo,proudmoore,239,warrior,fury,5,3,2
57894,Gwod,stormrage,239,warrior,fury,5,3,2
57895,Reagzy,stormrage,234,warrior,fury,10,4,6
57896,Schlosh,laughing-skull,223,warrior,fury,8,3,5
57897,Heirel,kelthuzad,208,warrior,fury,7,3,4
57898,Çórý,area-52,192,warrior,fury,4,3,1
57899,Datneck,tichondrius,192,warrior,fury,4,3,1
57900,Gavtini,drakthul,192,warrior,fury,4,3,1
57901,Naekochee,moon-guard,192,warrior,fury,4,3,1
57902,Amaragos,tichondrius,192,warrior,fury,6,4,2
57903,Kushal,sargeras,192,warrior,fury,8,3,5
57904,Drefnor,thunderhorn,192,warrior,fury,9,3,6
57905,Mimiu,ragnaros,192,warrior,fury,6,2,4
57906,Matahorda,darkspear,192,warrior,fury,6,2,4
57907,Aqee,illidan,192,warrior,fury,6,2,4
57908,Andrexion,moon-guard,192,warrior,fury,6,2,4
57909,Iïl,area-52,192,warrior,fury,6,2,4
57910,Melithiae,barthilas,192,warrior,fury,6,2,4
57911,Kachigas,sargeras,192,warrior,fury,6,2,4
57912,Ghostkin,ragnaros,192,warrior,fury,6,2,4
57913,Bachyr,stormrage,192,warrior,fury,6,2,4
57914,Horahloux,ragnaros,192,warrior,fury,6,2,4
57915,Fofefa,ragnaros,192,warrior,fury,6,2,4
57916,Weewarrior,wyrmrest-accord,192,warrior,fury,6,2,4
57917,Ðöminátè,kiljaeden,192,warrior,fury,6,2,4
57918,Erikx,ragnaros,192,warrior,fury,6,2,4
57919,Yeèzy,stormrage,192,warrior,fury,6,2,4
57920,Redrunebar,illidan,192,warrior,fury,6,2,4
57921,Arakod,moon-guard,192,warrior,fury,6,2,4
57922,Hatedßyßlízz,area-52,192,warrior,fury,6,2,4
57923,Franc,kiljaeden,192,warrior,fury,6,2,4
57924,Mussashí,stormrage,192,warrior,fury,6,2,4
57925,Reishera,stormrage,192,warrior,fury,6,2,4
57926,Elchacál,ragnaros,192,warrior,fury,6,2,4
57927,Tepaste,ragnaros,192,warrior,fury,6,2,4
57928,Záshá,ragnaros,192,warrior,fury,6,2,4
57929,Saltyareolas,destromath,192,warrior,fury,6,2,4
57930,Youdiankua,illidan,192,warrior,fury,6,2,4
57931,Rexxunos,ragnaros,192,warrior,fury,6,2,4
57932,Jeyvil,stormrage,192,warrior,fury,6,2,4
57933,Borealiss,ragnaros,192,warrior,fury,6,2,4
57934,Gistid,frostmourne,192,warrior,fury,6,2,4
57935,Beatmeat,frostmourne,192,warrior,fury,6,2,4
57936,Bernardes,stormrage,192,warrior,fury,6,2,4
57937,Koast,aerie-peak,192,warrior,fury,6,2,4
57938,Jäëgër,moon-guard,192,warrior,fury,6,2,4
57939,Azrailz,stormrage,192,warrior,fury,6,2,4
57940,Arx,frostwolf,192,warrior,fury,6,2,4
57941,Elyoy,aerie-peak,192,warrior,fury,6,2,4
57942,Jägernaught,stormrage,192,warrior,fury,6,2,4
57943,Disheartened,wyrmrest-accord,192,warrior,fury,6,2,4
57944,Bobbylee,ravencrest,192,warrior,fury,6,2,4
57945,Ëxecute,darkspear,192,warrior,fury,6,2,4
57946,Blademaw,stormreaver,192,warrior,fury,6,2,4
57947,Shablamm,korgath,192,warrior,fury,6,2,4
57948,Itzyourmom,nazjatar,192,warrior,fury,6,2,4
57949,Kalabawph,area-52,192,warrior,fury,6,2,4
57950,Fetalalcohol,illidan,192,warrior,fury,6,2,4
57951,Uju,lothar,192,warrior,fury,6,2,4
57952,Backtrack,whisperwind,192,warrior,fury,6,2,4
57953,Unterg,ragnaros,192,warrior,fury,6,2,4
57954,Verigislena,moon-guard,192,warrior,fury,6,2,4
57955,Ultraa,lightbringer,192,warrior,fury,6,2,4
57956,ßoris,grizzly-hills,192,warrior,fury,6,2,4
57957,Garagedays,area-52,192,warrior,fury,6,2,4
57958,Tarkvs,ragnaros,192,warrior,fury,6,2,4
57959,Containerbox,korgath,192,warrior,fury,6,2,4
57960,Iapologiz,illidan,192,warrior,fury,6,2,4
57961,Kaniks,dalaran,192,warrior,fury,6,2,4
57962,Wendër,area-52,192,warrior,fury,6,2,4
57963,Cartmain,illidan,192,warrior,fury,6,2,4
57964,Gotcrit,blood-furnace,192,warrior,fury,6,2,4
57965,Jayynorthyy,malganis,192,warrior,fury,6,2,4
57966,Drugdilla,zuljin,192,warrior,fury,6,2,4
57967,Boombop,zuljin,192,warrior,fury,6,2,4
57968,Rundai,zuljin,192,warrior,fury,6,2,4
57969,Prodgio,nemesis,192,warrior,fury,6,2,4
57970,Tappyz,area-52,192,warrior,fury,6,2,4
57971,Kraven,haomarush,192,warrior,fury,6,2,4
57972,Drenzywar,scilla,192,warrior,fury,6,2,4
57973,Torimzor,nemesis,192,warrior,fury,6,2,4
57974,Monstersynde,nemesis,192,warrior,fury,6,2,4
57975,Helder,destromath,192,warrior,fury,6,2,4
57976,Warkahoz,drakkari,192,warrior,fury,6,2,4
57977,Gladicus,zuljin,192,warrior,fury,6,2,4
57978,Tÿ,haomarush,192,warrior,fury,6,2,4
57979,Släughter,zuljin,192,warrior,fury,6,2,4
57980,Sveenn,area-52,192,warrior,fury,6,2,4
57981,Moosoka,malorne,192,warrior,fury,6,2,4
57982,Brewstrike,dalaran,192,warrior,fury,6,2,4
57983,Karukaj,azshara,192,warrior,fury,6,2,4
57984,Threg,malganis,192,warrior,fury,6,2,4
57985,Good,garona,192,warrior,fury,6,2,4
57986,Zarkró,quelthalas,192,warrior,fury,6,2,4
57987,Thrawb,bleeding-hollow,192,warrior,fury,6,2,4
57988,Lôwkeyfix,illidan,192,warrior,fury,6,2,4
57989,Zeroy,bleeding-hollow,192,warrior,fury,6,2,4
57990,Aisinbro,illidan,192,warrior,fury,6,2,4
57991,Warmul,bleeding-hollow,192,warrior,fury,6,2,4
57992,Druckerz,lightnings-blade,192,warrior,fury,6,2,4
57993,Lepzed,area-52,192,warrior,fury,6,2,4
57994,Dragmös,nemesis,192,warrior,fury,6,2,4
57995,Ragetide,illidan,192,warrior,fury,6,2,4
57996,Vaclein,quelthalas,192,warrior,fury,6,2,4
57997,Lubri,azralon,192,warrior,fury,6,2,4
57998,Painstake,illidan,192,warrior,fury,6,2,4
57999,Jéshka,wyrmrest-accord,192,warrior,fury,6,2,4
58000,Zareos,azralon,192,warrior,fury,6,2,4
58001,Peekyblinder,kiljaeden,192,warrior,fury,6,2,4
58002,Twoironfist,azralon,192,warrior,fury,6,2,4
58003,Mekkanic,moon-guard,192,warrior,fury,6,2,4
58004,Valko,ragnaros,192,warrior,fury,6,2,4
58005,Aboveaverage,arthas,192,warrior,fury,6,2,4
58006,Nebraskapete,wyrmrest-accord,192,warrior,fury,6,2,4
58007,Jowesley,azralon,192,warrior,fury,6,2,4
58008,Dagorine,eredar,192,warrior,fury,6,2,4
58009,Ragëqt,windrunner,192,warrior,fury,6,2,4
58010,Gangelx,illidan,192,warrior,fury,6,2,4
58011,Veyronn,stormrage,192,warrior,fury,6,2,4
58012,Halò,thrall,192,warrior,fury,6,2,4
58013,Lokgur,gallywix,192,warrior,fury,6,2,4
58014,Taurwaz,draka,192,warrior,fury,6,2,4
58015,Rahu,thrall,192,warrior,fury,6,2,4
58016,Gakatarc,thrall,192,warrior,fury,6,2,4
58017,Killaen,thrall,192,warrior,fury,6,2,4
58018,Catdestroyer,kelthuzad,192,warrior,fury,6,2,4
58019,Tickletickle,illidan,192,warrior,fury,6,2,4
58020,Deizhul,stormscale,192,warrior,fury,6,2,4
58021,Nsanesavage,kelthuzad,192,warrior,fury,6,2,4
58022,Risingson,argent-dawn,192,warrior,fury,6,2,4
58023,Agram,alleria,192,warrior,fury,6,2,4
58024,Youdeadx,aegwynn,192,warrior,fury,6,2,4
58025,Birddogs,scarlet-crusade,192,warrior,fury,6,2,4
58026,Amberlym,ragnaros,192,warrior,fury,6,2,4
58027,Telynne,frostmourne,192,warrior,fury,6,2,4
58028,Casteleiro,azralon,192,warrior,fury,6,2,4
58029,Oledcktwist,garrosh,192,warrior,fury,6,2,4
58030,Ludøciel,moon-guard,192,warrior,fury,6,2,4
58031,Furyworgen,kiljaeden,192,warrior,fury,6,2,4
58032,Wölf,azralon,192,warrior,fury,6,2,4
58033,Kforti,kiljaeden,192,warrior,fury,6,2,4
58034,Eîghtysîx,sargeras,192,warrior,fury,6,2,4
58035,Hackbbadda,tichondrius,192,warrior,fury,6,2,4
58036,Tigershárk,tichondrius,192,warrior,fury,6,2,4
58037,Mafe,tichondrius,192,warrior,fury,6,2,4
58038,Twilightzza,sargeras,192,warrior,fury,6,2,4
58039,Stugwar,moon-guard,192,warrior,fury,6,2,4
58040,Neifle,tichondrius,192,warrior,fury,6,2,4
58041,Kokixz,tichondrius,192,warrior,fury,6,2,4
58042,Lopotron,sargeras,192,warrior,fury,6,2,4
58043,Clerond,tichondrius,192,warrior,fury,6,2,4
58044,Estrasystole,sargeras,192,warrior,fury,6,2,4
58045,Browngusher,sargeras,192,warrior,fury,6,2,4
58046,Mortaldznuts,tichondrius,192,warrior,fury,6,2,4
58047,Yermalt,tichondrius,192,warrior,fury,6,2,4
58048,Persiancoco,tichondrius,192,warrior,fury,6,2,4
58049,Linios,tichondrius,192,warrior,fury,6,2,4
58050,Sickwar,emerald-dream,192,warrior,fury,6,2,4
58051,Bobisyourmom,tichondrius,192,warrior,fury,6,2,4
58052,Deafwarrior,sargeras,192,warrior,fury,6,2,4
58053,Creepedz,tichondrius,192,warrior,fury,6,2,4
58054,Wqnmlgbd,tichondrius,192,warrior,fury,6,2,4
58055,Warney,tichondrius,192,warrior,fury,6,2,4
58056,Wooters,tichondrius,192,warrior,fury,6,2,4
58057,Bariotyr,the-underbog,192,warrior,fury,6,2,4
58058,Supersteak,tichondrius,192,warrior,fury,6,2,4
58059,Slamspam,the-underbog,192,warrior,fury,6,2,4
58060,Ballbusting,moon-guard,192,warrior,fury,6,2,4
58061,Oohdang,tichondrius,192,warrior,fury,6,2,4
58062,Wariorwang,tichondrius,192,warrior,fury,6,2,4
58063,Onlyslams,sargeras,192,warrior,fury,6,2,4
58064,Jkasdfglkg,tichondrius,192,warrior,fury,6,2,4
58065,Irongiant,blades-edge,192,warrior,fury,6,2,4
58066,Noor,tichondrius,192,warrior,fury,6,2,4
58067,Thevan,dunemaul,192,warrior,fury,6,2,4
58068,Sustantus,emerald-dream,192,warrior,fury,6,2,4
58069,Xorjak,tichondrius,192,warrior,fury,6,2,4
58070,Estrozo,sargeras,192,warrior,fury,6,2,4
58071,Zdokk,sargeras,192,warrior,fury,6,2,4
58072,Shrexecute,tichondrius,192,warrior,fury,6,2,4
58073,Brosèph,sargeras,192,warrior,fury,6,2,4
58074,Illicitiri,sargeras,192,warrior,fury,6,2,4
58075,Swinkyzug,tichondrius,192,warrior,fury,6,2,4
58076,Bigbadaxe,sargeras,192,warrior,fury,6,2,4
58077,Mahievs,area-52,192,warrior,fury,10,3,7
58078,Rayson,saurfang,192,warrior,fury,10,2,8
58079,Bonesheild,ursin,192,warrior,fury,11,2,9
58080,Typenine,proudmoore,192,warrior,fury,12,2,10
58081,Pressd,frostmourne,192,warrior,fury,12,2,10
58082,Shandrar,frostmourne,192,warrior,fury,12,2,10
58083,Osselan,moon-guard,192,warrior,fury,12,2,10
58084,Queterompo,ragnaros,192,warrior,fury,12,2,10
58085,Destrogore,darkspear,192,warrior,fury,12,2,10
58086,Doappy,darkspear,192,warrior,fury,12,2,10
58087,Brummbär,thrall,192,warrior,fury,12,2,10
58088,Thecolor,tichondrius,192,warrior,fury,12,2,10
58089,Alchremo,dalaran,192,warrior,fury,12,2,10
58090,Gymnopolar,barthilas,192,warrior,fury,12,2,10
58091,Mickyplate,tichondrius,192,warrior,fury,12,2,10
58092,Nirvyn,quelthalas,191,warrior,fury,6,2,4
58093,Werrewolf,kul-tiras,191,warrior,fury,6,2,4
58094,Naabii,moon-guard,191,warrior,fury,6,2,4
58095,Wayne,kargath,160,warrior,fury,16,2,14
58096,Mariò,area-52,159,warrior,fury,5,2,3
58097,Orangerzze,hyjal,145,warrior,fury,32,9,23
58098,Finana,illidan,138,warrior,fury,10,4,6
58099,Dräxxär,sargeras,138,warrior,fury,10,3,7
58100,Eldarad,stormrage,128,warrior,fury,4,2,2
58101,Swifty,tichondrius,128,warrior,fury,4,2,2
58102,Fatbarstard,jubeithos,128,warrior,fury,4,2,2
58103,Chadrich,kilrogg,128,warrior,fury,4,2,2
58104,Cowmilk,llane,127,warrior,fury,8,2,6
58105,Bootskrapp,azgalor,112,warrior,fury,7,2,5
58106,Bradockqt,azralon,96,warrior,fury,3,2,1
58107,Nëcrophagist,wyrmrest-accord,96,warrior,fury,3,2,1
58108,Zuzi,korgath,96,warrior,fury,3,2,1
58109,Srze,azralon,96,warrior,fury,6,1,5
58110,Vvengencezz,the-underbog,96,warrior,fury,6,1,5
58111,Mafia,dalaran,96,warrior,fury,6,1,5
58112,Loveføx,stormrage,96,warrior,fury,6,1,5
58113,Arkayla,moon-guard,96,warrior,fury,6,1,5
58114,Chóps,quelthalas,96,warrior,fury,6,1,5
58115,Nerdturd,mannoroth,96,warrior,fury,6,1,5
58116,Radianteyes,quelthalas,96,warrior,fury,6,1,5
58117,Murrdock,nesingwary,96,warrior,fury,6,1,5
58118,Polox,ragnaros,96,warrior,fury,6,1,5
58119,Warritha,ragnaros,96,warrior,fury,6,1,5
58120,Bbyè,tichondrius,96,warrior,fury,6,1,5
58121,Lawlstørm,stormrage,96,warrior,fury,6,1,5
58122,Girthyslaps,frostmourne,96,warrior,fury,6,1,5
58123,Neotico,quelthalas,96,warrior,fury,6,1,5
58124,Schwicker,stormrage,96,warrior,fury,6,1,5
58125,Tamagoshi,kiljaeden,96,warrior,fury,6,1,5
58126,Magarrior,shadowsong,96,warrior,fury,6,1,5
58127,Woponese,veknilash,96,warrior,fury,6,1,5
58128,Bigk,korgath,96,warrior,fury,6,1,5
58129,Fatdiabetic,tichondrius,96,warrior,fury,6,1,5
58130,Ravenxdawnx,tichondrius,96,warrior,fury,6,1,5
58131,Alitalia,thunderlord,96,warrior,fury,6,1,5
58132,Warrbull,spirestone,96,warrior,fury,6,1,5
58133,Lanlorash,barthilas,96,warrior,fury,6,1,5
58134,Quasi,tichondrius,96,warrior,fury,6,1,5
58135,Spartacam,frostmourne,96,warrior,fury,6,1,5
58136,Dabdaddyy,dawnbringer,96,warrior,fury,6,1,5
58137,Xiaohuzi,tichondrius,96,warrior,fury,6,1,5
58138,Igmif,stormrage,96,warrior,fury,6,1,5
58139,Slayabunny,icecrown,96,warrior,fury,6,1,5
58140,Xut,moon-guard,96,warrior,fury,6,1,5
58141,Xehm,tichondrius,96,warrior,fury,6,1,5
58142,Smashkuntz,lightnings-blade,96,warrior,fury,6,1,5
58143,Beray,skullcrusher,96,warrior,fury,6,1,5
58144,Flabergaster,skullcrusher,96,warrior,fury,6,1,5
58145,Lambsy,zuljin,96,warrior,fury,6,1,5
58146,Play,dark-iron,96,warrior,fury,6,1,5
58147,Trollchopo,kiljaeden,96,warrior,fury,6,1,5
58148,Freesubs,sargeras,96,warrior,fury,6,1,5
58149,Kraevok,feathermoon,96,warrior,fury,6,1,5
58150,Augutra,moon-guard,96,warrior,fury,6,1,5
58151,Warrdawg,tichondrius,96,warrior,fury,6,1,5
58152,Pornawar,area-52,96,warrior,fury,6,1,5
58153,Carnagè,area-52,96,warrior,fury,6,1,5
58154,ßlåde,lethon,96,warrior,fury,6,1,5
58155,Grândmâ,zuljin,96,warrior,fury,6,1,5
58156,Rades,sargeras,96,warrior,fury,6,1,5
58157,Nillor,emerald-dream,96,warrior,fury,6,1,5
58158,Dokoba,bleeding-hollow,96,warrior,fury,6,1,5
58159,ßallinjr,illidan,96,warrior,fury,6,1,5
58160,Powerhard,area-52,96,warrior,fury,6,1,5
58161,Ridemepapi,tichondrius,96,warrior,fury,6,1,5
58162,Rexxous,hyjal,96,warrior,fury,6,1,5
58163,Slimeto,area-52,96,warrior,fury,6,1,5
58164,Jazzkiler,azralon,96,warrior,fury,6,1,5
58165,Katsarola,cenarion-circle,96,warrior,fury,6,1,5
58166,Omnislash,proudmoore,96,warrior,fury,6,1,5
58167,Hypëriøn,bleeding-hollow,96,warrior,fury,6,1,5
58168,Freanor,azralon,96,warrior,fury,6,1,5
58169,Soulmerc,turalyon,96,warrior,fury,6,1,5
58170,Fûry,barthilas,96,warrior,fury,6,1,5
58171,Bumrushed,tichondrius,96,warrior,fury,6,1,5
58172,Ezsmash,firetree,96,warrior,fury,6,1,5
58173,Awex,kelthuzad,96,warrior,fury,6,1,5
58174,Ustadbaba,area-52,96,warrior,fury,6,1,5
58175,Broxar,area-52,96,warrior,fury,6,1,5
58176,Keirina,bonechewer,96,warrior,fury,6,1,5
58177,Kaikah,aegwynn,96,warrior,fury,6,1,5
58178,Borahgis,area-52,96,warrior,fury,6,1,5
58179,Handain,malganis,96,warrior,fury,6,1,5
58180,Jotar,goldrinn,96,warrior,fury,6,1,5
58181,Bigwarrior,stonemaul,96,warrior,fury,6,1,5
58182,Cuttin,sargeras,96,warrior,fury,6,1,5
58183,Trén,hydraxis,96,warrior,fury,6,1,5
58184,Draann,kirin-tor,96,warrior,fury,6,1,5
58185,Wapistun,thrall,96,warrior,fury,6,1,5
58186,Aiforix,gorefiend,96,warrior,fury,6,1,5
58187,Lifaen,zangarmarsh,96,warrior,fury,6,1,5
58188,Pcprincipal,khadgar,96,warrior,fury,6,1,5
58189,Aftershóck,daggerspine,96,warrior,fury,6,1,5
58190,Tarviss,exodar,96,warrior,fury,6,1,5
58191,Harattawi,thrall,96,warrior,fury,6,1,5
58192,Horabad,terenas,96,warrior,fury,6,1,5
58193,Warriortimes,ragnaros,96,warrior,fury,6,1,5
58194,Figork,tichondrius,96,warrior,fury,6,1,5
58195,Largegayman,sargeras,96,warrior,fury,6,1,5
58196,Fletçhér,sargeras,96,warrior,fury,7,1,6
58197,Dragvovar,thrall,96,warrior,fury,7,1,6
58198,Nabangle,barthilas,96,warrior,fury,10,1,9
58199,Mawdryn,destromath,96,warrior,fury,12,1,11
58200,Philbert,alexstrasza,96,warrior,fury,12,1,11
58201,Furyofbeans,area-52,96,warrior,fury,12,1,11
58202,Maaxdry,area-52,96,warrior,fury,12,1,11
58203,Zaxari,gurubashi,96,warrior,fury,12,1,11
58204,Mamalonic,ragnaros,96,warrior,fury,12,1,11
58205,Facerollyou,blackrock,96,warrior,fury,12,1,11
58206,Gigglamesh,muradin,64,warrior,fury,4,1,3
58207,Cremosö,azralon,64,warrior,fury,4,1,3
58208,Adonis,burning-blade,64,warrior,fury,10,1,9
58209,Sarmat,undermine,63,warrior,fury,2,2,0
58210,Coverage,frostmourne,63,warrior,fury,2,2,0
58211,Xidaego,tichondrius,63,warrior,fury,2,2,0
58212,Kirikash,illidan,42,warrior,fury,6,2,4
58213,Husurnanny,dalaran,42,warrior,fury,7,2,5
58214,Ztg,tichondrius,42,warrior,fury,11,2,9
58215,Edrelang,bronzebeard,31,warrior,fury,2,1,1
58216,Khàzix,kelthuzad,31,warrior,fury,2,1,1
58217,Spartaacus,windrunner,31,warrior,fury,2,1,1
58218,Vioar,hyjal,31,warrior,fury,2,1,1
58219,Freakdps,stormrage,16,warrior,fury,1,1,0
58220,Sanduin,drakkari,16,warrior,fury,1,1,0
58221,Hapigirl,tichondrius,2283,warrior,arms,66,48,18
58222,Exzistance,area-52,2242,warrior,arms,127,70,57
58223,Río,area-52,2216,warrior,arms,136,72,64
58224,Récksus,tichondrius,2182,warrior,arms,98,58,40
58225,Thiccbiscuit,area-52,2168,warrior,arms,133,67,66
58226,Zhanwudix,tichondrius,2162,warrior,arms,111,62,49
58227,Killbørn,azralon,2156,warrior,arms,90,47,43
58228,Marsshine,tichondrius,2142,warrior,arms,119,63,56
58229,Turtleboy,feathermoon,2141,warrior,arms,79,45,34
58230,Todory,moon-guard,2137,warrior,arms,155,78,77
58231,Ikkyuo,proudmoore,2136,warrior,arms,174,93,81
58232,Ðêed,area-52,2133,warrior,arms,81,46,35
58233,Dpoy,tichondrius,2128,warrior,arms,108,54,54
58234,Kraftyx,bleeding-hollow,2125,warrior,arms,72,44,28
58235,Ssamök,ragnaros,2125,warrior,arms,329,168,161
58236,Toutie,tichondrius,2122,warrior,arms,120,67,53
58237,Buckwar,zuljin,2121,warrior,arms,78,41,37
58238,Huzha,tichondrius,2114,warrior,arms,117,64,53
58239,Warried,sargeras,2113,warrior,arms,66,37,29
58240,Tyranitar,proudmoore,2113,warrior,arms,90,50,40
58241,Strife,sargeras,2112,warrior,arms,56,32,24
58242,Abswar,tichondrius,2110,warrior,arms,171,100,71
58243,Menethíl,tichondrius,2110,warrior,arms,156,82,74
58244,Warrgodlol,illidan,2109,warrior,arms,81,41,40
58245,Nitron,dawnbringer,2108,warrior,arms,89,45,44
58246,Vituu,sargeras,2104,warrior,arms,104,54,50
58247,Killborn,tichondrius,2104,warrior,arms,145,73,72
58248,Edgarllama,sargeras,2103,warrior,arms,87,48,39
58249,ßallinjr,illidan,2103,warrior,arms,90,46,44
58250,Recksus,tichondrius,2102,warrior,arms,119,74,45
58251,Huuzha,tichondrius,2102,warrior,arms,95,55,40
58252,Nikomasked,kelthuzad,2100,warrior,arms,66,37,29
58253,Schonkopf,moon-guard,2100,warrior,arms,90,46,44
58254,Vø,agamaggan,2098,warrior,arms,153,79,74
58255,Nuqipq,tichondrius,2059,warrior,arms,64,36,28
58256,Kfcvivofifty,tichondrius,2052,warrior,arms,72,46,26
58257,Cloudxxy,kiljaeden,2052,warrior,arms,75,43,32
58258,Leans,sargeras,2048,warrior,arms,143,78,65
58259,Salgadoryan,stormrage,2047,warrior,arms,232,118,114
58260,Exespamtwo,area-52,2045,warrior,arms,206,112,94
58261,Bhaldur,sargeras,2037,warrior,arms,182,102,80
58262,Orclog,illidan,2033,warrior,arms,72,37,35
58263,Islonely,tichondrius,2026,warrior,arms,168,81,87
58264,Leoneceo,azralon,2025,warrior,arms,132,82,50
58265,Kimchikick,tichondrius,2017,warrior,arms,203,107,96
58266,Gyracide,area-52,2016,warrior,arms,101,49,52
58267,Tryhardr,sargeras,2006,warrior,arms,260,140,120
58268,Blackpînk,tichondrius,1992,warrior,arms,78,43,35
58269,Icarryrats,tichondrius,1988,warrior,arms,105,52,53
58270,Wutainx,tichondrius,1984,warrior,arms,60,33,27
58271,Szw,tichondrius,1983,warrior,arms,263,150,113
58272,Arthurjlol,tichondrius,1982,warrior,arms,72,33,39
58273,Zankets,area-52,1981,warrior,arms,144,74,70
58274,Boblennon,tichondrius,1977,warrior,arms,72,33,39
58275,Ironbad,sargeras,1975,warrior,arms,94,50,44
58276,Sick,azralon,1973,warrior,arms,94,46,48
58277,Belàrià,tichondrius,1969,warrior,arms,66,39,27
58278,Lyrics,tichondrius,1969,warrior,arms,62,32,30
58279,Pdbq,tichondrius,1968,warrior,arms,114,59,55
58280,Bighamm,tichondrius,1965,warrior,arms,71,40,31
58281,Azaks,drakkari,1965,warrior,arms,58,32,26
58282,Iløveaysla,azralon,1963,warrior,arms,84,39,45
58283,Massacretko,area-52,1962,warrior,arms,88,50,38
58284,Grantlol,illidan,1961,warrior,arms,102,55,47
58285,Og,shattered-hand,1958,warrior,arms,47,29,18
58286,Ddaÿ,tichondrius,1957,warrior,arms,130,62,68
58287,Xîonorc,ragnaros,1955,warrior,arms,225,117,108
58288,Shadowstingg,tichondrius,1954,warrior,arms,77,38,39
58289,Foxxfighter,thrall,1953,warrior,arms,98,49,49
58290,Foraken,dragonmaw,1948,warrior,arms,59,36,23
58291,Belàriá,tichondrius,1948,warrior,arms,66,36,30
58292,Icanfixher,moon-guard,1946,warrior,arms,739,370,369
58293,Exëqt,nemesis,1945,warrior,arms,144,75,69
58294,Yermalx,tichondrius,1941,warrior,arms,54,30,24
58295,Bacchanal,illidan,1935,warrior,arms,215,107,108
58296,Fanglerondz,area-52,1932,warrior,arms,53,28,25
58297,Perfs,bleeding-hollow,1931,warrior,arms,108,53,55
58298,Bigladmike,sargeras,1931,warrior,arms,78,34,44
58299,Huugg,skullcrusher,1930,warrior,arms,165,87,78
58300,Kalpok,tichondrius,1929,warrior,arms,64,33,31
58301,Yermalt,tichondrius,1928,warrior,arms,92,48,44
58302,Kiggs,tichondrius,1925,warrior,arms,66,34,32
58303,Ricorecklezz,korgath,1925,warrior,arms,66,32,34
58304,Marfas,hyjal,1924,warrior,arms,157,86,71
58305,Ushouldnome,tichondrius,1921,warrior,arms,72,40,32
58306,Bigbait,hyjal,1921,warrior,arms,78,38,40
58307,Gormag,sargeras,1917,warrior,arms,60,35,25
58308,Smorc,stormrage,1917,warrior,arms,60,31,29
58309,Trezturbo,tichondrius,1915,warrior,arms,174,92,82
58310,Tankypandazd,stormrage,1911,warrior,arms,294,145,149
58311,Ælilblessedñ,azralon,1909,warrior,arms,172,88,84
58312,Cosmicsteel,tichondrius,1908,warrior,arms,88,51,37
58313,Jadeemerald,kelthuzad,1906,warrior,arms,72,40,32
58314,Solastro,malganis,1906,warrior,arms,74,35,39
58315,Mítos,quelthalas,1904,warrior,arms,198,101,97
58316,Painqt,area-52,1903,warrior,arms,24,20,4
58317,Cutgirl,quelthalas,1903,warrior,arms,74,38,36
58318,Madblackcat,illidan,1902,warrior,arms,58,34,24
58319,Isnlonely,tichondrius,1901,warrior,arms,42,26,16
58320,Míasma,ragnaros,1900,warrior,arms,96,41,55
58321,Lícketysplít,ysondre,1893,warrior,arms,52,29,23
58322,Kydrav,khadgar,1891,warrior,arms,52,28,24
58323,Jgillz,sargeras,1891,warrior,arms,78,41,37
58324,Ruinenlust,zuljin,1891,warrior,arms,78,36,42
58325,Paoxiaolol,tichondrius,1890,warrior,arms,73,47,26
58326,Jdubz,frostmourne,1889,warrior,arms,66,36,30
58327,Joshiguy,area-52,1889,warrior,arms,78,36,42
58328,Etchiasoko,gurubashi,1888,warrior,arms,48,33,15
58329,Hanzmat,illidan,1885,warrior,arms,66,35,31
58330,Betterthanu,azralon,1885,warrior,arms,174,91,83
58331,Wtssap,ragnaros,1884,warrior,arms,42,27,15
58332,Drdalidou,zuljin,1884,warrior,arms,54,25,29
58333,Ttvdjrio,area-52,1883,warrior,arms,36,22,14
58334,Arivok,hyjal,1883,warrior,arms,161,81,80
58335,Everfury,tichondrius,1883,warrior,arms,162,81,81
58336,Baitson,hyjal,1882,warrior,arms,60,30,30
58337,Ochinching,tichondrius,1880,warrior,arms,84,39,45
58338,Ggtk,tichondrius,1880,warrior,arms,72,33,39
58339,Kigame,tichondrius,1879,warrior,arms,102,57,45
58340,Paoxiaoevs,tichondrius,1879,warrior,arms,53,29,24
58341,Samuluo,tichondrius,1879,warrior,arms,72,34,38
58342,Chakø,tichondrius,1878,warrior,arms,96,54,42
58343,Ignid,tichondrius,1878,warrior,arms,126,58,68
58344,Masumura,kaelthas,1877,warrior,arms,62,31,31
58345,Sziw,tichondrius,1875,warrior,arms,204,105,99
58346,Destrey,emerald-dream,1874,warrior,arms,84,46,38
58347,Bùbbájr,emerald-dream,1874,warrior,arms,66,31,35
58348,Blackpinkx,tichondrius,1873,warrior,arms,48,23,25
58349,Kamoo,bonechewer,1871,warrior,arms,54,30,24
58350,Urdem,moon-guard,1869,warrior,arms,156,87,69
58351,Hookahboss,area-52,1869,warrior,arms,64,33,31
58352,Eqztw,tichondrius,1864,warrior,arms,149,90,59
58353,Tyránny,stormrage,1864,warrior,arms,71,35,36
58354,Hoboedd,area-52,1864,warrior,arms,70,32,38
58355,Chupelo,tichondrius,1863,warrior,arms,54,46,8
58356,Dawx,thrall,1862,warrior,arms,65,32,33
58357,Cammerz,area-52,1861,warrior,arms,168,83,85
58358,Musclehead,moon-guard,1860,warrior,arms,135,81,54
58359,Natating,terenas,1860,warrior,arms,54,32,22
58360,Forakenna,dragonmaw,1860,warrior,arms,53,31,22
58361,Venturexone,azralon,1860,warrior,arms,54,31,23
58362,Barrbarossa,stormrage,1860,warrior,arms,157,80,77
58363,Überwältigen,thrall,1860,warrior,arms,53,26,27
58364,Vascoes,alleria,1859,warrior,arms,180,100,80
58365,Wutains,tichondrius,1858,warrior,arms,71,36,35
58366,Pezy,frostmourne,1858,warrior,arms,120,59,61
58367,Sunamys,illidan,1857,warrior,arms,48,23,25
58368,Evach,kelthuzad,1856,warrior,arms,52,30,22
58369,Spìke,thrall,1856,warrior,arms,149,75,74
58370,Zindawg,frostmourne,1856,warrior,arms,325,161,164
58371,Sponsored,argent-dawn,1856,warrior,arms,71,33,38
58372,Pooshshi,illidan,1855,warrior,arms,60,29,31
58373,Falindrah,moon-guard,1854,warrior,arms,66,32,34
58374,Archosaurs,illidan,1854,warrior,arms,48,23,25
58375,Evnine,illidan,1853,warrior,arms,39,29,10
58376,Bakadoom,illidan,1853,warrior,arms,90,53,37
58377,Rafheeki,tichondrius,1853,warrior,arms,90,49,41
58378,Mynameyaff,tichondrius,1852,warrior,arms,199,115,84
58379,Brahmo,kelthuzad,1852,warrior,arms,66,38,28
58380,Coldlòve,akama,1851,warrior,arms,48,27,21
58381,Lebanesemvp,tichondrius,1851,warrior,arms,109,58,51
58382,Ruzoc,frostmourne,1851,warrior,arms,112,50,62
58383,Demetor,skywall,1850,warrior,arms,53,27,26
58384,Yueren,tichondrius,1850,warrior,arms,78,35,43
58385,Goodlikeplay,ragnaros,1849,warrior,arms,60,34,26
58386,Kames,garrosh,1849,warrior,arms,166,85,81
58387,Magicalol,tichondrius,1848,warrior,arms,54,33,21
58388,Wartruë,tichondrius,1848,warrior,arms,316,170,146
58389,Tigima,tichondrius,1848,warrior,arms,66,31,35
58390,Jikith,proudmoore,1847,warrior,arms,48,23,25
58391,Bigbadbaka,thaurissan,1847,warrior,arms,78,36,42
58392,Icon,tichondrius,1846,warrior,arms,46,35,11
58393,Blozar,illidan,1846,warrior,arms,60,30,30
58394,Randydanger,illidan,1845,warrior,arms,66,32,34
58395,Wheyprotein,illidan,1844,warrior,arms,42,22,20
58396,Battousai,kiljaeden,1844,warrior,arms,54,27,27
58397,ßloodshed,frostmourne,1843,warrior,arms,67,44,23
58398,Bladebuster,stormrage,1843,warrior,arms,66,36,30
58399,Veilsidewar,kelthuzad,1843,warrior,arms,453,235,218
58400,Dabaojiàn,illidan,1843,warrior,arms,45,23,22
58401,Dishonorkill,dentarg,1842,warrior,arms,43,27,16
58402,Støne,draktharon,1842,warrior,arms,98,56,42
58403,Sukonamí,draka,1842,warrior,arms,60,33,27
58404,Executeqt,azralon,1842,warrior,arms,161,87,74
58405,Madwolf,tichondrius,1842,warrior,arms,103,51,52
58406,Rageroidz,area-52,1841,warrior,arms,84,44,40
58407,Goonassassin,tichondrius,1841,warrior,arms,60,31,29
58408,Gryffith,bleeding-hollow,1841,warrior,arms,87,40,47
58409,Krunnknator,azralon,1840,warrior,arms,41,26,15
58410,Mixx,bleeding-hollow,1840,warrior,arms,48,26,22
58411,Narwhål,tichondrius,1840,warrior,arms,90,44,46
58412,Orçaos,ragnaros,1839,warrior,arms,126,73,53
58413,Paddyj,illidan,1838,warrior,arms,116,72,44
58414,Uzza,stormrage,1838,warrior,arms,60,34,26
58415,Draus,nemesis,1838,warrior,arms,119,67,52
58416,Ânticide,darkspear,1838,warrior,arms,84,43,41
58417,Kylewalker,tichondrius,1838,warrior,arms,71,32,39
58418,Nïcowo,ragnaros,1837,warrior,arms,158,81,77
58419,Xiaoyujin,proudmoore,1837,warrior,arms,186,95,91
58420,Adaana,kargath,1836,warrior,arms,119,70,49
58421,Mantrà,skullcrusher,1836,warrior,arms,42,24,18
58422,Vatix,sargeras,1836,warrior,arms,50,28,22
58423,Imuti,illidan,1836,warrior,arms,102,54,48
58424,Croc,frostmourne,1834,warrior,arms,32,21,11
58425,Blakeb,area-52,1834,warrior,arms,54,34,20
58426,Yossarrion,frostwolf,1833,warrior,arms,48,25,23
58427,Brilliance,suramar,1832,warrior,arms,60,30,30
58428,Hildemir,tichondrius,1831,warrior,arms,88,52,36
58429,Darrowshire,moon-guard,1831,warrior,arms,41,23,18
58430,Frëdsmite,kelthuzad,1831,warrior,arms,144,77,67
58431,Zira,thrall,1831,warrior,arms,133,69,64
58432,Ðìbs,moon-guard,1831,warrior,arms,65,32,33
58433,Rólex,tichondrius,1831,warrior,arms,63,30,33
58434,Damage,malganis,1829,warrior,arms,48,23,25
58435,Razw,frostmourne,1828,warrior,arms,48,28,20
58436,Elpappa,tichondrius,1827,warrior,arms,48,42,6
58437,Sanquelme,ragnaros,1827,warrior,arms,63,32,31
58438,Jonathann,suramar,1827,warrior,arms,132,65,67
58439,Blaíze,ragnaros,1826,warrior,arms,44,24,20
58440,Grayview,sargeras,1826,warrior,arms,77,41,36
58441,Seblleddo,drakkari,1826,warrior,arms,66,34,32
58442,Rebied,ragnaros,1826,warrior,arms,96,43,53
58443,Warriorbloo,sargeras,1825,warrior,arms,72,39,33
58444,Sandycrack,blackrock,1825,warrior,arms,60,30,30
58445,Salthouse,sargeras,1824,warrior,arms,42,25,17
58446,Këther,tichondrius,1824,warrior,arms,90,43,47
58447,Calthi,moon-guard,1823,warrior,arms,125,75,50
58448,Coby,wildhammer,1823,warrior,arms,65,36,29
58449,Jokerkxs,tichondrius,1823,warrior,arms,53,29,24
58450,Gbar,azralon,1823,warrior,arms,79,42,37
58451,Bigdaddyxo,whisperwind,1823,warrior,arms,47,24,23
58452,Cyster,proudmoore,1822,warrior,arms,42,24,18
58453,Tùngrâu,frostmourne,1822,warrior,arms,190,100,90
58454,Soultarius,area-52,1822,warrior,arms,69,36,33
58455,Nuccî,azralon,1822,warrior,arms,83,42,41
58456,Kurï,duskwood,1822,warrior,arms,51,24,27
58457,Pkkcrisis,archimonde,1822,warrior,arms,60,28,32
58458,Anautumnday,tichondrius,1820,warrior,arms,48,24,24
58459,Aggnilia,proudmoore,1820,warrior,arms,102,50,52
58460,Honock,ragnaros,1820,warrior,arms,72,34,38
58461,Abbastanza,tichondrius,1820,warrior,arms,89,42,47
58462,Boomergodx,stormrage,1819,warrior,arms,96,56,40
58463,Badboyjan,tichondrius,1818,warrior,arms,30,19,11
58464,Nilah,tichondrius,1818,warrior,arms,46,26,20
58465,Yeawen,tichondrius,1818,warrior,arms,42,23,19
58466,Iwillcrushyo,darkspear,1818,warrior,arms,90,46,44
58467,Nozmok,proudmoore,1818,warrior,arms,65,33,32
58468,Thugdorr,sargeras,1818,warrior,arms,70,33,37
58469,Okita,bleeding-hollow,1817,warrior,arms,124,65,59
58470,Smashxx,area-52,1816,warrior,arms,95,55,40
58471,Deadhate,sargeras,1816,warrior,arms,54,28,26
58472,Missrend,hyjal,1816,warrior,arms,114,57,57
58473,Berzek,area-52,1816,warrior,arms,59,23,36
58474,Picarus,thunderhorn,1815,warrior,arms,72,40,32
58475,Warney,tichondrius,1815,warrior,arms,65,35,30
58476,Destram,kelthuzad,1815,warrior,arms,107,57,50
58477,Skolltonxoxo,tichondrius,1815,warrior,arms,54,28,26
58478,Mezdrì,quelthalas,1814,warrior,arms,72,46,26
58479,Anti,nerzhul,1814,warrior,arms,57,30,27
58480,Dissector,ragnaros,1814,warrior,arms,54,28,26
58481,Strongbaby,tichondrius,1814,warrior,arms,72,36,36
58482,Zapatín,quelthalas,1814,warrior,arms,67,32,35
58483,Mäddôx,tichondrius,1814,warrior,arms,126,60,66
58484,Sezariùs,darkspear,1813,warrior,arms,61,42,19
58485,Elimination,tichondrius,1813,warrior,arms,41,27,14
58486,Bigjbs,tichondrius,1813,warrior,arms,36,22,14
58487,Vicioustalol,proudmoore,1812,warrior,arms,57,34,23
58488,Onebraincell,stormrage,1811,warrior,arms,48,34,14
58489,Gohrgroc,quelthalas,1811,warrior,arms,48,30,18
58490,Glocç,sargeras,1811,warrior,arms,112,59,53
58491,Knuklez,tichondrius,1811,warrior,arms,64,33,31
58492,Indominate,tichondrius,1811,warrior,arms,194,98,96
58493,Mecc,tichondrius,1811,warrior,arms,78,39,39
58494,Dangerousd,kiljaeden,1811,warrior,arms,60,30,30
58495,Vergerak,tichondrius,1811,warrior,arms,58,29,29
58496,Dabdaddyy,dawnbringer,1811,warrior,arms,135,66,69
58497,Kaimedran,moon-guard,1810,warrior,arms,48,30,18
58498,Kriloth,frostmourne,1810,warrior,arms,50,30,20
58499,Ppdub,zuljin,1810,warrior,arms,44,26,18
58500,Bussupshut,kelthuzad,1810,warrior,arms,64,32,32
58501,Ürürææae,sargeras,1810,warrior,arms,189,94,95
58502,Darkduet,tichondrius,1810,warrior,arms,70,33,37
58503,Møcat,illidan,1809,warrior,arms,90,52,38
58504,Wulouzhan,tichondrius,1809,warrior,arms,137,77,60
58505,Kazynn,tichondrius,1808,warrior,arms,45,30,15
58506,Aavyrre,moon-guard,1808,warrior,arms,60,34,26
58507,Ciz,emerald-dream,1808,warrior,arms,64,34,30
58508,Smokes,sargeras,1808,warrior,arms,144,73,71
58509,Spartus,kelthuzad,1808,warrior,arms,78,32,46
58510,Crøm,tichondrius,1807,warrior,arms,48,29,19
58511,Crowsfall,aggramar,1807,warrior,arms,268,141,127
58512,Yamadaflash,tichondrius,1806,warrior,arms,55,31,24
58513,Bbyè,tichondrius,1806,warrior,arms,318,168,150
58514,Helrise,sargeras,1806,warrior,arms,54,27,27
58515,Bradockqt,azralon,1806,warrior,arms,54,25,29
58516,Kâdé,malganis,1805,warrior,arms,42,26,16
58517,Sickwidit,kiljaeden,1805,warrior,arms,49,28,21
58518,Rookìe,illidan,1805,warrior,arms,131,73,58
58519,Chaytin,bleeding-hollow,1805,warrior,arms,74,41,33
58520,Noblewinter,sargeras,1805,warrior,arms,36,19,17
58521,Tenskj,proudmoore,1805,warrior,arms,57,30,27
58522,Wootzu,zuljin,1805,warrior,arms,54,27,27
58523,Mildlol,tichondrius,1804,warrior,arms,42,25,17
58524,Peinx,ragnaros,1804,warrior,arms,59,31,28
58525,Bahlahkay,proudmoore,1804,warrior,arms,60,28,32
58526,Ollena,wyrmrest-accord,1803,warrior,arms,78,40,38
58527,Fleegugeegu,malganis,1803,warrior,arms,96,47,49
58528,Ramzeé,kelthuzad,1802,warrior,arms,124,77,47
58529,Storminshock,malganis,1802,warrior,arms,81,46,35
58530,Cgelangdula,tichondrius,1802,warrior,arms,54,28,26
58531,Asstastic,bonechewer,1802,warrior,arms,148,71,77
58532,Matesan,jubeithos,1801,warrior,arms,48,28,20
58533,Illing,tichondrius,1801,warrior,arms,336,178,158
58534,Hìm,tichondrius,1801,warrior,arms,54,28,26
58535,Franticlol,tichondrius,1801,warrior,arms,67,31,36
58536,Yagura,emerald-dream,1800,warrior,arms,70,34,36
58537,Longzhan,tichondrius,1800,warrior,arms,138,65,73
58538,Kustybuckets,korgath,1798,warrior,arms,46,27,19
58539,Comehnrfce,illidan,1798,warrior,arms,122,55,67
58540,Laddèrx,area-52,1796,warrior,arms,47,25,22
58541,Invalidoath,tichondrius,1794,warrior,arms,60,29,31
58542,Ksharer,tichondrius,1794,warrior,arms,89,41,48
58543,Montibello,moon-guard,1793,warrior,arms,186,99,87
58544,Garrmash,hyjal,1793,warrior,arms,259,137,122
58545,Meccsecute,tichondrius,1792,warrior,arms,114,59,55
58546,Kruma,stormscale,1791,warrior,arms,37,22,15
58547,Gorek,illidan,1791,warrior,arms,36,19,17
58548,Facefïster,malganis,1790,warrior,arms,72,37,35
58549,Beanbags,zangarmarsh,1790,warrior,arms,72,36,36
58550,Debbie,bleeding-hollow,1789,warrior,arms,90,44,46
58551,Melifehorde,tichondrius,1787,warrior,arms,48,25,23
58552,Bigglyjoobs,tichondrius,1787,warrior,arms,78,38,40
58553,Ígnatius,malganis,1781,warrior,arms,48,31,17
58554,Samwolok,tichondrius,1780,warrior,arms,36,19,17
58555,Slaten,barthilas,1780,warrior,arms,149,77,72
58556,Arx,frostwolf,1779,warrior,arms,207,112,95
58557,Nanchobo,tichondrius,1778,warrior,arms,66,28,38
58558,Lvlthreemage,fizzcrank,1775,warrior,arms,150,74,76
58559,Hbrandy,tichondrius,1773,warrior,arms,83,42,41
58560,Undefied,moon-guard,1772,warrior,arms,51,29,22
58561,Cushman,tichondrius,1772,warrior,arms,132,73,59
58562,Sharer,tichondrius,1772,warrior,arms,36,19,17
58563,Stáclin,ragnaros,1770,warrior,arms,492,265,227
58564,Krbigcow,tichondrius,1768,warrior,arms,120,62,58
58565,Danceylol,barthilas,1768,warrior,arms,96,47,49
58566,Warginger,malygos,1767,warrior,arms,65,36,29
58567,Dalan,korgath,1766,warrior,arms,48,30,18
58568,Chimbrila,azralon,1765,warrior,arms,126,59,67
58569,Nyloras,illidan,1765,warrior,arms,63,28,35
58570,Tokugawaieya,nemesis,1764,warrior,arms,95,43,52
58571,Tehfury,area-52,1763,warrior,arms,57,26,31
58572,Pipedoctor,kelthuzad,1762,warrior,arms,48,27,21
58573,Sherrywalken,azralon,1762,warrior,arms,133,72,61
58574,Nuvola,tichondrius,1761,warrior,arms,72,38,34
58575,Endstorm,proudmoore,1761,warrior,arms,68,34,34
58576,Dawxw,thrall,1759,warrior,arms,41,24,17
58577,Zenrrei,ragnaros,1759,warrior,arms,175,97,78
58578,Gomachi,moon-guard,1757,warrior,arms,58,26,32
58579,Yonkerss,garrosh,1756,warrior,arms,95,51,44
58580,Marchdream,tichondrius,1756,warrior,arms,60,32,28
58581,Vadio,area-52,1751,warrior,arms,58,28,30
58582,Tutifrutiø,azralon,1750,warrior,arms,108,49,59
58583,Warfuse,illidan,1749,warrior,arms,126,63,63
58584,Nànchobo,tichondrius,1749,warrior,arms,72,31,41
58585,Bigdude,frostwolf,1748,warrior,arms,66,38,28
58586,Partyx,tichondrius,1747,warrior,arms,288,148,140
58587,Polydopam,tichondrius,1747,warrior,arms,130,66,64
58588,Wartrué,tichondrius,1747,warrior,arms,77,27,50
58589,Línfert,stormrage,1746,warrior,arms,196,107,89
58590,Kurodia,quelthalas,1744,warrior,arms,84,35,49
58591,Ogrelurd,malygos,1743,warrior,arms,42,22,20
58592,Brendanshwab,bleeding-hollow,1743,warrior,arms,89,44,45
58593,Utxpia,azralon,1743,warrior,arms,59,26,33
58594,Bûm,sargeras,1742,warrior,arms,123,65,58
58595,Rynrak,tichondrius,1742,warrior,arms,102,52,50
58596,Rflexxo,tichondrius,1742,warrior,arms,54,27,27
58597,Bajheera,sargeras,1741,warrior,arms,41,21,20
58598,Franziskaner,frostmourne,1741,warrior,arms,144,71,73
58599,Purplepiper,ragnaros,1740,warrior,arms,55,30,25
58600,Dogmar,staghelm,1739,warrior,arms,110,54,56
58601,Bigdad,whisperwind,1737,warrior,arms,48,27,21
58602,Ciskokido,illidan,1737,warrior,arms,107,58,49
58603,Oxia,quelthalas,1737,warrior,arms,60,30,30
58604,Unhòólyshy,ragnaros,1733,warrior,arms,48,29,19
58605,Alëwar,quelthalas,1733,warrior,arms,77,37,40
58606,Nightheller,stormrage,1733,warrior,arms,78,33,45
58607,Cokeroom,tichondrius,1732,warrior,arms,97,56,41
58608,Hoobaz,area-52,1732,warrior,arms,34,19,15
58609,Odiseo,ragnaros,1732,warrior,arms,61,34,27
58610,Jdubzr,frostmourne,1732,warrior,arms,60,31,29
58611,Nänchobo,tichondrius,1730,warrior,arms,50,23,27
58612,Elsamok,ragnaros,1729,warrior,arms,34,19,15
58613,Mantistabogn,zuluhed,1726,warrior,arms,82,43,39
58614,Mirado,tichondrius,1726,warrior,arms,78,40,38
58615,Roughknuckle,kelthuzad,1726,warrior,arms,41,19,22
58616,Swifty,anvilmar,1725,warrior,arms,30,18,12
58617,Crushedlol,bleeding-hollow,1725,warrior,arms,42,22,20
58618,Bloodbath,kiljaeden,1725,warrior,arms,47,24,23
58619,Malice,frostmourne,1723,warrior,arms,60,25,35
58620,Daddyßigßeef,malganis,1722,warrior,arms,61,35,26
58621,Relerocker,area-52,1722,warrior,arms,101,53,48
58622,Swìll,illidan,1722,warrior,arms,36,18,18
58623,Itsfall,tichondrius,1721,warrior,arms,42,21,21
58624,Crownzz,tichondrius,1721,warrior,arms,36,18,18
58625,Swordborne,moon-guard,1720,warrior,arms,95,43,52
58626,Cåfe,tichondrius,1719,warrior,arms,149,81,68
58627,Zacharyx,tichondrius,1718,warrior,arms,302,144,158
58628,Soloqandy,moon-guard,1718,warrior,arms,78,33,45
58629,Rocta,tichondrius,1717,warrior,arms,98,54,44
58630,Afrikunt,tichondrius,1717,warrior,arms,72,38,34
58631,Doominus,tichondrius,1717,warrior,arms,36,18,18
58632,Heylol,blackhand,1717,warrior,arms,64,28,36
58633,Ariést,bleeding-hollow,1715,warrior,arms,84,37,47
58634,Milough,nesingwary,1714,warrior,arms,124,71,53
58635,Basedaf,frostmourne,1713,warrior,arms,84,45,39
58636,Bainian,tichondrius,1712,warrior,arms,114,65,49
58637,Killimanjaro,aggramar,1712,warrior,arms,77,35,42
58638,Grômm,tichondrius,1712,warrior,arms,53,22,31
58639,Murderbell,tichondrius,1711,warrior,arms,108,54,54
58640,Hateuu,tichondrius,1709,warrior,arms,60,26,34
58641,Anukhar,emerald-dream,1708,warrior,arms,95,55,40
58642,Pachacutecxx,ragnaros,1708,warrior,arms,75,40,35
58643,Smashies,kelthuzad,1708,warrior,arms,53,27,26
58644,Tatërs,zuljin,1708,warrior,arms,72,36,36
58645,Gromkhor,tichondrius,1708,warrior,arms,72,30,42
58646,Robodad,illidan,1707,warrior,arms,48,25,23
58647,Doublezuglol,tichondrius,1707,warrior,arms,282,142,140
58648,Joebo,thrall,1706,warrior,arms,24,20,4
58649,Ðíablø,tichondrius,1705,warrior,arms,146,78,68
58650,Furyslam,tichondrius,1705,warrior,arms,77,30,47
58651,Niubzs,tichondrius,1704,warrior,arms,53,27,26
58652,Zugprime,dragonmaw,1703,warrior,arms,48,26,22
58653,Kaÿip,tichondrius,1703,warrior,arms,157,79,78
58654,Ådderall,thrall,1702,warrior,arms,72,39,33
58655,Impactw,aerie-peak,1701,warrior,arms,64,37,27
58656,Misakizs,illidan,1701,warrior,arms,61,26,35
58657,Zarrdune,darkspear,1700,warrior,arms,30,21,9
58658,Trágus,azralon,1700,warrior,arms,101,60,41
58659,Thrator,wyrmrest-accord,1699,warrior,arms,42,23,19
58660,Golem,frostmourne,1699,warrior,arms,99,51,48
58661,Hariban,sargeras,1699,warrior,arms,95,46,49
58662,Battlestance,shadowsong,1699,warrior,arms,95,42,53
58663,Tepaste,ragnaros,1698,warrior,arms,66,33,33
58664,Slaught,kelthuzad,1698,warrior,arms,151,73,78
58665,Exorbit,sargeras,1697,warrior,arms,69,39,30
58666,Ramparts,moon-guard,1697,warrior,arms,48,23,25
58667,Ammeh,draka,1696,warrior,arms,48,28,20
58668,Thlam,muradin,1696,warrior,arms,162,82,80
58669,Warkingx,tichondrius,1696,warrior,arms,36,18,18
58670,Lanlorash,barthilas,1696,warrior,arms,36,18,18
58671,Akrono,sargeras,1696,warrior,arms,54,19,35
58672,Ashtonx,sargeras,1694,warrior,arms,36,24,12
58673,Genghiz,azralon,1694,warrior,arms,66,36,30
58674,Noodlezz,moon-guard,1694,warrior,arms,107,49,58
58675,Tastý,moon-guard,1694,warrior,arms,54,22,32
58676,Delphont,stormrage,1693,warrior,arms,107,59,48
58677,Jubeithos,draktharon,1693,warrior,arms,65,33,32
58678,Wolfcultist,moon-guard,1693,warrior,arms,78,35,43
58679,Zaÿne,moon-guard,1692,warrior,arms,87,41,46
58680,Infernae,emerald-dream,1691,warrior,arms,66,40,26
58681,Blaiize,ragnaros,1691,warrior,arms,60,25,35
58682,Littlevarian,ragnaros,1690,warrior,arms,54,30,24
58683,Kolosal,tichondrius,1690,warrior,arms,45,22,23
58684,Bozzy,illidan,1690,warrior,arms,77,34,43
58685,Lostsummer,frostmourne,1689,warrior,arms,58,31,27
58686,Marvachi,moon-guard,1689,warrior,arms,248,126,122
58687,Rogôsh,tichondrius,1689,warrior,arms,60,24,36
58688,Kilgorath,area-52,1688,warrior,arms,90,42,48
58689,Raph,barthilas,1686,warrior,arms,42,25,17
58690,Fumzxy,frostmourne,1686,warrior,arms,50,27,23
58691,Zastrow,dalaran,1686,warrior,arms,84,33,51
58692,Meowdaa,proudmoore,1686,warrior,arms,72,24,48
58693,Sindevelor,tichondrius,1684,warrior,arms,89,50,39
58694,Scoopdog,stormrage,1684,warrior,arms,36,20,16
58695,Bmo,chogall,1684,warrior,arms,87,44,43
58696,Sayîon,zuljin,1684,warrior,arms,126,62,64
58697,Nazraill,aggramar,1683,warrior,arms,75,42,33
58698,Tyrannus,chogall,1683,warrior,arms,113,58,55
58699,Tuggernaut,khadgar,1683,warrior,arms,42,20,22
58700,Omnismash,stormrage,1683,warrior,arms,44,20,24
58701,Zalakan,malganis,1682,warrior,arms,54,34,20
58702,Shinigamix,steamwheedle-cartel,1682,warrior,arms,48,29,19
58703,Janjannodie,tichondrius,1682,warrior,arms,41,20,21
58704,Purrava,tichondrius,1680,warrior,arms,50,25,25
58705,Stonesoup,kelthuzad,1680,warrior,arms,83,33,50
58706,Gravewurm,twisting-nether,1679,warrior,arms,42,24,18
58707,Bøek,area-52,1679,warrior,arms,104,49,55
58708,Kroni,ragnaros,1678,warrior,arms,42,21,21
58709,Warsongwolf,tichondrius,1678,warrior,arms,68,29,39
58710,Swagramarr,area-52,1677,warrior,arms,93,51,42
58711,Johnburns,tichondrius,1677,warrior,arms,53,27,26
58712,Huacai,tichondrius,1676,warrior,arms,54,26,28
58713,Coisini,tichondrius,1675,warrior,arms,130,75,55
58714,Ichirisw,tichondrius,1675,warrior,arms,59,32,27
58715,Heater,stormrage,1675,warrior,arms,95,46,49
58716,Automator,proudmoore,1675,warrior,arms,60,27,33
58717,Hofukumizuki,tichondrius,1675,warrior,arms,60,25,35
58718,Shneakywar,frostmourne,1674,warrior,arms,96,54,42
58719,Mitigated,bleeding-hollow,1673,warrior,arms,48,26,22
58720,Maddawgg,mugthol,1672,warrior,arms,64,31,33
58721,Kromgrall,tichondrius,1671,warrior,arms,167,79,88
58722,Pusspeepers,kelthuzad,1671,warrior,arms,39,18,21
58723,Arkkaine,sargeras,1670,warrior,arms,111,57,54
58724,Winota,frostmourne,1669,warrior,arms,30,22,8
58725,Dodgestrikes,khaz-modan,1669,warrior,arms,48,28,20
58726,Zenchi,nerzhul,1669,warrior,arms,76,36,40
58727,Brøly,sargeras,1669,warrior,arms,84,38,46
58728,Amlahj,stormrage,1668,warrior,arms,53,30,23
58729,Twilightrain,tichondrius,1668,warrior,arms,412,216,196
58730,Sparts,area-52,1667,warrior,arms,53,30,23
58731,Timbermack,moon-guard,1667,warrior,arms,120,66,54
58732,Woth,deathwing,1667,warrior,arms,41,21,20
58733,Zhangye,tichondrius,1667,warrior,arms,48,23,25
58734,Kamoo,gurubashi,1665,warrior,arms,60,46,14
58735,Bilboswagins,agamaggan,1665,warrior,arms,47,25,22
58736,Hickorie,sargeras,1665,warrior,arms,117,60,57
58737,Azeryan,azralon,1665,warrior,arms,83,40,43
58738,Marcellùs,proudmoore,1664,warrior,arms,52,29,23
58739,Bigbadaxe,sargeras,1664,warrior,arms,42,21,21
58740,Hoodrch,azralon,1664,warrior,arms,113,55,58
58741,Oxandrolona,ragnaros,1664,warrior,arms,76,30,46
58742,Legoyoda,zuljin,1663,warrior,arms,54,29,25
58743,Edgárllama,sargeras,1663,warrior,arms,38,20,18
58744,Colössal,moon-guard,1663,warrior,arms,94,48,46
58745,Mightyduck,area-52,1663,warrior,arms,64,29,35
58746,Ystkk,tichondrius,1662,warrior,arms,42,25,17
58747,Jimjinjin,tichondrius,1662,warrior,arms,48,25,23
58748,Warbeshar,area-52,1662,warrior,arms,42,21,21
58749,Ironboar,proudmoore,1662,warrior,arms,72,32,40
58750,Khørnë,ragnaros,1661,warrior,arms,54,30,24
58751,Iwillcrushu,tichondrius,1661,warrior,arms,113,59,54
58752,Killbórn,azralon,1660,warrior,arms,30,19,11
58753,Anticiðe,zuljin,1659,warrior,arms,42,22,20
58754,Vvarríør,tichondrius,1658,warrior,arms,48,31,17
58755,Onecho,tichondrius,1658,warrior,arms,48,24,24
58756,Hiness,tichondrius,1658,warrior,arms,48,20,28
58757,Spinspin,borean-tundra,1657,warrior,arms,64,35,29
58758,Babyogre,thunderlord,1657,warrior,arms,77,42,35
58759,Wurua,tichondrius,1657,warrior,arms,58,30,28
58760,Tzumugi,ragnaros,1657,warrior,arms,383,196,187
58761,Irascible,stormrage,1657,warrior,arms,54,22,32
58762,Sheyshey,quelthalas,1656,warrior,arms,42,25,17
58763,Møønnlight,quelthalas,1655,warrior,arms,111,53,58
58764,Sineatér,frostmourne,1654,warrior,arms,61,30,31
58765,Flexìn,tichondrius,1654,warrior,arms,48,23,25
58766,Maktarax,zuljin,1654,warrior,arms,40,18,22
58767,Thuykieu,barthilas,1653,warrior,arms,36,18,18
58768,Jehocc,tichondrius,1653,warrior,arms,44,21,23
58769,Shrikewing,moon-guard,1652,warrior,arms,100,62,38
58770,Bddg,tichondrius,1652,warrior,arms,36,20,16
58771,Potero,ragnaros,1652,warrior,arms,59,29,30
58772,Athalen,nemesis,1652,warrior,arms,73,33,40
58773,Spartiguss,emerald-dream,1650,warrior,arms,59,32,27
58774,Creøn,silvermoon,1650,warrior,arms,68,35,33
58775,Tiredkev,tichondrius,1649,warrior,arms,107,53,54
58776,Raahjz,sargeras,1649,warrior,arms,102,48,54
58777,Executing,emerald-dream,1649,warrior,arms,54,25,29
58778,Chillimus,tichondrius,1648,warrior,arms,75,41,34
58779,Phabian,frostmourne,1648,warrior,arms,41,22,19
58780,Tatsuujin,sargeras,1648,warrior,arms,110,56,54
58781,Amberlym,ragnaros,1648,warrior,arms,52,26,26
58782,Omnïslash,tichondrius,1647,warrior,arms,54,25,29
58783,Droguernaut,tichondrius,1646,warrior,arms,59,30,29
58784,Kralo,moon-guard,1646,warrior,arms,69,34,35
58785,Coltronitis,kelthuzad,1646,warrior,arms,42,20,22
58786,Xwarz,drakkari,1645,warrior,arms,42,19,23
58787,Fidel,blackrock,1645,warrior,arms,59,19,40
58788,Lokityr,tichondrius,1644,warrior,arms,132,84,48
58789,Rainingblooð,blackrock,1644,warrior,arms,103,53,50
58790,Kekbyemmr,illidan,1644,warrior,arms,48,22,26
58791,Príde,kiljaeden,1643,warrior,arms,66,34,32
58792,Xwoyer,malganis,1642,warrior,arms,82,42,40
58793,Karín,tichondrius,1641,warrior,arms,42,27,15
58794,Alator,gorgonnash,1641,warrior,arms,66,38,28
58795,Stattic,illidan,1641,warrior,arms,54,25,29
58796,Arixos,frostmourne,1640,warrior,arms,36,20,16
58797,Sinsinatra,azralon,1640,warrior,arms,263,136,127
58798,Dramalas,lightbringer,1640,warrior,arms,311,156,155
58799,Wqnmlgbd,tichondrius,1640,warrior,arms,54,27,27
58800,Tatsuu,tichondrius,1640,warrior,arms,270,134,136
58801,Sonjeba,malganis,1640,warrior,arms,70,32,38
58802,Rarefxck,tichondrius,1640,warrior,arms,90,39,51
58803,Fulaixiong,illidan,1639,warrior,arms,51,34,17
58804,Austerö,nemesis,1639,warrior,arms,33,20,13
58805,Kàli,kiljaeden,1639,warrior,arms,54,25,29
58806,Unkultom,stormrage,1638,warrior,arms,99,57,42
58807,Thulsan,emerald-dream,1638,warrior,arms,42,23,19
58808,Izugyou,thrall,1637,warrior,arms,87,45,42
58809,Wargasmx,tichondrius,1637,warrior,arms,70,31,39
58810,Wolfsbanne,khadgar,1636,warrior,arms,156,83,73
58811,Painsoul,illidan,1636,warrior,arms,53,27,26
58812,Ngu,eldrethalas,1636,warrior,arms,53,26,27
58813,Donivan,illidan,1636,warrior,arms,60,29,31
58814,Xtrachrome,stormrage,1635,warrior,arms,36,20,16
58815,Mavrus,malganis,1634,warrior,arms,36,19,17
58816,Lunartime,sargeras,1634,warrior,arms,84,43,41
58817,Trapbois,tichondrius,1633,warrior,arms,36,22,14
58818,Grimjouw,sargeras,1633,warrior,arms,42,23,19
58819,Slamedi,frostmourne,1633,warrior,arms,126,61,65
58820,Ragster,kelthuzad,1632,warrior,arms,65,34,31
58821,Iigotu,tichondrius,1632,warrior,arms,256,133,123
58822,Bigbrick,stormrage,1632,warrior,arms,96,45,51
58823,Baciless,illidan,1632,warrior,arms,48,20,28
58824,Lexíbelle,korgath,1631,warrior,arms,36,21,15
58825,Túrin,quelthalas,1631,warrior,arms,132,71,61
58826,Raveve,area-52,1631,warrior,arms,71,36,35
58827,Groundpound,sargeras,1630,warrior,arms,140,71,69
58828,Shazbøt,tichondrius,1630,warrior,arms,45,19,26
58829,Icrìtmypants,dragonmaw,1629,warrior,arms,48,27,21
58830,Furykets,proudmoore,1629,warrior,arms,38,19,19
58831,Aumni,illidan,1629,warrior,arms,98,47,51
58832,Rhynehardt,scilla,1629,warrior,arms,84,38,46
58833,Okanos,tichondrius,1629,warrior,arms,48,21,27
58834,Bigdumborc,tichondrius,1628,warrior,arms,42,22,20
58835,Bromro,tichondrius,1628,warrior,arms,166,80,86
58836,Alteryx,sargeras,1628,warrior,arms,75,36,39
58837,Yarock,malganis,1628,warrior,arms,90,43,47
58838,Mokron,moon-guard,1628,warrior,arms,74,34,40
58839,Hõdõnsin,tichondrius,1628,warrior,arms,57,26,31
58840,Ikaikasan,illidan,1627,warrior,arms,32,22,10
58841,Sosimi,tichondrius,1627,warrior,arms,78,44,34
58842,Wârtorn,darkspear,1627,warrior,arms,42,22,20
58843,Michaelrossx,bloodhoof,1627,warrior,arms,244,125,119
58844,Çrusha,thrall,1627,warrior,arms,48,20,28
58845,Dreadedbeef,area-52,1626,warrior,arms,36,23,13
58846,Coollelex,proudmoore,1626,warrior,arms,56,29,27
58847,Wewladdie,malganis,1626,warrior,arms,36,18,18
58848,Kazecap,proudmoore,1626,warrior,arms,66,29,37
58849,Orgnosh,tichondrius,1625,warrior,arms,96,52,44
58850,Gutting,moon-guard,1625,warrior,arms,36,18,18
58851,Unitsven,barthilas,1625,warrior,arms,54,26,28
58852,Duxor,sargeras,1625,warrior,arms,54,24,30
58853,Elyll,tichondrius,1624,warrior,arms,47,28,19
58854,Patwong,frostmourne,1624,warrior,arms,102,55,47
58855,Soupwar,moon-guard,1624,warrior,arms,177,90,87
58856,Faelash,stormrage,1624,warrior,arms,67,32,35
58857,Testflight,tichondrius,1623,warrior,arms,54,30,24
58858,Ryängosling,azralon,1623,warrior,arms,168,92,76
58859,Downblow,tichondrius,1623,warrior,arms,36,19,17
58860,Flexid,tichondrius,1623,warrior,arms,78,40,38
58861,Dotlom,wyrmrest-accord,1623,warrior,arms,144,73,71
58862,Lindsanv,illidan,1622,warrior,arms,110,59,51
58863,Swólepetrol,tichondrius,1622,warrior,arms,36,19,17
58864,Larrylurker,proudmoore,1622,warrior,arms,119,62,57
58865,Orahard,illidan,1622,warrior,arms,200,100,100
58866,Brainhaze,tichondrius,1622,warrior,arms,64,29,35
58867,Chadwarr,tichondrius,1621,warrior,arms,31,17,14
58868,Kirown,quelthalas,1621,warrior,arms,98,45,53
58869,Stooklol,tichondrius,1621,warrior,arms,54,22,32
58870,Nerdstompêr,illidan,1620,warrior,arms,78,37,41
58871,Thezboy,tichondrius,1619,warrior,arms,100,56,44
58872,Feiler,ragnaros,1619,warrior,arms,48,21,27
58873,Mcluffin,proudmoore,1618,warrior,arms,57,35,22
58874,Lacorte,ragnaros,1618,warrior,arms,51,23,28
58875,Szeo,tichondrius,1617,warrior,arms,24,17,7
58876,Achilex,sargeras,1617,warrior,arms,127,66,61
58877,Andrès,sargeras,1617,warrior,arms,162,80,82
58878,Thebigmala,azralon,1616,warrior,arms,55,32,23
58879,Theokos,dalaran,1616,warrior,arms,112,56,56
58880,Necroticism,bleeding-hollow,1616,warrior,arms,36,17,19
58881,Slamuëladams,bleeding-hollow,1616,warrior,arms,48,20,28
58882,Delakos,frostmourne,1615,warrior,arms,95,51,44
58883,Zekkenx,azjolnerub,1615,warrior,arms,54,23,31
58884,Axellent,gilneas,1614,warrior,arms,70,44,26
58885,Rittylord,frostmourne,1614,warrior,arms,68,37,31
58886,Stormlørd,frostmourne,1614,warrior,arms,82,44,38
58887,Metalchileno,ragnaros,1614,warrior,arms,48,20,28
58888,Willcharge,tichondrius,1614,warrior,arms,49,17,32
58889,Myndon,area-52,1613,warrior,arms,37,27,10
58890,Wingaling,malganis,1613,warrior,arms,66,29,37
58891,Dashballer,sargeras,1612,warrior,arms,50,27,23
58892,Fluffyarm,sargeras,1612,warrior,arms,198,98,100
58893,Brianucky,thrall,1612,warrior,arms,59,26,33
58894,Thètrùth,duskwood,1612,warrior,arms,54,23,31
58895,Ÿüñí,tichondrius,1612,warrior,arms,60,24,36
58896,Shaõkahn,nemesis,1611,warrior,arms,46,23,23
58897,Mindgoblin,smolderthorn,1611,warrior,arms,59,29,30
58898,Sgtquad,illidan,1611,warrior,arms,39,19,20
58899,Hugeflopper,malganis,1610,warrior,arms,32,19,13
58900,Deathsteelw,zuljin,1610,warrior,arms,36,21,15
58901,Matrias,tichondrius,1610,warrior,arms,177,96,81
58902,Gwlade,sargeras,1610,warrior,arms,210,113,97
58903,Malerick,illidan,1610,warrior,arms,69,31,38
58904,Thombelina,malganis,1610,warrior,arms,44,19,25
58905,Enzoh,zuljin,1610,warrior,arms,86,30,56
58906,Nitechaos,thrall,1609,warrior,arms,37,23,14
58907,Thebigsmash,tichondrius,1609,warrior,arms,42,23,19
58908,Aloregorey,malganis,1609,warrior,arms,138,69,69
58909,Morfoggore,ragnaros,1609,warrior,arms,98,49,49
58910,Darkirondork,bleeding-hollow,1609,warrior,arms,38,18,20
58911,Theseuse,tichondrius,1608,warrior,arms,40,24,16
58912,Tommygunns,area-52,1608,warrior,arms,30,17,13
58913,Ohanaglad,illidan,1608,warrior,arms,165,88,77
58914,Rongor,drakkari,1608,warrior,arms,66,33,33
58915,Liltop,moon-guard,1607,warrior,arms,75,41,34
58916,Furydudz,tichondrius,1607,warrior,arms,42,21,21
58917,Wartrue,tichondrius,1607,warrior,arms,162,74,88
58918,Dicedup,stormrage,1607,warrior,arms,48,20,28
58919,Ottø,area-52,1606,warrior,arms,72,40,32
58920,Aventajadu,ragnaros,1606,warrior,arms,42,20,22
58921,Auzery,emerald-dream,1606,warrior,arms,60,28,32
58922,Maraudertko,area-52,1605,warrior,arms,30,17,13
58923,Myxz,barthilas,1605,warrior,arms,120,59,61
58924,Ethuil,azshara,1605,warrior,arms,65,29,36
58925,Boiled,sargeras,1604,warrior,arms,30,21,9
58926,Morboo,illidan,1604,warrior,arms,48,27,21
58927,Kakamallo,black-dragonflight,1604,warrior,arms,201,109,92
58928,Blodreìna,hyjal,1604,warrior,arms,109,53,56
58929,Lôwkeyfix,illidan,1604,warrior,arms,126,58,68
58930,Sayyaf,moon-guard,1604,warrior,arms,57,20,37
58931,Killaen,thrall,1603,warrior,arms,48,29,19
58932,Bleedx,bleeding-hollow,1603,warrior,arms,51,30,21
58933,Parren,bleeding-hollow,1603,warrior,arms,31,18,13
58934,Crusherr,earthen-ring,1603,warrior,arms,90,47,43
58935,Saleem,tichondrius,1603,warrior,arms,273,142,131
58936,Bugsberserk,tichondrius,1603,warrior,arms,119,61,58
58937,Zaràki,area-52,1603,warrior,arms,186,95,91
58938,Powerbucks,tichondrius,1603,warrior,arms,44,22,22
58939,Bebob,tichondrius,1603,warrior,arms,86,42,44
58940,Mahoogler,hakkar,1603,warrior,arms,66,31,35
58941,Xradull,dawnbringer,1602,warrior,arms,146,85,61
58942,Reave,wyrmrest-accord,1601,warrior,arms,78,42,36
58943,Sheriff,eldrethalas,1600,warrior,arms,54,31,23
58944,Dulapamore,tichondrius,1600,warrior,arms,48,22,26
58945,Galehna,ragnaros,1600,warrior,arms,47,21,26
58946,Draenøk,tichondrius,1600,warrior,arms,54,21,33
58947,Draugus,azralon,1599,warrior,arms,58,31,27
58948,Kilgrah,emerald-dream,1599,warrior,arms,40,21,19
58949,Koberos,queldorei,1599,warrior,arms,66,26,40
58950,Shiv,illidan,1598,warrior,arms,116,60,56
58951,Memorylane,proudmoore,1598,warrior,arms,42,20,22
58952,Raahjv,sargeras,1597,warrior,arms,54,34,20
58953,Tríxman,moon-guard,1597,warrior,arms,124,73,51
58954,Tÿ,haomarush,1597,warrior,arms,77,42,35
58955,Benjiprice,sargeras,1597,warrior,arms,35,19,16
58956,Zeroskill,cenarius,1596,warrior,arms,82,38,44
58957,Shain,thrall,1596,warrior,arms,48,22,26
58958,Xunxie,tichondrius,1595,warrior,arms,113,60,53
58959,Gorez,ragnaros,1595,warrior,arms,48,24,24
58960,Yolo,dunemaul,1594,warrior,arms,78,45,33
58961,Vauquelin,tichondrius,1594,warrior,arms,78,41,37
58962,Qingmei,illidan,1594,warrior,arms,110,48,62
58963,Kolossus,korgath,1593,warrior,arms,52,21,31
58964,Hèphæstús,sargeras,1592,warrior,arms,132,65,67
58965,Vanexx,tichondrius,1590,warrior,arms,43,24,19
58966,Warthok,turalyon,1590,warrior,arms,58,29,29
58967,Legnar,malganis,1590,warrior,arms,42,18,24
58968,Mistrpower,bleeding-hollow,1589,warrior,arms,78,44,34
58969,Warrgawd,illidan,1589,warrior,arms,83,43,40
58970,Mimiovo,tichondrius,1588,warrior,arms,42,23,19
58971,Bobu,area-52,1588,warrior,arms,63,33,30
58972,Lootacris,illidan,1588,warrior,arms,67,34,33
58973,Dre,anubarak,1587,warrior,arms,65,32,33
58974,Ghianna,quelthalas,1586,warrior,arms,65,34,31
58975,Homebody,uldaman,1585,warrior,arms,38,25,13
58976,Hyperdevil,ragnaros,1585,warrior,arms,35,19,16
58977,Brokthard,ragnaros,1585,warrior,arms,36,18,18
58978,Sheetss,tichondrius,1585,warrior,arms,48,23,25
58979,Mortawar,tichondrius,1584,warrior,arms,68,42,26
58980,Dukà,hyjal,1584,warrior,arms,54,30,24
58981,Destructör,nagrand,1584,warrior,arms,93,49,44
58982,Zzchocolate,illidan,1584,warrior,arms,102,46,56
58983,Warriorbod,area-52,1583,warrior,arms,53,33,20
58984,Lyliumn,frostmourne,1583,warrior,arms,66,34,32
58985,Sakutarou,lightbringer,1583,warrior,arms,295,143,152
58986,Yueqingshu,tichondrius,1582,warrior,arms,38,24,14
58987,Cathillex,eonar,1582,warrior,arms,42,25,17
58988,Katre,malorne,1582,warrior,arms,67,30,37
58989,Methwitch,moon-guard,1581,warrior,arms,36,19,17
58990,Marsoc,burning-legion,1581,warrior,arms,52,26,26
58991,Wilric,ragnaros,1581,warrior,arms,54,22,32
58992,Wydstepwar,malganis,1580,warrior,arms,60,38,22
58993,Deadlypsycho,moonrunner,1580,warrior,arms,36,19,17
58994,Perrin,burning-blade,1580,warrior,arms,49,25,24
58995,Uneasyw,tichondrius,1580,warrior,arms,47,20,27
58996,Gannïcûs,drakkari,1580,warrior,arms,77,32,45
58997,Tarók,tichondrius,1579,warrior,arms,26,19,7
58998,Allyer,darkspear,1579,warrior,arms,90,45,45
58999,Erradic,sargeras,1579,warrior,arms,54,26,28
59000,Stick,tichondrius,1578,warrior,arms,125,64,61
59001,Zanjaro,thrall,1578,warrior,arms,35,17,18
59002,Kpc,tichondrius,1578,warrior,arms,110,44,66
59003,Evoltoad,illidan,1578,warrior,arms,71,27,44
59004,Drjuicce,tichondrius,1577,warrior,arms,24,17,7
59005,Bestseason,kelthuzad,1577,warrior,arms,87,48,39
59006,Ragetodef,illidan,1577,warrior,arms,91,45,46
59007,Nipnipz,kelthuzad,1577,warrior,arms,94,40,54
59008,Därkzh,stormrage,1576,warrior,arms,30,20,10
59009,Juuz,frostmourne,1575,warrior,arms,114,56,58
59010,Ferozan,azralon,1575,warrior,arms,42,20,22
59011,Durres,tichondrius,1575,warrior,arms,42,19,23
59012,Dokgö,tichondrius,1575,warrior,arms,64,27,37
59013,Darthbleezy,malygos,1573,warrior,arms,42,22,20
59014,Radox,tichondrius,1573,warrior,arms,78,40,38
59015,Hydrolisk,area-52,1573,warrior,arms,144,71,73
59016,Sinbãd,sargeras,1573,warrior,arms,65,29,36
59017,Vodkalol,bleeding-hollow,1572,warrior,arms,30,20,10
59018,Flexo,moon-guard,1572,warrior,arms,42,24,18
59019,Yabahdabah,stormrage,1572,warrior,arms,93,49,44
59020,Grimus,bleeding-hollow,1571,warrior,arms,179,100,79
59021,Husyuzhi,tichondrius,1571,warrior,arms,36,20,16
59022,Ashantia,stormrage,1571,warrior,arms,90,48,42
59023,Nyle,zuljin,1571,warrior,arms,106,56,50
59024,Raves,quelthalas,1571,warrior,arms,114,54,60
59025,Thistleberry,aegwynn,1571,warrior,arms,41,19,22
59026,Onefourfifty,tichondrius,1570,warrior,arms,30,17,13
59027,Underbite,area-52,1569,warrior,arms,60,37,23
59028,Flexeçute,moon-guard,1569,warrior,arms,78,38,40
59029,Juicylumpia,moon-guard,1568,warrior,arms,48,31,17
59030,Chadblade,tichondrius,1568,warrior,arms,66,34,32
59031,Zuzi,korgath,1567,warrior,arms,55,35,20
59032,Jaybers,malganis,1567,warrior,arms,59,31,28
59033,Fartazz,zuljin,1567,warrior,arms,126,58,68
59034,Gulgosh,stormscale,1566,warrior,arms,59,30,29
59035,Báhamut,area-52,1566,warrior,arms,53,25,28
59036,Soez,tichondrius,1565,warrior,arms,33,23,10
59037,Riggragg,tichondrius,1565,warrior,arms,48,28,20
59038,Rapcherawr,illidan,1565,warrior,arms,51,28,23
59039,Armamortal,kelthuzad,1565,warrior,arms,369,189,180
59040,Radagøn,drakkari,1565,warrior,arms,48,24,24
59041,Xkickaxes,tichondrius,1565,warrior,arms,95,46,49
59042,Scrümp,illidan,1564,warrior,arms,85,45,40
59043,Gnizzmo,sargeras,1564,warrior,arms,48,25,23
59044,Pigzig,nagrand,1564,warrior,arms,36,18,18
59045,Ralphy,lightnings-blade,1563,warrior,arms,94,53,41
59046,Naejwar,ragnaros,1563,warrior,arms,186,97,89
59047,Darkmagno,ragnaros,1563,warrior,arms,42,20,22
59048,Tkazo,tichondrius,1563,warrior,arms,91,41,50
59049,Chogar,proudmoore,1562,warrior,arms,64,34,30
59050,Chañ,tichondrius,1562,warrior,arms,36,19,17
59051,Executie,duskwood,1562,warrior,arms,73,36,37
59052,Titanor,illidan,1562,warrior,arms,63,31,32
59053,Yamatoflash,tichondrius,1562,warrior,arms,43,18,25
59054,Hanadaddy,frostmourne,1560,warrior,arms,282,141,141
59055,Jenkin,korgath,1560,warrior,arms,40,19,21
59056,Vargoth,frostmourne,1560,warrior,arms,83,37,46
59057,Staystrong,tichondrius,1559,warrior,arms,36,24,12
59058,Aranacn,tichondrius,1559,warrior,arms,66,36,30
59059,Hônor,ragnaros,1558,warrior,arms,54,24,30
59060,Claymation,tichondrius,1558,warrior,arms,48,18,30
59061,Cronguin,bleeding-hollow,1557,warrior,arms,54,27,27
59062,Ävdol,emerald-dream,1556,warrior,arms,103,49,54
59063,Amputate,akama,1556,warrior,arms,65,27,38
59064,Firesx,tichondrius,1555,warrior,arms,36,20,16
59065,Skronkar,illidan,1555,warrior,arms,162,82,80
59066,Wargasms,alterac-mountains,1555,warrior,arms,48,21,27
59067,Mardrex,korgath,1555,warrior,arms,48,21,27
59068,Azindar,gilneas,1554,warrior,arms,42,21,21
59069,Flavor,aegwynn,1554,warrior,arms,60,27,33
59070,Sulze,tichondrius,1553,warrior,arms,355,173,182
59071,Arctures,stormrage,1552,warrior,arms,84,51,33
59072,Martyferrari,black-dragonflight,1552,warrior,arms,114,63,51
59073,Morioso,boulderfist,1552,warrior,arms,102,45,57
59074,Twoone,illidan,1552,warrior,arms,44,18,26
59075,Banhaezzi,tichondrius,1551,warrior,arms,160,81,79
59076,Blíding,ragnaros,1551,warrior,arms,75,28,47
59077,Ghóstx,alleria,1550,warrior,arms,53,37,16
59078,Aragorn,mannoroth,1550,warrior,arms,36,19,17
59079,Titanzz,quelthalas,1550,warrior,arms,71,35,36
59080,Rèckit,thrall,1550,warrior,arms,48,21,27
59081,Slyith,shadow-council,1549,warrior,arms,115,61,54
59082,Gorgan,ragnaros,1549,warrior,arms,96,48,48
59083,Itskel,stormreaver,1546,warrior,arms,44,23,21
59084,Ðrex,nagrand,1546,warrior,arms,116,60,56
59085,Muskratz,tichondrius,1546,warrior,arms,194,99,95
59086,Orsex,ragnaros,1546,warrior,arms,50,25,25
59087,Wingedknight,malganis,1546,warrior,arms,104,50,54
59088,Johnnysmizle,kelthuzad,1546,warrior,arms,84,38,46
59089,Riled,barthilas,1546,warrior,arms,42,18,24
59090,Kénjar,tichondrius,1545,warrior,arms,54,32,22
59091,Pachacutec,area-52,1545,warrior,arms,92,42,50
59092,Brostormftw,shattered-halls,1544,warrior,arms,72,43,29
59093,Zyppz,sargeras,1543,warrior,arms,38,26,12
59094,Grumtak,azralon,1543,warrior,arms,59,30,29
59095,Boypartz,onyxia,1543,warrior,arms,66,26,40
59096,Lykemore,moon-guard,1542,warrior,arms,74,41,33
59097,Ginormous,rivendare,1542,warrior,arms,69,35,34
59098,Know,anetheron,1542,warrior,arms,98,45,53
59099,Danield,illidan,1542,warrior,arms,60,23,37
59100,Urscrewed,frostmane,1541,warrior,arms,41,18,23
59101,Kenshín,ragnaros,1540,warrior,arms,161,75,86
59102,Millywhopz,thrall,1539,warrior,arms,48,25,23
59103,Uhttercow,tichondrius,1539,warrior,arms,66,33,33
59104,Slitt,azralon,1538,warrior,arms,78,42,36
59105,Märkdî,quelthalas,1538,warrior,arms,132,71,61
59106,Bwandøn,moon-guard,1538,warrior,arms,88,41,47
59107,Cowtipin,illidan,1538,warrior,arms,110,50,60
59108,Endurefen,sargeras,1537,warrior,arms,30,19,11
59109,Tansozzi,tichondrius,1537,warrior,arms,48,27,21
59110,Gtr,illidan,1536,warrior,arms,68,41,27
59111,Mailløche,bleeding-hollow,1535,warrior,arms,72,41,31
59112,Kwelve,proudmoore,1535,warrior,arms,48,22,26
59113,Áres,malganis,1534,warrior,arms,280,150,130
59114,Mortyy,stormrage,1534,warrior,arms,43,23,20
59115,Rokgral,tichondrius,1534,warrior,arms,80,42,38
59116,Themudcrab,frostmourne,1534,warrior,arms,339,166,173
59117,Twshizgd,proudmoore,1534,warrior,arms,193,91,102
59118,Nornogin,tichondrius,1534,warrior,arms,66,31,35
59119,Burstmacro,garrosh,1534,warrior,arms,60,26,34
59120,Ogeezus,crushridge,1533,warrior,arms,72,36,36
59121,Fraccx,area-52,1533,warrior,arms,76,34,42
59122,Hydranoid,ragnaros,1532,warrior,arms,157,73,84
59123,Malathire,illidan,1531,warrior,arms,58,32,26
59124,Tigris,nesingwary,1531,warrior,arms,30,16,14
59125,Raviax,sargeras,1530,warrior,arms,54,29,25
59126,Anukhos,emerald-dream,1530,warrior,arms,30,16,14
59127,Drèádnought,tichondrius,1530,warrior,arms,38,19,19
59128,Axazel,drakkari,1530,warrior,arms,186,88,98
59129,Bonesaaw,caelestrasz,1530,warrior,arms,48,22,26
59130,Maddorlon,thrall,1530,warrior,arms,59,27,32
59131,Rohta,kiljaeden,1529,warrior,arms,113,55,58
59132,Marzse,sargeras,1529,warrior,arms,54,23,31
59133,Ratfang,zuljin,1528,warrior,arms,28,17,11
59134,Stinkyw,tichondrius,1528,warrior,arms,49,27,22
59135,Meatbone,emerald-dream,1528,warrior,arms,113,61,52
59136,Doves,tichondrius,1528,warrior,arms,45,21,24
59137,Noyel,tichondrius,1528,warrior,arms,70,32,38
59138,Termana,azjolnerub,1527,warrior,arms,30,16,14
59139,Volstraya,frostmourne,1527,warrior,arms,43,22,21
59140,Seukkang,tichondrius,1527,warrior,arms,54,24,30
59141,Jwz,tichondrius,1527,warrior,arms,36,16,20
59142,Ryen,malganis,1527,warrior,arms,87,38,49
59143,Yiplaw,stormrage,1526,warrior,arms,30,16,14
59144,Zaddybear,aerie-peak,1526,warrior,arms,45,23,22
59145,Bìgpoppapump,tichondrius,1526,warrior,arms,195,95,100
59146,Malvadin,stormrage,1526,warrior,arms,66,30,36
59147,Yawdamper,illidan,1525,warrior,arms,30,21,9
59148,Ginthril,magtheridon,1525,warrior,arms,143,67,76
59149,Saelaa,azralon,1525,warrior,arms,36,16,20
59150,Flynnstone,tichondrius,1524,warrior,arms,30,19,11
59151,Bowlingball,darkspear,1524,warrior,arms,48,24,24
59152,Chinamonk,tichondrius,1524,warrior,arms,101,49,52
59153,Dtitanzz,quelthalas,1524,warrior,arms,57,27,30
59154,Executty,stormrage,1524,warrior,arms,36,17,19
59155,Hannibalkng,zangarmarsh,1524,warrior,arms,52,20,32
59156,Lionbuster,ragnaros,1523,warrior,arms,36,22,14
59157,Urion,illidan,1523,warrior,arms,30,17,13
59158,Supersquish,moon-guard,1523,warrior,arms,106,57,49
59159,Varenkä,drakkari,1523,warrior,arms,36,16,20
59160,Genøcide,terenas,1522,warrior,arms,54,23,31
59161,Kimed,nordrassil,1520,warrior,arms,30,16,14
59162,Metalwarr,illidan,1520,warrior,arms,59,30,29
59163,Medusaann,proudmoore,1520,warrior,arms,63,32,31
59164,Spartacam,frostmourne,1520,warrior,arms,166,83,83
59165,Dáinsleif,frostmourne,1520,warrior,arms,48,23,25
59166,Renger,garona,1520,warrior,arms,42,20,22
59167,Elchacál,ragnaros,1520,warrior,arms,66,27,39
59168,Randysnapper,zuljin,1519,warrior,arms,24,16,8
59169,Peacemake,tichondrius,1519,warrior,arms,45,24,21
59170,Traumaj,bleeding-hollow,1519,warrior,arms,141,74,67
59171,Ichigö,gundrak,1519,warrior,arms,57,28,29
59172,Rukittenme,area-52,1519,warrior,arms,72,29,43
59173,Ártorius,sargeras,1518,warrior,arms,138,72,66
59174,Dâvo,area-52,1518,warrior,arms,60,29,31
59175,Malakaimapk,korgath,1517,warrior,arms,30,16,14
59176,Ashbringera,proudmoore,1517,warrior,arms,237,120,117
59177,Byung,terenas,1517,warrior,arms,183,92,91
59178,Môrôdin,area-52,1517,warrior,arms,108,49,59
59179,Doubleturbo,illidan,1517,warrior,arms,59,26,33
59180,Ôn,tichondrius,1516,warrior,arms,279,136,143
59181,Damiansuv,moon-guard,1516,warrior,arms,153,73,80
59182,Rathty,shadowsong,1515,warrior,arms,48,26,22
59183,Retrospex,black-dragonflight,1515,warrior,arms,30,16,14
59184,Dajva,ragnaros,1515,warrior,arms,78,36,42
59185,Bryk,korgath,1514,warrior,arms,36,21,15
59186,Rads,stormscale,1514,warrior,arms,69,39,30
59187,Brayitann,illidan,1514,warrior,arms,49,27,22
59188,Tkavalan,proudmoore,1514,warrior,arms,65,29,36
59189,Gruula,frostmourne,1513,warrior,arms,45,27,18
59190,Nyuk,tichondrius,1513,warrior,arms,51,29,22
59191,Bvrst,area-52,1513,warrior,arms,30,16,14
59192,Dtrumpo,moon-guard,1513,warrior,arms,52,27,25
59193,Monstersynde,nemesis,1513,warrior,arms,143,71,72
59194,Elevate,whisperwind,1513,warrior,arms,36,16,20
59195,Cosmosz,illidan,1512,warrior,arms,101,55,46
59196,Bullmastic,deathwing,1512,warrior,arms,52,26,26
59197,Gwàr,kiljaeden,1511,warrior,arms,36,19,17
59198,Tuvia,malganis,1511,warrior,arms,177,89,88
59199,Raala,cenarius,1510,warrior,arms,51,34,17
59200,Draganovich,aerie-peak,1509,warrior,arms,54,30,24
59201,Torzzen,azralon,1509,warrior,arms,117,59,58
59202,Karrosh,agamaggan,1509,warrior,arms,42,18,24
59203,Himer,tichondrius,1509,warrior,arms,48,20,28
59204,Punknicanor,quelthalas,1508,warrior,arms,84,42,42
59205,Kratosxx,quelthalas,1508,warrior,arms,79,38,41
59206,Asäel,ragnaros,1508,warrior,arms,53,25,28
59207,Ryank,bonechewer,1508,warrior,arms,54,25,29
59208,Kissmyaxê,tichondrius,1508,warrior,arms,63,28,35
59209,Machete,nemesis,1507,warrior,arms,76,40,36
59210,Geñeralguap,tichondrius,1506,warrior,arms,208,110,98
59211,Weildboy,undermine,1506,warrior,arms,71,37,34
59212,Zolotrollo,area-52,1505,warrior,arms,24,16,8
59213,Zewl,barthilas,1505,warrior,arms,42,22,20
59214,Moonär,emerald-dream,1505,warrior,arms,113,55,58
59215,Legbreaker,tichondrius,1504,warrior,arms,70,37,33
59216,Pocserwar,drakkari,1504,warrior,arms,36,16,20
59217,Wouili,zuljin,1503,warrior,arms,97,59,38
59218,Atróx,quelthalas,1503,warrior,arms,84,40,44
59219,Bottlecaps,shadowmoon,1502,warrior,arms,51,25,26
59220,Slvrback,stormrage,1501,warrior,arms,30,16,14
59221,Cagrekk,wyrmrest-accord,1501,warrior,arms,71,37,34
59222,Cúdi,darkspear,1501,warrior,arms,48,23,25
59223,Rallyingcry,illidan,1500,warrior,arms,30,18,12
59224,Devildriver,malganis,1499,warrior,arms,102,53,49
59225,Lilmerman,laughing-skull,1499,warrior,arms,77,39,38
59226,Yunnkel,ragnaros,1499,warrior,arms,128,64,64
59227,Dewbae,whisperwind,1498,warrior,arms,84,40,44
59228,Nagaboner,frostmourne,1497,warrior,arms,113,63,50
59229,Akkar,gilneas,1497,warrior,arms,99,53,46
59230,Stickybladez,frostmourne,1497,warrior,arms,160,80,80
59231,Lilreese,tichondrius,1497,warrior,arms,74,36,38
59232,Slashcry,frostmourne,1497,warrior,arms,58,26,32
59233,Tcchmm,akama,1497,warrior,arms,64,28,36
59234,Enilaw,proudmoore,1496,warrior,arms,62,36,26
59235,Habakkos,firetree,1496,warrior,arms,72,39,33
59236,Crustyfella,stormrage,1496,warrior,arms,52,28,24
59237,Naughtytwat,tichondrius,1496,warrior,arms,207,103,104
59238,Volkz,ragnaros,1496,warrior,arms,83,39,44
59239,Tharsìs,emerald-dream,1496,warrior,arms,51,18,33
59240,Wo,alleria,1495,warrior,arms,42,19,23
59241,Dann,ragnaros,1494,warrior,arms,102,49,53
59242,Crowncrumpah,illidan,1494,warrior,arms,60,28,32
59243,Gale,kelthuzad,1493,warrior,arms,42,24,18
59244,Datneck,tichondrius,1493,warrior,arms,30,16,14
59245,Kastenz,frostmourne,1493,warrior,arms,55,25,30
59246,Horsekok,tichondrius,1492,warrior,arms,30,19,11
59247,Aggorak,illidan,1492,warrior,arms,36,16,20
59248,Blowhoof,azralon,1491,warrior,arms,54,29,25
59249,Kiritos,draktharon,1491,warrior,arms,111,58,53
59250,Sáítámá,tichondrius,1491,warrior,arms,58,30,28
59251,Roidraging,thunderlord,1490,warrior,arms,149,66,83
59252,Theisius,tichondrius,1490,warrior,arms,75,33,42
59253,Garadiels,tichondrius,1490,warrior,arms,73,31,42
59254,Rockstedy,area-52,1489,warrior,arms,68,31,37
59255,Reckonting,moon-guard,1488,warrior,arms,24,16,8
59256,Bozwar,tichondrius,1488,warrior,arms,66,34,32
59257,Taywar,sargeras,1488,warrior,arms,60,29,31
59258,Casablancas,azralon,1488,warrior,arms,42,16,26
59259,Dragvovar,thrall,1488,warrior,arms,42,16,26
59260,Mewpaw,azralon,1487,warrior,arms,24,16,8
59261,Zeldawolfpac,moon-guard,1487,warrior,arms,30,19,11
59262,Gahju,area-52,1487,warrior,arms,36,20,16
59263,Zänn,dalaran,1486,warrior,arms,60,38,22
59264,Beefytheorc,tichondrius,1486,warrior,arms,30,17,13
59265,Linga,bleeding-hollow,1486,warrior,arms,36,19,17
59266,Sìkarío,illidan,1486,warrior,arms,60,31,29
59267,Athin,azralon,1486,warrior,arms,90,46,44
59268,Zxlor,tichondrius,1486,warrior,arms,60,26,34
59269,Lehzera,frostmourne,1485,warrior,arms,104,49,55
59270,Warriordanim,tichondrius,1485,warrior,arms,235,108,127
59271,Karnakk,thrall,1485,warrior,arms,41,16,25
59272,Oppressor,darkspear,1484,warrior,arms,112,54,58
59273,Wmf,frostmourne,1484,warrior,arms,96,44,52
59274,Braxin,dalaran,1483,warrior,arms,77,42,35
59275,Dæthtønes,tichondrius,1483,warrior,arms,86,43,43
59276,Hotdadparty,frostmourne,1483,warrior,arms,115,56,59
59277,Earlsiriuz,tichondrius,1483,warrior,arms,51,23,28
59278,Amaragos,tichondrius,1482,warrior,arms,74,44,30
59279,Tamagoshi,kiljaeden,1482,warrior,arms,185,100,85
59280,Islik,stormrage,1482,warrior,arms,73,35,38
59281,Bâlthor,quelthalas,1481,warrior,arms,126,61,65
59282,Visenyä,mannoroth,1481,warrior,arms,52,21,31
59283,Magnis,stormrage,1480,warrior,arms,72,33,39
59284,Leapgodx,drenden,1479,warrior,arms,48,26,22
59285,Brutallicus,kelthuzad,1479,warrior,arms,33,17,16
59286,Tommytimbo,destromath,1479,warrior,arms,37,16,21
59287,Jäÿ,proudmoore,1478,warrior,arms,75,37,38
59288,Aparentlynot,shattered-hand,1478,warrior,arms,36,17,19
59289,Bêelzebub,aerie-peak,1478,warrior,arms,54,20,34
59290,Shortgoofy,sargeras,1477,warrior,arms,129,61,68
59291,Crystaríum,stormrage,1477,warrior,arms,79,37,42
59292,Lsays,tichondrius,1476,warrior,arms,156,78,78
59293,Rainzy,stormrage,1476,warrior,arms,36,16,20
59294,Ewenki,tichondrius,1475,warrior,arms,298,151,147
59295,Weedow,proudmoore,1474,warrior,arms,29,16,13
59296,Rimz,sargeras,1474,warrior,arms,40,21,19
59297,Gerztok,aggramar,1474,warrior,arms,58,28,30
59298,Saîyanroyce,barthilas,1473,warrior,arms,137,69,68
59299,Armsprotfury,tichondrius,1472,warrior,arms,48,30,18
59300,Furyass,bleeding-hollow,1472,warrior,arms,120,65,55
59301,Vecira,moon-guard,1472,warrior,arms,41,20,21
59302,Belldor,barthilas,1472,warrior,arms,108,47,61
59303,Dazfotm,tichondrius,1472,warrior,arms,41,16,25
59304,Holddapoop,area-52,1471,warrior,arms,78,43,35
59305,Eihn,quelthalas,1471,warrior,arms,53,25,28
59306,Beaerboy,darkspear,1471,warrior,arms,136,63,73
59307,Neotico,quelthalas,1471,warrior,arms,62,27,35
59308,Arthwarf,proudmoore,1470,warrior,arms,60,29,31
59309,Achillescool,tichondrius,1470,warrior,arms,145,70,75
59310,Potalot,draenor,1469,warrior,arms,30,16,14
59311,Baul,area-52,1469,warrior,arms,59,31,28
59312,Tapijuju,stormrage,1468,warrior,arms,33,20,13
59313,Smokedaperc,illidan,1468,warrior,arms,84,44,40
59314,Jeffo,amanthul,1468,warrior,arms,38,18,20
59315,Thurman,spirestone,1467,warrior,arms,44,26,18
59316,Klouddraft,tichondrius,1466,warrior,arms,45,26,19
59317,Jurojin,tichondrius,1466,warrior,arms,29,16,13
59318,Sharpen,terokkar,1465,warrior,arms,30,17,13
59319,Bestid,tichondrius,1465,warrior,arms,60,33,27
59320,Warrimon,nemesis,1465,warrior,arms,78,35,43
59321,Thedin,gorefiend,1465,warrior,arms,84,36,48
59322,Barbatenaz,ragnaros,1465,warrior,arms,48,18,30
59323,Eggroll,emerald-dream,1465,warrior,arms,47,17,30
59324,Torimzor,nemesis,1464,warrior,arms,138,74,64
59325,Asc,barthilas,1464,warrior,arms,264,139,125
59326,Ángron,ragnaros,1464,warrior,arms,92,48,44
59327,Zhânshen,tichondrius,1464,warrior,arms,60,31,29
59328,Scrapx,malganis,1464,warrior,arms,161,83,78
59329,Luosifen,tichondrius,1464,warrior,arms,250,126,124
59330,Toughguts,saurfang,1464,warrior,arms,60,29,31
59331,Bricksquad,mannoroth,1464,warrior,arms,57,25,32
59332,Joesbàr,tichondrius,1464,warrior,arms,78,34,44
59333,Frashes,darkspear,1463,warrior,arms,55,26,29
59334,Bigdingus,frostwolf,1463,warrior,arms,60,28,32
59335,Tekaiatsu,tichondrius,1462,warrior,arms,107,61,46
59336,Vyndronor,illidan,1462,warrior,arms,96,52,44
59337,Dou,barthilas,1462,warrior,arms,41,22,19
59338,Duroxzee,area-52,1462,warrior,arms,187,100,87
59339,Carnith,arthas,1462,warrior,arms,60,27,33
59340,Skollyd,tichondrius,1462,warrior,arms,38,17,21
59341,Sertss,proudmoore,1462,warrior,arms,71,30,41
59342,Golkän,goldrinn,1461,warrior,arms,66,34,32
59343,Ihadnochoice,barthilas,1461,warrior,arms,256,126,130
59344,Noitrak,azralon,1461,warrior,arms,45,18,27
59345,Erynus,malganis,1460,warrior,arms,44,25,19
59346,Nabiouscx,malganis,1460,warrior,arms,101,47,54
59347,Asgaurdius,thunderlord,1459,warrior,arms,70,36,34
59348,Konraad,amanthul,1459,warrior,arms,54,26,28
59349,Riskydevil,azralon,1458,warrior,arms,58,32,26
59350,Koniq,azralon,1458,warrior,arms,29,16,13
59351,Warlow,korgath,1458,warrior,arms,64,29,35
59352,Mommysharky,illidan,1457,warrior,arms,36,26,10
59353,Dathalidus,area-52,1457,warrior,arms,50,32,18
59354,Brotu,nemesis,1457,warrior,arms,163,91,72
59355,Creepi,sargeras,1457,warrior,arms,56,30,26
59356,Smoket,tichondrius,1456,warrior,arms,48,25,23
59357,Brocky,malorne,1456,warrior,arms,659,324,335
59358,Kröh,quelthalas,1456,warrior,arms,42,19,23
59359,Pongk,tichondrius,1456,warrior,arms,57,17,40
59360,Cheeriozz,thrall,1455,warrior,arms,53,30,23
59361,Renegón,ragnaros,1455,warrior,arms,54,28,26
59362,Jotto,zuljin,1455,warrior,arms,36,18,18
59363,Jrod,boulderfist,1455,warrior,arms,204,101,103
59364,Säbeër,ragnaros,1455,warrior,arms,66,32,34
59365,Slamthony,sargeras,1455,warrior,arms,57,27,30
59366,Xaka,tichondrius,1455,warrior,arms,42,19,23
59367,Dropopen,tichondrius,1455,warrior,arms,60,21,39
59368,Bigdickgomez,frostmourne,1454,warrior,arms,30,16,14
59369,Lionssong,bleeding-hollow,1454,warrior,arms,71,31,40
59370,Suprslayer,spirestone,1453,warrior,arms,40,20,20
59371,Xenogears,boulderfist,1452,warrior,arms,96,51,45
59372,Ayath,hyjal,1452,warrior,arms,66,31,35
59373,Babybears,tichondrius,1451,warrior,arms,50,18,32
59374,Cjz,tichondrius,1450,warrior,arms,48,29,19
59375,Zizwe,proudmoore,1450,warrior,arms,83,44,39
59376,Lòrdnasher,tichondrius,1450,warrior,arms,83,43,40
59377,Biznizwar,sargeras,1450,warrior,arms,124,61,63
59378,Isarat,illidan,1450,warrior,arms,48,23,25
59379,Qetimporta,quelthalas,1449,warrior,arms,96,54,42
59380,Erple,eldrethalas,1449,warrior,arms,116,54,62
59381,Himurinha,nemesis,1448,warrior,arms,30,16,14
59382,Wellowarr,moon-guard,1448,warrior,arms,78,34,44
59383,Dcashmoney,moon-guard,1448,warrior,arms,66,28,38
59384,Wapistun,thrall,1447,warrior,arms,48,26,22
59385,Dånkers,sargeras,1447,warrior,arms,44,16,28
59386,Gtatewarr,azjolnerub,1446,warrior,arms,26,16,10
59387,Overswing,tichondrius,1446,warrior,arms,78,32,46
59388,Zeroaxx,ragnaros,1445,warrior,arms,85,50,35
59389,Rárict,moon-guard,1445,warrior,arms,46,26,20
59390,Shawnemd,proudmoore,1445,warrior,arms,54,29,25
59391,Streetdog,stormrage,1445,warrior,arms,60,29,31
59392,Khargrok,ragnaros,1444,warrior,arms,60,28,32
59393,Trackstarz,llane,1443,warrior,arms,250,124,126
59394,Aoste,tichondrius,1442,warrior,arms,61,33,28
59395,Kréix,sargeras,1442,warrior,arms,59,27,32
59396,Destoryhamer,illidan,1441,warrior,arms,96,51,45
59397,Radamäntthys,nemesis,1441,warrior,arms,117,51,66
59398,Akaius,ragnaros,1441,warrior,arms,60,26,34
59399,Frankoiz,quelthalas,1440,warrior,arms,48,20,28
59400,Ðêad,area-52,1439,warrior,arms,24,15,9
59401,Joran,dathremar,1439,warrior,arms,44,23,21
59402,Kror,garona,1439,warrior,arms,75,38,37
59403,Rekatron,area-52,1439,warrior,arms,30,15,15
59404,Emaree,thrall,1438,warrior,arms,98,55,43
59405,Darkfang,icecrown,1438,warrior,arms,48,26,22
59406,Himxp,tichondrius,1438,warrior,arms,70,35,35
59407,Jichelei,tichondrius,1438,warrior,arms,72,35,37
59408,Beatmeat,frostmourne,1438,warrior,arms,55,25,30
59409,Loosz,stormrage,1438,warrior,arms,36,15,21
59410,Moozz,dreadmaul,1438,warrior,arms,42,17,25
59411,Themessiah,stormrage,1437,warrior,arms,59,33,26
59412,Graelus,terenas,1437,warrior,arms,47,26,21
59413,Drekzul,azralon,1437,warrior,arms,71,39,32
59414,Kurdtx,tichondrius,1437,warrior,arms,30,15,15
59415,Handain,malganis,1437,warrior,arms,48,19,29
59416,Raxek,stormrage,1437,warrior,arms,54,19,35
59417,Benkenobi,khaz-modan,1436,warrior,arms,24,15,9
59418,Stufit,emerald-dream,1436,warrior,arms,34,20,14
59419,Sako,amanthul,1436,warrior,arms,36,19,17
59420,Gorenay,nemesis,1436,warrior,arms,48,21,27
59421,Swamphell,barthilas,1436,warrior,arms,68,25,43
59422,Lotsay,tichondrius,1435,warrior,arms,97,50,47
59423,Ikrad,quelthalas,1435,warrior,arms,111,57,54
59424,Threg,malganis,1435,warrior,arms,30,15,15
59425,Nikon,bleeding-hollow,1435,warrior,arms,42,16,26
59426,Valder,akama,1434,warrior,arms,42,23,19
59427,Broodthorne,tichondrius,1434,warrior,arms,36,16,20
59428,Vainamóinen,kelthuzad,1433,warrior,arms,24,15,9
59429,Fòntaine,shandris,1433,warrior,arms,49,28,21
59430,Ygucheng,emerald-dream,1433,warrior,arms,67,33,34
59431,Monowarx,frostmourne,1433,warrior,arms,46,22,24
59432,Ybo,illidan,1432,warrior,arms,87,56,31
59433,Zonkis,kelthuzad,1432,warrior,arms,30,15,15
59434,Brewstrike,dalaran,1432,warrior,arms,54,25,29
59435,Tonesman,tichondrius,1432,warrior,arms,48,22,26
59436,Druckerz,lightnings-blade,1432,warrior,arms,102,43,59
59437,Ôxluck,ragnaros,1432,warrior,arms,92,34,58
59438,Hdkwanwoo,tichondrius,1431,warrior,arms,55,31,24
59439,Painfulsin,tichondrius,1431,warrior,arms,60,26,34
59440,Badguys,illidan,1431,warrior,arms,36,15,21
59441,Recktko,sargeras,1431,warrior,arms,39,16,23
59442,Unstàble,frostmourne,1430,warrior,arms,120,58,62
59443,Jeffe,khadgar,1429,warrior,arms,86,39,47
59444,Kushhy,illidan,1429,warrior,arms,45,19,26
59445,Destroid,zuljin,1428,warrior,arms,24,15,9
59446,Laintimee,tichondrius,1428,warrior,arms,56,30,26
59447,Shiiftybuga,frostmourne,1427,warrior,arms,50,27,23
59448,Hulkbuster,ragnaros,1427,warrior,arms,42,18,24
59449,Kadira,stormrage,1427,warrior,arms,90,37,53
59450,Fraannky,windrunner,1426,warrior,arms,128,64,64
59451,Dysensor,illidan,1426,warrior,arms,120,60,60
59452,Calmebigfeet,tichondrius,1426,warrior,arms,30,15,15
59453,Ermeji,ragnaros,1426,warrior,arms,59,27,32
59454,Arot,bloodhoof,1425,warrior,arms,165,78,87
59455,Santiágo,wyrmrest-accord,1425,warrior,arms,42,15,27
59456,Nervoxztwo,ragnaros,1424,warrior,arms,126,66,60
59457,Kannzox,quelthalas,1424,warrior,arms,103,53,50
59458,Cptstarship,sargeras,1424,warrior,arms,42,21,21
59459,Krimgar,quelthalas,1424,warrior,arms,94,39,55
59460,Maintarget,malganis,1424,warrior,arms,59,21,38
59461,Rayks,tichondrius,1423,warrior,arms,72,42,30
59462,Aesom,wyrmrest-accord,1423,warrior,arms,133,73,60
59463,Ghostmourne,ragnaros,1423,warrior,arms,256,127,129
59464,Tergll,illidan,1423,warrior,arms,51,23,28
59465,Musclecrowe,illidan,1423,warrior,arms,36,15,21
59466,Ooze,darkspear,1422,warrior,arms,138,75,63
59467,Justfair,barthilas,1422,warrior,arms,63,31,32
59468,Guguito,drakkari,1422,warrior,arms,42,17,25
59469,Thalfor,emerald-dream,1422,warrior,arms,77,30,47
59470,Filthyrandy,proudmoore,1421,warrior,arms,42,21,21
59471,Lørdvingador,azralon,1421,warrior,arms,30,15,15
59472,Gritrog,thrall,1420,warrior,arms,56,42,14
59473,Banggo,frostmourne,1420,warrior,arms,72,41,31
59474,Dji,tichondrius,1420,warrior,arms,293,146,147
59475,Mahkrash,quelthalas,1420,warrior,arms,47,22,25
59476,Sleazedog,kelthuzad,1420,warrior,arms,48,21,27
59477,Farquahd,illidan,1420,warrior,arms,84,34,50
59478,Waraze,tichondrius,1420,warrior,arms,42,17,25
59479,Nipparcs,tichondrius,1420,warrior,arms,42,15,27
59480,Fatty,mugthol,1419,warrior,arms,48,28,20
59481,Varyanguard,quelthalas,1419,warrior,arms,47,25,22
59482,Orctiddy,emerald-dream,1419,warrior,arms,32,16,16
59483,Mopwarrior,sargeras,1419,warrior,arms,30,15,15
59484,Elyoy,aerie-peak,1418,warrior,arms,48,26,22
59485,Karrok,zuluhed,1418,warrior,arms,246,117,129
59486,Hundredplus,frostmourne,1418,warrior,arms,36,17,19
59487,Pepétí,azralon,1418,warrior,arms,160,72,88
59488,Balroge,illidan,1418,warrior,arms,54,24,30
59489,Mortalgodtko,ragnaros,1418,warrior,arms,39,17,22
59490,Lisande,sargeras,1417,warrior,arms,106,57,49
59491,Chanchoswar,ragnaros,1417,warrior,arms,126,58,68
59492,Jinsol,illidan,1416,warrior,arms,87,43,44
59493,Tasesino,quelthalas,1415,warrior,arms,70,39,31
59494,Aaryn,caelestrasz,1415,warrior,arms,104,56,48
59495,Rekitralph,tichondrius,1415,warrior,arms,45,23,22
59496,Ughh,bleeding-hollow,1415,warrior,arms,54,27,27
59497,Bâtar,area-52,1415,warrior,arms,47,17,30
59498,Drygen,tichondrius,1414,warrior,arms,60,36,24
59499,Sludgthwaps,stormrage,1414,warrior,arms,65,33,32
59500,Fatnfurious,dunemaul,1414,warrior,arms,100,50,50
59501,Kahuwuna,tichondrius,1414,warrior,arms,30,15,15
59502,Guerra,goldrinn,1414,warrior,arms,30,15,15
59503,Scumrat,frostmourne,1414,warrior,arms,66,32,34
59504,Soltrain,stormrage,1414,warrior,arms,74,33,41
59505,Dizgraceful,malganis,1413,warrior,arms,30,21,9
59506,Imyourdaddy,chogall,1413,warrior,arms,28,16,12
59507,Korboc,malganis,1413,warrior,arms,60,29,31
59508,Slickpapi,area-52,1413,warrior,arms,93,44,49
59509,Slimmjim,malganis,1412,warrior,arms,164,90,74
59510,Muertededios,quelthalas,1412,warrior,arms,141,70,71
59511,Rikuduo,quelthalas,1412,warrior,arms,138,66,72
59512,Steelfist,grizzly-hills,1412,warrior,arms,54,25,29
59513,Ëssex,tichondrius,1412,warrior,arms,83,38,45
59514,Piimpmaster,malganis,1412,warrior,arms,36,15,21
59515,Shadderaz,sargeras,1411,warrior,arms,66,30,36
59516,Shockkwave,tichondrius,1410,warrior,arms,30,15,15
59517,Kanamechan,area-52,1410,warrior,arms,71,28,43
59518,Áustin,sargeras,1409,warrior,arms,24,15,9
59519,Tyzana,illidan,1409,warrior,arms,36,20,16
59520,Slamix,area-52,1409,warrior,arms,81,41,40
59521,Rockadoodle,tichondrius,1409,warrior,arms,60,30,30
59522,Bellonar,stormrage,1408,warrior,arms,32,20,12
59523,Utgarde,stormrage,1408,warrior,arms,200,101,99
59524,Rokó,illidan,1408,warrior,arms,84,41,43
59525,Haxzors,sargeras,1408,warrior,arms,60,26,34
59526,Warthorns,malganis,1408,warrior,arms,49,17,32
59527,Jøq,ragnaros,1407,warrior,arms,30,17,13
59528,Solano,illidan,1405,warrior,arms,48,30,18
59529,Warb,aggramar,1405,warrior,arms,93,48,45
59530,Bruttallis,frostmane,1405,warrior,arms,51,25,26
59531,Hoodlark,lightbringer,1405,warrior,arms,78,30,48
59532,Baix,frostmourne,1404,warrior,arms,63,35,28
59533,Tithousand,tichondrius,1404,warrior,arms,45,24,21
59534,Yummysushi,gorgonnash,1404,warrior,arms,76,31,45
59535,Tdestroy,ragnaros,1403,warrior,arms,45,24,21
59536,Najarath,barthilas,1403,warrior,arms,36,19,17
59537,Xiosè,ragnaros,1403,warrior,arms,66,32,34
59538,Mortalstrike,chogall,1403,warrior,arms,52,25,27
59539,Aloloco,ragnaros,1403,warrior,arms,66,30,36
59540,Zareos,azralon,1403,warrior,arms,40,17,23
59541,Asgér,quelthalas,1403,warrior,arms,114,46,68
59542,Bløødy,lethon,1402,warrior,arms,26,17,9
59543,Gusbus,malganis,1402,warrior,arms,121,65,56
59544,Machineofwar,zuluhed,1402,warrior,arms,150,72,78
59545,Chacca,suramar,1401,warrior,arms,36,25,11
59546,Luckyw,draktharon,1401,warrior,arms,48,27,21
59547,Supremegalek,tichondrius,1401,warrior,arms,88,46,42
59548,Sigfir,ragnaros,1401,warrior,arms,76,36,40
59549,Aión,nemesis,1400,warrior,arms,24,17,7
59550,Thaisyta,tichondrius,1400,warrior,arms,30,19,11
59551,Flintish,moon-guard,1400,warrior,arms,71,43,28
59552,Dubstoob,illidan,1400,warrior,arms,148,77,71
59553,Buntpunt,mannoroth,1400,warrior,arms,109,53,56
59554,Peeb,tichondrius,1399,warrior,arms,30,15,15
59555,Hêllseeker,ragnaros,1399,warrior,arms,78,37,41
59556,Tern,emerald-dream,1398,warrior,arms,82,42,40
59557,Blightscream,bleeding-hollow,1397,warrior,arms,229,109,120
59558,Handkerchief,bleeding-hollow,1397,warrior,arms,37,16,21
59559,Tenebrous,nemesis,1397,warrior,arms,48,20,28
59560,Wanabea,tichondrius,1396,warrior,arms,42,17,25
59561,Grimreáper,bleeding-hollow,1396,warrior,arms,90,35,55
59562,Sokõ,tichondrius,1394,warrior,arms,48,28,20
59563,Varith,sargeras,1394,warrior,arms,36,20,16
59564,Ponchetas,quelthalas,1394,warrior,arms,96,46,50
59565,Fenømenoide,ragnaros,1392,warrior,arms,60,40,20
59566,Vanglorio,azralon,1392,warrior,arms,81,44,37
59567,Zaulgoodman,sargeras,1392,warrior,arms,30,15,15
59568,Zaurka,sargeras,1391,warrior,arms,30,18,12
59569,Bigster,malganis,1391,warrior,arms,30,16,14
59570,Nicegirl,sargeras,1391,warrior,arms,69,36,33
59571,Ayuko,greymane,1391,warrior,arms,47,23,24
59572,Coolade,thunderhorn,1391,warrior,arms,106,51,55
59573,Swordmasters,icecrown,1391,warrior,arms,77,37,40
59574,Zeerohkool,tichondrius,1391,warrior,arms,102,46,56
59575,Yazia,stormrage,1391,warrior,arms,42,17,25
59576,Magnar,zuljin,1389,warrior,arms,60,34,26
59577,Kiranoma,moon-guard,1389,warrior,arms,38,19,19
59578,Alexitwo,ragnaros,1388,warrior,arms,72,38,34
59579,Apallô,tichondrius,1388,warrior,arms,89,40,49
59580,Odrak,ragnaros,1388,warrior,arms,81,35,46
59581,Rekcd,sargeras,1387,warrior,arms,36,23,13
59582,Nãrax,area-52,1387,warrior,arms,40,20,20
59583,Demonsláyer,illidan,1387,warrior,arms,30,15,15
59584,Riderless,ragnaros,1387,warrior,arms,30,15,15
59585,Gilgaméshh,tichondrius,1387,warrior,arms,54,23,31
59586,Topmeoff,bleeding-hollow,1387,warrior,arms,42,16,26
59587,Cecchino,zuluhed,1386,warrior,arms,48,25,23
59588,Stoneshield,senjin,1386,warrior,arms,29,15,14
59589,Ninefingers,madoran,1386,warrior,arms,78,38,40
59590,Momojojo,daggerspine,1385,warrior,arms,26,18,8
59591,Morhgath,bonechewer,1385,warrior,arms,49,26,23
59592,Retros,kelthuzad,1385,warrior,arms,72,37,35
59593,Caupølican,ragnaros,1385,warrior,arms,76,37,39
59594,Soniixz,ragnaros,1385,warrior,arms,62,30,32
59595,Yirko,quelthalas,1385,warrior,arms,74,31,43
59596,Nightshauyia,kelthuzad,1384,warrior,arms,69,37,32
59597,Twobyfuor,sargeras,1383,warrior,arms,65,33,32
59598,Bobandi,tichondrius,1383,warrior,arms,34,16,18
59599,Raygé,malygos,1383,warrior,arms,45,21,24
59600,Disarmiea,cairne,1383,warrior,arms,87,40,47
59601,Fazeo,madoran,1382,warrior,arms,27,15,12
59602,Rongkhunxyz,tichondrius,1382,warrior,arms,54,28,26
59603,Ghostss,tichondrius,1382,warrior,arms,67,29,38
59604,Eîghtysîx,sargeras,1382,warrior,arms,100,43,57
59605,Rivenz,moon-guard,1382,warrior,arms,57,20,37
59606,Ukris,area-52,1381,warrior,arms,119,62,57
59607,Verain,thrall,1381,warrior,arms,36,17,19
59608,Bagur,ragnaros,1380,warrior,arms,114,61,53
59609,Typhön,tichondrius,1380,warrior,arms,77,31,46
59610,Gooshin,sargeras,1379,warrior,arms,127,65,62
59611,Dinogc,barthilas,1379,warrior,arms,44,21,23
59612,Rägar,quelthalas,1378,warrior,arms,67,33,34
59613,Edwiddin,frostmourne,1378,warrior,arms,72,32,40
59614,Killtarget,tichondrius,1377,warrior,arms,82,45,37
59615,Gwendolynl,hyjal,1377,warrior,arms,73,35,38
59616,Bjjorm,malganis,1377,warrior,arms,42,15,27
59617,Tusktrollmon,illidan,1376,warrior,arms,128,63,65
59618,Mafe,tichondrius,1375,warrior,arms,58,28,30
59619,Janlei,quelthalas,1375,warrior,arms,76,35,41
59620,Yoruba,burning-blade,1375,warrior,arms,67,29,38
59621,Beowúlf,burning-blade,1375,warrior,arms,41,16,25
59622,Dolkal,tichondrius,1375,warrior,arms,57,21,36
59623,Hopar,illidan,1374,warrior,arms,54,31,23
59624,Danzohh,dalaran,1374,warrior,arms,33,15,18
59625,Týrodar,moon-guard,1374,warrior,arms,54,24,30
59626,Jottman,tichondrius,1374,warrior,arms,135,54,81
59627,Groxxigore,chogall,1373,warrior,arms,111,62,49
59628,Blokz,arthas,1373,warrior,arms,72,40,32
59629,Rhohan,ysera,1373,warrior,arms,83,40,43
59630,Kowboy,stormrage,1372,warrior,arms,130,66,64
59631,Rushour,quelthalas,1372,warrior,arms,32,15,17
59632,Novastormer,barthilas,1372,warrior,arms,69,30,39
59633,Storkos,moon-guard,1371,warrior,arms,107,57,50
59634,Kantorowicz,goldrinn,1371,warrior,arms,78,40,38
59635,Ragepocket,proudmoore,1371,warrior,arms,66,32,34
59636,Ðarkstar,zuljin,1370,warrior,arms,140,62,78
59637,Northhill,tichondrius,1368,warrior,arms,120,64,56
59638,Budzie,frostwolf,1368,warrior,arms,40,21,19
59639,Zaexx,stormrage,1368,warrior,arms,65,32,33
59640,Pelonna,drakkari,1368,warrior,arms,154,75,79
59641,Powerhard,area-52,1368,warrior,arms,57,26,31
59642,Monkedurant,tichondrius,1367,warrior,arms,30,18,12
59643,Dhakhota,azralon,1367,warrior,arms,42,22,20
59644,Superdah,kiljaeden,1367,warrior,arms,72,36,36
59645,Dhaemom,azralon,1366,warrior,arms,133,69,64
59646,Evilkorean,tichondrius,1366,warrior,arms,59,29,30
59647,Noppô,tichondrius,1366,warrior,arms,42,15,27
59648,Doomreaper,hellscream,1365,warrior,arms,113,57,56
59649,Zugnut,tichondrius,1365,warrior,arms,70,34,36
59650,Xenowar,alleria,1365,warrior,arms,108,48,60
59651,Durko,whisperwind,1365,warrior,arms,36,16,20
59652,Natedógg,tichondrius,1365,warrior,arms,41,17,24
59653,Ragnarwar,azralon,1364,warrior,arms,69,39,30
59654,Looffy,saurfang,1364,warrior,arms,114,59,55
59655,Juicey,burning-blade,1364,warrior,arms,55,28,27
59656,Juggerboo,frostmourne,1364,warrior,arms,131,64,67
59657,Tÿÿr,azralon,1364,warrior,arms,60,26,34
59658,Danzael,quelthalas,1364,warrior,arms,42,18,24
59659,Xampuu,ragnaros,1363,warrior,arms,34,20,14
59660,Theragar,kilrogg,1363,warrior,arms,36,20,16
59661,Sevala,spinebreaker,1363,warrior,arms,58,32,26
59662,Ooktanx,emerald-dream,1363,warrior,arms,38,15,23
59663,Neozsmash,thrall,1362,warrior,arms,58,29,29
59664,Josephcrazy,tichondrius,1362,warrior,arms,30,15,15
59665,Fuknazum,gundrak,1362,warrior,arms,190,92,98
59666,Mjorn,sargeras,1362,warrior,arms,64,30,34
59667,Yummybumbum,barthilas,1362,warrior,arms,60,26,34
59668,Arashikage,malganis,1361,warrior,arms,40,18,22
59669,Mervyn,aegwynn,1360,warrior,arms,48,29,19
59670,Allgas,barthilas,1360,warrior,arms,107,58,49
59671,Tikkò,tichondrius,1360,warrior,arms,62,33,29
59672,Devil,illidan,1360,warrior,arms,33,17,16
59673,Warsaínt,area-52,1360,warrior,arms,65,31,34
59674,Krakitus,azralon,1360,warrior,arms,99,43,56
59675,Klingensturm,thrall,1359,warrior,arms,25,15,10
59676,Lègèndáry,dark-iron,1359,warrior,arms,48,21,27
59677,Tigo,khaz-modan,1358,warrior,arms,87,47,40
59678,Franc,kiljaeden,1358,warrior,arms,41,22,19
59679,Kilrosao,nordrassil,1358,warrior,arms,89,45,44
59680,Davidorco,drakkari,1358,warrior,arms,41,19,22
59681,Saltyundies,tichondrius,1358,warrior,arms,123,56,67
59682,Ightdoex,zuljin,1357,warrior,arms,32,22,10
59683,Kleavage,korgath,1357,warrior,arms,67,31,36
59684,Estivador,kelthuzad,1357,warrior,arms,62,27,35
59685,Pangpou,tichondrius,1355,warrior,arms,156,83,73
59686,Magnusson,kelthuzad,1354,warrior,arms,36,16,20
59687,Lowlow,lightbringer,1354,warrior,arms,36,16,20
59688,Kittybang,quelthalas,1354,warrior,arms,71,29,42
59689,Seariphim,lothar,1353,warrior,arms,45,24,21
59690,Jhave,ragnaros,1353,warrior,arms,44,22,22
59691,Silverkiller,drakkari,1352,warrior,arms,57,29,28
59692,Rapralph,barthilas,1352,warrior,arms,54,26,28
59693,Biloni,ragnaros,1352,warrior,arms,42,18,24
59694,Browneyed,area-52,1352,warrior,arms,36,15,21
59695,Zroz,ragnaros,1351,warrior,arms,63,34,29
59696,Toagrim,azralon,1351,warrior,arms,66,31,35
59697,Nviv,proudmoore,1351,warrior,arms,90,40,50
59698,Pírlo,ragnaros,1351,warrior,arms,42,18,24
59699,Devilsbane,khaz-modan,1350,warrior,arms,84,44,40
59700,Badmanego,illidan,1350,warrior,arms,61,28,33
59701,Hiddensquidd,stormrage,1349,warrior,arms,57,35,22
59702,Mightypower,gurubashi,1349,warrior,arms,30,17,13
59703,Hippy,kiljaeden,1349,warrior,arms,34,19,15
59704,Dreadwarr,stormrage,1349,warrior,arms,56,30,26
59705,Tinydingo,sargeras,1349,warrior,arms,36,19,17
59706,Rampage,azralon,1349,warrior,arms,125,59,66
59707,Vayper,illidan,1349,warrior,arms,71,33,38
59708,Themonsterr,stormrage,1349,warrior,arms,34,15,19
59709,Jellybomb,sargeras,1348,warrior,arms,216,104,112
59710,Jsolucky,thrall,1348,warrior,arms,36,15,21
59711,Thorado,nemesis,1347,warrior,arms,166,81,85
59712,Odrath,tichondrius,1347,warrior,arms,96,46,50
59713,Velarael,stormscale,1347,warrior,arms,46,22,24
59714,Dimus,area-52,1347,warrior,arms,36,15,21
59715,Skrot,stormrage,1346,warrior,arms,64,34,30
59716,Rasgriz,moon-guard,1346,warrior,arms,43,20,23
59717,Sonezwar,thrall,1345,warrior,arms,72,36,36
59718,Taürok,azralon,1345,warrior,arms,48,23,25
59719,Ðuratestön,azralon,1345,warrior,arms,36,16,20
59720,Juff,hakkar,1344,warrior,arms,70,36,34
59721,ßaldbornë,stormrage,1344,warrior,arms,94,47,47
59722,Jeffyd,bleeding-hollow,1344,warrior,arms,48,16,32
59723,Dackøzzt,quelthalas,1343,warrior,arms,24,14,10
59724,Warraaxx,stonemaul,1343,warrior,arms,48,25,23
59725,Lagzistance,area-52,1343,warrior,arms,30,14,16
59726,Notmagnusz,zuljin,1343,warrior,arms,30,14,16
59727,Legday,stormrage,1343,warrior,arms,30,14,16
59728,Orangesoda,tichondrius,1342,warrior,arms,24,14,10
59729,Gorrock,dreadmaul,1342,warrior,arms,72,35,37
59730,Kinzi,quelthalas,1342,warrior,arms,153,67,86
59731,Andeadw,tichondrius,1341,warrior,arms,21,15,6
59732,Mcflury,skullcrusher,1341,warrior,arms,24,14,10
59733,Kurdt,tichondrius,1341,warrior,arms,24,14,10
59734,Rage,uther,1341,warrior,arms,30,14,16
59735,Horcules,kiljaeden,1341,warrior,arms,47,19,28
59736,Xvett,drakkari,1340,warrior,arms,102,57,45
59737,Gentlehugs,illidan,1340,warrior,arms,36,14,22
59738,Nerdstorm,tichondrius,1338,warrior,arms,24,14,10
59739,Garysmalls,kelthuzad,1338,warrior,arms,24,14,10
59740,Gáren,quelthalas,1338,warrior,arms,24,14,10
59741,Eskobar,magtheridon,1338,warrior,arms,29,15,14
59742,Warrmoose,tichondrius,1338,warrior,arms,30,14,16
59743,Gavfields,tichondrius,1337,warrior,arms,24,14,10
59744,Allenwrite,frostmourne,1337,warrior,arms,48,21,27
59745,Småckin,frostmourne,1336,warrior,arms,52,31,21
59746,Suntore,malganis,1336,warrior,arms,24,14,10
59747,Govosh,thrall,1336,warrior,arms,24,14,10
59748,Laygoh,zuljin,1336,warrior,arms,24,14,10
59749,Ketaqt,illidan,1336,warrior,arms,26,15,11
59750,Azog,bleeding-hollow,1336,warrior,arms,48,25,23
59751,Kelidar,kaelthas,1336,warrior,arms,60,31,29
59752,Arm,stormscale,1336,warrior,arms,62,30,32
59753,Viagraliker,tichondrius,1336,warrior,arms,44,19,25
59754,Rhorix,korialstrasz,1336,warrior,arms,36,14,22
59755,Wesih,ragnaros,1336,warrior,arms,60,22,38
59756,Unbeatablezs,tichondrius,1335,warrior,arms,96,51,45
59757,Tooto,kelthuzad,1335,warrior,arms,30,15,15
59758,Xenoblade,wildhammer,1335,warrior,arms,48,21,27
59759,Teedubbs,antonidas,1335,warrior,arms,48,19,29
59760,Bwhaha,frostwolf,1334,warrior,arms,36,26,10
59761,Frosto,nemesis,1334,warrior,arms,24,14,10
59762,Rageinice,tichondrius,1334,warrior,arms,42,21,21
59763,Prodigál,dalaran,1334,warrior,arms,36,15,21
59764,Slammshady,tichondrius,1333,warrior,arms,21,15,6
59765,Thegoochgoon,malorne,1333,warrior,arms,67,36,31
59766,Barricade,velen,1333,warrior,arms,131,64,67
59767,Kolacut,tichondrius,1332,warrior,arms,24,14,10
59768,Jijiyeya,tichondrius,1332,warrior,arms,36,17,19
59769,Blackwulff,korgath,1332,warrior,arms,66,29,37
59770,Waabi,emerald-dream,1331,warrior,arms,30,18,12
59771,Necco,lothar,1331,warrior,arms,36,16,20
59772,Cainne,proudmoore,1330,warrior,arms,30,19,11
59773,Lexxsteele,mugthol,1330,warrior,arms,24,14,10
59774,Carken,kiljaeden,1330,warrior,arms,36,20,16
59775,Doomreaprr,hellscream,1330,warrior,arms,50,27,23
59776,Kilroywar,tichondrius,1329,warrior,arms,30,14,16
59777,Illicitkillz,destromath,1329,warrior,arms,30,14,16
59778,Hadesz,nazjatar,1328,warrior,arms,83,45,38
59779,Nuclearfury,khadgar,1328,warrior,arms,60,31,29
59780,Roitty,proudmoore,1328,warrior,arms,61,28,33
59781,Fixafflock,bleeding-hollow,1327,warrior,arms,24,14,10
59782,Chilicezo,durotan,1327,warrior,arms,65,37,28
59783,Cyllå,frostmourne,1327,warrior,arms,33,18,15
59784,Qookymonster,zuljin,1327,warrior,arms,106,56,50
59785,Kalnor,dark-iron,1327,warrior,arms,50,26,24
59786,Kourny,frostmourne,1327,warrior,arms,87,42,45
59787,Ketasshi,kelthuzad,1327,warrior,arms,36,14,22
59788,Twistwarr,area-52,1326,warrior,arms,24,14,10
59789,Greywo,tichondrius,1326,warrior,arms,67,38,29
59790,Iyamii,hyjal,1326,warrior,arms,35,19,16
59791,Zuljikan,illidan,1326,warrior,arms,47,16,31
59792,Sloppyglucks,moon-guard,1325,warrior,arms,30,15,15
59793,Icarrus,frostmourne,1325,warrior,arms,30,14,16
59794,Boocawkeyy,illidan,1325,warrior,arms,60,23,37
59795,Colosal,drakkari,1324,warrior,arms,33,20,13
59796,Brontok,darkspear,1324,warrior,arms,64,33,31
59797,Tasilia,tichondrius,1324,warrior,arms,30,14,16
59798,Mitered,tichondrius,1323,warrior,arms,39,19,20
59799,Kolossux,ragnaros,1323,warrior,arms,108,50,58
59800,Overfury,azralon,1322,warrior,arms,36,18,18
59801,Datsongz,proudmoore,1322,warrior,arms,120,59,61
59802,Gizzmo,bonechewer,1322,warrior,arms,36,14,22
59803,Venecus,stormrage,1321,warrior,arms,30,14,16
59804,Lelànd,kelthuzad,1320,warrior,arms,30,14,16
59805,Macsen,zuljin,1319,warrior,arms,36,18,18
59806,Semyus,ragnaros,1319,warrior,arms,65,32,33
59807,Linçpin,tichondrius,1319,warrior,arms,60,29,31
59808,Thrawb,bleeding-hollow,1319,warrior,arms,33,15,18
59809,Toragorr,illidan,1318,warrior,arms,24,15,9
59810,Gï,fizzcrank,1318,warrior,arms,24,14,10
59811,Chargeback,zuljin,1318,warrior,arms,63,34,29
59812,Arkayko,quelthalas,1318,warrior,arms,28,15,13
59813,Lujzika,stormreaver,1318,warrior,arms,39,17,22
59814,Calmaah,frostmourne,1317,warrior,arms,63,33,30
59815,Swamis,stormreaver,1315,warrior,arms,54,27,27
59816,Kappis,illidan,1315,warrior,arms,59,29,30
59817,Drippyjones,sargeras,1315,warrior,arms,54,26,28
59818,Bùlk,barthilas,1315,warrior,arms,112,49,63
59819,Dennlss,quelthalas,1315,warrior,arms,114,49,65
59820,Vondrack,ragnaros,1315,warrior,arms,83,34,49
59821,Tribbally,silver-hand,1314,warrior,arms,49,26,23
59822,Tenserr,kiljaeden,1314,warrior,arms,33,17,16
59823,Fuller,kelthuzad,1314,warrior,arms,36,18,18
59824,Ragehir,thrall,1314,warrior,arms,31,15,16
59825,Loothar,goldrinn,1313,warrior,arms,137,68,69
59826,Wreckz,blood-furnace,1312,warrior,arms,78,42,36
59827,Tenchuu,azralon,1312,warrior,arms,130,56,74
59828,Logi,alexstrasza,1312,warrior,arms,42,17,25
59829,Qtcrow,frostmourne,1310,warrior,arms,78,39,39
59830,Sseobeon,tichondrius,1310,warrior,arms,28,14,14
59831,Tunasurprize,stormrage,1310,warrior,arms,33,16,17
59832,Doomtree,zuljin,1309,warrior,arms,18,14,4
59833,Makcumba,ragnaros,1309,warrior,arms,54,29,25
59834,Verigislena,moon-guard,1309,warrior,arms,56,28,28
59835,Jalaskâ,azralon,1309,warrior,arms,82,39,43
59836,Kipqt,frostmourne,1309,warrior,arms,30,14,16
59837,Zeerohkool,malganis,1308,warrior,arms,140,62,78
59838,Daymiian,blackrock,1308,warrior,arms,42,17,25
59839,Mickyplate,tichondrius,1307,warrior,arms,78,39,39
59840,Notsi,ragnaros,1307,warrior,arms,66,28,38
59841,Aldérmach,zuljin,1306,warrior,arms,112,57,55
59842,Syllana,sargeras,1306,warrior,arms,30,15,15
59843,Velarrine,illidan,1306,warrior,arms,89,39,50
59844,Noelglz,quelthalas,1305,warrior,arms,23,14,9
59845,Knghtofseven,nemesis,1305,warrior,arms,72,39,33
59846,Exxic,zuljin,1305,warrior,arms,42,21,21
59847,Vemue,tichondrius,1305,warrior,arms,172,84,88
59848,Fûry,barthilas,1305,warrior,arms,30,14,16
59849,Auxthas,tichondrius,1305,warrior,arms,30,14,16
59850,Timbajimba,silvermoon,1305,warrior,arms,58,27,31
59851,Rhagnael,malganis,1305,warrior,arms,72,30,42
59852,Broxigore,nerzhul,1305,warrior,arms,48,14,34
59853,Raekor,tichondrius,1304,warrior,arms,42,25,17
59854,Zuggarnaught,tichondrius,1304,warrior,arms,82,44,38
59855,Dreweth,altar-of-storms,1304,warrior,arms,30,16,14
59856,Pum,bleeding-hollow,1304,warrior,arms,30,14,16
59857,Marraneitor,quelthalas,1303,warrior,arms,60,29,31
59858,Swiftui,nemesis,1303,warrior,arms,87,39,48
59859,Deadee,aerie-peak,1302,warrior,arms,100,48,52
59860,Akj,sargeras,1302,warrior,arms,54,23,31
59861,Ludicrous,dreadmaul,1302,warrior,arms,85,36,49
59862,Kayaburn,tichondrius,1301,warrior,arms,24,19,5
59863,Donhoolio,illidan,1301,warrior,arms,24,14,10
59864,Ximzhao,quelthalas,1301,warrior,arms,67,32,35
59865,Legolant,uther,1301,warrior,arms,30,14,16
59866,Beserkqt,azralon,1301,warrior,arms,48,20,28
59867,Erdres,kelthuzad,1301,warrior,arms,75,27,48
59868,Warnick,illidan,1300,warrior,arms,72,35,37
59869,Pvpheart,tichondrius,1299,warrior,arms,47,27,20
59870,Krostyx,ragnaros,1299,warrior,arms,72,40,32
59871,Arrozkonlech,proudmoore,1299,warrior,arms,31,17,14
59872,Chawp,emerald-dream,1299,warrior,arms,47,24,23
59873,Bluthammer,wyrmrest-accord,1299,warrior,arms,35,16,19
59874,Babamama,tichondrius,1299,warrior,arms,44,20,24
59875,Stewwar,wyrmrest-accord,1298,warrior,arms,26,16,10
59876,Warrdawg,tichondrius,1298,warrior,arms,36,20,16
59877,Aresmt,illidan,1298,warrior,arms,30,14,16
59878,Ccmeharder,kiljaeden,1298,warrior,arms,30,14,16
59879,Rekem,malganis,1298,warrior,arms,78,35,43
59880,Papaming,tichondrius,1298,warrior,arms,72,32,40
59881,Xufoxpikmin,gurubashi,1298,warrior,arms,106,46,60
59882,Kitonic,proudmoore,1296,warrior,arms,29,18,11
59883,Guitter,nazjatar,1296,warrior,arms,48,20,28
59884,Bustybucky,tichondrius,1296,warrior,arms,42,14,28
59885,Beeny,tichondrius,1295,warrior,arms,33,14,19
59886,Darthbjorn,lethon,1294,warrior,arms,48,28,20
59887,Superpot,bleeding-hollow,1294,warrior,arms,48,22,26
59888,Angertooth,tichondrius,1293,warrior,arms,30,14,16
59889,Crú,stormrage,1293,warrior,arms,30,14,16
59890,Xl,quelthalas,1292,warrior,arms,108,50,58
59891,Weepingdeath,burning-legion,1292,warrior,arms,72,33,39
59892,Lobsterrj,emerald-dream,1292,warrior,arms,48,19,29
59893,Deomer,quelthalas,1291,warrior,arms,36,18,18
59894,Noobslayr,wyrmrest-accord,1290,warrior,arms,30,18,12
59895,Ønì,tichondrius,1289,warrior,arms,48,35,13
59896,Grumok,tichondrius,1289,warrior,arms,57,24,33
59897,Ðigger,rivendare,1288,warrior,arms,42,19,23
59898,Balakay,drenden,1287,warrior,arms,24,15,9
59899,Hikikomori,goldrinn,1287,warrior,arms,65,35,30
59900,Walterwhîte,tichondrius,1287,warrior,arms,30,14,16
59901,Weesten,aerie-peak,1286,warrior,arms,24,16,8
59902,Utheroellin,stormrage,1286,warrior,arms,30,15,15
59903,Terók,stormrage,1286,warrior,arms,48,20,28
59904,Egargiss,malygos,1285,warrior,arms,24,14,10
59905,Hatedßyßlízz,area-52,1285,warrior,arms,48,21,27
59906,Skornnd,malganis,1285,warrior,arms,82,35,47
59907,Ðåddý,stormrage,1285,warrior,arms,41,14,27
59908,Repsey,zuljin,1284,warrior,arms,23,15,8
59909,Sllvrbck,tichondrius,1284,warrior,arms,28,17,11
59910,Niudazhuang,tichondrius,1284,warrior,arms,106,56,50
59911,Valde,stormrage,1284,warrior,arms,27,14,13
59912,Deadhawk,wyrmrest-accord,1284,warrior,arms,84,36,48
59913,Ashrah,emerald-dream,1283,warrior,arms,54,29,25
59914,Dualip,tichondrius,1283,warrior,arms,75,38,37
59915,Excaliburz,frostmourne,1283,warrior,arms,101,48,53
59916,Ñors,spinebreaker,1283,warrior,arms,36,15,21
59917,Rnkman,quelthalas,1282,warrior,arms,25,16,9
59918,Putong,tichondrius,1282,warrior,arms,53,29,24
59919,Homicideted,frostmourne,1282,warrior,arms,66,34,32
59920,Kagerou,ragnaros,1282,warrior,arms,62,28,34
59921,Heals,zuljin,1282,warrior,arms,36,15,21
59922,Shishokun,quelthalas,1281,warrior,arms,88,35,53
59923,Mussashí,stormrage,1280,warrior,arms,70,41,29
59924,Elíte,kelthuzad,1280,warrior,arms,30,14,16
59925,Orz,sargeras,1280,warrior,arms,37,15,22
59926,Menestz,dreadmaul,1279,warrior,arms,71,36,35
59927,Maywarro,ragnaros,1279,warrior,arms,77,35,42
59928,Rhâêgâr,tichondrius,1278,warrior,arms,48,26,22
59929,Onionion,stormrage,1278,warrior,arms,30,14,16
59930,Korsarro,frostmourne,1278,warrior,arms,98,45,53
59931,Gosariw,tichondrius,1278,warrior,arms,33,15,18
59932,Junsus,moon-guard,1278,warrior,arms,65,29,36
59933,Bfrenzy,dalaran,1278,warrior,arms,42,18,24
59934,Mogtash,blackrock,1278,warrior,arms,41,16,25
59935,Zeiyah,quelthalas,1277,warrior,arms,24,14,10
59936,Irix,tichondrius,1277,warrior,arms,129,63,66
59937,Chrosis,norgannon,1277,warrior,arms,71,27,44
59938,Aintou,aegwynn,1276,warrior,arms,42,20,22
59939,Udô,proudmoore,1275,warrior,arms,36,14,22
59940,Toxxel,wyrmrest-accord,1275,warrior,arms,65,23,42
59941,Naxxiki,wyrmrest-accord,1274,warrior,arms,186,91,95
59942,Rickyxp,aggramar,1274,warrior,arms,54,26,28
59943,Squeekzz,frostmane,1273,warrior,arms,62,31,31
59944,Swám,quelthalas,1273,warrior,arms,36,16,20
59945,Amrap,dentarg,1273,warrior,arms,37,16,21
59946,Krazyguerra,bleeding-hollow,1272,warrior,arms,48,26,22
59947,Arox,ghostlands,1272,warrior,arms,60,30,30
59948,Dëkm,quelthalas,1272,warrior,arms,41,18,23
59949,Mfmuggz,thunderlord,1271,warrior,arms,47,23,24
59950,Sneeze,kul-tiras,1271,warrior,arms,52,25,27
59951,Hunnam,illidan,1269,warrior,arms,42,16,26
59952,Azrielsc,vashj,1268,warrior,arms,48,23,25
59953,Thorablade,barthilas,1268,warrior,arms,96,44,52
59954,Loucha,nagrand,1268,warrior,arms,75,32,43
59955,Eudora,stormrage,1267,warrior,arms,72,38,34
59956,Bdubz,moknathal,1266,warrior,arms,29,14,15
59957,Catastrophie,mugthol,1266,warrior,arms,87,39,48
59958,Spartaner,shadowsong,1265,warrior,arms,36,14,22
59959,Seshømaru,quelthalas,1264,warrior,arms,26,15,11
59960,Spitfired,kiljaeden,1264,warrior,arms,36,19,17
59961,Hoodlord,tichondrius,1264,warrior,arms,60,28,32
59962,Timotheapple,stormrage,1264,warrior,arms,32,14,18
59963,Elane,moon-guard,1264,warrior,arms,72,28,44
59964,Ready,laughing-skull,1263,warrior,arms,54,30,24
59965,Thelgrath,quelthalas,1263,warrior,arms,136,66,70
59966,Punnisher,nerzhul,1263,warrior,arms,29,14,15
59967,Krimmjðw,sargeras,1263,warrior,arms,36,14,22
59968,Vamtoro,illidan,1262,warrior,arms,50,28,22
59969,Golinn,aerie-peak,1262,warrior,arms,54,24,30
59970,Babyguns,tichondrius,1262,warrior,arms,66,29,37
59971,Ivanovh,quelthalas,1261,warrior,arms,180,90,90
59972,Viladoht,aegwynn,1261,warrior,arms,30,14,16
59973,Knewty,stormrage,1261,warrior,arms,32,14,18
59974,Hudë,stormrage,1260,warrior,arms,36,19,17
59975,Laynarri,hyjal,1260,warrior,arms,60,28,32
59976,Irongummy,frostmourne,1260,warrior,arms,60,27,33
59977,Golîath,mannoroth,1260,warrior,arms,85,37,48
59978,Beiron,ragnaros,1259,warrior,arms,24,15,9
59979,Monardaid,uldum,1259,warrior,arms,42,17,25
59980,Tämuros,thrall,1258,warrior,arms,64,32,32
59981,Wrathena,khadgar,1258,warrior,arms,55,26,29
59982,Rockystyle,tichondrius,1256,warrior,arms,72,38,34
59983,Selathiel,burning-blade,1256,warrior,arms,40,16,24
59984,Carralee,azralon,1255,warrior,arms,72,42,30
59985,Queterompo,ragnaros,1255,warrior,arms,66,36,30
59986,Cbum,quelthalas,1255,warrior,arms,72,34,38
59987,Aleniá,tichondrius,1255,warrior,arms,79,37,42
59988,Rawlur,zuljin,1255,warrior,arms,41,16,25
59989,Blacksmiff,malganis,1254,warrior,arms,120,64,56
59990,Laint,wyrmrest-accord,1254,warrior,arms,146,73,73
59991,Lilboytroy,korgath,1253,warrior,arms,36,15,21
59992,Croxxs,aegwynn,1253,warrior,arms,50,17,33
59993,Huri,nemesis,1252,warrior,arms,80,45,35
59994,Tyrantwolf,ragnaros,1252,warrior,arms,69,35,34
59995,Magmaheart,lightbringer,1251,warrior,arms,30,14,16
59996,Cauldrin,bleeding-hollow,1251,warrior,arms,132,61,71
59997,Maimif,korgath,1251,warrior,arms,35,16,19
59998,Hblock,barthilas,1251,warrior,arms,45,16,29
59999,Rageoverdose,burning-legion,1250,warrior,arms,135,66,69
60000,Bloodwish,stormrage,1249,warrior,arms,58,32,26
60001,Âmânthul,alexstrasza,1249,warrior,arms,218,116,102
60002,Rodhin,proudmoore,1249,warrior,arms,47,22,25
60003,Brynjah,azralon,1249,warrior,arms,90,40,50
60004,Invinciblé,tichondrius,1248,warrior,arms,24,13,11
60005,Sowavey,korgath,1248,warrior,arms,24,13,11
60006,Bersorcker,ragnaros,1248,warrior,arms,74,29,45
60007,Raizzw,ragnaros,1247,warrior,arms,18,13,5
60008,Areaves,moon-guard,1247,warrior,arms,24,13,11
60009,Codyjones,illidan,1247,warrior,arms,24,13,11
60010,Herey,moon-guard,1247,warrior,arms,24,13,11
60011,Sabotender,suramar,1247,warrior,arms,30,13,17
60012,Scotteh,eredar,1247,warrior,arms,30,13,17
60013,Cowstik,illidan,1246,warrior,arms,24,13,11
60014,Marrago,moon-guard,1246,warrior,arms,24,13,11
60015,Callad,tichondrius,1246,warrior,arms,47,22,25
60016,Lilfookur,dalaran,1246,warrior,arms,82,37,45
60017,Schizogeist,malganis,1246,warrior,arms,40,18,22
60018,Betterwar,zuljin,1246,warrior,arms,30,13,17
60019,Spearmisser,stormrage,1246,warrior,arms,30,13,17
60020,Warhji,malganis,1246,warrior,arms,30,13,17
60021,Sleepypie,tichondrius,1245,warrior,arms,18,13,5
60022,Catwar,tichondrius,1245,warrior,arms,18,13,5
60023,Aqee,illidan,1245,warrior,arms,66,37,29
60024,Hashwar,area-52,1245,warrior,arms,24,13,11
60025,Tankomode,area-52,1245,warrior,arms,30,13,17
60026,Reichbeast,area-52,1244,warrior,arms,18,13,5
60027,Rarelinew,malganis,1244,warrior,arms,18,13,5
60028,Rollz,amanthul,1244,warrior,arms,52,22,30
60029,Nativê,sargeras,1244,warrior,arms,36,13,23
60030,Flèx,stormrage,1243,warrior,arms,24,13,11
60031,Mokrog,bleeding-hollow,1243,warrior,arms,24,13,11
60032,Andorane,bleeding-hollow,1243,warrior,arms,24,13,11
60033,Dutchyy,frostmourne,1243,warrior,arms,24,13,11
60034,Malvicious,proudmoore,1243,warrior,arms,24,13,11
60035,Antoníuz,drakkari,1243,warrior,arms,42,16,26
60036,Flexinbooty,kelthuzad,1243,warrior,arms,36,13,23
60037,Dukagã,tichondrius,1242,warrior,arms,18,13,5
60038,Ystk,tichondrius,1242,warrior,arms,24,13,11
60039,Thunderclapz,stormscale,1242,warrior,arms,30,16,14
60040,Hoshigaki,frostmourne,1242,warrior,arms,65,32,33
60041,Metalbiff,bleeding-hollow,1242,warrior,arms,30,13,17
60042,Gíal,ragnaros,1242,warrior,arms,64,26,38
60043,Titanika,wyrmrest-accord,1242,warrior,arms,72,28,44
60044,Gaydin,eldrethalas,1242,warrior,arms,39,15,24
60045,Ragedump,shadowsong,1241,warrior,arms,26,13,13
60046,Titanrage,tichondrius,1241,warrior,arms,32,14,18
60047,Qtxd,malganis,1240,warrior,arms,24,13,11
60048,Broxhar,ragnaros,1240,warrior,arms,53,26,27
60049,Deamonkiller,kelthuzad,1240,warrior,arms,103,45,58
60050,Rahj,caelestrasz,1240,warrior,arms,30,13,17
60051,Jaminos,frostmourne,1240,warrior,arms,51,22,29
60052,Ðhrâgøn,ragnaros,1239,warrior,arms,18,15,3
60053,Airhood,frostmourne,1239,warrior,arms,18,13,5
60054,Mezi,tichondrius,1239,warrior,arms,62,32,30
60055,Mitigation,hyjal,1239,warrior,arms,34,15,19
60056,Seniorsherk,dalaran,1239,warrior,arms,35,15,20
60057,Retrostorm,illidan,1238,warrior,arms,24,13,11
60058,Depthsii,lightbringer,1238,warrior,arms,30,14,16
60059,Etothed,stormrage,1238,warrior,arms,30,13,17
60060,Rasazghal,darrowmere,1238,warrior,arms,93,32,61
60061,Ragelol,icecrown,1237,warrior,arms,24,13,11
60062,Lokiilloo,drakkari,1237,warrior,arms,97,48,49
60063,Deathengine,area-52,1237,warrior,arms,29,14,15
60064,Torkus,ragnaros,1237,warrior,arms,76,35,41
60065,Nerròk,wyrmrest-accord,1236,warrior,arms,30,13,17
60066,Tallix,smolderthorn,1235,warrior,arms,24,13,11
60067,Macray,proudmoore,1235,warrior,arms,24,13,11
60068,Warrshield,ragnaros,1235,warrior,arms,95,45,50
60069,Rahgnarson,kelthuzad,1235,warrior,arms,42,13,29
60070,Nickfurie,emerald-dream,1234,warrior,arms,24,13,11
60071,Odinsglory,mugthol,1234,warrior,arms,188,89,99
60072,Rockedanger,stormrage,1233,warrior,arms,38,22,16
60073,Dieselsauce,stormscale,1233,warrior,arms,42,24,18
60074,Flycosmos,tichondrius,1233,warrior,arms,121,62,59
60075,Ådolf,sargeras,1233,warrior,arms,38,19,19
60076,Nosfuratuzod,frostmourne,1233,warrior,arms,49,22,27
60077,Standsonkegs,illidan,1233,warrior,arms,30,13,17
60078,Grizzlefish,feathermoon,1233,warrior,arms,72,30,42
60079,Bananae,stormrage,1232,warrior,arms,21,14,7
60080,Pandaniela,area-52,1232,warrior,arms,30,18,12
60081,Goldbêrg,malganis,1232,warrior,arms,24,13,11
60082,Heojae,tichondrius,1232,warrior,arms,24,13,11
60083,Vobiscum,drakkari,1232,warrior,arms,30,14,16
60084,Deesad,azralon,1231,warrior,arms,28,14,14
60085,Hôdû,tichondrius,1231,warrior,arms,87,40,47
60086,Wankcelot,kiljaeden,1231,warrior,arms,48,21,27
60087,Moonsworn,moon-guard,1231,warrior,arms,30,13,17
60088,Ðirtyboy,tichondrius,1231,warrior,arms,36,13,23
60089,Siegfriéd,bleeding-hollow,1231,warrior,arms,47,16,31
60090,Eternalwill,rexxar,1229,warrior,arms,24,13,11
60091,Bloodfx,darkspear,1229,warrior,arms,138,68,70
60092,Gorash,gundrak,1229,warrior,arms,111,54,57
60093,Thunderbash,thrall,1229,warrior,arms,36,13,23
60094,Jrodrick,nemesis,1229,warrior,arms,49,16,33
60095,Awkagar,hyjal,1228,warrior,arms,23,13,10
60096,Jaens,quelthalas,1228,warrior,arms,36,15,21
60097,Asarg,emerald-dream,1227,warrior,arms,36,23,13
60098,Rebelzudo,azralon,1227,warrior,arms,48,29,19
60099,Babyweenis,sargeras,1226,warrior,arms,18,13,5
60100,Lükë,zuluhed,1226,warrior,arms,24,13,11
60101,Pallus,korgath,1226,warrior,arms,24,13,11
60102,Celt,uldum,1226,warrior,arms,31,15,16
60103,Malystik,ragnaros,1225,warrior,arms,93,49,44
60104,Drdrip,shuhalo,1225,warrior,arms,63,29,34
60105,Tunchi,runetotem,1224,warrior,arms,90,47,43
60106,Armorlancer,stormrage,1223,warrior,arms,24,13,11
60107,Warrage,kiljaeden,1223,warrior,arms,103,55,48
60108,Philbert,alexstrasza,1223,warrior,arms,123,65,58
60109,Ahore,illidan,1223,warrior,arms,36,14,22
60110,Spincity,stormrage,1222,warrior,arms,30,16,14
60111,Aelrog,malganis,1222,warrior,arms,188,96,92
60112,Avesielli,dalaran,1221,warrior,arms,24,13,11
60113,Arthknight,ragnaros,1221,warrior,arms,30,15,15
60114,Daddymoist,moon-guard,1220,warrior,arms,60,29,31
60115,Kuchikilla,borean-tundra,1219,warrior,arms,100,48,52
60116,Sugarpanties,moon-guard,1219,warrior,arms,93,42,51
60117,Xowarr,borean-tundra,1219,warrior,arms,29,13,16
60118,Bladereaver,sargeras,1218,warrior,arms,24,13,11
60119,Slivers,stormrage,1218,warrior,arms,30,16,14
60120,Varekai,frostmourne,1218,warrior,arms,74,34,40
60121,Ðwârf,tichondrius,1218,warrior,arms,46,17,29
60122,Royye,blood-furnace,1217,warrior,arms,30,16,14
60123,Zeldrissx,quelthalas,1217,warrior,arms,50,19,31
60124,Rhydonero,azralon,1216,warrior,arms,47,26,21
60125,Baghatur,tichondrius,1216,warrior,arms,30,15,15
60126,Dungs,emerald-dream,1216,warrior,arms,46,22,24
60127,Pangean,sargeras,1216,warrior,arms,42,18,24
60128,Akunaswar,dalaran,1215,warrior,arms,89,41,48
60129,Dsz,nemesis,1215,warrior,arms,53,24,29
60130,Tuf,malygos,1214,warrior,arms,66,31,35
60131,Vâìn,tichondrius,1214,warrior,arms,34,15,19
60132,Dippindabz,area-52,1213,warrior,arms,47,26,21
60133,Colapse,zuljin,1213,warrior,arms,30,13,17
60134,Truongx,kiljaeden,1212,warrior,arms,24,14,10
60135,Ediict,illidan,1212,warrior,arms,29,13,16
60136,Çleåvage,stormrage,1212,warrior,arms,49,18,31
60137,Lilsweet,moon-guard,1211,warrior,arms,39,25,14
60138,Hazorl,zuljin,1210,warrior,arms,30,16,14
60139,Brianya,moon-guard,1210,warrior,arms,30,13,17
60140,Winjerrywin,frostwolf,1209,warrior,arms,46,26,20
60141,Raserei,moonrunner,1209,warrior,arms,136,70,66
60142,Gunnaoffxans,sargeras,1209,warrior,arms,30,14,16
60143,Brozown,wildhammer,1209,warrior,arms,32,14,18
60144,Rageloading,amanthul,1208,warrior,arms,36,18,18
60145,Baadomishram,ragnaros,1208,warrior,arms,30,14,16
60146,Soulcalibur,zuljin,1208,warrior,arms,29,13,16
60147,Kannerhus,quelthalas,1207,warrior,arms,103,49,54
60148,Yiffathon,wyrmrest-accord,1207,warrior,arms,87,37,50
60149,Deadhofe,azuremyst,1205,warrior,arms,33,16,17
60150,Eniaan,khaz-modan,1204,warrior,arms,24,13,11
60151,Hintofmint,tichondrius,1204,warrior,arms,56,30,26
60152,Diamict,wyrmrest-accord,1204,warrior,arms,86,43,43
60153,Demðnslayer,kelthuzad,1204,warrior,arms,67,33,34
60154,Xzqtz,tichondrius,1204,warrior,arms,50,24,26
60155,Aràthor,stormrage,1204,warrior,arms,113,52,61
60156,Hkbdynamus,black-dragonflight,1203,warrior,arms,42,18,24
60157,Toky,malganis,1202,warrior,arms,24,13,11
60158,Rageorade,area-52,1202,warrior,arms,29,13,16
60159,Colnar,stormrage,1202,warrior,arms,30,13,17
60160,Vapòr,frostmourne,1201,warrior,arms,24,14,10
60161,Bigolpeen,sargeras,1201,warrior,arms,42,23,19
60162,Tolette,quelthalas,1201,warrior,arms,24,13,11
60163,Luckybrother,tichondrius,1200,warrior,arms,98,51,47
60164,Newtommi,barthilas,1200,warrior,arms,54,27,27
60165,Kapalua,darkspear,1200,warrior,arms,45,21,24
60166,Aspxt,saurfang,1200,warrior,arms,66,30,36
60167,Dissx,illidan,1200,warrior,arms,55,24,31
60168,Friendnoodle,frostmourne,1199,warrior,arms,59,28,31
60169,Kiddoe,rivendare,1199,warrior,arms,84,39,45
60170,Munchiesxqc,exodar,1199,warrior,arms,68,25,43
60171,Theregulator,area-52,1198,warrior,arms,76,40,36
60172,Aggor,trollbane,1198,warrior,arms,36,13,23
60173,Aclipse,nagrand,1197,warrior,arms,65,34,31
60174,Buliwyff,wyrmrest-accord,1197,warrior,arms,57,28,29
60175,Koteketzu,ragnaros,1196,warrior,arms,47,29,18
60176,Flexakute,malganis,1196,warrior,arms,24,14,10
60177,Darkhorv,frostmourne,1196,warrior,arms,23,13,10
60178,Shotgunzx,tichondrius,1195,warrior,arms,27,13,14
60179,Bootstraps,hyjal,1195,warrior,arms,90,41,49
60180,Rargou,illidan,1194,warrior,arms,23,13,10
60181,Iridikron,dalaran,1194,warrior,arms,30,13,17
60182,Khåyman,illidan,1194,warrior,arms,42,15,27
60183,Saero,ragnaros,1193,warrior,arms,30,13,17
60184,Your,emerald-dream,1192,warrior,arms,24,13,11
60185,Thedargz,trollbane,1191,warrior,arms,134,71,63
60186,Calynn,frostmourne,1191,warrior,arms,288,137,151
60187,Ontull,emerald-dream,1191,warrior,arms,42,13,29
60188,Bazironbeard,ravencrest,1190,warrior,arms,17,13,4
60189,Annaliyah,wyrmrest-accord,1190,warrior,arms,66,36,30
60190,Baroque,darkspear,1190,warrior,arms,24,13,11
60191,Areiden,sargeras,1190,warrior,arms,48,16,32
60192,Aistine,alterac-mountains,1189,warrior,arms,36,18,18
60193,Tomcruisé,ragnaros,1188,warrior,arms,21,15,6
60194,Märx,barthilas,1187,warrior,arms,32,15,17
60195,Gohawn,hyjal,1186,warrior,arms,37,20,17
60196,Axharafuji,dalvengyr,1186,warrior,arms,78,35,43
60197,Lazyclap,nagrand,1185,warrior,arms,41,21,20
60198,Kreyonz,hyjal,1184,warrior,arms,30,14,16
60199,Olgran,drakkari,1183,warrior,arms,71,32,39
60200,Jamajuicedx,thrall,1183,warrior,arms,29,13,16
60201,Cowbøycrytoo,azralon,1182,warrior,arms,88,46,42
60202,Degentradorz,area-52,1182,warrior,arms,111,53,58
60203,Rios,jubeithos,1182,warrior,arms,36,14,22
60204,Avoraçado,nemesis,1181,warrior,arms,127,51,76
60205,Mangler,tichondrius,1180,warrior,arms,48,19,29
60206,Tobiwan,ragnaros,1179,warrior,arms,36,16,20
60207,Bifilar,frostmourne,1178,warrior,arms,54,23,31
60208,Archonian,stormscale,1177,warrior,arms,40,24,16
60209,Amaus,queldorei,1177,warrior,arms,27,14,13
60210,Skumwarr,moon-guard,1177,warrior,arms,64,25,39
60211,Orcbreaker,quelthalas,1176,warrior,arms,38,18,20
60212,Ibizà,tichondrius,1176,warrior,arms,48,18,30
60213,Fkndog,tichondrius,1175,warrior,arms,78,36,42
60214,Zarrock,emerald-dream,1174,warrior,arms,26,14,12
60215,Secsecute,moon-guard,1174,warrior,arms,30,13,17
60216,Süspicious,malfurion,1174,warrior,arms,35,14,21
60217,Dorianfrost,ravenholdt,1173,warrior,arms,102,33,69
60218,Lololosda,quelthalas,1172,warrior,arms,78,42,36
60219,Rrawrr,bleeding-hollow,1172,warrior,arms,44,23,21
60220,Droogust,tichondrius,1172,warrior,arms,30,15,15
60221,Southmariner,malganis,1172,warrior,arms,78,38,40
60222,Badbrain,barthilas,1172,warrior,arms,29,13,16
60223,Rauh,emerald-dream,1171,warrior,arms,22,13,9
60224,Sherway,quelthalas,1171,warrior,arms,240,118,122
60225,Stoul,illidan,1168,warrior,arms,30,22,8
60226,Rockley,mugthol,1168,warrior,arms,48,19,29
60227,Khâi,tichondrius,1168,warrior,arms,33,13,20
60228,Robotríp,illidan,1167,warrior,arms,64,29,35
60229,Kì,moon-guard,1166,warrior,arms,102,53,49
60230,Nosetackle,area-52,1166,warrior,arms,64,31,33
60231,Adunken,ragnaros,1165,warrior,arms,30,17,13
60232,Grömäash,ragnaros,1165,warrior,arms,32,13,19
60233,Tsmcsuckmyd,tichondrius,1163,warrior,arms,35,22,13
60234,Thebruce,nemesis,1163,warrior,arms,130,63,67
60235,Puertorc,ragnaros,1163,warrior,arms,36,17,19
60236,Gongos,doomhammer,1161,warrior,arms,207,107,100
60237,Orcaine,ursin,1160,warrior,arms,44,28,16
60238,Mortilant,perenolde,1160,warrior,arms,75,34,41
60239,Ãleister,stormrage,1160,warrior,arms,63,25,38
60240,Enthria,illidan,1159,warrior,arms,96,49,47
60241,Ogpapabear,stormscale,1158,warrior,arms,63,21,42
60242,Stolz,dragonmaw,1157,warrior,arms,30,13,17
60243,Angryskeever,garona,1156,warrior,arms,48,25,23
60244,Tomatogodx,sargeras,1156,warrior,arms,31,15,16
60245,Elpish,ragnaros,1154,warrior,arms,66,31,35
60246,Magnuszx,zuljin,1152,warrior,arms,18,12,6
60247,Pathelsonsus,stormrage,1152,warrior,arms,30,12,18
60248,Atomiclol,area-52,1151,warrior,arms,18,12,6
60249,Dpsmachinex,tichondrius,1151,warrior,arms,18,12,6
60250,Renaissancex,tichondrius,1151,warrior,arms,24,12,12
60251,Moxxyy,tichondrius,1151,warrior,arms,24,12,12
60252,Varrior,wyrmrest-accord,1151,warrior,arms,24,12,12
60253,Turecw,illidan,1151,warrior,arms,24,12,12
60254,Njjszn,thrall,1151,warrior,arms,226,110,116
60255,Soultarius,sargeras,1151,warrior,arms,33,13,20
60256,Pkgdtko,tichondrius,1150,warrior,arms,18,12,6
60257,Hàru,illidan,1150,warrior,arms,18,12,6
60258,Einnarr,tichondrius,1150,warrior,arms,19,12,7
60259,Vezixx,dragonmaw,1150,warrior,arms,30,17,13
60260,Nexgenwar,destromath,1150,warrior,arms,24,12,12
60261,Ragemane,illidan,1150,warrior,arms,27,13,14
60262,Shewar,ragnaros,1150,warrior,arms,27,12,15
60263,Mercystaling,tichondrius,1150,warrior,arms,30,12,18
60264,Jarheadz,bleeding-hollow,1150,warrior,arms,35,12,23
60265,Jaytoo,illidan,1149,warrior,arms,18,12,6
60266,Gordofofo,azralon,1149,warrior,arms,18,12,6
60267,Iblowloads,illidan,1149,warrior,arms,24,14,10
60268,Aiforix,gorefiend,1149,warrior,arms,45,25,20
60269,Scaredwarr,stormrage,1149,warrior,arms,45,24,21
60270,Doucherocket,kelthuzad,1149,warrior,arms,24,12,12
60271,Zerosends,kelthuzad,1149,warrior,arms,30,12,18
60272,Chestbrook,icecrown,1148,warrior,arms,18,12,6
60273,Kamuwarr,azralon,1148,warrior,arms,24,12,12
60274,Gladìus,area-52,1148,warrior,arms,24,12,12
60275,Fulreck,tichondrius,1148,warrior,arms,24,12,12
60276,Shino,garona,1148,warrior,arms,24,12,12
60277,Pezek,thrall,1148,warrior,arms,26,12,14
60278,Suicider,stormrage,1148,warrior,arms,30,12,18
60279,Vodkagoblin,sargeras,1147,warrior,arms,24,12,12
60280,Misclickëd,dalaran,1147,warrior,arms,24,12,12
60281,Virillius,wyrmrest-accord,1147,warrior,arms,28,13,15
60282,Jianhung,tichondrius,1147,warrior,arms,30,12,18
60283,Hektar,tichondrius,1146,warrior,arms,18,12,6
60284,Stompyocouch,mugthol,1146,warrior,arms,21,13,8
60285,Tramplehaste,barthilas,1146,warrior,arms,30,18,12
60286,Furryhorv,frostmourne,1146,warrior,arms,24,12,12
60287,Maleap,moon-guard,1146,warrior,arms,24,12,12
60288,Nebraskapete,wyrmrest-accord,1146,warrior,arms,24,12,12
60289,Ikitee,zuljin,1146,warrior,arms,24,12,12
60290,Alejandrica,ragnaros,1146,warrior,arms,30,12,18
60291,Plssaveme,ysera,1146,warrior,arms,68,27,41
60292,Ragnarloðbró,tichondrius,1146,warrior,arms,36,12,24
60293,Itskinggrizz,thrall,1145,warrior,arms,22,13,9
60294,Struka,drakkari,1145,warrior,arms,24,12,12
60295,Davlar,ragnaros,1145,warrior,arms,33,14,19
60296,Skizoid,kiljaeden,1144,warrior,arms,18,12,6
60297,Skittlesxo,bleeding-hollow,1144,warrior,arms,24,12,12
60298,Rezzett,wyrmrest-accord,1144,warrior,arms,27,13,14
60299,Dúmßlòwn,tichondrius,1144,warrior,arms,165,76,89
60300,Funderr,eonar,1144,warrior,arms,45,19,26
60301,Awm,wyrmrest-accord,1144,warrior,arms,30,12,18
60302,Sartin,boulderfist,1144,warrior,arms,42,14,28
60303,Invared,stormrage,1143,warrior,arms,18,12,6
60304,Marvél,quelthalas,1143,warrior,arms,173,83,90
60305,Xyazhiro,ragnaros,1143,warrior,arms,90,42,48
60306,Bladeblade,burning-blade,1143,warrior,arms,27,12,15
60307,Matutekz,ragnaros,1143,warrior,arms,36,12,24
60308,Nibbzy,sargeras,1142,warrior,arms,18,12,6
60309,Lucidx,malfurion,1142,warrior,arms,18,12,6
60310,Haldeer,shadow-council,1142,warrior,arms,24,12,12
60311,Realthiccbbw,tichondrius,1142,warrior,arms,24,12,12
60312,Dracossack,ragnaros,1142,warrior,arms,47,17,30
60313,Crnogorac,hakkar,1141,warrior,arms,18,12,6
60314,Elmosmash,thrall,1141,warrior,arms,24,12,12
60315,Yisunshin,azralon,1141,warrior,arms,24,12,12
60316,Strongtall,tichondrius,1141,warrior,arms,36,15,21
60317,Saskouach,stormrage,1140,warrior,arms,26,12,14
60318,Thanitose,bleeding-hollow,1139,warrior,arms,24,12,12
60319,Brocc,tichondrius,1139,warrior,arms,24,12,12
60320,Empriux,quelthalas,1139,warrior,arms,30,12,18
60321,Mnoga,azralon,1139,warrior,arms,55,18,37
60322,Gristly,sargeras,1138,warrior,arms,18,12,6
60323,Baloz,tichondrius,1138,warrior,arms,30,13,17
60324,Tappia,quelthalas,1138,warrior,arms,36,12,24
60325,Plugz,sargeras,1137,warrior,arms,28,14,14
60326,Maxalyss,stormrage,1137,warrior,arms,24,12,12
60327,Aztecvil,drakkari,1137,warrior,arms,30,12,18
60328,Soggynapkin,proudmoore,1136,warrior,arms,30,17,13
60329,Gageoddord,kiljaeden,1136,warrior,arms,24,12,12
60330,Purefury,whisperwind,1136,warrior,arms,99,46,53
60331,Nabii,tichondrius,1136,warrior,arms,30,12,18
60332,Zulgadark,ragnaros,1136,warrior,arms,39,15,24
60333,Èox,barthilas,1135,warrior,arms,18,12,6
60334,Drahconian,aggramar,1134,warrior,arms,24,12,12
60335,Shattering,fizzcrank,1134,warrior,arms,24,12,12
60336,Dhano,drakkari,1134,warrior,arms,60,25,35
60337,Soníco,area-52,1134,warrior,arms,29,12,17
60338,Areuz,azralon,1133,warrior,arms,22,13,9
60339,Angelsantos,sargeras,1133,warrior,arms,24,12,12
60340,Cocainiouz,dalaran,1133,warrior,arms,48,21,27
60341,Yamato,skywall,1133,warrior,arms,30,12,18
60342,Loktarrogar,illidan,1133,warrior,arms,30,12,18
60343,Kilrok,thunderlord,1133,warrior,arms,42,12,30
60344,Diãbel,azralon,1132,warrior,arms,18,12,6
60345,Tripleblack,mugthol,1132,warrior,arms,18,12,6
60346,Isildur,nerzhul,1132,warrior,arms,36,20,16
60347,Otheralex,kiljaeden,1132,warrior,arms,24,12,12
60348,Joed,quelthalas,1132,warrior,arms,96,45,51
60349,Sudavis,alleria,1131,warrior,arms,61,36,25
60350,Édton,area-52,1131,warrior,arms,72,36,36
60351,Bigsvit,trollbane,1131,warrior,arms,60,29,31
60352,Kiayla,quelthalas,1131,warrior,arms,195,87,108
60353,Spritez,malganis,1131,warrior,arms,70,27,43
60354,Diegoreo,drakkari,1130,warrior,arms,32,13,19
60355,Inunotaysho,quelthalas,1129,warrior,arms,54,22,32
60356,Genesisxp,barthilas,1129,warrior,arms,30,12,18
60357,Irishhammer,malfurion,1129,warrior,arms,41,15,26
60358,Lunks,kelthuzad,1128,warrior,arms,18,12,6
60359,Mogruk,stonemaul,1128,warrior,arms,36,14,22
60360,Elix,stormscale,1127,warrior,arms,24,12,12
60361,Bulletfodder,tichondrius,1127,warrior,arms,24,12,12
60362,Angitu,quelthalas,1124,warrior,arms,24,14,10
60363,Úmarth,azralon,1124,warrior,arms,60,29,31
60364,Raharon,chogall,1124,warrior,arms,61,26,35
60365,Demetrïus,moon-guard,1122,warrior,arms,30,12,18
60366,Carrito,perenolde,1120,warrior,arms,47,26,21
60367,Ambiss,azjolnerub,1120,warrior,arms,47,21,26
60368,Slumdawgg,andorhal,1119,warrior,arms,59,32,27
60369,Sarget,ragnaros,1119,warrior,arms,48,24,24
60370,Vaclein,quelthalas,1119,warrior,arms,54,24,30
60371,Swiftynifty,area-52,1118,warrior,arms,48,29,19
60372,Clovê,ragnaros,1118,warrior,arms,36,21,15
60373,Knocks,blackrock,1118,warrior,arms,44,24,20
60374,Aersasi,tichondrius,1117,warrior,arms,24,13,11
60375,Rahtahtas,area-52,1116,warrior,arms,24,12,12
60376,Buffalobob,bronzebeard,1115,warrior,arms,24,12,12
60377,Hemone,frostmourne,1114,warrior,arms,30,15,15
60378,Ereborh,ragnaros,1114,warrior,arms,24,12,12
60379,Containerbox,korgath,1112,warrior,arms,42,18,24
60380,Casteleiro,azralon,1112,warrior,arms,32,13,19
60381,Alejandros,azgalor,1111,warrior,arms,23,12,11
60382,Warriorlee,jubeithos,1111,warrior,arms,44,19,25
60383,Brysontiller,frostmourne,1110,warrior,arms,23,12,11
60384,Turkin,proudmoore,1110,warrior,arms,30,12,18
60385,Tyférious,tichondrius,1110,warrior,arms,68,27,41
60386,Wastenott,area-52,1109,warrior,arms,30,19,11
60387,Thedoofy,blackrock,1109,warrior,arms,39,20,19
60388,Iwishiknew,kargath,1109,warrior,arms,30,12,18
60389,Locotto,ragnaros,1109,warrior,arms,48,16,32
60390,Rineer,tichondrius,1108,warrior,arms,30,12,18
60391,Youtank,kiljaeden,1105,warrior,arms,78,36,42
60392,Dvhwec,tichondrius,1105,warrior,arms,28,12,16
60393,Xandrak,barthilas,1103,warrior,arms,47,25,22
60394,Marcolatus,ragnaros,1103,warrior,arms,102,50,52
60395,Baultenaz,draenor,1102,warrior,arms,23,12,11
60396,Tipincider,perenolde,1100,warrior,arms,21,12,9
60397,Hagud,tichondrius,1099,warrior,arms,65,26,39
60398,Anotee,kelthuzad,1098,warrior,arms,135,68,67
60399,Wtbfriends,malganis,1097,warrior,arms,29,15,14
60400,Riga,tichondrius,1097,warrior,arms,51,25,26
60401,Kreeper,farstriders,1097,warrior,arms,28,13,15
60402,Garìk,moon-guard,1097,warrior,arms,99,41,58
60403,Panzerian,area-52,1097,warrior,arms,37,14,23
60404,Forevercute,proudmoore,1096,warrior,arms,23,14,9
60405,Theøcritus,korgath,1096,warrior,arms,42,25,17
60406,Eiendira,proudmoore,1096,warrior,arms,32,13,19
60407,Jägernaught,stormrage,1095,warrior,arms,29,12,17
60408,Melankoma,sargeras,1094,warrior,arms,30,12,18
60409,Arrogated,emerald-dream,1093,warrior,arms,90,44,46
60410,Nanaru,tichondrius,1090,warrior,arms,41,16,25
60411,Charcharbinx,zuljin,1090,warrior,arms,48,18,30
60412,Racky,dragonmaw,1089,warrior,arms,28,12,16
60413,Padalouh,kelthuzad,1089,warrior,arms,48,19,29
60414,Ujumpijump,andorhal,1089,warrior,arms,84,32,52
60415,Bloren,thrall,1085,warrior,arms,30,14,16
60416,Jiszle,sargeras,1085,warrior,arms,34,12,22
60417,Agresvnapkin,dalaran,1084,warrior,arms,20,12,8
60418,Ragebladë,tichondrius,1083,warrior,arms,89,49,40
60419,Kempachii,ragnaros,1083,warrior,arms,82,40,42
60420,Aquannas,bloodscalp,1082,warrior,arms,24,14,10
60421,Pingorosho,quelthalas,1082,warrior,arms,36,16,20
60422,Malok,deathwing,1082,warrior,arms,57,20,37
60423,Orcopata,ragnaros,1081,warrior,arms,26,12,14
60424,Riuk,goldrinn,1080,warrior,arms,29,16,13
60425,Gorfin,spirestone,1077,warrior,arms,42,12,30
60426,Chisum,gnomeregan,1075,warrior,arms,52,29,23
60427,Several,whisperwind,1073,warrior,arms,39,23,16
60428,Beansgohard,deathwing,1073,warrior,arms,27,12,15
60429,Plsmilkme,zuljin,1072,warrior,arms,24,16,8
60430,Ødïñ,sargeras,1071,warrior,arms,75,37,38
60431,Victorhugo,ragnaros,1071,warrior,arms,28,12,16
60432,Ashanthaa,kelthuzad,1071,warrior,arms,30,12,18
60433,Yuccaleaptus,area-52,1070,warrior,arms,77,31,46
60434,Geoorg,ragnaros,1067,warrior,arms,71,28,43
60435,Karroww,thrall,1066,warrior,arms,24,15,9
60436,Helandas,moknathal,1066,warrior,arms,193,93,100
60437,Axedeity,caelestrasz,1063,warrior,arms,81,45,36
60438,Thebeastwar,area-52,1062,warrior,arms,66,33,33
60439,Krömm,kilrogg,1061,warrior,arms,48,25,23
60440,Ugrundan,zuljin,1061,warrior,arms,48,21,27
60441,Bussundas,azralon,1059,warrior,arms,78,35,43
60442,Outterspace,illidan,1056,warrior,arms,18,11,7
60443,Midorikwa,area-52,1056,warrior,arms,18,11,7
60444,Soyu,tichondrius,1056,warrior,arms,22,12,10
60445,Wizcleavuh,area-52,1056,warrior,arms,24,11,13
60446,Raime,sargeras,1056,warrior,arms,24,11,13
60447,Evanx,sargeras,1056,warrior,arms,24,11,13
60448,Golodiso,mugthol,1056,warrior,arms,24,11,13
60449,Paletona,emerald-dream,1056,warrior,arms,24,11,13
60450,Pkgd,tichondrius,1055,warrior,arms,12,11,1
60451,Hotshótz,kelthuzad,1055,warrior,arms,12,11,1
60452,Sonwar,azralon,1055,warrior,arms,18,11,7
60453,Warronin,kaelthas,1055,warrior,arms,18,11,7
60454,Thuggyfresh,malganis,1055,warrior,arms,18,11,7
60455,Turtlestorm,tichondrius,1055,warrior,arms,18,11,7
60456,Gladiator,azshara,1055,warrior,arms,18,11,7
60457,Jeffesptein,tichondrius,1055,warrior,arms,18,11,7
60458,Breyns,garrosh,1055,warrior,arms,25,12,13
60459,Carriney,illidan,1055,warrior,arms,77,36,41
60460,Sonicboom,whisperwind,1055,warrior,arms,24,11,13
60461,Duckyuwu,tichondrius,1055,warrior,arms,24,11,13
60462,Feedzz,area-52,1055,warrior,arms,24,11,13
60463,Abomlnatlon,tichondrius,1055,warrior,arms,24,11,13
60464,Faronstompz,sargeras,1055,warrior,arms,24,11,13
60465,Imcute,senjin,1055,warrior,arms,78,30,48
60466,Gangdamn,frostmourne,1055,warrior,arms,36,11,25
60467,Vooné,tichondrius,1054,warrior,arms,18,11,7
60468,Chopped,wyrmrest-accord,1054,warrior,arms,18,11,7
60469,Relaxnerdlol,antonidas,1054,warrior,arms,18,11,7
60470,Fallenguardx,sargeras,1054,warrior,arms,18,11,7
60471,Chonbi,tichondrius,1054,warrior,arms,18,11,7
60472,Executiepie,hyjal,1054,warrior,arms,18,11,7
60473,Mikero,terenas,1054,warrior,arms,24,11,13
60474,Vexwar,bleeding-hollow,1054,warrior,arms,24,11,13
60475,Boouuaakk,tichondrius,1054,warrior,arms,24,11,13
60476,Wolfsrage,frostmourne,1054,warrior,arms,30,11,19
60477,Shöthetank,area-52,1054,warrior,arms,30,11,19
60478,Hawkior,moon-guard,1053,warrior,arms,18,11,7
60479,Nfx,tichondrius,1053,warrior,arms,18,11,7
60480,Anabolics,bleeding-hollow,1053,warrior,arms,18,11,7
60481,Ttl,dalaran,1053,warrior,arms,18,11,7
60482,Iwooglybool,icecrown,1053,warrior,arms,18,11,7
60483,Stiffysword,tanaris,1053,warrior,arms,30,14,16
60484,Sawsyy,kelthuzad,1053,warrior,arms,27,11,16
60485,Fortchin,area-52,1053,warrior,arms,30,11,19
60486,Elbelgon,ragnaros,1052,warrior,arms,18,11,7
60487,Adryina,zuljin,1052,warrior,arms,18,11,7
60488,Carrange,moon-guard,1052,warrior,arms,24,11,13
60489,Chiêfatriox,tichondrius,1052,warrior,arms,24,11,13
60490,Kaìju,dragonmaw,1052,warrior,arms,24,11,13
60491,Kàkarot,illidan,1051,warrior,arms,18,11,7
60492,Envision,frostmourne,1051,warrior,arms,24,11,13
60493,Drob,malganis,1051,warrior,arms,24,11,13
60494,Drillbit,wyrmrest-accord,1051,warrior,arms,30,11,19
60495,Humminity,quelthalas,1051,warrior,arms,32,11,21
60496,Georgedubya,illidan,1051,warrior,arms,36,11,25
60497,Slasherman,illidan,1051,warrior,arms,36,11,25
60498,Spacepants,azjolnerub,1050,warrior,arms,16,12,4
60499,Angrybulky,illidan,1050,warrior,arms,18,11,7
60500,Thecolor,tichondrius,1050,warrior,arms,30,11,19
60501,Crul,gurubashi,1050,warrior,arms,31,11,20
60502,Myceliumlog,frostmourne,1049,warrior,arms,18,11,7
60503,Halis,illidan,1049,warrior,arms,27,16,11
60504,Arroezze,earthen-ring,1049,warrior,arms,25,12,13
60505,Plagueis,dark-iron,1049,warrior,arms,24,11,13
60506,Gadderhammer,azgalor,1049,warrior,arms,42,17,25
60507,Clortho,korialstrasz,1049,warrior,arms,40,16,24
60508,Sneakyhand,draktharon,1048,warrior,arms,18,11,7
60509,Wixer,illidan,1048,warrior,arms,18,11,7
60510,Snewdawg,malganis,1048,warrior,arms,22,12,10
60511,Jamil,illidan,1048,warrior,arms,156,75,81
60512,Noktyn,haomarush,1048,warrior,arms,24,11,13
60513,Kanekhy,ragnaros,1048,warrior,arms,24,11,13
60514,Pneumasmash,tichondrius,1048,warrior,arms,24,11,13
60515,Castedien,quelthalas,1048,warrior,arms,36,11,25
60516,Bøgz,kelthuzad,1047,warrior,arms,18,11,7
60517,Peepeeboi,blackrock,1047,warrior,arms,18,11,7
60518,Bouk,bloodscalp,1047,warrior,arms,18,11,7
60519,Dwarfanage,tichondrius,1047,warrior,arms,28,12,16
60520,Rankjuan,area-52,1047,warrior,arms,30,11,19
60521,Prunebery,area-52,1046,warrior,arms,30,16,14
60522,Blaxst,gorgonnash,1046,warrior,arms,30,16,14
60523,Nirax,burning-legion,1046,warrior,arms,26,11,15
60524,Rottlingberg,kelthuzad,1046,warrior,arms,30,11,19
60525,Lögän,azralon,1046,warrior,arms,30,11,19
60526,Jfordnever,area-52,1045,warrior,arms,18,11,7
60527,Warrpool,shadowmoon,1045,warrior,arms,18,11,7
60528,Swàgnáros,area-52,1045,warrior,arms,18,11,7
60529,Hugz,thrall,1045,warrior,arms,30,11,19
60530,Tasërface,hakkar,1045,warrior,arms,36,11,25
60531,Milkshake,stormrage,1045,warrior,arms,36,11,25
60532,Fabszord,nemesis,1044,warrior,arms,40,20,20
60533,Orphasmic,moon-guard,1044,warrior,arms,36,11,25
60534,Walmir,shadow-council,1043,warrior,arms,18,11,7
60535,Eqz,area-52,1043,warrior,arms,18,11,7
60536,Nachobeef,illidan,1043,warrior,arms,24,11,13
60537,Svênd,ragnaros,1042,warrior,arms,30,12,18
60538,Alondir,quelthalas,1042,warrior,arms,30,11,19
60539,Creator,dalaran,1041,warrior,arms,24,11,13
60540,Greenmachine,twisting-nether,1040,warrior,arms,30,11,19
60541,Notakîd,stormrage,1039,warrior,arms,24,11,13
60542,Loaksz,tichondrius,1038,warrior,arms,24,11,13
60543,Rágnárr,ragnaros,1038,warrior,arms,30,13,17
60544,Dylaiin,kelthuzad,1038,warrior,arms,30,11,19
60545,Wrekkshop,tichondrius,1037,warrior,arms,27,13,14
60546,Wrrx,frostmourne,1037,warrior,arms,24,11,13
60547,Ligerii,quelthalas,1036,warrior,arms,24,11,13
60548,Deathsmirk,illidan,1034,warrior,arms,61,32,29
60549,Regthar,illidan,1034,warrior,arms,23,11,12
60550,Indoondabeat,azgalor,1034,warrior,arms,32,15,17
60551,Portersz,korgath,1034,warrior,arms,24,11,13
60552,Layoon,azralon,1033,warrior,arms,25,12,13
60553,Nobowar,tichondrius,1032,warrior,arms,24,11,13
60554,Radeox,ragnaros,1032,warrior,arms,25,11,14
60555,Pegaso,the-underbog,1032,warrior,arms,29,12,17
60556,Beardoff,sargeras,1031,warrior,arms,28,14,14
60557,Raokao,senjin,1031,warrior,arms,30,11,19
60558,Burgdur,sargeras,1031,warrior,arms,54,19,35
60559,Stalecrouton,doomhammer,1030,warrior,arms,18,11,7
60560,Potan,thrall,1030,warrior,arms,60,25,35
60561,Uglycubano,quelthalas,1029,warrior,arms,24,11,13
60562,Märiä,ragnaros,1028,warrior,arms,52,27,25
60563,Thråsh,area-52,1028,warrior,arms,66,33,33
60564,Bradshaw,sargeras,1028,warrior,arms,36,15,21
60565,Cronie,steamwheedle-cartel,1027,warrior,arms,36,16,20
60566,Yerajmiel,proudmoore,1026,warrior,arms,18,11,7
60567,Inuyasha,korgath,1023,warrior,arms,52,31,21
60568,Unterg,ragnaros,1021,warrior,arms,36,17,19
60569,Abidis,tichondrius,1021,warrior,arms,35,11,24
60570,Nøzerker,kelthuzad,1020,warrior,arms,26,12,14
60571,Macdollibee,barthilas,1017,warrior,arms,42,22,20
60572,Guanyúu,tichondrius,1017,warrior,arms,23,11,12
60573,Orcimonde,arthas,1017,warrior,arms,28,11,17
60574,Stygïàn,draenor,1016,warrior,arms,80,45,35
60575,Hazew,kelthuzad,1016,warrior,arms,23,11,12
60576,Nashallo,zuljin,1015,warrior,arms,24,11,13
60577,Galuf,malygos,1014,warrior,arms,18,11,7
60578,Gargameld,stormrage,1012,warrior,arms,53,29,24
60579,Coffetea,area-52,1011,warrior,arms,41,25,16
60580,Psýchótic,tichondrius,1009,warrior,arms,23,11,12
60581,Hexenbæne,tichondrius,1006,warrior,arms,23,11,12
60582,Bingchilly,aegwynn,1004,warrior,arms,21,12,9
60583,Tsebaoth,quelthalas,1004,warrior,arms,78,38,40
60584,Starplatinum,aerie-peak,1004,warrior,arms,32,11,21
60585,Brutallypwnd,tichondrius,1002,warrior,arms,53,29,24
60586,Gorepig,sargeras,1002,warrior,arms,29,11,18
60587,Hugewarrior,area-52,1001,warrior,arms,21,12,9
60588,Imgunnacrum,malganis,1001,warrior,arms,28,14,14
60589,Tandiko,wyrmrest-accord,999,warrior,arms,23,11,12
60590,Borgee,tichondrius,999,warrior,arms,30,12,18
60591,Wasabiz,tichondrius,999,warrior,arms,66,25,41
60592,Lieutemajor,nemesis,998,warrior,arms,55,27,28
60593,Goofyahwok,doomhammer,998,warrior,arms,33,12,21
60594,Fûry,tichondrius,997,warrior,arms,136,63,73
60595,Altruiel,sargeras,995,warrior,arms,40,20,20
60596,Kyritto,azralon,994,warrior,arms,35,18,17
60597,Vicor,ragnaros,993,warrior,arms,42,22,20
60598,Orkuduro,azralon,993,warrior,arms,77,37,40
60599,Ankhxiety,sargeras,993,warrior,arms,26,12,14
60600,Kiggzs,tichondrius,991,warrior,arms,14,11,3
60601,Tmhinfen,tichondrius,991,warrior,arms,16,11,5
60602,Szee,tichondrius,991,warrior,arms,17,11,6
60603,Jragonmaster,borean-tundra,991,warrior,arms,36,13,23
60604,Billy,area-52,990,warrior,arms,14,11,3
60605,Aggripa,kelthuzad,990,warrior,arms,20,11,9
60606,Armada,sargeras,990,warrior,arms,20,11,9
60607,Neekka,tichondrius,990,warrior,arms,28,12,16
60608,Kalaxe,quelthalas,990,warrior,arms,36,11,25
60609,Brownman,saurfang,989,warrior,arms,30,12,18
60610,Ulnaz,stormrage,988,warrior,arms,18,12,6
60611,Ibba,khazgoroth,988,warrior,arms,27,12,15
60612,Wardeád,quelthalas,988,warrior,arms,27,11,16
60613,Midge,proudmoore,987,warrior,arms,83,40,43
60614,Biggieswords,madoran,984,warrior,arms,17,11,6
60615,Brrzrrkrr,twisting-nether,983,warrior,arms,36,18,18
60616,Bionikus,nemesis,982,warrior,arms,108,49,59
60617,Darkthok,drakkari,982,warrior,arms,34,15,19
60618,Sneaknyoface,sargeras,982,warrior,arms,26,11,15
60619,Josiah,frostmourne,979,warrior,arms,27,13,14
60620,Lokiullr,tichondrius,978,warrior,arms,81,35,46
60621,Tucô,skullcrusher,976,warrior,arms,49,22,27
60622,Happywarrior,tichondrius,976,warrior,arms,30,11,19
60623,Sudokubrain,tichondrius,974,warrior,arms,19,11,8
60624,Blackstamp,tichondrius,973,warrior,arms,41,20,21
60625,Hunchless,detheroc,973,warrior,arms,57,25,32
60626,Djfredsd,tichondrius,972,warrior,arms,13,11,2
60627,Ghainemarko,hakkar,970,warrior,arms,30,11,19
60628,Elfmonger,proudmoore,966,warrior,arms,19,11,8
60629,Târtàrûs,tichondrius,966,warrior,arms,60,28,32
60630,Tankdatt,frostmourne,966,warrior,arms,30,12,18
60631,Wondaimon,drakkari,963,warrior,arms,27,12,15
60632,Pvppaul,sargeras,960,warrior,arms,12,10,2
60633,Adios,tichondrius,960,warrior,arms,18,10,8
60634,Szew,tichondrius,960,warrior,arms,18,10,8
60635,Battousäi,kiljaeden,960,warrior,arms,18,10,8
60636,Escanòr,malganis,960,warrior,arms,18,10,8
60637,Åthos,illidan,960,warrior,arms,18,10,8
60638,Nuqupq,tichondrius,960,warrior,arms,18,10,8
60639,Gunjay,sargeras,960,warrior,arms,21,11,10
60640,Swoonmixy,frostmourne,960,warrior,arms,24,10,14
60641,ßdm,illidan,960,warrior,arms,24,10,14
60642,Wargázm,thrall,960,warrior,arms,24,10,14
60643,Americanbull,moon-guard,960,warrior,arms,24,10,14
60644,Choppin,sargeras,960,warrior,arms,24,10,14
60645,Jethrix,kelthuzad,960,warrior,arms,24,10,14
60646,Benw,dawnbringer,960,warrior,arms,24,10,14
60647,Aliminar,zuluhed,960,warrior,arms,24,10,14
60648,Fatalian,proudmoore,960,warrior,arms,30,10,20
60649,Angrymadman,mannoroth,959,warrior,arms,18,10,8
60650,Violence,icecrown,959,warrior,arms,18,10,8
60651,Tantei,moon-guard,959,warrior,arms,18,10,8
60652,Elessarr,moon-guard,959,warrior,arms,18,10,8
60653,Velicah,stormrage,959,warrior,arms,18,10,8
60654,Hellfirearms,tichondrius,959,warrior,arms,18,10,8
60655,Beozerker,thrall,959,warrior,arms,18,10,8
60656,Jelurd,stormrage,959,warrior,arms,18,10,8
60657,Tmjakeful,area-52,959,warrior,arms,18,10,8
60658,Bamxz,sargeras,959,warrior,arms,18,10,8
60659,Warbasher,area-52,959,warrior,arms,18,10,8
60660,Alkír,zuljin,959,warrior,arms,18,10,8
60661,Crysis,malorne,959,warrior,arms,24,10,14
60662,Wóko,tichondrius,959,warrior,arms,24,10,14
60663,Drdelicious,tichondrius,959,warrior,arms,24,10,14
60664,Organge,zuljin,959,warrior,arms,24,10,14
60665,Ggrone,ragnaros,959,warrior,arms,24,10,14
60666,Warfeno,malganis,959,warrior,arms,24,10,14
60667,Mikeoxgreen,zuljin,959,warrior,arms,24,10,14
60668,Chardz,ragnaros,959,warrior,arms,30,10,20
60669,Zugface,tichondrius,959,warrior,arms,36,10,26
60670,Elsee,drakkari,959,warrior,arms,42,10,32
60671,Arrtorias,quelthalas,958,warrior,arms,12,10,2
60672,Est,illidan,958,warrior,arms,12,10,2
60673,Glacierrsz,sargeras,958,warrior,arms,18,10,8
60674,Polox,ragnaros,958,warrior,arms,18,10,8
60675,Kanchy,sargeras,958,warrior,arms,18,10,8
60676,Hauce,illidan,958,warrior,arms,18,10,8
60677,Akylis,tichondrius,958,warrior,arms,18,10,8
60678,Jire,shadowmoon,958,warrior,arms,22,11,11
60679,Icestormray,illidan,958,warrior,arms,24,10,14
60680,Grimspin,tichondrius,958,warrior,arms,24,10,14
60681,Bigdickfever,sargeras,958,warrior,arms,24,10,14
60682,Unwarmas,ragnaros,958,warrior,arms,24,10,14
60683,Kelmor,thunderhorn,958,warrior,arms,30,10,20
60684,Calto,tichondrius,958,warrior,arms,30,10,20
60685,Razakamx,tichondrius,957,warrior,arms,12,10,2
60686,Ghostblood,stormscale,957,warrior,arms,12,10,2
60687,Leapsalp,proudmoore,957,warrior,arms,18,10,8
60688,Whórm,kelthuzad,957,warrior,arms,18,10,8
60689,Atuey,area-52,957,warrior,arms,18,10,8
60690,Fugmaface,sargeras,957,warrior,arms,18,10,8
60691,Pootybeef,daggerspine,957,warrior,arms,24,10,14
60692,Targos,frostwolf,957,warrior,arms,24,10,14
60693,Aberwarr,illidan,956,warrior,arms,18,10,8
60694,Topbel,sargeras,956,warrior,arms,18,10,8
60695,Keffdog,laughing-skull,956,warrior,arms,18,10,8
60696,Lòvex,alterac-mountains,956,warrior,arms,60,32,28
60697,Numb,moon-guard,956,warrior,arms,26,11,15
60698,Kriegsheer,bleeding-hollow,956,warrior,arms,24,10,14
60699,Aisinbro,illidan,956,warrior,arms,24,10,14
60700,Torbajhorn,moon-guard,956,warrior,arms,24,10,14
60701,Barøneza,stormrage,956,warrior,arms,24,10,14
60702,Kushe,moon-guard,956,warrior,arms,24,10,14
60703,Warrbull,spirestone,956,warrior,arms,30,10,20
60704,Xdorkie,area-52,956,warrior,arms,30,10,20
60705,Stromkiller,stormrage,955,warrior,arms,18,10,8
60706,Korlòth,proudmoore,955,warrior,arms,18,10,8
60707,Qtrpndwcheez,area-52,955,warrior,arms,18,10,8
60708,Theestallion,kiljaeden,954,warrior,arms,18,10,8
60709,Starshattr,bleeding-hollow,954,warrior,arms,30,10,20
60710,Zomars,ragnaros,953,warrior,arms,18,10,8
60711,Coffeebottom,wyrmrest-accord,953,warrior,arms,18,10,8
60712,Honanilana,burning-legion,953,warrior,arms,24,10,14
60713,Originalpimp,bleeding-hollow,952,warrior,arms,24,10,14
60714,Turlesoup,proudmoore,952,warrior,arms,24,10,14
60715,Mauler,medivh,952,warrior,arms,24,10,14
60716,Aziz,kiljaeden,952,warrior,arms,25,10,15
60717,Astellios,stormrage,951,warrior,arms,18,10,8
60718,Aaltara,barthilas,951,warrior,arms,18,10,8
60719,Uhredb,aegwynn,951,warrior,arms,30,16,14
60720,Vvârriôr,barthilas,951,warrior,arms,24,10,14
60721,Darroma,bleeding-hollow,950,warrior,arms,18,10,8
60722,Helaume,arathor,950,warrior,arms,18,10,8
60723,Discopogo,nemesis,950,warrior,arms,24,10,14
60724,Spredforbred,area-52,950,warrior,arms,24,10,14
60725,Oppos,lightnings-blade,950,warrior,arms,31,12,19
60726,Rainiki,stormrage,950,warrior,arms,30,11,19
60727,Babybiif,azralon,950,warrior,arms,30,10,20
60728,Tanatos,the-venture-co,949,warrior,arms,42,16,26
60729,Vlix,korgath,948,warrior,arms,24,10,14
60730,Baloraj,barthilas,948,warrior,arms,24,10,14
60731,Digitalpsyko,hyjal,946,warrior,arms,18,10,8
60732,Meatdrps,frostmane,941,warrior,arms,26,11,15
60733,Thing,gorgonnash,941,warrior,arms,24,10,14
60734,Feared,hakkar,940,warrior,arms,23,10,13
60735,Dragmös,nemesis,937,warrior,arms,12,10,2
60736,Stöñè,blackwater-raiders,937,warrior,arms,24,10,14
60737,Haowar,tichondrius,937,warrior,arms,35,10,25
60738,Cizzik,emerald-dream,936,warrior,arms,18,10,8
60739,Hulkspazz,darkspear,936,warrior,arms,39,18,21
60740,Alderr,frostmourne,935,warrior,arms,24,10,14
60741,Mariò,area-52,934,warrior,arms,18,10,8
60742,Tyrantt,malganis,934,warrior,arms,54,22,32
60743,Vlanko,tichondrius,933,warrior,arms,24,10,14
60744,Danielss,ragnaros,930,warrior,arms,29,12,17
60745,Pocketaxe,blackwater-raiders,927,warrior,arms,83,40,43
60746,Phoveros,sargeras,927,warrior,arms,23,10,13
60747,Bruze,hellscream,926,warrior,arms,19,11,8
60748,Dudupápá,tichondrius,926,warrior,arms,22,10,12
60749,Ragesimp,stormrage,926,warrior,arms,23,10,13
60750,Kalusha,ragnaros,926,warrior,arms,72,29,43
60751,Taigola,aggramar,923,warrior,arms,22,11,11
60752,Krokgoldmane,drakkari,921,warrior,arms,48,24,24
60753,Mâmba,thrall,918,warrior,arms,24,10,14
60754,Velliena,tichondrius,916,warrior,arms,32,11,21
60755,Rocketbom,tichondrius,911,warrior,arms,23,10,13
60756,Beanstrom,tichondrius,911,warrior,arms,23,10,13
60757,Skarkla,thrall,911,warrior,arms,29,10,19
60758,Lobo,sargeras,911,warrior,arms,58,17,41
60759,Beyblade,jubeithos,910,warrior,arms,17,10,7
60760,Loudpee,tichondrius,910,warrior,arms,20,11,9
60761,Nexie,moon-guard,910,warrior,arms,21,10,11
60762,Kzw,illidan,910,warrior,arms,23,10,13
60763,Deathhit,barthilas,907,warrior,arms,18,10,8
60764,Lishajr,malganis,907,warrior,arms,32,16,16
60765,Llewellenar,stormrage,907,warrior,arms,23,10,13
60766,Warbreaker,stormrage,905,warrior,arms,17,10,7
60767,Spitts,frostmourne,904,warrior,arms,21,10,11
60768,Placerqt,ragnaros,903,warrior,arms,26,11,15
60769,Atrocithy,ragnaros,896,warrior,arms,16,10,6
60770,Doglegz,saurfang,896,warrior,arms,18,10,8
60771,Girioo,thrall,895,warrior,arms,14,10,4
60772,Ohjim,stormrage,892,warrior,arms,26,10,16
60773,Pumpuup,bleeding-hollow,890,warrior,arms,48,19,29
60774,Smokezee,barthilas,890,warrior,arms,26,10,16
60775,Machatlan,stormrage,889,warrior,arms,38,18,20
60776,Wallzar,sargeras,887,warrior,arms,20,10,10
60777,Hruum,moknathal,886,warrior,arms,18,10,8
60778,Tankadin,dragonmaw,885,warrior,arms,24,10,14
60779,Mortalchop,tichondrius,880,warrior,arms,19,10,9
60780,Poornub,emerald-dream,875,warrior,arms,19,11,8
60781,Moosebeef,garrosh,873,warrior,arms,67,32,35
60782,Sígmar,dreadmaul,869,warrior,arms,18,10,8
60783,Wreckerr,area-52,869,warrior,arms,26,12,14
60784,Moonyxx,frostmourne,864,warrior,arms,12,9,3
60785,Skynitez,area-52,864,warrior,arms,12,9,3
60786,Tobella,illidan,864,warrior,arms,12,9,3
60787,Iracor,stormrage,864,warrior,arms,12,9,3
60788,Dripgodx,malganis,864,warrior,arms,12,9,3
60789,Youngmoneyd,illidan,864,warrior,arms,12,9,3
60790,Joker,andorhal,864,warrior,arms,12,9,3
60791,Microraccoon,tichondrius,864,warrior,arms,12,9,3
60792,Dedgamesucks,darkspear,864,warrior,arms,12,9,3
60793,Anklebiter,aerie-peak,864,warrior,arms,18,9,9
60794,Solocon,tichondrius,864,warrior,arms,18,9,9
60795,Vanlur,khaz-modan,864,warrior,arms,18,9,9
60796,Grimfate,boulderfist,864,warrior,arms,18,9,9
60797,Mlau,tichondrius,864,warrior,arms,18,9,9
60798,Rageroidz,sargeras,864,warrior,arms,18,9,9
60799,Miniraccoon,tichondrius,864,warrior,arms,18,9,9
60800,Gläedr,dalaran,864,warrior,arms,18,9,9
60801,Gathzyx,tichondrius,864,warrior,arms,18,9,9
60802,Alchera,fizzcrank,864,warrior,arms,18,9,9
60803,Undeadbones,firetree,864,warrior,arms,18,9,9
60804,Dreamonn,illidan,864,warrior,arms,18,9,9
60805,Oafnir,moon-guard,864,warrior,arms,18,9,9
60806,Stÿgian,blood-furnace,864,warrior,arms,18,9,9
60807,Intricacy,tichondrius,864,warrior,arms,18,9,9
60808,Böô,tichondrius,864,warrior,arms,18,9,9
60809,Warwagon,the-underbog,864,warrior,arms,18,9,9
60810,Bbg,bleeding-hollow,864,warrior,arms,18,9,9
60811,Dreadtøøth,tichondrius,864,warrior,arms,24,9,15
60812,Dankdad,garrosh,864,warrior,arms,24,9,15
60813,Eensy,sargeras,864,warrior,arms,24,9,15
60814,Boxxyy,tichondrius,864,warrior,arms,24,9,15
60815,Dustywx,area-52,864,warrior,arms,24,9,15
60816,Sejac,moon-guard,864,warrior,arms,24,9,15
60817,Pretending,dalaran,864,warrior,arms,24,9,15
60818,Boardslide,proudmoore,864,warrior,arms,30,9,21
60819,Durist,tichondrius,864,warrior,arms,36,9,27
60820,Grehk,sargeras,863,warrior,arms,12,9,3
60821,Tinymooie,frostmourne,863,warrior,arms,12,9,3
60822,Roadglide,korgath,863,warrior,arms,12,9,3
60823,Eggheadorc,area-52,863,warrior,arms,12,9,3
60824,Stickystorm,proudmoore,863,warrior,arms,16,10,6
60825,Skorgebt,thrall,863,warrior,arms,18,9,9
60826,Chrom,illidan,863,warrior,arms,18,9,9
60827,Trén,hydraxis,863,warrior,arms,18,9,9
60828,Däwggy,tichondrius,863,warrior,arms,18,9,9
60829,Erdnase,ragnaros,863,warrior,arms,18,9,9
60830,Wxwxwxwxwxw,illidan,863,warrior,arms,18,9,9
60831,Tâte,sargeras,863,warrior,arms,18,9,9
60832,Nosoraki,thrall,863,warrior,arms,18,9,9
60833,Spxnk,illidan,863,warrior,arms,18,9,9
60834,Terneitor,ragnaros,863,warrior,arms,18,9,9
60835,Reckfül,proudmoore,863,warrior,arms,18,9,9
60836,Balthamel,dunemaul,863,warrior,arms,18,9,9
60837,Palauu,tichondrius,863,warrior,arms,18,9,9
60838,Greven,malganis,863,warrior,arms,18,9,9
60839,Sambojüjü,stormrage,863,warrior,arms,18,9,9
60840,Zaynafein,emerald-dream,863,warrior,arms,18,9,9
60841,Hasbullaa,proudmoore,863,warrior,arms,18,9,9
60842,Mechagodzila,kiljaeden,863,warrior,arms,18,9,9
60843,Kid,daggerspine,863,warrior,arms,18,9,9
60844,Averagewar,frostwolf,863,warrior,arms,18,9,9
60845,Coveiro,nemesis,863,warrior,arms,19,9,10
60846,Spincycle,khadgar,863,warrior,arms,21,9,12
60847,Laochra,aggramar,863,warrior,arms,24,9,15
60848,Skunkz,kelthuzad,863,warrior,arms,24,9,15
60849,Touhen,illidan,863,warrior,arms,24,9,15
60850,Notoxzy,tichondrius,863,warrior,arms,24,9,15
60851,Actio,stormrage,863,warrior,arms,24,9,15
60852,Wrecktang,tichondrius,863,warrior,arms,24,9,15
60853,Vrinith,ragnaros,863,warrior,arms,25,9,16
60854,Hammertoez,thunderhorn,863,warrior,arms,26,9,17
60855,Xumæ,akama,863,warrior,arms,30,9,21
60856,Madeus,quelthalas,863,warrior,arms,30,9,21
60857,Warwslayer,tichondrius,863,warrior,arms,30,9,21
60858,Qnl,sargeras,862,warrior,arms,16,10,6
60859,Xargosh,magtheridon,862,warrior,arms,18,9,9
60860,Izârâk,frostmourne,862,warrior,arms,18,9,9
60861,Um,moon-guard,862,warrior,arms,18,9,9
60862,Cogsbixby,aerie-peak,862,warrior,arms,18,9,9
60863,Wargorin,bleeding-hollow,862,warrior,arms,18,9,9
60864,Humansmash,thrall,862,warrior,arms,18,9,9
60865,Fatalsfury,tichondrius,862,warrior,arms,18,9,9
60866,Iskandr,amanthul,862,warrior,arms,21,10,11
60867,Xurc,gnomeregan,862,warrior,arms,24,9,15
60868,Wárriór,tichondrius,862,warrior,arms,24,9,15
60869,Ichigami,kelthuzad,862,warrior,arms,24,9,15
60870,Tbagg,area-52,862,warrior,arms,24,9,15
60871,Shniewind,ragnaros,862,warrior,arms,30,9,21
60872,Jodoro,malfurion,861,warrior,arms,18,9,9
60873,Bruxigar,ragnaros,861,warrior,arms,18,9,9
60874,Swolthelas,tichondrius,861,warrior,arms,18,9,9
60875,Avalisk,balnazzar,861,warrior,arms,21,10,11
60876,Vãryan,frostmourne,861,warrior,arms,24,9,15
60877,Gobx,tichondrius,861,warrior,arms,24,9,15
60878,Shínkicker,area-52,861,warrior,arms,24,9,15
60879,Durtmcsmash,stormrage,860,warrior,arms,18,9,9
60880,Ogundados,kelthuzad,860,warrior,arms,18,9,9
60881,Kurgos,quelthalas,860,warrior,arms,18,9,9
60882,Stormit,illidan,860,warrior,arms,19,9,10
60883,Jindyn,boulderfist,860,warrior,arms,64,29,35
60884,Marnan,quelthalas,860,warrior,arms,24,9,15
60885,Layllassa,moon-guard,860,warrior,arms,24,9,15
60886,Ultradma,area-52,860,warrior,arms,24,9,15
60887,Umogarmac,draktharon,860,warrior,arms,24,9,15
60888,Kiyokó,sargeras,859,warrior,arms,18,9,9
60889,Zhyper,frostmourne,859,warrior,arms,18,9,9
60890,Thörir,proudmoore,859,warrior,arms,18,9,9
60891,Vio,mannoroth,859,warrior,arms,18,9,9
60892,Nishtana,quelthalas,859,warrior,arms,18,9,9
60893,Tôpanga,lightninghoof,859,warrior,arms,24,9,15
60894,Féril,ragnaros,858,warrior,arms,18,9,9
60895,Åres,wyrmrest-accord,858,warrior,arms,18,9,9
60896,Corthíus,stormrage,858,warrior,arms,22,10,12
60897,Bachyr,stormrage,858,warrior,arms,24,9,15
60898,Deathstrøke,illidan,858,warrior,arms,30,9,21
60899,Boltmor,stormrage,857,warrior,arms,12,9,3
60900,Tinyguysmall,eredar,857,warrior,arms,22,11,11
60901,Gahii,barthilas,857,warrior,arms,18,9,9
60902,Kaimana,zuljin,857,warrior,arms,18,9,9
60903,Joshums,warsong,857,warrior,arms,26,10,16
60904,Karusuke,stormrage,857,warrior,arms,24,9,15
60905,Fugufish,nemesis,857,warrior,arms,24,9,15
60906,Sparkye,gallywix,856,warrior,arms,18,9,9
60907,Éllenor,azralon,856,warrior,arms,18,9,9
60908,Tomcruizes,tichondrius,856,warrior,arms,18,9,9
60909,Tsurik,malfurion,856,warrior,arms,30,9,21
60910,Eorik,stormrage,856,warrior,arms,36,9,27
60911,Daytime,scilla,855,warrior,arms,18,9,9
60912,Coldsnaps,azjolnerub,855,warrior,arms,18,9,9
60913,Preschool,sargeras,854,warrior,arms,12,9,3
60914,Kenroc,illidan,854,warrior,arms,18,9,9
60915,Wândêrer,wyrmrest-accord,854,warrior,arms,18,9,9
60916,Xarlon,stormrage,854,warrior,arms,21,10,11
60917,Garusok,thrall,853,warrior,arms,12,9,3
60918,Kkaell,azralon,852,warrior,arms,18,9,9
60919,Asiyurekhans,borean-tundra,851,warrior,arms,12,9,3
60920,Trigon,chromaggus,851,warrior,arms,18,9,9
60921,Jaimey,malganis,845,warrior,arms,23,9,14
60922,Whiteclouds,blood-furnace,844,warrior,arms,42,17,25
60923,Karadell,emerald-dream,843,warrior,arms,22,10,12
60924,Blockcheese,illidan,840,warrior,arms,30,9,21
60925,Lamaril,silvermoon,837,warrior,arms,12,9,3
60926,Molloywr,kelthuzad,831,warrior,arms,23,9,14
60927,Karrison,azshara,829,warrior,arms,85,41,44
60928,Eskama,hyjal,823,warrior,arms,29,9,20
60929,Hjoz,illidan,822,warrior,arms,16,9,7
60930,Beepboop,malganis,817,warrior,arms,18,9,9
60931,Rexxous,hyjal,815,warrior,arms,27,9,18
60932,Dupaminichav,stormrage,814,warrior,arms,15,9,6
60933,Bargorengar,skullcrusher,814,warrior,arms,78,34,44
60934,Vikkz,frostmourne,811,warrior,arms,23,9,14
60935,Scran,sargeras,809,warrior,arms,21,10,11
60936,Paí,nemesis,808,warrior,arms,17,9,8
60937,Gigazug,stormrage,799,warrior,arms,20,9,11
60938,Rahj,saurfang,799,warrior,arms,20,9,11
60939,Fatmân,tichondrius,798,warrior,arms,22,9,13
60940,Warrihoe,stormrage,798,warrior,arms,23,9,14
60941,Psychosicko,tichondrius,796,warrior,arms,17,9,8
60942,Alzuga,quelthalas,796,warrior,arms,26,9,17
60943,Dierdris,gnomeregan,795,warrior,arms,19,9,10
60944,Zemdur,azralon,795,warrior,arms,20,9,11
60945,Xcal,malganis,795,warrior,arms,20,9,11
60946,Murrdock,nesingwary,794,warrior,arms,14,9,5
60947,Thagunshow,tichondrius,794,warrior,arms,20,9,11
60948,Ripstorm,emerald-dream,794,warrior,arms,20,9,11
60949,Ruick,wyrmrest-accord,793,warrior,arms,18,9,9
60950,Vandalizer,sargeras,788,warrior,arms,20,10,10
60951,Joecules,kelthuzad,783,warrior,arms,17,9,8
60952,Morbaras,tichondrius,781,warrior,arms,25,9,16
60953,Koraciá,illidan,780,warrior,arms,19,9,10
60954,Traglos,ragnaros,768,warrior,arms,12,8,4
60955,Dadslapper,illidan,768,warrior,arms,12,8,4
60956,Gorva,emerald-dream,768,warrior,arms,12,8,4
60957,Willieruth,stormrage,768,warrior,arms,12,8,4
60958,Optym,onyxia,768,warrior,arms,12,8,4
60959,Cazora,ragnaros,768,warrior,arms,12,8,4
60960,Wreckfúll,sargeras,768,warrior,arms,12,8,4
60961,Clown,andorhal,768,warrior,arms,12,8,4
60962,Thornhardt,frostmourne,768,warrior,arms,12,8,4
60963,Huangatang,wyrmrest-accord,768,warrior,arms,12,8,4
60964,Patékphilípe,area-52,768,warrior,arms,12,8,4
60965,Smallbrainx,tichondrius,768,warrior,arms,12,8,4
60966,Sweeped,darkspear,768,warrior,arms,12,8,4
60967,Xaenne,zuljin,768,warrior,arms,12,8,4
60968,Zdokk,sargeras,768,warrior,arms,12,8,4
60969,Fløkî,azralon,768,warrior,arms,12,8,4
60970,Cjay,bleeding-hollow,768,warrior,arms,12,8,4
60971,Iced,tichondrius,768,warrior,arms,12,8,4
60972,Gabv,shadowmoon,768,warrior,arms,12,8,4
60973,Sleifx,quelthalas,768,warrior,arms,12,8,4
60974,Laggytwodope,kelthuzad,768,warrior,arms,12,8,4
60975,Zleam,area-52,768,warrior,arms,12,8,4
60976,Imakeupuddin,turalyon,768,warrior,arms,12,8,4
60977,Grüumsh,drenden,768,warrior,arms,12,8,4
60978,Msallsunday,nerzhul,768,warrior,arms,12,8,4
60979,Hoodslam,moon-guard,768,warrior,arms,12,8,4
60980,Saucebussin,emerald-dream,768,warrior,arms,12,8,4
60981,Staffed,area-52,768,warrior,arms,12,8,4
60982,Halibut,kelthuzad,768,warrior,arms,12,8,4
60983,Slaughterx,malganis,768,warrior,arms,12,8,4
60984,Armsupx,tichondrius,768,warrior,arms,12,8,4
60985,Dazuu,illidan,768,warrior,arms,18,8,10
60986,Tamajkaz,the-forgotten-coast,768,warrior,arms,18,8,10
60987,Supermieo,illidan,768,warrior,arms,18,8,10
60988,Gízzmo,tichondrius,768,warrior,arms,18,8,10
60989,Chronek,sargeras,768,warrior,arms,18,8,10
60990,Baaltica,ragnaros,768,warrior,arms,18,8,10
60991,Martrios,alexstrasza,768,warrior,arms,18,8,10
60992,Elitistx,bleeding-hollow,768,warrior,arms,18,8,10
60993,Stoneball,kiljaeden,768,warrior,arms,18,8,10
60994,Leunitas,shadow-council,768,warrior,arms,18,8,10
60995,Cuddlechamp,barthilas,768,warrior,arms,18,8,10
60996,Easylel,stormrage,768,warrior,arms,18,8,10
60997,Monkeystrike,barthilas,768,warrior,arms,18,8,10
60998,Tádakatsu,sargeras,768,warrior,arms,18,8,10
60999,Elkz,tichondrius,768,warrior,arms,18,8,10
61000,Elky,area-52,768,warrior,arms,18,8,10
61001,Ogre,magtheridon,768,warrior,arms,18,8,10
61002,Sabers,mannoroth,768,warrior,arms,18,8,10
61003,Linjunfeng,tichondrius,768,warrior,arms,18,8,10
61004,Ricksanches,shadowmoon,768,warrior,arms,18,8,10
61005,Majaya,area-52,768,warrior,arms,24,8,16
61006,Dirkdallas,tichondrius,768,warrior,arms,24,8,16
61007,Bornne,doomhammer,768,warrior,arms,30,8,22
61008,Executefreak,illidan,767,warrior,arms,12,8,4
61009,Husc,kiljaeden,767,warrior,arms,12,8,4
61010,Domminux,darkspear,767,warrior,arms,12,8,4
61011,Rúz,illidan,767,warrior,arms,12,8,4
61012,Mikeyforever,quelthalas,767,warrior,arms,12,8,4
61013,Rushee,argent-dawn,767,warrior,arms,12,8,4
61014,Pigblind,azralon,767,warrior,arms,12,8,4
61015,Tharez,stormrage,767,warrior,arms,12,8,4
61016,Ferdaliance,tichondrius,767,warrior,arms,12,8,4
61017,Alucardio,turalyon,767,warrior,arms,12,8,4
61018,Dukar,crushridge,767,warrior,arms,12,8,4
61019,Letsgosmokes,stormrage,767,warrior,arms,12,8,4
61020,Azziiqt,stormrage,767,warrior,arms,12,8,4
61021,Kixxel,sargeras,767,warrior,arms,12,8,4
61022,Mongosyco,proudmoore,767,warrior,arms,12,8,4
61023,Warwagon,malganis,767,warrior,arms,12,8,4
61024,Wantor,lightnings-blade,767,warrior,arms,12,8,4
61025,Silac,drenden,767,warrior,arms,12,8,4
61026,Gränd,frostmourne,767,warrior,arms,12,8,4
61027,Blazingguard,stormrage,767,warrior,arms,12,8,4
61028,Bloodface,azralon,767,warrior,arms,13,8,5
61029,Zédelívery,azralon,767,warrior,arms,16,9,7
61030,Azkaosa,tichondrius,767,warrior,arms,18,8,10
61031,Nogèt,frostmourne,767,warrior,arms,18,8,10
61032,Laylowk,tichondrius,767,warrior,arms,18,8,10
61033,Moarbrainz,mannoroth,767,warrior,arms,18,8,10
61034,Wakaflaka,kiljaeden,767,warrior,arms,18,8,10
61035,Houdinix,stormrage,767,warrior,arms,18,8,10
61036,Ihazlolstorm,area-52,767,warrior,arms,18,8,10
61037,Dalinare,area-52,767,warrior,arms,18,8,10
61038,Æwarrìor,tichondrius,767,warrior,arms,18,8,10
61039,Broxar,area-52,767,warrior,arms,18,8,10
61040,Speedyfarm,sargeras,767,warrior,arms,18,8,10
61041,Fraxxure,proudmoore,767,warrior,arms,18,8,10
61042,Nanor,zuljin,767,warrior,arms,18,8,10
61043,Jorked,drakkari,767,warrior,arms,18,8,10
61044,Slashup,sargeras,767,warrior,arms,18,8,10
61045,Drusillaa,deathwing,767,warrior,arms,18,8,10
61046,Pípe,nemesis,767,warrior,arms,18,8,10
61047,Jódiarias,bleeding-hollow,767,warrior,arms,18,8,10
61048,Elegorn,nemesis,767,warrior,arms,18,8,10
61049,Execute,kirin-tor,767,warrior,arms,18,8,10
61050,Geubsalx,tichondrius,767,warrior,arms,18,8,10
61051,Empyrius,exodar,767,warrior,arms,18,8,10
61052,Orgreshin,area-52,767,warrior,arms,21,9,12
61053,Sabini,nemesis,767,warrior,arms,24,8,16
61054,Cajual,area-52,767,warrior,arms,24,8,16
61055,Cevadix,azralon,767,warrior,arms,24,8,16
61056,Rraw,demon-soul,767,warrior,arms,24,8,16
61057,Brawnforce,shadowsong,767,warrior,arms,24,8,16
61058,Essofeit,frostmourne,767,warrior,arms,24,8,16
61059,Techanina,aerie-peak,767,warrior,arms,24,8,16
61060,Mondëgo,stormrage,767,warrior,arms,24,8,16
61061,Headsour,thunderhorn,767,warrior,arms,30,8,22
61062,Khrull,khazgoroth,766,warrior,arms,12,8,4
61063,Ragarok,jubeithos,766,warrior,arms,12,8,4
61064,Houk,frostmourne,766,warrior,arms,12,8,4
61065,Zhasi,bonechewer,766,warrior,arms,12,8,4
61066,Warriorc,laughing-skull,766,warrior,arms,12,8,4
61067,Horvv,frostmourne,766,warrior,arms,12,8,4
61068,Thesmackboi,sargeras,766,warrior,arms,12,8,4
61069,Jackhanma,kelthuzad,766,warrior,arms,12,8,4
61070,Brodin,maelstrom,766,warrior,arms,12,8,4
61071,Sálieri,ragnaros,766,warrior,arms,18,8,10
61072,Chj,kelthuzad,766,warrior,arms,18,8,10
61073,Truecarnage,emerald-dream,766,warrior,arms,18,8,10
61074,Camphump,moon-guard,766,warrior,arms,18,8,10
61075,Edalthor,quelthalas,766,warrior,arms,18,8,10
61076,Donnacha,garona,766,warrior,arms,18,8,10
61077,Hemmyroidz,tichondrius,766,warrior,arms,18,8,10
61078,Javabaenss,tichondrius,766,warrior,arms,18,8,10
61079,Bigsquiggle,blackrock,766,warrior,arms,18,8,10
61080,Orthopedic,tichondrius,766,warrior,arms,18,8,10
61081,Zrads,zuljin,766,warrior,arms,19,8,11
61082,Violençe,malganis,766,warrior,arms,24,8,16
61083,Xforcewar,zuljin,766,warrior,arms,24,8,16
61084,Damadar,malganis,766,warrior,arms,24,8,16
61085,Modzilla,aerie-peak,766,warrior,arms,30,8,22
61086,Léva,ragnaros,765,warrior,arms,12,8,4
61087,Kurgrok,kiljaeden,765,warrior,arms,12,8,4
61088,Belladeom,azralon,765,warrior,arms,18,8,10
61089,Xeto,ragnaros,765,warrior,arms,18,8,10
61090,Ulfioff,whisperwind,765,warrior,arms,18,8,10
61091,Vassild,firetree,765,warrior,arms,18,8,10
61092,Uragiri,shadowsong,765,warrior,arms,18,8,10
61093,Percthirty,blackrock,765,warrior,arms,18,8,10
61094,Franklenn,mannoroth,765,warrior,arms,24,8,16
61095,Lui,the-forgotten-coast,765,warrior,arms,24,8,16
61096,Maxprotein,area-52,764,warrior,arms,14,8,6
61097,Harattawi,thrall,764,warrior,arms,18,8,10
61098,Alexarchos,chogall,764,warrior,arms,18,8,10
61099,Nosferagc,frostmourne,764,warrior,arms,21,9,12
61100,Exist,kaelthas,764,warrior,arms,24,8,16
61101,Daniín,azralon,764,warrior,arms,25,8,17
61102,Friends,azjolnerub,763,warrior,arms,18,8,10
61103,Croton,moon-guard,763,warrior,arms,18,8,10
61104,Luneblade,tichondrius,763,warrior,arms,18,8,10
61105,Chamfer,illidan,763,warrior,arms,18,8,10
61106,Sygw,area-52,763,warrior,arms,24,8,16
61107,Hellus,tichondrius,763,warrior,arms,24,8,16
61108,Shìromìzù,eredar,762,warrior,arms,12,8,4
61109,Tarmer,moon-guard,762,warrior,arms,18,8,10
61110,Sweetdeé,zuljin,762,warrior,arms,18,8,10
61111,Arktoast,tichondrius,762,warrior,arms,24,8,16
61112,Revenn,greymane,761,warrior,arms,12,8,4
61113,Jårko,dathremar,761,warrior,arms,18,8,10
61114,Lumilis,draenor,760,warrior,arms,18,8,10
61115,Vynfull,area-52,760,warrior,arms,18,8,10
61116,Rafaelwar,drakkari,758,warrior,arms,18,8,10
61117,Badazzdad,thunderhorn,757,warrior,arms,18,8,10
61118,Trapwar,malganis,755,warrior,arms,12,8,4
61119,Bilmuuri,illidan,754,warrior,arms,27,9,18
61120,Fleshtuxedo,stormrage,752,warrior,arms,12,8,4
61121,Bratomil,amanthul,751,warrior,arms,18,8,10
61122,Xomis,thrall,750,warrior,arms,17,8,9
61123,Tgnomeless,gilneas,750,warrior,arms,25,8,17
61124,Gladiattor,tol-barad,749,warrior,arms,18,8,10
61125,Dadookibooty,area-52,740,warrior,arms,24,11,13
61126,Ironwarr,hyjal,740,warrior,arms,23,8,15
61127,Vetinari,nazjatar,735,warrior,arms,11,8,3
61128,Outo,stormrage,735,warrior,arms,17,8,9
61129,Casmier,tichondrius,734,warrior,arms,17,8,9
61130,Tánktop,sargeras,733,warrior,arms,14,9,5
61131,Gorakis,barthilas,733,warrior,arms,20,9,11
61132,Saigø,stormrage,723,warrior,arms,18,8,10
61133,Señor,barthilas,719,warrior,arms,15,8,7
61134,Mêlo,area-52,719,warrior,arms,17,8,9
61135,Randywar,tichondrius,719,warrior,arms,21,8,13
61136,Wreckthis,area-52,718,warrior,arms,17,8,9
61137,Ârmstrong,quelthalas,714,warrior,arms,23,10,13
61138,Alemão,bleeding-hollow,713,warrior,arms,23,9,14
61139,Hrothtyr,kelthuzad,702,warrior,arms,20,8,12
61140,Tabadigbick,bleeding-hollow,698,warrior,arms,17,8,9
61141,Hordrek,moon-guard,688,warrior,arms,13,8,5
61142,Psyrush,area-52,687,warrior,arms,19,8,11
61143,Valuxia,sargeras,687,warrior,arms,19,8,11
61144,Earfquake,boulderfist,686,warrior,arms,13,8,5
61145,Greenbrain,dunemaul,685,warrior,arms,19,8,11
61146,Grounyl,azralon,672,warrior,arms,12,7,5
61147,Drashka,ragnaros,672,warrior,arms,12,7,5
61148,Dehumanized,greymane,672,warrior,arms,12,7,5
61149,Nekopara,caelestrasz,672,warrior,arms,12,7,5
61150,Jypster,stormrage,672,warrior,arms,12,7,5
61151,Gbrz,stormrage,672,warrior,arms,12,7,5
61152,Kevy,arygos,672,warrior,arms,12,7,5
61153,Madamemarie,stormrage,672,warrior,arms,12,7,5
61154,Espadotas,ragnaros,672,warrior,arms,12,7,5
61155,Cuzmyslam,sargeras,672,warrior,arms,12,7,5
61156,Spaceslam,tichondrius,672,warrior,arms,12,7,5
61157,Deseroth,sargeras,672,warrior,arms,12,7,5
61158,Tunnelvision,garrosh,672,warrior,arms,12,7,5
61159,Spartagux,dalaran,672,warrior,arms,12,7,5
61160,Arsis,whisperwind,672,warrior,arms,12,7,5
61161,Studdythejet,zuljin,672,warrior,arms,12,7,5
61162,Korbles,moon-guard,672,warrior,arms,12,7,5
61163,Madmartiggan,tichondrius,672,warrior,arms,12,7,5
61164,Kufflinks,kelthuzad,672,warrior,arms,12,7,5
61165,Slaughtér,tichondrius,672,warrior,arms,12,7,5
61166,Petuniä,zuljin,672,warrior,arms,12,7,5
61167,Deathammer,stormrage,672,warrior,arms,12,7,5
61168,Toungy,kelthuzad,672,warrior,arms,12,7,5
61169,Qutuz,illidan,672,warrior,arms,12,7,5
61170,Papazugs,kelthuzad,672,warrior,arms,12,7,5
61171,Warzôg,emerald-dream,672,warrior,arms,12,7,5
61172,Raeging,area-52,672,warrior,arms,12,7,5
61173,Baye,kargath,672,warrior,arms,12,7,5
61174,Furìous,stormrage,672,warrior,arms,12,7,5
61175,Niulaoye,tichondrius,672,warrior,arms,12,7,5
61176,Nayuta,area-52,672,warrior,arms,12,7,5
61177,Executor,mugthol,672,warrior,arms,12,7,5
61178,Mouncha,tichondrius,672,warrior,arms,12,7,5
61179,Bullwar,barthilas,672,warrior,arms,12,7,5
61180,Jahrakál,thunderlord,672,warrior,arms,12,7,5
61181,Cugij,frostmourne,672,warrior,arms,12,7,5
61182,Bloodshêdz,stormrage,672,warrior,arms,12,7,5
61183,Ousetadoidao,nemesis,672,warrior,arms,12,7,5
61184,Ischyrós,stormrage,672,warrior,arms,12,7,5
61185,Mõgorrin,area-52,672,warrior,arms,12,7,5
61186,Püsspeepers,kelthuzad,672,warrior,arms,12,7,5
61187,Jaysmom,tichondrius,672,warrior,arms,12,7,5
61188,Turtleofhope,barthilas,672,warrior,arms,12,7,5
61189,Roiboy,stormrage,672,warrior,arms,12,7,5
61190,Hinsionzillu,proudmoore,672,warrior,arms,12,7,5
61191,Yrz,malganis,672,warrior,arms,12,7,5
61192,Fernzie,malganis,672,warrior,arms,12,7,5
61193,Vids,aegwynn,672,warrior,arms,12,7,5
61194,Kahn,andorhal,672,warrior,arms,12,7,5
61195,Okayge,proudmoore,672,warrior,arms,12,7,5
61196,Giv,frostmourne,672,warrior,arms,12,7,5
61197,Magnusz,zuljin,672,warrior,arms,12,7,5
61198,Yqoos,tichondrius,672,warrior,arms,12,7,5
61199,Havocsmash,tichondrius,672,warrior,arms,12,7,5
61200,Benbtw,malganis,672,warrior,arms,12,7,5
61201,Jesbar,ragnaros,672,warrior,arms,12,7,5
61202,Bean,ragnaros,672,warrior,arms,12,7,5
61203,Xdoombringer,area-52,672,warrior,arms,12,7,5
61204,Hopefulki,duskwood,672,warrior,arms,12,7,5
61205,Ryalaeth,moon-guard,672,warrior,arms,12,7,5
61206,Vxjohnson,proudmoore,672,warrior,arms,15,8,7
61207,Kappiz,wyrmrest-accord,672,warrior,arms,14,7,7
61208,Infâmous,proudmoore,672,warrior,arms,18,7,11
61209,Zuans,azralon,672,warrior,arms,18,7,11
61210,Ignorebrain,tichondrius,672,warrior,arms,18,7,11
61211,Sayjaki,stormrage,672,warrior,arms,18,7,11
61212,Beatstickz,malganis,672,warrior,arms,18,7,11
61213,Pangus,uldum,672,warrior,arms,18,7,11
61214,Kerrena,kelthuzad,672,warrior,arms,18,7,11
61215,Uglyfuq,bleeding-hollow,672,warrior,arms,18,7,11
61216,Jackmonkey,the-forgotten-coast,672,warrior,arms,18,7,11
61217,Ivory,emerald-dream,672,warrior,arms,18,7,11
61218,Käggai,khadgar,672,warrior,arms,18,7,11
61219,Orczug,tichondrius,672,warrior,arms,18,7,11
61220,Hellizzy,sargeras,672,warrior,arms,18,7,11
61221,Hazelbean,tichondrius,672,warrior,arms,18,7,11
61222,Eronara,emerald-dream,672,warrior,arms,18,7,11
61223,Kraft,azralon,672,warrior,arms,18,7,11
61224,Buddypalmer,bleeding-hollow,672,warrior,arms,18,7,11
61225,Ulamøg,proudmoore,672,warrior,arms,18,7,11
61226,Yamzprime,stormrage,672,warrior,arms,18,7,11
61227,Ryänlord,mugthol,672,warrior,arms,18,7,11
61228,July,arthas,672,warrior,arms,18,7,11
61229,Udmwarrior,zuljin,672,warrior,arms,18,7,11
61230,Lorewow,quelthalas,672,warrior,arms,18,7,11
61231,Arquiem,ragnaros,672,warrior,arms,18,7,11
61232,Dypnos,ragnaros,672,warrior,arms,18,7,11
61233,Goyqqw,illidan,672,warrior,arms,18,7,11
61234,Kforti,kiljaeden,672,warrior,arms,18,7,11
61235,Hårrison,tichondrius,672,warrior,arms,18,7,11
61236,Rudakoff,ragnaros,672,warrior,arms,18,7,11
61237,Beifong,barthilas,672,warrior,arms,24,7,17
61238,Paralyzed,malganis,672,warrior,arms,24,7,17
61239,Omlas,azralon,672,warrior,arms,24,7,17
61240,Festerclaws,wyrmrest-accord,672,warrior,arms,24,7,17
61241,Corevp,barthilas,672,warrior,arms,24,7,17
61242,Natalieftm,tichondrius,672,warrior,arms,24,7,17
61243,Pokeyobutt,hydraxis,672,warrior,arms,24,7,17
61244,Zugmeov,barthilas,672,warrior,arms,24,7,17
61245,Joaododrøp,azralon,671,warrior,arms,12,7,5
61246,Vijit,stormrage,671,warrior,arms,12,7,5
61247,Gunnëy,malganis,671,warrior,arms,12,7,5
61248,Sriara,ragnaros,671,warrior,arms,12,7,5
61249,Furiousangel,area-52,671,warrior,arms,12,7,5
61250,Riffralph,quelthalas,671,warrior,arms,12,7,5
61251,Girthstick,eredar,671,warrior,arms,12,7,5
61252,Rhuktar,azralon,671,warrior,arms,12,7,5
61253,Capo,windrunner,671,warrior,arms,12,7,5
61254,Iradri,wyrmrest-accord,671,warrior,arms,12,7,5
61255,Coffeephd,moon-guard,671,warrior,arms,12,7,5
61256,Hungdiesel,area-52,671,warrior,arms,12,7,5
61257,Jeason,ragnaros,671,warrior,arms,12,7,5
61258,Dêsêcratê,frostmourne,671,warrior,arms,12,7,5
61259,Nyokenshi,quelthalas,671,warrior,arms,12,7,5
61260,Balela,sargeras,671,warrior,arms,12,7,5
61261,Dunkindots,tichondrius,671,warrior,arms,12,7,5
61262,Pipeman,blackhand,671,warrior,arms,12,7,5
61263,Exceldoc,frostwolf,671,warrior,arms,12,7,5
61264,Blazie,barthilas,671,warrior,arms,12,7,5
61265,Maddzspin,tichondrius,671,warrior,arms,12,7,5
61266,Schwicker,stormrage,671,warrior,arms,12,7,5
61267,Glizzarms,dalaran,671,warrior,arms,12,7,5
61268,Kevinlanders,sargeras,671,warrior,arms,12,7,5
61269,Jedeva,stormrage,671,warrior,arms,12,7,5
61270,Ramborco,kelthuzad,671,warrior,arms,12,7,5
61271,Kryssanta,kilrogg,671,warrior,arms,13,7,6
61272,Metaphoric,stormrage,671,warrior,arms,15,8,7
61273,Ironhide,malorne,671,warrior,arms,18,7,11
61274,Stepzugger,illidan,671,warrior,arms,18,7,11
61275,Chieef,illidan,671,warrior,arms,18,7,11
61276,Bröstörm,bonechewer,671,warrior,arms,18,7,11
61277,Mustachelove,bleeding-hollow,671,warrior,arms,18,7,11
61278,Rembrand,blackhand,671,warrior,arms,18,7,11
61279,Analítico,ragnaros,671,warrior,arms,18,7,11
61280,Layøut,azralon,671,warrior,arms,18,7,11
61281,Mirandakerrx,frostmourne,671,warrior,arms,18,7,11
61282,Nehpets,akama,671,warrior,arms,18,7,11
61283,Pharan,malganis,671,warrior,arms,18,7,11
61284,Earnhardt,tichondrius,671,warrior,arms,18,7,11
61285,Kasheeka,spirestone,671,warrior,arms,18,7,11
61286,Cj,proudmoore,671,warrior,arms,18,7,11
61287,Paratech,thrall,671,warrior,arms,18,7,11
61288,Smash,frostmane,671,warrior,arms,18,7,11
61289,Strongtongue,malganis,671,warrior,arms,18,7,11
61290,Mentalape,bleeding-hollow,671,warrior,arms,18,7,11
61291,Conviction,draka,671,warrior,arms,18,7,11
61292,Brøxigár,quelthalas,671,warrior,arms,18,7,11
61293,Chumbinhu,stormrage,671,warrior,arms,18,7,11
61294,Flabergaster,skullcrusher,671,warrior,arms,18,7,11
61295,Moffett,illidan,671,warrior,arms,18,7,11
61296,Grazellor,khaz-modan,671,warrior,arms,18,7,11
61297,Slöppyjoe,blackrock,671,warrior,arms,18,7,11
61298,Andrexion,moon-guard,671,warrior,arms,18,7,11
61299,Xeniwar,tichondrius,671,warrior,arms,20,7,13
61300,Powerjaw,stormrage,671,warrior,arms,24,7,17
61301,Zerevik,stormrage,671,warrior,arms,24,7,17
61302,Tryndåmere,firetree,671,warrior,arms,24,7,17
61303,Winso,blood-furnace,671,warrior,arms,24,7,17
61304,Vandammage,cenarion-circle,671,warrior,arms,24,7,17
61305,Czartacus,dalaran,670,warrior,arms,14,9,5
61306,Svantevit,tichondrius,670,warrior,arms,12,7,5
61307,Hoboken,quelthalas,670,warrior,arms,12,7,5
61308,Nraged,illidan,670,warrior,arms,12,7,5
61309,Oglethorrpe,dragonmaw,670,warrior,arms,12,7,5
61310,Deathlokz,proudmoore,670,warrior,arms,12,7,5
61311,Murrderrface,azgalor,670,warrior,arms,12,7,5
61312,Darquan,trollbane,670,warrior,arms,12,7,5
61313,Eirikdahulk,area-52,670,warrior,arms,12,7,5
61314,Draggo,tortheldrin,670,warrior,arms,12,7,5
61315,Promewar,ragnaros,670,warrior,arms,12,7,5
61316,Babyreap,frostmourne,670,warrior,arms,12,7,5
61317,Bailo,dathremar,670,warrior,arms,12,7,5
61318,Gìraffe,illidan,670,warrior,arms,18,7,11
61319,Dizzygal,hyjal,670,warrior,arms,18,7,11
61320,Daleo,ragnaros,670,warrior,arms,18,7,11
61321,Kaimera,echo-isles,670,warrior,arms,18,7,11
61322,Aquaknight,tortheldrin,670,warrior,arms,18,7,11
61323,Reidahn,zuljin,670,warrior,arms,24,7,17
61324,Tarviss,exodar,670,warrior,arms,26,7,19
61325,Torage,wyrmrest-accord,669,warrior,arms,12,7,5
61326,Astrokreep,emerald-dream,669,warrior,arms,12,7,5
61327,Guille,skullcrusher,669,warrior,arms,12,7,5
61328,Getoffmee,queldorei,669,warrior,arms,18,7,11
61329,Kâyous,tichondrius,669,warrior,arms,18,7,11
61330,Harnor,garrosh,669,warrior,arms,18,7,11
61331,Teyliemond,amanthul,668,warrior,arms,12,7,5
61332,Grokash,azralon,668,warrior,arms,18,7,11
61333,Nepheliloux,amanthul,668,warrior,arms,18,7,11
61334,Pandamoanman,moon-guard,668,warrior,arms,18,7,11
61335,Azaeil,tanaris,668,warrior,arms,18,7,11
61336,Yanïka,barthilas,667,warrior,arms,13,7,6
61337,Moøster,aggramar,667,warrior,arms,18,7,11
61338,Sienge,tortheldrin,667,warrior,arms,18,7,11
61339,Rogkhan,tichondrius,667,warrior,arms,18,7,11
61340,Kevasaurr,sargeras,667,warrior,arms,24,7,17
61341,Zammuro,sargeras,666,warrior,arms,12,7,5
61342,Mattrick,hyjal,665,warrior,arms,12,7,5
61343,Terribletom,stormrage,665,warrior,arms,18,7,11
61344,Wnunes,nemesis,665,warrior,arms,18,7,11
61345,Nepharia,kirin-tor,664,warrior,arms,18,7,11
61346,Jötunn,dalaran,663,warrior,arms,12,7,5
61347,Kriegert,illidan,663,warrior,arms,12,7,5
61348,Othon,nemesis,663,warrior,arms,12,7,5
61349,Lilwarrior,blackrock,661,warrior,arms,12,7,5
61350,Konstanttine,darkspear,660,warrior,arms,13,7,6
61351,Dragothian,laughing-skull,655,warrior,arms,17,7,10
61352,Blok,malorne,655,warrior,arms,17,7,10
61353,Garrygarry,zuljin,639,warrior,arms,14,8,6
61354,Agnesis,quelthalas,639,warrior,arms,16,7,9
61355,Parmizan,hydraxis,639,warrior,arms,16,7,9
61356,Moostorm,darkspear,639,warrior,arms,17,7,10
61357,Fewfingers,sargeras,638,warrior,arms,16,7,9
61358,Jamska,quelthalas,638,warrior,arms,17,7,10
61359,Twinxin,thrall,637,warrior,arms,17,7,10
61360,Rametep,illidan,624,warrior,arms,15,7,8
61361,Oohyu,tichondrius,623,warrior,arms,11,7,4
61362,Tildzy,sargeras,623,warrior,arms,11,7,4
61363,Allenwalker,dreadmaul,623,warrior,arms,13,7,6
61364,Haveya,ghostlands,623,warrior,arms,15,7,8
61365,Bigboycandy,malganis,621,warrior,arms,11,7,4
61366,Bullkathoss,bleeding-hollow,620,warrior,arms,23,8,15
61367,Xunaco,quelthalas,620,warrior,arms,26,7,19
61368,Shabus,moon-guard,617,warrior,arms,21,8,13
61369,Ålbedo,malganis,616,warrior,arms,23,8,15
61370,Kimuraa,hyjal,615,warrior,arms,23,9,14
61371,Spartanor,darkspear,607,warrior,arms,20,7,13
61372,Pkrage,hellscream,606,warrior,arms,11,7,4
61373,Reliquia,quelthalas,606,warrior,arms,20,7,13
61374,Suhwoosh,bleeding-hollow,584,warrior,arms,28,10,18
61375,Nada,eredar,576,warrior,arms,6,6,0
61376,Elpresador,dragonmaw,576,warrior,arms,6,6,0
61377,Dóminus,malfurion,576,warrior,arms,6,6,0
61378,Baltusrol,hydraxis,576,warrior,arms,6,6,0
61379,Khalwar,ragnaros,576,warrior,arms,6,6,0
61380,Darkoil,illidan,576,warrior,arms,6,6,0
61381,Roflcombo,illidan,576,warrior,arms,12,6,6
61382,Sorr,bonechewer,576,warrior,arms,12,6,6
61383,Arên,ragnaros,576,warrior,arms,12,6,6
61384,Swiftystorm,thrall,576,warrior,arms,12,6,6
61385,Tmgagexx,tichondrius,576,warrior,arms,12,6,6
61386,Stÿgían,kelthuzad,576,warrior,arms,12,6,6
61387,Catêyês,kelthuzad,576,warrior,arms,12,6,6
61388,Lathian,sargeras,576,warrior,arms,12,6,6
61389,Illmindofboo,tichondrius,576,warrior,arms,12,6,6
61390,Gladdz,moon-guard,576,warrior,arms,12,6,6
61391,Gílly,borean-tundra,576,warrior,arms,12,6,6
61392,Mebraindead,tichondrius,576,warrior,arms,12,6,6
61393,Ctc,gilneas,576,warrior,arms,12,6,6
61394,Rattw,area-52,576,warrior,arms,12,6,6
61395,Screwz,blackrock,576,warrior,arms,12,6,6
61396,Kronathas,stormrage,576,warrior,arms,12,6,6
61397,Jakslasfa,aegwynn,576,warrior,arms,12,6,6
61398,Flanrych,illidan,576,warrior,arms,12,6,6
61399,Larrythelob,kelthuzad,576,warrior,arms,12,6,6
61400,Feedmetren,tichondrius,576,warrior,arms,12,6,6
61401,Rendron,frostmourne,576,warrior,arms,12,6,6
61402,Inkurushio,suramar,576,warrior,arms,12,6,6
61403,Latorre,kelthuzad,576,warrior,arms,12,6,6
61404,Brrazze,moon-guard,576,warrior,arms,12,6,6
61405,Hülkamanïa,sargeras,576,warrior,arms,12,6,6
61406,Mufasaprime,ursin,576,warrior,arms,12,6,6
61407,Bagginses,quelthalas,576,warrior,arms,12,6,6
61408,Jerebeloz,proudmoore,576,warrior,arms,12,6,6
61409,Kovarro,stormrage,576,warrior,arms,12,6,6
61410,Sodarzok,thaurissan,576,warrior,arms,12,6,6
61411,Azrailz,stormrage,576,warrior,arms,12,6,6
61412,Targramu,emerald-dream,576,warrior,arms,12,6,6
61413,Prìscìlla,stormrage,576,warrior,arms,12,6,6
61414,Trexxen,stormrage,576,warrior,arms,12,6,6
61415,Hitwkey,tichondrius,576,warrior,arms,12,6,6
61416,Aùstin,moon-guard,576,warrior,arms,12,6,6
61417,Dgumby,illidan,576,warrior,arms,12,6,6
61418,Xilents,frostmourne,576,warrior,arms,12,6,6
61419,Warnazx,azralon,576,warrior,arms,12,6,6
61420,Yenør,stormrage,576,warrior,arms,12,6,6
61421,Zingywar,tichondrius,576,warrior,arms,12,6,6
61422,Raahj,sargeras,576,warrior,arms,12,6,6
61423,Rexquando,barthilas,576,warrior,arms,12,6,6
61424,Rokknark,stormrage,576,warrior,arms,12,6,6
61425,Nooniezpw,tichondrius,576,warrior,arms,12,6,6
61426,Bedman,tichondrius,576,warrior,arms,12,6,6
61427,Iromrogar,area-52,576,warrior,arms,12,6,6
61428,Chura,kiljaeden,576,warrior,arms,12,6,6
61429,Spikedudley,wildhammer,576,warrior,arms,12,6,6
61430,Bailu,ragnaros,576,warrior,arms,12,6,6
61431,Griftustle,moon-guard,576,warrior,arms,12,6,6
61432,Sadomize,kiljaeden,576,warrior,arms,12,6,6
61433,Hololeave,tichondrius,576,warrior,arms,12,6,6
61434,Jabakas,tichondrius,576,warrior,arms,12,6,6
61435,Bamlin,sargeras,576,warrior,arms,12,6,6
61436,Cleaveson,malganis,576,warrior,arms,12,6,6
61437,Luminiere,sargeras,576,warrior,arms,12,6,6
61438,Madrak,greymane,576,warrior,arms,12,6,6
61439,Róngor,ragnaros,576,warrior,arms,12,6,6
61440,Señortryhard,area-52,576,warrior,arms,12,6,6
61441,Kuraiaki,crushridge,576,warrior,arms,12,6,6
61442,Breaker,undermine,576,warrior,arms,12,6,6
61443,Brookiecooki,frostmourne,576,warrior,arms,12,6,6
61444,Deicide,quelthalas,576,warrior,arms,12,6,6
61445,Dustiezi,stormrage,576,warrior,arms,12,6,6
61446,Ayaseharuqt,quelthalas,576,warrior,arms,12,6,6
61447,Flidumpling,tichondrius,576,warrior,arms,12,6,6
61448,Biorhn,area-52,576,warrior,arms,12,6,6
61449,Gnomërcy,tichondrius,576,warrior,arms,12,6,6
61450,Êraser,tichondrius,576,warrior,arms,12,6,6
61451,Amortens,area-52,576,warrior,arms,12,6,6
61452,Sigrik,moon-guard,576,warrior,arms,12,6,6
61453,Chrig,tichondrius,576,warrior,arms,12,6,6
61454,Murdokkwml,ragnaros,576,warrior,arms,12,6,6
61455,Linios,tichondrius,576,warrior,arms,12,6,6
61456,Dreamwarr,tichondrius,576,warrior,arms,12,6,6
61457,Clutchclutz,spirestone,576,warrior,arms,12,6,6
61458,Loxcrow,sargeras,576,warrior,arms,12,6,6
61459,Grughak,kiljaeden,576,warrior,arms,12,6,6
61460,Zugsok,thrall,576,warrior,arms,12,6,6
61461,Prontera,illidan,576,warrior,arms,12,6,6
61462,Blazight,dunemaul,576,warrior,arms,12,6,6
61463,Calledon,emerald-dream,576,warrior,arms,12,6,6
61464,Psychescape,cenarius,576,warrior,arms,12,6,6
61465,Glourfindel,quelthalas,576,warrior,arms,12,6,6
61466,Toegap,illidan,576,warrior,arms,12,6,6
61467,Luckychaos,bleeding-hollow,576,warrior,arms,12,6,6
61468,Hipower,lethon,576,warrior,arms,12,6,6
61469,Warsongworg,tichondrius,576,warrior,arms,12,6,6
61470,Littlemieoo,sargeras,576,warrior,arms,12,6,6
61471,Oxxelfer,tichondrius,576,warrior,arms,12,6,6
61472,Assamith,nemesis,576,warrior,arms,12,6,6
61473,Cannibalizm,hyjal,576,warrior,arms,12,6,6
61474,Ratherfull,ragnaros,576,warrior,arms,12,6,6
61475,Cassetto,icecrown,576,warrior,arms,12,6,6
61476,Sunderstruck,boulderfist,576,warrior,arms,12,6,6
61477,Areiana,stormrage,576,warrior,arms,12,6,6
61478,Dollfacelol,bleeding-hollow,576,warrior,arms,12,6,6
61479,Kazabare,tichondrius,576,warrior,arms,12,6,6
61480,Ibyessa,emerald-dream,576,warrior,arms,12,6,6
61481,Reflective,zuljin,576,warrior,arms,12,6,6
61482,Roccoz,quelthalas,576,warrior,arms,12,6,6
61483,Dysazter,ravencrest,576,warrior,arms,12,6,6
61484,Tàlent,thrall,576,warrior,arms,12,6,6
61485,Devastata,jaedenar,576,warrior,arms,12,6,6
61486,Caperage,tichondrius,576,warrior,arms,12,6,6
61487,Gonthoriàn,stormrage,576,warrior,arms,12,6,6
61488,Alphablade,frostmourne,576,warrior,arms,12,6,6
61489,Fatpoos,barthilas,576,warrior,arms,12,6,6
61490,Zzode,tichondrius,576,warrior,arms,12,6,6
61491,Marîn,stormrage,576,warrior,arms,12,6,6
61492,Szar,stormrage,576,warrior,arms,12,6,6
61493,Arozay,illidan,576,warrior,arms,12,6,6
61494,Bonclay,nerzhul,576,warrior,arms,12,6,6
61495,Pyrælara,shattered-halls,576,warrior,arms,12,6,6
61496,Rikthor,sargeras,576,warrior,arms,12,6,6
61497,Armsofury,kelthuzad,576,warrior,arms,12,6,6
61498,Aladarith,moon-guard,576,warrior,arms,12,6,6
61499,Martiallawl,skullcrusher,576,warrior,arms,12,6,6
61500,Orkussw,illidan,576,warrior,arms,12,6,6
61501,Exeqt,terokkar,576,warrior,arms,12,6,6
61502,Guerramacina,tichondrius,576,warrior,arms,13,6,7
61503,Ganzism,tichondrius,576,warrior,arms,13,6,7
61504,Olala,kiljaeden,576,warrior,arms,13,6,7
61505,Phojjangz,tichondrius,576,warrior,arms,16,7,9
61506,Ronak,vashj,576,warrior,arms,18,6,12
61507,Eabywarrs,tichondrius,576,warrior,arms,18,6,12
61508,Lundyswung,silver-hand,576,warrior,arms,18,6,12
61509,Ðred,blackhand,576,warrior,arms,18,6,12
61510,Stormwald,sargeras,576,warrior,arms,18,6,12
61511,Pushh,thrall,576,warrior,arms,18,6,12
61512,Ezgamelol,azralon,576,warrior,arms,18,6,12
61513,Drakunai,shattered-halls,576,warrior,arms,18,6,12
61514,Májorrobot,area-52,576,warrior,arms,18,6,12
61515,Xgraves,sargeras,576,warrior,arms,18,6,12
61516,Syrupsippin,zuljin,576,warrior,arms,18,6,12
61517,Silywarr,frostmourne,576,warrior,arms,18,6,12
61518,Boozy,barthilas,576,warrior,arms,18,6,12
61519,Ahkimih,ragnaros,576,warrior,arms,18,6,12
61520,Kaggorax,tichondrius,576,warrior,arms,18,6,12
61521,Abrakàrn,zuluhed,576,warrior,arms,18,6,12
61522,Dondà,illidan,576,warrior,arms,18,6,12
61523,Robar,trollbane,576,warrior,arms,18,6,12
61524,Mahoneslice,thrall,576,warrior,arms,18,6,12
61525,Egoist,malganis,576,warrior,arms,18,6,12
61526,Longcutie,tichondrius,576,warrior,arms,18,6,12
61527,Kennäy,azralon,576,warrior,arms,18,6,12
61528,Cleavxy,sargeras,576,warrior,arms,18,6,12
61529,Rhinð,sargeras,576,warrior,arms,18,6,12
61530,Fayttful,area-52,576,warrior,arms,18,6,12
61531,Aldhard,moon-guard,576,warrior,arms,18,6,12
61532,Augutra,moon-guard,576,warrior,arms,18,6,12
61533,Psilly,sargeras,576,warrior,arms,18,6,12
61534,Geubsal,tichondrius,576,warrior,arms,18,6,12
61535,Cowboybeast,tanaris,576,warrior,arms,18,6,12
61536,Irondefense,thrall,576,warrior,arms,18,6,12
61537,Nillor,emerald-dream,576,warrior,arms,18,6,12
61538,Sõnics,tichondrius,576,warrior,arms,18,6,12
61539,Lieofa,tichondrius,576,warrior,arms,19,6,13
61540,Contentious,moon-guard,576,warrior,arms,24,6,18
61541,Shîzu,moon-guard,576,warrior,arms,24,6,18
61542,Trohgdor,sargeras,575,warrior,arms,12,6,6
61543,Ragefested,tichondrius,575,warrior,arms,12,6,6
61544,Theodere,moon-guard,575,warrior,arms,12,6,6
61545,Cryptikk,tichondrius,575,warrior,arms,12,6,6
61546,Stonnies,bleeding-hollow,575,warrior,arms,12,6,6
61547,Aguìi,quelthalas,575,warrior,arms,12,6,6
61548,Córnpop,tichondrius,575,warrior,arms,12,6,6
61549,Penryn,illidan,575,warrior,arms,12,6,6
61550,Vioar,hyjal,575,warrior,arms,12,6,6
61551,Pandatrue,azralon,575,warrior,arms,12,6,6
61552,Desul,tichondrius,575,warrior,arms,12,6,6
61553,Amérus,moon-guard,575,warrior,arms,12,6,6
61554,Redneckk,emerald-dream,575,warrior,arms,12,6,6
61555,Thornakh,stormrage,575,warrior,arms,12,6,6
61556,Nospace,tichondrius,575,warrior,arms,12,6,6
61557,Atømic,illidan,575,warrior,arms,12,6,6
61558,Gilisraw,tichondrius,575,warrior,arms,12,6,6
61559,Bolx,archimonde,575,warrior,arms,12,6,6
61560,Edgeegee,sargeras,575,warrior,arms,12,6,6
61561,Obstruktíon,tichondrius,575,warrior,arms,12,6,6
61562,Ajulacho,ragnaros,575,warrior,arms,12,6,6
61563,Abuse,nordrassil,575,warrior,arms,12,6,6
61564,Huggesmash,thaurissan,575,warrior,arms,12,6,6
61565,Gimmiefood,emerald-dream,575,warrior,arms,12,6,6
61566,Tyrall,stormrage,575,warrior,arms,12,6,6
61567,Orryn,proudmoore,575,warrior,arms,12,6,6
61568,Trenbalogna,area-52,575,warrior,arms,12,6,6
61569,Teyrn,stormrage,575,warrior,arms,12,6,6
61570,Balthazãr,quelthalas,575,warrior,arms,12,6,6
61571,Bkdorbandit,illidan,575,warrior,arms,12,6,6
61572,Volnas,earthen-ring,575,warrior,arms,12,6,6
61573,Jujuassgeter,darkspear,575,warrior,arms,12,6,6
61574,Pummels,area-52,575,warrior,arms,12,6,6
61575,Hildibrawn,stormrage,575,warrior,arms,12,6,6
61576,Onisusu,frostmourne,575,warrior,arms,12,6,6
61577,Mekkanic,moon-guard,575,warrior,arms,12,6,6
61578,Weewarrior,wyrmrest-accord,575,warrior,arms,12,6,6
61579,Aybssin,skullcrusher,575,warrior,arms,12,6,6
61580,Burntwaffle,ysera,575,warrior,arms,12,6,6
61581,Maltrate,hyjal,575,warrior,arms,15,7,8
61582,Èxecutè,area-52,575,warrior,arms,15,7,8
61583,Bärdock,ragnaros,575,warrior,arms,16,7,9
61584,Diesel,duskwood,575,warrior,arms,14,6,8
61585,Agoro,tichondrius,575,warrior,arms,14,6,8
61586,Opalert,tichondrius,575,warrior,arms,18,6,12
61587,Renziass,tichondrius,575,warrior,arms,18,6,12
61588,Orckims,tichondrius,575,warrior,arms,18,6,12
61589,Dede,darkspear,575,warrior,arms,18,6,12
61590,Neegrompp,moonrunner,575,warrior,arms,18,6,12
61591,Chadler,dragonmaw,575,warrior,arms,18,6,12
61592,Slamchowdy,tichondrius,575,warrior,arms,18,6,12
61593,Darkshrek,quelthalas,574,warrior,arms,12,6,6
61594,Wako,hyjal,574,warrior,arms,12,6,6
61595,Mubun,tichondrius,574,warrior,arms,12,6,6
61596,Kracha,thrall,574,warrior,arms,12,6,6
61597,Porkasolta,goldrinn,574,warrior,arms,12,6,6
61598,Zolpidem,nemesis,574,warrior,arms,18,6,12
61599,Masami,moon-guard,574,warrior,arms,18,6,12
61600,Grândmâ,zuljin,574,warrior,arms,18,6,12
61601,Tekkamanaxe,tichondrius,574,warrior,arms,24,6,18
61602,Antonios,drakthul,574,warrior,arms,30,6,24
61603,Môgwai,kelthuzad,573,warrior,arms,12,6,6
61604,Chrysion,moon-guard,573,warrior,arms,12,6,6
61605,Logohn,wyrmrest-accord,573,warrior,arms,12,6,6
61606,Dúmp,stormrage,573,warrior,arms,12,6,6
61607,Irgon,quelthalas,573,warrior,arms,12,6,6
61608,Gfree,kiljaeden,573,warrior,arms,21,7,14
61609,Brosèph,sargeras,573,warrior,arms,18,6,12
61610,Liiberator,thrall,573,warrior,arms,18,6,12
61611,Girei,ghostlands,573,warrior,arms,18,6,12
61612,Faóra,moon-guard,572,warrior,arms,12,6,6
61613,Johnsnake,sargeras,572,warrior,arms,12,6,6
61614,Azyxia,emerald-dream,572,warrior,arms,15,7,8
61615,Bitiatus,scilla,572,warrior,arms,18,6,12
61616,Reginato,ravenholdt,572,warrior,arms,18,6,12
61617,Tatsher,turalyon,571,warrior,arms,12,6,6
61618,Rudiblade,dalaran,571,warrior,arms,12,6,6
61619,Slaughterist,illidan,567,warrior,arms,18,6,12
61620,Ciran,azralon,564,warrior,arms,18,6,12
61621,Stormfuhrer,stormrage,559,warrior,arms,15,7,8
61622,Conchalover,illidan,559,warrior,arms,17,6,11
61623,Lïnkzq,frostmourne,558,warrior,arms,10,7,3
61624,Ecopolis,azshara,544,warrior,arms,16,6,10
61625,Ballzindeep,tichondrius,543,warrior,arms,8,7,1
61626,Tastyskeet,illidan,543,warrior,arms,11,6,5
61627,Tâlos,ysondre,543,warrior,arms,11,6,5
61628,Trevvel,proudmoore,543,warrior,arms,11,6,5
61629,Tecnowar,quelthalas,543,warrior,arms,17,6,11
61630,Ragerok,bleeding-hollow,542,warrior,arms,22,7,15
61631,Jÿp,tichondrius,527,warrior,arms,11,6,5
61632,Warwik,stormscale,527,warrior,arms,17,6,11
61633,Ledezma,proudmoore,527,warrior,arms,17,6,11
61634,Lazric,area-52,524,warrior,arms,15,6,9
61635,Meadsweats,tichondrius,522,warrior,arms,17,10,7
61636,Bersérk,area-52,522,warrior,arms,14,8,6
61637,Tomcruz,bloodscalp,522,warrior,arms,16,7,9
61638,Hrókr,kiljaeden,522,warrior,arms,19,8,11
61639,Shaydeen,black-dragonflight,521,warrior,arms,15,7,8
61640,Swafty,daggerspine,519,warrior,arms,17,9,8
61641,Rhok,elune,515,warrior,arms,16,9,7
61642,Protologist,chogall,512,warrior,arms,16,6,10
61643,Illicitiri,sargeras,511,warrior,arms,10,6,4
61644,Samoksk,ragnaros,511,warrior,arms,11,6,5
61645,Kvobash,area-52,511,warrior,arms,11,6,5
61646,Jackjaeger,area-52,511,warrior,arms,16,6,10
61647,Berzerc,stormrage,511,warrior,arms,18,6,12
61648,Ruiend,bonechewer,510,warrior,arms,14,6,8
61649,Tyraelius,kiljaeden,510,warrior,arms,17,6,11
61650,Magarrior,shadowsong,495,warrior,arms,13,7,6
61651,Zachw,stormrage,495,warrior,arms,13,6,7
61652,Warlapse,emerald-dream,494,warrior,arms,13,6,7
61653,Flexecute,area-52,480,warrior,arms,6,5,1
61654,Ryü,khaz-modan,480,warrior,arms,6,5,1
61655,Noor,tichondrius,480,warrior,arms,6,5,1
61656,Xruntz,kelthuzad,480,warrior,arms,6,5,1
61657,Byvo,stormrage,480,warrior,arms,6,5,1
61658,Billythunda,tichondrius,480,warrior,arms,6,5,1
61659,Tehnklo,malorne,480,warrior,arms,6,5,1
61660,Healthpoints,area-52,480,warrior,arms,6,5,1
61661,Warmgun,quelthalas,480,warrior,arms,6,5,1
61662,Tâlos,magtheridon,480,warrior,arms,6,5,1
61663,Ghostemane,whisperwind,480,warrior,arms,6,5,1
61664,Jackox,sargeras,480,warrior,arms,6,5,1
61665,Pavv,malganis,480,warrior,arms,6,5,1
61666,Trojanx,malganis,480,warrior,arms,6,5,1
61667,Kushian,tichondrius,480,warrior,arms,6,5,1
61668,Isoln,tichondrius,480,warrior,arms,6,5,1
61669,Noreaga,tichondrius,480,warrior,arms,6,5,1
61670,Biggesttoees,tichondrius,480,warrior,arms,6,5,1
61671,Zerøhøùr,kul-tiras,480,warrior,arms,6,5,1
61672,Tinymo,archimonde,480,warrior,arms,6,5,1
61673,Jarlaix,dragonmaw,480,warrior,arms,6,5,1
61674,Rickywarx,illidan,480,warrior,arms,6,5,1
61675,Olbus,tichondrius,480,warrior,arms,6,5,1
61676,Ckranzz,azralon,480,warrior,arms,6,5,1
61677,Saladin,gnomeregan,480,warrior,arms,6,5,1
61678,Damore,sargeras,480,warrior,arms,6,5,1
61679,Bootypound,sargeras,480,warrior,arms,6,5,1
61680,Crookedface,area-52,480,warrior,arms,6,5,1
61681,Geàrbreaker,tichondrius,480,warrior,arms,6,5,1
61682,Meatsweatx,stormrage,480,warrior,arms,6,5,1
61683,Moè,frostmourne,480,warrior,arms,10,6,4
61684,Skaaxx,barthilas,480,warrior,arms,10,6,4
61685,Warpenguin,kelthuzad,480,warrior,arms,10,6,4
61686,Whittyxc,tichondrius,480,warrior,arms,9,5,4
61687,Sercastic,illidan,480,warrior,arms,11,6,5
61688,Iamfine,area-52,480,warrior,arms,12,5,7
61689,Phyriix,stormrage,480,warrior,arms,12,5,7
61690,Shadowsea,dragonblight,480,warrior,arms,12,5,7
61691,Ffrog,tichondrius,480,warrior,arms,12,5,7
61692,Glenn,tichondrius,480,warrior,arms,12,5,7
61693,Flexxinpapi,exodar,480,warrior,arms,12,5,7
61694,Sylvanos,arthas,480,warrior,arms,12,5,7
61695,Ericthegreat,azuremyst,480,warrior,arms,12,5,7
61696,Takenotez,sargeras,480,warrior,arms,12,5,7
61697,Paulhëyman,sargeras,480,warrior,arms,12,5,7
61698,Miniwarkingx,tichondrius,480,warrior,arms,12,5,7
61699,Greyknights,kiljaeden,480,warrior,arms,12,5,7
61700,Dillý,area-52,480,warrior,arms,12,5,7
61701,Drudw,moon-guard,480,warrior,arms,12,5,7
61702,Mayshowgunmo,tichondrius,480,warrior,arms,12,5,7
61703,Beerstorm,stormrage,480,warrior,arms,12,5,7
61704,Mimiu,ragnaros,480,warrior,arms,12,5,7
61705,Viizer,tichondrius,480,warrior,arms,12,5,7
61706,Qwort,moon-guard,480,warrior,arms,12,5,7
61707,Secondbro,tichondrius,480,warrior,arms,12,5,7
61708,Vmill,tichondrius,480,warrior,arms,12,5,7
61709,Clamjammed,thrall,480,warrior,arms,12,5,7
61710,Nazgrull,wildhammer,480,warrior,arms,12,5,7
61711,Sigismundd,bonechewer,480,warrior,arms,12,5,7
61712,Kvoth,bleeding-hollow,480,warrior,arms,12,5,7
61713,Kluster,kelthuzad,480,warrior,arms,12,5,7
61714,Silvers,blades-edge,480,warrior,arms,12,5,7
61715,Agoge,stormrage,480,warrior,arms,12,5,7
61716,Claponomics,area-52,480,warrior,arms,12,5,7
61717,Bariotyr,the-underbog,480,warrior,arms,12,5,7
61718,Peters,malfurion,480,warrior,arms,12,5,7
61719,Lanco,kiljaeden,480,warrior,arms,12,5,7
61720,Vurk,area-52,480,warrior,arms,12,5,7
61721,Téry,dalaran,480,warrior,arms,12,5,7
61722,Matumbo,skullcrusher,480,warrior,arms,12,5,7
61723,Kethsel,ragnaros,480,warrior,arms,12,5,7
61724,Wonbin,moon-guard,480,warrior,arms,12,5,7
61725,Thaedes,kelthuzad,480,warrior,arms,12,5,7
61726,Pandaxes,proudmoore,480,warrior,arms,12,5,7
61727,Karik,proudmoore,480,warrior,arms,12,5,7
61728,Astrálís,nemesis,480,warrior,arms,12,5,7
61729,Gonzwold,drenden,480,warrior,arms,12,5,7
61730,Buffwar,tichondrius,480,warrior,arms,12,5,7
61731,Arcâdio,cairne,480,warrior,arms,12,5,7
61732,Krongarr,area-52,480,warrior,arms,12,5,7
61733,Bootysmelly,mannoroth,480,warrior,arms,12,5,7
61734,Excalibruh,frostmourne,480,warrior,arms,12,5,7
61735,Beleña,dalaran,480,warrior,arms,12,5,7
61736,Huleo,tichondrius,480,warrior,arms,12,5,7
61737,Lru,whisperwind,480,warrior,arms,12,5,7
61738,Robertolini,moon-guard,480,warrior,arms,12,5,7
61739,Loveføx,stormrage,480,warrior,arms,12,5,7
61740,Martydom,proudmoore,480,warrior,arms,12,5,7
61741,Loudnoise,frostwolf,480,warrior,arms,12,5,7
61742,Warriorkofwa,tichondrius,480,warrior,arms,12,5,7
61743,Maniel,greymane,480,warrior,arms,12,5,7
61744,Ponygon,quelthalas,480,warrior,arms,12,5,7
61745,Batchat,frostmourne,480,warrior,arms,12,5,7
61746,Thehóund,area-52,480,warrior,arms,12,5,7
61747,Thiccowman,area-52,480,warrior,arms,12,5,7
61748,Crushingnews,sargeras,480,warrior,arms,12,5,7
61749,Shrëkslovaki,tichondrius,480,warrior,arms,12,5,7
61750,Bigcracka,illidan,480,warrior,arms,12,5,7
61751,Fracked,sargeras,480,warrior,arms,12,5,7
61752,Felorelea,moon-guard,480,warrior,arms,12,5,7
61753,Zuiken,kiljaeden,480,warrior,arms,12,5,7
61754,Hemkcus,zuluhed,480,warrior,arms,12,5,7
61755,Gävilar,sargeras,480,warrior,arms,12,5,7
61756,Igoon,dentarg,480,warrior,arms,12,5,7
61757,Schoolbuhs,tichondrius,480,warrior,arms,12,5,7
61758,Tiitlefight,bleeding-hollow,480,warrior,arms,12,5,7
61759,Crammed,tichondrius,480,warrior,arms,12,5,7
61760,Wcb,sargeras,480,warrior,arms,12,5,7
61761,Vãnth,kelthuzad,480,warrior,arms,12,5,7
61762,Shwip,tichondrius,480,warrior,arms,12,5,7
61763,Shadalloo,azralon,480,warrior,arms,12,5,7
61764,Bulldozar,zuljin,480,warrior,arms,12,5,7
61765,Jkasdfglkg,tichondrius,480,warrior,arms,12,5,7
61766,Trevmo,bloodscalp,480,warrior,arms,12,5,7
61767,Zuggernaut,shadowsong,480,warrior,arms,12,5,7
61768,Philipjoo,illidan,480,warrior,arms,12,5,7
61769,Pregnannie,barthilas,480,warrior,arms,12,5,7
61770,Consolidate,hyjal,480,warrior,arms,12,5,7
61771,Juggernäut,malganis,480,warrior,arms,12,5,7
61772,Toddlovesu,kelthuzad,480,warrior,arms,12,5,7
61773,Biggrizz,area-52,480,warrior,arms,12,5,7
61774,Thedeejoner,caelestrasz,480,warrior,arms,12,5,7
61775,Elkinss,tichondrius,480,warrior,arms,12,5,7
61776,Madhouse,tanaris,480,warrior,arms,12,5,7
61777,Kð,zuljin,480,warrior,arms,12,5,7
61778,Metalhog,sargeras,480,warrior,arms,12,5,7
61779,Kamboocha,tichondrius,480,warrior,arms,12,5,7
61780,Cpudemon,undermine,480,warrior,arms,12,5,7
61781,Shapur,tichondrius,480,warrior,arms,12,5,7
61782,Kaikah,aegwynn,480,warrior,arms,12,5,7
61783,Biggiesmash,bleeding-hollow,480,warrior,arms,12,5,7
61784,Sideon,frostmourne,480,warrior,arms,12,5,7
61785,Wën,stormrage,480,warrior,arms,12,5,7
61786,Hìtchslap,tichondrius,480,warrior,arms,12,5,7
61787,Flëët,tichondrius,480,warrior,arms,12,5,7
61788,Spirìt,illidan,480,warrior,arms,12,5,7
61789,Huricas,arthas,480,warrior,arms,12,5,7
61790,Orcbum,kiljaeden,480,warrior,arms,12,5,7
61791,Lokgur,gallywix,480,warrior,arms,12,5,7
61792,Bloodxfrenzy,silvermoon,480,warrior,arms,12,5,7
61793,Meatspinner,sargeras,480,warrior,arms,12,5,7
61794,Womanbeaterx,stormrage,480,warrior,arms,12,5,7
61795,Jäëgër,moon-guard,480,warrior,arms,12,5,7
61796,Scozziee,barthilas,480,warrior,arms,12,5,7
61797,Slamoholic,turalyon,480,warrior,arms,12,5,7
61798,Quinntis,anvilmar,480,warrior,arms,12,5,7
61799,Cuantascopas,ragnaros,480,warrior,arms,12,5,7
61800,Crogosh,quelthalas,480,warrior,arms,12,5,7
61801,Manbok,tichondrius,480,warrior,arms,12,5,7
61802,Brickhouse,tichondrius,480,warrior,arms,12,5,7
61803,Tyragyz,azralon,480,warrior,arms,12,5,7
61804,Whytea,cairne,480,warrior,arms,12,5,7
61805,Dynamiite,bleeding-hollow,480,warrior,arms,12,5,7
61806,Cabi,frostmourne,480,warrior,arms,12,5,7
61807,Justicwar,area-52,480,warrior,arms,12,5,7
61808,Milbën,tichondrius,480,warrior,arms,12,5,7
61809,Andrismash,barthilas,480,warrior,arms,12,5,7
61810,Grandtank,veknilash,480,warrior,arms,15,6,9
61811,Battosaì,bonechewer,480,warrior,arms,15,6,9
61812,Mág,burning-legion,480,warrior,arms,13,5,8
61813,Oledcktwist,garrosh,480,warrior,arms,13,5,8
61814,Zibby,malganis,480,warrior,arms,14,5,9
61815,Darkdargon,tichondrius,480,warrior,arms,18,6,12
61816,Tigershárk,tichondrius,480,warrior,arms,16,5,11
61817,Imprw,stormrage,480,warrior,arms,18,5,13
61818,Kamigoroshi,crushridge,480,warrior,arms,18,5,13
61819,Goaco,drakkari,480,warrior,arms,18,5,13
61820,Reifrayton,ragnaros,480,warrior,arms,18,5,13
61821,Ravager,ragnaros,480,warrior,arms,18,5,13
61822,Skyanidas,korgath,480,warrior,arms,18,5,13
61823,Eightydeuce,bonechewer,480,warrior,arms,18,5,13
61824,Osannd,tichondrius,480,warrior,arms,18,5,13
61825,Shaynaynay,tichondrius,480,warrior,arms,18,5,13
61826,Oofta,kelthuzad,480,warrior,arms,18,5,13
61827,Øvrpwrd,frostmourne,480,warrior,arms,18,5,13
61828,Seppukush,quelthalas,480,warrior,arms,18,5,13
61829,Smackify,stormrage,480,warrior,arms,18,5,13
61830,Kkuzo,bleeding-hollow,480,warrior,arms,18,5,13
61831,Tsathoggua,kiljaeden,480,warrior,arms,18,5,13
61832,Cyllyzie,emerald-dream,480,warrior,arms,18,5,13
61833,Aldathion,argent-dawn,480,warrior,arms,18,5,13
61834,Bigwarrior,stonemaul,480,warrior,arms,19,5,14
61835,Bornclueless,illidan,480,warrior,arms,21,5,16
61836,Creannew,drakkari,480,warrior,arms,24,5,19
61837,Lorinzer,zuljin,480,warrior,arms,24,5,19
61838,Tanger,korgath,479,warrior,arms,6,5,1
61839,Dinocrusher,illidan,479,warrior,arms,6,5,1
61840,Sarkhan,zuluhed,479,warrior,arms,6,5,1
61841,Asidieslowly,tichondrius,479,warrior,arms,6,5,1
61842,Faiken,quelthalas,479,warrior,arms,6,5,1
61843,Rinngo,proudmoore,479,warrior,arms,6,5,1
61844,Trufsoturi,bleeding-hollow,479,warrior,arms,12,5,7
61845,Dirtyrandy,zuluhed,479,warrior,arms,12,5,7
61846,Rücküs,tichondrius,479,warrior,arms,12,5,7
61847,Maudlewis,bladefist,479,warrior,arms,12,5,7
61848,Kurixu,ragnaros,479,warrior,arms,12,5,7
61849,Cueromodel,ragnaros,479,warrior,arms,12,5,7
61850,Crushaholic,azgalor,479,warrior,arms,12,5,7
61851,Stretchytime,emerald-dream,479,warrior,arms,12,5,7
61852,Synestira,frostmourne,479,warrior,arms,12,5,7
61853,Skragg,chogall,479,warrior,arms,12,5,7
61854,Bovisrex,shadow-council,479,warrior,arms,12,5,7
61855,Luckstang,zuljin,479,warrior,arms,12,5,7
61856,Spliff,ghostlands,479,warrior,arms,12,5,7
61857,Unphased,area-52,479,warrior,arms,12,5,7
61858,Warstik,malganis,479,warrior,arms,12,5,7
61859,Têzeret,shadowmoon,479,warrior,arms,12,5,7
61860,Spàcetìme,stormrage,479,warrior,arms,12,5,7
61861,Fwengli,illidan,479,warrior,arms,12,5,7
61862,Reishera,stormrage,479,warrior,arms,12,5,7
61863,Qqmachine,tichondrius,479,warrior,arms,12,5,7
61864,Helscreem,hyjal,479,warrior,arms,18,5,13
61865,Irøns,arthas,479,warrior,arms,18,5,13
61866,Onso,ragnaros,479,warrior,arms,18,5,13
61867,ßlindãø,azralon,479,warrior,arms,18,5,13
61868,Flexecute,senjin,479,warrior,arms,18,5,13
61869,Tentacruels,area-52,479,warrior,arms,18,5,13
61870,Kanicky,draka,479,warrior,arms,18,5,13
61871,Fruth,nagrand,479,warrior,arms,24,5,19
61872,Gorrthrax,area-52,479,warrior,arms,24,5,19
61873,Arooy,azralon,478,warrior,arms,6,5,1
61874,Otyek,proudmoore,478,warrior,arms,12,5,7
61875,Bennybrock,crushridge,478,warrior,arms,12,5,7
61876,Condog,stormrage,478,warrior,arms,12,5,7
61877,Dirtywarrior,lightnings-blade,478,warrior,arms,12,5,7
61878,Tmible,ragnaros,477,warrior,arms,6,5,1
61879,Larale,emerald-dream,477,warrior,arms,12,5,7
61880,Therom,ragnaros,477,warrior,arms,21,6,15
61881,Acanof,azjolnerub,474,warrior,arms,9,6,3
61882,Raktrazbirt,dalaran,472,warrior,arms,12,5,7
61883,Bøøtymuncher,illidan,462,warrior,arms,11,7,4
61884,Naindejardin,sargeras,462,warrior,arms,11,5,6
61885,Danalle,area-52,448,warrior,arms,10,6,4
61886,Mverstappen,azralon,448,warrior,arms,10,5,5
61887,Turboboy,tichondrius,448,warrior,arms,10,5,5
61888,Notcoverage,tichondrius,447,warrior,arms,11,5,6
61889,Tenderturtle,tichondrius,447,warrior,arms,11,5,6
61890,Enelsita,sargeras,447,warrior,arms,14,6,8
61891,Dontkiteme,frostmourne,447,warrior,arms,17,5,12
61892,Boorabill,stormrage,446,warrior,arms,14,6,8
61893,Hvwk,sargeras,445,warrior,arms,11,5,6
61894,Dpsdone,blackrock,432,warrior,arms,9,6,3
61895,Gurgak,illidan,431,warrior,arms,11,5,6
61896,Esko,tichondrius,431,warrior,arms,11,5,6
61897,Jackedaniels,stormrage,431,warrior,arms,12,5,7
61898,Bloodbottle,darkspear,426,warrior,arms,14,7,7
61899,Reignwolf,azralon,426,warrior,arms,13,6,7
61900,Boombasta,shuhalo,426,warrior,arms,15,6,9
61901,Machutron,quelthalas,415,warrior,arms,8,5,3
61902,Yarocktoo,kelthuzad,415,warrior,arms,8,5,3
61903,Crackersmack,stormrage,415,warrior,arms,11,6,5
61904,Nrico,frostmourne,415,warrior,arms,10,5,5
61905,Thano,kiljaeden,415,warrior,arms,10,5,5
61906,Superbest,tichondrius,415,warrior,arms,14,5,9
61907,Smashsmash,barthilas,400,warrior,arms,7,5,2
61908,Calcùlus,kelthuzad,400,warrior,arms,13,5,8
61909,Gushyguts,tichondrius,399,warrior,arms,19,5,14
61910,Wardread,frostmourne,384,warrior,arms,6,4,2
61911,Terminatorr,quelthalas,384,warrior,arms,6,4,2
61912,Wariorwang,tichondrius,384,warrior,arms,6,4,2
61913,Daddydomtop,moon-guard,384,warrior,arms,6,4,2
61914,Gnasty,hyjal,384,warrior,arms,6,4,2
61915,Sayuri,frostmourne,384,warrior,arms,6,4,2
61916,Chapux,ragnaros,384,warrior,arms,6,4,2
61917,Takitó,ragnaros,384,warrior,arms,6,4,2
61918,Picpay,area-52,384,warrior,arms,6,4,2
61919,Claymorer,tichondrius,384,warrior,arms,6,4,2
61920,Deosgladius,ragnaros,384,warrior,arms,6,4,2
61921,Mfgodofwar,kelthuzad,384,warrior,arms,6,4,2
61922,Gozugurself,barthilas,384,warrior,arms,6,4,2
61923,Swaystko,sargeras,384,warrior,arms,6,4,2
61924,Sakuraya,tichondrius,384,warrior,arms,6,4,2
61925,Ragingboner,aggramar,384,warrior,arms,6,4,2
61926,Chulain,tichondrius,384,warrior,arms,6,4,2
61927,Mortalhandx,tichondrius,384,warrior,arms,6,4,2
61928,Swingyslammy,area-52,384,warrior,arms,6,4,2
61929,Ziggeraut,cenarion-circle,384,warrior,arms,6,4,2
61930,Lxstcxntury,sargeras,384,warrior,arms,6,4,2
61931,Sphatic,tichondrius,384,warrior,arms,6,4,2
61932,Farlywarrior,tichondrius,384,warrior,arms,6,4,2
61933,Rõcky,frostmourne,384,warrior,arms,6,4,2
61934,Tickej,dragonmaw,384,warrior,arms,6,4,2
61935,Ckoaw,dalaran,384,warrior,arms,6,4,2
61936,Afelhia,moon-guard,384,warrior,arms,6,4,2
61937,Shartstaín,tichondrius,384,warrior,arms,6,4,2
61938,Swillzz,illidan,384,warrior,arms,6,4,2
61939,Warcheif,dentarg,384,warrior,arms,6,4,2
61940,Mòrgo,agamaggan,384,warrior,arms,6,4,2
61941,Jersucristö,quelthalas,384,warrior,arms,6,4,2
61942,Swordfighter,moon-guard,384,warrior,arms,6,4,2
61943,Yêawen,tichondrius,384,warrior,arms,6,4,2
61944,Fròthy,emerald-dream,384,warrior,arms,6,4,2
61945,Còlòssal,moknathal,384,warrior,arms,6,4,2
61946,Kimbö,quelthalas,384,warrior,arms,6,4,2
61947,Blitzø,malganis,384,warrior,arms,6,4,2
61948,Littlegengar,tichondrius,384,warrior,arms,6,4,2
61949,Blucollardad,bleeding-hollow,384,warrior,arms,6,4,2
61950,Hamur,azralon,384,warrior,arms,6,4,2
61951,Titanmax,kelthuzad,384,warrior,arms,6,4,2
61952,Braxxìnn,tichondrius,384,warrior,arms,6,4,2
61953,Lüxord,quelthalas,384,warrior,arms,6,4,2
61954,Borahgis,area-52,384,warrior,arms,6,4,2
61955,Caberg,ragnaros,384,warrior,arms,6,4,2
61956,Alèx,tichondrius,384,warrior,arms,6,4,2
61957,Bajheeraz,sargeras,384,warrior,arms,6,4,2
61958,Softtofu,illidan,384,warrior,arms,6,4,2
61959,Cheshe,area-52,384,warrior,arms,6,4,2
61960,Pineapplezz,kelthuzad,384,warrior,arms,6,4,2
61961,Zoldyak,ragnaros,384,warrior,arms,6,4,2
61962,Fancysin,malganis,384,warrior,arms,6,4,2
61963,Rungoar,frostmourne,384,warrior,arms,6,4,2
61964,Rinima,tichondrius,384,warrior,arms,6,4,2
61965,Zarttorius,quelthalas,384,warrior,arms,6,4,2
61966,Bütch,stormrage,384,warrior,arms,6,4,2
61967,Ráwrxd,bleeding-hollow,384,warrior,arms,6,4,2
61968,Kraggo,zuljin,384,warrior,arms,6,4,2
61969,Helder,destromath,384,warrior,arms,6,4,2
61970,Frakt,illidan,384,warrior,arms,6,4,2
61971,Restoy,tichondrius,384,warrior,arms,6,4,2
61972,Oddyseey,moon-guard,384,warrior,arms,6,4,2
61973,Nextquestion,sargeras,384,warrior,arms,6,4,2
61974,Iroh,thunderhorn,384,warrior,arms,6,4,2
61975,Fingaz,azralon,384,warrior,arms,6,4,2
61976,Míaguiulfo,ragnaros,384,warrior,arms,6,4,2
61977,Mommystrasza,kelthuzad,384,warrior,arms,6,4,2
61978,Halfman,turalyon,384,warrior,arms,6,4,2
61979,Evergardens,saurfang,384,warrior,arms,6,4,2
61980,Conormacleod,stormrage,384,warrior,arms,6,4,2
61981,Sinergui,nemesis,384,warrior,arms,6,4,2
61982,Kaghogar,area-52,384,warrior,arms,6,4,2
61983,Sanqq,tichondrius,384,warrior,arms,6,4,2
61984,Ediann,elune,384,warrior,arms,6,4,2
61985,Bigmens,illidan,384,warrior,arms,6,4,2
61986,Cläpped,thrall,384,warrior,arms,6,4,2
61987,Kruçify,dark-iron,384,warrior,arms,6,4,2
61988,Krokü,area-52,384,warrior,arms,6,4,2
61989,Thiccyb,area-52,384,warrior,arms,6,4,2
61990,Ssamba,shattered-hand,384,warrior,arms,6,4,2
61991,Sonoflaw,skullcrusher,384,warrior,arms,6,4,2
61992,Prodigi,ragnaros,384,warrior,arms,6,4,2
61993,Malgoth,illidan,384,warrior,arms,6,4,2
61994,Thottprot,blackhand,384,warrior,arms,6,4,2
61995,Sygurd,drakkari,384,warrior,arms,6,4,2
61996,Slapywar,illidan,384,warrior,arms,6,4,2
61997,Bajheeraz,tichondrius,384,warrior,arms,6,4,2
61998,Calembo,illidan,384,warrior,arms,6,4,2
61999,Burzerk,malganis,384,warrior,arms,6,4,2
62000,Ummso,nerzhul,384,warrior,arms,6,4,2
62001,Mystïctank,sargeras,384,warrior,arms,6,4,2
62002,Gangdan,sargeras,384,warrior,arms,6,4,2
62003,Aægekaz,proudmoore,384,warrior,arms,6,4,2
62004,Stromdart,quelthalas,384,warrior,arms,6,4,2
62005,Dazfury,barthilas,384,warrior,arms,6,4,2
62006,Pilgrimslays,tichondrius,384,warrior,arms,6,4,2
62007,Bjërgsen,azralon,384,warrior,arms,6,4,2
62008,Evencane,stormrage,384,warrior,arms,6,4,2
62009,Farmtruckqt,proudmoore,384,warrior,arms,6,4,2
62010,Boomtacular,moon-guard,384,warrior,arms,6,4,2
62011,Appolyonn,hyjal,384,warrior,arms,6,4,2
62012,Tsutsana,lightninghoof,384,warrior,arms,6,4,2
62013,Neon,wildhammer,384,warrior,arms,6,4,2
62014,Gamörä,illidan,384,warrior,arms,6,4,2
62015,Diâbetes,area-52,384,warrior,arms,6,4,2
62016,Gurneyhalec,proudmoore,384,warrior,arms,6,4,2
62017,Koalabear,shadow-council,384,warrior,arms,6,4,2
62018,Tankdawg,draktharon,384,warrior,arms,6,4,2
62019,Hamburgezo,quelthalas,384,warrior,arms,6,4,2
62020,Datogkush,frostmourne,384,warrior,arms,6,4,2
62021,Mikrotik,alleria,384,warrior,arms,6,4,2
62022,Yivicus,sargeras,384,warrior,arms,6,4,2
62023,Ygìr,mannoroth,384,warrior,arms,6,4,2
62024,Orangew,dalaran,384,warrior,arms,6,4,2
62025,Veedrin,ysera,384,warrior,arms,6,4,2
62026,Odalp,tichondrius,384,warrior,arms,6,4,2
62027,Majinnox,wyrmrest-accord,384,warrior,arms,6,4,2
62028,Stormleap,tichondrius,384,warrior,arms,6,4,2
62029,Bruisebanner,area-52,384,warrior,arms,6,4,2
62030,Styiex,ragnaros,384,warrior,arms,6,4,2
62031,Yagarel,dalaran,384,warrior,arms,6,4,2
62032,Mcwanga,barthilas,384,warrior,arms,6,4,2
62033,Demolishier,quelthalas,384,warrior,arms,6,4,2
62034,Copinhodagua,azralon,384,warrior,arms,6,4,2
62035,Dragonupup,tichondrius,384,warrior,arms,6,4,2
62036,Misticstorm,barthilas,384,warrior,arms,6,4,2
62037,Slipter,ragnaros,384,warrior,arms,6,4,2
62038,Crunchytacos,zuljin,384,warrior,arms,6,4,2
62039,Hoboeddtwo,area-52,384,warrior,arms,6,4,2
62040,Galaxius,frostmane,384,warrior,arms,7,4,3
62041,Hitmypronoun,illidan,384,warrior,arms,9,5,4
62042,Greenishfox,illidan,384,warrior,arms,9,5,4
62043,Finndal,bleeding-hollow,384,warrior,arms,9,5,4
62044,Ragnarlbrok,goldrinn,384,warrior,arms,10,5,5
62045,Kalisandra,undermine,384,warrior,arms,10,5,5
62046,Ailes,hakkar,384,warrior,arms,11,4,7
62047,Jaredfrmsbwy,kelthuzad,384,warrior,arms,12,4,8
62048,Redbeanw,tichondrius,384,warrior,arms,12,4,8
62049,Draiken,dalaran,384,warrior,arms,12,4,8
62050,Handikap,stormrage,384,warrior,arms,12,4,8
62051,Chongos,malganis,384,warrior,arms,12,4,8
62052,Thelsarian,nerzhul,384,warrior,arms,12,4,8
62053,Brendan,llane,384,warrior,arms,12,4,8
62054,Malahorda,illidan,384,warrior,arms,12,4,8
62055,Nginx,queldorei,384,warrior,arms,12,4,8
62056,Demonsterz,ravenholdt,384,warrior,arms,12,4,8
62057,Chàrr,crushridge,384,warrior,arms,12,4,8
62058,Metalhit,tichondrius,384,warrior,arms,12,4,8
62059,Barrocops,kiljaeden,384,warrior,arms,12,4,8
62060,Joekenshield,stonemaul,384,warrior,arms,12,4,8
62061,Crimsóñ,kelthuzad,384,warrior,arms,12,4,8
62062,Bewbeebangz,kelthuzad,384,warrior,arms,12,4,8
62063,Totenhammer,nathrezim,384,warrior,arms,12,4,8
62064,Varrian,rivendare,384,warrior,arms,12,4,8
62065,Licona,wyrmrest-accord,384,warrior,arms,12,4,8
62066,Jasonsdady,illidan,384,warrior,arms,12,4,8
62067,Fetalalcohol,illidan,384,warrior,arms,12,4,8
62068,Ferilya,thunderhorn,384,warrior,arms,12,4,8
62069,Runningatyou,area-52,384,warrior,arms,12,4,8
62070,Claphub,malganis,384,warrior,arms,12,4,8
62071,Koei,illidan,384,warrior,arms,12,4,8
62072,Tanksbad,lightnings-blade,384,warrior,arms,12,4,8
62073,Estrasystole,sargeras,384,warrior,arms,12,4,8
62074,Sandrine,fizzcrank,384,warrior,arms,12,4,8
62075,Ästen,kargath,384,warrior,arms,12,4,8
62076,Galaxywar,stormrage,384,warrior,arms,12,4,8
62077,Jathellum,stormrage,384,warrior,arms,12,4,8
62078,Khaellanax,azralon,384,warrior,arms,12,4,8
62079,Bib,malganis,384,warrior,arms,12,4,8
62080,Renclave,wyrmrest-accord,384,warrior,arms,12,4,8
62081,Pop,stormrage,384,warrior,arms,12,4,8
62082,Laokan,illidan,384,warrior,arms,12,4,8
62083,Palumorw,deathwing,384,warrior,arms,12,4,8
62084,Doully,proudmoore,384,warrior,arms,12,4,8
62085,Porchorc,hyjal,384,warrior,arms,12,4,8
62086,Sorty,emerald-dream,384,warrior,arms,12,4,8
62087,Xårren,stormrage,384,warrior,arms,12,4,8
62088,Regax,thrall,384,warrior,arms,12,4,8
62089,Wendër,area-52,384,warrior,arms,12,4,8
62090,Lebs,frostmourne,384,warrior,arms,12,4,8
62091,Smokr,azralon,384,warrior,arms,12,4,8
62092,Bigboy,icecrown,384,warrior,arms,12,4,8
62093,Bigshett,sargeras,384,warrior,arms,12,4,8
62094,Angrybrog,malfurion,384,warrior,arms,12,4,8
62095,Pilsenerog,ragnaros,384,warrior,arms,12,4,8
62096,Còsmico,trollbane,384,warrior,arms,12,4,8
62097,Gurtheng,sargeras,384,warrior,arms,12,4,8
62098,Rexmar,tichondrius,384,warrior,arms,12,4,8
62099,Gangaa,barthilas,384,warrior,arms,12,4,8
62100,Meanface,malganis,384,warrior,arms,12,4,8
62101,Wingnut,zuluhed,384,warrior,arms,12,4,8
62102,Emmartillos,ragnaros,384,warrior,arms,12,4,8
62103,Majitz,azralon,384,warrior,arms,12,4,8
62104,Ladderx,area-52,384,warrior,arms,12,4,8
62105,Warmachined,grizzly-hills,384,warrior,arms,12,4,8
62106,Narduk,emerald-dream,384,warrior,arms,12,4,8
62107,Facekilla,nordrassil,384,warrior,arms,12,4,8
62108,Filth,tichondrius,384,warrior,arms,12,4,8
62109,Bersk,sargeras,384,warrior,arms,12,4,8
62110,Notfaytful,thrall,384,warrior,arms,12,4,8
62111,Vurks,frostmourne,384,warrior,arms,12,4,8
62112,Redrumman,demon-soul,384,warrior,arms,12,4,8
62113,Izhansheni,illidan,384,warrior,arms,12,4,8
62114,Grullhamer,ragnaros,384,warrior,arms,12,4,8
62115,Warspartan,stormrage,384,warrior,arms,12,4,8
62116,Brazenox,illidan,384,warrior,arms,12,4,8
62117,Dessindir,quelthalas,384,warrior,arms,12,4,8
62118,Drewpqawk,tichondrius,384,warrior,arms,12,4,8
62119,Kenedy,moon-guard,384,warrior,arms,12,4,8
62120,Zamera,tichondrius,384,warrior,arms,12,4,8
62121,Dosey,kelthuzad,384,warrior,arms,12,4,8
62122,Furyofrage,dalaran,384,warrior,arms,12,4,8
62123,Freedum,shandris,384,warrior,arms,12,4,8
62124,Nerolanast,wyrmrest-accord,384,warrior,arms,12,4,8
62125,Velanos,bleeding-hollow,384,warrior,arms,12,4,8
62126,Guyllol,barthilas,384,warrior,arms,12,4,8
62127,Akoro,bleeding-hollow,384,warrior,arms,12,4,8
62128,Gazah,skullcrusher,384,warrior,arms,12,4,8
62129,Zulataza,zuljin,384,warrior,arms,12,4,8
62130,Durango,duskwood,384,warrior,arms,12,4,8
62131,Flexyx,arthas,384,warrior,arms,12,4,8
62132,Gorethak,kiljaeden,384,warrior,arms,12,4,8
62133,Moseshrute,zuljin,384,warrior,arms,12,4,8
62134,Gaouis,stormreaver,384,warrior,arms,12,4,8
62135,Tappyc,tichondrius,384,warrior,arms,12,4,8
62136,Fatherkelso,tichondrius,384,warrior,arms,12,4,8
62137,Frntdblbicep,tichondrius,384,warrior,arms,12,4,8
62138,Lørdvingådør,azralon,384,warrior,arms,12,4,8
62139,Indfo,altar-of-storms,384,warrior,arms,12,4,8
62140,Hameey,sargeras,384,warrior,arms,12,4,8
62141,Mefus,wyrmrest-accord,384,warrior,arms,12,4,8
62142,Hambster,frostmane,384,warrior,arms,12,4,8
62143,Obama,chogall,384,warrior,arms,12,4,8
62144,Zebel,tichondrius,384,warrior,arms,12,4,8
62145,Hârambe,kiljaeden,384,warrior,arms,12,4,8
62146,Aldaøm,ragnaros,384,warrior,arms,12,4,8
62147,Nxmabala,proudmoore,384,warrior,arms,12,4,8
62148,Cupper,tichondrius,384,warrior,arms,12,4,8
62149,Snack,stormreaver,384,warrior,arms,12,4,8
62150,Daduké,stormrage,384,warrior,arms,12,4,8
62151,Murotamaka,malganis,384,warrior,arms,12,4,8
62152,Ballsy,fenris,384,warrior,arms,12,4,8
62153,Drakgøre,ragnaros,384,warrior,arms,12,4,8
62154,Goodrik,quelthalas,384,warrior,arms,12,4,8
62155,Zebron,sargeras,384,warrior,arms,12,4,8
62156,Mindgoblin,bleeding-hollow,384,warrior,arms,12,4,8
62157,Iargestpp,bleeding-hollow,384,warrior,arms,12,4,8
62158,Hamslamm,area-52,384,warrior,arms,12,4,8
62159,Mikejustice,kelthuzad,384,warrior,arms,12,4,8
62160,Verrynasty,area-52,384,warrior,arms,12,4,8
62161,Swingú,illidan,384,warrior,arms,12,4,8
62162,Naelynh,quelthalas,384,warrior,arms,12,4,8
62163,Heliza,ragnaros,384,warrior,arms,12,4,8
62164,Spacegoatze,thunderlord,384,warrior,arms,12,4,8
62165,Wyborn,emerald-dream,384,warrior,arms,12,4,8
62166,Dámöuse,stormrage,384,warrior,arms,12,4,8
62167,Allonsas,moon-guard,384,warrior,arms,12,4,8
62168,Sinkale,moon-guard,384,warrior,arms,12,4,8
62169,Iden,vashj,384,warrior,arms,12,4,8
62170,Zantetsukenn,sargeras,384,warrior,arms,12,4,8
62171,Jaclksparrow,azralon,384,warrior,arms,12,4,8
62172,Warriormikey,tichondrius,384,warrior,arms,12,4,8
62173,Twoshoutz,stormrage,384,warrior,arms,12,4,8
62174,Bondadoso,stormrage,384,warrior,arms,13,4,9
62175,Varkery,sargeras,384,warrior,arms,13,4,9
62176,Lunusx,stormrage,384,warrior,arms,13,4,9
62177,Kyres,moon-guard,384,warrior,arms,16,4,12
62178,Biggieth,sargeras,384,warrior,arms,21,5,16
62179,Jazzkiler,azralon,384,warrior,arms,17,4,13
62180,Gladicus,zuljin,384,warrior,arms,18,4,14
62181,Raggnar,zuluhed,384,warrior,arms,18,4,14
62182,Cowsgomerr,tichondrius,384,warrior,arms,18,4,14
62183,Retiarius,tichondrius,384,warrior,arms,18,4,14
62184,Asphyxiating,illidan,384,warrior,arms,18,4,14
62185,Draxxarlol,zuljin,384,warrior,arms,18,4,14
62186,Zugyu,tichondrius,384,warrior,arms,18,4,14
62187,Powerlift,area-52,384,warrior,arms,18,4,14
62188,Orcrist,stormreaver,383,warrior,arms,6,4,2
62189,Unbeaten,malganis,383,warrior,arms,6,4,2
62190,Ezaxe,tichondrius,383,warrior,arms,6,4,2
62191,Thedozer,kargath,383,warrior,arms,6,4,2
62192,Sethh,ragnaros,383,warrior,arms,6,4,2
62193,Randumxx,nerzhul,383,warrior,arms,6,4,2
62194,Rathlann,crushridge,383,warrior,arms,6,4,2
62195,Yeit,tichondrius,383,warrior,arms,6,4,2
62196,Tookbeki,tichondrius,383,warrior,arms,6,4,2
62197,Antêro,sargeras,383,warrior,arms,12,4,8
62198,Ralf,emerald-dream,383,warrior,arms,12,4,8
62199,Drovik,malygos,383,warrior,arms,12,4,8
62200,Orangerzze,hyjal,383,warrior,arms,12,4,8
62201,Duvir,frostwolf,383,warrior,arms,12,4,8
62202,Dayafter,queldorei,383,warrior,arms,12,4,8
62203,Aazokk,emerald-dream,383,warrior,arms,12,4,8
62204,Ajamu,aegwynn,383,warrior,arms,12,4,8
62205,Spitbeard,kargath,383,warrior,arms,12,4,8
62206,Bläckraven,quelthalas,383,warrior,arms,12,4,8
62207,Christellà,dalaran,383,warrior,arms,18,4,14
62208,Bigbouba,jubeithos,383,warrior,arms,24,4,20
62209,Bahlsac,cenarion-circle,382,warrior,arms,12,4,8
62210,Lightstrikes,sargeras,379,warrior,arms,12,4,8
62211,Dingoe,wyrmrest-accord,379,warrior,arms,12,4,8
62212,Handdok,runetotem,379,warrior,arms,12,4,8
62213,Såmmÿ,moon-guard,379,warrior,arms,12,4,8
62214,Twohandkilla,scilla,367,warrior,arms,11,4,7
62215,Loomine,illidan,367,warrior,arms,11,4,7
62216,Shagalaca,tichondrius,367,warrior,arms,11,4,7
62217,Drakôn,quelthalas,367,warrior,arms,11,4,7
62218,Xaxxar,bleeding-hollow,367,warrior,arms,11,4,7
62219,Warsins,bonechewer,367,warrior,arms,17,4,13
62220,Gâbríel,maiev,351,warrior,arms,11,4,7
62221,Förkz,ragnaros,351,warrior,arms,11,4,7
62222,Vaetren,area-52,351,warrior,arms,11,4,7
62223,Thøros,moon-guard,351,warrior,arms,11,4,7
62224,Twinktop,tichondrius,351,warrior,arms,11,4,7
62225,Cönan,thunderhorn,351,warrior,arms,16,4,12
62226,Boyarde,tichondrius,336,warrior,arms,9,4,5
62227,Matasimio,drakkari,336,warrior,arms,9,4,5
62228,Justentacle,zuljin,336,warrior,arms,15,4,11
62229,Sinweaver,bleeding-hollow,335,warrior,arms,9,5,4
62230,Caynos,stormrage,335,warrior,arms,11,4,7
62231,Toir,bladefist,335,warrior,arms,11,4,7
62232,Jimpepega,quelthalas,335,warrior,arms,11,4,7
62233,Rubbers,thrall,330,warrior,arms,17,6,11
62234,Macray,zuljin,330,warrior,arms,18,5,13
62235,Lildumptruck,emerald-dream,320,warrior,arms,10,4,6
62236,Painstake,illidan,320,warrior,arms,19,5,14
62237,Toetoeto,darrowmere,319,warrior,arms,5,4,1
62238,Skollton,tichondrius,319,warrior,arms,5,4,1
62239,Vaider,bleeding-hollow,319,warrior,arms,5,4,1
62240,Rauwers,azralon,319,warrior,arms,8,4,4
62241,Kricken,frostmourne,319,warrior,arms,8,4,4
62242,Cptdrako,alterac-mountains,319,warrior,arms,8,4,4
62243,Aerriz,area-52,319,warrior,arms,11,4,7
62244,Edmaghar,ragnaros,319,warrior,arms,14,4,10
62245,Atruis,area-52,304,warrior,arms,7,4,3
62246,Syradar,ragnaros,304,warrior,arms,13,4,9
62247,Rezhan,area-52,304,warrior,arms,13,4,9
62248,Nicolasrage,trollbane,303,warrior,arms,11,5,6
62249,Hotboxer,kelthuzad,295,warrior,arms,12,5,7
62250,Rockhardt,tichondrius,288,warrior,arms,6,3,3
62251,Faywarsong,area-52,288,warrior,arms,6,3,3
62252,Runtasticx,tichondrius,288,warrior,arms,6,3,3
62253,Agamere,stormrage,288,warrior,arms,6,3,3
62254,Jutank,sargeras,288,warrior,arms,6,3,3
62255,Gpro,tichondrius,288,warrior,arms,6,3,3
62256,Davien,tichondrius,288,warrior,arms,6,3,3
62257,Yasser,ragnaros,288,warrior,arms,6,3,3
62258,Drugdilla,zuljin,288,warrior,arms,6,3,3
62259,Hesch,thunderlord,288,warrior,arms,6,3,3
62260,Schlosh,laughing-skull,288,warrior,arms,6,3,3
62261,Dronarmus,ragnaros,288,warrior,arms,6,3,3
62262,Robio,tichondrius,288,warrior,arms,6,3,3
62263,Mcrîb,stormscale,288,warrior,arms,6,3,3
62264,Kénblock,tichondrius,288,warrior,arms,6,3,3
62265,Småckêd,sargeras,288,warrior,arms,6,3,3
62266,Scottpilgrim,illidan,288,warrior,arms,6,3,3
62267,Bigpharma,elune,288,warrior,arms,6,3,3
62268,Caalypso,stormrage,288,warrior,arms,6,3,3
62269,Badvelic,tichondrius,288,warrior,arms,6,3,3
62270,Nedstarc,laughing-skull,288,warrior,arms,6,3,3
62271,Wrèckingball,tichondrius,288,warrior,arms,6,3,3
62272,Hanginaround,zuluhed,288,warrior,arms,6,3,3
62273,Spartanfury,tichondrius,288,warrior,arms,6,3,3
62274,Mekaknight,destromath,288,warrior,arms,6,3,3
62275,Swifty,tichondrius,288,warrior,arms,6,3,3
62276,Hotaha,tichondrius,288,warrior,arms,6,3,3
62277,Robostergler,tichondrius,288,warrior,arms,6,3,3
62278,Dematic,skullcrusher,288,warrior,arms,6,3,3
62279,Az,malorne,288,warrior,arms,6,3,3
62280,Críxus,sargeras,288,warrior,arms,6,3,3
62281,Tulnaak,durotan,288,warrior,arms,6,3,3
62282,Valför,ysera,288,warrior,arms,6,3,3
62283,Salveknight,ragnaros,288,warrior,arms,6,3,3
62284,Vólkar,quelthalas,288,warrior,arms,6,3,3
62285,Roidråge,area-52,288,warrior,arms,6,3,3
62286,Ayenel,stormrage,288,warrior,arms,6,3,3
62287,Poppacd,stormrage,288,warrior,arms,6,3,3
62288,Swizzly,tichondrius,288,warrior,arms,6,3,3
62289,Hytonmi,moon-guard,288,warrior,arms,6,3,3
62290,Daedrion,dalaran,288,warrior,arms,6,3,3
62291,Allmurr,ragnaros,288,warrior,arms,6,3,3
62292,Decimus,medivh,288,warrior,arms,6,3,3
62293,Larosfan,tichondrius,288,warrior,arms,6,3,3
62294,Brayven,area-52,288,warrior,arms,6,3,3
62295,Grapegush,bleeding-hollow,288,warrior,arms,6,3,3
62296,Ambevsgunnar,tichondrius,288,warrior,arms,6,3,3
62297,Nazakeen,tichondrius,288,warrior,arms,6,3,3
62298,Rezorc,stormrage,288,warrior,arms,6,3,3
62299,Smashndspin,sargeras,288,warrior,arms,6,3,3
62300,Necrøbutchër,ragnaros,288,warrior,arms,6,3,3
62301,Allmotor,zuljin,288,warrior,arms,6,3,3
62302,Fjswpp,tichondrius,288,warrior,arms,6,3,3
62303,Springbreak,bleeding-hollow,288,warrior,arms,6,3,3
62304,Exdilla,zuljin,288,warrior,arms,6,3,3
62305,Riidim,area-52,288,warrior,arms,6,3,3
62306,Fakktwo,blackhand,288,warrior,arms,6,3,3
62307,Mandofl,ragnaros,288,warrior,arms,6,3,3
62308,Jerveen,quelthalas,288,warrior,arms,6,3,3
62309,Cheekclapps,tichondrius,288,warrior,arms,6,3,3
62310,Dedbeet,barthilas,288,warrior,arms,6,3,3
62311,Kuntahkintah,tichondrius,288,warrior,arms,6,3,3
62312,Blazingfury,area-52,288,warrior,arms,6,3,3
62313,Jackanape,sargeras,288,warrior,arms,6,3,3
62314,Magthor,warsong,288,warrior,arms,6,3,3
62315,Zemms,mannoroth,288,warrior,arms,6,3,3
62316,Kokurawr,burning-legion,288,warrior,arms,6,3,3
62317,Aalrua,moon-guard,288,warrior,arms,6,3,3
62318,Serindel,quelthalas,288,warrior,arms,6,3,3
62319,Mcbanner,ragnaros,288,warrior,arms,6,3,3
62320,Notawar,stormrage,288,warrior,arms,6,3,3
62321,Wrekzor,zuljin,288,warrior,arms,6,3,3
62322,Mortaryon,malganis,288,warrior,arms,6,3,3
62323,Hellscrom,galakrond,288,warrior,arms,6,3,3
62324,Trashman,frostwolf,288,warrior,arms,6,3,3
62325,Reapr,moonrunner,288,warrior,arms,6,3,3
62326,Exequet,tichondrius,288,warrior,arms,6,3,3
62327,Zenmore,illidan,288,warrior,arms,6,3,3
62328,Zåzriel,tichondrius,288,warrior,arms,6,3,3
62329,Aiöria,ragnaros,288,warrior,arms,6,3,3
62330,Fivewarrior,tichondrius,288,warrior,arms,6,3,3
62331,Tsmtsmtsm,tichondrius,288,warrior,arms,6,3,3
62332,Cwar,tichondrius,288,warrior,arms,6,3,3
62333,Dropthemic,tichondrius,288,warrior,arms,6,3,3
62334,Zemi,sargeras,288,warrior,arms,6,3,3
62335,Darkirondolo,tichondrius,288,warrior,arms,6,3,3
62336,Humanlog,illidan,288,warrior,arms,6,3,3
62337,Glowstick,tichondrius,288,warrior,arms,6,3,3
62338,Miarisa,moon-guard,288,warrior,arms,6,3,3
62339,Idarkshakra,illidan,288,warrior,arms,6,3,3
62340,Perfz,bleeding-hollow,288,warrior,arms,6,3,3
62341,Srkong,stormrage,288,warrior,arms,6,3,3
62342,Cabelas,tichondrius,288,warrior,arms,6,3,3
62343,Akhinoz,area-52,288,warrior,arms,6,3,3
62344,Óðinnodin,tichondrius,288,warrior,arms,6,3,3
62345,Leonidas,barthilas,288,warrior,arms,6,3,3
62346,Tnytank,burning-legion,288,warrior,arms,6,3,3
62347,Wulfgarn,frostwolf,288,warrior,arms,6,3,3
62348,Sweetmojito,vashj,288,warrior,arms,6,3,3
62349,Chronicdank,tichondrius,288,warrior,arms,6,3,3
62350,Clerond,tichondrius,288,warrior,arms,6,3,3
62351,Cokedope,tichondrius,288,warrior,arms,6,3,3
62352,Noteko,tichondrius,288,warrior,arms,6,3,3
62353,Desertor,illidan,288,warrior,arms,6,3,3
62354,Chøde,barthilas,288,warrior,arms,6,3,3
62355,Letyoupain,illidan,288,warrior,arms,6,3,3
62356,Altron,icecrown,288,warrior,arms,6,3,3
62357,Ssamok,ragnaros,288,warrior,arms,6,3,3
62358,Shloope,barthilas,288,warrior,arms,6,3,3
62359,Drakr,ragnaros,288,warrior,arms,6,3,3
62360,Vibrates,stormreaver,288,warrior,arms,6,3,3
62361,Fregory,moon-guard,288,warrior,arms,6,3,3
62362,Exiledwarz,area-52,288,warrior,arms,6,3,3
62363,Temperament,area-52,288,warrior,arms,6,3,3
62364,Meatpouch,kelthuzad,288,warrior,arms,6,3,3
62365,Axeslaps,illidan,288,warrior,arms,6,3,3
62366,Hotwings,kelthuzad,288,warrior,arms,6,3,3
62367,Warriortimes,ragnaros,288,warrior,arms,6,3,3
62368,Warnuk,lightnings-blade,288,warrior,arms,6,3,3
62369,Retrô,uldum,288,warrior,arms,6,3,3
62370,Tread,mugthol,288,warrior,arms,6,3,3
62371,Akilosh,illidan,288,warrior,arms,6,3,3
62372,Richenbach,kelthuzad,288,warrior,arms,6,3,3
62373,Corrum,shuhalo,288,warrior,arms,6,3,3
62374,Dunsker,stormrage,288,warrior,arms,6,3,3
62375,Pussman,malganis,288,warrior,arms,6,3,3
62376,Topee,area-52,288,warrior,arms,6,3,3
62377,Hukzula,illidan,288,warrior,arms,6,3,3
62378,Shiromiya,tichondrius,288,warrior,arms,6,3,3
62379,Percanator,aggramar,288,warrior,arms,6,3,3
62380,Renning,malganis,288,warrior,arms,6,3,3
62381,Smashbashdie,stormrage,288,warrior,arms,6,3,3
62382,Ellx,sargeras,288,warrior,arms,6,3,3
62383,Jeyvil,stormrage,288,warrior,arms,6,3,3
62384,Thunderess,illidan,288,warrior,arms,6,3,3
62385,Garroshrimp,tichondrius,288,warrior,arms,6,3,3
62386,Tothepain,thrall,288,warrior,arms,6,3,3
62387,Evôlutiôn,kelthuzad,288,warrior,arms,6,3,3
62388,Gypsypsycho,stormrage,288,warrior,arms,6,3,3
62389,Huffzo,tichondrius,288,warrior,arms,6,3,3
62390,Solembuumm,illidan,288,warrior,arms,6,3,3
62391,Cryptex,illidan,288,warrior,arms,6,3,3
62392,Fyle,stormrage,288,warrior,arms,6,3,3
62393,Readytoflee,moon-guard,288,warrior,arms,6,3,3
62394,Assmut,stormrage,288,warrior,arms,6,3,3
62395,Senzhi,sargeras,288,warrior,arms,6,3,3
62396,Dolph,sargeras,288,warrior,arms,6,3,3
62397,Ragemelon,icecrown,288,warrior,arms,6,3,3
62398,Stárscreám,malganis,288,warrior,arms,6,3,3
62399,Haginn,malorne,288,warrior,arms,6,3,3
62400,Éten,drakkari,288,warrior,arms,6,3,3
62401,Girthquake,stormreaver,288,warrior,arms,6,3,3
62402,Ghomory,quelthalas,288,warrior,arms,6,3,3
62403,Imperiial,stormrage,288,warrior,arms,6,3,3
62404,Flarkin,area-52,288,warrior,arms,6,3,3
62405,Largegayman,sargeras,288,warrior,arms,6,3,3
62406,Miltlan,drakkari,288,warrior,arms,6,3,3
62407,Duglug,malganis,288,warrior,arms,6,3,3
62408,Warreeper,area-52,288,warrior,arms,6,3,3
62409,Mittyroar,khazgoroth,288,warrior,arms,6,3,3
62410,Jug,khazgoroth,288,warrior,arms,6,3,3
62411,Messe,khazgoroth,288,warrior,arms,6,3,3
62412,Seymourbot,illidan,288,warrior,arms,6,3,3
62413,Kajind,boulderfist,288,warrior,arms,6,3,3
62414,Rockybâlboa,illidan,288,warrior,arms,6,3,3
62415,Finnagnome,sargeras,288,warrior,arms,6,3,3
62416,Siouxfall,area-52,288,warrior,arms,6,3,3
62417,Tragictonka,stormrage,288,warrior,arms,6,3,3
62418,Vistacleave,maiev,288,warrior,arms,6,3,3
62419,Skullsplittr,illidan,288,warrior,arms,6,3,3
62420,Krïtzkreig,the-forgotten-coast,288,warrior,arms,6,3,3
62421,Gulharot,stormrage,288,warrior,arms,6,3,3
62422,Forthejeers,sargeras,288,warrior,arms,6,3,3
62423,Dublinn,llane,288,warrior,arms,6,3,3
62424,Elegance,llane,288,warrior,arms,6,3,3
62425,Bëowulf,malganis,288,warrior,arms,6,3,3
62426,Sauceslinga,frostmourne,288,warrior,arms,6,3,3
62427,Antiab,ragnaros,288,warrior,arms,6,3,3
62428,Uzy,proudmoore,288,warrior,arms,6,3,3
62429,Vnw,illidan,288,warrior,arms,6,3,3
62430,Unhealbedam,area-52,288,warrior,arms,6,3,3
62431,Camaeel,stormrage,288,warrior,arms,6,3,3
62432,Orkwar,tichondrius,288,warrior,arms,6,3,3
62433,Nukehazard,bleeding-hollow,288,warrior,arms,6,3,3
62434,Liltotey,frostmourne,288,warrior,arms,6,3,3
62435,Benieswar,frostmourne,288,warrior,arms,6,3,3
62436,Brôm,emerald-dream,288,warrior,arms,6,3,3
62437,Sunhands,emerald-dream,288,warrior,arms,6,3,3
62438,Leeth,azralon,288,warrior,arms,6,3,3
62439,Telynne,frostmourne,288,warrior,arms,6,3,3
62440,Warbringerr,hydraxis,288,warrior,arms,6,3,3
62441,Ei,darrowmere,288,warrior,arms,6,3,3
62442,Geyaráh,azralon,288,warrior,arms,6,3,3
62443,Ragëqt,windrunner,288,warrior,arms,6,3,3
62444,Sinjino,proudmoore,288,warrior,arms,6,3,3
62445,Gorkrog,frostmourne,288,warrior,arms,6,3,3
62446,Boitoróh,azralon,288,warrior,arms,6,3,3
62447,Gungo,kiljaeden,288,warrior,arms,6,3,3
62448,Renseven,frostmourne,288,warrior,arms,6,3,3
62449,Kryptïç,moon-guard,288,warrior,arms,6,3,3
62450,Carborr,frostmourne,288,warrior,arms,6,3,3
62451,Osselan,moon-guard,288,warrior,arms,6,3,3
62452,Bghero,wyrmrest-accord,288,warrior,arms,6,3,3
62453,Faelzerá,azralon,288,warrior,arms,6,3,3
62454,Trackhawk,moon-guard,288,warrior,arms,6,3,3
62455,Preceptron,azralon,288,warrior,arms,6,3,3
62456,Bullblader,azralon,288,warrior,arms,6,3,3
62457,Billpoonover,blackwing-lair,288,warrior,arms,6,3,3
62458,Awöl,jubeithos,288,warrior,arms,6,3,3
62459,Edokthong,frostmourne,288,warrior,arms,6,3,3
62460,Scanlan,dalvengyr,288,warrior,arms,6,3,3
62461,Flavorw,cairne,288,warrior,arms,6,3,3
62462,Ymìr,moon-guard,288,warrior,arms,6,3,3
62463,Vinetic,kiljaeden,288,warrior,arms,6,3,3
62464,Phaknah,emerald-dream,288,warrior,arms,6,3,3
62465,Poonoxo,gundrak,288,warrior,arms,6,3,3
62466,Tenfury,proudmoore,288,warrior,arms,6,3,3
62467,Tinylimbs,frostmourne,288,warrior,arms,6,3,3
62468,Valperion,frostmourne,288,warrior,arms,6,3,3
62469,Rhonusturune,blackrock,288,warrior,arms,6,3,3
62470,Ðuffman,jubeithos,288,warrior,arms,6,3,3
62471,Maldre,stormrage,288,warrior,arms,9,4,5
62472,Rageslayer,area-52,288,warrior,arms,9,4,5
62473,Grognäk,malganis,288,warrior,arms,7,3,4
62474,Terukan,drakkari,288,warrior,arms,7,3,4
62475,Ohdang,dark-iron,288,warrior,arms,8,3,5
62476,Ennia,azralon,288,warrior,arms,9,3,6
62477,Akil,ragnaros,288,warrior,arms,15,4,11
62478,Neltar,nagrand,288,warrior,arms,12,3,9
62479,Extremist,nagrand,288,warrior,arms,12,3,9
62480,Eightballerz,barthilas,288,warrior,arms,12,3,9
62481,Scrubzwarr,barthilas,288,warrior,arms,12,3,9
62482,Porori,proudmoore,288,warrior,arms,12,3,9
62483,Ntwandamaela,moon-guard,288,warrior,arms,12,3,9
62484,Smallraccoon,tichondrius,288,warrior,arms,12,3,9
62485,Grimthad,emerald-dream,288,warrior,arms,12,3,9
62486,Erzawälkër,quelthalas,288,warrior,arms,12,3,9
62487,Darthfaith,azgalor,288,warrior,arms,12,3,9
62488,Beenbag,aerie-peak,288,warrior,arms,12,3,9
62489,Orcboic,area-52,288,warrior,arms,12,3,9
62490,Minnysota,area-52,288,warrior,arms,12,3,9
62491,Äisemberg,quelthalas,288,warrior,arms,12,3,9
62492,Aræn,sargeras,288,warrior,arms,12,3,9
62493,Gnomas,destromath,288,warrior,arms,12,3,9
62494,Ichil,azshara,288,warrior,arms,12,3,9
62495,Smashyu,fenris,288,warrior,arms,12,3,9
62496,Bekilled,frostmourne,288,warrior,arms,12,3,9
62497,Relay,mugthol,288,warrior,arms,12,3,9
62498,Battleboxes,area-52,288,warrior,arms,12,3,9
62499,Basingsei,area-52,288,warrior,arms,12,3,9
62500,Kirikash,illidan,288,warrior,arms,12,3,9
62501,Ggodmyles,lightbringer,288,warrior,arms,12,3,9
62502,Morgithia,suramar,288,warrior,arms,12,3,9
62503,Mesw,illidan,288,warrior,arms,12,3,9
62504,Fupatwo,moon-guard,288,warrior,arms,12,3,9
62505,Zaeyr,tichondrius,288,warrior,arms,12,3,9
62506,Forarrior,malganis,288,warrior,arms,12,3,9
62507,Alliancerulz,darrowmere,288,warrior,arms,12,3,9
62508,Kero,malganis,288,warrior,arms,12,3,9
62509,Valestrike,moon-guard,288,warrior,arms,12,3,9
62510,Aralla,area-52,288,warrior,arms,12,3,9
62511,Kigo,azralon,288,warrior,arms,12,3,9
62512,Guerreraa,ragnaros,288,warrior,arms,12,3,9
62513,Krunchal,terenas,288,warrior,arms,12,3,9
62514,Wxxz,tichondrius,288,warrior,arms,12,3,9
62515,Luchonamøm,ragnaros,288,warrior,arms,12,3,9
62516,Xdragonfirex,terenas,288,warrior,arms,12,3,9
62517,Djshinobi,whisperwind,288,warrior,arms,12,3,9
62518,Swiftless,gnomeregan,288,warrior,arms,12,3,9
62519,Brujas,blackrock,288,warrior,arms,12,3,9
62520,Sescor,moon-guard,288,warrior,arms,12,3,9
62521,Hozer,tichondrius,288,warrior,arms,12,3,9
62522,Naughtynilla,sargeras,288,warrior,arms,12,3,9
62523,Brütalize,wyrmrest-accord,288,warrior,arms,12,3,9
62524,Maldrik,exodar,288,warrior,arms,12,3,9
62525,Mothor,thrall,288,warrior,arms,12,3,9
62526,Ggéz,stormrage,288,warrior,arms,12,3,9
62527,Âlecos,ragnaros,288,warrior,arms,12,3,9
62528,Hrl,tichondrius,288,warrior,arms,12,3,9
62529,Melancalli,thorium-brotherhood,288,warrior,arms,12,3,9
62530,Enzothebaker,thrall,288,warrior,arms,12,3,9
62531,Kregnar,gundrak,288,warrior,arms,12,3,9
62532,Nektar,aerie-peak,288,warrior,arms,12,3,9
62533,Roadpig,zuljin,288,warrior,arms,12,3,9
62534,Héro,stormrage,288,warrior,arms,12,3,9
62535,Geontage,drakkari,288,warrior,arms,12,3,9
62536,Nightwing,bleeding-hollow,288,warrior,arms,12,3,9
62537,Émerald,kilrogg,288,warrior,arms,12,3,9
62538,Paxyisbad,tichondrius,288,warrior,arms,12,3,9
62539,Doomr,tichondrius,288,warrior,arms,12,3,9
62540,Staticego,dalaran,288,warrior,arms,12,3,9
62541,Mavromantus,lightninghoof,288,warrior,arms,12,3,9
62542,Kintownhero,aegwynn,288,warrior,arms,12,3,9
62543,Dablao,tichondrius,288,warrior,arms,12,3,9
62544,Enulimen,daggerspine,288,warrior,arms,12,3,9
62545,Zsl,tichondrius,288,warrior,arms,12,3,9
62546,Snippy,garona,288,warrior,arms,12,3,9
62547,Mansin,tichondrius,288,warrior,arms,12,3,9
62548,Dainbramage,dalaran,288,warrior,arms,12,3,9
62549,Awezc,chogall,288,warrior,arms,12,3,9
62550,Kierto,undermine,288,warrior,arms,12,3,9
62551,Phargo,korgath,288,warrior,arms,12,3,9
62552,Glamen,moon-guard,288,warrior,arms,12,3,9
62553,Kiillwar,smolderthorn,288,warrior,arms,12,3,9
62554,Lowdopamine,tichondrius,288,warrior,arms,12,3,9
62555,Soughloe,illidan,288,warrior,arms,12,3,9
62556,Slamspam,the-underbog,288,warrior,arms,13,3,10
62557,Khallell,illidan,288,warrior,arms,18,3,15
62558,Dorathorn,azralon,288,warrior,arms,18,3,15
62559,Integrâl,tichondrius,288,warrior,arms,18,3,15
62560,Mathilan,moon-guard,288,warrior,arms,18,3,15
62561,Giant,lothar,288,warrior,arms,18,3,15
62562,Madgrim,tichondrius,288,warrior,arms,18,3,15
62563,Macbride,blackrock,288,warrior,arms,24,3,21
62564,Yomaaln,blackrock,287,warrior,arms,6,3,3
62565,Silverludê,sargeras,287,warrior,arms,6,3,3
62566,Magtharas,dunemaul,287,warrior,arms,6,3,3
62567,Elliyuh,darkspear,287,warrior,arms,6,3,3
62568,Saintgeorge,thorium-brotherhood,287,warrior,arms,6,3,3
62569,Breinan,ragnaros,287,warrior,arms,6,3,3
62570,Smashthings,area-52,287,warrior,arms,6,3,3
62571,Noktarr,tichondrius,287,warrior,arms,9,4,5
62572,Brutekush,barthilas,287,warrior,arms,12,3,9
62573,Leosax,drakthul,287,warrior,arms,12,3,9
62574,Clayske,gurubashi,287,warrior,arms,12,3,9
62575,Dekromm,tol-barad,287,warrior,arms,12,3,9
62576,Rhawl,ragnaros,287,warrior,arms,22,5,17
62577,Borgosa,wyrmrest-accord,287,warrior,arms,18,3,15
62578,Tyronê,moon-guard,287,warrior,arms,18,3,15
62579,Morphexo,quelthalas,276,warrior,arms,20,6,14
62580,Vith,bleeding-hollow,271,warrior,arms,11,3,8
62581,Dazanor,moon-guard,271,warrior,arms,11,3,8
62582,Zugbrained,zuljin,271,warrior,arms,11,3,8
62583,Nooy,blackrock,271,warrior,arms,17,3,14
62584,Thorsën,sargeras,256,warrior,arms,8,4,4
62585,Zuckexe,illidan,256,warrior,arms,10,3,7
62586,Pippysmallz,tichondrius,256,warrior,arms,10,3,7
62587,Nècroxious,hellscream,255,warrior,arms,11,3,8
62588,Spicywagyu,tichondrius,255,warrior,arms,11,3,8
62589,Blksquadron,sargeras,253,warrior,arms,12,3,9
62590,Faduuba,quelthalas,240,warrior,arms,9,3,6
62591,Builtdif,zuljin,239,warrior,arms,5,3,2
62592,Busyguyw,kiljaeden,239,warrior,arms,5,3,2
62593,ßlitzxkreig,tichondrius,239,warrior,arms,5,3,2
62594,Omicripto,tichondrius,239,warrior,arms,5,3,2
62595,Hakén,tichondrius,239,warrior,arms,5,3,2
62596,Kholusia,kul-tiras,239,warrior,arms,5,3,2
62597,Kalphok,tichondrius,239,warrior,arms,5,3,2
62598,Likearock,thrall,239,warrior,arms,5,3,2
62599,Benchpress,bleeding-hollow,223,warrior,arms,8,3,5
62600,Nayaqt,tichondrius,223,warrior,arms,8,3,5
62601,Snikkles,frostmourne,223,warrior,arms,8,3,5
62602,Metal,ragnaros,223,warrior,arms,8,3,5
62603,Nicked,azralon,223,warrior,arms,14,3,11
62604,Condemnd,area-52,207,warrior,arms,8,3,5
62605,Elyn,tichondrius,192,warrior,arms,4,3,1
62606,Wonderjack,akama,192,warrior,arms,4,3,1
62607,Porotitto,drakkari,192,warrior,arms,11,4,7
62608,Arianarkw,sargeras,192,warrior,arms,9,3,6
62609,Berru,bleeding-hollow,192,warrior,arms,9,3,6
62610,Cugino,tichondrius,192,warrior,arms,9,3,6
62611,Shiestyzug,tichondrius,192,warrior,arms,6,2,4
62612,Xurug,zuljin,192,warrior,arms,6,2,4
62613,Spaceshuttle,bleeding-hollow,192,warrior,arms,6,2,4
62614,Tonytonychop,chogall,192,warrior,arms,6,2,4
62615,Trenbopanda,tichondrius,192,warrior,arms,6,2,4
62616,Hookiee,zuljin,192,warrior,arms,6,2,4
62617,Pookythebear,tichondrius,192,warrior,arms,6,2,4
62618,Armsracê,zuljin,192,warrior,arms,6,2,4
62619,Harlo,nerzhul,192,warrior,arms,6,2,4
62620,Bloodscream,magtheridon,192,warrior,arms,6,2,4
62621,Freezyraw,zuljin,192,warrior,arms,6,2,4
62622,Suavay,executus,192,warrior,arms,6,2,4
62623,Vamsx,barthilas,192,warrior,arms,6,2,4
62624,Verwischen,zuljin,192,warrior,arms,6,2,4
62625,Danksoms,arthas,192,warrior,arms,6,2,4
62626,Ronipastrami,kelthuzad,192,warrior,arms,6,2,4
62627,Tnknspnk,magtheridon,192,warrior,arms,6,2,4
62628,Chopmeat,ysera,192,warrior,arms,6,2,4
62629,Chapa,tichondrius,192,warrior,arms,6,2,4
62630,Kostikk,tichondrius,192,warrior,arms,6,2,4
62631,Bearlornan,frostmourne,192,warrior,arms,6,2,4
62632,Tatro,tichondrius,192,warrior,arms,6,2,4
62633,Passionjar,bleeding-hollow,192,warrior,arms,6,2,4
62634,Bs,kiljaeden,192,warrior,arms,6,2,4
62635,Burstful,bleeding-hollow,192,warrior,arms,6,2,4
62636,Oow,barthilas,192,warrior,arms,6,2,4
62637,Drtbag,tichondrius,192,warrior,arms,6,2,4
62638,Avansys,tichondrius,192,warrior,arms,6,2,4
62639,Bronzeblood,arthas,192,warrior,arms,6,2,4
62640,Kvnñ,frostmourne,192,warrior,arms,6,2,4
62641,Bigbungus,frostmourne,192,warrior,arms,6,2,4
62642,Papichoppyme,bleeding-hollow,192,warrior,arms,6,2,4
62643,Emraldfury,darkspear,192,warrior,arms,6,2,4
62644,Kinaed,durotan,192,warrior,arms,6,2,4
62645,Clayguns,argent-dawn,192,warrior,arms,6,2,4
62646,Hurricán,tichondrius,192,warrior,arms,6,2,4
62647,Gtrain,barthilas,192,warrior,arms,6,2,4
62648,Ningz,tichondrius,192,warrior,arms,6,2,4
62649,Risr,illidan,192,warrior,arms,6,2,4
62650,Dracufeuer,bleeding-hollow,192,warrior,arms,6,2,4
62651,Annubiis,tichondrius,192,warrior,arms,6,2,4
62652,Zingerboss,barthilas,192,warrior,arms,6,2,4
62653,Depressedman,tichondrius,192,warrior,arms,6,2,4
62654,Stormbadge,tichondrius,192,warrior,arms,6,2,4
62655,Hellabandz,bleeding-hollow,192,warrior,arms,6,2,4
62656,Blackzone,lethon,192,warrior,arms,6,2,4
62657,Sylvannlee,tichondrius,192,warrior,arms,6,2,4
62658,Shrexecute,tichondrius,192,warrior,arms,6,2,4
62659,Deloum,tichondrius,192,warrior,arms,6,2,4
62660,Marszx,frostmourne,192,warrior,arms,6,2,4
62661,Icebringer,frostmourne,192,warrior,arms,6,2,4
62662,Rendus,hyjal,192,warrior,arms,6,2,4
62663,Uldrath,hyjal,192,warrior,arms,6,2,4
62664,Controlololx,hyjal,192,warrior,arms,6,2,4
62665,Kratøz,tichondrius,192,warrior,arms,6,2,4
62666,Sweatyvols,illidan,192,warrior,arms,6,2,4
62667,Thiccthôt,frostmourne,192,warrior,arms,6,2,4
62668,Tokushima,illidan,192,warrior,arms,6,2,4
62669,Roidragez,illidan,192,warrior,arms,6,2,4
62670,Flyaf,illidan,192,warrior,arms,6,2,4
62671,Fäey,dalaran,192,warrior,arms,6,2,4
62672,Kuthero,bonechewer,192,warrior,arms,6,2,4
62673,Endlesskilla,destromath,192,warrior,arms,6,2,4
62674,Braxxinn,tichondrius,192,warrior,arms,6,2,4
62675,Squonks,kelthuzad,192,warrior,arms,6,2,4
62676,Ychazz,stormrage,192,warrior,arms,6,2,4
62677,Dreadworld,bleeding-hollow,192,warrior,arms,6,2,4
62678,Focalabbys,illidan,192,warrior,arms,6,2,4
62679,Soldiër,proudmoore,192,warrior,arms,6,2,4
62680,Tinykong,zuljin,192,warrior,arms,6,2,4
62681,Gigglamesh,muradin,192,warrior,arms,6,2,4
62682,Rambð,illidan,192,warrior,arms,6,2,4
62683,Wakkawar,stormrage,192,warrior,arms,6,2,4
62684,Orphenkaos,bleeding-hollow,192,warrior,arms,6,2,4
62685,Baynn,frostmourne,192,warrior,arms,6,2,4
62686,Guroku,tichondrius,192,warrior,arms,6,2,4
62687,Berario,garrosh,192,warrior,arms,6,2,4
62688,Åmowarr,illidan,192,warrior,arms,6,2,4
62689,Dalmor,stormrage,192,warrior,arms,6,2,4
62690,Beirdo,aegwynn,192,warrior,arms,6,2,4
62691,Bjorgsen,frostmourne,192,warrior,arms,6,2,4
62692,Berserkur,daggerspine,192,warrior,arms,6,2,4
62693,Wildawar,tichondrius,192,warrior,arms,6,2,4
62694,Befòx,tichondrius,192,warrior,arms,6,2,4
62695,Josmawar,drakkari,192,warrior,arms,6,2,4
62696,Kreits,drakkari,192,warrior,arms,6,2,4
62697,Nabangle,barthilas,192,warrior,arms,6,2,4
62698,Eleenoor,drakkari,192,warrior,arms,6,2,4
62699,Clumhaku,dalaran,192,warrior,arms,6,2,4
62700,Darkstrikee,tichondrius,192,warrior,arms,6,2,4
62701,Ulkharek,wyrmrest-accord,192,warrior,arms,6,2,4
62702,Deepsplitter,illidan,192,warrior,arms,6,2,4
62703,Soulmerc,turalyon,192,warrior,arms,6,2,4
62704,Orcly,kilrogg,192,warrior,arms,6,2,4
62705,Variants,azralon,192,warrior,arms,6,2,4
62706,Danskmand,tichondrius,192,warrior,arms,6,2,4
62707,Kénny,stormrage,192,warrior,arms,6,2,4
62708,Stellabear,aggramar,192,warrior,arms,6,2,4
62709,Brenrainn,thrall,192,warrior,arms,6,2,4
62710,Warcryof,illidan,192,warrior,arms,6,2,4
62711,Stavsie,tichondrius,192,warrior,arms,6,2,4
62712,Borealiss,ragnaros,192,warrior,arms,6,2,4
62713,Tyir,ragnaros,192,warrior,arms,6,2,4
62714,Ereshom,wyrmrest-accord,192,warrior,arms,6,2,4
62715,Saabre,tichondrius,192,warrior,arms,6,2,4
62716,Jessicajinn,illidan,192,warrior,arms,6,2,4
62717,Ruinhorn,thrall,192,warrior,arms,6,2,4
62718,Vampiranha,azralon,192,warrior,arms,6,2,4
62719,Jéshka,wyrmrest-accord,192,warrior,arms,6,2,4
62720,Rekshor,wyrmrest-accord,192,warrior,arms,6,2,4
62721,Trouz,ragnaros,192,warrior,arms,6,2,4
62722,Raldoron,thrall,192,warrior,arms,6,2,4
62723,Joelyyonerr,barthilas,192,warrior,arms,6,2,4
62724,Sosaalmigh,tichondrius,192,warrior,arms,6,2,4
62725,Bubjones,anvilmar,192,warrior,arms,6,2,4
62726,Suzushi,tichondrius,192,warrior,arms,6,2,4
62727,Overlordz,azralon,192,warrior,arms,6,2,4
62728,Dunklad,thrall,192,warrior,arms,6,2,4
62729,Hoovie,thrall,192,warrior,arms,6,2,4
62730,Bbyzugga,kelthuzad,192,warrior,arms,6,2,4
62731,Karlsabad,medivh,192,warrior,arms,6,2,4
62732,Draimän,ragnaros,192,warrior,arms,6,2,4
62733,Frankal,aegwynn,192,warrior,arms,6,2,4
62734,Dagorine,eredar,192,warrior,arms,6,2,4
62735,Bloodthristy,dunemaul,192,warrior,arms,6,2,4
62736,Hbbaboy,nagrand,192,warrior,arms,6,2,4
62737,Æxe,tichondrius,192,warrior,arms,6,2,4
62738,ßabybeef,azralon,192,warrior,arms,6,2,4
62739,Warkaiser,ragnaros,192,warrior,arms,6,2,4
62740,Surge,eredar,192,warrior,arms,6,2,4
62741,Chuck,zangarmarsh,192,warrior,arms,6,2,4
62742,Troyana,azralon,192,warrior,arms,6,2,4
62743,Bestexecutes,stormrage,192,warrior,arms,6,2,4
62744,Wl,ragnaros,192,warrior,arms,6,2,4
62745,Maleficous,tol-barad,192,warrior,arms,6,2,4
62746,Jírky,ragnaros,192,warrior,arms,6,2,4
62747,Corazondleón,ragnaros,192,warrior,arms,6,2,4
62748,Anabolicjim,frostmourne,192,warrior,arms,6,2,4
62749,Negrolas,nemesis,192,warrior,arms,6,2,4
62750,Denival,proudmoore,192,warrior,arms,6,2,4
62751,Disheartened,wyrmrest-accord,192,warrior,arms,6,2,4
62752,Nezy,frostmourne,192,warrior,arms,6,2,4
62753,Gátzú,ragnaros,192,warrior,arms,6,2,4
62754,Yeèzy,stormrage,192,warrior,arms,6,2,4
62755,Arbitraiter,whisperwind,192,warrior,arms,6,2,4
62756,Yeicomoon,ragnaros,192,warrior,arms,6,2,4
62757,Tankum,dunemaul,192,warrior,arms,6,2,4
62758,Dodiru,azralon,192,warrior,arms,6,2,4
62759,Düde,whisperwind,192,warrior,arms,6,2,4
62760,Crno,stormrage,192,warrior,arms,6,2,4
62761,Bonetotem,azralon,192,warrior,arms,6,2,4
62762,Mansaniwis,tichondrius,192,warrior,arms,6,2,4
62763,Xaviorn,illidan,192,warrior,arms,6,2,4
62764,Helminth,kirin-tor,192,warrior,arms,6,2,4
62765,Tarkvs,ragnaros,192,warrior,arms,6,2,4
62766,Flakesskillz,darkspear,192,warrior,arms,6,2,4
62767,Padregordo,stormrage,192,warrior,arms,6,2,4
62768,Slamzftw,stormreaver,192,warrior,arms,6,2,4
62769,Annihilataur,blackhand,192,warrior,arms,6,2,4
62770,Rizmal,area-52,192,warrior,arms,6,2,4
62771,Failnat,area-52,192,warrior,arms,6,2,4
62772,Lgnasty,area-52,192,warrior,arms,6,2,4
62773,Bogii,area-52,192,warrior,arms,6,2,4
62774,Primørdíal,tichondrius,192,warrior,arms,6,2,4
62775,Lhariza,stormrage,192,warrior,arms,6,2,4
62776,Wooglinx,stormrage,192,warrior,arms,6,2,4
62777,Dahakawar,malganis,192,warrior,arms,6,2,4
62778,Sypii,malganis,192,warrior,arms,6,2,4
62779,Saltos,frostmourne,192,warrior,arms,6,2,4
62780,Pép,malganis,192,warrior,arms,6,2,4
62781,Tnknspnk,stormrage,192,warrior,arms,6,2,4
62782,Chrizo,area-52,192,warrior,arms,6,2,4
62783,Saltycrakerz,area-52,192,warrior,arms,6,2,4
62784,Nordrages,stormrage,192,warrior,arms,6,2,4
62785,Ggcthulu,area-52,192,warrior,arms,6,2,4
62786,Nerffrogues,stormrage,192,warrior,arms,6,2,4
62787,Immadropyou,malganis,192,warrior,arms,6,2,4
62788,Akaínu,area-52,192,warrior,arms,6,2,4
62789,Àyo,frostmourne,192,warrior,arms,6,2,4
62790,Titanwarr,malganis,192,warrior,arms,6,2,4
62791,Riggs,stonemaul,192,warrior,arms,6,2,4
62792,Hitokïri,stormrage,192,warrior,arms,6,2,4
62793,Playbox,area-52,192,warrior,arms,6,2,4
62794,Çampbêll,area-52,192,warrior,arms,6,2,4
62795,Treeinchkokk,area-52,192,warrior,arms,6,2,4
62796,Comic,malganis,192,warrior,arms,6,2,4
62797,Digitalfear,malganis,192,warrior,arms,6,2,4
62798,Pendrake,proudmoore,192,warrior,arms,6,2,4
62799,Kalabawph,area-52,192,warrior,arms,6,2,4
62800,Derr,tichondrius,192,warrior,arms,6,2,4
62801,Zulex,dathremar,192,warrior,arms,6,2,4
62802,Eurthx,lightbringer,192,warrior,arms,6,2,4
62803,Smokingops,frostmourne,192,warrior,arms,6,2,4
62804,Warhova,area-52,192,warrior,arms,6,2,4
62805,Pisagnòmos,quelthalas,192,warrior,arms,6,2,4
62806,Alitalia,thunderlord,192,warrior,arms,6,2,4
62807,Dëckhand,proudmoore,192,warrior,arms,6,2,4
62808,Kraff,tichondrius,192,warrior,arms,6,2,4
62809,Tüssèll,khazgoroth,192,warrior,arms,6,2,4
62810,Jakelope,proudmoore,192,warrior,arms,6,2,4
62811,Eravor,quelthalas,192,warrior,arms,6,2,4
62812,Airolol,tichondrius,192,warrior,arms,6,2,4
62813,Mututu,frostmourne,192,warrior,arms,6,2,4
62814,Lazarenthus,stormrage,192,warrior,arms,6,2,4
62815,Marconisabio,azralon,192,warrior,arms,6,2,4
62816,Beilian,quelthalas,192,warrior,arms,6,2,4
62817,Hagger,quelthalas,192,warrior,arms,6,2,4
62818,Stebe,thunderlord,192,warrior,arms,6,2,4
62819,Tearadis,thunderlord,192,warrior,arms,6,2,4
62820,Guanabacoa,area-52,192,warrior,arms,6,2,4
62821,Toscö,quelthalas,192,warrior,arms,6,2,4
62822,Deldramor,proudmoore,192,warrior,arms,6,2,4
62823,Hookahmasta,area-52,192,warrior,arms,6,2,4
62824,Exec,mannoroth,192,warrior,arms,6,2,4
62825,Mongofiera,quelthalas,192,warrior,arms,6,2,4
62826,Pornawar,area-52,192,warrior,arms,6,2,4
62827,Fùzzy,zuluhed,192,warrior,arms,6,2,4
62828,Smokinaces,emerald-dream,192,warrior,arms,6,2,4
62829,Iapologiz,illidan,192,warrior,arms,6,2,4
62830,Uprisèn,illidan,192,warrior,arms,6,2,4
62831,Stinkdog,khazgoroth,192,warrior,arms,6,2,4
62832,Bradic,bladefist,192,warrior,arms,6,2,4
62833,Scrubwarrior,black-dragonflight,192,warrior,arms,6,2,4
62834,Hawaiianko,guldan,192,warrior,arms,6,2,4
62835,Disturbed,velen,192,warrior,arms,6,2,4
62836,Vegr,queldorei,192,warrior,arms,6,2,4
62837,Xtrego,quelthalas,192,warrior,arms,6,2,4
62838,Kiladrew,korgath,192,warrior,arms,6,2,4
62839,Zabutay,quelthalas,192,warrior,arms,6,2,4
62840,Noblêsix,dalaran,192,warrior,arms,6,2,4
62841,Adonis,burning-blade,192,warrior,arms,6,2,4
62842,Donni,kelthuzad,192,warrior,arms,6,2,4
62843,Liabilities,icecrown,192,warrior,arms,6,2,4
62844,Minionz,tichondrius,192,warrior,arms,6,2,4
62845,Smeshyou,kelthuzad,192,warrior,arms,6,2,4
62846,Orson,lothar,192,warrior,arms,6,2,4
62847,Yeetzbytre,sargeras,192,warrior,arms,6,2,4
62848,Mahknut,moon-guard,192,warrior,arms,6,2,4
62849,Lopotron,sargeras,192,warrior,arms,6,2,4
62850,Thresdan,emerald-dream,192,warrior,arms,6,2,4
62851,Tormite,spirestone,192,warrior,arms,6,2,4
62852,Oneeyewille,sargeras,192,warrior,arms,6,2,4
62853,Berserkchow,sargeras,192,warrior,arms,6,2,4
62854,Pollere,firetree,192,warrior,arms,6,2,4
62855,Steelbane,moon-guard,192,warrior,arms,6,2,4
62856,Skalvi,moon-guard,192,warrior,arms,6,2,4
62857,Donpepe,sargeras,192,warrior,arms,6,2,4
62858,Negrus,sargeras,192,warrior,arms,6,2,4
62859,Beârz,the-underbog,192,warrior,arms,6,2,4
62860,Alppha,emerald-dream,192,warrior,arms,6,2,4
62861,Lvcifer,akama,192,warrior,arms,6,2,4
62862,Mochigome,moon-guard,192,warrior,arms,6,2,4
62863,Rí,moon-guard,192,warrior,arms,6,2,4
62864,Pandemonio,burning-legion,192,warrior,arms,6,2,4
62865,Lavablood,moon-guard,192,warrior,arms,6,2,4
62866,Zerríck,moon-guard,192,warrior,arms,6,2,4
62867,Plata,akama,192,warrior,arms,6,2,4
62868,Zekken,blades-edge,192,warrior,arms,6,2,4
62869,Fealix,moon-guard,192,warrior,arms,6,2,4
62870,Creedmor,moon-guard,192,warrior,arms,6,2,4
62871,Oðín,emerald-dream,192,warrior,arms,6,2,4
62872,Linkedd,sargeras,192,warrior,arms,6,2,4
62873,Valky,sargeras,192,warrior,arms,6,2,4
62874,Revinth,sargeras,192,warrior,arms,6,2,4
62875,Daechoochoo,frostwolf,192,warrior,arms,6,2,4
62876,Moosoka,malorne,192,warrior,arms,6,2,4
62877,Rassius,sargeras,192,warrior,arms,6,2,4
62878,Amicus,frostmourne,192,warrior,arms,7,2,5
62879,Sinenrs,tichondrius,192,warrior,arms,8,2,6
62880,Xavíerus,tichondrius,192,warrior,arms,9,2,7
62881,Rexsi,korgath,192,warrior,arms,9,2,7
62882,Redrunebar,illidan,192,warrior,arms,10,2,8
62883,Hiddensquids,laughing-skull,192,warrior,arms,11,2,9
62884,Ragekilla,silvermoon,192,warrior,arms,12,2,10
62885,Alvitr,kelthuzad,192,warrior,arms,12,2,10
62886,Twoironfist,azralon,192,warrior,arms,12,2,10
62887,Cleaver,draka,192,warrior,arms,12,2,10
62888,Lawyer,quelthalas,192,warrior,arms,12,2,10
62889,Zulm,emerald-dream,192,warrior,arms,12,2,10
62890,Jiva,emerald-dream,192,warrior,arms,12,2,10
62891,Item,nerzhul,192,warrior,arms,12,2,10
62892,Grègore,stormrage,192,warrior,arms,12,2,10
62893,Killtrain,illidan,192,warrior,arms,12,2,10
62894,Yoknitron,bonechewer,192,warrior,arms,12,2,10
62895,Bearyfresh,area-52,192,warrior,arms,12,2,10
62896,Loveliuna,illidan,192,warrior,arms,12,2,10
62897,Warmachîne,area-52,192,warrior,arms,12,2,10
62898,Loktaromoose,frostmourne,192,warrior,arms,12,2,10
62899,Goretooth,moon-guard,192,warrior,arms,12,2,10
62900,Bronkyaf,hyjal,192,warrior,arms,12,2,10
62901,Trollchopo,kiljaeden,192,warrior,arms,12,2,10
62902,Axemurdera,frostmourne,192,warrior,arms,12,2,10
62903,Erwin,kiljaeden,192,warrior,arms,12,2,10
62904,Stipdip,tichondrius,192,warrior,arms,12,2,10
62905,Aymadommy,illidan,192,warrior,arms,12,2,10
62906,Gouzizhang,proudmoore,192,warrior,arms,12,2,10
62907,Léonwow,tichondrius,192,warrior,arms,12,2,10
62908,Árades,tichondrius,192,warrior,arms,12,2,10
62909,Råging,area-52,192,warrior,arms,12,2,10
62910,Gornal,sargeras,192,warrior,arms,12,2,10
62911,Spårtacus,illidan,192,warrior,arms,12,2,10
62912,Shaffer,bleeding-hollow,192,warrior,arms,12,2,10
62913,Jsl,tichondrius,192,warrior,arms,12,2,10
62914,Strongboii,tichondrius,192,warrior,arms,12,2,10
62915,Ohhgeekush,proudmoore,192,warrior,arms,12,2,10
62916,Braygar,barthilas,192,warrior,arms,12,2,10
62917,Jhalakni,quelthalas,192,warrior,arms,12,2,10
62918,Annyan,ragnaros,192,warrior,arms,12,2,10
62919,Avondwella,undermine,192,warrior,arms,12,2,10
62920,Warhoofz,malganis,192,warrior,arms,12,2,10
62921,Connero,stormrage,192,warrior,arms,12,2,10
62922,Escuamata,quelthalas,192,warrior,arms,12,2,10
62923,Gambii,moon-guard,192,warrior,arms,12,2,10
62924,Hellswine,barthilas,192,warrior,arms,12,2,10
62925,Kurzix,crushridge,192,warrior,arms,12,2,10
62926,Lawlstørm,stormrage,192,warrior,arms,12,2,10
62927,Zaxxry,malganis,192,warrior,arms,12,2,10
62928,Mokthar,barthilas,192,warrior,arms,12,2,10
62929,Hugezs,tichondrius,192,warrior,arms,12,2,10
62930,Falcmore,stormrage,192,warrior,arms,12,2,10
62931,Haruq,tichondrius,192,warrior,arms,12,2,10
62932,Artá,uldum,192,warrior,arms,12,2,10
62933,Brutaltruth,dragonmaw,192,warrior,arms,12,2,10
62934,Arthurston,tichondrius,192,warrior,arms,12,2,10
62935,Pennyonebutt,barthilas,192,warrior,arms,12,2,10
62936,Schecterguy,stormrage,192,warrior,arms,14,2,12
62937,Fallensoul,nazjatar,192,warrior,arms,14,2,12
62938,Edrelang,bronzebeard,191,warrior,arms,6,2,4
62939,Blackkcow,zuljin,191,warrior,arms,6,2,4
62940,Hazell,gundrak,191,warrior,arms,6,2,4
62941,Krátös,farstriders,191,warrior,arms,6,2,4
62942,Chóps,quelthalas,191,warrior,arms,6,2,4
62943,Bunedau,azgalor,191,warrior,arms,12,2,10
62944,Berserko,gurubashi,175,warrior,arms,9,4,5
62945,Hornsolo,archimonde,175,warrior,arms,11,2,9
62946,Hemmy,kilrogg,175,warrior,arms,11,2,9
62947,Tour,proudmoore,160,warrior,arms,10,2,8
62948,Ybsorc,kelthuzad,160,warrior,arms,10,2,8
62949,Kellsbro,hyjal,159,warrior,arms,5,2,3
62950,Zîppyx,tichondrius,159,warrior,arms,5,2,3
62951,Wyerlyn,illidan,159,warrior,arms,5,2,3
62952,Vapyr,moon-guard,159,warrior,arms,5,2,3
62953,Rutroo,kelthuzad,159,warrior,arms,5,2,3
62954,Gontore,thrall,159,warrior,arms,5,2,3
62955,Notoriousmmà,illidan,159,warrior,arms,5,2,3
62956,Swordblood,ragnaros,159,warrior,arms,5,2,3
62957,Leshak,tichondrius,159,warrior,arms,5,2,3
62958,Sheerwill,wyrmrest-accord,159,warrior,arms,8,3,5
62959,Eatscrayons,barthilas,159,warrior,arms,11,2,9
62960,Liftedgainz,stormreaver,144,warrior,arms,3,3,0
62961,Chawboks,sargeras,144,warrior,arms,9,2,7
62962,Dösiërx,area-52,138,warrior,arms,9,3,6
62963,Fatbarstard,jubeithos,138,warrior,arms,16,3,13
62964,Scottie,cairne,136,warrior,arms,7,3,4
62965,Nosors,kelthuzad,128,warrior,arms,4,2,2
62966,Clarityw,illidan,128,warrior,arms,4,2,2
62967,Rageface,illidan,128,warrior,arms,4,2,2
62968,Stunahh,bleeding-hollow,128,warrior,arms,4,2,2
62969,Captnplague,mugthol,128,warrior,arms,5,2,3
62970,Eatmyblade,wyrmrest-accord,128,warrior,arms,10,2,8
62971,Jowesley,azralon,105,warrior,arms,14,4,10
62972,Ranikmurr,moon-guard,96,warrior,arms,3,2,1
62973,Kevs,sargeras,96,warrior,arms,3,2,1
62974,Shoresy,korgath,96,warrior,arms,3,2,1
62975,Ryuulion,proudmoore,96,warrior,arms,3,2,1
62976,Darthkrull,ragnaros,96,warrior,arms,3,2,1
62977,Wolurog,emerald-dream,96,warrior,arms,6,1,5
62978,Wäkko,stormrage,96,warrior,arms,6,1,5
62979,Targha,tichondrius,96,warrior,arms,6,1,5
62980,Jennatolls,boulderfist,96,warrior,arms,6,1,5
62981,Warriorlover,stormrage,96,warrior,arms,6,1,5
62982,Fexis,queldorei,96,warrior,arms,6,1,5
62983,Shibanda,tichondrius,96,warrior,arms,6,1,5
62984,Hellamoist,tichondrius,96,warrior,arms,6,1,5
62985,Sosaw,moon-guard,96,warrior,arms,6,1,5
62986,Tfd,tichondrius,96,warrior,arms,6,1,5
62987,Brigandier,shattered-hand,96,warrior,arms,6,1,5
62988,Einoch,stormrage,96,warrior,arms,6,1,5
62989,Rambovix,tichondrius,96,warrior,arms,6,1,5
62990,Berawar,tichondrius,96,warrior,arms,6,1,5
62991,Betsisword,stormrage,96,warrior,arms,6,1,5
62992,Faintswar,stormrage,96,warrior,arms,6,1,5
62993,Kåyotix,proudmoore,96,warrior,arms,6,1,5
62994,Radenos,proudmoore,96,warrior,arms,6,1,5
62995,Talunus,tichondrius,96,warrior,arms,6,1,5
62996,Uju,lothar,96,warrior,arms,6,1,5
62997,Blazeblade,cenarius,96,warrior,arms,6,1,5
62998,Dikesrus,tichondrius,96,warrior,arms,6,1,5
62999,Iscylicene,tichondrius,96,warrior,arms,6,1,5
63000,Cahdrophenia,moon-guard,96,warrior,arms,6,1,5
63001,Pyraei,nordrassil,96,warrior,arms,6,1,5
63002,Cursedogre,tichondrius,96,warrior,arms,6,1,5
63003,Myc,zuljin,96,warrior,arms,6,1,5
63004,Glonzito,tichondrius,96,warrior,arms,6,1,5
63005,Kevinersaa,frostmourne,96,warrior,arms,6,1,5
63006,Chubw,tichondrius,96,warrior,arms,6,1,5
63007,Smoogzz,tichondrius,96,warrior,arms,6,1,5
63008,Zépileque,azralon,96,warrior,arms,6,1,5
63009,Dogmar,moon-guard,96,warrior,arms,6,1,5
63010,Mortalbtw,tichondrius,96,warrior,arms,6,1,5
63011,Olavson,proudmoore,96,warrior,arms,6,1,5
63012,Larrybiscuit,moon-guard,96,warrior,arms,6,1,5
63013,Bestgrunt,tichondrius,96,warrior,arms,6,1,5
63014,Warmaghar,azralon,96,warrior,arms,6,1,5
63015,Didgeridoo,stormrage,96,warrior,arms,6,1,5
63016,Melithiae,barthilas,96,warrior,arms,6,1,5
63017,Codey,stormrage,96,warrior,arms,6,1,5
63018,Wrex,bleeding-hollow,96,warrior,arms,6,1,5
63019,Warsung,azgalor,96,warrior,arms,6,1,5
63020,Jpiece,tichondrius,96,warrior,arms,6,1,5
63021,Shimizuken,tichondrius,96,warrior,arms,6,1,5
63022,Bhuppzz,barthilas,96,warrior,arms,6,1,5
63023,Ivadell,stormrage,96,warrior,arms,6,1,5
63024,Zørg,bleeding-hollow,96,warrior,arms,6,1,5
63025,Atomicboxer,tichondrius,96,warrior,arms,6,1,5
63026,Shagstrike,azralon,96,warrior,arms,6,1,5
63027,Weechubber,bleeding-hollow,96,warrior,arms,6,1,5
63028,Rogswar,sargeras,96,warrior,arms,6,1,5
63029,Paveyourcave,sargeras,96,warrior,arms,6,1,5
63030,Skrtcobain,moon-guard,96,warrior,arms,6,1,5
63031,Xalë,tichondrius,96,warrior,arms,6,1,5
63032,Joetempest,azralon,96,warrior,arms,6,1,5
63033,Solsirrior,tichondrius,96,warrior,arms,6,1,5
63034,Yongvi,tichondrius,96,warrior,arms,6,1,5
63035,Dokoba,bleeding-hollow,96,warrior,arms,6,1,5
63036,Nelfmoehawk,barthilas,96,warrior,arms,6,1,5
63037,Wienertoes,tichondrius,96,warrior,arms,6,1,5
63038,Abaton,wyrmrest-accord,96,warrior,arms,6,1,5
63039,Rarityw,tichondrius,96,warrior,arms,6,1,5
63040,Igoboom,bleeding-hollow,96,warrior,arms,6,1,5
63041,Elodié,stormrage,96,warrior,arms,6,1,5
63042,Fidelwar,bleeding-hollow,96,warrior,arms,6,1,5
63043,Erhue,sargeras,96,warrior,arms,6,1,5
63044,Tangö,barthilas,96,warrior,arms,6,1,5
63045,Meleth,darkspear,96,warrior,arms,6,1,5
63046,Icé,bleeding-hollow,96,warrior,arms,6,1,5
63047,Thiq,proudmoore,96,warrior,arms,6,1,5
63048,Tagaash,azralon,96,warrior,arms,6,1,5
63049,Selockclap,bleeding-hollow,96,warrior,arms,6,1,5
63050,Gromhell,azralon,96,warrior,arms,6,1,5
63051,Bobisyourmom,tichondrius,96,warrior,arms,6,1,5
63052,Warstun,tichondrius,96,warrior,arms,6,1,5
63053,Cloudsmash,arthas,96,warrior,arms,6,1,5
63054,Adav,arthas,96,warrior,arms,6,1,5
63055,Felwariorkig,tichondrius,96,warrior,arms,6,1,5
63056,Maxtavius,baelgun,96,warrior,arms,6,1,5
63057,Shadowswar,tichondrius,96,warrior,arms,6,1,5
63058,Angryorc,norgannon,96,warrior,arms,6,1,5
63059,Nukefrmorbit,dalaran,96,warrior,arms,6,1,5
63060,Droggo,cenarius,96,warrior,arms,6,1,5
63061,Aotha,moon-guard,96,warrior,arms,6,1,5
63062,Edariana,dalaran,96,warrior,arms,6,1,5
63063,Funsize,dalaran,96,warrior,arms,6,1,5
63064,Sver,dalaran,96,warrior,arms,6,1,5
63065,Dezeran,tichondrius,96,warrior,arms,6,1,5
63066,Vethronis,dalaran,96,warrior,arms,6,1,5
63067,Meytuglin,stormrage,96,warrior,arms,6,1,5
63068,Genesisblade,illidan,96,warrior,arms,6,1,5
63069,Vitalocity,frostmourne,96,warrior,arms,6,1,5
63070,Jazz,frostwolf,96,warrior,arms,6,1,5
63071,Thiccsmith,blackrock,96,warrior,arms,6,1,5
63072,Warrmachine,scarlet-crusade,96,warrior,arms,6,1,5
63073,Wàrrðèémzý,frostmourne,96,warrior,arms,6,1,5
63074,Skärz,azshara,96,warrior,arms,6,1,5
63075,Klobnslob,mannoroth,96,warrior,arms,6,1,5
63076,Hypëriøn,bleeding-hollow,96,warrior,arms,6,1,5
63077,Soymong,frostmourne,96,warrior,arms,6,1,5
63078,Stinkktoe,tichondrius,96,warrior,arms,6,1,5
63079,Cindabotica,sargeras,96,warrior,arms,6,1,5
63080,Nukee,tichondrius,96,warrior,arms,6,1,5
63081,Beastro,rexxar,96,warrior,arms,6,1,5
63082,Dáin,azralon,96,warrior,arms,6,1,5
63083,Razgorkul,illidan,96,warrior,arms,6,1,5
63084,Släughter,zuljin,96,warrior,arms,6,1,5
63085,Blacken,tichondrius,96,warrior,arms,6,1,5
63086,Pressd,frostmourne,96,warrior,arms,6,1,5
63087,Rage,tanaris,96,warrior,arms,6,1,5
63088,Kboyrage,sargeras,96,warrior,arms,6,1,5
63089,Nicrose,hyjal,96,warrior,arms,6,1,5
63090,Vhagaar,emerald-dream,96,warrior,arms,6,1,5
63091,Deathislovê,moonrunner,96,warrior,arms,6,1,5
63092,Hergo,spirestone,96,warrior,arms,6,1,5
63093,Striphex,trollbane,96,warrior,arms,6,1,5
63094,Mezw,tichondrius,96,warrior,arms,6,1,5
63095,Serakur,emerald-dream,96,warrior,arms,6,1,5
63096,Glurg,illidan,96,warrior,arms,6,1,5
63097,Rucktuck,tichondrius,96,warrior,arms,6,1,5
63098,Noctrelor,sargeras,96,warrior,arms,6,1,5
63099,Keynlor,antonidas,96,warrior,arms,6,1,5
63100,Sweetlove,akama,96,warrior,arms,6,1,5
63101,Jimhoffa,bonechewer,96,warrior,arms,6,1,5
63102,Goywarr,illidan,96,warrior,arms,6,1,5
63103,Odiiragda,sargeras,96,warrior,arms,6,1,5
63104,Dragginball,garrosh,96,warrior,arms,6,1,5
63105,Morotak,area-52,96,warrior,arms,6,1,5
63106,Forsake,daggerspine,96,warrior,arms,6,1,5
63107,Ghostierip,illidan,96,warrior,arms,6,1,5
63108,Blitzkrieegz,drakkari,96,warrior,arms,6,1,5
63109,Arkenon,drakkari,96,warrior,arms,6,1,5
63110,Hadrum,turalyon,96,warrior,arms,6,1,5
63111,Grosjambes,turalyon,96,warrior,arms,6,1,5
63112,Kargan,thrall,96,warrior,arms,6,1,5
63113,Däger,ragnaros,96,warrior,arms,6,1,5
63114,Slayabunny,icecrown,96,warrior,arms,6,1,5
63115,Kado,zuluhed,96,warrior,arms,6,1,5
63116,Shuffle,velen,96,warrior,arms,6,1,5
63117,Warbomb,thrall,96,warrior,arms,6,1,5
63118,Gordurin,akama,96,warrior,arms,6,1,5
63119,Okgotchax,kelthuzad,96,warrior,arms,6,1,5
63120,Elryth,ragnaros,96,warrior,arms,6,1,5
63121,Airwick,kelthuzad,96,warrior,arms,6,1,5
63122,Tømy,quelthalas,96,warrior,arms,6,1,5
63123,Notacop,malygos,96,warrior,arms,6,1,5
63124,Kaysin,sargeras,96,warrior,arms,6,1,5
63125,Shyliar,thrall,96,warrior,arms,6,1,5
63126,Morlu,alleria,96,warrior,arms,6,1,5
63127,Xeno,steamwheedle-cartel,96,warrior,arms,6,1,5
63128,Áres,spinebreaker,96,warrior,arms,6,1,5
63129,Nyaner,quelthalas,96,warrior,arms,6,1,5
63130,Lifaen,zangarmarsh,96,warrior,arms,6,1,5
63131,Garagedays,area-52,96,warrior,arms,6,1,5
63132,Silverdeadl,ragnaros,96,warrior,arms,6,1,5
63133,Draann,kirin-tor,96,warrior,arms,6,1,5
63134,Fréäkk,ragnaros,96,warrior,arms,6,1,5
63135,Gärroshh,ragnaros,96,warrior,arms,6,1,5
63136,Horahloux,ragnaros,96,warrior,arms,6,1,5
63137,Roxesc,area-52,96,warrior,arms,6,1,5
63138,Racsorr,ragnaros,96,warrior,arms,6,1,5
63139,Ghaladir,area-52,96,warrior,arms,6,1,5
63140,Heyzulnut,whisperwind,96,warrior,arms,6,1,5
63141,Aidenwr,area-52,96,warrior,arms,6,1,5
63142,Mikachero,ragnaros,96,warrior,arms,6,1,5
63143,Nibones,malganis,96,warrior,arms,6,1,5
63144,Doriax,sentinels,96,warrior,arms,6,1,5
63145,Durseyturm,area-52,96,warrior,arms,6,1,5
63146,Uub,malganis,96,warrior,arms,6,1,5
63147,Darkromel,quelthalas,96,warrior,arms,6,1,5
63148,Immortal,icecrown,96,warrior,arms,6,1,5
63149,Äléx,frostmourne,96,warrior,arms,7,1,6
63150,Maat,blood-furnace,96,warrior,arms,8,1,7
63151,Sangettsu,stormrage,96,warrior,arms,8,1,7
63152,Ruinsteel,area-52,96,warrior,arms,8,1,7
63153,Ogrimir,moon-guard,96,warrior,arms,9,1,8
63154,Sickwar,emerald-dream,96,warrior,arms,12,1,11
63155,Meelehard,zuljin,96,warrior,arms,12,1,11
63156,Berzerk,dentarg,96,warrior,arms,12,1,11
63157,Bushwook,emerald-dream,96,warrior,arms,12,1,11
63158,Odyssey,vashj,96,warrior,arms,12,1,11
63159,Honoriowar,nemesis,96,warrior,arms,12,1,11
63160,Morkep,stormrage,96,warrior,arms,12,1,11
63161,Cartou,stormscale,96,warrior,arms,12,1,11
63162,Drarn,norgannon,96,warrior,arms,12,1,11
63163,Baozz,frostmourne,96,warrior,arms,12,1,11
63164,Njalulfhild,korgath,96,warrior,arms,12,1,11
63165,Falkur,amanthul,96,warrior,arms,12,1,11
63166,Babyfelix,tichondrius,96,warrior,arms,12,1,11
63167,Wmuuzh,quelthalas,96,warrior,arms,12,1,11
63168,Hazzak,quelthalas,96,warrior,arms,12,1,11
63169,Psykd,arathor,79,warrior,arms,5,1,4
63170,Stackws,tichondrius,79,warrior,arms,5,1,4
63171,Keringan,stormrage,79,warrior,arms,5,1,4
63172,Savagetko,illidan,79,warrior,arms,5,1,4
63173,Rokmok,frostmane,79,warrior,arms,5,1,4
63174,Roxon,hellscream,79,warrior,arms,5,1,4
63175,Hexenwolf,moon-guard,79,warrior,arms,5,1,4
63176,Smashpatatas,proudmoore,64,warrior,arms,4,1,3
63177,Sniperbeer,sargeras,64,warrior,arms,4,1,3
63178,Garrossh,thunderhorn,64,warrior,arms,4,1,3
63179,Kothal,thrall,63,warrior,arms,2,2,0
63180,Anvil,bronzebeard,63,warrior,arms,2,2,0
63181,Thewarrior,tichondrius,48,warrior,arms,3,1,2
63182,Critnectar,aggramar,48,warrior,arms,3,1,2
63183,Warriorba,tichondrius,48,warrior,arms,3,1,2
63184,Foldrak,quelthalas,48,warrior,arms,3,1,2
63185,Åcé,ragnaros,48,warrior,arms,3,1,2
63186,Mauboro,azralon,48,warrior,arms,3,1,2
63187,Rumka,draktharon,42,warrior,arms,6,2,4
63188,Ghostkin,ragnaros,42,warrior,arms,7,2,5
63189,Trôca,ragnaros,42,warrior,arms,8,2,6
63190,Hexmaul,zuljin,31,warrior,arms,2,1,1
63191,Raselix,quelthalas,31,warrior,arms,2,1,1
63192,Flus,zuljin,31,warrior,arms,2,1,1
63193,Mantiflash,stormrage,31,warrior,arms,2,1,1
63194,Flandiz,sargeras,31,warrior,arms,2,1,1
63195,Shwutty,stormrage,16,warrior,arms,1,1,0
63196,Goodidea,mannoroth,16,warrior,arms,1,1,0
63197,Clêaved,darkspear,16,warrior,arms,1,1,0
63198,Americanbull,moon-guard,1399,warrior,protection,80,41,39
63199,Graventhal,tichondrius,1192,warrior,protection,53,25,28
63200,Percaderp,barthilas,1158,warrior,protection,63,30,33
63201,Thororan,whisperwind,845,warrior,protection,27,10,17
63202,Appolyonn,hyjal,836,warrior,protection,43,17,26
63203,Logan,twisting-nether,705,warrior,protection,44,12,32
63204,Smelldrglove,frostmourne,692,warrior,protection,32,12,20
63205,Nansitao,kelthuzad,668,warrior,protection,24,7,17
63206,Lagurtz,ragnaros,576,warrior,protection,18,6,12
63207,Ghostoffury,thrall,574,warrior,protection,12,6,6
63208,Meadier,windrunner,566,warrior,protection,12,6,6
63209,Stophitingme,bloodscalp,525,warrior,protection,40,10,30
63210,Archaòn,frostmourne,473,warrior,protection,12,5,7
63211,Ksubîî,frostmourne,448,warrior,protection,16,5,11
63212,Dabdaddyy,dawnbringer,384,warrior,protection,6,4,2
63213,Kidkolby,moon-guard,384,warrior,protection,12,4,8
63214,Rhuk,drakkari,383,warrior,protection,24,4,20
63215,Metalhog,sargeras,288,warrior,protection,6,3,3
63216,Manthraxx,sargeras,288,warrior,protection,6,3,3
63217,Chàrr,crushridge,288,warrior,protection,15,4,11
63218,Zatu,moknathal,285,warrior,protection,12,3,9
63219,Toothnnailz,destromath,284,warrior,protection,12,3,9
63220,Tåra,area-52,256,warrior,protection,22,3,19
63221,Executespam,madoran,192,warrior,protection,6,2,4
63222,Bulldozer,terokkar,192,warrior,protection,12,2,10
63223,Strongtongue,malganis,192,warrior,protection,12,2,10
63224,Loonycity,arygos,192,warrior,protection,12,2,10
63225,Fearless,moon-guard,96,warrior,protection,6,1,5
63226,Lunusx,stormrage,96,warrior,protection,6,1,5
63227,Varith,sargeras,96,warrior,protection,12,1,11
63228,Mannorth,aerie-peak,95,warrior,protection,6,1,5
63229,Piojowar,quelthalas,95,warrior,protection,6,1,5
63230,Jindyn,boulderfist,95,warrior,protection,6,1,5
63231,Stowdace,bladefist,89,warrior,protection,10,5,5
63232,Axiyum,tichondrius,79,warrior,protection,5,1,4
63233,Juicey,burning-blade,31,warrior,protection,2,1,1
