name,realm,rating,cls,spec,play,win,lose
Phearbunny,bleeding-hollow,1523,deathknight,blood,60,31,29
Pagumon,moon-guard,1144,deathknight,blood,60,23,37
Bloodbukkaky,bleeding-hollow,1046,deathknight,blood,30,11,19
Valind,eredar,854,deathknight,blood,18,9,9
Blasphemus,malganis,575,deathknight,blood,12,6,6
Tragül,sargeras,477,deathknight,blood,12,5,7
Tristam,area-52,384,deathknight,blood,6,4,2
Kimbøslîce,area-52,288,deathknight,blood,12,3,9
Unhølydøøm,misha,191,deathknight,blood,12,2,10
Cozzasad,barthilas,96,deathknight,blood,6,1,5
Gnargnarr,firetree,96,deathknight,blood,6,1,5
Lunatick,darkspear,96,deathknight,blood,6,1,5
Hulmorr,bleeding-hollow,64,deathknight,blood,4,1,3
Spaidzz,malganis,2107,deathknight,unholy,134,70,64
Partywaffles,illidan,2105,deathknight,unholy,98,53,45
Neroxz,area-52,2105,deathknight,unholy,83,43,40
Níngjìng,tichondrius,2041,deathknight,unholy,78,41,37
Pwaff,illidan,1993,deathknight,unholy,65,31,34
Juelzjerk,tichondrius,1976,deathknight,unholy,48,30,18
Veilsidé,kelthuzad,1948,deathknight,unholy,228,115,113
Toxicwaste,malganis,1945,deathknight,unholy,58,27,31
Brutos,thrall,1934,deathknight,unholy,68,42,26
Scriptløl,sargeras,1919,deathknight,unholy,132,61,71
Roidboy,illidan,1917,deathknight,unholy,85,41,44
Mårlbørø,tichondrius,1915,deathknight,unholy,41,21,20
Darkdj,kelthuzad,1914,deathknight,unholy,67,31,36
Éternalnight,tichondrius,1913,deathknight,unholy,76,32,44
Zynyzter,malganis,1912,deathknight,unholy,72,41,31
Achílles,sargeras,1901,deathknight,unholy,114,51,63
Geomdae,tichondrius,1901,deathknight,unholy,71,31,40
Chillbayné,the-scryers,1900,deathknight,unholy,83,47,36
Poesoul,tichondrius,1889,deathknight,unholy,60,33,27
Vineyard,area-52,1884,deathknight,unholy,101,48,53
Cavaliers,ragnaros,1881,deathknight,unholy,48,25,23
Áethros,malganis,1879,deathknight,unholy,84,42,42
Plagueflavor,tichondrius,1876,deathknight,unholy,151,77,74
Qipara,zuljin,1869,deathknight,unholy,50,31,19
Graphics,moon-guard,1865,deathknight,unholy,220,104,116
Ilceses,area-52,1861,deathknight,unholy,42,22,20
Drauguss,azralon,1860,deathknight,unholy,106,53,53
Lattè,area-52,1859,deathknight,unholy,55,30,25
Dkya,tichondrius,1855,deathknight,unholy,118,58,60
Morbiddesire,stormrage,1849,deathknight,unholy,87,49,38
Wøund,black-dragonflight,1848,deathknight,unholy,96,51,45
Didri,quelthalas,1846,deathknight,unholy,72,34,38
Sinell,kargath,1841,deathknight,unholy,103,60,43
Haldevarik,doomhammer,1834,deathknight,unholy,78,43,35
Kilohotel,stormrage,1832,deathknight,unholy,36,22,14
Anatøly,ragnaros,1827,deathknight,unholy,42,21,21
Bloodbruh,blackrock,1825,deathknight,unholy,54,32,22
Sadboy,grizzly-hills,1822,deathknight,unholy,65,27,38
Serwestley,stormrage,1820,deathknight,unholy,59,31,28
Barelyviable,tichondrius,1818,deathknight,unholy,60,27,33
Flizzycash,malganis,1816,deathknight,unholy,56,27,29
Riddles,maiev,1809,deathknight,unholy,113,60,53
Infectik,tichondrius,1807,deathknight,unholy,59,35,24
Flarkness,area-52,1806,deathknight,unholy,54,25,29
Necrôtic,area-52,1806,deathknight,unholy,76,35,41
Kaeligh,ragnaros,1803,deathknight,unholy,66,29,37
Zìlêán,tichondrius,1800,deathknight,unholy,70,39,31
Starshopping,proudmoore,1800,deathknight,unholy,37,20,17
Aerd,sargeras,1800,deathknight,unholy,118,59,59
Grimiz,tichondrius,1798,deathknight,unholy,102,51,51
Nixonxx,tichondrius,1793,deathknight,unholy,41,30,11
Milleh,bleeding-hollow,1790,deathknight,unholy,42,19,23
Nevmic,emerald-dream,1784,deathknight,unholy,56,28,28
Brandonsdk,tichondrius,1775,deathknight,unholy,42,22,20
Demonboyjr,tichondrius,1766,deathknight,unholy,75,31,44
Jakeboyswag,shandris,1763,deathknight,unholy,99,49,50
Apøçálýpsé,firetree,1761,deathknight,unholy,67,35,32
Boneyards,bleeding-hollow,1756,deathknight,unholy,66,29,37
Xiaodabaolol,tichondrius,1751,deathknight,unholy,48,26,22
Azre,tichondrius,1748,deathknight,unholy,54,21,33
Kwolve,proudmoore,1747,deathknight,unholy,147,77,70
Orphanmakerx,area-52,1746,deathknight,unholy,89,40,49
Standalizer,gilneas,1745,deathknight,unholy,72,40,32
Carryme,quelthalas,1734,deathknight,unholy,74,36,38
Hwml,barthilas,1732,deathknight,unholy,63,36,27
Xebane,frostmourne,1728,deathknight,unholy,276,143,133
Orkky,jubeithos,1721,deathknight,unholy,63,35,28
Õdin,area-52,1718,deathknight,unholy,78,36,42
Thorediks,stormrage,1712,deathknight,unholy,48,24,24
Hhasaki,area-52,1710,deathknight,unholy,64,36,28
Nalz,drakkari,1710,deathknight,unholy,84,45,39
Noik,azralon,1707,deathknight,unholy,75,36,39
Warrcc,steamwheedle-cartel,1706,deathknight,unholy,36,18,18
Ludgan,stormrage,1706,deathknight,unholy,54,25,29
Imadkloldie,frostmourne,1690,deathknight,unholy,84,44,40
Azhid,tichondrius,1690,deathknight,unholy,100,50,50
Ermanotruta,azralon,1690,deathknight,unholy,36,18,18
Aurious,lightnings-blade,1688,deathknight,unholy,54,28,26
Aldebamuu,ragnaros,1687,deathknight,unholy,30,19,11
Blacklabel,andorhal,1675,deathknight,unholy,72,31,41
Avengering,tichondrius,1673,deathknight,unholy,39,22,17
Dunduner,tichondrius,1672,deathknight,unholy,78,38,40
Kinkysgnome,tichondrius,1672,deathknight,unholy,66,27,39
Merados,quelthalas,1672,deathknight,unholy,67,25,42
Soulhand,tichondrius,1670,deathknight,unholy,40,21,19
Hrsb,tichondrius,1667,deathknight,unholy,42,23,19
Spacealien,malganis,1667,deathknight,unholy,42,23,19
Yubell,barthilas,1663,deathknight,unholy,137,69,68
Asheravon,moon-guard,1663,deathknight,unholy,119,58,61
Twindleroot,aggramar,1662,deathknight,unholy,35,20,15
Mortarîon,moon-guard,1658,deathknight,unholy,72,40,32
Mephostophel,sargeras,1650,deathknight,unholy,60,31,29
Vexxan,thrall,1644,deathknight,unholy,41,23,18
Properterps,bonechewer,1642,deathknight,unholy,86,49,37
Tkyo,tichondrius,1638,deathknight,unholy,41,18,23
Kortingert,nagrand,1635,deathknight,unholy,41,22,19
Frostbite,the-venture-co,1634,deathknight,unholy,78,47,31
Krargosh,quelthalas,1634,deathknight,unholy,102,54,48
Justafkdk,gorefiend,1632,deathknight,unholy,60,29,31
Kakarotó,azralon,1629,deathknight,unholy,53,30,23
Søad,quelthalas,1628,deathknight,unholy,40,25,15
Dialysis,emerald-dream,1628,deathknight,unholy,67,37,30
Giznator,malganis,1628,deathknight,unholy,84,39,45
Zerhistran,proudmoore,1627,deathknight,unholy,191,97,94
Paratekdk,thrall,1625,deathknight,unholy,71,39,32
Bladê,tichondrius,1624,deathknight,unholy,61,26,35
Nabbiby,tichondrius,1622,deathknight,unholy,30,17,13
Vazarus,darrowmere,1618,deathknight,unholy,36,23,13
Wheatasil,garona,1618,deathknight,unholy,64,33,31
Harókz,azralon,1616,deathknight,unholy,41,20,21
Altareon,ragnaros,1615,deathknight,unholy,96,45,51
Ligmagooch,tichondrius,1614,deathknight,unholy,51,26,25
Boofcigars,sargeras,1612,deathknight,unholy,42,21,21
Ðogmá,vashj,1610,deathknight,unholy,35,22,13
Ousted,daggerspine,1608,deathknight,unholy,36,20,16
Kaaizer,azralon,1605,deathknight,unholy,108,63,45
Unholykevin,sargeras,1604,deathknight,unholy,42,21,21
Dominos,tichondrius,1604,deathknight,unholy,42,20,22
Kjarnda,malganis,1604,deathknight,unholy,36,17,19
Azynks,azralon,1604,deathknight,unholy,90,39,51
Drpepp,bleeding-hollow,1603,deathknight,unholy,95,53,42
Idodamn,tichondrius,1603,deathknight,unholy,78,42,36
Wednesdæ,moon-guard,1603,deathknight,unholy,54,28,26
Puppykisses,perenolde,1602,deathknight,unholy,83,35,48
Iato,sargeras,1600,deathknight,unholy,36,21,15
Ðomìnus,moon-guard,1596,deathknight,unholy,60,35,25
Kellydean,moon-guard,1596,deathknight,unholy,42,23,19
Khaíne,wyrmrest-accord,1592,deathknight,unholy,85,43,42
Ravindrannor,saurfang,1574,deathknight,unholy,41,20,21
Grimmdreamer,stormrage,1573,deathknight,unholy,40,20,20
Zìlêáns,tichondrius,1572,deathknight,unholy,30,20,10
Landez,ragnaros,1571,deathknight,unholy,42,23,19
Fasterjake,sargeras,1568,deathknight,unholy,51,27,24
Typhøn,illidan,1565,deathknight,unholy,71,37,34
Lichtborne,illidan,1564,deathknight,unholy,61,24,37
Wastethis,sargeras,1556,deathknight,unholy,53,28,25
Läskö,area-52,1555,deathknight,unholy,30,21,9
Toophus,sargeras,1554,deathknight,unholy,62,29,33
Siphilusxo,dalaran,1551,deathknight,unholy,36,20,16
Tigs,proudmoore,1550,deathknight,unholy,90,48,42
Ulísés,ragnaros,1549,deathknight,unholy,46,17,29
Kalgor,illidan,1542,deathknight,unholy,66,34,32
Deuter,quelthalas,1541,deathknight,unholy,63,31,32
Raps,frostmourne,1538,deathknight,unholy,44,17,27
Släke,azralon,1533,deathknight,unholy,90,45,45
Xhoul,sargeras,1531,deathknight,unholy,43,26,17
Arktoz,tichondrius,1531,deathknight,unholy,30,16,14
Xibbas,illidan,1530,deathknight,unholy,24,16,8
Gottajuice,moonrunner,1530,deathknight,unholy,39,23,16
Kindaholy,malganis,1528,deathknight,unholy,23,17,6
Ullísés,ragnaros,1521,deathknight,unholy,33,17,16
Biefeile,tichondrius,1519,deathknight,unholy,36,17,19
Dashinglee,proudmoore,1516,deathknight,unholy,66,29,37
Megatroun,stormreaver,1513,deathknight,unholy,30,16,14
Zerøimperial,quelthalas,1513,deathknight,unholy,106,48,58
Lazarise,area-52,1513,deathknight,unholy,36,16,20
Takeoverr,ragnaros,1505,deathknight,unholy,24,20,4
Urieen,gorefiend,1505,deathknight,unholy,77,43,34
Allhejluya,illidan,1504,deathknight,unholy,175,91,84
Arc,maiev,1504,deathknight,unholy,81,31,50
Aradorn,azralon,1502,deathknight,unholy,89,43,46
Abroham,arthas,1498,deathknight,unholy,59,30,29
Starms,ragnaros,1492,deathknight,unholy,54,25,29
Breadtruck,area-52,1492,deathknight,unholy,58,24,34
Ghoulslasher,bleeding-hollow,1490,deathknight,unholy,56,25,31
Kcorides,tichondrius,1488,deathknight,unholy,49,28,21
Obedient,firetree,1483,deathknight,unholy,66,40,26
Rhaeisxalnym,sargeras,1483,deathknight,unholy,33,16,17
Jaxxftw,azralon,1482,deathknight,unholy,42,25,17
Saighast,illidan,1482,deathknight,unholy,66,36,30
Corrpsse,tichondrius,1481,deathknight,unholy,145,77,68
Lùcius,garrosh,1477,deathknight,unholy,66,32,34
Nialich,kelthuzad,1476,deathknight,unholy,41,16,25
Kuwarerubana,proudmoore,1474,deathknight,unholy,30,17,13
Zuly,moon-guard,1474,deathknight,unholy,101,52,49
Emopalli,tichondrius,1466,deathknight,unholy,54,24,30
Fadedlight,zuljin,1461,deathknight,unholy,54,24,30
Takeurcheeks,tichondrius,1458,deathknight,unholy,83,35,48
Rk,blackhand,1457,deathknight,unholy,97,58,39
Zaluster,malganis,1455,deathknight,unholy,132,66,66
Balboskina,shattered-hand,1448,deathknight,unholy,70,36,34
Gilden,malfurion,1447,deathknight,unholy,38,17,21
Boofcigars,kelthuzad,1445,deathknight,unholy,29,16,13
Zaxrree,malganis,1442,deathknight,unholy,42,26,16
Bloodramen,dalaran,1442,deathknight,unholy,211,110,101
Sammåel,malganis,1438,deathknight,unholy,30,17,13
Vynox,frostmourne,1437,deathknight,unholy,31,16,15
Tronnie,kelthuzad,1434,deathknight,unholy,54,27,27
Ningjinglol,tichondrius,1434,deathknight,unholy,30,15,15
Exin,cenarion-circle,1432,deathknight,unholy,24,15,9
Fatzilla,tichondrius,1430,deathknight,unholy,48,15,33
Cardii,area-52,1429,deathknight,unholy,40,16,24
Daoniancc,tichondrius,1426,deathknight,unholy,24,15,9
Anexdk,korgath,1423,deathknight,unholy,24,15,9
Krätos,zuljin,1422,deathknight,unholy,24,15,9
Brisblade,shattered-hand,1422,deathknight,unholy,36,19,17
Sannistus,ysera,1420,deathknight,unholy,97,43,54
Shélly,ragnaros,1415,deathknight,unholy,35,19,16
Darknessice,tichondrius,1414,deathknight,unholy,30,19,11
Subparatbest,chogall,1414,deathknight,unholy,30,15,15
Genjírou,frostwolf,1405,deathknight,unholy,66,29,37
Unholyfish,malganis,1398,deathknight,unholy,85,40,45
Plagueghoul,wyrmrest-accord,1384,deathknight,unholy,67,35,32
Putrefactive,frostmourne,1381,deathknight,unholy,75,36,39
Fugs,ghostlands,1380,deathknight,unholy,50,26,24
Banjingquan,tichondrius,1375,deathknight,unholy,42,21,21
Sparklekitty,illidan,1374,deathknight,unholy,24,16,8
Greeasy,bleeding-hollow,1374,deathknight,unholy,41,23,18
Redbr,tichondrius,1372,deathknight,unholy,30,15,15
Nokenoke,illidan,1367,deathknight,unholy,33,16,17
Hornpipe,borean-tundra,1364,deathknight,unholy,72,32,40
Waremoto,ragnaros,1361,deathknight,unholy,63,38,25
Belegos,quelthalas,1357,deathknight,unholy,67,31,36
Reinhartlol,sargeras,1356,deathknight,unholy,57,24,33
Fellenn,stormrage,1354,deathknight,unholy,90,49,41
Bumbleton,blackrock,1349,deathknight,unholy,45,24,21
Dethcro,shandris,1343,deathknight,unholy,93,47,46
Bruceleedk,tichondrius,1342,deathknight,unholy,24,14,10
Rezøk,ragnaros,1342,deathknight,unholy,36,14,22
Tailm,ragnaros,1339,deathknight,unholy,24,14,10
Ântipaladin,arthas,1335,deathknight,unholy,46,19,27
Demonnation,illidan,1333,deathknight,unholy,36,14,22
Negril,tichondrius,1332,deathknight,unholy,78,38,40
Darkunral,stormrage,1330,deathknight,unholy,52,18,34
Devillele,proudmoore,1326,deathknight,unholy,30,14,16
Nevarro,lightbringer,1321,deathknight,unholy,100,51,49
Earador,dalaran,1321,deathknight,unholy,30,15,15
Mords,area-52,1321,deathknight,unholy,30,14,16
Halvôr,moon-guard,1320,deathknight,unholy,60,30,30
Knownkilla,hyjal,1316,deathknight,unholy,30,17,13
Mazey,moon-guard,1315,deathknight,unholy,151,77,74
Dexarax,norgannon,1307,deathknight,unholy,49,23,26
Zeban,area-52,1306,deathknight,unholy,72,32,40
Ñovacaine,moon-guard,1304,deathknight,unholy,44,20,24
Gwiffhm,tichondrius,1304,deathknight,unholy,40,14,26
Kallgìn,emerald-dream,1299,deathknight,unholy,36,15,21
Deezwaz,draka,1292,deathknight,unholy,28,14,14
Wndypefrcorn,sargeras,1290,deathknight,unholy,25,16,9
Regiknight,stormrage,1279,deathknight,unholy,29,18,11
Cesaroo,aegwynn,1274,deathknight,unholy,32,14,18
Ometecuhtli,kelthuzad,1273,deathknight,unholy,60,35,25
Sgtdead,thrall,1271,deathknight,unholy,24,14,10
Madmaxxy,barthilas,1267,deathknight,unholy,57,25,32
Alexeous,wyrmrest-accord,1265,deathknight,unholy,42,19,23
Unhølydøøm,misha,1258,deathknight,unholy,72,37,35
Deliriioh,ragnaros,1252,deathknight,unholy,48,25,23
Ownaron,moon-guard,1249,deathknight,unholy,45,24,21
Magipierrot,ragnaros,1249,deathknight,unholy,50,25,25
Pettyk,tichondrius,1248,deathknight,unholy,24,13,11
Kromgarath,stormrage,1248,deathknight,unholy,48,21,27
Clowngodx,illidan,1247,deathknight,unholy,24,13,11
Buldrokastee,tichondrius,1247,deathknight,unholy,36,13,23
Möchi,ragnaros,1246,deathknight,unholy,63,32,31
Skippee,tichondrius,1246,deathknight,unholy,30,13,17
Catarïa,tichondrius,1246,deathknight,unholy,30,13,17
Lovedaddy,frostmourne,1242,deathknight,unholy,30,13,17
Rhaenyrà,tichondrius,1239,deathknight,unholy,24,14,10
Treikorh,quelthalas,1239,deathknight,unholy,84,34,50
Flavorchops,kelthuzad,1238,deathknight,unholy,36,13,23
Neipum,stormrage,1234,deathknight,unholy,18,13,5
Risottonero,kelthuzad,1231,deathknight,unholy,24,13,11
Huuzzha,tichondrius,1226,deathknight,unholy,31,13,18
Lorð,malganis,1223,deathknight,unholy,36,19,17
Potatobob,dalaran,1222,deathknight,unholy,30,13,17
Killerundead,area-52,1221,deathknight,unholy,33,14,19
Gatrars,sargeras,1220,deathknight,unholy,66,30,36
Soulhuntress,doomhammer,1217,deathknight,unholy,68,35,33
Drowhd,nemesis,1207,deathknight,unholy,54,25,29
Mèrc,ragnaros,1206,deathknight,unholy,29,13,16
Heärt,bleeding-hollow,1192,deathknight,unholy,38,15,23
Zaelize,sargeras,1166,deathknight,unholy,36,19,17
Mmrhostage,kelthuzad,1165,deathknight,unholy,30,14,16
Oql,tichondrius,1152,deathknight,unholy,24,12,12
Kciktep,tichondrius,1152,deathknight,unholy,24,12,12
Divinium,bleeding-hollow,1152,deathknight,unholy,30,12,18
Goonà,tichondrius,1151,deathknight,unholy,24,12,12
Kryptikkyt,blackrock,1150,deathknight,unholy,30,12,18
Arroyo,borean-tundra,1149,deathknight,unholy,24,12,12
Vesel,tichondrius,1149,deathknight,unholy,36,12,24
Ståtìc,tichondrius,1148,deathknight,unholy,24,12,12
Arcticc,area-52,1148,deathknight,unholy,30,12,18
Kehin,azralon,1148,deathknight,unholy,41,15,26
Polydeuces,queldorei,1148,deathknight,unholy,36,13,23
Bedstains,thunderlord,1147,deathknight,unholy,25,12,13
Kenishii,kiljaeden,1146,deathknight,unholy,18,12,6
Tiansama,ragnaros,1143,deathknight,unholy,18,12,6
Volcolm,kelthuzad,1142,deathknight,unholy,18,12,6
Gankstagrip,anvilmar,1140,deathknight,unholy,24,12,12
Rognarash,emerald-dream,1139,deathknight,unholy,24,12,12
Tracyminaj,tichondrius,1139,deathknight,unholy,30,12,18
Rekbari,sargeras,1138,deathknight,unholy,18,12,6
Hatreon,sargeras,1135,deathknight,unholy,18,12,6
Golurun,tichondrius,1135,deathknight,unholy,19,12,7
Toroandmoi,area-52,1121,deathknight,unholy,24,12,12
Oldskul,sargeras,1102,deathknight,unholy,26,13,13
Darktrinnity,nemesis,1100,deathknight,unholy,29,15,14
Omegaseven,gorgonnash,1097,deathknight,unholy,72,37,35
Anonymousix,kelthuzad,1090,deathknight,unholy,23,12,11
Beanboyx,tichondrius,1085,deathknight,unholy,22,12,10
Kanthrix,illidan,1084,deathknight,unholy,32,12,20
Steamerboy,stormrage,1056,deathknight,unholy,18,11,7
Tduggylolz,tichondrius,1056,deathknight,unholy,24,11,13
Muspellheim,azralon,1056,deathknight,unholy,24,11,13
Fiddleop,thrall,1054,deathknight,unholy,18,11,7
Dâki,blades-edge,1053,deathknight,unholy,18,11,7
Kurnoth,barthilas,1053,deathknight,unholy,30,11,19
Deathboost,stormrage,1053,deathknight,unholy,36,11,25
Deathpool,shadowmoon,1051,deathknight,unholy,30,11,19
Any,the-venture-co,1050,deathknight,unholy,24,11,13
Draenor,shadowmoon,1049,deathknight,unholy,18,11,7
Bazzingaxd,hyjal,1044,deathknight,unholy,30,18,12
Deathnorris,zuljin,1026,deathknight,unholy,74,35,39
Plaguebreak,darrowmere,1023,deathknight,unholy,36,22,14
Voncleaver,tichondrius,1023,deathknight,unholy,40,11,29
Mordekaiseer,azralon,1016,deathknight,unholy,106,51,55
Carecaa,azralon,1006,deathknight,unholy,26,11,15
Exequias,zuljin,996,deathknight,unholy,18,11,7
Azibar,moon-guard,990,deathknight,unholy,17,11,6
Vaske,azjolnerub,963,deathknight,unholy,55,20,35
Ragsec,bleeding-hollow,960,deathknight,unholy,12,10,2
Vaizard,malganis,960,deathknight,unholy,18,10,8
Rängi,caelestrasz,960,deathknight,unholy,78,26,52
Youngmoneyyd,illidan,959,deathknight,unholy,12,10,2
Deathbloss,illidan,959,deathknight,unholy,20,11,9
Tötenkaiser,quelthalas,959,deathknight,unholy,24,10,14
Emarose,illidan,959,deathknight,unholy,24,10,14
Galaxyboom,tichondrius,958,deathknight,unholy,12,10,2
Seranta,wyrmrest-accord,958,deathknight,unholy,24,10,14
Yamanji,wyrmrest-accord,956,deathknight,unholy,18,10,8
Stangz,bonechewer,956,deathknight,unholy,30,10,20
Arthyius,kiljaeden,956,deathknight,unholy,30,10,20
Promotheseis,sargeras,955,deathknight,unholy,18,10,8
Tenóry,nemesis,955,deathknight,unholy,30,10,20
Unleud,tichondrius,949,deathknight,unholy,18,10,8
Thaylenaar,eredar,947,deathknight,unholy,18,10,8
Mercysparx,thrall,943,deathknight,unholy,18,10,8
Lazta,azralon,937,deathknight,unholy,28,11,17
Alphabro,zuluhed,934,deathknight,unholy,18,10,8
Zareon,zuluhed,876,deathknight,unholy,24,12,12
Dandandor,muradin,876,deathknight,unholy,38,17,21
Nerfdklul,illidan,864,deathknight,unholy,12,9,3
Brocigar,tichondrius,864,deathknight,unholy,18,9,9
Datnai,barthilas,864,deathknight,unholy,24,9,15
Blackfyré,sargeras,864,deathknight,unholy,24,9,15
Fortissax,area-52,864,deathknight,unholy,30,9,21
Marixoxo,kelthuzad,863,deathknight,unholy,12,9,3
Bellum,moon-guard,863,deathknight,unholy,18,9,9
Catena,blood-furnace,863,deathknight,unholy,18,9,9
Vynlerran,skullcrusher,862,deathknight,unholy,18,9,9
Gerometal,ragnaros,862,deathknight,unholy,24,9,15
Runeswanson,area-52,861,deathknight,unholy,18,9,9
Luckyson,tichondrius,861,deathknight,unholy,18,9,9
Deathofchaos,smolderthorn,861,deathknight,unholy,24,10,14
Cosanostrá,malganis,860,deathknight,unholy,12,9,3
Rinthosaka,ragnaros,860,deathknight,unholy,18,9,9
Orphnoch,illidan,860,deathknight,unholy,24,9,15
Wrothgarr,stormreaver,859,deathknight,unholy,18,9,9
Cripticknigt,spinebreaker,859,deathknight,unholy,21,10,11
Sidbane,kalecgos,859,deathknight,unholy,19,9,10
Sabotdk,tichondrius,857,deathknight,unholy,18,9,9
Tinytanx,aerie-peak,856,deathknight,unholy,24,9,15
Muffinstomp,eredar,854,deathknight,unholy,18,9,9
Nicrack,malganis,853,deathknight,unholy,18,9,9
Zathog,lightbringer,853,deathknight,unholy,30,9,21
Ulerin,illidan,850,deathknight,unholy,18,9,9
Hansmclroy,trollbane,828,deathknight,unholy,18,9,9
Nøsfferatus,azralon,815,deathknight,unholy,17,9,8
Brounlyii,drakkari,796,deathknight,unholy,14,9,5
Vampirecarti,tichondrius,793,deathknight,unholy,14,9,5
Azgaroth,dathremar,792,deathknight,unholy,14,9,5
Mesx,illidan,768,deathknight,unholy,12,8,4
Dicromick,illidan,768,deathknight,unholy,15,9,6
Pmpfrmdwntwn,stormrage,768,deathknight,unholy,18,8,10
Shadowsdk,tichondrius,768,deathknight,unholy,18,8,10
Darktonelol,tichondrius,768,deathknight,unholy,18,8,10
Fydedk,stormrage,768,deathknight,unholy,18,8,10
Loomoros,sargeras,768,deathknight,unholy,24,8,16
Hotdk,thrall,768,deathknight,unholy,24,8,16
Immadkx,area-52,768,deathknight,unholy,24,8,16
Auniel,gorefiend,768,deathknight,unholy,24,8,16
Rongkhun,proudmoore,768,deathknight,unholy,30,8,22
Rarum,bleeding-hollow,767,deathknight,unholy,12,8,4
Hædës,area-52,767,deathknight,unholy,18,8,10
Paíín,illidan,767,deathknight,unholy,18,8,10
Komplex,kelthuzad,767,deathknight,unholy,18,8,10
Vynkys,shadow-council,766,deathknight,unholy,12,8,4
Shadowghast,saurfang,765,deathknight,unholy,12,8,4
Midway,drakkari,765,deathknight,unholy,18,8,10
Bloodydebt,malganis,765,deathknight,unholy,18,8,10
Dankbro,tichondrius,761,deathknight,unholy,24,10,14
Annerito,area-52,735,deathknight,unholy,17,8,9
Exaar,tichondrius,720,deathknight,unholy,27,8,19
Hatrèd,quelthalas,719,deathknight,unholy,17,8,9
Grayfoxx,twisting-nether,719,deathknight,unholy,17,8,9
Wryu,malganis,717,deathknight,unholy,17,8,9
Gêralt,darkspear,712,deathknight,unholy,18,9,9
Somethingdum,sargeras,703,deathknight,unholy,16,8,8
Froznorbs,tichondrius,700,deathknight,unholy,14,8,6
Shezoe,drakkari,672,deathknight,unholy,12,7,5
Falkorn,korgath,672,deathknight,unholy,12,7,5
Arthez,frostmourne,672,deathknight,unholy,12,7,5
Piratehookah,sargeras,672,deathknight,unholy,12,7,5
Jbert,sargeras,672,deathknight,unholy,12,7,5
Døømhøund,tichondrius,672,deathknight,unholy,12,7,5
Donrhythmic,ysera,672,deathknight,unholy,12,7,5
Brß,tichondrius,672,deathknight,unholy,12,7,5
Littlekims,emerald-dream,672,deathknight,unholy,12,7,5
Sommeliergg,stormrage,672,deathknight,unholy,12,7,5
Cgg,tichondrius,672,deathknight,unholy,12,7,5
Plag,bleeding-hollow,672,deathknight,unholy,12,7,5
Chalamander,tichondrius,672,deathknight,unholy,12,7,5
Fuzzknight,ravenholdt,672,deathknight,unholy,12,7,5
Barakhenaku,illidan,672,deathknight,unholy,12,7,5
Gurnok,barthilas,672,deathknight,unholy,12,7,5
Originalcimm,stormrage,672,deathknight,unholy,18,7,11
Bannedforevr,dalaran,672,deathknight,unholy,18,7,11
Bellybuster,malganis,672,deathknight,unholy,18,7,11
Deathzpeckt,tichondrius,672,deathknight,unholy,18,7,11
Ebolaxd,area-52,672,deathknight,unholy,18,7,11
Mmaximus,darkspear,672,deathknight,unholy,18,7,11
Bryku,tichondrius,672,deathknight,unholy,18,7,11
Xenocrates,illidan,672,deathknight,unholy,24,7,17
Ceedog,crushridge,672,deathknight,unholy,30,7,23
Deatheey,area-52,671,deathknight,unholy,12,7,5
Gâbriel,cairne,671,deathknight,unholy,12,7,5
Polpop,zuljin,671,deathknight,unholy,12,7,5
Fligdeath,llane,671,deathknight,unholy,12,7,5
Ganancïa,nemesis,671,deathknight,unholy,15,8,7
Dalrin,emerald-dream,671,deathknight,unholy,18,7,11
Mfknight,archimonde,671,deathknight,unholy,18,7,11
Coldrhelx,quelthalas,671,deathknight,unholy,30,7,23
Irokthefrost,frostmourne,669,deathknight,unholy,12,7,5
Unrealzrotz,tichondrius,669,deathknight,unholy,12,7,5
Sne,dragonmaw,667,deathknight,unholy,12,7,5
Grtmisdirect,illidan,666,deathknight,unholy,21,8,13
Zàkgor,moon-guard,665,deathknight,unholy,12,7,5
Grimmtidings,dentarg,649,deathknight,unholy,18,7,11
Bonalumë,azralon,620,deathknight,unholy,17,7,10
Xtador,quelthalas,591,deathknight,unholy,11,7,4
Bøoth,area-52,576,deathknight,unholy,12,6,6
Mûs,tichondrius,576,deathknight,unholy,12,6,6
Hickish,tichondrius,576,deathknight,unholy,12,6,6
Garù,ragnaros,576,deathknight,unholy,12,6,6
Bébøp,malganis,576,deathknight,unholy,12,6,6
Lemuriön,nemesis,576,deathknight,unholy,12,6,6
Meisterdeath,stormrage,576,deathknight,unholy,12,6,6
Jonahdk,sargeras,576,deathknight,unholy,12,6,6
Surkk,tichondrius,576,deathknight,unholy,12,6,6
Burbash,moon-guard,576,deathknight,unholy,12,6,6
Delwrath,proudmoore,576,deathknight,unholy,12,6,6
Lagérthâ,ragnaros,576,deathknight,unholy,12,6,6
Raaizz,ragnaros,576,deathknight,unholy,12,6,6
Svlla,doomhammer,576,deathknight,unholy,12,6,6
Jarah,destromath,576,deathknight,unholy,12,6,6
Friezen,illidan,576,deathknight,unholy,12,6,6
Justtaki,zuljin,576,deathknight,unholy,12,6,6
Desen,arthas,576,deathknight,unholy,12,6,6
Utthrity,ysera,576,deathknight,unholy,12,6,6
Cali,bladefist,576,deathknight,unholy,12,6,6
Malhandir,azgalor,576,deathknight,unholy,12,6,6
Ridesatenspd,caelestrasz,576,deathknight,unholy,12,6,6
Howdoulose,illidan,576,deathknight,unholy,12,6,6
Maripaula,ragnaros,576,deathknight,unholy,18,6,12
Lainmortal,ragnaros,576,deathknight,unholy,18,6,12
Rixin,agamaggan,576,deathknight,unholy,18,6,12
Unknowndk,kul-tiras,576,deathknight,unholy,18,6,12
Coffeebagel,bleeding-hollow,576,deathknight,unholy,19,6,13
Baldlord,tichondrius,576,deathknight,unholy,24,6,18
Bukum,zuljin,576,deathknight,unholy,24,6,18
Conquest,drenden,576,deathknight,unholy,24,6,18
Leviiathan,tichondrius,575,deathknight,unholy,12,6,6
Unhøøly,nemesis,575,deathknight,unholy,12,6,6
Pántera,darkspear,575,deathknight,unholy,12,6,6
Christophe,skullcrusher,575,deathknight,unholy,12,6,6
Åkatsukii,uther,575,deathknight,unholy,12,6,6
Mëlødy,quelthalas,575,deathknight,unholy,12,6,6
Frðst,executus,575,deathknight,unholy,12,6,6
Corpsepetal,muradin,575,deathknight,unholy,18,6,12
Deathcometh,tichondrius,575,deathknight,unholy,18,6,12
Heldwynd,bonechewer,574,deathknight,unholy,12,6,6
Fraänrisco,ragnaros,574,deathknight,unholy,18,6,12
Vapelounge,darkspear,574,deathknight,unholy,18,6,12
Juggérnaút,bonechewer,572,deathknight,unholy,12,6,6
Hentaideath,kiljaeden,572,deathknight,unholy,18,6,12
Bahtman,hakkar,571,deathknight,unholy,12,6,6
Kel,stormreaver,559,deathknight,unholy,23,6,17
Syzurp,barthilas,558,deathknight,unholy,13,7,6
Poonen,area-52,543,deathknight,unholy,11,6,5
Galarick,area-52,527,deathknight,unholy,11,6,5
Gkdm,tichondrius,522,deathknight,unholy,21,8,13
Chës,tichondrius,522,deathknight,unholy,22,7,15
Nekrosys,eitrigg,512,deathknight,unholy,16,6,10
Bloodyloco,malganis,511,deathknight,unholy,11,6,5
Malsedius,kelthuzad,511,deathknight,unholy,21,7,14
Bawlsauce,area-52,496,deathknight,unholy,13,6,7
Drfauci,boulderfist,480,deathknight,unholy,6,5,1
Solø,proudmoore,480,deathknight,unholy,6,5,1
Depthknight,barthilas,480,deathknight,unholy,6,5,1
Swänsz,stormrage,480,deathknight,unholy,12,5,7
Mordumi,stormrage,480,deathknight,unholy,12,5,7
Defekaite,kiljaeden,480,deathknight,unholy,12,5,7
Römney,stormrage,480,deathknight,unholy,12,5,7
Riparonii,illidan,480,deathknight,unholy,12,5,7
Dkdanim,tichondrius,480,deathknight,unholy,12,5,7
Darkfög,sargeras,480,deathknight,unholy,12,5,7
Cosmicrune,turalyon,480,deathknight,unholy,12,5,7
Defaultz,turalyon,480,deathknight,unholy,12,5,7
Allianknight,windrunner,480,deathknight,unholy,12,5,7
Gorillagrip,sargeras,480,deathknight,unholy,12,5,7
Andem,elune,480,deathknight,unholy,12,5,7
Hardtoplaydk,chogall,480,deathknight,unholy,12,5,7
Iamthedanger,aerie-peak,480,deathknight,unholy,12,5,7
Rytex,moon-guard,480,deathknight,unholy,18,5,13
Sylèss,tichondrius,480,deathknight,unholy,18,5,13
Deadspellz,bleeding-hollow,480,deathknight,unholy,18,5,13
Althamon,tanaris,480,deathknight,unholy,18,5,13
Lagmasterx,sargeras,480,deathknight,unholy,18,5,13
Dûsk,thunderlord,480,deathknight,unholy,18,5,13
Dementrius,zuljin,480,deathknight,unholy,25,5,20
Primoverdino,azralon,479,deathknight,unholy,12,5,7
Daixks,proudmoore,479,deathknight,unholy,12,5,7
Itired,tichondrius,479,deathknight,unholy,12,5,7
Mëgazørd,nemesis,479,deathknight,unholy,12,5,7
Caqw,akama,479,deathknight,unholy,12,5,7
Deathfearsme,kiljaeden,479,deathknight,unholy,12,5,7
Frostcleave,emerald-dream,478,deathknight,unholy,6,5,1
Starset,burning-legion,472,deathknight,unholy,12,5,7
Dreekon,bleeding-hollow,468,deathknight,unholy,19,9,10
Megatrôn,malganis,463,deathknight,unholy,17,5,12
Mordeo,bleeding-hollow,463,deathknight,unholy,17,5,12
Nevermore,hyjal,447,deathknight,unholy,11,5,6
Cammy,frostmourne,447,deathknight,unholy,11,5,6
Sorry,ysera,432,deathknight,unholy,9,6,3
Spôôn,aggramar,430,deathknight,unholy,11,5,6
Jaydkx,tichondrius,426,deathknight,unholy,16,6,10
Testifier,illidan,415,deathknight,unholy,8,5,3
Shiminy,chogall,415,deathknight,unholy,10,5,5
Festers,burning-legion,415,deathknight,unholy,20,5,15
Frostology,echo-isles,399,deathknight,unholy,5,5,0
Atrahazis,quelthalas,384,deathknight,unholy,6,4,2
Darkwraith,illidan,384,deathknight,unholy,6,4,2
Mistmoorex,stormscale,384,deathknight,unholy,6,4,2
Kowell,drakkari,384,deathknight,unholy,6,4,2
Deadsamurai,illidan,384,deathknight,unholy,6,4,2
Zzdk,thrall,384,deathknight,unholy,6,4,2
Rompeimën,ragnaros,384,deathknight,unholy,6,4,2
Vläad,ragnaros,384,deathknight,unholy,6,4,2
Evilbot,tichondrius,384,deathknight,unholy,6,4,2
Coffïnfeeder,dalaran,384,deathknight,unholy,6,4,2
Futruth,khaz-modan,384,deathknight,unholy,6,4,2
Claudio,tichondrius,384,deathknight,unholy,6,4,2
Koreandk,tichondrius,384,deathknight,unholy,6,4,2
Zeathial,moon-guard,384,deathknight,unholy,6,4,2
Nøzawkolypse,area-52,384,deathknight,unholy,6,4,2
Darkswar,barthilas,384,deathknight,unholy,6,4,2
Happynaru,tichondrius,384,deathknight,unholy,6,4,2
Xhamstr,frostmourne,384,deathknight,unholy,6,4,2
Vampygeizt,zuljin,384,deathknight,unholy,6,4,2
Raynorr,dawnbringer,384,deathknight,unholy,6,4,2
Sleezyfbaby,sargeras,384,deathknight,unholy,6,4,2
Afterdeath,frostmourne,384,deathknight,unholy,6,4,2
Reapsouls,stormrage,384,deathknight,unholy,7,4,3
Sussybakadk,sargeras,384,deathknight,unholy,10,5,5
Ambagrips,frostmourne,384,deathknight,unholy,12,4,8
Annuvyz,darkspear,384,deathknight,unholy,12,4,8
Hounura,dathremar,384,deathknight,unholy,12,4,8
Threehunned,frostmourne,384,deathknight,unholy,12,4,8
Telrenaur,proudmoore,384,deathknight,unholy,12,4,8
Kidek,proudmoore,384,deathknight,unholy,12,4,8
Noiksnow,azralon,384,deathknight,unholy,12,4,8
Tyrien,frostmane,384,deathknight,unholy,12,4,8
Tinylich,arthas,384,deathknight,unholy,12,4,8
Bjorstad,moon-guard,384,deathknight,unholy,12,4,8
Deephideblue,proudmoore,384,deathknight,unholy,12,4,8
Nolderosdk,nemesis,384,deathknight,unholy,12,4,8
Bøngripx,tichondrius,384,deathknight,unholy,12,4,8
Feorlar,dalaran,384,deathknight,unholy,12,4,8
Coronä,malfurion,384,deathknight,unholy,12,4,8
Çorn,sargeras,384,deathknight,unholy,12,4,8
Xlive,tichondrius,384,deathknight,unholy,12,4,8
Ziskon,illidan,384,deathknight,unholy,12,4,8
Maalevolent,thunderlord,384,deathknight,unholy,12,4,8
Bealzabub,sargeras,384,deathknight,unholy,12,4,8
Dill,madoran,384,deathknight,unholy,12,4,8
Bhyrnam,ragnaros,384,deathknight,unholy,12,4,8
Darione,twisting-nether,384,deathknight,unholy,12,4,8
Daethiel,demon-soul,384,deathknight,unholy,12,4,8
Bubblesdk,whisperwind,384,deathknight,unholy,12,4,8
Agohnim,moon-guard,384,deathknight,unholy,12,4,8
Enjal,stormrage,384,deathknight,unholy,12,4,8
Sahaile,moon-guard,384,deathknight,unholy,18,4,14
Avengis,bleeding-hollow,384,deathknight,unholy,18,4,14
Volardan,trollbane,383,deathknight,unholy,6,4,2
Hitsüyi,quelthalas,383,deathknight,unholy,11,6,5
Mëllowhypë,sargeras,383,deathknight,unholy,12,4,8
Demher,ragnaros,383,deathknight,unholy,12,4,8
Jinxtar,wyrmrest-accord,382,deathknight,unholy,6,4,2
Búddy,zuljin,382,deathknight,unholy,10,6,4
Cishei,quelthalas,333,deathknight,unholy,9,4,5
Ahirek,quelthalas,320,deathknight,unholy,10,4,6
Ekaj,azuremyst,319,deathknight,unholy,5,4,1
Hadianton,stormrage,318,deathknight,unholy,5,4,1
Nifftybear,tichondrius,288,deathknight,unholy,6,3,3
Petkick,tichondrius,288,deathknight,unholy,6,3,3
Zoomoth,illidan,288,deathknight,unholy,6,3,3
Darktone,tichondrius,288,deathknight,unholy,6,3,3
Smokeyjoe,aegwynn,288,deathknight,unholy,6,3,3
Chrønnøz,nemesis,288,deathknight,unholy,6,3,3
Mendoh,tichondrius,288,deathknight,unholy,6,3,3
Loongdk,kiljaeden,288,deathknight,unholy,6,3,3
Handler,nemesis,288,deathknight,unholy,6,3,3
Lafourche,sargeras,288,deathknight,unholy,6,3,3
Válak,stormrage,288,deathknight,unholy,6,3,3
Shinukishin,stormrage,288,deathknight,unholy,6,3,3
Frostdest,kiljaeden,288,deathknight,unholy,6,3,3
Vërmilliøn,ragnaros,288,deathknight,unholy,6,3,3
Hooterzqt,tichondrius,288,deathknight,unholy,6,3,3
Vinaroth,kiljaeden,288,deathknight,unholy,6,3,3
Diviniumx,bleeding-hollow,288,deathknight,unholy,6,3,3
Blitzcreig,sargeras,288,deathknight,unholy,6,3,3
Monglord,arthas,288,deathknight,unholy,6,3,3
Initiative,moon-guard,288,deathknight,unholy,6,3,3
Fearfull,hyjal,288,deathknight,unholy,6,3,3
Jojomcdeath,senjin,288,deathknight,unholy,6,3,3
Yeetmaster,area-52,288,deathknight,unholy,6,3,3
Kossero,thunderlord,288,deathknight,unholy,6,3,3
Wúhan,moon-guard,288,deathknight,unholy,6,3,3
Aldoraenna,illidan,288,deathknight,unholy,6,3,3
Anderius,tichondrius,288,deathknight,unholy,6,3,3
Bosleigor,elune,288,deathknight,unholy,6,3,3
Jerkin,area-52,288,deathknight,unholy,6,3,3
Trant,tichondrius,288,deathknight,unholy,6,3,3
Laeroth,zuluhed,288,deathknight,unholy,6,3,3
Azombie,burning-blade,288,deathknight,unholy,6,3,3
Herstôry,kelthuzad,288,deathknight,unholy,6,3,3
Muspel,sargeras,288,deathknight,unholy,6,3,3
Libitina,tichondrius,288,deathknight,unholy,6,3,3
Schreit,zuljin,288,deathknight,unholy,6,3,3
Ariacy,sargeras,288,deathknight,unholy,6,3,3
Ödens,dalaran,288,deathknight,unholy,6,3,3
Bingoez,frostmourne,288,deathknight,unholy,6,3,3
Emberwarden,stormrage,288,deathknight,unholy,6,3,3
Moonjae,illidan,288,deathknight,unholy,6,3,3
Adavynn,darkspear,288,deathknight,unholy,6,3,3
Drippedout,illidan,288,deathknight,unholy,6,3,3
Pepecoomer,frostmourne,288,deathknight,unholy,6,3,3
Remõrse,moon-guard,288,deathknight,unholy,6,3,3
Pleasecakes,blood-furnace,288,deathknight,unholy,6,3,3
Akilol,tichondrius,288,deathknight,unholy,6,3,3
Axeldrion,tichondrius,288,deathknight,unholy,6,3,3
Lepanda,skywall,288,deathknight,unholy,6,3,3
Fallen,nazjatar,288,deathknight,unholy,6,3,3
Mýrrh,wyrmrest-accord,288,deathknight,unholy,6,3,3
Renaming,area-52,288,deathknight,unholy,9,4,5
Wisdôm,frostmourne,288,deathknight,unholy,12,3,9
Lho,caelestrasz,288,deathknight,unholy,12,3,9
Torsophuk,stormrage,288,deathknight,unholy,12,3,9
Fokit,barthilas,288,deathknight,unholy,12,3,9
Rottenqunt,tichondrius,288,deathknight,unholy,12,3,9
Nymppho,kelthuzad,288,deathknight,unholy,12,3,9
Beeftip,area-52,288,deathknight,unholy,12,3,9
Danlorinis,moon-guard,288,deathknight,unholy,12,3,9
Garonse,wyrmrest-accord,288,deathknight,unholy,12,3,9
Chosenrune,stormrage,288,deathknight,unholy,12,3,9
Deathsent,malganis,288,deathknight,unholy,18,3,15
Chanskey,stormrage,287,deathknight,unholy,9,3,6
Zedknight,emerald-dream,287,deathknight,unholy,15,4,11
Lowan,stormrage,286,deathknight,unholy,6,3,3
Orthason,moon-guard,286,deathknight,unholy,6,3,3
Papparoach,ysera,286,deathknight,unholy,6,3,3
Copy,suramar,271,deathknight,unholy,11,3,8
Baskel,frostmane,255,deathknight,unholy,11,3,8
Deathrowe,blackhand,240,deathknight,unholy,9,3,6
Originalsin,tichondrius,239,deathknight,unholy,5,3,2
Ålastor,stormrage,234,deathknight,unholy,10,6,4
Kalëndar,drakkari,233,deathknight,unholy,8,4,4
Mefistô,quelthalas,192,deathknight,unholy,4,3,1
Charabone,ragnaros,192,deathknight,unholy,4,3,1
Doombeast,area-52,192,deathknight,unholy,9,4,5
Azupo,aerie-peak,192,deathknight,unholy,9,3,6
Onsslaught,sargeras,192,deathknight,unholy,6,2,4
Raakaa,ghostlands,192,deathknight,unholy,6,2,4
Ragrek,bleeding-hollow,192,deathknight,unholy,6,2,4
Lördd,moon-guard,192,deathknight,unholy,6,2,4
Milkdrugs,daggerspine,192,deathknight,unholy,6,2,4
Supfam,tichondrius,192,deathknight,unholy,6,2,4
Optics,bleeding-hollow,192,deathknight,unholy,6,2,4
Demona,ragnaros,192,deathknight,unholy,6,2,4
Válhállá,ragnaros,192,deathknight,unholy,6,2,4
Tbop,ragnaros,192,deathknight,unholy,6,2,4
Blooddisease,frostmourne,192,deathknight,unholy,6,2,4
Gooré,ragnaros,192,deathknight,unholy,6,2,4
Menalise,moon-guard,192,deathknight,unholy,6,2,4
Fizzease,illidan,192,deathknight,unholy,6,2,4
Ams,moon-guard,192,deathknight,unholy,6,2,4
Yosemithe,quelthalas,192,deathknight,unholy,6,2,4
Kookx,tichondrius,192,deathknight,unholy,6,2,4
Lìlith,dreadmaul,192,deathknight,unholy,6,2,4
Koda,thrall,192,deathknight,unholy,6,2,4
Teedk,drakthul,192,deathknight,unholy,6,2,4
Dustknight,sargeras,192,deathknight,unholy,6,2,4
Ahmisu,tichondrius,192,deathknight,unholy,6,2,4
Sieg,goldrinn,192,deathknight,unholy,6,2,4
Junepí,stormrage,192,deathknight,unholy,6,2,4
Kranaz,barthilas,192,deathknight,unholy,6,2,4
Moonkhink,stormrage,192,deathknight,unholy,6,2,4
Chandsformer,tichondrius,192,deathknight,unholy,6,2,4
Asana,illidan,192,deathknight,unholy,6,2,4
Rxzo,frostmourne,192,deathknight,unholy,6,2,4
Orbo,elune,192,deathknight,unholy,6,2,4
Mongomongo,malganis,192,deathknight,unholy,6,2,4
Saraphdk,area-52,192,deathknight,unholy,6,2,4
Daellius,ragnaros,192,deathknight,unholy,6,2,4
Tristam,area-52,192,deathknight,unholy,6,2,4
Mako,garithos,192,deathknight,unholy,6,2,4
Grimreminder,zuljin,192,deathknight,unholy,6,2,4
Kmardk,area-52,192,deathknight,unholy,6,2,4
Nukydoe,azralon,192,deathknight,unholy,6,2,4
Nurglet,proudmoore,192,deathknight,unholy,6,2,4
Orcazmic,area-52,192,deathknight,unholy,6,2,4
Fanggrief,proudmoore,192,deathknight,unholy,6,2,4
Cokedrip,bleeding-hollow,192,deathknight,unholy,6,2,4
Sagadk,hyjal,192,deathknight,unholy,6,2,4
Coffeemilk,kiljaeden,192,deathknight,unholy,6,2,4
Kterrorblade,sargeras,192,deathknight,unholy,12,2,10
Rykard,hyjal,192,deathknight,unholy,12,2,10
Giraldus,stormrage,192,deathknight,unholy,12,2,10
Longlnus,malganis,192,deathknight,unholy,12,2,10
Terracundo,quelthalas,191,deathknight,unholy,6,4,2
Larrisey,illidan,191,deathknight,unholy,6,2,4
Vynjonc,drenden,191,deathknight,unholy,6,2,4
Zeeroo,moon-guard,160,deathknight,unholy,10,2,8
Gankhiss,emerald-dream,159,deathknight,unholy,5,2,3
Faelmo,malganis,159,deathknight,unholy,5,2,3
Hooker,dragonmaw,138,deathknight,unholy,8,4,4
Dtrayn,tichondrius,128,deathknight,unholy,4,2,2
Ðëthbringër,jubeithos,127,deathknight,unholy,8,2,6
Sílthree,barthilas,96,deathknight,unholy,6,1,5
Almostdead,proudmoore,96,deathknight,unholy,6,1,5
Tarone,zuljin,96,deathknight,unholy,6,1,5
Argy,zuljin,96,deathknight,unholy,6,1,5
Requísition,barthilas,96,deathknight,unholy,6,1,5
Slty,tichondrius,96,deathknight,unholy,6,1,5
Otarin,tichondrius,96,deathknight,unholy,6,1,5
Worgenracist,tichondrius,96,deathknight,unholy,6,1,5
Gnargnarr,firetree,96,deathknight,unholy,6,1,5
Tuicca,frostmane,96,deathknight,unholy,6,1,5
Shargan,tichondrius,96,deathknight,unholy,6,1,5
Rotfang,elune,96,deathknight,unholy,6,1,5
Vicesquad,tichondrius,96,deathknight,unholy,6,1,5
Percy,thaurissan,96,deathknight,unholy,6,1,5
Ghorzul,thrall,96,deathknight,unholy,6,1,5
Laxatives,tichondrius,96,deathknight,unholy,6,1,5
Deathscyythe,illidan,96,deathknight,unholy,6,1,5
Dknightor,dalaran,96,deathknight,unholy,6,1,5
Abake,illidan,96,deathknight,unholy,6,1,5
Einherjiar,tichondrius,96,deathknight,unholy,6,1,5
Papalich,stormrage,96,deathknight,unholy,6,1,5
Alexanderz,quelthalas,96,deathknight,unholy,6,1,5
Arkhän,ragnaros,96,deathknight,unholy,6,1,5
Grimorra,bleeding-hollow,96,deathknight,unholy,6,1,5
Dontbanmepls,zuljin,96,deathknight,unholy,6,1,5
Raull,ragnaros,96,deathknight,unholy,6,1,5
Lichhbanne,doomhammer,96,deathknight,unholy,6,1,5
Andivh,hydraxis,96,deathknight,unholy,6,1,5
Bein,frostmourne,96,deathknight,unholy,6,1,5
Moldremover,frostmourne,96,deathknight,unholy,6,1,5
Istery,thrall,96,deathknight,unholy,6,1,5
Amö,emerald-dream,96,deathknight,unholy,6,1,5
Rgn,deathwing,96,deathknight,unholy,6,1,5
Perculës,sargeras,96,deathknight,unholy,7,1,6
Ulyssess,jubeithos,95,deathknight,unholy,6,1,5
Funerall,azralon,95,deathknight,unholy,12,1,11
Frostbytez,barthilas,79,deathknight,unholy,5,1,4
Deanz,stormrage,63,deathknight,unholy,2,2,0
Asfaq,frostmourne,63,deathknight,unholy,2,2,0
Harrypottr,darrowmere,42,deathknight,unholy,8,2,6
Jhiv,tichondrius,42,deathknight,unholy,10,2,8
Boomxic,shuhalo,31,deathknight,unholy,2,1,1
Pookr,area-52,2164,deathknight,frost,199,101,98
Sylèss,tichondrius,1949,deathknight,frost,78,43,35
Thânätos,nemesis,1809,deathknight,frost,48,26,22
Saco,malganis,1803,deathknight,frost,69,40,29
Sober,destromath,1772,deathknight,frost,77,41,36
Fastapi,tichondrius,1768,deathknight,frost,48,22,26
Dkyeico,ragnaros,1766,deathknight,frost,78,38,40
Yoinkzz,illidan,1763,deathknight,frost,41,19,22
Ksmc,tichondrius,1740,deathknight,frost,54,27,27
Mikepinkdk,illidan,1700,deathknight,frost,63,34,29
Deaddubya,illidan,1670,deathknight,frost,27,21,6
Børeas,quelthalas,1645,deathknight,frost,96,43,53
Tzepesci,hyjal,1626,deathknight,frost,58,26,32
Duranteh,illidan,1623,deathknight,frost,42,20,22
Raiekko,dalaran,1617,deathknight,frost,36,17,19
Rekktless,aerie-peak,1613,deathknight,frost,60,31,29
Gkdm,tichondrius,1532,deathknight,frost,30,16,14
Grakth,quelthalas,1527,deathknight,frost,66,37,29
Lho,caelestrasz,1522,deathknight,frost,77,41,36
Report,dathremar,1521,deathknight,frost,69,36,33
Ðerion,stormrage,1517,deathknight,frost,97,44,53
Percy,thaurissan,1499,deathknight,frost,79,31,48
Zemzil,tichondrius,1477,deathknight,frost,36,16,20
Eldavò,quelthalas,1441,deathknight,frost,42,18,24
Ellipsoro,onyxia,1429,deathknight,frost,48,22,26
Thetalis,moon-guard,1405,deathknight,frost,72,37,35
Jimmyjohnson,illidan,1398,deathknight,frost,41,22,19
Clongeus,tichondrius,1374,deathknight,frost,54,25,29
Tangarang,dalaran,1372,deathknight,frost,36,16,20
Estali,kelthuzad,1362,deathknight,frost,46,22,24
Barrodir,tichondrius,1358,deathknight,frost,51,31,20
Lichborn,azralon,1354,deathknight,frost,39,17,22
Gwab,stormrage,1354,deathknight,frost,48,20,28
Sandooñ,tichondrius,1353,deathknight,frost,42,19,23
Kryptikkyt,blackrock,1341,deathknight,frost,18,14,4
Clapdat,malganis,1335,deathknight,frost,114,56,58
Alexeous,wyrmrest-accord,1326,deathknight,frost,81,34,47
Tekc,nemesis,1317,deathknight,frost,132,64,68
Nevermor,malganis,1304,deathknight,frost,60,29,31
Abake,illidan,1267,deathknight,frost,62,30,32
Alexanderz,quelthalas,1264,deathknight,frost,36,15,21
Rylas,destromath,1250,deathknight,frost,51,22,29
Rayden,frostmourne,1235,deathknight,frost,24,13,11
Sinyay,tichondrius,1233,deathknight,frost,30,18,12
Darketvam,illidan,1230,deathknight,frost,33,20,13
Zefdk,illidan,1214,deathknight,frost,42,25,17
Darfik,sargeras,1210,deathknight,frost,76,45,31
Jackofblades,veknilash,1204,deathknight,frost,66,32,34
Flins,nemesis,1186,deathknight,frost,111,58,53
Jordankg,tanaris,1137,deathknight,frost,30,12,18
Laumuelden,ragnaros,1135,deathknight,frost,42,14,28
Spoon,sargeras,1126,deathknight,frost,28,13,15
Mawvac,quelthalas,1101,deathknight,frost,66,31,35
Moonnwater,frostmourne,1087,deathknight,frost,84,43,41
Garryxz,quelthalas,1077,deathknight,frost,22,12,10
Zephyx,lightbringer,1056,deathknight,frost,18,11,7
Puppykisses,perenolde,1055,deathknight,frost,24,11,13
Malovv,nemesis,1042,deathknight,frost,18,12,6
Worgenracist,tichondrius,1038,deathknight,frost,23,11,12
Sephirott,boulderfist,996,deathknight,frost,23,12,11
Khalid,azgalor,994,deathknight,frost,29,12,17
Xhín,bleeding-hollow,959,deathknight,frost,18,10,8
Frosthana,illidan,959,deathknight,frost,24,10,14
Toothstick,stormrage,957,deathknight,frost,18,10,8
Fokit,barthilas,897,deathknight,frost,46,22,24
Ciputra,blood-furnace,890,deathknight,frost,18,10,8
Lokitabeso,ragnaros,864,deathknight,frost,12,9,3
Scareth,proudmoore,864,deathknight,frost,18,9,9
Lazenca,malganis,863,deathknight,frost,18,9,9
Thesseo,quelthalas,862,deathknight,frost,18,9,9
Chicnchsteak,tichondrius,862,deathknight,frost,30,9,21
Jasmíne,vashj,861,deathknight,frost,12,9,3
Urieen,gorefiend,861,deathknight,frost,18,9,9
Vuldy,blackhand,860,deathknight,frost,18,9,9
Seeyoudiebr,gallywix,856,deathknight,frost,24,9,15
Metaphysicsx,amanthul,839,deathknight,frost,20,9,11
Zarathraz,ragnaros,827,deathknight,frost,17,9,8
Uncfester,onyxia,823,deathknight,frost,18,9,9
Lokítabesos,ragnaros,768,deathknight,frost,12,8,4
Crink,sargeras,768,deathknight,frost,24,8,16
Dregdar,emerald-dream,767,deathknight,frost,12,8,4
Incanis,moon-guard,767,deathknight,frost,18,8,10
Gypo,scilla,766,deathknight,frost,12,8,4
Freemoney,wyrmrest-accord,766,deathknight,frost,12,8,4
Verhangnis,azjolnerub,765,deathknight,frost,12,8,4
Dhrogar,moon-guard,762,deathknight,frost,12,8,4
Pembadk,tichondrius,760,deathknight,frost,21,9,12
Hansmclroy,trollbane,738,deathknight,frost,24,8,16
Monglord,arthas,733,deathknight,frost,27,9,18
Larrisey,illidan,727,deathknight,frost,21,8,13
Tarone,zuljin,688,deathknight,frost,21,10,11
Russkivolk,frostmourne,688,deathknight,frost,19,8,11
Griswold,windrunner,680,deathknight,frost,24,9,15
Grippygarý,illidan,672,deathknight,frost,12,7,5
Bossk,emerald-dream,672,deathknight,frost,12,7,5
Janco,runetotem,672,deathknight,frost,12,7,5
Dumbledore,deathwing,672,deathknight,frost,12,7,5
Iskandàr,ragnaros,672,deathknight,frost,12,7,5
Jazh,tichondrius,672,deathknight,frost,15,8,7
Mikeycal,stormrage,672,deathknight,frost,18,7,11
Anexdk,korgath,672,deathknight,frost,18,7,11
Necrósy,azralon,671,deathknight,frost,12,7,5
Yödä,barthilas,671,deathknight,frost,18,7,11
Emanuels,quelthalas,671,deathknight,frost,18,7,11
Unholycube,zuljin,671,deathknight,frost,30,7,23
Kruspy,area-52,670,deathknight,frost,18,7,11
Cryptgore,moon-guard,665,deathknight,frost,18,7,11
Iiedown,stormrage,623,deathknight,frost,11,7,4
Plaw,kiljaeden,607,deathknight,frost,11,7,4
Rennoc,emerald-dream,576,deathknight,frost,12,6,6
Otarin,tichondrius,576,deathknight,frost,12,6,6
Soulbone,wyrmrest-accord,576,deathknight,frost,12,6,6
Frostunholy,tichondrius,576,deathknight,frost,12,6,6
Riglros,tichondrius,576,deathknight,frost,12,6,6
Dementrius,zuljin,576,deathknight,frost,12,6,6
Cozzasad,barthilas,576,deathknight,frost,12,6,6
Dontbanmepls,zuljin,576,deathknight,frost,18,6,12
Ariacy,sargeras,576,deathknight,frost,18,6,12
Nezareth,sargeras,574,deathknight,frost,12,6,6
Bloodbanne,darkspear,573,deathknight,frost,12,6,6
Sandolorian,area-52,573,deathknight,frost,12,6,6
Darkdevilvii,tichondrius,572,deathknight,frost,12,6,6
Ikaris,wildhammer,569,deathknight,frost,12,6,6
Dkptador,azralon,541,deathknight,frost,17,6,11
Abrahams,tichondrius,522,deathknight,frost,22,8,14
Bellum,moon-guard,511,deathknight,frost,20,6,14
Neaz,moon-guard,480,deathknight,frost,12,5,7
Subparatbest,chogall,480,deathknight,frost,12,5,7
Jhonnsnow,frostmourne,480,deathknight,frost,12,5,7
Martinnash,emerald-dream,480,deathknight,frost,12,5,7
Sinizster,kelthuzad,480,deathknight,frost,12,5,7
Onsslaught,sargeras,480,deathknight,frost,12,5,7
Iriwa,tichondrius,480,deathknight,frost,12,5,7
Deadbeards,zuluhed,480,deathknight,frost,12,5,7
Frozenhawk,lothar,480,deathknight,frost,12,5,7
Saighast,illidan,480,deathknight,frost,18,5,13
Bëlzëbü,stormrage,479,deathknight,frost,6,5,1
Adjudicated,darkspear,477,deathknight,frost,12,5,7
Soulfang,nemesis,477,deathknight,frost,24,5,19
Eloton,daggerspine,431,deathknight,frost,11,5,6
Vanyor,wyrmrest-accord,413,deathknight,frost,24,6,18
Icedmilk,zuluhed,412,deathknight,frost,11,5,6
Orbo,elune,384,deathknight,frost,6,4,2
Anatøly,ragnaros,384,deathknight,frost,6,4,2
Bridenbrad,quelthalas,384,deathknight,frost,6,4,2
Nabreus,ragnaros,384,deathknight,frost,6,4,2
Xelonith,sargeras,384,deathknight,frost,6,4,2
Axiomqt,tichondrius,384,deathknight,frost,6,4,2
Lókhä,thrall,384,deathknight,frost,6,4,2
Unintended,barthilas,384,deathknight,frost,12,4,8
Lichhbanne,doomhammer,384,deathknight,frost,12,4,8
Algeross,dalaran,384,deathknight,frost,12,4,8
Xhoul,sargeras,384,deathknight,frost,12,4,8
Deathrowe,blackhand,384,deathknight,frost,12,4,8
Tambaknight,nemesis,384,deathknight,frost,18,4,14
Vorlakesh,boulderfist,383,deathknight,frost,12,4,8
Eliagianluca,caelestrasz,383,deathknight,frost,12,4,8
Vithael,stormrage,383,deathknight,frost,12,4,8
Loverianed,aerie-peak,383,deathknight,frost,18,4,14
Cailras,argent-dawn,382,deathknight,frost,6,4,2
Sindragos,stormrage,382,deathknight,frost,12,4,8
Greeasy,bleeding-hollow,351,deathknight,frost,11,4,7
Yungdooks,area-52,288,deathknight,frost,6,3,3
Ghouldruis,barthilas,288,deathknight,frost,6,3,3
Saraphdk,area-52,288,deathknight,frost,6,3,3
Úndead,barthilas,288,deathknight,frost,6,3,3
Darkxavros,stormrage,288,deathknight,frost,6,3,3
Plaugedone,lightbringer,288,deathknight,frost,6,3,3
Egirlgripper,area-52,288,deathknight,frost,6,3,3
Nagaizao,nemesis,288,deathknight,frost,6,3,3
Kalevesicant,nesingwary,288,deathknight,frost,6,3,3
Sllice,aegwynn,288,deathknight,frost,6,3,3
Fåîrÿdûst,skullcrusher,288,deathknight,frost,6,3,3
Zügzug,chogall,288,deathknight,frost,6,3,3
Wap,bloodhoof,288,deathknight,frost,6,3,3
Tofurious,barthilas,288,deathknight,frost,6,3,3
Dyingwolf,ragnaros,288,deathknight,frost,6,3,3
Brumaks,quelthalas,288,deathknight,frost,6,3,3
Janzano,deathwing,288,deathknight,frost,6,3,3
Nalec,tichondrius,288,deathknight,frost,6,3,3
Gorsz,tichondrius,288,deathknight,frost,6,3,3
Devcoil,sargeras,288,deathknight,frost,6,3,3
Fearfull,hyjal,288,deathknight,frost,10,4,6
Kraige,tichondrius,288,deathknight,frost,12,3,9
Iccyhottie,stormrage,288,deathknight,frost,12,3,9
Flarkness,area-52,288,deathknight,frost,12,3,9
Bloodmourne,barthilas,288,deathknight,frost,12,3,9
ßlazedkush,kelthuzad,287,deathknight,frost,6,3,3
Páthøgen,ravencrest,287,deathknight,frost,12,3,9
Gnomey,area-52,255,deathknight,frost,8,4,4
Hamze,stormrage,239,deathknight,frost,5,3,2
Surcäfauces,ragnaros,192,deathknight,frost,9,3,6
Crakdos,illidan,192,deathknight,frost,6,2,4
Bonusman,sargeras,192,deathknight,frost,6,2,4
Soutennizase,azralon,192,deathknight,frost,6,2,4
Aradorn,azralon,192,deathknight,frost,6,2,4
Oreodeath,sargeras,192,deathknight,frost,6,2,4
Nenó,illidan,192,deathknight,frost,6,2,4
Aldrey,bonechewer,192,deathknight,frost,6,2,4
Shmacmiller,stormrage,192,deathknight,frost,6,2,4
Zarakas,sargeras,192,deathknight,frost,6,2,4
Frozenjuice,sargeras,192,deathknight,frost,6,2,4
Jykupajr,proudmoore,192,deathknight,frost,6,2,4
Elwoodblooz,stormrage,192,deathknight,frost,6,2,4
Rotfang,elune,192,deathknight,frost,6,2,4
Toxicant,zuljin,192,deathknight,frost,6,2,4
Blooddisease,frostmourne,192,deathknight,frost,6,2,4
Kallugrax,kelthuzad,192,deathknight,frost,6,2,4
Chilivibes,boulderfist,192,deathknight,frost,6,2,4
Corrpsse,tichondrius,192,deathknight,frost,6,2,4
Fraýja,tichondrius,192,deathknight,frost,6,2,4
Ârtas,uldum,192,deathknight,frost,6,2,4
Melyrc,quelthalas,192,deathknight,frost,12,2,10
Neofrank,drakkari,192,deathknight,frost,12,2,10
Killa,maiev,191,deathknight,frost,6,2,4
Edhral,ragnaros,191,deathknight,frost,6,2,4
Sübzerö,quelthalas,191,deathknight,frost,6,2,4
Nickolas,dalvengyr,159,deathknight,frost,5,2,3
Xaldeth,moon-guard,127,deathknight,frost,8,2,6
Kookx,tichondrius,110,deathknight,frost,7,2,5
Telrenaur,proudmoore,96,deathknight,frost,3,2,1
Hadianton,stormrage,96,deathknight,frost,6,1,5
Bingoez,frostmourne,96,deathknight,frost,6,1,5
Zenin,emerald-dream,96,deathknight,frost,6,1,5
Sakaarr,bleeding-hollow,96,deathknight,frost,6,1,5
Shadar,muradin,96,deathknight,frost,6,1,5
Thwap,sargeras,96,deathknight,frost,6,1,5
Vrolock,quelthalas,96,deathknight,frost,6,1,5
Janus,illidan,96,deathknight,frost,6,1,5
Xakri,kelthuzad,96,deathknight,frost,6,1,5
Kodokuna,bleeding-hollow,96,deathknight,frost,6,1,5
Denkot,stormrage,96,deathknight,frost,6,1,5
Bbcobliterat,proudmoore,96,deathknight,frost,6,1,5
Mako,garithos,96,deathknight,frost,6,1,5
Bubblesdk,whisperwind,96,deathknight,frost,6,1,5
Záiiko,quelthalas,96,deathknight,frost,6,1,5
Frostpanda,dalaran,96,deathknight,frost,6,1,5
Almostdead,proudmoore,96,deathknight,frost,6,1,5
Siphilusxo,dalaran,96,deathknight,frost,6,1,5
Mordekeiser,wyrmrest-accord,96,deathknight,frost,6,1,5
Darkwraith,illidan,96,deathknight,frost,6,1,5
Gooré,ragnaros,96,deathknight,frost,6,1,5
Grimorra,bleeding-hollow,96,deathknight,frost,6,1,5
Umbramane,tichondrius,48,deathknight,frost,3,1,2
Agasuko,ghostlands,48,deathknight,frost,3,1,2
Werebuddy,lightnings-blade,48,deathknight,frost,3,1,2
Villåin,hyjal,42,deathknight,frost,9,2,7
Twindleroot,aggramar,31,deathknight,frost,2,1,1
Sharnathos,stormrage,16,deathknight,frost,1,1,0
Xiaosu,tichondrius,2209,demonhunter,havoc,150,78,72
Ordorll,area-52,2112,demonhunter,havoc,66,39,27
Ehtend,sargeras,2106,demonhunter,havoc,78,42,36
Insomniaq,sargeras,2102,demonhunter,havoc,115,62,53
Demoncouch,malganis,2088,demonhunter,havoc,78,41,37
Taegos,tichondrius,2053,demonhunter,havoc,179,88,91
Ehtend,malganis,2020,demonhunter,havoc,83,41,42
Nézuko,eldrethalas,2015,demonhunter,havoc,87,46,41
Lighost,tichondrius,2004,demonhunter,havoc,144,70,74
Càrnagex,tichondrius,1983,demonhunter,havoc,96,53,43
Jøsem,ragnaros,1957,demonhunter,havoc,82,43,39
Boos,moon-guard,1946,demonhunter,havoc,82,41,41
Xtickles,frostmourne,1937,demonhunter,havoc,142,71,71
Bippy,durotan,1936,demonhunter,havoc,78,41,37
Xch,aegwynn,1932,demonhunter,havoc,136,74,62
Tømåtøgøðx,sargeras,1931,demonhunter,havoc,71,40,31
Lademon,tichondrius,1921,demonhunter,havoc,66,37,29
Felz,illidan,1921,demonhunter,havoc,59,28,31
Cromega,malganis,1906,demonhunter,havoc,108,50,58
Lifting,illidan,1905,demonhunter,havoc,78,36,42
Winsforgold,area-52,1899,demonhunter,havoc,54,32,22
Seorae,tichondrius,1892,demonhunter,havoc,54,32,22
Mevadow,bleeding-hollow,1884,demonhunter,havoc,60,28,32
Junma,tichondrius,1874,demonhunter,havoc,84,47,37
Badhábits,sargeras,1873,demonhunter,havoc,36,23,13
Joshallen,malganis,1872,demonhunter,havoc,72,39,33
Mvqqdh,tichondrius,1872,demonhunter,havoc,42,20,22
Dwilk,sargeras,1867,demonhunter,havoc,72,32,40
Reps,hydraxis,1863,demonhunter,havoc,78,41,37
Leothero,area-52,1863,demonhunter,havoc,54,28,26
Azrethec,wyrmrest-accord,1855,demonhunter,havoc,108,62,46
Mvpdh,area-52,1848,demonhunter,havoc,46,27,19
Rosinanta,malygos,1848,demonhunter,havoc,68,38,30
Kohî,sargeras,1846,demonhunter,havoc,47,23,24
Lemilion,wyrmrest-accord,1842,demonhunter,havoc,47,24,23
Nasadh,tichondrius,1840,demonhunter,havoc,48,24,24
Divide,tichondrius,1830,demonhunter,havoc,106,58,48
Takagi,kirin-tor,1828,demonhunter,havoc,221,120,101
Migey,thrall,1825,demonhunter,havoc,112,65,47
Vanarion,area-52,1825,demonhunter,havoc,84,36,48
Dhcn,tichondrius,1823,demonhunter,havoc,35,20,15
Monfel,dalaran,1821,demonhunter,havoc,84,54,30
Karonisam,dalaran,1820,demonhunter,havoc,61,32,29
ßöb,aggramar,1820,demonhunter,havoc,48,22,26
Axalark,nemesis,1817,demonhunter,havoc,42,23,19
Ðavid,firetree,1817,demonhunter,havoc,90,48,42
Terrorsong,tichondrius,1815,demonhunter,havoc,53,32,21
Rufio,nesingwary,1813,demonhunter,havoc,54,25,29
Eldiablaso,malganis,1812,demonhunter,havoc,36,19,17
Failtimeboat,terenas,1811,demonhunter,havoc,56,32,24
Tyskeram,bleeding-hollow,1810,demonhunter,havoc,81,47,34
Medrathis,wyrmrest-accord,1808,demonhunter,havoc,36,22,14
Feldarath,sargeras,1807,demonhunter,havoc,133,76,57
Remh,bleeding-hollow,1807,demonhunter,havoc,150,81,69
Brotherz,tichondrius,1805,demonhunter,havoc,66,32,34
Thânatøs,nemesis,1801,demonhunter,havoc,69,35,34
Icecokelime,black-dragonflight,1800,demonhunter,havoc,38,20,18
Deathbladezx,tichondrius,1800,demonhunter,havoc,47,23,24
Ruffolina,azralon,1799,demonhunter,havoc,121,71,50
Donaldjr,area-52,1798,demonhunter,havoc,69,42,27
Busting,tichondrius,1797,demonhunter,havoc,36,19,17
Nuktukdh,moon-guard,1791,demonhunter,havoc,68,30,38
Flyudzhin,azgalor,1790,demonhunter,havoc,88,45,43
Bigbadmad,stormrage,1785,demonhunter,havoc,96,48,48
Blode,tichondrius,1782,demonhunter,havoc,36,23,13
Oddblindguy,area-52,1777,demonhunter,havoc,30,22,8
Bitcoingodx,tichondrius,1777,demonhunter,havoc,72,43,29
Fruitbatx,tichondrius,1773,demonhunter,havoc,54,27,27
Darkrai,area-52,1765,demonhunter,havoc,108,59,49
Stellitas,ragnaros,1761,demonhunter,havoc,42,21,21
Calpoot,stormscale,1757,demonhunter,havoc,35,19,16
Mizaru,moon-guard,1756,demonhunter,havoc,29,19,10
Sadgirlx,area-52,1756,demonhunter,havoc,54,28,26
Cyrøcryphä,quelthalas,1755,demonhunter,havoc,56,28,28
Devotio,emerald-dream,1749,demonhunter,havoc,48,31,17
Raiinier,sargeras,1746,demonhunter,havoc,60,36,24
Stellartv,tichondrius,1740,demonhunter,havoc,53,26,27
Potspoon,tichondrius,1737,demonhunter,havoc,84,41,43
Furious,tichondrius,1737,demonhunter,havoc,48,23,25
Hoochee,lightnings-blade,1735,demonhunter,havoc,73,39,34
Firstsol,stormrage,1734,demonhunter,havoc,54,33,21
Wickbeams,barthilas,1731,demonhunter,havoc,47,25,22
Garbage,illidan,1731,demonhunter,havoc,54,26,28
Zetara,malganis,1718,demonhunter,havoc,24,18,6
Çhan,tichondrius,1717,demonhunter,havoc,153,79,74
Nadlli,bleeding-hollow,1717,demonhunter,havoc,55,28,27
Crittic,thrall,1717,demonhunter,havoc,48,22,26
Theprodigy,malganis,1715,demonhunter,havoc,48,25,23
Asdazanis,nemesis,1714,demonhunter,havoc,38,22,16
Thehonor,tichondrius,1713,demonhunter,havoc,65,36,29
Dewk,ghostlands,1712,demonhunter,havoc,42,22,20
Harríson,tichondrius,1712,demonhunter,havoc,66,31,35
Oshinoko,area-52,1711,demonhunter,havoc,41,24,17
Azexion,malganis,1711,demonhunter,havoc,46,25,21
Aetheris,bleeding-hollow,1709,demonhunter,havoc,78,34,44
Demabrak,azralon,1707,demonhunter,havoc,47,23,24
Xeylin,sargeras,1703,demonhunter,havoc,54,34,20
Dayvenie,area-52,1703,demonhunter,havoc,60,31,29
Nopohunter,burning-blade,1699,demonhunter,havoc,47,31,16
Anihilum,zuljin,1699,demonhunter,havoc,48,31,17
Raahjxz,sargeras,1696,demonhunter,havoc,36,24,12
Chiesa,sargeras,1695,demonhunter,havoc,34,27,7
Tendiës,tichondrius,1695,demonhunter,havoc,44,23,21
Gesture,malganis,1692,demonhunter,havoc,88,55,33
Munyanyô,moon-guard,1691,demonhunter,havoc,41,26,15
Tubaki,tichondrius,1691,demonhunter,havoc,35,19,16
Speedh,area-52,1691,demonhunter,havoc,36,18,18
Deaforalive,malganis,1690,demonhunter,havoc,96,54,42
Boagz,area-52,1689,demonhunter,havoc,66,40,26
Deathlex,sargeras,1688,demonhunter,havoc,48,26,22
Buddyyguy,illidan,1675,demonhunter,havoc,102,45,57
Ahsref,stormrage,1670,demonhunter,havoc,36,20,16
Bloodhunter,exodar,1668,demonhunter,havoc,92,53,39
Noobstaa,area-52,1664,demonhunter,havoc,36,25,11
Andthrx,area-52,1660,demonhunter,havoc,37,21,16
Griphunt,tichondrius,1655,demonhunter,havoc,46,25,21
Sáìto,arthas,1654,demonhunter,havoc,30,19,11
Ðaredevil,azralon,1650,demonhunter,havoc,36,22,14
Helenquinn,kelthuzad,1649,demonhunter,havoc,30,21,9
Ubetterun,azralon,1649,demonhunter,havoc,81,40,41
Sarynrae,malganis,1647,demonhunter,havoc,40,21,19
Asheng,cairne,1646,demonhunter,havoc,45,22,23
Azinoht,ragnaros,1645,demonhunter,havoc,48,20,28
Karmakula,tichondrius,1642,demonhunter,havoc,65,34,31
Ystkz,tichondrius,1641,demonhunter,havoc,45,20,25
Sivà,tichondrius,1640,demonhunter,havoc,66,35,31
Needlepoint,illidan,1635,demonhunter,havoc,29,19,10
Thundiir,area-52,1635,demonhunter,havoc,36,18,18
Synthwäve,area-52,1634,demonhunter,havoc,36,23,13
Joric,dalaran,1634,demonhunter,havoc,48,30,18
Seraphïel,khaz-modan,1631,demonhunter,havoc,36,23,13
Mvqdh,illidan,1630,demonhunter,havoc,30,17,13
Cezkia,hyjal,1629,demonhunter,havoc,72,36,36
Nolabb,tichondrius,1628,demonhunter,havoc,60,31,29
Ferano,frostmourne,1624,demonhunter,havoc,42,19,23
Randomdh,zuljin,1623,demonhunter,havoc,40,21,19
Zeroheaven,stormrage,1621,demonhunter,havoc,48,19,29
Hehehaha,wyrmrest-accord,1620,demonhunter,havoc,30,20,10
Sicknizzle,area-52,1619,demonhunter,havoc,42,22,20
Dingowango,illidan,1615,demonhunter,havoc,42,19,23
Ouru,area-52,1610,demonhunter,havoc,42,20,22
Kaelclaira,dalvengyr,1609,demonhunter,havoc,36,19,17
Khaõs,tichondrius,1605,demonhunter,havoc,48,18,30
Wsickformula,gilneas,1604,demonhunter,havoc,80,47,33
Mavrush,malganis,1604,demonhunter,havoc,54,31,23
Shale,gilneas,1602,demonhunter,havoc,70,35,35
Yiptaw,area-52,1601,demonhunter,havoc,49,26,23
Gjoat,tichondrius,1600,demonhunter,havoc,42,19,23
Mamif,korgath,1597,demonhunter,havoc,38,20,18
Smqkepvrpp,zuljin,1595,demonhunter,havoc,30,18,12
Cöcainë,stormrage,1594,demonhunter,havoc,24,17,7
Vendeem,moonrunner,1594,demonhunter,havoc,62,32,30
Reito,ragnaros,1589,demonhunter,havoc,53,29,24
Crixxus,zuljin,1589,demonhunter,havoc,42,19,23
Xday,tichondrius,1581,demonhunter,havoc,30,20,10
Ossivil,ragnaros,1581,demonhunter,havoc,60,26,34
Jaybeezy,balnazzar,1580,demonhunter,havoc,42,18,24
Ironsightsdh,dalaran,1577,demonhunter,havoc,35,19,16
Corngodx,sargeras,1577,demonhunter,havoc,90,44,46
Wildh,stormrage,1574,demonhunter,havoc,30,17,13
Stefdh,tichondrius,1565,demonhunter,havoc,39,19,20
Darkrasta,ragnaros,1562,demonhunter,havoc,78,34,44
Cuper,tichondrius,1561,demonhunter,havoc,60,32,28
Gamernation,area-52,1561,demonhunter,havoc,39,19,20
Tichóndrius,tichondrius,1558,demonhunter,havoc,47,26,21
Zatharas,stormrage,1557,demonhunter,havoc,29,17,12
Gorillidan,kelthuzad,1553,demonhunter,havoc,30,18,12
Warlasher,zuljin,1550,demonhunter,havoc,54,28,26
Deadpixellz,illidan,1549,demonhunter,havoc,36,20,16
Lilise,kiljaeden,1541,demonhunter,havoc,39,18,21
Feelmybush,barthilas,1541,demonhunter,havoc,54,23,31
Immortalsinz,dalaran,1541,demonhunter,havoc,53,17,36
Scoplyn,malfurion,1540,demonhunter,havoc,42,21,21
ßlurr,moon-guard,1533,demonhunter,havoc,52,30,22
Solit,illidan,1532,demonhunter,havoc,36,16,20
Vynthar,wyrmrest-accord,1532,demonhunter,havoc,64,28,36
Taszyn,blackrock,1527,demonhunter,havoc,38,21,17
Aiapaec,wyrmrest-accord,1527,demonhunter,havoc,78,41,37
Mattdizzle,illidan,1524,demonhunter,havoc,24,17,7
Knuckifubuck,frostwolf,1521,demonhunter,havoc,76,41,35
Jk,dreadmaul,1520,demonhunter,havoc,40,22,18
Askvivian,sargeras,1511,demonhunter,havoc,31,17,14
Ethhunter,proudmoore,1503,demonhunter,havoc,36,16,20
Glaivediggar,barthilas,1499,demonhunter,havoc,42,16,26
Eery,tichondrius,1497,demonhunter,havoc,65,33,32
Dammitbôbby,tichondrius,1495,demonhunter,havoc,61,33,28
Yqpro,tichondrius,1492,demonhunter,havoc,79,39,40
Jaysavage,eitrigg,1488,demonhunter,havoc,51,27,24
Brútalgore,area-52,1488,demonhunter,havoc,42,22,20
Kaedri,burning-blade,1487,demonhunter,havoc,50,19,31
Gohamx,illidan,1484,demonhunter,havoc,50,25,25
Sciatic,area-52,1482,demonhunter,havoc,62,31,31
Vlääd,ragnaros,1480,demonhunter,havoc,53,25,28
Anathørn,ragnaros,1477,demonhunter,havoc,30,16,14
Nooksuh,bleeding-hollow,1473,demonhunter,havoc,29,16,13
Gubydal,frostmourne,1473,demonhunter,havoc,29,16,13
Falachio,tichondrius,1472,demonhunter,havoc,31,19,12
Kegu,stormrage,1469,demonhunter,havoc,54,20,34
Gomesdhunter,azralon,1466,demonhunter,havoc,88,47,41
Ranir,doomhammer,1464,demonhunter,havoc,36,17,19
Landorus,barthilas,1463,demonhunter,havoc,42,17,25
Mazakein,tichondrius,1462,demonhunter,havoc,30,16,14
Zackfair,burning-legion,1462,demonhunter,havoc,72,37,35
Perspirant,malganis,1460,demonhunter,havoc,29,16,13
Hellnkeller,tichondrius,1459,demonhunter,havoc,36,16,20
Somethingstu,sargeras,1458,demonhunter,havoc,28,18,10
Ilydos,emerald-dream,1458,demonhunter,havoc,36,18,18
Varthalos,thrall,1457,demonhunter,havoc,54,34,20
Darknezzl,ragnaros,1457,demonhunter,havoc,75,33,42
Coohiyan,tichondrius,1455,demonhunter,havoc,30,18,12
Grizzop,sargeras,1454,demonhunter,havoc,48,25,23
Eyecandyxo,grizzly-hills,1452,demonhunter,havoc,37,20,17
Órph,sargeras,1452,demonhunter,havoc,36,19,17
Wangasaurus,emerald-dream,1452,demonhunter,havoc,54,26,28
Enfirok,duskwood,1451,demonhunter,havoc,83,42,41
Bucx,barthilas,1445,demonhunter,havoc,60,36,24
Demoncastx,tichondrius,1442,demonhunter,havoc,26,16,10
Tychondrius,earthen-ring,1438,demonhunter,havoc,47,22,25
Molchamp,kelthuzad,1438,demonhunter,havoc,60,27,33
Lravanal,quelthalas,1435,demonhunter,havoc,24,17,7
Fametrap,tichondrius,1435,demonhunter,havoc,24,15,9
Soyboycuck,emerald-dream,1435,demonhunter,havoc,30,15,15
Ìke,quelthalas,1435,demonhunter,havoc,30,15,15
Lazydeamon,frostmourne,1432,demonhunter,havoc,36,15,21
Faphunter,illidan,1431,demonhunter,havoc,84,48,36
Mybus,tichondrius,1429,demonhunter,havoc,72,32,40
Hawkowicz,tichondrius,1425,demonhunter,havoc,75,42,33
Gwendanzig,zangarmarsh,1421,demonhunter,havoc,36,18,18
Ergzydh,frostmourne,1420,demonhunter,havoc,42,18,24
Duhan,tichondrius,1419,demonhunter,havoc,48,30,18
Valka,emerald-dream,1417,demonhunter,havoc,88,47,41
Bremdh,thrall,1413,demonhunter,havoc,30,15,15
Alli,bleeding-hollow,1412,demonhunter,havoc,43,23,20
Chîsäki,quelthalas,1410,demonhunter,havoc,30,15,15
Softkyll,area-52,1404,demonhunter,havoc,253,133,120
Nekrosdaeva,zuljin,1402,demonhunter,havoc,37,19,18
Boonchu,frostmourne,1402,demonhunter,havoc,34,15,19
Radamanthysi,azralon,1401,demonhunter,havoc,54,34,20
Yodiegang,nazgrel,1400,demonhunter,havoc,24,15,9
Genruis,area-52,1398,demonhunter,havoc,43,21,22
Skace,jubeithos,1397,demonhunter,havoc,102,56,46
Alganoth,malfurion,1394,demonhunter,havoc,42,24,18
Miroir,silvermoon,1390,demonhunter,havoc,87,43,44
Ronkasprince,thunderlord,1389,demonhunter,havoc,86,39,47
Lostsoulzz,tichondrius,1387,demonhunter,havoc,42,27,15
Nolights,area-52,1378,demonhunter,havoc,57,23,34
Fhors,tichondrius,1371,demonhunter,havoc,42,25,17
Gaìjîn,barthilas,1370,demonhunter,havoc,54,28,26
Alaron,wildhammer,1365,demonhunter,havoc,45,29,16
Methany,saurfang,1364,demonhunter,havoc,57,24,33
Inkubuz,sargeras,1356,demonhunter,havoc,102,53,49
Hornedelf,frostmourne,1353,demonhunter,havoc,35,19,16
Nicodine,tichondrius,1348,demonhunter,havoc,36,17,19
Vegan,magtheridon,1345,demonhunter,havoc,24,16,8
Rem,stormrage,1344,demonhunter,havoc,69,37,32
Thêpunisher,ragnaros,1342,demonhunter,havoc,100,50,50
Theflurry,tichondrius,1342,demonhunter,havoc,36,14,22
Biognosis,ragnaros,1334,demonhunter,havoc,42,14,28
Mcspicyy,tichondrius,1332,demonhunter,havoc,24,14,10
Sheepone,tichondrius,1331,demonhunter,havoc,18,14,4
Ikilldemonz,thrall,1331,demonhunter,havoc,24,14,10
Rânkle,darkspear,1328,demonhunter,havoc,36,19,17
Loreney,quelthalas,1327,demonhunter,havoc,78,31,47
Tekkamanevil,tichondrius,1324,demonhunter,havoc,126,62,64
Kuramou,area-52,1322,demonhunter,havoc,24,14,10
Bjj,bonechewer,1320,demonhunter,havoc,40,23,17
Nepzz,stormrage,1316,demonhunter,havoc,30,16,14
Diversityabc,bleeding-hollow,1314,demonhunter,havoc,48,20,28
Sicklyslick,frostmourne,1313,demonhunter,havoc,25,15,10
Sillyslayadk,moon-guard,1300,demonhunter,havoc,80,47,33
Yønkou,stormrage,1300,demonhunter,havoc,96,47,49
Chromatïc,jubeithos,1300,demonhunter,havoc,42,15,27
Belial,haomarush,1299,demonhunter,havoc,54,28,26
Revvup,tichondrius,1294,demonhunter,havoc,71,33,38
Draenkz,ragnaros,1287,demonhunter,havoc,46,15,31
Jellous,rivendare,1286,demonhunter,havoc,36,14,22
Kereses,bonechewer,1282,demonhunter,havoc,36,21,15
Rizzaarrdd,tichondrius,1279,demonhunter,havoc,74,37,37
Xein,khazgoroth,1272,demonhunter,havoc,36,14,22
Whataboutbob,korgath,1268,demonhunter,havoc,36,14,22
Layli,azralon,1266,demonhunter,havoc,24,14,10
Tattedandfab,stormrage,1265,demonhunter,havoc,96,41,55
Roughins,chogall,1260,demonhunter,havoc,36,20,16
Swoffordsr,tichondrius,1259,demonhunter,havoc,30,14,16
Eullz,skullcrusher,1257,demonhunter,havoc,31,14,17
Moylecrumbs,stormrage,1254,demonhunter,havoc,36,14,22
Crayoz,tichondrius,1249,demonhunter,havoc,53,30,23
Ilovenina,sargeras,1247,demonhunter,havoc,24,13,11
Felseal,frostmourne,1247,demonhunter,havoc,30,15,15
Mårth,caelestrasz,1246,demonhunter,havoc,36,19,17
Hogmandh,illidan,1246,demonhunter,havoc,30,13,17
Madepp,tichondrius,1246,demonhunter,havoc,30,13,17
Thechaz,bleeding-hollow,1244,demonhunter,havoc,42,26,16
Alizqt,ragnaros,1244,demonhunter,havoc,24,13,11
Kázeshini,frostmourne,1244,demonhunter,havoc,30,13,17
Skilla,frostmourne,1242,demonhunter,havoc,64,31,33
Halftruth,stormrage,1242,demonhunter,havoc,34,15,19
Narandra,malganis,1239,demonhunter,havoc,36,13,23
Litzilla,thrall,1238,demonhunter,havoc,30,14,16
Glayve,emerald-dream,1237,demonhunter,havoc,55,28,27
Alast,emerald-dream,1237,demonhunter,havoc,30,13,17
Telrindyl,moon-guard,1231,demonhunter,havoc,36,23,13
Dèmonhuntèr,tichondrius,1229,demonhunter,havoc,30,13,17
Accidcleaves,sargeras,1225,demonhunter,havoc,24,14,10
Lory,eldrethalas,1219,demonhunter,havoc,24,16,8
Ixix,proudmoore,1219,demonhunter,havoc,56,28,28
Pilyn,ragnaros,1216,demonhunter,havoc,30,14,16
Soulsteall,tichondrius,1213,demonhunter,havoc,24,14,10
Keelin,ragnaros,1212,demonhunter,havoc,28,13,15
Spicywings,arthas,1209,demonhunter,havoc,42,18,24
Nomfries,malganis,1205,demonhunter,havoc,28,13,15
Blazed,thrall,1202,demonhunter,havoc,88,44,44
Hellspawnn,malganis,1200,demonhunter,havoc,44,24,20
Etherëäl,stormrage,1194,demonhunter,havoc,53,32,21
Xillidan,area-52,1192,demonhunter,havoc,48,29,19
Devwillhuntu,barthilas,1192,demonhunter,havoc,74,38,36
Cyberpsycho,illidan,1184,demonhunter,havoc,30,14,16
Sleepyjobe,sargeras,1183,demonhunter,havoc,16,13,3
Fenomeno,tichondrius,1182,demonhunter,havoc,28,13,15
Thedaz,frostmourne,1182,demonhunter,havoc,112,51,61
Tyrelara,durotan,1179,demonhunter,havoc,23,13,10
Emeress,illidan,1174,demonhunter,havoc,29,13,16
Buzzmezaddy,bleeding-hollow,1170,demonhunter,havoc,63,28,35
Ozark,barthilas,1162,demonhunter,havoc,18,14,4
Xanthalos,wyrmrest-accord,1162,demonhunter,havoc,37,13,24
Zoruv,quelthalas,1160,demonhunter,havoc,27,14,13
Xragii,kelthuzad,1152,demonhunter,havoc,24,12,12
Thêdràïñgáñg,jubeithos,1151,demonhunter,havoc,24,12,12
Wompo,wyrmrest-accord,1151,demonhunter,havoc,24,12,12
Nb,silvermoon,1151,demonhunter,havoc,24,12,12
Fasnk,tichondrius,1150,demonhunter,havoc,24,12,12
Qixoni,emerald-dream,1150,demonhunter,havoc,30,12,18
Obsidians,korgath,1147,demonhunter,havoc,19,13,6
Tenthslayer,frostmourne,1147,demonhunter,havoc,24,12,12
Kaelthys,nordrassil,1145,demonhunter,havoc,18,12,6
Gigavlad,area-52,1145,demonhunter,havoc,24,12,12
Skinnrd,malganis,1142,demonhunter,havoc,24,12,12
Kagraxxis,stormrage,1141,demonhunter,havoc,21,13,8
Jennesis,tichondrius,1140,demonhunter,havoc,30,14,16
Pupupoo,tichondrius,1138,demonhunter,havoc,18,12,6
Gouge,hakkar,1138,demonhunter,havoc,31,17,14
Elidani,area-52,1138,demonhunter,havoc,30,12,18
Endyr,area-52,1136,demonhunter,havoc,25,12,13
Asmoday,warsong,1130,demonhunter,havoc,30,19,11
Imjustbad,malganis,1126,demonhunter,havoc,24,16,8
Ibeatrix,malorne,1124,demonhunter,havoc,24,18,6
Silvs,illidan,1123,demonhunter,havoc,96,52,44
Kaelidan,kelthuzad,1118,demonhunter,havoc,29,13,16
Drachyn,darkspear,1118,demonhunter,havoc,29,12,17
Lilliåna,kiljaeden,1115,demonhunter,havoc,50,22,28
Demonizhe,thrall,1101,demonhunter,havoc,41,22,19
Nixsa,area-52,1091,demonhunter,havoc,31,13,18
Spamsamich,stormscale,1087,demonhunter,havoc,47,26,21
Kelmar,stormreaver,1084,demonhunter,havoc,32,12,20
Jënesis,illidan,1080,demonhunter,havoc,56,25,31
Misfortune,bloodscalp,1076,demonhunter,havoc,36,15,21
Faalleen,quelthalas,1059,demonhunter,havoc,18,12,6
Syrine,veknilash,1059,demonhunter,havoc,72,41,31
Mamazboy,area-52,1056,demonhunter,havoc,18,11,7
Fëlla,tanaris,1055,demonhunter,havoc,18,11,7
Larandaa,sargeras,1055,demonhunter,havoc,18,11,7
Dealer,frostmourne,1055,demonhunter,havoc,18,11,7
Deathsweep,tichondrius,1055,demonhunter,havoc,18,11,7
Thumôss,malganis,1054,demonhunter,havoc,18,11,7
Decoi,tichondrius,1054,demonhunter,havoc,18,11,7
Kìed,kiljaeden,1054,demonhunter,havoc,24,11,13
Sikarnix,stormrage,1054,demonhunter,havoc,30,11,19
Scylus,tichondrius,1053,demonhunter,havoc,18,11,7
Abigëil,quelthalas,1052,demonhunter,havoc,18,11,7
Torophz,azralon,1051,demonhunter,havoc,24,11,13
Messenoire,area-52,1051,demonhunter,havoc,26,11,15
Spicyblades,stormrage,1049,demonhunter,havoc,41,18,23
Ønsen,tichondrius,1049,demonhunter,havoc,29,11,18
Vuse,moon-guard,1048,demonhunter,havoc,24,11,13
Legäult,bleeding-hollow,1047,demonhunter,havoc,33,17,16
Callux,black-dragonflight,1047,demonhunter,havoc,30,11,19
Exequion,ragnaros,1042,demonhunter,havoc,18,11,7
Kazdh,sargeras,1042,demonhunter,havoc,24,11,13
Rickinmorty,lightnings-blade,1041,demonhunter,havoc,18,11,7
Mursiless,drenden,1041,demonhunter,havoc,18,11,7
Blinddh,bleeding-hollow,1041,demonhunter,havoc,26,11,15
Clorhídrico,quelthalas,1036,demonhunter,havoc,30,16,14
Mortiria,dalaran,1036,demonhunter,havoc,30,11,19
Dameon,wildhammer,1027,demonhunter,havoc,48,24,24
Chinadh,tichondrius,1022,demonhunter,havoc,23,11,12
Zématador,azralon,1008,demonhunter,havoc,36,13,23
Saaldh,zuljin,1007,demonhunter,havoc,23,11,12
Eikichi,bleeding-hollow,1007,demonhunter,havoc,42,20,22
Demonhunter,kirin-tor,1005,demonhunter,havoc,23,12,11
Brunoqt,azralon,1004,demonhunter,havoc,23,11,12
Furiel,quelthalas,1000,demonhunter,havoc,21,12,9
Xanthee,drakkari,1000,demonhunter,havoc,45,22,23
Ghostzface,sargeras,993,demonhunter,havoc,18,11,7
Annabow,moon-guard,993,demonhunter,havoc,48,27,21
Krizo,frostmourne,991,demonhunter,havoc,24,12,12
Xxann,tichondrius,991,demonhunter,havoc,26,11,15
Churchpls,stormrage,990,demonhunter,havoc,22,11,11
Syrio,frostmourne,988,demonhunter,havoc,23,11,12
Lüky,malganis,986,demonhunter,havoc,22,11,11
Sacredtree,tichondrius,975,demonhunter,havoc,14,11,3
Troigh,thunderlord,964,demonhunter,havoc,48,25,23
Emopidgeon,dalaran,960,demonhunter,havoc,18,10,8
Ntts,tichondrius,960,demonhunter,havoc,24,10,14
Hoguriders,tichondrius,959,demonhunter,havoc,24,10,14
Irisand,ragnaros,959,demonhunter,havoc,24,10,14
Esomet,stormrage,958,demonhunter,havoc,21,13,8
Yaety,tichondrius,958,demonhunter,havoc,18,10,8
Planeinsky,malganis,958,demonhunter,havoc,18,10,8
Vandeste,tichondrius,958,demonhunter,havoc,24,10,14
Phaintx,tichondrius,958,demonhunter,havoc,24,10,14
Sikäria,malganis,957,demonhunter,havoc,18,10,8
Zunfooki,stormrage,957,demonhunter,havoc,18,10,8
Kalmora,frostmourne,956,demonhunter,havoc,18,10,8
Cäldo,tichondrius,956,demonhunter,havoc,18,10,8
Zévron,area-52,955,demonhunter,havoc,18,10,8
Xibir,amanthul,953,demonhunter,havoc,24,10,14
Lillidum,azralon,945,demonhunter,havoc,42,21,21
Deegsdh,sargeras,932,demonhunter,havoc,27,10,17
Illadra,fizzcrank,929,demonhunter,havoc,17,10,7
Gozer,korialstrasz,929,demonhunter,havoc,36,12,24
Eraticdh,illidan,926,demonhunter,havoc,23,10,13
Imwhack,frostmane,924,demonhunter,havoc,22,10,12
Johnconnor,tichondrius,911,demonhunter,havoc,23,10,13
Lucifèr,uther,911,demonhunter,havoc,23,10,13
Malthazaan,stormrage,895,demonhunter,havoc,14,10,4
Vândel,kelthuzad,895,demonhunter,havoc,23,10,13
Kslicedevil,dalaran,895,demonhunter,havoc,24,10,14
Rissélys,thrall,894,demonhunter,havoc,30,15,15
Shawnchad,blood-furnace,884,demonhunter,havoc,54,25,29
Ripchimmii,illidan,880,demonhunter,havoc,25,10,15
Blacktocki,barthilas,878,demonhunter,havoc,22,10,12
Andyhunter,emerald-dream,875,demonhunter,havoc,24,12,12
Fellight,bonechewer,874,demonhunter,havoc,20,11,9
Faarkyou,barthilas,868,demonhunter,havoc,26,10,16
Brackmagik,barthilas,864,demonhunter,havoc,12,9,3
Pennyx,barthilas,864,demonhunter,havoc,12,9,3
Remuko,tichondrius,864,demonhunter,havoc,18,9,9
Gènji,tichondrius,864,demonhunter,havoc,18,9,9
Vapegodxqt,aegwynn,864,demonhunter,havoc,21,10,11
Tydriedian,dalaran,863,demonhunter,havoc,12,9,3
Creãtuss,area-52,863,demonhunter,havoc,15,10,5
Rothdh,tichondrius,863,demonhunter,havoc,15,10,5
Subieshift,sargeras,863,demonhunter,havoc,15,10,5
Orosz,bleeding-hollow,863,demonhunter,havoc,18,9,9
Naelaksa,tichondrius,863,demonhunter,havoc,18,9,9
Talyethsam,shadowsong,863,demonhunter,havoc,18,9,9
Checkmate,bleeding-hollow,863,demonhunter,havoc,24,9,15
Throniren,stormrage,861,demonhunter,havoc,18,9,9
Hellboss,dalaran,860,demonhunter,havoc,12,9,3
Erazuz,stormrage,860,demonhunter,havoc,18,9,9
Elevateztko,stormrage,859,demonhunter,havoc,24,9,15
Onlypain,korgath,858,demonhunter,havoc,24,9,15
Demonbane,moon-guard,857,demonhunter,havoc,18,9,9
Aflex,zuljin,855,demonhunter,havoc,18,9,9
Dartanyn,tichondrius,853,demonhunter,havoc,24,9,15
Drackista,stormrage,852,demonhunter,havoc,18,9,9
Hasbeen,tichondrius,847,demonhunter,havoc,15,10,5
Aussiepleb,nagrand,846,demonhunter,havoc,87,37,50
Wut,nemesis,843,demonhunter,havoc,24,11,13
Doejah,stormrage,831,demonhunter,havoc,20,10,10
Zachfortnite,emerald-dream,816,demonhunter,havoc,15,10,5
Neshaan,stormreaver,809,demonhunter,havoc,15,12,3
Gwîlym,area-52,794,demonhunter,havoc,14,9,5
Demonslaier,dragonblight,790,demonhunter,havoc,14,9,5
Surkkdh,tichondrius,768,demonhunter,havoc,12,8,4
Sypï,malganis,768,demonhunter,havoc,12,8,4
Viio,proudmoore,768,demonhunter,havoc,12,8,4
Dawgzo,thunderhorn,768,demonhunter,havoc,12,8,4
Cegocruel,sargeras,768,demonhunter,havoc,13,8,5
Ohanadh,ragnaros,768,demonhunter,havoc,18,8,10
Hoonjojjyana,tichondrius,768,demonhunter,havoc,18,8,10
Veilmaya,arthas,768,demonhunter,havoc,18,8,10
Lancee,zuljin,768,demonhunter,havoc,18,8,10
Killuaqt,frostmourne,768,demonhunter,havoc,18,8,10
Mcgurty,illidan,768,demonhunter,havoc,18,8,10
Jcosta,tichondrius,768,demonhunter,havoc,19,8,11
Doomantwo,sargeras,768,demonhunter,havoc,24,8,16
Netherbird,malganis,767,demonhunter,havoc,12,8,4
Tyredris,kelthuzad,767,demonhunter,havoc,12,8,4
Mood,stonemaul,767,demonhunter,havoc,12,8,4
Tezrian,earthen-ring,767,demonhunter,havoc,12,8,4
Anatema,illidan,767,demonhunter,havoc,12,8,4
Lethalblows,darkspear,767,demonhunter,havoc,15,9,6
Loadedtruck,frostmourne,766,demonhunter,havoc,12,8,4
Kellytgt,perenolde,766,demonhunter,havoc,12,8,4
Aedice,gurubashi,766,demonhunter,havoc,18,8,10
Lû,arthas,765,demonhunter,havoc,24,8,16
Baejuhyun,kiljaeden,764,demonhunter,havoc,12,8,4
Dömönic,illidan,764,demonhunter,havoc,18,8,10
Cursesoul,area-52,763,demonhunter,havoc,12,8,4
Syrena,mugthol,763,demonhunter,havoc,18,8,10
Raradane,illidan,762,demonhunter,havoc,12,8,4
Sodiaksd,quelthalas,762,demonhunter,havoc,18,8,10
Covidneitor,drakkari,752,demonhunter,havoc,18,8,10
Seamenhunter,garrosh,752,demonhunter,havoc,18,8,10
Dirtyvitus,gorefiend,748,demonhunter,havoc,12,8,4
Demonkratoz,ragnaros,734,demonhunter,havoc,22,8,14
Rekttx,area-52,714,demonhunter,havoc,20,9,11
Bukwheat,thunderhorn,699,demonhunter,havoc,42,16,26
Memoryleaky,proudmoore,696,demonhunter,havoc,11,8,3
Mustardtigër,bleeding-hollow,672,demonhunter,havoc,12,7,5
Mamadorx,azralon,672,demonhunter,havoc,12,7,5
Supadupä,stormrage,672,demonhunter,havoc,12,7,5
Demonthorne,illidan,672,demonhunter,havoc,12,7,5
Missjotab,tichondrius,672,demonhunter,havoc,12,7,5
Mèw,bleeding-hollow,672,demonhunter,havoc,12,7,5
Tarro,whisperwind,672,demonhunter,havoc,12,7,5
Alwaysin,zuljin,672,demonhunter,havoc,12,7,5
Dashxo,tichondrius,672,demonhunter,havoc,12,7,5
Reddh,bleeding-hollow,672,demonhunter,havoc,12,7,5
Sucio,khaz-modan,672,demonhunter,havoc,12,7,5
Warassassin,stormrage,672,demonhunter,havoc,12,7,5
Flamehunter,durotan,672,demonhunter,havoc,13,7,6
Mudßutt,malganis,672,demonhunter,havoc,18,7,11
Bitskii,kelthuzad,672,demonhunter,havoc,18,7,11
Yasuo,moon-guard,672,demonhunter,havoc,18,7,11
Gilberte,stormrage,672,demonhunter,havoc,18,7,11
Moistybreeze,frostmourne,672,demonhunter,havoc,18,7,11
Getpoodon,sargeras,672,demonhunter,havoc,18,7,11
Ídunno,kiljaeden,672,demonhunter,havoc,18,7,11
Faceurdemons,frostmourne,672,demonhunter,havoc,18,7,11
Beerdash,area-52,672,demonhunter,havoc,24,7,17
Skyfly,stormscale,672,demonhunter,havoc,24,7,17
Gtåte,azjolnerub,672,demonhunter,havoc,24,7,17
Mázoku,shuhalo,671,demonhunter,havoc,12,7,5
Cascadingeye,emerald-dream,671,demonhunter,havoc,12,7,5
Creamboi,stormrage,671,demonhunter,havoc,12,7,5
Larnol,moon-guard,671,demonhunter,havoc,12,7,5
Cleår,kelthuzad,671,demonhunter,havoc,12,7,5
Unóhana,drakkari,671,demonhunter,havoc,12,7,5
Ogmon,tichondrius,671,demonhunter,havoc,12,7,5
Kwoop,tichondrius,671,demonhunter,havoc,12,7,5
Hyphonìc,area-52,671,demonhunter,havoc,18,7,11
Ðarkone,ragnaros,671,demonhunter,havoc,24,7,17
Báléríón,area-52,670,demonhunter,havoc,12,7,5
Bijix,area-52,670,demonhunter,havoc,12,7,5
Swarlee,kiljaeden,668,demonhunter,havoc,18,7,11
Chronicsmoke,blood-furnace,666,demonhunter,havoc,12,7,5
Doomhead,burning-legion,658,demonhunter,havoc,12,7,5
Luzev,thrall,657,demonhunter,havoc,12,7,5
Purpsquirter,stormscale,653,demonhunter,havoc,21,8,13
Pegásus,kiljaeden,639,demonhunter,havoc,10,7,3
Macacøbrr,azralon,639,demonhunter,havoc,17,7,10
Bliqué,emerald-dream,633,demonhunter,havoc,17,7,10
Bofxo,sargeras,624,demonhunter,havoc,15,7,8
Skyez,moon-guard,624,demonhunter,havoc,21,7,14
Bigtitiemilk,tichondrius,623,demonhunter,havoc,11,7,4
Gebblemon,aerie-peak,623,demonhunter,havoc,17,7,10
Galaxezz,bonechewer,612,demonhunter,havoc,15,8,7
Røllnautløw,aegwynn,607,demonhunter,havoc,8,7,1
Xiaochicken,tichondrius,607,demonhunter,havoc,14,7,7
Whatdagoof,tichondrius,576,demonhunter,havoc,12,6,6
Qualitycaulk,tichondrius,576,demonhunter,havoc,12,6,6
Tendies,tichondrius,576,demonhunter,havoc,12,6,6
Kssmee,korgath,576,demonhunter,havoc,12,6,6
Sätän,malganis,576,demonhunter,havoc,12,6,6
Solriel,malganis,576,demonhunter,havoc,12,6,6
Vida,winterhoof,576,demonhunter,havoc,12,6,6
Foxdie,bonechewer,576,demonhunter,havoc,12,6,6
Basdminority,bleeding-hollow,576,demonhunter,havoc,12,6,6
Hugehogger,boulderfist,576,demonhunter,havoc,12,6,6
Kenmu,ragnaros,576,demonhunter,havoc,12,6,6
Jagidan,area-52,576,demonhunter,havoc,12,6,6
Stalkdemon,azralon,576,demonhunter,havoc,12,6,6
Pythongodx,azralon,576,demonhunter,havoc,12,6,6
Slapxy,illidan,576,demonhunter,havoc,12,6,6
Audara,sargeras,576,demonhunter,havoc,12,6,6
Manmilker,bleeding-hollow,576,demonhunter,havoc,12,6,6
Malevolentz,sargeras,576,demonhunter,havoc,12,6,6
Abadina,illidan,576,demonhunter,havoc,12,6,6
Majnun,moon-guard,576,demonhunter,havoc,12,6,6
Pabloh,trollbane,576,demonhunter,havoc,12,6,6
Trillidan,mugthol,576,demonhunter,havoc,12,6,6
Kelan,borean-tundra,576,demonhunter,havoc,18,6,12
Abscarnage,ragnaros,576,demonhunter,havoc,18,6,12
Chabashira,tichondrius,576,demonhunter,havoc,19,6,13
Orgasmia,tichondrius,576,demonhunter,havoc,24,6,18
Elenamarth,kiljaeden,575,demonhunter,havoc,12,6,6
Durello,stormrage,575,demonhunter,havoc,12,6,6
Falaszun,aegwynn,575,demonhunter,havoc,12,6,6
Diizy,illidan,575,demonhunter,havoc,12,6,6
Powertaco,tichondrius,575,demonhunter,havoc,12,6,6
Smoothtaco,azshara,575,demonhunter,havoc,12,6,6
Chungg,laughing-skull,575,demonhunter,havoc,12,6,6
Illidice,tichondrius,575,demonhunter,havoc,12,6,6
Greent,stormrage,575,demonhunter,havoc,12,6,6
Veladoria,malorne,575,demonhunter,havoc,12,6,6
Kitnix,proudmoore,575,demonhunter,havoc,12,6,6
Tyindorin,gurubashi,575,demonhunter,havoc,12,6,6
Miltonpickle,tichondrius,574,demonhunter,havoc,18,6,12
Ðruh,kelthuzad,574,demonhunter,havoc,18,6,12
Keeblerself,tichondrius,569,demonhunter,havoc,12,6,6
Rampyr,terokkar,569,demonhunter,havoc,12,6,6
Kreel,ghostlands,568,demonhunter,havoc,12,6,6
Thjoannys,illidan,567,demonhunter,havoc,12,6,6
Kêydën,ragnaros,541,demonhunter,havoc,10,7,3
Shizune,boulderfist,525,demonhunter,havoc,11,6,5
Wickedlurker,sargeras,519,demonhunter,havoc,17,9,8
Nándÿ,tichondrius,512,demonhunter,havoc,10,6,4
Soure,azralon,511,demonhunter,havoc,14,6,8
Ceried,moon-guard,491,demonhunter,havoc,13,6,7
Ljevilin,gilneas,480,demonhunter,havoc,6,5,1
Cynthadra,frostmourne,480,demonhunter,havoc,6,5,1
Lumh,quelthalas,480,demonhunter,havoc,6,5,1
Ottie,kelthuzad,480,demonhunter,havoc,6,5,1
Junmà,tichondrius,480,demonhunter,havoc,6,5,1
Milfhuñter,sargeras,480,demonhunter,havoc,6,5,1
Prazethesun,emerald-dream,480,demonhunter,havoc,6,5,1
Ariaxy,sargeras,480,demonhunter,havoc,6,5,1
Apõz,tichondrius,480,demonhunter,havoc,6,5,1
Nephxz,tichondrius,480,demonhunter,havoc,6,5,1
Shyisback,area-52,480,demonhunter,havoc,12,5,7
Harahmbae,moon-guard,480,demonhunter,havoc,12,5,7
Maverzz,area-52,480,demonhunter,havoc,12,5,7
Finagel,destromath,480,demonhunter,havoc,12,5,7
Demondurk,illidan,480,demonhunter,havoc,12,5,7
Beerbreak,area-52,480,demonhunter,havoc,12,5,7
Chupillidan,tichondrius,480,demonhunter,havoc,12,5,7
Untouchèd,bleeding-hollow,480,demonhunter,havoc,12,5,7
Oddlysimple,korgath,480,demonhunter,havoc,12,5,7
Onbloodfam,kelthuzad,480,demonhunter,havoc,12,5,7
Sailtheskies,tichondrius,480,demonhunter,havoc,12,5,7
Zlr,bleeding-hollow,480,demonhunter,havoc,12,5,7
Elchapotko,tichondrius,480,demonhunter,havoc,12,5,7
Dhyzz,proudmoore,480,demonhunter,havoc,12,5,7
Karmadh,malganis,480,demonhunter,havoc,12,5,7
Bátmañ,stormrage,480,demonhunter,havoc,12,5,7
Deviljane,illidan,480,demonhunter,havoc,12,5,7
Darkglaive,ragnaros,480,demonhunter,havoc,12,5,7
Gogungho,tichondrius,480,demonhunter,havoc,12,5,7
Delaían,drakkari,480,demonhunter,havoc,12,5,7
Uneasydh,tichondrius,480,demonhunter,havoc,12,5,7
Domeemommy,moon-guard,480,demonhunter,havoc,12,5,7
Felbreak,stormrage,480,demonhunter,havoc,12,5,7
Haax,azralon,480,demonhunter,havoc,12,5,7
Køugami,azralon,480,demonhunter,havoc,12,5,7
Metagoblin,tichondrius,480,demonhunter,havoc,12,5,7
Dontplanahea,tichondrius,480,demonhunter,havoc,12,5,7
Zuppashi,area-52,480,demonhunter,havoc,12,5,7
Hippygamer,frostmourne,480,demonhunter,havoc,12,5,7
Bllackclover,zuljin,480,demonhunter,havoc,12,5,7
Ptsdh,bloodhoof,480,demonhunter,havoc,12,5,7
Maddummy,tichondrius,480,demonhunter,havoc,12,5,7
Roughcut,blackrock,480,demonhunter,havoc,12,5,7
Soulrending,stormrage,480,demonhunter,havoc,18,5,13
Scriptyscrip,dark-iron,480,demonhunter,havoc,18,5,13
Breezoo,tichondrius,479,demonhunter,havoc,6,5,1
Flyingsky,tichondrius,479,demonhunter,havoc,6,5,1
Kritik,goldrinn,478,demonhunter,havoc,12,5,7
Illhuntya,bonechewer,478,demonhunter,havoc,12,5,7
Midnightlord,tichondrius,477,demonhunter,havoc,6,5,1
Blops,emerald-dream,475,demonhunter,havoc,12,5,7
Mentoes,tichondrius,473,demonhunter,havoc,12,5,7
Mikiller,thrall,472,demonhunter,havoc,12,5,7
Vladdtepes,cairne,472,demonhunter,havoc,12,5,7
Siicknote,frostmourne,463,demonhunter,havoc,11,5,6
Leg,scilla,448,demonhunter,havoc,10,5,5
Fugabag,thrall,447,demonhunter,havoc,11,5,6
Raum,elune,443,demonhunter,havoc,8,6,2
Bituhvic,stormrage,431,demonhunter,havoc,11,5,6
Rhaast,executus,430,demonhunter,havoc,15,6,9
Wheredyougo,proudmoore,416,demonhunter,havoc,10,5,5
Antistar,emerald-dream,415,demonhunter,havoc,14,5,9
Blinddude,sargeras,415,demonhunter,havoc,14,5,9
Bladezues,tichondrius,415,demonhunter,havoc,14,5,9
Cyånan,bleeding-hollow,384,demonhunter,havoc,11,8,3
Bigdingding,area-52,384,demonhunter,havoc,6,4,2
Heygriffin,proudmoore,384,demonhunter,havoc,6,4,2
Bopersdh,drakkari,384,demonhunter,havoc,6,4,2
Dadoftheyear,destromath,384,demonhunter,havoc,6,4,2
Everdh,barthilas,384,demonhunter,havoc,6,4,2
Intrusive,kelthuzad,384,demonhunter,havoc,6,4,2
Darthmah,illidan,384,demonhunter,havoc,6,4,2
Yågåmist,dalaran,384,demonhunter,havoc,6,4,2
Xà,sargeras,384,demonhunter,havoc,6,4,2
Diëgo,gallywix,384,demonhunter,havoc,6,4,2
Theownz,stormrage,384,demonhunter,havoc,6,4,2
Cupernacus,tichondrius,384,demonhunter,havoc,6,4,2
Aeonys,stormrage,384,demonhunter,havoc,6,4,2
Verasu,kiljaeden,384,demonhunter,havoc,6,4,2
Hypetraindh,kelthuzad,384,demonhunter,havoc,6,4,2
Äòégämîñg,stormrage,384,demonhunter,havoc,6,4,2
Extínctíon,moon-guard,384,demonhunter,havoc,6,4,2
Parabolicc,illidan,384,demonhunter,havoc,6,4,2
Cloudzzy,illidan,384,demonhunter,havoc,6,4,2
Cococat,tichondrius,384,demonhunter,havoc,6,4,2
Lysol,darrowmere,384,demonhunter,havoc,6,4,2
Souliz,tichondrius,384,demonhunter,havoc,6,4,2
Flirtyscythe,illidan,384,demonhunter,havoc,6,4,2
Spasmodiic,illidan,384,demonhunter,havoc,6,4,2
Khaito,illidan,384,demonhunter,havoc,6,4,2
Deezhuntz,anvilmar,384,demonhunter,havoc,6,4,2
Yuppx,tichondrius,384,demonhunter,havoc,6,4,2
Valerrias,area-52,384,demonhunter,havoc,6,4,2
Promitto,tichondrius,384,demonhunter,havoc,6,4,2
Bogged,emerald-dream,384,demonhunter,havoc,6,4,2
Hordesback,illidan,384,demonhunter,havoc,6,4,2
Besoween,tichondrius,384,demonhunter,havoc,6,4,2
Danloesh,silver-hand,384,demonhunter,havoc,6,4,2
Jellehx,frostmourne,384,demonhunter,havoc,6,4,2
Ineptbb,frostmourne,384,demonhunter,havoc,6,4,2
Smilingbomb,tichondrius,384,demonhunter,havoc,6,4,2
Déörwine,quelthalas,384,demonhunter,havoc,6,4,2
Blackmvp,tichondrius,384,demonhunter,havoc,6,4,2
Sleepyjoeb,illidan,384,demonhunter,havoc,6,4,2
Niteclawla,illidan,384,demonhunter,havoc,6,4,2
Dàrk,zuljin,384,demonhunter,havoc,17,6,11
Älönë,thrall,384,demonhunter,havoc,12,4,8
Wowcoldcold,barthilas,384,demonhunter,havoc,12,4,8
Fraxxured,proudmoore,384,demonhunter,havoc,12,4,8
Sektõr,dalaran,384,demonhunter,havoc,12,4,8
Wherwelandin,zuljin,384,demonhunter,havoc,12,4,8
Vorlimornd,illidan,384,demonhunter,havoc,12,4,8
Dhsoop,tichondrius,384,demonhunter,havoc,12,4,8
Allidox,tichondrius,384,demonhunter,havoc,12,4,8
Randôm,kelthuzad,384,demonhunter,havoc,12,4,8
Contactfront,whisperwind,384,demonhunter,havoc,12,4,8
Mommafingers,illidan,384,demonhunter,havoc,12,4,8
Heallscrean,drakkari,384,demonhunter,havoc,12,4,8
Zoenin,illidan,384,demonhunter,havoc,12,4,8
Rolecheck,tichondrius,384,demonhunter,havoc,12,4,8
Sathsong,tichondrius,384,demonhunter,havoc,12,4,8
Temporarý,bleeding-hollow,384,demonhunter,havoc,12,4,8
Sinhful,darkspear,384,demonhunter,havoc,12,4,8
Uchulu,quelthalas,384,demonhunter,havoc,12,4,8
Fenthras,thrall,384,demonhunter,havoc,12,4,8
Noliaclap,sargeras,384,demonhunter,havoc,12,4,8
Mikemyoffice,illidan,384,demonhunter,havoc,12,4,8
Siksix,bleeding-hollow,384,demonhunter,havoc,12,4,8
Maisus,illidan,384,demonhunter,havoc,12,4,8
Billmcawsom,proudmoore,384,demonhunter,havoc,12,4,8
Felhunt,ragnaros,384,demonhunter,havoc,12,4,8
Drîp,moon-guard,384,demonhunter,havoc,12,4,8
Cherlas,blood-furnace,384,demonhunter,havoc,12,4,8
Noobender,malganis,384,demonhunter,havoc,18,4,14
Demondrëad,lightbringer,383,demonhunter,havoc,9,5,4
Slaytan,darkspear,383,demonhunter,havoc,12,4,8
Vellinaris,zuljin,383,demonhunter,havoc,12,4,8
Riicardo,ragnaros,382,demonhunter,havoc,6,4,2
Findoratoqc,darrowmere,351,demonhunter,havoc,11,4,7
Backtolumby,bleeding-hollow,336,demonhunter,havoc,9,4,5
Xiruu,area-52,336,demonhunter,havoc,15,5,10
Deadlysin,dragonmaw,336,demonhunter,havoc,15,4,11
Fingerjamsx,area-52,335,demonhunter,havoc,11,4,7
Criyn,kelthuzad,330,demonhunter,havoc,17,5,12
Teenis,malygos,318,demonhunter,havoc,8,4,4
Gibbz,wyrmrest-accord,304,demonhunter,havoc,11,5,6
Zoomie,durotan,288,demonhunter,havoc,6,3,3
Dzdh,stormrage,288,demonhunter,havoc,6,3,3
Hròðvitnir,quelthalas,288,demonhunter,havoc,6,3,3
Rákdos,illidan,288,demonhunter,havoc,6,3,3
Asukaxox,illidan,288,demonhunter,havoc,6,3,3
Vyrai,lightbringer,288,demonhunter,havoc,6,3,3
Thickgary,illidan,288,demonhunter,havoc,6,3,3
Pubelice,draenor,288,demonhunter,havoc,6,3,3
Thunderrbolt,illidan,288,demonhunter,havoc,6,3,3
Letzgobrandn,silvermoon,288,demonhunter,havoc,6,3,3
Giselah,malganis,288,demonhunter,havoc,6,3,3
Fiveiq,malganis,288,demonhunter,havoc,6,3,3
Shacco,bleeding-hollow,288,demonhunter,havoc,6,3,3
Wokeaf,malganis,288,demonhunter,havoc,6,3,3
Ziyutomioka,moon-guard,288,demonhunter,havoc,6,3,3
Dgj,kelthuzad,288,demonhunter,havoc,6,3,3
Feltini,whisperwind,288,demonhunter,havoc,6,3,3
Slodeath,zuljin,288,demonhunter,havoc,6,3,3
Rauwèrs,azralon,288,demonhunter,havoc,6,3,3
Touched,guldan,288,demonhunter,havoc,6,3,3
Xxsozin,skullcrusher,288,demonhunter,havoc,6,3,3
Ravack,stormrage,288,demonhunter,havoc,6,3,3
Talsaris,drakthul,288,demonhunter,havoc,6,3,3
Velerolas,area-52,288,demonhunter,havoc,6,3,3
Littlewolfie,illidan,288,demonhunter,havoc,6,3,3
Riodh,area-52,288,demonhunter,havoc,6,3,3
Ocão,azralon,288,demonhunter,havoc,6,3,3
Seabisciut,silvermoon,288,demonhunter,havoc,6,3,3
Bossdh,zuljin,288,demonhunter,havoc,6,3,3
Noóve,area-52,288,demonhunter,havoc,6,3,3
Broneill,blood-furnace,288,demonhunter,havoc,6,3,3
Zétta,area-52,288,demonhunter,havoc,6,3,3
Orsova,area-52,288,demonhunter,havoc,6,3,3
Ravevê,area-52,288,demonhunter,havoc,6,3,3
Aslowbust,tichondrius,288,demonhunter,havoc,6,3,3
Baka,grizzly-hills,288,demonhunter,havoc,6,3,3
Sloôtybag,tichondrius,288,demonhunter,havoc,6,3,3
Adycatt,illidan,288,demonhunter,havoc,6,3,3
Cocomeld,tichondrius,288,demonhunter,havoc,6,3,3
Demønical,dalaran,288,demonhunter,havoc,6,3,3
Catastrophis,tichondrius,288,demonhunter,havoc,6,3,3
Dracxus,sargeras,288,demonhunter,havoc,6,3,3
Cðnstantine,barthilas,288,demonhunter,havoc,6,3,3
Moranah,tichondrius,288,demonhunter,havoc,6,3,3
Mavrii,executus,288,demonhunter,havoc,6,3,3
Wingsofhavoc,darkspear,288,demonhunter,havoc,6,3,3
Mewmewkitty,tichondrius,288,demonhunter,havoc,6,3,3
Fiebzz,queldorei,288,demonhunter,havoc,6,3,3
Dejay,thunderhorn,288,demonhunter,havoc,6,3,3
Demonbanter,emerald-dream,288,demonhunter,havoc,6,3,3
Gurthbrookz,tichondrius,288,demonhunter,havoc,6,3,3
Cassadega,sargeras,288,demonhunter,havoc,6,3,3
Blurblurblur,frostmourne,288,demonhunter,havoc,6,3,3
Mèrlyn,sargeras,288,demonhunter,havoc,6,3,3
Bbteaa,frostmourne,288,demonhunter,havoc,6,3,3
Eyesyk,bonechewer,288,demonhunter,havoc,6,3,3
Verå,tichondrius,288,demonhunter,havoc,6,3,3
Bogdan,azjolnerub,288,demonhunter,havoc,6,3,3
Raith,khazgoroth,288,demonhunter,havoc,6,3,3
Darkstein,nathrezim,288,demonhunter,havoc,6,3,3
Dhuck,nemesis,288,demonhunter,havoc,15,4,11
Zudo,amanthul,288,demonhunter,havoc,12,3,9
Denadiirx,area-52,288,demonhunter,havoc,12,3,9
Roodblurz,zuljin,288,demonhunter,havoc,12,3,9
Trekt,blades-edge,288,demonhunter,havoc,12,3,9
Superbug,quelthalas,288,demonhunter,havoc,12,3,9
Barael,tichondrius,288,demonhunter,havoc,12,3,9
Yåkuza,daggerspine,288,demonhunter,havoc,12,3,9
Fuujiin,tol-barad,288,demonhunter,havoc,12,3,9
Ovèrrated,area-52,288,demonhunter,havoc,12,3,9
Dãnishroll,illidan,288,demonhunter,havoc,12,3,9
Atriax,kelthuzad,288,demonhunter,havoc,12,3,9
Dmfeetpics,dalaran,288,demonhunter,havoc,12,3,9
Vellassa,stormscale,288,demonhunter,havoc,18,3,15
Haydet,stormrage,287,demonhunter,havoc,6,3,3
Aliniron,illidan,287,demonhunter,havoc,6,3,3
Lrianna,senjin,287,demonhunter,havoc,6,3,3
Devc,stormrage,287,demonhunter,havoc,6,3,3
Cheriste,malganis,287,demonhunter,havoc,14,4,10
Rahgoul,garrosh,287,demonhunter,havoc,12,3,9
Hiresol,emerald-dream,239,demonhunter,havoc,5,3,2
Vickyvette,illidan,239,demonhunter,havoc,5,3,2
Vespherie,moon-guard,234,demonhunter,havoc,8,5,3
Funky,draenor,231,demonhunter,havoc,16,6,10
Bushwacker,azralon,223,demonhunter,havoc,8,3,5
Cobra,quelthalas,208,demonhunter,havoc,7,3,4
Critxclutch,tichondrius,192,demonhunter,havoc,4,3,1
Syrendris,moon-guard,192,demonhunter,havoc,8,3,5
Ratcnt,barthilas,192,demonhunter,havoc,6,2,4
Lachesix,tichondrius,192,demonhunter,havoc,6,2,4
Zzatmikaze,area-52,192,demonhunter,havoc,6,2,4
Lovekills,tichondrius,192,demonhunter,havoc,6,2,4
Reapersauce,illidan,192,demonhunter,havoc,6,2,4
Renatha,ragnaros,192,demonhunter,havoc,6,2,4
Frøppy,illidan,192,demonhunter,havoc,6,2,4
Dridri,quelthalas,192,demonhunter,havoc,6,2,4
Wowomg,tichondrius,192,demonhunter,havoc,6,2,4
Carlibeth,illidan,192,demonhunter,havoc,6,2,4
Pariah,saurfang,192,demonhunter,havoc,6,2,4
Allenqt,azralon,192,demonhunter,havoc,6,2,4
Pragma,thrall,192,demonhunter,havoc,6,2,4
Faster,tichondrius,192,demonhunter,havoc,6,2,4
Sarithos,frostmourne,192,demonhunter,havoc,6,2,4
Mavèrick,thrall,192,demonhunter,havoc,6,2,4
Daabsdh,thrall,192,demonhunter,havoc,6,2,4
Ragath,bonechewer,192,demonhunter,havoc,6,2,4
Xanthrodril,illidan,192,demonhunter,havoc,6,2,4
Jadyne,frostmourne,192,demonhunter,havoc,6,2,4
Harû,tichondrius,192,demonhunter,havoc,6,2,4
Paypaldh,malganis,192,demonhunter,havoc,6,2,4
Krador,wyrmrest-accord,192,demonhunter,havoc,6,2,4
Thegoph,bleeding-hollow,192,demonhunter,havoc,6,2,4
Kyuno,eitrigg,192,demonhunter,havoc,6,2,4
Malviciouss,tichondrius,192,demonhunter,havoc,6,2,4
Ilìdarì,zuljin,192,demonhunter,havoc,6,2,4
Zethh,drakkari,192,demonhunter,havoc,6,2,4
Deathschosen,malganis,192,demonhunter,havoc,6,2,4
Jozeez,emerald-dream,192,demonhunter,havoc,6,2,4
Freddiedread,bladefist,192,demonhunter,havoc,6,2,4
Frino,steamwheedle-cartel,192,demonhunter,havoc,6,2,4
Ossariss,moon-guard,192,demonhunter,havoc,6,2,4
Lilvetis,thrall,192,demonhunter,havoc,6,2,4
Ivexia,blackrock,192,demonhunter,havoc,6,2,4
Devilweef,whisperwind,192,demonhunter,havoc,6,2,4
Daracu,aerie-peak,192,demonhunter,havoc,6,2,4
Vivas,tichondrius,192,demonhunter,havoc,6,2,4
Arkynth,dalaran,192,demonhunter,havoc,6,2,4
Daso,the-forgotten-coast,192,demonhunter,havoc,6,2,4
Rykko,borean-tundra,192,demonhunter,havoc,6,2,4
Berquondh,tichondrius,192,demonhunter,havoc,6,2,4
Spacéphoenix,stormrage,192,demonhunter,havoc,6,2,4
Felmilk,demon-soul,192,demonhunter,havoc,6,2,4
Pokoloko,twisting-nether,192,demonhunter,havoc,6,2,4
Sparklepunch,stormrage,192,demonhunter,havoc,6,2,4
Blynx,destromath,192,demonhunter,havoc,6,2,4
Texts,norgannon,192,demonhunter,havoc,6,2,4
Falan,drakthul,192,demonhunter,havoc,6,2,4
Swagidan,khaz-modan,192,demonhunter,havoc,6,2,4
Morgoph,burning-legion,192,demonhunter,havoc,6,2,4
Wreckforce,blades-edge,192,demonhunter,havoc,6,2,4
Badservice,frostwolf,192,demonhunter,havoc,6,2,4
Tdmturbo,zuluhed,192,demonhunter,havoc,6,2,4
Lilyanie,stormrage,192,demonhunter,havoc,6,2,4
Aleta,firetree,192,demonhunter,havoc,6,2,4
Bastaghor,stormrage,192,demonhunter,havoc,6,2,4
Zergedh,kiljaeden,192,demonhunter,havoc,6,2,4
Itachiix,sargeras,192,demonhunter,havoc,6,2,4
Xonu,sargeras,192,demonhunter,havoc,6,2,4
Mqvdh,area-52,192,demonhunter,havoc,6,2,4
Kalikanzar,sargeras,192,demonhunter,havoc,6,2,4
Cryolite,sargeras,192,demonhunter,havoc,6,2,4
Kayanson,azralon,192,demonhunter,havoc,6,2,4
Rivent,dethecus,192,demonhunter,havoc,6,2,4
Gopump,area-52,192,demonhunter,havoc,6,2,4
Dirtydone,area-52,192,demonhunter,havoc,6,2,4
Jaauk,ragnaros,192,demonhunter,havoc,10,3,7
Qlmm,stormrage,192,demonhunter,havoc,7,2,5
Hávok,sargeras,192,demonhunter,havoc,7,2,5
Tiristra,cenarion-circle,192,demonhunter,havoc,8,2,6
Hueylucifer,ravencrest,192,demonhunter,havoc,12,2,10
Âduka,illidan,192,demonhunter,havoc,12,2,10
Hollownight,area-52,192,demonhunter,havoc,12,2,10
Dangerspud,frostmourne,192,demonhunter,havoc,12,2,10
Catastroz,ragnaros,192,demonhunter,havoc,12,2,10
Sadpepe,bleeding-hollow,192,demonhunter,havoc,12,2,10
Aleymar,tichondrius,191,demonhunter,havoc,6,2,4
Abusedchild,dalaran,191,demonhunter,havoc,6,2,4
Lëif,stormrage,191,demonhunter,havoc,6,2,4
Anguloke,wyrmrest-accord,191,demonhunter,havoc,6,2,4
Feilixx,moon-guard,190,demonhunter,havoc,12,2,10
Ryoga,malganis,159,demonhunter,havoc,5,2,3
Shanjara,sargeras,138,demonhunter,havoc,15,3,12
Xeil,zuljin,128,demonhunter,havoc,4,2,2
Gittgudd,area-52,128,demonhunter,havoc,4,2,2
Elfofura,azralon,127,demonhunter,havoc,14,2,12
Evros,tichondrius,96,demonhunter,havoc,3,2,1
Safikins,tichondrius,96,demonhunter,havoc,6,1,5
Icanmove,area-52,96,demonhunter,havoc,6,1,5
Nightsatan,stormrage,96,demonhunter,havoc,6,1,5
Theysuffer,scilla,96,demonhunter,havoc,6,1,5
Eibizoudh,sargeras,96,demonhunter,havoc,6,1,5
Chakan,burning-legion,96,demonhunter,havoc,6,1,5
Jerry,emerald-dream,96,demonhunter,havoc,6,1,5
Izruul,tichondrius,96,demonhunter,havoc,6,1,5
Nikator,emerald-dream,96,demonhunter,havoc,6,1,5
Elillidan,emerald-dream,96,demonhunter,havoc,6,1,5
Memslaw,tichondrius,96,demonhunter,havoc,6,1,5
Ripperxx,zuljin,96,demonhunter,havoc,6,1,5
Saladuoduo,illidan,96,demonhunter,havoc,6,1,5
Skylinetime,sargeras,96,demonhunter,havoc,6,1,5
Ðemonhunterx,frostmourne,96,demonhunter,havoc,6,1,5
Frenchtoast,bonechewer,96,demonhunter,havoc,6,1,5
Demonleàf,area-52,96,demonhunter,havoc,6,1,5
Finnanutt,tichondrius,96,demonhunter,havoc,6,1,5
Slycerr,illidan,96,demonhunter,havoc,6,1,5
Thedh,ragnaros,96,demonhunter,havoc,6,1,5
Kushidari,tichondrius,96,demonhunter,havoc,6,1,5
Devî,ragnaros,96,demonhunter,havoc,6,1,5
Asharian,wyrmrest-accord,96,demonhunter,havoc,6,1,5
Dhrongor,drakkari,96,demonhunter,havoc,6,1,5
Ðemonix,tichondrius,96,demonhunter,havoc,6,1,5
Mazïkeen,uther,96,demonhunter,havoc,6,1,5
Jhinskui,drakkari,96,demonhunter,havoc,6,1,5
Baalböski,tichondrius,96,demonhunter,havoc,6,1,5
Itsplague,tichondrius,96,demonhunter,havoc,6,1,5
Foxzz,tichondrius,96,demonhunter,havoc,6,1,5
Boatsnhoze,tichondrius,96,demonhunter,havoc,6,1,5
Treblig,nerzhul,96,demonhunter,havoc,6,1,5
Gosrend,durotan,96,demonhunter,havoc,7,1,6
Alphatoo,area-52,96,demonhunter,havoc,9,1,8
Moonsocks,proudmoore,96,demonhunter,havoc,12,1,11
Gnocchis,thrall,96,demonhunter,havoc,12,1,11
Grolschen,proudmoore,95,demonhunter,havoc,6,1,5
Miskiiv,malganis,79,demonhunter,havoc,5,1,4
Fellchapo,illidan,79,demonhunter,havoc,5,1,4
Mcthiccyy,moon-guard,64,demonhunter,havoc,4,1,3
Aryía,stormrage,48,demonhunter,havoc,3,1,2
Unjust,darkspear,48,demonhunter,havoc,3,1,2
Xaryic,stormrage,42,demonhunter,havoc,16,5,11
Worcraf,ragnaros,42,demonhunter,havoc,8,2,6
Aríes,dreadmaul,31,demonhunter,havoc,2,1,1
Turecdh,illidan,31,demonhunter,havoc,2,1,1
Pooterjuice,shadowmoon,31,demonhunter,havoc,2,1,1
Lathazar,darkspear,16,demonhunter,havoc,1,1,0
Iwasright,stonemaul,1457,demonhunter,vengeance,66,31,35
Jersey,proudmoore,1063,demonhunter,vengeance,23,14,9
Ferano,frostmourne,288,demonhunter,vengeance,6,3,3
Agricornia,tichondrius,287,demonhunter,vengeance,6,3,3
Çherrii,moon-guard,286,demonhunter,vengeance,6,3,3
Aleymar,tichondrius,96,demonhunter,vengeance,6,1,5
Grovetenderx,tichondrius,2238,druid,restoration,86,53,33
Kobaishome,tichondrius,2148,druid,restoration,119,70,49
Linful,tichondrius,2141,druid,restoration,179,92,87
Couragé,ragnaros,2108,druid,restoration,135,68,67
Andrwceo,stormrage,2104,druid,restoration,60,37,23
Vers,dathremar,2037,druid,restoration,90,43,47
Shaylyne,moonrunner,2032,druid,restoration,51,32,19
Dannycarry,tichondrius,2025,druid,restoration,59,32,27
Racialmotive,illidan,2000,druid,restoration,123,70,53
Plorenz,zuljin,1952,druid,restoration,89,51,38
Rorae,tichondrius,1942,druid,restoration,113,56,57
Mengniulol,tichondrius,1941,druid,restoration,84,49,35
Brenden,area-52,1921,druid,restoration,72,38,34
Sanlunainiu,tichondrius,1915,druid,restoration,166,73,93
Tizzyy,eredar,1898,druid,restoration,72,39,33
Davidqx,zuljin,1882,druid,restoration,42,30,12
Renner,zuljin,1875,druid,restoration,65,30,35
Eddí,illidan,1872,druid,restoration,64,32,32
Rindy,rexxar,1869,druid,restoration,72,37,35
Ksz,stormrage,1867,druid,restoration,42,25,17
Szwlol,tichondrius,1855,druid,restoration,118,63,55
Guqingshuang,tichondrius,1855,druid,restoration,73,35,38
Rèmix,bleeding-hollow,1847,druid,restoration,42,23,19
Mimidelol,tichondrius,1839,druid,restoration,66,36,30
Darkenëd,dalaran,1836,druid,restoration,62,36,26
Gluesmoka,icecrown,1836,druid,restoration,54,31,23
Gankstanerdz,tichondrius,1835,druid,restoration,113,55,58
Reehz,stormrage,1834,druid,restoration,53,25,28
Bodytwisting,tichondrius,1828,druid,restoration,48,29,19
Heymeow,tichondrius,1825,druid,restoration,60,24,36
Brendenjr,area-52,1819,druid,restoration,45,32,13
Shiftýx,tichondrius,1818,druid,restoration,59,31,28
Leafowl,tichondrius,1817,druid,restoration,36,22,14
Tunnaris,ragnaros,1811,druid,restoration,71,33,38
Kenái,nemesis,1810,druid,restoration,30,19,11
Hlchs,tichondrius,1810,druid,restoration,36,22,14
Corcovado,bleeding-hollow,1809,druid,restoration,66,31,35
Yggdrasil,ravencrest,1805,druid,restoration,65,31,34
Kayorva,gurubashi,1804,druid,restoration,47,24,23
Jegara,auchindoun,1801,druid,restoration,59,35,24
Ivý,shadowsong,1800,druid,restoration,41,28,13
Héisénbérg,sargeras,1800,druid,restoration,81,44,37
Treenleaves,stormrage,1799,druid,restoration,201,110,91
Corbind,arthas,1799,druid,restoration,133,69,64
Saxhouse,illidan,1798,druid,restoration,48,29,19
Lotiononmyd,illidan,1794,druid,restoration,123,67,56
Hchls,tichondrius,1786,druid,restoration,48,22,26
Creamcow,tichondrius,1785,druid,restoration,46,25,21
Pvpgold,illidan,1781,druid,restoration,54,29,25
Reizzy,sargeras,1780,druid,restoration,36,19,17
Jdown,dalaran,1772,druid,restoration,76,43,33
Kruisberg,sargeras,1769,druid,restoration,29,19,10
Surefacts,dathremar,1738,druid,restoration,40,21,19
Geddoff,stormrage,1737,druid,restoration,54,23,31
Branchmanagr,dark-iron,1736,druid,restoration,54,23,31
Airmeodaddy,barthilas,1730,druid,restoration,44,24,20
Omkin,tichondrius,1719,druid,restoration,42,24,18
Drjelly,tichondrius,1707,druid,restoration,76,32,44
Hideurkidz,tichondrius,1699,druid,restoration,39,23,16
Facegotrake,stormrage,1698,druid,restoration,66,39,27
Staraborn,stormrage,1693,druid,restoration,198,113,85
Gotheels,illidan,1685,druid,restoration,29,18,11
Pootyleaf,daggerspine,1678,druid,restoration,54,27,27
Currants,lightbringer,1678,druid,restoration,108,43,65
Boonsogan,tichondrius,1672,druid,restoration,36,18,18
Gonimydear,proudmoore,1668,druid,restoration,66,35,31
Dirtdog,uther,1664,druid,restoration,47,21,26
Legitonedge,zuljin,1662,druid,restoration,55,30,25
Fattdiabetic,tichondrius,1660,druid,restoration,36,20,16
Zoteqt,kelthuzad,1653,druid,restoration,36,21,15
Addiedru,area-52,1650,druid,restoration,45,23,22
Ekr,tichondrius,1650,druid,restoration,36,18,18
Pizzatimex,zuluhed,1649,druid,restoration,42,22,20
Druidstin,tichondrius,1649,druid,restoration,162,84,78
Angrygochux,tichondrius,1648,druid,restoration,42,21,21
Defteras,illidan,1647,druid,restoration,42,21,21
Animalge,sargeras,1643,druid,restoration,60,25,35
Images,kilrogg,1638,druid,restoration,54,37,17
Birdfromtree,dalaran,1636,druid,restoration,48,26,22
Légz,area-52,1634,druid,restoration,94,49,45
Playstyle,stormrage,1630,druid,restoration,31,17,14
Nikdruidne,tichondrius,1628,druid,restoration,30,17,13
Acdru,tichondrius,1624,druid,restoration,54,26,28
Wolfis,malganis,1622,druid,restoration,36,20,16
Holydruid,tichondrius,1617,druid,restoration,36,17,19
Muhu,frostmourne,1615,druid,restoration,60,35,25
Naturae,spirestone,1615,druid,restoration,68,36,32
Gulperberg,sargeras,1612,druid,restoration,30,25,5
Hxm,tichondrius,1611,druid,restoration,35,17,18
Notpodruida,tichondrius,1610,druid,restoration,30,18,12
Fhiziod,kelthuzad,1606,druid,restoration,68,41,27
Yavannita,quelthalas,1600,druid,restoration,57,36,21
Commercii,tichondrius,1600,druid,restoration,36,19,17
Erral,malganis,1597,druid,restoration,57,26,31
Hdruid,tichondrius,1596,druid,restoration,43,25,18
Thasta,blackrock,1595,druid,restoration,65,31,34
Silentbeer,frostmourne,1587,druid,restoration,114,59,55
Methyld,frostmourne,1584,druid,restoration,66,25,41
Poscow,tichondrius,1583,druid,restoration,45,25,20
Cheddy,tichondrius,1582,druid,restoration,59,33,26
Mortqt,tichondrius,1574,druid,restoration,48,22,26
Duragx,bleeding-hollow,1567,druid,restoration,100,62,38
Anaps,frostmourne,1566,druid,restoration,30,19,11
Gødriç,tichondrius,1566,druid,restoration,215,107,108
Zyzzema,frostmourne,1563,druid,restoration,138,64,74
Relbedo,sargeras,1558,druid,restoration,75,39,36
Youngteezy,barthilas,1555,druid,restoration,52,20,32
Ursiiday,sargeras,1553,druid,restoration,42,19,23
Aberdare,tichondrius,1546,druid,restoration,58,37,21
Rizzit,wyrmrest-accord,1544,druid,restoration,170,94,76
Hayase,tichondrius,1542,druid,restoration,36,22,14
Lutein,tichondrius,1541,druid,restoration,60,25,35
Lubbeck,stormrage,1538,druid,restoration,98,53,45
Morphiq,tichondrius,1537,druid,restoration,93,51,42
Errane,eonar,1533,druid,restoration,49,32,17
Nikotser,dreadmaul,1531,druid,restoration,39,18,21
Cutely,tichondrius,1526,druid,restoration,105,56,49
Sanitizer,tichondrius,1525,druid,restoration,30,16,14
Sarrati,emerald-dream,1524,druid,restoration,117,61,56
Terkpla,ragnaros,1523,druid,restoration,41,24,17
Lenya,bleeding-hollow,1523,druid,restoration,36,16,20
Kaleaky,thrall,1519,druid,restoration,42,21,21
Bexdru,area-52,1516,druid,restoration,104,46,58
Meruemoo,tichondrius,1506,druid,restoration,64,34,30
Hravan,dentarg,1505,druid,restoration,37,19,18
Kimnim,tichondrius,1500,druid,restoration,106,57,49
Pëndulum,illidan,1497,druid,restoration,66,29,37
Poliage,moon-guard,1489,druid,restoration,99,44,55
Rowlex,moon-guard,1483,druid,restoration,22,17,5
Volktots,bleeding-hollow,1483,druid,restoration,48,29,19
Approx,tichondrius,1479,druid,restoration,51,24,27
Shapedance,sargeras,1469,druid,restoration,36,16,20
Unpeelable,stormrage,1460,druid,restoration,24,16,8
Psyqobloom,dalaran,1459,druid,restoration,36,19,17
Verkara,stormrage,1452,druid,restoration,76,35,41
Meepø,mugthol,1451,druid,restoration,103,56,47
Cndistance,tichondrius,1447,druid,restoration,54,25,29
Berzz,frostmourne,1439,druid,restoration,100,44,56
Sxlanderx,malganis,1438,druid,restoration,51,27,24
Drøgbä,tichondrius,1436,druid,restoration,24,15,9
Petmydeadcow,illidan,1436,druid,restoration,63,35,28
Vuru,azralon,1432,druid,restoration,72,33,39
Shinjis,tichondrius,1428,druid,restoration,30,15,15
Strokingmyd,illidan,1427,druid,restoration,63,31,32
Hyne,emerald-dream,1425,druid,restoration,114,62,52
Horymory,darkspear,1423,druid,restoration,96,51,45
Rwi,tichondrius,1415,druid,restoration,32,18,14
Komaner,frostmourne,1414,druid,restoration,48,21,27
Kaerrort,sargeras,1412,druid,restoration,26,15,11
Bruujz,moon-guard,1402,druid,restoration,36,22,14
Dbk,suramar,1400,druid,restoration,42,28,14
Healingcute,tichondrius,1400,druid,restoration,116,64,52
Biggucci,stonemaul,1399,druid,restoration,30,18,12
Lilbigcow,gnomeregan,1397,druid,restoration,99,34,65
Seizuressld,stormrage,1395,druid,restoration,81,46,35
Prevail,nazgrel,1393,druid,restoration,48,25,23
Ananan,burning-blade,1387,druid,restoration,54,30,24
Classydruid,spinebreaker,1385,druid,restoration,98,48,50
Icastsmells,tichondrius,1381,druid,restoration,57,36,21
Okiesmokied,proudmoore,1378,druid,restoration,30,17,13
Purpleleaves,stormrage,1374,druid,restoration,54,22,32
Riiccflaiir,stormrage,1373,druid,restoration,27,16,11
Azshunara,moon-guard,1369,druid,restoration,84,43,41
Shifftycent,trollbane,1359,druid,restoration,54,26,28
Amandi,magtheridon,1358,druid,restoration,36,20,16
Deamondruidz,kaelthas,1356,druid,restoration,72,27,45
Kergai,emerald-dream,1355,druid,restoration,102,53,49
Melbian,tichondrius,1354,druid,restoration,90,55,35
Dkfm,thrall,1353,druid,restoration,77,40,37
Onblue,tichondrius,1347,druid,restoration,38,22,16
Nestaballo,illidan,1343,druid,restoration,58,32,26
Flóp,dalaran,1343,druid,restoration,30,14,16
Liangpibro,illidan,1342,druid,restoration,24,14,10
Socialyst,area-52,1342,druid,restoration,24,14,10
Romcom,demon-soul,1341,druid,restoration,30,21,9
Groschats,area-52,1339,druid,restoration,42,14,28
Ripberg,chogall,1338,druid,restoration,30,14,16
Remus,hydraxis,1338,druid,restoration,30,14,16
Cznfik,area-52,1338,druid,restoration,78,32,46
Anchunlol,tichondrius,1332,druid,restoration,36,18,18
Pilcosbie,stormrage,1327,druid,restoration,24,14,10
Gladelf,sargeras,1323,druid,restoration,136,70,66
Greylyth,moon-guard,1323,druid,restoration,36,15,21
Joopsy,tichondrius,1321,druid,restoration,130,71,59
Jimjab,stormreaver,1319,druid,restoration,36,23,13
Nanniel,tichondrius,1318,druid,restoration,30,14,16
Haymade,sargeras,1314,druid,restoration,36,15,21
Zelyvia,moon-guard,1313,druid,restoration,24,14,10
Freehealjob,lightnings-blade,1313,druid,restoration,30,14,16
Kzinti,zuluhed,1312,druid,restoration,30,14,16
Amatxu,ragnaros,1311,druid,restoration,72,38,34
Donnà,tichondrius,1310,druid,restoration,43,21,22
Farmageddon,thunderhorn,1309,druid,restoration,30,18,12
Speaks,moon-guard,1309,druid,restoration,29,15,14
Mudpi,illidan,1307,druid,restoration,65,30,35
Kerrzo,frostmourne,1297,druid,restoration,24,14,10
Caustìk,malganis,1295,druid,restoration,30,18,12
Plagiarist,stormrage,1295,druid,restoration,44,20,24
Xzerhos,area-52,1290,druid,restoration,94,44,50
Groõt,barthilas,1284,druid,restoration,48,18,30
Lauramavra,azralon,1274,druid,restoration,26,17,9
Odcerberus,azralon,1267,druid,restoration,36,18,18
Widescreen,burning-blade,1265,druid,restoration,95,43,52
Tallenzz,lightninghoof,1257,druid,restoration,91,50,41
Longisland,quelthalas,1257,druid,restoration,65,34,31
Cuddles,moon-guard,1257,druid,restoration,109,48,61
Shekelsnätch,area-52,1256,druid,restoration,30,16,14
Jacknit,illidan,1250,druid,restoration,28,15,13
Phåtkid,darkspear,1250,druid,restoration,36,15,21
Tìssuebox,malganis,1249,druid,restoration,57,25,32
Druidnim,tichondrius,1249,druid,restoration,48,15,33
Ninzor,tichondrius,1247,druid,restoration,30,13,17
Ziegey,tichondrius,1246,druid,restoration,24,13,11
Ellystarry,stormrage,1244,druid,restoration,24,13,11
Nxghtfall,tichondrius,1244,druid,restoration,42,22,20
Svarne,kiljaeden,1243,druid,restoration,30,16,14
Goosebümps,stormrage,1242,druid,restoration,24,13,11
Magicrock,moon-guard,1242,druid,restoration,30,16,14
Leleoceo,azralon,1239,druid,restoration,18,13,5
Feldstarx,stormrage,1238,druid,restoration,24,13,11
Rlzdruid,tichondrius,1238,druid,restoration,30,13,17
Moonyy,emerald-dream,1235,druid,restoration,30,13,17
Thericebags,illidan,1232,druid,restoration,103,56,47
Smilax,eonar,1231,druid,restoration,71,29,42
Imakitty,aerie-peak,1226,druid,restoration,121,62,59
Carneluna,area-52,1226,druid,restoration,66,31,35
Wildwhisper,moon-guard,1225,druid,restoration,96,50,46
Katherine,moon-guard,1220,druid,restoration,78,35,43
Druidkingdk,stormrage,1218,druid,restoration,29,18,11
Skotty,hyjal,1217,druid,restoration,24,13,11
Ännä,moon-guard,1217,druid,restoration,30,13,17
Jonculler,korgath,1214,druid,restoration,36,16,20
Ulfaren,frostmourne,1209,druid,restoration,24,15,9
Driftwood,bonechewer,1203,druid,restoration,42,16,26
Meôwmix,stormrage,1202,druid,restoration,24,13,11
Bikacat,kelthuzad,1200,druid,restoration,24,13,11
Schlotzsky,skullcrusher,1196,druid,restoration,63,36,27
Toslick,kelthuzad,1193,druid,restoration,39,18,21
Gossìpgoat,frostmourne,1191,druid,restoration,80,38,42
Gorillagloo,area-52,1190,druid,restoration,31,14,17
Ahylen,quelthalas,1188,druid,restoration,48,22,26
Suye,tichondrius,1188,druid,restoration,54,22,32
Greenvibes,drakkari,1187,druid,restoration,36,20,16
Furfu,illidan,1187,druid,restoration,44,22,22
Fatshift,chogall,1186,druid,restoration,48,25,23
Adarindre,aerie-peak,1185,druid,restoration,93,46,47
Pawpurrazzi,moon-guard,1183,druid,restoration,17,13,4
Cowtox,moon-guard,1178,druid,restoration,29,15,14
Mf,stormscale,1171,druid,restoration,30,14,16
Whispurrz,tichondrius,1170,druid,restoration,93,51,42
Matpd,norgannon,1170,druid,restoration,106,50,56
Chowyunfats,proudmoore,1165,druid,restoration,202,102,100
Sinseir,stormscale,1164,druid,restoration,58,22,36
Veganz,moon-guard,1163,druid,restoration,100,48,52
Smhyle,frostmourne,1162,druid,restoration,23,13,10
Yellowstone,drakthul,1162,druid,restoration,30,15,15
Lenori,vashj,1159,druid,restoration,48,24,24
Kasannaommi,sargeras,1157,druid,restoration,42,22,20
Würzel,nemesis,1156,druid,restoration,60,30,30
Dchizzle,tichondrius,1156,druid,restoration,33,15,18
Izzabelle,deathwing,1154,druid,restoration,19,13,6
Doah,kelthuzad,1152,druid,restoration,24,12,12
Spiritot,tichondrius,1152,druid,restoration,24,12,12
Dancesdru,area-52,1151,druid,restoration,24,12,12
Jonnygg,illidan,1151,druid,restoration,30,12,18
Taaienberg,sargeras,1151,druid,restoration,30,12,18
Vesoween,tichondrius,1150,druid,restoration,22,13,9
Kaperij,sargeras,1150,druid,restoration,24,12,12
Enrÿu,nemesis,1149,druid,restoration,30,12,18
Mommymilkers,jubeithos,1149,druid,restoration,54,14,40
Skibbidy,boulderfist,1145,druid,restoration,33,14,19
Busanmilk,tichondrius,1144,druid,restoration,24,12,12
Jijunss,tichondrius,1137,druid,restoration,23,13,10
Müfasä,azralon,1131,druid,restoration,48,23,25
Entydruid,khazgoroth,1128,druid,restoration,23,13,10
Foxbear,garona,1121,druid,restoration,27,21,6
Hotkage,tichondrius,1120,druid,restoration,18,12,6
Caipirinha,tichondrius,1118,druid,restoration,23,12,11
Jruids,stormrage,1111,druid,restoration,36,12,24
Clawriander,barthilas,1110,druid,restoration,71,37,34
Katdog,warsong,1109,druid,restoration,33,22,11
Pmsprone,tichondrius,1109,druid,restoration,30,17,13
Junglefists,frostmourne,1109,druid,restoration,48,19,29
Iambeefy,hyjal,1108,druid,restoration,101,47,54
Maddoxi,stormrage,1106,druid,restoration,30,12,18
Yourka,uther,1099,druid,restoration,26,14,12
Skymund,tichondrius,1095,druid,restoration,38,19,19
Alfurr,tichondrius,1091,druid,restoration,61,35,26
Kittne,hellscream,1089,druid,restoration,48,24,24
Vollzar,sargeras,1072,druid,restoration,38,14,24
Baduret,dalaran,1067,druid,restoration,19,12,7
Gimborion,stormrage,1066,druid,restoration,48,23,25
Macdonah,tichondrius,1064,druid,restoration,18,13,5
Hðthead,area-52,1064,druid,restoration,36,16,20
Agranock,nazgrel,1063,druid,restoration,40,21,19
Buffalobillz,lethon,1062,druid,restoration,40,25,15
Bobd,proudmoore,1056,druid,restoration,18,11,7
Whhm,burning-blade,1056,druid,restoration,24,11,13
Bigtimers,illidan,1056,druid,restoration,24,11,13
Poscod,tichondrius,1055,druid,restoration,18,11,7
Vecuronium,tichondrius,1055,druid,restoration,18,11,7
Boomtastik,frostmourne,1055,druid,restoration,24,11,13
Goodhealer,akama,1054,druid,restoration,42,26,16
Valeñtine,dalaran,1054,druid,restoration,48,19,29
Áçxpërt,jubeithos,1052,druid,restoration,18,11,7
Israh,malygos,1052,druid,restoration,26,15,11
Samerax,vashj,1052,druid,restoration,21,12,9
Yorch,stormrage,1052,druid,restoration,60,28,32
Rhatir,stormrage,1051,druid,restoration,35,12,23
Phxburn,illidan,1050,druid,restoration,30,11,19
Eredorn,darkspear,1049,druid,restoration,24,18,6
Sodury,tichondrius,1049,druid,restoration,48,25,23
Anothersalad,stormrage,1047,druid,restoration,48,23,25
Zadayos,aerie-peak,1044,druid,restoration,30,16,14
Druilicious,ghostlands,1043,druid,restoration,55,27,28
Nanate,sargeras,1041,druid,restoration,18,11,7
Cratose,runetotem,1040,druid,restoration,35,15,20
Jimmycooks,tichondrius,1039,druid,restoration,18,11,7
Beladrexx,stormrage,1035,druid,restoration,30,11,19
Rivetrix,azralon,1032,druid,restoration,85,43,42
Fionnbharr,ragnaros,1031,druid,restoration,76,35,41
Edraen,zuljin,1031,druid,restoration,59,24,35
Imcop,tichondrius,1020,druid,restoration,18,11,7
Yakuho,proudmoore,1006,druid,restoration,20,12,8
Katochi,area-52,1006,druid,restoration,30,16,14
Sonrius,proudmoore,1006,druid,restoration,30,13,17
Sharinna,andorhal,1005,druid,restoration,32,12,20
Yeahhots,frostmourne,1000,druid,restoration,15,12,3
Mainera,sargeras,1000,druid,restoration,26,12,14
Slleep,tichondrius,999,druid,restoration,24,12,12
Bethemarble,sargeras,996,druid,restoration,29,16,13
Treewik,emerald-dream,989,druid,restoration,61,35,26
Feralgød,tichondrius,985,druid,restoration,30,11,19
Iheartmushu,mannoroth,983,druid,restoration,51,31,20
Lawlz,aegwynn,976,druid,restoration,24,13,11
Wiggle,stormscale,962,druid,restoration,44,21,23
Soreze,kelthuzad,960,druid,restoration,12,10,2
Bemelerberg,sargeras,960,druid,restoration,18,10,8
Hideurchickn,tichondrius,959,druid,restoration,12,10,2
Douwantoplay,tichondrius,959,druid,restoration,18,10,8
Garbagebutt,burning-legion,959,druid,restoration,18,10,8
Kurrious,frostmourne,959,druid,restoration,24,10,14
Blueclàssxx,akama,958,druid,restoration,12,10,2
Ñoobdruid,tichondrius,956,druid,restoration,18,10,8
Lorca,stormrage,955,druid,restoration,12,10,2
Seamandeman,sargeras,954,druid,restoration,24,10,14
Pronewb,frostmourne,952,druid,restoration,12,10,2
Hruke,illidan,952,druid,restoration,18,10,8
Bovindickus,tichondrius,952,druid,restoration,24,10,14
Fortnitburgr,tichondrius,951,druid,restoration,18,10,8
Keladria,bleeding-hollow,950,druid,restoration,54,27,27
Guron,aegwynn,949,druid,restoration,47,23,24
Slév,frostmourne,946,druid,restoration,24,10,14
Maxobviously,stormrage,942,druid,restoration,18,10,8
Kg,cenarion-circle,941,druid,restoration,28,13,15
Shiftaholic,azgalor,940,druid,restoration,33,17,16
Drucaicer,quelthalas,939,druid,restoration,71,38,33
Kataless,sargeras,936,druid,restoration,71,37,34
Minokawa,kargath,917,druid,restoration,23,10,13
Meniscus,arthas,910,druid,restoration,29,10,19
Bindudream,frostmane,907,druid,restoration,18,10,8
Mengyu,tichondrius,905,druid,restoration,22,12,10
Gromdruid,azralon,903,druid,restoration,44,22,22
Vengaul,amanthul,892,druid,restoration,24,10,14
Yoshí,emerald-dream,877,druid,restoration,21,11,10
Theboy,dalaran,876,druid,restoration,42,13,29
Duo,demon-soul,864,druid,restoration,12,9,3
Spikeleaf,tichondrius,864,druid,restoration,12,9,3
Dendrix,area-52,864,druid,restoration,12,9,3
Rekelberg,sargeras,864,druid,restoration,12,9,3
Mmrborrower,icecrown,864,druid,restoration,18,9,9
Ymy,tichondrius,864,druid,restoration,18,9,9
Tokesh,malganis,864,druid,restoration,18,9,9
Rawbacon,blackrock,864,druid,restoration,25,9,16
Luckyslot,frostmourne,863,druid,restoration,18,9,9
Chocoo,thaurissan,862,druid,restoration,18,9,9
Slev,frostmourne,861,druid,restoration,18,9,9
Alindrä,moon-guard,861,druid,restoration,18,9,9
Standee,sargeras,861,druid,restoration,30,9,21
Torofarmeon,quelthalas,854,druid,restoration,18,9,9
Faroo,azralon,854,druid,restoration,24,9,15
Moolan,bleeding-hollow,852,druid,restoration,20,11,9
Dobidas,tichondrius,847,druid,restoration,18,9,9
Barugaf,drakkari,846,druid,restoration,19,10,9
Kanadae,thrall,846,druid,restoration,24,9,15
Uwupollo,ragnaros,846,druid,restoration,42,13,29
Fronkysilva,illidan,838,druid,restoration,48,19,29
Swiftydel,frostmourne,807,druid,restoration,22,11,11
Stamynn,kelthuzad,807,druid,restoration,72,23,49
Elauria,stormreaver,804,druid,restoration,42,17,25
Merawr,arygos,800,druid,restoration,16,9,7
Sùlyvahn,tichondrius,798,druid,restoration,22,9,13
Ppbdru,tichondrius,768,druid,restoration,12,8,4
Ppm,illidan,768,druid,restoration,12,8,4
Germlol,sargeras,768,druid,restoration,12,8,4
Aljalladtv,bleeding-hollow,768,druid,restoration,12,8,4
Chinadruids,tichondrius,768,druid,restoration,12,8,4
Albafic,illidan,768,druid,restoration,12,8,4
Chinadruides,tichondrius,768,druid,restoration,12,8,4
Zrobloom,stormrage,768,druid,restoration,18,8,10
Alend,alexstrasza,767,druid,restoration,12,8,4
Maeo,drenden,767,druid,restoration,12,8,4
Arwëna,tichondrius,767,druid,restoration,12,8,4
Santiagowski,ragnaros,767,druid,restoration,12,8,4
Thetakeout,tichondrius,767,druid,restoration,18,8,10
Durintor,nemesis,767,druid,restoration,18,8,10
Ohhshiift,tichondrius,766,druid,restoration,18,8,10
Imnotinhuman,tichondrius,765,druid,restoration,12,8,4
Slee,eredar,764,druid,restoration,12,8,4
Travys,sargeras,764,druid,restoration,18,8,10
Needabandaid,arthas,764,druid,restoration,24,8,16
Afonso,frostmourne,763,druid,restoration,18,8,10
Wp,proudmoore,762,druid,restoration,18,8,10
Blitzÿ,lothar,761,druid,restoration,12,8,4
Darksteak,tichondrius,759,druid,restoration,24,8,16
Rhondarootsy,zuljin,756,druid,restoration,18,8,10
Kitnip,proudmoore,753,druid,restoration,12,8,4
Xxuan,tichondrius,748,druid,restoration,50,10,40
Friarpuck,nerzhul,747,druid,restoration,12,8,4
Ojdidnt,bleeding-hollow,720,druid,restoration,15,9,6
Rdruidchump,the-forgotten-coast,719,druid,restoration,15,9,6
Xîstance,barthilas,717,druid,restoration,23,8,15
Whiskeyblues,ursin,706,druid,restoration,24,8,16
Ourse,frostmourne,702,druid,restoration,11,8,3
Lutzenberger,nemesis,692,druid,restoration,28,9,19
Treeofangels,nathrezim,672,druid,restoration,12,7,5
Druinin,archimonde,672,druid,restoration,12,7,5
Rbavny,tichondrius,672,druid,restoration,12,7,5
Faramar,sargeras,672,druid,restoration,12,7,5
Yungdoinkski,icecrown,672,druid,restoration,12,7,5
Motate,malganis,672,druid,restoration,12,7,5
Delody,tichondrius,672,druid,restoration,12,7,5
Udoyu,barthilas,672,druid,restoration,18,7,11
Zblmystic,tichondrius,672,druid,restoration,18,7,11
Kobrah,twisting-nether,672,druid,restoration,18,7,11
Tweeguy,malganis,672,druid,restoration,18,7,11
Wùúkìí,bleeding-hollow,672,druid,restoration,24,7,17
Jathy,area-52,672,druid,restoration,24,7,17
Maaui,sargeras,671,druid,restoration,12,7,5
Kevarcen,dalaran,671,druid,restoration,12,7,5
Zthatchx,shadowmoon,671,druid,restoration,12,7,5
Hehaw,kelthuzad,671,druid,restoration,12,7,5
Chixao,tichondrius,671,druid,restoration,12,7,5
Trolbearpig,malganis,671,druid,restoration,12,7,5
Wildarumqt,tichondrius,671,druid,restoration,18,7,11
Airmíd,illidan,671,druid,restoration,30,7,23
Shanê,proudmoore,670,druid,restoration,12,7,5
Lindi,kelthuzad,670,druid,restoration,12,7,5
Concordya,tichondrius,670,druid,restoration,12,7,5
Santicow,ragnaros,670,druid,restoration,12,7,5
Kyndel,kiljaeden,670,druid,restoration,12,7,5
Wreckked,sargeras,670,druid,restoration,18,7,11
Dokasaurus,lightbringer,670,druid,restoration,18,7,11
Frave,dentarg,670,druid,restoration,24,7,17
Battiatus,malganis,669,druid,restoration,18,7,11
Esyiix,tichondrius,668,druid,restoration,24,7,17
Mïms,area-52,667,druid,restoration,12,7,5
Cannabull,echo-isles,665,druid,restoration,18,7,11
Gotdruid,sargeras,639,druid,restoration,14,8,6
Riddickd,malfurion,639,druid,restoration,14,8,6
Warmkitteh,kiljaeden,639,druid,restoration,17,7,10
Breathe,ysera,639,druid,restoration,28,7,21
Rígo,frostmourne,622,druid,restoration,15,8,7
Bobruid,nagrand,619,druid,restoration,15,8,7
Midoriiro,dentarg,612,druid,restoration,25,8,17
Semangarbage,tichondrius,607,druid,restoration,15,8,7
Höneyfang,moon-guard,585,druid,restoration,11,7,4
Moldragon,crushridge,576,druid,restoration,6,6,0
Xiaoyi,tichondrius,576,druid,restoration,6,6,0
Kurohîme,illidan,576,druid,restoration,12,6,6
Nogàrd,arygos,576,druid,restoration,12,6,6
Gsex,nemesis,576,druid,restoration,12,6,6
Gemo,tichondrius,576,druid,restoration,12,6,6
Bearys,area-52,576,druid,restoration,12,6,6
Eraticdruid,illidan,576,druid,restoration,12,6,6
Undaunted,bloodhoof,576,druid,restoration,12,6,6
Afkifuthrow,ysera,576,druid,restoration,12,6,6
Dirtydrood,mugthol,576,druid,restoration,12,6,6
Vernaar,laughing-skull,576,druid,restoration,12,6,6
Rikishi,executus,576,druid,restoration,12,6,6
Torbock,zuljin,576,druid,restoration,12,6,6
Naturenugget,sargeras,576,druid,restoration,12,6,6
Hawtyforever,tichondrius,576,druid,restoration,18,6,12
Opim,sargeras,576,druid,restoration,18,6,12
Vakimumu,anubarak,576,druid,restoration,18,6,12
Wintarz,sargeras,576,druid,restoration,18,6,12
Suublime,ragnaros,576,druid,restoration,18,6,12
Lolomas,proudmoore,576,druid,restoration,18,6,12
Velauris,sargeras,575,druid,restoration,12,6,6
Nrp,stormrage,575,druid,restoration,12,6,6
Cinderellax,illidan,575,druid,restoration,12,6,6
Flôkey,tichondrius,575,druid,restoration,12,6,6
Gosch,stormrage,575,druid,restoration,12,6,6
Kokushe,burning-legion,575,druid,restoration,12,6,6
Skullchief,barthilas,575,druid,restoration,16,7,9
Treynî,tichondrius,575,druid,restoration,18,6,12
Poutyface,sargeras,575,druid,restoration,39,7,32
Elpako,ragnaros,574,druid,restoration,6,6,0
Indicahigh,moon-guard,574,druid,restoration,12,6,6
Astraelas,tichondrius,574,druid,restoration,12,6,6
Aranuir,emerald-dream,574,druid,restoration,18,6,12
Persiancoco,area-52,572,druid,restoration,12,6,6
Vdubz,blackrock,570,druid,restoration,12,6,6
Aokseer,azralon,570,druid,restoration,12,6,6
Nordway,alexstrasza,569,druid,restoration,12,6,6
Bunrÿl,thorium-brotherhood,565,druid,restoration,12,6,6
Lililililil,stormrage,552,druid,restoration,36,6,30
Redharp,proudmoore,547,druid,restoration,24,6,18
Qidzerker,arathor,544,druid,restoration,16,6,10
Cudbacrakhed,tichondrius,541,druid,restoration,20,7,13
Arthemisgodx,azralon,520,druid,restoration,17,10,7
Lâvazza,tichondrius,510,druid,restoration,16,6,10
Brëed,tichondrius,480,druid,restoration,6,5,1
Dëmoníc,ragnaros,480,druid,restoration,6,5,1
Bigmoran,tichondrius,480,druid,restoration,6,5,1
Bopplejr,tichondrius,480,druid,restoration,6,5,1
Chaníng,frostmourne,480,druid,restoration,6,5,1
Fanboy,magtheridon,480,druid,restoration,6,5,1
Yimii,stormrage,480,druid,restoration,6,5,1
Pawsbutton,stormrage,480,druid,restoration,6,5,1
Zemul,ragnaros,480,druid,restoration,6,5,1
Nersepha,gurubashi,480,druid,restoration,6,5,1
Kascatm,area-52,480,druid,restoration,6,5,1
Asaphelps,stormrage,480,druid,restoration,6,5,1
Justforgame,sargeras,480,druid,restoration,6,5,1
Floray,tichondrius,480,druid,restoration,6,5,1
Sevend,tichondrius,480,druid,restoration,6,5,1
Salzadruid,aggramar,480,druid,restoration,6,5,1
Kybecruz,stormrage,480,druid,restoration,12,5,7
Ppb,illidan,480,druid,restoration,12,5,7
Clubroot,sargeras,480,druid,restoration,12,5,7
Lusam,korialstrasz,480,druid,restoration,12,5,7
Hotgoal,frostmourne,480,druid,restoration,12,5,7
Jaydog,emerald-dream,480,druid,restoration,12,5,7
Moonfannia,malganis,480,druid,restoration,12,5,7
Ppbtw,illidan,480,druid,restoration,12,5,7
Binionsolboy,illidan,480,druid,restoration,12,5,7
Sixthsex,tichondrius,480,druid,restoration,12,5,7
Lissette,thrall,480,druid,restoration,12,5,7
Shartah,zuljin,480,druid,restoration,12,5,7
Twentyfour,laughing-skull,480,druid,restoration,12,5,7
Lukass,tichondrius,480,druid,restoration,12,5,7
Guavajuice,stormrage,480,druid,restoration,16,5,11
Djimbo,kelthuzad,480,druid,restoration,18,5,13
Chevy,onyxia,480,druid,restoration,30,5,25
Forest,frostmourne,479,druid,restoration,12,5,7
Xarressian,moon-guard,479,druid,restoration,12,5,7
Murkkd,tichondrius,479,druid,restoration,12,5,7
Anotherstar,frostmourne,479,druid,restoration,24,5,19
Olegoatjames,darkspear,478,druid,restoration,13,6,7
Bäñgarang,tichondrius,478,druid,restoration,12,5,7
Pachacamac,dragonmaw,478,druid,restoration,12,5,7
Bloodyhoofs,malganis,478,druid,restoration,12,5,7
Rònaldò,drakthul,478,druid,restoration,12,5,7
Wraiven,elune,477,druid,restoration,18,5,13
Kaldrago,detheroc,476,druid,restoration,12,5,7
Phlap,zuljin,476,druid,restoration,12,5,7
Dietmilk,sargeras,476,druid,restoration,12,5,7
Chopleaf,khadgar,475,druid,restoration,12,5,7
Judwen,grizzly-hills,475,druid,restoration,18,5,13
Diaks,proudmoore,473,druid,restoration,12,5,7
Ekj,tichondrius,447,druid,restoration,8,6,2
Kellogs,malganis,447,druid,restoration,11,5,6
Bigelbows,area-52,432,druid,restoration,15,6,9
Oongadunga,tichondrius,415,druid,restoration,14,5,9
Krunks,frostmourne,384,druid,restoration,6,4,2
Treelomilo,stormrage,384,druid,restoration,6,4,2
Nøbuchi,kelthuzad,384,druid,restoration,6,4,2
Opiumheals,sargeras,384,druid,restoration,6,4,2
Joeyshiftz,blackrock,384,druid,restoration,6,4,2
Armorkits,area-52,384,druid,restoration,6,4,2
Erû,ragnaros,384,druid,restoration,6,4,2
Druidlstrudl,moon-guard,384,druid,restoration,6,4,2
Woshiyigede,frostmourne,384,druid,restoration,6,4,2
Lylek,azshara,384,druid,restoration,6,4,2
Dzone,tichondrius,384,druid,restoration,6,4,2
Metaindexqt,quelthalas,384,druid,restoration,6,4,2
Crusch,shattered-halls,384,druid,restoration,6,4,2
Zbh,tichondrius,384,druid,restoration,6,4,2
Èmax,barthilas,384,druid,restoration,6,4,2
Lorern,eldrethalas,384,druid,restoration,6,4,2
Shroomdealer,kelthuzad,384,druid,restoration,6,4,2
Bigdockepoch,sargeras,384,druid,restoration,6,4,2
Mastabtw,illidan,384,druid,restoration,12,4,8
Polyester,frostmourne,384,druid,restoration,12,4,8
Bumbally,illidan,384,druid,restoration,12,4,8
Hotrecki,kelthuzad,384,druid,restoration,12,4,8
Calimei,bladefist,384,druid,restoration,12,4,8
Leatherpig,proudmoore,384,druid,restoration,12,4,8
Nocup,illidan,384,druid,restoration,12,4,8
Bwaccowi,sargeras,384,druid,restoration,12,4,8
Flompstomper,skullcrusher,384,druid,restoration,12,4,8
Chickenwings,ragnaros,384,druid,restoration,12,4,8
Sleepypaws,silvermoon,384,druid,restoration,12,4,8
Thebutterboy,stormrage,384,druid,restoration,12,4,8
Lillenan,illidan,384,druid,restoration,12,4,8
Flyshles,frostmourne,384,druid,restoration,12,4,8
Restobaby,tichondrius,384,druid,restoration,12,4,8
Tarvosx,thrall,384,druid,restoration,18,4,14
Xay,runetotem,383,druid,restoration,12,4,8
Pahrump,stormrage,383,druid,restoration,12,4,8
Posmard,ragnaros,383,druid,restoration,12,4,8
Jonnyutaa,emerald-dream,383,druid,restoration,12,4,8
Vantorsydmel,proudmoore,383,druid,restoration,12,4,8
Nightflow,emerald-dream,383,druid,restoration,12,4,8
Madmandan,moon-guard,383,druid,restoration,18,4,14
Rikey,thaurissan,383,druid,restoration,18,4,14
Seceru,proudmoore,382,druid,restoration,6,4,2
Puzzlè,thrall,382,druid,restoration,12,4,8
Guojue,tichondrius,382,druid,restoration,12,4,8
Maldrake,quelthalas,381,druid,restoration,12,4,8
Certzu,moon-guard,381,druid,restoration,18,4,14
Breakthemm,bonechewer,379,druid,restoration,12,4,8
Metamooseowl,crushridge,379,druid,restoration,12,4,8
Møøncry,ragnaros,377,druid,restoration,22,10,12
Nerfmesoon,sargeras,367,druid,restoration,11,4,7
Zoeyx,tichondrius,330,druid,restoration,7,5,2
Felinedreams,sargeras,330,druid,restoration,8,5,3
Elvishchamp,mugthol,319,druid,restoration,6,4,2
Gairen,the-venture-co,318,druid,restoration,8,4,4
Monkeyxo,kelthuzad,288,druid,restoration,6,3,3
Hashdxm,tichondrius,288,druid,restoration,6,3,3
Gloomster,tichondrius,288,druid,restoration,6,3,3
Razberriesz,stormrage,288,druid,restoration,6,3,3
Antonniel,azralon,288,druid,restoration,6,3,3
Mädnhairy,zuljin,288,druid,restoration,6,3,3
Druxe,zuljin,288,druid,restoration,6,3,3
Azaran,bleeding-hollow,288,druid,restoration,6,3,3
Disembles,illidan,288,druid,restoration,6,3,3
Wythrim,quelthalas,288,druid,restoration,6,3,3
Creamsoda,frostmane,288,druid,restoration,6,3,3
Omelet,tichondrius,288,druid,restoration,6,3,3
Naturetazer,sargeras,288,druid,restoration,6,3,3
Hazbekbek,area-52,288,druid,restoration,6,3,3
Lifebloomlol,area-52,288,druid,restoration,6,3,3
Nokash,tichondrius,288,druid,restoration,6,3,3
Smeekqtwo,tichondrius,288,druid,restoration,6,3,3
Koratan,frostmourne,288,druid,restoration,6,3,3
Hugharection,illidan,288,druid,restoration,6,3,3
Louisvuittón,area-52,288,druid,restoration,6,3,3
Kcazz,thorium-brotherhood,288,druid,restoration,6,3,3
Cutefeetz,moon-guard,288,druid,restoration,6,3,3
Noah,altar-of-storms,288,druid,restoration,6,3,3
Ayra,sargeras,288,druid,restoration,6,3,3
Bobobear,proudmoore,288,druid,restoration,6,3,3
Quss,tichondrius,288,druid,restoration,6,3,3
Erykk,dalaran,288,druid,restoration,6,3,3
Vadroid,dalaran,288,druid,restoration,6,3,3
Eryon,nemesis,288,druid,restoration,6,3,3
Vìdá,tichondrius,288,druid,restoration,6,3,3
Cameltail,kelthuzad,288,druid,restoration,6,3,3
Taiwanzz,tichondrius,288,druid,restoration,6,3,3
Elylaylalar,moon-guard,288,druid,restoration,6,3,3
Lðhnar,malganis,288,druid,restoration,6,3,3
Gizho,dark-iron,288,druid,restoration,6,3,3
Dunedaddy,silvermoon,288,druid,restoration,6,3,3
Mythicdruid,ragnaros,288,druid,restoration,6,3,3
Tondrai,malganis,288,druid,restoration,6,3,3
Lookhowirun,emerald-dream,288,druid,restoration,6,3,3
Càlthar,sargeras,288,druid,restoration,6,3,3
Ðeepsixx,burning-legion,288,druid,restoration,6,3,3
Spinach,moon-guard,288,druid,restoration,6,3,3
Wâggles,moon-guard,288,druid,restoration,6,3,3
Ømí,quelthalas,288,druid,restoration,6,3,3
Pekingcuckoo,illidan,288,druid,restoration,6,3,3
Reptile,terenas,288,druid,restoration,6,3,3
Overgrowth,zuljin,288,druid,restoration,9,3,6
Quadrivium,stormrage,288,druid,restoration,12,3,9
Oinkme,kiljaeden,288,druid,restoration,12,3,9
Theømega,stormrage,288,druid,restoration,12,3,9
Kanokoho,wyrmrest-accord,288,druid,restoration,12,3,9
Cybeé,sargeras,288,druid,restoration,12,3,9
Sbc,anvilmar,288,druid,restoration,12,3,9
Deyz,ysera,288,druid,restoration,12,3,9
Bøo,frostmourne,288,druid,restoration,12,3,9
Blacksimba,area-52,288,druid,restoration,12,3,9
Monicaduan,frostmourne,288,druid,restoration,12,3,9
Hoedrufroza,tichondrius,288,druid,restoration,12,3,9
Qdrui,tichondrius,288,druid,restoration,12,3,9
Dipset,khadgar,288,druid,restoration,12,3,9
Mattiu,area-52,288,druid,restoration,12,3,9
Martymoo,bleeding-hollow,288,druid,restoration,18,3,15
Giddeonv,draenor,288,druid,restoration,18,3,15
Beecammy,frostmourne,287,druid,restoration,6,3,3
Xkcc,perenolde,287,druid,restoration,6,3,3
Sefestria,senjin,287,druid,restoration,6,3,3
Breakertime,illidan,287,druid,restoration,6,3,3
Cloudbreaker,duskwood,287,druid,restoration,6,3,3
Vulgär,kiljaeden,287,druid,restoration,12,3,9
Fatjoints,tichondrius,287,druid,restoration,18,3,15
Bullshiftter,ursin,286,druid,restoration,6,3,3
Fortunecat,illidan,286,druid,restoration,12,3,9
Anastasyiar,illidan,256,druid,restoration,10,3,7
Worgbearpig,destromath,239,druid,restoration,5,3,2
Awkwarder,emerald-dream,239,druid,restoration,5,3,2
Stèvén,tichondrius,233,druid,restoration,13,4,9
Gavdru,tichondrius,223,druid,restoration,8,3,5
Faentz,stormrage,192,druid,restoration,9,3,6
Nodeathz,sargeras,192,druid,restoration,6,2,4
Akinetic,illidan,192,druid,restoration,6,2,4
Duxz,tichondrius,192,druid,restoration,6,2,4
Tickman,altar-of-storms,192,druid,restoration,6,2,4
Chopotron,ragnaros,192,druid,restoration,6,2,4
Loved,stormrage,192,druid,restoration,6,2,4
Tropikana,burning-legion,192,druid,restoration,6,2,4
Hughcockman,tichondrius,192,druid,restoration,6,2,4
Hedwíg,ragnaros,192,druid,restoration,6,2,4
Megasteak,lightninghoof,192,druid,restoration,6,2,4
Stetile,azralon,192,druid,restoration,6,2,4
Sweetcorn,malganis,192,druid,restoration,6,2,4
Theblind,korgath,192,druid,restoration,6,2,4
Droody,earthen-ring,192,druid,restoration,6,2,4
Kroshape,stormrage,192,druid,restoration,6,2,4
Uggadruid,malganis,192,druid,restoration,6,2,4
Gretatunberg,skywall,192,druid,restoration,6,2,4
Levincy,thrall,192,druid,restoration,6,2,4
Fracxx,area-52,192,druid,restoration,6,2,4
Saltyzz,tichondrius,192,druid,restoration,6,2,4
Janzak,thrall,192,druid,restoration,6,2,4
Floofi,kelthuzad,192,druid,restoration,6,2,4
Fixn,tichondrius,192,druid,restoration,6,2,4
Barkcheeks,area-52,192,druid,restoration,6,2,4
Imlordgumper,illidan,192,druid,restoration,6,2,4
Tadoo,tichondrius,192,druid,restoration,6,2,4
Ambassador,kelthuzad,192,druid,restoration,6,2,4
Cultnelf,illidan,192,druid,restoration,6,2,4
Psycloned,magtheridon,192,druid,restoration,6,2,4
Bekroh,crushridge,192,druid,restoration,6,2,4
Ghostti,stormrage,192,druid,restoration,6,2,4
Markóla,stormrage,192,druid,restoration,6,2,4
Awguseon,proudmoore,192,druid,restoration,6,2,4
Fastyhands,illidan,192,druid,restoration,6,2,4
Cauroth,azralon,192,druid,restoration,6,2,4
Clonkzy,area-52,192,druid,restoration,6,2,4
Goorybud,tichondrius,192,druid,restoration,6,2,4
Mcbeef,tichondrius,192,druid,restoration,6,2,4
Tempesd,stormrage,192,druid,restoration,6,2,4
Bigtonkatruk,tichondrius,192,druid,restoration,6,2,4
Kaisuckslol,stormrage,192,druid,restoration,6,2,4
Aurajin,spinebreaker,192,druid,restoration,6,2,4
Snugglin,kelthuzad,192,druid,restoration,6,2,4
Acexten,tichondrius,192,druid,restoration,6,2,4
Hawtzi,stormrage,192,druid,restoration,6,2,4
Kagekuma,bleeding-hollow,192,druid,restoration,6,2,4
Owlgz,barthilas,192,druid,restoration,6,2,4
Judar,barthilas,192,druid,restoration,6,2,4
Dankcentral,frostwolf,192,druid,restoration,10,3,7
Trèè,frostmane,192,druid,restoration,12,2,10
Morphiius,archimonde,192,druid,restoration,12,2,10
Kittysnuggle,emerald-dream,192,druid,restoration,12,2,10
Moocka,ragnaros,192,druid,restoration,12,2,10
Brisketmre,dalaran,192,druid,restoration,12,2,10
Rootslayer,tichondrius,192,druid,restoration,12,2,10
Maggiee,arthas,192,druid,restoration,12,2,10
Aelena,whisperwind,192,druid,restoration,12,2,10
Elven,frostmourne,192,druid,restoration,12,2,10
Moonkay,tichondrius,192,druid,restoration,12,2,10
Cpksdru,tichondrius,192,druid,restoration,12,2,10
Urhero,sargeras,192,druid,restoration,12,2,10
Clonemunster,frostmourne,192,druid,restoration,18,2,16
Brutalhealz,aegwynn,192,druid,restoration,18,2,16
Irontree,dunemaul,192,druid,restoration,18,2,16
Alphalemon,ragnaros,192,druid,restoration,21,2,19
Fovoss,dalaran,191,druid,restoration,6,2,4
Äbÿss,tichondrius,191,druid,restoration,6,2,4
Voodooshiftz,emerald-dream,191,druid,restoration,12,2,10
Dreamwalk,stormrage,175,druid,restoration,17,3,14
Brbcatsonfir,malganis,175,druid,restoration,22,3,19
Pvptactician,tichondrius,159,druid,restoration,11,4,7
Frenzymoon,zuljin,144,druid,restoration,3,3,0
Galind,rexxar,128,druid,restoration,4,2,2
Dotdmage,tichondrius,96,druid,restoration,6,1,5
Atagoo,tichondrius,96,druid,restoration,6,1,5
Beldiin,khazgoroth,96,druid,restoration,6,1,5
Ånxiety,skullcrusher,96,druid,restoration,6,1,5
Hellshifterr,tichondrius,96,druid,restoration,6,1,5
Starkraven,firetree,96,druid,restoration,6,1,5
Guap,bleeding-hollow,96,druid,restoration,6,1,5
Jayto,frostmourne,96,druid,restoration,6,1,5
Caminanube,quelthalas,96,druid,restoration,6,1,5
Natürëblÿät,illidan,96,druid,restoration,6,1,5
Atillah,stormscale,96,druid,restoration,6,1,5
Ddizz,cairne,96,druid,restoration,6,1,5
Kuaite,azralon,96,druid,restoration,6,1,5
Ttaure,ragnaros,96,druid,restoration,6,1,5
Arienne,kelthuzad,96,druid,restoration,6,1,5
Ðjx,stormrage,96,druid,restoration,6,1,5
Feralgo,tichondrius,96,druid,restoration,6,1,5
Wotermelon,moon-guard,96,druid,restoration,6,1,5
Mollytonasty,demon-soul,96,druid,restoration,6,1,5
Tworax,frostmourne,96,druid,restoration,6,1,5
Carlosd,tichondrius,96,druid,restoration,6,1,5
Solá,skywall,96,druid,restoration,6,1,5
Chomperz,tichondrius,96,druid,restoration,6,1,5
Iamanoob,sargeras,96,druid,restoration,6,1,5
Fartsicle,lightnings-blade,96,druid,restoration,6,1,5
Macfluff,emerald-dream,96,druid,restoration,6,1,5
Rockmeifucan,greymane,96,druid,restoration,6,1,5
Lirilith,shadowsong,96,druid,restoration,16,2,14
Foracus,sargeras,96,druid,restoration,11,1,10
Shebleeder,aegwynn,96,druid,restoration,11,1,10
Sinigang,duskwood,96,druid,restoration,12,1,11
Vondutch,tichondrius,96,druid,restoration,18,1,17
Grakzul,blood-furnace,95,druid,restoration,9,2,7
Aaughh,sargeras,79,druid,restoration,5,1,4
Pownage,kelthuzad,64,druid,restoration,16,1,15
Smorak,area-52,63,druid,restoration,2,2,0
Neferpitou,fenris,16,druid,restoration,6,1,5
Landro,tichondrius,1562,druid,guardian,30,19,11
Haalls,gallywix,1107,druid,guardian,36,12,24
Crashägásm,proudmoore,1062,druid,guardian,30,15,15
Multivar,burning-legion,669,druid,guardian,12,7,5
Agmukar,wyrmrest-accord,659,druid,guardian,12,7,5
Giddeonv,draenor,570,druid,guardian,12,6,6
Koan,proudmoore,480,druid,guardian,12,5,7
Balanah,quelthalas,472,druid,guardian,15,6,9
Kesagake,feathermoon,383,druid,guardian,6,4,2
Mordu,rivendare,383,druid,guardian,12,4,8
Cayinna,altar-of-storms,288,druid,guardian,12,3,9
Manwool,illidan,288,druid,guardian,12,3,9
Deutschland,whisperwind,288,druid,guardian,12,3,9
Woozydruid,anetheron,288,druid,guardian,12,3,9
Mavren,uldaman,286,druid,guardian,6,3,3
Maraliss,shadowsong,286,druid,guardian,6,3,3
Athious,moon-guard,192,druid,guardian,6,2,4
Aurno,queldorei,96,druid,guardian,6,1,5
Vindecca,kelthuzad,96,druid,guardian,6,1,5
Wintarz,sargeras,96,druid,guardian,6,1,5
Kylysea,dalaran,96,druid,guardian,12,1,11
Lakroz,zuljin,95,druid,guardian,6,1,5
Auntsusie,stormrage,2128,druid,feral,95,61,34
Iinkinbio,alleria,2124,druid,feral,84,50,34
Nyç,sargeras,2031,druid,feral,153,80,73
Crunchyroll,sargeras,2020,druid,feral,96,51,45
Boomboombom,tichondrius,1999,druid,feral,77,49,28
Loser,stormrage,1985,druid,feral,69,35,34
Yukjr,stormrage,1981,druid,feral,59,32,27
Bawbe,lightbringer,1967,druid,feral,59,36,23
Amellies,quelthalas,1967,druid,feral,88,49,39
Marvin,stormreaver,1961,druid,feral,60,32,28
Fappywapple,kiljaeden,1948,druid,feral,62,32,30
Abstractf,sargeras,1941,druid,feral,44,29,15
Formrage,jubeithos,1938,druid,feral,59,31,28
Russiaguy,area-52,1900,druid,feral,241,129,112
Samuel,ravencrest,1897,druid,feral,60,33,27
Stellar,steamwheedle-cartel,1896,druid,feral,84,42,42
Pdfilewatch,stormrage,1872,druid,feral,36,26,10
Beomjun,tichondrius,1866,druid,feral,65,34,31
Darmari,quelthalas,1852,druid,feral,60,27,33
Notapn,tichondrius,1827,druid,feral,66,35,31
Feignxd,emerald-dream,1823,druid,feral,60,43,17
Nuadris,azralon,1822,druid,feral,168,86,82
Hugecat,tichondrius,1812,druid,feral,60,26,34
Feeg,sargeras,1808,druid,feral,53,25,28
Icespicè,tichondrius,1794,druid,feral,66,30,36
Porkloafed,illidan,1770,druid,feral,36,22,14
Proudfurryxo,dragonmaw,1765,druid,feral,50,27,23
Jaguar,whisperwind,1745,druid,feral,42,25,17
Lemön,frostmourne,1745,druid,feral,42,21,21
Sappora,illidan,1741,druid,feral,148,74,74
Killuf,quelthalas,1739,druid,feral,53,22,31
Blrr,sargeras,1730,druid,feral,54,25,29
Durwyn,sargeras,1725,druid,feral,51,26,25
Trìckyz,tichondrius,1723,druid,feral,46,26,20
Yavà,tichondrius,1700,druid,feral,48,30,18
Alleae,stormrage,1688,druid,feral,30,20,10
Oldtomcat,moon-guard,1683,druid,feral,66,33,33
Nitetree,thrall,1679,druid,feral,60,31,29
Bpdferal,stormrage,1673,druid,feral,121,63,58
Lucky,destromath,1666,druid,feral,84,39,45
Bigbite,tichondrius,1663,druid,feral,36,22,14
Chrye,tichondrius,1661,druid,feral,33,23,10
Wildfire,nesingwary,1659,druid,feral,87,45,42
Chasertv,tichondrius,1650,druid,feral,36,19,17
Kyoski,moon-guard,1645,druid,feral,34,19,15
Xyphor,bladefist,1637,druid,feral,40,22,18
Franksuba,windrunner,1635,druid,feral,78,40,38
Luvgames,area-52,1631,druid,feral,38,22,16
Addymeow,drenden,1630,druid,feral,36,22,14
Stêff,zuljin,1630,druid,feral,60,31,29
Kolbie,emerald-dream,1625,druid,feral,62,34,28
Skyde,sargeras,1621,druid,feral,61,28,33
Wøs,area-52,1620,druid,feral,77,40,37
Sïmba,andorhal,1619,druid,feral,59,23,36
Sammy,scilla,1618,druid,feral,36,17,19
Enya,stormreaver,1618,druid,feral,66,31,35
Hiddenfur,ragnaros,1617,druid,feral,36,19,17
Nobruh,sargeras,1612,druid,feral,53,25,28
Extic,sargeras,1611,druid,feral,30,21,9
Raincloud,mannoroth,1603,druid,feral,24,17,7
Flowkie,illidan,1600,druid,feral,59,27,32
Irontree,dunemaul,1598,druid,feral,48,23,25
Bassy,whisperwind,1595,druid,feral,40,17,23
Cawkaw,frostwolf,1592,druid,feral,110,58,52
Zyhsul,emerald-dream,1583,druid,feral,36,19,17
Azrethyu,emerald-dream,1583,druid,feral,48,21,27
Anxietyburns,stormrage,1573,druid,feral,42,25,17
Ferraricat,bleeding-hollow,1567,druid,feral,44,19,25
Rank,nerzhul,1563,druid,feral,48,19,29
Kdrumania,tichondrius,1558,druid,feral,98,54,44
Swolareclips,eitrigg,1558,druid,feral,96,47,49
Slanue,tichondrius,1556,druid,feral,64,26,38
Jurasico,ragnaros,1554,druid,feral,72,38,34
Ulcera,nemesis,1551,druid,feral,36,25,11
Darkombra,frostmourne,1548,druid,feral,54,27,27
Käïïjü,tichondrius,1548,druid,feral,49,18,31
Mocfernando,sargeras,1535,druid,feral,30,16,14
Nicó,darkspear,1535,druid,feral,66,24,42
Melez,kelthuzad,1524,druid,feral,63,32,31
Ikkarus,nemesis,1502,druid,feral,66,36,30
Feond,illidan,1496,druid,feral,46,27,19
Kaisuckslol,stormrage,1496,druid,feral,108,53,55
Plux,illidan,1490,druid,feral,84,43,41
Ozex,crushridge,1484,druid,feral,42,17,25
Revcow,malganis,1477,druid,feral,42,21,21
Faelonk,frostmourne,1476,druid,feral,66,32,34
Bullcritzz,saurfang,1475,druid,feral,58,38,20
Delorík,illidan,1475,druid,feral,60,27,33
Kibbens,area-52,1474,druid,feral,114,50,64
Fendiy,barthilas,1471,druid,feral,42,22,20
Kushtiger,ragnaros,1470,druid,feral,84,42,42
Blut,stormrage,1458,druid,feral,186,89,97
Bossdru,sargeras,1447,druid,feral,47,28,19
Malthen,quelthalas,1443,druid,feral,33,20,13
Gairen,the-venture-co,1442,druid,feral,36,20,16
Classydruid,spinebreaker,1442,druid,feral,66,30,36
Off,ravencrest,1440,druid,feral,106,46,60
Floorz,firetree,1439,druid,feral,30,15,15
Dillywadz,tichondrius,1435,druid,feral,152,68,84
Prowli,tichondrius,1421,druid,feral,110,57,53
Vaniedron,zuljin,1415,druid,feral,66,22,44
Jaspurr,illidan,1412,druid,feral,24,15,9
Fugekî,zuljin,1410,druid,feral,29,18,11
Clarice,shattered-halls,1409,druid,feral,24,15,9
Hriiya,tichondrius,1404,druid,feral,35,15,20
Dahmu,malygos,1394,druid,feral,60,28,32
Swappy,korgath,1388,druid,feral,60,28,32
Treeweed,tichondrius,1386,druid,feral,81,42,39
Babekisser,stormrage,1382,druid,feral,34,16,18
Chomperz,tichondrius,1379,druid,feral,66,33,33
Weedsmuggler,burning-legion,1372,druid,feral,113,54,59
Fastcat,moon-guard,1361,druid,feral,30,15,15
Bigmolii,quelthalas,1359,druid,feral,48,17,31
Hjerim,quelthalas,1357,druid,feral,44,20,24
Fugg,frostmourne,1350,druid,feral,84,34,50
Frostelles,stormrage,1348,druid,feral,42,20,22
Floorz,bleeding-hollow,1343,druid,feral,24,14,10
Tenavï,stormrage,1341,druid,feral,30,14,16
Fuqet,kelthuzad,1339,druid,feral,30,14,16
Lesliewj,proudmoore,1338,druid,feral,29,14,15
Chococrispis,quelthalas,1338,druid,feral,36,14,22
Brawleyx,tichondrius,1337,druid,feral,36,14,22
Brewdock,boulderfist,1335,druid,feral,33,15,18
Khyzan,illidan,1329,druid,feral,78,41,37
Snowfaerie,moon-guard,1325,druid,feral,214,112,102
Scruffywolf,tichondrius,1322,druid,feral,83,37,46
Bullboy,frostmourne,1320,druid,feral,30,17,13
Sheeyts,tichondrius,1319,druid,feral,24,14,10
Sahksi,lothar,1317,druid,feral,48,25,23
Panyot,kiljaeden,1317,druid,feral,48,25,23
Kyrô,sargeras,1317,druid,feral,29,14,15
Porkonmyfork,frostmourne,1311,druid,feral,22,15,7
Suedle,kelthuzad,1309,druid,feral,29,14,15
Asteriel,stormrage,1307,druid,feral,34,17,17
Ferar,frostmourne,1305,druid,feral,29,14,15
Raebies,dalaran,1297,druid,feral,93,50,43
Hektuk,barthilas,1295,druid,feral,18,14,4
Ðreadfang,tichondrius,1295,druid,feral,41,25,16
Erahar,illidan,1281,druid,feral,46,24,22
Glockitty,tichondrius,1281,druid,feral,42,19,23
Chitára,ragnaros,1272,druid,feral,58,27,31
Senex,stormrage,1257,druid,feral,29,17,12
Kleanxx,tichondrius,1249,druid,feral,156,78,78
Skrambles,mugthol,1247,druid,feral,33,14,19
Nrp,stormrage,1245,druid,feral,48,13,35
Jpegcollectr,tichondrius,1243,druid,feral,42,13,29
Gonjatusk,ravencrest,1242,druid,feral,33,17,16
Senorcholo,malganis,1242,druid,feral,30,14,16
Theømega,stormrage,1237,druid,feral,24,13,11
Riemannzeta,azgalor,1237,druid,feral,26,14,12
Hellodan,proudmoore,1236,druid,feral,30,13,17
Jasminonmars,zuluhed,1235,druid,feral,36,19,17
Matpd,norgannon,1232,druid,feral,42,16,26
Xanbàr,hyjal,1222,druid,feral,35,22,13
Azuredreams,bleeding-hollow,1214,druid,feral,30,13,17
Midnitex,illidan,1214,druid,feral,37,16,21
Ourse,aegwynn,1210,druid,feral,59,36,23
Hermbott,proudmoore,1206,druid,feral,48,23,25
Xdkittyrawr,tichondrius,1199,druid,feral,58,29,29
Kwilli,tichondrius,1175,druid,feral,26,13,13
Haneulso,tichondrius,1171,druid,feral,33,14,19
Nomnomnomn,chogall,1168,druid,feral,22,13,9
Ðementia,stormrage,1161,druid,feral,48,31,17
Mariko,area-52,1158,druid,feral,29,13,16
Tardcakes,tichondrius,1155,druid,feral,43,18,25
Foxmeowz,blackwater-raiders,1152,druid,feral,24,12,12
Ryecoke,stormrage,1151,druid,feral,24,12,12
Lakunahof,ragnaros,1149,druid,feral,27,13,14
Fangry,queldorei,1147,druid,feral,30,12,18
Gnairda,sargeras,1143,druid,feral,96,43,53
Smeow,zuljin,1142,druid,feral,30,12,18
Khione,dreadmaul,1141,druid,feral,56,31,25
Aahx,thrall,1133,druid,feral,51,27,24
Vintera,sargeras,1132,druid,feral,81,40,41
Sweetxtooth,area-52,1128,druid,feral,24,12,12
Tonoshapepai,azralon,1122,druid,feral,36,13,23
Dätto,thrall,1116,druid,feral,30,12,18
Iamnature,dalaran,1103,druid,feral,31,13,18
Surmise,tichondrius,1100,druid,feral,24,12,12
Azakana,sargeras,1094,druid,feral,23,12,11
Leight,whisperwind,1093,druid,feral,24,14,10
Duhfective,proudmoore,1086,druid,feral,23,12,11
Chëësëbürgër,illidan,1067,druid,feral,30,12,18
Darkdragoonz,barthilas,1060,druid,feral,25,12,13
Duzis,tichondrius,1056,druid,feral,18,11,7
Glenn,norgannon,1056,druid,feral,18,11,7
Birdy,proudmoore,1056,druid,feral,18,11,7
Astrozxy,sargeras,1056,druid,feral,18,11,7
Switchform,kiljaeden,1056,druid,feral,18,11,7
Dangersweg,frostmourne,1056,druid,feral,24,11,13
Yüxy,sargeras,1056,druid,feral,30,11,19
Shmayba,malganis,1054,druid,feral,18,11,7
Kellydabear,azuremyst,1054,druid,feral,24,11,13
Cheshiire,moon-guard,1053,druid,feral,18,11,7
Anastasyiar,illidan,1053,druid,feral,24,11,13
Buhooki,tichondrius,1052,druid,feral,53,26,27
Myeow,illidan,1052,druid,feral,24,11,13
Corv,drenden,1051,druid,feral,16,12,4
Swindlestan,zuljin,1051,druid,feral,24,11,13
Mbarakaja,malganis,1050,druid,feral,25,11,14
Hööper,illidan,1050,druid,feral,36,11,25
Kongquest,emerald-dream,1049,druid,feral,36,11,25
Eletto,stormrage,1048,druid,feral,24,11,13
Yám,tichondrius,1048,druid,feral,30,11,19
Kyrona,frostmourne,1047,druid,feral,18,12,6
Badferal,blackhand,1045,druid,feral,30,11,19
Hadox,azralon,1040,druid,feral,29,11,18
Doubledówn,sargeras,1035,druid,feral,42,21,21
Yobolsun,sargeras,1030,druid,feral,30,12,18
Screwdrivers,moon-guard,1022,druid,feral,29,11,18
Pokémon,grizzly-hills,1018,druid,feral,29,12,17
Pavel,aerie-peak,1018,druid,feral,47,14,33
Lyndonww,frostmourne,1006,druid,feral,26,12,14
Ruzkit,illidan,995,druid,feral,24,11,13
Lusk,blades-edge,970,druid,feral,41,18,23
Yayue,tichondrius,960,druid,feral,18,10,8
Buffjungle,tichondrius,960,druid,feral,26,10,16
Zuljor,sargeras,959,druid,feral,12,10,2
Dewfuss,tichondrius,959,druid,feral,18,10,8
Yaboidakota,stormrage,959,druid,feral,24,10,14
Kekepöp,illidan,959,druid,feral,24,10,14
Nearkoo,tichondrius,958,druid,feral,24,10,14
Zazieraiel,moon-guard,957,druid,feral,27,11,16
Jizzie,tichondrius,956,druid,feral,18,10,8
Swornenemy,mugthol,956,druid,feral,18,10,8
Shiftingdean,sargeras,956,druid,feral,30,10,20
Dorio,quelthalas,952,druid,feral,18,10,8
Nazdaq,stormrage,945,druid,feral,24,10,14
Feraluwu,illidan,938,druid,feral,18,10,8
Lelobull,ragnaros,937,druid,feral,24,10,14
Taurenaught,aegwynn,933,druid,feral,30,15,15
Kuzigothigh,thunderhorn,924,druid,feral,30,15,15
Zeroshift,sargeras,911,druid,feral,34,10,24
Azoth,hyjal,864,druid,feral,12,9,3
Hatergodx,ravencrest,864,druid,feral,18,9,9
Akamu,nemesis,864,druid,feral,24,9,15
Dimsump,zuljin,864,druid,feral,24,9,15
Thycamore,cenarius,864,druid,feral,30,9,21
Tt,akama,863,druid,feral,18,9,9
Zirrie,stormrage,863,druid,feral,18,9,9
Kobez,bleeding-hollow,863,druid,feral,18,9,9
Kaissara,nemesis,862,druid,feral,18,9,9
Duckieheit,sargeras,861,druid,feral,18,9,9
Catten,barthilas,860,druid,feral,12,9,3
Eyzie,stormrage,853,druid,feral,24,9,15
Borybuilder,azralon,852,druid,feral,26,9,17
Trevvor,thrall,852,druid,feral,30,9,21
Sosd,kelthuzad,837,druid,feral,17,9,8
Shartasm,anetheron,822,druid,feral,30,12,18
Prêdator,ragnaros,814,druid,feral,17,9,8
Feorelm,proudmoore,810,druid,feral,17,9,8
Nephdruid,stormrage,804,druid,feral,30,9,21
Craak,tichondrius,797,druid,feral,20,9,11
Fliip,barthilas,768,druid,feral,12,8,4
Jason,vashj,768,druid,feral,12,8,4
Anìmorph,sargeras,768,druid,feral,12,8,4
Mooncatbear,malganis,768,druid,feral,18,8,10
Zenlonn,emerald-dream,768,druid,feral,18,8,10
Jentzull,tichondrius,767,druid,feral,12,8,4
Ytgamezoned,darkspear,767,druid,feral,18,8,10
Udderchaos,dark-iron,767,druid,feral,18,8,10
Yavann,tichondrius,767,druid,feral,18,8,10
Fullmoon,greymane,767,druid,feral,22,9,13
Herbx,sargeras,765,druid,feral,18,8,10
Raknary,kelthuzad,764,druid,feral,30,8,22
Dehltax,stormrage,762,druid,feral,12,8,4
Shahahrazad,queldorei,762,druid,feral,30,8,22
Beargodx,stormrage,757,druid,feral,24,8,16
Sjana,bleeding-hollow,752,druid,feral,12,8,4
Mychi,ragnaros,748,druid,feral,20,9,11
Koag,dalaran,741,druid,feral,18,8,10
Spinach,moon-guard,720,druid,feral,21,8,13
Ashmila,ragnaros,716,druid,feral,17,8,9
Mazoak,sargeras,703,druid,feral,28,8,20
Shakedru,stormrage,684,druid,feral,19,8,11
Tnvï,stormrage,672,druid,feral,12,7,5
Akanx,tichondrius,672,druid,feral,12,7,5
Féèd,stormrage,672,druid,feral,12,7,5
Elyveen,proudmoore,672,druid,feral,12,7,5
Henikbite,zuljin,672,druid,feral,12,7,5
Primalxd,area-52,672,druid,feral,12,7,5
Fyrkax,sargeras,672,druid,feral,12,7,5
Faithxo,stormrage,672,druid,feral,18,7,11
Zlegacy,anvilmar,672,druid,feral,18,7,11
Meowny,area-52,672,druid,feral,18,7,11
Muffbfloppn,zuljin,672,druid,feral,18,7,11
Yobibit,terenas,672,druid,feral,24,7,17
Tree,lothar,671,druid,feral,12,7,5
Superwrath,khaz-modan,671,druid,feral,12,7,5
Boofings,sargeras,671,druid,feral,12,7,5
Roots,anubarak,671,druid,feral,12,7,5
Druidydruid,blackrock,671,druid,feral,18,7,11
Momoxchan,quelthalas,671,druid,feral,18,7,11
Oneinchclaw,malganis,671,druid,feral,18,7,11
Ruckiz,stormrage,671,druid,feral,18,7,11
Datkittydoe,kiljaeden,671,druid,feral,18,7,11
Vykarux,suramar,671,druid,feral,18,7,11
Bearmuda,trollbane,671,druid,feral,18,7,11
Styli,tichondrius,670,druid,feral,12,7,5
Redness,daggerspine,669,druid,feral,18,7,11
Yokimo,amanthul,668,druid,feral,18,7,11
Predatõr,malorne,663,druid,feral,12,7,5
Rum,the-venture-co,656,druid,feral,18,7,11
Oxvxo,senjin,648,druid,feral,18,7,11
Injail,tichondrius,640,druid,feral,16,7,9
Arntu,malganis,639,druid,feral,11,7,4
Fennel,korgath,639,druid,feral,17,7,10
Jeanz,bonechewer,632,druid,feral,19,9,10
Meowzetzan,tichondrius,623,druid,feral,11,7,4
Greasemonkey,trollbane,623,druid,feral,16,8,8
Treespec,stormrage,622,druid,feral,11,7,4
Berd,whisperwind,606,druid,feral,16,7,9
Beaker,uldum,605,druid,feral,11,7,4
Bigherbo,zuljin,585,druid,feral,20,8,12
Wildbeasts,proudmoore,583,druid,feral,22,8,14
Retzerbil,sargeras,576,druid,feral,6,6,0
Lïberty,ragnaros,576,druid,feral,6,6,0
Cíphenz,illidan,576,druid,feral,12,6,6
Naturestouch,tichondrius,576,druid,feral,12,6,6
Bênî,emerald-dream,576,druid,feral,12,6,6
Bloodynine,cairne,576,druid,feral,12,6,6
Daniverse,sargeras,576,druid,feral,12,6,6
Thontt,sargeras,576,druid,feral,12,6,6
Ännä,moon-guard,576,druid,feral,12,6,6
Hashmall,ragnaros,576,druid,feral,12,6,6
Jinhova,stormrage,576,druid,feral,15,6,9
Zivak,azshara,576,druid,feral,18,6,12
Beastbaby,eldrethalas,576,druid,feral,18,6,12
Xanybarz,stormrage,576,druid,feral,18,6,12
Feorb,azuremyst,576,druid,feral,18,6,12
Thaherb,korgath,576,druid,feral,18,6,12
Rahxay,quelthalas,576,druid,feral,18,6,12
Hoofin,blackwing-lair,576,druid,feral,18,6,12
Wabbehkus,barthilas,576,druid,feral,24,6,18
Stríðsmaður,area-52,575,druid,feral,12,6,6
Wulfjack,emerald-dream,575,druid,feral,12,6,6
Allenjunior,ragnaros,575,druid,feral,12,6,6
Fireeloot,tichondrius,575,druid,feral,12,6,6
Moonbow,frostmourne,575,druid,feral,12,6,6
Súse,sargeras,575,druid,feral,12,6,6
Ursuur,drakkari,575,druid,feral,18,6,12
Beelzehog,whisperwind,574,druid,feral,12,6,6
Nikozho,sargeras,573,druid,feral,18,6,12
Reallysauce,zuljin,570,druid,feral,12,6,6
Snowlion,the-forgotten-coast,570,druid,feral,12,6,6
Expells,nemesis,569,druid,feral,18,6,12
Hyperlite,bonechewer,566,druid,feral,12,6,6
Pawprika,tichondrius,562,druid,feral,24,6,18
Dreamfyre,kiljaeden,543,druid,feral,17,6,11
Tatiannaa,stormreaver,528,druid,feral,9,7,2
Ursarius,skullcrusher,528,druid,feral,15,6,9
Wtfimacat,area-52,527,druid,feral,11,6,5
Shadalor,frostmourne,512,druid,feral,16,6,10
Jonio,tichondrius,511,druid,feral,17,6,11
Druski,lightbringer,508,druid,feral,11,6,5
Bearjoo,kelthuzad,495,druid,feral,18,6,12
Exxh,tichondrius,480,druid,feral,6,5,1
Gloomcat,illidan,480,druid,feral,6,5,1
Sweetnippies,elune,480,druid,feral,6,5,1
Carboz,jubeithos,480,druid,feral,6,5,1
Snuppy,sargeras,480,druid,feral,6,5,1
Gz,icecrown,480,druid,feral,6,5,1
Saltydru,illidan,480,druid,feral,12,5,7
Bloodriot,wyrmrest-accord,480,druid,feral,12,5,7
Jazzxs,proudmoore,480,druid,feral,12,5,7
Waggs,illidan,480,druid,feral,12,5,7
Csinii,bleeding-hollow,480,druid,feral,12,5,7
Beygatti,sargeras,480,druid,feral,12,5,7
Luluid,tichondrius,480,druid,feral,12,5,7
Calikonger,spirestone,480,druid,feral,12,5,7
Yizhiyuren,aegwynn,480,druid,feral,12,5,7
Traxxo,tichondrius,480,druid,feral,12,5,7
Mythienair,stormrage,480,druid,feral,12,5,7
Feralhearted,kelthuzad,480,druid,feral,12,5,7
Topangâ,lightninghoof,480,druid,feral,12,5,7
Rwhatkr,tichondrius,480,druid,feral,18,5,13
Oneninesix,frostmourne,480,druid,feral,18,5,13
Sylvaster,stormrage,480,druid,feral,18,5,13
Bullshiftin,area-52,479,druid,feral,6,5,1
Anessan,silvermoon,479,druid,feral,12,5,7
Animalcade,area-52,479,druid,feral,12,5,7
Balthøs,moon-guard,479,druid,feral,12,5,7
Calani,lightnings-blade,479,druid,feral,12,5,7
Weedleaf,wyrmrest-accord,479,druid,feral,12,5,7
Snugglin,kelthuzad,479,druid,feral,12,5,7
Ninefeet,argent-dawn,479,druid,feral,12,5,7
Ediiann,cenarius,477,druid,feral,12,5,7
Skrillin,thrall,477,druid,feral,12,5,7
Moonrg,stormrage,431,druid,feral,11,5,6
Blêêd,stormscale,426,druid,feral,7,7,0
Mhdd,tichondrius,415,druid,feral,8,5,3
Byson,bleeding-hollow,415,druid,feral,11,5,6
Yunekai,stormrage,415,druid,feral,11,5,6
Nâturê,dalaran,384,druid,feral,6,4,2
Amdruid,bloodhoof,384,druid,feral,6,4,2
Pressuretd,frostmourne,384,druid,feral,6,4,2
Kistormx,tichondrius,384,druid,feral,6,4,2
Gunnymad,tichondrius,384,druid,feral,6,4,2
Krobz,bleeding-hollow,384,druid,feral,6,4,2
Tabbsy,frostmourne,384,druid,feral,6,4,2
Jaegerbombx,sargeras,384,druid,feral,6,4,2
Aldr,tichondrius,384,druid,feral,6,4,2
Neetform,zuljin,384,druid,feral,6,4,2
Hroney,area-52,384,druid,feral,6,4,2
Cfab,tichondrius,384,druid,feral,6,4,2
Orizane,moon-guard,384,druid,feral,6,4,2
Funkattack,tichondrius,384,druid,feral,6,4,2
Olhosdlua,azralon,384,druid,feral,6,4,2
Bhen,tichondrius,384,druid,feral,6,4,2
Menapäws,area-52,384,druid,feral,6,4,2
Curet,lightbringer,384,druid,feral,6,4,2
Drywatter,tichondrius,384,druid,feral,6,4,2
Toiiz,malganis,384,druid,feral,9,4,5
Feralgød,tichondrius,384,druid,feral,12,4,8
Angulus,darkspear,384,druid,feral,12,4,8
Carlosd,tichondrius,384,druid,feral,12,4,8
Ewok,vashj,384,druid,feral,12,4,8
Oroskii,bleeding-hollow,384,druid,feral,12,4,8
Carnumoose,zuljin,384,druid,feral,12,4,8
Pollykush,sargeras,384,druid,feral,12,4,8
Weeñor,tichondrius,384,druid,feral,12,4,8
Skufty,illidan,384,druid,feral,12,4,8
Kajla,sargeras,384,druid,feral,12,4,8
Auxl,tichondrius,384,druid,feral,12,4,8
Toetoetoete,darrowmere,384,druid,feral,12,4,8
Quiziato,burning-legion,384,druid,feral,12,4,8
Startalons,area-52,384,druid,feral,18,4,14
Udala,durotan,383,druid,feral,6,4,2
Shoboski,quelthalas,383,druid,feral,12,4,8
Bramth,quelthalas,383,druid,feral,12,4,8
Porrosman,quelthalas,383,druid,feral,12,4,8
Sansao,sargeras,383,druid,feral,12,4,8
Mfgs,kelthuzad,383,druid,feral,12,4,8
Chambz,tichondrius,383,druid,feral,24,4,20
Mogli,perenolde,383,druid,feral,30,4,26
Ssimbaa,area-52,382,druid,feral,12,4,8
Jabiso,smolderthorn,382,druid,feral,12,4,8
Wokoom,windrunner,382,druid,feral,18,4,14
Fogboom,area-52,351,druid,feral,8,5,3
Eightyhd,ravencrest,351,druid,feral,11,4,7
Defku,quelthalas,330,druid,feral,28,6,22
Erykk,dalaran,288,druid,feral,6,3,3
Honeybeam,moon-guard,288,druid,feral,6,3,3
Hitchslaps,tichondrius,288,druid,feral,6,3,3
Riddickd,malfurion,288,druid,feral,6,3,3
Worgbearpig,destromath,288,druid,feral,6,3,3
Susruth,area-52,288,druid,feral,6,3,3
Dkkng,dalaran,288,druid,feral,6,3,3
Idiotferal,tortheldrin,288,druid,feral,6,3,3
Rivetrix,azralon,288,druid,feral,6,3,3
Tommyjimmy,andorhal,288,druid,feral,6,3,3
Drewiid,stormrage,288,druid,feral,6,3,3
Chopleaf,khadgar,288,druid,feral,6,3,3
Ogversaucey,skullcrusher,288,druid,feral,6,3,3
Bubbleshiftz,area-52,288,druid,feral,6,3,3
Nofeets,azshara,288,druid,feral,6,3,3
Bloodyugly,area-52,288,druid,feral,6,3,3
Øvernight,azralon,288,druid,feral,6,3,3
Arienne,kelthuzad,288,druid,feral,6,3,3
Katatafish,azralon,288,druid,feral,6,3,3
Férállgødx,area-52,288,druid,feral,6,3,3
Opconvoke,illidan,288,druid,feral,6,3,3
Chowxx,tichondrius,288,druid,feral,6,3,3
Kynvi,moon-guard,288,druid,feral,6,3,3
Elythria,hellscream,288,druid,feral,6,3,3
Frrest,proudmoore,288,druid,feral,6,3,3
Datlogan,tichondrius,288,druid,feral,6,3,3
Steakjr,senjin,288,druid,feral,6,3,3
Owlcapwn,stormreaver,288,druid,feral,6,3,3
Kobebeef,malganis,288,druid,feral,6,3,3
Celetra,kiljaeden,288,druid,feral,6,3,3
Kurokyy,frostmourne,288,druid,feral,6,3,3
Gorim,area-52,288,druid,feral,6,3,3
Kittendev,tichondrius,288,druid,feral,6,3,3
Selendis,tichondrius,288,druid,feral,6,3,3
Pokeyouryolk,sargeras,288,druid,feral,6,3,3
Bootayclappa,sargeras,288,druid,feral,6,3,3
Behrhart,stormrage,288,druid,feral,6,3,3
Barbary,tichondrius,288,druid,feral,6,3,3
Whitetigeris,tichondrius,288,druid,feral,6,3,3
Zelyvia,moon-guard,288,druid,feral,6,3,3
Jeperty,tichondrius,288,druid,feral,6,3,3
Tagzz564946,tichondrius,288,druid,feral,6,3,3
Turow,firetree,288,druid,feral,6,3,3
Tasselhoof,hyjal,288,druid,feral,6,3,3
Plantdaddy,bladefist,288,druid,feral,6,3,3
Deaddpool,ragnaros,288,druid,feral,6,3,3
Riverthorne,moon-guard,288,druid,feral,6,3,3
Zadayos,aerie-peak,288,druid,feral,6,3,3
Bere,kul-tiras,288,druid,feral,6,3,3
Lilrichdmg,sargeras,288,druid,feral,6,3,3
Ysemia,drakkari,288,druid,feral,8,3,5
Lilnippy,stormscale,288,druid,feral,12,3,9
Uniquex,zuljin,288,druid,feral,12,3,9
Oo,grizzly-hills,288,druid,feral,12,3,9
Tchallå,tichondrius,288,druid,feral,12,3,9
Näna,dalaran,288,druid,feral,12,3,9
Solstice,frostmourne,288,druid,feral,12,3,9
Hobbles,emerald-dream,288,druid,feral,12,3,9
Extremeshift,dalaran,287,druid,feral,8,4,4
Twigz,illidan,287,druid,feral,6,3,3
Mavren,uldaman,287,druid,feral,6,3,3
Àspên,moon-guard,287,druid,feral,6,3,3
Orthognathic,emerald-dream,287,druid,feral,6,3,3
Eglania,stormrage,286,druid,feral,6,3,3
Lémons,tichondrius,255,druid,feral,11,3,8
Ërebüs,emerald-dream,239,druid,feral,5,3,2
Slapymilf,dentarg,239,druid,feral,5,3,2
Yámï,stormrage,239,druid,feral,5,3,2
Rosalba,zuljin,221,druid,feral,29,8,21
Puiltraxs,ragnaros,192,druid,feral,4,3,1
Kittysnuggle,emerald-dream,192,druid,feral,9,3,6
Soldadito,zuljin,192,druid,feral,9,3,6
Hännibal,hydraxis,192,druid,feral,6,2,4
Prosperz,dalaran,192,druid,feral,6,2,4
Athious,moon-guard,192,druid,feral,6,2,4
Worldly,medivh,192,druid,feral,6,2,4
Taiga,moon-guard,192,druid,feral,6,2,4
Illr,laughing-skull,192,druid,feral,6,2,4
Kanadae,thrall,192,druid,feral,6,2,4
Snupy,area-52,192,druid,feral,6,2,4
Bigthirty,area-52,192,druid,feral,6,2,4
Ruhgen,deathwing,192,druid,feral,6,2,4
Topguncarl,illidan,192,druid,feral,6,2,4
Bdsurges,illidan,192,druid,feral,6,2,4
Milkmoneymeo,illidan,192,druid,feral,6,2,4
Maplesyrup,moonrunner,192,druid,feral,6,2,4
Shiftalk,nerzhul,192,druid,feral,6,2,4
Theliono,lightnings-blade,192,druid,feral,6,2,4
Taztoc,stormrage,192,druid,feral,6,2,4
Yukcyducky,tichondrius,192,druid,feral,6,2,4
Nabious,malganis,192,druid,feral,6,2,4
Enderhero,illidan,192,druid,feral,6,2,4
Atreis,malganis,192,druid,feral,6,2,4
Dreadonly,tichondrius,192,druid,feral,6,2,4
Yakir,kiljaeden,192,druid,feral,6,2,4
Groovybot,tichondrius,192,druid,feral,6,2,4
Haegur,tichondrius,192,druid,feral,6,2,4
Lavanca,azralon,192,druid,feral,6,2,4
Varietypack,antonidas,192,druid,feral,6,2,4
Binjuicex,frostmourne,192,druid,feral,6,2,4
Juiceonlips,sargeras,192,druid,feral,6,2,4
Evolute,sargeras,192,druid,feral,6,2,4
Samsaralol,tichondrius,192,druid,feral,6,2,4
Freinnar,kiljaeden,192,druid,feral,6,2,4
Manwool,illidan,192,druid,feral,6,2,4
Pawblems,sargeras,192,druid,feral,6,2,4
Catmóm,tichondrius,192,druid,feral,6,2,4
Stolenrims,tichondrius,192,druid,feral,6,2,4
Asmondruud,tichondrius,192,druid,feral,6,2,4
Igneël,ragnaros,192,druid,feral,12,2,10
Codieneme,blades-edge,192,druid,feral,12,2,10
Shiftyounot,shattered-hand,192,druid,feral,12,2,10
Seyala,moon-guard,192,druid,feral,12,2,10
Faroo,azralon,192,druid,feral,12,2,10
Àcid,stormreaver,192,druid,feral,12,2,10
Meudayr,crushridge,192,druid,feral,12,2,10
Shadedmika,zuljin,192,druid,feral,12,2,10
Drabo,boulderfist,192,druid,feral,12,2,10
Happyc,bleeding-hollow,192,druid,feral,12,2,10
Nerfdemo,kiljaeden,192,druid,feral,12,2,10
Feralhearted,tichondrius,175,druid,feral,11,2,9
Jdoozie,bleeding-hollow,159,druid,feral,5,2,3
Jihadibleeds,stormrage,138,druid,feral,7,3,4
Kipsmiffly,darkspear,128,druid,feral,4,2,2
Mawnster,drenden,96,druid,feral,3,2,1
Chumdrumrum,malganis,96,druid,feral,6,1,5
Valdr,stormrage,96,druid,feral,6,1,5
Aquahektik,malganis,96,druid,feral,6,1,5
Habras,alterac-mountains,96,druid,feral,6,1,5
Awarz,drakkari,96,druid,feral,6,1,5
Malfurionsto,moon-guard,96,druid,feral,6,1,5
Jawsbee,emerald-dream,96,druid,feral,6,1,5
Kollective,sargeras,96,druid,feral,6,1,5
Polyproof,emerald-dream,96,druid,feral,6,1,5
Ojira,moon-guard,96,druid,feral,6,1,5
Édzar,area-52,96,druid,feral,6,1,5
Caelüm,area-52,96,druid,feral,6,1,5
Raigor,azralon,96,druid,feral,6,1,5
Yungle,tichondrius,96,druid,feral,6,1,5
Thebigcat,deathwing,96,druid,feral,6,1,5
Alope,blades-edge,96,druid,feral,6,1,5
Deelark,skywall,96,druid,feral,6,1,5
Pibily,sargeras,96,druid,feral,6,1,5
Lakroz,zuljin,96,druid,feral,6,1,5
Wreckingcrew,emerald-dream,96,druid,feral,6,1,5
Ghostboy,zuljin,96,druid,feral,6,1,5
Catorcow,aegwynn,96,druid,feral,6,1,5
Ymirgore,zuljin,96,druid,feral,6,1,5
Droody,earthen-ring,96,druid,feral,6,1,5
Ashmíla,ragnaros,96,druid,feral,6,1,5
Mxdi,tichondrius,96,druid,feral,6,1,5
Captclaws,tichondrius,96,druid,feral,6,1,5
Vorare,tichondrius,96,druid,feral,6,1,5
Ausbie,garona,96,druid,feral,6,1,5
Jamesbailey,sargeras,96,druid,feral,6,1,5
Barnabie,black-dragonflight,96,druid,feral,6,1,5
Purrcat,tichondrius,96,druid,feral,6,1,5
Absoles,agamaggan,96,druid,feral,6,1,5
Purpyo,bleeding-hollow,96,druid,feral,6,1,5
Lunarboy,tichondrius,96,druid,feral,6,1,5
Healthy,auchindoun,96,druid,feral,6,1,5
Cattdog,tichondrius,96,druid,feral,6,1,5
Vernaar,laughing-skull,96,druid,feral,6,1,5
Capson,darkspear,96,druid,feral,6,1,5
Acórn,frostmourne,96,druid,feral,6,1,5
Crowaar,moon-guard,96,druid,feral,6,1,5
Naztekk,dalaran,96,druid,feral,6,1,5
Poosnickety,kelthuzad,96,druid,feral,6,1,5
Fortunecat,illidan,96,druid,feral,6,1,5
Gretatunberg,skywall,96,druid,feral,6,1,5
Dééz,illidan,96,druid,feral,6,1,5
Ticømia,stormrage,96,druid,feral,6,1,5
Liightbite,illidan,96,druid,feral,6,1,5
Versipex,emerald-dream,96,druid,feral,12,1,11
Ballsnack,zuljin,96,druid,feral,12,1,11
Furiøsä,quelthalas,95,druid,feral,6,1,5
Gitsnshigles,frostmourne,79,druid,feral,5,1,4
Pixyls,bleeding-hollow,48,druid,feral,3,1,2
Kilbys,nemesis,31,druid,feral,2,1,1
Cliodhna,kelthuzad,16,druid,feral,1,1,0
Ebrìthil,hyjal,16,druid,feral,1,1,0
Laryfsherman,tichondrius,2324,druid,balance,83,54,29
Legionsucks,tanaris,2277,druid,balance,120,68,52
Jbz,balnazzar,2236,druid,balance,124,85,39
Supatease,tichondrius,2231,druid,balance,105,60,45
Bkqtpie,tichondrius,2228,druid,balance,94,55,39
Fredagn,illidan,2213,druid,balance,78,46,32
Tanerno,illidan,2173,druid,balance,102,61,41
Flapz,illidan,2164,druid,balance,66,38,28
Owl,shadowsong,2157,druid,balance,72,41,31
Notes,farstriders,2147,druid,balance,98,51,47
Pushpop,frostmourne,2141,druid,balance,60,41,19
Impëria,quelthalas,2137,druid,balance,89,58,31
Balancex,tichondrius,2135,druid,balance,102,52,50
Houli,tichondrius,2134,druid,balance,96,50,46
Peterßigßeam,malganis,2131,druid,balance,88,47,41
Nbadizzyboy,illidan,2130,druid,balance,53,43,10
Murkeÿ,frostmourne,2104,druid,balance,60,32,28
Sqwippyd,tichondrius,2102,druid,balance,78,49,29
Houlix,stormrage,2099,druid,balance,98,50,48
Gritzxv,stormrage,2097,druid,balance,71,42,29
Gugukuaipao,tichondrius,2086,druid,balance,66,39,27
Kidcudi,dentarg,2075,druid,balance,144,74,70
Lazershartz,cenarion-circle,2064,druid,balance,66,36,30
Fergh,tichondrius,2058,druid,balance,54,32,22
Soggykfc,illidan,2052,druid,balance,72,42,30
Jimmypop,malganis,2049,druid,balance,62,44,18
Murruk,darkspear,2044,druid,balance,141,81,60
Lavlol,frostmourne,2029,druid,balance,156,87,69
Tranquilo,stormrage,2018,druid,balance,72,44,28
Snöwghost,aerie-peak,2011,druid,balance,96,53,43
Biophilic,moon-guard,1990,druid,balance,70,36,34
Zneb,darkspear,1987,druid,balance,36,29,7
Trusyrusty,stormrage,1987,druid,balance,97,52,45
Dogwáter,tichondrius,1984,druid,balance,40,29,11
Flowerboï,azralon,1984,druid,balance,66,47,19
Fracxx,area-52,1981,druid,balance,30,21,9
Brose,malganis,1979,druid,balance,54,33,21
Nokomanida,zuljin,1977,druid,balance,69,42,27
Bigdiablo,frostmourne,1971,druid,balance,100,55,45
Riskies,tichondrius,1965,druid,balance,64,34,30
Pønchø,quelthalas,1960,druid,balance,56,33,23
Boomçhicken,tichondrius,1959,druid,balance,58,31,27
Béstworld,dalaran,1955,druid,balance,62,43,19
Vertderferk,tichondrius,1954,druid,balance,68,40,28
Smëagol,zuljin,1945,druid,balance,48,31,17
Daspdruid,nagrand,1938,druid,balance,170,87,83
Sebastian,tichondrius,1937,druid,balance,59,36,23
Compléx,tichondrius,1937,druid,balance,60,31,29
Jakob,arygos,1933,druid,balance,78,50,28
Altoberano,azralon,1930,druid,balance,65,35,30
Lovemakitty,sargeras,1922,druid,balance,78,46,32
Acdru,tichondrius,1911,druid,balance,67,37,30
Foekinghobo,sargeras,1908,druid,balance,60,38,22
Knotgiver,moon-guard,1899,druid,balance,52,31,21
Thugrose,blackrock,1899,druid,balance,42,23,19
John,azralon,1896,druid,balance,72,34,38
Xijînping,tichondrius,1893,druid,balance,42,26,16
Cultnelf,illidan,1885,druid,balance,56,35,21
Dilondru,area-52,1884,druid,balance,63,42,21
Druidstin,tichondrius,1883,druid,balance,66,33,33
Lazersnewch,kelthuzad,1877,druid,balance,60,35,25
Lilkitty,tichondrius,1870,druid,balance,72,47,25
Sarvi,zuljin,1864,druid,balance,33,24,9
Elythria,hellscream,1863,druid,balance,30,26,4
Sawsaw,bleeding-hollow,1858,druid,balance,68,40,28
Vernaar,laughing-skull,1858,druid,balance,78,43,35
Ezgamed,tichondrius,1853,druid,balance,57,37,20
Dízzen,bleeding-hollow,1853,druid,balance,54,34,20
Omends,thrall,1853,druid,balance,68,35,33
Johnieboy,azralon,1850,druid,balance,45,32,13
Cti,tichondrius,1840,druid,balance,36,23,13
Swayjizz,tichondrius,1840,druid,balance,78,49,29
Gèb,dalaran,1835,druid,balance,116,71,45
Bubalolz,quelthalas,1833,druid,balance,113,59,54
Deloria,nemesis,1829,druid,balance,42,25,17
Dontnerfmore,queldorei,1829,druid,balance,66,31,35
Chernovax,kelthuzad,1828,druid,balance,87,47,40
Wereocelot,firetree,1827,druid,balance,66,42,24
Fhormations,area-52,1827,druid,balance,42,23,19
Herpadruid,illidan,1823,druid,balance,72,32,40
Clonemunster,frostmourne,1821,druid,balance,66,38,28
Resorange,malganis,1818,druid,balance,48,29,19
Readt,malganis,1818,druid,balance,180,102,78
Enøsh,tichondrius,1817,druid,balance,42,25,17
Rìniroo,area-52,1816,druid,balance,48,30,18
Xenny,chogall,1815,druid,balance,48,34,14
Toughshift,zuljin,1814,druid,balance,36,19,17
Spacedruidx,illidan,1810,druid,balance,66,39,27
Byk,tichondrius,1810,druid,balance,54,30,24
Ertuzi,tichondrius,1809,druid,balance,36,27,9
Cocainebeär,tichondrius,1808,druid,balance,54,30,24
Maligoz,nemesis,1806,druid,balance,71,41,30
Flatass,cairne,1805,druid,balance,48,31,17
Petruccius,nordrassil,1801,druid,balance,112,59,53
Mewfasa,duskwood,1800,druid,balance,57,38,19
Chal,illidan,1791,druid,balance,53,32,21
Alpine,eldrethalas,1790,druid,balance,48,32,16
Boomybro,thrall,1790,druid,balance,116,73,43
Lilbeam,sargeras,1789,druid,balance,36,24,12
Swaggu,kelthuzad,1781,druid,balance,48,31,17
Jaxer,illidan,1774,druid,balance,87,57,30
Cousa,zuljin,1774,druid,balance,40,26,14
Dextructive,tichondrius,1772,druid,balance,89,44,45
Orollå,tichondrius,1771,druid,balance,50,29,21
Lekick,tichondrius,1770,druid,balance,54,30,24
Tòmathy,tichondrius,1769,druid,balance,47,24,23
Solareclipse,tichondrius,1768,druid,balance,48,26,22
Dôcteurowl,zuljin,1767,druid,balance,47,25,22
Jayelljaÿ,thrall,1766,druid,balance,60,39,21
Ericzzdd,tichondrius,1765,druid,balance,42,32,10
Astraldank,tichondrius,1765,druid,balance,48,28,20
Treirus,sargeras,1760,druid,balance,60,45,15
Mythleaf,ragnaros,1756,druid,balance,72,44,28
Soulz,quelthalas,1756,druid,balance,48,27,21
Sommerrays,kelthuzad,1753,druid,balance,54,27,27
Oungan,illidan,1750,druid,balance,75,44,31
Ataraxie,illidan,1749,druid,balance,54,34,20
Spamclonewin,tichondrius,1743,druid,balance,53,31,22
Basedcatx,tichondrius,1742,druid,balance,30,19,11
Druidwhat,stormrage,1737,druid,balance,128,69,59
Harukai,azralon,1736,druid,balance,60,37,23
Moonkay,tichondrius,1734,druid,balance,30,20,10
Metroboomy,magtheridon,1734,druid,balance,42,25,17
Panansy,stormrage,1734,druid,balance,96,48,48
Ruthlessbro,sargeras,1730,druid,balance,67,37,30
Brodda,sargeras,1730,druid,balance,174,96,78
Animatronixz,area-52,1728,druid,balance,54,25,29
Ebrìthil,hyjal,1722,druid,balance,48,26,22
Bentøbøx,barthilas,1721,druid,balance,35,19,16
Glazinator,sargeras,1721,druid,balance,148,72,76
Wecksox,area-52,1721,druid,balance,240,116,124
Xantastic,area-52,1719,druid,balance,42,24,18
Swiftydel,frostmourne,1718,druid,balance,42,27,15
Bunnykiss,tichondrius,1718,druid,balance,48,24,24
Starsucceed,illidan,1718,druid,balance,42,21,21
Doomdawn,sargeras,1715,druid,balance,71,39,32
Gillidd,bleeding-hollow,1713,druid,balance,24,18,6
Pipiwiwi,stormrage,1711,druid,balance,75,43,32
Poliage,moon-guard,1708,druid,balance,77,45,32
Vengex,sargeras,1707,druid,balance,24,18,6
Mädnhairy,zuljin,1703,druid,balance,45,28,17
Spinach,moon-guard,1702,druid,balance,81,42,39
Naakx,tichondrius,1701,druid,balance,47,28,19
Moonflora,stormrage,1697,druid,balance,75,41,34
Auras,kelthuzad,1695,druid,balance,54,43,11
Hayase,tichondrius,1687,druid,balance,34,23,11
Showmanship,tichondrius,1683,druid,balance,24,19,5
Thottiie,hyjal,1682,druid,balance,30,21,9
Kyura,sargeras,1678,druid,balance,106,49,57
Komacine,emerald-dream,1674,druid,balance,165,92,73
Líu,area-52,1671,druid,balance,54,35,19
Partylord,malganis,1668,druid,balance,78,43,35
Jojo,ysera,1665,druid,balance,48,25,23
Tagzz564946,tichondrius,1664,druid,balance,42,25,17
Jacusias,stormrage,1664,druid,balance,105,56,49
Beretta,rexxar,1660,druid,balance,54,36,18
Frames,area-52,1660,druid,balance,41,21,20
Yipëë,moon-guard,1657,druid,balance,30,18,12
Brockolini,tichondrius,1654,druid,balance,54,34,20
Aull,kelthuzad,1653,druid,balance,36,19,17
Sadboy,moon-guard,1653,druid,balance,71,35,36
Starlyxo,malganis,1652,druid,balance,53,34,19
Geezbutt,tichondrius,1646,druid,balance,73,30,43
Nyloke,kelthuzad,1644,druid,balance,42,29,13
Grapeful,frostmourne,1640,druid,balance,66,37,29
Rerob,aerie-peak,1639,druid,balance,26,18,8
Trapdoorboom,illidan,1638,druid,balance,72,36,36
Pennytrate,barthilas,1637,druid,balance,30,19,11
Pisces,emerald-dream,1636,druid,balance,32,21,11
Thamoonsbak,aggramar,1635,druid,balance,35,18,17
Raïsin,moon-guard,1631,druid,balance,24,17,7
Lostnsauce,tichondrius,1630,druid,balance,48,36,12
Bearyhallsjr,sargeras,1627,druid,balance,24,17,7
Droodaphobé,sargeras,1625,druid,balance,29,18,11
Yepz,tichondrius,1624,druid,balance,24,17,7
Pils,nemesis,1624,druid,balance,60,39,21
Ablackdruid,moon-guard,1624,druid,balance,35,21,14
Khryllx,tichondrius,1623,druid,balance,30,20,10
Çørrúptíøñzx,tichondrius,1621,druid,balance,24,17,7
Harryhotter,blackrock,1621,druid,balance,61,30,31
Pizzaparties,tichondrius,1619,druid,balance,29,24,5
Realmehji,wyrmrest-accord,1619,druid,balance,30,23,7
Tunaren,wyrmrest-accord,1619,druid,balance,30,17,13
Jillferal,proudmoore,1618,druid,balance,42,28,14
Aethisra,moon-guard,1618,druid,balance,89,53,36
Lunalai,bloodhoof,1618,druid,balance,42,22,20
Wildslash,proudmoore,1617,druid,balance,75,37,38
Djsummer,tichondrius,1614,druid,balance,54,30,24
Psychotycxd,tichondrius,1613,druid,balance,30,17,13
Druiddruid,daggerspine,1608,druid,balance,41,28,13
Zeromoon,frostmourne,1608,druid,balance,41,20,21
Brokenomega,area-52,1603,druid,balance,78,49,29
Hoagiecannon,moon-guard,1603,druid,balance,125,70,55
Josepha,tichondrius,1596,druid,balance,24,17,7
Drdrulittle,darkspear,1595,druid,balance,54,29,25
Beamrooster,silvermoon,1586,druid,balance,36,23,13
Maviç,hyjal,1582,druid,balance,54,31,23
Myeow,illidan,1582,druid,balance,62,33,29
Shîfty,ysondre,1580,druid,balance,65,35,30
Ðøomkinz,azjolnerub,1579,druid,balance,30,21,9
Rayzer,bleeding-hollow,1578,druid,balance,66,37,29
Zettka,tichondrius,1575,druid,balance,38,25,13
Sombrien,stormrage,1573,druid,balance,90,46,44
Odirtytshirt,malganis,1572,druid,balance,37,20,17
Mûû,tichondrius,1567,druid,balance,48,29,19
Swoopy,stormrage,1563,druid,balance,79,44,35
Nightstalkr,kelthuzad,1559,druid,balance,124,73,51
Cauroth,azralon,1559,druid,balance,73,42,31
Hagatta,stormrage,1559,druid,balance,79,42,37
Polánd,area-52,1558,druid,balance,57,32,25
Fancynut,kiljaeden,1558,druid,balance,42,19,23
Syclonez,stormrage,1554,druid,balance,42,21,21
Swooped,emerald-dream,1549,druid,balance,47,27,20
Quelarre,velen,1544,druid,balance,28,18,10
Thespían,tichondrius,1540,druid,balance,192,103,89
Montrá,stormrage,1537,druid,balance,84,38,46
Pannaxx,tichondrius,1535,druid,balance,24,16,8
Duglas,illidan,1535,druid,balance,66,40,26
Quaras,frostmourne,1535,druid,balance,103,57,46
Atagoo,tichondrius,1535,druid,balance,90,48,42
Midoo,proudmoore,1535,druid,balance,44,22,22
Equinøxx,malganis,1534,druid,balance,18,16,2
Anchunlol,tichondrius,1534,druid,balance,30,16,14
Awkwarder,emerald-dream,1532,druid,balance,42,23,19
Hasteley,khadgar,1532,druid,balance,36,18,18
Hessenmèow,tichondrius,1532,druid,balance,36,16,20
Bcup,sargeras,1524,druid,balance,30,16,14
Sweatydruidx,tichondrius,1523,druid,balance,24,16,8
Musha,tichondrius,1517,druid,balance,57,30,27
Skyde,sargeras,1517,druid,balance,36,17,19
Boomchickens,area-52,1510,druid,balance,24,16,8
Seyedo,sargeras,1510,druid,balance,30,18,12
Haneulso,tichondrius,1509,druid,balance,74,45,29
Clense,tichondrius,1505,druid,balance,55,34,21
Sadsex,illidan,1505,druid,balance,71,42,29
Canek,ghostlands,1504,druid,balance,71,40,31
Jxrx,malganis,1501,druid,balance,24,16,8
Zhinger,tichondrius,1495,druid,balance,49,25,24
Krahz,lightnings-blade,1494,druid,balance,139,70,69
Gaawdx,illidan,1492,druid,balance,54,23,31
Syntheris,kaelthas,1491,druid,balance,57,36,21
Jemima,auchindoun,1487,druid,balance,54,31,23
Boome,blackrock,1485,druid,balance,42,22,20
Elyveen,proudmoore,1484,druid,balance,45,32,13
Stepbro,malorne,1484,druid,balance,95,53,42
Byte,ragnaros,1482,druid,balance,29,16,13
Blackjésüs,kelthuzad,1481,druid,balance,99,55,44
Starsurgê,tichondrius,1477,druid,balance,54,33,21
Fahnir,ragnaros,1477,druid,balance,66,37,29
Kuwä,proudmoore,1474,druid,balance,72,36,36
Kg,cenarion-circle,1473,druid,balance,89,54,35
Ellguin,malganis,1469,druid,balance,42,30,12
Neytîrî,tichondrius,1468,druid,balance,53,28,25
Unclenya,barthilas,1462,druid,balance,66,29,37
Animaldoctor,illidan,1459,druid,balance,27,17,10
Deviperdruid,frostmourne,1455,druid,balance,27,19,8
Envoy,sargeras,1453,druid,balance,36,22,14
Tinkeress,stormrage,1452,druid,balance,78,42,36
Rezlur,tichondrius,1452,druid,balance,35,16,19
Repanda,proudmoore,1451,druid,balance,71,37,34
Gullmock,quelthalas,1449,druid,balance,72,33,39
Groggs,frostwolf,1447,druid,balance,27,16,11
Monsin,illidan,1447,druid,balance,78,41,37
Kawshuhn,bleeding-hollow,1445,druid,balance,48,32,16
Rdruidchump,the-forgotten-coast,1445,druid,balance,32,19,13
Bighomïe,emerald-dream,1445,druid,balance,48,27,21
Instanodle,proudmoore,1442,druid,balance,30,17,13
Saeval,korgath,1441,druid,balance,54,32,22
Ripdimebag,frostmourne,1438,druid,balance,34,18,16
Nebulose,moon-guard,1437,druid,balance,55,25,30
Clarice,shattered-halls,1433,druid,balance,41,18,23
Jruids,stormrage,1432,druid,balance,30,19,11
Raddosaurus,area-52,1432,druid,balance,41,18,23
Djayolo,illidan,1431,druid,balance,18,15,3
Tahunne,tichondrius,1431,druid,balance,42,30,12
November,wyrmrest-accord,1426,druid,balance,62,33,29
Dreamkin,tichondrius,1424,druid,balance,36,17,19
Înfamous,thrall,1423,druid,balance,24,15,9
Mèowcenaary,chogall,1423,druid,balance,54,32,22
Starsaber,dalaran,1421,druid,balance,24,17,7
Itachi,dragonmaw,1420,druid,balance,30,15,15
Zoteqt,kelthuzad,1420,druid,balance,30,15,15
Crocface,tichondrius,1415,druid,balance,66,38,28
Bukkwild,stormrage,1414,druid,balance,18,15,3
Lavanis,stormrage,1413,druid,balance,125,65,60
Suncintus,aggramar,1410,druid,balance,42,17,25
Feroz,frostmourne,1409,druid,balance,24,15,9
Cowody,moon-guard,1408,druid,balance,23,18,5
Imnotinhuman,tichondrius,1405,druid,balance,35,22,13
Ihavehothots,kiljaeden,1404,druid,balance,26,17,9
Slyfoxx,stonemaul,1403,druid,balance,92,53,39
Nephdruid,stormrage,1402,druid,balance,30,19,11
Cobal,goldrinn,1402,druid,balance,239,114,125
Offthezaza,tichondrius,1401,druid,balance,30,15,15
Cudbacrakhed,tichondrius,1399,druid,balance,48,27,21
Zuice,thrall,1398,druid,balance,69,32,37
Âzn,tichondrius,1396,druid,balance,24,19,5
Ulcera,nemesis,1396,druid,balance,33,17,16
Cottonpaw,sargeras,1391,druid,balance,70,42,28
Indoee,mannoroth,1385,druid,balance,70,33,37
Cyeq,blackrock,1378,druid,balance,177,89,88
Padavore,wyrmrest-accord,1374,druid,balance,41,23,18
Shemeus,malganis,1374,druid,balance,54,27,27
Kuroshizen,tichondrius,1374,druid,balance,40,18,22
Huskars,tichondrius,1373,druid,balance,36,20,16
Chonkykitty,frostmourne,1364,druid,balance,24,16,8
Druuyid,jubeithos,1364,druid,balance,36,20,16
Alliess,aerie-peak,1363,druid,balance,72,34,38
Hikoro,sargeras,1360,druid,balance,72,41,31
Druiddreams,frostmourne,1358,druid,balance,24,17,7
Nxf,sargeras,1353,druid,balance,23,15,8
Mythelian,icecrown,1348,druid,balance,60,34,26
Gitsnshigles,frostmourne,1345,druid,balance,41,21,20
Barrah,barthilas,1343,druid,balance,35,19,16
Raquelitá,ragnaros,1339,druid,balance,22,15,7
Thorothir,ragnaros,1336,druid,balance,24,15,9
Sibby,barthilas,1334,druid,balance,24,14,10
Droody,earthen-ring,1333,druid,balance,40,20,20
Kamero,tichondrius,1332,druid,balance,27,15,12
Squidrific,tichondrius,1330,druid,balance,35,26,9
Xvenusaur,bleeding-hollow,1329,druid,balance,21,15,6
Reàsons,stormrage,1329,druid,balance,36,14,22
Soupbeandru,zuljin,1328,druid,balance,24,14,10
Tak,garrosh,1326,druid,balance,30,14,16
Barekat,emerald-dream,1324,druid,balance,22,15,7
Theirs,tichondrius,1324,druid,balance,101,60,41
Umadornahh,malganis,1319,druid,balance,24,14,10
Cabek,malganis,1319,druid,balance,24,14,10
Seneshy,azralon,1318,druid,balance,24,17,7
Pirira,quelthalas,1317,druid,balance,24,14,10
Shuxz,sargeras,1313,druid,balance,30,20,10
Evilakali,tichondrius,1311,druid,balance,49,27,22
Jonoa,nagrand,1310,druid,balance,43,27,16
Stepdru,sargeras,1308,druid,balance,24,14,10
Annef,tichondrius,1307,druid,balance,42,21,21
Ðjx,stormrage,1306,druid,balance,19,15,4
Kyabe,ragnaros,1298,druid,balance,49,19,30
Sergat,stormreaver,1296,druid,balance,36,19,17
Lønewolf,sargeras,1293,druid,balance,44,23,21
Justinheras,area-52,1289,druid,balance,34,18,16
Thatscute,moon-guard,1289,druid,balance,181,89,92
Sofereir,frostmourne,1272,druid,balance,72,30,42
Redbbull,tichondrius,1271,druid,balance,24,18,6
Softshirtxo,ragnaros,1271,druid,balance,24,14,10
Formmaster,malganis,1269,druid,balance,52,24,28
Flôkey,tichondrius,1268,druid,balance,30,15,15
Kallabaluwa,azralon,1265,druid,balance,29,14,15
Musclemilk,zuljin,1262,druid,balance,21,14,7
Axiomisop,tichondrius,1262,druid,balance,24,14,10
Furu,bonechewer,1262,druid,balance,36,16,20
Kydormi,stormrage,1260,druid,balance,45,19,26
Thickmoo,tichondrius,1259,druid,balance,57,24,33
Nimfaa,nemesis,1249,druid,balance,30,17,13
Starfail,illidan,1248,druid,balance,24,13,11
Dirtdog,uther,1246,druid,balance,24,13,11
Mntra,emerald-dream,1245,druid,balance,18,13,5
Shivlary,stormrage,1244,druid,balance,21,15,6
Darkombra,frostmourne,1241,druid,balance,24,13,11
Eldenis,drakkari,1241,druid,balance,30,14,16
Kletys,azralon,1240,druid,balance,24,13,11
Boõsty,bleeding-hollow,1238,druid,balance,24,13,11
Snugglin,kelthuzad,1237,druid,balance,30,13,17
Roundtummy,area-52,1234,druid,balance,24,13,11
Nophysique,zuljin,1234,druid,balance,30,13,17
Boxtops,bleeding-hollow,1230,druid,balance,18,13,5
Dontfloodit,tichondrius,1228,druid,balance,30,13,17
Vicorin,illidan,1226,druid,balance,24,13,11
Winekoolers,malganis,1222,druid,balance,24,13,11
Ernest,goldrinn,1222,druid,balance,33,15,18
Noteff,illidan,1220,druid,balance,18,13,5
Guojue,tichondrius,1220,druid,balance,35,19,16
Deths1F9F2B,frostmourne,1219,druid,balance,18,13,5
Deths,frostmourne,1219,druid,balance,18,13,5
Acidmoon,tichondrius,1219,druid,balance,46,19,27
Vuginas,bleeding-hollow,1215,druid,balance,62,33,29
Édzar,area-52,1211,druid,balance,37,17,20
Daddyshift,proudmoore,1209,druid,balance,26,14,12
Trollsmind,tichondrius,1202,druid,balance,28,14,14
Thehooligan,stormrage,1200,druid,balance,75,41,34
Nolifer,sargeras,1192,druid,balance,30,17,13
Dumdumdugan,korgath,1191,druid,balance,83,41,42
Møønscar,tichondrius,1188,druid,balance,42,20,22
Solarcannon,shuhalo,1185,druid,balance,72,35,37
Quincunx,tichondrius,1181,druid,balance,70,39,31
Strallà,illidan,1177,druid,balance,30,15,15
Sunboy,tichondrius,1177,druid,balance,67,32,35
Shapedance,sargeras,1177,druid,balance,29,13,16
Kattel,blackrock,1171,druid,balance,30,16,14
Dojacow,mannoroth,1154,druid,balance,34,16,18
Locose,black-dragonflight,1151,druid,balance,18,12,6
Ilovediegoxo,kelthuzad,1151,druid,balance,18,12,6
Katbriel,zuljin,1151,druid,balance,18,12,6
Verbz,arthas,1150,druid,balance,24,12,12
Mk,caelestrasz,1148,druid,balance,18,12,6
Zesto,nazjatar,1144,druid,balance,18,12,6
Lawlz,aegwynn,1144,druid,balance,45,25,20
Saturday,frostmourne,1137,druid,balance,18,12,6
Thunderhox,tichondrius,1135,druid,balance,24,12,12
Juicywap,proudmoore,1134,druid,balance,24,12,12
Rootchan,azralon,1130,druid,balance,18,12,6
Prismo,ravencrest,1129,druid,balance,24,12,12
Coppersnout,moon-guard,1118,druid,balance,48,27,21
Mercz,illidan,1111,druid,balance,18,12,6
Angryjo,tichondrius,1103,druid,balance,17,12,5
Réko,sargeras,1095,druid,balance,22,13,9
Alucardxd,ragnaros,1094,druid,balance,29,12,17
Krazykritz,illidan,1090,druid,balance,27,13,14
Thèbearjèw,tichondrius,1089,druid,balance,35,15,20
Gorgoncity,illidan,1088,druid,balance,22,12,10
Tahnu,deathwing,1070,druid,balance,17,12,5
Levincy,thrall,1064,druid,balance,36,18,18
Kittiepurry,blackrock,1059,druid,balance,30,13,17
Wnxmomthicc,tichondrius,1056,druid,balance,18,11,7
Gspx,dalaran,1056,druid,balance,18,11,7
Slickitty,kelthuzad,1056,druid,balance,18,11,7
Chanimal,tichondrius,1055,druid,balance,12,11,1
Wallower,malganis,1055,druid,balance,18,11,7
Moonrg,stormrage,1055,druid,balance,18,11,7
Coldkill,burning-legion,1055,druid,balance,18,11,7
Kydro,sargeras,1055,druid,balance,18,11,7
Mooseknukel,zuljin,1055,druid,balance,18,11,7
Docleave,tichondrius,1055,druid,balance,18,11,7
Buffjungle,tichondrius,1055,druid,balance,24,11,13
Smeepy,bleeding-hollow,1055,druid,balance,24,11,13
Aule,frostmourne,1055,druid,balance,24,11,13
Nodadpullout,tichondrius,1054,druid,balance,18,11,7
Yaboydave,stonemaul,1054,druid,balance,18,11,7
Buffclyde,blackrock,1054,druid,balance,18,11,7
Pankecito,ragnaros,1054,druid,balance,18,11,7
Rashmi,kiljaeden,1054,druid,balance,18,11,7
Lyshani,thrall,1054,druid,balance,18,11,7
Formhub,malganis,1054,druid,balance,24,13,11
Quefemme,kelthuzad,1053,druid,balance,18,11,7
Treeshift,tichondrius,1053,druid,balance,18,11,7
Halenson,illidan,1053,druid,balance,22,12,10
Convokeula,tichondrius,1051,druid,balance,18,11,7
Roar,moon-guard,1051,druid,balance,18,11,7
Boostgu,illidan,1050,druid,balance,18,11,7
Nozgöth,quelthalas,1050,druid,balance,45,23,22
Spicydurid,tichondrius,1050,druid,balance,24,11,13
Balverixqt,tichondrius,1048,druid,balance,24,11,13
Chikenflu,tichondrius,1047,druid,balance,22,11,11
Drunknoodles,stormrage,1047,druid,balance,24,11,13
Kogiid,moon-guard,1046,druid,balance,18,11,7
Deathkahn,lightninghoof,1044,druid,balance,24,11,13
Tankbareass,aerie-peak,1042,druid,balance,24,11,13
Kuthian,moon-guard,1040,druid,balance,33,13,20
Treeteej,kelthuzad,1036,druid,balance,30,12,18
Hosehead,malganis,1035,druid,balance,18,11,7
Lumipawz,frostmourne,1014,druid,balance,19,12,7
Breynna,draenor,1012,druid,balance,23,11,12
Crazystorm,ragnaros,1011,druid,balance,18,11,7
Floridajoe,blackrock,1010,druid,balance,18,11,7
Catrene,mannoroth,989,druid,balance,26,17,9
Lightconvoke,norgannon,987,druid,balance,20,11,9
Xevão,nemesis,987,druid,balance,20,11,9
Rakelan,tichondrius,986,druid,balance,86,46,40
Surfingbird,tichondrius,983,druid,balance,15,12,3
Indy,rivendare,980,druid,balance,22,11,11
Vapeculture,lightbringer,977,druid,balance,36,21,15
Smashthatbox,illidan,977,druid,balance,32,12,20
Borrdru,arthas,960,druid,balance,12,10,2
Irl,frostmane,960,druid,balance,12,10,2
Elvishrage,zuljin,960,druid,balance,12,10,2
Jubi,bleeding-hollow,960,druid,balance,12,10,2
Roben,tichondrius,960,druid,balance,18,10,8
Rizzit,wyrmrest-accord,960,druid,balance,18,10,8
Hefkerd,tichondrius,960,druid,balance,18,10,8
Jshwills,sargeras,959,druid,balance,12,10,2
Furryswipe,proudmoore,959,druid,balance,12,10,2
Yazmawma,tichondrius,959,druid,balance,18,10,8
Kohru,moon-guard,959,druid,balance,18,10,8
Trippyshift,hyjal,959,druid,balance,18,10,8
Wildsïde,tichondrius,958,druid,balance,12,10,2
Meatcat,sargeras,958,druid,balance,18,10,8
Lunarbalance,veknilash,958,druid,balance,24,10,14
Messyboom,illidan,957,druid,balance,12,10,2
Odweaven,thunderlord,956,druid,balance,18,10,8
Paddywhacked,tichondrius,956,druid,balance,18,10,8
Nasuu,bleeding-hollow,955,druid,balance,18,10,8
Drewpg,zuljin,955,druid,balance,18,10,8
Wiiee,darkspear,955,druid,balance,18,10,8
Minusdruid,dalaran,953,druid,balance,24,10,14
Veraciouss,sargeras,952,druid,balance,18,10,8
Crunkk,thunderlord,952,druid,balance,18,10,8
Audacities,bloodhoof,952,druid,balance,18,10,8
Miggzii,draka,952,druid,balance,34,15,19
Nalarin,kaelthas,947,druid,balance,54,28,26
Athious,moon-guard,909,druid,balance,29,13,16
Bellä,nazjatar,900,druid,balance,37,11,26
Bäñgarang,tichondrius,878,druid,balance,25,10,15
Bathrobe,bloodscalp,864,druid,balance,12,9,3
Hydrahl,thrall,864,druid,balance,12,9,3
Zebyn,tichondrius,864,druid,balance,12,9,3
Scurse,tichondrius,864,druid,balance,12,9,3
Comidru,tichondrius,864,druid,balance,18,9,9
Mastabtw,illidan,864,druid,balance,18,9,9
Jssy,tichondrius,864,druid,balance,18,9,9
Mvpps,thrall,864,druid,balance,18,9,9
Mõoõoõoõoõoõ,tichondrius,864,druid,balance,18,9,9
Nicotinefien,sargeras,864,druid,balance,18,9,9
Cyclone,darkspear,864,druid,balance,24,9,15
Sueycide,tichondrius,864,druid,balance,30,9,21
Renithen,trollbane,863,druid,balance,12,9,3
Tummycummy,thrall,863,druid,balance,12,9,3
Starcastic,tichondrius,863,druid,balance,12,9,3
Goochies,aerie-peak,863,druid,balance,18,9,9
Môônkîn,chogall,863,druid,balance,18,9,9
Héisénbérg,sargeras,863,druid,balance,18,9,9
Driftwood,bonechewer,862,druid,balance,12,9,3
Faroo,azralon,862,druid,balance,12,9,3
Oreoshift,illidan,862,druid,balance,12,9,3
Zugdruid,tichondrius,862,druid,balance,13,9,4
Furrmissile,area-52,862,druid,balance,18,9,9
Ghostowl,thrall,861,druid,balance,12,9,3
Nanashi,tichondrius,861,druid,balance,18,9,9
Sanleba,tichondrius,860,druid,balance,18,9,9
Torrox,tichondrius,858,druid,balance,24,9,15
Amandi,magtheridon,858,druid,balance,24,9,15
Stupidranga,barthilas,857,druid,balance,18,9,9
Dèmønblâckev,malganis,842,druid,balance,24,11,13
Kzinti,zuluhed,815,druid,balance,17,9,8
Meliódás,area-52,804,druid,balance,114,44,70
Spazz,firetree,783,druid,balance,11,9,2
Faerie,kaelthas,768,druid,balance,12,8,4
Yøpìèrre,zuljin,768,druid,balance,12,8,4
Pänzerkin,sargeras,768,druid,balance,12,8,4
Columpio,area-52,768,druid,balance,12,8,4
Elyiaida,emerald-dream,768,druid,balance,12,8,4
Chayten,bleeding-hollow,768,druid,balance,12,8,4
Azakai,sargeras,768,druid,balance,12,8,4
Mcy,nerzhul,768,druid,balance,12,8,4
Shibbith,nordrassil,768,druid,balance,12,8,4
Nyzear,bleeding-hollow,768,druid,balance,12,8,4
Argento,frostmourne,768,druid,balance,12,8,4
Laserxo,tichondrius,768,druid,balance,12,8,4
Maxspeed,tichondrius,768,druid,balance,12,8,4
Boomfold,tichondrius,768,druid,balance,18,8,10
Onsen,tichondrius,768,druid,balance,18,8,10
Qs,rivendare,768,druid,balance,18,8,10
Arntu,malganis,767,druid,balance,12,8,4
Starbender,arygos,767,druid,balance,12,8,4
Davo,tichondrius,767,druid,balance,12,8,4
Softkiller,chogall,767,druid,balance,12,8,4
Ssïp,tichondrius,767,druid,balance,12,8,4
Treemendous,nemesis,767,druid,balance,12,8,4
Harddeenball,area-52,767,druid,balance,15,9,6
Ebonclaw,malganis,767,druid,balance,18,8,10
Jiya,zuljin,767,druid,balance,18,8,10
Khristine,spinebreaker,767,druid,balance,24,8,16
Onidudu,frostmourne,766,druid,balance,12,8,4
Lunapuma,stonemaul,765,druid,balance,12,8,4
Whitekongg,blackhand,765,druid,balance,15,9,6
Sefestria,senjin,765,druid,balance,18,8,10
Råstafart,tichondrius,764,druid,balance,18,8,10
Wabbehkus,barthilas,764,druid,balance,26,8,18
Psnárf,area-52,763,druid,balance,12,8,4
Dirtydot,ragnaros,762,druid,balance,12,8,4
Bethemarble,sargeras,762,druid,balance,18,8,10
Dennyyd,illidan,759,druid,balance,12,8,4
Malamew,antonidas,756,druid,balance,12,8,4
Seilah,lightbringer,735,druid,balance,14,9,5
Outclone,tichondrius,734,druid,balance,10,9,1
Cowel,tichondrius,687,druid,balance,13,8,5
Kitinglol,alexstrasza,672,druid,balance,12,7,5
Covidcarrier,thrall,672,druid,balance,12,7,5
Sym,zuljin,672,druid,balance,12,7,5
Psilo,kelthuzad,672,druid,balance,12,7,5
Fastlife,drakkari,672,druid,balance,12,7,5
Nickyü,ragnaros,672,druid,balance,12,7,5
Xioqt,chogall,672,druid,balance,12,7,5
Flapping,illidan,672,druid,balance,12,7,5
Ottovonbird,tichondrius,672,druid,balance,12,7,5
Eseldra,area-52,672,druid,balance,12,7,5
Chøpstixs,bleeding-hollow,672,druid,balance,12,7,5
Instar,tichondrius,672,druid,balance,12,7,5
Slickthick,sargeras,672,druid,balance,12,7,5
Floofi,kelthuzad,672,druid,balance,12,7,5
Junaleska,lightbringer,672,druid,balance,12,7,5
Likorit,azralon,672,druid,balance,12,7,5
Nokther,muradin,672,druid,balance,12,7,5
Hogd,illidan,672,druid,balance,18,7,11
Buckwhêât,illidan,672,druid,balance,18,7,11
Trashytrash,bleeding-hollow,672,druid,balance,18,7,11
Dooruid,tichondrius,672,druid,balance,18,7,11
Dgas,tichondrius,671,druid,balance,12,7,5
Gravshift,zuljin,671,druid,balance,12,7,5
Jubeam,area-52,671,druid,balance,12,7,5
Aralix,zuljin,671,druid,balance,12,7,5
Woog,moon-guard,671,druid,balance,12,7,5
Lokdu,area-52,671,druid,balance,12,7,5
Lãzy,tichondrius,671,druid,balance,12,7,5
Wyldthangz,stormrage,671,druid,balance,18,7,11
Milksquirts,thrall,671,druid,balance,18,7,11
Shebleeder,aegwynn,671,druid,balance,18,7,11
Flatnose,agamaggan,671,druid,balance,18,7,11
Oâk,farstriders,670,druid,balance,12,7,5
Chukksz,nerzhul,670,druid,balance,12,7,5
Hootyhoot,illidan,670,druid,balance,12,7,5
Vicvc,tichondrius,669,druid,balance,12,7,5
Eurotrance,frostmourne,669,druid,balance,12,7,5
Onecalf,tichondrius,668,druid,balance,12,7,5
Coqeh,frostwolf,664,druid,balance,12,7,5
Beammz,stormrage,664,druid,balance,15,8,7
Meiling,spirestone,659,druid,balance,12,7,5
Doomkiñ,darkspear,639,druid,balance,17,7,10
Tumblr,terenas,624,druid,balance,9,7,2
Shifterx,illidan,618,druid,balance,16,11,5
Chankletta,quelthalas,618,druid,balance,18,8,10
Warberton,moon-guard,616,druid,balance,15,7,8
Zalothianx,thrall,608,druid,balance,16,7,9
Aranuir,emerald-dream,607,druid,balance,11,7,4
Boomchí,tichondrius,576,druid,balance,6,6,0
Dreamwalker,bleeding-hollow,576,druid,balance,6,6,0
Ory,illidan,576,druid,balance,6,6,0
Evsn,tichondrius,576,druid,balance,6,6,0
Prev,arathor,576,druid,balance,6,6,0
Astrixx,frostmourne,576,druid,balance,6,6,0
Starship,frostmourne,576,druid,balance,6,6,0
Doomky,area-52,576,druid,balance,12,6,6
Rikishi,executus,576,druid,balance,12,6,6
Milkshift,demon-soul,576,druid,balance,12,6,6
Starboy,garona,576,druid,balance,12,6,6
Lunartiç,kelthuzad,576,druid,balance,12,6,6
Nerfdemo,kiljaeden,576,druid,balance,12,6,6
Gordzak,illidan,576,druid,balance,12,6,6
Boomsquanch,emerald-dream,576,druid,balance,12,6,6
Muagor,tichondrius,576,druid,balance,12,6,6
Valranor,stormrage,576,druid,balance,12,6,6
Ggae,tichondrius,576,druid,balance,12,6,6
Faletra,eitrigg,576,druid,balance,12,6,6
Treehard,malganis,576,druid,balance,12,6,6
Kekepöp,illidan,576,druid,balance,12,6,6
Jmackd,frostmourne,576,druid,balance,12,6,6
Gâlaxy,sargeras,576,druid,balance,12,6,6
Celetra,kiljaeden,576,druid,balance,12,6,6
Soonntkgo,ragnaros,576,druid,balance,12,6,6
Cheezaygx,arthas,576,druid,balance,12,6,6
Moohok,bleeding-hollow,576,druid,balance,12,6,6
Renamebdsm,cenarius,576,druid,balance,12,6,6
Bigherbo,zuljin,576,druid,balance,12,6,6
Skydín,stormrage,576,druid,balance,12,6,6
Fironous,nerzhul,576,druid,balance,12,6,6
Hugodruid,frostmourne,576,druid,balance,12,6,6
Frostig,tichondrius,576,druid,balance,12,6,6
Notpodruida,tichondrius,576,druid,balance,13,6,7
Kushidabs,tichondrius,576,druid,balance,16,7,9
Ailari,moon-guard,576,druid,balance,16,6,10
Longnus,stormrage,576,druid,balance,18,6,12
Donresantis,stormreaver,576,druid,balance,18,6,12
Droodad,mannoroth,576,druid,balance,18,6,12
Mooing,azralon,575,druid,balance,6,6,0
Jherrak,area-52,575,druid,balance,6,6,0
Alphakatt,area-52,575,druid,balance,12,6,6
Yehaw,bloodhoof,575,druid,balance,12,6,6
Jal,khazgoroth,575,druid,balance,12,6,6
Beleraine,moon-guard,575,druid,balance,12,6,6
Tariksha,sargeras,575,druid,balance,12,6,6
Chodkiewicz,echo-isles,575,druid,balance,12,6,6
Runarok,ragnaros,575,druid,balance,12,6,6
Guybranch,illidan,575,druid,balance,12,6,6
Dampnr,tichondrius,575,druid,balance,12,6,6
Slingin,illidan,575,druid,balance,18,6,12
Brawndiboom,stormrage,575,druid,balance,18,6,12
Hootie,arygos,575,druid,balance,18,6,12
Araminka,drakkari,573,druid,balance,6,6,0
Mctree,cenarius,572,druid,balance,12,6,6
Casaran,anetheron,543,druid,balance,11,6,5
Drufasa,tichondrius,527,druid,balance,11,6,5
Fleasy,wyrmrest-accord,511,druid,balance,8,6,2
Gemineye,stormrage,511,druid,balance,11,6,5
Velaana,tichondrius,511,druid,balance,20,6,14
Ðarkscar,laughing-skull,509,druid,balance,14,6,8
Slumpxaddy,illidan,480,druid,balance,6,5,1
Xiaoshuaigê,illidan,480,druid,balance,6,5,1
Jacknit,illidan,480,druid,balance,6,5,1
Daroot,spinebreaker,480,druid,balance,6,5,1
Nephsis,kelthuzad,480,druid,balance,6,5,1
Mcv,tichondrius,480,druid,balance,6,5,1
Dtefy,ragnaros,480,druid,balance,6,5,1
Aoewynn,nerzhul,480,druid,balance,6,5,1
Jentlegiant,tichondrius,480,druid,balance,6,5,1
Dahts,destromath,480,druid,balance,6,5,1
Charnlok,thunderlord,480,druid,balance,6,5,1
Rootslayer,tichondrius,480,druid,balance,6,5,1
Miçangak,azralon,480,druid,balance,6,5,1
Numbkin,stormrage,480,druid,balance,6,5,1
Ratspot,stormrage,480,druid,balance,6,5,1
Canuatemyrat,tichondrius,480,druid,balance,6,5,1
Dànkness,frostwolf,480,druid,balance,6,5,1
Gerrt,bleeding-hollow,480,druid,balance,6,5,1
Dojacat,tichondrius,480,druid,balance,6,5,1
Bumbleebee,azralon,480,druid,balance,6,5,1
Arwëna,tichondrius,480,druid,balance,6,5,1
Yokux,thunderlord,480,druid,balance,6,5,1
Laser,bonechewer,480,druid,balance,6,5,1
Bearyhalls,sargeras,480,druid,balance,6,5,1
Katobe,tichondrius,480,druid,balance,6,5,1
Mithroi,tichondrius,480,druid,balance,6,5,1
Hooffy,emerald-dream,480,druid,balance,6,5,1
Skum,bloodscalp,480,druid,balance,6,5,1
Hawkk,azralon,480,druid,balance,9,6,3
Haymade,sargeras,480,druid,balance,12,5,7
Drcuy,ragnaros,480,druid,balance,12,5,7
Chaossdruid,bleeding-hollow,480,druid,balance,12,5,7
Bigtammy,moon-guard,480,druid,balance,12,5,7
Livilla,sargeras,480,druid,balance,12,5,7
Fluff,gurubashi,480,druid,balance,12,5,7
Venkin,gnomeregan,480,druid,balance,12,5,7
Bearwithit,sargeras,480,druid,balance,12,5,7
Dotdmage,tichondrius,480,druid,balance,12,5,7
Sodacream,illidan,480,druid,balance,12,5,7
Bigdaddyferg,illidan,480,druid,balance,12,5,7
Tôpdadwôrld,sargeras,480,druid,balance,12,5,7
Cynderellaa,proudmoore,480,druid,balance,12,5,7
Ragerag,trollbane,480,druid,balance,12,5,7
Havócdh,tichondrius,480,druid,balance,12,5,7
Huggerino,stormrage,480,druid,balance,12,5,7
Rakex,tichondrius,480,druid,balance,12,5,7
Paintlicker,emerald-dream,480,druid,balance,12,5,7
Indicamicah,tichondrius,480,druid,balance,12,5,7
Druizzy,illidan,480,druid,balance,18,5,13
Tuppyboom,barthilas,480,druid,balance,18,5,13
Crashägásm,proudmoore,479,druid,balance,12,5,7
Damallis,anubarak,479,druid,balance,12,5,7
Dkat,malganis,479,druid,balance,12,5,7
Smhyle,frostmourne,479,druid,balance,12,5,7
Boatox,jubeithos,479,druid,balance,18,5,13
Charmandxr,hyjal,447,druid,balance,14,6,8
Velais,exodar,416,druid,balance,16,5,11
Grgcostanza,bleeding-hollow,414,druid,balance,8,5,3
Flappyjacks,elune,384,druid,balance,6,4,2
Nicklul,llane,384,druid,balance,6,4,2
Bâzinga,bleeding-hollow,384,druid,balance,6,4,2
Feathergun,ragnaros,384,druid,balance,6,4,2
Runforest,tichondrius,384,druid,balance,6,4,2
Fätål,ysera,384,druid,balance,6,4,2
Crépes,bleeding-hollow,384,druid,balance,6,4,2
Killiamp,tichondrius,384,druid,balance,6,4,2
Tinishaker,ragnaros,384,druid,balance,6,4,2
Tinkker,zuljin,384,druid,balance,6,4,2
Joiczar,maelstrom,384,druid,balance,6,4,2
Drubuzz,tichondrius,384,druid,balance,6,4,2
Blizdontcuur,area-52,384,druid,balance,6,4,2
Bearlylegál,sargeras,384,druid,balance,6,4,2
Bruddahderpp,tichondrius,384,druid,balance,6,4,2
Abelladañger,area-52,384,druid,balance,6,4,2
Withwind,dalaran,384,druid,balance,6,4,2
Aton,frostwolf,384,druid,balance,6,4,2
Barrahjr,frostmourne,384,druid,balance,6,4,2
Druz,spirestone,384,druid,balance,6,4,2
Beefnudlsoup,tichondrius,384,druid,balance,6,4,2
Somarythe,moon-guard,384,druid,balance,6,4,2
Nevershiftx,kirin-tor,384,druid,balance,6,4,2
Kiwidru,frostmourne,384,druid,balance,6,4,2
Komaner,frostmourne,384,druid,balance,6,4,2
Wizdùm,frostmourne,384,druid,balance,6,4,2
Harlisu,stormrage,384,druid,balance,6,4,2
Wòót,stormreaver,384,druid,balance,6,4,2
Twostars,thrall,384,druid,balance,6,4,2
Yoloboomkin,tichondrius,384,druid,balance,6,4,2
Daddyfresh,ursin,384,druid,balance,6,4,2
Dokasaurus,lightbringer,384,druid,balance,6,4,2
Selfplay,barthilas,384,druid,balance,6,4,2
Rennar,stormrage,384,druid,balance,6,4,2
Keylae,sargeras,384,druid,balance,6,4,2
Yaboidakota,stormrage,384,druid,balance,6,4,2
Pawpurrazzi,darkspear,384,druid,balance,6,4,2
Justsidious,sargeras,384,druid,balance,6,4,2
Elonmuskirl,illidan,384,druid,balance,6,4,2
Moozzash,azralon,384,druid,balance,6,4,2
Rokk,baelgun,384,druid,balance,6,4,2
Bäldir,dalaran,384,druid,balance,6,4,2
Armorkits,area-52,384,druid,balance,6,4,2
Gummoo,tichondrius,384,druid,balance,6,4,2
Theboomkin,kelthuzad,384,druid,balance,6,4,2
Lukass,tichondrius,384,druid,balance,6,4,2
Donaldsr,area-52,384,druid,balance,6,4,2
Matinee,tichondrius,384,druid,balance,6,4,2
Hëllchaos,sargeras,384,druid,balance,6,4,2
Matock,malganis,384,druid,balance,6,4,2
Foafoa,illidan,384,druid,balance,6,4,2
Nuubmurph,stormrage,384,druid,balance,9,5,4
Balancz,thrall,384,druid,balance,10,5,5
Sinistuhd,tichondrius,384,druid,balance,12,4,8
Vashida,stormrage,384,druid,balance,12,4,8
Datdruidrod,illidan,384,druid,balance,12,4,8
Inuyasha,sargeras,384,druid,balance,12,4,8
Lutein,tichondrius,384,druid,balance,12,4,8
Dárách,malganis,384,druid,balance,12,4,8
Wintarz,sargeras,384,druid,balance,12,4,8
Zentabra,proudmoore,384,druid,balance,12,4,8
Velaar,arthas,384,druid,balance,12,4,8
Astrals,runetotem,384,druid,balance,12,4,8
Liñk,sargeras,384,druid,balance,12,4,8
Barkcheeks,area-52,384,druid,balance,12,4,8
Metal,jaedenar,384,druid,balance,12,4,8
Jâykeup,lightbringer,384,druid,balance,12,4,8
Maldobear,stormrage,384,druid,balance,12,4,8
Finntröll,area-52,384,druid,balance,12,4,8
Madisonivyx,area-52,384,druid,balance,12,4,8
Dolwizz,tichondrius,384,druid,balance,12,4,8
Sorh,stormrage,384,druid,balance,12,4,8
Jakermans,area-52,384,druid,balance,12,4,8
Katdog,warsong,384,druid,balance,18,4,14
Krunge,frostwolf,383,druid,balance,6,4,2
Rahkaaga,kiljaeden,383,druid,balance,6,4,2
Balthøs,moon-guard,383,druid,balance,6,4,2
Dodid,laughing-skull,383,druid,balance,12,4,8
Sever,ysera,382,druid,balance,12,4,8
Imshiftastic,area-52,360,druid,balance,16,7,9
Kimnim,tichondrius,330,druid,balance,9,6,3
Ihjx,sargeras,330,druid,balance,11,6,5
Sodah,tichondrius,288,druid,balance,6,3,3
Rslm,tichondrius,288,druid,balance,6,3,3
Catahoula,lothar,288,druid,balance,6,3,3
Sawachicky,frostmourne,288,druid,balance,6,3,3
Mådge,frostmourne,288,druid,balance,6,3,3
Jgb,dalaran,288,druid,balance,6,3,3
Polyproof,emerald-dream,288,druid,balance,6,3,3
Smokeheaters,dalaran,288,druid,balance,6,3,3
Davione,tichondrius,288,druid,balance,6,3,3
Ðeepsixx,burning-legion,288,druid,balance,6,3,3
Bamfferal,tichondrius,288,druid,balance,6,3,3
Wrathmighty,frostmourne,288,druid,balance,6,3,3
Çãñçèr,frostmourne,288,druid,balance,6,3,3
Piping,thunderlord,288,druid,balance,6,3,3
Kaldelar,emerald-dream,288,druid,balance,6,3,3
Ornaaga,blackrock,288,druid,balance,6,3,3
Starsurgeon,thrall,288,druid,balance,6,3,3
Iploopedyogf,bleeding-hollow,288,druid,balance,6,3,3
Raximus,moon-guard,288,druid,balance,6,3,3
Ephwürd,malganis,288,druid,balance,6,3,3
Samsshifter,tichondrius,288,druid,balance,6,3,3
Spooser,proudmoore,288,druid,balance,6,3,3
Icastsmells,tichondrius,288,druid,balance,6,3,3
Snailtail,shattered-hand,288,druid,balance,6,3,3
Painsbrook,thrall,288,druid,balance,6,3,3
Silynce,tichondrius,288,druid,balance,6,3,3
Pergutory,frostmourne,288,druid,balance,6,3,3
Hitchslaps,tichondrius,288,druid,balance,6,3,3
Thumpb,bronzebeard,288,druid,balance,6,3,3
Taztoc,stormrage,288,druid,balance,6,3,3
Snartx,illidan,288,druid,balance,6,3,3
Goldentaint,tichondrius,288,druid,balance,6,3,3
Slottpocket,malganis,288,druid,balance,6,3,3
Alcorria,area-52,288,druid,balance,6,3,3
Olongjonsson,wyrmrest-accord,288,druid,balance,6,3,3
Waiv,area-52,288,druid,balance,6,3,3
Aconcat,bleeding-hollow,288,druid,balance,6,3,3
Stretchhxd,tichondrius,288,druid,balance,6,3,3
Tinyypuppyy,sargeras,288,druid,balance,6,3,3
Roots,boulderfist,288,druid,balance,6,3,3
Uuli,area-52,288,druid,balance,6,3,3
Mastahskills,illidan,288,druid,balance,6,3,3
Gaiä,crushridge,288,druid,balance,6,3,3
Antiherø,sargeras,288,druid,balance,6,3,3
Hchhi,ragnaros,288,druid,balance,6,3,3
Jxred,illidan,288,druid,balance,6,3,3
Shalaz,magtheridon,288,druid,balance,6,3,3
Azoth,hyjal,288,druid,balance,6,3,3
Shaftomatic,tichondrius,288,druid,balance,6,3,3
Jinglebells,kiljaeden,288,druid,balance,6,3,3
Retsarehard,illidan,288,druid,balance,8,3,5
Wreckingcrew,emerald-dream,288,druid,balance,8,3,5
Cêania,moon-guard,288,druid,balance,12,3,9
Bigboðm,tichondrius,288,druid,balance,12,3,9
Yorch,stormrage,288,druid,balance,12,3,9
Xalstarrot,sargeras,288,druid,balance,12,3,9
Jalapenoz,wyrmrest-accord,288,druid,balance,12,3,9
Lavenderowl,arthas,288,druid,balance,12,3,9
Davelombardo,tichondrius,288,druid,balance,12,3,9
Monicaduan,frostmourne,288,druid,balance,12,3,9
Uezzon,tol-barad,288,druid,balance,12,3,9
Evarene,vashj,288,druid,balance,12,3,9
Azevedoo,nemesis,288,druid,balance,19,3,16
Jokey,quelthalas,286,druid,balance,6,3,3
Elydaria,destromath,286,druid,balance,6,3,3
Vollzar,sargeras,255,druid,balance,11,3,8
Oddclaw,stormrage,239,druid,balance,5,3,2
Tanawak,tichondrius,239,druid,balance,5,3,2
Jazzman,jubeithos,223,druid,balance,14,3,11
Cattdog,tichondrius,208,druid,balance,7,3,4
Koratan,frostmourne,208,druid,balance,7,3,4
Nokash,tichondrius,192,druid,balance,6,2,4
Guap,bleeding-hollow,192,druid,balance,6,2,4
Mythicdruid,ragnaros,192,druid,balance,6,2,4
Hawgs,bleeding-hollow,192,druid,balance,6,2,4
Elatheris,stormrage,192,druid,balance,6,2,4
Ginunaga,tichondrius,192,druid,balance,6,2,4
Bignosecow,illidan,192,druid,balance,6,2,4
Edinhalfhorn,bonechewer,192,druid,balance,6,2,4
Treezyn,sargeras,192,druid,balance,6,2,4
Moistism,tichondrius,192,druid,balance,6,2,4
Crycloné,stormrage,192,druid,balance,6,2,4
Tasselhoof,hyjal,192,druid,balance,6,2,4
Maidah,malganis,192,druid,balance,6,2,4
Fourthkind,illidan,192,druid,balance,6,2,4
Bullwïnkle,uther,192,druid,balance,6,2,4
Absentteeth,stormrage,192,druid,balance,6,2,4
Sloppysheila,sargeras,192,druid,balance,6,2,4
Scykin,stormrage,192,druid,balance,6,2,4
Aozeh,kiljaeden,192,druid,balance,6,2,4
Skke,barthilas,192,druid,balance,6,2,4
Hancalimon,nemesis,192,druid,balance,6,2,4
Hream,echo-isles,192,druid,balance,6,2,4
Spicyorange,dalaran,192,druid,balance,6,2,4
Spudpatikins,barthilas,192,druid,balance,6,2,4
Hagenws,azralon,192,druid,balance,6,2,4
Palermo,aerie-peak,192,druid,balance,6,2,4
Variandruid,kelthuzad,192,druid,balance,6,2,4
Hellabanx,tichondrius,192,druid,balance,6,2,4
Arienne,kelthuzad,192,druid,balance,6,2,4
Pawswap,tichondrius,192,druid,balance,6,2,4
Martians,laughing-skull,192,druid,balance,6,2,4
Adonalsium,area-52,192,druid,balance,6,2,4
Mäûled,fizzcrank,192,druid,balance,6,2,4
Zigh,azralon,192,druid,balance,6,2,4
Ssantirap,quelthalas,192,druid,balance,6,2,4
Zukru,malganis,192,druid,balance,6,2,4
Tanguanota,quelthalas,192,druid,balance,6,2,4
Moonhorn,kelthuzad,192,druid,balance,6,2,4
Srbestias,quelthalas,192,druid,balance,6,2,4
Maimz,tichondrius,192,druid,balance,6,2,4
Octacer,malfurion,192,druid,balance,6,2,4
Explicít,sargeras,192,druid,balance,6,2,4
Felløwship,nemesis,192,druid,balance,6,2,4
Nobullshift,icecrown,192,druid,balance,6,2,4
Mortqt,tichondrius,192,druid,balance,6,2,4
Gazwazluz,lothar,192,druid,balance,6,2,4
Dudur,zuljin,192,druid,balance,6,2,4
Dalaverrunis,tichondrius,192,druid,balance,6,2,4
Purkins,barthilas,192,druid,balance,6,2,4
Mulgorer,tichondrius,192,druid,balance,6,2,4
Zorn,lightnings-blade,192,druid,balance,6,2,4
Totorostard,tichondrius,192,druid,balance,6,2,4
Cbreezyy,tichondrius,192,druid,balance,6,2,4
Speaks,moon-guard,192,druid,balance,6,2,4
Markóla,stormrage,192,druid,balance,6,2,4
Gallianö,frostmourne,192,druid,balance,6,2,4
Clawandørder,tichondrius,192,druid,balance,6,2,4
Ohzú,ragnaros,192,druid,balance,6,2,4
Razzldazzle,thrall,192,druid,balance,6,2,4
Dobidas,tichondrius,192,druid,balance,6,2,4
Azshunara,moon-guard,192,druid,balance,6,2,4
Katherine,moon-guard,192,druid,balance,6,2,4
Loggoruk,illidan,192,druid,balance,12,2,10
Everglim,azralon,192,druid,balance,12,2,10
Thicchicken,emerald-dream,191,druid,balance,12,2,10
Formality,kalecgos,159,druid,balance,5,2,3
Stealthhero,lightbringer,159,druid,balance,5,2,3
Xylemcow,malganis,159,druid,balance,5,2,3
Gatorskin,sargeras,96,druid,balance,3,2,1
Treeheehee,frostmourne,96,druid,balance,3,2,1
Yøpièrre,bleeding-hollow,96,druid,balance,3,2,1
Cloyer,stormrage,96,druid,balance,6,1,5
Sinapticc,proudmoore,96,druid,balance,6,1,5
Stinkycrotch,malganis,96,druid,balance,6,1,5
Walkdown,turalyon,96,druid,balance,6,1,5
Aelena,whisperwind,96,druid,balance,6,1,5
Caponetonejr,steamwheedle-cartel,96,druid,balance,6,1,5
Appitrap,emerald-dream,96,druid,balance,6,1,5
Proudmom,barthilas,96,druid,balance,6,1,5
Chickenaeg,stormrage,96,druid,balance,6,1,5
Worldbullguy,area-52,96,druid,balance,6,1,5
Dèrpin,thrall,96,druid,balance,6,1,5
Oatmeals,fizzcrank,96,druid,balance,6,1,5
Idontknowbro,bonechewer,96,druid,balance,6,1,5
Zazinium,illidan,96,druid,balance,6,1,5
Dendríta,ragnaros,96,druid,balance,6,1,5
Meatbender,frostmourne,96,druid,balance,6,1,5
Grimmb,emerald-dream,96,druid,balance,6,1,5
Pao,nordrassil,96,druid,balance,6,1,5
Furryluvr,tichondrius,96,druid,balance,6,1,5
Etherêal,stormrage,96,druid,balance,6,1,5
Shmooglite,emerald-dream,96,druid,balance,6,1,5
Brucey,khadgar,96,druid,balance,6,1,5
Skiouros,emerald-dream,96,druid,balance,6,1,5
Samelthios,proudmoore,96,druid,balance,6,1,5
Thecovid,illidan,96,druid,balance,6,1,5
Salanzô,bleeding-hollow,96,druid,balance,6,1,5
Schlaankeyy,stormrage,96,druid,balance,6,1,5
Youlived,aegwynn,96,druid,balance,6,1,5
Breedable,elune,96,druid,balance,6,1,5
Goodhealer,akama,96,druid,balance,6,1,5
Drewcarriesu,arthas,79,druid,balance,5,2,3
Foggie,spirestone,79,druid,balance,5,1,4
Zephiee,kelthuzad,79,druid,balance,5,1,4
Lutzenberger,nemesis,79,druid,balance,5,1,4
Raahmirtah,illidan,79,druid,balance,5,1,4
Skeevz,darkspear,63,druid,balance,2,2,0
Hughhefferr,illidan,63,druid,balance,2,2,0
Desiration,area-52,48,druid,balance,3,1,2
Policë,skullcrusher,42,druid,balance,8,2,6
Istayfrawsty,darkspear,31,druid,balance,2,1,1
Thullian,stormrage,31,druid,balance,2,1,1
Sleepiihead,stormrage,2180,evoker,preservation,78,42,36
Kallie,whisperwind,2080,evoker,preservation,149,75,74
Garbagevoker,scilla,2041,evoker,preservation,120,55,65
Didy,tichondrius,2022,evoker,preservation,90,48,42
Jdbthyr,malganis,1992,evoker,preservation,132,60,72
Eskrizzle,thrall,1991,evoker,preservation,78,38,40
Walf,stormrage,1950,evoker,preservation,251,131,120
Kiry,emerald-dream,1933,evoker,preservation,54,26,28
Dragocula,tichondrius,1917,evoker,preservation,57,27,30
Sloane,dunemaul,1899,evoker,preservation,51,32,19
Meraxes,moonrunner,1897,evoker,preservation,48,26,22
Lieferant,area-52,1867,evoker,preservation,48,25,23
Thnake,zuljin,1839,evoker,preservation,72,38,34
Selkisaurus,area-52,1834,evoker,preservation,60,29,31
Ancalagøn,ragnaros,1833,evoker,preservation,70,35,35
Ojigi,sargeras,1833,evoker,preservation,69,28,41
Neskor,moon-guard,1827,evoker,preservation,101,58,43
Livesey,thunderhorn,1821,evoker,preservation,66,43,23
Bimbus,illidan,1818,evoker,preservation,130,70,60
Drupy,tichondrius,1816,evoker,preservation,54,28,26
Benym,tichondrius,1810,evoker,preservation,54,28,26
Mngxaltx,ragnaros,1807,evoker,preservation,66,31,35
Lodekiim,malganis,1806,evoker,preservation,66,30,36
Eyjes,stormrage,1805,evoker,preservation,60,32,28
Idk,proudmoore,1801,evoker,preservation,48,22,26
Petezra,ragnaros,1800,evoker,preservation,70,33,37
Stønemonkey,sargeras,1768,evoker,preservation,93,49,44
Dragontrees,illidan,1765,evoker,preservation,54,28,26
Iba,tichondrius,1762,evoker,preservation,78,42,36
Dunkinonem,black-dragonflight,1754,evoker,preservation,285,143,142
Schmitty,hellscream,1750,evoker,preservation,78,40,38
Berquone,tichondrius,1747,evoker,preservation,72,31,41
Cerevok,area-52,1745,evoker,preservation,60,37,23
Dracore,firetree,1740,evoker,preservation,193,103,90
Lucardeht,illidan,1740,evoker,preservation,38,19,19
Driceses,area-52,1735,evoker,preservation,50,29,21
Rosestrasza,silvermoon,1734,evoker,preservation,132,63,69
Jakedrake,stormrage,1734,evoker,preservation,61,25,36
Storeypagoda,tichondrius,1715,evoker,preservation,30,18,12
Ugg,stormrage,1714,evoker,preservation,124,52,72
Elimi,tichondrius,1687,evoker,preservation,30,18,12
Mirandaxo,tichondrius,1684,evoker,preservation,161,73,88
Lodedragon,tichondrius,1670,evoker,preservation,84,35,49
Dripdrop,stormscale,1665,evoker,preservation,77,42,35
Dupastrasza,illidan,1664,evoker,preservation,60,25,35
Judra,barthilas,1649,evoker,preservation,62,31,31
Trákanon,mugthol,1634,evoker,preservation,67,37,30
Ðrac,bleeding-hollow,1633,evoker,preservation,53,30,23
Modenzu,malganis,1629,evoker,preservation,66,33,33
Twizzthyr,bleeding-hollow,1627,evoker,preservation,48,22,26
Evokethisdik,tichondrius,1625,evoker,preservation,24,17,7
Deathdrake,jubeithos,1621,evoker,preservation,48,23,25
Basherm,moon-guard,1621,evoker,preservation,54,22,32
Courtvoke,turalyon,1612,evoker,preservation,69,36,33
Leonilxd,tichondrius,1610,evoker,preservation,97,51,46
Deadlybx,bleeding-hollow,1603,evoker,preservation,70,32,38
Novustrasza,lightbringer,1600,evoker,preservation,24,17,7
Veraxsys,wyrmrest-accord,1600,evoker,preservation,52,20,32
Emperör,quelthalas,1598,evoker,preservation,79,43,36
Junkstam,malganis,1574,evoker,preservation,51,25,26
Flamedramon,bleeding-hollow,1572,evoker,preservation,172,72,100
Møritz,stormrage,1562,evoker,preservation,86,40,46
Buttcrease,emerald-dream,1539,evoker,preservation,36,18,18
Emoker,magtheridon,1536,evoker,preservation,48,29,19
Fláppÿbírd,bleeding-hollow,1533,evoker,preservation,24,16,8
Cokobra,haomarush,1529,evoker,preservation,24,16,8
Velocîraptor,bleeding-hollow,1524,evoker,preservation,92,53,39
Révoked,magtheridon,1516,evoker,preservation,116,63,53
Eyolker,kelthuzad,1508,evoker,preservation,50,26,24
Madegood,tichondrius,1508,evoker,preservation,42,20,22
Ffaarrvv,illidan,1504,evoker,preservation,61,39,22
Jacm,fizzcrank,1502,evoker,preservation,48,23,25
Voithyr,moon-guard,1499,evoker,preservation,87,37,50
Ponnukii,tichondrius,1486,evoker,preservation,84,44,40
Virtualcrush,sisters-of-elune,1486,evoker,preservation,94,49,45
Nikholatrus,malganis,1483,evoker,preservation,106,52,54
Sineexe,illidan,1477,evoker,preservation,48,30,18
Jlucks,wyrmrest-accord,1470,evoker,preservation,142,77,65
Cyndragosa,dalvengyr,1468,evoker,preservation,41,17,24
Monavoker,bleeding-hollow,1466,evoker,preservation,36,20,16
Lalargata,azralon,1463,evoker,preservation,41,19,22
Xurota,proudmoore,1454,evoker,preservation,68,30,38
Nyxtari,ragnaros,1447,evoker,preservation,108,57,51
Spyrox,zuluhed,1445,evoker,preservation,30,16,14
Yotus,illidan,1443,evoker,preservation,48,28,20
Dragisha,gnomeregan,1441,evoker,preservation,48,28,20
Runawayslave,frostmane,1441,evoker,preservation,96,41,55
Derazar,malganis,1438,evoker,preservation,249,111,138
Squarter,kiljaeden,1437,evoker,preservation,48,28,20
Greenscales,frostmourne,1431,evoker,preservation,62,25,37
Zenot,malganis,1429,evoker,preservation,22,17,5
Redseal,tichondrius,1429,evoker,preservation,30,15,15
Whethersmell,tichondrius,1428,evoker,preservation,30,15,15
Handeezol,malganis,1426,evoker,preservation,48,27,21
Enazen,kiljaeden,1425,evoker,preservation,53,29,24
Xerroh,area-52,1416,evoker,preservation,59,32,27
Ralzital,auchindoun,1416,evoker,preservation,36,15,21
Vyndormu,moon-guard,1411,evoker,preservation,41,20,21
Kigglypuff,illidan,1406,evoker,preservation,36,15,21
Egglayer,tichondrius,1406,evoker,preservation,90,28,62
Forsakentime,sargeras,1405,evoker,preservation,54,32,22
Bigdrag,blackhand,1399,evoker,preservation,58,35,23
Dylôn,tichondrius,1398,evoker,preservation,58,27,31
Kjerne,stormrage,1396,evoker,preservation,46,23,23
Primshin,illidan,1389,evoker,preservation,45,23,22
Jmir,tichondrius,1389,evoker,preservation,59,24,35
Otsira,frostmourne,1383,evoker,preservation,48,32,16
Fuoco,kiljaeden,1374,evoker,preservation,50,28,22
Mfka,dalaran,1373,evoker,preservation,29,15,14
Fusrodude,shuhalo,1368,evoker,preservation,33,18,15
Elcigala,ragnaros,1362,evoker,preservation,105,49,56
Lifewing,bleeding-hollow,1357,evoker,preservation,43,16,27
Earthshatter,lightbringer,1356,evoker,preservation,54,29,25
Kikokosta,tichondrius,1350,evoker,preservation,42,23,19
Dawitchvoker,illidan,1345,evoker,preservation,108,60,48
Sanninv,barthilas,1334,evoker,preservation,30,14,16
Growthyy,malganis,1328,evoker,preservation,23,16,7
Cynderrellaa,proudmoore,1328,evoker,preservation,140,68,72
Mäverick,kelthuzad,1327,evoker,preservation,35,23,12
Glizzurd,proudmoore,1315,evoker,preservation,57,26,31
Tazarke,dawnbringer,1313,evoker,preservation,30,17,13
Buttfinger,bladefist,1308,evoker,preservation,36,14,22
Bryagh,executus,1304,evoker,preservation,36,18,18
Vhaegart,area-52,1294,evoker,preservation,42,15,27
Meiron,azralon,1289,evoker,preservation,30,14,16
Nitalash,moon-guard,1286,evoker,preservation,29,14,15
Selfhealzer,korgath,1285,evoker,preservation,62,29,33
Nêwt,darkspear,1282,evoker,preservation,70,36,34
Feijiwang,aegwynn,1281,evoker,preservation,39,24,15
Riz,blackhand,1272,evoker,preservation,53,28,25
Tryhard,wyrmrest-accord,1269,evoker,preservation,36,23,13
Ultis,tichondrius,1258,evoker,preservation,107,60,47
Dracniel,illidan,1258,evoker,preservation,41,22,19
Thereptile,frostmourne,1258,evoker,preservation,84,37,47
Agony,emerald-dream,1255,evoker,preservation,159,75,84
Lizzardload,stormreaver,1255,evoker,preservation,58,23,35
Vgt,nemesis,1253,evoker,preservation,84,35,49
Bayvoker,area-52,1252,evoker,preservation,47,25,22
Zindrozarath,area-52,1251,evoker,preservation,29,14,15
Deralan,khaz-modan,1251,evoker,preservation,84,31,53
Döublepenn,tichondrius,1248,evoker,preservation,63,35,28
Mikoriivoker,tichondrius,1247,evoker,preservation,30,13,17
Kainalaz,moon-guard,1245,evoker,preservation,31,13,18
Splendadaddy,kiljaeden,1238,evoker,preservation,24,13,11
Zerath,frostmane,1236,evoker,preservation,30,13,17
Lavagurl,stormscale,1235,evoker,preservation,30,13,17
Astoragosa,moon-guard,1231,evoker,preservation,61,38,23
Ycnpass,tichondrius,1228,evoker,preservation,55,33,22
Brantley,stormscale,1228,evoker,preservation,36,15,21
Kycaka,area-52,1228,evoker,preservation,46,14,32
Lilithlittle,daggerspine,1227,evoker,preservation,112,52,60
Nulldd,tichondrius,1219,evoker,preservation,41,13,28
Zmaj,jubeithos,1213,evoker,preservation,18,13,5
Ysondrius,durotan,1212,evoker,preservation,48,26,22
Sanaz,stormreaver,1211,evoker,preservation,36,19,17
Rubellite,azralon,1210,evoker,preservation,36,18,18
Mysticenergy,tichondrius,1206,evoker,preservation,30,15,15
Frozanat,kelthuzad,1205,evoker,preservation,75,34,41
Allaker,kargath,1204,evoker,preservation,39,16,23
Hamanv,tichondrius,1202,evoker,preservation,30,13,17
Partysnaxx,thrall,1199,evoker,preservation,72,35,37
Shênlong,sargeras,1193,evoker,preservation,54,22,32
Kaguax,tichondrius,1189,evoker,preservation,48,15,33
Shudo,moon-guard,1188,evoker,preservation,53,23,30
Masquemeto,illidan,1181,evoker,preservation,25,14,11
Draginnuts,illidan,1178,evoker,preservation,35,18,17
Héllfire,ghostlands,1171,evoker,preservation,36,17,19
Azuril,wyrmrest-accord,1171,evoker,preservation,48,17,31
Worldx,illidan,1166,evoker,preservation,24,13,11
Mazalagon,trollbane,1165,evoker,preservation,29,15,14
Vermitor,sargeras,1155,evoker,preservation,24,13,11
Dracthyrfang,elune,1152,evoker,preservation,18,12,6
Fatsu,executus,1152,evoker,preservation,30,12,18
Velstrasza,stormrage,1151,evoker,preservation,18,12,6
Moralies,area-52,1150,evoker,preservation,24,12,12
Raundur,ragnaros,1150,evoker,preservation,24,12,12
Bahamut,magtheridon,1143,evoker,preservation,48,18,30
Vulkerr,stormrage,1142,evoker,preservation,30,12,18
Zippityzoom,barthilas,1137,evoker,preservation,23,13,10
Doogiehowser,azshara,1136,evoker,preservation,48,23,25
Vermax,akama,1133,evoker,preservation,45,17,28
Brôcôlînî,zuljin,1131,evoker,preservation,18,14,4
Suedeshoes,bleeding-hollow,1131,evoker,preservation,24,12,12
Allaston,tichondrius,1122,evoker,preservation,24,13,11
Detreshan,stormreaver,1120,evoker,preservation,68,38,30
Endroz,tichondrius,1119,evoker,preservation,24,12,12
Drathron,tichondrius,1118,evoker,preservation,28,13,15
Dandera,stormrage,1114,evoker,preservation,44,17,27
Çhara,illidan,1110,evoker,preservation,46,24,22
Evokas,tichondrius,1105,evoker,preservation,51,26,25
Geico,spinebreaker,1100,evoker,preservation,15,13,2
Thegrinchh,malganis,1097,evoker,preservation,81,39,42
Krossbones,cenarion-circle,1096,evoker,preservation,80,47,33
Draisin,zuljin,1083,evoker,preservation,24,13,11
Myxter,tichondrius,1082,evoker,preservation,43,24,19
Lilithà,kelthuzad,1075,evoker,preservation,30,20,10
Draganoche,zuljin,1066,evoker,preservation,30,14,16
Yozhz,ragnaros,1059,evoker,preservation,29,13,16
Daegonz,lightbringer,1055,evoker,preservation,18,11,7
Vodkasauce,tichondrius,1052,evoker,preservation,18,11,7
Imugee,sargeras,1051,evoker,preservation,24,11,13
Lickndragons,sargeras,1048,evoker,preservation,24,11,13
Thepplschamp,bloodhoof,1043,evoker,preservation,24,11,13
Rynntynn,blood-furnace,1039,evoker,preservation,24,11,13
Charadrius,zuljin,1038,evoker,preservation,41,23,18
Dragonwench,sargeras,1037,evoker,preservation,18,11,7
Carloxd,tichondrius,1035,evoker,preservation,34,12,22
Abigaile,illidan,1034,evoker,preservation,18,13,5
Blankebr,gallywix,1032,evoker,preservation,36,24,12
Chunkè,moon-guard,1026,evoker,preservation,39,12,27
Evoke,boulderfist,1025,evoker,preservation,28,12,16
Solryp,terokkar,1022,evoker,preservation,53,25,28
Giratina,area-52,1017,evoker,preservation,23,11,12
Cringilisk,kelthuzad,1015,evoker,preservation,16,12,4
Dragonsand,area-52,1001,evoker,preservation,49,26,23
Ilithiphobia,ghostlands,1000,evoker,preservation,32,14,18
Drittles,illidan,998,evoker,preservation,50,21,29
Brahown,altar-of-storms,998,evoker,preservation,36,11,25
Chambea,kelthuzad,995,evoker,preservation,23,13,10
Hover,vashj,989,evoker,preservation,27,13,14
Vyreth,sargeras,987,evoker,preservation,81,38,43
Lahfly,tichondrius,978,evoker,preservation,30,17,13
Healmeta,sargeras,971,evoker,preservation,135,50,85
Rubyzz,illidan,960,evoker,preservation,18,10,8
Draconian,frostmourne,960,evoker,preservation,24,10,14
Uncleìroh,tichondrius,960,evoker,preservation,24,10,14
Suffler,warsong,959,evoker,preservation,12,10,2
Dragonkink,sargeras,959,evoker,preservation,12,10,2
Puffthemagic,lightnings-blade,958,evoker,preservation,18,10,8
Bendover,proudmoore,957,evoker,preservation,18,10,8
Drakthussey,illidan,957,evoker,preservation,18,10,8
Delivv,hyjal,955,evoker,preservation,18,10,8
Qiblii,moon-guard,955,evoker,preservation,24,10,14
Mythsvoker,barthilas,954,evoker,preservation,18,10,8
Soziin,skullcrusher,953,evoker,preservation,18,10,8
Barneydragon,stormrage,949,evoker,preservation,18,10,8
Mesamune,bonechewer,949,evoker,preservation,36,11,25
Ayavi,illidan,942,evoker,preservation,18,10,8
Emyhr,sargeras,941,evoker,preservation,18,10,8
Zitasanazen,tichondrius,935,evoker,preservation,134,63,71
Richviewrd,illidan,928,evoker,preservation,24,11,13
Raptormoto,lothar,926,evoker,preservation,26,11,15
Dragonbro,spirestone,923,evoker,preservation,18,10,8
Justbreathe,sargeras,911,evoker,preservation,17,10,7
Lightbeing,nazjatar,904,evoker,preservation,30,16,14
Badvoker,area-52,902,evoker,preservation,71,26,45
Cransvoker,illidan,902,evoker,preservation,30,10,20
Chessyk,ragnaros,893,evoker,preservation,17,10,7
Purrlynn,tichondrius,893,evoker,preservation,20,10,10
Mugenyan,ragnaros,879,evoker,preservation,41,21,20
Willowflight,illidan,867,evoker,preservation,50,23,27
Mikorivoker,illidan,864,evoker,preservation,12,9,3
Tonymanitoba,whisperwind,863,evoker,preservation,18,9,9
Nuubvoker,stormrage,863,evoker,preservation,18,9,9
Grunkthyr,moon-guard,863,evoker,preservation,18,9,9
Zandragosa,dalaran,863,evoker,preservation,18,9,9
Hepzibah,kelthuzad,863,evoker,preservation,24,9,15
Naykir,khazgoroth,862,evoker,preservation,12,9,3
Sovietønion,tichondrius,862,evoker,preservation,24,9,15
Kakanjutan,azralon,861,evoker,preservation,16,10,6
Macdrag,malganis,861,evoker,preservation,18,9,9
Jesstrasza,quelthalas,861,evoker,preservation,42,18,24
Gravityblast,tichondrius,861,evoker,preservation,24,9,15
Actïoncat,emerald-dream,860,evoker,preservation,30,9,21
Treadcinder,tichondrius,857,evoker,preservation,18,9,9
Hentaizilla,kiljaeden,850,evoker,preservation,55,19,36
Dragonknght,tichondrius,843,evoker,preservation,18,9,9
Drakthuul,icecrown,825,evoker,preservation,18,10,8
Dragndeez,garrosh,824,evoker,preservation,40,9,31
Careflight,barthilas,822,evoker,preservation,24,9,15
Triarcs,sargeras,799,evoker,preservation,17,9,8
Bucket,wyrmrest-accord,798,evoker,preservation,20,9,11
Drackaras,stormrage,790,evoker,preservation,18,9,9
Ninereeds,malganis,768,evoker,preservation,12,8,4
Rvrbzv,stormrage,768,evoker,preservation,12,8,4
Chañïng,frostmourne,768,evoker,preservation,18,8,10
Quickshootin,tichondrius,768,evoker,preservation,18,8,10
Walloper,malganis,767,evoker,preservation,12,8,4
Miliolievo,azralon,767,evoker,preservation,18,8,10
Zakaraki,bloodscalp,766,evoker,preservation,12,8,4
Chue,quelthalas,766,evoker,preservation,18,8,10
Caphe,nerzhul,765,evoker,preservation,18,8,10
Kathendrov,sargeras,764,evoker,preservation,12,8,4
Matsutake,kelthuzad,762,evoker,preservation,18,8,10
Bumbledragn,moon-guard,761,evoker,preservation,19,10,9
Milkspurt,tichondrius,759,evoker,preservation,18,8,10
Crumbflaps,kelthuzad,758,evoker,preservation,18,8,10
Gemis,anvilmar,751,evoker,preservation,20,9,11
Criteria,burning-legion,748,evoker,preservation,18,8,10
Pootylizard,daggerspine,736,evoker,preservation,28,9,19
Durtyvoker,illidan,735,evoker,preservation,22,8,14
Polland,area-52,731,evoker,preservation,17,8,9
Icthelestron,black-dragonflight,729,evoker,preservation,14,9,5
Geicovoker,tichondrius,714,evoker,preservation,28,9,19
Shardsnorta,chogall,708,evoker,preservation,17,8,9
Velaryonhero,arthas,700,evoker,preservation,20,8,12
Feelzz,illidan,685,evoker,preservation,11,8,3
Ajiz,mannoroth,672,evoker,preservation,12,7,5
Vroomby,area-52,672,evoker,preservation,12,7,5
Cycircle,tichondrius,672,evoker,preservation,12,7,5
Stableboy,bleeding-hollow,672,evoker,preservation,12,7,5
Dragonkok,stormrage,672,evoker,preservation,12,7,5
Beatxqt,area-52,672,evoker,preservation,12,7,5
Skrimbles,tichondrius,672,evoker,preservation,12,7,5
Gaslightqt,tichondrius,672,evoker,preservation,13,7,6
Alitasbbq,malganis,672,evoker,preservation,18,7,11
Kwitty,illidan,672,evoker,preservation,18,7,11
Draikia,zuljin,672,evoker,preservation,18,7,11
Kwebab,tichondrius,672,evoker,preservation,18,7,11
Hamine,tichondrius,672,evoker,preservation,18,7,11
Orncen,emerald-dream,672,evoker,preservation,18,7,11
Nyzara,emerald-dream,672,evoker,preservation,18,7,11
Neffiie,dalaran,671,evoker,preservation,12,7,5
Proevoker,illidan,671,evoker,preservation,12,7,5
Forlornomens,area-52,671,evoker,preservation,12,7,5
Arûmat,tichondrius,671,evoker,preservation,18,7,11
Longxx,dalaran,671,evoker,preservation,18,7,11
Kaeszandrus,azralon,670,evoker,preservation,12,7,5
Mad,aerie-peak,670,evoker,preservation,19,9,10
Woozul,malganis,670,evoker,preservation,30,7,23
Retcondragon,sargeras,669,evoker,preservation,18,7,11
Dragonballer,trollbane,669,evoker,preservation,18,7,11
Hakuroyime,ragnaros,667,evoker,preservation,12,7,5
Daikis,proudmoore,666,evoker,preservation,18,7,11
Acidbreath,tichondrius,661,evoker,preservation,18,7,11
Kivoke,proudmoore,660,evoker,preservation,18,7,11
Moxa,doomhammer,659,evoker,preservation,12,7,5
Yiptondabs,emerald-dream,650,evoker,preservation,29,7,22
Thenasath,sargeras,640,evoker,preservation,17,7,10
Lilacstrasza,moon-guard,638,evoker,preservation,23,7,16
Mokkdala,blackrock,637,evoker,preservation,17,7,10
Shenlong,malganis,635,evoker,preservation,14,8,6
Elderdragon,nerzhul,629,evoker,preservation,16,8,8
Kixxely,sargeras,623,evoker,preservation,12,8,4
Terpsy,area-52,620,evoker,preservation,11,7,4
Kilawatt,barthilas,620,evoker,preservation,11,7,4
Drerick,illidan,618,evoker,preservation,20,8,12
Grousegamer,barthilas,618,evoker,preservation,26,8,18
Zackxo,moon-guard,617,evoker,preservation,11,7,4
Kalikani,moon-guard,617,evoker,preservation,16,8,8
Wilbog,moon-guard,604,evoker,preservation,36,7,29
Balmoze,tichondrius,584,evoker,preservation,19,7,12
Drepz,dalaran,576,evoker,preservation,6,6,0
Hwansu,tichondrius,576,evoker,preservation,6,6,0
Dokthyr,lightbringer,576,evoker,preservation,6,6,0
Sleepiiheadx,stormrage,576,evoker,preservation,12,6,6
Datinysmaug,stormrage,576,evoker,preservation,12,6,6
Ozvoker,area-52,576,evoker,preservation,12,6,6
Wtfhappen,tichondrius,576,evoker,preservation,12,6,6
Flybro,malganis,576,evoker,preservation,12,6,6
Furegos,zuljin,576,evoker,preservation,12,6,6
Weagle,zuljin,576,evoker,preservation,12,6,6
Teëst,malganis,576,evoker,preservation,12,6,6
Sheepdoll,icecrown,576,evoker,preservation,12,6,6
Azarke,rivendare,576,evoker,preservation,12,6,6
Innervoker,tichondrius,576,evoker,preservation,12,6,6
Verosria,area-52,576,evoker,preservation,12,6,6
Daylenx,thrall,576,evoker,preservation,12,6,6
Localfemboy,area-52,576,evoker,preservation,12,6,6
Bookwyrm,khadgar,576,evoker,preservation,12,6,6
Provokker,drakkari,576,evoker,preservation,12,6,6
Sandragon,ragnaros,576,evoker,preservation,15,7,8
Dracadukez,illidan,576,evoker,preservation,18,6,12
Imperialist,proudmoore,576,evoker,preservation,18,6,12
Corncrake,sargeras,576,evoker,preservation,18,6,12
Dragonk,dragonblight,576,evoker,preservation,18,6,12
Toodllesz,stormrage,575,evoker,preservation,6,6,0
Flameschosen,malganis,575,evoker,preservation,12,6,6
Skailyx,zuljin,575,evoker,preservation,12,6,6
Nutsdragon,tichondrius,575,evoker,preservation,12,6,6
Dragûn,stormrage,575,evoker,preservation,12,6,6
Wrathiøn,sargeras,575,evoker,preservation,18,6,12
Dragy,bonechewer,575,evoker,preservation,18,6,12
Toothless,garithos,574,evoker,preservation,6,6,0
Lamentation,area-52,574,evoker,preservation,12,6,6
Amun,frostwolf,574,evoker,preservation,12,6,6
Cinderazerat,moon-guard,574,evoker,preservation,18,6,12
Kerlaan,illidan,568,evoker,preservation,12,6,6
Spliffdragon,sargeras,528,evoker,preservation,17,6,11
Gloamdream,cenarius,521,evoker,preservation,15,7,8
Shenlòng,drakkari,521,evoker,preservation,15,7,8
Akavoker,sargeras,521,evoker,preservation,20,7,13
Errier,tichondrius,511,evoker,preservation,14,6,8
Kîñggïgàçhäð,stormrage,480,evoker,preservation,6,5,1
Evvookkeerr,tichondrius,480,evoker,preservation,6,5,1
Chinadragon,balnazzar,480,evoker,preservation,6,5,1
Bandel,tichondrius,480,evoker,preservation,6,5,1
Shellessturt,kelthuzad,480,evoker,preservation,6,5,1
Unknowndrago,kul-tiras,480,evoker,preservation,12,5,7
Gumbåll,bleeding-hollow,480,evoker,preservation,12,5,7
Advancedonly,tichondrius,480,evoker,preservation,12,5,7
Bigdwagon,stormrage,480,evoker,preservation,12,5,7
Neocellx,frostwolf,480,evoker,preservation,12,5,7
Neewhad,malganis,480,evoker,preservation,12,5,7
Imwoker,illidan,480,evoker,preservation,12,5,7
Naùghtygames,area-52,480,evoker,preservation,12,5,7
Evizzar,zuljin,480,evoker,preservation,12,5,7
Slèv,frostmourne,480,evoker,preservation,12,5,7
Oldmandrake,mannoroth,480,evoker,preservation,12,5,7
Spyrotime,tichondrius,480,evoker,preservation,15,5,10
Bronyflexy,sargeras,480,evoker,preservation,24,5,19
Prevoker,kirin-tor,479,evoker,preservation,6,5,1
Mãttyy,malganis,479,evoker,preservation,6,5,1
Balèrion,illidan,479,evoker,preservation,6,5,1
Drizzydrag,jubeithos,479,evoker,preservation,12,5,7
Dracdeez,dreadmaul,479,evoker,preservation,12,5,7
Kratostrasz,moon-guard,479,evoker,preservation,12,5,7
Lickyertits,tichondrius,479,evoker,preservation,12,5,7
Rhaènyra,sargeras,479,evoker,preservation,12,5,7
Cootietooter,icecrown,479,evoker,preservation,12,5,7
Dragown,sargeras,478,evoker,preservation,12,5,7
Scaryðragon,akama,477,evoker,preservation,12,5,7
Falsedaze,sargeras,475,evoker,preservation,12,5,7
Saintpablox,illidan,426,evoker,preservation,28,6,22
Items,frostmourne,416,evoker,preservation,10,5,5
Monzydrake,emerald-dream,408,evoker,preservation,20,5,15
Nwo,shattered-hand,399,evoker,preservation,5,5,0
Mtndewboy,illidan,384,evoker,preservation,6,4,2
Boomlvx,frostmourne,384,evoker,preservation,6,4,2
Exrtj,stormrage,384,evoker,preservation,6,4,2
Dragoncods,velen,384,evoker,preservation,6,4,2
Thegoone,bleeding-hollow,384,evoker,preservation,6,4,2
Dreamfuego,tichondrius,384,evoker,preservation,6,4,2
Magnito,thorium-brotherhood,384,evoker,preservation,6,4,2
Murloc,shadowsong,384,evoker,preservation,6,4,2
Bassblasterr,dalaran,384,evoker,preservation,6,4,2
Atraxian,tichondrius,384,evoker,preservation,6,4,2
Whitesnow,korgath,384,evoker,preservation,6,4,2
Setash,hyjal,384,evoker,preservation,6,4,2
Babylons,area-52,384,evoker,preservation,6,4,2
Ancalagðn,quelthalas,384,evoker,preservation,6,4,2
Macismighty,emerald-dream,384,evoker,preservation,6,4,2
Gavstarz,frostmourne,384,evoker,preservation,6,4,2
Tygor,arthas,384,evoker,preservation,6,4,2
Docevoker,tichondrius,384,evoker,preservation,6,4,2
Whelp,shadow-council,384,evoker,preservation,6,4,2
Venitsu,malganis,384,evoker,preservation,6,4,2
Jëthrø,illidan,384,evoker,preservation,6,4,2
Zaedor,stormrage,384,evoker,preservation,10,5,5
Teddydarg,tichondrius,384,evoker,preservation,8,4,4
Shoestrings,tichondrius,384,evoker,preservation,12,4,8
Soyum,sargeras,384,evoker,preservation,12,4,8
Pensini,illidan,384,evoker,preservation,12,4,8
Galrend,firetree,384,evoker,preservation,12,4,8
Friedwings,wyrmrest-accord,384,evoker,preservation,12,4,8
Bryágh,wyrmrest-accord,384,evoker,preservation,12,4,8
Ráigon,ragnaros,384,evoker,preservation,12,4,8
Gobananas,sargeras,384,evoker,preservation,12,4,8
Satratren,moon-guard,384,evoker,preservation,12,4,8
Williamjong,tichondrius,384,evoker,preservation,12,4,8
Crumbsock,thrall,384,evoker,preservation,12,4,8
Bookkoo,burning-legion,384,evoker,preservation,12,4,8
Raphdragon,stormrage,384,evoker,preservation,12,4,8
Upsdriver,dentarg,384,evoker,preservation,18,4,14
Kyloflight,thrall,384,evoker,preservation,18,4,14
Lervish,durotan,383,evoker,preservation,6,4,2
Sandrozeria,wyrmrest-accord,383,evoker,preservation,6,4,2
Shintrax,ragnaros,383,evoker,preservation,8,4,4
Shook,baelgun,383,evoker,preservation,12,4,8
Sïgrìd,tichondrius,382,evoker,preservation,6,4,2
Bigtoots,illidan,382,evoker,preservation,12,4,8
Danatreseth,moon-guard,380,evoker,preservation,12,4,8
Nyxstrasza,moknathal,366,evoker,preservation,11,4,7
Clubmetro,boulderfist,365,evoker,preservation,9,6,3
Dkvastate,tichondrius,352,evoker,preservation,10,4,6
Butta,darkspear,351,evoker,preservation,11,4,7
Corlys,thunderhorn,330,evoker,preservation,17,5,12
Jolynne,illidan,320,evoker,preservation,14,4,10
Polyrhythmic,ysera,304,evoker,preservation,7,4,3
Kaldobar,stormrage,288,evoker,preservation,6,3,3
Vokefuu,illidan,288,evoker,preservation,6,3,3
Vygrax,nerzhul,288,evoker,preservation,6,3,3
Swagdriver,moon-guard,288,evoker,preservation,6,3,3
Ðçßñÿåæéîùøð,tichondrius,288,evoker,preservation,6,3,3
Evoketage,malganis,288,evoker,preservation,6,3,3
Setren,antonidas,288,evoker,preservation,6,3,3
Jamörant,tichondrius,288,evoker,preservation,6,3,3
Gogmagog,korgath,288,evoker,preservation,6,3,3
Saxthyr,stormreaver,288,evoker,preservation,6,3,3
Gvoker,nemesis,288,evoker,preservation,6,3,3
Mignificent,sargeras,288,evoker,preservation,6,3,3
Bigtitsdrag,illidan,288,evoker,preservation,6,3,3
Jakburnon,stormrage,288,evoker,preservation,6,3,3
Rangä,caelestrasz,288,evoker,preservation,6,3,3
Kreutzhauser,tichondrius,288,evoker,preservation,6,3,3
Paradïsso,tichondrius,288,evoker,preservation,6,3,3
Kalsit,emerald-dream,288,evoker,preservation,6,3,3
Icallthecops,tichondrius,288,evoker,preservation,6,3,3
Redhorn,frostmourne,288,evoker,preservation,6,3,3
Wethotgarbee,tichondrius,288,evoker,preservation,6,3,3
Spicypnuts,zuljin,288,evoker,preservation,6,3,3
Holdherhorn,area-52,288,evoker,preservation,6,3,3
Flyingmooie,frostmourne,288,evoker,preservation,6,3,3
Vaeghar,anvilmar,288,evoker,preservation,6,3,3
Gaserick,quelthalas,288,evoker,preservation,6,3,3
Visserion,sargeras,288,evoker,preservation,6,3,3
Raxdragon,sargeras,288,evoker,preservation,6,3,3
Knowragretz,tichondrius,288,evoker,preservation,6,3,3
Dracoon,madoran,288,evoker,preservation,6,3,3
Selden,boulderfist,288,evoker,preservation,6,3,3
Necrathma,tichondrius,288,evoker,preservation,6,3,3
Phooby,sargeras,288,evoker,preservation,6,3,3
Flexlong,tichondrius,288,evoker,preservation,6,3,3
Stormdagger,proudmoore,288,evoker,preservation,12,3,9
Reflexd,malganis,288,evoker,preservation,12,3,9
Galfiore,malganis,288,evoker,preservation,12,3,9
Bitkoinz,tichondrius,288,evoker,preservation,12,3,9
Pauly,suramar,288,evoker,preservation,12,3,9
Discussion,area-52,288,evoker,preservation,12,3,9
Murphymonsta,stormscale,288,evoker,preservation,12,3,9
Drakkar,elune,288,evoker,preservation,12,3,9
Mouthgorawr,tichondrius,288,evoker,preservation,13,3,10
Wapowthion,blades-edge,288,evoker,preservation,18,3,15
Supereragon,area-52,287,evoker,preservation,6,3,3
Ownlyfans,silvermoon,287,evoker,preservation,6,3,3
Saphfire,burning-legion,287,evoker,preservation,6,3,3
Tazen,bleeding-hollow,287,evoker,preservation,12,3,9
Toothlesz,draka,287,evoker,preservation,18,3,15
Stíckyj,tichondrius,255,evoker,preservation,11,3,8
Tsuruda,illidan,234,evoker,preservation,15,4,11
Tugmapvpean,kelthuzad,208,evoker,preservation,7,3,4
Preserveluke,moon-guard,192,evoker,preservation,6,2,4
Versezz,tichondrius,192,evoker,preservation,6,2,4
Inkdsy,detheroc,192,evoker,preservation,6,2,4
Ceraxxes,tichondrius,192,evoker,preservation,6,2,4
Nite,lothar,192,evoker,preservation,6,2,4
Kalrid,sargeras,192,evoker,preservation,6,2,4
Ellafortnite,emerald-dream,192,evoker,preservation,6,2,4
Dwagonwage,zuljin,192,evoker,preservation,6,2,4
Scyyterr,azralon,192,evoker,preservation,6,2,4
Saviorkai,barthilas,192,evoker,preservation,6,2,4
Sketchybum,tichondrius,192,evoker,preservation,6,2,4
Nil,malganis,192,evoker,preservation,6,2,4
Aetherz,illidan,192,evoker,preservation,6,2,4
Xerithious,bleeding-hollow,192,evoker,preservation,6,2,4
Wonderk,frostmourne,192,evoker,preservation,6,2,4
Wse,illidan,192,evoker,preservation,6,2,4
Syfen,burning-blade,192,evoker,preservation,6,2,4
Emozoomer,malganis,192,evoker,preservation,6,2,4
Invdkill,azralon,192,evoker,preservation,6,2,4
Racovoker,zuljin,192,evoker,preservation,6,2,4
Slaymedaddy,proudmoore,192,evoker,preservation,6,2,4
Aspecto,area-52,192,evoker,preservation,6,2,4
Smurgma,frostmane,192,evoker,preservation,6,2,4
Carrnedge,area-52,192,evoker,preservation,6,2,4
Surasi,frostmourne,192,evoker,preservation,6,2,4
Nunez,frostmourne,192,evoker,preservation,6,2,4
Simmnyxia,area-52,192,evoker,preservation,6,2,4
Linguistic,tichondrius,192,evoker,preservation,6,2,4
Lampizard,bonechewer,192,evoker,preservation,12,2,10
Annum,moon-guard,192,evoker,preservation,12,2,10
Takasaki,dalaran,192,evoker,preservation,12,2,10
Arazerazer,thrall,192,evoker,preservation,12,2,10
Draghyon,tichondrius,192,evoker,preservation,12,2,10
Thendroz,aerie-peak,191,evoker,preservation,4,3,1
Valethal,ragnaros,191,evoker,preservation,6,2,4
Spyrð,emerald-dream,191,evoker,preservation,6,2,4
Dracalis,thrall,191,evoker,preservation,6,2,4
Drakonyx,mugthol,191,evoker,preservation,6,2,4
Sodre,illidan,191,evoker,preservation,12,2,10
Enalen,azjolnerub,138,evoker,preservation,8,3,5
Shíkyo,stormrage,138,evoker,preservation,14,3,11
Amnemís,tichondrius,128,evoker,preservation,4,2,2
Deviantart,emerald-dream,96,evoker,preservation,6,1,5
Simarity,thrall,96,evoker,preservation,6,1,5
Patrdorasz,zuljin,96,evoker,preservation,6,1,5
Yoyke,tichondrius,96,evoker,preservation,6,1,5
Nazatra,wyrmrest-accord,96,evoker,preservation,6,1,5
Trrxx,tichondrius,96,evoker,preservation,6,1,5
Roastdrake,tichondrius,96,evoker,preservation,6,1,5
Ohmylanta,stormrage,96,evoker,preservation,6,1,5
Tasdarallar,frostmourne,96,evoker,preservation,6,1,5
Vvhip,tichondrius,96,evoker,preservation,6,1,5
Yujirohanma,frostmourne,96,evoker,preservation,6,1,5
Shockragosa,chogall,96,evoker,preservation,6,1,5
Vermax,spirestone,96,evoker,preservation,6,1,5
Dwacawys,zuljin,96,evoker,preservation,6,1,5
Gamerwords,barthilas,96,evoker,preservation,6,1,5
Uwuspit,tichondrius,96,evoker,preservation,6,1,5
Ðräco,quelthalas,96,evoker,preservation,6,1,5
Dracomedicus,frostmourne,96,evoker,preservation,10,1,9
Diavai,area-52,96,evoker,preservation,12,1,11
Tidehunter,chogall,96,evoker,preservation,12,1,11
Khorvin,proudmoore,96,evoker,preservation,12,1,11
Thiqc,zuluhed,9,evoker,preservation,9,3,6
Nikthevoker,tichondrius,2119,evoker,devastation,84,47,37
Dametra,proudmoore,2100,evoker,devastation,102,59,43
Caedalade,proudmoore,2073,evoker,devastation,125,65,60
Rothvoker,tichondrius,1991,evoker,devastation,68,42,26
Evokemedaddy,bleeding-hollow,1965,evoker,devastation,84,44,40
Somyr,area-52,1964,evoker,devastation,72,39,33
Trogdør,illidan,1942,evoker,devastation,123,63,60
Nikthevoker,area-52,1941,evoker,devastation,52,30,22
Wazgon,emerald-dream,1940,evoker,devastation,194,94,100
Koalaman,area-52,1919,evoker,devastation,138,73,65
Dzrn,moon-guard,1917,evoker,devastation,78,39,39
Arzaria,stormrage,1904,evoker,devastation,114,66,48
Quadude,illidan,1896,evoker,devastation,71,34,37
Azazél,borean-tundra,1894,evoker,devastation,60,39,21
Ayavi,illidan,1890,evoker,devastation,96,61,35
Juicyjom,staghelm,1886,evoker,devastation,48,25,23
Bugberry,illidan,1854,evoker,devastation,96,51,45
Draxarys,area-52,1854,evoker,devastation,131,68,63
Wheezee,emerald-dream,1850,evoker,devastation,46,25,21
Lizzimcguire,zuljin,1827,evoker,devastation,42,27,15
Venarys,dalaran,1826,evoker,devastation,42,30,12
Raxdragon,sargeras,1826,evoker,devastation,36,22,14
Anachronormu,mannoroth,1826,evoker,devastation,71,40,31
Azradormu,zuljin,1823,evoker,devastation,85,37,48
Ethalem,thrall,1820,evoker,devastation,102,63,39
Draxarys,tichondrius,1818,evoker,devastation,140,67,73
Breathalizer,sargeras,1816,evoker,devastation,36,20,16
Laneva,moon-guard,1809,evoker,devastation,122,82,40
Ragedizzle,twisting-nether,1808,evoker,devastation,91,49,42
Fractalz,alterac-mountains,1800,evoker,devastation,169,92,77
Eshen,ragnaros,1782,evoker,devastation,257,135,122
Oldxdrake,sargeras,1776,evoker,devastation,96,50,46
Emiriss,thrall,1772,evoker,devastation,70,37,33
Nørbert,frostmourne,1769,evoker,devastation,48,29,19
Dooklord,shuhalo,1763,evoker,devastation,54,24,30
Bigdrag,blackhand,1761,evoker,devastation,90,45,45
Caelïn,malganis,1744,evoker,devastation,66,40,26
Thrawn,arygos,1743,evoker,devastation,41,25,16
Garlicbreth,stormrage,1728,evoker,devastation,64,36,28
Ævoker,tichondrius,1720,evoker,devastation,48,27,21
Rescued,wyrmrest-accord,1718,evoker,devastation,36,22,14
Psynister,illidan,1711,evoker,devastation,108,48,60
Tazriak,tichondrius,1709,evoker,devastation,43,29,14
Rðsè,tichondrius,1697,evoker,devastation,114,56,58
Gojirastraza,stormrage,1696,evoker,devastation,36,22,14
Jase,gilneas,1691,evoker,devastation,74,45,29
Shoestrings,tichondrius,1690,evoker,devastation,54,25,29
Geicovoker,tichondrius,1685,evoker,devastation,40,24,16
Catvoker,area-52,1678,evoker,devastation,114,58,56
Fores,tichondrius,1674,evoker,devastation,64,28,36
Balrôg,malganis,1660,evoker,devastation,57,27,30
Juooun,tichondrius,1655,evoker,devastation,59,28,31
Mfquietus,illidan,1653,evoker,devastation,42,24,18
Thordak,drakkari,1652,evoker,devastation,48,25,23
Whilefalse,stormrage,1650,evoker,devastation,48,21,27
Nunez,frostmourne,1644,evoker,devastation,29,18,11
Dwagonwage,zuljin,1643,evoker,devastation,48,23,25
Izzythelizzy,tichondrius,1629,evoker,devastation,102,55,47
Arkeryte,moon-guard,1629,evoker,devastation,96,49,47
Theredmenace,barthilas,1618,evoker,devastation,30,20,10
Wingdeadly,tichondrius,1618,evoker,devastation,60,31,29
Shalander,proudmoore,1615,evoker,devastation,102,57,45
Krúnsh,ragnaros,1607,evoker,devastation,89,45,44
Puf,magtheridon,1606,evoker,devastation,99,55,44
Bombs,shattered-hand,1594,evoker,devastation,126,66,60
Juicylizard,stormrage,1593,evoker,devastation,69,33,36
Eszel,thunderlord,1592,evoker,devastation,130,68,62
Blackdragôn,stormrage,1590,evoker,devastation,37,19,18
Zenithria,thrall,1589,evoker,devastation,35,20,15
Drakori,azralon,1589,evoker,devastation,44,24,20
Bryágh,wyrmrest-accord,1589,evoker,devastation,135,73,62
Chànge,lothar,1587,evoker,devastation,41,23,18
Akajills,tichondrius,1575,evoker,devastation,52,32,20
Polyrhythmic,ysera,1567,evoker,devastation,55,28,27
Narissian,wyrmrest-accord,1566,evoker,devastation,56,33,23
Rá,drenden,1564,evoker,devastation,42,18,24
Linguistic,tichondrius,1558,evoker,devastation,36,20,16
Galrend,firetree,1556,evoker,devastation,60,33,27
Aarax,tichondrius,1554,evoker,devastation,83,41,42
Imugee,sargeras,1549,evoker,devastation,36,19,17
Dubskis,area-52,1549,evoker,devastation,84,41,43
Agheel,firetree,1543,evoker,devastation,44,23,21
Monkeydrake,tichondrius,1542,evoker,devastation,42,20,22
Haramcad,tichondrius,1523,evoker,devastation,75,40,35
Bréáth,tichondrius,1520,evoker,devastation,30,21,9
Ðeepßreath,sargeras,1509,evoker,devastation,30,16,14
Sintholo,sargeras,1508,evoker,devastation,42,20,22
Gôdzevoker,area-52,1507,evoker,devastation,30,16,14
Evòker,tichondrius,1505,evoker,devastation,36,17,19
Xplode,area-52,1504,evoker,devastation,176,89,87
Tezzyl,kiljaeden,1498,evoker,devastation,30,16,14
Flysokan,tichondrius,1486,evoker,devastation,30,16,14
Tinine,frostmourne,1485,evoker,devastation,36,21,15
Lorb,icecrown,1478,evoker,devastation,54,30,24
Eternabeam,gilneas,1478,evoker,devastation,35,16,19
Dragonvore,moon-guard,1475,evoker,devastation,23,17,6
Valkalas,moon-guard,1475,evoker,devastation,36,19,17
Xhaal,tichondrius,1468,evoker,devastation,90,38,52
Dekux,elune,1459,evoker,devastation,36,16,20
Devonstation,zuljin,1456,evoker,devastation,36,22,14
Bellerion,proudmoore,1450,evoker,devastation,48,22,26
Bvo,stormrage,1449,evoker,devastation,59,35,24
Xaeradroz,area-52,1448,evoker,devastation,48,25,23
Midi,boulderfist,1446,evoker,devastation,42,21,21
Lilfootmommy,emerald-dream,1446,evoker,devastation,36,16,20
Grapthar,korgath,1445,evoker,devastation,42,24,18
Peef,tichondrius,1439,evoker,devastation,24,15,9
Ùwüdragon,tichondrius,1435,evoker,devastation,58,39,19
Grendalevo,tichondrius,1431,evoker,devastation,42,23,19
Dragonbic,illidan,1423,evoker,devastation,36,16,20
Beatdownbill,sargeras,1419,evoker,devastation,36,15,21
Trenash,illidan,1418,evoker,devastation,64,26,38
Quadarius,tichondrius,1416,evoker,devastation,78,40,38
Toastragosa,cenarius,1409,evoker,devastation,84,33,51
Firkrag,bleeding-hollow,1402,evoker,devastation,54,25,29
Hydrogenbomb,sargeras,1400,evoker,devastation,30,17,13
Bumbledragn,moon-guard,1396,evoker,devastation,53,27,26
Tyrvin,kiljaeden,1396,evoker,devastation,51,25,26
Veserion,azralon,1395,evoker,devastation,72,41,31
Yuukee,thrall,1394,evoker,devastation,37,22,15
Itwasntthis,tichondrius,1394,evoker,devastation,57,33,24
Srb,chogall,1390,evoker,devastation,26,16,10
Devdjinn,tichondrius,1377,evoker,devastation,64,32,32
Scaleychad,zuljin,1375,evoker,devastation,35,15,20
Aoxila,proudmoore,1366,evoker,devastation,78,33,45
Drakoris,malganis,1365,evoker,devastation,93,50,43
Meltharian,frostmourne,1365,evoker,devastation,32,15,17
Navaji,tichondrius,1362,evoker,devastation,55,30,25
Zayllaerth,illidan,1360,evoker,devastation,82,42,40
Thendroz,moon-guard,1357,evoker,devastation,30,18,12
Kêristrasza,wyrmrest-accord,1352,evoker,devastation,54,27,27
Blittlle,bleeding-hollow,1350,evoker,devastation,36,22,14
Monyz,emerald-dream,1342,evoker,devastation,34,26,8
Nazanazar,wyrmrest-accord,1341,evoker,devastation,30,16,14
Mønster,zuljin,1340,evoker,devastation,85,42,43
Marccuss,bleeding-hollow,1339,evoker,devastation,18,14,4
Rodgoesinya,blackrock,1332,evoker,devastation,36,19,17
Epollyon,sargeras,1328,evoker,devastation,24,14,10
Skykeeper,quelthalas,1328,evoker,devastation,106,56,50
Tealetaz,area-52,1320,evoker,devastation,31,18,13
Drachenatem,skywall,1319,evoker,devastation,24,14,10
Thechadwasgr,bleeding-hollow,1310,evoker,devastation,24,14,10
Galakrønd,illidan,1309,evoker,devastation,35,15,20
Emikothyr,thrall,1296,evoker,devastation,60,33,27
Vahaerys,stormrage,1296,evoker,devastation,48,21,27
Vokeero,ysera,1287,evoker,devastation,54,27,27
Sylverion,thrall,1277,evoker,devastation,70,35,35
Dragnmÿballs,blackrock,1263,evoker,devastation,23,14,9
Evokjoe,tortheldrin,1261,evoker,devastation,48,23,25
Ezgamedeez,tichondrius,1247,evoker,devastation,24,13,11
Brounno,area-52,1246,evoker,devastation,34,21,13
Marknormand,area-52,1246,evoker,devastation,24,13,11
Plep,wyrmrest-accord,1244,evoker,devastation,27,14,13
Nazaral,mannoroth,1241,evoker,devastation,24,13,11
Valthenax,frostmourne,1240,evoker,devastation,30,13,17
Zalzin,agamaggan,1239,evoker,devastation,18,13,5
Valyrik,illidan,1239,evoker,devastation,54,22,32
Longxx,dalaran,1235,evoker,devastation,24,13,11
Galakraas,proudmoore,1235,evoker,devastation,69,31,38
Dingermun,bleeding-hollow,1221,evoker,devastation,19,14,5
Rinstraza,thrall,1204,evoker,devastation,29,13,16
Layothyr,stormrage,1201,evoker,devastation,24,14,10
Shamblewing,arthas,1199,evoker,devastation,29,13,16
Wrecketz,tichondrius,1178,evoker,devastation,29,16,13
Jabbawockeëz,drakkari,1178,evoker,devastation,64,30,34
Kaikisen,malganis,1178,evoker,devastation,41,19,22
Midnights,scarlet-crusade,1153,evoker,devastation,30,18,12
Envisioned,kelthuzad,1149,evoker,devastation,24,14,10
Rengöku,skullcrusher,1148,evoker,devastation,24,12,12
Zona,moon-guard,1147,evoker,devastation,24,12,12
Aentharion,argent-dawn,1147,evoker,devastation,24,12,12
Azorian,vashj,1146,evoker,devastation,24,13,11
Drozul,stormrage,1145,evoker,devastation,30,12,18
Zippityzoom,barthilas,1139,evoker,devastation,36,15,21
Dinnkyion,dalaran,1138,evoker,devastation,24,12,12
Dragonbranch,area-52,1133,evoker,devastation,24,12,12
Yiserion,sargeras,1114,evoker,devastation,30,15,15
Asham,azralon,1111,evoker,devastation,36,21,15
Zitasanazen,tichondrius,1107,evoker,devastation,64,25,39
Frequevoker,tichondrius,1103,evoker,devastation,29,12,17
Raghnard,illidan,1099,evoker,devastation,28,13,15
Madelines,tichondrius,1097,evoker,devastation,24,13,11
Zhannecgos,moon-guard,1087,evoker,devastation,28,12,16
Ocdgamer,malganis,1086,evoker,devastation,31,13,18
Prevocker,sargeras,1082,evoker,devastation,26,12,14
Dragneel,wyrmrest-accord,1076,evoker,devastation,27,12,15
Aktas,illidan,1063,evoker,devastation,28,12,16
Yousurper,thunderlord,1058,evoker,devastation,24,13,11
Dracomalfoyy,caelestrasz,1056,evoker,devastation,15,12,3
Endoveire,tichondrius,1055,evoker,devastation,18,11,7
Hydroponicsz,bloodscalp,1055,evoker,devastation,24,11,13
Kubus,emerald-dream,1054,evoker,devastation,18,11,7
Climax,stormrage,1054,evoker,devastation,24,11,13
Howtew,jubeithos,1048,evoker,devastation,18,11,7
Jurokiel,sargeras,1046,evoker,devastation,18,11,7
Sübjugador,azralon,1042,evoker,devastation,30,20,10
Valentis,bleeding-hollow,1041,evoker,devastation,24,11,13
Drögón,stormrage,1038,evoker,devastation,24,16,8
Crymor,lethon,1019,evoker,devastation,24,12,12
Herikas,tichondrius,1009,evoker,devastation,49,26,23
Culture,khazgoroth,1006,evoker,devastation,15,11,4
Seldantria,dalaran,960,evoker,devastation,18,10,8
Kazrekan,moon-guard,960,evoker,devastation,18,10,8
Pykan,skullcrusher,960,evoker,devastation,24,10,14
Cmiygl,proudmoore,959,evoker,devastation,12,10,2
Eshaybruh,barthilas,959,evoker,devastation,18,10,8
Xeerus,stormreaver,959,evoker,devastation,18,10,8
Spicyrooster,area-52,959,evoker,devastation,18,10,8
Betasoldier,kelthuzad,958,evoker,devastation,18,10,8
Embarasi,moon-guard,956,evoker,devastation,24,10,14
Jorlozthyr,ragnaros,948,evoker,devastation,24,10,14
Salakhar,drakkari,924,evoker,devastation,14,11,3
Dragongrim,silvermoon,909,evoker,devastation,24,10,14
Ciana,black-dragonflight,902,evoker,devastation,38,19,19
Áspect,aegwynn,864,evoker,devastation,12,9,3
Gobananas,sargeras,864,evoker,devastation,12,9,3
Oracle,duskwood,864,evoker,devastation,12,9,3
Todorøki,hyjal,864,evoker,devastation,18,9,9
Tatsurai,tichondrius,864,evoker,devastation,18,9,9
Puffthemagic,lightnings-blade,864,evoker,devastation,18,9,9
Misik,frostwolf,863,evoker,devastation,18,9,9
Thyatera,ragnaros,863,evoker,devastation,18,9,9
Dracfire,saurfang,863,evoker,devastation,18,9,9
Teanie,tichondrius,861,evoker,devastation,18,9,9
Nasath,arthas,861,evoker,devastation,18,9,9
Talanoth,skullcrusher,859,evoker,devastation,18,9,9
Aelvina,moon-guard,857,evoker,devastation,24,9,15
Alnuin,stormrage,857,evoker,devastation,60,17,43
Furyíon,stormrage,855,evoker,devastation,12,9,3
Trenot,draenor,855,evoker,devastation,18,9,9
Stolesom,emerald-dream,849,evoker,devastation,26,10,16
Tïtäm,area-52,846,evoker,devastation,17,9,8
Rasec,moon-guard,843,evoker,devastation,20,9,11
Abaddragon,dalaran,831,evoker,devastation,17,9,8
Zandrov,greymane,814,evoker,devastation,15,9,6
Dvrk,frostmourne,812,evoker,devastation,17,9,8
Sindraxx,stormrage,811,evoker,devastation,15,9,6
Dragonfarts,frostmourne,768,evoker,devastation,12,8,4
Algonir,wyrmrest-accord,768,evoker,devastation,12,8,4
Saryuja,thunderhorn,768,evoker,devastation,12,8,4
Teritwo,stormrage,768,evoker,devastation,18,8,10
Airgordan,area-52,768,evoker,devastation,21,9,12
Pewpowdragon,malganis,767,evoker,devastation,12,8,4
Dragocser,drakkari,767,evoker,devastation,12,8,4
Vermax,akama,767,evoker,devastation,18,8,10
Karox,moon-guard,767,evoker,devastation,18,8,10
Malygoz,frostmourne,767,evoker,devastation,18,8,10
Zlandicaar,area-52,766,evoker,devastation,18,8,10
Dawitchvoker,illidan,766,evoker,devastation,18,8,10
Archion,azgalor,764,evoker,devastation,24,8,16
Detraa,illidan,754,evoker,devastation,12,8,4
Kyloflight,thrall,736,evoker,devastation,10,9,1
Lamperr,illidan,728,evoker,devastation,48,10,38
Zhyrouvion,stormrage,699,evoker,devastation,17,8,9
Escanorr,ghostlands,693,evoker,devastation,14,8,6
Mushugon,wyrmrest-accord,672,evoker,devastation,12,7,5
Serathrine,smolderthorn,672,evoker,devastation,12,7,5
Eastwubz,norgannon,672,evoker,devastation,12,7,5
Dudeofdragon,illidan,672,evoker,devastation,12,7,5
Vokr,area-52,672,evoker,devastation,12,7,5
Lacadabeef,tichondrius,672,evoker,devastation,12,7,5
Komodolong,tichondrius,672,evoker,devastation,16,8,8
Strepo,proudmoore,672,evoker,devastation,18,7,11
Runescape,altar-of-storms,672,evoker,devastation,18,7,11
Rotscale,proudmoore,672,evoker,devastation,18,7,11
Razistzegrlz,illidan,672,evoker,devastation,24,7,17
Gôdswrath,tichondrius,671,evoker,devastation,12,7,5
Mayhemvoker,rexxar,671,evoker,devastation,12,7,5
Whiegrath,azralon,671,evoker,devastation,12,7,5
Xeretas,bleeding-hollow,671,evoker,devastation,12,7,5
Dragontrees,illidan,671,evoker,devastation,12,7,5
Loganvkr,illidan,671,evoker,devastation,12,7,5
Krokuzan,ragnaros,671,evoker,devastation,12,7,5
Glaurungr,ragnaros,671,evoker,devastation,12,7,5
Karaxes,gorefiend,671,evoker,devastation,18,7,11
Setchagos,emerald-dream,670,evoker,devastation,12,7,5
Fìg,wyrmrest-accord,670,evoker,devastation,12,7,5
Beastlysoul,tichondrius,670,evoker,devastation,12,7,5
Loginplease,frostmourne,670,evoker,devastation,18,7,11
Nikeze,kiljaeden,670,evoker,devastation,18,7,11
Sleepeasy,blackrock,667,evoker,devastation,18,7,11
Popgoesurmom,tichondrius,662,evoker,devastation,12,7,5
Drahkoo,azralon,623,evoker,devastation,15,7,8
Sidrasza,norgannon,607,evoker,devastation,16,7,9
Tekath,altar-of-storms,591,evoker,devastation,13,7,6
Coltist,elune,576,evoker,devastation,6,6,0
Dovå,moon-guard,576,evoker,devastation,6,6,0
Zenasatral,sargeras,576,evoker,devastation,6,6,0
Yellowker,thrall,576,evoker,devastation,6,6,0
Orncen,emerald-dream,576,evoker,devastation,10,7,3
Bigbadfred,tichondrius,576,evoker,devastation,12,6,6
Puffthemagiq,mugthol,576,evoker,devastation,12,6,6
Siatrend,moon-guard,576,evoker,devastation,12,6,6
Brakkarion,wyrmrest-accord,576,evoker,devastation,12,6,6
Dafiya,thrall,576,evoker,devastation,12,6,6
Comepancito,quelthalas,576,evoker,devastation,12,6,6
Dragønbørne,blackrock,576,evoker,devastation,12,6,6
Royquaza,illidan,576,evoker,devastation,12,6,6
Dracthyrius,thunderlord,576,evoker,devastation,12,6,6
Glizard,firetree,576,evoker,devastation,12,6,6
Drsgme,dentarg,576,evoker,devastation,12,6,6
Iamtrash,daggerspine,576,evoker,devastation,12,6,6
Krashbandico,zangarmarsh,576,evoker,devastation,18,6,12
Kinto,stormrage,576,evoker,devastation,18,6,12
Rykuvokr,azuremyst,575,evoker,devastation,12,6,6
Avastri,moon-guard,575,evoker,devastation,12,6,6
Avithori,borean-tundra,575,evoker,devastation,12,6,6
Lòrdope,illidan,575,evoker,devastation,12,6,6
Børedom,burning-legion,575,evoker,devastation,12,6,6
Keedrori,thrall,575,evoker,devastation,13,6,7
Vermáx,caelestrasz,574,evoker,devastation,12,6,6
Snowdragon,azralon,574,evoker,devastation,12,6,6
Carloxd,tichondrius,574,evoker,devastation,24,6,18
Syndue,malganis,573,evoker,devastation,12,6,6
Noodleslut,stormrage,573,evoker,devastation,12,6,6
Azuril,wyrmrest-accord,572,evoker,devastation,12,6,6
Lightaurae,thunderlord,556,evoker,devastation,30,6,24
Blazor,sisters-of-elune,542,evoker,devastation,11,6,5
Dragonbreaf,emerald-dream,527,evoker,devastation,11,6,5
Alekoslol,area-52,522,evoker,devastation,16,8,8
Lexgrossman,kelthuzad,495,evoker,devastation,19,6,13
Jiminsgf,tichondrius,480,evoker,devastation,6,5,1
Evokez,barthilas,480,evoker,devastation,6,5,1
Unseenzblack,tichondrius,480,evoker,devastation,6,5,1
Vaelikai,korgath,480,evoker,devastation,6,5,1
Hotdragon,zuljin,480,evoker,devastation,6,5,1
Gangbânk,tichondrius,480,evoker,devastation,6,5,1
Drakedrift,malganis,480,evoker,devastation,6,5,1
Stælthßømbèr,baelgun,480,evoker,devastation,12,5,7
Trillvoker,illidan,480,evoker,devastation,12,5,7
Kinndyvoker,sargeras,480,evoker,devastation,12,5,7
Kheeleesi,illidan,480,evoker,devastation,12,5,7
Kozara,trollbane,480,evoker,devastation,12,5,7
Taeloc,frostmourne,480,evoker,devastation,12,5,7
Bazelgos,moon-guard,480,evoker,devastation,12,5,7
Deezdragon,stormrage,480,evoker,devastation,12,5,7
Evokes,moon-guard,480,evoker,devastation,12,5,7
Draehgor,hyjal,480,evoker,devastation,12,5,7
Meleyx,saurfang,480,evoker,devastation,12,5,7
Bently,bloodhoof,480,evoker,devastation,12,5,7
Purplerocket,illidan,480,evoker,devastation,12,5,7
Fizzlevoker,malganis,480,evoker,devastation,12,5,7
Ryhu,sargeras,480,evoker,devastation,12,5,7
Darkscale,haomarush,480,evoker,devastation,12,5,7
Asatrat,greymane,480,evoker,devastation,12,5,7
Ackresh,executus,480,evoker,devastation,12,5,7
Glideoure,stonemaul,480,evoker,devastation,18,5,13
Kozukimomo,area-52,480,evoker,devastation,18,5,13
Wizadsa,amanthul,479,evoker,devastation,6,5,1
Dragoceleste,ragnaros,479,evoker,devastation,6,5,1
Scalesun,azralon,479,evoker,devastation,12,5,7
Evooern,frostmourne,479,evoker,devastation,12,5,7
Dedderion,zuljin,479,evoker,devastation,12,5,7
Lorathyr,lothar,479,evoker,devastation,12,5,7
Drahconne,illidan,479,evoker,devastation,12,5,7
Warhammerxx,tichondrius,479,evoker,devastation,21,6,15
Draconicus,bonechewer,478,evoker,devastation,18,5,13
Nathrach,wyrmrest-accord,477,evoker,devastation,6,5,1
Sandrov,kaelthas,477,evoker,devastation,12,5,7
Visron,stormrage,474,evoker,devastation,12,5,7
Pouncer,proudmoore,473,evoker,devastation,14,5,9
Durijus,tichondrius,426,evoker,devastation,17,7,10
Mmrglmrglmr,stormrage,399,evoker,devastation,5,5,0
Kosstro,thunderlord,398,evoker,devastation,10,5,5
Mushú,archimonde,384,evoker,devastation,6,4,2
Machaflux,winterhoof,384,evoker,devastation,6,4,2
Atraxian,tichondrius,384,evoker,devastation,6,4,2
Bmbo,illidan,384,evoker,devastation,6,4,2
Lizardgodtko,tichondrius,384,evoker,devastation,6,4,2
Dovàhkin,moon-guard,384,evoker,devastation,6,4,2
Deathraux,tichondrius,384,evoker,devastation,6,4,2
Qfyre,frostmourne,384,evoker,devastation,6,4,2
Bodytypetwo,area-52,384,evoker,devastation,6,4,2
Raikori,ragnaros,384,evoker,devastation,6,4,2
Koralia,wyrmrest-accord,384,evoker,devastation,6,4,2
Kiserys,suramar,384,evoker,devastation,6,4,2
Dillss,tichondrius,384,evoker,devastation,6,4,2
Seaserpent,kelthuzad,384,evoker,devastation,6,4,2
Aaztra,whisperwind,384,evoker,devastation,6,4,2
Zoomi,whisperwind,384,evoker,devastation,6,4,2
Shenròn,kelthuzad,384,evoker,devastation,6,4,2
Docevoker,tichondrius,384,evoker,devastation,6,4,2
Draisin,zuljin,384,evoker,devastation,6,4,2
Curtis,shadowmoon,384,evoker,devastation,6,4,2
Whinks,zangarmarsh,384,evoker,devastation,6,4,2
Lardicønn,thrall,384,evoker,devastation,6,4,2
Growthyy,malganis,384,evoker,devastation,6,4,2
Nysian,wyrmrest-accord,384,evoker,devastation,6,4,2
Xhamon,quelthalas,384,evoker,devastation,6,4,2
Écaille,dalaran,384,evoker,devastation,6,4,2
Kaidoxuchihv,ragnaros,384,evoker,devastation,6,4,2
Jereico,stonemaul,384,evoker,devastation,6,4,2
Drogu,kelthuzad,384,evoker,devastation,6,4,2
Dragonsbgay,stormrage,384,evoker,devastation,6,4,2
Smacktoch,sargeras,384,evoker,devastation,12,4,8
Thnake,zuljin,384,evoker,devastation,12,4,8
Rizzlordx,bleeding-hollow,384,evoker,devastation,12,4,8
Dragostephen,nazjatar,384,evoker,devastation,12,4,8
Idiotlizard,stormrage,384,evoker,devastation,12,4,8
Bhanethyr,illidan,384,evoker,devastation,12,4,8
Slitherin,dalaran,384,evoker,devastation,12,4,8
Golden,area-52,384,evoker,devastation,12,4,8
Butta,darkspear,384,evoker,devastation,12,4,8
Munichho,spirestone,384,evoker,devastation,18,4,14
Pläid,azuremyst,383,evoker,devastation,6,4,2
Dinossauro,stormrage,383,evoker,devastation,6,4,2
Redeyés,area-52,383,evoker,devastation,6,4,2
Rysonda,tichondrius,383,evoker,devastation,6,4,2
Pyrepapi,thrall,352,evoker,devastation,10,4,6
Serazenoth,area-52,336,evoker,devastation,9,4,5
Acindor,stormrage,335,evoker,devastation,11,4,7
Fearmybreath,stormrage,329,evoker,devastation,14,5,9
Carrnedge,area-52,319,evoker,devastation,5,4,1
Lamdyn,wyrmrest-accord,288,evoker,devastation,6,3,3
Favoredson,area-52,288,evoker,devastation,6,3,3
Shennron,darkspear,288,evoker,devastation,6,3,3
Kulrainor,drakkari,288,evoker,devastation,6,3,3
Dragonstonks,moon-guard,288,evoker,devastation,6,3,3
Galakrond,black-dragonflight,288,evoker,devastation,6,3,3
Rhÿu,quelthalas,288,evoker,devastation,6,3,3
Bagelsaurus,tichondrius,288,evoker,devastation,6,3,3
Avasd,area-52,288,evoker,devastation,6,3,3
Dreamfyrexi,thrall,288,evoker,devastation,6,3,3
Kettor,kelthuzad,288,evoker,devastation,6,3,3
Yousmokemids,frostwolf,288,evoker,devastation,6,3,3
Axiomoixa,tichondrius,288,evoker,devastation,6,3,3
Dragontales,stormrage,288,evoker,devastation,6,3,3
Nethenezoth,auchindoun,288,evoker,devastation,6,3,3
Baddrake,moon-guard,288,evoker,devastation,6,3,3
Shwaydbz,zuljin,288,evoker,devastation,6,3,3
Aomend,stormrage,288,evoker,devastation,6,3,3
Platypus,tichondrius,288,evoker,devastation,6,3,3
Æthyr,anubarak,288,evoker,devastation,6,3,3
Xxkimura,tichondrius,288,evoker,devastation,6,3,3
Hausebat,aegwynn,288,evoker,devastation,6,3,3
Dragonherb,zuljin,288,evoker,devastation,6,3,3
Kjerne,stormrage,288,evoker,devastation,6,3,3
Zorashal,kiljaeden,288,evoker,devastation,6,3,3
Uncleìroh,tichondrius,288,evoker,devastation,6,3,3
Granolajin,ragnaros,288,evoker,devastation,6,3,3
Deewey,sargeras,288,evoker,devastation,6,3,3
Nathenezital,frostmourne,288,evoker,devastation,6,3,3
Aegontargary,azralon,288,evoker,devastation,6,3,3
Shanegillis,emerald-dream,288,evoker,devastation,6,3,3
Scyyterr,azralon,288,evoker,devastation,6,3,3
Taegon,area-52,288,evoker,devastation,10,4,6
Enserio,stormrage,288,evoker,devastation,12,3,9
Ashenoth,antonidas,288,evoker,devastation,12,3,9
Erling,duskwood,288,evoker,devastation,12,3,9
Deathflamee,emerald-dream,288,evoker,devastation,12,3,9
Rïvé,tichondrius,288,evoker,devastation,12,3,9
Talonsong,wyrmrest-accord,288,evoker,devastation,12,3,9
Evilsquirel,area-52,287,evoker,devastation,6,3,3
Fortwonty,thrall,287,evoker,devastation,6,3,3
Zeralzin,aerie-peak,287,evoker,devastation,6,3,3
Kilnarx,uldaman,286,evoker,devastation,6,3,3
Ghorin,akama,240,evoker,devastation,9,3,6
Zartolas,moon-guard,239,evoker,devastation,11,3,8
Trrxx,tichondrius,224,evoker,devastation,10,3,7
Racovoker,zuljin,192,evoker,devastation,6,2,4
Analogies,stormrage,192,evoker,devastation,6,2,4
Rebuk,area-52,192,evoker,devastation,6,2,4
Dragonsand,area-52,192,evoker,devastation,6,2,4
Selocky,bleeding-hollow,192,evoker,devastation,6,2,4
Takhysis,frostmourne,192,evoker,devastation,6,2,4
Slydawg,amanthul,192,evoker,devastation,6,2,4
Draketyr,area-52,192,evoker,devastation,6,2,4
Puffed,frostmourne,192,evoker,devastation,6,2,4
Parachutes,kelthuzad,192,evoker,devastation,6,2,4
Theyevokbuda,kelthuzad,192,evoker,devastation,6,2,4
Ilithiphobia,ghostlands,192,evoker,devastation,6,2,4
Tylexstranza,malganis,192,evoker,devastation,6,2,4
Lightbeing,nazjatar,192,evoker,devastation,6,2,4
Yalena,illidan,192,evoker,devastation,6,2,4
Vermithõr,ragnaros,192,evoker,devastation,6,2,4
Vikings,madoran,192,evoker,devastation,6,2,4
Ytq,tichondrius,192,evoker,devastation,6,2,4
Lostplanet,drakkari,192,evoker,devastation,6,2,4
Noxidian,moon-guard,192,evoker,devastation,6,2,4
Wse,illidan,192,evoker,devastation,6,2,4
Kazervish,wyrmrest-accord,192,evoker,devastation,6,2,4
Byäkuyá,azralon,192,evoker,devastation,6,2,4
Actïoncat,emerald-dream,192,evoker,devastation,6,2,4
Nitalash,moon-guard,192,evoker,devastation,6,2,4
Dixb,illidan,192,evoker,devastation,6,2,4
Healmeta,sargeras,192,evoker,devastation,6,2,4
Kímbah,emerald-dream,192,evoker,devastation,6,2,4
Mtndewboy,illidan,192,evoker,devastation,6,2,4
Doldorrii,terenas,192,evoker,devastation,6,2,4
Darazen,scarlet-crusade,192,evoker,devastation,6,2,4
Dokthyr,lightbringer,192,evoker,devastation,6,2,4
Tasdaral,tichondrius,192,evoker,devastation,6,2,4
Genderboy,tichondrius,192,evoker,devastation,6,2,4
Phatë,nerzhul,192,evoker,devastation,6,2,4
Daraz,tichondrius,192,evoker,devastation,6,2,4
Paindragon,tol-barad,192,evoker,devastation,6,2,4
Saxthyr,stormreaver,192,evoker,devastation,6,2,4
Nyaraoorun,uther,192,evoker,devastation,6,2,4
Acade,tichondrius,192,evoker,devastation,6,2,4
Charlestrasz,hyjal,192,evoker,devastation,6,2,4
Magnito,thorium-brotherhood,192,evoker,devastation,6,2,4
Chriszilla,tichondrius,192,evoker,devastation,6,2,4
Aralzit,tichondrius,192,evoker,devastation,6,2,4
Cyromancerr,illidan,192,evoker,devastation,8,2,6
Dracalis,thrall,191,evoker,devastation,6,2,4
Goongdi,tichondrius,159,evoker,devastation,5,2,3
Tevvez,moon-guard,159,evoker,devastation,5,2,3
Batwig,tichondrius,159,evoker,devastation,5,2,3
Zzae,tichondrius,144,evoker,devastation,9,2,7
Booniejimbob,illidan,128,evoker,devastation,4,2,2
Vïtmercon,frostmourne,128,evoker,devastation,4,2,2
Vormontis,azralon,112,evoker,devastation,7,2,5
Gavstarz,frostmourne,96,evoker,devastation,3,2,1
Grafixx,sargeras,96,evoker,devastation,3,2,1
Zealagon,ragnaros,96,evoker,devastation,6,1,5
Ojigi,sargeras,96,evoker,devastation,6,1,5
Yongyang,tichondrius,96,evoker,devastation,6,1,5
Fígment,tichondrius,96,evoker,devastation,6,1,5
Ackonstraza,frostmourne,96,evoker,devastation,6,1,5
Asui,senjin,96,evoker,devastation,6,1,5
Erathiss,wyrmrest-accord,96,evoker,devastation,6,1,5
Dracoi,illidan,96,evoker,devastation,6,1,5
Ðrac,bleeding-hollow,96,evoker,devastation,6,1,5
Lucià,thrall,96,evoker,devastation,6,1,5
Drapybaras,bleeding-hollow,96,evoker,devastation,6,1,5
Batterypowa,frostmourne,96,evoker,devastation,6,1,5
Gamerwords,barthilas,96,evoker,devastation,6,1,5
Terraxkhan,quelthalas,96,evoker,devastation,6,1,5
Cuarta,drakkari,96,evoker,devastation,6,1,5
Modenzu,malganis,96,evoker,devastation,6,1,5
Shintrax,ragnaros,96,evoker,devastation,6,1,5
Aratre,daggerspine,96,evoker,devastation,12,1,11
Ysondrius,durotan,96,evoker,devastation,12,1,11
Nwo,shattered-hand,64,evoker,devastation,4,1,3
Cerevok,area-52,64,evoker,devastation,4,1,3
Zindrozarath,area-52,64,evoker,devastation,4,1,3
Zyzzy,icecrown,48,evoker,devastation,3,1,2
Neofarian,lightbringer,31,evoker,devastation,2,1,1
Emoker,magtheridon,16,evoker,devastation,1,1,0
Remisha,emerald-dream,2136,hunter,marksmanship,82,44,38
Dobarantu,tichondrius,2041,hunter,marksmanship,63,33,30
Abolick,area-52,2026,hunter,marksmanship,90,48,42
Fuknhunter,kiljaeden,1980,hunter,marksmanship,95,51,44
Rakan,spinebreaker,1884,hunter,marksmanship,54,33,21
Renaître,tichondrius,1866,hunter,marksmanship,120,57,63
Nishinos,tichondrius,1839,hunter,marksmanship,177,86,91
Iconvoked,sargeras,1812,hunter,marksmanship,96,51,45
Bosshunter,tichondrius,1810,hunter,marksmanship,86,43,43
Undeadroach,tichondrius,1804,hunter,marksmanship,89,42,47
Hokutox,tichondrius,1803,hunter,marksmanship,50,23,27
Deutêr,quelthalas,1801,hunter,marksmanship,60,32,28
Drasen,deathwing,1778,hunter,marksmanship,48,27,21
Hagadinn,frostmourne,1765,hunter,marksmanship,48,21,27
Alyywn,tichondrius,1762,hunter,marksmanship,77,37,40
Globalcake,illidan,1758,hunter,marksmanship,54,29,25
Shawtytraps,tichondrius,1746,hunter,marksmanship,84,33,51
Boquiinha,stormrage,1729,hunter,marksmanship,72,36,36
Heädshöt,malorne,1728,hunter,marksmanship,60,30,30
Kristemis,thrall,1727,hunter,marksmanship,42,23,19
Kkoduckk,tichondrius,1715,hunter,marksmanship,30,19,11
Dolcece,tichondrius,1713,hunter,marksmanship,48,24,24
Darkshady,tichondrius,1708,hunter,marksmanship,48,21,27
Onemøreshot,bleeding-hollow,1701,hunter,marksmanship,42,26,16
Somethinggo,tichondrius,1698,hunter,marksmanship,71,40,31
Hrafn,illidan,1693,hunter,marksmanship,42,21,21
Blackjesu,blackrock,1691,hunter,marksmanship,36,20,16
Dummorogh,stormrage,1682,hunter,marksmanship,54,28,26
Killatrap,malganis,1677,hunter,marksmanship,42,23,19
Ingrutamig,tichondrius,1672,hunter,marksmanship,48,23,25
Onemoreshot,bleeding-hollow,1669,hunter,marksmanship,68,31,37
Tassili,illidan,1666,hunter,marksmanship,60,23,37
Quickitty,proudmoore,1648,hunter,marksmanship,54,25,29
Insanedabz,tichondrius,1644,hunter,marksmanship,36,22,14
Easynightjr,bleeding-hollow,1632,hunter,marksmanship,168,89,79
Bigpie,daggerspine,1628,hunter,marksmanship,59,37,22
Arjunå,sargeras,1621,hunter,marksmanship,101,56,45
Dezertpower,sargeras,1613,hunter,marksmanship,36,20,16
Notnick,tichondrius,1604,hunter,marksmanship,42,17,25
Tropic,proudmoore,1602,hunter,marksmanship,41,17,24
Dienasty,zuljin,1601,hunter,marksmanship,30,21,9
Luchadoris,malganis,1587,hunter,marksmanship,55,29,26
Johaylon,sargeras,1583,hunter,marksmanship,36,17,19
Taylormadae,frostmourne,1570,hunter,marksmanship,60,32,28
Stimpblimp,jubeithos,1563,hunter,marksmanship,48,19,29
Latesummer,tichondrius,1559,hunter,marksmanship,30,17,13
Shotsphodays,sargeras,1558,hunter,marksmanship,72,37,35
Rampagez,tichondrius,1555,hunter,marksmanship,36,19,17
Alansho,tichondrius,1551,hunter,marksmanship,41,17,24
Metalgear,icecrown,1533,hunter,marksmanship,66,34,32
Aymas,sargeras,1528,hunter,marksmanship,71,33,38
Colada,malganis,1524,hunter,marksmanship,36,16,20
Elfymcelf,arthas,1520,hunter,marksmanship,84,39,45
Baixiaochu,area-52,1519,hunter,marksmanship,63,30,33
Lsily,tichondrius,1519,hunter,marksmanship,36,16,20
Cyrsmen,ragnaros,1518,hunter,marksmanship,45,21,24
Chï,zuljin,1510,hunter,marksmanship,77,41,36
Hitts,barthilas,1510,hunter,marksmanship,47,23,24
Undien,area-52,1509,hunter,marksmanship,30,16,14
Aimz,zuluhed,1467,hunter,marksmanship,61,25,36
Vibøra,stormrage,1461,hunter,marksmanship,42,17,25
Braxigarr,area-52,1460,hunter,marksmanship,95,48,47
Esler,quelthalas,1447,hunter,marksmanship,36,18,18
Hemathios,drakkari,1442,hunter,marksmanship,50,21,29
Xcisiion,nagrand,1438,hunter,marksmanship,34,18,16
Windrein,ysondre,1438,hunter,marksmanship,42,17,25
Nelosi,shadowmoon,1423,hunter,marksmanship,36,16,20
Hämhunter,stormrage,1415,hunter,marksmanship,24,16,8
Klannis,quelthalas,1409,hunter,marksmanship,42,19,23
Malebolick,ragnaros,1409,hunter,marksmanship,59,25,34
Ryukuzen,tichondrius,1409,hunter,marksmanship,36,15,21
Gstring,kelthuzad,1408,hunter,marksmanship,48,22,26
Lewanker,zuljin,1406,hunter,marksmanship,30,17,13
Húntingarrow,area-52,1403,hunter,marksmanship,66,34,32
Condorexe,illidan,1395,hunter,marksmanship,54,22,32
Lixniqua,tichondrius,1392,hunter,marksmanship,23,15,8
Rockenrique,nemesis,1390,hunter,marksmanship,36,16,20
ßeãst,bladefist,1387,hunter,marksmanship,24,16,8
Maia,frostwolf,1387,hunter,marksmanship,36,15,21
Lokuhzmarcus,goldrinn,1374,hunter,marksmanship,36,19,17
Leshwi,ragnaros,1370,hunter,marksmanship,47,23,24
Pleyadez,drakkari,1356,hunter,marksmanship,42,24,18
Celph,moon-guard,1356,hunter,marksmanship,42,19,23
Cashhapp,zuljin,1350,hunter,marksmanship,85,42,43
Lowlore,moon-guard,1349,hunter,marksmanship,68,34,34
Kyukon,illidan,1345,hunter,marksmanship,36,18,18
Evaelfi,illidan,1340,hunter,marksmanship,33,14,19
Toniic,moon-guard,1337,hunter,marksmanship,42,27,15
Orgpopeyes,illidan,1336,hunter,marksmanship,24,14,10
Dvei,silvermoon,1336,hunter,marksmanship,57,25,32
Voidmarksman,whisperwind,1335,hunter,marksmanship,25,17,8
Kalibah,azralon,1323,hunter,marksmanship,36,14,22
Acelol,proudmoore,1320,hunter,marksmanship,89,46,43
Péppérmínt,korgath,1318,hunter,marksmanship,22,15,7
Dogezandalar,illidan,1317,hunter,marksmanship,40,18,22
Ricas,malganis,1315,hunter,marksmanship,98,44,54
Bojob,azgalor,1314,hunter,marksmanship,40,22,18
Sniperarmy,dalaran,1311,hunter,marksmanship,73,38,35
Killz,skullcrusher,1306,hunter,marksmanship,38,21,17
Boombob,sargeras,1304,hunter,marksmanship,29,14,15
Benme,illidan,1299,hunter,marksmanship,115,47,68
Veranir,nemesis,1291,hunter,marksmanship,85,44,41
Cloudbuck,aegwynn,1290,hunter,marksmanship,48,18,30
Joshmckin,area-52,1288,hunter,marksmanship,34,14,20
Tristiae,stormrage,1281,hunter,marksmanship,41,21,20
Darylovejr,destromath,1274,hunter,marksmanship,38,16,22
Apaweclover,stormrage,1269,hunter,marksmanship,119,58,61
Idiiot,sargeras,1268,hunter,marksmanship,38,19,19
Lilbang,thrall,1257,hunter,marksmanship,24,14,10
Lightweight,kelthuzad,1257,hunter,marksmanship,47,22,25
Seenobody,stormrage,1255,hunter,marksmanship,30,17,13
Mezmore,thrall,1255,hunter,marksmanship,42,21,21
Mensrea,illidan,1254,hunter,marksmanship,31,21,10
Jerybery,gundrak,1253,hunter,marksmanship,29,18,11
Duruainn,zuljin,1251,hunter,marksmanship,43,18,25
Shotashot,area-52,1246,hunter,marksmanship,30,13,17
Huntncheekz,kelthuzad,1244,hunter,marksmanship,33,15,18
Hoeswannafuk,stormrage,1243,hunter,marksmanship,24,13,11
Mizhu,ragnaros,1242,hunter,marksmanship,36,17,19
Rudekeef,illidan,1240,hunter,marksmanship,24,13,11
Softhunter,tichondrius,1240,hunter,marksmanship,30,13,17
Vergillx,ragnaros,1239,hunter,marksmanship,38,21,17
Rekshot,amanthul,1237,hunter,marksmanship,78,34,44
Adive,drakkari,1236,hunter,marksmanship,30,13,17
Marshen,zuljin,1235,hunter,marksmanship,30,13,17
Albe,azralon,1230,hunter,marksmanship,42,18,24
Jotosalsa,blackrock,1229,hunter,marksmanship,24,13,11
Chikkynuggy,destromath,1228,hunter,marksmanship,33,14,19
Realskinhead,terenas,1226,hunter,marksmanship,30,13,17
Fuzzypjs,stormrage,1226,hunter,marksmanship,33,14,19
Ilovehippos,laughing-skull,1224,hunter,marksmanship,90,42,48
Automatic,illidan,1223,hunter,marksmanship,30,13,17
Diisdik,tichondrius,1223,hunter,marksmanship,37,14,23
Zock,lothar,1220,hunter,marksmanship,58,28,30
Jumaanji,gurubashi,1216,hunter,marksmanship,25,13,12
Targetreaper,proudmoore,1215,hunter,marksmanship,24,13,11
Wixyy,aegwynn,1208,hunter,marksmanship,46,20,26
Rocroc,gurubashi,1205,hunter,marksmanship,30,15,15
Vinranya,sargeras,1194,hunter,marksmanship,75,34,41
Cßo,tichondrius,1191,hunter,marksmanship,54,26,28
Chaðs,amanthul,1190,hunter,marksmanship,39,21,18
Kayzia,lightninghoof,1190,hunter,marksmanship,29,13,16
Chainmaster,misha,1189,hunter,marksmanship,43,19,24
Forthethrill,area-52,1187,hunter,marksmanship,45,24,21
Oopsurtrappd,darkspear,1186,hunter,marksmanship,29,16,13
Udietofast,illidan,1177,hunter,marksmanship,47,19,28
Nelandris,tichondrius,1176,hunter,marksmanship,41,20,21
Aftërlyfe,tichondrius,1170,hunter,marksmanship,29,14,15
Ackzar,ragnaros,1166,hunter,marksmanship,45,24,21
Vhan,azralon,1163,hunter,marksmanship,38,17,21
Cocobread,stormreaver,1161,hunter,marksmanship,36,13,23
Valieev,black-dragonflight,1158,hunter,marksmanship,18,13,5
Thoopered,korgath,1151,hunter,marksmanship,53,30,23
Hunterlist,frostmourne,1151,hunter,marksmanship,24,12,12
Negãn,tichondrius,1151,hunter,marksmanship,24,12,12
Wìkkihx,emerald-dream,1148,hunter,marksmanship,24,12,12
Hötdôg,kiljaeden,1145,hunter,marksmanship,24,12,12
Gunther,korgath,1144,hunter,marksmanship,24,12,12
Pwnagraphic,barthilas,1144,hunter,marksmanship,30,12,18
Arrowslol,stormrage,1143,hunter,marksmanship,30,12,18
Plopslopper,frostmourne,1142,hunter,marksmanship,24,12,12
Bowinc,greymane,1140,hunter,marksmanship,18,12,6
Pokcmvmxckm,senjin,1136,hunter,marksmanship,24,12,12
Bigolhippy,frostmourne,1129,hunter,marksmanship,24,12,12
Alindra,zuluhed,1127,hunter,marksmanship,36,13,23
Kritsu,tichondrius,1122,hunter,marksmanship,24,12,12
Banshee,frostmourne,1119,hunter,marksmanship,16,13,3
Linedalina,wyrmrest-accord,1119,hunter,marksmanship,30,14,16
Jubiscleudo,azralon,1116,hunter,marksmanship,29,12,17
Maxwel,sargeras,1114,hunter,marksmanship,91,46,45
Halibut,quelthalas,1106,hunter,marksmanship,47,25,22
Preze,moon-guard,1101,hunter,marksmanship,22,13,9
Wwing,frostwolf,1101,hunter,marksmanship,94,49,45
Madogite,azralon,1097,hunter,marksmanship,36,25,11
Kalinor,cenarius,1095,hunter,marksmanship,24,13,11
Moüserat,moon-guard,1088,hunter,marksmanship,78,34,44
Lezzbow,tichondrius,1081,hunter,marksmanship,61,32,29
Gromtheponch,area-52,1065,hunter,marksmanship,23,12,11
Vipermaster,azralon,1065,hunter,marksmanship,28,14,14
Sumom,darrowmere,1065,hunter,marksmanship,30,13,17
Oqqo,tichondrius,1061,hunter,marksmanship,30,12,18
Baldor,stormrage,1061,hunter,marksmanship,48,19,29
Gvjellybeans,tichondrius,1056,hunter,marksmanship,18,11,7
Tren,blackrock,1056,hunter,marksmanship,18,11,7
Thebweh,ragnaros,1054,hunter,marksmanship,24,11,13
Zasnar,malganis,1053,hunter,marksmanship,24,11,13
Blimpbooty,stormrage,1050,hunter,marksmanship,24,11,13
Balun,sargeras,1049,hunter,marksmanship,24,11,13
Vansatih,azralon,1047,hunter,marksmanship,66,27,39
Staticarrow,norgannon,1046,hunter,marksmanship,30,11,19
Corruptid,moon-guard,1039,hunter,marksmanship,18,11,7
Yoimiya,thunderlord,1036,hunter,marksmanship,41,18,23
Jetlinx,thrall,1031,hunter,marksmanship,18,11,7
Angelacross,azralon,1027,hunter,marksmanship,30,13,17
Torturekilla,bleeding-hollow,1026,hunter,marksmanship,30,15,15
Balgair,hakkar,1019,hunter,marksmanship,40,22,18
Yadír,quelthalas,1017,hunter,marksmanship,30,11,19
Shukucingjr,illidan,1015,hunter,marksmanship,39,23,16
Kuramax,senjin,1010,hunter,marksmanship,48,20,28
Brenri,boulderfist,1006,hunter,marksmanship,24,13,11
Lauannÿ,gallywix,997,hunter,marksmanship,48,23,25
Nelay,ragnaros,988,hunter,marksmanship,23,11,12
Kánnah,ragnaros,988,hunter,marksmanship,65,31,34
Ritler,frostmourne,987,hunter,marksmanship,21,11,10
Scottcrume,area-52,986,hunter,marksmanship,36,15,21
Triggaplease,jubeithos,983,hunter,marksmanship,49,27,22
Tiidkloul,illidan,968,hunter,marksmanship,18,12,6
Ontarget,cairne,968,hunter,marksmanship,52,24,28
Hanabanana,wyrmrest-accord,960,hunter,marksmanship,12,10,2
Goonsh,tichondrius,960,hunter,marksmanship,18,10,8
Nainit,sargeras,960,hunter,marksmanship,18,10,8
Supersaiyan,antonidas,960,hunter,marksmanship,24,10,14
Sylvaa,tichondrius,960,hunter,marksmanship,30,10,20
Gotchã,area-52,959,hunter,marksmanship,12,10,2
Onehitrip,illidan,959,hunter,marksmanship,66,29,37
Sagadegêmeos,stormrage,959,hunter,marksmanship,30,10,20
Rubinaldo,azralon,958,hunter,marksmanship,18,10,8
Wildder,area-52,958,hunter,marksmanship,18,10,8
Lilnatty,area-52,958,hunter,marksmanship,27,11,16
Kronicbeast,bleeding-hollow,957,hunter,marksmanship,24,10,14
Gretress,azralon,957,hunter,marksmanship,30,10,20
Dartháne,moon-guard,956,hunter,marksmanship,29,11,18
Raneldar,proudmoore,956,hunter,marksmanship,30,10,20
Hurstt,kelthuzad,955,hunter,marksmanship,21,11,10
Twist,burning-legion,953,hunter,marksmanship,12,10,2
Puresport,hyjal,953,hunter,marksmanship,18,10,8
Mèseeks,bleeding-hollow,953,hunter,marksmanship,18,10,8
Verdao,stormrage,952,hunter,marksmanship,30,10,20
Watchmanjoe,grizzly-hills,951,hunter,marksmanship,18,10,8
Zettl,eredar,951,hunter,marksmanship,30,12,18
Xephert,ragnaros,949,hunter,marksmanship,24,10,14
Vanhe,quelthalas,947,hunter,marksmanship,18,10,8
Silverweaver,illidan,939,hunter,marksmanship,24,10,14
Yamanashi,black-dragonflight,936,hunter,marksmanship,48,24,24
Déadlyshot,tichondrius,935,hunter,marksmanship,59,28,31
Thundershots,tichondrius,927,hunter,marksmanship,62,23,39
Huntercotoco,azralon,923,hunter,marksmanship,41,22,19
Porkerr,black-dragonflight,922,hunter,marksmanship,18,10,8
Wael,perenolde,920,hunter,marksmanship,29,10,19
Fourkayiv,azgalor,913,hunter,marksmanship,23,12,11
Crounzz,sargeras,910,hunter,marksmanship,21,11,10
Sunnimuffens,deathwing,906,hunter,marksmanship,23,10,13
Nachtcloverr,stormrage,906,hunter,marksmanship,57,23,34
Sukr,korgath,901,hunter,marksmanship,29,11,18
Karazuba,ragnaros,865,hunter,marksmanship,89,33,56
Comebacks,ragnaros,864,hunter,marksmanship,18,9,9
Imvalence,area-52,864,hunter,marksmanship,18,9,9
Ñðñdêsçrípt,frostmourne,864,hunter,marksmanship,24,9,15
Drãgenox,quelthalas,864,hunter,marksmanship,24,9,15
Hunghang,frostmourne,864,hunter,marksmanship,24,9,15
Rambot,bleeding-hollow,863,hunter,marksmanship,12,9,3
Topshotx,tichondrius,863,hunter,marksmanship,12,9,3
Lildex,demon-soul,863,hunter,marksmanship,12,9,3
Artemyzz,tichondrius,863,hunter,marksmanship,18,9,9
Hmh,burning-legion,863,hunter,marksmanship,18,9,9
Longshánks,stormrage,863,hunter,marksmanship,18,9,9
Dôntlosmebro,stormrage,863,hunter,marksmanship,18,9,9
Junglejam,elune,863,hunter,marksmanship,24,9,15
Airpodpro,emerald-dream,862,hunter,marksmanship,12,9,3
Syrach,area-52,862,hunter,marksmanship,18,9,9
Pokeyourbutt,hydraxis,862,hunter,marksmanship,18,9,9
Katnie,azralon,860,hunter,marksmanship,17,10,7
Junka,bleeding-hollow,860,hunter,marksmanship,18,9,9
Tazent,moon-guard,859,hunter,marksmanship,18,9,9
Mathund,gurubashi,858,hunter,marksmanship,18,9,9
Coldhunger,uldum,857,hunter,marksmanship,12,9,3
Grimbleneep,emerald-dream,855,hunter,marksmanship,24,9,15
Muggzzy,malygos,824,hunter,marksmanship,18,9,9
Brenogam,azralon,802,hunter,marksmanship,21,10,11
Skyloss,illidan,780,hunter,marksmanship,30,9,21
Ragshunt,stormrage,768,hunter,marksmanship,12,8,4
Keenz,frostmourne,768,hunter,marksmanship,18,8,10
Blungo,azralon,768,hunter,marksmanship,18,8,10
Achillez,bleeding-hollow,768,hunter,marksmanship,18,8,10
Muerteaterry,ragnaros,768,hunter,marksmanship,18,8,10
Woeisyou,stormrage,768,hunter,marksmanship,24,8,16
Civvo,dalaran,768,hunter,marksmanship,24,8,16
Vileplumè,stormrage,767,hunter,marksmanship,18,8,10
Inability,emerald-dream,767,hunter,marksmanship,18,8,10
Xtina,drakkari,767,hunter,marksmanship,18,8,10
Varrinda,wyrmrest-accord,767,hunter,marksmanship,18,8,10
Ravanskull,burning-blade,767,hunter,marksmanship,18,8,10
Ärtémisa,quelthalas,766,hunter,marksmanship,12,8,4
Saltz,tichondrius,766,hunter,marksmanship,12,8,4
Juicyjams,moon-guard,766,hunter,marksmanship,12,8,4
Fëanora,quelthalas,766,hunter,marksmanship,18,8,10
Ladright,altar-of-storms,766,hunter,marksmanship,18,8,10
Deadalot,dalaran,765,hunter,marksmanship,12,8,4
Snìpershot,sargeras,765,hunter,marksmanship,19,10,9
Silhouettes,barthilas,765,hunter,marksmanship,21,10,11
Myciri,proudmoore,764,hunter,marksmanship,18,8,10
Thisguÿ,arthas,762,hunter,marksmanship,18,8,10
Enonoa,thunderlord,760,hunter,marksmanship,12,8,4
Huntercry,ragnaros,751,hunter,marksmanship,12,8,4
Niceshotboi,azgalor,751,hunter,marksmanship,24,8,16
Lynnì,khadgar,750,hunter,marksmanship,18,8,10
Xshadowdemon,korgath,749,hunter,marksmanship,12,8,4
Koonorc,dalaran,749,hunter,marksmanship,22,8,14
Andalora,malganis,703,hunter,marksmanship,11,8,3
Reanivan,kiljaeden,686,hunter,marksmanship,36,9,27
Kaznik,ragnaros,672,hunter,marksmanship,12,7,5
Enty,khazgoroth,672,hunter,marksmanship,12,7,5
Imperatrix,emerald-dream,672,hunter,marksmanship,12,7,5
Timmee,bleeding-hollow,672,hunter,marksmanship,12,7,5
Yory,tol-barad,672,hunter,marksmanship,12,7,5
Landon,lightnings-blade,672,hunter,marksmanship,12,7,5
Ehnub,stormrage,672,hunter,marksmanship,12,7,5
Lely,tichondrius,672,hunter,marksmanship,12,7,5
Bertimus,sargeras,672,hunter,marksmanship,12,7,5
Papacohen,stormrage,672,hunter,marksmanship,12,7,5
Shotmaster,tichondrius,672,hunter,marksmanship,12,7,5
Malkuri,medivh,672,hunter,marksmanship,12,7,5
Mochaxd,stormrage,672,hunter,marksmanship,14,7,7
Gor,hyjal,672,hunter,marksmanship,18,7,11
Focusfire,khazgoroth,672,hunter,marksmanship,18,7,11
Sunyourmom,proudmoore,671,hunter,marksmanship,12,7,5
Dest,azralon,671,hunter,marksmanship,12,7,5
Zhions,ragnaros,671,hunter,marksmanship,12,7,5
Twistedtawl,area-52,671,hunter,marksmanship,12,7,5
Neoxbow,wyrmrest-accord,671,hunter,marksmanship,12,7,5
Táká,quelthalas,671,hunter,marksmanship,12,7,5
Sáns,sargeras,671,hunter,marksmanship,12,7,5
Getnukedbud,emerald-dream,671,hunter,marksmanship,12,7,5
Larree,kelthuzad,671,hunter,marksmanship,12,7,5
Geraldson,proudmoore,671,hunter,marksmanship,12,7,5
Xhare,stormrage,671,hunter,marksmanship,12,7,5
Toesgoes,thrall,671,hunter,marksmanship,18,7,11
Glittergun,sargeras,671,hunter,marksmanship,18,7,11
Scourgesurge,kiljaeden,671,hunter,marksmanship,18,7,11
Navagee,tichondrius,671,hunter,marksmanship,18,7,11
Kaeuljua,tichondrius,671,hunter,marksmanship,18,7,11
Kalizra,quelthalas,671,hunter,marksmanship,18,7,11
Chuvug,quelthalas,671,hunter,marksmanship,18,7,11
Såvagehunter,malganis,671,hunter,marksmanship,18,7,11
Ssdslol,bleeding-hollow,670,hunter,marksmanship,12,7,5
Milktoker,tichondrius,670,hunter,marksmanship,18,7,11
Gagau,stormrage,670,hunter,marksmanship,18,7,11
Wolfyyxx,stormrage,670,hunter,marksmanship,18,7,11
Lilzoomer,barthilas,668,hunter,marksmanship,12,7,5
Kødran,stormrage,666,hunter,marksmanship,12,7,5
Mahty,stormrage,665,hunter,marksmanship,12,7,5
Mackin,maelstrom,661,hunter,marksmanship,18,7,11
Rödrigö,azralon,657,hunter,marksmanship,12,7,5
Konar,nemesis,656,hunter,marksmanship,30,7,23
Righthole,area-52,640,hunter,marksmanship,22,7,15
Mawlotov,barthilas,639,hunter,marksmanship,23,7,16
Huntkiller,tichondrius,638,hunter,marksmanship,14,8,6
Swolfp,tichondrius,623,hunter,marksmanship,16,8,8
Typh,saurfang,607,hunter,marksmanship,11,7,4
Rawrzy,sargeras,607,hunter,marksmanship,17,7,10
Hokutoxx,tichondrius,607,hunter,marksmanship,20,7,13
Krossx,thrall,591,hunter,marksmanship,11,7,4
Summerrain,illidan,576,hunter,marksmanship,6,6,0
Lostfaith,tichondrius,576,hunter,marksmanship,12,6,6
Ssds,sargeras,576,hunter,marksmanship,12,6,6
Laurenx,illidan,576,hunter,marksmanship,12,6,6
Aoti,nerzhul,576,hunter,marksmanship,12,6,6
Bootywhop,dalaran,576,hunter,marksmanship,12,6,6
Gq,garona,576,hunter,marksmanship,12,6,6
Telånnas,illidan,576,hunter,marksmanship,12,6,6
Rendel,drakkari,576,hunter,marksmanship,12,6,6
Zèd,azralon,576,hunter,marksmanship,12,6,6
Temara,icecrown,576,hunter,marksmanship,12,6,6
Spanerd,moon-guard,576,hunter,marksmanship,12,6,6
Oattes,daggerspine,576,hunter,marksmanship,12,6,6
Flämma,azralon,576,hunter,marksmanship,12,6,6
Tokez,moon-guard,576,hunter,marksmanship,12,6,6
Gritzix,frostmourne,576,hunter,marksmanship,12,6,6
Blaðe,kelthuzad,576,hunter,marksmanship,12,6,6
Gugubird,proudmoore,576,hunter,marksmanship,12,6,6
Kyudo,moon-guard,576,hunter,marksmanship,12,6,6
Throre,bleeding-hollow,576,hunter,marksmanship,12,6,6
Êlautismo,wyrmrest-accord,576,hunter,marksmanship,12,6,6
Grimcask,ragnaros,576,hunter,marksmanship,12,6,6
Groomme,area-52,576,hunter,marksmanship,12,6,6
Murderone,undermine,576,hunter,marksmanship,12,6,6
Gnometoprace,illidan,576,hunter,marksmanship,18,6,12
Amyrkvothe,ragnaros,576,hunter,marksmanship,18,6,12
Crazyeasy,azshara,576,hunter,marksmanship,18,6,12
Odin,goldrinn,576,hunter,marksmanship,24,6,18
Loyalrely,tichondrius,575,hunter,marksmanship,12,6,6
Onlyfeìgns,frostmourne,575,hunter,marksmanship,12,6,6
Snewboy,malganis,575,hunter,marksmanship,12,6,6
Hobbës,kelthuzad,575,hunter,marksmanship,12,6,6
Littlespike,queldorei,575,hunter,marksmanship,12,6,6
Projectilez,sargeras,575,hunter,marksmanship,12,6,6
Aragörnn,azralon,575,hunter,marksmanship,12,6,6
Taynen,azralon,575,hunter,marksmanship,12,6,6
Smoeky,aerie-peak,575,hunter,marksmanship,12,6,6
Cobrag,tichondrius,575,hunter,marksmanship,12,6,6
Katebishop,nemesis,575,hunter,marksmanship,12,6,6
Shadowhokage,zuljin,575,hunter,marksmanship,18,6,12
Salsa,hakkar,575,hunter,marksmanship,24,6,18
Marcusrarnis,zuljin,574,hunter,marksmanship,12,6,6
Hildihunt,stormrage,574,hunter,marksmanship,12,6,6
Zeddunn,stormrage,574,hunter,marksmanship,12,6,6
Killincrew,scilla,574,hunter,marksmanship,14,6,8
Flacidhunter,kelthuzad,573,hunter,marksmanship,18,6,12
Recebaa,barthilas,572,hunter,marksmanship,12,6,6
Ratspit,chogall,557,hunter,marksmanship,11,6,5
Gymli,destromath,543,hunter,marksmanship,11,6,5
Jvmr,azralon,534,hunter,marksmanship,14,7,7
Smokabombom,eredar,522,hunter,marksmanship,16,7,9
Remixjy,burning-blade,522,hunter,marksmanship,16,7,9
Cplski,kelthuzad,511,hunter,marksmanship,16,6,10
Stepbroski,moon-guard,510,hunter,marksmanship,14,6,8
Fian,lightnings-blade,510,hunter,marksmanship,16,6,10
Redzic,tichondrius,480,hunter,marksmanship,6,5,1
Cimotsw,stormrage,480,hunter,marksmanship,6,5,1
Chasseür,quelthalas,480,hunter,marksmanship,6,5,1
Austelos,moon-guard,480,hunter,marksmanship,6,5,1
Headshoot,tichondrius,480,hunter,marksmanship,6,5,1
Bendotexe,stormrage,480,hunter,marksmanship,6,5,1
Shootandloot,zuljin,480,hunter,marksmanship,6,5,1
Kensho,illidan,480,hunter,marksmanship,6,5,1
Chickenzzack,tichondrius,480,hunter,marksmanship,6,5,1
Zucarita,tichondrius,480,hunter,marksmanship,7,5,2
Ladderpolice,tichondrius,480,hunter,marksmanship,9,6,3
Idtrapthat,nordrassil,480,hunter,marksmanship,9,5,4
Snoplow,illidan,480,hunter,marksmanship,12,5,7
Duckpow,frostmourne,480,hunter,marksmanship,12,5,7
Tandope,sargeras,480,hunter,marksmanship,12,5,7
Xísa,proudmoore,480,hunter,marksmanship,12,5,7
Hunt,the-underbog,480,hunter,marksmanship,12,5,7
Raiku,aggramar,480,hunter,marksmanship,12,5,7
Kyujin,ragnaros,480,hunter,marksmanship,12,5,7
Damadar,tichondrius,480,hunter,marksmanship,12,5,7
Elendïr,tichondrius,480,hunter,marksmanship,12,5,7
Eratichunt,illidan,480,hunter,marksmanship,12,5,7
Bullzeyê,kelthuzad,480,hunter,marksmanship,12,5,7
Teaks,aggramar,480,hunter,marksmanship,12,5,7
Connora,stormrage,480,hunter,marksmanship,12,5,7
Jaywuz,tichondrius,480,hunter,marksmanship,12,5,7
Rïve,tichondrius,480,hunter,marksmanship,12,5,7
Lianm,stormrage,480,hunter,marksmanship,12,5,7
Absinther,emerald-dream,480,hunter,marksmanship,18,5,13
Insgesicht,proudmoore,480,hunter,marksmanship,18,5,13
Nubcaks,nerzhul,480,hunter,marksmanship,18,5,13
Datbigbowdoe,illidan,480,hunter,marksmanship,18,5,13
Ikiteforfood,zuljin,480,hunter,marksmanship,18,5,13
Eurekasl,ragnaros,480,hunter,marksmanship,18,5,13
Tarah,lightbringer,480,hunter,marksmanship,18,5,13
Blaws,tichondrius,480,hunter,marksmanship,18,5,13
Daahm,malganis,480,hunter,marksmanship,19,5,14
Emeri,winterhoof,479,hunter,marksmanship,6,5,1
Clemenlemon,illidan,479,hunter,marksmanship,6,5,1
Runimurder,zuljin,479,hunter,marksmanship,6,5,1
Hishamo,aggramar,479,hunter,marksmanship,6,5,1
Blurrí,area-52,479,hunter,marksmanship,12,5,7
Globalhunter,emerald-dream,479,hunter,marksmanship,12,5,7
Týrak,illidan,479,hunter,marksmanship,12,5,7
Rykbad,area-52,479,hunter,marksmanship,12,5,7
Ohhsnaapp,blood-furnace,479,hunter,marksmanship,12,5,7
Patmypet,terenas,479,hunter,marksmanship,12,5,7
Seyd,barthilas,479,hunter,marksmanship,18,5,13
Ashaelyn,wyrmrest-accord,479,hunter,marksmanship,18,5,13
Enzym,archimonde,479,hunter,marksmanship,18,5,13
Cócaine,tichondrius,478,hunter,marksmanship,13,6,7
Avindal,greymane,478,hunter,marksmanship,12,5,7
Ozzoty,tol-barad,478,hunter,marksmanship,12,5,7
Tungles,tichondrius,478,hunter,marksmanship,18,5,13
Tularac,sentinels,477,hunter,marksmanship,12,5,7
Desolateone,nazgrel,474,hunter,marksmanship,12,5,7
Diavál,area-52,447,hunter,marksmanship,11,5,6
Mukeru,stormrage,432,hunter,marksmanship,9,5,4
Jaydemo,thunderhorn,431,hunter,marksmanship,11,5,6
Hukkx,kalecgos,415,hunter,marksmanship,8,5,3
Infatuatedx,moon-guard,384,hunter,marksmanship,6,4,2
Blamethenaga,sargeras,384,hunter,marksmanship,6,4,2
Thirià,garona,384,hunter,marksmanship,6,4,2
Huumpoutine,burning-blade,384,hunter,marksmanship,6,4,2
Anecko,zuljin,384,hunter,marksmanship,6,4,2
Ashx,nemesis,384,hunter,marksmanship,6,4,2
Subdue,tichondrius,384,hunter,marksmanship,6,4,2
Wellerman,firetree,384,hunter,marksmanship,6,4,2
Sugarboyy,darkspear,384,hunter,marksmanship,6,4,2
Photos,moon-guard,384,hunter,marksmanship,6,4,2
Relapse,dreadmaul,384,hunter,marksmanship,6,4,2
Silvertokay,ragnaros,384,hunter,marksmanship,6,4,2
Maidán,azralon,384,hunter,marksmanship,6,4,2
Ocromiun,illidan,384,hunter,marksmanship,6,4,2
Swoljashotxp,area-52,384,hunter,marksmanship,6,4,2
Raevon,kelthuzad,384,hunter,marksmanship,6,4,2
Coolwhip,demon-soul,384,hunter,marksmanship,6,4,2
Tánsøxøxø,tichondrius,384,hunter,marksmanship,6,4,2
Peitowyn,illidan,384,hunter,marksmanship,6,4,2
Malcab,tichondrius,384,hunter,marksmanship,6,4,2
Tup,guldan,384,hunter,marksmanship,6,4,2
Zeenuts,sargeras,384,hunter,marksmanship,6,4,2
Emilysamuels,tichondrius,384,hunter,marksmanship,6,4,2
Aimbôt,frostmourne,384,hunter,marksmanship,6,4,2
Balaria,tichondrius,384,hunter,marksmanship,6,4,2
Dathunterr,azralon,384,hunter,marksmanship,6,4,2
Zendarae,tichondrius,384,hunter,marksmanship,6,4,2
Pulso,illidan,384,hunter,marksmanship,6,4,2
Llhopital,ragnaros,384,hunter,marksmanship,6,4,2
Swish,burning-legion,384,hunter,marksmanship,6,4,2
Huataran,stormrage,384,hunter,marksmanship,6,4,2
Explosief,area-52,384,hunter,marksmanship,6,4,2
Côckblocked,tichondrius,384,hunter,marksmanship,6,4,2
Oromís,dalaran,384,hunter,marksmanship,6,4,2
Lagginwaggin,azgalor,384,hunter,marksmanship,6,4,2
Mehontar,area-52,384,hunter,marksmanship,6,4,2
Vatits,dalaran,384,hunter,marksmanship,6,4,2
Junmuxiao,ragnaros,384,hunter,marksmanship,6,4,2
Amanazàra,tichondrius,384,hunter,marksmanship,6,4,2
Sabo,nemesis,384,hunter,marksmanship,12,4,8
Revö,area-52,384,hunter,marksmanship,12,4,8
Ðïanä,azralon,384,hunter,marksmanship,12,4,8
Crimsonmm,ragnaros,384,hunter,marksmanship,12,4,8
Emérr,drakkari,384,hunter,marksmanship,12,4,8
Aewyn,malganis,384,hunter,marksmanship,12,4,8
Kä,blackhand,384,hunter,marksmanship,12,4,8
Ownyoufast,darkspear,384,hunter,marksmanship,12,4,8
Shottz,blackhand,384,hunter,marksmanship,12,4,8
Audioannie,thrall,384,hunter,marksmanship,12,4,8
Vélos,illidan,384,hunter,marksmanship,12,4,8
Saralli,thrall,384,hunter,marksmanship,12,4,8
Patroclo,azralon,384,hunter,marksmanship,12,4,8
Braindeadorc,illidan,384,hunter,marksmanship,12,4,8
Grukar,tichondrius,384,hunter,marksmanship,12,4,8
Dropflag,stormrage,384,hunter,marksmanship,12,4,8
Inktray,durotan,384,hunter,marksmanship,12,4,8
Nosmoke,kargath,384,hunter,marksmanship,12,4,8
Enchantras,jaedenar,384,hunter,marksmanship,12,4,8
Ojmo,arthas,384,hunter,marksmanship,12,4,8
Noriee,destromath,384,hunter,marksmanship,12,4,8
Shotfromhell,sargeras,384,hunter,marksmanship,12,4,8
Bleedwolf,tichondrius,384,hunter,marksmanship,12,4,8
Sylvanâs,bleeding-hollow,384,hunter,marksmanship,12,4,8
Astolenis,quelthalas,384,hunter,marksmanship,16,4,12
Picaubica,kiljaeden,384,hunter,marksmanship,18,4,14
Peashooter,sargeras,384,hunter,marksmanship,19,4,15
Dnicee,stormrage,383,hunter,marksmanship,6,4,2
Arzant,quelthalas,383,hunter,marksmanship,6,4,2
Snäpträp,stormrage,383,hunter,marksmanship,6,4,2
Essya,frostmourne,383,hunter,marksmanship,6,4,2
Soulbutter,malganis,383,hunter,marksmanship,6,4,2
Vendortrash,aggramar,383,hunter,marksmanship,6,4,2
Lazygnome,azshara,383,hunter,marksmanship,8,4,4
Shootingjaem,tichondrius,383,hunter,marksmanship,12,4,8
Aridan,area-52,383,hunter,marksmanship,12,4,8
Bemaa,frostmourne,383,hunter,marksmanship,12,4,8
Zarely,frostmourne,383,hunter,marksmanship,12,4,8
Minibrö,tichondrius,383,hunter,marksmanship,12,4,8
Juanita,laughing-skull,383,hunter,marksmanship,12,4,8
Brody,eitrigg,383,hunter,marksmanship,12,4,8
Nevon,azralon,383,hunter,marksmanship,18,4,14
Oohuntsoo,emerald-dream,382,hunter,marksmanship,6,4,2
Eaudelune,vashj,382,hunter,marksmanship,12,4,8
Lennfear,frostmourne,382,hunter,marksmanship,12,4,8
Beastmodeqt,blood-furnace,381,hunter,marksmanship,12,4,8
Twofeathers,wyrmrest-accord,381,hunter,marksmanship,12,4,8
Aksalaz,area-52,367,hunter,marksmanship,11,4,7
Iamtotoro,area-52,351,hunter,marksmanship,16,4,12
Llachiip,zuljin,336,hunter,marksmanship,9,4,5
Cns,tichondrius,330,hunter,marksmanship,14,5,9
Iililillilii,tichondrius,330,hunter,marksmanship,14,5,9
Stupïd,tichondrius,319,hunter,marksmanship,5,4,1
Kazug,destromath,319,hunter,marksmanship,12,5,7
Dagre,the-forgotten-coast,304,hunter,marksmanship,13,4,9
Trænquility,tichondrius,288,hunter,marksmanship,6,3,3
Muffhuntér,blackrock,288,hunter,marksmanship,6,3,3
Gorhound,tichondrius,288,hunter,marksmanship,6,3,3
Stupedhunter,tichondrius,288,hunter,marksmanship,6,3,3
Silenciozzo,azralon,288,hunter,marksmanship,6,3,3
Surprisemfkr,emerald-dream,288,hunter,marksmanship,6,3,3
Silvershot,emerald-dream,288,hunter,marksmanship,6,3,3
Weegnomie,wyrmrest-accord,288,hunter,marksmanship,6,3,3
Auset,aegwynn,288,hunter,marksmanship,6,3,3
Racoon,spinebreaker,288,hunter,marksmanship,6,3,3
Vinksy,sargeras,288,hunter,marksmanship,6,3,3
Lilbic,bleeding-hollow,288,hunter,marksmanship,6,3,3
Westbrooke,illidan,288,hunter,marksmanship,6,3,3
Azairxd,tichondrius,288,hunter,marksmanship,6,3,3
Ropivacaine,illidan,288,hunter,marksmanship,6,3,3
Starsabov,emerald-dream,288,hunter,marksmanship,6,3,3
Wolfmilkers,illidan,288,hunter,marksmanship,6,3,3
Casadora,dark-iron,288,hunter,marksmanship,6,3,3
Silentzkill,tichondrius,288,hunter,marksmanship,6,3,3
Playnogames,moon-guard,288,hunter,marksmanship,6,3,3
Boomphaque,ravencrest,288,hunter,marksmanship,6,3,3
Cloakedninja,illidan,288,hunter,marksmanship,6,3,3
Kong,tichondrius,288,hunter,marksmanship,6,3,3
Buzzkiller,sargeras,288,hunter,marksmanship,6,3,3
Innerhunt,aegwynn,288,hunter,marksmanship,6,3,3
Eforas,ragnaros,288,hunter,marksmanship,6,3,3
Torrthack,area-52,288,hunter,marksmanship,6,3,3
Juwannaaim,lethon,288,hunter,marksmanship,6,3,3
Déadshot,thaurissan,288,hunter,marksmanship,6,3,3
Sereom,frostmourne,288,hunter,marksmanship,6,3,3
Thugbeast,tichondrius,288,hunter,marksmanship,6,3,3
Sosaho,sargeras,288,hunter,marksmanship,6,3,3
Daggétt,zuljin,288,hunter,marksmanship,6,3,3
Khasu,ragnaros,288,hunter,marksmanship,6,3,3
Kimbaa,tichondrius,288,hunter,marksmanship,6,3,3
Zym,the-forgotten-coast,288,hunter,marksmanship,6,3,3
Xtremesnipez,frostmourne,288,hunter,marksmanship,6,3,3
Bwaa,illidan,288,hunter,marksmanship,6,3,3
Kansolly,tichondrius,288,hunter,marksmanship,6,3,3
Samsin,sargeras,288,hunter,marksmanship,6,3,3
Candîce,moon-guard,288,hunter,marksmanship,6,3,3
Carot,dalaran,288,hunter,marksmanship,6,3,3
Shooterzz,illidan,288,hunter,marksmanship,6,3,3
Halosucks,sargeras,288,hunter,marksmanship,6,3,3
Tugh,maiev,288,hunter,marksmanship,6,3,3
Keliara,dunemaul,288,hunter,marksmanship,6,3,3
Untermench,tichondrius,288,hunter,marksmanship,6,3,3
Vivaswan,tichondrius,288,hunter,marksmanship,6,3,3
Jônathan,tichondrius,288,hunter,marksmanship,6,3,3
Cù,frostmourne,288,hunter,marksmanship,6,3,3
Bowtech,kelthuzad,288,hunter,marksmanship,6,3,3
Xcw,stormrage,288,hunter,marksmanship,6,3,3
Zengrin,quelthalas,288,hunter,marksmanship,6,3,3
Blickys,area-52,288,hunter,marksmanship,6,3,3
Humiliation,mugthol,288,hunter,marksmanship,6,3,3
Waqz,tichondrius,288,hunter,marksmanship,6,3,3
Fruitenveg,frostmourne,288,hunter,marksmanship,6,3,3
Triggamikê,tichondrius,288,hunter,marksmanship,6,3,3
Wannakill,stormrage,288,hunter,marksmanship,6,3,3
Vashra,stormrage,288,hunter,marksmanship,6,3,3
Ekzoo,tichondrius,288,hunter,marksmanship,6,3,3
Calî,stormscale,288,hunter,marksmanship,6,3,3
Zindula,malganis,288,hunter,marksmanship,7,3,4
Prpl,sargeras,288,hunter,marksmanship,15,4,11
Kòng,quelthalas,288,hunter,marksmanship,12,3,9
Zeedii,dalaran,288,hunter,marksmanship,12,3,9
Fatehunter,bleeding-hollow,288,hunter,marksmanship,12,3,9
Ryutiz,fizzcrank,288,hunter,marksmanship,12,3,9
Hatara,quelthalas,288,hunter,marksmanship,12,3,9
Princssdaizy,zuljin,288,hunter,marksmanship,12,3,9
Angelickon,tichondrius,288,hunter,marksmanship,12,3,9
Sliperysaly,tichondrius,288,hunter,marksmanship,12,3,9
Wadadly,malganis,288,hunter,marksmanship,12,3,9
Peña,trollbane,288,hunter,marksmanship,12,3,9
Alyzza,sargeras,288,hunter,marksmanship,12,3,9
Lukhas,moon-guard,288,hunter,marksmanship,12,3,9
Johar,nerzhul,288,hunter,marksmanship,12,3,9
Arbclimbs,frostmane,288,hunter,marksmanship,12,3,9
Oua,queldorei,288,hunter,marksmanship,12,3,9
Lumbygoblin,illidan,288,hunter,marksmanship,13,3,10
Lookøut,moon-guard,288,hunter,marksmanship,15,3,12
Repotro,drakkari,288,hunter,marksmanship,18,3,15
Lapelada,ragnaros,287,hunter,marksmanship,6,3,3
Multicereal,quelthalas,287,hunter,marksmanship,6,3,3
Malo,dragonmaw,287,hunter,marksmanship,6,3,3
Survival,dentarg,287,hunter,marksmanship,6,3,3
Ghazzghkuull,ragnaros,287,hunter,marksmanship,6,3,3
Piloks,gallywix,287,hunter,marksmanship,6,3,3
Bumbow,tichondrius,287,hunter,marksmanship,12,3,9
Zievieda,hellscream,286,hunter,marksmanship,6,3,3
Lorelåii,tichondrius,286,hunter,marksmanship,6,3,3
Irishnia,bleeding-hollow,286,hunter,marksmanship,6,3,3
Mikeangel,hydraxis,240,hunter,marksmanship,9,3,6
Setepalms,azralon,239,hunter,marksmanship,5,3,2
Brorc,kul-tiras,239,hunter,marksmanship,5,3,2
Knowtraps,area-52,234,hunter,marksmanship,7,4,3
Druskritag,moon-guard,234,hunter,marksmanship,10,4,6
Andrømeda,frostmourne,208,hunter,marksmanship,7,3,4
Lamb,undermine,202,hunter,marksmanship,11,4,7
Abloodelf,zuljin,192,hunter,marksmanship,6,2,4
Yembohi,queldorei,192,hunter,marksmanship,6,2,4
Dracõ,proudmoore,192,hunter,marksmanship,6,2,4
Thewïld,tichondrius,192,hunter,marksmanship,6,2,4
Buckethole,doomhammer,192,hunter,marksmanship,6,2,4
Drysst,tichondrius,192,hunter,marksmanship,6,2,4
Boomheadshot,blood-furnace,192,hunter,marksmanship,6,2,4
Fleshfeast,tichondrius,192,hunter,marksmanship,6,2,4
Thejessiah,tichondrius,192,hunter,marksmanship,6,2,4
Voodoohunter,blood-furnace,192,hunter,marksmanship,6,2,4
Blury,tichondrius,192,hunter,marksmanship,6,2,4
Latherel,bleeding-hollow,192,hunter,marksmanship,6,2,4
Dreezzy,bleeding-hollow,192,hunter,marksmanship,6,2,4
Dikbender,tichondrius,192,hunter,marksmanship,6,2,4
Vitae,shattered-halls,192,hunter,marksmanship,6,2,4
Nes,azuremyst,192,hunter,marksmanship,6,2,4
Petmydog,aegwynn,192,hunter,marksmanship,6,2,4
Jeezyxxii,shadowmoon,192,hunter,marksmanship,6,2,4
Tus,tichondrius,192,hunter,marksmanship,6,2,4
Kanta,bleeding-hollow,192,hunter,marksmanship,6,2,4
Bendoon,sargeras,192,hunter,marksmanship,6,2,4
Gangstashot,burning-legion,192,hunter,marksmanship,6,2,4
Huntgar,earthen-ring,192,hunter,marksmanship,6,2,4
Ilîiìîìiilil,bleeding-hollow,192,hunter,marksmanship,6,2,4
Bloodrainia,ravencrest,192,hunter,marksmanship,6,2,4
Namøscä,nemesis,192,hunter,marksmanship,6,2,4
Kahtniss,quelthalas,192,hunter,marksmanship,6,2,4
Córnell,tichondrius,192,hunter,marksmanship,6,2,4
Kïwwï,tichondrius,192,hunter,marksmanship,6,2,4
Bôdon,illidan,192,hunter,marksmanship,6,2,4
Ðevil,ragnaros,192,hunter,marksmanship,6,2,4
Inurah,malganis,192,hunter,marksmanship,6,2,4
Sinsix,akama,192,hunter,marksmanship,6,2,4
Desdee,icecrown,192,hunter,marksmanship,6,2,4
Exiun,sargeras,192,hunter,marksmanship,6,2,4
Pumpydumpy,malganis,192,hunter,marksmanship,6,2,4
Kookh,area-52,192,hunter,marksmanship,6,2,4
Rottinghood,hyjal,192,hunter,marksmanship,6,2,4
Symz,ragnaros,192,hunter,marksmanship,6,2,4
Bionix,sargeras,192,hunter,marksmanship,6,2,4
Gadorim,kelthuzad,192,hunter,marksmanship,6,2,4
Littleagu,proudmoore,192,hunter,marksmanship,6,2,4
Sogeki,kelthuzad,192,hunter,marksmanship,6,2,4
Taurenseason,sargeras,192,hunter,marksmanship,6,2,4
Yortrox,ragnaros,192,hunter,marksmanship,6,2,4
Xxunderoath,frostwolf,192,hunter,marksmanship,6,2,4
Mùneyshot,nagrand,192,hunter,marksmanship,6,2,4
Erebor,malganis,192,hunter,marksmanship,6,2,4
Crownchild,illidan,192,hunter,marksmanship,6,2,4
Leeshaarrow,moon-guard,192,hunter,marksmanship,6,2,4
Huntugz,frostmourne,192,hunter,marksmanship,6,2,4
Lolknocked,alexstrasza,192,hunter,marksmanship,6,2,4
Muscletooth,moon-guard,192,hunter,marksmanship,6,2,4
Geeshot,area-52,192,hunter,marksmanship,6,2,4
Wartoz,dragonblight,192,hunter,marksmanship,6,2,4
Cuchulláin,area-52,192,hunter,marksmanship,6,2,4
Momomomo,draka,192,hunter,marksmanship,6,2,4
Rëxx,moon-guard,192,hunter,marksmanship,6,2,4
Kimghak,tichondrius,192,hunter,marksmanship,6,2,4
Cazaaires,quelthalas,192,hunter,marksmanship,6,2,4
Penelòpe,wyrmrest-accord,192,hunter,marksmanship,6,2,4
Stingyshot,thrall,192,hunter,marksmanship,6,2,4
Yonzo,area-52,192,hunter,marksmanship,6,2,4
Sobala,azralon,192,hunter,marksmanship,6,2,4
Ëzy,frostmourne,192,hunter,marksmanship,6,2,4
Xpyroshot,area-52,192,hunter,marksmanship,6,2,4
Mesiauzx,stormrage,192,hunter,marksmanship,6,2,4
Áppóló,spinebreaker,192,hunter,marksmanship,6,2,4
Firskin,frostmourne,192,hunter,marksmanship,6,2,4
Diur,ragnaros,192,hunter,marksmanship,9,2,7
Sharpzy,jubeithos,192,hunter,marksmanship,12,2,10
Stïinck,azralon,192,hunter,marksmanship,12,2,10
Àlëxx,aegwynn,192,hunter,marksmanship,12,2,10
Warpedshots,malganis,192,hunter,marksmanship,12,2,10
Shafttrapper,queldorei,192,hunter,marksmanship,12,2,10
Eaglesx,skullcrusher,192,hunter,marksmanship,12,2,10
Xulag,tichondrius,192,hunter,marksmanship,12,2,10
Demolitions,kelthuzad,192,hunter,marksmanship,12,2,10
Warrioress,illidan,192,hunter,marksmanship,12,2,10
Findbind,altar-of-storms,192,hunter,marksmanship,12,2,10
Maximos,lightnings-blade,192,hunter,marksmanship,12,2,10
Seekem,destromath,192,hunter,marksmanship,12,2,10
Larts,fenris,192,hunter,marksmanship,12,2,10
Birgite,stormrage,192,hunter,marksmanship,12,2,10
Chetta,ragnaros,192,hunter,marksmanship,18,2,16
Zelanst,illidan,191,hunter,marksmanship,6,2,4
Damnnicebutt,borean-tundra,191,hunter,marksmanship,6,2,4
Sylviannas,frostmourne,191,hunter,marksmanship,6,2,4
Jonsnow,lightnings-blade,191,hunter,marksmanship,6,2,4
Fizzleshot,malganis,191,hunter,marksmanship,6,2,4
ßonßon,stormrage,160,hunter,marksmanship,10,2,8
Thesloott,azshara,159,hunter,marksmanship,5,2,3
Clintbartun,shadowsong,159,hunter,marksmanship,5,2,3
Ryonel,moon-guard,159,hunter,marksmanship,5,2,3
Hunntard,veknilash,159,hunter,marksmanship,5,2,3
Overgnome,ragnaros,144,hunter,marksmanship,6,3,3
Dusle,azralon,138,hunter,marksmanship,8,3,5
Darthski,drenden,138,hunter,marksmanship,12,4,8
Drjingajanga,zuluhed,138,hunter,marksmanship,16,4,12
Plsnobanmee,frostmourne,137,hunter,marksmanship,9,5,4
Demongirl,arathor,137,hunter,marksmanship,13,3,10
Hyesik,tichondrius,128,hunter,marksmanship,4,2,2
Berkhof,tichondrius,127,hunter,marksmanship,8,2,6
Lúthiel,azralon,127,hunter,marksmanship,8,2,6
Póra,stormrage,110,hunter,marksmanship,7,2,5
Ïmprîsôñ,dalaran,96,hunter,marksmanship,3,2,1
Samanta,blood-furnace,96,hunter,marksmanship,6,1,5
Hunterish,area-52,96,hunter,marksmanship,6,1,5
Zral,dragonmaw,96,hunter,marksmanship,6,1,5
Zaamsa,ragnaros,96,hunter,marksmanship,6,1,5
Ogzog,tichondrius,96,hunter,marksmanship,6,1,5
Desarus,archimonde,96,hunter,marksmanship,6,1,5
Crazyshot,drakkari,96,hunter,marksmanship,6,1,5
Hâwkêyê,thrall,96,hunter,marksmanship,6,1,5
Siimmplicitz,area-52,96,hunter,marksmanship,6,1,5
Jaidev,nemesis,96,hunter,marksmanship,6,1,5
Ruhak,windrunner,96,hunter,marksmanship,6,1,5
Zipzyup,tichondrius,96,hunter,marksmanship,6,1,5
Exitwoundz,hyjal,96,hunter,marksmanship,6,1,5
Hellcry,khadgar,96,hunter,marksmanship,6,1,5
Spunky,zuluhed,96,hunter,marksmanship,6,1,5
Hawneyduo,skullcrusher,96,hunter,marksmanship,6,1,5
Rockehm,frostmourne,96,hunter,marksmanship,6,1,5
Shablagoosh,zuljin,96,hunter,marksmanship,6,1,5
Blaptz,wyrmrest-accord,96,hunter,marksmanship,6,1,5
Markymarc,tichondrius,96,hunter,marksmanship,6,1,5
Shootermgavn,frostmourne,96,hunter,marksmanship,6,1,5
Solderboi,tichondrius,96,hunter,marksmanship,6,1,5
Pâl,quelthalas,96,hunter,marksmanship,6,1,5
Puppyghoul,malganis,96,hunter,marksmanship,6,1,5
Necroshotz,kul-tiras,96,hunter,marksmanship,6,1,5
Deadlyattack,barthilas,96,hunter,marksmanship,6,1,5
Zünma,tichondrius,96,hunter,marksmanship,6,1,5
Gunwalk,azjolnerub,96,hunter,marksmanship,6,1,5
Terezhunt,tichondrius,96,hunter,marksmanship,6,1,5
Gorîlla,sargeras,96,hunter,marksmanship,6,1,5
Jumeog,stormscale,96,hunter,marksmanship,6,1,5
Kiatus,nesingwary,96,hunter,marksmanship,6,1,5
Htcrazykofwa,tichondrius,96,hunter,marksmanship,6,1,5
Zarknoth,cenarius,96,hunter,marksmanship,6,1,5
Biehuixin,tichondrius,96,hunter,marksmanship,6,1,5
Elknut,sargeras,96,hunter,marksmanship,6,1,5
Hyena,kelthuzad,96,hunter,marksmanship,6,1,5
Xalmoinmybow,illidan,96,hunter,marksmanship,12,1,11
Jacobsladder,illidan,96,hunter,marksmanship,12,1,11
Wij,turalyon,95,hunter,marksmanship,6,1,5
Strixis,blood-furnace,95,hunter,marksmanship,6,1,5
Venessie,moon-guard,95,hunter,marksmanship,6,1,5
Setbackhunt,illidan,79,hunter,marksmanship,5,1,4
Belieli,ragnaros,79,hunter,marksmanship,5,1,4
Hoboh,illidan,79,hunter,marksmanship,5,1,4
Huntsmate,tichondrius,64,hunter,marksmanship,4,1,3
Raymose,tichondrius,64,hunter,marksmanship,4,1,3
Maveraxx,executus,48,hunter,marksmanship,3,1,2
Dsizzle,tichondrius,42,hunter,marksmanship,14,2,12
Downworlder,darkspear,31,hunter,marksmanship,2,1,1
Tracershot,malganis,31,hunter,marksmanship,2,1,1
Dapoosyx,tichondrius,31,hunter,marksmanship,2,1,1
Rnger,aerie-peak,31,hunter,marksmanship,2,1,1
Suntail,dalaran,2208,hunter,survival,111,58,53
Cëb,stormrage,2170,hunter,survival,90,47,43
Hotmuscleman,tichondrius,2127,hunter,survival,74,45,29
Cadencex,stormrage,2120,hunter,survival,111,57,54
Pridefulz,stormrage,2109,hunter,survival,115,59,56
Capncams,emerald-dream,2108,hunter,survival,100,52,48
Djtraphouse,stormrage,2100,hunter,survival,120,64,56
Dijhoni,moon-guard,2071,hunter,survival,72,44,28
Kansolly,tichondrius,2040,hunter,survival,99,51,48
Hamslapper,shattered-hand,2025,hunter,survival,111,56,55
Noimnotokay,tichondrius,2015,hunter,survival,72,37,35
Legoelass,emerald-dream,2009,hunter,survival,60,39,21
Maxiam,frostmourne,1989,hunter,survival,71,37,34
Nearly,wyrmrest-accord,1987,hunter,survival,79,40,39
Koupon,tichondrius,1986,hunter,survival,84,42,42
Bicmex,sargeras,1970,hunter,survival,42,29,13
Lèkïnhø,azralon,1953,hunter,survival,72,36,36
Gabiña,tichondrius,1942,hunter,survival,59,32,27
Effyh,emerald-dream,1930,hunter,survival,99,54,45
Disciple,darkspear,1925,hunter,survival,56,30,26
Hwslol,tichondrius,1917,hunter,survival,83,46,37
Dwx,bleeding-hollow,1911,hunter,survival,66,35,31
Otii,tichondrius,1910,hunter,survival,60,29,31
Malukaca,azralon,1910,hunter,survival,95,43,52
Veyronnx,stormrage,1898,hunter,survival,78,44,34
Foxyhood,ragnaros,1893,hunter,survival,78,42,36
Buffmm,kelthuzad,1888,hunter,survival,54,29,25
Runecrossbow,barthilas,1885,hunter,survival,60,34,26
Róckzero,quelthalas,1885,hunter,survival,106,58,48
Finito,bladefist,1872,hunter,survival,87,44,43
Fizzleegear,area-52,1866,hunter,survival,82,40,42
Sikhunt,frostmourne,1858,hunter,survival,48,30,18
Ssds,sargeras,1834,hunter,survival,42,26,16
Gvoo,tichondrius,1829,hunter,survival,30,24,6
Angrybow,ragnaros,1821,hunter,survival,36,25,11
Sartel,tichondrius,1821,hunter,survival,155,80,75
Thoromel,wyrmrest-accord,1820,hunter,survival,66,33,33
Ynoit,sargeras,1818,hunter,survival,40,23,17
Kisuke,khaz-modan,1815,hunter,survival,54,34,20
Trapula,tichondrius,1814,hunter,survival,84,46,38
Queríde,emerald-dream,1811,hunter,survival,47,32,15
Kubu,emerald-dream,1810,hunter,survival,57,38,19
Wmsgs,tichondrius,1802,hunter,survival,58,29,29
Huntmon,nemesis,1800,hunter,survival,48,31,17
Jîñßæçhïñæ,sargeras,1800,hunter,survival,66,29,37
Stevemonday,stormrage,1768,hunter,survival,78,46,32
Carnidon,area-52,1765,hunter,survival,111,55,56
Woriath,quelthalas,1761,hunter,survival,96,50,46
Vlf,tichondrius,1753,hunter,survival,60,30,30
Destrumz,zuljin,1738,hunter,survival,54,25,29
Hibyexo,illidan,1732,hunter,survival,30,20,10
Drasen,deathwing,1730,hunter,survival,42,22,20
Peppancini,wyrmrest-accord,1725,hunter,survival,53,34,19
Fictìon,kelthuzad,1712,hunter,survival,35,21,14
Aurelx,tichondrius,1710,hunter,survival,24,18,6
Dyucol,tichondrius,1709,hunter,survival,48,28,20
Sylvanne,sargeras,1706,hunter,survival,30,18,12
Názzul,area-52,1705,hunter,survival,30,18,12
Concur,frostmourne,1699,hunter,survival,48,23,25
Bergy,thrall,1686,hunter,survival,30,20,10
Killshøtß,tichondrius,1673,hunter,survival,36,20,16
Gnarwallz,stormrage,1673,hunter,survival,50,26,24
Shablagoosh,zuljin,1672,hunter,survival,45,23,22
Réxon,quelthalas,1671,hunter,survival,99,48,51
Samcro,rivendare,1670,hunter,survival,59,29,30
Crypy,illidan,1664,hunter,survival,48,24,24
Kelarcia,moon-guard,1661,hunter,survival,35,19,16
Fleche,aggramar,1658,hunter,survival,30,20,10
Knewbee,emerald-dream,1658,hunter,survival,29,18,11
Ryukotsu,tichondrius,1641,hunter,survival,49,24,25
Bjornwald,thrall,1638,hunter,survival,89,47,42
Queride,area-52,1625,hunter,survival,36,17,19
Bigbillx,tichondrius,1623,hunter,survival,30,17,13
Xebbec,sargeras,1618,hunter,survival,35,22,13
Liekis,darkspear,1615,hunter,survival,48,22,26
Berenal,moon-guard,1604,hunter,survival,84,41,43
Chimeralol,area-52,1602,hunter,survival,42,27,15
Imapacifist,barthilas,1600,hunter,survival,69,37,32
Nicochan,senjin,1593,hunter,survival,60,26,34
Noxickk,sargeras,1587,hunter,survival,30,19,11
Limpingspoon,kelthuzad,1579,hunter,survival,79,46,33
Pivott,wyrmrest-accord,1579,hunter,survival,130,70,60
Anisphia,tichondrius,1579,hunter,survival,46,20,26
Swordshot,moon-guard,1574,hunter,survival,45,22,23
Drifting,bleeding-hollow,1569,hunter,survival,54,31,23
Køjo,emerald-dream,1564,hunter,survival,38,23,15
Galavant,frostmourne,1556,hunter,survival,35,18,17
Hrywnn,azralon,1551,hunter,survival,103,58,45
Jarhar,nesingwary,1550,hunter,survival,42,22,20
Shooting,sargeras,1541,hunter,survival,41,23,18
Mckennagrace,tichondrius,1535,hunter,survival,30,18,12
Garfieldbb,tichondrius,1531,hunter,survival,36,16,20
Bendotexe,stormrage,1530,hunter,survival,24,16,8
Sativ,moknathal,1524,hunter,survival,54,27,27
Meowtard,kaelthas,1520,hunter,survival,66,31,35
Bbaronsamedi,darkspear,1519,hunter,survival,30,16,14
Hildebald,moon-guard,1514,hunter,survival,42,25,17
Snowynightt,proudmoore,1510,hunter,survival,36,16,20
Kukulkan,haomarush,1494,hunter,survival,57,30,27
Fallacies,moon-guard,1491,hunter,survival,54,30,24
Uhm,laughing-skull,1490,hunter,survival,52,28,24
Rooman,ragnaros,1477,hunter,survival,48,24,24
Fkurrules,frostmourne,1472,hunter,survival,39,20,19
Altarare,ragnaros,1458,hunter,survival,117,54,63
Mayamia,ragnaros,1456,hunter,survival,42,19,23
Shtealo,ragnaros,1443,hunter,survival,60,31,29
Hunterdemond,ragnaros,1442,hunter,survival,35,20,15
Ajacs,zuljin,1439,hunter,survival,23,16,7
Titanaxis,tichondrius,1435,hunter,survival,71,31,40
Kensho,illidan,1432,hunter,survival,36,15,21
Moartraps,zuljin,1425,hunter,survival,24,15,9
Nandorius,proudmoore,1425,hunter,survival,30,15,15
Gadorim,kelthuzad,1425,hunter,survival,73,31,42
Axezul,tichondrius,1422,hunter,survival,30,15,15
Ryonel,moon-guard,1422,hunter,survival,59,29,30
Exh,tichondrius,1409,hunter,survival,30,15,15
Ivansotes,quelthalas,1409,hunter,survival,39,18,21
Weedhoof,barthilas,1406,hunter,survival,54,30,24
Luckboy,tichondrius,1401,hunter,survival,49,26,23
Cocobread,stormreaver,1395,hunter,survival,66,28,38
Killconfirm,sargeras,1389,hunter,survival,48,19,29
Arsk,ragnaros,1385,hunter,survival,33,15,18
Equilibrium,tol-barad,1367,hunter,survival,38,17,21
Exxonerous,sargeras,1358,hunter,survival,60,29,31
Volkr,bleeding-hollow,1354,hunter,survival,36,16,20
Toross,stormscale,1352,hunter,survival,55,19,36
Lamerpvp,tichondrius,1343,hunter,survival,18,14,4
Ikiteforfood,zuljin,1343,hunter,survival,24,14,10
Gloomy,dark-iron,1341,hunter,survival,18,14,4
Caiodluffy,malganis,1339,hunter,survival,24,14,10
Evilfury,tichondrius,1339,hunter,survival,56,23,33
Grizzlydeath,stormrage,1337,hunter,survival,24,15,9
Wetpeach,frostmourne,1337,hunter,survival,36,18,18
Mxabyycc,tichondrius,1334,hunter,survival,24,14,10
Bigsexi,kiljaeden,1329,hunter,survival,62,27,35
Asarden,jubeithos,1328,hunter,survival,24,14,10
Taiberianrex,khazgoroth,1317,hunter,survival,48,28,20
Dudemanyeah,black-dragonflight,1314,hunter,survival,30,14,16
Apokryph,stormrage,1307,hunter,survival,30,23,7
Gichiwalrus,emerald-dream,1303,hunter,survival,36,20,16
Dreebizz,gorefiend,1292,hunter,survival,31,14,17
Gxswow,tichondrius,1268,hunter,survival,66,30,36
Ghuntcassh,quelthalas,1262,hunter,survival,30,18,12
Zorht,ragnaros,1259,hunter,survival,56,28,28
Fìebs,queldorei,1251,hunter,survival,29,14,15
Budika,ragnaros,1247,hunter,survival,18,13,5
Fancyox,frostmourne,1247,hunter,survival,18,13,5
Hawkem,illidan,1246,hunter,survival,24,13,11
Sniffler,barthilas,1245,hunter,survival,30,13,17
Soyos,sargeras,1223,hunter,survival,36,13,23
Chiad,kargath,1213,hunter,survival,18,13,5
Audiofly,tichondrius,1213,hunter,survival,24,13,11
Navagee,tichondrius,1213,hunter,survival,24,13,11
Arkeryn,azralon,1203,hunter,survival,18,13,5
Bangerzx,stormrage,1185,hunter,survival,24,13,11
Eastera,tichondrius,1178,hunter,survival,46,21,25
Gigabigly,wyrmrest-accord,1152,hunter,survival,18,12,6
Raef,azralon,1151,hunter,survival,24,12,12
Åpe,illidan,1150,hunter,survival,18,12,6
Crimsoncoast,tichondrius,1149,hunter,survival,18,12,6
Viòlenc,tichondrius,1147,hunter,survival,24,12,12
Ronnïn,proudmoore,1144,hunter,survival,24,12,12
Xenonviper,bleeding-hollow,1141,hunter,survival,30,12,18
Henesis,sargeras,1139,hunter,survival,24,12,12
Arcos,emerald-dream,1138,hunter,survival,18,12,6
Arazian,stormrage,1068,hunter,survival,17,12,5
Laralodge,stormrage,1066,hunter,survival,33,12,21
Scythedom,tichondrius,1056,hunter,survival,18,11,7
Tumerok,barthilas,1056,hunter,survival,18,11,7
Huntardadoo,nemesis,1056,hunter,survival,18,11,7
Saltstream,tichondrius,1056,hunter,survival,24,11,13
Leonilc,tichondrius,1056,hunter,survival,30,11,19
Viólenc,tichondrius,1055,hunter,survival,18,11,7
Pathed,azralon,1055,hunter,survival,18,11,7
Plsbepatient,wyrmrest-accord,1054,hunter,survival,18,11,7
Skàdii,tichondrius,1054,hunter,survival,24,11,13
Reignwolf,nemesis,1053,hunter,survival,18,11,7
Jaw,hakkar,1053,hunter,survival,18,11,7
Gairkill,area-52,1018,hunter,survival,48,27,21
Wartoz,dragonblight,1001,hunter,survival,29,18,11
Prettysure,nesingwary,1001,hunter,survival,22,12,10
Aniraza,ragnaros,999,hunter,survival,21,11,10
Rirand,dalaran,996,hunter,survival,29,11,18
Lucarcher,stormrage,988,hunter,survival,17,11,6
Thrandrial,smolderthorn,985,hunter,survival,20,11,9
Hellrayserr,azralon,970,hunter,survival,24,11,13
Ickstab,illidan,960,hunter,survival,12,10,2
Arrów,duskwood,960,hunter,survival,18,10,8
Sobit,tichondrius,960,hunter,survival,18,10,8
Covlol,illidan,960,hunter,survival,24,10,14
Zipzyo,tichondrius,960,hunter,survival,24,10,14
Dirtysoap,sargeras,960,hunter,survival,24,10,14
Kêdokî,sargeras,959,hunter,survival,12,10,2
Plainrain,tichondrius,959,hunter,survival,18,10,8
Ifoxs,bleeding-hollow,959,hunter,survival,18,10,8
Pathofsexile,tichondrius,959,hunter,survival,24,10,14
Pedropete,barthilas,959,hunter,survival,24,10,14
Legalt,tichondrius,958,hunter,survival,18,10,8
Xitara,stormrage,956,hunter,survival,18,10,8
Syvarris,medivh,943,hunter,survival,17,10,7
Aimbotmir,zuljin,927,hunter,survival,26,11,15
Demtings,dark-iron,925,hunter,survival,32,11,21
Gruì,malganis,892,hunter,survival,20,10,10
Weedzy,tichondrius,864,hunter,survival,12,9,3
Tigglyjits,tichondrius,864,hunter,survival,12,9,3
Nussyo,tichondrius,864,hunter,survival,15,10,5
Desari,thunderhorn,864,hunter,survival,18,9,9
Noxtis,kiljaeden,864,hunter,survival,18,9,9
Bolognã,tichondrius,864,hunter,survival,18,9,9
Vhelkan,senjin,863,hunter,survival,12,9,3
Rhyzen,drenden,863,hunter,survival,12,9,3
Kurnos,hyjal,863,hunter,survival,12,9,3
Undien,area-52,863,hunter,survival,12,9,3
Wingclippin,stormrage,863,hunter,survival,15,10,5
Sarvaxagar,tichondrius,863,hunter,survival,18,9,9
Helïos,drakkari,863,hunter,survival,18,9,9
Duckpow,frostmourne,861,hunter,survival,18,9,9
Shootin,frostmourne,768,hunter,survival,12,8,4
Toozz,frostmourne,768,hunter,survival,12,8,4
Scytsbow,illidan,768,hunter,survival,12,8,4
Iizerd,illidan,768,hunter,survival,12,8,4
Fineye,illidan,768,hunter,survival,14,8,6
Blåker,bleeding-hollow,768,hunter,survival,18,8,10
Buttercocoa,kelthuzad,768,hunter,survival,18,8,10
Packlead,sargeras,767,hunter,survival,12,8,4
Ripsurvival,area-52,767,hunter,survival,12,8,4
Bicflop,azralon,767,hunter,survival,12,8,4
Giraffetrap,zuljin,767,hunter,survival,12,8,4
Trap,vashj,767,hunter,survival,12,8,4
Lavo,borean-tundra,767,hunter,survival,18,8,10
Dorkins,azralon,767,hunter,survival,18,8,10
Chokemescara,stormrage,767,hunter,survival,30,8,22
Pdg,ragnaros,766,hunter,survival,12,8,4
Haumer,wyrmrest-accord,763,hunter,survival,12,8,4
Khaoskills,thunderlord,751,hunter,survival,12,8,4
Iraxium,illidan,735,hunter,survival,14,9,5
Dirtypolee,bleeding-hollow,719,hunter,survival,17,8,9
Thrakgor,wyrmrest-accord,713,hunter,survival,23,10,13
Pfheign,area-52,672,hunter,survival,12,7,5
Twodoobies,ghostlands,672,hunter,survival,12,7,5
Porrainga,auchindoun,672,hunter,survival,12,7,5
Arraza,ragnaros,672,hunter,survival,12,7,5
Briggsx,sargeras,672,hunter,survival,12,7,5
Svhunt,frostmourne,672,hunter,survival,12,7,5
Mattyhuntz,tichondrius,672,hunter,survival,12,7,5
Oronir,frostmourne,672,hunter,survival,12,7,5
Dju,stormrage,672,hunter,survival,18,7,11
Trumpmerica,illidan,672,hunter,survival,18,7,11
Venoc,bleeding-hollow,672,hunter,survival,18,7,11
Scottmeyers,proudmoore,672,hunter,survival,18,7,11
Notnunca,tichondrius,672,hunter,survival,18,7,11
Bombbot,zuljin,672,hunter,survival,18,7,11
Acres,emerald-dream,672,hunter,survival,24,7,17
Panm,runetotem,671,hunter,survival,15,8,7
Expskippy,darkspear,665,hunter,survival,12,7,5
Vansatih,azralon,663,hunter,survival,12,7,5
Catboikilla,ravencrest,639,hunter,survival,17,7,10
Vanthel,ragnaros,638,hunter,survival,18,8,10
Xtina,drakkari,638,hunter,survival,17,7,10
Rotthem,ragnaros,638,hunter,survival,20,8,12
Dversive,nagrand,624,hunter,survival,15,7,8
Odynshowl,stormrage,605,hunter,survival,11,7,4
Ðevil,ragnaros,576,hunter,survival,6,6,0
Vinnieone,kiljaeden,576,hunter,survival,6,6,0
Ivanjackenov,illidan,576,hunter,survival,10,7,3
Crumpit,moon-guard,576,hunter,survival,12,6,6
Hawkethorn,moon-guard,576,hunter,survival,12,6,6
Rojpube,frostmourne,576,hunter,survival,12,6,6
Kenjipoo,tichondrius,576,hunter,survival,12,6,6
Kimssis,tichondrius,576,hunter,survival,12,6,6
Haemøphilus,area-52,576,hunter,survival,12,6,6
Percival,firetree,576,hunter,survival,12,6,6
Jubulba,frostwolf,576,hunter,survival,12,6,6
Kimbaa,tichondrius,576,hunter,survival,12,6,6
Traponomics,stormrage,576,hunter,survival,12,6,6
Htniss,tichondrius,576,hunter,survival,12,6,6
Jésús,dalaran,576,hunter,survival,12,6,6
Rúdrá,area-52,576,hunter,survival,18,6,12
Emart,bloodhoof,576,hunter,survival,18,6,12
Exhausted,blackrock,576,hunter,survival,24,6,18
Týrak,illidan,575,hunter,survival,12,6,6
Allahakbar,ragnaros,575,hunter,survival,12,6,6
Xeiana,proudmoore,575,hunter,survival,12,6,6
Rayuwa,azralon,575,hunter,survival,16,7,9
Bushytails,illidan,573,hunter,survival,18,6,12
Opsi,ragnaros,559,hunter,survival,11,6,5
Trapgodxo,moon-guard,528,hunter,survival,9,7,2
Rairin,tichondrius,526,hunter,survival,17,6,11
Pxry,drenden,511,hunter,survival,11,6,5
Neverturtlex,tichondrius,480,hunter,survival,6,5,1
Gufanyaun,tichondrius,480,hunter,survival,6,5,1
Jonah,sargeras,480,hunter,survival,6,5,1
Randël,nemesis,480,hunter,survival,6,5,1
Lohse,emerald-dream,480,hunter,survival,6,5,1
Tmzsteezy,tichondrius,480,hunter,survival,6,5,1
Jäger,zuljin,480,hunter,survival,6,5,1
Narukín,tichondrius,480,hunter,survival,6,5,1
Selenis,khadgar,480,hunter,survival,6,5,1
Greyh,madoran,480,hunter,survival,6,5,1
Mambothehunt,stormrage,480,hunter,survival,12,5,7
Dephobius,azralon,480,hunter,survival,12,5,7
Minxed,sargeras,480,hunter,survival,12,5,7
Downrange,stonemaul,480,hunter,survival,12,5,7
Chicall,kalecgos,480,hunter,survival,12,5,7
Shootnoscore,vashj,480,hunter,survival,15,6,9
Orgpopeyes,illidan,480,hunter,survival,18,5,13
Belvhar,skullcrusher,479,hunter,survival,12,5,7
Nanotorque,moon-guard,479,hunter,survival,13,5,8
Lesseneth,aegwynn,479,hunter,survival,18,5,13
Dirtysoap,tichondrius,448,hunter,survival,10,5,5
Liñcoln,sargeras,416,hunter,survival,10,5,5
Joón,moon-guard,400,hunter,survival,7,5,2
Jawbreakër,tichondrius,400,hunter,survival,13,5,8
Bigpets,azralon,384,hunter,survival,6,4,2
Survïvalïst,bleeding-hollow,384,hunter,survival,6,4,2
Puffcopeak,illidan,384,hunter,survival,6,4,2
Æßç,ragnaros,384,hunter,survival,6,4,2
Nimeer,tichondrius,384,hunter,survival,6,4,2
Nastoid,area-52,384,hunter,survival,6,4,2
Alfaan,moon-guard,384,hunter,survival,6,4,2
Jagaerz,emerald-dream,384,hunter,survival,6,4,2
Ehhee,twisting-nether,384,hunter,survival,6,4,2
Petstun,moon-guard,384,hunter,survival,6,4,2
Terapista,area-52,384,hunter,survival,6,4,2
Lenacraft,frostmourne,384,hunter,survival,6,4,2
Draban,stormrage,384,hunter,survival,6,4,2
Tharoks,tichondrius,384,hunter,survival,6,4,2
Corpo,area-52,384,hunter,survival,6,4,2
Thefanbus,tichondrius,384,hunter,survival,6,4,2
Tyjes,stormrage,384,hunter,survival,6,4,2
Darkarrow,hyjal,384,hunter,survival,6,4,2
Kula,haomarush,384,hunter,survival,10,5,5
Ariran,illidan,384,hunter,survival,12,4,8
Éygon,sargeras,384,hunter,survival,12,4,8
Eforas,ragnaros,384,hunter,survival,12,4,8
Wolfsok,norgannon,384,hunter,survival,12,4,8
Oatmeallover,stormrage,384,hunter,survival,12,4,8
Skriill,tichondrius,384,hunter,survival,12,4,8
Fâpple,stormrage,384,hunter,survival,12,4,8
Gunicks,illidan,384,hunter,survival,12,4,8
Lashga,wyrmrest-accord,384,hunter,survival,12,4,8
Braindeadorc,illidan,384,hunter,survival,12,4,8
Keenz,frostmourne,384,hunter,survival,12,4,8
Downer,antonidas,384,hunter,survival,12,4,8
Camfeed,illidan,384,hunter,survival,12,4,8
Zänich,tichondrius,384,hunter,survival,12,4,8
Tydee,nagrand,383,hunter,survival,18,4,14
Nishinos,tichondrius,351,hunter,survival,11,4,7
Tyrokk,barthilas,351,hunter,survival,12,4,8
Trapmasterx,tichondrius,288,hunter,survival,6,3,3
Dirtymongrel,barthilas,288,hunter,survival,6,3,3
Ferex,tichondrius,288,hunter,survival,6,3,3
Genocell,thunderlord,288,hunter,survival,6,3,3
Thalrae,quelthalas,288,hunter,survival,6,3,3
Xfo,bleeding-hollow,288,hunter,survival,6,3,3
Slowhunterr,tichondrius,288,hunter,survival,6,3,3
Warhog,wyrmrest-accord,288,hunter,survival,6,3,3
Wooftoof,frostmourne,288,hunter,survival,6,3,3
Ünitedi,nemesis,288,hunter,survival,6,3,3
Snzzl,bleeding-hollow,288,hunter,survival,6,3,3
Violénc,tichondrius,288,hunter,survival,6,3,3
Twom,area-52,288,hunter,survival,6,3,3
Yoonsukyeol,tichondrius,288,hunter,survival,6,3,3
Furipoon,stormrage,288,hunter,survival,6,3,3
Petkd,frostmourne,288,hunter,survival,6,3,3
Pridefulzjr,stormrage,288,hunter,survival,6,3,3
Trenbolone,frostmourne,288,hunter,survival,6,3,3
Mistrj,frostmourne,288,hunter,survival,6,3,3
Magvez,tichondrius,288,hunter,survival,6,3,3
Sterge,maiev,288,hunter,survival,6,3,3
Querosushi,ragnaros,288,hunter,survival,6,3,3
Lahinch,darkspear,288,hunter,survival,6,3,3
Calidian,moon-guard,288,hunter,survival,6,3,3
Ariädne,sargeras,288,hunter,survival,6,3,3
Thesniperx,sargeras,288,hunter,survival,6,3,3
Tuohnosaj,sargeras,288,hunter,survival,6,3,3
Schurk,illidan,288,hunter,survival,6,3,3
Moistbooger,emerald-dream,288,hunter,survival,6,3,3
Whitemàne,dalaran,288,hunter,survival,6,3,3
Viró,sargeras,288,hunter,survival,6,3,3
Zà,sargeras,288,hunter,survival,6,3,3
Meowimadog,spinebreaker,288,hunter,survival,6,3,3
Leaku,illidan,288,hunter,survival,6,3,3
Anêmos,ragnaros,288,hunter,survival,6,3,3
Kyujin,ragnaros,288,hunter,survival,6,3,3
Cndavyjones,akama,288,hunter,survival,12,3,9
Iol,blades-edge,288,hunter,survival,12,3,9
Daxar,ragnaros,288,hunter,survival,12,3,9
Cakeislife,kelthuzad,288,hunter,survival,12,3,9
Endsnear,stormrage,288,hunter,survival,12,3,9
Snipin,ragnaros,288,hunter,survival,12,3,9
Henhøuse,illidan,288,hunter,survival,12,3,9
Chopsley,feathermoon,240,hunter,survival,15,3,12
Ungrella,malganis,239,hunter,survival,5,3,2
Jalinhabbei,azralon,239,hunter,survival,5,3,2
Moscato,cenarion-circle,232,hunter,survival,14,4,10
Rinehart,dalaran,223,hunter,survival,8,3,5
Trígger,azshara,192,hunter,survival,6,2,4
Nahzah,stormrage,192,hunter,survival,6,2,4
Dfnhdft,stormrage,192,hunter,survival,6,2,4
Stylebende,tichondrius,192,hunter,survival,6,2,4
Shaftgravy,area-52,192,hunter,survival,6,2,4
Sukr,korgath,192,hunter,survival,6,2,4
Comebacks,ragnaros,192,hunter,survival,6,2,4
Slipox,sargeras,192,hunter,survival,6,2,4
Buggyhuntz,stormrage,192,hunter,survival,6,2,4
Imraghorn,sargeras,192,hunter,survival,6,2,4
Cosmodome,daggerspine,192,hunter,survival,6,2,4
Mckim,tichondrius,192,hunter,survival,6,2,4
Ratonh,ragnaros,192,hunter,survival,6,2,4
Bboo,bonechewer,192,hunter,survival,6,2,4
Gaim,dalaran,192,hunter,survival,6,2,4
Turkshot,area-52,192,hunter,survival,6,2,4
Gswag,malganis,192,hunter,survival,6,2,4
Raiku,aggramar,192,hunter,survival,6,2,4
Zackèse,area-52,192,hunter,survival,6,2,4
Diddycombe,stormrage,192,hunter,survival,6,2,4
Eclipsie,aerie-peak,192,hunter,survival,6,2,4
Pedropete,frostmourne,192,hunter,survival,6,2,4
Sunchea,arygos,192,hunter,survival,6,2,4
Acidhunt,tichondrius,192,hunter,survival,6,2,4
Splewsh,area-52,192,hunter,survival,6,2,4
Stupidgodx,tichondrius,192,hunter,survival,6,2,4
Rogaldornn,thrall,192,hunter,survival,6,2,4
Nelandris,tichondrius,192,hunter,survival,6,2,4
Egurl,firetree,192,hunter,survival,6,2,4
Zèd,azralon,192,hunter,survival,6,2,4
Aiyanafox,moon-guard,192,hunter,survival,6,2,4
Côckblocked,tichondrius,192,hunter,survival,6,2,4
Darkèlfo,azralon,192,hunter,survival,6,2,4
Kaldrool,frostmourne,192,hunter,survival,12,2,10
Skrìms,tichondrius,192,hunter,survival,12,2,10
Ganemdar,sargeras,192,hunter,survival,12,2,10
Lawafla,area-52,138,hunter,survival,8,3,5
Bránn,quelthalas,128,hunter,survival,4,2,2
Arrebol,tichondrius,128,hunter,survival,4,2,2
Narakara,stormreaver,128,hunter,survival,5,2,3
Taofang,emerald-dream,96,hunter,survival,6,1,5
Silversøng,moon-guard,96,hunter,survival,6,1,5
Weegnomie,wyrmrest-accord,96,hunter,survival,6,1,5
Gutshott,tichondrius,96,hunter,survival,6,1,5
Sobala,azralon,96,hunter,survival,6,1,5
Nevertraps,tichondrius,96,hunter,survival,6,1,5
Esser,mannoroth,96,hunter,survival,6,1,5
Dusle,azralon,96,hunter,survival,6,1,5
Lammy,bleeding-hollow,96,hunter,survival,6,1,5
Jîlt,aerie-peak,96,hunter,survival,6,1,5
Legosshi,darrowmere,96,hunter,survival,6,1,5
Tejodite,thrall,96,hunter,survival,6,1,5
Survbot,malganis,96,hunter,survival,6,1,5
Drunkbunny,tichondrius,79,hunter,survival,5,1,4
Kaelles,illidan,79,hunter,survival,5,1,4
Luangg,tichondrius,31,hunter,survival,2,1,1
Therealpafo,tichondrius,31,hunter,survival,8,1,7
Sphericsnow,shuhalo,2183,hunter,beastmastery,89,47,42
Saiiph,bleeding-hollow,2165,hunter,beastmastery,124,66,58
Wmsgs,tichondrius,2049,hunter,beastmastery,88,42,46
Missedmytrap,agamaggan,2038,hunter,beastmastery,62,34,28
Manyu,tichondrius,2035,hunter,beastmastery,69,34,35
Hazzersk,ragnaros,2035,hunter,beastmastery,107,52,55
Eref,sargeras,2005,hunter,beastmastery,48,26,22
Antø,tichondrius,1998,hunter,beastmastery,81,40,41
Cannondale,tichondrius,1993,hunter,beastmastery,36,21,15
Pokìmane,tichondrius,1987,hunter,beastmastery,66,41,25
Zugbrained,illidan,1980,hunter,beastmastery,106,62,44
Fish,darkspear,1957,hunter,beastmastery,78,37,41
Arcobaleno,tichondrius,1952,hunter,beastmastery,89,44,45
Outz,anvilmar,1931,hunter,beastmastery,126,62,64
Wodhunterxdd,sargeras,1915,hunter,beastmastery,70,34,36
Axlee,tichondrius,1911,hunter,beastmastery,54,25,29
Ashenga,cairne,1910,hunter,beastmastery,108,61,47
Nollzey,frostmourne,1903,hunter,beastmastery,39,21,18
Zujo,emerald-dream,1899,hunter,beastmastery,131,60,71
Kensho,illidan,1895,hunter,beastmastery,57,32,25
Blackathena,tichondrius,1894,hunter,beastmastery,78,40,38
Genom,tichondrius,1886,hunter,beastmastery,88,43,45
Lamerpvp,tichondrius,1885,hunter,beastmastery,50,31,19
Perawantua,frostmourne,1878,hunter,beastmastery,61,35,26
Headshotzplz,tichondrius,1869,hunter,beastmastery,50,27,23
Nutellacrepe,kelthuzad,1868,hunter,beastmastery,116,59,57
Orber,stormrage,1867,hunter,beastmastery,104,54,50
Hogx,sargeras,1862,hunter,beastmastery,72,32,40
Funkyjunk,arthas,1860,hunter,beastmastery,54,28,26
Lkw,tichondrius,1855,hunter,beastmastery,44,22,22
Hfn,stormrage,1849,hunter,beastmastery,47,26,21
Inktray,durotan,1844,hunter,beastmastery,37,22,15
Ucl,tichondrius,1843,hunter,beastmastery,54,27,27
Beastmunster,frostmourne,1843,hunter,beastmastery,54,25,29
Aqq,moon-guard,1842,hunter,beastmastery,98,58,40
Illweedx,kiljaeden,1839,hunter,beastmastery,65,32,33
Arsk,ragnaros,1838,hunter,beastmastery,60,30,30
Mørodox,sargeras,1834,hunter,beastmastery,54,24,30
Ñotorious,frostmane,1833,hunter,beastmastery,36,21,15
Zumago,tichondrius,1832,hunter,beastmastery,83,36,47
Nelay,ragnaros,1829,hunter,beastmastery,82,46,36
Sosaho,sargeras,1825,hunter,beastmastery,41,21,20
Jeffersan,illidan,1825,hunter,beastmastery,125,60,65
Zefbaby,quelthalas,1822,hunter,beastmastery,66,31,35
Tyreu,tichondrius,1820,hunter,beastmastery,59,30,29
Liarael,illidan,1820,hunter,beastmastery,78,39,39
Grimrokk,malganis,1819,hunter,beastmastery,78,40,38
Scuffedshots,tichondrius,1817,hunter,beastmastery,74,43,31
Bogen,nemesis,1816,hunter,beastmastery,34,22,12
Audeline,tichondrius,1815,hunter,beastmastery,69,33,36
Songhammer,tichondrius,1814,hunter,beastmastery,47,30,17
Goonsh,tichondrius,1813,hunter,beastmastery,40,25,15
Asukaw,barthilas,1813,hunter,beastmastery,57,28,29
Faniquitinha,stormrage,1811,hunter,beastmastery,48,22,26
Kybelís,dalaran,1810,hunter,beastmastery,110,61,49
Graar,tichondrius,1809,hunter,beastmastery,42,22,20
Negãn,tichondrius,1805,hunter,beastmastery,68,34,34
Phayzd,sargeras,1804,hunter,beastmastery,48,28,20
Warcher,azralon,1802,hunter,beastmastery,60,32,28
Absinther,emerald-dream,1798,hunter,beastmastery,60,37,23
Koridelse,nemesis,1797,hunter,beastmastery,108,51,57
Easonl,tichondrius,1795,hunter,beastmastery,66,27,39
Torolol,tichondrius,1793,hunter,beastmastery,108,63,45
Zeddead,magtheridon,1791,hunter,beastmastery,111,54,57
Hunterphil,hyjal,1775,hunter,beastmastery,48,30,18
Mauklindaufe,fenris,1764,hunter,beastmastery,39,24,15
Swang,kiljaeden,1764,hunter,beastmastery,43,21,22
Veevx,proudmoore,1750,hunter,beastmastery,41,28,13
Kwinoah,zuljin,1747,hunter,beastmastery,42,27,15
Warpath,ursin,1743,hunter,beastmastery,48,26,22
Vëëv,proudmoore,1743,hunter,beastmastery,47,21,26
Nyxus,tichondrius,1740,hunter,beastmastery,60,28,32
Jsgun,illidan,1733,hunter,beastmastery,32,20,12
Coopshot,darkspear,1732,hunter,beastmastery,63,39,24
Dahmer,greymane,1732,hunter,beastmastery,62,29,33
Melov,frostmourne,1730,hunter,beastmastery,64,30,34
Monffbe,tichondrius,1729,hunter,beastmastery,48,22,26
Tracershot,malganis,1727,hunter,beastmastery,65,39,26
Krunkz,frostmourne,1724,hunter,beastmastery,53,33,20
Dreygar,dawnbringer,1721,hunter,beastmastery,54,32,22
Bootydoo,illidan,1721,hunter,beastmastery,124,64,60
Quietqt,ragnaros,1721,hunter,beastmastery,77,38,39
Kytan,shadowmoon,1720,hunter,beastmastery,150,70,80
Xgoh,sargeras,1712,hunter,beastmastery,30,18,12
Edelyysa,arthas,1711,hunter,beastmastery,174,86,88
Lenacraft,frostmourne,1708,hunter,beastmastery,24,18,6
Cuchulláin,area-52,1707,hunter,beastmastery,108,55,53
Kushaddict,lightnings-blade,1701,hunter,beastmastery,60,25,35
Shablagoosh,zuljin,1694,hunter,beastmastery,25,19,6
Edarkness,gurubashi,1694,hunter,beastmastery,42,21,21
Sissleto,tichondrius,1694,hunter,beastmastery,118,58,60
Jfkd,sargeras,1694,hunter,beastmastery,52,21,31
Dpdóugh,illidan,1692,hunter,beastmastery,42,25,17
Auwstin,tichondrius,1688,hunter,beastmastery,43,23,20
Turtlegirl,tichondrius,1687,hunter,beastmastery,35,18,17
Lucki,blades-edge,1682,hunter,beastmastery,36,21,15
Shafttrapper,queldorei,1676,hunter,beastmastery,96,48,48
Saiiphz,bleeding-hollow,1675,hunter,beastmastery,40,22,18
Tuân,azgalor,1674,hunter,beastmastery,36,23,13
Sindragostra,tichondrius,1666,hunter,beastmastery,66,34,32
Hokutoxx,tichondrius,1663,hunter,beastmastery,61,25,36
Kopula,illidan,1662,hunter,beastmastery,49,26,23
Phatshiet,anvilmar,1660,hunter,beastmastery,30,18,12
Kangarookyle,illidan,1656,hunter,beastmastery,48,29,19
Rndx,sargeras,1653,hunter,beastmastery,46,20,26
Maiyev,quelthalas,1650,hunter,beastmastery,35,18,17
Apøllö,kilrogg,1647,hunter,beastmastery,155,70,85
Sobewan,staghelm,1646,hunter,beastmastery,38,20,18
Ipickmynose,tichondrius,1645,hunter,beastmastery,45,27,18
Dju,stormrage,1636,hunter,beastmastery,59,26,33
Drakarth,khazgoroth,1635,hunter,beastmastery,47,22,25
Parnicyon,frostmourne,1634,hunter,beastmastery,103,57,46
Mambothehunt,stormrage,1633,hunter,beastmastery,41,19,22
Cocoapuffs,cenarius,1627,hunter,beastmastery,36,17,19
Eastwood,tichondrius,1627,hunter,beastmastery,72,30,42
Laurenx,illidan,1624,hunter,beastmastery,24,17,7
Realskinhead,terenas,1622,hunter,beastmastery,54,29,25
Cachín,ragnaros,1618,hunter,beastmastery,36,21,15
Mournebow,tichondrius,1616,hunter,beastmastery,108,64,44
Telånnas,illidan,1616,hunter,beastmastery,42,21,21
Killwill,illidan,1613,hunter,beastmastery,36,20,16
Killshøtß,tichondrius,1613,hunter,beastmastery,36,20,16
Bertimus,sargeras,1611,hunter,beastmastery,102,46,56
Cobrakhan,tichondrius,1608,hunter,beastmastery,66,42,24
Focusfire,khazgoroth,1607,hunter,beastmastery,66,32,34
Kahll,azralon,1606,hunter,beastmastery,42,18,24
Biehuixin,tichondrius,1603,hunter,beastmastery,32,19,13
Asurvivor,suramar,1601,hunter,beastmastery,48,26,22
Twixzorz,boulderfist,1599,hunter,beastmastery,36,17,19
Shadowfangs,tichondrius,1599,hunter,beastmastery,36,17,19
Mlemily,stormrage,1598,hunter,beastmastery,36,21,15
Mythxplosive,ragnaros,1597,hunter,beastmastery,41,17,24
Consanguin,sargeras,1588,hunter,beastmastery,30,19,11
Svsnipe,tichondrius,1585,hunter,beastmastery,41,23,18
Silverbite,garona,1585,hunter,beastmastery,45,24,21
Casperonni,illidan,1581,hunter,beastmastery,42,23,19
Lexandr,tichondrius,1578,hunter,beastmastery,72,40,32
Shootnoscore,vashj,1578,hunter,beastmastery,71,39,32
Wilmaßallfit,malganis,1578,hunter,beastmastery,42,18,24
Zennifi,bleeding-hollow,1575,hunter,beastmastery,49,24,25
Kript,dragonmaw,1575,hunter,beastmastery,175,83,92
Fkkroglash,barthilas,1573,hunter,beastmastery,36,23,13
Hyjax,darkspear,1569,hunter,beastmastery,31,18,13
Velhokoira,illidan,1563,hunter,beastmastery,42,27,15
Assbow,kiljaeden,1561,hunter,beastmastery,36,18,18
Snewfly,tichondrius,1544,hunter,beastmastery,36,25,11
Sootgarbage,sargeras,1540,hunter,beastmastery,60,39,21
Despairius,moon-guard,1540,hunter,beastmastery,42,24,18
Grànd,tortheldrin,1539,hunter,beastmastery,48,26,22
Ungoliánt,cairne,1539,hunter,beastmastery,42,22,20
Petkd,frostmourne,1538,hunter,beastmastery,42,23,19
Freebeë,area-52,1531,hunter,beastmastery,79,46,33
Sñïpêr,tichondrius,1530,hunter,beastmastery,30,16,14
Lasix,burning-blade,1530,hunter,beastmastery,101,48,53
Robnhunt,tichondrius,1526,hunter,beastmastery,30,16,14
Sonichunterr,illidan,1520,hunter,beastmastery,29,19,10
Hazzeth,thrall,1516,hunter,beastmastery,30,21,9
Grimbrew,garona,1514,hunter,beastmastery,29,17,12
Gamestopceo,tichondrius,1511,hunter,beastmastery,84,41,43
Uzpak,tichondrius,1510,hunter,beastmastery,50,29,21
Chowyunfatss,proudmoore,1507,hunter,beastmastery,82,39,43
Legoflaiz,drakkari,1506,hunter,beastmastery,36,16,20
Stalkstride,destromath,1503,hunter,beastmastery,72,35,37
Dlabio,emerald-dream,1491,hunter,beastmastery,66,35,31
Scirfreez,ragnaros,1491,hunter,beastmastery,42,18,24
Chizhi,tichondrius,1489,hunter,beastmastery,72,36,36
Lilpoots,warsong,1487,hunter,beastmastery,41,22,19
Fames,shuhalo,1485,hunter,beastmastery,43,21,22
Laras,blades-edge,1484,hunter,beastmastery,36,22,14
Sniperælite,korgath,1481,hunter,beastmastery,27,17,10
Internade,frostmourne,1481,hunter,beastmastery,42,18,24
Bamfhunt,darkspear,1478,hunter,beastmastery,28,17,11
Garzb,area-52,1476,hunter,beastmastery,42,22,20
Scourgesurge,kiljaeden,1476,hunter,beastmastery,97,47,50
Silversøng,moon-guard,1474,hunter,beastmastery,66,31,35
Nobito,quelthalas,1472,hunter,beastmastery,27,17,10
Aguntur,ragnaros,1471,hunter,beastmastery,93,56,37
Daarrk,thrall,1462,hunter,beastmastery,40,19,21
Danncer,alexstrasza,1459,hunter,beastmastery,60,35,25
Jjack,muradin,1454,hunter,beastmastery,42,22,20
Mortalz,barthilas,1454,hunter,beastmastery,77,35,42
Limpnoodle,nerzhul,1452,hunter,beastmastery,75,36,39
Reloadz,shattered-hand,1451,hunter,beastmastery,29,16,13
Øverdose,ragnaros,1439,hunter,beastmastery,24,15,9
Flitt,zuljin,1439,hunter,beastmastery,30,15,15
Limcross,drakkari,1438,hunter,beastmastery,30,16,14
Jyttrg,tichondrius,1437,hunter,beastmastery,53,29,24
Pãrzival,tichondrius,1437,hunter,beastmastery,36,15,21
Cyboreg,stormrage,1436,hunter,beastmastery,35,21,14
Gernon,frostmourne,1434,hunter,beastmastery,27,16,11
Borudin,stormrage,1428,hunter,beastmastery,81,33,48
Trickshotss,illidan,1426,hunter,beastmastery,23,17,6
Munyshotz,tichondrius,1426,hunter,beastmastery,86,50,36
Peterming,tichondrius,1424,hunter,beastmastery,54,24,30
Yaisk,tichondrius,1418,hunter,beastmastery,42,22,20
Eldlichi,proudmoore,1416,hunter,beastmastery,48,20,28
Partz,darkspear,1413,hunter,beastmastery,24,15,9
Sioul,bleeding-hollow,1403,hunter,beastmastery,30,15,15
Thezeus,barthilas,1402,hunter,beastmastery,41,15,26
Belime,korgath,1399,hunter,beastmastery,65,37,28
Terpa,nemesis,1396,hunter,beastmastery,90,45,45
Outfazed,tichondrius,1396,hunter,beastmastery,42,21,21
Timmee,bleeding-hollow,1392,hunter,beastmastery,36,15,21
Viperstng,area-52,1380,hunter,beastmastery,70,40,30
Sereom,frostmourne,1375,hunter,beastmastery,59,33,26
Boward,illidan,1373,hunter,beastmastery,36,21,15
Aristæos,kelthuzad,1370,hunter,beastmastery,40,20,20
Omegalulzxd,kelthuzad,1370,hunter,beastmastery,36,16,20
Phaction,tichondrius,1369,hunter,beastmastery,60,26,34
Lizymcguire,malganis,1364,hunter,beastmastery,36,22,14
Ryukuzen,tichondrius,1359,hunter,beastmastery,35,15,20
Shlandy,frostmourne,1356,hunter,beastmastery,32,18,14
Sliturthroat,barthilas,1354,hunter,beastmastery,38,17,21
Bowrockobama,illidan,1341,hunter,beastmastery,24,14,10
Shockwave,velen,1341,hunter,beastmastery,75,35,40
Tergls,illidan,1341,hunter,beastmastery,73,33,40
Airtight,area-52,1340,hunter,beastmastery,41,20,21
Oatmeallover,stormrage,1339,hunter,beastmastery,30,14,16
Skulgor,zuljin,1336,hunter,beastmastery,66,34,32
Psychiatry,bonechewer,1336,hunter,beastmastery,70,35,35
Mitulla,wyrmrest-accord,1331,hunter,beastmastery,24,15,9
Jacobsladder,illidan,1330,hunter,beastmastery,54,24,30
Wadadly,malganis,1328,hunter,beastmastery,108,54,54
Luprikus,maelstrom,1328,hunter,beastmastery,29,14,15
Irøneye,sargeras,1328,hunter,beastmastery,42,14,28
Bluebow,tichondrius,1323,hunter,beastmastery,42,20,22
Vruul,sargeras,1318,hunter,beastmastery,42,18,24
Fallenfates,stormrage,1317,hunter,beastmastery,36,17,19
Ñðñdêsçrípt,frostmourne,1317,hunter,beastmastery,33,15,18
Pingaamarela,nemesis,1314,hunter,beastmastery,36,18,18
Vaettai,barthilas,1314,hunter,beastmastery,66,30,36
Hoboh,illidan,1310,hunter,beastmastery,66,32,34
Sniper,area-52,1305,hunter,beastmastery,29,14,15
Hughneutron,kirin-tor,1290,hunter,beastmastery,123,66,57
Camhaanes,area-52,1283,hunter,beastmastery,30,14,16
Kälec,quelthalas,1277,hunter,beastmastery,63,31,32
Wulfgeng,azgalor,1274,hunter,beastmastery,62,29,33
Iar,tichondrius,1270,hunter,beastmastery,30,18,12
Revbubs,darkspear,1270,hunter,beastmastery,36,15,21
Femonemos,nemesis,1266,hunter,beastmastery,24,14,10
Fruitenveg,frostmourne,1261,hunter,beastmastery,30,14,16
Desydn,draenor,1247,hunter,beastmastery,125,64,61
Zzsocrateszz,dragonmaw,1247,hunter,beastmastery,41,20,21
Frankabingle,area-52,1247,hunter,beastmastery,30,13,17
Slowhunterr,tichondrius,1247,hunter,beastmastery,36,13,23
Junglefever,skywall,1246,hunter,beastmastery,22,14,8
Gabulmenina,nemesis,1245,hunter,beastmastery,24,13,11
Shotmieye,thunderhorn,1244,hunter,beastmastery,60,30,30
Jillypoo,azralon,1243,hunter,beastmastery,18,13,5
Craftarrow,tichondrius,1243,hunter,beastmastery,41,21,20
Nogaro,nemesis,1235,hunter,beastmastery,36,17,19
Xtop,draktharon,1231,hunter,beastmastery,23,15,8
Sungoro,tichondrius,1231,hunter,beastmastery,30,13,17
Luoca,shuhalo,1227,hunter,beastmastery,24,13,11
Grands,tortheldrin,1219,hunter,beastmastery,29,14,15
Cigâro,thrall,1218,hunter,beastmastery,32,13,19
Bacatran,darkspear,1214,hunter,beastmastery,24,14,10
Alaurys,moon-guard,1214,hunter,beastmastery,23,13,10
Ascer,gurubashi,1214,hunter,beastmastery,36,16,20
Vesity,tichondrius,1211,hunter,beastmastery,32,14,18
Alaranel,kiljaeden,1208,hunter,beastmastery,36,15,21
Ðeatheater,tichondrius,1198,hunter,beastmastery,23,13,10
Rypunzul,proudmoore,1196,hunter,beastmastery,24,13,11
Rektarrow,area-52,1190,hunter,beastmastery,29,13,16
Arucedd,frostmourne,1188,hunter,beastmastery,47,20,27
Bepee,auchindoun,1185,hunter,beastmastery,30,15,15
Genx,frostmane,1182,hunter,beastmastery,35,15,20
Thetrickyone,area-52,1180,hunter,beastmastery,52,20,32
Brokenstars,illidan,1160,hunter,beastmastery,55,26,29
Ydaine,alexstrasza,1158,hunter,beastmastery,70,28,42
Chrønic,khadgar,1155,hunter,beastmastery,24,13,11
Ragnarlobkk,ragnaros,1154,hunter,beastmastery,47,20,27
Lustblitz,illidan,1152,hunter,beastmastery,18,12,6
Logjohn,frostmourne,1152,hunter,beastmastery,28,13,15
Madbéê,tichondrius,1151,hunter,beastmastery,24,12,12
Fockewulf,dragonmaw,1151,hunter,beastmastery,30,12,18
Andalora,malganis,1150,hunter,beastmastery,24,12,12
Venrod,ragnaros,1149,hunter,beastmastery,24,12,12
Kroozeh,illidan,1149,hunter,beastmastery,24,12,12
Squishasf,tichondrius,1148,hunter,beastmastery,18,12,6
Szone,tichondrius,1147,hunter,beastmastery,35,14,21
Yembohi,queldorei,1145,hunter,beastmastery,18,12,6
Doug,illidan,1145,hunter,beastmastery,24,12,12
Flexxbow,thrall,1144,hunter,beastmastery,21,13,8
Sunchea,arygos,1141,hunter,beastmastery,24,12,12
Shneedle,illidan,1129,hunter,beastmastery,24,12,12
Ioioi,tichondrius,1127,hunter,beastmastery,24,12,12
Huñté,stormrage,1127,hunter,beastmastery,24,12,12
Brendie,thrall,1117,hunter,beastmastery,42,17,25
Spèedbump,stormrage,1107,hunter,beastmastery,23,12,11
Ukamau,ragnaros,1097,hunter,beastmastery,24,14,10
Wredd,nemesis,1094,hunter,beastmastery,23,12,11
Zalyssavara,aerie-peak,1085,hunter,beastmastery,27,12,15
Buyaga,stormreaver,1073,hunter,beastmastery,72,37,35
Dracð,malganis,1071,hunter,beastmastery,30,14,16
Qpoc,tichondrius,1060,hunter,beastmastery,20,12,8
Kenshaunter,azralon,1056,hunter,beastmastery,18,11,7
Liillilliil,tichondrius,1055,hunter,beastmastery,18,11,7
Ryutiz,fizzcrank,1055,hunter,beastmastery,18,11,7
Datadyne,stormrage,1054,hunter,beastmastery,12,11,1
Emilysamuels,tichondrius,1054,hunter,beastmastery,18,11,7
Ispamtraps,emerald-dream,1054,hunter,beastmastery,18,11,7
Seatback,arathor,1054,hunter,beastmastery,18,11,7
Cerébro,illidan,1054,hunter,beastmastery,30,11,19
Drunkhunter,malygos,1053,hunter,beastmastery,18,11,7
Phindo,agamaggan,1053,hunter,beastmastery,18,11,7
Wøden,draka,1051,hunter,beastmastery,24,11,13
Tinyted,nathrezim,1051,hunter,beastmastery,24,11,13
Varthurg,ragnaros,1050,hunter,beastmastery,18,11,7
Whitecake,area-52,1050,hunter,beastmastery,22,12,10
Lashga,wyrmrest-accord,1050,hunter,beastmastery,24,11,13
ßaelon,malganis,1047,hunter,beastmastery,12,11,1
Kynagidas,korgath,1047,hunter,beastmastery,24,11,13
Araghrn,draktharon,1047,hunter,beastmastery,25,11,14
Javoz,drakkari,1047,hunter,beastmastery,30,11,19
Vord,frostmourne,1046,hunter,beastmastery,24,11,13
Cilnolm,moon-guard,1045,hunter,beastmastery,24,11,13
Wogolas,barthilas,1044,hunter,beastmastery,18,11,7
Frostyarrow,moon-guard,1044,hunter,beastmastery,23,12,11
Argent,altar-of-storms,1043,hunter,beastmastery,18,11,7
Honeygold,tichondrius,1042,hunter,beastmastery,30,11,19
Tmac,winterhoof,1040,hunter,beastmastery,29,13,16
Hetaya,lightninghoof,1035,hunter,beastmastery,53,18,35
Riivali,quelthalas,1032,hunter,beastmastery,24,11,13
Bobbysmurica,cenarion-circle,1032,hunter,beastmastery,30,11,19
Iffy,dentarg,1030,hunter,beastmastery,18,11,7
Robingear,baelgun,1026,hunter,beastmastery,75,34,41
Mhter,tichondrius,1023,hunter,beastmastery,17,11,6
Vegamax,illidan,1020,hunter,beastmastery,18,11,7
Puhpsy,azralon,1016,hunter,beastmastery,24,15,9
Fifie,azgalor,1011,hunter,beastmastery,31,12,19
Skywvlker,illidan,1007,hunter,beastmastery,29,11,18
Antihero,norgannon,1001,hunter,beastmastery,20,12,8
Erovianoria,silver-hand,1001,hunter,beastmastery,51,27,24
Rotokrim,emerald-dream,996,hunter,beastmastery,108,53,55
Mckim,tichondrius,960,hunter,beastmastery,12,10,2
Ahhpash,tichondrius,960,hunter,beastmastery,16,11,5
Shinhyez,tichondrius,960,hunter,beastmastery,18,10,8
Wovow,tichondrius,960,hunter,beastmastery,18,10,8
Gööber,hyjal,960,hunter,beastmastery,18,10,8
Trapful,illidan,960,hunter,beastmastery,18,10,8
Huntinpuss,tichondrius,960,hunter,beastmastery,18,10,8
Emmihunt,tichondrius,960,hunter,beastmastery,18,10,8
Tashio,aerie-peak,960,hunter,beastmastery,18,10,8
Livelovelaff,tichondrius,960,hunter,beastmastery,18,10,8
Prêd,malganis,960,hunter,beastmastery,21,11,10
Willdey,frostmourne,960,hunter,beastmastery,24,10,14
Kyló,sargeras,960,hunter,beastmastery,24,10,14
Flanzo,illidan,960,hunter,beastmastery,24,10,14
Datbigbowdoe,illidan,959,hunter,beastmastery,16,11,5
Rosebullets,bleeding-hollow,959,hunter,beastmastery,18,10,8
Kapukapu,illidan,959,hunter,beastmastery,18,10,8
Tmnarcanttv,tichondrius,959,hunter,beastmastery,18,10,8
Toxarch,aggramar,959,hunter,beastmastery,18,10,8
Crownchild,illidan,959,hunter,beastmastery,18,10,8
Razor,destromath,959,hunter,beastmastery,19,10,9
Kimbaa,tichondrius,959,hunter,beastmastery,24,10,14
Comebacks,ragnaros,959,hunter,beastmastery,24,10,14
Icecaffemoca,tichondrius,959,hunter,beastmastery,24,10,14
Orgpopeyes,illidan,959,hunter,beastmastery,24,10,14
Ðfac,moon-guard,959,hunter,beastmastery,24,10,14
Yager,kalecgos,958,hunter,beastmastery,18,10,8
Aquabat,wildhammer,958,hunter,beastmastery,18,10,8
Pankyrangs,kelthuzad,958,hunter,beastmastery,18,10,8
Mikly,ragnaros,957,hunter,beastmastery,24,10,14
Hynathios,azralon,957,hunter,beastmastery,24,10,14
Angdre,tichondrius,956,hunter,beastmastery,24,10,14
Deepcarver,tichondrius,954,hunter,beastmastery,24,10,14
Lilien,khazgoroth,951,hunter,beastmastery,18,10,8
Steelaeon,moon-guard,951,hunter,beastmastery,24,10,14
Bgheart,andorhal,950,hunter,beastmastery,24,10,14
Böuntyhuntêr,area-52,948,hunter,beastmastery,24,10,14
Glizzys,cairne,943,hunter,beastmastery,24,11,13
Shootyurshot,stormrage,927,hunter,beastmastery,20,11,9
Faldran,earthen-ring,915,hunter,beastmastery,35,10,25
Coyner,tichondrius,907,hunter,beastmastery,21,10,11
Showmakerc,proudmoore,905,hunter,beastmastery,29,11,18
Arrowae,sargeras,899,hunter,beastmastery,23,10,13
Foh,kelthuzad,888,hunter,beastmastery,17,10,7
Rairin,tichondrius,869,hunter,beastmastery,44,17,27
Lubze,bleeding-hollow,864,hunter,beastmastery,12,9,3
Bmhuntlol,illidan,864,hunter,beastmastery,12,9,3
Slipox,sargeras,864,hunter,beastmastery,12,9,3
Xbloody,tichondrius,864,hunter,beastmastery,18,9,9
Perffect,sargeras,864,hunter,beastmastery,18,9,9
Hagadinn,frostmourne,864,hunter,beastmastery,18,9,9
Yucca,drenden,864,hunter,beastmastery,18,9,9
Bolanite,illidan,864,hunter,beastmastery,18,9,9
Tytonic,bleeding-hollow,864,hunter,beastmastery,18,9,9
Hurak,elune,864,hunter,beastmastery,18,9,9
Lilsynchfyb,sargeras,864,hunter,beastmastery,18,9,9
Déwi,tichondrius,864,hunter,beastmastery,18,9,9
Balrröt,malganis,864,hunter,beastmastery,24,9,15
Çhexmix,kiljaeden,863,hunter,beastmastery,12,9,3
Rëxx,moon-guard,863,hunter,beastmastery,12,9,3
Cloxygen,moon-guard,863,hunter,beastmastery,12,9,3
Nikronos,quelthalas,863,hunter,beastmastery,18,9,9
Çute,moon-guard,863,hunter,beastmastery,18,9,9
Jamzlol,frostmourne,863,hunter,beastmastery,18,9,9
Nubberton,sargeras,863,hunter,beastmastery,24,9,15
Myladyy,zuljin,863,hunter,beastmastery,30,9,21
Rcman,tichondrius,862,hunter,beastmastery,12,9,3
Bootylickin,tichondrius,862,hunter,beastmastery,18,9,9
Toross,stormscale,862,hunter,beastmastery,18,9,9
Korasaurus,tichondrius,861,hunter,beastmastery,12,9,3
Cottonshots,dalaran,861,hunter,beastmastery,24,9,15
ßaeløn,malganis,860,hunter,beastmastery,12,9,3
Dontmissz,tichondrius,860,hunter,beastmastery,18,9,9
Alitharia,nerzhul,860,hunter,beastmastery,30,9,21
Ketulirantle,azralon,860,hunter,beastmastery,36,9,27
Kamikazey,tichondrius,859,hunter,beastmastery,18,9,9
More,khadgar,858,hunter,beastmastery,24,9,15
Vexxør,bleeding-hollow,856,hunter,beastmastery,12,9,3
Bromance,kaelthas,856,hunter,beastmastery,18,9,9
Urimiel,daggerspine,855,hunter,beastmastery,24,9,15
Shiztec,malganis,854,hunter,beastmastery,24,9,15
Topshunter,sargeras,853,hunter,beastmastery,22,10,12
Eggsquatch,emerald-dream,844,hunter,beastmastery,12,9,3
Entrapment,emerald-dream,830,hunter,beastmastery,17,9,8
Jangle,mannoroth,828,hunter,beastmastery,17,9,8
Rawspits,kiljaeden,814,hunter,beastmastery,29,9,20
Zullypewpew,alexstrasza,811,hunter,beastmastery,11,9,2
Alexxspewpew,ragnaros,768,hunter,beastmastery,12,8,4
Yonzo,area-52,768,hunter,beastmastery,12,8,4
Chippendales,illidan,768,hunter,beastmastery,12,8,4
Sax,stormreaver,768,hunter,beastmastery,12,8,4
Jsrhuntz,sargeras,768,hunter,beastmastery,12,8,4
Kkoner,illidan,768,hunter,beastmastery,12,8,4
Teneightt,tichondrius,768,hunter,beastmastery,15,9,6
Aazua,frostmourne,768,hunter,beastmastery,18,8,10
Jawnhunter,tichondrius,768,hunter,beastmastery,18,8,10
Hogd,sargeras,768,hunter,beastmastery,18,8,10
Seongnam,tichondrius,768,hunter,beastmastery,18,8,10
Tigglyjits,tichondrius,768,hunter,beastmastery,18,8,10
Huntfaceguy,agamaggan,768,hunter,beastmastery,18,8,10
Oblitus,zuljin,768,hunter,beastmastery,18,8,10
Falesta,sargeras,768,hunter,beastmastery,18,8,10
Selhort,quelthalas,768,hunter,beastmastery,24,8,16
Remièl,frostmourne,767,hunter,beastmastery,12,8,4
Freeside,emerald-dream,767,hunter,beastmastery,12,8,4
Trim,tichondrius,767,hunter,beastmastery,12,8,4
Bulleitrye,illidan,767,hunter,beastmastery,12,8,4
Setepalms,azralon,767,hunter,beastmastery,12,8,4
Cxnt,saurfang,767,hunter,beastmastery,15,9,6
Jímmycorn,sargeras,767,hunter,beastmastery,18,8,10
Morbow,proudmoore,767,hunter,beastmastery,18,8,10
Picapaul,stormrage,767,hunter,beastmastery,18,8,10
Zephanno,sargeras,767,hunter,beastmastery,18,8,10
Bowjingles,blackrock,767,hunter,beastmastery,18,8,10
Unrealpewpew,lightbringer,767,hunter,beastmastery,18,8,10
Huukend,azjolnerub,766,hunter,beastmastery,12,8,4
Traps,deathwing,766,hunter,beastmastery,18,8,10
Londen,tichondrius,765,hunter,beastmastery,12,8,4
Handicrap,tichondrius,765,hunter,beastmastery,16,9,7
Timogen,illidan,764,hunter,beastmastery,18,8,10
Blury,tichondrius,762,hunter,beastmastery,18,8,10
Frenzyfire,whisperwind,760,hunter,beastmastery,27,9,18
Ophiela,shuhalo,759,hunter,beastmastery,36,8,28
Massivattack,skullcrusher,758,hunter,beastmastery,24,8,16
Blankshot,doomhammer,757,hunter,beastmastery,18,8,10
Vendortrash,aggramar,733,hunter,beastmastery,17,8,9
Virolac,tichondrius,720,hunter,beastmastery,15,8,7
Timberex,drenden,715,hunter,beastmastery,15,8,7
Håwkeye,hyjal,711,hunter,beastmastery,15,9,6
Koalahunter,area-52,704,hunter,beastmastery,20,9,11
Yozomoto,nordrassil,703,hunter,beastmastery,14,8,6
Lenalena,tichondrius,687,hunter,beastmastery,11,8,3
Pmø,sargeras,672,hunter,beastmastery,12,7,5
Gumbro,malganis,672,hunter,beastmastery,12,7,5
Downor,malganis,672,hunter,beastmastery,12,7,5
Trápngap,barthilas,672,hunter,beastmastery,12,7,5
Handmemygun,aggramar,672,hunter,beastmastery,12,7,5
Kouandjio,area-52,672,hunter,beastmastery,12,7,5
Wastdpenguin,area-52,672,hunter,beastmastery,12,7,5
Tentoontrey,emerald-dream,672,hunter,beastmastery,12,7,5
Gotrap,saurfang,672,hunter,beastmastery,12,7,5
Mehontar,area-52,672,hunter,beastmastery,12,7,5
Gentledream,dalaran,672,hunter,beastmastery,12,7,5
Zå,dalaran,672,hunter,beastmastery,12,7,5
Flamenco,arthas,672,hunter,beastmastery,12,7,5
Barainto,tichondrius,672,hunter,beastmastery,12,7,5
Cinnybunz,malganis,672,hunter,beastmastery,12,7,5
Tusxx,tichondrius,672,hunter,beastmastery,12,7,5
Mugiwara,frostwolf,672,hunter,beastmastery,12,7,5
Crimsoncoast,tichondrius,672,hunter,beastmastery,12,7,5
Sakedji,area-52,672,hunter,beastmastery,12,7,5
Starkhaven,firetree,672,hunter,beastmastery,12,7,5
Kabalaku,moon-guard,672,hunter,beastmastery,12,7,5
Imthaböss,nazjatar,672,hunter,beastmastery,12,7,5
Litchi,illidan,672,hunter,beastmastery,12,7,5
Broydiesnipe,illidan,672,hunter,beastmastery,12,7,5
Jsr,tichondrius,672,hunter,beastmastery,12,7,5
Skippyh,zuluhed,672,hunter,beastmastery,12,7,5
Lilskill,lightnings-blade,672,hunter,beastmastery,12,7,5
Hollowhunt,sentinels,672,hunter,beastmastery,12,7,5
Yandralen,kiljaeden,672,hunter,beastmastery,12,7,5
Shootiepie,hyjal,672,hunter,beastmastery,12,7,5
Zemphoths,eredar,672,hunter,beastmastery,15,7,8
Wickyz,malganis,672,hunter,beastmastery,18,7,11
Dreagneal,ragnaros,672,hunter,beastmastery,18,7,11
Geeshot,area-52,672,hunter,beastmastery,18,7,11
Clowntown,illidan,672,hunter,beastmastery,18,7,11
Raymose,tichondrius,672,hunter,beastmastery,18,7,11
Ðevil,ragnaros,672,hunter,beastmastery,18,7,11
Vigon,stormrage,672,hunter,beastmastery,18,7,11
Liadrelle,proudmoore,672,hunter,beastmastery,21,8,13
Crounzz,sargeras,672,hunter,beastmastery,30,7,23
Satours,quelthalas,671,hunter,beastmastery,12,7,5
Scrubmastery,emerald-dream,671,hunter,beastmastery,12,7,5
Aggargh,baelgun,671,hunter,beastmastery,12,7,5
Wael,perenolde,671,hunter,beastmastery,12,7,5
Exploits,stormrage,671,hunter,beastmastery,12,7,5
Voodoohunter,blood-furnace,671,hunter,beastmastery,12,7,5
Lavo,borean-tundra,671,hunter,beastmastery,12,7,5
Anniefuchsia,stormrage,671,hunter,beastmastery,12,7,5
Eightbeers,bleeding-hollow,671,hunter,beastmastery,12,7,5
Amortiz,illidan,671,hunter,beastmastery,18,7,11
Mooséhunt,wyrmrest-accord,671,hunter,beastmastery,18,7,11
Threethirty,thrall,671,hunter,beastmastery,18,7,11
Fleetfox,tichondrius,671,hunter,beastmastery,18,7,11
Kârân,tichondrius,670,hunter,beastmastery,16,8,8
Trapz,hellscream,670,hunter,beastmastery,18,7,11
Flacidhunter,kelthuzad,670,hunter,beastmastery,18,7,11
Spaeth,borean-tundra,670,hunter,beastmastery,24,7,17
Blimpbooty,stormrage,669,hunter,beastmastery,18,7,11
Neurosurgery,azralon,669,hunter,beastmastery,18,7,11
Strafenshoot,darkspear,666,hunter,beastmastery,12,7,5
Shootaids,illidan,666,hunter,beastmastery,18,7,11
Eastera,tichondrius,663,hunter,beastmastery,27,8,19
Theprovider,burning-blade,659,hunter,beastmastery,12,7,5
Benryats,area-52,657,hunter,beastmastery,21,8,13
Oblivîon,illidan,623,hunter,beastmastery,15,8,7
Gufanyaun,tichondrius,608,hunter,beastmastery,16,7,9
Kaizong,hyjal,607,hunter,beastmastery,11,7,4
Shanghunt,cenarius,604,hunter,beastmastery,14,7,7
Wodhunterxdd,tichondrius,576,hunter,beastmastery,6,6,0
Rekkis,area-52,576,hunter,beastmastery,6,6,0
Gassmask,area-52,576,hunter,beastmastery,6,6,0
Shootnskoot,icecrown,576,hunter,beastmastery,6,6,0
Ehnó,illidan,576,hunter,beastmastery,6,6,0
Cashisabeast,zuljin,576,hunter,beastmastery,6,6,0
Rbtz,illidan,576,hunter,beastmastery,6,6,0
Somethinglit,sargeras,576,hunter,beastmastery,12,6,6
Thoridhal,quelthalas,576,hunter,beastmastery,12,6,6
Gravshot,zuljin,576,hunter,beastmastery,12,6,6
Diegoshotz,zuljin,576,hunter,beastmastery,12,6,6
Balboa,tortheldrin,576,hunter,beastmastery,12,6,6
Memënto,barthilas,576,hunter,beastmastery,12,6,6
Hunterpk,lightbringer,576,hunter,beastmastery,12,6,6
Digitizoid,tichondrius,576,hunter,beastmastery,12,6,6
Evilblammo,thorium-brotherhood,576,hunter,beastmastery,12,6,6
Spottedoger,burning-legion,576,hunter,beastmastery,12,6,6
Cw,gorefiend,576,hunter,beastmastery,12,6,6
Deutêr,quelthalas,576,hunter,beastmastery,12,6,6
Gennaro,ragnaros,576,hunter,beastmastery,12,6,6
Zizilio,kelthuzad,576,hunter,beastmastery,12,6,6
Marexx,tichondrius,576,hunter,beastmastery,12,6,6
Despise,frostmourne,576,hunter,beastmastery,12,6,6
Smullik,wyrmrest-accord,576,hunter,beastmastery,12,6,6
Antares,dalaran,576,hunter,beastmastery,12,6,6
Xernen,thrall,576,hunter,beastmastery,12,6,6
Wildlifezoo,tichondrius,576,hunter,beastmastery,12,6,6
Ecl,azralon,576,hunter,beastmastery,12,6,6
Fma,stormrage,576,hunter,beastmastery,12,6,6
Jonah,sargeras,576,hunter,beastmastery,12,6,6
Huntard,stormrage,576,hunter,beastmastery,12,6,6
Lûrtz,aegwynn,576,hunter,beastmastery,12,6,6
Alochol,vashj,576,hunter,beastmastery,12,6,6
Raadun,terokkar,576,hunter,beastmastery,12,6,6
Arraza,ragnaros,576,hunter,beastmastery,16,7,9
Skytrooper,boulderfist,576,hunter,beastmastery,17,6,11
Kanta,bleeding-hollow,576,hunter,beastmastery,18,6,12
Bowreckage,malganis,576,hunter,beastmastery,18,6,12
Zooker,tichondrius,576,hunter,beastmastery,18,6,12
Nishinos,tichondrius,576,hunter,beastmastery,18,6,12
Mvpwonder,frostmourne,576,hunter,beastmastery,18,6,12
Beastbaal,sargeras,576,hunter,beastmastery,24,6,18
Drektorath,bleeding-hollow,576,hunter,beastmastery,24,6,18
Yolloswag,tichondrius,576,hunter,beastmastery,24,6,18
Chrise,darkspear,575,hunter,beastmastery,6,6,0
Asuryakha,darkspear,575,hunter,beastmastery,12,6,6
Gïzmo,malganis,575,hunter,beastmastery,12,6,6
Yobby,area-52,575,hunter,beastmastery,12,6,6
Gwarnar,stormrage,575,hunter,beastmastery,12,6,6
Darthski,drenden,575,hunter,beastmastery,18,6,12
Kathoey,wyrmrest-accord,575,hunter,beastmastery,18,6,12
Tozier,destromath,575,hunter,beastmastery,18,6,12
Revö,area-52,575,hunter,beastmastery,18,6,12
Nekrongar,agamaggan,574,hunter,beastmastery,12,6,6
Arcticuz,aegwynn,574,hunter,beastmastery,12,6,6
Chetta,ragnaros,574,hunter,beastmastery,18,6,12
Rikitiki,bleeding-hollow,573,hunter,beastmastery,12,6,6
Pewpew,gallywix,573,hunter,beastmastery,18,6,12
Pewpewd,tichondrius,572,hunter,beastmastery,12,6,6
Camperbill,borean-tundra,572,hunter,beastmastery,12,6,6
Bluehead,emerald-dream,566,hunter,beastmastery,12,6,6
Shootsb,tichondrius,544,hunter,beastmastery,22,6,16
Saltz,tichondrius,521,hunter,beastmastery,15,7,8
Ataxyus,area-52,512,hunter,beastmastery,10,6,4
Kkoduckk,tichondrius,480,hunter,beastmastery,6,5,1
Tukki,quelthalas,480,hunter,beastmastery,6,5,1
Brokensnipez,area-52,480,hunter,beastmastery,6,5,1
Teammatescba,tichondrius,480,hunter,beastmastery,6,5,1
Varka,area-52,480,hunter,beastmastery,6,5,1
Megahuntard,bleeding-hollow,480,hunter,beastmastery,6,5,1
Bowzørx,tichondrius,480,hunter,beastmastery,6,5,1
Tèrrabite,sargeras,480,hunter,beastmastery,6,5,1
Trappxy,sargeras,480,hunter,beastmastery,6,5,1
Sniperfx,lightbringer,480,hunter,beastmastery,6,5,1
Oeoeoeoeoeoe,alterac-mountains,480,hunter,beastmastery,6,5,1
Melinda,kilrogg,480,hunter,beastmastery,6,5,1
Beasting,moon-guard,480,hunter,beastmastery,6,5,1
Wopper,moon-guard,480,hunter,beastmastery,6,5,1
Plsnobanmee,frostmourne,480,hunter,beastmastery,6,5,1
Cojáx,dalaran,480,hunter,beastmastery,6,5,1
Clydebarro,sargeras,480,hunter,beastmastery,6,5,1
Slêv,frostmourne,480,hunter,beastmastery,6,5,1
Traptrinket,sargeras,480,hunter,beastmastery,6,5,1
Gejagt,sargeras,480,hunter,beastmastery,6,5,1
Dj,arygos,480,hunter,beastmastery,12,5,7
Teaks,aggramar,480,hunter,beastmastery,12,5,7
Ferex,tichondrius,480,hunter,beastmastery,12,5,7
Leyliann,quelthalas,480,hunter,beastmastery,12,5,7
Jesticles,zuljin,480,hunter,beastmastery,12,5,7
Sinvat,tichondrius,480,hunter,beastmastery,12,5,7
Paganfinn,tichondrius,480,hunter,beastmastery,12,5,7
Nj,kiljaeden,480,hunter,beastmastery,12,5,7
Valeous,azjolnerub,480,hunter,beastmastery,12,5,7
Lrnb,tichondrius,480,hunter,beastmastery,12,5,7
Twoshotz,stormrage,480,hunter,beastmastery,12,5,7
Luckshot,destromath,480,hunter,beastmastery,12,5,7
Køk,agamaggan,480,hunter,beastmastery,12,5,7
Smexyhunter,moon-guard,480,hunter,beastmastery,12,5,7
Clinteastwoo,ragnaros,480,hunter,beastmastery,12,5,7
Kaelles,illidan,480,hunter,beastmastery,12,5,7
Dôntlosmebro,stormrage,480,hunter,beastmastery,12,5,7
Heädshöt,malorne,480,hunter,beastmastery,12,5,7
Wønky,stormrage,480,hunter,beastmastery,12,5,7
Kinete,proudmoore,480,hunter,beastmastery,12,5,7
Hyena,kelthuzad,480,hunter,beastmastery,12,5,7
Yatyegatchun,illidan,480,hunter,beastmastery,12,5,7
Onemoreshot,bleeding-hollow,480,hunter,beastmastery,12,5,7
Sunflwerdawn,emerald-dream,480,hunter,beastmastery,12,5,7
Getrekt,azralon,480,hunter,beastmastery,12,5,7
Drakku,zuljin,480,hunter,beastmastery,12,5,7
Recha,emerald-dream,480,hunter,beastmastery,12,5,7
Mav,dragonmaw,480,hunter,beastmastery,14,5,9
Darksector,nemesis,480,hunter,beastmastery,18,5,13
Terminatôr,malganis,480,hunter,beastmastery,18,5,13
Chetxs,bleeding-hollow,480,hunter,beastmastery,18,5,13
Somethinggo,tichondrius,480,hunter,beastmastery,18,5,13
Zpax,area-52,479,hunter,beastmastery,6,5,1
Mafghine,malganis,479,hunter,beastmastery,6,5,1
Shamtus,bladefist,479,hunter,beastmastery,6,5,1
Huntercry,ragnaros,479,hunter,beastmastery,6,5,1
Trianthel,azralon,479,hunter,beastmastery,12,5,7
Shoya,nerzhul,479,hunter,beastmastery,12,5,7
Mecatrón,quelthalas,479,hunter,beastmastery,12,5,7
Deadlyattack,barthilas,479,hunter,beastmastery,12,5,7
Smider,magtheridon,479,hunter,beastmastery,18,5,13
Feralhuntard,muradin,477,hunter,beastmastery,12,5,7
Jîa,tichondrius,448,hunter,beastmastery,10,5,5
Spunky,zuluhed,447,hunter,beastmastery,11,5,6
Verzatyle,frostwolf,447,hunter,beastmastery,11,5,6
Gunther,korgath,447,hunter,beastmastery,11,5,6
Studiosx,tichondrius,447,hunter,beastmastery,11,5,6
Vuur,korialstrasz,447,hunter,beastmastery,19,6,13
Mordriva,azjolnerub,431,hunter,beastmastery,11,5,6
Twatshót,burning-legion,431,hunter,beastmastery,11,5,6
Rástakhan,ragnaros,431,hunter,beastmastery,11,5,6
Dekestei,bleeding-hollow,431,hunter,beastmastery,17,5,12
Gandson,fizzcrank,415,hunter,beastmastery,11,5,6
Malgar,zuljin,415,hunter,beastmastery,11,5,6
Hunbatz,dalaran,397,hunter,beastmastery,7,5,2
Huntations,sargeras,384,hunter,beastmastery,6,4,2
Traptations,sargeras,384,hunter,beastmastery,6,4,2
Actioh,stormrage,384,hunter,beastmastery,6,4,2
Kong,tichondrius,384,hunter,beastmastery,6,4,2
Snipingmilfs,zuluhed,384,hunter,beastmastery,6,4,2
Shadowtensai,stormrage,384,hunter,beastmastery,6,4,2
Malcab,tichondrius,384,hunter,beastmastery,6,4,2
Petpenguin,kelthuzad,384,hunter,beastmastery,6,4,2
Fizzpow,blackrock,384,hunter,beastmastery,6,4,2
Mexishots,tichondrius,384,hunter,beastmastery,6,4,2
Naxhunter,stormrage,384,hunter,beastmastery,6,4,2
Quickfyre,stormrage,384,hunter,beastmastery,6,4,2
Khanittus,area-52,384,hunter,beastmastery,6,4,2
Exitwoundz,hyjal,384,hunter,beastmastery,6,4,2
Puns,stormreaver,384,hunter,beastmastery,6,4,2
Taterballs,illidan,384,hunter,beastmastery,6,4,2
Gammaraven,dalaran,384,hunter,beastmastery,6,4,2
Geregaux,sargeras,384,hunter,beastmastery,6,4,2
Raerdun,bonechewer,384,hunter,beastmastery,6,4,2
Tezcâtlipocâ,sargeras,384,hunter,beastmastery,6,4,2
Mhters,tichondrius,384,hunter,beastmastery,6,4,2
Nodougaelark,dalaran,384,hunter,beastmastery,6,4,2
Murdaugh,icecrown,384,hunter,beastmastery,6,4,2
Thiccit,illidan,384,hunter,beastmastery,6,4,2
Mannypew,kelthuzad,384,hunter,beastmastery,6,4,2
Yolotraps,thrall,384,hunter,beastmastery,6,4,2
Hawkkeye,thunderlord,384,hunter,beastmastery,6,4,2
Vindication,ysera,384,hunter,beastmastery,6,4,2
Mmeep,illidan,384,hunter,beastmastery,6,4,2
Ragerab,trollbane,384,hunter,beastmastery,6,4,2
Chikkynuggy,destromath,384,hunter,beastmastery,6,4,2
Energiser,stormrage,384,hunter,beastmastery,6,4,2
Zarnick,frostwolf,384,hunter,beastmastery,6,4,2
Sôuleater,moon-guard,384,hunter,beastmastery,6,4,2
Vox,tichondrius,384,hunter,beastmastery,6,4,2
Tangoda,tichondrius,384,hunter,beastmastery,6,4,2
Houdan,frostmourne,384,hunter,beastmastery,6,4,2
Jerso,zuljin,384,hunter,beastmastery,6,4,2
Skysmile,tichondrius,384,hunter,beastmastery,6,4,2
Infatuatedx,moon-guard,384,hunter,beastmastery,6,4,2
Yeaheh,area-52,384,hunter,beastmastery,6,4,2
Heylenny,area-52,384,hunter,beastmastery,6,4,2
Dexh,frostmourne,384,hunter,beastmastery,6,4,2
Loriandel,proudmoore,384,hunter,beastmastery,8,4,4
Rycksanches,quelthalas,384,hunter,beastmastery,10,4,6
Noxura,illidan,384,hunter,beastmastery,12,4,8
Bowsauce,khadgar,384,hunter,beastmastery,12,4,8
Seanpaì,tichondrius,384,hunter,beastmastery,12,4,8
Elywen,alexstrasza,384,hunter,beastmastery,12,4,8
Bubbz,bloodscalp,384,hunter,beastmastery,12,4,8
Grimshot,boulderfist,384,hunter,beastmastery,12,4,8
Iililillilii,tichondrius,384,hunter,beastmastery,12,4,8
Cndavyjones,akama,384,hunter,beastmastery,12,4,8
Saharä,illidan,384,hunter,beastmastery,12,4,8
Shaevie,lothar,384,hunter,beastmastery,12,4,8
Grumaku,area-52,384,hunter,beastmastery,12,4,8
Kaliaraan,bleeding-hollow,384,hunter,beastmastery,12,4,8
Odb,kelthuzad,384,hunter,beastmastery,12,4,8
Twopawshunta,tichondrius,384,hunter,beastmastery,12,4,8
Päinal,area-52,384,hunter,beastmastery,12,4,8
Killatrap,malganis,384,hunter,beastmastery,12,4,8
Xcisiion,nagrand,384,hunter,beastmastery,12,4,8
Atheranni,azralon,384,hunter,beastmastery,12,4,8
Boomseed,nagrand,384,hunter,beastmastery,12,4,8
Moùrningwood,stormrage,384,hunter,beastmastery,12,4,8
Heparinqt,area-52,384,hunter,beastmastery,12,4,8
Iyne,stormrage,384,hunter,beastmastery,12,4,8
Bagodonuts,malganis,384,hunter,beastmastery,12,4,8
Devastavi,proudmoore,384,hunter,beastmastery,12,4,8
Bangerzx,stormrage,384,hunter,beastmastery,12,4,8
Throwadox,malganis,384,hunter,beastmastery,12,4,8
Bówjòb,nordrassil,384,hunter,beastmastery,12,4,8
Inetpub,stormrage,384,hunter,beastmastery,12,4,8
Sèasons,tichondrius,384,hunter,beastmastery,15,4,11
Katiepie,frostmourne,384,hunter,beastmastery,18,4,14
Ruffini,tichondrius,384,hunter,beastmastery,18,4,14
Löö,arthas,384,hunter,beastmastery,23,4,19
Eeremm,drakkari,383,hunter,beastmastery,6,4,2
Bboo,bonechewer,383,hunter,beastmastery,6,4,2
Paulayork,drakthul,383,hunter,beastmastery,6,4,2
Gichiwalrus,emerald-dream,383,hunter,beastmastery,6,4,2
Àléç,mannoroth,383,hunter,beastmastery,12,4,8
Terusa,ragnaros,383,hunter,beastmastery,12,4,8
Lazygnome,azshara,383,hunter,beastmastery,12,4,8
Taedulos,azralon,383,hunter,beastmastery,12,4,8
Böwjøb,illidan,383,hunter,beastmastery,12,4,8
Beatnyou,tichondrius,383,hunter,beastmastery,12,4,8
Xeriife,stormrage,383,hunter,beastmastery,13,4,9
Etb,bleeding-hollow,382,hunter,beastmastery,12,4,8
Vastiks,dalaran,382,hunter,beastmastery,14,4,10
Euclase,bleeding-hollow,377,hunter,beastmastery,11,6,5
Clinkz,chogall,351,hunter,beastmastery,11,4,7
Sadarrow,frostmourne,334,hunter,beastmastery,11,4,7
Aluminumfoil,kelthuzad,319,hunter,beastmastery,5,4,1
Dayneryz,quelthalas,319,hunter,beastmastery,14,4,10
Cluhaywood,zuljin,288,hunter,beastmastery,6,3,3
Saynice,warsong,288,hunter,beastmastery,6,3,3
Britannian,moon-guard,288,hunter,beastmastery,6,3,3
Valintine,the-scryers,288,hunter,beastmastery,6,3,3
Burguir,ragnaros,288,hunter,beastmastery,6,3,3
Braxigarr,area-52,288,hunter,beastmastery,6,3,3
Norgalys,proudmoore,288,hunter,beastmastery,6,3,3
Ljai,gilneas,288,hunter,beastmastery,6,3,3
Deahtgab,ragnaros,288,hunter,beastmastery,6,3,3
Perfectcrit,area-52,288,hunter,beastmastery,6,3,3
Firskin,frostmourne,288,hunter,beastmastery,6,3,3
Adapted,proudmoore,288,hunter,beastmastery,6,3,3
Chrisp,bloodhoof,288,hunter,beastmastery,6,3,3
Dbrickashaw,proudmoore,288,hunter,beastmastery,6,3,3
Emart,bloodhoof,288,hunter,beastmastery,6,3,3
Popshotz,khazgoroth,288,hunter,beastmastery,6,3,3
Bro,malorne,288,hunter,beastmastery,6,3,3
Bmsurvmm,tichondrius,288,hunter,beastmastery,6,3,3
Xerosa,emerald-dream,288,hunter,beastmastery,6,3,3
Nytefell,skullcrusher,288,hunter,beastmastery,6,3,3
Elyssandrá,thrall,288,hunter,beastmastery,6,3,3
Siimmplicitz,area-52,288,hunter,beastmastery,6,3,3
Trixex,darkspear,288,hunter,beastmastery,6,3,3
Enonoa,thunderlord,288,hunter,beastmastery,6,3,3
Tus,tichondrius,288,hunter,beastmastery,6,3,3
Thirtyeight,blades-edge,288,hunter,beastmastery,6,3,3
Terrygross,sargeras,288,hunter,beastmastery,6,3,3
Orqism,tichondrius,288,hunter,beastmastery,6,3,3
Vicarnam,uldum,288,hunter,beastmastery,6,3,3
Teaa,dalaran,288,hunter,beastmastery,6,3,3
Gølin,aerie-peak,288,hunter,beastmastery,6,3,3
Rachetbutt,tichondrius,288,hunter,beastmastery,6,3,3
Vinksy,sargeras,288,hunter,beastmastery,6,3,3
Mastasnipa,illidan,288,hunter,beastmastery,6,3,3
Jetzy,illidan,288,hunter,beastmastery,6,3,3
Aldurion,wyrmrest-accord,288,hunter,beastmastery,6,3,3
Wannakill,stormrage,288,hunter,beastmastery,6,3,3
Vicluvv,stormrage,288,hunter,beastmastery,6,3,3
Wanshöt,tichondrius,288,hunter,beastmastery,6,3,3
Shøz,wyrmrest-accord,288,hunter,beastmastery,6,3,3
Playnogames,moon-guard,288,hunter,beastmastery,6,3,3
Zeroday,emerald-dream,288,hunter,beastmastery,6,3,3
Loktarnum,illidan,288,hunter,beastmastery,6,3,3
Morenarösa,nemesis,288,hunter,beastmastery,6,3,3
Mogradme,shadowsong,288,hunter,beastmastery,6,3,3
Billcsbyswtr,sargeras,288,hunter,beastmastery,6,3,3
Cummis,skullcrusher,288,hunter,beastmastery,6,3,3
Therealgam,the-underbog,288,hunter,beastmastery,6,3,3
Stonehard,mugthol,288,hunter,beastmastery,6,3,3
Tacos,kelthuzad,288,hunter,beastmastery,6,3,3
Suetyic,tichondrius,288,hunter,beastmastery,6,3,3
Relaxnerd,antonidas,288,hunter,beastmastery,6,3,3
Stimpblimp,jubeithos,288,hunter,beastmastery,6,3,3
Calypso,chromaggus,288,hunter,beastmastery,6,3,3
Latrampoza,quelthalas,288,hunter,beastmastery,6,3,3
Yoyoletsgo,malganis,288,hunter,beastmastery,6,3,3
Nexxa,muradin,288,hunter,beastmastery,6,3,3
Díllý,area-52,288,hunter,beastmastery,6,3,3
Soberish,bleeding-hollow,288,hunter,beastmastery,6,3,3
Shyck,ragnaros,288,hunter,beastmastery,6,3,3
Frenzygirl,azralon,288,hunter,beastmastery,6,3,3
Vikshen,illidan,288,hunter,beastmastery,6,3,3
Raainha,stormrage,288,hunter,beastmastery,6,3,3
Tetzuo,illidan,288,hunter,beastmastery,6,3,3
Mynds,stormrage,288,hunter,beastmastery,6,3,3
Acres,emerald-dream,288,hunter,beastmastery,6,3,3
Tibineids,stormrage,288,hunter,beastmastery,6,3,3
Gudlukk,stormrage,288,hunter,beastmastery,6,3,3
Cefla,illidan,288,hunter,beastmastery,6,3,3
Spídër,maiev,288,hunter,beastmastery,9,3,6
Hazzlôk,cairne,288,hunter,beastmastery,10,3,7
Xxo,frostmourne,288,hunter,beastmastery,11,3,8
Nikå,ragnaros,288,hunter,beastmastery,12,3,9
Leggodex,caelestrasz,288,hunter,beastmastery,12,3,9
Toozz,frostmourne,288,hunter,beastmastery,12,3,9
Hohohohahah,gallywix,288,hunter,beastmastery,12,3,9
Lastanar,amanthul,288,hunter,beastmastery,12,3,9
Kharthorin,moon-guard,288,hunter,beastmastery,12,3,9
Kniightjayyx,kelthuzad,288,hunter,beastmastery,12,3,9
Thiande,zuljin,288,hunter,beastmastery,12,3,9
Dunkam,quelthalas,288,hunter,beastmastery,12,3,9
Tanrith,dark-iron,288,hunter,beastmastery,12,3,9
Rinasonline,sargeras,288,hunter,beastmastery,12,3,9
Harÿn,nemesis,288,hunter,beastmastery,12,3,9
Tarah,lightbringer,288,hunter,beastmastery,12,3,9
Rice,veknilash,288,hunter,beastmastery,12,3,9
Natnat,sargeras,288,hunter,beastmastery,12,3,9
Fiznits,nerzhul,288,hunter,beastmastery,12,3,9
Dodirty,laughing-skull,288,hunter,beastmastery,12,3,9
Digsites,emerald-dream,288,hunter,beastmastery,12,3,9
Rooman,ragnaros,288,hunter,beastmastery,12,3,9
Lunarlunar,khadgar,288,hunter,beastmastery,18,3,15
Ledan,lightnings-blade,287,hunter,beastmastery,6,3,3
Arin,suramar,287,hunter,beastmastery,12,3,9
Darkally,blades-edge,285,hunter,beastmastery,12,3,9
Kargathx,ragnaros,281,hunter,beastmastery,14,5,9
Salurian,destromath,271,hunter,beastmastery,11,3,8
Bulszeye,azgalor,255,hunter,beastmastery,8,4,4
Tearsofnoobs,tichondrius,255,hunter,beastmastery,9,4,5
Busch,blood-furnace,255,hunter,beastmastery,11,3,8
Pokeyourbutt,hydraxis,240,hunter,beastmastery,15,3,12
Diisdik,tichondrius,239,hunter,beastmastery,5,3,2
Djcummyfeet,stormrage,234,hunter,beastmastery,17,6,11
Punjisticks,tichondrius,223,hunter,beastmastery,8,3,5
Llachiip,zuljin,192,hunter,beastmastery,4,3,1
Warplaquee,zuljin,192,hunter,beastmastery,6,2,4
Ikiteforfood,zuljin,192,hunter,beastmastery,6,2,4
Kansolly,tichondrius,192,hunter,beastmastery,6,2,4
Pathofsexile,tichondrius,192,hunter,beastmastery,6,2,4
Viracha,stormrage,192,hunter,beastmastery,6,2,4
Chømp,tichondrius,192,hunter,beastmastery,6,2,4
Snoogen,illidan,192,hunter,beastmastery,6,2,4
Solderboi,tichondrius,192,hunter,beastmastery,6,2,4
Monffbc,tichondrius,192,hunter,beastmastery,6,2,4
Zarknoth,cenarius,192,hunter,beastmastery,6,2,4
Snaken,the-forgotten-coast,192,hunter,beastmastery,6,2,4
Smallsouljah,demon-soul,192,hunter,beastmastery,6,2,4
Varianhunter,kelthuzad,192,hunter,beastmastery,6,2,4
Caligar,tichondrius,192,hunter,beastmastery,6,2,4
Nerfthepet,blackrock,192,hunter,beastmastery,6,2,4
Shådé,stormrage,192,hunter,beastmastery,6,2,4
Nflmaster,malganis,192,hunter,beastmastery,6,2,4
Pfheign,area-52,192,hunter,beastmastery,6,2,4
Twocranes,tichondrius,192,hunter,beastmastery,6,2,4
Nubcaks,nerzhul,192,hunter,beastmastery,6,2,4
Csadark,nemesis,192,hunter,beastmastery,6,2,4
Hötdôg,kiljaeden,192,hunter,beastmastery,6,2,4
Nahzah,stormrage,192,hunter,beastmastery,6,2,4
Gunwalk,azjolnerub,192,hunter,beastmastery,6,2,4
Arteene,illidan,192,hunter,beastmastery,6,2,4
Raphgun,stormrage,192,hunter,beastmastery,6,2,4
Rhyzen,drenden,192,hunter,beastmastery,6,2,4
Purpreynolds,tichondrius,192,hunter,beastmastery,6,2,4
Artemisa,warsong,192,hunter,beastmastery,6,2,4
Jämmëdclïp,emerald-dream,192,hunter,beastmastery,6,2,4
Flor,boulderfist,192,hunter,beastmastery,6,2,4
Hüh,area-52,192,hunter,beastmastery,6,2,4
Ivanjackenov,illidan,192,hunter,beastmastery,6,2,4
Ussy,area-52,192,hunter,beastmastery,6,2,4
Barrelsofrum,illidan,192,hunter,beastmastery,6,2,4
Xavííer,tichondrius,192,hunter,beastmastery,6,2,4
Survenant,zuljin,192,hunter,beastmastery,6,2,4
Doves,wyrmrest-accord,192,hunter,beastmastery,6,2,4
Ganderion,sargeras,192,hunter,beastmastery,6,2,4
Skillvanas,stormrage,192,hunter,beastmastery,6,2,4
Blickymon,wyrmrest-accord,192,hunter,beastmastery,6,2,4
Ratfood,tichondrius,192,hunter,beastmastery,6,2,4
Zoopdapoop,dalaran,192,hunter,beastmastery,6,2,4
Trailbreaker,trollbane,192,hunter,beastmastery,6,2,4
Totolol,trollbane,192,hunter,beastmastery,6,2,4
Notoffended,sargeras,192,hunter,beastmastery,6,2,4
Ariais,zangarmarsh,192,hunter,beastmastery,6,2,4
Impërïum,zuljin,192,hunter,beastmastery,6,2,4
Verzoz,illidan,192,hunter,beastmastery,6,2,4
Csantana,sargeras,192,hunter,beastmastery,6,2,4
Etarie,malganis,192,hunter,beastmastery,6,2,4
Equipmunk,arthas,192,hunter,beastmastery,6,2,4
Åî,tichondrius,192,hunter,beastmastery,6,2,4
Survbot,malganis,192,hunter,beastmastery,6,2,4
Ratbasterrd,darkspear,192,hunter,beastmastery,6,2,4
Cufless,proudmoore,192,hunter,beastmastery,6,2,4
Camfeed,illidan,192,hunter,beastmastery,6,2,4
Seenobody,stormrage,192,hunter,beastmastery,6,2,4
Elfinballz,khadgar,192,hunter,beastmastery,6,2,4
Capnjack,hyjal,192,hunter,beastmastery,6,2,4
Lissavi,tichondrius,192,hunter,beastmastery,6,2,4
Ownyoufast,darkspear,192,hunter,beastmastery,6,2,4
Harrowin,area-52,192,hunter,beastmastery,6,2,4
Grøøves,dalaran,192,hunter,beastmastery,6,2,4
Clütch,darkspear,192,hunter,beastmastery,6,2,4
Hìrcine,nesingwary,192,hunter,beastmastery,6,2,4
Pressbro,tichondrius,192,hunter,beastmastery,6,2,4
Bazanguita,tichondrius,192,hunter,beastmastery,6,2,4
Skillhunter,tichondrius,192,hunter,beastmastery,6,2,4
Snoozee,emerald-dream,192,hunter,beastmastery,6,2,4
Dnicee,stormrage,192,hunter,beastmastery,6,2,4
Autoshotxprt,frostmourne,192,hunter,beastmastery,6,2,4
Diacachimbaa,ragnaros,192,hunter,beastmastery,6,2,4
Shootermgavn,frostmourne,192,hunter,beastmastery,6,2,4
Munrrack,ragnaros,192,hunter,beastmastery,6,2,4
Illrannevian,garrosh,192,hunter,beastmastery,6,2,4
Mojito,frostmourne,192,hunter,beastmastery,6,2,4
Jumeog,stormscale,192,hunter,beastmastery,6,2,4
Fjdominador,azralon,192,hunter,beastmastery,6,2,4
Nanotorque,moon-guard,192,hunter,beastmastery,6,2,4
Noahxkhalel,azralon,192,hunter,beastmastery,6,2,4
Nevon,azralon,192,hunter,beastmastery,6,2,4
Graatata,shandris,192,hunter,beastmastery,6,2,4
Revalay,emerald-dream,192,hunter,beastmastery,6,2,4
Alikay,ragnaros,192,hunter,beastmastery,6,2,4
Sativ,moknathal,192,hunter,beastmastery,6,2,4
Dirtymongrel,barthilas,192,hunter,beastmastery,6,2,4
Neverwipes,frostmourne,192,hunter,beastmastery,6,2,4
Frìtz,barthilas,192,hunter,beastmastery,6,2,4
Arrowzpeckt,tichondrius,192,hunter,beastmastery,12,2,10
Jezoo,frostmourne,192,hunter,beastmastery,12,2,10
Meetdmonster,illidan,192,hunter,beastmastery,12,2,10
Ullr,gurubashi,192,hunter,beastmastery,12,2,10
Khabul,area-52,192,hunter,beastmastery,12,2,10
Ijii,tichondrius,192,hunter,beastmastery,12,2,10
Tánsøxøxø,tichondrius,192,hunter,beastmastery,12,2,10
Recebaa,barthilas,191,hunter,beastmastery,6,2,4
Moapax,azralon,191,hunter,beastmastery,6,2,4
Aiilton,gallywix,191,hunter,beastmastery,6,2,4
Malthiz,antonidas,191,hunter,beastmastery,6,2,4
Linszsz,nemesis,169,hunter,beastmastery,11,4,7
Zock,lothar,160,hunter,beastmastery,10,2,8
Helikaon,deathwing,159,hunter,beastmastery,5,2,3
Skrìms,tichondrius,159,hunter,beastmastery,5,2,3
Glediator,tichondrius,144,hunter,beastmastery,9,2,7
Lele,stormrage,138,hunter,beastmastery,8,4,4
ßowjõbs,tichondrius,128,hunter,beastmastery,4,2,2
Laviè,tichondrius,112,hunter,beastmastery,4,3,1
Facerolled,area-52,96,hunter,beastmastery,3,2,1
Jeonghun,tichondrius,96,hunter,beastmastery,3,2,1
Katherìnelol,tichondrius,96,hunter,beastmastery,3,2,1
Nakyash,ragnaros,96,hunter,beastmastery,3,2,1
Auset,aegwynn,96,hunter,beastmastery,6,1,5
Tiraa,kelthuzad,96,hunter,beastmastery,6,1,5
Dusle,azralon,96,hunter,beastmastery,6,1,5
Wixyy,aegwynn,96,hunter,beastmastery,6,1,5
Nachtcloverr,stormrage,96,hunter,beastmastery,6,1,5
Ãmi,moon-guard,96,hunter,beastmastery,6,1,5
Oldmandave,stormrage,96,hunter,beastmastery,6,1,5
Sobala,azralon,96,hunter,beastmastery,6,1,5
Boido,ghostlands,96,hunter,beastmastery,6,1,5
Physical,destromath,96,hunter,beastmastery,6,1,5
Appä,lightnings-blade,96,hunter,beastmastery,6,1,5
Bigpie,daggerspine,96,hunter,beastmastery,6,1,5
Cophunter,tichondrius,96,hunter,beastmastery,6,1,5
Panm,runetotem,96,hunter,beastmastery,6,1,5
Varag,amanthul,96,hunter,beastmastery,6,1,5
Kurmojo,hyjal,96,hunter,beastmastery,6,1,5
Spitballa,emerald-dream,96,hunter,beastmastery,6,1,5
Allgasnocap,kelthuzad,96,hunter,beastmastery,6,1,5
Xcopel,azralon,96,hunter,beastmastery,6,1,5
Sashagreen,frostmourne,96,hunter,beastmastery,6,1,5
Wamion,zuljin,96,hunter,beastmastery,6,1,5
Warpedshots,malganis,96,hunter,beastmastery,6,1,5
Bertiebott,zuljin,96,hunter,beastmastery,6,1,5
Jabbar,bleeding-hollow,96,hunter,beastmastery,6,1,5
Xclaw,llane,96,hunter,beastmastery,6,1,5
Percival,firetree,96,hunter,beastmastery,6,1,5
Penelòpe,wyrmrest-accord,96,hunter,beastmastery,6,1,5
Ilîiìîìiilil,bleeding-hollow,96,hunter,beastmastery,6,1,5
Dampteeth,sargeras,96,hunter,beastmastery,6,1,5
Muckenfoose,frostmourne,96,hunter,beastmastery,6,1,5
Opsi,ragnaros,96,hunter,beastmastery,6,1,5
Kok,andorhal,96,hunter,beastmastery,6,1,5
Poonbaddy,kiljaeden,96,hunter,beastmastery,6,1,5
Murk,spirestone,96,hunter,beastmastery,6,1,5
Båttousai,kiljaeden,96,hunter,beastmastery,6,1,5
Bithiáh,quelthalas,96,hunter,beastmastery,6,1,5
Rexxiga,kiljaeden,96,hunter,beastmastery,6,1,5
Cocobread,stormreaver,96,hunter,beastmastery,6,1,5
Carot,dalaran,96,hunter,beastmastery,6,1,5
Henhøuse,illidan,96,hunter,beastmastery,6,1,5
Ballinpotato,tichondrius,96,hunter,beastmastery,6,1,5
Darkhunterr,tichondrius,96,hunter,beastmastery,6,1,5
Espaada,tichondrius,96,hunter,beastmastery,6,1,5
Sóggybóxers,tichondrius,96,hunter,beastmastery,6,1,5
Bosshunt,whisperwind,96,hunter,beastmastery,6,1,5
Robious,tichondrius,96,hunter,beastmastery,6,1,5
Bendotexe,stormrage,96,hunter,beastmastery,7,1,6
Trushôtz,tichondrius,96,hunter,beastmastery,11,1,10
Tydee,nagrand,96,hunter,beastmastery,12,1,11
Jijiyoyo,tichondrius,96,hunter,beastmastery,12,1,11
Boomup,tichondrius,96,hunter,beastmastery,12,1,11
Leaii,thrall,95,hunter,beastmastery,6,1,5
Triggamikê,tichondrius,63,hunter,beastmastery,2,2,0
Onihanzo,thrall,63,hunter,beastmastery,2,2,0
Montano,area-52,63,hunter,beastmastery,2,2,0
Falsifier,ragnaros,48,hunter,beastmastery,3,1,2
Memorypet,proudmoore,48,hunter,beastmastery,3,1,2
Yory,tol-barad,48,hunter,beastmastery,3,1,2
Vyalaris,emerald-dream,48,hunter,beastmastery,3,1,2
Bowjoblul,stormrage,42,hunter,beastmastery,9,2,7
Dadhatesme,stormrage,31,hunter,beastmastery,2,1,1
Khillin,destromath,31,hunter,beastmastery,2,1,1
Voladren,moon-guard,31,hunter,beastmastery,2,1,1
Numbing,sargeras,2233,mage,arcane,100,54,46
Cvark,sargeras,2123,mage,arcane,76,45,31
Venruki,tichondrius,2035,mage,arcane,63,36,27
Junglejape,tichondrius,1967,mage,arcane,54,35,19
Hallat,archimonde,1939,mage,arcane,141,75,66
Ktp,tichondrius,1860,mage,arcane,42,23,19
Vampìrelolz,tichondrius,1809,mage,arcane,48,26,22
Elfmage,tichondrius,1777,mage,arcane,30,19,11
Bíscuít,illidan,1770,mage,arcane,100,53,47
Lmaginedying,illidan,1715,mage,arcane,30,24,6
Birdfather,tichondrius,1695,mage,arcane,30,23,7
Bambambilly,kelthuzad,1683,mage,arcane,36,18,18
Snortmeth,area-52,1679,mage,arcane,48,32,16
Clutchy,gorefiend,1672,mage,arcane,42,29,13
Ligmmah,stormrage,1672,mage,arcane,36,21,15
Nyj,tichondrius,1662,mage,arcane,35,21,14
Proximalol,tichondrius,1610,mage,arcane,36,20,16
Zhanna,nazjatar,1566,mage,arcane,66,34,32
Primearcanis,tol-barad,1555,mage,arcane,42,19,23
Dbox,stormscale,1549,mage,arcane,58,32,26
Lucidaze,daggerspine,1546,mage,arcane,68,35,33
Felsparkles,area-52,1541,mage,arcane,36,20,16
Perrc,area-52,1535,mage,arcane,66,34,32
Delibro,tichondrius,1523,mage,arcane,28,17,11
Agoniey,illidan,1498,mage,arcane,71,34,37
Sáron,quelthalas,1488,mage,arcane,42,25,17
Missile,frostmourne,1472,mage,arcane,30,16,14
Linkolni,azralon,1470,mage,arcane,48,28,20
Somariais,illidan,1469,mage,arcane,36,20,16
Magecombe,thrall,1436,mage,arcane,24,15,9
Hustle,frostmourne,1426,mage,arcane,36,18,18
Strêss,kelthuzad,1414,mage,arcane,88,48,40
Véyda,emerald-dream,1378,mage,arcane,36,21,15
Melkdud,wyrmrest-accord,1341,mage,arcane,24,14,10
Ruzam,area-52,1326,mage,arcane,60,29,31
Szrp,stormrage,1306,mage,arcane,45,20,25
Draell,drakkari,1301,mage,arcane,54,30,24
Jedamere,proudmoore,1300,mage,arcane,30,16,14
Airbnb,area-52,1274,mage,arcane,23,15,8
Chëryl,proudmoore,1267,mage,arcane,52,24,28
Hennimage,sargeras,1266,mage,arcane,36,20,16
Thewizârd,stormrage,1255,mage,arcane,107,59,48
Bananappeal,kelthuzad,1243,mage,arcane,30,13,17
Dmgperseç,tichondrius,1241,mage,arcane,18,13,5
Antifreezex,tichondrius,1227,mage,arcane,41,25,16
Unlike,sargeras,1227,mage,arcane,54,20,34
Skywalkerino,azralon,1199,mage,arcane,101,51,50
Gryd,area-52,1193,mage,arcane,60,33,27
Juicemage,tichondrius,1152,mage,arcane,24,12,12
Sestren,zuljin,1150,mage,arcane,24,12,12
Zps,illidan,1147,mage,arcane,24,12,12
Coôler,illidan,1134,mage,arcane,33,13,20
Gessin,area-52,1111,mage,arcane,58,24,34
Klausgc,sargeras,1084,mage,arcane,20,12,8
Arcanemagek,tichondrius,1056,mage,arcane,12,11,1
Oneschool,sargeras,1056,mage,arcane,24,11,13
Spellsteål,malganis,1055,mage,arcane,12,11,1
Dawitchery,illidan,1055,mage,arcane,24,11,13
Exterminatüs,tichondrius,1052,mage,arcane,30,11,19
Astrojrue,sargeras,1049,mage,arcane,23,11,12
Avandal,proudmoore,1019,mage,arcane,23,11,12
Tsarevich,fizzcrank,1018,mage,arcane,24,11,13
Raeign,frostmourne,986,mage,arcane,89,42,47
Smoks,stormrage,973,mage,arcane,26,12,14
Nightsaber,blackrock,960,mage,arcane,12,10,2
Windwìtch,quelthalas,960,mage,arcane,18,10,8
Mokelovin,sargeras,959,mage,arcane,18,10,8
Hööva,illidan,959,mage,arcane,18,10,8
Haze,hyjal,955,mage,arcane,18,10,8
Themagicman,whisperwind,954,mage,arcane,24,10,14
Orderlight,alexstrasza,954,mage,arcane,24,10,14
Tagere,moon-guard,954,mage,arcane,24,10,14
Khierlana,hellscream,935,mage,arcane,60,25,35
Oyagi,moon-guard,926,mage,arcane,30,10,20
Dietdeww,borean-tundra,913,mage,arcane,18,10,8
Ezchallenger,undermine,864,mage,arcane,18,9,9
Jazzgroyper,sargeras,864,mage,arcane,18,9,9
Wïzarduous,mannoroth,863,mage,arcane,12,9,3
Pandazed,proudmoore,863,mage,arcane,18,9,9
Alode,moon-guard,862,mage,arcane,12,9,3
Sherian,queldorei,832,mage,arcane,18,9,9
Whiterice,zuljin,831,mage,arcane,14,10,4
Jööz,deathwing,768,mage,arcane,18,8,10
Tommagic,tichondrius,768,mage,arcane,18,8,10
Eludin,aegwynn,768,mage,arcane,18,8,10
Watchmepog,tichondrius,767,mage,arcane,12,8,4
Shmage,dragonmaw,767,mage,arcane,12,8,4
Balencii,kiljaeden,767,mage,arcane,12,8,4
Fakebusiness,area-52,767,mage,arcane,18,8,10
Boredmoomoo,thunderlord,765,mage,arcane,12,8,4
Archtype,azralon,764,mage,arcane,18,8,10
Aycc,tichondrius,735,mage,arcane,17,8,9
Enthy,frostmourne,672,mage,arcane,18,7,11
Zezima,spirestone,671,mage,arcane,12,7,5
Ankidar,quelthalas,671,mage,arcane,18,7,11
Warthormage,stormrage,670,mage,arcane,12,7,5
Lünå,onyxia,670,mage,arcane,12,7,5
Zimzum,bladefist,666,mage,arcane,12,7,5
Waisted,kelthuzad,654,mage,arcane,13,8,5
Wizzyx,illidan,639,mage,arcane,16,8,8
Chezzmasterx,misha,638,mage,arcane,16,8,8
Harshx,bleeding-hollow,576,mage,arcane,12,6,6
Ject,ragnaros,576,mage,arcane,12,6,6
Söngs,goldrinn,575,mage,arcane,12,6,6
Mageyoulooks,kelthuzad,575,mage,arcane,18,6,12
Greenwise,illidan,574,mage,arcane,12,6,6
Cassanara,moon-guard,574,mage,arcane,12,6,6
Enfuegoe,tichondrius,571,mage,arcane,12,6,6
Waef,quelthalas,571,mage,arcane,12,6,6
Esien,tichondrius,522,mage,arcane,20,7,13
Diamondx,ragnaros,480,mage,arcane,12,5,7
Wauzcrol,quelthalas,480,mage,arcane,12,5,7
Dagreatone,malganis,480,mage,arcane,12,5,7
Sceledrus,quelthalas,479,mage,arcane,12,5,7
Merlon,dalaran,476,mage,arcane,12,5,7
Cyphen,proudmoore,384,mage,arcane,6,4,2
Dogmagetw,tichondrius,384,mage,arcane,6,4,2
Fearhades,drakkari,384,mage,arcane,6,4,2
Wanming,tichondrius,384,mage,arcane,6,4,2
Jordèb,sargeras,384,mage,arcane,6,4,2
Parapio,tichondrius,384,mage,arcane,6,4,2
Garrieto,sargeras,384,mage,arcane,6,4,2
Lightsoran,tichondrius,384,mage,arcane,6,4,2
Chilléd,tichondrius,384,mage,arcane,6,4,2
Magicos,frostmourne,384,mage,arcane,6,4,2
Tuggernaug,malganis,384,mage,arcane,6,4,2
Fredcouples,tichondrius,384,mage,arcane,6,4,2
Morkleen,korgath,384,mage,arcane,12,4,8
Biotic,kiljaeden,384,mage,arcane,12,4,8
Hogslop,saurfang,384,mage,arcane,12,4,8
Khaldyn,tichondrius,384,mage,arcane,12,4,8
Bigbuttangel,borean-tundra,384,mage,arcane,12,4,8
Forestella,tichondrius,384,mage,arcane,12,4,8
Scxut,tichondrius,384,mage,arcane,12,4,8
Kogin,thrall,288,mage,arcane,6,3,3
Snoogma,illidan,288,mage,arcane,6,3,3
Watchmesleep,tichondrius,288,mage,arcane,6,3,3
Zerodium,sargeras,288,mage,arcane,6,3,3
Aeghis,stormrage,288,mage,arcane,6,3,3
Madpoondog,frostmourne,288,mage,arcane,6,3,3
Pwnstarx,proudmoore,288,mage,arcane,6,3,3
Insulting,aerie-peak,288,mage,arcane,6,3,3
Natzue,sargeras,288,mage,arcane,6,3,3
Myrondor,tichondrius,288,mage,arcane,6,3,3
Jizzlez,tichondrius,288,mage,arcane,6,3,3
Gin,nemesis,288,mage,arcane,6,3,3
Adrazell,sargeras,288,mage,arcane,6,3,3
Shäräpova,zuljin,288,mage,arcane,6,3,3
Milfmaster,aerie-peak,288,mage,arcane,6,3,3
Heflash,azralon,288,mage,arcane,6,3,3
Unknownblast,kul-tiras,288,mage,arcane,6,3,3
Spart,runetotem,288,mage,arcane,11,3,8
Elux,whisperwind,288,mage,arcane,12,3,9
Hogdog,illidan,288,mage,arcane,12,3,9
Matmagic,drakkari,288,mage,arcane,13,3,10
Kryptekk,area-52,287,mage,arcane,6,3,3
Calcaster,aegwynn,287,mage,arcane,6,3,3
Cokézero,frostmourne,287,mage,arcane,12,3,9
Shadows,exodar,287,mage,arcane,12,3,9
Grarg,stormrage,286,mage,arcane,6,3,3
Karamzov,zuljin,286,mage,arcane,12,3,9
Etyx,tichondrius,239,mage,arcane,5,3,2
Blastgodx,stormrage,192,mage,arcane,6,2,4
Mastablastar,windrunner,192,mage,arcane,6,2,4
Alìv,tichondrius,192,mage,arcane,6,2,4
Caimil,echo-isles,192,mage,arcane,6,2,4
Nesomage,destromath,192,mage,arcane,6,2,4
Noescaping,illidan,192,mage,arcane,6,2,4
Sheepshot,dentarg,192,mage,arcane,6,2,4
Vensyr,stormrage,192,mage,arcane,6,2,4
Clernlol,emerald-dream,192,mage,arcane,6,2,4
Opiumlord,tichondrius,192,mage,arcane,6,2,4
Icebish,skullcrusher,192,mage,arcane,6,2,4
Fakelovè,area-52,192,mage,arcane,6,2,4
Mymaage,andorhal,192,mage,arcane,6,2,4
Chinkins,illidan,192,mage,arcane,6,2,4
Akunimon,ragnaros,192,mage,arcane,6,2,4
Kevymarts,tichondrius,192,mage,arcane,6,2,4
Nekrobear,nemesis,192,mage,arcane,6,2,4
Xpez,stormrage,192,mage,arcane,6,2,4
Dereliction,nagrand,192,mage,arcane,6,2,4
Vengx,tichondrius,192,mage,arcane,6,2,4
Xunalatu,frostmourne,192,mage,arcane,6,2,4
Crinkit,frostmourne,192,mage,arcane,6,2,4
Umber,dreadmaul,192,mage,arcane,6,2,4
Gatka,quelthalas,192,mage,arcane,12,2,10
Compactor,emerald-dream,192,mage,arcane,12,2,10
Purpledrank,nagrand,96,mage,arcane,9,2,7
Flomin,tichondrius,96,mage,arcane,6,1,5
Ignit,stormrage,96,mage,arcane,6,1,5
Illúmi,moon-guard,96,mage,arcane,6,1,5
Burrbon,area-52,96,mage,arcane,6,1,5
Derkrìeger,turalyon,96,mage,arcane,6,1,5
Mageki,ragnaros,96,mage,arcane,6,1,5
Needmyvape,moon-guard,96,mage,arcane,6,1,5
Pollybot,tichondrius,96,mage,arcane,6,1,5
Nazztwren,bleeding-hollow,96,mage,arcane,6,1,5
Bobalama,tichondrius,96,mage,arcane,6,1,5
Quinnfreeze,boulderfist,96,mage,arcane,6,1,5
Coldrin,tichondrius,96,mage,arcane,6,1,5
Nachtt,sargeras,96,mage,arcane,6,1,5
Trippy,senjin,96,mage,arcane,6,1,5
Humpadumplin,wyrmrest-accord,96,mage,arcane,6,1,5
Smôl,emerald-dream,96,mage,arcane,6,1,5
Krazsus,tichondrius,96,mage,arcane,6,1,5
Greaterbust,tichondrius,96,mage,arcane,12,1,11
Kralien,dalaran,95,mage,arcane,6,1,5
Frostmaul,dreadmaul,79,mage,arcane,11,1,10
Keepinitnoob,tichondrius,63,mage,arcane,2,2,0
Setback,illidan,2122,mage,fire,138,69,69
Taylorlol,tichondrius,2092,mage,fire,104,51,53
Vcamusorz,tichondrius,2068,mage,fire,94,54,40
Kasperkar,illidan,2014,mage,fire,186,95,91
Bigfirebat,tichondrius,2012,mage,fire,78,41,37
Xiaoxiaochu,tichondrius,1989,mage,fire,122,78,44
Talibandzx,sargeras,1985,mage,fire,99,46,53
Vazlgs,tichondrius,1933,mage,fire,66,40,26
Hansol,farstriders,1906,mage,fire,42,23,19
Valériemeow,tichondrius,1904,mage,fire,73,34,39
Yaya,kargath,1893,mage,fire,66,36,30
Icetomeetyu,bleeding-hollow,1893,mage,fire,88,45,43
Horoba,sargeras,1867,mage,fire,72,33,39
Aeghis,stormrage,1863,mage,fire,42,21,21
Ròÿ,area-52,1861,mage,fire,72,37,35
Csx,turalyon,1854,mage,fire,102,59,43
Rmxd,malganis,1848,mage,fire,60,35,25
Gohonn,emerald-dream,1847,mage,fire,69,41,28
Ksmackm,illidan,1842,mage,fire,65,34,31
Vampìrelolz,tichondrius,1828,mage,fire,47,25,22
Cinnablast,darkspear,1824,mage,fire,26,20,6
Degen,laughing-skull,1824,mage,fire,34,25,9
Fwooshinator,malganis,1823,mage,fire,71,56,15
Younghehe,tichondrius,1821,mage,fire,98,57,41
Juju,tichondrius,1803,mage,fire,57,36,21
Poundcakezx,tichondrius,1802,mage,fire,42,22,20
Dáddyshark,sargeras,1798,mage,fire,75,33,42
Undeadmerlin,zuljin,1774,mage,fire,48,27,21
Varroc,quelthalas,1774,mage,fire,52,29,23
Käxs,ragnaros,1762,mage,fire,42,21,21
Sorcerous,bloodhoof,1758,mage,fire,84,52,32
Highms,stormrage,1755,mage,fire,42,24,18
Creaystar,area-52,1750,mage,fire,83,42,41
Udmx,zuljin,1747,mage,fire,50,26,24
Volkazar,sargeras,1722,mage,fire,33,19,14
Zoryack,azralon,1718,mage,fire,54,28,26
Adjudicatory,tichondrius,1718,mage,fire,40,19,21
Snoogma,illidan,1702,mage,fire,35,25,10
Likebutter,tichondrius,1695,mage,fire,30,22,8
Tuniepop,sargeras,1683,mage,fire,48,26,22
Nickioxox,tichondrius,1674,mage,fire,24,18,6
Bighot,tichondrius,1673,mage,fire,90,53,37
Firewreckage,malganis,1655,mage,fire,48,24,24
Daddymayhem,proudmoore,1653,mage,fire,48,21,27
Sakurai,tichondrius,1651,mage,fire,42,27,15
Såni,tichondrius,1651,mage,fire,42,21,21
Trippy,senjin,1630,mage,fire,60,30,30
Opisop,kelthuzad,1621,mage,fire,36,20,16
Ööf,emerald-dream,1616,mage,fire,48,22,26
Ligmmah,stormrage,1615,mage,fire,36,22,14
Djpolymorph,stormrage,1614,mage,fire,52,34,18
Audacy,sargeras,1613,mage,fire,97,51,46
Fruitdealerr,tichondrius,1607,mage,fire,48,29,19
Zarkanis,tichondrius,1604,mage,fire,49,25,24
Garbagemage,barthilas,1602,mage,fire,60,33,27
Jardz,area-52,1597,mage,fire,42,21,21
Enthy,frostmourne,1595,mage,fire,42,21,21
Xs,stormrage,1583,mage,fire,102,59,43
Kev,sentinels,1581,mage,fire,54,31,23
Pootysmooch,sargeras,1574,mage,fire,42,24,18
Trolson,sargeras,1573,mage,fire,48,24,24
Hpthewizard,deathwing,1550,mage,fire,71,42,29
Magekylex,proudmoore,1544,mage,fire,84,51,33
Pòlly,illidan,1540,mage,fire,30,21,9
Fookz,malganis,1540,mage,fire,54,30,24
Thxo,hyjal,1534,mage,fire,37,18,19
Pyroshima,barthilas,1530,mage,fire,65,32,33
Myrondor,tichondrius,1529,mage,fire,60,31,29
Mushys,stormrage,1525,mage,fire,29,18,11
Notini,azralon,1525,mage,fire,36,16,20
Wotl,tichondrius,1518,mage,fire,50,24,26
Smallbrainz,emerald-dream,1515,mage,fire,30,21,9
Squantanimo,shadowmoon,1513,mage,fire,35,18,17
Marrioo,tichondrius,1511,mage,fire,30,17,13
Imannoyingha,darkspear,1510,mage,fire,71,37,34
Singheart,tichondrius,1510,mage,fire,66,33,33
Mager,dentarg,1508,mage,fire,62,40,22
Jundead,dalaran,1504,mage,fire,47,33,14
Oi,frostwolf,1504,mage,fire,30,20,10
Ålmøst,tichondrius,1493,mage,fire,47,30,17
Pzaz,moon-guard,1492,mage,fire,32,19,13
Worldonfire,ragnaros,1490,mage,fire,59,30,29
Lilbabyx,stormrage,1484,mage,fire,50,25,25
Teetems,sargeras,1478,mage,fire,90,44,46
Chickenspank,stormrage,1473,mage,fire,36,18,18
Yooyar,barthilas,1473,mage,fire,42,18,24
Schwenkyy,sargeras,1462,mage,fire,59,28,31
Eazzybaby,eredar,1453,mage,fire,117,65,52
Sparklepoof,tichondrius,1449,mage,fire,29,17,12
Bettybonk,cenarius,1449,mage,fire,42,20,22
Starxen,tichondrius,1439,mage,fire,24,15,9
Mariomario,tichondrius,1433,mage,fire,30,18,12
Murcury,tichondrius,1425,mage,fire,66,30,36
Lolololololo,kelthuzad,1416,mage,fire,108,51,57
Anàrchy,emerald-dream,1411,mage,fire,39,21,18
Eekzlol,illidan,1409,mage,fire,30,16,14
Jojomage,thrall,1403,mage,fire,64,32,32
Leonr,tichondrius,1395,mage,fire,35,21,14
Ruzam,area-52,1394,mage,fire,66,31,35
Ultrá,stormscale,1393,mage,fire,24,15,9
Hööva,illidan,1392,mage,fire,71,35,36
Purpscurp,illidan,1387,mage,fire,23,15,8
Sydrol,area-52,1387,mage,fire,60,31,29
Leaso,tichondrius,1384,mage,fire,45,22,23
Badaszbich,tichondrius,1344,mage,fire,36,20,16
Sorankim,tichondrius,1343,mage,fire,30,14,16
Iceward,frostmourne,1336,mage,fire,24,14,10
Smigui,azralon,1329,mage,fire,87,42,45
Mongomike,stormrage,1317,mage,fire,33,15,18
Holbrook,greymane,1316,mage,fire,43,21,22
Jjijuns,tichondrius,1302,mage,fire,40,18,22
Helcarwen,area-52,1292,mage,fire,48,25,23
Alzagen,ragnaros,1284,mage,fire,33,16,17
Ârcano,ragnaros,1267,mage,fire,26,14,12
Zulugara,barthilas,1258,mage,fire,36,19,17
Adronicus,tichondrius,1252,mage,fire,38,23,15
Peachygamer,stormscale,1246,mage,fire,30,13,17
Yorgøs,ragnaros,1245,mage,fire,24,13,11
Swaglo,illidan,1242,mage,fire,24,13,11
Feogato,proudmoore,1237,mage,fire,60,29,31
Politeness,tichondrius,1233,mage,fire,24,13,11
Abzy,sargeras,1233,mage,fire,42,19,23
Fíery,blades-edge,1227,mage,fire,60,27,33
Waffles,ravencrest,1221,mage,fire,46,18,28
Zinnos,tichondrius,1218,mage,fire,30,13,17
Archtype,azralon,1217,mage,fire,18,13,5
Genthruz,ragnaros,1205,mage,fire,30,14,16
Esfire,frostmourne,1185,mage,fire,48,23,25
Christjan,tichondrius,1172,mage,fire,96,48,48
Tamarolfrost,illidan,1158,mage,fire,19,13,6
Maxvila,kelthuzad,1152,mage,fire,18,12,6
Snaregodx,area-52,1151,mage,fire,18,12,6
Sunskim,tichondrius,1151,mage,fire,24,12,12
Wizarts,ragnaros,1150,mage,fire,30,12,18
Rhykx,malganis,1149,mage,fire,18,12,6
Dragonie,nordrassil,1147,mage,fire,30,14,16
Fleët,tichondrius,1139,mage,fire,18,12,6
Raynark,nemesis,1134,mage,fire,18,12,6
Gnarwallx,stormrage,1132,mage,fire,30,12,18
Wawakun,ragnaros,1127,mage,fire,30,14,16
Dexpy,tichondrius,1119,mage,fire,20,13,7
Xzilence,aerie-peak,1118,mage,fire,30,12,18
Sánzunokawa,quelthalas,1109,mage,fire,27,16,11
Nazmagus,hydraxis,1096,mage,fire,17,12,5
Jööz,deathwing,1096,mage,fire,27,12,15
Gempette,tichondrius,1095,mage,fire,23,12,11
Wazzerd,moon-guard,1093,mage,fire,27,12,15
Gradmage,proudmoore,1093,mage,fire,29,12,17
Guccilaflur,proudmoore,1082,mage,fire,27,12,15
Crnomage,area-52,1081,mage,fire,23,12,11
Kjuuler,moon-guard,1056,mage,fire,18,11,7
Zonmague,drakkari,1056,mage,fire,30,12,18
Lightsoran,tichondrius,1055,mage,fire,18,11,7
Dmgdaddy,zuljin,1055,mage,fire,24,11,13
Albbano,tichondrius,1054,mage,fire,18,11,7
Dreadparadox,bleeding-hollow,1054,mage,fire,18,11,7
Gigatuts,stormrage,1054,mage,fire,18,11,7
Biscobush,turalyon,1051,mage,fire,18,11,7
Cinns,moon-guard,1051,mage,fire,24,11,13
Purpledrank,nagrand,1049,mage,fire,24,11,13
Pyroflinger,stormrage,1049,mage,fire,24,11,13
Jizzlez,tichondrius,1048,mage,fire,24,11,13
Garungar,antonidas,1045,mage,fire,18,11,7
Coltrip,azralon,1017,mage,fire,23,11,12
Wickymorph,barthilas,1004,mage,fire,23,11,12
Hotjazzfarts,sargeras,1003,mage,fire,61,35,26
Endmepls,ysera,965,mage,fire,96,40,56
Mokelovin,sargeras,959,mage,fire,18,10,8
Mudohir,stormrage,959,mage,fire,18,10,8
Dârkus,sargeras,957,mage,fire,24,10,14
Osh,malorne,957,mage,fire,24,10,14
Dearasian,ragnaros,955,mage,fire,18,10,8
Sahala,frostmourne,955,mage,fire,24,10,14
Marajaade,tichondrius,955,mage,fire,27,11,16
Skoffla,executus,953,mage,fire,24,10,14
Hypernova,vashj,952,mage,fire,24,10,14
Abstractgoat,tichondrius,946,mage,fire,30,15,15
Vamkari,ragnaros,942,mage,fire,18,10,8
Coldarei,nagrand,928,mage,fire,27,12,15
Senegau,azralon,906,mage,fire,33,14,19
Dánó,lightbringer,896,mage,fire,56,25,31
Alaramaria,sargeras,886,mage,fire,18,10,8
Dorkski,bleeding-hollow,884,mage,fire,31,11,20
Formi,frostmourne,864,mage,fire,18,9,9
Charkoalzz,moon-guard,864,mage,fire,18,9,9
Gadgítte,moon-guard,863,mage,fire,12,9,3
Slumpgodd,frostmourne,863,mage,fire,18,9,9
Dabsx,moon-guard,863,mage,fire,18,9,9
Torched,stormreaver,863,mage,fire,24,9,15
Xanthan,runetotem,862,mage,fire,18,9,9
Zstyle,frostmourne,860,mage,fire,12,9,3
Neglect,moknathal,860,mage,fire,18,9,9
Fryry,dalaran,860,mage,fire,24,9,15
Halfsquad,malfurion,858,mage,fire,18,9,9
Freez,garona,858,mage,fire,21,10,11
Gadalka,frostmourne,857,mage,fire,18,9,9
Strêss,kelthuzad,830,mage,fire,14,10,4
Ripburn,stormrage,822,mage,fire,24,9,15
Coolhandz,tichondrius,814,mage,fire,17,9,8
Preceptør,azralon,768,mage,fire,12,8,4
Kraxos,stormrage,768,mage,fire,12,8,4
Castana,tichondrius,768,mage,fire,18,8,10
Shimmerpoly,sargeras,768,mage,fire,18,8,10
Avicci,shattered-halls,768,mage,fire,24,8,16
Kawailenard,tichondrius,767,mage,fire,12,8,4
Chainpoly,area-52,766,mage,fire,13,10,3
Ashenlad,moon-guard,766,mage,fire,18,8,10
Undedkev,tichondrius,761,mage,fire,24,8,16
Noescaping,illidan,759,mage,fire,18,8,10
Orianne,windrunner,750,mage,fire,12,8,4
Arcanemain,kargath,733,mage,fire,18,8,10
Shmagee,azralon,684,mage,fire,13,8,5
Tuggernaug,malganis,672,mage,fire,12,7,5
Wanming,tichondrius,672,mage,fire,12,7,5
Osirax,frostmane,672,mage,fire,12,7,5
Warpfactor,malganis,672,mage,fire,12,7,5
Sos,kelthuzad,672,mage,fire,12,7,5
Magicmaghar,area-52,672,mage,fire,12,7,5
Salvick,emerald-dream,672,mage,fire,12,7,5
Vastlord,stormrage,672,mage,fire,18,7,11
Bigdjohnson,dalaran,672,mage,fire,18,7,11
Juul,emerald-dream,672,mage,fire,18,7,11
Lucidaze,daggerspine,671,mage,fire,12,7,5
Ásune,moon-guard,671,mage,fire,12,7,5
Blastfire,stormrage,671,mage,fire,12,7,5
Kryptekk,area-52,671,mage,fire,18,7,11
Alàh,stormscale,671,mage,fire,18,7,11
Dreaming,draktharon,670,mage,fire,12,7,5
Dojacute,frostmourne,623,mage,fire,11,7,4
Slipqt,tichondrius,607,mage,fire,22,7,15
Rudeswizard,area-52,591,mage,fire,13,7,6
Grymorum,ragnaros,576,mage,fire,6,6,0
Wakamage,area-52,576,mage,fire,12,6,6
Stergenutfr,tichondrius,576,mage,fire,12,6,6
Omagawd,tichondrius,576,mage,fire,12,6,6
Frostboy,borean-tundra,576,mage,fire,12,6,6
Toteypotter,frostmourne,576,mage,fire,12,6,6
Darkisfrosty,tichondrius,576,mage,fire,12,6,6
Magination,frostmourne,576,mage,fire,12,6,6
Alunarassra,area-52,576,mage,fire,12,6,6
Stimml,blood-furnace,576,mage,fire,18,6,12
Zukoprince,azralon,575,mage,fire,6,6,0
Christensen,stormrage,575,mage,fire,12,6,6
Magja,bloodhoof,575,mage,fire,12,6,6
Spellpowa,khaz-modan,574,mage,fire,12,6,6
Adrazell,sargeras,574,mage,fire,18,6,12
Bobalama,tichondrius,574,mage,fire,18,6,12
Bàttlemage,nagrand,567,mage,fire,12,6,6
Béssie,area-52,565,mage,fire,12,6,6
Ashex,moon-guard,559,mage,fire,18,7,11
Benisp,stormrage,528,mage,fire,14,8,6
Babysharky,uther,512,mage,fire,16,6,10
Youezdawg,tichondrius,480,mage,fire,6,5,1
Streetember,nemesis,480,mage,fire,6,5,1
Hocusjokus,frostmourne,480,mage,fire,6,5,1
Ñïz,bleeding-hollow,480,mage,fire,6,5,1
Polypolypoly,kiljaeden,480,mage,fire,10,6,4
Dìus,malganis,480,mage,fire,12,5,7
Kyphosis,illidan,480,mage,fire,12,5,7
Skillcap,nagrand,480,mage,fire,12,5,7
Diamondx,ragnaros,480,mage,fire,12,5,7
Cumbus,stormrage,480,mage,fire,12,5,7
Entomas,quelthalas,480,mage,fire,12,5,7
Epod,illidan,480,mage,fire,12,5,7
Kqlyy,tichondrius,480,mage,fire,12,5,7
Kyriê,darkspear,480,mage,fire,12,5,7
Zerosaspect,thrall,480,mage,fire,12,5,7
Pugsmugg,icecrown,480,mage,fire,12,5,7
Arishasis,tichondrius,480,mage,fire,12,5,7
Baida,kelthuzad,480,mage,fire,12,5,7
Harlloo,the-underbog,480,mage,fire,12,5,7
Jikario,zuljin,480,mage,fire,12,5,7
Marther,whisperwind,480,mage,fire,12,5,7
Kevymarts,tichondrius,480,mage,fire,12,5,7
Arrcadia,darkspear,480,mage,fire,12,5,7
Tunax,tichondrius,480,mage,fire,18,5,13
Mageyoulooks,kelthuzad,480,mage,fire,18,5,13
Xunalatu,frostmourne,479,mage,fire,12,5,7
Shadowgalaxy,arthas,479,mage,fire,12,5,7
Xannymancan,tichondrius,479,mage,fire,24,5,19
Zendrix,bonechewer,478,mage,fire,12,5,7
Gwenage,tichondrius,472,mage,fire,12,5,7
Molassess,illidan,400,mage,fire,13,5,8
Shmoked,kelthuzad,384,mage,fire,6,4,2
Pyröz,kelthuzad,384,mage,fire,6,4,2
Fïtz,quelthalas,384,mage,fire,6,4,2
Floatyz,tichondrius,384,mage,fire,6,4,2
Kaylemage,tichondrius,384,mage,fire,6,4,2
Itshug,area-52,384,mage,fire,6,4,2
Pollybot,tichondrius,384,mage,fire,6,4,2
Squidio,stormrage,384,mage,fire,6,4,2
Haze,hyjal,384,mage,fire,6,4,2
Polymedaddi,tichondrius,384,mage,fire,6,4,2
Toastedoats,hyjal,384,mage,fire,6,4,2
Flavaflame,mugthol,384,mage,fire,6,4,2
Velvetlurker,tichondrius,384,mage,fire,6,4,2
Belven,proudmoore,384,mage,fire,6,4,2
Pherixsw,stormrage,384,mage,fire,6,4,2
Kataklyzm,illidan,384,mage,fire,6,4,2
Gominsi,tichondrius,384,mage,fire,6,4,2
Cømbust,frostmourne,384,mage,fire,6,4,2
Jazzgroyper,sargeras,384,mage,fire,6,4,2
Asönia,illidan,384,mage,fire,6,4,2
Insightæ,frostmourne,384,mage,fire,6,4,2
Ranj,tichondrius,384,mage,fire,12,4,8
Linkolni,azralon,384,mage,fire,12,4,8
Astroblasty,tichondrius,384,mage,fire,12,4,8
Supermajor,frostmourne,384,mage,fire,12,4,8
Spookydookie,dark-iron,384,mage,fire,12,4,8
Othokk,tichondrius,384,mage,fire,12,4,8
Galsola,bronzebeard,384,mage,fire,12,4,8
Hogslop,saurfang,384,mage,fire,12,4,8
Aquralina,moon-guard,384,mage,fire,12,4,8
Droppinbombs,draka,384,mage,fire,12,4,8
Kronicblast,bleeding-hollow,384,mage,fire,18,4,14
Gôøglëlòl,nemesis,384,mage,fire,18,4,14
Noyade,illidan,383,mage,fire,6,4,2
Boptimus,moonrunner,383,mage,fire,6,4,2
Drewzz,tichondrius,383,mage,fire,8,4,4
Iguanodon,proudmoore,383,mage,fire,12,4,8
Hockisonz,moon-guard,383,mage,fire,12,4,8
Soulwiper,illidan,383,mage,fire,17,5,12
Smoney,icecrown,383,mage,fire,18,4,14
Hollfz,nemesis,367,mage,fire,11,4,7
Letitgoo,azralon,367,mage,fire,11,4,7
Hositonet,malganis,344,mage,fire,15,6,9
Frostkage,tichondrius,288,mage,fire,6,3,3
Fredcouples,tichondrius,288,mage,fire,6,3,3
Putridìty,thrall,288,mage,fire,6,3,3
Jimmyhendrix,wildhammer,288,mage,fire,6,3,3
Vengefuly,tichondrius,288,mage,fire,6,3,3
Aulle,whisperwind,288,mage,fire,6,3,3
Tráshmage,zuljin,288,mage,fire,6,3,3
Chez,tichondrius,288,mage,fire,6,3,3
Rích,tichondrius,288,mage,fire,6,3,3
Eraticmage,illidan,288,mage,fire,6,3,3
Ave,anetheron,288,mage,fire,6,3,3
Kushjointz,tichondrius,288,mage,fire,6,3,3
Chilléd,tichondrius,288,mage,fire,6,3,3
Elfmage,tichondrius,288,mage,fire,6,3,3
Herzthroh,stormrage,288,mage,fire,6,3,3
Dropdeadlol,bonechewer,288,mage,fire,6,3,3
Avócadó,malganis,288,mage,fire,6,3,3
Thecorruptor,malorne,288,mage,fire,6,3,3
Slinkyslink,area-52,288,mage,fire,6,3,3
Bhalec,kelthuzad,288,mage,fire,6,3,3
Zakume,stormrage,288,mage,fire,6,3,3
Mirimida,ragnaros,288,mage,fire,6,3,3
Urbadxd,llane,288,mage,fire,6,3,3
Hasteboy,kelthuzad,288,mage,fire,6,3,3
Isoicast,moon-guard,288,mage,fire,6,3,3
Umber,dreadmaul,288,mage,fire,6,3,3
Missingxx,silvermoon,288,mage,fire,6,3,3
Englavian,frostmane,288,mage,fire,6,3,3
Rhunón,dalaran,288,mage,fire,6,3,3
Ancientmagik,area-52,288,mage,fire,6,3,3
Kuther,draenor,288,mage,fire,6,3,3
Polyburst,darkspear,288,mage,fire,6,3,3
Zenzoh,azuremyst,288,mage,fire,6,3,3
Melkra,tichondrius,288,mage,fire,11,3,8
Reddfire,proudmoore,288,mage,fire,12,3,9
Keionti,dalaran,288,mage,fire,12,3,9
Mendittorosa,tichondrius,288,mage,fire,12,3,9
Tarmiel,quelthalas,288,mage,fire,12,3,9
Frostyii,stonemaul,287,mage,fire,6,3,3
Nesomage,destromath,256,mage,fire,10,3,7
Orderlight,alexstrasza,239,mage,fire,5,3,2
Fizario,barthilas,239,mage,fire,5,3,2
Flomin,tichondrius,234,mage,fire,16,6,10
Burna,amanthul,192,mage,fire,6,2,4
Coôler,illidan,192,mage,fire,6,2,4
Massivepoo,barthilas,192,mage,fire,6,2,4
Rbn,tichondrius,192,mage,fire,6,2,4
Jinglehz,frostmourne,192,mage,fire,6,2,4
Wauzcrol,quelthalas,192,mage,fire,6,2,4
Naimi,malganis,192,mage,fire,6,2,4
Karameltart,barthilas,192,mage,fire,6,2,4
Ignitex,bleeding-hollow,192,mage,fire,6,2,4
Felsparkles,area-52,192,mage,fire,6,2,4
Josephaqil,tichondrius,192,mage,fire,6,2,4
Sasghengis,frostmourne,192,mage,fire,6,2,4
Likelyhard,tichondrius,192,mage,fire,6,2,4
Defaultx,turalyon,192,mage,fire,6,2,4
Zënith,quelthalas,192,mage,fire,6,2,4
Starguy,terenas,192,mage,fire,6,2,4
Abruaa,area-52,192,mage,fire,6,2,4
Covín,malganis,192,mage,fire,6,2,4
Notria,illidan,192,mage,fire,6,2,4
Gunzz,aegwynn,192,mage,fire,6,2,4
Remana,anvilmar,192,mage,fire,6,2,4
Parruka,warsong,192,mage,fire,6,2,4
Coldrin,tichondrius,192,mage,fire,6,2,4
Kaboodlz,stormrage,192,mage,fire,6,2,4
Gotya,tichondrius,192,mage,fire,6,2,4
Sogood,tanaris,192,mage,fire,6,2,4
Magifish,malganis,192,mage,fire,6,2,4
Magiër,tichondrius,192,mage,fire,6,2,4
Aquafiona,garona,192,mage,fire,6,2,4
Cradic,tichondrius,192,mage,fire,6,2,4
Coldnuke,stormrage,192,mage,fire,6,2,4
Banquetmeal,emerald-dream,192,mage,fire,6,2,4
Alïce,kelthuzad,192,mage,fire,6,2,4
Randommagi,area-52,192,mage,fire,6,2,4
Trebbiano,illidan,192,mage,fire,6,2,4
Siayo,stormscale,192,mage,fire,6,2,4
Elwyn,dunemaul,192,mage,fire,6,2,4
Avandal,proudmoore,192,mage,fire,6,2,4
Gódsfather,kelthuzad,192,mage,fire,6,2,4
Burrbon,area-52,192,mage,fire,6,2,4
Gødvana,frostmourne,192,mage,fire,6,2,4
Snanth,black-dragonflight,192,mage,fire,6,2,4
Thedodgex,sargeras,192,mage,fire,6,2,4
Kymowiz,sargeras,192,mage,fire,6,2,4
Pòpsmóke,tichondrius,192,mage,fire,6,2,4
Zuqo,sargeras,192,mage,fire,6,2,4
Natzue,sargeras,192,mage,fire,6,2,4
Arnx,tichondrius,192,mage,fire,11,2,9
Bic,darrowmere,192,mage,fire,12,2,10
Madalon,nemesis,160,mage,fire,10,2,8
Zezima,spirestone,159,mage,fire,5,2,3
Jazen,quelthalas,144,mage,fire,3,3,0
Tmharp,tichondrius,144,mage,fire,3,3,0
Fingerblaste,malganis,138,mage,fire,16,3,13
Eromir,dawnbringer,128,mage,fire,4,2,2
Yeweiliang,tichondrius,128,mage,fire,4,2,2
Jaysaucetv,tichondrius,112,mage,fire,7,2,5
Neltar,dalaran,112,mage,fire,7,2,5
Baelthezer,moon-guard,96,mage,fire,3,2,1
Clutchy,gorefiend,96,mage,fire,6,1,5
Clapsyou,illidan,96,mage,fire,6,1,5
Nazztwren,bleeding-hollow,96,mage,fire,6,1,5
Firemids,thrall,96,mage,fire,6,1,5
Dildope,frostmourne,96,mage,fire,6,1,5
Iamsol,area-52,96,mage,fire,6,1,5
Eldrielle,frostmourne,96,mage,fire,6,1,5
Espyy,area-52,96,mage,fire,6,1,5
Prosperoh,burning-legion,96,mage,fire,6,1,5
Muted,frostmourne,96,mage,fire,6,1,5
Trojay,malganis,96,mage,fire,6,1,5
Ignit,stormrage,96,mage,fire,6,1,5
Hyndoriann,azgalor,96,mage,fire,6,1,5
Truewinter,tichondrius,96,mage,fire,6,1,5
Miapolyafoo,stormrage,96,mage,fire,6,1,5
Couto,tichondrius,96,mage,fire,6,1,5
Nomidian,area-52,96,mage,fire,6,1,5
Brayni,wyrmrest-accord,96,mage,fire,6,1,5
Rolypolyman,tichondrius,96,mage,fire,6,1,5
Eludin,aegwynn,96,mage,fire,6,1,5
Mescudi,bonechewer,96,mage,fire,6,1,5
Dagreatone,malganis,96,mage,fire,6,1,5
Zuroz,dathremar,96,mage,fire,6,1,5
Somnuss,barthilas,96,mage,fire,7,1,6
Flame,arthas,96,mage,fire,12,1,11
Pyrlos,terokkar,95,mage,fire,6,1,5
Savanali,kelthuzad,79,mage,fire,5,1,4
Jaked,frostmourne,79,mage,fire,5,1,4
Absolutepowa,bleeding-hollow,31,mage,fire,2,1,1
Juicemage,tichondrius,2224,mage,frost,120,65,55
Ghostrr,tichondrius,2016,mage,frost,111,59,52
Easyfreeze,sargeras,1996,mage,frost,48,27,21
Ligmmah,stormrage,1991,mage,frost,93,55,38
Backjing,tichondrius,1969,mage,frost,81,39,42
Stonedmonkeý,tichondrius,1962,mage,frost,107,49,58
Cremgotrockd,blackrock,1937,mage,frost,59,32,27
Douyuweifa,tichondrius,1911,mage,frost,65,31,34
Elkiador,area-52,1909,mage,frost,30,21,9
Joe,llane,1877,mage,frost,69,36,33
Vazlgs,tichondrius,1869,mage,frost,70,40,30
Fròzt,ragnaros,1857,mage,frost,72,31,41
Hideongp,barthilas,1842,mage,frost,108,54,54
Dahp,thrall,1831,mage,frost,47,23,24
Koro,tichondrius,1823,mage,frost,56,29,27
Chez,tichondrius,1818,mage,frost,30,19,11
Cømbust,frostmourne,1816,mage,frost,72,50,22
Maegwynah,stormrage,1804,mage,frost,66,29,37
Instincts,uldum,1796,mage,frost,42,25,17
Tupactopus,tichondrius,1788,mage,frost,36,19,17
Koozay,kelthuzad,1787,mage,frost,53,32,21
Polyenjoyerx,ysera,1776,mage,frost,84,47,37
Riddickl,malfurion,1760,mage,frost,66,33,33
Ams,aerie-peak,1747,mage,frost,42,23,19
Téfy,ragnaros,1744,mage,frost,59,34,25
Stöpwatch,hyjal,1742,mage,frost,42,27,15
Srinshi,sargeras,1733,mage,frost,60,29,31
Valériemeow,tichondrius,1727,mage,frost,53,26,27
Trolson,sargeras,1726,mage,frost,60,29,31
Ingcho,tichondrius,1721,mage,frost,66,29,37
Mokelovin,sargeras,1720,mage,frost,32,21,11
Illumià,illidan,1719,mage,frost,26,20,6
Chrisxo,azuremyst,1714,mage,frost,30,18,12
Sifr,tichondrius,1713,mage,frost,36,18,18
Hunchojack,tichondrius,1713,mage,frost,42,18,24
Headbake,malganis,1705,mage,frost,42,24,18
Faynet,dalaran,1701,mage,frost,48,24,24
Gôøglëlòl,nemesis,1699,mage,frost,105,54,51
Fromcanadaqc,stormrage,1689,mage,frost,41,24,17
Dve,frostmourne,1685,mage,frost,42,31,11
Jtizzlè,tichondrius,1679,mage,frost,59,33,26
Snaregodx,area-52,1671,mage,frost,35,21,14
Leakyboots,illidan,1669,mage,frost,35,18,17
Hogdog,illidan,1662,mage,frost,48,24,24
Arcayne,tichondrius,1661,mage,frost,42,25,17
Bambambilly,kelthuzad,1655,mage,frost,75,35,40
Zorexx,area-52,1649,mage,frost,49,26,23
Zhangxiaowu,tichondrius,1644,mage,frost,44,29,15
Xanthilia,chogall,1644,mage,frost,48,23,25
Blinkbow,tichondrius,1642,mage,frost,60,27,33
Quippy,kiljaeden,1634,mage,frost,183,86,97
Alurion,moon-guard,1632,mage,frost,26,18,8
Stimml,blood-furnace,1632,mage,frost,42,25,17
Zezima,spirestone,1625,mage,frost,36,23,13
Deathrøll,moon-guard,1624,mage,frost,78,48,30
Yeweiliang,tichondrius,1619,mage,frost,93,45,48
Neverblockx,kirin-tor,1618,mage,frost,30,17,13
Sestren,zuljin,1618,mage,frost,36,17,19
Gwyn,nemesis,1614,mage,frost,54,29,25
Mageonthcc,korgath,1611,mage,frost,80,41,39
Pichorrá,quelthalas,1595,mage,frost,50,28,22
Kissradiox,tichondrius,1594,mage,frost,36,19,17
Grumpyòlfart,tichondrius,1591,mage,frost,43,21,22
Zinnos,tichondrius,1590,mage,frost,120,54,66
Dace,tichondrius,1580,mage,frost,30,18,12
Charmed,black-dragonflight,1577,mage,frost,68,34,34
Deverror,frostmourne,1575,mage,frost,89,41,48
Squidio,stormrage,1570,mage,frost,125,68,57
Crithappy,baelgun,1568,mage,frost,48,26,22
Animatronic,moon-guard,1567,mage,frost,47,22,25
Nickioxox,tichondrius,1567,mage,frost,41,17,24
Floofies,moon-guard,1557,mage,frost,54,27,27
Playsfrost,skullcrusher,1554,mage,frost,88,55,33
Christmas,tichondrius,1553,mage,frost,316,157,159
Sheepu,bladefist,1551,mage,frost,76,44,32
Zeshilol,stormrage,1549,mage,frost,39,19,20
Theetwotime,area-52,1548,mage,frost,42,18,24
Gasolína,stormrage,1546,mage,frost,35,20,15
Frøzzen,quelthalas,1536,mage,frost,42,23,19
Yorgøs,ragnaros,1530,mage,frost,30,16,14
Syntacks,lightnings-blade,1519,mage,frost,125,58,67
Priyel,hyjal,1513,mage,frost,36,19,17
Umber,dreadmaul,1513,mage,frost,60,28,32
Eldrielle,frostmourne,1508,mage,frost,171,90,81
Khadberry,aerie-peak,1501,mage,frost,71,34,37
Vecna,tichondrius,1500,mage,frost,54,26,28
Fròzen,moon-guard,1497,mage,frost,56,28,28
Omnislasher,terenas,1494,mage,frost,66,29,37
Osnapmage,malganis,1488,mage,frost,133,66,67
Dorsia,jaedenar,1480,mage,frost,22,17,5
Venachi,emerald-dream,1478,mage,frost,79,43,36
Frostqt,area-52,1476,mage,frost,72,38,34
Qsc,barthilas,1476,mage,frost,79,38,41
Soulberg,emerald-dream,1466,mage,frost,47,18,29
Enterthevoid,proudmoore,1463,mage,frost,36,21,15
Respectx,nemesis,1463,mage,frost,46,20,26
Sesshomaru,emerald-dream,1462,mage,frost,33,17,16
Coôler,illidan,1451,mage,frost,160,90,70
Rích,tichondrius,1443,mage,frost,54,24,30
Rizke,tichondrius,1437,mage,frost,24,15,9
Lambsalsa,tichondrius,1435,mage,frost,30,15,15
Plainblaine,illidan,1431,mage,frost,57,29,28
Song,sargeras,1428,mage,frost,71,34,37
Starkp,ragnaros,1427,mage,frost,129,65,64
Fakebusiness,area-52,1418,mage,frost,43,20,23
Tylers,moon-guard,1415,mage,frost,36,19,17
Tagere,moon-guard,1410,mage,frost,62,30,32
Perrc,area-52,1407,mage,frost,128,56,72
Canva,barthilas,1406,mage,frost,41,25,16
Magicbunny,andorhal,1405,mage,frost,53,29,24
Kleinz,quelthalas,1402,mage,frost,25,17,8
Lachawr,stormrage,1396,mage,frost,37,19,18
Tifrodo,azralon,1395,mage,frost,64,34,30
Alìv,tichondrius,1392,mage,frost,122,56,66
Crymachine,garrosh,1391,mage,frost,33,17,16
Selless,zuljin,1388,mage,frost,36,20,16
Clm,lightnings-blade,1380,mage,frost,24,15,9
Gazzuu,ragnaros,1369,mage,frost,30,16,14
Savanali,kelthuzad,1346,mage,frost,30,19,11
Cryogeniks,illidan,1343,mage,frost,30,14,16
Trebbiano,illidan,1343,mage,frost,37,17,20
Corgim,thrall,1340,mage,frost,30,14,16
Drewdy,stormreaver,1339,mage,frost,24,14,10
Sabrita,proudmoore,1336,mage,frost,24,14,10
Ado,zuluhed,1330,mage,frost,48,21,27
Gualter,nemesis,1329,mage,frost,78,44,34
Juul,emerald-dream,1328,mage,frost,237,109,128
Gûmbÿ,illidan,1323,mage,frost,18,14,4
Myxzz,barthilas,1317,mage,frost,56,26,30
Hermanmiller,tichondrius,1316,mage,frost,60,26,34
Ragemage,borean-tundra,1311,mage,frost,59,20,39
Yulian,tichondrius,1310,mage,frost,27,15,12
Feogato,proudmoore,1306,mage,frost,54,28,26
Frostítute,alterac-mountains,1305,mage,frost,30,15,15
Soia,ragnaros,1298,mage,frost,39,20,19
Slipqt,tichondrius,1297,mage,frost,36,14,22
Frostitutå,eonar,1290,mage,frost,81,35,46
Icybanter,emerald-dream,1286,mage,frost,30,14,16
Layolis,area-52,1281,mage,frost,36,22,14
Valrendor,nazjatar,1270,mage,frost,41,21,20
Affewxd,lothar,1270,mage,frost,29,14,15
Ignit,stormrage,1269,mage,frost,34,17,17
Agniih,azralon,1262,mage,frost,42,20,22
Samuoa,tichondrius,1261,mage,frost,30,17,13
Copperfield,dreadmaul,1257,mage,frost,68,30,38
Cavit,wyrmrest-accord,1254,mage,frost,42,22,20
Maigoddess,proudmoore,1252,mage,frost,59,26,33
Pigdancell,tichondrius,1247,mage,frost,30,13,17
Vornz,sargeras,1244,mage,frost,31,14,17
Deallus,tichondrius,1242,mage,frost,30,13,17
Yourefat,emerald-dream,1238,mage,frost,36,20,16
Burritsacold,bleeding-hollow,1238,mage,frost,24,13,11
Unleáshed,moonrunner,1229,mage,frost,61,29,32
Nate,black-dragonflight,1226,mage,frost,42,16,26
Jikario,zuljin,1224,mage,frost,30,13,17
Tyrecgosa,tichondrius,1212,mage,frost,24,14,10
Clownspocket,tichondrius,1211,mage,frost,30,15,15
Zerodium,sargeras,1197,mage,frost,29,13,16
Bmuafgfe,tichondrius,1195,mage,frost,21,13,8
Canassa,azralon,1195,mage,frost,29,16,13
Derpmanjr,area-52,1194,mage,frost,30,21,9
Gatka,quelthalas,1190,mage,frost,134,61,73
Ibalyn,khazgoroth,1189,mage,frost,54,28,26
Valtaira,wyrmrest-accord,1181,mage,frost,43,24,19
Sahir,thaurissan,1173,mage,frost,30,14,16
Smáckington,tichondrius,1173,mage,frost,39,18,21
Sturmrevenge,lightnings-blade,1170,mage,frost,48,23,25
Gsr,nerzhul,1169,mage,frost,34,14,20
Devlux,area-52,1167,mage,frost,80,38,42
Khaldyn,tichondrius,1159,mage,frost,114,56,58
Tjofmajik,stormrage,1151,mage,frost,24,12,12
Cubanmage,drakkari,1147,mage,frost,24,12,12
Emetah,ysera,1144,mage,frost,30,12,18
Diixynormus,illidan,1141,mage,frost,30,17,13
Corucia,echo-isles,1137,mage,frost,100,46,54
Xárdas,quelthalas,1137,mage,frost,46,20,26
Mageeoh,bleeding-hollow,1128,mage,frost,41,14,27
Fatum,ragnaros,1124,mage,frost,32,14,18
Elwyn,dunemaul,1123,mage,frost,27,13,14
Gunzz,aegwynn,1122,mage,frost,30,12,18
Wowenjoyer,area-52,1119,mage,frost,64,28,36
Mntaindew,bleeding-hollow,1119,mage,frost,29,12,17
Kazmir,area-52,1119,mage,frost,29,12,17
Couto,tichondrius,1116,mage,frost,23,12,11
Bellåtrîx,quelthalas,1115,mage,frost,18,12,6
Littlebeth,azjolnerub,1115,mage,frost,30,16,14
Drumzter,ragnaros,1114,mage,frost,29,16,13
Shäräpova,zuljin,1109,mage,frost,24,12,12
Dejavuh,dalaran,1106,mage,frost,30,18,12
Twirkin,proudmoore,1102,mage,frost,36,18,18
Praestigium,barthilas,1099,mage,frost,21,12,9
Magedango,bleeding-hollow,1095,mage,frost,35,14,21
Safety,stormreaver,1094,mage,frost,22,12,10
Toesuckerlol,tichondrius,1093,mage,frost,23,12,11
Cìfel,quelthalas,1087,mage,frost,17,12,5
Castingmommy,moon-guard,1082,mage,frost,42,21,21
Helcarwen,area-52,1081,mage,frost,31,13,18
Xannymancan,tichondrius,1080,mage,frost,54,21,33
Lildabpen,tichondrius,1057,mage,frost,86,34,52
Entm,burning-blade,1056,mage,frost,18,11,7
Biglance,frostmourne,1055,mage,frost,18,11,7
Marrioo,tichondrius,1055,mage,frost,24,11,13
Angerfrost,khazgoroth,1054,mage,frost,36,22,14
Axecap,tichondrius,1054,mage,frost,18,11,7
Renoria,norgannon,1054,mage,frost,24,11,13
Gunzup,lightnings-blade,1051,mage,frost,24,11,13
Auralyn,wyrmrest-accord,1051,mage,frost,25,11,14
Zibbo,ragnaros,1046,mage,frost,18,11,7
Sluagh,terenas,1044,mage,frost,47,22,25
Skynhet,ragnaros,1043,mage,frost,24,11,13
Devoh,dunemaul,1040,mage,frost,20,11,9
Pugsmugg,icecrown,1032,mage,frost,49,13,36
Bobalama,tichondrius,1025,mage,frost,18,14,4
Coldfrønt,moon-guard,1024,mage,frost,24,11,13
Moonfhang,azralon,1017,mage,frost,51,20,31
Darkrukia,tichondrius,1014,mage,frost,24,11,13
Kouks,tichondrius,1006,mage,frost,17,11,6
Zoidy,bleeding-hollow,1005,mage,frost,29,11,18
Megapasta,illidan,989,mage,frost,23,11,12
Prometheus,crushridge,986,mage,frost,52,27,25
Damage,skullcrusher,971,mage,frost,25,11,14
Grudel,archimonde,960,mage,frost,18,11,7
Feener,stormreaver,960,mage,frost,18,10,8
Kassmage,skullcrusher,960,mage,frost,24,10,14
Legendkiller,bleeding-hollow,959,mage,frost,18,10,8
Atra,spinebreaker,959,mage,frost,24,10,14
Qcomberoo,frostmane,959,mage,frost,27,11,16
Aluce,frostmourne,958,mage,frost,18,10,8
Fawcett,khazgoroth,957,mage,frost,24,10,14
Epifeni,blackrock,955,mage,frost,30,10,20
Who,emerald-dream,950,mage,frost,16,11,5
Kryliak,ragnaros,946,mage,frost,18,10,8
Onlyfansme,dalaran,939,mage,frost,18,10,8
Critique,malorne,923,mage,frost,30,16,14
Marschubas,drakthul,917,mage,frost,65,28,37
Moesel,emerald-dream,908,mage,frost,15,11,4
Itoncruxy,tichondrius,886,mage,frost,57,26,31
Frostitutex,illidan,880,mage,frost,19,10,9
Valtessa,stormrage,864,mage,frost,12,9,3
Furisheep,stormrage,864,mage,frost,12,9,3
Nalabb,illidan,864,mage,frost,12,9,3
Hyoonsfeet,stormrage,864,mage,frost,18,9,9
Triuneward,tichondrius,864,mage,frost,18,9,9
Weathersmell,tichondrius,864,mage,frost,18,9,9
Rhythmdog,tichondrius,864,mage,frost,30,9,21
Doubledown,kiljaeden,863,mage,frost,12,9,3
Nicemangoes,proudmoore,863,mage,frost,12,9,3
Blinkbotx,proudmoore,863,mage,frost,18,9,9
Lastiari,wyrmrest-accord,863,mage,frost,18,9,9
Dillor,tichondrius,863,mage,frost,18,9,9
Burstage,destromath,863,mage,frost,18,9,9
Blinkharder,stormrage,863,mage,frost,24,9,15
Traelol,blades-edge,863,mage,frost,24,9,15
Jaked,frostmourne,863,mage,frost,30,9,21
Kitenic,proudmoore,862,mage,frost,12,9,3
Åøe,tichondrius,862,mage,frost,18,9,9
Boredomkïlls,burning-legion,862,mage,frost,18,9,9
Skillcap,nagrand,862,mage,frost,18,9,9
Tunax,tichondrius,862,mage,frost,24,9,15
Kevymarts,tichondrius,861,mage,frost,12,9,3
Shenme,moon-guard,861,mage,frost,20,9,11
Fruza,emerald-dream,860,mage,frost,16,10,6
Remana,anvilmar,859,mage,frost,18,9,9
Soya,sargeras,852,mage,frost,24,9,15
Naoz,ragnaros,851,mage,frost,18,9,9
Jarethleon,ragnaros,837,mage,frost,21,11,10
Âürõrâ,firetree,834,mage,frost,24,9,15
Pocsermage,drakkari,831,mage,frost,22,9,13
Drfrostie,anvilmar,798,mage,frost,14,9,5
Wolfgangvn,stormrage,783,mage,frost,19,9,10
Wickednoob,malganis,771,mage,frost,25,9,16
Nefm,frostmourne,768,mage,frost,12,8,4
Tonystonerz,lightnings-blade,768,mage,frost,12,8,4
Smuky,stormrage,768,mage,frost,12,8,4
Xialing,tichondrius,768,mage,frost,12,8,4
Marisadaze,tichondrius,768,mage,frost,18,8,10
Sheepshot,dentarg,768,mage,frost,18,8,10
Pigdancel,tichondrius,768,mage,frost,18,8,10
Sáron,quelthalas,767,mage,frost,12,8,4
Radiku,blood-furnace,767,mage,frost,12,8,4
Bigdjohnson,dalaran,767,mage,frost,12,8,4
Nôtôrious,thrall,767,mage,frost,12,8,4
Minverces,tichondrius,767,mage,frost,18,8,10
Erîol,ragnaros,767,mage,frost,18,8,10
Vamplol,tichondrius,767,mage,frost,18,8,10
Numz,sargeras,767,mage,frost,18,8,10
Wickymorph,barthilas,767,mage,frost,18,8,10
Zirkur,mannoroth,767,mage,frost,18,8,10
Ràmdas,hyjal,766,mage,frost,12,8,4
Koulder,zuljin,766,mage,frost,12,8,4
Marvelcuck,sargeras,763,mage,frost,12,8,4
Crizzpy,tichondrius,762,mage,frost,18,8,10
Letitgoo,azralon,760,mage,frost,16,9,7
Osda,azralon,756,mage,frost,18,8,10
Fizario,barthilas,751,mage,frost,23,9,14
Artruis,detheroc,748,mage,frost,12,8,4
Bandmaid,emerald-dream,736,mage,frost,16,9,7
Orderlight,alexstrasza,735,mage,frost,29,8,21
Heca,tichondrius,719,mage,frost,11,8,3
Stankfreezer,thrall,719,mage,frost,11,8,3
Nereidan,drakkari,703,mage,frost,14,8,6
Esun,moon-guard,683,mage,frost,13,8,5
Neovim,stormrage,672,mage,frost,12,7,5
Littlejay,kelthuzad,672,mage,frost,12,7,5
Hogmantwo,illidan,672,mage,frost,12,7,5
Nukedat,proudmoore,672,mage,frost,12,7,5
Tibbit,kelthuzad,672,mage,frost,12,7,5
Mushys,stormrage,672,mage,frost,12,7,5
Proximalol,tichondrius,672,mage,frost,12,7,5
Maguín,tichondrius,672,mage,frost,12,7,5
Dexd,laughing-skull,672,mage,frost,12,7,5
Dtbmar,misha,672,mage,frost,16,8,8
Skoals,thrall,672,mage,frost,17,8,9
Stealing,barthilas,672,mage,frost,18,7,11
Seeu,tichondrius,672,mage,frost,18,7,11
Chunzhangfs,tichondrius,672,mage,frost,18,7,11
Factsx,area-52,672,mage,frost,18,7,11
Snoogma,illidan,671,mage,frost,12,7,5
Chade,dunemaul,671,mage,frost,12,7,5
Khaziiong,scilla,671,mage,frost,12,7,5
Dairian,whisperwind,671,mage,frost,12,7,5
Degenhours,illidan,671,mage,frost,12,7,5
Minerves,tichondrius,671,mage,frost,18,7,11
Aulie,burning-blade,670,mage,frost,12,7,5
Featherboo,stormrage,670,mage,frost,12,7,5
Starguy,laughing-skull,670,mage,frost,18,7,11
Bigpinkies,korgath,669,mage,frost,12,7,5
Zalatirix,bleeding-hollow,669,mage,frost,12,7,5
Criticalness,illidan,669,mage,frost,12,7,5
Icelordd,ragnaros,669,mage,frost,13,7,6
Bòóyah,muradin,668,mage,frost,12,7,5
Memnor,amanthul,668,mage,frost,12,7,5
Worknlurk,malganis,666,mage,frost,12,7,5
Trollsita,thrall,665,mage,frost,12,7,5
Arkoz,tichondrius,664,mage,frost,12,7,5
Tigoditties,emerald-dream,662,mage,frost,12,7,5
Xoxmage,frostmourne,659,mage,frost,18,7,11
Tatertots,bladefist,655,mage,frost,23,7,16
Vendizzle,malganis,654,mage,frost,23,7,16
Slaash,barthilas,639,mage,frost,14,8,6
Discoinferno,kelthuzad,638,mage,frost,14,8,6
Shaynna,tichondrius,624,mage,frost,15,7,8
Ghostblaze,blackhand,621,mage,frost,15,8,7
Ghrámz,stormrage,607,mage,frost,16,7,9
Shatturd,sargeras,576,mage,frost,12,6,6
Supergun,tichondrius,576,mage,frost,12,6,6
Hambürglar,garrosh,576,mage,frost,12,6,6
Alludèd,illidan,576,mage,frost,12,6,6
Frostzadan,quelthalas,576,mage,frost,12,6,6
Thatlejund,tichondrius,576,mage,frost,12,6,6
Hýdramist,sargeras,576,mage,frost,12,6,6
Luckysir,illidan,576,mage,frost,18,6,12
Fromcanada,tichondrius,576,mage,frost,18,6,12
Kymowiz,sargeras,576,mage,frost,18,6,12
Cransmage,illidan,575,mage,frost,12,6,6
Aarne,thrall,575,mage,frost,18,6,12
Fabled,stonemaul,575,mage,frost,18,6,12
Kaël,area-52,574,mage,frost,12,6,6
Tonepedo,zuljin,574,mage,frost,18,6,12
Azzurn,doomhammer,572,mage,frost,12,6,6
Sodrezinn,illidan,571,mage,frost,12,6,6
Ärià,sargeras,571,mage,frost,12,6,6
Arckayne,zuljin,543,mage,frost,11,6,5
Hiiamtay,azralon,542,mage,frost,8,7,1
Nazneen,elune,528,mage,frost,9,6,3
Rrite,tichondrius,527,mage,frost,11,6,5
Pidge,aggramar,519,mage,frost,22,6,16
Aycc,tichondrius,512,mage,frost,10,6,4
Barceclas,tichondrius,512,mage,frost,10,6,4
Somethinglos,sargeras,512,mage,frost,16,6,10
Ereblink,proudmoore,511,mage,frost,11,6,5
Guji,area-52,510,mage,frost,17,7,10
Parruka,warsong,510,mage,frost,20,6,14
Zabaione,stormrage,508,mage,frost,16,6,10
Fromcanadaqc,zuljin,480,mage,frost,6,5,1
Whosdismage,illidan,480,mage,frost,6,5,1
Blinksz,korgath,480,mage,frost,6,5,1
Flavaflame,mugthol,480,mage,frost,6,5,1
Factszxy,area-52,480,mage,frost,6,5,1
Tommagic,tichondrius,480,mage,frost,6,5,1
Vengefuly,tichondrius,480,mage,frost,6,5,1
Rositajonez,terenas,480,mage,frost,6,5,1
Galacticslug,tichondrius,480,mage,frost,6,5,1
Freez,garona,480,mage,frost,10,6,4
Siobhána,moon-guard,480,mage,frost,12,5,7
Betrian,quelthalas,480,mage,frost,12,5,7
Kh,stormrage,480,mage,frost,12,5,7
Zime,moon-guard,480,mage,frost,12,5,7
Baemers,tichondrius,480,mage,frost,12,5,7
Kayenri,area-52,480,mage,frost,12,5,7
Gadwick,alexstrasza,480,mage,frost,12,5,7
Adronicus,tichondrius,480,mage,frost,12,5,7
Scrúmp,tichondrius,480,mage,frost,12,5,7
Mageyoulooks,kelthuzad,480,mage,frost,12,5,7
Mclanda,frostmourne,480,mage,frost,12,5,7
Badboykilla,dentarg,480,mage,frost,12,5,7
Frussy,blood-furnace,480,mage,frost,12,5,7
Hustle,frostmourne,480,mage,frost,12,5,7
Cinns,moon-guard,480,mage,frost,12,5,7
Vires,kelthuzad,480,mage,frost,12,5,7
Frostytoez,firetree,480,mage,frost,12,5,7
Syndra,korialstrasz,480,mage,frost,12,5,7
Pendrake,sargeras,480,mage,frost,12,5,7
Starguy,terenas,480,mage,frost,12,5,7
Gadogear,draka,480,mage,frost,12,5,7
Isömetrics,tichondrius,480,mage,frost,12,5,7
Snoogensftw,tichondrius,480,mage,frost,18,5,13
Throatdemon,hakkar,480,mage,frost,18,5,13
Undedkev,tichondrius,480,mage,frost,18,5,13
Magifish,malganis,479,mage,frost,6,5,1
Piixxiie,sargeras,479,mage,frost,6,5,1
Cuoreforte,moon-guard,479,mage,frost,12,5,7
Dimmershnitz,draka,479,mage,frost,12,5,7
Cezax,frostmourne,479,mage,frost,12,5,7
Sènding,sargeras,479,mage,frost,24,5,19
Ceadruk,darkspear,478,mage,frost,12,5,7
Magekingz,shattered-halls,477,mage,frost,12,5,7
Trollings,azralon,476,mage,frost,12,5,7
Rekonx,tichondrius,463,mage,frost,11,5,6
Cerisium,kiljaeden,431,mage,frost,11,5,6
Zionist,earthen-ring,415,mage,frost,8,5,3
Mageboy,bonechewer,415,mage,frost,11,5,6
Quinnfreeze,boulderfist,414,mage,frost,11,5,6
Kygores,tichondrius,384,mage,frost,6,4,2
Kfortyone,kiljaeden,384,mage,frost,6,4,2
Kutulu,aerie-peak,384,mage,frost,6,4,2
Dearyuanmage,tichondrius,384,mage,frost,6,4,2
Ankidar,quelthalas,384,mage,frost,6,4,2
Arcánè,velen,384,mage,frost,6,4,2
Nexttmage,area-52,384,mage,frost,6,4,2
Mkudos,ragnaros,384,mage,frost,6,4,2
Kromeus,illidan,384,mage,frost,6,4,2
Voiddude,proudmoore,384,mage,frost,6,4,2
Myrondor,tichondrius,384,mage,frost,6,4,2
Poonfarmer,zangarmarsh,384,mage,frost,6,4,2
Reptär,demon-soul,384,mage,frost,6,4,2
Zuqo,sargeras,384,mage,frost,6,4,2
Eriktherod,maelstrom,384,mage,frost,6,4,2
Kaboozles,area-52,384,mage,frost,6,4,2
Frostkage,tichondrius,384,mage,frost,6,4,2
Corruptionz,nemesis,384,mage,frost,6,4,2
Bçøløñápûðgé,illidan,384,mage,frost,6,4,2
Tofusmell,illidan,384,mage,frost,6,4,2
Crnomage,area-52,384,mage,frost,6,4,2
Mmine,tichondrius,384,mage,frost,6,4,2
Nihilitý,malganis,384,mage,frost,6,4,2
Frobo,mannoroth,384,mage,frost,6,4,2
Aigam,hyjal,384,mage,frost,6,4,2
Dashdoor,stormrage,384,mage,frost,6,4,2
Burist,illidan,384,mage,frost,6,4,2
Gelokay,tichondrius,384,mage,frost,6,4,2
Safu,bleeding-hollow,384,mage,frost,6,4,2
Zgodspeedz,stormrage,384,mage,frost,6,4,2
Ratfather,the-forgotten-coast,384,mage,frost,6,4,2
Lohkey,darkspear,384,mage,frost,6,4,2
Babyspise,nathrezim,384,mage,frost,6,4,2
Fromcanadaqc,tichondrius,384,mage,frost,6,4,2
Zlint,quelthalas,384,mage,frost,6,4,2
Kälis,zuljin,384,mage,frost,6,4,2
Frizbee,sargeras,384,mage,frost,9,5,4
Iladiin,malganis,384,mage,frost,9,4,5
Ineedashave,shandris,384,mage,frost,12,4,8
Frostpimp,anubarak,384,mage,frost,12,4,8
Luxør,aegwynn,384,mage,frost,12,4,8
Crimpster,illidan,384,mage,frost,12,4,8
Lorlene,frostmourne,384,mage,frost,12,4,8
Bluedustfart,illidan,384,mage,frost,12,4,8
Castana,tichondrius,384,mage,frost,12,4,8
Jejihev,drakkari,384,mage,frost,12,4,8
Nickygift,tichondrius,384,mage,frost,12,4,8
Darthez,darkspear,384,mage,frost,12,4,8
Acarilla,stormrage,384,mage,frost,12,4,8
Dallamar,frostwolf,384,mage,frost,12,4,8
Ultrá,stormscale,384,mage,frost,12,4,8
Horizons,moon-guard,384,mage,frost,12,4,8
Badaszbich,tichondrius,384,mage,frost,12,4,8
Novokaine,area-52,384,mage,frost,12,4,8
Frenk,moon-guard,384,mage,frost,12,4,8
Rolypolyman,tichondrius,384,mage,frost,18,4,14
Ehduh,onyxia,383,mage,frost,6,4,2
Bubbleblower,hakkar,383,mage,frost,12,4,8
Cynafox,moon-guard,383,mage,frost,12,4,8
Freyia,mugthol,382,mage,frost,12,4,8
Kuni,ghostlands,382,mage,frost,12,4,8
Cowwboydan,malganis,351,mage,frost,8,5,3
Peetufo,whisperwind,351,mage,frost,11,4,7
Lirahmi,quelthalas,351,mage,frost,11,4,7
Freezeup,area-52,349,mage,frost,14,7,7
Jerawokee,undermine,335,mage,frost,17,4,13
Devkek,area-52,330,mage,frost,22,7,15
Icëblöck,ysera,329,mage,frost,6,5,1
Zssy,tichondrius,319,mage,frost,5,4,1
Jayfunk,sargeras,319,mage,frost,5,4,1
Scár,blackrock,317,mage,frost,8,4,4
Scarablast,bleeding-hollow,304,mage,frost,7,4,3
Bigmêan,boulderfist,288,mage,frost,6,3,3
Nnenna,bonechewer,288,mage,frost,6,3,3
Tsuchek,tichondrius,288,mage,frost,6,3,3
Youngwiz,arthas,288,mage,frost,6,3,3
Corrmic,winterhoof,288,mage,frost,6,3,3
Thxo,hyjal,288,mage,frost,6,3,3
Ruzam,area-52,288,mage,frost,6,3,3
Limeade,ursin,288,mage,frost,6,3,3
Noescaping,illidan,288,mage,frost,6,3,3
Maelista,tichondrius,288,mage,frost,6,3,3
Milambehr,elune,288,mage,frost,6,3,3
Murderlin,tichondrius,288,mage,frost,6,3,3
Kqlyy,tichondrius,288,mage,frost,6,3,3
Kryptekk,area-52,288,mage,frost,6,3,3
Giovannie,zuluhed,288,mage,frost,6,3,3
Isuikido,nemesis,288,mage,frost,6,3,3
Coneofkony,bleeding-hollow,288,mage,frost,6,3,3
Shardgodx,kelthuzad,288,mage,frost,6,3,3
Oharvestero,illidan,288,mage,frost,6,3,3
Cruxx,ragnaros,288,mage,frost,6,3,3
Zaxrie,malganis,288,mage,frost,6,3,3
Bigchilly,malganis,288,mage,frost,6,3,3
Grimreefer,trollbane,288,mage,frost,6,3,3
Betaduck,bleeding-hollow,288,mage,frost,6,3,3
Trozkov,dalaran,288,mage,frost,6,3,3
Puvö,tichondrius,288,mage,frost,6,3,3
Aquariusmoon,bonechewer,288,mage,frost,6,3,3
Gobstpper,nagrand,288,mage,frost,6,3,3
Sølem,frostmourne,288,mage,frost,6,3,3
Urbadxd,llane,288,mage,frost,6,3,3
Zukoprince,azralon,288,mage,frost,6,3,3
Missingxx,silvermoon,288,mage,frost,6,3,3
Bamx,stormrage,288,mage,frost,6,3,3
Bønemage,azralon,288,mage,frost,6,3,3
Illúmi,moon-guard,288,mage,frost,6,3,3
Alatria,frostmourne,288,mage,frost,6,3,3
Packaged,emerald-dream,288,mage,frost,6,3,3
Cheapsects,drakthul,288,mage,frost,6,3,3
Bound,emerald-dream,288,mage,frost,6,3,3
Twiztidwitch,burning-legion,288,mage,frost,6,3,3
Icetooseeyou,barthilas,288,mage,frost,6,3,3
Natallyn,stormrage,288,mage,frost,6,3,3
Blinkinghobo,sargeras,288,mage,frost,6,3,3
Mäz,malorne,288,mage,frost,6,3,3
Personah,darkspear,288,mage,frost,6,3,3
Magetherian,frostmourne,288,mage,frost,6,3,3
Hékate,moon-guard,288,mage,frost,6,3,3
Címegripe,stormrage,288,mage,frost,6,3,3
Etyx,tichondrius,288,mage,frost,10,4,6
Putosucio,nordrassil,288,mage,frost,12,3,9
Hqscoltt,azralon,288,mage,frost,12,3,9
Draell,drakkari,288,mage,frost,12,3,9
Ezchallenger,undermine,288,mage,frost,12,3,9
Worldonfire,ragnaros,288,mage,frost,12,3,9
Rabeiro,tichondrius,288,mage,frost,12,3,9
Calcaster,aegwynn,288,mage,frost,12,3,9
Daydreamz,lightnings-blade,288,mage,frost,12,3,9
Houdiinii,illidan,288,mage,frost,12,3,9
Fracxure,area-52,288,mage,frost,12,3,9
Cawyro,caelestrasz,287,mage,frost,6,3,3
Gufi,drakkari,287,mage,frost,6,3,3
Vantus,tichondrius,287,mage,frost,8,3,5
Lünâliä,bleeding-hollow,286,mage,frost,6,3,3
Leocius,daggerspine,239,mage,frost,5,3,2
Drewann,draenor,239,mage,frost,5,3,2
Unydae,frostmourne,239,mage,frost,5,3,2
Itsoveryo,jubeithos,239,mage,frost,5,3,2
Icebboxx,tichondrius,239,mage,frost,6,3,3
Thaldarian,emerald-dream,234,mage,frost,13,4,9
Skerei,azralon,234,mage,frost,19,4,15
Juicechanel,tichondrius,224,mage,frost,10,3,7
Abracadaver,greymane,192,mage,frost,4,3,1
Rayricefan,blood-furnace,192,mage,frost,4,3,1
Pizzle,perenolde,192,mage,frost,6,2,4
Muskybiggie,bleeding-hollow,192,mage,frost,6,2,4
Karameltart,barthilas,192,mage,frost,6,2,4
Albbano,tichondrius,192,mage,frost,6,2,4
Ess,tichondrius,192,mage,frost,6,2,4
Baleiabranca,stormrage,192,mage,frost,6,2,4
Undeadmager,nerzhul,192,mage,frost,6,2,4
Thergon,kul-tiras,192,mage,frost,6,2,4
Winstonchill,zuljin,192,mage,frost,6,2,4
Afknz,frostmourne,192,mage,frost,6,2,4
Kabrax,nerzhul,192,mage,frost,6,2,4
Agoniey,illidan,192,mage,frost,6,2,4
Cayoux,darkspear,192,mage,frost,6,2,4
Magicginger,barthilas,192,mage,frost,6,2,4
Earff,kiljaeden,192,mage,frost,6,2,4
Bluishhue,thrall,192,mage,frost,6,2,4
Raynark,nemesis,192,mage,frost,6,2,4
Gradmage,proudmoore,192,mage,frost,6,2,4
Pivnert,boulderfist,192,mage,frost,6,2,4
Mager,dentarg,192,mage,frost,6,2,4
Strêss,kelthuzad,192,mage,frost,6,2,4
Elvin,frostmourne,192,mage,frost,6,2,4
Gryd,area-52,192,mage,frost,6,2,4
Makius,area-52,192,mage,frost,6,2,4
Roarly,stonemaul,192,mage,frost,6,2,4
Harlloo,the-underbog,192,mage,frost,6,2,4
Pyröz,kelthuzad,192,mage,frost,6,2,4
Ayci,velen,192,mage,frost,6,2,4
Cantblocklul,baelgun,192,mage,frost,6,2,4
Sparqablink,tichondrius,192,mage,frost,6,2,4
Tanedos,tichondrius,192,mage,frost,6,2,4
Tris,malganis,192,mage,frost,6,2,4
Dinklord,azuremyst,192,mage,frost,6,2,4
Mcdfries,tichondrius,192,mage,frost,6,2,4
Valire,kelthuzad,192,mage,frost,6,2,4
Vorass,kelthuzad,192,mage,frost,6,2,4
Nachtt,sargeras,192,mage,frost,6,2,4
Perkaset,turalyon,192,mage,frost,6,2,4
Snanth,black-dragonflight,192,mage,frost,6,2,4
Cradic,tichondrius,192,mage,frost,6,2,4
Avicci,shattered-halls,192,mage,frost,6,2,4
Audacy,sargeras,192,mage,frost,6,2,4
Fullmetal,jaedenar,192,mage,frost,6,2,4
Drewzz,tichondrius,192,mage,frost,6,2,4
Iguanodon,proudmoore,192,mage,frost,6,2,4
Fïtz,quelthalas,192,mage,frost,6,2,4
Pyroshima,barthilas,192,mage,frost,12,2,10
Mendittorosa,tichondrius,192,mage,frost,12,2,10
Èvilmage,blackrock,192,mage,frost,12,2,10
Rán,spirestone,192,mage,frost,12,2,10
Dreddpool,barthilas,192,mage,frost,12,2,10
Zerg,fenris,192,mage,frost,12,2,10
Sîmply,zuljin,192,mage,frost,12,2,10
Converseqt,stormrage,192,mage,frost,12,2,10
Mageyoulooks,shattered-hand,192,mage,frost,12,2,10
Hositonet,malganis,192,mage,frost,12,2,10
Wqnmlgbdy,tichondrius,192,mage,frost,18,2,16
Kahldyn,stormrage,191,mage,frost,4,3,1
Hense,stormrage,191,mage,frost,6,2,4
Rathrizar,emerald-dream,191,mage,frost,6,2,4
Silverstrza,gnomeregan,191,mage,frost,6,2,4
Brynach,trollbane,191,mage,frost,6,2,4
Cheapped,emerald-dream,175,mage,frost,6,3,3
Triambukh,grizzly-hills,159,mage,frost,5,2,3
Frosteddiks,shattered-halls,159,mage,frost,5,2,3
Erudit,tichondrius,144,mage,frost,15,2,13
Blakus,tichondrius,128,mage,frost,4,2,2
Goingmassive,frostmourne,127,mage,frost,4,2,2
Mongera,bonechewer,126,mage,frost,8,2,6
Snipymagus,shattered-hand,96,mage,frost,3,2,1
Sillycole,emerald-dream,96,mage,frost,3,2,1
Adrazell,sargeras,96,mage,frost,6,1,5
Freezze,malganis,96,mage,frost,6,1,5
Anuub,kelthuzad,96,mage,frost,6,1,5
Evilnuts,quelthalas,96,mage,frost,6,1,5
Linadeslayer,chogall,96,mage,frost,6,1,5
Jizzlez,tichondrius,96,mage,frost,6,1,5
Merkkinz,thrall,96,mage,frost,6,1,5
Meduka,proudmoore,96,mage,frost,6,1,5
Evilear,andorhal,96,mage,frost,6,1,5
Gnòmêrcy,kelthuzad,96,mage,frost,6,1,5
Themose,sargeras,96,mage,frost,6,1,5
Fookz,malganis,96,mage,frost,6,1,5
Ârcano,ragnaros,96,mage,frost,6,1,5
Ñõxx,sargeras,96,mage,frost,6,1,5
Michaelbust,tichondrius,96,mage,frost,6,1,5
Maagin,zuljin,96,mage,frost,6,1,5
Fortemage,tichondrius,96,mage,frost,6,1,5
Klinkr,illidan,96,mage,frost,6,1,5
Mastacombust,illidan,96,mage,frost,6,1,5
Ichirou,stormrage,96,mage,frost,6,1,5
Stormfrieza,tichondrius,96,mage,frost,6,1,5
Krabby,malganis,96,mage,frost,6,1,5
Ricter,hyjal,96,mage,frost,6,1,5
Khrixa,illidan,96,mage,frost,6,1,5
Åpollous,frostmourne,96,mage,frost,6,1,5
Professor,khadgar,96,mage,frost,6,1,5
Magicmom,wyrmrest-accord,96,mage,frost,6,1,5
Dathoe,laughing-skull,96,mage,frost,6,1,5
Furrblock,tichondrius,96,mage,frost,6,1,5
Nynalith,area-52,96,mage,frost,6,1,5
Coolhandz,tichondrius,96,mage,frost,6,1,5
Neverworks,tichondrius,96,mage,frost,6,1,5
Rizzbot,sargeras,96,mage,frost,12,1,11
Taladas,suramar,96,mage,frost,12,1,11
Icestory,tichondrius,96,mage,frost,13,1,12
Notria,illidan,79,mage,frost,5,1,4
Buckybever,illidan,79,mage,frost,11,1,10
Taevy,tichondrius,64,mage,frost,4,1,3
Barkäi,ragnaros,48,mage,frost,3,1,2
Alphricton,cenarion-circle,48,mage,frost,3,1,2
Woezx,stormreaver,2264,monk,mistweaver,68,47,21
Linlol,tichondrius,2219,monk,mistweaver,206,121,85
Zenjj,thorium-brotherhood,2209,monk,mistweaver,140,80,60
Emoeres,kelthuzad,2179,monk,mistweaver,98,53,45
Mysticallx,sargeras,2175,monk,mistweaver,72,47,25
Cuteballs,tichondrius,2138,monk,mistweaver,81,50,31
Crunchyrollx,tichondrius,2135,monk,mistweaver,66,49,17
Mãsterpõ,tichondrius,2134,monk,mistweaver,126,67,59
Jep,tichondrius,2129,monk,mistweaver,108,70,38
Weavied,sargeras,2129,monk,mistweaver,120,63,57
Griefgodx,tichondrius,2127,monk,mistweaver,88,49,39
Moonym,nagrand,2126,monk,mistweaver,68,41,27
Vaen,kelthuzad,2126,monk,mistweaver,78,47,31
Cool,crushridge,2124,monk,mistweaver,102,60,42
Purgenm,tichondrius,2122,monk,mistweaver,90,52,38
Sloppyroppy,tichondrius,2120,monk,mistweaver,89,50,39
Hernameplz,proudmoore,2120,monk,mistweaver,99,53,46
Heywhatsup,emerald-dream,2115,monk,mistweaver,96,48,48
Oliveirarr,tichondrius,2114,monk,mistweaver,114,64,50
Firewatches,emerald-dream,2113,monk,mistweaver,72,42,30
Akkiira,sargeras,2112,monk,mistweaver,72,42,30
Nohandslost,blackrock,2101,monk,mistweaver,107,51,56
Thet,sargeras,2094,monk,mistweaver,123,65,58
Woggitie,jubeithos,2093,monk,mistweaver,62,41,21
Itzokinlol,malganis,2086,monk,mistweaver,90,58,32
Oldmanswirl,mugthol,2077,monk,mistweaver,72,42,30
Glqjkglbfgdl,zuljin,2074,monk,mistweaver,108,60,48
Huaren,tichondrius,2058,monk,mistweaver,101,61,40
Originull,darkspear,2050,monk,mistweaver,65,37,28
Dãnwun,tichondrius,2048,monk,mistweaver,66,40,26
Kicub,emerald-dream,2047,monk,mistweaver,78,38,40
Wheatsli,malganis,2039,monk,mistweaver,114,67,47
Fizzlefarmer,moon-guard,2031,monk,mistweaver,89,54,35
Zhoku,tichondrius,2020,monk,mistweaver,58,34,24
Brazfu,skullcrusher,2016,monk,mistweaver,60,41,19
Speedcapped,area-52,2016,monk,mistweaver,126,63,63
Oblivæon,tichondrius,2012,monk,mistweaver,54,34,20
Punchgodx,greymane,2010,monk,mistweaver,78,46,32
Jiwå,terenas,2008,monk,mistweaver,355,187,168
Wetchickennz,tichondrius,1994,monk,mistweaver,102,63,39
Bhoredom,kiljaeden,1989,monk,mistweaver,116,65,51
Drdabz,illidan,1987,monk,mistweaver,36,24,12
Vongg,tichondrius,1950,monk,mistweaver,66,36,30
Praggers,proudmoore,1950,monk,mistweaver,65,35,30
Zukki,zuljin,1949,monk,mistweaver,88,54,34
Zuhakmw,tichondrius,1947,monk,mistweaver,78,39,39
Orbgodx,darkspear,1941,monk,mistweaver,48,30,18
Ðrägønéyèz,malygos,1940,monk,mistweaver,72,41,31
Leetcoder,tichondrius,1935,monk,mistweaver,141,91,50
Timermørk,kalecgos,1932,monk,mistweaver,48,32,16
Garbagemonk,scilla,1928,monk,mistweaver,36,27,9
Gsdfjskpx,sargeras,1926,monk,mistweaver,126,64,62
Pandacottoco,azralon,1924,monk,mistweaver,78,44,34
Imdabes,velen,1923,monk,mistweaver,72,39,33
Vethosis,illidan,1921,monk,mistweaver,43,27,16
Lmhs,tichondrius,1920,monk,mistweaver,54,32,22
Ònó,quelthalas,1919,monk,mistweaver,67,39,28
Grif,nazjatar,1918,monk,mistweaver,160,81,79
Parodies,illidan,1915,monk,mistweaver,55,28,27
Abellmonk,tichondrius,1910,monk,mistweaver,203,117,86
Brewsome,bloodhoof,1907,monk,mistweaver,76,40,36
Kristië,stormrage,1891,monk,mistweaver,42,30,12
Celerein,illidan,1889,monk,mistweaver,76,44,32
Wrxx,kelthuzad,1889,monk,mistweaver,179,91,88
Liltuna,icecrown,1887,monk,mistweaver,30,20,10
Poscom,tichondrius,1885,monk,mistweaver,89,68,21
Shad,frostmourne,1883,monk,mistweaver,90,53,37
Sintifissti,sargeras,1877,monk,mistweaver,42,28,14
Taeeun,tichondrius,1874,monk,mistweaver,45,30,15
Martiálfarts,malganis,1873,monk,mistweaver,36,25,11
Sifu,bleeding-hollow,1873,monk,mistweaver,59,36,23
Mavvi,tichondrius,1871,monk,mistweaver,74,42,32
Robocto,area-52,1869,monk,mistweaver,96,58,38
Igriefidiots,tichondrius,1868,monk,mistweaver,41,25,16
Swurvex,bleeding-hollow,1866,monk,mistweaver,42,25,17
Dalillama,stormreaver,1865,monk,mistweaver,48,31,17
Michæ,quelthalas,1864,monk,mistweaver,174,98,76
Nesoween,tichondrius,1863,monk,mistweaver,39,30,9
Taichí,tichondrius,1863,monk,mistweaver,59,33,26
Canghaigg,tichondrius,1860,monk,mistweaver,65,41,24
Papermade,barthilas,1860,monk,mistweaver,48,26,22
Suhjoon,bleeding-hollow,1859,monk,mistweaver,64,31,33
Sevenmonk,tichondrius,1857,monk,mistweaver,54,36,18
Piilsburry,sargeras,1855,monk,mistweaver,48,26,22
Toyotasupra,emerald-dream,1849,monk,mistweaver,60,38,22
Proghouse,illidan,1848,monk,mistweaver,48,27,21
Assez,tichondrius,1847,monk,mistweaver,56,30,26
Tonyboloney,tichondrius,1845,monk,mistweaver,42,25,17
Fîstweave,emerald-dream,1844,monk,mistweaver,77,45,32
Moremoretea,tichondrius,1843,monk,mistweaver,39,25,14
Crabfest,zuljin,1843,monk,mistweaver,60,35,25
Xinergy,illidan,1840,monk,mistweaver,98,65,33
Voidstate,stormrage,1840,monk,mistweaver,83,40,43
Fluval,moon-guard,1839,monk,mistweaver,59,41,18
Nabunaga,illidan,1837,monk,mistweaver,42,34,8
Okchat,emerald-dream,1837,monk,mistweaver,113,72,41
Baychiz,sargeras,1837,monk,mistweaver,42,25,17
Cardrik,thrall,1837,monk,mistweaver,90,45,45
Irraeine,malganis,1836,monk,mistweaver,48,31,17
Djkungfu,thrall,1836,monk,mistweaver,138,88,50
Caffeinated,barthilas,1836,monk,mistweaver,109,51,58
Guarantee,tichondrius,1832,monk,mistweaver,182,102,80
Secdog,tichondrius,1832,monk,mistweaver,60,27,33
Cmonkey,turalyon,1831,monk,mistweaver,48,31,17
Chadweave,moon-guard,1831,monk,mistweaver,78,42,36
Suamw,tichondrius,1827,monk,mistweaver,68,32,36
Sillyguy,stormrage,1825,monk,mistweaver,89,56,33
Logtich,moon-guard,1825,monk,mistweaver,66,35,31
Jackouse,frostmourne,1824,monk,mistweaver,50,31,19
Vrieden,illidan,1824,monk,mistweaver,81,34,47
Hugdealer,warsong,1823,monk,mistweaver,80,47,33
Gtmdyjs,illidan,1822,monk,mistweaver,29,20,9
Wootzhu,zuljin,1821,monk,mistweaver,80,41,39
Ilovefrogs,stormrage,1819,monk,mistweaver,60,30,30
Mcoos,tichondrius,1818,monk,mistweaver,86,54,32
Intra,exodar,1818,monk,mistweaver,117,62,55
Ándi,barthilas,1817,monk,mistweaver,53,28,25
Wolf,shattered-hand,1816,monk,mistweaver,30,19,11
Daito,jubeithos,1816,monk,mistweaver,105,62,43
Tyrfan,sargeras,1815,monk,mistweaver,54,30,24
Lexxbtw,thrall,1815,monk,mistweaver,107,59,48
Dræmwalker,malygos,1815,monk,mistweaver,253,126,127
Paperfist,stormrage,1813,monk,mistweaver,90,64,26
Dro,khadgar,1813,monk,mistweaver,36,19,17
Mistpump,tichondrius,1811,monk,mistweaver,48,26,22
Gummycat,bonechewer,1810,monk,mistweaver,54,36,18
Yokuu,thunderlord,1808,monk,mistweaver,54,29,25
Abeldra,moon-guard,1807,monk,mistweaver,82,42,40
Wingchungus,sargeras,1806,monk,mistweaver,24,19,5
Waggìes,moon-guard,1806,monk,mistweaver,53,30,23
Timed,shuhalo,1806,monk,mistweaver,49,26,23
Astrino,zuljin,1805,monk,mistweaver,42,29,13
Strongmandan,twisting-nether,1805,monk,mistweaver,42,23,19
Onlyfansx,ragnaros,1805,monk,mistweaver,256,139,117
Cenfu,malganis,1805,monk,mistweaver,72,29,43
Gamesuxlol,the-underbog,1804,monk,mistweaver,66,42,24
Rokkon,sargeras,1802,monk,mistweaver,42,25,17
Kungfoocious,tichondrius,1802,monk,mistweaver,57,33,24
Shiinobi,area-52,1802,monk,mistweaver,63,35,28
Mixflo,bleeding-hollow,1802,monk,mistweaver,39,20,19
Jakethegreat,moknathal,1801,monk,mistweaver,55,36,19
Jiucho,dalaran,1800,monk,mistweaver,35,23,12
Tiptea,stormrage,1799,monk,mistweaver,42,23,19
Mackiechan,kelthuzad,1797,monk,mistweaver,116,67,49
Zarenki,tichondrius,1794,monk,mistweaver,67,30,37
Natalié,caelestrasz,1793,monk,mistweaver,36,25,11
Àvríam,stormrage,1788,monk,mistweaver,47,22,25
Stonemists,ragnaros,1786,monk,mistweaver,30,21,9
Voltio,frostmane,1783,monk,mistweaver,91,60,31
Rexfiend,tichondrius,1782,monk,mistweaver,24,19,5
Raddxd,illidan,1781,monk,mistweaver,30,21,9
Lgee,kelthuzad,1774,monk,mistweaver,30,19,11
Cööked,illidan,1773,monk,mistweaver,54,31,23
Tokol,tichondrius,1773,monk,mistweaver,72,38,34
Liteup,smolderthorn,1770,monk,mistweaver,262,130,132
Greenbrews,area-52,1765,monk,mistweaver,122,67,55
Wigglygiggly,mannoroth,1762,monk,mistweaver,66,38,28
Crypomunkz,malganis,1758,monk,mistweaver,29,23,6
Femalejam,darkspear,1757,monk,mistweaver,47,29,18
Mikamonk,illidan,1755,monk,mistweaver,75,45,30
Ileffsinll,illidan,1755,monk,mistweaver,60,32,28
Fistofchanny,tichondrius,1752,monk,mistweaver,68,41,27
Spinharder,stormrage,1750,monk,mistweaver,65,38,27
Ðescubra,stormrage,1750,monk,mistweaver,74,42,32
Callmekoldi,dalaran,1748,monk,mistweaver,93,52,41
Gentleuncle,tichondrius,1747,monk,mistweaver,47,29,18
Bebuu,proudmoore,1744,monk,mistweaver,65,44,21
Postmark,tichondrius,1741,monk,mistweaver,42,23,19
Xdfu,stormrage,1734,monk,mistweaver,36,26,10
Tamonger,stormrage,1733,monk,mistweaver,139,83,56
Heha,tichondrius,1731,monk,mistweaver,30,22,8
Mariabaraks,darkspear,1729,monk,mistweaver,78,46,32
Alekun,quelthalas,1724,monk,mistweaver,59,35,24
Steelcase,frostmourne,1722,monk,mistweaver,47,26,21
Gramazen,tichondrius,1718,monk,mistweaver,42,25,17
Dupaweaver,stormrage,1717,monk,mistweaver,41,21,20
Mistweaverxo,malganis,1716,monk,mistweaver,68,42,26
Nezly,sargeras,1716,monk,mistweaver,36,21,15
Canghaimonk,tichondrius,1714,monk,mistweaver,54,25,29
Iightning,dentarg,1712,monk,mistweaver,54,32,22
Sleeks,bonechewer,1710,monk,mistweaver,45,27,18
Snuggubae,moon-guard,1710,monk,mistweaver,66,36,30
Starçandy,tichondrius,1710,monk,mistweaver,96,51,45
Ensaymada,frostmourne,1708,monk,mistweaver,66,34,32
Coomweaver,stormrage,1706,monk,mistweaver,36,18,18
Gnappyy,tichondrius,1705,monk,mistweaver,30,18,12
Røllitup,illidan,1704,monk,mistweaver,54,34,20
Turbokíll,proudmoore,1703,monk,mistweaver,36,22,14
Tirionx,area-52,1700,monk,mistweaver,108,66,42
Drracaryss,sargeras,1696,monk,mistweaver,42,29,13
Krömbopulos,magtheridon,1696,monk,mistweaver,36,24,12
Tazi,chromaggus,1696,monk,mistweaver,48,27,21
Zaqqari,wyrmrest-accord,1695,monk,mistweaver,48,24,24
Nakedidiot,kelthuzad,1693,monk,mistweaver,36,24,12
Ellesig,ragnaros,1691,monk,mistweaver,100,53,47
Hansul,tichondrius,1691,monk,mistweaver,65,29,36
Trackstarx,area-52,1687,monk,mistweaver,24,19,5
Gauche,arygos,1686,monk,mistweaver,144,74,70
Monklike,illidan,1685,monk,mistweaver,48,23,25
Bubblepony,illidan,1684,monk,mistweaver,167,86,81
Cromulent,saurfang,1682,monk,mistweaver,71,34,37
Mexii,hellscream,1682,monk,mistweaver,143,68,75
Canadá,bleeding-hollow,1681,monk,mistweaver,24,18,6
Discurzed,barthilas,1681,monk,mistweaver,33,20,13
Aráshicage,malganis,1681,monk,mistweaver,48,29,19
Planetariumz,bleeding-hollow,1681,monk,mistweaver,133,77,56
Moushindeiru,sargeras,1680,monk,mistweaver,36,30,6
Gujunpyó,sargeras,1678,monk,mistweaver,48,33,15
Stepfistz,aegwynn,1677,monk,mistweaver,66,36,30
Nuriva,tichondrius,1674,monk,mistweaver,30,23,7
Drunkentoker,illidan,1673,monk,mistweaver,48,26,22
Takugava,illidan,1671,monk,mistweaver,60,40,20
Stonymcblaze,malganis,1671,monk,mistweaver,42,25,17
Xcrispy,scilla,1670,monk,mistweaver,30,20,10
Phtarded,stormreaver,1669,monk,mistweaver,38,24,14
Nugskis,dalaran,1666,monk,mistweaver,263,135,128
Mememories,tichondrius,1665,monk,mistweaver,74,46,28
Decompress,illidan,1665,monk,mistweaver,42,25,17
Smallboots,area-52,1662,monk,mistweaver,24,20,4
Rectus,proudmoore,1659,monk,mistweaver,30,22,8
Onees,tichondrius,1659,monk,mistweaver,71,38,33
Èmacs,barthilas,1655,monk,mistweaver,29,21,8
Ttvchickchau,tichondrius,1654,monk,mistweaver,36,24,12
Calvana,tichondrius,1653,monk,mistweaver,101,40,61
Zuen,ragnaros,1652,monk,mistweaver,41,24,17
Yeji,altar-of-storms,1652,monk,mistweaver,43,21,22
Ropturttlê,tichondrius,1646,monk,mistweaver,30,22,8
Miillkz,zuljin,1644,monk,mistweaver,47,25,22
Místme,tichondrius,1641,monk,mistweaver,36,22,14
Tenoseven,area-52,1640,monk,mistweaver,21,19,2
Djux,zuljin,1639,monk,mistweaver,30,20,10
Ææøææôææôææô,illidan,1636,monk,mistweaver,78,58,20
Paralee,tichondrius,1635,monk,mistweaver,48,34,14
Beerflow,stormrage,1635,monk,mistweaver,42,23,19
Tezcatyo,malganis,1629,monk,mistweaver,36,23,13
Lovehate,zuljin,1629,monk,mistweaver,48,23,25
Wittymonk,illidan,1628,monk,mistweaver,47,31,16
Proventos,azralon,1628,monk,mistweaver,180,101,79
Gameníne,tichondrius,1627,monk,mistweaver,24,17,7
Baldbutcute,darkspear,1627,monk,mistweaver,28,19,9
Barelroll,proudmoore,1626,monk,mistweaver,59,44,15
Winfred,bleeding-hollow,1625,monk,mistweaver,42,28,14
Innerchii,tichondrius,1624,monk,mistweaver,24,17,7
Noremaç,frostmourne,1624,monk,mistweaver,30,17,13
Kaylux,stormrage,1623,monk,mistweaver,30,17,13
Aegea,illidan,1621,monk,mistweaver,24,17,7
Whaes,thrall,1621,monk,mistweaver,24,17,7
Intertwine,frostmourne,1619,monk,mistweaver,30,17,13
Seokdenam,tichondrius,1619,monk,mistweaver,78,42,36
Motogp,tichondrius,1619,monk,mistweaver,104,47,57
Avz,azralon,1618,monk,mistweaver,30,21,9
Hunkymonky,thrall,1618,monk,mistweaver,45,29,16
Jaja,kiljaeden,1617,monk,mistweaver,30,17,13
Pumakicks,tichondrius,1616,monk,mistweaver,47,26,21
Nekzí,sargeras,1615,monk,mistweaver,30,20,10
Greenrice,thrall,1615,monk,mistweaver,40,25,15
Pacee,deathwing,1613,monk,mistweaver,24,17,7
Velenious,tichondrius,1613,monk,mistweaver,62,41,21
Xhangtu,thrall,1612,monk,mistweaver,70,46,24
Qords,tichondrius,1612,monk,mistweaver,148,77,71
Mistweave,aerie-peak,1611,monk,mistweaver,24,17,7
Pingpang,stormreaver,1610,monk,mistweaver,81,46,35
Unclety,tichondrius,1610,monk,mistweaver,36,20,16
Furyjames,quelthalas,1610,monk,mistweaver,66,28,38
Hîbîscus,illidan,1609,monk,mistweaver,32,17,15
Integrity,durotan,1608,monk,mistweaver,53,30,23
Harkwind,azralon,1608,monk,mistweaver,90,49,41
Eatmykïtty,dalaran,1607,monk,mistweaver,30,22,8
Pomonk,nazjatar,1607,monk,mistweaver,67,45,22
Lilsloptop,moon-guard,1605,monk,mistweaver,93,60,33
Hiiyaa,tichondrius,1605,monk,mistweaver,78,43,35
Pandaiax,area-52,1605,monk,mistweaver,59,31,28
Cherep,kiljaeden,1605,monk,mistweaver,66,32,34
Oblivion,wildhammer,1604,monk,mistweaver,61,36,25
Goochtickles,bleeding-hollow,1602,monk,mistweaver,128,79,49
Qxt,tichondrius,1601,monk,mistweaver,46,25,21
Roogymw,emerald-dream,1601,monk,mistweaver,48,24,24
Lunarc,mannoroth,1600,monk,mistweaver,58,41,17
Boogstyle,malganis,1599,monk,mistweaver,28,18,10
Mistastep,tichondrius,1599,monk,mistweaver,78,38,40
Mð,vashj,1596,monk,mistweaver,48,21,27
Lightskinmon,area-52,1595,monk,mistweaver,42,23,19
Centalink,barthilas,1594,monk,mistweaver,44,30,14
Kansú,ragnaros,1594,monk,mistweaver,58,24,34
Grabbitz,kelthuzad,1592,monk,mistweaver,30,19,11
Pp,icecrown,1589,monk,mistweaver,31,27,4
Kendro,trollbane,1589,monk,mistweaver,53,34,19
Cangry,area-52,1589,monk,mistweaver,42,19,23
Neonep,stormrage,1586,monk,mistweaver,130,72,58
Kwoon,hyjal,1585,monk,mistweaver,52,30,22
Crypslegacy,tichondrius,1584,monk,mistweaver,68,34,34
Itspoils,illidan,1583,monk,mistweaver,31,22,9
Ekèl,tichondrius,1581,monk,mistweaver,48,29,19
Yepcocc,lightbringer,1581,monk,mistweaver,29,17,12
Patfu,area-52,1581,monk,mistweaver,29,17,12
Monjimen,ragnaros,1579,monk,mistweaver,53,31,22
Safiel,proudmoore,1577,monk,mistweaver,102,43,59
Waataafaak,malganis,1574,monk,mistweaver,48,25,23
Moonhealsyou,moon-guard,1573,monk,mistweaver,67,41,26
Wildfists,tichondrius,1572,monk,mistweaver,263,132,131
Boneykicks,tichondrius,1569,monk,mistweaver,42,21,21
Sixsticks,tichondrius,1566,monk,mistweaver,40,23,17
Fistuhcuffs,sargeras,1561,monk,mistweaver,87,49,38
Greenstar,bleeding-hollow,1557,monk,mistweaver,100,52,48
Showshoway,tichondrius,1556,monk,mistweaver,41,20,21
Josciel,ragnaros,1552,monk,mistweaver,200,101,99
Sabersatin,sargeras,1550,monk,mistweaver,42,21,21
Rañga,caelestrasz,1548,monk,mistweaver,30,17,13
Shlunks,illidan,1548,monk,mistweaver,117,62,55
Notfw,tichondrius,1547,monk,mistweaver,62,27,35
Manggi,tichondrius,1546,monk,mistweaver,55,33,22
Nailtech,tichondrius,1543,monk,mistweaver,51,29,22
Gnetic,nemesis,1543,monk,mistweaver,38,20,18
Grizzm,sargeras,1542,monk,mistweaver,36,22,14
Romdansik,tichondrius,1542,monk,mistweaver,107,60,47
Rakia,moon-guard,1539,monk,mistweaver,112,54,58
Keileas,moon-guard,1534,monk,mistweaver,94,43,51
Endér,tichondrius,1533,monk,mistweaver,84,48,36
Hyori,saurfang,1532,monk,mistweaver,30,16,14
Dryungpwnz,zuljin,1530,monk,mistweaver,72,44,28
Jadestørmz,illidan,1529,monk,mistweaver,18,16,2
Brucechez,tichondrius,1529,monk,mistweaver,24,16,8
Janeil,wyrmrest-accord,1529,monk,mistweaver,87,48,39
Carzo,area-52,1527,monk,mistweaver,38,23,15
Märthä,azralon,1527,monk,mistweaver,75,41,34
Ludan,eredar,1527,monk,mistweaver,37,20,17
Timbomist,kelthuzad,1526,monk,mistweaver,30,16,14
Lépøissøn,tichondrius,1525,monk,mistweaver,30,16,14
Glad,stormscale,1524,monk,mistweaver,116,69,47
Bunnygal,thaurissan,1522,monk,mistweaver,83,41,42
Metakillër,ragnaros,1522,monk,mistweaver,76,37,39
Kiqz,stormrage,1519,monk,mistweaver,30,16,14
Chelada,sargeras,1513,monk,mistweaver,48,22,26
Themonkfunk,bleeding-hollow,1511,monk,mistweaver,36,25,11
Snoodle,korgath,1507,monk,mistweaver,42,26,16
Pagtuk,daggerspine,1507,monk,mistweaver,48,23,25
Tinypunch,emerald-dream,1496,monk,mistweaver,72,34,38
Kazov,proudmoore,1493,monk,mistweaver,95,55,40
Mungka,tichondrius,1487,monk,mistweaver,82,43,39
Fistnanweavn,dawnbringer,1487,monk,mistweaver,62,27,35
Warzsong,azralon,1486,monk,mistweaver,54,33,21
Oakleet,bleeding-hollow,1486,monk,mistweaver,42,23,19
Tenshu,runetotem,1484,monk,mistweaver,33,20,13
Buddhabud,sargeras,1483,monk,mistweaver,42,22,20
Grommin,area-52,1482,monk,mistweaver,64,39,25
Soothinn,tichondrius,1481,monk,mistweaver,36,26,10
Kariwanji,tichondrius,1481,monk,mistweaver,46,29,17
Slothman,nagrand,1481,monk,mistweaver,48,27,21
Bebess,moon-guard,1480,monk,mistweaver,33,18,15
Âfrika,ysondre,1480,monk,mistweaver,65,31,34
Talented,azuremyst,1477,monk,mistweaver,63,41,22
Monkpowaz,stormrage,1476,monk,mistweaver,42,26,16
Aokuâng,malganis,1473,monk,mistweaver,36,26,10
Mòñk,shattered-halls,1473,monk,mistweaver,42,26,16
Lonebamboo,tichondrius,1472,monk,mistweaver,33,17,16
Wheygodx,lothar,1471,monk,mistweaver,42,28,14
Slashsmack,caelestrasz,1470,monk,mistweaver,42,19,23
Scrapfu,proudmoore,1467,monk,mistweaver,48,22,26
Bobbybiz,bleeding-hollow,1465,monk,mistweaver,42,27,15
Gotmonk,aggramar,1464,monk,mistweaver,30,19,11
Xtrememisty,frostmourne,1462,monk,mistweaver,54,30,24
Gnomepuncher,dalaran,1459,monk,mistweaver,48,25,23
Fidgetspinna,zuljin,1457,monk,mistweaver,38,18,20
Vorikson,stormrage,1457,monk,mistweaver,78,35,43
Banterx,sargeras,1457,monk,mistweaver,47,20,27
Sangthos,darkspear,1455,monk,mistweaver,48,19,29
Slipperybobs,tichondrius,1453,monk,mistweaver,41,25,16
Lekrosa,thrall,1453,monk,mistweaver,47,24,23
Sudury,tichondrius,1451,monk,mistweaver,54,29,25
Dedracula,quelthalas,1450,monk,mistweaver,39,27,12
Versachi,stormreaver,1446,monk,mistweaver,42,18,24
Yurm,moon-guard,1445,monk,mistweaver,24,20,4
Lidela,sargeras,1445,monk,mistweaver,52,27,25
Cranekicks,moon-guard,1444,monk,mistweaver,116,63,53
Tarkir,quelthalas,1443,monk,mistweaver,30,19,11
Meshugah,quelthalas,1443,monk,mistweaver,42,18,24
Yasysy,tichondrius,1439,monk,mistweaver,24,15,9
Zuhak,tichondrius,1438,monk,mistweaver,24,15,9
Elcidx,tichondrius,1438,monk,mistweaver,24,15,9
Mukboo,tichondrius,1435,monk,mistweaver,30,15,15
Axellrod,tichondrius,1432,monk,mistweaver,24,16,8
Pichau,zuljin,1431,monk,mistweaver,21,16,5
Iamamonk,kelthuzad,1429,monk,mistweaver,20,17,3
Fuqame,kiljaeden,1428,monk,mistweaver,42,19,23
Baroon,chogall,1427,monk,mistweaver,53,22,31
Hepp,stormrage,1425,monk,mistweaver,24,15,9
Pøkemonk,malganis,1424,monk,mistweaver,24,15,9
Spencere,hyjal,1421,monk,mistweaver,30,15,15
Taijutzu,darkspear,1419,monk,mistweaver,24,15,9
Vegoku,moon-guard,1416,monk,mistweaver,54,32,22
Spaazz,tichondrius,1411,monk,mistweaver,41,25,16
Ungankable,sargeras,1408,monk,mistweaver,60,32,28
Ghorb,boulderfist,1406,monk,mistweaver,41,20,21
Bungfist,stormrage,1404,monk,mistweaver,23,15,8
Kungfused,frostmourne,1403,monk,mistweaver,30,15,15
Seung,duskwood,1402,monk,mistweaver,156,68,88
Fister,garithos,1398,monk,mistweaver,28,20,8
Mightbweavin,bleeding-hollow,1398,monk,mistweaver,78,34,44
Htm,barthilas,1392,monk,mistweaver,41,16,25
Dashenna,illidan,1390,monk,mistweaver,54,20,34
Carzzy,sargeras,1388,monk,mistweaver,23,15,8
Kylièjenner,gilneas,1387,monk,mistweaver,30,19,11
Drama,tichondrius,1384,monk,mistweaver,26,18,8
Leemîn,tichondrius,1382,monk,mistweaver,24,17,7
Dlysezzic,tichondrius,1381,monk,mistweaver,29,15,14
Pablojám,ragnaros,1375,monk,mistweaver,36,20,16
Rhynoo,lothar,1371,monk,mistweaver,60,33,27
Zundor,ghostlands,1368,monk,mistweaver,20,15,5
Ozen,burning-blade,1368,monk,mistweaver,60,30,30
Ninjagordu,nemesis,1368,monk,mistweaver,43,20,23
Aledal,agamaggan,1366,monk,mistweaver,30,17,13
Ric,gundrak,1363,monk,mistweaver,63,37,26
Monktor,dalaran,1363,monk,mistweaver,30,16,14
Ywingtsuan,frostmourne,1363,monk,mistweaver,29,15,14
Lõgan,azralon,1362,monk,mistweaver,46,24,22
Muzzye,frostmourne,1355,monk,mistweaver,52,31,21
Gooncave,stormrage,1354,monk,mistweaver,23,15,8
Iloki,shuhalo,1352,monk,mistweaver,42,23,19
Smackdat,azjolnerub,1348,monk,mistweaver,49,26,23
Damemasduro,ragnaros,1347,monk,mistweaver,123,57,66
Ninjatoots,aerie-peak,1346,monk,mistweaver,59,36,23
Pandemikmonk,turalyon,1346,monk,mistweaver,42,19,23
Shandaspanda,rivendare,1344,monk,mistweaver,33,17,16
Veejaex,stormreaver,1343,monk,mistweaver,18,14,4
Akiramenaide,tichondrius,1343,monk,mistweaver,18,14,4
Rylens,draka,1343,monk,mistweaver,40,25,15
Siserfister,sargeras,1343,monk,mistweaver,24,14,10
Damogen,spinebreaker,1343,monk,mistweaver,30,14,16
Kris,llane,1342,monk,mistweaver,24,14,10
Cnww,tichondrius,1342,monk,mistweaver,24,14,10
Séthrogèn,tichondrius,1341,monk,mistweaver,18,14,4
Phattea,thrall,1340,monk,mistweaver,18,14,4
Rîce,burning-blade,1339,monk,mistweaver,18,14,4
Turbofist,bleeding-hollow,1337,monk,mistweaver,24,14,10
Luvdeluxe,skullcrusher,1336,monk,mistweaver,24,14,10
Valian,tichondrius,1336,monk,mistweaver,24,14,10
Zenmasta,exodar,1336,monk,mistweaver,30,17,13
Tiduskies,crushridge,1335,monk,mistweaver,24,14,10
Vonn,drakkari,1335,monk,mistweaver,36,17,19
Iielia,wyrmrest-accord,1335,monk,mistweaver,35,16,19
Nicotinetap,tichondrius,1334,monk,mistweaver,24,14,10
Chañi,ragnaros,1333,monk,mistweaver,59,33,26
Chongal,whisperwind,1332,monk,mistweaver,24,14,10
Rizzdriver,moon-guard,1330,monk,mistweaver,24,14,10
Toastage,tichondrius,1328,monk,mistweaver,24,14,10
Tirêd,sargeras,1325,monk,mistweaver,36,15,21
Tenzing,azgalor,1324,monk,mistweaver,24,14,10
Momochi,malygos,1323,monk,mistweaver,30,16,14
Americå,zuljin,1322,monk,mistweaver,24,15,9
Nerfmonk,spirestone,1322,monk,mistweaver,24,14,10
Puoll,gallywix,1321,monk,mistweaver,71,38,33
Mcfluffey,area-52,1321,monk,mistweaver,50,26,24
Ralphiex,tichondrius,1318,monk,mistweaver,77,37,40
Shon,frostmourne,1316,monk,mistweaver,24,14,10
Boozebear,spirestone,1316,monk,mistweaver,53,28,25
Albusventos,azralon,1315,monk,mistweaver,35,21,14
Healzpapi,tichondrius,1314,monk,mistweaver,36,16,20
Jackphan,azralon,1313,monk,mistweaver,42,20,22
Sweatweaver,frostmourne,1313,monk,mistweaver,64,28,36
Abdoolah,illidan,1309,monk,mistweaver,24,14,10
Punch,lothar,1309,monk,mistweaver,31,18,13
Brewmanchew,frostmourne,1308,monk,mistweaver,24,14,10
Swiftm,thrall,1308,monk,mistweaver,57,32,25
Reque,illidan,1305,monk,mistweaver,66,40,26
Kemmy,ravencrest,1305,monk,mistweaver,25,14,11
Flixz,stormrage,1304,monk,mistweaver,30,15,15
Dextr,arthas,1302,monk,mistweaver,27,14,13
Ojiin,wyrmrest-accord,1300,monk,mistweaver,175,89,86
Drinkkin,bleeding-hollow,1298,monk,mistweaver,24,14,10
Jeffdagnome,moon-guard,1291,monk,mistweaver,78,38,40
Ermac,kiljaeden,1289,monk,mistweaver,23,14,9
Dblfistez,stormreaver,1287,monk,mistweaver,40,16,24
Zeiana,proudmoore,1280,monk,mistweaver,38,22,16
Tert,aerie-peak,1279,monk,mistweaver,48,31,17
Monxellius,moon-guard,1279,monk,mistweaver,45,24,21
Byakugan,moon-guard,1277,monk,mistweaver,35,20,15
Betasquadxd,bleeding-hollow,1272,monk,mistweaver,31,15,16
Poundmedaddi,tichondrius,1270,monk,mistweaver,42,27,15
Gallorex,frostmourne,1262,monk,mistweaver,36,20,16
Yunmen,blades-edge,1262,monk,mistweaver,29,14,15
Omimonk,sargeras,1251,monk,mistweaver,56,24,32
Ringofpeace,sargeras,1248,monk,mistweaver,18,13,5
Aviee,illidan,1248,monk,mistweaver,24,13,11
Ticmonk,frostmourne,1247,monk,mistweaver,18,13,5
Elvenmonk,frostmane,1247,monk,mistweaver,18,13,5
Nelly,grizzly-hills,1247,monk,mistweaver,24,13,11
Gothamonk,tichondrius,1247,monk,mistweaver,24,13,11
Dancah,eitrigg,1247,monk,mistweaver,24,13,11
Evilstep,tichondrius,1247,monk,mistweaver,60,31,29
Antriai,icecrown,1247,monk,mistweaver,36,13,23
Hîddëncløùdx,tichondrius,1245,monk,mistweaver,18,13,5
Ieatshrooms,malfurion,1245,monk,mistweaver,60,25,35
Confa,ragnaros,1245,monk,mistweaver,45,18,27
Qarmax,azralon,1244,monk,mistweaver,24,13,11
React,frostwolf,1242,monk,mistweaver,18,13,5
Poppyharlow,saurfang,1240,monk,mistweaver,24,17,7
Cisneros,doomhammer,1236,monk,mistweaver,39,14,25
Zenquadz,elune,1234,monk,mistweaver,30,21,9
Lolkungfu,spirestone,1234,monk,mistweaver,24,13,11
Chiban,misha,1232,monk,mistweaver,24,13,11
Azizyzz,barthilas,1231,monk,mistweaver,42,20,22
Darkheälzz,sargeras,1231,monk,mistweaver,48,22,26
Shizunô,stormrage,1229,monk,mistweaver,30,14,16
Fkedyourwife,dalaran,1227,monk,mistweaver,30,13,17
Darrhon,illidan,1226,monk,mistweaver,42,21,21
Chnzhs,tichondrius,1222,monk,mistweaver,37,13,24
Cammy,aerie-peak,1219,monk,mistweaver,32,20,12
Phoenixspark,gnomeregan,1211,monk,mistweaver,18,13,5
Marimonkori,stormscale,1205,monk,mistweaver,45,21,24
Menadraene,wyrmrest-accord,1198,monk,mistweaver,26,14,12
Puffpuffp,nazgrel,1196,monk,mistweaver,24,13,11
Boostmonk,terenas,1187,monk,mistweaver,54,25,29
Anthuri,frostmourne,1178,monk,mistweaver,41,28,13
Iseeyouqt,tichondrius,1176,monk,mistweaver,20,13,7
Ferrarí,quelthalas,1176,monk,mistweaver,63,31,32
Kodrik,tichondrius,1175,monk,mistweaver,48,23,25
Miçrosoft,area-52,1174,monk,mistweaver,42,24,18
Gobfu,emerald-dream,1168,monk,mistweaver,59,24,35
Hie,laughing-skull,1166,monk,mistweaver,90,38,52
Shwankeesha,thrall,1165,monk,mistweaver,28,14,14
Keyszz,tichondrius,1162,monk,mistweaver,76,24,52
Callibella,amanthul,1155,monk,mistweaver,26,13,13
Razod,stormrage,1155,monk,mistweaver,59,29,30
Xaurian,firetree,1153,monk,mistweaver,22,13,9
Supbro,hyjal,1152,monk,mistweaver,18,12,6
Magmuruk,garrosh,1152,monk,mistweaver,18,12,6
Yobeel,tichondrius,1152,monk,mistweaver,30,12,18
Jojostar,shadowsong,1150,monk,mistweaver,24,12,12
Ïtächï,illidan,1150,monk,mistweaver,30,12,18
Bastilaqt,korgath,1149,monk,mistweaver,25,13,12
Aioffe,emerald-dream,1149,monk,mistweaver,24,12,12
Strixx,silvermoon,1147,monk,mistweaver,18,14,4
Rexzilla,tichondrius,1146,monk,mistweaver,18,12,6
Kaniou,proudmoore,1146,monk,mistweaver,29,13,16
Jagichan,area-52,1145,monk,mistweaver,18,12,6
Monkaveli,ursin,1145,monk,mistweaver,78,37,41
Kexti,wyrmrest-accord,1135,monk,mistweaver,45,18,27
Chuks,nerzhul,1132,monk,mistweaver,99,52,47
Szuka,tichondrius,1131,monk,mistweaver,18,12,6
Herbivorous,sargeras,1131,monk,mistweaver,24,12,12
Modelman,area-52,1130,monk,mistweaver,26,14,12
Affrika,ragnaros,1127,monk,mistweaver,35,15,20
Bussyweaver,sargeras,1125,monk,mistweaver,18,12,6
Sedition,emerald-dream,1123,monk,mistweaver,198,99,99
Søpra,zuljin,1114,monk,mistweaver,26,13,13
Orbii,tichondrius,1111,monk,mistweaver,42,29,13
Dokfu,tichondrius,1108,monk,mistweaver,79,46,33
Fitmonje,drakkari,1107,monk,mistweaver,31,15,16
Biggoosie,korgath,1106,monk,mistweaver,52,31,21
Sinistuhm,tichondrius,1104,monk,mistweaver,23,12,11
Waxxi,barthilas,1104,monk,mistweaver,48,22,26
Baittor,proudmoore,1100,monk,mistweaver,21,13,8
Meepmonk,kilrogg,1098,monk,mistweaver,27,13,14
Purging,draka,1096,monk,mistweaver,44,30,14
Fistmeister,tichondrius,1089,monk,mistweaver,18,13,5
Shùù,tichondrius,1086,monk,mistweaver,17,12,5
Hache,azjolnerub,1078,monk,mistweaver,74,32,42
Misthealz,black-dragonflight,1070,monk,mistweaver,19,12,7
Threefanandy,kelthuzad,1056,monk,mistweaver,12,11,1
Duelist,the-scryers,1056,monk,mistweaver,12,11,1
Swoleypoley,tichondrius,1056,monk,mistweaver,18,11,7
Mistussy,sargeras,1056,monk,mistweaver,18,11,7
Poppinbrews,thrall,1056,monk,mistweaver,18,11,7
Breadweaver,malganis,1056,monk,mistweaver,24,11,13
Forgèt,kelthuzad,1056,monk,mistweaver,24,11,13
Squalicorax,area-52,1056,monk,mistweaver,24,11,13
Undertickle,illidan,1055,monk,mistweaver,18,11,7
Iplus,thrall,1055,monk,mistweaver,18,11,7
Bromonster,zuljin,1055,monk,mistweaver,18,11,7
Xuenws,tichondrius,1055,monk,mistweaver,18,11,7
Oppsimop,frostmourne,1055,monk,mistweaver,24,11,13
Chessyx,ragnaros,1055,monk,mistweaver,24,11,13
Chillionaíre,proudmoore,1055,monk,mistweaver,24,11,13
Dreadknotz,hyjal,1054,monk,mistweaver,42,17,25
Santiaguiño,ragnaros,1054,monk,mistweaver,36,11,25
Wungpo,the-forgotten-coast,1052,monk,mistweaver,18,11,7
Havasupai,turalyon,1052,monk,mistweaver,18,11,7
Karnbroo,frostmourne,1052,monk,mistweaver,24,11,13
Tobyblack,illidan,1049,monk,mistweaver,18,11,7
Johnkreese,andorhal,1049,monk,mistweaver,24,11,13
Proctology,tichondrius,1047,monk,mistweaver,18,11,7
Delassian,moon-guard,1044,monk,mistweaver,34,16,18
Raidenmnx,tichondrius,1042,monk,mistweaver,24,11,13
Knaveus,frostmourne,1039,monk,mistweaver,18,11,7
Teancrumpets,wyrmrest-accord,1038,monk,mistweaver,48,20,28
Xulieng,tichondrius,1035,monk,mistweaver,166,82,84
Tadaku,dalaran,1033,monk,mistweaver,37,17,20
Puya,nemesis,1032,monk,mistweaver,24,11,13
Kickbone,tichondrius,1032,monk,mistweaver,30,11,19
Merand,tichondrius,1031,monk,mistweaver,36,20,16
Marnartou,zuljin,1026,monk,mistweaver,12,11,1
Ainz,nagrand,1016,monk,mistweaver,30,15,15
Clutchinmist,malganis,1016,monk,mistweaver,28,12,16
Kfpanda,hellscream,1015,monk,mistweaver,30,14,16
Ratioed,moon-guard,1014,monk,mistweaver,23,15,8
Vum,quelthalas,1007,monk,mistweaver,15,12,3
Twizzurp,magtheridon,1007,monk,mistweaver,21,12,9
Jerumay,tichondrius,1000,monk,mistweaver,23,11,12
Wmo,tichondrius,997,monk,mistweaver,17,11,6
Kimonk,proudmoore,996,monk,mistweaver,18,11,7
Telrande,ysondre,994,monk,mistweaver,35,24,11
Monkgringo,azralon,983,monk,mistweaver,48,27,21
Deadlyzz,gilneas,983,monk,mistweaver,64,35,29
Bomer,moknathal,969,monk,mistweaver,32,21,11
Drizzywow,arathor,960,monk,mistweaver,12,10,2
Hype,ursin,960,monk,mistweaver,12,10,2
Inkar,tichondrius,960,monk,mistweaver,18,10,8
Proxy,ragnaros,960,monk,mistweaver,18,10,8
Nahr,tichondrius,960,monk,mistweaver,18,10,8
Fheng,emerald-dream,960,monk,mistweaver,18,10,8
Greenfriend,illidan,960,monk,mistweaver,18,10,8
Bouncymoo,frostmourne,960,monk,mistweaver,18,10,8
Danarolls,spirestone,960,monk,mistweaver,24,10,14
Shâdòw,ragnaros,959,monk,mistweaver,12,10,2
Blasê,frostmourne,959,monk,mistweaver,12,10,2
Somebodym,illidan,959,monk,mistweaver,12,10,2
Guïnness,tichondrius,959,monk,mistweaver,15,11,4
Monkwalker,tichondrius,959,monk,mistweaver,18,10,8
Friskyfister,tichondrius,959,monk,mistweaver,18,10,8
Cymonka,sargeras,959,monk,mistweaver,18,10,8
Sodamint,sargeras,959,monk,mistweaver,18,10,8
Chanîng,frostmourne,959,monk,mistweaver,18,10,8
Korata,frostwolf,959,monk,mistweaver,18,10,8
Gino,proudmoore,959,monk,mistweaver,48,25,23
Miniswag,arthas,959,monk,mistweaver,24,10,14
Lostinmistz,tichondrius,958,monk,mistweaver,18,10,8
Snoozzy,kelthuzad,958,monk,mistweaver,24,10,14
Jèricho,thrall,955,monk,mistweaver,18,10,8
Wessex,sargeras,954,monk,mistweaver,18,10,8
Hapgido,deathwing,954,monk,mistweaver,31,14,17
Güwop,tichondrius,951,monk,mistweaver,24,10,14
Brewtalitops,illidan,950,monk,mistweaver,18,10,8
Afw,moon-guard,949,monk,mistweaver,18,10,8
Pepperoncini,korgath,947,monk,mistweaver,36,10,26
Akfourseven,barthilas,945,monk,mistweaver,69,31,38
Aramonk,tichondrius,926,monk,mistweaver,14,11,3
Xbrewtal,tichondrius,909,monk,mistweaver,30,17,13
Vencö,tichondrius,909,monk,mistweaver,27,10,17
Äncient,quelthalas,908,monk,mistweaver,15,11,4
Statue,cenarius,895,monk,mistweaver,11,10,1
Stickbundle,illidan,888,monk,mistweaver,15,11,4
Monkgyfatso,tichondrius,878,monk,mistweaver,11,10,1
Flicksx,arthas,864,monk,mistweaver,12,9,3
Alternatives,sargeras,864,monk,mistweaver,12,9,3
Chaddington,malorne,864,monk,mistweaver,12,9,3
Imnumberone,alterac-mountains,864,monk,mistweaver,12,9,3
Ggonext,wyrmrest-accord,864,monk,mistweaver,12,9,3
Qtmonk,emerald-dream,864,monk,mistweaver,12,9,3
Jonnymon,sargeras,864,monk,mistweaver,12,9,3
Basedbuck,dalaran,864,monk,mistweaver,12,9,3
Bobbytheorc,tichondrius,864,monk,mistweaver,18,9,9
Sqmw,tichondrius,864,monk,mistweaver,18,9,9
Kriticalkush,kelthuzad,864,monk,mistweaver,18,9,9
Dwánesan,tichondrius,864,monk,mistweaver,18,9,9
Elesm,area-52,864,monk,mistweaver,18,9,9
Gottí,sargeras,864,monk,mistweaver,18,9,9
Keiirah,zuluhed,864,monk,mistweaver,24,9,15
Babyfaceqt,skullcrusher,864,monk,mistweaver,24,9,15
Seaja,malganis,864,monk,mistweaver,69,14,55
Senseii,dathremar,863,monk,mistweaver,12,9,3
Ghðst,ragnaros,863,monk,mistweaver,12,9,3
Cystweaver,dalaran,863,monk,mistweaver,12,9,3
Sshri,illidan,863,monk,mistweaver,18,9,9
Breezymist,doomhammer,863,monk,mistweaver,18,9,9
Oochi,illidan,863,monk,mistweaver,18,9,9
Fisetèrr,kelthuzad,863,monk,mistweaver,18,9,9
Nelda,gorgonnash,862,monk,mistweaver,12,9,3
Kungupanda,nesingwary,862,monk,mistweaver,24,9,15
Pimpolhona,nemesis,862,monk,mistweaver,24,9,15
Odogin,tichondrius,861,monk,mistweaver,12,9,3
Palomagozzu,ragnaros,860,monk,mistweaver,12,9,3
Jugies,emerald-dream,860,monk,mistweaver,18,9,9
Bobthedrag,illidan,860,monk,mistweaver,18,9,9
Fludz,burning-blade,859,monk,mistweaver,24,9,15
Troutline,bonechewer,858,monk,mistweaver,12,9,3
Monkism,warsong,855,monk,mistweaver,12,9,3
Winwakamank,sargeras,855,monk,mistweaver,24,9,15
Zefta,moon-guard,855,monk,mistweaver,24,9,15
Bullshido,aerie-peak,851,monk,mistweaver,18,9,9
Hirav,khazgoroth,847,monk,mistweaver,18,9,9
Sìrtankallot,stormrage,837,monk,mistweaver,32,9,23
Goodluck,madoran,809,monk,mistweaver,27,10,17
Dreamy,mugthol,769,monk,mistweaver,30,10,20
Ricearolli,area-52,768,monk,mistweaver,12,8,4
Jiskweaver,sargeras,768,monk,mistweaver,12,8,4
Garg,malganis,768,monk,mistweaver,12,8,4
Furiousfrank,stormrage,768,monk,mistweaver,12,8,4
Gess,stormscale,768,monk,mistweaver,12,8,4
Torakigai,ghostlands,768,monk,mistweaver,12,8,4
Kynalla,thunderlord,768,monk,mistweaver,12,8,4
Ninjachavez,tichondrius,768,monk,mistweaver,12,8,4
Cuckoon,malganis,768,monk,mistweaver,12,8,4
Yamatoqt,frostmourne,768,monk,mistweaver,12,8,4
Zipmw,tichondrius,768,monk,mistweaver,12,8,4
Tuladura,tichondrius,768,monk,mistweaver,12,8,4
Manchu,stormrage,768,monk,mistweaver,12,8,4
Scrypter,proudmoore,768,monk,mistweaver,12,8,4
Missweaver,sargeras,768,monk,mistweaver,12,8,4
Zenox,rexxar,768,monk,mistweaver,18,8,10
Velzarria,zuljin,768,monk,mistweaver,18,8,10
Dreamscapexo,kelthuzad,768,monk,mistweaver,18,8,10
Kwatann,bonechewer,768,monk,mistweaver,18,8,10
Imafqnbaby,tichondrius,768,monk,mistweaver,18,8,10
Epî,tichondrius,768,monk,mistweaver,18,8,10
Jeolmyung,tichondrius,767,monk,mistweaver,12,8,4
Lenee,frostmourne,767,monk,mistweaver,12,8,4
Dragonwhirl,stormrage,767,monk,mistweaver,12,8,4
Qup,lightbringer,767,monk,mistweaver,12,8,4
Cryptmist,frostmourne,767,monk,mistweaver,12,8,4
Blitzcombo,thrall,767,monk,mistweaver,12,8,4
Aerona,stormreaver,767,monk,mistweaver,12,8,4
Raígon,ragnaros,767,monk,mistweaver,18,8,10
Elfass,bleeding-hollow,767,monk,mistweaver,18,8,10
Barleygar,tichondrius,767,monk,mistweaver,18,8,10
Phatcheeks,aegwynn,766,monk,mistweaver,12,8,4
Artomist,stormrage,766,monk,mistweaver,12,8,4
Sobuu,wyrmrest-accord,765,monk,mistweaver,12,8,4
Sihgriid,tichondrius,765,monk,mistweaver,18,8,10
Madmint,illidan,765,monk,mistweaver,18,8,10
Wzzi,tichondrius,765,monk,mistweaver,18,8,10
Orenj,boulderfist,764,monk,mistweaver,12,8,4
Scips,fizzcrank,764,monk,mistweaver,18,8,10
Prddoss,quelthalas,745,monk,mistweaver,12,8,4
Sätsu,bleeding-hollow,735,monk,mistweaver,17,8,9
ßrewslèè,tichondrius,732,monk,mistweaver,14,9,5
Kryflex,frostmourne,720,monk,mistweaver,15,9,6
Raphzen,stormrage,714,monk,mistweaver,21,9,12
Karynia,illidan,712,monk,mistweaver,15,9,6
Diagrams,tichondrius,703,monk,mistweaver,11,8,3
Ataxic,illidan,703,monk,mistweaver,11,8,3
Kyndrïa,tichondrius,692,monk,mistweaver,24,8,16
Nerf,malganis,672,monk,mistweaver,12,7,5
Thirteendads,turalyon,672,monk,mistweaver,12,7,5
Tjab,kiljaeden,672,monk,mistweaver,12,7,5
Yujiro,draktharon,672,monk,mistweaver,12,7,5
Santhz,ragnaros,672,monk,mistweaver,12,7,5
Ashmisty,kelthuzad,672,monk,mistweaver,12,7,5
Benneroy,moon-guard,672,monk,mistweaver,12,7,5
Prisonike,bleeding-hollow,672,monk,mistweaver,12,7,5
Stinkycok,tichondrius,672,monk,mistweaver,12,7,5
Himah,area-52,672,monk,mistweaver,12,7,5
Tuesdây,wyrmrest-accord,672,monk,mistweaver,12,7,5
Shefcurry,boulderfist,672,monk,mistweaver,12,7,5
Copamine,dalaran,672,monk,mistweaver,12,7,5
Sharkpiggie,illidan,672,monk,mistweaver,12,7,5
Boorams,tichondrius,672,monk,mistweaver,12,7,5
Zerker,nagrand,672,monk,mistweaver,12,7,5
Flavier,illidan,672,monk,mistweaver,12,7,5
Knuqz,stormrage,672,monk,mistweaver,12,7,5
Noogiie,barthilas,672,monk,mistweaver,12,7,5
Itdreams,illidan,672,monk,mistweaver,12,7,5
Dapperdabz,illidan,672,monk,mistweaver,12,7,5
Ekn,tichondrius,672,monk,mistweaver,12,7,5
Rehder,barthilas,672,monk,mistweaver,12,7,5
Saiyañ,proudmoore,672,monk,mistweaver,12,7,5
Buhmonk,thrall,672,monk,mistweaver,12,7,5
Yangzai,tichondrius,672,monk,mistweaver,12,7,5
Bloodyxmonk,firetree,672,monk,mistweaver,13,7,6
Fistay,burning-legion,672,monk,mistweaver,15,8,7
Èxpèrtisè,jubeithos,672,monk,mistweaver,14,7,7
Beejae,tichondrius,672,monk,mistweaver,14,7,7
Monktu,frostmourne,672,monk,mistweaver,18,7,11
Thevy,area-52,672,monk,mistweaver,18,7,11
Imdabes,destromath,672,monk,mistweaver,18,7,11
Actualcrime,tichondrius,672,monk,mistweaver,18,7,11
Squaanched,emerald-dream,672,monk,mistweaver,24,7,17
Pappaya,tichondrius,671,monk,mistweaver,12,7,5
Touzin,bleeding-hollow,671,monk,mistweaver,12,7,5
Stormpounder,proudmoore,671,monk,mistweaver,12,7,5
Xenitate,bleeding-hollow,671,monk,mistweaver,12,7,5
Afabled,drakkari,671,monk,mistweaver,12,7,5
Alisoly,tichondrius,671,monk,mistweaver,12,7,5
Monkydoo,blackhand,671,monk,mistweaver,12,7,5
Shórtlived,skullcrusher,671,monk,mistweaver,13,7,6
Táishen,wyrmrest-accord,671,monk,mistweaver,16,8,8
Chitacos,trollbane,671,monk,mistweaver,18,7,11
Bükki,ragnaros,671,monk,mistweaver,18,7,11
Soderbergh,ysera,671,monk,mistweaver,18,7,11
Rockcalm,malganis,671,monk,mistweaver,24,7,17
Kreacher,ravencrest,670,monk,mistweaver,12,7,5
Pandaranga,saurfang,670,monk,mistweaver,28,8,20
Wraithfire,uldum,669,monk,mistweaver,18,7,11
Djwushu,blackhand,668,monk,mistweaver,18,7,11
Lilbee,azjolnerub,667,monk,mistweaver,12,7,5
Balooballs,frostmourne,667,monk,mistweaver,18,7,11
Ckqt,stormrage,639,monk,mistweaver,11,7,4
Gomey,bleeding-hollow,638,monk,mistweaver,14,8,6
Tekuto,tichondrius,624,monk,mistweaver,15,7,8
Sourcandyx,area-52,624,monk,mistweaver,15,7,8
Azz,barthilas,623,monk,mistweaver,11,7,4
Dasubb,crushridge,623,monk,mistweaver,11,7,4
Swolington,proudmoore,623,monk,mistweaver,11,7,4
Praydoh,tichondrius,623,monk,mistweaver,11,7,4
Keeanuweaves,tichondrius,592,monk,mistweaver,7,7,0
Lolcutie,shandris,587,monk,mistweaver,13,7,6
Lýøp,illidan,576,monk,mistweaver,6,6,0
Spicyx,kiljaeden,576,monk,mistweaver,6,6,0
Chainwax,korgath,576,monk,mistweaver,6,6,0
Chadmw,illidan,576,monk,mistweaver,6,6,0
Bowstâff,lightbringer,576,monk,mistweaver,6,6,0
Docwang,malganis,576,monk,mistweaver,6,6,0
Psypalm,zuljin,576,monk,mistweaver,6,6,0
Rileyreidfan,azjolnerub,576,monk,mistweaver,6,6,0
Sâx,stormreaver,576,monk,mistweaver,6,6,0
Evilbit,boulderfist,576,monk,mistweaver,6,6,0
Aiswalle,illidan,576,monk,mistweaver,12,6,6
Dreamfist,emerald-dream,576,monk,mistweaver,12,6,6
Nukeproof,stormreaver,576,monk,mistweaver,12,6,6
Xitearith,ragnaros,576,monk,mistweaver,12,6,6
Meepmonk,tichondrius,576,monk,mistweaver,12,6,6
Jieterchan,malganis,576,monk,mistweaver,12,6,6
Vayce,barthilas,576,monk,mistweaver,12,6,6
Underpants,skullcrusher,576,monk,mistweaver,12,6,6
Hinåta,thrall,576,monk,mistweaver,12,6,6
Comonk,area-52,576,monk,mistweaver,12,6,6
Briàr,area-52,576,monk,mistweaver,12,6,6
Titti,korgath,576,monk,mistweaver,12,6,6
Magnustavick,bleeding-hollow,576,monk,mistweaver,12,6,6
Eppsmonk,tichondrius,576,monk,mistweaver,12,6,6
Fkinbis,area-52,576,monk,mistweaver,12,6,6
Bearmode,wyrmrest-accord,576,monk,mistweaver,12,6,6
Wèave,tichondrius,576,monk,mistweaver,12,6,6
Khungfeu,area-52,576,monk,mistweaver,12,6,6
Chignar,dathremar,576,monk,mistweaver,12,6,6
Inkers,detheroc,576,monk,mistweaver,12,6,6
Mlngo,illidan,576,monk,mistweaver,12,6,6
Quitw,tichondrius,576,monk,mistweaver,12,6,6
Boppweave,tichondrius,576,monk,mistweaver,12,6,6
Faccemelter,illidan,576,monk,mistweaver,12,6,6
Lumiän,area-52,576,monk,mistweaver,12,6,6
Simarity,kelthuzad,576,monk,mistweaver,18,6,12
Stonefists,ysondre,576,monk,mistweaver,18,6,12
Shaolinmists,malganis,575,monk,mistweaver,6,6,0
Kung,tichondrius,575,monk,mistweaver,12,6,6
Bresmeatfore,barthilas,575,monk,mistweaver,12,6,6
Putisucia,nordrassil,575,monk,mistweaver,12,6,6
Itsjohnnylol,azuremyst,575,monk,mistweaver,12,6,6
Tanskee,sargeras,575,monk,mistweaver,12,6,6
Glitchi,area-52,575,monk,mistweaver,12,6,6
Ormchi,stormrage,575,monk,mistweaver,13,6,7
Freepunchz,frostmourne,575,monk,mistweaver,18,6,12
Blorkk,area-52,574,monk,mistweaver,12,6,6
Monkoala,illidan,574,monk,mistweaver,12,6,6
Monjepa,illidan,574,monk,mistweaver,18,6,12
Mënace,skullcrusher,572,monk,mistweaver,12,6,6
Bógus,tichondrius,571,monk,mistweaver,12,6,6
Kpeste,tichondrius,569,monk,mistweaver,12,6,6
Sohéi,proudmoore,559,monk,mistweaver,17,6,11
Domisalamii,sargeras,527,monk,mistweaver,11,6,5
Rektfu,emerald-dream,524,monk,mistweaver,15,7,8
Mastamonksta,illidan,512,monk,mistweaver,16,6,10
Fonnf,nemesis,511,monk,mistweaver,8,6,2
Oldmanwalker,mannoroth,511,monk,mistweaver,11,6,5
Winniethepoo,borean-tundra,496,monk,mistweaver,13,6,7
Baee,cairne,496,monk,mistweaver,19,6,13
Zbhm,illidan,480,monk,mistweaver,6,5,1
Lazeekick,sargeras,480,monk,mistweaver,6,5,1
Spirits,dreadmaul,480,monk,mistweaver,6,5,1
Chevvyy,azshara,480,monk,mistweaver,6,5,1
Grumpî,tichondrius,480,monk,mistweaver,6,5,1
Avãrîce,stormrage,480,monk,mistweaver,6,5,1
Omnly,stormrage,480,monk,mistweaver,6,5,1
Genia,ragnaros,480,monk,mistweaver,6,5,1
Gomon,terenas,480,monk,mistweaver,6,5,1
Pinot,dragonmaw,480,monk,mistweaver,6,5,1
Kayflock,tichondrius,480,monk,mistweaver,6,5,1
Alvinete,tichondrius,480,monk,mistweaver,6,5,1
Pungeebi,tichondrius,480,monk,mistweaver,6,5,1
Woes,stormreaver,480,monk,mistweaver,6,5,1
Fistlord,zuljin,480,monk,mistweaver,6,5,1
Pinkfairy,wyrmrest-accord,480,monk,mistweaver,6,5,1
Bootÿmagic,tichondrius,480,monk,mistweaver,6,5,1
Catmonk,the-forgotten-coast,480,monk,mistweaver,6,5,1
Donatello,arthas,480,monk,mistweaver,6,5,1
Vitcheztein,ragnaros,480,monk,mistweaver,6,5,1
Yuldaddy,tichondrius,480,monk,mistweaver,6,5,1
Elcidw,tichondrius,480,monk,mistweaver,6,5,1
Håzê,kul-tiras,480,monk,mistweaver,6,5,1
Swuseng,tichondrius,480,monk,mistweaver,12,5,7
Eraticmonk,illidan,480,monk,mistweaver,12,5,7
Catchmemaybe,stormscale,480,monk,mistweaver,12,5,7
Dabnhash,emerald-dream,480,monk,mistweaver,12,5,7
Onak,illidan,480,monk,mistweaver,12,5,7
Snuzzao,darkspear,480,monk,mistweaver,12,5,7
Judo,khadgar,480,monk,mistweaver,12,5,7
Amybaby,sargeras,480,monk,mistweaver,12,5,7
Thors,gorgonnash,480,monk,mistweaver,12,5,7
Whipllash,tichondrius,480,monk,mistweaver,12,5,7
Kênpächi,rexxar,480,monk,mistweaver,12,5,7
Babychi,frostmourne,480,monk,mistweaver,12,5,7
Bogez,area-52,480,monk,mistweaver,12,5,7
Lemmetouch,illidan,480,monk,mistweaver,12,5,7
Rosellina,kelthuzad,480,monk,mistweaver,12,5,7
Ocmonk,hyjal,480,monk,mistweaver,12,5,7
Kaiøken,tichondrius,480,monk,mistweaver,12,5,7
Avm,azralon,480,monk,mistweaver,12,5,7
Cmonktwo,turalyon,480,monk,mistweaver,12,5,7
Màngø,ragnaros,480,monk,mistweaver,18,5,13
Göat,emerald-dream,480,monk,mistweaver,18,5,13
Oyyo,tichondrius,480,monk,mistweaver,18,5,13
Cckknckr,sargeras,480,monk,mistweaver,24,5,19
Angrybrewski,tichondrius,479,monk,mistweaver,6,5,1
Halfaling,tichondrius,479,monk,mistweaver,6,5,1
Maiitoguy,illidan,479,monk,mistweaver,12,5,7
Bitrau,destromath,479,monk,mistweaver,12,5,7
Annara,tichondrius,479,monk,mistweaver,12,5,7
Gentle,cenarius,479,monk,mistweaver,12,5,7
Lumïnous,moon-guard,479,monk,mistweaver,12,5,7
Wisepaw,tichondrius,479,monk,mistweaver,12,5,7
Cdeez,malganis,479,monk,mistweaver,12,5,7
Satchelgizmo,tichondrius,479,monk,mistweaver,18,5,13
Cahuun,baelgun,478,monk,mistweaver,12,5,7
Safigirl,doomhammer,478,monk,mistweaver,12,5,7
Wetspaghetti,malganis,477,monk,mistweaver,12,5,7
Kìmjungheal,tichondrius,447,monk,mistweaver,11,5,6
Beefdadyfist,tichondrius,440,monk,mistweaver,24,8,16
Soprà,zuljin,432,monk,mistweaver,9,6,3
Blessedbalor,tichondrius,432,monk,mistweaver,9,5,4
Jasonmonk,sargeras,432,monk,mistweaver,9,5,4
Ogsimpsonn,tichondrius,432,monk,mistweaver,9,5,4
Lovechabill,darkspear,431,monk,mistweaver,11,5,6
Manicata,tichondrius,431,monk,mistweaver,11,5,6
Boomtac,moon-guard,426,monk,mistweaver,9,6,3
Obàma,tichondrius,426,monk,mistweaver,13,6,7
Brewamp,zuljin,416,monk,mistweaver,16,5,11
Vynchi,area-52,384,monk,mistweaver,6,4,2
Zettelkasten,tichondrius,384,monk,mistweaver,6,4,2
Zbell,sargeras,384,monk,mistweaver,6,4,2
Grandpå,tichondrius,384,monk,mistweaver,6,4,2
Globalmonk,emerald-dream,384,monk,mistweaver,6,4,2
Monkatron,arthas,384,monk,mistweaver,6,4,2
Hornymonkale,thrall,384,monk,mistweaver,6,4,2
Pai,sargeras,384,monk,mistweaver,6,4,2
Drunkgiraffe,zuljin,384,monk,mistweaver,6,4,2
Cmonk,turalyon,384,monk,mistweaver,6,4,2
Nfm,cairne,384,monk,mistweaver,6,4,2
Teddybéar,illidan,384,monk,mistweaver,6,4,2
Pcyesh,nemesis,384,monk,mistweaver,6,4,2
Justamönk,moon-guard,384,monk,mistweaver,6,4,2
Onlythumbs,area-52,384,monk,mistweaver,6,4,2
Melonmuncher,duskwood,384,monk,mistweaver,6,4,2
Taichichuan,tichondrius,384,monk,mistweaver,6,4,2
Axibar,tichondrius,384,monk,mistweaver,6,4,2
Tinyboots,area-52,384,monk,mistweaver,6,4,2
Rolybones,boulderfist,384,monk,mistweaver,6,4,2
Floka,bleeding-hollow,384,monk,mistweaver,6,4,2
Blpkosher,tichondrius,384,monk,mistweaver,6,4,2
Vernki,laughing-skull,384,monk,mistweaver,6,4,2
Fairyeflora,hellscream,384,monk,mistweaver,6,4,2
Miley,lethon,384,monk,mistweaver,6,4,2
Lita,barthilas,384,monk,mistweaver,6,4,2
Tubescreamer,barthilas,384,monk,mistweaver,6,4,2
Brewtillis,tichondrius,384,monk,mistweaver,6,4,2
Sparksgamer,ragnaros,384,monk,mistweaver,6,4,2
Ragemore,emerald-dream,384,monk,mistweaver,6,4,2
Mêlon,tichondrius,384,monk,mistweaver,6,4,2
Monkqi,lightbringer,384,monk,mistweaver,6,4,2
Howziexd,tichondrius,384,monk,mistweaver,6,4,2
Theminivan,sargeras,384,monk,mistweaver,6,4,2
Keepcryin,gorefiend,384,monk,mistweaver,6,4,2
Horndog,skullcrusher,384,monk,mistweaver,6,4,2
Brantkicks,tichondrius,384,monk,mistweaver,6,4,2
Nakiki,cenarion-circle,384,monk,mistweaver,6,4,2
Darong,tichondrius,384,monk,mistweaver,6,4,2
Truefists,stormrage,384,monk,mistweaver,6,4,2
Austinm,tichondrius,384,monk,mistweaver,6,4,2
Millé,frostmourne,384,monk,mistweaver,6,4,2
Makimä,stormrage,384,monk,mistweaver,6,4,2
Fïish,stormrage,384,monk,mistweaver,6,4,2
Bréwmaster,stormrage,384,monk,mistweaver,6,4,2
Meisterbrew,garona,384,monk,mistweaver,6,4,2
Zac,veknilash,384,monk,mistweaver,6,4,2
Mightbewôrth,thunderhorn,384,monk,mistweaver,6,4,2
Keyndanlamor,sargeras,384,monk,mistweaver,6,4,2
Mixon,archimonde,384,monk,mistweaver,6,4,2
Juchiyosamu,illidan,384,monk,mistweaver,9,4,5
Diligentmonk,illidan,384,monk,mistweaver,15,5,10
Åvå,emerald-dream,384,monk,mistweaver,12,4,8
Eqoy,moon-guard,384,monk,mistweaver,12,4,8
Neuron,spirestone,384,monk,mistweaver,12,4,8
Pax,boulderfist,384,monk,mistweaver,12,4,8
Xblingtron,malganis,384,monk,mistweaver,12,4,8
Hoyocochino,quelthalas,384,monk,mistweaver,12,4,8
Darylphilbin,emerald-dream,384,monk,mistweaver,12,4,8
Nutbag,norgannon,384,monk,mistweaver,12,4,8
Valkana,kelthuzad,384,monk,mistweaver,12,4,8
Jhaded,tichondrius,384,monk,mistweaver,12,4,8
Nicolascåge,destromath,384,monk,mistweaver,12,4,8
Darkeiji,stormrage,384,monk,mistweaver,12,4,8
Sprinkli,sargeras,384,monk,mistweaver,12,4,8
Crakgirl,malganis,384,monk,mistweaver,12,4,8
Samzo,barthilas,384,monk,mistweaver,12,4,8
Shinarri,thrall,383,monk,mistweaver,6,4,2
Zyemell,tichondrius,383,monk,mistweaver,12,4,8
Jigong,bleeding-hollow,383,monk,mistweaver,12,4,8
Bluemyselph,tichondrius,383,monk,mistweaver,12,4,8
Esleif,moonrunner,383,monk,mistweaver,12,4,8
Epptwo,aggramar,383,monk,mistweaver,12,4,8
Metalmønk,nerzhul,360,monk,mistweaver,13,7,6
Sáble,stormrage,351,monk,mistweaver,11,4,7
Iluvthugnmcz,sargeras,335,monk,mistweaver,11,4,7
Kimchidelite,gorefiend,319,monk,mistweaver,5,4,1
Fiztingfaded,area-52,319,monk,mistweaver,11,4,7
Drkeen,frostmourne,288,monk,mistweaver,10,5,5
Milkshayx,kiljaeden,288,monk,mistweaver,6,3,3
Sterow,kiljaeden,288,monk,mistweaver,6,3,3
Maybeyooshi,kelthuzad,288,monk,mistweaver,6,3,3
Saeloon,frostmourne,288,monk,mistweaver,6,3,3
Graoul,thaurissan,288,monk,mistweaver,6,3,3
Austaar,frostmourne,288,monk,mistweaver,6,3,3
Kushmintz,whisperwind,288,monk,mistweaver,6,3,3
Zeelos,kelthuzad,288,monk,mistweaver,6,3,3
Triarcs,area-52,288,monk,mistweaver,6,3,3
Stigzz,stormrage,288,monk,mistweaver,6,3,3
Benex,tichondrius,288,monk,mistweaver,6,3,3
Ðreadhot,malganis,288,monk,mistweaver,6,3,3
Danceofchiji,tichondrius,288,monk,mistweaver,6,3,3
Mizzycash,malganis,288,monk,mistweaver,6,3,3
Shinobui,jubeithos,288,monk,mistweaver,6,3,3
Teclas,ragnaros,288,monk,mistweaver,6,3,3
Imisswodxo,illidan,288,monk,mistweaver,6,3,3
Saltyone,firetree,288,monk,mistweaver,6,3,3
Ilani,malganis,288,monk,mistweaver,6,3,3
Hazelbazel,bleeding-hollow,288,monk,mistweaver,6,3,3
Cädemaddöx,stormrage,288,monk,mistweaver,6,3,3
Tamingpanda,wildhammer,288,monk,mistweaver,6,3,3
Brews,black-dragonflight,288,monk,mistweaver,6,3,3
Originalmonk,tichondrius,288,monk,mistweaver,6,3,3
Lindraice,illidan,288,monk,mistweaver,6,3,3
Shredmw,tichondrius,288,monk,mistweaver,6,3,3
Fammi,stormrage,288,monk,mistweaver,6,3,3
Beboté,quelthalas,288,monk,mistweaver,6,3,3
Brosiedon,sargeras,288,monk,mistweaver,6,3,3
Aphrodîîte,area-52,288,monk,mistweaver,6,3,3
Loppjr,tichondrius,288,monk,mistweaver,6,3,3
Lemeta,tichondrius,288,monk,mistweaver,6,3,3
Mauvem,tichondrius,288,monk,mistweaver,6,3,3
Pisswalker,area-52,288,monk,mistweaver,6,3,3
Dracc,zuljin,288,monk,mistweaver,6,3,3
Gguldduck,tichondrius,288,monk,mistweaver,6,3,3
Möösê,moon-guard,288,monk,mistweaver,6,3,3
Chingu,ragnaros,288,monk,mistweaver,6,3,3
Frogsarecool,stormrage,288,monk,mistweaver,6,3,3
Docpalpatine,tichondrius,288,monk,mistweaver,6,3,3
Maripaulita,ragnaros,288,monk,mistweaver,6,3,3
Spiritmist,sargeras,288,monk,mistweaver,6,3,3
Bigolbootay,tichondrius,288,monk,mistweaver,6,3,3
Fistin,laughing-skull,288,monk,mistweaver,6,3,3
Grogio,wyrmrest-accord,288,monk,mistweaver,6,3,3
Sumaran,hydraxis,288,monk,mistweaver,6,3,3
Annisokay,bleeding-hollow,288,monk,mistweaver,6,3,3
Hogarg,emerald-dream,288,monk,mistweaver,6,3,3
Galeindra,whisperwind,288,monk,mistweaver,6,3,3
Monkeynut,whisperwind,288,monk,mistweaver,6,3,3
Ammonk,bloodhoof,288,monk,mistweaver,6,3,3
Ericshin,sargeras,288,monk,mistweaver,8,3,5
Kúrios,azralon,288,monk,mistweaver,10,3,7
Roloyolo,illidan,288,monk,mistweaver,12,3,9
Dirtyshef,deathwing,288,monk,mistweaver,12,3,9
Chilliweaver,frostmourne,288,monk,mistweaver,12,3,9
Vchii,tichondrius,288,monk,mistweaver,12,3,9
Mwtouch,nemesis,288,monk,mistweaver,12,3,9
Tubbytiph,ghostlands,288,monk,mistweaver,12,3,9
Wizcaulifa,stormrage,288,monk,mistweaver,12,3,9
Wørm,emerald-dream,288,monk,mistweaver,12,3,9
Giatzo,barthilas,288,monk,mistweaver,13,3,10
Holandri,moon-guard,287,monk,mistweaver,6,3,3
Rosinhood,illidan,287,monk,mistweaver,6,3,3
Deyseddia,azgalor,287,monk,mistweaver,6,3,3
Shaolyyn,zuljin,287,monk,mistweaver,6,3,3
Minttea,kiljaeden,287,monk,mistweaver,12,3,9
Tokkyo,frostmourne,287,monk,mistweaver,24,3,21
Lilpielover,zuljin,286,monk,mistweaver,9,4,5
Bradyfour,moon-guard,265,monk,mistweaver,19,5,14
Lildae,burning-legion,256,monk,mistweaver,4,4,0
Haruko,baelgun,256,monk,mistweaver,10,3,7
Bigjuicers,bleeding-hollow,239,monk,mistweaver,5,3,2
Excitable,moon-guard,234,monk,mistweaver,8,4,4
Zeisei,wyrmrest-accord,234,monk,mistweaver,10,4,6
Friedpanda,kelthuzad,234,monk,mistweaver,16,4,12
Whatdaheal,darkspear,217,monk,mistweaver,20,4,16
Gguldduk,tichondrius,192,monk,mistweaver,4,3,1
Acena,stormrage,192,monk,mistweaver,6,2,4
Theriní,stormrage,192,monk,mistweaver,6,2,4
Chopschtichs,kiljaeden,192,monk,mistweaver,6,2,4
Anabolicx,khazgoroth,192,monk,mistweaver,6,2,4
Fäded,trollbane,192,monk,mistweaver,6,2,4
Aniwhy,tichondrius,192,monk,mistweaver,6,2,4
Skadouch,wyrmrest-accord,192,monk,mistweaver,6,2,4
Nilonsso,sargeras,192,monk,mistweaver,6,2,4
Rubntug,zuljin,192,monk,mistweaver,6,2,4
Hugerichard,wyrmrest-accord,192,monk,mistweaver,6,2,4
Iililiililil,stormrage,192,monk,mistweaver,6,2,4
Sukrit,darkspear,192,monk,mistweaver,6,2,4
Zåz,nazgrel,192,monk,mistweaver,6,2,4
Fistorcstar,daggerspine,192,monk,mistweaver,6,2,4
Fortnight,emerald-dream,192,monk,mistweaver,6,2,4
Barlyfe,tichondrius,192,monk,mistweaver,6,2,4
Gngrbeardman,tichondrius,192,monk,mistweaver,6,2,4
Zengoku,zuljin,192,monk,mistweaver,6,2,4
Wamii,tichondrius,192,monk,mistweaver,6,2,4
Caralia,exodar,192,monk,mistweaver,6,2,4
Musachi,barthilas,192,monk,mistweaver,6,2,4
Silkymoves,tichondrius,192,monk,mistweaver,6,2,4
Jaybum,sargeras,192,monk,mistweaver,6,2,4
Melocotonn,goldrinn,192,monk,mistweaver,6,2,4
Macktickle,zuljin,192,monk,mistweaver,6,2,4
Selocke,bleeding-hollow,192,monk,mistweaver,6,2,4
Privm,moonrunner,192,monk,mistweaver,6,2,4
Krob,bleeding-hollow,192,monk,mistweaver,6,2,4
Taipanni,sargeras,192,monk,mistweaver,6,2,4
Hymasterlol,tichondrius,192,monk,mistweaver,6,2,4
Mistbeard,aggramar,192,monk,mistweaver,6,2,4
Songwei,barthilas,192,monk,mistweaver,6,2,4
Korvishka,malganis,192,monk,mistweaver,6,2,4
Monke,onyxia,192,monk,mistweaver,6,2,4
Ftgx,sargeras,192,monk,mistweaver,6,2,4
Ashenn,area-52,192,monk,mistweaver,6,2,4
Xanzee,area-52,192,monk,mistweaver,6,2,4
Apparent,lightnings-blade,192,monk,mistweaver,6,2,4
Otzyy,turalyon,192,monk,mistweaver,6,2,4
Bodyshot,area-52,192,monk,mistweaver,6,2,4
Jittersx,silvermoon,192,monk,mistweaver,6,2,4
Onepunch,exodar,192,monk,mistweaver,7,2,5
Glowsgreenby,area-52,192,monk,mistweaver,8,2,6
Coffeek,area-52,192,monk,mistweaver,8,2,6
Copula,illidan,192,monk,mistweaver,10,2,8
Missmagda,darkspear,192,monk,mistweaver,12,2,10
Tragictea,zuljin,192,monk,mistweaver,12,2,10
Drfoochi,tichondrius,192,monk,mistweaver,12,2,10
Ghim,frostmourne,192,monk,mistweaver,12,2,10
Izgoku,frostmane,192,monk,mistweaver,12,2,10
Mung,boulderfist,192,monk,mistweaver,12,2,10
Whynotec,tichondrius,192,monk,mistweaver,12,2,10
Jeme,tichondrius,191,monk,mistweaver,6,2,4
Phystweaver,malganis,175,monk,mistweaver,11,2,9
Hyugga,azralon,159,monk,mistweaver,5,2,3
Edbtz,illidan,144,monk,mistweaver,3,3,0
Dabins,tichondrius,138,monk,mistweaver,7,3,4
Craziediemon,malganis,138,monk,mistweaver,8,3,5
Vyostao,ragnaros,138,monk,mistweaver,11,3,8
Averagéjoe,tichondrius,127,monk,mistweaver,8,2,6
Figurines,sargeras,112,monk,mistweaver,7,2,5
Frankènmonk,illidan,96,monk,mistweaver,6,1,5
Kromrax,stormrage,96,monk,mistweaver,6,1,5
Danicah,altar-of-storms,96,monk,mistweaver,6,1,5
Stickyloads,illidan,96,monk,mistweaver,6,1,5
Zrza,tichondrius,96,monk,mistweaver,6,1,5
Kick,dragonmaw,96,monk,mistweaver,6,1,5
Dankestkhan,korialstrasz,96,monk,mistweaver,6,1,5
Súprä,stormrage,96,monk,mistweaver,6,1,5
Kungfucheeks,illidan,96,monk,mistweaver,6,1,5
Stinx,ragnaros,96,monk,mistweaver,6,1,5
Ezpzmonk,bloodscalp,96,monk,mistweaver,6,1,5
Kimmyfists,tichondrius,96,monk,mistweaver,6,1,5
Linsey,frostmourne,96,monk,mistweaver,6,1,5
Lomist,nazjatar,96,monk,mistweaver,6,1,5
Fatboyswag,tichondrius,96,monk,mistweaver,6,1,5
Charrek,zuljin,96,monk,mistweaver,6,1,5
Turkeydinner,frostmourne,96,monk,mistweaver,6,1,5
Eliwenn,ragnaros,96,monk,mistweaver,12,1,11
Ghostsofur,tichondrius,96,monk,mistweaver,12,1,11
Selectra,malfurion,95,monk,mistweaver,6,1,5
Pinkgucci,thrall,79,monk,mistweaver,5,1,4
Braindi,arathor,79,monk,mistweaver,5,1,4
Fairymonk,frostwolf,79,monk,mistweaver,5,1,4
ßiggiesmallz,barthilas,42,monk,mistweaver,6,2,4
Sivedrafely,arthas,42,monk,mistweaver,17,2,15
Swiftyboi,tichondrius,31,monk,mistweaver,2,1,1
Daesun,quelthalas,672,monk,brewmaster,12,7,5
Worldpvp,nerzhul,672,monk,brewmaster,21,8,13
Robbo,tichondrius,288,monk,brewmaster,6,3,3
Quaria,moon-guard,288,monk,brewmaster,18,3,15
Drunkfight,zuljin,192,monk,brewmaster,18,2,16
Encry,zuljin,191,monk,brewmaster,6,2,4
Neighbors,sargeras,2250,monk,windwalker,91,51,40
Keyam,illidan,2208,monk,windwalker,101,54,47
Droguex,tichondrius,2150,monk,windwalker,132,69,63
Sean,nazjatar,2143,monk,windwalker,72,38,34
Cmx,sargeras,2140,monk,windwalker,125,66,59
Thewy,tichondrius,2132,monk,windwalker,108,55,53
Iílílílílílí,area-52,2101,monk,windwalker,84,43,41
Senseiww,sargeras,2093,monk,windwalker,108,53,55
Spotifyfan,ysera,2030,monk,windwalker,46,34,12
Wondý,quelthalas,2021,monk,windwalker,119,62,57
Pacmankr,tichondrius,2012,monk,windwalker,93,46,47
Vybïn,tichondrius,2008,monk,windwalker,152,81,71
Blackpandax,tichondrius,2008,monk,windwalker,107,55,52
Fueld,burning-legion,1986,monk,windwalker,89,47,42
Flattsww,tichondrius,1982,monk,windwalker,238,118,120
Jaxvisto,dalaran,1969,monk,windwalker,66,38,28
Kabals,frostmourne,1967,monk,windwalker,66,34,32
Hypnøtìze,frostmourne,1955,monk,windwalker,66,37,29
Lodbork,tichondrius,1942,monk,windwalker,184,99,85
Stárset,illidan,1933,monk,windwalker,78,39,39
Helvectius,tichondrius,1928,monk,windwalker,114,54,60
Catgallery,tichondrius,1924,monk,windwalker,113,54,59
Serthean,illidan,1899,monk,windwalker,92,47,45
Rytes,moon-guard,1899,monk,windwalker,114,57,57
Repbrew,sargeras,1897,monk,windwalker,63,33,30
Madtiger,scilla,1885,monk,windwalker,66,33,33
Alps,darkspear,1884,monk,windwalker,30,20,10
Touchofdeáth,stormrage,1880,monk,windwalker,71,39,32
Tschi,illidan,1844,monk,windwalker,42,29,13
Bdw,tichondrius,1844,monk,windwalker,70,44,26
Baddi,uldum,1843,monk,windwalker,70,34,36
Conngaline,stormreaver,1834,monk,windwalker,138,63,75
Edenx,sargeras,1825,monk,windwalker,42,23,19
Nelariah,wyrmrest-accord,1822,monk,windwalker,59,28,31
Sentomaru,bleeding-hollow,1820,monk,windwalker,66,33,33
Smokechief,hyjal,1813,monk,windwalker,42,25,17
Turbofist,bleeding-hollow,1803,monk,windwalker,42,25,17
Yuujitsu,sargeras,1797,monk,windwalker,42,22,20
Bigherosixx,tichondrius,1791,monk,windwalker,48,28,20
Cuteirl,tichondrius,1785,monk,windwalker,24,19,5
Rockyßalboa,sargeras,1772,monk,windwalker,69,42,27
Shïvïr,azralon,1772,monk,windwalker,53,27,26
Threnody,malganis,1764,monk,windwalker,47,26,21
Omnly,stormrage,1762,monk,windwalker,42,21,21
Pandagirlw,tichondrius,1735,monk,windwalker,72,43,29
Ambal,hellscream,1734,monk,windwalker,55,32,23
Sunfistway,sargeras,1733,monk,windwalker,44,26,18
Jasey,area-52,1729,monk,windwalker,29,21,8
Kuranchi,sargeras,1724,monk,windwalker,30,18,12
Khawai,sargeras,1720,monk,windwalker,36,23,13
Boostedww,bloodscalp,1720,monk,windwalker,48,25,23
Weathermanxv,kelthuzad,1711,monk,windwalker,56,24,32
Guylian,tichondrius,1710,monk,windwalker,41,20,21
Monkgyatso,drakthul,1703,monk,windwalker,42,22,20
Jükedx,stormrage,1700,monk,windwalker,73,44,29
Titanus,chogall,1698,monk,windwalker,199,105,94
Allmight,wyrmrest-accord,1696,monk,windwalker,45,23,22
Wolffangfist,sargeras,1695,monk,windwalker,69,42,27
Jåðëðrägøñ,sargeras,1688,monk,windwalker,55,31,24
Shids,barthilas,1686,monk,windwalker,47,22,25
Mechamonk,aerie-peak,1678,monk,windwalker,54,24,30
Xanaxåddict,sargeras,1673,monk,windwalker,80,36,44
Zenigma,area-52,1670,monk,windwalker,45,24,21
Hèllòkîttý,illidan,1666,monk,windwalker,30,19,11
Fistnu,aggramar,1665,monk,windwalker,71,45,26
Hæt,stormrage,1665,monk,windwalker,48,23,25
Monkatron,arthas,1663,monk,windwalker,47,23,24
Screwz,tichondrius,1661,monk,windwalker,40,20,20
Liamllama,barthilas,1659,monk,windwalker,42,22,20
Hotwatertank,area-52,1658,monk,windwalker,48,29,19
Haharetsdead,illidan,1645,monk,windwalker,83,46,37
Dea,thrall,1645,monk,windwalker,78,39,39
Foxchik,zuljin,1641,monk,windwalker,76,42,34
Zynflex,tichondrius,1637,monk,windwalker,40,21,19
Yerky,stormrage,1631,monk,windwalker,30,17,13
Chopt,zuljin,1625,monk,windwalker,42,20,22
Jigong,bleeding-hollow,1620,monk,windwalker,42,23,19
Aidenww,area-52,1618,monk,windwalker,24,17,7
Hadoukeñ,thrall,1616,monk,windwalker,41,22,19
Lingerer,aerie-peak,1614,monk,windwalker,54,29,25
Sonsia,arthas,1610,monk,windwalker,76,46,30
Xradu,dawnbringer,1604,monk,windwalker,36,25,11
Ronk,the-forgotten-coast,1600,monk,windwalker,30,17,13
Rigi,stormrage,1600,monk,windwalker,59,23,36
Dirtypunch,proudmoore,1598,monk,windwalker,42,19,23
Windwalker,blackhand,1597,monk,windwalker,35,19,16
Surgarush,moon-guard,1592,monk,windwalker,106,64,42
Jbills,muradin,1588,monk,windwalker,41,25,16
Odi,stonemaul,1588,monk,windwalker,65,31,34
Reprap,elune,1582,monk,windwalker,58,33,25
Homun,tichondrius,1581,monk,windwalker,36,18,18
Robbo,tichondrius,1580,monk,windwalker,36,18,18
Windmónk,tichondrius,1580,monk,windwalker,48,21,27
Wonderx,darkspear,1579,monk,windwalker,30,20,10
Copenfist,black-dragonflight,1578,monk,windwalker,36,21,15
Bamron,fizzcrank,1576,monk,windwalker,65,30,35
Hagano,drakkari,1573,monk,windwalker,59,33,26
Katsübooy,azralon,1569,monk,windwalker,117,65,52
Unlike,tichondrius,1566,monk,windwalker,84,40,44
Kogoli,frostwolf,1561,monk,windwalker,54,22,32
Corsan,illidan,1560,monk,windwalker,36,25,11
Harde,thrall,1551,monk,windwalker,53,25,28
Chingu,ragnaros,1543,monk,windwalker,123,59,64
Maomaogun,tichondrius,1533,monk,windwalker,18,16,2
Çraßsßùrgêr,bonechewer,1533,monk,windwalker,24,16,8
Marcusm,bleeding-hollow,1528,monk,windwalker,27,17,10
Kutz,proudmoore,1526,monk,windwalker,61,30,31
Euman,sargeras,1523,monk,windwalker,24,16,8
Byakugun,wyrmrest-accord,1522,monk,windwalker,36,21,15
Yoshifistsu,malganis,1521,monk,windwalker,54,26,28
Dumplíngs,emerald-dream,1521,monk,windwalker,44,17,27
Odogin,tichondrius,1520,monk,windwalker,65,42,23
Rockemsockem,gorefiend,1517,monk,windwalker,72,40,32
Göllyjee,tichondrius,1516,monk,windwalker,72,30,42
Dabzin,stormrage,1513,monk,windwalker,67,35,32
Sgarbossa,tortheldrin,1509,monk,windwalker,42,16,26
Shishosenin,quelthalas,1506,monk,windwalker,84,38,46
Themanski,area-52,1504,monk,windwalker,30,16,14
Jerax,thunderlord,1491,monk,windwalker,48,26,22
Muritors,ragnaros,1488,monk,windwalker,30,16,14
Varn,frostmourne,1488,monk,windwalker,74,35,39
Arizøna,illidan,1477,monk,windwalker,74,40,34
Banyasong,tichondrius,1468,monk,windwalker,30,17,13
Showshoway,tichondrius,1467,monk,windwalker,42,18,24
Fistys,area-52,1461,monk,windwalker,111,58,53
Mastahp,tichondrius,1457,monk,windwalker,42,23,19
Tyroneßanks,stormrage,1456,monk,windwalker,30,17,13
Lickthefist,sargeras,1445,monk,windwalker,24,16,8
Lavinci,area-52,1437,monk,windwalker,30,15,15
Astrofu,tichondrius,1429,monk,windwalker,58,25,33
Pinot,dragonmaw,1427,monk,windwalker,36,15,21
Zaabuza,azralon,1406,monk,windwalker,18,15,3
Jegann,tichondrius,1392,monk,windwalker,68,27,41
Killmachine,farstriders,1386,monk,windwalker,77,36,41
Backfliptime,ragnaros,1383,monk,windwalker,34,19,15
Brewmaker,sargeras,1372,monk,windwalker,40,19,21
Bluntdoctor,stormreaver,1361,monk,windwalker,54,19,35
Kriticalkush,kelthuzad,1353,monk,windwalker,24,17,7
Anarska,thrall,1351,monk,windwalker,54,28,26
Sarious,lightbringer,1350,monk,windwalker,115,62,53
Npepper,khadgar,1350,monk,windwalker,34,15,19
Owned,dreadmaul,1349,monk,windwalker,36,23,13
Gún,ragnaros,1344,monk,windwalker,72,34,38
Daslow,quelthalas,1343,monk,windwalker,78,38,40
Zuì,sargeras,1342,monk,windwalker,24,14,10
Bruceteå,area-52,1339,monk,windwalker,24,14,10
Pangpoong,tichondrius,1339,monk,windwalker,45,20,25
Jümmy,area-52,1338,monk,windwalker,30,14,16
Zenluckydo,grizzly-hills,1334,monk,windwalker,24,14,10
Smoothboxing,tichondrius,1332,monk,windwalker,36,22,14
Trapeez,kelthuzad,1326,monk,windwalker,58,32,26
Acharä,tichondrius,1305,monk,windwalker,36,20,16
Goonkeg,frostmourne,1304,monk,windwalker,30,14,16
Kawasakii,tichondrius,1294,monk,windwalker,88,40,48
Dodried,ragnaros,1290,monk,windwalker,52,24,28
Sleýin,tichondrius,1280,monk,windwalker,36,15,21
Zettelkasten,tichondrius,1265,monk,windwalker,30,15,15
Weezzyboi,tichondrius,1263,monk,windwalker,42,22,20
Inbu,tichondrius,1248,monk,windwalker,18,13,5
Hamyu,illidan,1247,monk,windwalker,30,15,15
Larryjonés,area-52,1247,monk,windwalker,30,13,17
Prostotak,area-52,1246,monk,windwalker,18,13,5
Pamii,quelthalas,1246,monk,windwalker,36,13,23
Båshkin,terenas,1245,monk,windwalker,42,19,23
Flyingfury,illidan,1243,monk,windwalker,24,13,11
Nightww,area-52,1241,monk,windwalker,24,13,11
Ofn,moon-guard,1240,monk,windwalker,48,22,26
Napoleonic,vashj,1239,monk,windwalker,18,13,5
Fistnafurry,tichondrius,1239,monk,windwalker,24,13,11
Bruhmesoftly,thrall,1237,monk,windwalker,24,13,11
Stickyloads,illidan,1220,monk,windwalker,72,33,39
Xiaowën,nemesis,1218,monk,windwalker,34,15,19
Razielic,frostmourne,1207,monk,windwalker,36,15,21
Xéia,area-52,1201,monk,windwalker,60,23,37
Ghaelessi,senjin,1189,monk,windwalker,35,17,18
Gidster,dalaran,1188,monk,windwalker,36,13,23
Leehofook,azshara,1176,monk,windwalker,30,14,16
Opmother,elune,1157,monk,windwalker,17,13,4
Torkscrew,bleeding-hollow,1152,monk,windwalker,18,12,6
Linkya,daggerspine,1152,monk,windwalker,22,14,8
Bløødÿ,ragnaros,1151,monk,windwalker,12,12,0
Karelio,wyrmrest-accord,1150,monk,windwalker,24,12,12
Pikotaro,tichondrius,1150,monk,windwalker,24,12,12
Shôckley,tichondrius,1142,monk,windwalker,24,12,12
Wutangkillaß,kiljaeden,1142,monk,windwalker,24,12,12
Milktank,medivh,1137,monk,windwalker,53,31,22
Garmakasmonk,skullcrusher,1136,monk,windwalker,18,12,6
Sleepÿ,area-52,1130,monk,windwalker,54,18,36
Shinaniganz,chogall,1128,monk,windwalker,42,17,25
Stigzz,stormrage,1118,monk,windwalker,23,12,11
Jimothydab,lightbringer,1117,monk,windwalker,23,12,11
Gurda,wyrmrest-accord,1117,monk,windwalker,24,12,12
Tino,kelthuzad,1113,monk,windwalker,30,13,17
Fitmonje,drakkari,1108,monk,windwalker,28,13,15
Astteell,proudmoore,1089,monk,windwalker,39,13,26
Drektarz,area-52,1085,monk,windwalker,75,33,42
Ojiin,wyrmrest-accord,1079,monk,windwalker,24,13,11
Kagebunshin,kelthuzad,1056,monk,windwalker,18,11,7
Xyän,bleeding-hollow,1056,monk,windwalker,18,11,7
Sultanofwind,malganis,1056,monk,windwalker,18,11,7
Yavaxye,stormrage,1056,monk,windwalker,24,11,13
Rubntug,zuljin,1055,monk,windwalker,18,11,7
Elfoverde,stormrage,1055,monk,windwalker,18,11,7
Therapeutics,moon-guard,1055,monk,windwalker,18,11,7
Bakedmonk,smolderthorn,1055,monk,windwalker,18,11,7
Jdanîel,ragnaros,1055,monk,windwalker,24,11,13
Calmpunchman,mannoroth,1055,monk,windwalker,24,11,13
Jamut,stormrage,1055,monk,windwalker,36,11,25
Monkamax,tichondrius,1054,monk,windwalker,18,11,7
Daddyrugburn,area-52,1052,monk,windwalker,18,11,7
Bonflur,quelthalas,1051,monk,windwalker,126,62,64
Chowlaos,coilfang,1048,monk,windwalker,18,11,7
Chaosrose,area-52,1044,monk,windwalker,18,11,7
Lexivixi,khazgoroth,1044,monk,windwalker,24,12,12
Screwballz,blackrock,1044,monk,windwalker,35,11,24
Hinakii,dalaran,1043,monk,windwalker,30,11,19
Shinjiki,tichondrius,1039,monk,windwalker,23,11,12
Jnx,emerald-dream,1038,monk,windwalker,24,11,13
Arshavin,skullcrusher,1038,monk,windwalker,30,11,19
Mcnipple,moonrunner,1036,monk,windwalker,18,11,7
Sandii,azralon,1026,monk,windwalker,42,24,18
Steenkk,tichondrius,1023,monk,windwalker,24,11,13
Marstol,bleeding-hollow,1020,monk,windwalker,18,11,7
Zhoku,tichondrius,960,monk,windwalker,12,10,2
Fettywhopper,kaelthas,960,monk,windwalker,12,10,2
Aýre,ravencrest,960,monk,windwalker,12,10,2
Innerverse,tichondrius,960,monk,windwalker,18,10,8
Telospateo,ragnaros,960,monk,windwalker,18,10,8
Bearface,blades-edge,960,monk,windwalker,24,10,14
Dwarfmonk,tichondrius,960,monk,windwalker,24,10,14
Råii,sargeras,959,monk,windwalker,12,10,2
Akanq,tichondrius,959,monk,windwalker,18,10,8
Domiik,ragnaros,959,monk,windwalker,18,10,8
Creonus,proudmoore,958,monk,windwalker,18,10,8
Dïsturbedtko,azralon,958,monk,windwalker,24,10,14
Mônkdunk,daggerspine,957,monk,windwalker,18,10,8
Avz,azralon,957,monk,windwalker,24,10,14
Fanetö,stormrage,957,monk,windwalker,30,10,20
Tassmonk,hyjal,956,monk,windwalker,18,10,8
Megatraun,tichondrius,953,monk,windwalker,18,10,8
Quanon,stormreaver,953,monk,windwalker,18,10,8
Xìðñ,moon-guard,952,monk,windwalker,18,10,8
Tianhu,sargeras,951,monk,windwalker,18,10,8
Alcaquito,goldrinn,950,monk,windwalker,18,10,8
Yrn,crushridge,949,monk,windwalker,18,10,8
Frootsmoothi,thrall,943,monk,windwalker,29,10,19
Scarlos,tichondrius,938,monk,windwalker,114,52,62
Nutcrakerz,tichondrius,935,monk,windwalker,24,13,11
Fatal,bonechewer,928,monk,windwalker,22,11,11
Ipmán,moon-guard,892,monk,windwalker,41,18,23
Dzq,stormrage,864,monk,windwalker,12,9,3
Danimalz,stormrage,864,monk,windwalker,12,9,3
Poormanx,illidan,864,monk,windwalker,12,9,3
Mikeyx,area-52,864,monk,windwalker,12,9,3
Garypool,emerald-dream,864,monk,windwalker,15,9,6
Phistea,area-52,864,monk,windwalker,18,9,9
Crashandflow,zuljin,864,monk,windwalker,18,9,9
Takkeya,zuljin,864,monk,windwalker,18,9,9
Molta,tichondrius,864,monk,windwalker,18,9,9
Shaszx,zuljin,864,monk,windwalker,18,9,9
Jaige,illidan,864,monk,windwalker,18,9,9
Naagg,tichondrius,864,monk,windwalker,18,9,9
Fátë,tichondrius,864,monk,windwalker,24,9,15
Chiang,chogall,864,monk,windwalker,24,9,15
Thåi,anubarak,864,monk,windwalker,24,9,15
Brewbaker,hyjal,863,monk,windwalker,12,9,3
Fistyuh,illidan,863,monk,windwalker,12,9,3
Helicopter,borean-tundra,863,monk,windwalker,18,9,9
Stepsista,sargeras,863,monk,windwalker,18,9,9
Vanmonk,eonar,863,monk,windwalker,24,9,15
Chingwang,frostmourne,862,monk,windwalker,12,9,3
Kungfüsed,stormrage,862,monk,windwalker,12,9,3
Somethingre,sargeras,862,monk,windwalker,12,9,3
Romeonjuliet,tichondrius,859,monk,windwalker,18,9,9
Acindian,malganis,853,monk,windwalker,18,9,9
Imonkalot,destromath,839,monk,windwalker,19,10,9
Sébástián,drakkari,832,monk,windwalker,24,10,14
Thekilla,aegwynn,827,monk,windwalker,18,9,9
Senritsuh,drakkari,815,monk,windwalker,23,9,14
Silvopanda,azralon,814,monk,windwalker,35,10,25
Drakfu,tichondrius,806,monk,windwalker,21,10,11
Rykouu,area-52,784,monk,windwalker,19,9,10
Rerolled,moon-guard,768,monk,windwalker,12,8,4
Micai,thrall,768,monk,windwalker,12,8,4
Geekweek,frostmourne,768,monk,windwalker,12,8,4
Xølik,draenor,768,monk,windwalker,12,8,4
Mcbluffin,onyxia,768,monk,windwalker,12,8,4
Zoomerxd,stormrage,768,monk,windwalker,12,8,4
Furiamvp,stormrage,768,monk,windwalker,12,8,4
Taggz,thunderlord,768,monk,windwalker,18,8,10
Percentx,tichondrius,768,monk,windwalker,18,8,10
Mahatmä,dalaran,768,monk,windwalker,18,8,10
Stepfistz,aegwynn,768,monk,windwalker,18,8,10
Hitt,barthilas,768,monk,windwalker,18,8,10
Galaxystrike,illidan,768,monk,windwalker,18,8,10
Monke,onyxia,768,monk,windwalker,24,8,16
Zukki,zuljin,767,monk,windwalker,18,8,10
Niked,tichondrius,767,monk,windwalker,18,8,10
Nf,zuljin,766,monk,windwalker,12,8,4
Anatomyx,kelthuzad,766,monk,windwalker,12,8,4
Eavale,destromath,765,monk,windwalker,18,8,10
Dazzler,ragnaros,764,monk,windwalker,24,8,16
Natus,greymane,763,monk,windwalker,18,8,10
Extinctión,stormscale,762,monk,windwalker,12,8,4
Kfpeeves,sargeras,759,monk,windwalker,18,8,10
Hehex,bleeding-hollow,751,monk,windwalker,17,8,9
Natintell,drakkari,749,monk,windwalker,24,8,16
Oxli,emerald-dream,736,monk,windwalker,16,8,8
Deadlyfist,stormrage,729,monk,windwalker,23,8,15
Nehji,illidan,720,monk,windwalker,15,9,6
Syerzie,dalaran,714,monk,windwalker,23,12,11
Rïggen,thrall,703,monk,windwalker,11,8,3
Bakha,illidan,703,monk,windwalker,11,8,3
Mists,velen,672,monk,windwalker,12,7,5
Richywayne,bleeding-hollow,672,monk,windwalker,12,7,5
Simonb,tichondrius,672,monk,windwalker,12,7,5
Wizcaulifa,stormrage,672,monk,windwalker,12,7,5
Vai,korgath,672,monk,windwalker,12,7,5
Bramicaye,malganis,672,monk,windwalker,12,7,5
Shiphappens,barthilas,672,monk,windwalker,12,7,5
Ristion,moon-guard,672,monk,windwalker,12,7,5
Dragonwhirl,stormrage,672,monk,windwalker,12,7,5
Yoojimin,kiljaeden,672,monk,windwalker,12,7,5
Ázão,stormrage,672,monk,windwalker,12,7,5
Goldfornudez,area-52,672,monk,windwalker,12,7,5
Kudrix,frostwolf,672,monk,windwalker,12,7,5
Duhäst,sargeras,672,monk,windwalker,12,7,5
Fimeu,kiljaeden,672,monk,windwalker,12,7,5
Porxhub,tichondrius,672,monk,windwalker,12,7,5
Verizani,stormrage,672,monk,windwalker,18,7,11
Maozhën,tichondrius,672,monk,windwalker,18,7,11
Awcfanboy,bleeding-hollow,672,monk,windwalker,21,8,13
Judgevr,frostmourne,672,monk,windwalker,23,8,15
Omimonk,sargeras,671,monk,windwalker,12,7,5
Quietbegger,sargeras,671,monk,windwalker,12,7,5
Chuchinga,tichondrius,670,monk,windwalker,13,8,5
Loadedfries,frostmourne,670,monk,windwalker,12,7,5
Minusmonk,dalaran,670,monk,windwalker,12,7,5
Cryptique,tichondrius,670,monk,windwalker,12,7,5
Kuungfoo,tichondrius,667,monk,windwalker,12,7,5
Tobearus,stormscale,666,monk,windwalker,12,7,5
Hyun,stormrage,666,monk,windwalker,12,7,5
Kush,dalvengyr,665,monk,windwalker,12,7,5
Milkychi,frostmourne,655,monk,windwalker,17,7,10
Kómugi,area-52,638,monk,windwalker,17,7,10
Nagato,nemesis,623,monk,windwalker,11,7,4
Sistafistaa,emerald-dream,606,monk,windwalker,14,7,7
Bussÿ,area-52,591,monk,windwalker,11,7,4
Veso,tichondrius,576,monk,windwalker,6,6,0
Srýbrø,illidan,576,monk,windwalker,6,6,0
Griswolld,ragnaros,576,monk,windwalker,6,6,0
Gójó,tichondrius,576,monk,windwalker,12,6,6
Tinypunch,emerald-dream,576,monk,windwalker,12,6,6
Hòlygòd,dalaran,576,monk,windwalker,12,6,6
Silvyrx,boulderfist,576,monk,windwalker,12,6,6
Xedou,azralon,576,monk,windwalker,12,6,6
Pokinpooters,stormrage,576,monk,windwalker,12,6,6
Fuqmeh,darkspear,576,monk,windwalker,12,6,6
Jaspier,quelthalas,576,monk,windwalker,12,6,6
Thalreyzian,vashj,576,monk,windwalker,12,6,6
Creamchop,stormreaver,576,monk,windwalker,12,6,6
Vandamme,durotan,576,monk,windwalker,12,6,6
Xuenfu,tichondrius,576,monk,windwalker,12,6,6
Ludanford,eitrigg,576,monk,windwalker,12,6,6
Rickybobbyx,vashj,576,monk,windwalker,12,6,6
Saltystepbro,illidan,576,monk,windwalker,12,6,6
Neejitsu,malganis,576,monk,windwalker,12,6,6
Sterow,kiljaeden,576,monk,windwalker,12,6,6
Metalmønk,nerzhul,576,monk,windwalker,12,6,6
Forthekicks,tichondrius,576,monk,windwalker,19,8,11
Awsmonk,malygos,576,monk,windwalker,18,6,12
Hîddènsõündx,tichondrius,576,monk,windwalker,18,6,12
Monjimen,ragnaros,576,monk,windwalker,18,6,12
Tremonk,kelthuzad,575,monk,windwalker,12,6,6
Kalrsk,frostmourne,575,monk,windwalker,12,6,6
Samaelsin,emerald-dream,575,monk,windwalker,18,6,12
Linwong,garithos,574,monk,windwalker,12,6,6
Anavara,drakkari,574,monk,windwalker,12,6,6
Mynamegeorge,area-52,572,monk,windwalker,12,6,6
Brewzllee,tichondrius,570,monk,windwalker,12,6,6
Monkii,bonechewer,523,monk,windwalker,9,7,2
Quanyaozu,ragnaros,480,monk,windwalker,6,5,1
Lilpøøter,tichondrius,480,monk,windwalker,6,5,1
Tews,quelthalas,480,monk,windwalker,6,5,1
Rhyskrispiez,sargeras,480,monk,windwalker,6,5,1
Iloveabby,sargeras,480,monk,windwalker,6,5,1
Onepunchman,quelthalas,480,monk,windwalker,6,5,1
Varimå,area-52,480,monk,windwalker,6,5,1
Yenjung,azralon,480,monk,windwalker,6,5,1
Shevchenkô,quelthalas,480,monk,windwalker,6,5,1
Pleasetouch,emerald-dream,480,monk,windwalker,6,5,1
Kimmyfists,tichondrius,480,monk,windwalker,6,5,1
Orkmonk,tichondrius,480,monk,windwalker,6,5,1
Monkskiiz,tichondrius,480,monk,windwalker,6,5,1
Poem,grizzly-hills,480,monk,windwalker,6,5,1
Muhli,kiljaeden,480,monk,windwalker,6,5,1
Miresa,kelthuzad,480,monk,windwalker,6,5,1
Hennyww,dalaran,480,monk,windwalker,6,5,1
Nitrobrewed,stormrage,480,monk,windwalker,6,5,1
Tyrus,kelthuzad,480,monk,windwalker,9,5,4
Tenkix,zuljin,480,monk,windwalker,12,5,7
Lokimana,zuljin,480,monk,windwalker,12,5,7
Izu,senjin,480,monk,windwalker,12,5,7
Akrethar,medivh,480,monk,windwalker,12,5,7
Rocketfrogg,bleeding-hollow,480,monk,windwalker,12,5,7
Stevezee,barthilas,480,monk,windwalker,12,5,7
Zadaa,alleria,480,monk,windwalker,12,5,7
Karmerr,proudmoore,480,monk,windwalker,12,5,7
Ddoongmonk,tichondrius,480,monk,windwalker,12,5,7
Valdur,sargeras,480,monk,windwalker,12,5,7
Zhíu,ragnaros,480,monk,windwalker,12,5,7
Ragraxx,quelthalas,480,monk,windwalker,12,5,7
Píñg,area-52,480,monk,windwalker,12,5,7
Angerday,illidan,480,monk,windwalker,12,5,7
Shlumpuh,tichondrius,480,monk,windwalker,12,5,7
Mepepegaclap,malganis,480,monk,windwalker,12,5,7
Gabaan,azralon,480,monk,windwalker,18,5,13
Jatzai,emerald-dream,480,monk,windwalker,22,5,17
Zionk,tichondrius,479,monk,windwalker,6,5,1
Shocclol,stormrage,479,monk,windwalker,9,6,3
Tzidkiyahu,barthilas,478,monk,windwalker,6,5,1
Kilabit,azshara,476,monk,windwalker,12,5,7
Hitchslapz,tichondrius,400,monk,windwalker,7,5,2
Daracus,kelthuzad,384,monk,windwalker,10,7,3
Lolqtxd,sargeras,384,monk,windwalker,6,4,2
Touchbot,tichondrius,384,monk,windwalker,6,4,2
Azizyzz,barthilas,384,monk,windwalker,6,4,2
Saiyajinsoul,ragnaros,384,monk,windwalker,6,4,2
Preceptonk,azralon,384,monk,windwalker,6,4,2
Kiggo,bonechewer,384,monk,windwalker,6,4,2
Molific,gurubashi,384,monk,windwalker,6,4,2
Thewyjr,illidan,384,monk,windwalker,6,4,2
Beverage,frostmourne,384,monk,windwalker,6,4,2
Satchelgizmo,tichondrius,384,monk,windwalker,6,4,2
Sistuhfista,tichondrius,384,monk,windwalker,6,4,2
Convectuoso,illidan,384,monk,windwalker,6,4,2
Kiukiukiu,tichondrius,384,monk,windwalker,6,4,2
Pathad,stormrage,384,monk,windwalker,6,4,2
Monkespin,stormrage,384,monk,windwalker,6,4,2
Aedalithe,stormrage,384,monk,windwalker,6,4,2
Orbgodx,darkspear,384,monk,windwalker,6,4,2
Iarw,tichondrius,384,monk,windwalker,6,4,2
Ðøhkø,nemesis,384,monk,windwalker,6,4,2
Delorenzi,hellscream,384,monk,windwalker,6,4,2
Druta,illidan,384,monk,windwalker,6,4,2
Gothamonk,tichondrius,384,monk,windwalker,6,4,2
Xoir,tichondrius,384,monk,windwalker,6,4,2
Barleygar,tichondrius,384,monk,windwalker,6,4,2
Ezpzmonk,bloodscalp,384,monk,windwalker,6,4,2
Buffmonkdmg,tichondrius,384,monk,windwalker,9,5,4
Mysticzen,tichondrius,384,monk,windwalker,12,4,8
Xinvictus,frostmourne,384,monk,windwalker,12,4,8
Evilstep,tichondrius,384,monk,windwalker,12,4,8
Züdo,area-52,384,monk,windwalker,12,4,8
Jayr,bleeding-hollow,384,monk,windwalker,12,4,8
Chijinx,area-52,384,monk,windwalker,12,4,8
Rowenoa,tichondrius,384,monk,windwalker,12,4,8
Ramisan,barthilas,384,monk,windwalker,12,4,8
Ohtani,frostwolf,384,monk,windwalker,12,4,8
Merand,tichondrius,384,monk,windwalker,12,4,8
Fruitpünch,tichondrius,384,monk,windwalker,12,4,8
Jacquelline,moon-guard,384,monk,windwalker,12,4,8
Moopdahoop,stormrage,383,monk,windwalker,6,4,2
Traxshin,kelthuzad,383,monk,windwalker,6,4,2
Ryucko,azralon,383,monk,windwalker,6,4,2
Felgolos,azralon,383,monk,windwalker,9,5,4
Mùnkey,nagrand,351,monk,windwalker,11,4,7
Broxxenidas,quelthalas,351,monk,windwalker,11,4,7
Kandinarra,jubeithos,334,monk,windwalker,9,4,5
Hím,garrosh,304,monk,windwalker,7,4,3
Nakuang,tichondrius,297,monk,windwalker,14,5,9
Raires,tichondrius,288,monk,windwalker,6,3,3
Snebyos,tichondrius,288,monk,windwalker,6,3,3
Silestial,sargeras,288,monk,windwalker,6,3,3
Gulmokk,tichondrius,288,monk,windwalker,6,3,3
Rhonco,quelthalas,288,monk,windwalker,6,3,3
Monksoon,tichondrius,288,monk,windwalker,6,3,3
Ferknights,moon-guard,288,monk,windwalker,6,3,3
Tigerlust,sargeras,288,monk,windwalker,6,3,3
Detox,sargeras,288,monk,windwalker,6,3,3
Kárma,malganis,288,monk,windwalker,6,3,3
Atezo,tichondrius,288,monk,windwalker,6,3,3
Hitman,thrall,288,monk,windwalker,6,3,3
Pinkgucci,thrall,288,monk,windwalker,6,3,3
Dripharder,tichondrius,288,monk,windwalker,6,3,3
Iilmachoggy,stormrage,288,monk,windwalker,6,3,3
Sosm,kelthuzad,288,monk,windwalker,6,3,3
Redami,gnomeregan,288,monk,windwalker,6,3,3
Karkata,sargeras,288,monk,windwalker,6,3,3
Madtigon,scilla,288,monk,windwalker,6,3,3
Trunkx,area-52,288,monk,windwalker,6,3,3
Güwop,tichondrius,288,monk,windwalker,6,3,3
Aydowon,illidan,288,monk,windwalker,6,3,3
Idonthustle,area-52,288,monk,windwalker,6,3,3
Mlngo,illidan,288,monk,windwalker,6,3,3
Frimayadri,area-52,288,monk,windwalker,6,3,3
Littlemw,tichondrius,288,monk,windwalker,6,3,3
Mitras,dragonblight,288,monk,windwalker,6,3,3
Xas,sentinels,288,monk,windwalker,6,3,3
Jubei,dragonmaw,288,monk,windwalker,6,3,3
Bogez,area-52,288,monk,windwalker,6,3,3
Highaskite,tichondrius,288,monk,windwalker,6,3,3
Vuadeira,azralon,288,monk,windwalker,6,3,3
Currycooker,tichondrius,288,monk,windwalker,6,3,3
Hábìtz,area-52,288,monk,windwalker,6,3,3
Bakicaa,dalaran,288,monk,windwalker,6,3,3
Yamoshì,stormrage,288,monk,windwalker,6,3,3
Gngrbeardman,tichondrius,288,monk,windwalker,6,3,3
Mcfluffey,area-52,288,monk,windwalker,6,3,3
Dublefist,draktharon,288,monk,windwalker,6,3,3
Fistay,burning-legion,288,monk,windwalker,6,3,3
Imasterl,proudmoore,288,monk,windwalker,6,3,3
Swurvex,bleeding-hollow,288,monk,windwalker,6,3,3
Finesse,frostwolf,288,monk,windwalker,6,3,3
Goodluck,madoran,288,monk,windwalker,6,3,3
Bromonster,zuljin,288,monk,windwalker,6,3,3
Giatzo,barthilas,288,monk,windwalker,6,3,3
Mgzx,kelthuzad,288,monk,windwalker,6,3,3
Tictox,sargeras,288,monk,windwalker,6,3,3
Heavytrain,azralon,288,monk,windwalker,6,3,3
Mistérfister,blackrock,288,monk,windwalker,6,3,3
Tenshu,runetotem,288,monk,windwalker,6,3,3
Honkbazz,illidan,288,monk,windwalker,12,3,9
Meatcleave,kiljaeden,288,monk,windwalker,12,3,9
Rockxtv,illidan,288,monk,windwalker,12,3,9
Dmhsaint,sargeras,288,monk,windwalker,12,3,9
Bujiburger,frostmourne,288,monk,windwalker,12,3,9
Squidie,tichondrius,288,monk,windwalker,18,3,15
Gaziee,tichondrius,271,monk,windwalker,11,3,8
Napbox,bleeding-hollow,239,monk,windwalker,5,3,2
Iminglee,area-52,239,monk,windwalker,5,3,2
Primez,frostmourne,239,monk,windwalker,5,3,2
Sahhalea,sargeras,223,monk,windwalker,8,3,5
Kfchi,tichondrius,192,monk,windwalker,4,3,1
Butjaum,stormrage,192,monk,windwalker,4,3,1
Facekandy,tichondrius,192,monk,windwalker,4,3,1
Mùk,tichondrius,192,monk,windwalker,4,3,1
Pepeloser,illidan,192,monk,windwalker,6,2,4
Spirits,dreadmaul,192,monk,windwalker,6,2,4
Jüdo,barthilas,192,monk,windwalker,6,2,4
Tadaku,dalaran,192,monk,windwalker,6,2,4
Sickbanga,barthilas,192,monk,windwalker,6,2,4
Ghooch,illidan,192,monk,windwalker,6,2,4
Gumrag,illidan,192,monk,windwalker,6,2,4
Icesmoker,frostmourne,192,monk,windwalker,6,2,4
Fistpumps,thrall,192,monk,windwalker,6,2,4
Kreese,rivendare,192,monk,windwalker,6,2,4
Excalibrew,malganis,192,monk,windwalker,6,2,4
Deathgoku,norgannon,192,monk,windwalker,6,2,4
Romeoe,muradin,192,monk,windwalker,6,2,4
Takazawas,bonechewer,192,monk,windwalker,6,2,4
Hossdelgadoe,kiljaeden,192,monk,windwalker,6,2,4
Monkuban,destromath,192,monk,windwalker,6,2,4
Bhoredom,kiljaeden,192,monk,windwalker,6,2,4
Privix,tichondrius,192,monk,windwalker,6,2,4
Saywha,windrunner,192,monk,windwalker,6,2,4
Tahs,azralon,192,monk,windwalker,6,2,4
Averagéjoe,tichondrius,192,monk,windwalker,6,2,4
Imafqnbaby,tichondrius,192,monk,windwalker,6,2,4
Pvptone,bleeding-hollow,192,monk,windwalker,6,2,4
Wât,bleeding-hollow,192,monk,windwalker,6,2,4
Ftgx,sargeras,192,monk,windwalker,6,2,4
Salanzoww,bleeding-hollow,192,monk,windwalker,6,2,4
Nyofu,moon-guard,192,monk,windwalker,6,2,4
Selfless,gilneas,192,monk,windwalker,6,2,4
Senseî,altar-of-storms,192,monk,windwalker,6,2,4
Monkbro,altar-of-storms,192,monk,windwalker,6,2,4
Senseixww,sargeras,192,monk,windwalker,6,2,4
Joreg,moon-guard,192,monk,windwalker,6,2,4
Flicksx,arthas,192,monk,windwalker,6,2,4
Induhca,area-52,192,monk,windwalker,6,2,4
Röllup,area-52,192,monk,windwalker,6,2,4
Sinistuhm,tichondrius,192,monk,windwalker,6,2,4
Taringa,drakkari,192,monk,windwalker,6,2,4
Giorhno,ragnaros,192,monk,windwalker,6,2,4
Hydraoxy,moon-guard,192,monk,windwalker,6,2,4
Coomerww,kelthuzad,192,monk,windwalker,6,2,4
Resolver,stormscale,192,monk,windwalker,6,2,4
Youngnudy,sargeras,192,monk,windwalker,6,2,4
Bvndio,ragnaros,192,monk,windwalker,6,2,4
Mannkin,zuluhed,192,monk,windwalker,6,2,4
Fuchizaki,ragnaros,192,monk,windwalker,6,2,4
Ked,ragnaros,192,monk,windwalker,6,2,4
Wheresmyjuul,malganis,192,monk,windwalker,6,2,4
Möösê,moon-guard,192,monk,windwalker,6,2,4
Novoctek,quelthalas,192,monk,windwalker,6,2,4
Liw,quelthalas,192,monk,windwalker,6,2,4
Cpapi,sargeras,192,monk,windwalker,12,2,10
Eliwenn,ragnaros,192,monk,windwalker,12,2,10
Dankestkhan,korialstrasz,192,monk,windwalker,12,2,10
Razekahl,wyrmrest-accord,192,monk,windwalker,12,2,10
Goku,frostmourne,159,monk,windwalker,5,2,3
Captnmurphy,tichondrius,159,monk,windwalker,5,2,3
Habzz,tichondrius,159,monk,windwalker,5,2,3
Clytpuncher,emerald-dream,159,monk,windwalker,5,2,3
Fendi,stormrage,159,monk,windwalker,5,2,3
Wheatsli,malganis,159,monk,windwalker,5,2,3
Chisuschrist,hyjal,144,monk,windwalker,9,2,7
Heartsies,sargeras,128,monk,windwalker,4,2,2
Raninn,bleeding-hollow,128,monk,windwalker,4,2,2
Prettyflacko,thrall,128,monk,windwalker,4,2,2
Neaxain,tichondrius,96,monk,windwalker,3,2,1
Lhiri,moon-guard,96,monk,windwalker,6,1,5
Sprinkli,sargeras,96,monk,windwalker,6,1,5
Teewin,area-52,96,monk,windwalker,6,1,5
Buddaba,tichondrius,96,monk,windwalker,6,1,5
Molsonicee,tichondrius,96,monk,windwalker,6,1,5
Fínzy,ragnaros,96,monk,windwalker,6,1,5
Shianjuo,ragnaros,96,monk,windwalker,6,1,5
Yípman,uldum,96,monk,windwalker,6,1,5
Memurk,bleeding-hollow,96,monk,windwalker,6,1,5
Munnk,stormreaver,96,monk,windwalker,6,1,5
Lainerya,moon-guard,96,monk,windwalker,6,1,5
Phukyu,moon-guard,96,monk,windwalker,6,1,5
Obiiwan,tichondrius,96,monk,windwalker,6,1,5
Giriom,thrall,96,monk,windwalker,6,1,5
Saruyo,frostmourne,96,monk,windwalker,6,1,5
Chunlee,tichondrius,96,monk,windwalker,6,1,5
Piccolo,emerald-dream,96,monk,windwalker,6,1,5
Shírÿu,azralon,96,monk,windwalker,6,1,5
Imingleejr,illidan,96,monk,windwalker,6,1,5
Zinque,emerald-dream,96,monk,windwalker,6,1,5
Pipochen,ragnaros,96,monk,windwalker,6,1,5
Srgtbingo,azgalor,96,monk,windwalker,6,1,5
Ökami,tichondrius,96,monk,windwalker,6,1,5
Cerocool,hyjal,96,monk,windwalker,6,1,5
Æsir,moon-guard,96,monk,windwalker,6,1,5
Sínsayer,tichondrius,96,monk,windwalker,6,1,5
Cudzingtin,dalaran,96,monk,windwalker,6,1,5
Leisa,jaedenar,79,monk,windwalker,5,1,4
Shindoro,bonechewer,42,monk,windwalker,10,5,5
Veganbacon,mannoroth,31,monk,windwalker,2,1,1
Kungxxl,kiljaeden,31,monk,windwalker,2,1,1
Mommysalamii,moon-guard,16,monk,windwalker,1,1,0
Raskalnikov,kelthuzad,9,monk,windwalker,8,2,6
Sunita,arthas,2134,paladin,holy,147,78,69
Pattar,area-52,2107,paladin,holy,66,37,29
Holylolz,ragnaros,2084,paladin,holy,132,67,65
Digglesx,area-52,2012,paladin,holy,78,35,43
Eskerda,azralon,1935,paladin,holy,136,64,72
Hamsti,sargeras,1909,paladin,holy,125,63,62
Thejustice,tichondrius,1894,paladin,holy,52,29,23
Bombboyoz,area-52,1893,paladin,holy,36,20,16
Angrycubanx,black-dragonflight,1887,paladin,holy,50,25,25
Rèxpéi,area-52,1867,paladin,holy,54,31,23
Bilmurii,zuljin,1866,paladin,holy,72,36,36
Sojupapi,area-52,1862,paladin,holy,72,38,34
Curator,emerald-dream,1859,paladin,holy,56,29,27
Nyctemavanna,ragnaros,1852,paladin,holy,70,38,32
Tmborn,tichondrius,1842,paladin,holy,54,24,30
Cynthianna,tichondrius,1839,paladin,holy,116,61,55
Csupremacy,tichondrius,1839,paladin,holy,64,30,34
Bushyy,tichondrius,1838,paladin,holy,54,26,28
Ðáx,sargeras,1828,paladin,holy,75,39,36
Ppgdx,azralon,1826,paladin,holy,78,34,44
Sacbubldead,area-52,1820,paladin,holy,126,79,47
Truluck,area-52,1820,paladin,holy,111,56,55
Deadlyassian,sargeras,1819,paladin,holy,100,54,46
Fonypally,tichondrius,1815,paladin,holy,332,171,161
Fukndibs,kiljaeden,1811,paladin,holy,172,85,87
Sd,kelthuzad,1811,paladin,holy,123,59,64
Bubblist,tichondrius,1811,paladin,holy,68,28,40
Flashv,barthilas,1808,paladin,holy,50,26,24
Bravepl,tichondrius,1808,paladin,holy,73,28,45
Overwhelm,muradin,1806,paladin,holy,40,22,18
Wtbmana,frostmourne,1801,paladin,holy,72,39,33
Memnoche,frostmane,1796,paladin,holy,71,42,29
Dreathhammer,muradin,1787,paladin,holy,36,21,15
Amourranth,stormrage,1785,paladin,holy,52,30,22
Zilea,kiljaeden,1768,paladin,holy,48,24,24
Tylennis,archimonde,1762,paladin,holy,77,32,45
Hps,argent-dawn,1759,paladin,holy,42,22,20
Evylinn,burning-legion,1744,paladin,holy,66,42,24
Dyppally,moon-guard,1743,paladin,holy,48,22,26
Beyondsausag,malganis,1734,paladin,holy,53,24,29
Brynnhild,stormrage,1722,paladin,holy,102,55,47
Hongwoosang,tichondrius,1709,paladin,holy,128,55,73
Fortold,bloodhoof,1692,paladin,holy,54,23,31
Virabelle,gurubashi,1690,paladin,holy,48,25,23
Landrysdad,malorne,1690,paladin,holy,48,24,24
Hats,icecrown,1690,paladin,holy,136,66,70
Taargaryenn,tichondrius,1680,paladin,holy,48,26,22
Avengom,tichondrius,1678,paladin,holy,218,111,107
Ængelic,barthilas,1677,paladin,holy,100,51,49
Tenêbrae,area-52,1674,paladin,holy,52,33,19
Mvpj,medivh,1673,paladin,holy,41,25,16
Guerrer,hyjal,1673,paladin,holy,224,123,101
Sàga,hyjal,1671,paladin,holy,47,26,21
Minefujiko,tichondrius,1668,paladin,holy,143,77,66
Braindeadrsj,anetheron,1667,paladin,holy,42,24,18
Imshmackedd,darkspear,1663,paladin,holy,84,35,49
Sacridas,fizzcrank,1657,paladin,holy,36,20,16
Ihaveajob,zuluhed,1657,paladin,holy,36,19,17
Zunit,laughing-skull,1656,paladin,holy,46,22,24
Bushÿ,tichondrius,1652,paladin,holy,66,42,24
Pallice,queldorei,1651,paladin,holy,96,43,53
Xciss,kiljaeden,1647,paladin,holy,72,31,41
Ppgddxx,azralon,1643,paladin,holy,30,18,12
Ellyarian,emerald-dream,1635,paladin,holy,42,22,20
Yuuichi,moon-guard,1634,paladin,holy,64,29,35
Ddeuk,tichondrius,1628,paladin,holy,193,101,92
Defensezone,tichondrius,1622,paladin,holy,50,22,28
Dazargeros,moon-guard,1617,paladin,holy,84,42,42
Ascion,tichondrius,1614,paladin,holy,119,58,61
Larryhoova,malganis,1608,paladin,holy,36,20,16
Crâfty,bleeding-hollow,1608,paladin,holy,83,45,38
Jiraya,nemesis,1598,paladin,holy,79,39,40
Perfect,crushridge,1597,paladin,holy,32,18,14
Wuhb,aerie-peak,1596,paladin,holy,88,44,44
Saveursavior,bleeding-hollow,1595,paladin,holy,93,46,47
Handyandy,kelthuzad,1589,paladin,holy,48,31,17
Drägonmynuts,tichondrius,1587,paladin,holy,55,22,33
Crabsaladpal,illidan,1577,paladin,holy,70,42,28
Pasda,frostmourne,1575,paladin,holy,53,22,31
Galeras,norgannon,1574,paladin,holy,68,32,36
Doofum,stormrage,1573,paladin,holy,119,55,64
Humañ,tichondrius,1559,paladin,holy,30,20,10
Nrpzy,stormrage,1558,paladin,holy,53,29,24
Mabia,tichondrius,1543,paladin,holy,138,77,61
Discordnitro,illidan,1539,paladin,holy,36,20,16
Runihaveaids,stormrage,1535,paladin,holy,58,29,29
Erikx,smolderthorn,1530,paladin,holy,36,22,14
Paladinaa,lothar,1529,paladin,holy,74,33,41
Prettylightx,kelthuzad,1527,paladin,holy,54,28,26
Bigoldman,tichondrius,1526,paladin,holy,60,32,28
Rodrigo,frostmourne,1524,paladin,holy,69,34,35
Kidstable,nathrezim,1523,paladin,holy,70,27,43
Beyönd,quelthalas,1520,paladin,holy,78,39,39
Riptonix,stormrage,1514,paladin,holy,105,56,49
Hônòr,thrall,1512,paladin,holy,45,24,21
Rhunon,dalaran,1512,paladin,holy,42,19,23
Sinfolly,whisperwind,1510,paladin,holy,42,19,23
Raigha,stormrage,1507,paladin,holy,30,16,14
Cjqcjq,tichondrius,1507,paladin,holy,41,21,20
Lightkillerx,thrall,1494,paladin,holy,84,37,47
Ibury,quelthalas,1492,paladin,holy,101,46,55
Kdex,tichondrius,1489,paladin,holy,66,27,39
Xinqingle,tichondrius,1488,paladin,holy,66,32,34
Rg,nerzhul,1487,paladin,holy,111,52,59
Judgemode,the-scryers,1487,paladin,holy,90,39,51
Dreadrot,azralon,1484,paladin,holy,46,24,22
Condone,earthen-ring,1484,paladin,holy,90,41,49
Ageroÿ,sargeras,1483,paladin,holy,50,25,25
Granklol,tichondrius,1476,paladin,holy,50,25,25
Fixyouz,mannoroth,1473,paladin,holy,34,17,17
Paladinaiko,nemesis,1472,paladin,holy,108,54,54
Nanøha,frostmourne,1465,paladin,holy,72,21,51
Konvi,tichondrius,1464,paladin,holy,60,24,36
Cohesion,draenor,1461,paladin,holy,77,35,42
Devöut,aggramar,1461,paladin,holy,56,25,31
Kihluxo,frostmourne,1459,paladin,holy,84,48,36
Indemnity,wildhammer,1457,paladin,holy,69,40,29
Dewlight,zuljin,1454,paladin,holy,157,75,82
Holyterror,dentarg,1451,paladin,holy,42,23,19
Zoeyxo,tichondrius,1448,paladin,holy,80,42,38
Noback,ragnaros,1448,paladin,holy,66,31,35
Holyknight,veknilash,1446,paladin,holy,71,32,39
Donkeydumper,wyrmrest-accord,1445,paladin,holy,60,37,23
Holyprotectr,tichondrius,1442,paladin,holy,30,17,13
Sigmapepe,quelthalas,1437,paladin,holy,54,32,22
Kustp,tichondrius,1428,paladin,holy,33,19,14
Sekitar,ragnaros,1427,paladin,holy,60,23,37
Sorkar,tichondrius,1424,paladin,holy,63,37,26
Moonmi,tichondrius,1423,paladin,holy,66,36,30
Ivan,tichondrius,1421,paladin,holy,42,15,27
Jpwx,barthilas,1419,paladin,holy,30,15,15
Saeranella,moon-guard,1419,paladin,holy,88,37,51
Danpros,azralon,1417,paladin,holy,66,24,42
Friedpaladin,frostmourne,1416,paladin,holy,87,46,41
Allitharis,tichondrius,1413,paladin,holy,79,41,38
Xuanxingchai,tichondrius,1413,paladin,holy,72,30,42
Ironpaladin,sargeras,1407,paladin,holy,58,27,31
Hodl,barthilas,1406,paladin,holy,71,41,30
Talantyr,zuljin,1398,paladin,holy,48,23,25
Percüles,sargeras,1395,paladin,holy,54,29,25
Decalli,tichondrius,1391,paladin,holy,63,31,32
Boomda,tichondrius,1389,paladin,holy,36,15,21
Anea,kelthuzad,1388,paladin,holy,32,17,15
Summercarma,area-52,1387,paladin,holy,27,15,12
Ryhighh,sargeras,1384,paladin,holy,63,26,37
Heaven,gurubashi,1382,paladin,holy,35,16,19
Vurian,uther,1382,paladin,holy,36,16,20
Rezmefool,tichondrius,1381,paladin,holy,60,23,37
Twck,hyjal,1378,paladin,holy,36,17,19
Lu,the-venture-co,1371,paladin,holy,34,15,19
Solanin,frostmourne,1362,paladin,holy,42,24,18
Mcllovin,kiljaeden,1351,paladin,holy,48,23,25
Galabanja,malganis,1350,paladin,holy,42,24,18
Hawtwangs,proudmoore,1349,paladin,holy,48,26,22
Flippo,sargeras,1346,paladin,holy,36,17,19
Vitabro,bleeding-hollow,1342,paladin,holy,41,20,21
Uxe,zuljin,1338,paladin,holy,36,14,22
Xiaoladin,frostmourne,1337,paladin,holy,25,16,9
Finerkane,quelthalas,1334,paladin,holy,138,62,76
Zergmé,executus,1330,paladin,holy,30,14,16
Goodwood,ghostlands,1330,paladin,holy,36,16,20
Buri,tichondrius,1330,paladin,holy,42,17,25
Savagegirlz,tichondrius,1329,paladin,holy,72,33,39
Syrenz,khazgoroth,1327,paladin,holy,42,24,18
Castleknight,tichondrius,1327,paladin,holy,36,14,22
Senorbaxter,emerald-dream,1326,paladin,holy,42,14,28
Catechism,laughing-skull,1325,paladin,holy,44,24,20
Consecrated,daggerspine,1324,paladin,holy,75,30,45
Zantdemption,frostmourne,1322,paladin,holy,30,15,15
Fuzed,frostmourne,1317,paladin,holy,118,63,55
Ùnholypally,jubeithos,1316,paladin,holy,71,42,29
Daenrahh,azralon,1315,paladin,holy,80,36,44
Negodoskate,nemesis,1306,paladin,holy,54,27,27
Ozpal,burning-blade,1305,paladin,holy,38,24,14
Kriegmeister,amanthul,1305,paladin,holy,30,14,16
Güido,stormrage,1292,paladin,holy,30,16,14
Acori,azralon,1289,paladin,holy,30,16,14
Quarall,blackhand,1288,paladin,holy,40,20,20
Jiberish,illidan,1287,paladin,holy,38,15,23
Quadrifoglio,moon-guard,1283,paladin,holy,181,88,93
Wokeinator,malganis,1282,paladin,holy,65,29,36
Vithar,bleeding-hollow,1276,paladin,holy,74,35,39
Alphanerd,burning-blade,1272,paladin,holy,43,18,25
Errant,bonechewer,1267,paladin,holy,41,23,18
Merll,ragnaros,1265,paladin,holy,115,55,60
Mundomaloo,quelthalas,1264,paladin,holy,36,21,15
Salipally,dalaran,1258,paladin,holy,101,46,55
Brenenk,quelthalas,1247,paladin,holy,59,28,31
Röniin,ragnaros,1244,paladin,holy,137,70,67
Bpalaayo,kelthuzad,1244,paladin,holy,36,13,23
Sologriefer,sargeras,1242,paladin,holy,30,13,17
Gospel,duskwood,1241,paladin,holy,18,13,5
Scarlet,skywall,1241,paladin,holy,30,13,17
Rarth,nemesis,1238,paladin,holy,24,13,11
Kristienna,boulderfist,1236,paladin,holy,35,16,19
Cbm,tichondrius,1235,paladin,holy,23,14,9
Oldgrumpster,stormrage,1232,paladin,holy,75,34,41
Aoishie,bleeding-hollow,1229,paladin,holy,84,38,46
Fiate,azralon,1229,paladin,holy,30,13,17
Holysplonk,stonemaul,1229,paladin,holy,66,26,40
Justizz,vashj,1228,paladin,holy,65,35,30
Crocfacex,tichondrius,1226,paladin,holy,46,18,28
Elizzabeth,skullcrusher,1220,paladin,holy,35,21,14
Kamaelyn,proudmoore,1220,paladin,holy,109,57,52
Ramspartan,drakkari,1218,paladin,holy,106,52,54
Boarfarmer,tichondrius,1215,paladin,holy,81,35,46
Saffranzord,azralon,1214,paladin,holy,73,35,38
Yérn,barthilas,1208,paladin,holy,42,15,27
Hammercy,tichondrius,1199,paladin,holy,49,28,21
Encantado,thrall,1196,paladin,holy,31,15,16
Shorthordeon,kelthuzad,1194,paladin,holy,54,30,24
Deepsearide,illidan,1193,paladin,holy,30,17,13
Barbaluzz,quelthalas,1188,paladin,holy,75,35,40
Hóbbs,trollbane,1184,paladin,holy,83,29,54
Dawnhammer,mugthol,1178,paladin,holy,36,19,17
Myrthedara,kargath,1178,paladin,holy,33,16,17
Tiernoo,illidan,1177,paladin,holy,38,13,25
Ziggzag,hyjal,1172,paladin,holy,60,27,33
Dbolpala,frostmourne,1169,paladin,holy,36,20,16
Coltlocks,sargeras,1168,paladin,holy,36,14,22
Chopsparks,khadgar,1164,paladin,holy,80,39,41
Shocka,norgannon,1156,paladin,holy,78,45,33
Onecmpeter,kelthuzad,1152,paladin,holy,67,38,29
Htmlar,tichondrius,1152,paladin,holy,33,14,19
Dwarrior,quelthalas,1151,paladin,holy,24,12,12
Dageraad,tichondrius,1150,paladin,holy,24,12,12
Boxjang,tichondrius,1149,paladin,holy,24,12,12
Kevinthecube,nerzhul,1146,paladin,holy,18,12,6
Bubblebooty,drakthul,1146,paladin,holy,42,27,15
Renteria,sargeras,1144,paladin,holy,24,12,12
Dazztrain,barthilas,1139,paladin,holy,24,12,12
Exxin,turalyon,1139,paladin,holy,90,40,50
Flareous,moon-guard,1138,paladin,holy,30,12,18
Sixtynine,nathrezim,1137,paladin,holy,36,13,23
Toroke,nemesis,1133,paladin,holy,36,20,16
Dóminos,quelthalas,1127,paladin,holy,24,12,12
Stompcomp,tichondrius,1127,paladin,holy,59,29,30
Balanoriaa,azralon,1122,paladin,holy,50,24,26
Faileeria,malganis,1121,paladin,holy,24,16,8
Bonz,ragnaros,1121,paladin,holy,24,12,12
Airbad,tichondrius,1119,paladin,holy,35,12,23
Biwi,zuljin,1115,paladin,holy,61,25,36
Ihr,kiljaeden,1110,paladin,holy,30,12,18
Lovehan,tichondrius,1103,paladin,holy,27,12,15
Orphandog,zuljin,1100,paladin,holy,17,12,5
Nugsbunne,tichondrius,1100,paladin,holy,42,15,27
Kënsi,quelthalas,1092,paladin,holy,111,55,56
Spikele,barthilas,1079,paladin,holy,30,13,17
Rajava,gallywix,1076,paladin,holy,24,14,10
Rykeran,warsong,1072,paladin,holy,36,25,11
Toesy,area-52,1067,paladin,holy,34,12,22
Lycheelz,illidan,1064,paladin,holy,48,26,22
Malakk,zuljin,1058,paladin,holy,35,19,16
Odriew,sargeras,1056,paladin,holy,18,11,7
Dýstopia,stormrage,1056,paladin,holy,24,11,13
Chenzo,exodar,1055,paladin,holy,18,11,7
Bushys,tichondrius,1055,paladin,holy,18,11,7
Waifu,area-52,1055,paladin,holy,18,11,7
Pelletbrain,emerald-dream,1055,paladin,holy,30,11,19
Jealp,sargeras,1054,paladin,holy,12,11,1
Aldrion,stormrage,1054,paladin,holy,24,11,13
Amiigo,tichondrius,1052,paladin,holy,24,11,13
Wonpai,frostmourne,1051,paladin,holy,24,11,13
Ramhammerz,sargeras,1051,paladin,holy,54,23,31
Minereth,quelthalas,1044,paladin,holy,24,11,13
Sinara,detheroc,1040,paladin,holy,73,31,42
Palaadiin,sargeras,1032,paladin,holy,30,16,14
Va,onyxia,1029,paladin,holy,54,26,28
Lobõ,ragnaros,1028,paladin,holy,24,11,13
Paulx,malganis,1017,paladin,holy,40,23,17
Iamholyman,dragonmaw,1014,paladin,holy,29,14,15
Vamir,magtheridon,1014,paladin,holy,30,13,17
Buckybarnes,gorefiend,1013,paladin,holy,18,12,6
Jazzmatic,dalaran,1012,paladin,holy,23,11,12
Overthrrow,kelthuzad,1010,paladin,holy,95,47,48
Teenytoots,burning-legion,1002,paladin,holy,27,12,15
Mèdic,illidan,1000,paladin,holy,30,16,14
Gigadunker,tichondrius,999,paladin,holy,29,13,16
Holyhades,auchindoun,988,paladin,holy,25,13,12
Scoopzi,frostmourne,988,paladin,holy,26,11,15
Ckemosabe,emerald-dream,985,paladin,holy,32,11,21
Lukas,vashj,984,paladin,holy,89,40,49
Hammerabi,moon-guard,963,paladin,holy,21,13,8
Thoryin,tichondrius,960,paladin,holy,12,10,2
Síríús,malganis,960,paladin,holy,15,11,4
Nickimahoj,tichondrius,960,paladin,holy,24,10,14
Lavarball,tichondrius,960,paladin,holy,30,10,20
Leónrey,stormrage,958,paladin,holy,33,10,23
Raenilil,area-52,955,paladin,holy,30,12,18
Starfaith,illidan,951,paladin,holy,49,15,34
Affrika,ysondre,950,paladin,holy,18,10,8
Nikopala,tichondrius,945,paladin,holy,18,10,8
Darkwingdad,illidan,940,paladin,holy,14,10,4
Snnow,stormrage,938,paladin,holy,24,15,9
Eradrae,mannoroth,933,paladin,holy,18,10,8
Saìdelia,moon-guard,929,paladin,holy,71,24,47
Colombía,illidan,928,paladin,holy,48,21,27
Santiadin,ragnaros,926,paladin,holy,14,11,3
Sutadansa,doomhammer,921,paladin,holy,49,24,25
Svitanie,bleeding-hollow,909,paladin,holy,62,28,34
Ascension,amanthul,897,paladin,holy,84,30,54
Fedpowell,tichondrius,894,paladin,holy,23,10,13
Shananakin,azshara,892,paladin,holy,29,13,16
Trâshcårt,sargeras,864,paladin,holy,12,9,3
Sovice,illidan,864,paladin,holy,12,9,3
Deadry,ysera,864,paladin,holy,18,9,9
Mayru,ragnaros,864,paladin,holy,18,9,9
Zilzag,moon-guard,864,paladin,holy,23,9,14
Diamondwater,tichondrius,864,paladin,holy,24,9,15
Sde,kelthuzad,864,paladin,holy,24,9,15
Gotomars,tichondrius,862,paladin,holy,24,9,15
Kusotarão,nemesis,861,paladin,holy,18,9,9
Tandury,tichondrius,858,paladin,holy,18,9,9
Spamsalot,malganis,857,paladin,holy,24,9,15
Maalik,thrall,844,paladin,holy,18,9,9
Nea,argent-dawn,843,paladin,holy,29,12,17
Adventholy,tichondrius,836,paladin,holy,24,9,15
Thaedrun,hydraxis,825,paladin,holy,48,20,28
Bainn,nerzhul,822,paladin,holy,73,31,42
Beejae,stormreaver,815,paladin,holy,17,9,8
Psychorino,tichondrius,813,paladin,holy,21,9,12
Praisin,zuljin,805,paladin,holy,18,9,9
Nualrossan,veknilash,776,paladin,holy,42,14,28
Swellowsx,tichondrius,768,paladin,holy,12,8,4
Artús,ragnaros,768,paladin,holy,18,8,10
Holymooie,frostmourne,768,paladin,holy,18,8,10
Blarr,azshara,768,paladin,holy,24,8,16
Bestpally,alterac-mountains,767,paladin,holy,12,8,4
Nume,nesingwary,767,paladin,holy,12,8,4
Mhera,sargeras,767,paladin,holy,12,8,4
Wonpai,barthilas,767,paladin,holy,18,8,10
Wálker,ragnaros,767,paladin,holy,18,8,10
Trancelancer,kelthuzad,767,paladin,holy,18,8,10
Avahir,moon-guard,767,paladin,holy,18,8,10
Miniweiner,proudmoore,767,paladin,holy,18,8,10
Kencyxx,tichondrius,767,paladin,holy,18,8,10
Gorgona,illidan,767,paladin,holy,24,8,16
Caike,frostmourne,766,paladin,holy,12,8,4
Thonar,stormrage,765,paladin,holy,12,8,4
Elogant,mannoroth,764,paladin,holy,12,8,4
Whangsta,tichondrius,764,paladin,holy,18,8,10
Pambam,thrall,763,paladin,holy,18,9,9
Darkbringer,frostmourne,763,paladin,holy,18,8,10
Vidalia,barthilas,763,paladin,holy,18,8,10
Vaalbara,fizzcrank,757,paladin,holy,18,8,10
Hybbo,runetotem,753,paladin,holy,18,8,10
Huijji,illidan,750,paladin,holy,12,8,4
Gênji,eldrethalas,737,paladin,holy,24,8,16
Mirotchburns,illidan,724,paladin,holy,16,9,7
Chewiipal,dalaran,719,paladin,holy,9,9,0
Solfire,stormreaver,713,paladin,holy,26,9,17
Vasar,tichondrius,703,paladin,holy,10,8,2
Thorfinaa,moon-guard,687,paladin,holy,11,8,3
Imsuffering,zuljin,672,paladin,holy,12,7,5
Shxz,illidan,672,paladin,holy,12,7,5
Everrlasting,tichondrius,672,paladin,holy,12,7,5
Gankstapwn,tichondrius,672,paladin,holy,12,7,5
Censy,tichondrius,672,paladin,holy,12,7,5
Ilovecanada,sargeras,672,paladin,holy,12,7,5
Oîn,area-52,672,paladin,holy,12,7,5
Busdid,sargeras,672,paladin,holy,12,7,5
Crinject,sargeras,672,paladin,holy,12,7,5
Danyuel,zuljin,672,paladin,holy,18,7,11
Bubblebuddyx,tichondrius,672,paladin,holy,18,7,11
Orekilol,stormrage,672,paladin,holy,18,7,11
Stompedlawl,illidan,672,paladin,holy,24,7,17
Samaze,tichondrius,671,paladin,holy,12,7,5
Lördnextdoor,tichondrius,671,paladin,holy,12,7,5
Uprise,chogall,671,paladin,holy,12,7,5
Doktavius,lightbringer,671,paladin,holy,12,7,5
Virkas,area-52,671,paladin,holy,18,7,11
Korvén,area-52,670,paladin,holy,12,7,5
Yadiyadiyada,barthilas,670,paladin,holy,12,7,5
Tyriam,stormscale,670,paladin,holy,12,7,5
Paladam,burning-blade,670,paladin,holy,18,7,11
Bárdokø,ragnaros,670,paladin,holy,18,7,11
Pluto,the-underbog,669,paladin,holy,12,7,5
Stationarity,frostmourne,669,paladin,holy,18,7,11
Kimahri,anvilmar,669,paladin,holy,36,7,29
Maldobarr,stormrage,668,paladin,holy,18,7,11
Cephadrome,proudmoore,667,paladin,holy,12,7,5
Daik,proudmoore,666,paladin,holy,12,7,5
Snowdawg,blackhand,654,paladin,holy,24,7,17
Mycow,tichondrius,638,paladin,holy,17,7,10
Mojiberus,wyrmrest-accord,606,paladin,holy,14,7,7
Turnevil,wyrmrest-accord,591,paladin,holy,19,7,12
Wonpait,frostmourne,576,paladin,holy,9,7,2
Caitthegreat,malorne,576,paladin,holy,12,6,6
Kencyz,tichondrius,576,paladin,holy,12,6,6
Maín,tichondrius,576,paladin,holy,12,6,6
Dequincy,tichondrius,576,paladin,holy,12,6,6
Veejayx,tichondrius,576,paladin,holy,12,6,6
Tolentino,elune,576,paladin,holy,12,6,6
Chånïng,frostmourne,576,paladin,holy,12,6,6
Fadiez,sargeras,576,paladin,holy,12,6,6
Squarehammer,blackrock,576,paladin,holy,12,6,6
Catharsis,tichondrius,576,paladin,holy,12,6,6
Kensyzs,tichondrius,576,paladin,holy,12,6,6
Wonpaiv,frostmourne,576,paladin,holy,17,6,11
Remibear,tichondrius,576,paladin,holy,18,6,12
Colepal,zuljin,576,paladin,holy,18,6,12
Santiagolol,ragnaros,576,paladin,holy,24,6,18
Regivän,azralon,576,paladin,holy,24,6,18
Lilfingered,malganis,575,paladin,holy,12,6,6
Cassiel,barthilas,575,paladin,holy,12,6,6
Diebeatus,zuljin,575,paladin,holy,12,6,6
Hojadin,area-52,575,paladin,holy,18,6,12
Sixthycent,kiljaeden,574,paladin,holy,12,6,6
Mörphêus,tichondrius,574,paladin,holy,12,6,6
Randuir,proudmoore,574,paladin,holy,12,6,6
Belmonte,greymane,574,paladin,holy,12,6,6
Holyredx,bleeding-hollow,573,paladin,holy,18,6,12
Bangerzzx,sargeras,572,paladin,holy,12,6,6
Ducii,stormrage,571,paladin,holy,12,6,6
Cloûd,tichondrius,570,paladin,holy,12,6,6
Willycrow,nordrassil,569,paladin,holy,12,6,6
Hivers,stormrage,569,paladin,holy,24,6,18
Kaina,wildhammer,569,paladin,holy,24,6,18
Maplleafs,kelthuzad,560,paladin,holy,24,6,18
Fayernaa,proudmoore,557,paladin,holy,10,7,3
Center,ragnaros,543,paladin,holy,11,6,5
Powtilted,thrall,543,paladin,holy,11,6,5
Redpally,emerald-dream,543,paladin,holy,16,6,10
Brumm,quelthalas,543,paladin,holy,20,7,13
Møcha,moon-guard,542,paladin,holy,14,7,7
Eboi,daggerspine,542,paladin,holy,26,7,19
Kbot,zuljin,528,paladin,holy,9,6,3
Mfn,tichondrius,522,paladin,holy,12,7,5
Grumpybubble,sargeras,522,paladin,holy,13,7,6
Mianheyo,quelthalas,521,paladin,holy,20,8,12
Trivana,durotan,496,paladin,holy,7,6,1
Holythunderx,tichondrius,496,paladin,holy,19,6,13
Zenastra,moon-guard,480,paladin,holy,6,5,1
Usebandage,sargeras,480,paladin,holy,6,5,1
Loganholy,tichondrius,480,paladin,holy,6,5,1
Badboí,azralon,480,paladin,holy,6,5,1
Zanduncy,stormrage,480,paladin,holy,6,5,1
Careless,malganis,480,paladin,holy,12,5,7
Beila,illidan,480,paladin,holy,12,5,7
Lyticmartyr,bleeding-hollow,480,paladin,holy,12,5,7
Miswalkpally,ragnaros,480,paladin,holy,12,5,7
Zero,anetheron,480,paladin,holy,12,5,7
Adrizzyx,barthilas,480,paladin,holy,12,5,7
Rachaelucky,malganis,480,paladin,holy,12,5,7
Tigranes,proudmoore,480,paladin,holy,12,5,7
Chunzhangsqs,tichondrius,480,paladin,holy,12,5,7
Fartburger,saurfang,480,paladin,holy,12,5,7
Sprjustice,frostmourne,480,paladin,holy,12,5,7
Harryhui,tichondrius,480,paladin,holy,12,5,7
Zhangliyi,tichondrius,480,paladin,holy,12,5,7
Tèhflip,tichondrius,480,paladin,holy,12,5,7
Holyiseasy,alleria,480,paladin,holy,12,5,7
Airbusx,tichondrius,480,paladin,holy,12,5,7
Bíteme,sargeras,480,paladin,holy,15,6,9
Doidyph,frostmourne,479,paladin,holy,12,5,7
Colbroggins,crushridge,479,paladin,holy,12,5,7
Tankgreed,quelthalas,479,paladin,holy,12,5,7
Loabandit,malorne,479,paladin,holy,12,5,7
Gyle,stormrage,479,paladin,holy,12,5,7
Meistyr,thrall,479,paladin,holy,18,5,13
Moogmodular,malganis,479,paladin,holy,18,5,13
Yobnai,zuljin,478,paladin,holy,12,5,7
Stemi,kelthuzad,478,paladin,holy,24,5,19
Unworn,proudmoore,477,paladin,holy,18,5,13
Parts,aerie-peak,468,paladin,holy,24,5,19
Fleshoflíght,azjolnerub,463,paladin,holy,11,5,6
Ziggerqt,stormrage,432,paladin,holy,15,5,10
Paladinomoto,sargeras,430,paladin,holy,11,5,6
Nivie,moon-guard,430,paladin,holy,15,5,10
Rashell,garrosh,426,paladin,holy,16,7,9
Retribution,mannoroth,426,paladin,holy,23,6,17
Ziti,bonechewer,415,paladin,holy,8,5,3
Cyandra,moon-guard,400,paladin,holy,7,5,2
Immensepower,tichondrius,384,paladin,holy,6,4,2
Leddie,stormrage,384,paladin,holy,6,4,2
Thin,ragnaros,384,paladin,holy,6,4,2
Holodecoy,bleeding-hollow,384,paladin,holy,6,4,2
Cheers,garona,384,paladin,holy,6,4,2
Notdjalex,zuljin,384,paladin,holy,6,4,2
Eladore,hakkar,384,paladin,holy,6,4,2
Decree,rexxar,384,paladin,holy,6,4,2
Undefeatæd,korgath,384,paladin,holy,6,4,2
Icac,stormrage,384,paladin,holy,6,4,2
Oralen,daggerspine,384,paladin,holy,6,4,2
Arleos,mannoroth,384,paladin,holy,6,4,2
Hamen,frostwolf,384,paladin,holy,6,4,2
Respect,black-dragonflight,384,paladin,holy,6,4,2
Boundric,emerald-dream,384,paladin,holy,6,4,2
Rc,tichondrius,384,paladin,holy,6,4,2
Ladanthal,barthilas,384,paladin,holy,6,4,2
Lightwerk,frostmourne,384,paladin,holy,6,4,2
Neurôtoxins,frostmourne,384,paladin,holy,6,4,2
Garethorne,illidan,384,paladin,holy,6,4,2
Agravaine,moon-guard,384,paladin,holy,12,4,8
Swolsus,illidan,384,paladin,holy,12,4,8
Devsrdumb,bonechewer,384,paladin,holy,12,4,8
Lesauceboss,tichondrius,384,paladin,holy,12,4,8
Nikkixo,ysera,384,paladin,holy,12,4,8
Nontheism,malganis,384,paladin,holy,12,4,8
Footjob,baelgun,384,paladin,holy,12,4,8
Bighardshock,aggramar,384,paladin,holy,12,4,8
Saacbot,area-52,384,paladin,holy,12,4,8
Waldir,silver-hand,384,paladin,holy,12,4,8
Daflash,emerald-dream,384,paladin,holy,12,4,8
Amadeo,hyjal,384,paladin,holy,18,4,14
Kaminasol,quelthalas,384,paladin,holy,18,4,14
Caobobby,tichondrius,384,paladin,holy,18,4,14
Holyflux,winterhoof,383,paladin,holy,6,4,2
Sloppybobby,zuljin,383,paladin,holy,6,4,2
Lightbeard,feathermoon,383,paladin,holy,12,4,8
Thulamon,zuljin,383,paladin,holy,12,4,8
Cowladino,tichondrius,383,paladin,holy,12,4,8
Sventyn,frostmourne,383,paladin,holy,12,4,8
Alyosya,barthilas,383,paladin,holy,18,4,14
Anjøs,azralon,383,paladin,holy,18,4,14
Unsungherø,skywall,382,paladin,holy,6,4,2
Imajeala,thrall,382,paladin,holy,6,4,2
Inarit,thrall,382,paladin,holy,18,4,14
Rustacian,area-52,380,paladin,holy,12,4,8
Orleenz,zuljin,379,paladin,holy,12,4,8
Aärøn,stormrage,351,paladin,holy,11,4,7
Gnomeslapper,frostmourne,351,paladin,holy,11,4,7
Tarnak,kelthuzad,336,paladin,holy,15,4,11
Veeve,emerald-dream,304,paladin,holy,7,4,3
Nulric,moon-guard,304,paladin,holy,13,4,9
Nipon,stormrage,288,paladin,holy,6,3,3
Bubblet,bleeding-hollow,288,paladin,holy,6,3,3
Dayatthespa,stormrage,288,paladin,holy,6,3,3
Hughmyron,stormrage,288,paladin,holy,6,3,3
Lachaple,illidan,288,paladin,holy,6,3,3
Vajuicy,dalaran,288,paladin,holy,6,3,3
Madorian,bleeding-hollow,288,paladin,holy,6,3,3
Repgodx,illidan,288,paladin,holy,6,3,3
Botburger,stormrage,288,paladin,holy,6,3,3
Whitekao,illidan,288,paladin,holy,6,3,3
Leronos,zuljin,288,paladin,holy,6,3,3
Loyantal,tichondrius,288,paladin,holy,6,3,3
Hazkal,sargeras,288,paladin,holy,6,3,3
Hálløwéð,firetree,288,paladin,holy,6,3,3
Aduhrawl,moon-guard,288,paladin,holy,6,3,3
Alîcë,wyrmrest-accord,288,paladin,holy,6,3,3
Clare,burning-blade,288,paladin,holy,6,3,3
Zacháry,sargeras,288,paladin,holy,6,3,3
Schwârts,blackrock,288,paladin,holy,6,3,3
Kaleroenin,cenarius,288,paladin,holy,6,3,3
Twodkittyy,kelthuzad,288,paladin,holy,6,3,3
Laythoz,hyjal,288,paladin,holy,6,3,3
Mindfoolness,sargeras,288,paladin,holy,6,3,3
Kharissia,proudmoore,288,paladin,holy,6,3,3
Luxsit,tichondrius,288,paladin,holy,6,3,3
Holzinger,quelthalas,288,paladin,holy,6,3,3
Palqq,tichondrius,288,paladin,holy,6,3,3
Sevenword,tichondrius,288,paladin,holy,6,3,3
Lamas,kelthuzad,288,paladin,holy,6,3,3
Bigtimepali,tichondrius,288,paladin,holy,6,3,3
Scamlikely,tichondrius,288,paladin,holy,6,3,3
Wonpæi,frostmourne,288,paladin,holy,6,3,3
Clehley,turalyon,288,paladin,holy,6,3,3
Blancaflór,ragnaros,288,paladin,holy,6,3,3
Archerxx,ragnaros,288,paladin,holy,6,3,3
Paintthinner,frostmourne,288,paladin,holy,6,3,3
Mileihot,quelthalas,288,paladin,holy,6,3,3
Chrisgrin,malganis,288,paladin,holy,12,3,9
Judgynomnom,the-underbog,288,paladin,holy,12,3,9
Dartherion,shandris,288,paladin,holy,12,3,9
Haldry,wyrmrest-accord,288,paladin,holy,12,3,9
Tig,alleria,288,paladin,holy,12,3,9
Jacobhowda,tichondrius,288,paladin,holy,18,3,15
Alogagain,frostmourne,288,paladin,holy,18,3,15
Hugokpz,quelthalas,288,paladin,holy,18,3,15
Mathalt,area-52,288,paladin,holy,18,3,15
Bullivan,sisters-of-elune,287,paladin,holy,12,3,9
Schnabdain,exodar,285,paladin,holy,18,3,15
Ryuzu,arathor,256,paladin,holy,4,4,0
Antivaxer,frostmourne,255,paladin,holy,11,3,8
Iradruidz,tichondrius,255,paladin,holy,11,3,8
Swordstrikes,tichondrius,239,paladin,holy,5,3,2
Itheternal,dalaran,234,paladin,holy,9,4,5
Jastella,illidan,192,paladin,holy,6,2,4
Regivan,nemesis,192,paladin,holy,6,2,4
Leatherfase,dalaran,192,paladin,holy,6,2,4
Goldirock,quelthalas,192,paladin,holy,6,2,4
Flexxborn,thrall,192,paladin,holy,6,2,4
Antoniano,ragnaros,192,paladin,holy,6,2,4
Alkyna,kelthuzad,192,paladin,holy,6,2,4
Razzypal,sargeras,192,paladin,holy,6,2,4
Borngood,tichondrius,192,paladin,holy,6,2,4
Romaztlan,area-52,192,paladin,holy,6,2,4
Turnipfãrmer,tichondrius,192,paladin,holy,6,2,4
Bakapal,tichondrius,192,paladin,holy,6,2,4
Marleigh,kelthuzad,192,paladin,holy,6,2,4
Mamothman,barthilas,192,paladin,holy,6,2,4
Mangchì,tichondrius,192,paladin,holy,6,2,4
Davinity,senjin,192,paladin,holy,6,2,4
Toonchies,barthilas,192,paladin,holy,6,2,4
Rawpaladin,blackrock,192,paladin,holy,6,2,4
Gilazhar,eldrethalas,192,paladin,holy,6,2,4
Holyshasha,tichondrius,192,paladin,holy,6,2,4
Hitabull,hyjal,192,paladin,holy,6,2,4
Aulty,sargeras,192,paladin,holy,6,2,4
Duallkore,stormrage,192,paladin,holy,6,2,4
Ahsys,tichondrius,192,paladin,holy,6,2,4
Smôres,sargeras,192,paladin,holy,6,2,4
Raiel,aegwynn,192,paladin,holy,6,2,4
Lazydin,tichondrius,192,paladin,holy,6,2,4
Sainttom,sargeras,192,paladin,holy,6,2,4
Raywhite,kelthuzad,192,paladin,holy,6,2,4
Bloodangelz,sargeras,192,paladin,holy,6,2,4
Boiducéu,azralon,192,paladin,holy,6,2,4
Emilywilis,sargeras,192,paladin,holy,6,2,4
Elchupalibre,tichondrius,192,paladin,holy,6,2,4
Lørdthemar,azralon,192,paladin,holy,6,2,4
Ajlol,thrall,192,paladin,holy,6,2,4
Naxzero,shadowsong,192,paladin,holy,8,2,6
Carmiínha,azralon,192,paladin,holy,12,2,10
Jorik,lightbringer,192,paladin,holy,12,2,10
Valandiel,proudmoore,192,paladin,holy,12,2,10
Minouther,area-52,192,paladin,holy,12,2,10
Gavril,kirin-tor,192,paladin,holy,12,2,10
Juuzou,turalyon,192,paladin,holy,12,2,10
Levarious,thunderlord,192,paladin,holy,12,2,10
Cutebtw,zuljin,192,paladin,holy,12,2,10
Shoresy,terokkar,192,paladin,holy,18,2,16
Photons,emerald-dream,191,paladin,holy,6,2,4
Arobelse,sargeras,191,paladin,holy,6,2,4
Prh,frostmourne,191,paladin,holy,6,2,4
Dimior,quelthalas,175,paladin,holy,11,2,9
Shkafell,ragnaros,159,paladin,holy,5,2,3
Ashera,amanthul,159,paladin,holy,8,3,5
Itsoverninek,emerald-dream,159,paladin,holy,17,2,15
Whitedozer,darkspear,138,paladin,holy,10,4,6
Myû,korgath,112,paladin,holy,7,2,5
Therealdeal,sargeras,96,paladin,holy,3,2,1
Arturias,kiljaeden,96,paladin,holy,6,1,5
Khaosactual,proudmoore,96,paladin,holy,6,1,5
Therëv,zuljin,96,paladin,holy,6,1,5
Nikxx,tichondrius,96,paladin,holy,6,1,5
Trixzthot,barthilas,96,paladin,holy,6,1,5
Kamí,elune,96,paladin,holy,6,1,5
Trycider,lightninghoof,96,paladin,holy,6,1,5
Mobitz,dalvengyr,96,paladin,holy,6,1,5
Yikyok,stormrage,96,paladin,holy,6,1,5
Wrekster,tichondrius,96,paladin,holy,6,1,5
Silreck,ragnaros,96,paladin,holy,6,1,5
Jordenz,bonechewer,96,paladin,holy,6,1,5
Palabora,kelthuzad,96,paladin,holy,6,1,5
Evilpallie,illidan,96,paladin,holy,6,1,5
Chakris,wyrmrest-accord,96,paladin,holy,6,1,5
Deadlyassian,ysera,96,paladin,holy,6,1,5
Bigboppapump,lightnings-blade,96,paladin,holy,6,1,5
Purdicks,emerald-dream,96,paladin,holy,6,1,5
Kilion,illidan,96,paladin,holy,6,1,5
Vexe,emerald-dream,96,paladin,holy,6,1,5
Wings,arygos,96,paladin,holy,6,1,5
Trojani,malganis,96,paladin,holy,6,1,5
Ploppers,sargeras,96,paladin,holy,6,1,5
Keltheas,rivendare,96,paladin,holy,6,1,5
Pála,dalaran,96,paladin,holy,6,1,5
Netéro,skywall,96,paladin,holy,6,1,5
Cyphinx,darkspear,96,paladin,holy,6,1,5
Mfpink,thrall,96,paladin,holy,6,1,5
Ripadin,dunemaul,96,paladin,holy,11,1,10
Retholyprot,tichondrius,96,paladin,holy,12,1,11
Zentrick,whisperwind,96,paladin,holy,12,1,11
Ordained,moonrunner,96,paladin,holy,12,1,11
Vanquishyr,stormrage,96,paladin,holy,12,1,11
Milkovir,quelthalas,96,paladin,holy,12,1,11
Midnightboto,dragonmaw,96,paladin,holy,12,1,11
Ååron,thrall,89,paladin,holy,11,3,8
Tmzoeyqt,tichondrius,84,paladin,holy,9,4,5
Athenia,moon-guard,63,paladin,holy,6,3,3
Jkethuhsnake,ghostlands,48,paladin,holy,21,1,20
Alpinestârs,tichondrius,42,paladin,holy,9,2,7
Justinbebr,tichondrius,42,paladin,holy,14,3,11
Oghal,frostmourne,9,paladin,holy,23,3,20
Vanguards,tichondrius,2192,paladin,retribution,78,43,35
Imitlol,alexstrasza,2167,paladin,retribution,107,56,51
Picachü,ragnaros,2104,paladin,retribution,125,63,62
Bullmarket,tichondrius,2104,paladin,retribution,114,57,57
Hollyflame,tichondrius,2101,paladin,retribution,101,53,48
Yuji,darkspear,2073,paladin,retribution,84,42,42
Aldda,azralon,2047,paladin,retribution,80,39,41
Dreamcastx,tichondrius,2040,paladin,retribution,113,57,56
Angryvelic,tichondrius,2019,paladin,retribution,87,41,46
Yccorz,frostmourne,1991,paladin,retribution,71,40,31
Wasteddwolf,tichondrius,1985,paladin,retribution,58,29,29
Maledraenei,sargeras,1970,paladin,retribution,113,54,59
Mashbringer,moon-guard,1958,paladin,retribution,60,33,27
Ämoureux,bleeding-hollow,1939,paladin,retribution,99,45,54
Dratzq,ragnaros,1938,paladin,retribution,90,49,41
Simplybést,zuljin,1937,paladin,retribution,96,45,51
Cønk,khadgar,1920,paladin,retribution,158,95,63
Coolvelic,tichondrius,1909,paladin,retribution,78,35,43
Notvelic,tichondrius,1901,paladin,retribution,63,30,33
Angelguards,tichondrius,1900,paladin,retribution,60,30,30
Caveyodeler,zuluhed,1888,paladin,retribution,42,23,19
Hellsingwolf,zuljin,1885,paladin,retribution,30,20,10
Theblèss,tichondrius,1885,paladin,retribution,49,26,23
Honeydutchtv,black-dragonflight,1884,paladin,retribution,156,72,84
Retroreq,tichondrius,1878,paladin,retribution,101,56,45
Condiments,earthen-ring,1876,paladin,retribution,66,34,32
Alexjones,stormrage,1866,paladin,retribution,78,43,35
Xilio,tichondrius,1865,paladin,retribution,72,36,36
Quitzz,tichondrius,1847,paladin,retribution,63,32,31
Ozzium,ragnaros,1847,paladin,retribution,90,42,48
Zanur,tichondrius,1845,paladin,retribution,77,39,38
Pécorino,malganis,1843,paladin,retribution,46,29,17
Divinehammer,proudmoore,1842,paladin,retribution,60,28,32
Mikhàël,stormscale,1840,paladin,retribution,52,37,15
Hurv,area-52,1839,paladin,retribution,41,25,16
Grifnballs,agamaggan,1839,paladin,retribution,56,31,25
Immobilized,frostmourne,1839,paladin,retribution,58,29,29
Kushsessions,zuljin,1837,paladin,retribution,42,20,22
Alodorx,tichondrius,1836,paladin,retribution,36,23,13
Smortain,tichondrius,1836,paladin,retribution,60,23,37
Kangsang,illidan,1835,paladin,retribution,70,33,37
Leonilx,tichondrius,1832,paladin,retribution,48,21,27
Eldenblade,moon-guard,1829,paladin,retribution,54,31,23
Coldzerox,ragnaros,1829,paladin,retribution,161,82,79
Mürlin,illidan,1829,paladin,retribution,75,38,37
Hammrekt,kelthuzad,1829,paladin,retribution,47,20,27
Xexe,stormreaver,1829,paladin,retribution,78,31,47
Reypally,dalaran,1828,paladin,retribution,66,34,32
Idenline,moon-guard,1827,paladin,retribution,59,30,29
Lundor,ragnaros,1826,paladin,retribution,59,30,29
Wolfs,firetree,1826,paladin,retribution,66,29,37
Metallíka,nemesis,1826,paladin,retribution,71,31,40
Saradomin,kelthuzad,1822,paladin,retribution,129,66,63
Kíngkáísér,azralon,1820,paladin,retribution,29,20,9
Geöspäwn,tichondrius,1819,paladin,retribution,39,20,19
Anbivilent,moon-guard,1819,paladin,retribution,48,23,25
Furgalicious,area-52,1819,paladin,retribution,107,48,59
Xxwitcherxx,stormrage,1818,paladin,retribution,42,25,17
Evanguards,tichondrius,1818,paladin,retribution,69,31,38
Dwimberlike,ragnaros,1816,paladin,retribution,56,37,19
Kíngkáiser,azralon,1815,paladin,retribution,46,27,19
Fuchí,tichondrius,1815,paladin,retribution,143,68,75
Bigdickrick,ragnaros,1814,paladin,retribution,36,23,13
Danceholy,tichondrius,1814,paladin,retribution,57,30,27
Zulmay,malganis,1814,paladin,retribution,156,78,78
Dorktanian,stormrage,1813,paladin,retribution,78,40,38
Rethumtv,tichondrius,1812,paladin,retribution,72,30,42
Arkadiano,drakkari,1812,paladin,retribution,78,29,49
Triston,area-52,1810,paladin,retribution,120,66,54
Downways,sargeras,1807,paladin,retribution,73,39,34
Velstadt,sargeras,1807,paladin,retribution,66,29,37
Pornenjoyer,dalaran,1806,paladin,retribution,30,19,11
Erodan,moon-guard,1806,paladin,retribution,82,35,47
Ohuo,tichondrius,1805,paladin,retribution,107,58,49
Swiftskillz,bleeding-hollow,1804,paladin,retribution,59,42,17
Panncakeman,tichondrius,1804,paladin,retribution,60,33,27
Lumbersnack,moon-guard,1804,paladin,retribution,75,36,39
Luosiding,tichondrius,1804,paladin,retribution,111,45,66
Niubcjq,tichondrius,1803,paladin,retribution,42,19,23
Sâdê,bleeding-hollow,1802,paladin,retribution,36,19,17
Voodoovon,tichondrius,1796,paladin,retribution,47,26,21
Kádabrak,tichondrius,1794,paladin,retribution,48,31,17
Mikeqiaodan,tichondrius,1790,paladin,retribution,79,34,45
Zakladchick,illidan,1778,paladin,retribution,48,26,22
Younghova,kelthuzad,1777,paladin,retribution,54,26,28
Primaryee,tichondrius,1775,paladin,retribution,79,31,48
Voidaz,stormscale,1772,paladin,retribution,48,25,23
Rasler,stormrage,1772,paladin,retribution,72,37,35
Syleith,shadow-council,1768,paladin,retribution,115,54,61
Rahkinishu,khaz-modan,1766,paladin,retribution,189,109,80
Lilcyans,ragnaros,1766,paladin,retribution,48,26,22
Daxxj,akama,1755,paladin,retribution,62,28,34
Indivisionxp,tichondrius,1751,paladin,retribution,40,23,17
Kurôsh,kalecgos,1750,paladin,retribution,48,25,23
Aleríon,ragnaros,1744,paladin,retribution,121,67,54
Rashbringer,azgalor,1742,paladin,retribution,67,34,33
Retxsilver,thrall,1739,paladin,retribution,89,41,48
Malakor,thrall,1736,paladin,retribution,48,25,23
Lokâr,lightbringer,1736,paladin,retribution,48,25,23
Bigdaddysdic,illidan,1736,paladin,retribution,72,36,36
Actionb,aggramar,1735,paladin,retribution,72,37,35
Crayt,tichondrius,1732,paladin,retribution,45,24,21
Konesky,dalaran,1732,paladin,retribution,40,21,19
Dtaitou,tichondrius,1732,paladin,retribution,48,19,29
Darcobs,ragnaros,1729,paladin,retribution,106,54,52
Lanteranth,drenden,1728,paladin,retribution,66,28,38
Trippën,tichondrius,1727,paladin,retribution,79,47,32
Justnikop,tichondrius,1726,paladin,retribution,51,26,25
Riseandgrind,tichondrius,1723,paladin,retribution,36,18,18
Dazn,tichondrius,1723,paladin,retribution,72,24,48
ßò,area-52,1720,paladin,retribution,34,25,9
Teknik,stormscale,1718,paladin,retribution,70,33,37
Notae,icecrown,1717,paladin,retribution,42,21,21
Dampenedxd,bleeding-hollow,1716,paladin,retribution,50,23,27
Beautiful,proudmoore,1715,paladin,retribution,54,26,28
Jvbai,area-52,1714,paladin,retribution,54,26,28
Jonathein,barthilas,1713,paladin,retribution,82,40,42
Radacos,emerald-dream,1712,paladin,retribution,114,60,54
Fylerz,blackhand,1710,paladin,retribution,42,24,18
Svinadin,emerald-dream,1708,paladin,retribution,36,21,15
Bartharious,malganis,1708,paladin,retribution,48,24,24
Soverejgn,bleeding-hollow,1708,paladin,retribution,76,29,47
Kamadonezuko,illidan,1707,paladin,retribution,36,18,18
Buckey,kilrogg,1699,paladin,retribution,52,28,24
Dippedxd,tichondrius,1697,paladin,retribution,45,23,22
Homelanderp,tichondrius,1693,paladin,retribution,51,25,26
Pickleret,emerald-dream,1689,paladin,retribution,66,30,36
Neonblade,illidan,1689,paladin,retribution,54,23,31
Apnea,ragnaros,1689,paladin,retribution,78,32,46
Konsentrate,tichondrius,1687,paladin,retribution,96,50,46
Thoreal,thrall,1686,paladin,retribution,60,30,30
Palimedic,sargeras,1685,paladin,retribution,60,26,34
Palli,moon-guard,1684,paladin,retribution,42,24,18
Animepower,moon-guard,1684,paladin,retribution,78,43,35
Agamemnom,tichondrius,1682,paladin,retribution,40,24,16
Elëssar,ragnaros,1680,paladin,retribution,77,40,37
Hedilyan,azralon,1675,paladin,retribution,54,30,24
Genericuser,sargeras,1674,paladin,retribution,42,20,22
Vip,frostmourne,1671,paladin,retribution,42,21,21
Chriskriego,frostmourne,1671,paladin,retribution,60,24,36
Pumperjer,tichondrius,1669,paladin,retribution,53,26,27
Boarfarmer,tichondrius,1669,paladin,retribution,48,23,25
Techno,tichondrius,1667,paladin,retribution,30,19,11
Backdrop,proudmoore,1665,paladin,retribution,53,27,26
Lleo,nemesis,1663,paladin,retribution,53,22,31
Finaljustice,sargeras,1661,paladin,retribution,30,19,11
Clownfister,barthilas,1661,paladin,retribution,36,21,15
Fussyotter,stormreaver,1661,paladin,retribution,48,27,21
Scrubble,thrall,1660,paladin,retribution,60,28,32
Bakapal,tichondrius,1656,paladin,retribution,36,20,16
Itzcupcake,illidan,1653,paladin,retribution,120,69,51
Lanach,lightbringer,1651,paladin,retribution,64,33,31
Comeuppance,wyrmrest-accord,1649,paladin,retribution,72,38,34
Koketsu,ragnaros,1649,paladin,retribution,49,19,30
Zalndraeda,barthilas,1647,paladin,retribution,66,37,29
Geedee,ysera,1645,paladin,retribution,64,36,28
Beaconlol,proudmoore,1644,paladin,retribution,43,29,14
Beefjustice,velen,1643,paladin,retribution,48,27,21
Serås,silvermoon,1640,paladin,retribution,66,43,23
Forthestreet,tichondrius,1640,paladin,retribution,82,45,37
Dimdabbin,malganis,1637,paladin,retribution,42,22,20
Utherpendrag,bladefist,1637,paladin,retribution,42,18,24
Jud,frostmourne,1636,paladin,retribution,90,43,47
Marehk,thrall,1635,paladin,retribution,53,30,23
Lightowen,draka,1634,paladin,retribution,46,22,24
Mílkywayx,stormrage,1632,paladin,retribution,49,24,25
Hamburgeryu,tichondrius,1632,paladin,retribution,46,21,25
Tagex,malganis,1631,paladin,retribution,66,31,35
Azoruken,quelthalas,1630,paladin,retribution,41,22,19
Loisterly,bladefist,1630,paladin,retribution,74,37,37
Lvladen,sargeras,1629,paladin,retribution,30,17,13
Zèrà,thunderhorn,1629,paladin,retribution,36,17,19
Remethea,sargeras,1626,paladin,retribution,72,35,37
Ironblade,zuljin,1624,paladin,retribution,36,20,16
Gobblerr,blackrock,1622,paladin,retribution,30,20,10
Evangelìne,darkspear,1622,paladin,retribution,30,18,12
Hazexd,illidan,1621,paladin,retribution,36,20,16
Faladrim,moon-guard,1621,paladin,retribution,160,84,76
Kaithen,quelthalas,1620,paladin,retribution,125,61,64
Bbtea,frostmourne,1619,paladin,retribution,48,20,28
Nhsvikings,bleeding-hollow,1617,paladin,retribution,36,21,15
Moolishous,frostmourne,1615,paladin,retribution,65,34,31
Zett,jubeithos,1612,paladin,retribution,41,17,24
Sasorï,stormrage,1612,paladin,retribution,60,24,36
Beeftink,tichondrius,1609,paladin,retribution,100,51,49
Regivan,nemesis,1609,paladin,retribution,54,21,33
Trolladin,rivendare,1607,paladin,retribution,110,51,59
Traceless,emerald-dream,1606,paladin,retribution,63,38,25
Oppressive,moon-guard,1606,paladin,retribution,182,86,96
Parkwons,tichondrius,1606,paladin,retribution,54,20,34
Chrisader,stormrage,1605,paladin,retribution,36,19,17
Stompëd,proudmoore,1605,paladin,retribution,52,23,29
Xeniél,illidan,1604,paladin,retribution,36,19,17
Dïlly,area-52,1604,paladin,retribution,72,36,36
Ítsyôúñötmé,tichondrius,1599,paladin,retribution,50,28,22
Raxadin,stormrage,1599,paladin,retribution,36,19,17
Flykzu,azralon,1596,paladin,retribution,42,21,21
Lyrz,sargeras,1595,paladin,retribution,45,26,19
Happybubbles,tichondrius,1594,paladin,retribution,36,20,16
Layonhánd,ragnaros,1593,paladin,retribution,48,22,26
Dankrachet,thrall,1593,paladin,retribution,48,19,29
Whyta,azralon,1592,paladin,retribution,61,33,28
Nah,emerald-dream,1592,paladin,retribution,38,20,18
Jhasøn,quelthalas,1588,paladin,retribution,30,21,9
Pantufä,stormrage,1588,paladin,retribution,35,17,18
Fionno,quelthalas,1587,paladin,retribution,74,38,36
Crybátt,quelthalas,1586,paladin,retribution,36,20,16
Usdacertifed,lightnings-blade,1584,paladin,retribution,36,19,17
Practícal,moon-guard,1584,paladin,retribution,36,17,19
Allîe,malganis,1583,paladin,retribution,60,30,30
Taphos,icecrown,1581,paladin,retribution,53,30,23
Chancellor,azralon,1580,paladin,retribution,120,68,52
Telarøn,stormrage,1578,paladin,retribution,147,73,74
Getdiswork,malygos,1577,paladin,retribution,51,24,27
Ibullyourmom,tichondrius,1576,paladin,retribution,41,18,23
Gelosagrado,illidan,1576,paladin,retribution,41,17,24
Víkk,zuljin,1573,paladin,retribution,96,40,56
Stackmymoney,kelthuzad,1572,paladin,retribution,50,22,28
Alpinestârs,tichondrius,1572,paladin,retribution,44,18,26
Rahmie,kiljaeden,1571,paladin,retribution,66,24,42
Ðoflamingo,area-52,1570,paladin,retribution,48,27,21
Quinnzel,barthilas,1570,paladin,retribution,38,20,18
Castïël,area-52,1570,paladin,retribution,121,61,60
Skylinator,bleeding-hollow,1568,paladin,retribution,53,23,30
Coffeepal,tichondrius,1567,paladin,retribution,48,23,25
Zeldoul,magtheridon,1564,paladin,retribution,48,18,30
Toughxguy,sargeras,1563,paladin,retribution,44,18,26
Paladinomg,darkspear,1561,paladin,retribution,91,51,40
Trixtur,tichondrius,1560,paladin,retribution,36,17,19
Rohrn,firetree,1557,paladin,retribution,37,25,12
Vêgenace,proudmoore,1556,paladin,retribution,48,24,24
Missusomutch,azralon,1556,paladin,retribution,50,17,33
Lightlana,frostwolf,1555,paladin,retribution,36,17,19
ßountystrike,sargeras,1554,paladin,retribution,48,18,30
Shaidd,bleeding-hollow,1553,paladin,retribution,62,32,30
Luminiscente,ragnaros,1553,paladin,retribution,58,29,29
Alexieus,wyrmrest-accord,1553,paladin,retribution,71,32,39
Titannious,stormrage,1553,paladin,retribution,71,29,42
Litler,tichondrius,1552,paladin,retribution,32,21,11
Reìarthur,stormrage,1552,paladin,retribution,48,25,23
Holyjoint,uther,1550,paladin,retribution,68,27,41
Matthrian,moon-guard,1550,paladin,retribution,48,17,31
Unfairness,skullcrusher,1549,paladin,retribution,54,29,25
Forlam,sargeras,1542,paladin,retribution,90,38,52
Parlore,moon-guard,1542,paladin,retribution,60,24,36
Thaldun,wyrmrest-accord,1541,paladin,retribution,95,41,54
Fuknshané,area-52,1540,paladin,retribution,58,26,32
Ascetic,barthilas,1540,paladin,retribution,72,23,49
Frùglé,sargeras,1538,paladin,retribution,36,20,16
Beshiki,hakkar,1538,paladin,retribution,204,100,104
Folgimar,moon-guard,1537,paladin,retribution,42,25,17
Andrilsteh,malganis,1535,paladin,retribution,60,23,37
Xuantianchai,tichondrius,1534,paladin,retribution,18,16,2
Tramatic,sargeras,1534,paladin,retribution,36,16,20
Mortaine,moon-guard,1530,paladin,retribution,30,16,14
Dashhighborn,sargeras,1527,paladin,retribution,42,20,22
Ashkandi,tichondrius,1526,paladin,retribution,24,16,8
Raelan,icecrown,1525,paladin,retribution,53,37,16
Borrus,malygos,1525,paladin,retribution,30,17,13
Grîshnâkh,ragnaros,1525,paladin,retribution,83,44,39
Gokuu,korgath,1524,paladin,retribution,38,20,18
Istril,ragnaros,1523,paladin,retribution,85,47,38
Holywaffle,nemesis,1521,paladin,retribution,24,16,8
Dorex,moon-guard,1521,paladin,retribution,57,35,22
Filthyape,wyrmrest-accord,1520,paladin,retribution,24,17,7
Jager,medivh,1519,paladin,retribution,41,26,15
Stônemôuntan,moon-guard,1518,paladin,retribution,42,16,26
Brightstar,azjolnerub,1516,paladin,retribution,42,20,22
Jdgmnt,sargeras,1515,paladin,retribution,54,28,26
Rycerzforge,ragnaros,1515,paladin,retribution,38,18,20
Kooi,illidan,1514,paladin,retribution,48,16,32
Haunter,akama,1513,paladin,retribution,48,23,25
Mysticblade,sargeras,1508,paladin,retribution,54,31,23
Glørious,drakkari,1508,paladin,retribution,60,23,37
Dreyan,wyrmrest-accord,1507,paladin,retribution,36,19,17
Sukilol,tichondrius,1506,paladin,retribution,42,16,26
Quadrifoglio,moon-guard,1505,paladin,retribution,48,24,24
Sneeber,stormrage,1505,paladin,retribution,48,21,27
Elegan,frostmourne,1504,paladin,retribution,36,16,20
Alanthor,ragnaros,1503,paladin,retribution,108,48,60
Sovereignt,aggramar,1502,paladin,retribution,97,55,42
Xk,kiljaeden,1502,paladin,retribution,30,16,14
Lecheroø,tichondrius,1502,paladin,retribution,30,16,14
Kozk,quelthalas,1498,paladin,retribution,58,38,20
Lucianz,ragnaros,1497,paladin,retribution,36,16,20
Ástridr,moon-guard,1495,paladin,retribution,77,33,44
Preacherfudd,area-52,1493,paladin,retribution,30,16,14
Schwârts,blackrock,1492,paladin,retribution,46,24,22
Ezcoatl,stormrage,1492,paladin,retribution,62,30,32
Týrael,uldum,1491,paladin,retribution,36,21,15
Sololeveling,malganis,1484,paladin,retribution,50,20,30
Onitenshi,stormscale,1482,paladin,retribution,36,18,18
Kellissandra,aerie-peak,1482,paladin,retribution,42,18,24
Lolslikeomg,malganis,1482,paladin,retribution,54,21,33
Cloaxy,azgalor,1480,paladin,retribution,60,23,37
Mcholy,thrall,1479,paladin,retribution,38,20,18
Janokaluo,wyrmrest-accord,1479,paladin,retribution,72,37,35
Valardaharis,thunderlord,1479,paladin,retribution,46,18,28
Arecht,moon-guard,1474,paladin,retribution,30,19,11
Zuthora,alleria,1471,paladin,retribution,52,28,24
Kenpachí,doomhammer,1468,paladin,retribution,30,22,8
Bilbain,proudmoore,1467,paladin,retribution,101,52,49
Ópsv,quelthalas,1466,paladin,retribution,59,32,27
Joltie,quelthalas,1465,paladin,retribution,65,37,28
Deepsearide,illidan,1464,paladin,retribution,36,18,18
Belgrieve,proudmoore,1461,paladin,retribution,30,17,13
Snussp,emerald-dream,1461,paladin,retribution,69,32,37
Lmd,tichondrius,1460,paladin,retribution,42,24,18
Dentarg,garrosh,1456,paladin,retribution,54,29,25
Benoít,zuljin,1456,paladin,retribution,48,24,24
Monchy,bleeding-hollow,1453,paladin,retribution,52,27,25
Audris,chogall,1453,paladin,retribution,48,19,29
Liaadrin,azralon,1450,paladin,retribution,32,16,16
Airplane,malygos,1449,paladin,retribution,24,16,8
Tmac,azralon,1449,paladin,retribution,62,34,28
Sammyste,elune,1446,paladin,retribution,56,29,27
Aoishie,bleeding-hollow,1444,paladin,retribution,90,42,48
Iluminadoor,nemesis,1442,paladin,retribution,29,19,10
Bañe,lightbringer,1442,paladin,retribution,54,21,33
Ddeadwhisper,executus,1440,paladin,retribution,68,41,27
Samgonz,tichondrius,1439,paladin,retribution,30,16,14
Kkgame,tichondrius,1439,paladin,retribution,37,19,18
Getmeabag,tichondrius,1439,paladin,retribution,30,15,15
Watchamebaba,malganis,1438,paladin,retribution,36,15,21
Lilglick,illidan,1436,paladin,retribution,24,15,9
Tyrillian,aerie-peak,1435,paladin,retribution,36,15,21
Gimli,mannoroth,1434,paladin,retribution,36,15,21
Antlkd,quelthalas,1433,paladin,retribution,30,15,15
Holydiver,sargeras,1433,paladin,retribution,60,23,37
Jowliet,stormrage,1432,paladin,retribution,30,15,15
Roushex,sargeras,1432,paladin,retribution,36,15,21
Cyrenity,tichondrius,1431,paladin,retribution,48,15,33
Sprinkills,frostmourne,1430,paladin,retribution,25,18,7
Zarrakra,daggerspine,1428,paladin,retribution,34,17,17
Sunwrath,quelthalas,1425,paladin,retribution,42,19,23
Powermonster,tichondrius,1425,paladin,retribution,36,15,21
Thastrian,stormreaver,1424,paladin,retribution,24,15,9
Bigjiba,proudmoore,1421,paladin,retribution,30,15,15
Arahann,bleeding-hollow,1420,paladin,retribution,29,16,13
Beardy,emerald-dream,1419,paladin,retribution,36,17,19
Vasharien,nerzhul,1418,paladin,retribution,24,15,9
Annhette,sargeras,1418,paladin,retribution,31,15,16
Droden,tichondrius,1417,paladin,retribution,49,27,22
Landeren,khazgoroth,1417,paladin,retribution,36,15,21
Savagedemise,barthilas,1413,paladin,retribution,55,28,27
Tuuro,stormrage,1413,paladin,retribution,42,15,27
Lumíty,sargeras,1412,paladin,retribution,65,33,32
Justicierø,aegwynn,1412,paladin,retribution,36,18,18
Renckay,ragnaros,1412,paladin,retribution,30,15,15
Kevybevy,stormrage,1410,paladin,retribution,115,57,58
Vaqoh,ragnaros,1409,paladin,retribution,36,15,21
Kulandis,stormrage,1408,paladin,retribution,57,24,33
Dazedpal,tichondrius,1406,paladin,retribution,99,50,49
Wasembroder,ragnaros,1406,paladin,retribution,53,25,28
Forged,steamwheedle-cartel,1405,paladin,retribution,54,22,32
Thalorian,azshara,1404,paladin,retribution,45,20,25
Swietomierz,proudmoore,1403,paladin,retribution,48,20,28
Tacien,tichondrius,1402,paladin,retribution,47,19,28
Anivan,moon-guard,1397,paladin,retribution,30,15,15
Belregn,illidan,1393,paladin,retribution,78,36,42
Slowedreverb,stormrage,1387,paladin,retribution,81,42,39
Naverpay,tichondrius,1385,paladin,retribution,29,15,14
Hdmi,darkspear,1382,paladin,retribution,35,17,18
Levian,spirestone,1380,paladin,retribution,66,31,35
Theretpally,kelthuzad,1378,paladin,retribution,36,16,20
Elsinore,senjin,1377,paladin,retribution,35,19,16
Álkair,ragnaros,1376,paladin,retribution,35,15,20
Talantyr,zuljin,1375,paladin,retribution,48,19,29
Melize,area-52,1374,paladin,retribution,57,28,29
Stdee,zuljin,1372,paladin,retribution,57,30,27
Falaran,azralon,1368,paladin,retribution,44,21,23
Christman,illidan,1367,paladin,retribution,42,17,25
Bebopin,tichondrius,1365,paladin,retribution,34,16,18
Hazmât,illidan,1365,paladin,retribution,76,31,45
Perzeføne,quelthalas,1364,paladin,retribution,30,15,15
Richiggaa,illidan,1363,paladin,retribution,36,21,15
Hamertime,wyrmrest-accord,1363,paladin,retribution,48,20,28
Alvick,icecrown,1363,paladin,retribution,39,16,23
Zadquel,ragnaros,1362,paladin,retribution,33,16,17
Brightsaber,tichondrius,1357,paladin,retribution,51,29,22
Dfbattlepass,kelthuzad,1357,paladin,retribution,61,32,29
Wickedwingz,sargeras,1356,paladin,retribution,30,15,15
Urfavxbf,baelgun,1353,paladin,retribution,80,43,37
Øxøxø,emerald-dream,1347,paladin,retribution,72,38,34
Dwurim,moon-guard,1346,paladin,retribution,42,23,19
Avantasias,sargeras,1345,paladin,retribution,34,17,17
Kumdonia,illidan,1343,paladin,retribution,30,14,16
Cardynivans,tichondrius,1343,paladin,retribution,36,14,22
Messeb,veknilash,1342,paladin,retribution,47,27,20
Conndiment,earthen-ring,1342,paladin,retribution,30,14,16
Sweetfish,kiljaeden,1341,paladin,retribution,24,14,10
Lazypally,frostmourne,1341,paladin,retribution,30,14,16
Retsonictwo,tichondrius,1340,paladin,retribution,30,14,16
Wesdarian,jaedenar,1338,paladin,retribution,42,15,27
Dimmadome,frostmourne,1331,paladin,retribution,36,24,12
Heraolympian,black-dragonflight,1331,paladin,retribution,24,15,9
Trogdorpwn,bonechewer,1331,paladin,retribution,30,17,13
Malorian,azgalor,1331,paladin,retribution,36,16,20
Seraphini,illidan,1329,paladin,retribution,30,14,16
Amanzhul,quelthalas,1329,paladin,retribution,36,14,22
Sländers,sargeras,1322,paladin,retribution,36,15,21
Purejudgemnt,area-52,1320,paladin,retribution,24,14,10
Sventyn,frostmourne,1320,paladin,retribution,41,14,27
Morneau,malganis,1317,paladin,retribution,86,39,47
Critxx,tichondrius,1316,paladin,retribution,47,21,26
Formergf,crushridge,1311,paladin,retribution,48,24,24
Freiermoth,shadowmoon,1311,paladin,retribution,62,27,35
Oldicktwist,garrosh,1307,paladin,retribution,36,19,17
Solanin,frostmourne,1307,paladin,retribution,29,14,15
Retrah,azralon,1306,paladin,retribution,24,14,10
Shecara,malygos,1305,paladin,retribution,42,23,19
Yawnbringer,tichondrius,1305,paladin,retribution,48,19,29
Xbloodknight,malganis,1300,paladin,retribution,26,15,11
Atrayeus,dawnbringer,1300,paladin,retribution,48,21,27
Krawmwell,lothar,1298,paladin,retribution,48,31,17
Carnagias,bleeding-hollow,1297,paladin,retribution,30,14,16
Vtyr,nemesis,1297,paladin,retribution,51,23,28
Hwanko,tichondrius,1291,paladin,retribution,22,16,6
Galaxahan,bonechewer,1289,paladin,retribution,58,28,30
Vêndar,ragnaros,1289,paladin,retribution,78,33,45
Hùck,alexstrasza,1288,paladin,retribution,84,36,48
Fabolouss,tichondrius,1287,paladin,retribution,42,22,20
Tutankhammer,stormrage,1286,paladin,retribution,58,28,30
Cyreus,emerald-dream,1278,paladin,retribution,33,14,19
Mikehawkhuge,area-52,1276,paladin,retribution,42,22,20
Hinataa,illidan,1273,paladin,retribution,45,24,21
Webothhateme,tichondrius,1272,paladin,retribution,30,17,13
Khorgus,gundrak,1271,paladin,retribution,48,24,24
Jursch,emerald-dream,1268,paladin,retribution,48,18,30
Nqe,area-52,1264,paladin,retribution,26,14,12
Ajoladin,illidan,1262,paladin,retribution,42,16,26
Canadianeh,malganis,1260,paladin,retribution,66,28,38
Heindallr,nemesis,1259,paladin,retribution,30,15,15
Toyotasupra,azgalor,1258,paladin,retribution,36,21,15
Aztraseneco,ragnaros,1256,paladin,retribution,38,19,19
Aretwin,dalaran,1255,paladin,retribution,30,14,16
Balster,moon-guard,1254,paladin,retribution,43,18,25
Haiden,goldrinn,1254,paladin,retribution,43,14,29
Zanthus,shadow-council,1248,paladin,retribution,24,13,11
Szeq,tichondrius,1248,paladin,retribution,24,13,11
Kíbá,malganis,1247,paladin,retribution,27,14,13
Beyönd,quelthalas,1246,paladin,retribution,30,13,17
Yuccalicious,area-52,1246,paladin,retribution,35,15,20
Tribiani,lightbringer,1244,paladin,retribution,18,13,5
Moød,ragnaros,1244,paladin,retribution,27,14,13
Viclovin,stormrage,1243,paladin,retribution,28,14,14
Deployed,kaelthas,1243,paladin,retribution,36,13,23
Çestlavie,korgath,1242,paladin,retribution,24,13,11
Bebitufiufiu,illidan,1242,paladin,retribution,24,13,11
Happywow,tichondrius,1242,paladin,retribution,41,19,22
Napstër,ragnaros,1242,paladin,retribution,30,13,17
Såssy,moon-guard,1240,paladin,retribution,48,18,30
Saintpower,stormscale,1239,paladin,retribution,24,13,11
Deftonia,stormrage,1238,paladin,retribution,65,31,34
Albïreo,drakkari,1237,paladin,retribution,24,13,11
Pristinne,darkspear,1237,paladin,retribution,82,34,48
Sconey,andorhal,1237,paladin,retribution,34,14,20
Streetsaint,frostmourne,1236,paladin,retribution,36,21,15
Dalgren,quelthalas,1236,paladin,retribution,45,14,31
Hammerzite,whisperwind,1234,paladin,retribution,24,13,11
Lustros,stormrage,1234,paladin,retribution,30,13,17
Skanknflex,tichondrius,1233,paladin,retribution,24,13,11
Shiadfang,tichondrius,1231,paladin,retribution,30,13,17
Nicret,tichondrius,1230,paladin,retribution,18,13,5
Saucepally,laughing-skull,1229,paladin,retribution,36,18,18
Solandiis,tichondrius,1229,paladin,retribution,30,13,17
Legible,tichondrius,1228,paladin,retribution,28,15,13
Drágons,stormrage,1228,paladin,retribution,42,19,23
Mathalt,area-52,1222,paladin,retribution,25,14,11
Bigdoosa,frostmourne,1221,paladin,retribution,24,13,11
Füriøsa,quelthalas,1221,paladin,retribution,59,29,30
Balrok,cenarius,1218,paladin,retribution,106,47,59
Redeviliu,tichondrius,1217,paladin,retribution,41,15,26
Paladingirl,darkspear,1214,paladin,retribution,74,38,36
Kalgormoth,ragnaros,1213,paladin,retribution,29,13,16
Brsjak,frostmourne,1212,paladin,retribution,41,18,23
Longinus,eredar,1206,paladin,retribution,24,13,11
Rediems,drakkari,1203,paladin,retribution,42,21,21
Stõnêdpimp,agamaggan,1201,paladin,retribution,29,13,16
Finishearlyx,kelthuzad,1198,paladin,retribution,35,13,22
Ulessys,bleeding-hollow,1194,paladin,retribution,36,17,19
Peledin,azralon,1190,paladin,retribution,34,16,18
Zadragon,sargeras,1189,paladin,retribution,36,13,23
Punative,darkspear,1184,paladin,retribution,42,13,29
Hokkan,quelthalas,1176,paladin,retribution,17,13,4
Schnabdain,exodar,1171,paladin,retribution,66,36,30
Linias,quelthalas,1169,paladin,retribution,21,14,7
Elbigboy,tichondrius,1168,paladin,retribution,65,34,31
Soopadupa,trollbane,1164,paladin,retribution,68,36,32
Grimhammer,the-scryers,1160,paladin,retribution,44,25,19
Mechelle,thrall,1157,paladin,retribution,42,19,23
Amarith,queldorei,1157,paladin,retribution,52,17,35
Hammrekt,sargeras,1152,paladin,retribution,18,12,6
Vânguârds,tichondrius,1152,paladin,retribution,24,12,12
Venxpeita,azralon,1151,paladin,retribution,18,12,6
Cöjax,dalaran,1151,paladin,retribution,18,12,6
Yorøchi,azralon,1151,paladin,retribution,24,12,12
Popje,zuljin,1151,paladin,retribution,24,12,12
Lukeington,malganis,1151,paladin,retribution,24,12,12
Dragynfist,malganis,1151,paladin,retribution,30,12,18
Galeast,tichondrius,1151,paladin,retribution,30,12,18
Xandia,aegwynn,1151,paladin,retribution,36,12,24
Bravepala,tichondrius,1151,paladin,retribution,36,12,24
Luzoscura,quelthalas,1150,paladin,retribution,18,12,6
Britanybich,area-52,1150,paladin,retribution,24,12,12
Jaikerino,emerald-dream,1150,paladin,retribution,30,12,18
Hurrîcane,illidan,1150,paladin,retribution,30,12,18
Bigolcriddys,barthilas,1149,paladin,retribution,18,12,6
Retosterone,stormrage,1149,paladin,retribution,30,12,18
Brokeniron,wyrmrest-accord,1148,paladin,retribution,24,12,12
Accépting,sargeras,1148,paladin,retribution,24,12,12
Bigdpally,frostmourne,1148,paladin,retribution,36,12,24
Siaaryn,darkspear,1147,paladin,retribution,18,12,6
Nasnyl,stormrage,1147,paladin,retribution,30,12,18
Rhegyna,quelthalas,1146,paladin,retribution,24,12,12
Xdiegox,stormrage,1145,paladin,retribution,30,12,18
Zimzob,stormscale,1144,paladin,retribution,24,12,12
Thoti,tichondrius,1143,paladin,retribution,25,12,13
Faowin,sargeras,1143,paladin,retribution,30,12,18
Stormwinter,azralon,1143,paladin,retribution,36,12,24
Mitchyc,stormrage,1142,paladin,retribution,24,12,12
Wésters,quelthalas,1142,paladin,retribution,36,12,24
Ginbirdup,kelthuzad,1141,paladin,retribution,18,12,6
Follower,sargeras,1141,paladin,retribution,37,14,23
Armstrongz,bleeding-hollow,1140,paladin,retribution,30,12,18
Beastyone,tichondrius,1139,paladin,retribution,64,34,30
Scudstock,tichondrius,1138,paladin,retribution,36,16,20
Áthz,ragnaros,1131,paladin,retribution,28,13,15
Arun,arthas,1128,paladin,retribution,33,15,18
Aellâ,bloodscalp,1125,paladin,retribution,62,31,31
Damorte,ragnaros,1125,paladin,retribution,30,15,15
Melloow,azralon,1125,paladin,retribution,33,13,20
Aowynd,tichondrius,1119,paladin,retribution,49,26,23
Zaklehblue,daggerspine,1118,paladin,retribution,60,24,36
Deathwyz,thunderlord,1116,paladin,retribution,36,14,22
Davinshki,stormrage,1115,paladin,retribution,20,13,7
Kadbury,icecrown,1115,paladin,retribution,40,12,28
Palpingon,kelthuzad,1110,paladin,retribution,32,13,19
Vanillur,tichondrius,1109,paladin,retribution,38,16,22
Willhookah,azralon,1106,paladin,retribution,18,12,6
Greatgirthy,hyjal,1106,paladin,retribution,30,13,17
Sandicang,azuremyst,1105,paladin,retribution,30,15,15
Noskill,moonrunner,1101,paladin,retribution,18,12,6
Soana,alexstrasza,1094,paladin,retribution,30,18,12
Joelanson,blood-furnace,1092,paladin,retribution,30,16,14
Omenix,laughing-skull,1091,paladin,retribution,29,12,17
Billnighy,alleria,1089,paladin,retribution,30,14,16
Mcbraín,quelthalas,1089,paladin,retribution,30,12,18
Ôdenswrath,stormscale,1083,paladin,retribution,30,13,17
Salvations,queldorei,1082,paladin,retribution,24,13,11
Jinfandi,gurubashi,1079,paladin,retribution,30,12,18
Bubblegums,nagrand,1072,paladin,retribution,42,25,17
Clefairy,arathor,1067,paladin,retribution,33,19,14
Alairius,tichondrius,1059,paladin,retribution,17,13,4
Andras,emerald-dream,1059,paladin,retribution,22,12,10
Zozo,zuljin,1056,paladin,retribution,18,11,7
Pambeazley,bronzebeard,1056,paladin,retribution,24,11,13
Shiryn,illidan,1056,paladin,retribution,24,11,13
Hefaista,ragnaros,1056,paladin,retribution,30,11,19
Siq,arthas,1056,paladin,retribution,30,11,19
Whosyadaddy,tichondrius,1055,paladin,retribution,24,11,13
Souyiro,sargeras,1055,paladin,retribution,24,11,13
Eneraxx,proudmoore,1055,paladin,retribution,24,11,13
Djdiogø,azralon,1055,paladin,retribution,27,12,15
Áldin,ragnaros,1054,paladin,retribution,20,12,8
Minitas,blackrock,1054,paladin,retribution,24,11,13
Pallyzo,zuljin,1054,paladin,retribution,24,11,13
Palban,tichondrius,1053,paladin,retribution,24,11,13
Cripplemakër,stormrage,1052,paladin,retribution,18,11,7
Brolando,hyjal,1052,paladin,retribution,24,11,13
Rimjobrachel,barthilas,1052,paladin,retribution,24,11,13
Albion,sargeras,1052,paladin,retribution,24,11,13
Angrytitan,tichondrius,1052,paladin,retribution,30,11,19
Iesous,kiljaeden,1051,paladin,retribution,18,11,7
Athenauwu,illidan,1051,paladin,retribution,24,11,13
Libertylol,tichondrius,1051,paladin,retribution,28,12,16
Ranthoril,hydraxis,1050,paladin,retribution,12,11,1
Sanctum,barthilas,1050,paladin,retribution,117,57,60
Kaélthas,eonar,1050,paladin,retribution,24,11,13
Ødin,turalyon,1049,paladin,retribution,18,11,7
Mangguo,tichondrius,1049,paladin,retribution,24,11,13
Lïgma,dalaran,1048,paladin,retribution,18,11,7
Yamush,silver-hand,1048,paladin,retribution,24,11,13
Mfgspally,kelthuzad,1048,paladin,retribution,24,11,13
Solomonss,frostmourne,1048,paladin,retribution,24,11,13
Theldart,ragnaros,1046,paladin,retribution,24,11,13
Simplesam,draenor,1046,paladin,retribution,30,11,19
Statícx,ragnaros,1045,paladin,retribution,25,12,13
Dedsxy,tichondrius,1045,paladin,retribution,24,11,13
Lostkanvas,azralon,1043,paladin,retribution,18,11,7
Chinsta,zuljin,1040,paladin,retribution,18,11,7
Tyrswrath,sargeras,1040,paladin,retribution,30,18,12
Gramaton,malfurion,1034,paladin,retribution,30,11,19
Thanatiel,area-52,1033,paladin,retribution,27,15,12
Mortika,frostmourne,1033,paladin,retribution,30,14,16
Arnblass,magtheridon,1030,paladin,retribution,39,12,27
Fortueni,illidan,1029,paladin,retribution,36,22,14
Kittylickers,tichondrius,1026,paladin,retribution,30,15,15
Adrockiller,quelthalas,1016,paladin,retribution,20,12,8
Missoutale,aerie-peak,1013,paladin,retribution,64,24,40
Wasimodo,emerald-dream,1002,paladin,retribution,30,13,17
Bubblemark,tichondrius,999,paladin,retribution,38,14,24
Tharkeves,cenarius,987,paladin,retribution,22,11,11
Exulta,illidan,977,paladin,retribution,30,15,15
Hammerhitter,lightbringer,972,paladin,retribution,36,14,22
Uglymugz,area-52,961,paladin,retribution,25,11,14
Alyena,area-52,960,paladin,retribution,18,10,8
Burnning,tichondrius,960,paladin,retribution,18,10,8
Kmackk,tichondrius,960,paladin,retribution,18,10,8
Meleegodx,darkspear,960,paladin,retribution,18,10,8
Zeyrox,stormrage,960,paladin,retribution,18,10,8
Golden,tichondrius,960,paladin,retribution,24,10,14
Komonai,illidan,960,paladin,retribution,24,10,14
Iäl,tichondrius,960,paladin,retribution,24,10,14
Caperx,tichondrius,960,paladin,retribution,24,10,14
Stöneblood,moon-guard,960,paladin,retribution,24,10,14
Galeatus,tichondrius,960,paladin,retribution,30,10,20
Darguen,ragnaros,959,paladin,retribution,16,11,5
Daeyang,tichondrius,959,paladin,retribution,18,10,8
Doktavius,lightbringer,959,paladin,retribution,18,10,8
Ibustcheeks,sargeras,959,paladin,retribution,18,10,8
Purdicks,emerald-dream,959,paladin,retribution,18,10,8
Déathkiing,area-52,959,paladin,retribution,24,10,14
Arquidea,tichondrius,959,paladin,retribution,24,10,14
Yiqieyouwei,proudmoore,959,paladin,retribution,24,10,14
Anafensa,malganis,959,paladin,retribution,24,10,14
Lucy,sargeras,959,paladin,retribution,30,10,20
Thepinkdept,proudmoore,958,paladin,retribution,18,10,8
Notneo,zuljin,958,paladin,retribution,18,10,8
Holybirkkal,arthas,958,paladin,retribution,18,10,8
Nuggetpusher,thunderlord,958,paladin,retribution,21,10,11
Verdicts,moon-guard,958,paladin,retribution,30,10,20
Grünt,ragnaros,957,paladin,retribution,18,10,8
Pockopea,arygos,957,paladin,retribution,18,10,8
Mazaltoff,proudmoore,957,paladin,retribution,30,10,20
Vulkaros,azralon,956,paladin,retribution,12,10,2
Solgrïm,wyrmrest-accord,956,paladin,retribution,18,10,8
Rusinator,bonechewer,956,paladin,retribution,18,10,8
Kiritazuma,ravencrest,956,paladin,retribution,30,10,20
Bulioevn,emerald-dream,955,paladin,retribution,18,10,8
Vanthor,emerald-dream,955,paladin,retribution,18,10,8
Vejita,frostmourne,955,paladin,retribution,18,10,8
Cacaine,goldrinn,954,paladin,retribution,21,11,10
Sòl,stormrage,954,paladin,retribution,24,10,14
Hiikari,silver-hand,953,paladin,retribution,18,10,8
Giltronix,thrall,952,paladin,retribution,18,10,8
Exeneyder,elune,952,paladin,retribution,25,10,15
Belena,jaedenar,951,paladin,retribution,24,10,14
Ðetroity,stormrage,950,paladin,retribution,18,10,8
Bigjwpb,illidan,949,paladin,retribution,78,34,44
Crosshammer,quelthalas,946,paladin,retribution,18,10,8
Zephyrvalor,sargeras,943,paladin,retribution,18,10,8
Kènjii,sargeras,938,paladin,retribution,28,13,15
Atreuss,moon-guard,929,paladin,retribution,18,10,8
Nerfret,zuljin,926,paladin,retribution,14,11,3
Holyroro,area-52,926,paladin,retribution,20,11,9
Superzooted,sargeras,925,paladin,retribution,22,10,12
Drtom,mannoroth,908,paladin,retribution,21,10,11
Lilsquirt,proudmoore,901,paladin,retribution,23,14,9
Goldranger,hakkar,896,paladin,retribution,30,15,15
Luret,tichondrius,896,paladin,retribution,22,10,12
Zir,frostmourne,896,paladin,retribution,23,10,13
Toguro,kelthuzad,894,paladin,retribution,22,10,12
Dralkou,kaelthas,893,paladin,retribution,28,10,18
Cuthroat,area-52,890,paladin,retribution,66,29,37
Tobaz,azralon,890,paladin,retribution,28,10,18
Keu,emerald-dream,889,paladin,retribution,33,11,22
Reti,ursin,883,paladin,retribution,53,25,28
Profundity,area-52,873,paladin,retribution,24,11,13
Wölfheärt,tichondrius,864,paladin,retribution,12,9,3
Kaetix,frostmourne,864,paladin,retribution,12,9,3
Chrigpal,tichondrius,864,paladin,retribution,12,9,3
Traize,kelthuzad,864,paladin,retribution,12,9,3
Christtel,stormrage,864,paladin,retribution,12,9,3
Josxth,stormrage,864,paladin,retribution,18,9,9
Héber,nemesis,864,paladin,retribution,18,9,9
Popwings,azralon,864,paladin,retribution,18,9,9
Émiluss,stormrage,864,paladin,retribution,18,9,9
Alicê,moon-guard,864,paladin,retribution,18,9,9
Semellem,bloodhoof,864,paladin,retribution,18,9,9
Huuzhaa,tichondrius,864,paladin,retribution,18,9,9
Notoriouus,bleeding-hollow,864,paladin,retribution,18,9,9
Venguards,azralon,864,paladin,retribution,18,9,9
Shôtgun,tichondrius,864,paladin,retribution,18,9,9
Beefdaddyx,tichondrius,864,paladin,retribution,18,9,9
Brohtato,area-52,864,paladin,retribution,18,9,9
Wogyu,area-52,864,paladin,retribution,18,9,9
Kishou,stormrage,864,paladin,retribution,21,10,11
Wde,zuljin,864,paladin,retribution,25,10,15
Iqt,moon-guard,864,paladin,retribution,24,9,15
Apollidin,malganis,864,paladin,retribution,24,9,15
Pistis,kelthuzad,864,paladin,retribution,24,9,15
Traevel,moon-guard,864,paladin,retribution,24,9,15
Joeyrat,area-52,864,paladin,retribution,24,9,15
Gabbynator,emerald-dream,864,paladin,retribution,24,9,15
Asukaba,sargeras,864,paladin,retribution,27,10,17
Rukkas,sargeras,864,paladin,retribution,30,9,21
Nitemareforu,stormreaver,863,paladin,retribution,12,9,3
Theseusz,tichondrius,863,paladin,retribution,12,9,3
Merculios,stormrage,863,paladin,retribution,12,9,3
Inquisídor,nemesis,863,paladin,retribution,12,9,3
Greasysteve,stormrage,863,paladin,retribution,12,9,3
Teewrecks,frostmourne,863,paladin,retribution,18,9,9
Paliwarrior,illidan,863,paladin,retribution,18,9,9
Røshea,hydraxis,863,paladin,retribution,18,9,9
Loraven,wyrmrest-accord,863,paladin,retribution,18,9,9
Pàladwarf,stormrage,863,paladin,retribution,18,9,9
Todesgott,tichondrius,863,paladin,retribution,18,9,9
Garlond,moon-guard,863,paladin,retribution,18,9,9
Fótm,bleeding-hollow,863,paladin,retribution,18,9,9
Angriel,azralon,863,paladin,retribution,18,9,9
Waffletrain,tichondrius,863,paladin,retribution,22,10,12
Orivia,spirestone,863,paladin,retribution,24,9,15
Atterz,azralon,863,paladin,retribution,24,9,15
Rivzx,tichondrius,863,paladin,retribution,24,9,15
Snoogans,korgath,863,paladin,retribution,24,9,15
Oathen,proudmoore,863,paladin,retribution,26,9,17
Zerohöur,emerald-dream,863,paladin,retribution,30,9,21
Badboí,azralon,862,paladin,retribution,12,9,3
Salaminhoo,azralon,862,paladin,retribution,12,9,3
Worder,tichondrius,862,paladin,retribution,12,9,3
Playandrunn,illidan,862,paladin,retribution,18,9,9
Konarik,stormrage,862,paladin,retribution,18,9,9
Dzx,nemesis,862,paladin,retribution,18,9,9
Kelthálas,illidan,862,paladin,retribution,24,9,15
Restitution,area-52,862,paladin,retribution,24,9,15
Saccro,area-52,862,paladin,retribution,30,9,21
Pallytoot,aerie-peak,861,paladin,retribution,12,9,3
Vexxa,nerzhul,861,paladin,retribution,18,9,9
Kalboko,twisting-nether,861,paladin,retribution,21,10,11
Rennalux,stormrage,861,paladin,retribution,24,9,15
Emmastoned,bleeding-hollow,860,paladin,retribution,24,9,15
Layonthis,the-venture-co,859,paladin,retribution,18,9,9
Khetzi,thunderhorn,859,paladin,retribution,18,9,9
Irongiant,grizzly-hills,858,paladin,retribution,18,9,9
Alysca,tichondrius,858,paladin,retribution,18,9,9
Xenagos,akama,858,paladin,retribution,24,9,15
Alerz,moon-guard,857,paladin,retribution,15,9,6
Dynamais,barthilas,855,paladin,retribution,30,9,21
Morthalos,moon-guard,845,paladin,retribution,23,9,14
Rensvall,frostmourne,844,paladin,retribution,18,9,9
Hotdgwatr,bleeding-hollow,843,paladin,retribution,24,10,14
Avaheal,dragonmaw,842,paladin,retribution,23,9,14
Jeinova,barthilas,837,paladin,retribution,12,9,3
Pallehx,tichondrius,831,paladin,retribution,23,9,14
Areuss,tichondrius,815,paladin,retribution,17,9,8
Kookamønga,tichondrius,815,paladin,retribution,21,10,11
Cozzey,amanthul,810,paladin,retribution,17,9,8
Chuoo,proudmoore,810,paladin,retribution,28,10,18
Thadose,bonechewer,808,paladin,retribution,22,9,13
Yovan,proudmoore,806,paladin,retribution,20,11,9
Páláx,stormrage,806,paladin,retribution,27,9,18
Lizzyz,illidan,799,paladin,retribution,20,9,11
Erós,azralon,798,paladin,retribution,22,9,13
Lightfdre,rexxar,797,paladin,retribution,33,11,22
Jdisco,bonechewer,782,paladin,retribution,19,9,10
Gannecus,bleeding-hollow,768,paladin,retribution,12,8,4
Mortalbeef,zuljin,768,paladin,retribution,12,8,4
Tearet,tichondrius,768,paladin,retribution,12,8,4
Unicornslayr,antonidas,768,paladin,retribution,12,8,4
Djangø,azuremyst,768,paladin,retribution,12,8,4
Laboøn,stormrage,768,paladin,retribution,12,8,4
Swellows,tichondrius,768,paladin,retribution,12,8,4
Arellis,barthilas,768,paladin,retribution,12,8,4
Tanishalfelf,stormrage,768,paladin,retribution,12,8,4
Goldnhart,wyrmrest-accord,768,paladin,retribution,12,8,4
Yezzyll,korgath,768,paladin,retribution,12,8,4
Clee,sargeras,768,paladin,retribution,12,8,4
Cutebtw,zuljin,768,paladin,retribution,16,9,7
Grimreaperx,azralon,768,paladin,retribution,17,8,9
Ðiviñe,zuluhed,768,paladin,retribution,18,8,10
Furylolz,tichondrius,768,paladin,retribution,18,8,10
Nozfferatu,drakkari,768,paladin,retribution,18,8,10
Retrachet,thrall,768,paladin,retribution,18,8,10
Hojdin,tichondrius,768,paladin,retribution,18,8,10
Jakkatähn,malganis,768,paladin,retribution,18,8,10
Ponytail,dark-iron,768,paladin,retribution,18,8,10
Väkariän,quelthalas,768,paladin,retribution,18,8,10
Jebpal,tichondrius,768,paladin,retribution,18,8,10
Gorostas,kelthuzad,768,paladin,retribution,18,8,10
Southerly,tichondrius,768,paladin,retribution,18,8,10
Roshord,quelthalas,768,paladin,retribution,18,8,10
Blackpie,bleeding-hollow,768,paladin,retribution,18,8,10
Vibránium,tichondrius,768,paladin,retribution,24,8,16
Ðori,tichondrius,768,paladin,retribution,24,8,16
Rexpeitaboot,azralon,768,paladin,retribution,24,8,16
Triginhall,moon-guard,768,paladin,retribution,24,8,16
Smorezz,bonechewer,767,paladin,retribution,12,8,4
Wickedpälly,kelthuzad,767,paladin,retribution,12,8,4
Naghret,arthas,767,paladin,retribution,12,8,4
Cókelol,zuljin,767,paladin,retribution,12,8,4
Mægenta,tichondrius,767,paladin,retribution,12,8,4
Hqknight,moon-guard,767,paladin,retribution,12,8,4
Husurdaddy,dalaran,767,paladin,retribution,12,8,4
Beachyo,tichondrius,767,paladin,retribution,12,8,4
Greybrox,barthilas,767,paladin,retribution,12,8,4
Smitetheweak,rivendare,767,paladin,retribution,12,8,4
Victidin,quelthalas,767,paladin,retribution,12,8,4
Keit,moon-guard,767,paladin,retribution,12,8,4
Chewyjitsu,tichondrius,767,paladin,retribution,12,8,4
Arreliya,sargeras,767,paladin,retribution,18,8,10
Wagyou,skywall,767,paladin,retribution,18,8,10
Erwubawan,illidan,767,paladin,retribution,18,8,10
Amlovích,quelthalas,767,paladin,retribution,18,8,10
Retman,azuremyst,767,paladin,retribution,18,8,10
Nightfallz,farstriders,767,paladin,retribution,18,8,10
Ashess,sargeras,767,paladin,retribution,18,8,10
Pallynation,korgath,767,paladin,retribution,18,8,10
Temote,anvilmar,767,paladin,retribution,18,8,10
Phanna,the-forgotten-coast,767,paladin,retribution,18,8,10
Holyskeeter,thunderhorn,767,paladin,retribution,18,8,10
Eurekasret,ragnaros,767,paladin,retribution,18,8,10
Barcar,area-52,767,paladin,retribution,18,8,10
Dontsleep,magtheridon,767,paladin,retribution,18,8,10
Nutsmashèr,illidan,767,paladin,retribution,18,8,10
Lainn,zuljin,766,paladin,retribution,12,8,4
Oneminute,nerzhul,766,paladin,retribution,12,8,4
Deesqueezie,area-52,766,paladin,retribution,12,8,4
Sanguinata,shadowsong,766,paladin,retribution,12,8,4
Otorten,bladefist,766,paladin,retribution,12,8,4
Luxord,ysera,766,paladin,retribution,16,9,7
Xoxoxoxoxoxo,aegwynn,766,paladin,retribution,18,8,10
Guji,jubeithos,766,paladin,retribution,18,8,10
Nikinaki,stormrage,765,paladin,retribution,12,8,4
Bayaz,emerald-dream,765,paladin,retribution,12,8,4
Huitz,drakkari,765,paladin,retribution,18,8,10
Ichigò,sargeras,765,paladin,retribution,18,8,10
Charleyy,stormscale,765,paladin,retribution,18,8,10
Deathblazer,blades-edge,763,paladin,retribution,18,8,10
Guccii,quelthalas,763,paladin,retribution,18,8,10
Goldfînger,zuljin,763,paladin,retribution,18,8,10
Herrit,frostmourne,762,paladin,retribution,12,8,4
Jebadia,proudmoore,762,paladin,retribution,12,8,4
Shusekki,drakkari,762,paladin,retribution,18,8,10
Flisk,garona,761,paladin,retribution,12,8,4
Eldirn,bleeding-hollow,761,paladin,retribution,12,8,4
Trappadin,sargeras,760,paladin,retribution,18,8,10
Volorick,dalaran,759,paladin,retribution,26,8,18
Aladid,aggramar,758,paladin,retribution,12,8,4
Populate,tichondrius,752,paladin,retribution,12,8,4
Fumaçaa,nemesis,751,paladin,retribution,18,8,10
Maelie,shadowmoon,749,paladin,retribution,12,8,4
Holyzeen,darkspear,749,paladin,retribution,13,8,5
Tonimâster,misha,735,paladin,retribution,17,8,9
Mádz,ragnaros,718,paladin,retribution,17,8,9
Irantir,drakkari,718,paladin,retribution,17,8,9
Lilbursty,tichondrius,714,paladin,retribution,19,9,10
Andorsi,elune,714,paladin,retribution,21,9,12
Tøpbløke,frostmourne,711,paladin,retribution,19,9,10
Procs,hyjal,701,paladin,retribution,11,9,2
Palaðu,azralon,700,paladin,retribution,14,8,6
Àmárìs,tichondrius,700,paladin,retribution,16,8,8
Kokuryuha,quelthalas,688,paladin,retribution,27,11,16
Turtlehoof,thrall,684,paladin,retribution,19,8,11
Holreshee,tichondrius,672,paladin,retribution,12,7,5
Diebygcd,tichondrius,672,paladin,retribution,12,7,5
Celethor,wyrmrest-accord,672,paladin,retribution,12,7,5
Rektwings,area-52,672,paladin,retribution,12,7,5
Mes,dragonmaw,672,paladin,retribution,12,7,5
Wèbb,burning-legion,672,paladin,retribution,12,7,5
Greasy,quelthalas,672,paladin,retribution,12,7,5
Arkoth,kelthuzad,672,paladin,retribution,12,7,5
Noitra,azralon,672,paladin,retribution,12,7,5
Yeeter,thrall,672,paladin,retribution,12,7,5
Holycar,illidan,672,paladin,retribution,12,7,5
Venturep,azralon,672,paladin,retribution,12,7,5
Anjurus,moon-guard,672,paladin,retribution,12,7,5
Fakesimp,illidan,672,paladin,retribution,12,7,5
Mikâel,cairne,672,paladin,retribution,12,7,5
Aurðra,kiljaeden,672,paladin,retribution,12,7,5
Zözo,zuljin,672,paladin,retribution,12,7,5
Nosferätu,illidan,672,paladin,retribution,12,7,5
Rönän,sargeras,672,paladin,retribution,12,7,5
Paltarrd,bleeding-hollow,672,paladin,retribution,12,7,5
Veroth,caelestrasz,672,paladin,retribution,12,7,5
Armstrong,azralon,672,paladin,retribution,12,7,5
Pinkies,frostmourne,672,paladin,retribution,12,7,5
Chäinswellx,area-52,672,paladin,retribution,12,7,5
Araguaney,bleeding-hollow,672,paladin,retribution,12,7,5
Cesah,tichondrius,672,paladin,retribution,12,7,5
Âllmíght,quelthalas,672,paladin,retribution,12,7,5
Hèlfar,wyrmrest-accord,672,paladin,retribution,12,7,5
Fogonaventa,nemesis,672,paladin,retribution,12,7,5
Bigdixss,tichondrius,672,paladin,retribution,12,7,5
Iloveket,blackrock,672,paladin,retribution,12,7,5
Trejetë,tichondrius,672,paladin,retribution,12,7,5
Dabbicus,tichondrius,672,paladin,retribution,12,7,5
Sermon,moon-guard,672,paladin,retribution,12,7,5
Unitiss,velen,672,paladin,retribution,12,7,5
Bighoochie,moon-guard,672,paladin,retribution,12,7,5
Greatwyrm,illidan,672,paladin,retribution,12,7,5
Lhacius,drakkari,672,paladin,retribution,16,8,8
Kipow,proudmoore,672,paladin,retribution,18,7,11
Ziti,bonechewer,672,paladin,retribution,18,7,11
Rebukezz,dalaran,672,paladin,retribution,18,7,11
Amntir,sargeras,672,paladin,retribution,18,7,11
Hølyshyt,tichondrius,672,paladin,retribution,18,7,11
Éætûgýäëí,area-52,672,paladin,retribution,18,7,11
Auxilio,arathor,672,paladin,retribution,18,7,11
Detrimentãl,nagrand,672,paladin,retribution,18,7,11
Hakson,stormrage,672,paladin,retribution,18,7,11
Trfreedomz,frostmourne,672,paladin,retribution,18,7,11
Kloud,sargeras,672,paladin,retribution,18,7,11
Cliftôn,illidan,672,paladin,retribution,18,7,11
Sukmyret,sargeras,672,paladin,retribution,18,7,11
Ktwocrank,dalaran,672,paladin,retribution,18,7,11
Navicc,zuljin,672,paladin,retribution,18,7,11
Divínos,area-52,672,paladin,retribution,18,7,11
Caonizumu,area-52,672,paladin,retribution,18,7,11
Aledin,frostmourne,672,paladin,retribution,18,7,11
Loyality,sargeras,672,paladin,retribution,18,7,11
Moistbible,kelthuzad,672,paladin,retribution,18,7,11
Cuteluna,tichondrius,672,paladin,retribution,18,7,11
Baeflux,kelthuzad,672,paladin,retribution,18,7,11
Palaxoto,nemesis,672,paladin,retribution,21,8,13
Saintgeórge,frostmourne,672,paladin,retribution,19,7,12
Sôck,zuljin,672,paladin,retribution,20,7,13
Lejeñd,stormrage,672,paladin,retribution,24,7,17
Thenextx,illidan,672,paladin,retribution,24,7,17
Hargol,stormrage,672,paladin,retribution,24,7,17
Auralyon,tichondrius,672,paladin,retribution,24,7,17
Ledster,kelthuzad,672,paladin,retribution,24,7,17
Lestaroth,goldrinn,672,paladin,retribution,24,7,17
Varaben,sargeras,672,paladin,retribution,24,7,17
Cryof,illidan,672,paladin,retribution,30,7,23
Pocserpala,drakkari,671,paladin,retribution,12,7,5
Jaybbers,malganis,671,paladin,retribution,12,7,5
Torujo,drakkari,671,paladin,retribution,12,7,5
Darktank,malganis,671,paladin,retribution,12,7,5
Ironpaladin,sargeras,671,paladin,retribution,12,7,5
Neutroo,stormrage,671,paladin,retribution,12,7,5
Shlaps,crushridge,671,paladin,retribution,12,7,5
Astharor,nemesis,671,paladin,retribution,12,7,5
Justsmiteit,dalaran,671,paladin,retribution,12,7,5
Koohny,stormrage,671,paladin,retribution,12,7,5
Darawin,korgath,671,paladin,retribution,12,7,5
Lystia,malfurion,671,paladin,retribution,12,7,5
Tonytoi,aegwynn,671,paladin,retribution,12,7,5
Gigadorff,stormrage,671,paladin,retribution,12,7,5
Äeriah,fizzcrank,671,paladin,retribution,12,7,5
Emethala,windrunner,671,paladin,retribution,12,7,5
Crematória,azralon,671,paladin,retribution,12,7,5
Krixes,firetree,671,paladin,retribution,12,7,5
Showfet,dalaran,671,paladin,retribution,16,8,8
Auriol,azshara,671,paladin,retribution,14,7,7
Pallyhealed,tichondrius,671,paladin,retribution,15,7,8
Sona,jubeithos,671,paladin,retribution,18,7,11
Vaelicus,emerald-dream,671,paladin,retribution,18,7,11
Misskilljoy,proudmoore,671,paladin,retribution,18,7,11
Ane,gorefiend,671,paladin,retribution,18,7,11
Tyelca,zuljin,671,paladin,retribution,18,7,11
Doraléous,illidan,671,paladin,retribution,24,7,17
Daddytoad,tichondrius,671,paladin,retribution,30,7,23
Hanno,azshara,670,paladin,retribution,12,7,5
ßlððdyßðnez,malganis,670,paladin,retribution,12,7,5
Riek,sargeras,670,paladin,retribution,16,8,8
Gainen,illidan,670,paladin,retribution,18,7,11
Chbestafera,nemesis,669,paladin,retribution,12,7,5
Terroll,bonechewer,669,paladin,retribution,13,7,6
Vargonha,azralon,669,paladin,retribution,18,9,9
Denstain,kul-tiras,669,paladin,retribution,18,7,11
Kiergann,quelthalas,669,paladin,retribution,24,7,17
Marshman,kelthuzad,668,paladin,retribution,12,7,5
Mandow,tichondrius,667,paladin,retribution,22,8,14
Imsoosmall,sargeras,666,paladin,retribution,12,7,5
Jonnywick,duskwood,665,paladin,retribution,12,7,5
Durothar,dalaran,664,paladin,retribution,18,7,11
Toepuller,doomhammer,661,paladin,retribution,12,7,5
Tectorr,proudmoore,661,paladin,retribution,12,7,5
Nicepally,moon-guard,657,paladin,retribution,18,7,11
Epòc,frostmourne,639,paladin,retribution,20,8,12
Carliitoz,quelthalas,639,paladin,retribution,23,7,16
Quotation,silvermoon,638,paladin,retribution,14,8,6
Fatalpally,antonidas,633,paladin,retribution,17,7,10
Californía,bleeding-hollow,623,paladin,retribution,11,7,4
Táçô,illidan,623,paladin,retribution,11,7,4
Thrax,spirestone,623,paladin,retribution,17,7,10
Fressbee,nathrezim,623,paladin,retribution,17,7,10
Krossfyre,kiljaeden,623,paladin,retribution,17,7,10
Johnyfresh,jubeithos,621,paladin,retribution,21,8,13
Bizzaz,moon-guard,618,paladin,retribution,20,8,12
Marvallous,area-52,608,paladin,retribution,16,7,9
Chestbrah,nemesis,607,paladin,retribution,14,7,7
Wîckèd,tichondrius,607,paladin,retribution,23,7,16
Tolkki,dalaran,607,paladin,retribution,26,7,19
Witewolf,illidan,606,paladin,retribution,13,8,5
Krønos,nordrassil,602,paladin,retribution,22,7,15
Warswordz,stormrage,595,paladin,retribution,28,9,19
Sixtynine,nathrezim,592,paladin,retribution,31,7,24
Warbird,lightnings-blade,591,paladin,retribution,13,7,6
Árèz,frostmourne,591,paladin,retribution,15,7,8
Theomere,sargeras,586,paladin,retribution,21,10,11
Ashley,sargeras,576,paladin,retribution,6,6,0
Lucard,drakkari,576,paladin,retribution,6,6,0
Thøradin,moon-guard,576,paladin,retribution,6,6,0
Jabrohnie,sargeras,576,paladin,retribution,12,6,6
Heälmeñow,tichondrius,576,paladin,retribution,12,6,6
Beardedbrute,korgath,576,paladin,retribution,12,6,6
Shakalot,illidan,576,paladin,retribution,12,6,6
Sathandrä,sargeras,576,paladin,retribution,12,6,6
Sacerbelator,zuluhed,576,paladin,retribution,12,6,6
Sniper,uther,576,paladin,retribution,12,6,6
Gambitdin,moon-guard,576,paladin,retribution,12,6,6
Hurukpaly,azralon,576,paladin,retribution,12,6,6
Pallysmack,stormrage,576,paladin,retribution,12,6,6
Koûtt,ragnaros,576,paladin,retribution,12,6,6
Escanøor,stormrage,576,paladin,retribution,12,6,6
Brpistol,azralon,576,paladin,retribution,12,6,6
Blasstar,quelthalas,576,paladin,retribution,12,6,6
Holycrp,proudmoore,576,paladin,retribution,12,6,6
Relentless,magtheridon,576,paladin,retribution,12,6,6
Duhvine,malganis,576,paladin,retribution,12,6,6
Rohad,thrall,576,paladin,retribution,12,6,6
Virtuosi,area-52,576,paladin,retribution,12,6,6
Ralo,khaz-modan,576,paladin,retribution,12,6,6
Banzz,azralon,576,paladin,retribution,12,6,6
Protein,magtheridon,576,paladin,retribution,12,6,6
Jxke,barthilas,576,paladin,retribution,12,6,6
Onixx,kargath,576,paladin,retribution,12,6,6
Tantradin,area-52,576,paladin,retribution,12,6,6
Andrinn,nemesis,576,paladin,retribution,12,6,6
Gánico,ragnaros,576,paladin,retribution,12,6,6
Margit,moon-guard,576,paladin,retribution,12,6,6
Zèró,terokkar,576,paladin,retribution,12,6,6
Contritus,kiljaeden,576,paladin,retribution,12,6,6
Pállyho,tichondrius,576,paladin,retribution,12,6,6
Tazanian,aegwynn,576,paladin,retribution,12,6,6
Memepaladin,area-52,576,paladin,retribution,12,6,6
Brioc,tichondrius,576,paladin,retribution,12,6,6
Çhñkzrèt,illidan,576,paladin,retribution,12,6,6
Enril,azgalor,576,paladin,retribution,12,6,6
Bronytime,illidan,576,paladin,retribution,12,6,6
Olixx,blackrock,576,paladin,retribution,12,6,6
Thuggrnaut,darkspear,576,paladin,retribution,12,6,6
Bloodyängel,emerald-dream,576,paladin,retribution,12,6,6
Hardnow,emerald-dream,576,paladin,retribution,12,6,6
Handyandy,kelthuzad,576,paladin,retribution,12,6,6
Trixzthot,barthilas,576,paladin,retribution,12,6,6
Lightcast,moon-guard,576,paladin,retribution,12,6,6
Ogholyhands,bleeding-hollow,576,paladin,retribution,12,6,6
Proctrlx,tichondrius,576,paladin,retribution,12,6,6
Felwythe,emerald-dream,576,paladin,retribution,12,6,6
Zägreus,moon-guard,576,paladin,retribution,12,6,6
Emetselchs,tichondrius,576,paladin,retribution,12,6,6
Avacii,illidan,576,paladin,retribution,12,6,6
Mwqyyds,tichondrius,576,paladin,retribution,12,6,6
Tothegravetv,illidan,576,paladin,retribution,12,6,6
Crânkdât,frostmourne,576,paladin,retribution,12,6,6
Yungcheezy,illidan,576,paladin,retribution,12,6,6
Sozmsjackson,barthilas,576,paladin,retribution,15,7,8
Galedance,tichondrius,576,paladin,retribution,16,7,9
Lit,alexstrasza,576,paladin,retribution,16,7,9
Rashrind,moon-guard,576,paladin,retribution,21,7,14
Nufi,magtheridon,576,paladin,retribution,18,6,12
Tåine,bladefist,576,paladin,retribution,18,6,12
Xinqingle,tichondrius,576,paladin,retribution,18,6,12
Goozlight,area-52,576,paladin,retribution,18,6,12
Astolfo,tortheldrin,576,paladin,retribution,18,6,12
Respect,moon-guard,576,paladin,retribution,18,6,12
Retz,tichondrius,576,paladin,retribution,18,6,12
Kochinodin,ragnaros,576,paladin,retribution,18,6,12
Exorcìst,tichondrius,576,paladin,retribution,18,6,12
Emaus,tichondrius,576,paladin,retribution,18,6,12
Goldskìn,sargeras,576,paladin,retribution,18,6,12
Isayas,tichondrius,576,paladin,retribution,18,6,12
Niksilp,malfurion,576,paladin,retribution,18,6,12
Gogofisco,moonrunner,576,paladin,retribution,18,6,12
Vânguards,tichondrius,576,paladin,retribution,18,6,12
Tesak,emerald-dream,576,paladin,retribution,18,6,12
Mixnut,tichondrius,576,paladin,retribution,18,6,12
Lightslion,stormrage,576,paladin,retribution,18,6,12
Jivvy,eredar,576,paladin,retribution,18,6,12
Mïkhael,nemesis,576,paladin,retribution,18,6,12
Dayuanzhong,tichondrius,576,paladin,retribution,20,6,14
Againstfilet,azralon,576,paladin,retribution,24,6,18
Sabotsaint,tichondrius,576,paladin,retribution,24,6,18
Vick,zuljin,575,paladin,retribution,6,6,0
Potiguar,azralon,575,paladin,retribution,12,6,6
Pocacoco,azralon,575,paladin,retribution,12,6,6
Athenariel,bleeding-hollow,575,paladin,retribution,12,6,6
Hijinxx,antonidas,575,paladin,retribution,12,6,6
Aeroßlaze,dragonmaw,575,paladin,retribution,12,6,6
Haziel,darkspear,575,paladin,retribution,12,6,6
Synthetic,moon-guard,575,paladin,retribution,12,6,6
Derethen,emerald-dream,575,paladin,retribution,12,6,6
Dirkadirkka,stormrage,575,paladin,retribution,12,6,6
Spartus,area-52,575,paladin,retribution,12,6,6
Snowcrest,cenarius,575,paladin,retribution,12,6,6
Yuzuru,mannoroth,575,paladin,retribution,12,6,6
Souiler,thunderlord,575,paladin,retribution,16,7,9
Dárí,stormrage,575,paladin,retribution,18,6,12
Mikezheng,tichondrius,575,paladin,retribution,18,6,12
Positivemind,nerzhul,574,paladin,retribution,6,6,0
Ihmperiuus,quelthalas,574,paladin,retribution,12,6,6
Akeero,khaz-modan,574,paladin,retribution,12,6,6
Hibrael,azralon,574,paladin,retribution,12,6,6
Tamahu,azralon,574,paladin,retribution,18,6,12
Thaly,shadowmoon,574,paladin,retribution,18,6,12
Holyshoc,kiljaeden,573,paladin,retribution,20,6,14
Kalerien,wildhammer,571,paladin,retribution,12,6,6
Ajaex,area-52,571,paladin,retribution,12,6,6
Thirtyfivemm,area-52,571,paladin,retribution,18,6,12
Luke,frostwolf,559,paladin,retribution,17,6,11
Hapii,tichondrius,543,paladin,retribution,11,6,5
Sosalo,sargeras,543,paladin,retribution,15,7,8
Gloren,garrosh,543,paladin,retribution,17,6,11
Galatus,tichondrius,543,paladin,retribution,17,6,11
Suslazin,area-52,543,paladin,retribution,20,7,13
Cexus,tichondrius,527,paladin,retribution,11,6,5
Gtate,azjolnerub,527,paladin,retribution,11,6,5
Shuckles,windrunner,522,paladin,retribution,20,7,13
Briaelyne,tichondrius,522,paladin,retribution,25,8,17
Ha,bleeding-hollow,522,paladin,retribution,22,7,15
Pantheeon,altar-of-storms,522,paladin,retribution,24,7,17
Noblelight,saurfang,520,paladin,retribution,12,7,5
Cheesetitan,tichondrius,511,paladin,retribution,16,6,10
ßìgdám,bleeding-hollow,511,paladin,retribution,17,6,11
Slashnroses,tichondrius,511,paladin,retribution,20,6,14
Neró,quelthalas,495,paladin,retribution,13,6,7
Senorwang,dalaran,494,paladin,retribution,13,6,7
Ulrah,moon-guard,494,paladin,retribution,15,6,9
Mikkylol,tichondrius,494,paladin,retribution,16,6,10
Cathode,area-52,480,paladin,retribution,6,5,1
Mmrdonator,icecrown,480,paladin,retribution,6,5,1
Kimitail,tichondrius,480,paladin,retribution,6,5,1
Jaimi,stormreaver,480,paladin,retribution,6,5,1
Immensepower,tichondrius,480,paladin,retribution,6,5,1
Taeret,tichondrius,480,paladin,retribution,6,5,1
Mattilla,tichondrius,480,paladin,retribution,6,5,1
Mollymatt,drenden,480,paladin,retribution,6,5,1
Bramot,moon-guard,480,paladin,retribution,6,5,1
Chuckvandam,illidan,480,paladin,retribution,6,5,1
Mizumaru,sargeras,480,paladin,retribution,6,5,1
Kylarha,stormrage,480,paladin,retribution,6,5,1
Shadoweelite,sargeras,480,paladin,retribution,6,5,1
Avati,sargeras,480,paladin,retribution,6,5,1
Andelko,tichondrius,480,paladin,retribution,6,5,1
Dividin,stormrage,480,paladin,retribution,6,5,1
Totalaustin,sargeras,480,paladin,retribution,6,5,1
Ignasius,blood-furnace,480,paladin,retribution,6,5,1
Coleta,stormrage,480,paladin,retribution,6,5,1
Zeprikito,nemesis,480,paladin,retribution,6,5,1
Rikkupìgu,sargeras,480,paladin,retribution,6,5,1
Moozafa,kiljaeden,480,paladin,retribution,6,5,1
Capsiel,caelestrasz,480,paladin,retribution,6,5,1
Heathen,spirestone,480,paladin,retribution,6,5,1
Chopsparks,khadgar,480,paladin,retribution,6,5,1
Sonatas,ursin,480,paladin,retribution,9,6,3
Vynesonia,emerald-dream,480,paladin,retribution,9,6,3
Leaelda,wyrmrest-accord,480,paladin,retribution,12,5,7
Lebowski,nordrassil,480,paladin,retribution,12,5,7
Farmerzonly,tichondrius,480,paladin,retribution,12,5,7
Liadryn,kiljaeden,480,paladin,retribution,12,5,7
Callandør,illidan,480,paladin,retribution,12,5,7
Borélock,kelthuzad,480,paladin,retribution,12,5,7
Bold,frostmourne,480,paladin,retribution,12,5,7
Valkaurus,drakkari,480,paladin,retribution,12,5,7
Valtariel,wyrmrest-accord,480,paladin,retribution,12,5,7
Holycots,stormrage,480,paladin,retribution,12,5,7
Mvpj,medivh,480,paladin,retribution,12,5,7
Zhaslk,ragnaros,480,paladin,retribution,12,5,7
Faithkiller,garrosh,480,paladin,retribution,12,5,7
Thrasheric,ragnaros,480,paladin,retribution,12,5,7
Attkdamdam,illidan,480,paladin,retribution,12,5,7
Dazargeros,moon-guard,480,paladin,retribution,12,5,7
Ravage,lothar,480,paladin,retribution,12,5,7
Randvi,sargeras,480,paladin,retribution,12,5,7
Bettyböp,bleeding-hollow,480,paladin,retribution,12,5,7
Nadinebb,proudmoore,480,paladin,retribution,12,5,7
Hallastus,stormrage,480,paladin,retribution,12,5,7
Retcuzyaknow,illidan,480,paladin,retribution,12,5,7
Methor,thrall,480,paladin,retribution,12,5,7
Xalixxa,moon-guard,480,paladin,retribution,12,5,7
Són,ragnaros,480,paladin,retribution,12,5,7
Arturias,kiljaeden,480,paladin,retribution,12,5,7
Rikku,undermine,480,paladin,retribution,12,5,7
Connore,stormrage,480,paladin,retribution,12,5,7
Noleyboo,proudmoore,480,paladin,retribution,12,5,7
Thickgirl,bleeding-hollow,480,paladin,retribution,12,5,7
Adrexious,dalaran,480,paladin,retribution,12,5,7
Lyricism,tichondrius,480,paladin,retribution,12,5,7
Fìlìgree,tichondrius,480,paladin,retribution,12,5,7
Dalance,draka,480,paladin,retribution,12,5,7
Toojazzyleah,proudmoore,480,paladin,retribution,12,5,7
Kaidoz,aegwynn,480,paladin,retribution,12,5,7
Decareos,tichondrius,480,paladin,retribution,12,5,7
Pique,malganis,480,paladin,retribution,12,5,7
ßraveheart,zuljin,480,paladin,retribution,12,5,7
Skilladin,zuljin,480,paladin,retribution,12,5,7
Critadins,thrall,480,paladin,retribution,12,5,7
Yérn,barthilas,480,paladin,retribution,12,5,7
Stroods,stormrage,480,paladin,retribution,12,5,7
Tedward,emerald-dream,480,paladin,retribution,12,5,7
Beatman,blades-edge,480,paladin,retribution,12,5,7
Golozzakum,tichondrius,480,paladin,retribution,12,5,7
Ragarèn,emerald-dream,480,paladin,retribution,12,5,7
Tpane,kelthuzad,480,paladin,retribution,12,5,7
Aeoliá,moon-guard,480,paladin,retribution,12,5,7
Shadòw,emerald-dream,480,paladin,retribution,12,5,7
Dirtbagg,demon-soul,480,paladin,retribution,12,5,7
Chadatron,tichondrius,480,paladin,retribution,12,5,7
Lawmower,sargeras,480,paladin,retribution,12,5,7
Lücid,arthas,480,paladin,retribution,12,5,7
Dinobe,arthas,480,paladin,retribution,12,5,7
Johnmacclane,azralon,480,paladin,retribution,12,5,7
Dipho,area-52,480,paladin,retribution,12,5,7
Makayla,kiljaeden,480,paladin,retribution,12,5,7
Hegarth,archimonde,480,paladin,retribution,12,5,7
Delaswing,quelthalas,480,paladin,retribution,12,5,7
Chriscoz,korgath,480,paladin,retribution,18,5,13
Holyfilers,thunderlord,480,paladin,retribution,18,5,13
Delanadras,kelthuzad,480,paladin,retribution,18,5,13
Purged,wyrmrest-accord,480,paladin,retribution,18,5,13
Downs,tichondrius,480,paladin,retribution,18,5,13
Butchur,area-52,480,paladin,retribution,18,5,13
Clapstick,illidan,480,paladin,retribution,18,5,13
Ulcerà,azralon,480,paladin,retribution,18,5,13
Møemøeda,illidan,480,paladin,retribution,18,5,13
Zolktro,stormrage,480,paladin,retribution,18,5,13
Zightmare,azralon,480,paladin,retribution,18,5,13
Krinkin,illidan,480,paladin,retribution,18,5,13
Gimlias,kelthuzad,480,paladin,retribution,18,5,13
Typheuz,wyrmrest-accord,480,paladin,retribution,18,5,13
Holychris,shadowmoon,480,paladin,retribution,18,5,13
Midnightboto,dragonmaw,480,paladin,retribution,18,5,13
Boogerred,korialstrasz,480,paladin,retribution,18,5,13
Valinorean,nemesis,480,paladin,retribution,18,5,13
Artherion,kelthuzad,480,paladin,retribution,27,6,21
Garethorne,illidan,480,paladin,retribution,24,5,19
Zero,garona,480,paladin,retribution,30,5,25
Lêe,dalaran,479,paladin,retribution,6,5,1
Mybadfoo,lethon,479,paladin,retribution,6,5,1
Nerfmehpls,ragnaros,479,paladin,retribution,6,5,1
Kremation,zuljin,479,paladin,retribution,6,5,1
Industry,firetree,479,paladin,retribution,9,6,3
Inqa,thunderlord,479,paladin,retribution,12,5,7
Murderous,frostmourne,479,paladin,retribution,12,5,7
Dredberserk,stormrage,479,paladin,retribution,12,5,7
Cowsavior,terenas,479,paladin,retribution,12,5,7
Noctis,nerzhul,479,paladin,retribution,12,5,7
Zelrich,moon-guard,479,paladin,retribution,12,5,7
Onemorelight,area-52,479,paladin,retribution,12,5,7
Memoríez,zuljin,479,paladin,retribution,12,5,7
Holyshôckz,stormrage,479,paladin,retribution,18,5,13
Eliasor,illidan,478,paladin,retribution,6,5,1
Palypunchh,darrowmere,478,paladin,retribution,12,6,6
Meltedcheese,destromath,478,paladin,retribution,12,5,7
Lucent,duskwood,478,paladin,retribution,12,5,7
Chengduqq,illidan,478,paladin,retribution,12,5,7
Neipala,ragnaros,478,paladin,retribution,12,5,7
Deltajk,drakkari,475,paladin,retribution,12,5,7
Pickypally,moon-guard,475,paladin,retribution,12,5,7
Solstein,dalaran,474,paladin,retribution,12,5,7
Vengecide,proudmoore,473,paladin,retribution,12,5,7
Cleavix,tichondrius,463,paladin,retribution,23,5,18
Pablito,fizzcrank,457,paladin,retribution,21,7,14
Zzf,turalyon,431,paladin,retribution,11,5,6
Regivän,azralon,426,paladin,retribution,12,6,6
Theboxx,frostmourne,426,paladin,retribution,16,7,9
Kimochiyuh,illidan,425,paladin,retribution,17,7,10
Lalatinx,quelthalas,416,paladin,retribution,10,5,5
Frêyr,barthilas,416,paladin,retribution,10,5,5
Judgmentor,malganis,416,paladin,retribution,16,5,11
Chiphazard,stormscale,415,paladin,retribution,14,5,9
Battlepope,thrall,399,paladin,retribution,5,5,0
Sydnneeyy,kelthuzad,399,paladin,retribution,5,5,0
Dazztrain,barthilas,384,paladin,retribution,6,4,2
Mixz,bleeding-hollow,384,paladin,retribution,6,4,2
Antoniano,ragnaros,384,paladin,retribution,6,4,2
Cowsecration,ragnaros,384,paladin,retribution,6,4,2
Anaxxie,azralon,384,paladin,retribution,6,4,2
Minikalina,ragnaros,384,paladin,retribution,6,4,2
Lashlan,barthilas,384,paladin,retribution,6,4,2
Rohlin,boulderfist,384,paladin,retribution,6,4,2
Plophero,moon-guard,384,paladin,retribution,6,4,2
Crewsade,sargeras,384,paladin,retribution,6,4,2
Nizzy,caelestrasz,384,paladin,retribution,6,4,2
Konthrus,azralon,384,paladin,retribution,6,4,2
Gellehar,barthilas,384,paladin,retribution,6,4,2
Snowcrow,tichondrius,384,paladin,retribution,6,4,2
Sïrenek,tichondrius,384,paladin,retribution,6,4,2
Kadryck,drakkari,384,paladin,retribution,6,4,2
Alxndrr,area-52,384,paladin,retribution,6,4,2
Dachenkov,tichondrius,384,paladin,retribution,6,4,2
Mathieü,zuljin,384,paladin,retribution,6,4,2
Taiffan,azralon,384,paladin,retribution,6,4,2
Eduardoap,azralon,384,paladin,retribution,6,4,2
Haiyaa,frostwolf,384,paladin,retribution,6,4,2
Bigolhammer,khadgar,384,paladin,retribution,6,4,2
Fxxku,tichondrius,384,paladin,retribution,6,4,2
Careyprice,area-52,384,paladin,retribution,6,4,2
Holytankadin,alleria,384,paladin,retribution,6,4,2
Mothh,terokkar,384,paladin,retribution,6,4,2
Mikeyqt,nemesis,384,paladin,retribution,6,4,2
Ironpallyx,garrosh,384,paladin,retribution,6,4,2
Soymilkdrnka,sargeras,384,paladin,retribution,6,4,2
Geesworld,nazjatar,384,paladin,retribution,6,4,2
Varuul,nerzhul,384,paladin,retribution,6,4,2
Gírthbrooks,hyjal,384,paladin,retribution,6,4,2
Khanid,emerald-dream,384,paladin,retribution,6,4,2
Seven,blackwing-lair,384,paladin,retribution,6,4,2
Takinvcards,area-52,384,paladin,retribution,6,4,2
Trisøn,area-52,384,paladin,retribution,6,4,2
Crtinsideyou,skullcrusher,384,paladin,retribution,6,4,2
Gilgamesh,moonrunner,384,paladin,retribution,6,4,2
Justeight,stormrage,384,paladin,retribution,6,4,2
Hellcallerl,quelthalas,384,paladin,retribution,6,4,2
Furnost,drenden,384,paladin,retribution,6,4,2
Kawkpaladin,kaelthas,384,paladin,retribution,6,4,2
Luluwu,stormrage,384,paladin,retribution,6,4,2
Puredecuy,ragnaros,384,paladin,retribution,6,4,2
Puresight,kelthuzad,384,paladin,retribution,6,4,2
Wyrmblood,moon-guard,384,paladin,retribution,6,4,2
Esçanór,darkspear,384,paladin,retribution,6,4,2
Sasukee,quelthalas,384,paladin,retribution,6,4,2
Leoros,blackrock,384,paladin,retribution,6,4,2
Madalynn,quelthalas,384,paladin,retribution,6,4,2
Deecompose,sargeras,384,paladin,retribution,6,4,2
Miitt,blackrock,384,paladin,retribution,6,4,2
Sophany,shattered-halls,384,paladin,retribution,6,4,2
Pappablanco,stormrage,384,paladin,retribution,6,4,2
Notaefc,icecrown,384,paladin,retribution,6,4,2
Stonekey,warsong,384,paladin,retribution,6,4,2
Cillessá,kelthuzad,384,paladin,retribution,6,4,2
Crocfacex,tichondrius,384,paladin,retribution,6,4,2
Cybopig,kelthuzad,384,paladin,retribution,6,4,2
Temptrez,bleeding-hollow,384,paladin,retribution,6,4,2
Glexann,sargeras,384,paladin,retribution,6,4,2
Ðorlie,malganis,384,paladin,retribution,6,4,2
Qsx,bleeding-hollow,384,paladin,retribution,6,4,2
Itaghí,sargeras,384,paladin,retribution,6,4,2
Saulhudson,bleeding-hollow,384,paladin,retribution,6,4,2
Izidar,tichondrius,384,paladin,retribution,10,5,5
Bigddady,quelthalas,384,paladin,retribution,8,4,4
Wainkywink,malganis,384,paladin,retribution,12,4,8
Ibull,stormscale,384,paladin,retribution,12,4,8
Drriz,stormrage,384,paladin,retribution,12,4,8
Niolite,ragnaros,384,paladin,retribution,12,4,8
Promethèus,jubeithos,384,paladin,retribution,12,4,8
Geospawn,tichondrius,384,paladin,retribution,12,4,8
Stax,moon-guard,384,paladin,retribution,12,4,8
Zøzø,zuljin,384,paladin,retribution,12,4,8
Torosagrado,drakkari,384,paladin,retribution,12,4,8
Lenneth,nordrassil,384,paladin,retribution,12,4,8
Riggen,thrall,384,paladin,retribution,12,4,8
Pramethious,sargeras,384,paladin,retribution,12,4,8
Grimdel,moon-guard,384,paladin,retribution,12,4,8
Yoboyindahiz,stormrage,384,paladin,retribution,12,4,8
Adauto,illidan,384,paladin,retribution,12,4,8
Smontis,sargeras,384,paladin,retribution,12,4,8
Juliusplzher,area-52,384,paladin,retribution,12,4,8
Veshral,arthas,384,paladin,retribution,12,4,8
Eutectic,moon-guard,384,paladin,retribution,12,4,8
Rusticles,aerie-peak,384,paladin,retribution,12,4,8
Oceangal,illidan,384,paladin,retribution,12,4,8
Scubàlicous,magtheridon,384,paladin,retribution,12,4,8
Theril,kelthuzad,384,paladin,retribution,12,4,8
Retspec,darkspear,384,paladin,retribution,12,4,8
Aricen,thunderhorn,384,paladin,retribution,12,4,8
Mabia,tichondrius,384,paladin,retribution,12,4,8
Tekar,altar-of-storms,384,paladin,retribution,12,4,8
Draenkz,quelthalas,384,paladin,retribution,12,4,8
Lânnâ,tichondrius,384,paladin,retribution,12,4,8
Sevik,garithos,384,paladin,retribution,12,4,8
Helldevil,zuljin,384,paladin,retribution,12,4,8
Imcomingbro,blackrock,384,paladin,retribution,12,4,8
Dezul,stormscale,384,paladin,retribution,12,4,8
Aewynn,nemesis,384,paladin,retribution,12,4,8
Dmghack,tichondrius,384,paladin,retribution,12,4,8
Àpolo,stormrage,384,paladin,retribution,12,4,8
Juffury,illidan,384,paladin,retribution,12,4,8
Crystahlmeth,sargeras,384,paladin,retribution,12,4,8
Botch,drenden,384,paladin,retribution,12,4,8
Smöke,frostmourne,384,paladin,retribution,12,4,8
Baptism,shattered-hand,384,paladin,retribution,12,4,8
Malandru,darrowmere,384,paladin,retribution,12,4,8
Rasc,barthilas,384,paladin,retribution,12,4,8
Júdgedredd,illidan,384,paladin,retribution,12,4,8
Roodictz,zuljin,384,paladin,retribution,12,4,8
Msjudged,blackrock,384,paladin,retribution,12,4,8
Fossilz,sargeras,384,paladin,retribution,12,4,8
Bauldrin,moon-guard,384,paladin,retribution,12,4,8
Imrahilaf,korialstrasz,384,paladin,retribution,12,4,8
Shiftybugar,tichondrius,384,paladin,retribution,12,4,8
Clariten,ghostlands,384,paladin,retribution,12,4,8
Strugglèbus,thrall,384,paladin,retribution,12,4,8
Haimdallr,azralon,384,paladin,retribution,12,4,8
Toxanator,frostmourne,384,paladin,retribution,12,4,8
Bestowed,moon-guard,384,paladin,retribution,12,4,8
Fây,sargeras,384,paladin,retribution,12,4,8
Koreancannon,tichondrius,384,paladin,retribution,12,4,8
Kurook,moon-guard,384,paladin,retribution,12,4,8
Senion,velen,384,paladin,retribution,12,4,8
Tieberion,bleeding-hollow,384,paladin,retribution,12,4,8
Anastos,anvilmar,384,paladin,retribution,12,4,8
Tëmplar,bleeding-hollow,384,paladin,retribution,12,4,8
Ddawz,proudmoore,384,paladin,retribution,12,4,8
Litium,frostmourne,384,paladin,retribution,12,4,8
Stoof,arygos,384,paladin,retribution,12,4,8
Shoresy,terokkar,384,paladin,retribution,12,4,8
Simpforomenx,emerald-dream,384,paladin,retribution,12,4,8
Jimithing,senjin,384,paladin,retribution,12,4,8
Fiate,azralon,384,paladin,retribution,12,4,8
Galess,tichondrius,384,paladin,retribution,12,4,8
Rëtribution,tichondrius,384,paladin,retribution,12,4,8
Acquiesce,bleeding-hollow,384,paladin,retribution,16,5,11
Kamí,elune,384,paladin,retribution,15,4,11
Pallyfreddyy,frostmourne,384,paladin,retribution,18,4,14
Indemnity,wildhammer,384,paladin,retribution,18,4,14
Ongang,illidan,384,paladin,retribution,18,4,14
Talurius,azralon,384,paladin,retribution,18,4,14
Demihoj,illidan,384,paladin,retribution,18,4,14
Ryuseiblade,ragnaros,384,paladin,retribution,18,4,14
Ellyee,jaedenar,384,paladin,retribution,18,4,14
Sponce,kirin-tor,384,paladin,retribution,18,4,14
Lüuz,area-52,384,paladin,retribution,18,4,14
Theholysword,tichondrius,384,paladin,retribution,18,4,14
Ccpx,area-52,384,paladin,retribution,18,4,14
Elcíd,quelthalas,384,paladin,retribution,18,4,14
Hayden,stormscale,384,paladin,retribution,18,4,14
Essexqt,blackhand,384,paladin,retribution,18,4,14
Powercelest,quelthalas,384,paladin,retribution,18,4,14
Mhakoi,bleeding-hollow,384,paladin,retribution,24,4,20
Dabsmaster,dalaran,383,paladin,retribution,6,4,2
Brandforge,thunderlord,383,paladin,retribution,6,4,2
Retgasm,drakthul,383,paladin,retribution,6,4,2
Praisin,zuljin,383,paladin,retribution,6,4,2
Lucifuge,twisting-nether,383,paladin,retribution,6,4,2
Thorsenâ,sargeras,383,paladin,retribution,9,5,4
Hølydiver,rivendare,383,paladin,retribution,12,4,8
Vonfraud,lightbringer,383,paladin,retribution,12,4,8
Holyburger,hakkar,383,paladin,retribution,12,4,8
Funkknight,sargeras,383,paladin,retribution,18,4,14
Hadrianus,azralon,383,paladin,retribution,24,4,20
Kenbad,aegwynn,382,paladin,retribution,6,4,2
Diablosgrim,stormrage,382,paladin,retribution,6,4,2
Barzø,tichondrius,367,paladin,retribution,11,4,7
Crucifine,wyrmrest-accord,367,paladin,retribution,11,4,7
Bibimbop,boulderfist,352,paladin,retribution,13,5,8
Vietnomeez,tichondrius,351,paladin,retribution,11,4,7
Hekki,ragnaros,351,paladin,retribution,13,4,9
Xcream,nemesis,351,paladin,retribution,20,5,15
Davinchi,laughing-skull,350,paladin,retribution,11,6,5
Bruujqt,moon-guard,336,paladin,retribution,9,5,4
Stinaz,quelthalas,335,paladin,retribution,11,4,7
Exwars,moon-guard,330,paladin,retribution,8,5,3
Bastiion,stormrage,320,paladin,retribution,10,4,6
Làzårus,area-52,320,paladin,retribution,16,4,12
Swurvezx,bleeding-hollow,319,paladin,retribution,5,4,1
Ruulight,tichondrius,319,paladin,retribution,5,4,1
Iammj,skywall,319,paladin,retribution,5,4,1
Holyshasha,tichondrius,319,paladin,retribution,8,4,4
Laysonus,moon-guard,319,paladin,retribution,8,4,4
Karig,sargeras,319,paladin,retribution,8,4,4
Dexko,silvermoon,319,paladin,retribution,8,4,4
Jadelong,azshara,319,paladin,retribution,8,4,4
Holynaps,malganis,319,paladin,retribution,9,4,5
Wadalee,tichondrius,319,paladin,retribution,14,4,10
Rainingrets,tichondrius,308,paladin,retribution,25,8,17
Paullokis,gallywix,304,paladin,retribution,7,4,3
Iamriched,illidan,304,paladin,retribution,7,4,3
Torrthak,area-52,304,paladin,retribution,7,4,3
Releváncé,frostmourne,304,paladin,retribution,19,4,15
Justsaiyen,bleeding-hollow,288,paladin,retribution,6,3,3
Frepz,illidan,288,paladin,retribution,6,3,3
Valadinna,tichondrius,288,paladin,retribution,6,3,3
Rockbell,kiljaeden,288,paladin,retribution,6,3,3
Cocodog,kiljaeden,288,paladin,retribution,6,3,3
Meduselda,kelthuzad,288,paladin,retribution,6,3,3
Retrodino,anvilmar,288,paladin,retribution,6,3,3
Everith,bleeding-hollow,288,paladin,retribution,6,3,3
Nalenne,alexstrasza,288,paladin,retribution,6,3,3
Doogo,cenarius,288,paladin,retribution,6,3,3
Cause,farstriders,288,paladin,retribution,6,3,3
Leá,illidan,288,paladin,retribution,6,3,3
Bubblless,thrall,288,paladin,retribution,6,3,3
Scamadin,tichondrius,288,paladin,retribution,6,3,3
Senisse,illidan,288,paladin,retribution,6,3,3
Aiethyria,tichondrius,288,paladin,retribution,6,3,3
Raywhite,kelthuzad,288,paladin,retribution,6,3,3
Baconsock,kelthuzad,288,paladin,retribution,6,3,3
Àxçël,hyjal,288,paladin,retribution,6,3,3
Maxduo,bleeding-hollow,288,paladin,retribution,6,3,3
Principe,queldorei,288,paladin,retribution,6,3,3
Taynos,tichondrius,288,paladin,retribution,6,3,3
Rickadin,bleeding-hollow,288,paladin,retribution,6,3,3
Gstbubble,hyjal,288,paladin,retribution,6,3,3
Zakh,proudmoore,288,paladin,retribution,6,3,3
Bubblet,bleeding-hollow,288,paladin,retribution,6,3,3
Venter,bleeding-hollow,288,paladin,retribution,6,3,3
Nickotines,kelthuzad,288,paladin,retribution,6,3,3
Astasia,laughing-skull,288,paladin,retribution,6,3,3
Reallyfe,skullcrusher,288,paladin,retribution,6,3,3
Elhoj,illidan,288,paladin,retribution,6,3,3
Outlivz,hyjal,288,paladin,retribution,6,3,3
Deadlyskills,arathor,288,paladin,retribution,6,3,3
Lomis,azgalor,288,paladin,retribution,6,3,3
Brahlix,area-52,288,paladin,retribution,6,3,3
Buttflapster,proudmoore,288,paladin,retribution,6,3,3
Zaxxous,hyjal,288,paladin,retribution,6,3,3
Reptila,bonechewer,288,paladin,retribution,6,3,3
Eleonorr,proudmoore,288,paladin,retribution,6,3,3
Orangepa,dalaran,288,paladin,retribution,6,3,3
Tarnyb,illidan,288,paladin,retribution,6,3,3
Cinacalcet,dalaran,288,paladin,retribution,6,3,3
Mèdic,illidan,288,paladin,retribution,6,3,3
Mvpp,dalaran,288,paladin,retribution,6,3,3
Jovolur,dalaran,288,paladin,retribution,6,3,3
Krackanut,kelthuzad,288,paladin,retribution,6,3,3
Mordered,proudmoore,288,paladin,retribution,6,3,3
Kanachi,bleeding-hollow,288,paladin,retribution,6,3,3
Ankhz,area-52,288,paladin,retribution,6,3,3
Joeschmo,area-52,288,paladin,retribution,6,3,3
Halnarran,area-52,288,paladin,retribution,6,3,3
Naughtygames,area-52,288,paladin,retribution,6,3,3
Purekiller,destromath,288,paladin,retribution,6,3,3
Assaultron,dalaran,288,paladin,retribution,6,3,3
Heamis,thunderlord,288,paladin,retribution,6,3,3
Nerfretpls,area-52,288,paladin,retribution,6,3,3
Ltt,dalaran,288,paladin,retribution,6,3,3
Tadaki,dalaran,288,paladin,retribution,6,3,3
Scathol,tichondrius,288,paladin,retribution,6,3,3
Talionz,illidan,288,paladin,retribution,6,3,3
Dfz,mannoroth,288,paladin,retribution,6,3,3
Smashnasty,area-52,288,paladin,retribution,6,3,3
Troegenator,stormrage,288,paladin,retribution,6,3,3
Merphy,tichondrius,288,paladin,retribution,6,3,3
Hamerfall,tichondrius,288,paladin,retribution,6,3,3
Palman,frostmourne,288,paladin,retribution,6,3,3
Gryphin,moon-guard,288,paladin,retribution,6,3,3
Sóláris,moon-guard,288,paladin,retribution,6,3,3
Vindictacho,tichondrius,288,paladin,retribution,6,3,3
Ýøg,tichondrius,288,paladin,retribution,6,3,3
Bíteme,sargeras,288,paladin,retribution,6,3,3
Articilia,ragnaros,288,paladin,retribution,6,3,3
Shakemup,stormrage,288,paladin,retribution,6,3,3
Jestiny,amanthul,288,paladin,retribution,6,3,3
Greciâ,ragnaros,288,paladin,retribution,6,3,3
Agonyss,quelthalas,288,paladin,retribution,6,3,3
Halordriest,tichondrius,288,paladin,retribution,6,3,3
Dráugus,azralon,288,paladin,retribution,6,3,3
Pahlevahn,stormrage,288,paladin,retribution,6,3,3
Zenpally,doomhammer,288,paladin,retribution,6,3,3
Cedwarlancy,sargeras,288,paladin,retribution,6,3,3
Mesmi,moon-guard,288,paladin,retribution,6,3,3
Volcathos,moon-guard,288,paladin,retribution,6,3,3
Uneazyxx,tichondrius,288,paladin,retribution,6,3,3
Flareous,moon-guard,288,paladin,retribution,6,3,3
Mki,kargath,288,paladin,retribution,6,3,3
Beato,silvermoon,288,paladin,retribution,6,3,3
Maanuel,ragnaros,288,paladin,retribution,6,3,3
Jugheadqc,mugthol,288,paladin,retribution,6,3,3
Hybrix,tichondrius,288,paladin,retribution,6,3,3
Moox,wyrmrest-accord,288,paladin,retribution,6,3,3
Wálker,ragnaros,288,paladin,retribution,6,3,3
Nerilliah,sargeras,288,paladin,retribution,6,3,3
Gashlycrumb,tichondrius,288,paladin,retribution,6,3,3
Justicejosh,frostmourne,288,paladin,retribution,6,3,3
Zercker,ragnaros,288,paladin,retribution,6,3,3
Elri,ragnaros,288,paladin,retribution,6,3,3
Aidillon,shadowsong,288,paladin,retribution,6,3,3
Runebane,doomhammer,288,paladin,retribution,6,3,3
Orestis,stormrage,288,paladin,retribution,6,3,3
Gattís,stormrage,288,paladin,retribution,6,3,3
Lmac,frostmourne,288,paladin,retribution,6,3,3
Beepsmash,executus,288,paladin,retribution,6,3,3
Holyshrekt,frostmourne,288,paladin,retribution,6,3,3
Ximenita,ragnaros,288,paladin,retribution,6,3,3
Kôld,tichondrius,288,paladin,retribution,6,3,3
Reaslovak,jubeithos,288,paladin,retribution,6,3,3
Olsen,stormrage,288,paladin,retribution,6,3,3
Drágônbôrn,tichondrius,288,paladin,retribution,6,3,3
Liandroa,stormrage,288,paladin,retribution,6,3,3
Genovah,sargeras,288,paladin,retribution,6,3,3
Kahleesy,sargeras,288,paladin,retribution,6,3,3
Apocryphx,stormrage,288,paladin,retribution,6,3,3
Åddict,kelthuzad,288,paladin,retribution,6,3,3
Zeroret,tichondrius,288,paladin,retribution,6,3,3
Lawdeedawh,tichondrius,288,paladin,retribution,6,3,3
Lightballz,vashj,288,paladin,retribution,6,3,3
Dev,frostwolf,288,paladin,retribution,6,3,3
Darkknes,quelthalas,288,paladin,retribution,6,3,3
Theehopper,shandris,288,paladin,retribution,6,3,3
Menjo,malganis,288,paladin,retribution,6,3,3
Trg,azralon,288,paladin,retribution,6,3,3
Disappearing,stormrage,288,paladin,retribution,6,3,3
Varezion,vashj,288,paladin,retribution,6,3,3
Theßest,baelgun,288,paladin,retribution,6,3,3
Chajaaro,ragnaros,288,paladin,retribution,6,3,3
Boladosx,azralon,288,paladin,retribution,6,3,3
Laluce,malganis,288,paladin,retribution,6,3,3
Dasp,nagrand,288,paladin,retribution,6,3,3
Joeseph,stormrage,288,paladin,retribution,6,3,3
Stamptime,emerald-dream,288,paladin,retribution,6,3,3
Sellenagomez,malganis,288,paladin,retribution,6,3,3
Jónò,tichondrius,288,paladin,retribution,6,3,3
Deosfires,ragnaros,288,paladin,retribution,6,3,3
Ivanko,dalaran,288,paladin,retribution,7,3,4
Kiboko,tichondrius,288,paladin,retribution,7,3,4
Ziberax,chogall,288,paladin,retribution,10,3,7
Sunwalker,tichondrius,288,paladin,retribution,11,3,8
Dragonbait,khadgar,288,paladin,retribution,12,3,9
Lue,boulderfist,288,paladin,retribution,12,3,9
Kaupe,barthilas,288,paladin,retribution,12,3,9
Razuel,frostmourne,288,paladin,retribution,12,3,9
Yeluh,malganis,288,paladin,retribution,12,3,9
Zoliz,tichondrius,288,paladin,retribution,12,3,9
Bigplucker,kelthuzad,288,paladin,retribution,12,3,9
Levarious,thunderlord,288,paladin,retribution,12,3,9
Craq,alexstrasza,288,paladin,retribution,12,3,9
Tolleytrain,malganis,288,paladin,retribution,12,3,9
Hardclimacks,frostmourne,288,paladin,retribution,12,3,9
Tarkovkappa,illidan,288,paladin,retribution,12,3,9
Allixis,wyrmrest-accord,288,paladin,retribution,12,3,9
Therëv,zuljin,288,paladin,retribution,12,3,9
Varthinator,stormrage,288,paladin,retribution,12,3,9
Elpal,thrall,288,paladin,retribution,12,3,9
Jafbe,mugthol,288,paladin,retribution,12,3,9
Jontapally,stormrage,288,paladin,retribution,12,3,9
Palâdin,zuljin,288,paladin,retribution,12,3,9
Vegetå,malganis,288,paladin,retribution,12,3,9
Provail,stormrage,288,paladin,retribution,12,3,9
Rxxkiee,tichondrius,288,paladin,retribution,12,3,9
Onemassacre,spirestone,288,paladin,retribution,12,3,9
Leronos,zuljin,288,paladin,retribution,12,3,9
Kuoch,shandris,288,paladin,retribution,12,3,9
Wreathy,sargeras,288,paladin,retribution,12,3,9
Spiritkeep,veknilash,288,paladin,retribution,12,3,9
Véxv,emerald-dream,288,paladin,retribution,12,3,9
Madworld,moon-guard,288,paladin,retribution,12,3,9
Gämä,azralon,288,paladin,retribution,12,3,9
Säv,tichondrius,288,paladin,retribution,12,3,9
Quelite,sargeras,288,paladin,retribution,12,3,9
Smokeys,sargeras,288,paladin,retribution,12,3,9
Hyperforce,area-52,288,paladin,retribution,12,3,9
Uoenò,moon-guard,288,paladin,retribution,12,3,9
Slania,area-52,288,paladin,retribution,12,3,9
Bdaws,tichondrius,288,paladin,retribution,12,3,9
Hahe,tichondrius,288,paladin,retribution,12,3,9
Caityaj,illidan,288,paladin,retribution,12,3,9
Asukaxt,illidan,288,paladin,retribution,12,3,9
Darqtank,smolderthorn,288,paladin,retribution,12,3,9
Nik,the-underbog,288,paladin,retribution,12,3,9
Mcconnell,sargeras,288,paladin,retribution,12,3,9
Arkanica,moon-guard,288,paladin,retribution,12,3,9
Galadriele,zuljin,288,paladin,retribution,12,3,9
Cromsecrate,dalaran,288,paladin,retribution,12,3,9
Marrike,moon-guard,288,paladin,retribution,12,3,9
Paladatrox,ragnaros,288,paladin,retribution,12,3,9
Bubblebooty,drakthul,288,paladin,retribution,12,3,9
Slowmoshend,illidan,288,paladin,retribution,12,3,9
Tíron,dalaran,288,paladin,retribution,12,3,9
Zaeris,proudmoore,288,paladin,retribution,12,3,9
Brightfire,dawnbringer,288,paladin,retribution,12,3,9
Ucvnt,illidan,288,paladin,retribution,12,3,9
Bakednub,malganis,288,paladin,retribution,17,3,14
Fourchon,tichondrius,288,paladin,retribution,18,3,15
Nume,nesingwary,288,paladin,retribution,18,3,15
Whangsta,tichondrius,288,paladin,retribution,24,3,21
Soyafed,mugthol,287,paladin,retribution,6,3,3
Covidxlx,hakkar,287,paladin,retribution,6,3,3
Lítebearer,kelthuzad,287,paladin,retribution,6,3,3
Niáa,quelthalas,287,paladin,retribution,12,3,9
Bubbleöseven,agamaggan,281,paladin,retribution,11,5,6
Ekyu,sargeras,272,paladin,retribution,7,5,2
Milkmi,frostmourne,271,paladin,retribution,11,3,8
Gusset,tichondrius,255,paladin,retribution,8,4,4
Lorgax,alterac-mountains,240,paladin,retribution,9,3,6
Sôsaboy,tichondrius,239,paladin,retribution,5,3,2
Palitard,tichondrius,234,paladin,retribution,7,5,2
Hottest,wyrmrest-accord,234,paladin,retribution,8,4,4
Swiftysh,ragnaros,234,paladin,retribution,9,4,5
Stinkystan,korgath,234,paladin,retribution,10,4,6
Ducii,stormrage,234,paladin,retribution,16,4,12
Waffulzz,moonrunner,223,paladin,retribution,8,3,5
Keegân,area-52,192,paladin,retribution,4,3,1
Zhspeilian,tichondrius,192,paladin,retribution,11,4,7
Anonymvs,eredar,192,paladin,retribution,9,3,6
Bizaro,malganis,192,paladin,retribution,6,2,4
Oynx,emerald-dream,192,paladin,retribution,6,2,4
Gwff,tichondrius,192,paladin,retribution,6,2,4
Thal,silvermoon,192,paladin,retribution,6,2,4
Quiznossubs,kelthuzad,192,paladin,retribution,6,2,4
Roseheart,emerald-dream,192,paladin,retribution,6,2,4
Palabora,kelthuzad,192,paladin,retribution,6,2,4
Ret,onyxia,192,paladin,retribution,6,2,4
Thepallyx,silvermoon,192,paladin,retribution,6,2,4
Mynnorath,emerald-dream,192,paladin,retribution,6,2,4
Schooiez,tichondrius,192,paladin,retribution,6,2,4
Dabakle,stormrage,192,paladin,retribution,6,2,4
Dragomnnm,stormrage,192,paladin,retribution,6,2,4
Thantore,scilla,192,paladin,retribution,6,2,4
Strîkes,emerald-dream,192,paladin,retribution,6,2,4
Passinpeace,tichondrius,192,paladin,retribution,6,2,4
Pallylyfe,wyrmrest-accord,192,paladin,retribution,6,2,4
Gunderbok,emerald-dream,192,paladin,retribution,6,2,4
Angelscrÿ,stormrage,192,paladin,retribution,6,2,4
Orin,guldan,192,paladin,retribution,6,2,4
Felourian,malganis,192,paladin,retribution,6,2,4
Whittia,wyrmrest-accord,192,paladin,retribution,6,2,4
Nocomus,andorhal,192,paladin,retribution,6,2,4
Krabbiepatty,wyrmrest-accord,192,paladin,retribution,6,2,4
Erethonis,bladefist,192,paladin,retribution,6,2,4
Sethy,feathermoon,192,paladin,retribution,6,2,4
Ohsoclose,bleeding-hollow,192,paladin,retribution,6,2,4
Desterro,quelthalas,192,paladin,retribution,6,2,4
Machoo,laughing-skull,192,paladin,retribution,6,2,4
Inexcusable,tichondrius,192,paladin,retribution,6,2,4
Khels,gilneas,192,paladin,retribution,6,2,4
Alphönsë,quelthalas,192,paladin,retribution,6,2,4
Páladian,quelthalas,192,paladin,retribution,6,2,4
Brand,emerald-dream,192,paladin,retribution,6,2,4
Blaeng,shandris,192,paladin,retribution,6,2,4
Outofholy,stormrage,192,paladin,retribution,6,2,4
Repèntance,stormrage,192,paladin,retribution,6,2,4
Smolbeef,tichondrius,192,paladin,retribution,6,2,4
Dynastyhero,area-52,192,paladin,retribution,6,2,4
Oxycleän,doomhammer,192,paladin,retribution,6,2,4
Watersesh,baelgun,192,paladin,retribution,6,2,4
Spyglas,quelthalas,192,paladin,retribution,6,2,4
Killerspally,area-52,192,paladin,retribution,6,2,4
Dréveleth,quelthalas,192,paladin,retribution,6,2,4
Alexandros,the-underbog,192,paladin,retribution,6,2,4
Roundbutts,stormrage,192,paladin,retribution,6,2,4
Noscajj,tichondrius,192,paladin,retribution,6,2,4
Hafra,zuljin,192,paladin,retribution,6,2,4
Meanlight,zuljin,192,paladin,retribution,6,2,4
Retboy,archimonde,192,paladin,retribution,6,2,4
Øexørcistta,nemesis,192,paladin,retribution,6,2,4
Psychlight,quelthalas,192,paladin,retribution,6,2,4
Blëssëd,zuljin,192,paladin,retribution,6,2,4
Tyberas,wyrmrest-accord,192,paladin,retribution,6,2,4
Rakzan,nerzhul,192,paladin,retribution,6,2,4
Kêy,the-venture-co,192,paladin,retribution,6,2,4
Crânkz,blackrock,192,paladin,retribution,6,2,4
Eljosco,nordrassil,192,paladin,retribution,6,2,4
Kraggar,arthas,192,paladin,retribution,6,2,4
Suro,moon-guard,192,paladin,retribution,6,2,4
Juanvaldez,muradin,192,paladin,retribution,6,2,4
Rây,stormrage,192,paladin,retribution,6,2,4
Sac,sargeras,192,paladin,retribution,6,2,4
Freslys,zuljin,192,paladin,retribution,6,2,4
Pallydin,smolderthorn,192,paladin,retribution,6,2,4
Thørîm,nazjatar,192,paladin,retribution,6,2,4
Brifos,sargeras,192,paladin,retribution,6,2,4
Vaaga,quelthalas,192,paladin,retribution,6,2,4
Varianpally,kelthuzad,192,paladin,retribution,6,2,4
Corthic,area-52,192,paladin,retribution,6,2,4
Avelane,caelestrasz,192,paladin,retribution,6,2,4
Exalter,malganis,192,paladin,retribution,6,2,4
Chrisqwa,sargeras,192,paladin,retribution,6,2,4
Aleio,moon-guard,192,paladin,retribution,6,2,4
Gripadin,tichondrius,192,paladin,retribution,6,2,4
Duffnroses,tichondrius,192,paladin,retribution,6,2,4
Jazzmatic,dalaran,192,paladin,retribution,6,2,4
Yeshayah,dalaran,192,paladin,retribution,6,2,4
Lunchboxz,nazjatar,192,paladin,retribution,6,2,4
Blargnarg,area-52,192,paladin,retribution,6,2,4
Toto,sargeras,192,paladin,retribution,6,2,4
Thejüdge,malfurion,192,paladin,retribution,6,2,4
Alasper,malganis,192,paladin,retribution,6,2,4
Vengx,sargeras,192,paladin,retribution,6,2,4
Paintpumper,malganis,192,paladin,retribution,6,2,4
Adavinn,azjolnerub,192,paladin,retribution,6,2,4
Enjoy,frostmourne,192,paladin,retribution,6,2,4
Juiicebox,darrowmere,192,paladin,retribution,6,2,4
Ödin,scarlet-crusade,192,paladin,retribution,6,2,4
Marthellus,quelthalas,192,paladin,retribution,6,2,4
Nicerice,dalaran,192,paladin,retribution,6,2,4
Johnygoodboi,khazgoroth,192,paladin,retribution,6,2,4
Nishru,sargeras,192,paladin,retribution,6,2,4
Rhodius,dalaran,192,paladin,retribution,6,2,4
Airane,sargeras,192,paladin,retribution,6,2,4
Pelegroot,azralon,192,paladin,retribution,6,2,4
Troyamat,nemesis,192,paladin,retribution,6,2,4
Tìg,proudmoore,192,paladin,retribution,6,2,4
Shaqueefah,illidan,192,paladin,retribution,6,2,4
Ramises,nemesis,192,paladin,retribution,6,2,4
Roity,proudmoore,192,paladin,retribution,6,2,4
Mazexd,illidan,192,paladin,retribution,6,2,4
Taddedpally,tichondrius,192,paladin,retribution,6,2,4
Zentrick,whisperwind,192,paladin,retribution,6,2,4
Giulio,moon-guard,192,paladin,retribution,6,2,4
Dynamism,frostmourne,192,paladin,retribution,6,2,4
Reepr,tichondrius,192,paladin,retribution,6,2,4
Hekcthor,ragnaros,192,paladin,retribution,6,2,4
Midheaven,moon-guard,192,paladin,retribution,6,2,4
Zoeyxo,tichondrius,192,paladin,retribution,6,2,4
Lightkillerx,thrall,192,paladin,retribution,6,2,4
Mercuryx,tichondrius,192,paladin,retribution,6,2,4
Snuggymuffin,barthilas,192,paladin,retribution,6,2,4
Doobiehigh,proudmoore,192,paladin,retribution,6,2,4
Cïelo,dragonmaw,192,paladin,retribution,6,2,4
Rightz,muradin,192,paladin,retribution,6,2,4
Sixty,sargeras,192,paladin,retribution,6,2,4
Haznthley,proudmoore,192,paladin,retribution,6,2,4
Lilpally,frostmourne,192,paladin,retribution,6,2,4
Trê,sargeras,192,paladin,retribution,6,2,4
Shanehere,thrall,192,paladin,retribution,6,2,4
Bigdret,moon-guard,192,paladin,retribution,6,2,4
Pushabuton,illidan,192,paladin,retribution,6,2,4
Pállymán,proudmoore,192,paladin,retribution,6,2,4
Bootcrusader,thrall,192,paladin,retribution,6,2,4
Tyrack,ragnaros,192,paladin,retribution,6,2,4
Felkor,caelestrasz,192,paladin,retribution,6,2,4
Dohsevèn,tichondrius,192,paladin,retribution,6,2,4
Däkh,sargeras,192,paladin,retribution,6,2,4
Neydisa,sargeras,192,paladin,retribution,6,2,4
Danaimei,tichondrius,192,paladin,retribution,6,2,4
Misease,illidan,192,paladin,retribution,6,2,4
Parkhwi,tichondrius,192,paladin,retribution,6,2,4
Buddyolpally,proudmoore,192,paladin,retribution,6,2,4
Ratkiller,barthilas,192,paladin,retribution,6,2,4
Talions,illidan,192,paladin,retribution,6,2,4
Ablunedion,illidan,192,paladin,retribution,6,2,4
Gîmply,proudmoore,192,paladin,retribution,6,2,4
Mikeelul,tichondrius,192,paladin,retribution,6,2,4
Buri,tichondrius,192,paladin,retribution,6,2,4
Holypumper,moon-guard,192,paladin,retribution,6,2,4
Rite,azralon,192,paladin,retribution,6,2,4
Avengzeus,tichondrius,192,paladin,retribution,6,2,4
Brucitenjr,illidan,192,paladin,retribution,6,2,4
Pallypallyy,aerie-peak,192,paladin,retribution,6,2,4
Blessinofsac,nagrand,192,paladin,retribution,6,2,4
Lxwd,tichondrius,192,paladin,retribution,6,2,4
Blastoise,drakkari,192,paladin,retribution,6,2,4
Greenracer,kiljaeden,192,paladin,retribution,6,2,4
Narcolepso,azralon,192,paladin,retribution,6,2,4
Diänë,ragnaros,192,paladin,retribution,6,2,4
Alexese,area-52,192,paladin,retribution,6,2,4
Voro,barthilas,192,paladin,retribution,6,2,4
Supermetroid,vashj,192,paladin,retribution,6,2,4
Ghatte,azralon,192,paladin,retribution,6,2,4
Inmortall,illidan,192,paladin,retribution,6,2,4
Thaléros,tichondrius,192,paladin,retribution,6,2,4
Drízzy,ragnaros,192,paladin,retribution,6,2,4
Mesaa,illidan,192,paladin,retribution,6,2,4
Chàrron,garrosh,192,paladin,retribution,6,2,4
Toscadin,ragnaros,192,paladin,retribution,6,2,4
Rochet,kiljaeden,192,paladin,retribution,6,2,4
Armasexodus,barthilas,192,paladin,retribution,6,2,4
Dose,moon-guard,192,paladin,retribution,6,2,4
Andronik,bleeding-hollow,192,paladin,retribution,9,2,7
Azajudgeman,nemesis,192,paladin,retribution,9,2,7
Aeterias,dalaran,192,paladin,retribution,10,2,8
Warmpôcket,proudmoore,192,paladin,retribution,11,2,9
Sïncere,frostmourne,192,paladin,retribution,12,2,10
Dirtfunk,illidan,192,paladin,retribution,12,2,10
Kaminasol,quelthalas,192,paladin,retribution,12,2,10
Aetol,proudmoore,192,paladin,retribution,12,2,10
Anahl,icecrown,192,paladin,retribution,12,2,10
Slithix,stormreaver,192,paladin,retribution,12,2,10
Nr,blood-furnace,192,paladin,retribution,12,2,10
Fazoéli,stormrage,192,paladin,retribution,12,2,10
Criixx,malganis,192,paladin,retribution,12,2,10
Dgâza,tichondrius,192,paladin,retribution,12,2,10
Friendfriend,proudmoore,192,paladin,retribution,12,2,10
Iskándar,tichondrius,192,paladin,retribution,12,2,10
Ricopal,frostmourne,192,paladin,retribution,12,2,10
Saifollah,cenarion-circle,192,paladin,retribution,12,2,10
Milfcrusader,tichondrius,192,paladin,retribution,12,2,10
Seratox,illidan,192,paladin,retribution,12,2,10
Rayli,dalaran,192,paladin,retribution,12,2,10
Thorsmites,sargeras,192,paladin,retribution,12,2,10
Bennygee,moonrunner,192,paladin,retribution,12,2,10
Arminhamer,sargeras,192,paladin,retribution,12,2,10
Cabacarl,quelthalas,192,paladin,retribution,12,2,10
Kaiyleigh,sargeras,192,paladin,retribution,12,2,10
Goomie,icecrown,192,paladin,retribution,12,2,10
Yawnday,farstriders,192,paladin,retribution,12,2,10
Modjytech,tichondrius,192,paladin,retribution,18,2,16
Dorisseline,emerald-dream,192,paladin,retribution,18,2,16
Imnoracist,thrall,192,paladin,retribution,18,2,16
Nejie,nazjatar,191,paladin,retribution,6,2,4
Thugmuffin,thrall,176,paladin,retribution,7,3,4
Wokeinator,malganis,175,paladin,retribution,11,3,8
Palejandro,illidan,175,paladin,retribution,11,2,9
Baalduru,borean-tundra,175,paladin,retribution,11,2,9
Sycomaniac,illidan,175,paladin,retribution,11,2,9
Drholypurp,tichondrius,159,paladin,retribution,5,2,3
Thorviim,azralon,159,paladin,retribution,5,2,3
Pallydeen,illidan,159,paladin,retribution,5,2,3
Tonnerre,silvermoon,159,paladin,retribution,5,2,3
Bringbackrmp,tichondrius,159,paladin,retribution,5,2,3
Whoopsie,dragonmaw,159,paladin,retribution,5,2,3
Mäýhëm,sargeras,144,paladin,retribution,3,3,0
Noholy,nemesis,138,paladin,retribution,8,3,5
Iæl,stormrage,138,paladin,retribution,10,3,7
Dathromir,stormrage,138,paladin,retribution,15,3,12
Bubbleosèven,tichondrius,138,paladin,retribution,16,3,13
Modafinil,bonechewer,138,paladin,retribution,20,3,17
Yemotis,emerald-dream,128,paladin,retribution,4,2,2
Sugnidrom,frostmourne,128,paladin,retribution,4,2,2
Mikwa,ragnaros,128,paladin,retribution,4,2,2
Khileeha,sargeras,128,paladin,retribution,10,2,8
Thortanous,icecrown,96,paladin,retribution,3,2,1
Dazak,ragnaros,96,paladin,retribution,3,2,1
Utho,wyrmrest-accord,96,paladin,retribution,3,2,1
Scarllye,illidan,96,paladin,retribution,6,1,5
Scuffedhoj,tichondrius,96,paladin,retribution,6,1,5
Deviill,winterhoof,96,paladin,retribution,6,1,5
Ariolo,baelgun,96,paladin,retribution,6,1,5
Scah,illidan,96,paladin,retribution,6,1,5
Xkillz,korgath,96,paladin,retribution,6,1,5
Parts,aerie-peak,96,paladin,retribution,6,1,5
Shiningtendi,aerie-peak,96,paladin,retribution,6,1,5
Talahar,boulderfist,96,paladin,retribution,6,1,5
Howlerhead,illidan,96,paladin,retribution,6,1,5
Urudith,azralon,96,paladin,retribution,6,1,5
Kentö,area-52,96,paladin,retribution,6,1,5
Ssjgodvy,illidan,96,paladin,retribution,6,1,5
Rg,nerzhul,96,paladin,retribution,6,1,5
Nytto,lightnings-blade,96,paladin,retribution,6,1,5
Mentalíssues,moon-guard,96,paladin,retribution,6,1,5
Actionman,bleeding-hollow,96,paladin,retribution,6,1,5
Amorimbr,area-52,96,paladin,retribution,6,1,5
Miniell,tichondrius,96,paladin,retribution,6,1,5
Djset,blackhand,96,paladin,retribution,6,1,5
Hôtt,kul-tiras,96,paladin,retribution,6,1,5
Brynleigh,malganis,96,paladin,retribution,6,1,5
Chuggawhugga,area-52,96,paladin,retribution,6,1,5
Carloss,drakkari,96,paladin,retribution,6,1,5
Bosmoklikdat,moon-guard,96,paladin,retribution,6,1,5
Gotdrò,tichondrius,96,paladin,retribution,6,1,5
Jüstice,tichondrius,96,paladin,retribution,6,1,5
Erindor,emerald-dream,96,paladin,retribution,6,1,5
Egirlret,tichondrius,96,paladin,retribution,6,1,5
Skadooshh,illidan,96,paladin,retribution,6,1,5
Smïthh,area-52,96,paladin,retribution,6,1,5
Clayban,stormrage,96,paladin,retribution,6,1,5
Simple,ghostlands,96,paladin,retribution,6,1,5
Lobips,sargeras,96,paladin,retribution,6,1,5
Luiiguii,drakkari,96,paladin,retribution,6,1,5
Dankpaladin,frostwolf,96,paladin,retribution,6,1,5
Anyatay,ragnaros,96,paladin,retribution,6,1,5
Chapichapi,illidan,96,paladin,retribution,6,1,5
Édzor,area-52,96,paladin,retribution,6,1,5
Retrib,tichondrius,96,paladin,retribution,6,1,5
Gdesign,tichondrius,96,paladin,retribution,6,1,5
Hanael,quelthalas,96,paladin,retribution,6,1,5
Bogùs,tichondrius,96,paladin,retribution,6,1,5
Asellusarc,kelthuzad,96,paladin,retribution,6,1,5
Matrium,kiljaeden,96,paladin,retribution,6,1,5
Holiness,stormreaver,96,paladin,retribution,6,1,5
Gordonryan,bleeding-hollow,96,paladin,retribution,6,1,5
Shádøwy,nemesis,96,paladin,retribution,6,1,5
Tehgodofdmg,tichondrius,96,paladin,retribution,6,1,5
Tradalia,illidan,96,paladin,retribution,6,1,5
Kreigvar,moon-guard,96,paladin,retribution,6,1,5
Flashstark,area-52,96,paladin,retribution,6,1,5
Synnderilla,wyrmrest-accord,96,paladin,retribution,6,1,5
Judgémental,bleeding-hollow,96,paladin,retribution,6,1,5
Aldwyn,deathwing,96,paladin,retribution,6,1,5
Justtrollin,black-dragonflight,96,paladin,retribution,6,1,5
Slantee,illidan,96,paladin,retribution,6,1,5
Rodrigo,frostmourne,96,paladin,retribution,6,1,5
Dalden,trollbane,96,paladin,retribution,6,1,5
Retsarro,frostmourne,96,paladin,retribution,6,1,5
Yøu,tichondrius,96,paladin,retribution,6,1,5
Krulu,thrall,96,paladin,retribution,6,1,5
Inareus,agamaggan,96,paladin,retribution,6,1,5
Gazef,proudmoore,96,paladin,retribution,6,1,5
Clrty,area-52,96,paladin,retribution,6,1,5
Zealotry,tichondrius,96,paladin,retribution,6,1,5
Zulzander,kelthuzad,96,paladin,retribution,6,1,5
Cyniaria,moon-guard,96,paladin,retribution,6,1,5
Conámi,ragnaros,96,paladin,retribution,6,1,5
Mindfoolness,sargeras,96,paladin,retribution,6,1,5
Holyflopper,malganis,96,paladin,retribution,6,1,5
Chakin,burning-legion,96,paladin,retribution,6,1,5
Rynis,arthas,96,paladin,retribution,6,1,5
Lygophobia,frostmourne,96,paladin,retribution,6,1,5
Wwanntae,tichondrius,96,paladin,retribution,6,1,5
Holyclapzy,stormrage,96,paladin,retribution,6,1,5
Kamakazê,sargeras,96,paladin,retribution,6,1,5
Smudgexy,frostmourne,96,paladin,retribution,6,1,5
Fourwives,sargeras,96,paladin,retribution,6,1,5
Zwilliam,frostmourne,96,paladin,retribution,6,1,5
Narsys,tichondrius,96,paladin,retribution,6,1,5
Palajem,stormrage,96,paladin,retribution,6,1,5
Fknnoath,frostmourne,96,paladin,retribution,6,1,5
Volphorix,illidan,96,paladin,retribution,6,1,5
Marcovk,quelthalas,96,paladin,retribution,6,1,5
Dafoq,stormrage,96,paladin,retribution,6,1,5
Warhero,sargeras,96,paladin,retribution,6,1,5
Wantsome,frostmourne,96,paladin,retribution,6,1,5
Pugnacity,stormrage,96,paladin,retribution,6,1,5
Màli,akama,96,paladin,retribution,6,1,5
Aduhrawl,moon-guard,96,paladin,retribution,6,1,5
Cyona,gallywix,96,paladin,retribution,6,1,5
Lamer,proudmoore,96,paladin,retribution,6,1,5
Chainjustice,area-52,96,paladin,retribution,6,1,5
Thumos,sargeras,96,paladin,retribution,6,1,5
Kyuubî,bloodhoof,96,paladin,retribution,6,1,5
Javiermiléi,quelthalas,96,paladin,retribution,6,1,5
Rîf,malganis,96,paladin,retribution,6,1,5
Ahrieze,moon-guard,96,paladin,retribution,6,1,5
Rodt,dalaran,96,paladin,retribution,6,1,5
Valadinn,tichondrius,96,paladin,retribution,6,1,5
Miketavius,moon-guard,96,paladin,retribution,6,1,5
Rxes,frostmourne,96,paladin,retribution,6,1,5
Cupidxbye,tichondrius,96,paladin,retribution,6,1,5
Uzbadkhazad,ragnaros,96,paladin,retribution,6,1,5
Acpally,tichondrius,96,paladin,retribution,6,1,5
Wilmâ,ragnaros,96,paladin,retribution,6,1,5
Hólyélf,illidan,96,paladin,retribution,6,1,5
Killmönger,tichondrius,96,paladin,retribution,6,1,5
Poeboyz,stormrage,96,paladin,retribution,6,1,5
Ryudoshël,nemesis,96,paladin,retribution,6,1,5
Lelythia,bleeding-hollow,96,paladin,retribution,7,1,6
Hojpocketx,tichondrius,96,paladin,retribution,12,1,11
Lorenzojr,sargeras,96,paladin,retribution,12,1,11
Rimorse,illidan,96,paladin,retribution,12,1,11
Shamo,stormreaver,96,paladin,retribution,12,1,11
Astralweed,quelthalas,96,paladin,retribution,12,1,11
Æpaldin,tichondrius,96,paladin,retribution,12,1,11
Catholica,tichondrius,96,paladin,retribution,12,1,11
Hondacivicsi,mannoroth,96,paladin,retribution,12,1,11
Reinhardburm,quelthalas,96,paladin,retribution,12,1,11
Oshia,destromath,96,paladin,retribution,12,1,11
Nbtv,tichondrius,96,paladin,retribution,12,1,11
Malisaa,tichondrius,96,paladin,retribution,12,1,11
Yobnai,zuljin,96,paladin,retribution,12,1,11
Amerok,malfurion,95,paladin,retribution,12,1,11
Goldieg,tichondrius,79,paladin,retribution,5,1,4
Strabic,stormrage,79,paladin,retribution,5,1,4
Attkdmgcurry,illidan,79,paladin,retribution,5,1,4
Maverickxz,nemesis,79,paladin,retribution,5,1,4
Hivers,stormrage,79,paladin,retribution,11,1,10
Lawbandit,tichondrius,42,paladin,retribution,10,3,7
Eljefee,emerald-dream,42,paladin,retribution,11,3,8
Newwow,tichondrius,42,paladin,retribution,9,2,7
Nathaniel,galakrond,31,paladin,retribution,2,1,1
Epxilon,ragnaros,31,paladin,retribution,2,1,1
Paim,tol-barad,31,paladin,retribution,8,1,7
Kletüs,quelthalas,16,paladin,retribution,1,1,0
ßleider,quelthalas,1906,paladin,protection,55,39,16
Ëlmaster,nemesis,1815,paladin,protection,102,62,40
Kierolechita,ragnaros,1807,paladin,protection,118,63,55
Sutadansa,doomhammer,1791,paladin,protection,87,42,45
Zhspeilian,tichondrius,1730,paladin,protection,84,47,37
Eclipsor,bleeding-hollow,1679,paladin,protection,36,24,12
Vondonna,moon-guard,1665,paladin,protection,48,28,20
Lxwd,tichondrius,1655,paladin,protection,113,56,57
Aopidsfihjov,stormrage,1649,paladin,protection,42,30,12
Motates,malganis,1621,paladin,protection,54,25,29
Höpönpöppö,frostmourne,1589,paladin,protection,36,17,19
Zephyrvalor,sargeras,1525,paladin,protection,69,31,38
Chozverialyz,ysondre,1490,paladin,protection,62,27,35
Modafinil,bonechewer,1456,paladin,protection,87,42,45
Íaan,drakkari,1425,paladin,protection,58,38,20
Arcilys,illidan,1398,paladin,protection,60,29,31
Khrome,cenarion-circle,1347,paladin,protection,104,38,66
Domocho,azgalor,1315,paladin,protection,24,14,10
Jkethuhsnake,ghostlands,1278,paladin,protection,45,27,18
Thorsmites,sargeras,1273,paladin,protection,48,18,30
Lelythia,bleeding-hollow,1161,paladin,protection,65,25,40
Wowmike,sargeras,1050,paladin,protection,24,11,13
Rehtua,bleeding-hollow,958,paladin,protection,18,10,8
Ndnpaly,bonechewer,953,paladin,protection,12,10,2
Borrus,malygos,863,paladin,protection,18,9,9
Bighardshock,aggramar,768,paladin,protection,18,8,10
Crusâder,area-52,767,paladin,protection,24,8,16
Herimi,drakkari,766,paladin,protection,12,8,4
Halnoth,dethecus,702,paladin,protection,11,8,3
Dirkdigglerz,bleeding-hollow,670,paladin,protection,18,7,11
Kiehui,lightbringer,480,paladin,protection,12,5,7
Bullivan,sisters-of-elune,480,paladin,protection,12,5,7
Danthorin,malfurion,480,paladin,protection,12,5,7
Kittié,proudmoore,479,paladin,protection,18,5,13
Aluvia,malygos,384,paladin,protection,6,4,2
Belmorlin,moon-guard,384,paladin,protection,12,4,8
Gîmply,proudmoore,384,paladin,protection,12,4,8
Isecretly,stormrage,335,paladin,protection,7,7,0
Poorly,thorium-brotherhood,288,paladin,protection,6,3,3
Ronor,thorium-brotherhood,288,paladin,protection,6,3,3
Bt,quelthalas,288,paladin,protection,6,3,3
Bubblemark,tichondrius,288,paladin,protection,12,3,9
Saeranella,moon-guard,240,paladin,protection,9,3,6
Blâckhârt,saurfang,234,paladin,protection,9,4,5
Almeta,kelthuzad,192,paladin,protection,6,2,4
Lewstelamon,korialstrasz,192,paladin,protection,6,2,4
Xinqingle,tichondrius,192,paladin,protection,6,2,4
Consecrated,daggerspine,192,paladin,protection,12,2,10
Holyknight,veknilash,96,paladin,protection,8,2,6
Bullmarket,tichondrius,96,paladin,protection,6,1,5
Yötönyö,sargeras,2082,priest,holy,114,57,57
Fluent,emerald-dream,2051,priest,holy,90,47,43
Dogbutt,burning-legion,1996,priest,holy,222,111,111
Zenelu,tichondrius,1934,priest,holy,80,44,36
Priestlike,tichondrius,1915,priest,holy,81,42,39
Tirrify,frostmourne,1899,priest,holy,54,29,25
Fusira,gurubashi,1894,priest,holy,36,20,16
Pianohouse,illidan,1893,priest,holy,54,29,25
Jjmms,akama,1867,priest,holy,72,45,27
Peat,hyjal,1844,priest,holy,54,27,27
Superduperr,illidan,1840,priest,holy,66,33,33
Gerpe,stormrage,1838,priest,holy,177,100,77
Onikûdaki,sargeras,1835,priest,holy,80,35,45
Mastuti,azralon,1817,priest,holy,59,27,32
Iniquitatem,tichondrius,1817,priest,holy,60,23,37
Tromnasty,area-52,1816,priest,holy,90,53,37
Cinnalite,darkspear,1813,priest,holy,36,26,10
Lëønë,nemesis,1813,priest,holy,88,62,26
Sweatynick,proudmoore,1813,priest,holy,227,109,118
Bloodlinex,malganis,1806,priest,holy,171,102,69
Ninbara,tichondrius,1806,priest,holy,96,46,50
Murkd,tichondrius,1804,priest,holy,145,68,77
Immthuggin,tichondrius,1780,priest,holy,102,43,59
Moonideli,moon-guard,1765,priest,holy,72,36,36
Vandalia,shadowsong,1760,priest,holy,94,42,52
Cheekypriest,stormrage,1747,priest,holy,54,25,29
Heavyflo,kelthuzad,1746,priest,holy,96,49,47
Dreckie,sargeras,1730,priest,holy,72,33,39
Wøo,area-52,1727,priest,holy,135,75,60
Hyouka,area-52,1725,priest,holy,133,68,65
Saintjpii,tichondrius,1715,priest,holy,84,50,34
Zazul,frostmane,1710,priest,holy,95,54,41
Goodlife,frostmourne,1687,priest,holy,95,43,52
Geoffrred,illidan,1686,priest,holy,54,21,33
Rustymvp,nagrand,1685,priest,holy,38,19,19
Gaudthree,tichondrius,1675,priest,holy,48,26,22
Óst,tichondrius,1673,priest,holy,42,18,24
Citrinesta,illidan,1667,priest,holy,143,88,55
Gill,proudmoore,1663,priest,holy,98,48,50
Candohp,frostmourne,1653,priest,holy,36,18,18
Bopang,emerald-dream,1638,priest,holy,59,27,32
Punkndrublic,sargeras,1624,priest,holy,78,40,38
Soloqqt,tichondrius,1622,priest,holy,36,21,15
Washdp,frostmourne,1621,priest,holy,48,21,27
Leoshi,turalyon,1615,priest,holy,36,21,15
Bubbles,drakthul,1611,priest,holy,184,94,90
Soaphia,kelthuzad,1599,priest,holy,88,48,40
Snowymooie,frostmourne,1586,priest,holy,42,19,23
Sacrifer,moon-guard,1570,priest,holy,84,45,39
Matthiass,thrall,1570,priest,holy,65,33,32
Cerebrill,bleeding-hollow,1557,priest,holy,45,22,23
Wankenobi,stormrage,1544,priest,holy,84,39,45
Avis,illidan,1539,priest,holy,110,54,56
Tòxìç,stormrage,1526,priest,holy,67,40,27
Nielbomb,tichondrius,1512,priest,holy,180,88,92
Sukeena,malganis,1510,priest,holy,54,23,31
Bestgirlna,area-52,1509,priest,holy,30,16,14
Applepieyum,illidan,1508,priest,holy,42,19,23
Chervz,chogall,1503,priest,holy,42,18,24
Tranquilty,tichondrius,1501,priest,holy,72,31,41
Giveheadpats,moon-guard,1492,priest,holy,152,74,78
Cryptron,tichondrius,1487,priest,holy,48,16,32
Xedus,mannoroth,1485,priest,holy,62,28,34
Tazzi,chromaggus,1479,priest,holy,42,17,25
Symbolofhope,moon-guard,1474,priest,holy,45,20,25
Illyasviel,terenas,1472,priest,holy,103,41,62
Heluupa,illidan,1467,priest,holy,50,36,14
Soleyxo,frostmourne,1463,priest,holy,36,21,15
Owlchubz,mannoroth,1445,priest,holy,48,20,28
Dawnside,wyrmrest-accord,1436,priest,holy,136,84,52
Reverenced,stormrage,1432,priest,holy,54,34,20
Mizzbehavn,tichondrius,1430,priest,holy,44,24,20
Pesca,proudmoore,1429,priest,holy,36,15,21
Edmen,stormrage,1427,priest,holy,66,30,36
Artiannaa,bleeding-hollow,1423,priest,holy,51,32,19
Anguishment,stormrage,1416,priest,holy,153,73,80
Rihen,tichondrius,1413,priest,holy,79,33,46
Plebiss,burning-blade,1410,priest,holy,108,54,54
Soapfan,kelthuzad,1400,priest,holy,60,26,34
Mkenze,moon-guard,1386,priest,holy,102,47,55
Icychain,area-52,1385,priest,holy,29,15,14
Holyshytt,tichondrius,1381,priest,holy,49,28,21
Akaneo,tichondrius,1380,priest,holy,36,18,18
Methodist,proudmoore,1374,priest,holy,78,28,50
Kovaxx,frostmourne,1373,priest,holy,76,33,43
Sabene,greymane,1364,priest,holy,91,44,47
Littlebat,proudmoore,1361,priest,holy,54,28,26
Heist,kelthuzad,1353,priest,holy,26,16,10
Quartzolio,azralon,1347,priest,holy,53,32,21
Sappes,area-52,1346,priest,holy,54,27,27
Tookiex,stormrage,1343,priest,holy,30,14,16
Eccentricx,sargeras,1342,priest,holy,24,14,10
Lilyxo,bleeding-hollow,1339,priest,holy,30,14,16
Nanatoo,sargeras,1338,priest,holy,30,14,16
Trufumthunzi,illidan,1330,priest,holy,26,17,9
Xinferesia,sargeras,1330,priest,holy,55,23,32
Shaldra,bleeding-hollow,1326,priest,holy,85,52,33
Handsumheals,kiljaeden,1322,priest,holy,24,14,10
Strivedaily,proudmoore,1314,priest,holy,31,14,17
Ayanamil,tichondrius,1310,priest,holy,38,29,9
Ksâh,bleeding-hollow,1309,priest,holy,36,17,19
Esvary,quelthalas,1306,priest,holy,56,30,26
Xrafa,azralon,1301,priest,holy,84,38,46
Raskreia,dragonmaw,1268,priest,holy,30,14,16
Threesclass,tichondrius,1262,priest,holy,29,14,15
Lexiié,area-52,1261,priest,holy,49,28,21
Preacherr,bonechewer,1256,priest,holy,24,14,10
Bjorke,tichondrius,1247,priest,holy,30,13,17
Animè,zuluhed,1243,priest,holy,30,20,10
Cruxave,aegwynn,1243,priest,holy,28,14,14
Zerolimitzz,arthas,1240,priest,holy,42,20,22
Mercý,zuljin,1235,priest,holy,36,20,16
Joeschmoe,proudmoore,1235,priest,holy,24,13,11
Aiwa,winterhoof,1229,priest,holy,18,13,5
Dagaen,thunderlord,1229,priest,holy,138,69,69
Rebirthed,kelthuzad,1222,priest,holy,79,39,40
Cléah,sargeras,1218,priest,holy,107,49,58
Firewatcher,sisters-of-elune,1214,priest,holy,30,17,13
Kostantina,kelthuzad,1214,priest,holy,30,15,15
Spriest,kul-tiras,1211,priest,holy,53,26,27
Veltaxis,moon-guard,1205,priest,holy,56,27,29
Dóctóre,thrall,1205,priest,holy,61,24,37
Stayhealed,tichondrius,1201,priest,holy,45,22,23
Chemod,quelthalas,1201,priest,holy,29,14,15
Kytiana,blackwing-lair,1200,priest,holy,215,106,109
Ranøth,deathwing,1197,priest,holy,53,24,29
Theophobe,illidan,1190,priest,holy,79,42,37
Pílí,drakkari,1174,priest,holy,54,24,30
Valkur,aegwynn,1170,priest,holy,60,24,36
Kälashnikova,ragnaros,1165,priest,holy,89,42,47
Haushauha,azralon,1164,priest,holy,48,23,25
Leonihpriest,nemesis,1151,priest,holy,30,12,18
Trompiscola,quelthalas,1151,priest,holy,30,12,18
Etros,wyrmrest-accord,1150,priest,holy,72,29,43
Iluvthgnmicz,sargeras,1148,priest,holy,24,12,12
Meiev,quelthalas,1139,priest,holy,24,12,12
Benjamints,thrall,1124,priest,holy,24,12,12
Dactylion,moon-guard,1119,priest,holy,24,12,12
Niná,arathor,1114,priest,holy,20,13,7
Zojhira,khazgoroth,1114,priest,holy,66,32,34
Artemix,azralon,1109,priest,holy,42,17,25
Selket,stormscale,1107,priest,holy,66,26,40
Floppytatas,illidan,1102,priest,holy,75,34,41
Maiyennefer,proudmoore,1097,priest,holy,28,12,16
Mavuiss,barthilas,1069,priest,holy,25,12,13
Tarlex,illidan,1068,priest,holy,31,12,19
Minipriest,sargeras,1055,priest,holy,24,11,13
Scyner,bleeding-hollow,1052,priest,holy,24,11,13
Dotdotdead,earthen-ring,1049,priest,holy,18,11,7
Arçhángël,moon-guard,1048,priest,holy,18,11,7
Vampiric,laughing-skull,1047,priest,holy,18,11,7
Dylirium,dathremar,1044,priest,holy,18,11,7
Holyb,tichondrius,1040,priest,holy,24,11,13
Droneboy,moon-guard,1037,priest,holy,24,11,13
Sanaconda,sargeras,1035,priest,holy,30,11,19
Holiermilk,demon-soul,1033,priest,holy,140,57,83
Seråphim,sargeras,1013,priest,holy,36,20,16
Sybenela,proudmoore,994,priest,holy,61,28,33
Djdazzle,kargath,991,priest,holy,23,11,12
Galadrael,quelthalas,988,priest,holy,29,13,16
Healgirls,dalaran,980,priest,holy,29,12,17
Ragekiller,lothar,962,priest,holy,42,19,23
Jameswarren,silvermoon,959,priest,holy,11,11,0
Krobs,bleeding-hollow,959,priest,holy,18,10,8
Iaptop,tichondrius,958,priest,holy,18,10,8
Phearix,zuljin,957,priest,holy,24,10,14
Adrenalinn,illidan,955,priest,holy,18,10,8
Pottime,tichondrius,955,priest,holy,24,10,14
Cappoo,tichondrius,955,priest,holy,36,10,26
Delthas,nagrand,952,priest,holy,124,60,64
Dovoso,kargath,951,priest,holy,26,10,16
Taylorsmites,emerald-dream,935,priest,holy,30,12,18
Souljourner,stormrage,930,priest,holy,18,10,8
Dipanddøts,area-52,926,priest,holy,17,10,7
Rustymvpfan,nagrand,864,priest,holy,18,9,9
Pws,azralon,864,priest,holy,18,9,9
Dioecesis,moon-guard,864,priest,holy,29,9,20
Holyxb,bleeding-hollow,863,priest,holy,18,9,9
Lickless,illidan,863,priest,holy,18,9,9
Glöws,area-52,863,priest,holy,24,9,15
Falsegodx,tichondrius,863,priest,holy,24,9,15
Berzum,chogall,862,priest,holy,18,9,9
Discospider,sargeras,861,priest,holy,18,9,9
Fanseband,dalaran,860,priest,holy,12,9,3
Padreamarol,ragnaros,859,priest,holy,18,9,9
Nowwow,tichondrius,854,priest,holy,24,9,15
Sondrak,doomhammer,846,priest,holy,41,16,25
Psïren,quelthalas,831,priest,holy,28,9,19
ßsimp,darrowmere,799,priest,holy,26,9,17
Stennic,emerald-dream,795,priest,holy,16,9,7
Gbumy,tichondrius,784,priest,holy,13,9,4
Turnip,zuljin,768,priest,holy,12,8,4
Tookz,stormrage,768,priest,holy,12,8,4
Fotmtrash,the-underbog,768,priest,holy,12,8,4
Voidzx,tichondrius,768,priest,holy,18,8,10
Khalesî,ragnaros,767,priest,holy,12,8,4
Zeroo,maiev,765,priest,holy,12,8,4
Msdash,tichondrius,717,priest,holy,15,8,7
Jaytee,aggramar,703,priest,holy,14,9,5
Iilmama,area-52,672,priest,holy,12,7,5
Santyel,ragnaros,672,priest,holy,12,7,5
Onemission,whisperwind,672,priest,holy,18,7,11
Tylexus,tichondrius,672,priest,holy,18,7,11
Jordandoesnt,tichondrius,671,priest,holy,12,7,5
Deidre,illidan,671,priest,holy,16,8,8
Braevera,wyrmrest-accord,671,priest,holy,18,7,11
Novous,area-52,670,priest,holy,18,7,11
Hycinamun,malganis,670,priest,holy,18,7,11
Boboxiao,illidan,655,priest,holy,23,7,16
Punishing,illidan,606,priest,holy,16,7,9
Papadarkness,tichondrius,603,priest,holy,14,7,7
Pikachuwu,moon-guard,586,priest,holy,11,7,4
Oxynor,zuljin,576,priest,holy,12,6,6
Jezebëll,nemesis,576,priest,holy,12,6,6
Doob,ghostlands,576,priest,holy,12,6,6
Kaelthos,quelthalas,576,priest,holy,12,6,6
Folate,frostmourne,576,priest,holy,12,6,6
Sigx,area-52,576,priest,holy,12,6,6
Hysteria,dalaran,576,priest,holy,12,6,6
Skylust,azralon,576,priest,holy,12,6,6
Suirr,tichondrius,576,priest,holy,18,6,12
Oyy,barthilas,576,priest,holy,18,6,12
Musashibo,kelthuzad,576,priest,holy,18,6,12
Griddly,alterac-mountains,576,priest,holy,25,6,19
Bismund,chogall,575,priest,holy,12,6,6
Darkheals,azralon,575,priest,holy,12,6,6
Necroplasma,area-52,575,priest,holy,12,6,6
Kephrek,eonar,575,priest,holy,18,6,12
Daisie,bleeding-hollow,574,priest,holy,12,6,6
Veni,kiljaeden,574,priest,holy,18,6,12
Soulhealer,shadowmoon,572,priest,holy,12,6,6
Aldryth,lightbringer,571,priest,holy,12,6,6
Zual,hakkar,569,priest,holy,12,6,6
Pipelayerx,illidan,527,priest,holy,11,6,5
Deathrina,moon-guard,519,priest,holy,21,7,14
Xanky,frostmourne,511,priest,holy,10,6,4
Soulghast,gorefiend,480,priest,holy,6,5,1
Archbishop,stormscale,480,priest,holy,6,5,1
Dylbags,frostmourne,480,priest,holy,6,5,1
Canibumsmoke,illidan,480,priest,holy,6,5,1
Elbowbeans,tichondrius,480,priest,holy,10,6,4
Timbobaloo,thrall,480,priest,holy,12,5,7
Endure,moon-guard,480,priest,holy,12,5,7
Ukizeal,moknathal,480,priest,holy,12,5,7
Hotguysixpak,drakthul,480,priest,holy,12,5,7
Chadopri,stormrage,480,priest,holy,12,5,7
Tytusx,stormrage,480,priest,holy,12,5,7
Maelei,ragnaros,480,priest,holy,12,5,7
Cardinalpéll,frostmourne,480,priest,holy,12,5,7
Kernelious,illidan,480,priest,holy,12,5,7
Snookp,kiljaeden,480,priest,holy,12,5,7
Selidri,proudmoore,480,priest,holy,12,5,7
Lieuwe,kelthuzad,479,priest,holy,6,5,1
Klassa,thrall,479,priest,holy,11,6,5
Adjectives,nerzhul,479,priest,holy,12,5,7
Unni,azralon,479,priest,holy,18,5,13
Shadowchárm,bleeding-hollow,447,priest,holy,11,5,6
Illooj,eonar,447,priest,holy,11,5,6
Cokeheals,kelthuzad,384,priest,holy,6,4,2
ßeautiful,sargeras,384,priest,holy,6,4,2
Yav,exodar,384,priest,holy,6,4,2
Dadcantdeath,frostmourne,384,priest,holy,6,4,2
Chanyt,azralon,384,priest,holy,6,4,2
Schátten,spirestone,384,priest,holy,6,4,2
Xusin,tichondrius,384,priest,holy,6,4,2
Patchyemoly,frostmourne,384,priest,holy,6,4,2
Flemyth,eitrigg,384,priest,holy,6,4,2
Dankpope,malganis,384,priest,holy,6,4,2
Manatea,moon-guard,384,priest,holy,12,4,8
Hoglet,moon-guard,384,priest,holy,12,4,8
Giusep,tichondrius,384,priest,holy,12,4,8
Sätîvá,tichondrius,384,priest,holy,12,4,8
Clarify,arathor,384,priest,holy,12,4,8
Döyöuliftbro,tichondrius,384,priest,holy,12,4,8
Hynzor,barthilas,384,priest,holy,24,4,20
Jol,aggramar,383,priest,holy,6,4,2
Dyianah,wyrmrest-accord,383,priest,holy,12,4,8
Holyfizzle,dethecus,382,priest,holy,6,4,2
Blackprez,dathremar,381,priest,holy,12,4,8
Hatxsu,emerald-dream,372,priest,holy,22,8,14
Stradey,tichondrius,367,priest,holy,11,4,7
Sharkda,frostmourne,350,priest,holy,17,4,13
Smellybox,area-52,336,priest,holy,9,4,5
Santamuerte,agamaggan,336,priest,holy,15,4,11
Yidra,illidan,335,priest,holy,11,4,7
Edessa,lothar,335,priest,holy,17,4,13
Qtasiangirl,emerald-dream,330,priest,holy,21,5,16
Boogiedo,area-52,319,priest,holy,5,4,1
Raphan,stormrage,288,priest,holy,6,3,3
Smiteyducks,stormrage,288,priest,holy,6,3,3
Meatboxmoldy,blood-furnace,288,priest,holy,6,3,3
Laurens,fenris,288,priest,holy,6,3,3
Dypkillet,moon-guard,288,priest,holy,6,3,3
Toje,korgath,288,priest,holy,6,3,3
Swrvlol,emerald-dream,288,priest,holy,6,3,3
Purgeoften,sargeras,288,priest,holy,6,3,3
Becrixx,thunderlord,288,priest,holy,6,3,3
Discountay,burning-legion,288,priest,holy,6,3,3
Estaria,the-forgotten-coast,288,priest,holy,6,3,3
Xoraya,proudmoore,288,priest,holy,6,3,3
Grindr,ragnaros,288,priest,holy,6,3,3
Orderic,ragnaros,288,priest,holy,6,3,3
Ñÿx,arthas,288,priest,holy,6,3,3
Vynlanesh,illidan,288,priest,holy,6,3,3
Duonaiameng,illidan,288,priest,holy,6,3,3
Celinsa,ragnaros,288,priest,holy,6,3,3
Nerfdisc,azralon,288,priest,holy,6,3,3
Zesho,firetree,288,priest,holy,6,3,3
Xtcbtc,sargeras,288,priest,holy,6,3,3
Wubbi,blackrock,288,priest,holy,6,3,3
Charbosan,gorgonnash,288,priest,holy,6,3,3
Madomie,bladefist,288,priest,holy,6,3,3
Swis,area-52,288,priest,holy,12,3,9
Jezuz,aerie-peak,288,priest,holy,12,3,9
Lalight,tichondrius,288,priest,holy,12,3,9
Ísábella,ragnaros,288,priest,holy,12,3,9
Irilde,proudmoore,288,priest,holy,12,3,9
Smitepie,malganis,288,priest,holy,12,3,9
Disperse,vashj,288,priest,holy,12,3,9
Pringlés,suramar,288,priest,holy,18,3,15
Korhíl,ragnaros,287,priest,holy,6,3,3
Healztonic,dalaran,239,priest,holy,5,3,2
Ftheman,tichondrius,234,priest,holy,17,4,13
Gles,quelthalas,192,priest,holy,6,2,4
Rylance,burning-blade,192,priest,holy,6,2,4
Wagnerr,jubeithos,192,priest,holy,6,2,4
Gusho,frostmourne,192,priest,holy,6,2,4
Mommyafk,moon-guard,192,priest,holy,6,2,4
Spïcÿ,frostmourne,192,priest,holy,6,2,4
Dolandir,quelthalas,192,priest,holy,6,2,4
Igotubrah,malganis,192,priest,holy,6,2,4
Xeras,ravencrest,192,priest,holy,6,2,4
Mindgoblin,terokkar,192,priest,holy,6,2,4
Twodxo,kelthuzad,192,priest,holy,6,2,4
Priesttess,skullcrusher,192,priest,holy,6,2,4
Verboden,kelthuzad,192,priest,holy,6,2,4
Whalexo,kelthuzad,192,priest,holy,6,2,4
Hypodontia,caelestrasz,192,priest,holy,6,2,4
Mendx,tichondrius,192,priest,holy,6,2,4
Sinthe,stormrage,192,priest,holy,6,2,4
Holynug,stormrage,192,priest,holy,6,2,4
Jilt,aerie-peak,192,priest,holy,6,2,4
Voltstein,dalaran,192,priest,holy,6,2,4
Releknosleep,frostwolf,192,priest,holy,6,2,4
Pancakeboi,tichondrius,192,priest,holy,6,2,4
Belfortx,tichondrius,192,priest,holy,6,2,4
Ôp,sargeras,192,priest,holy,6,2,4
Fraggydaddy,frostmourne,192,priest,holy,12,2,10
Merellia,moon-guard,192,priest,holy,12,2,10
Fertalize,maiev,192,priest,holy,12,2,10
Rootandboot,frostmourne,192,priest,holy,12,2,10
Remixcandoit,malganis,191,priest,holy,6,2,4
Satíva,dark-iron,159,priest,holy,5,2,3
Pumpss,area-52,138,priest,holy,11,3,8
Plzhelp,cairne,136,priest,holy,9,3,6
Kabutta,stormrage,127,priest,holy,8,2,6
Frozencherry,elune,96,priest,holy,6,1,5
Dmgisop,illidan,96,priest,holy,6,1,5
Alëssana,illidan,96,priest,holy,6,1,5
Janova,tichondrius,96,priest,holy,6,1,5
Kagura,dunemaul,96,priest,holy,6,1,5
Qnarisha,tichondrius,96,priest,holy,6,1,5
Minamy,tichondrius,96,priest,holy,6,1,5
Alaskaa,moon-guard,96,priest,holy,6,1,5
Burtier,zuljin,96,priest,holy,6,1,5
Lilpaprika,sargeras,96,priest,holy,6,1,5
Hüde,stormrage,96,priest,holy,6,1,5
Tammyone,emerald-dream,96,priest,holy,6,1,5
Angelicduck,illidan,96,priest,holy,6,1,5
Celani,gilneas,96,priest,holy,6,1,5
Missjules,illidan,96,priest,holy,6,1,5
Shadyvoodoo,barthilas,96,priest,holy,6,1,5
Øliverxp,lightbringer,96,priest,holy,6,1,5
Badgoy,dalaran,96,priest,holy,6,1,5
Barryp,wyrmrest-accord,96,priest,holy,12,1,11
Gillís,thrall,96,priest,holy,12,1,11
Djriest,sargeras,96,priest,holy,12,1,11
Brownsnooter,sargeras,79,priest,holy,5,1,4
Helorren,nagrand,79,priest,holy,11,1,10
Halö,doomhammer,31,priest,holy,8,1,7
Èfflux,sargeras,2252,priest,discipline,97,56,41
Whammiez,tichondrius,2243,priest,discipline,84,50,34
Strickmaney,nathrezim,2155,priest,discipline,216,114,102
Pesian,dalaran,2153,priest,discipline,233,121,112
Ante,stonemaul,2144,priest,discipline,97,56,41
Cinnamontage,illidan,2142,priest,discipline,114,64,50
Castsmite,tichondrius,2141,priest,discipline,99,52,47
Shikinomi,illidan,2133,priest,discipline,78,46,32
Nusrah,tichondrius,2114,priest,discipline,87,45,42
Kovulol,area-52,2107,priest,discipline,126,67,59
Woolp,frostmourne,2102,priest,discipline,100,58,42
Søryn,madoran,2100,priest,discipline,102,52,50
Classmaster,stormrage,2082,priest,discipline,159,90,69
Esqueue,illidan,2044,priest,discipline,54,26,28
Redonkulos,shattered-hand,2036,priest,discipline,133,71,62
Smokezter,area-52,2031,priest,discipline,87,47,40
Gentlewoman,ragnaros,2030,priest,discipline,70,41,29
Zxxkawaii,tichondrius,2029,priest,discipline,148,78,70
Markers,spinebreaker,2023,priest,discipline,102,51,51
Crutched,blackhand,2022,priest,discipline,60,35,25
Zámmy,area-52,2021,priest,discipline,65,44,21
Praeyer,area-52,2017,priest,discipline,184,98,86
Sÿnpriest,illidan,2016,priest,discipline,252,127,125
Mauvex,stormrage,2011,priest,discipline,181,87,94
Cosmicyiff,area-52,2010,priest,discipline,100,57,43
Fádé,illidan,2003,priest,discipline,67,41,26
Reilacoste,moon-guard,2002,priest,discipline,83,41,42
Iilmama,area-52,1996,priest,discipline,93,51,42
Proxs,sargeras,1995,priest,discipline,201,101,100
Sonicboomsz,azralon,1994,priest,discipline,92,47,45
Hospetal,tichondrius,1981,priest,discipline,87,46,41
Instoway,illidan,1977,priest,discipline,144,84,60
Idkmyname,proudmoore,1974,priest,discipline,46,26,20
Penanceperry,bleeding-hollow,1973,priest,discipline,131,60,71
Amine,tichondrius,1970,priest,discipline,60,34,26
Astüty,illidan,1967,priest,discipline,66,37,29
Abepriest,zuljin,1964,priest,discipline,204,106,98
Crabsp,illidan,1962,priest,discipline,90,44,46
Likethis,ragnaros,1959,priest,discipline,83,46,37
Rukiyou,frostwolf,1957,priest,discipline,84,37,47
Changwongpk,kelthuzad,1956,priest,discipline,178,88,90
Quaree,stormrage,1951,priest,discipline,255,139,116
Miamama,hydraxis,1943,priest,discipline,70,41,29
Gotdro,kelthuzad,1942,priest,discipline,68,36,32
Mimikyú,tichondrius,1941,priest,discipline,96,41,55
Gosharbg,tichondrius,1940,priest,discipline,34,24,10
Goodlife,frostmourne,1936,priest,discipline,65,30,35
Ccgo,tichondrius,1933,priest,discipline,84,42,42
Duw,icecrown,1930,priest,discipline,133,69,64
Praitne,tichondrius,1926,priest,discipline,71,37,34
Poporeborn,tichondrius,1926,priest,discipline,105,48,57
Indiglo,arthas,1925,priest,discipline,60,37,23
Balsak,zuljin,1924,priest,discipline,152,72,80
Pancakeboi,tichondrius,1923,priest,discipline,83,35,48
Thefiveoh,malganis,1914,priest,discipline,27,23,4
Haunting,nerzhul,1914,priest,discipline,159,79,80
Artíst,sargeras,1911,priest,discipline,119,64,55
Varenon,stormrage,1910,priest,discipline,159,90,69
Omhz,tichondrius,1910,priest,discipline,78,40,38
Frksake,area-52,1908,priest,discipline,132,83,49
Adûnaic,frostmourne,1908,priest,discipline,124,59,65
Twocrshort,area-52,1903,priest,discipline,65,42,23
Evicereith,ragnaros,1896,priest,discipline,42,25,17
Pølupoker,illidan,1895,priest,discipline,59,27,32
Boriz,frostmourne,1892,priest,discipline,79,44,35
Notatk,tichondrius,1891,priest,discipline,151,66,85
Zerorizz,tichondrius,1890,priest,discipline,42,20,22
Ndzy,malganis,1890,priest,discipline,48,21,27
Meoveryou,stormrage,1884,priest,discipline,74,43,31
Usefirstaid,sargeras,1883,priest,discipline,42,26,16
Usedwrap,sargeras,1881,priest,discipline,78,43,35
Throatgoated,moon-guard,1881,priest,discipline,47,21,26
Fatbellyx,sargeras,1877,priest,discipline,60,34,26
Budings,tichondrius,1874,priest,discipline,95,51,44
Rileymcgerr,tichondrius,1873,priest,discipline,42,24,18
Mumrah,antonidas,1873,priest,discipline,113,56,57
Shieldspamx,tichondrius,1873,priest,discipline,71,33,38
Dellaptop,sargeras,1871,priest,discipline,88,51,37
Dayx,malganis,1870,priest,discipline,60,27,33
Hamstip,sargeras,1868,priest,discipline,36,26,10
Alisas,malganis,1868,priest,discipline,65,27,38
Sarkozzlol,tichondrius,1867,priest,discipline,78,37,41
Lidoradra,zuljin,1867,priest,discipline,77,36,41
Elybele,sargeras,1863,priest,discipline,81,46,35
Cokeheals,tichondrius,1861,priest,discipline,60,29,31
Reecepack,moon-guard,1859,priest,discipline,53,31,22
Frostinal,illidan,1858,priest,discipline,72,39,33
Highskrizzle,thrall,1857,priest,discipline,67,37,30
Jjmms,akama,1857,priest,discipline,114,59,55
Spoõks,darkspear,1857,priest,discipline,117,57,60
Phludd,malganis,1856,priest,discipline,82,45,37
ßeyonder,tichondrius,1855,priest,discipline,60,27,33
Vidzar,area-52,1854,priest,discipline,42,28,14
Drsquiddy,tichondrius,1854,priest,discipline,47,30,17
Cardinaldave,frostmourne,1850,priest,discipline,48,26,22
Exdric,kiljaeden,1849,priest,discipline,66,34,32
Awàken,sargeras,1848,priest,discipline,45,29,16
Bigshieldlol,illidan,1847,priest,discipline,60,39,21
Tzïñåçåñ,tichondrius,1847,priest,discipline,54,29,25
Clearclouds,tichondrius,1845,priest,discipline,95,47,48
Cavityx,illidan,1844,priest,discipline,52,30,22
Jiangfenglol,tichondrius,1843,priest,discipline,54,24,30
Invincible,ragnaros,1842,priest,discipline,42,26,16
Zelená,trollbane,1841,priest,discipline,128,77,51
Syliva,frostmourne,1840,priest,discipline,65,30,35
Yanye,tichondrius,1839,priest,discipline,103,53,50
Koalakazamza,shadow-council,1839,priest,discipline,62,28,34
Shamáng,tichondrius,1838,priest,discipline,62,33,29
Didy,dark-iron,1838,priest,discipline,40,20,20
Aitri,hakkar,1838,priest,discipline,61,30,31
Lotion,icecrown,1837,priest,discipline,48,25,23
Namilol,tichondrius,1836,priest,discipline,42,22,20
Vaaynee,ragnaros,1835,priest,discipline,96,53,43
Jamino,jubeithos,1835,priest,discipline,111,60,51
Tmeugene,tichondrius,1835,priest,discipline,40,21,19
Shazdo,illidan,1834,priest,discipline,42,29,13
Thottsteal,queldorei,1834,priest,discipline,60,31,29
Ameliarys,sargeras,1833,priest,discipline,103,51,52
Msai,tichondrius,1830,priest,discipline,114,68,46
Nayzoh,darkspear,1830,priest,discipline,72,33,39
Lemonmint,tichondrius,1829,priest,discipline,58,28,30
Misatomori,tichondrius,1828,priest,discipline,54,28,26
Eluneslight,tichondrius,1827,priest,discipline,60,30,30
Fracxured,sargeras,1827,priest,discipline,68,31,37
Stepxo,sargeras,1826,priest,discipline,72,34,38
Bloodyxx,bleeding-hollow,1825,priest,discipline,34,23,11
Cpks,tichondrius,1825,priest,discipline,70,45,25
Buffle,zuluhed,1825,priest,discipline,66,38,28
Yokuz,thunderlord,1825,priest,discipline,48,26,22
Rosaparksxo,sargeras,1825,priest,discipline,66,35,31
Mackulate,tichondrius,1825,priest,discipline,65,34,31
Chk,moon-guard,1825,priest,discipline,88,41,47
Pnsp,perenolde,1824,priest,discipline,42,30,12
Anasuzana,stormrage,1824,priest,discipline,48,28,20
Cya,deathwing,1824,priest,discipline,54,30,24
Senzy,tichondrius,1824,priest,discipline,144,79,65
Swurvexo,bleeding-hollow,1823,priest,discipline,47,28,19
Valothrian,area-52,1823,priest,discipline,124,67,57
Sprankels,bleeding-hollow,1823,priest,discipline,108,55,53
Dairy,the-underbog,1822,priest,discipline,49,29,20
Zachon,sargeras,1822,priest,discipline,54,27,27
Etharass,illidan,1822,priest,discipline,54,26,28
Oohso,chogall,1821,priest,discipline,91,43,48
Ultrà,ragnaros,1820,priest,discipline,71,44,27
Wreklol,tichondrius,1820,priest,discipline,60,34,26
Ujelin,kiljaeden,1820,priest,discipline,48,24,24
Soojwa,frostmourne,1819,priest,discipline,54,24,30
Demaholy,illidan,1817,priest,discipline,89,50,39
Akuzaki,illidan,1817,priest,discipline,54,25,29
Lichtschreit,zuljin,1816,priest,discipline,41,24,17
Baldzx,sargeras,1816,priest,discipline,86,48,38
Woodowl,tichondrius,1816,priest,discipline,46,25,21
Jackski,nemesis,1816,priest,discipline,48,25,23
Discopenguin,kelthuzad,1815,priest,discipline,54,30,24
Jezebëll,nemesis,1815,priest,discipline,168,91,77
Engle,arathor,1815,priest,discipline,42,22,20
Ousïa,quelthalas,1815,priest,discipline,164,81,83
Khaoshealer,destromath,1815,priest,discipline,96,44,52
Mommyafk,moon-guard,1815,priest,discipline,48,22,26
Abt,proudmoore,1815,priest,discipline,60,27,33
Fullmetals,azralon,1814,priest,discipline,53,30,23
Tanmo,illidan,1814,priest,discipline,96,50,46
Razdaz,twisting-nether,1814,priest,discipline,66,29,37
Relicx,firetree,1813,priest,discipline,54,33,21
Morboo,proudmoore,1813,priest,discipline,78,43,35
Svzy,illidan,1813,priest,discipline,48,26,22
Shnozberry,tichondrius,1813,priest,discipline,90,38,52
Psyjes,stormrage,1812,priest,discipline,90,58,32
Shallwedance,tichondrius,1812,priest,discipline,44,26,18
Tyrrdisc,skywall,1811,priest,discipline,104,58,46
Kostantina,kelthuzad,1811,priest,discipline,88,41,47
Wübbie,emerald-dream,1810,priest,discipline,72,40,32
Memoria,emerald-dream,1810,priest,discipline,72,37,35
Mancito,mannoroth,1810,priest,discipline,96,49,47
Arguseonp,proudmoore,1809,priest,discipline,54,37,17
Thepumps,sargeras,1809,priest,discipline,73,43,30
Paramour,laughing-skull,1809,priest,discipline,108,59,49
Dabaojian,tichondrius,1809,priest,discipline,60,28,32
Vbear,dunemaul,1808,priest,discipline,71,39,32
Pkkdestiny,archimonde,1808,priest,discipline,71,37,34
Luhkx,stormrage,1808,priest,discipline,48,24,24
Hazzang,tichondrius,1807,priest,discipline,54,32,22
Dopeypriest,area-52,1807,priest,discipline,120,68,52
Gices,area-52,1806,priest,discipline,36,24,12
Ayakashi,frostmourne,1806,priest,discipline,75,46,29
Wormface,moon-guard,1806,priest,discipline,58,35,23
Releriel,area-52,1806,priest,discipline,58,31,27
Yezhua,zuljin,1806,priest,discipline,84,44,40
Forti,sargeras,1806,priest,discipline,114,57,57
Bubblekanush,tichondrius,1805,priest,discipline,30,19,11
Rylla,illidan,1805,priest,discipline,66,34,32
Öxhö,tichondrius,1804,priest,discipline,44,31,13
Ðsco,tichondrius,1804,priest,discipline,36,24,12
Absorbs,stormrage,1804,priest,discipline,30,19,11
Fearmen,tichondrius,1804,priest,discipline,59,33,26
Selath,ragnaros,1804,priest,discipline,47,26,21
Angelumlucis,frostmane,1804,priest,discipline,145,80,65
Astroverse,tichondrius,1804,priest,discipline,52,28,24
Cln,bleeding-hollow,1804,priest,discipline,65,32,33
Størmy,kiljaeden,1803,priest,discipline,168,99,69
Applecare,illidan,1803,priest,discipline,102,60,42
Tarlex,illidan,1803,priest,discipline,168,94,74
Goldsunx,emerald-dream,1803,priest,discipline,152,85,67
Cbalnom,tichondrius,1803,priest,discipline,70,37,33
Manyhot,tichondrius,1802,priest,discipline,51,32,19
Yrñwiotøø,illidan,1802,priest,discipline,54,33,21
Seifong,frostmourne,1802,priest,discipline,125,68,57
Retardèr,tichondrius,1801,priest,discipline,97,68,29
Reverendtun,area-52,1801,priest,discipline,83,55,28
Trebrooke,sargeras,1800,priest,discipline,131,77,54
Alola,illidan,1800,priest,discipline,135,69,66
Aratis,bleeding-hollow,1800,priest,discipline,42,19,23
Juicyturon,moon-guard,1799,priest,discipline,59,35,24
Fearinoculúm,bleeding-hollow,1798,priest,discipline,24,19,5
Impvp,tichondrius,1795,priest,discipline,89,49,40
Sleetherp,barthilas,1793,priest,discipline,58,33,25
Bublehead,zuljin,1789,priest,discipline,114,56,58
Xiaoqunzi,tichondrius,1787,priest,discipline,36,22,14
Stinkiez,area-52,1787,priest,discipline,46,26,20
Osis,rivendare,1786,priest,discipline,112,53,59
Aprîl,quelthalas,1784,priest,discipline,60,29,31
Tmversace,tichondrius,1781,priest,discipline,112,56,56
Usedmedkit,sargeras,1780,priest,discipline,47,28,19
Cynthus,dalvengyr,1777,priest,discipline,96,55,41
Jemine,tichondrius,1776,priest,discipline,78,47,31
Hugemilkys,tichondrius,1775,priest,discipline,37,22,15
Wânda,tichondrius,1773,priest,discipline,36,19,17
Compxx,barthilas,1772,priest,discipline,48,30,18
Nohéalforu,stormrage,1770,priest,discipline,47,25,22
Olark,durotan,1770,priest,discipline,96,43,53
Auxp,tichondrius,1769,priest,discipline,59,23,36
Deathtones,barthilas,1768,priest,discipline,84,47,37
Dontlineme,tichondrius,1768,priest,discipline,65,28,37
Írithyll,stormrage,1767,priest,discipline,59,33,26
Breakmoon,tichondrius,1767,priest,discipline,66,27,39
Nxghtmares,tichondrius,1764,priest,discipline,294,146,148
Isilador,moon-guard,1764,priest,discipline,71,32,39
Åpples,tichondrius,1763,priest,discipline,59,27,32
Raysx,stormrage,1759,priest,discipline,83,37,46
Velftrixi,sargeras,1758,priest,discipline,96,44,52
Crypcanheal,sargeras,1757,priest,discipline,244,119,125
Kaddy,mannoroth,1757,priest,discipline,130,60,70
Discflips,dalaran,1756,priest,discipline,84,42,42
Jaytee,aggramar,1754,priest,discipline,72,33,39
Catbabyorz,tichondrius,1754,priest,discipline,60,26,34
Wapriest,blades-edge,1752,priest,discipline,341,167,174
Quèénstar,tichondrius,1752,priest,discipline,73,29,44
Nickydamous,moon-guard,1749,priest,discipline,48,24,24
Barthol,malygos,1748,priest,discipline,190,96,94
Taipriest,frostmourne,1748,priest,discipline,60,24,36
Nerfthedoc,blackrock,1747,priest,discipline,43,27,16
Pervysaged,sargeras,1746,priest,discipline,24,19,5
Tallïa,stormrage,1746,priest,discipline,95,48,47
Xtcbtc,sargeras,1746,priest,discipline,63,29,34
Leapofdoubt,zuljin,1745,priest,discipline,232,121,111
Selenitax,sargeras,1743,priest,discipline,62,28,34
Cupitan,tichondrius,1743,priest,discipline,44,19,25
Qtasiangirl,emerald-dream,1742,priest,discipline,85,38,47
Holyfall,sargeras,1741,priest,discipline,95,57,38
Hotgirlshiit,dalaran,1741,priest,discipline,132,60,72
Cremona,tichondrius,1741,priest,discipline,54,24,30
Marcìano,bleeding-hollow,1736,priest,discipline,64,35,29
Pgpriest,kelthuzad,1736,priest,discipline,84,41,43
Niark,frostmourne,1736,priest,discipline,48,20,28
Saelom,frostmourne,1730,priest,discipline,78,49,29
Murth,laughing-skull,1729,priest,discipline,47,30,17
Probs,frostmourne,1729,priest,discipline,66,34,32
Owstepbro,sargeras,1728,priest,discipline,64,51,13
Pesca,proudmoore,1728,priest,discipline,107,48,59
Rilad,icecrown,1723,priest,discipline,54,30,24
Plaedo,stormscale,1723,priest,discipline,34,18,16
Xidis,vashj,1723,priest,discipline,71,29,42
Sobamian,tichondrius,1723,priest,discipline,90,36,54
Zaryx,wildhammer,1722,priest,discipline,42,24,18
Vegetable,suramar,1722,priest,discipline,36,18,18
Gochuxx,tichondrius,1721,priest,discipline,48,27,21
Deadpriesst,arthas,1721,priest,discipline,36,19,17
Bamboon,tanaris,1718,priest,discipline,54,28,26
Liteztvp,tichondrius,1718,priest,discipline,72,33,39
Tophr,illidan,1717,priest,discipline,30,18,12
Hideonlight,barthilas,1716,priest,discipline,74,40,34
Priceléss,tichondrius,1715,priest,discipline,24,18,6
Synsparks,tichondrius,1715,priest,discipline,54,25,29
Kragenn,malganis,1713,priest,discipline,165,83,82
Celestiah,illidan,1713,priest,discipline,48,24,24
Dorgondra,wyrmrest-accord,1709,priest,discipline,48,26,22
Meltmeltz,nerzhul,1708,priest,discipline,65,29,36
Imissdave,dethecus,1707,priest,discipline,36,19,17
Xajen,illidan,1706,priest,discipline,48,21,27
Comana,frostmourne,1705,priest,discipline,35,21,14
Squaanchy,bleeding-hollow,1705,priest,discipline,129,61,68
Bennito,moon-guard,1704,priest,discipline,60,24,36
Bholebender,tichondrius,1703,priest,discipline,41,20,21
Binipriest,tichondrius,1702,priest,discipline,34,20,14
Nightcráwler,illidan,1702,priest,discipline,89,47,42
Asthenia,saurfang,1702,priest,discipline,72,36,36
Conifer,emerald-dream,1700,priest,discipline,48,28,20
Meloxicamm,tichondrius,1700,priest,discipline,46,23,23
Philmacrakn,stormrage,1700,priest,discipline,131,62,69
Beowulfy,stormrage,1699,priest,discipline,48,27,21
Séxgodx,tichondrius,1698,priest,discipline,53,24,29
Clydeington,illidan,1697,priest,discipline,49,29,20
Mixful,bleeding-hollow,1696,priest,discipline,40,27,13
Apoorstudent,tichondrius,1696,priest,discipline,80,52,28
Boykoz,zuljin,1696,priest,discipline,37,21,16
Undrcvr,sargeras,1695,priest,discipline,42,23,19
Elilium,tichondrius,1690,priest,discipline,74,46,28
Pigogo,tichondrius,1690,priest,discipline,45,26,19
Zymmie,moon-guard,1690,priest,discipline,60,29,31
Pleasant,dathremar,1690,priest,discipline,69,29,40
Mastaspell,illidan,1689,priest,discipline,31,18,13
Bigmomcook,tichondrius,1689,priest,discipline,173,99,74
Trollpreist,tichondrius,1688,priest,discipline,63,36,27
Opriest,queldorei,1688,priest,discipline,48,25,23
Sweetnipsbro,tichondrius,1688,priest,discipline,71,35,36
Ukishizumi,tichondrius,1687,priest,discipline,79,39,40
Aco,tichondrius,1686,priest,discipline,126,67,59
Resisted,gorefiend,1680,priest,discipline,178,91,87
Reignen,tichondrius,1679,priest,discipline,76,43,33
Caveria,emerald-dream,1679,priest,discipline,72,39,33
Poosydoodlez,malganis,1679,priest,discipline,105,48,57
Geon,sargeras,1676,priest,discipline,59,30,29
Gibens,tichondrius,1676,priest,discipline,118,59,59
Fordranger,frostmourne,1676,priest,discipline,40,20,20
Oyy,barthilas,1675,priest,discipline,42,22,20
Kkelly,stormrage,1675,priest,discipline,51,24,27
Pawnza,tichondrius,1674,priest,discipline,54,27,27
Ayabae,illidan,1671,priest,discipline,269,129,140
Fhinky,tichondrius,1669,priest,discipline,155,74,81
Jmlz,tichondrius,1668,priest,discipline,36,23,13
Kastep,tichondrius,1663,priest,discipline,76,36,40
Fibbre,tichondrius,1663,priest,discipline,55,23,32
Shocklol,stormrage,1662,priest,discipline,29,22,7
Apathist,sargeras,1662,priest,discipline,66,44,22
Azureslaps,tichondrius,1662,priest,discipline,92,50,42
Hallucinogen,kelthuzad,1662,priest,discipline,95,51,44
Dévore,dalaran,1662,priest,discipline,40,20,20
Fisp,moon-guard,1661,priest,discipline,72,33,39
Hungrybone,proudmoore,1659,priest,discipline,412,206,206
Alarin,whisperwind,1659,priest,discipline,42,20,22
Skunkbishop,sargeras,1659,priest,discipline,161,75,86
Rawze,tichondrius,1659,priest,discipline,41,18,23
Alguîen,ragnaros,1657,priest,discipline,97,53,44
Ritzzx,ragnaros,1657,priest,discipline,36,19,17
Arianagrande,garona,1656,priest,discipline,78,43,35
Comebaack,stormrage,1654,priest,discipline,68,36,32
Perceptions,dalaran,1653,priest,discipline,36,23,13
Kathere,tichondrius,1653,priest,discipline,42,23,19
Zunitpriest,laughing-skull,1653,priest,discipline,36,18,18
Bigweebo,sargeras,1652,priest,discipline,39,25,14
Glassbirds,stormrage,1652,priest,discipline,48,25,23
Wildsmite,hyjal,1652,priest,discipline,150,66,84
Mindseye,azgalor,1652,priest,discipline,72,31,41
Inthemix,stormreaver,1651,priest,discipline,286,146,140
Syrillia,wildhammer,1650,priest,discipline,82,42,40
Slickwilly,bloodhoof,1650,priest,discipline,155,75,80
Karebenniian,area-52,1649,priest,discipline,78,43,35
Chañing,frostmourne,1649,priest,discipline,72,33,39
Andreslol,sargeras,1648,priest,discipline,36,21,15
Cixelpvp,area-52,1648,priest,discipline,47,22,25
Badhabit,zuluhed,1648,priest,discipline,42,19,23
Krewesin,ravencrest,1647,priest,discipline,43,22,21
Holécriss,tichondrius,1646,priest,discipline,102,56,46
Trengodqt,destromath,1646,priest,discipline,78,42,36
Luciuz,tichondrius,1646,priest,discipline,43,20,23
Beeffdaddy,tichondrius,1646,priest,discipline,57,25,32
Gankdez,kelthuzad,1645,priest,discipline,63,35,28
Döllyy,illidan,1645,priest,discipline,42,21,21
Centalinkxo,frostmourne,1645,priest,discipline,48,22,26
Zuwukey,kirin-tor,1645,priest,discipline,48,20,28
Ketapriest,frostmourne,1643,priest,discipline,82,39,43
Serakiki,nemesis,1642,priest,discipline,42,25,17
Selfless,barthilas,1642,priest,discipline,60,26,34
Hanley,tichondrius,1641,priest,discipline,49,30,19
Charbosan,gorgonnash,1641,priest,discipline,322,173,149
Heart,misha,1639,priest,discipline,78,42,36
Eetsqt,barthilas,1638,priest,discipline,75,49,26
Mxfd,tichondrius,1637,priest,discipline,41,22,19
Bkwhopper,emerald-dream,1636,priest,discipline,48,26,22
Lolcrafthd,ragnaros,1634,priest,discipline,46,27,19
Airelia,sargeras,1634,priest,discipline,42,22,20
Mclyte,whisperwind,1633,priest,discipline,149,77,72
Orderic,ragnaros,1631,priest,discipline,30,18,12
Rámmstein,wyrmrest-accord,1631,priest,discipline,72,39,33
Dolm,tichondrius,1631,priest,discipline,136,73,63
Leonilcx,tichondrius,1631,priest,discipline,216,104,112
Meip,illidan,1630,priest,discipline,24,17,7
Doutoodou,tichondrius,1630,priest,discipline,75,45,30
Blessxo,ragnaros,1630,priest,discipline,43,21,22
Rlzpriest,tichondrius,1629,priest,discipline,79,36,43
Umadcüzubad,azralon,1628,priest,discipline,48,22,26
Çammy,frostmourne,1626,priest,discipline,24,17,7
Claverr,stormrage,1626,priest,discipline,27,18,9
Discavow,bleeding-hollow,1626,priest,discipline,51,31,20
Theravus,moon-guard,1626,priest,discipline,107,57,50
Raxekk,stormrage,1626,priest,discipline,48,25,23
Bloodify,azralon,1626,priest,discipline,41,21,20
Argylemomo,emerald-dream,1626,priest,discipline,172,85,87
Twêet,frostmourne,1626,priest,discipline,132,57,75
Layons,nemesis,1625,priest,discipline,98,59,39
Nanoboost,dark-iron,1625,priest,discipline,232,114,118
Adrio,malorne,1624,priest,discipline,156,73,83
Ussmissouri,area-52,1624,priest,discipline,141,63,78
Jatral,azralon,1624,priest,discipline,47,20,27
Sodezz,stormrage,1623,priest,discipline,30,17,13
Caesus,sargeras,1623,priest,discipline,124,70,54
Cokeheals,kelthuzad,1621,priest,discipline,30,17,13
Høwtokill,azralon,1621,priest,discipline,48,17,31
Samirah,arthas,1620,priest,discipline,36,20,16
Wickedpriest,malganis,1620,priest,discipline,48,22,26
Healbaby,illidan,1619,priest,discipline,71,39,32
Danceslol,area-52,1619,priest,discipline,36,17,19
Baddmachine,illidan,1619,priest,discipline,47,21,26
Ooit,tichondrius,1618,priest,discipline,18,17,1
Timbobaloo,thrall,1618,priest,discipline,58,33,25
Syrul,tichondrius,1618,priest,discipline,63,34,29
Buchöna,quelthalas,1618,priest,discipline,42,22,20
Kelthax,sargeras,1618,priest,discipline,42,17,25
Mangolatte,frostmourne,1617,priest,discipline,49,37,12
Bustit,azgalor,1616,priest,discipline,35,20,15
Hoshx,sargeras,1615,priest,discipline,66,40,26
Jîtters,silvermoon,1615,priest,discipline,84,45,39
Downturn,tichondrius,1615,priest,discipline,36,17,19
Famemolol,tichondrius,1614,priest,discipline,100,50,50
Lines,sargeras,1613,priest,discipline,64,36,28
Nolar,shadowmoon,1613,priest,discipline,36,20,16
ßðßßÿ,area-52,1613,priest,discipline,42,21,21
Sanddglokta,tichondrius,1613,priest,discipline,152,71,81
Hoonjojjyang,tichondrius,1612,priest,discipline,30,17,13
Gsek,nemesis,1611,priest,discipline,36,23,13
Zllik,illidan,1611,priest,discipline,42,26,16
Valyx,tichondrius,1610,priest,discipline,67,39,28
Brothercarl,stormrage,1610,priest,discipline,71,38,33
Blathers,malganis,1610,priest,discipline,92,48,44
Somefire,proudmoore,1610,priest,discipline,131,64,67
Interworld,illidan,1610,priest,discipline,50,24,26
Mortteus,agamaggan,1610,priest,discipline,54,25,29
Gsek,azralon,1608,priest,discipline,54,34,20
Juckerr,tichondrius,1608,priest,discipline,111,62,49
Wrekkit,area-52,1608,priest,discipline,84,42,42
Milkkz,zuljin,1607,priest,discipline,36,20,16
Jammeslight,quelthalas,1605,priest,discipline,30,18,12
Trojanphobia,bleeding-hollow,1605,priest,discipline,36,20,16
Yoggismydad,emerald-dream,1605,priest,discipline,185,95,90
Snakedoc,emerald-dream,1605,priest,discipline,66,33,33
Hoglet,moon-guard,1604,priest,discipline,65,39,26
Priestass,bleeding-hollow,1604,priest,discipline,78,37,41
Vern,laughing-skull,1604,priest,discipline,78,29,49
Woobgasm,sargeras,1603,priest,discipline,30,22,8
Iamgess,kilrogg,1603,priest,discipline,42,22,20
Önagashøw,azralon,1603,priest,discipline,149,77,72
Fäctor,bleeding-hollow,1603,priest,discipline,78,36,42
Resortv,illidan,1602,priest,discipline,42,32,10
Sâsh,stormrage,1602,priest,discipline,36,22,14
Holyhõ,stormrage,1602,priest,discipline,36,20,16
Grizzlysmite,stormrage,1602,priest,discipline,159,77,82
Mealmassttr,frostmourne,1602,priest,discipline,66,27,39
Mepisth,sargeras,1600,priest,discipline,66,36,30
Playsoon,shattered-hand,1600,priest,discipline,78,42,36
Obsolete,area-52,1600,priest,discipline,36,17,19
Marython,tichondrius,1600,priest,discipline,52,22,30
Toastspriest,tichondrius,1599,priest,discipline,36,21,15
Inquisitionx,frostmourne,1599,priest,discipline,54,31,23
Ankhxiety,area-52,1599,priest,discipline,61,31,30
Zunari,thrall,1599,priest,discipline,48,23,25
Andypr,illidan,1599,priest,discipline,54,20,34
Memoriesorz,tichondrius,1598,priest,discipline,129,72,57
Ragretsxo,darkspear,1598,priest,discipline,36,17,19
Dupaforted,stormrage,1598,priest,discipline,71,26,45
Justashadow,zangarmarsh,1596,priest,discipline,62,40,22
Sacrify,ragnaros,1594,priest,discipline,42,22,20
Gromkekz,area-52,1594,priest,discipline,63,31,32
Gummachine,tichondrius,1594,priest,discipline,36,17,19
Shadöwtest,quelthalas,1591,priest,discipline,101,45,56
Däzzlë,quelthalas,1591,priest,discipline,48,20,28
Isteri,thrall,1590,priest,discipline,52,26,26
Woosanghong,tichondrius,1590,priest,discipline,90,44,46
Kks,tichondrius,1589,priest,discipline,54,28,26
Primael,tichondrius,1587,priest,discipline,40,18,22
Jaquels,sargeras,1587,priest,discipline,58,22,36
Fallenumbra,area-52,1586,priest,discipline,54,31,23
Conezy,frostmourne,1586,priest,discipline,60,32,28
Evilspreist,arthas,1585,priest,discipline,30,17,13
Chewey,tichondrius,1585,priest,discipline,36,20,16
Malpractíce,zuljin,1585,priest,discipline,83,45,38
Aerdaras,illidan,1584,priest,discipline,68,33,35
Zerokool,moonrunner,1583,priest,discipline,42,25,17
Mintadnade,nemesis,1583,priest,discipline,83,38,45
Prayussy,tichondrius,1582,priest,discipline,93,50,43
Rómmul,azralon,1582,priest,discipline,65,33,32
Tecnica,kelthuzad,1582,priest,discipline,107,51,56
Persimmons,lightbringer,1581,priest,discipline,30,17,13
Jacksreturne,kelthuzad,1581,priest,discipline,162,83,79
Indigojuly,sargeras,1580,priest,discipline,40,24,16
Thadino,nagrand,1579,priest,discipline,30,17,13
Sêlbus,stormrage,1579,priest,discipline,91,48,43
Krusheal,tichondrius,1578,priest,discipline,35,18,17
Vampirê,tichondrius,1578,priest,discipline,42,19,23
Scarabless,bleeding-hollow,1578,priest,discipline,114,51,63
Verna,dunemaul,1577,priest,discipline,49,29,20
Zilah,ravencrest,1576,priest,discipline,54,27,27
Zenobiai,hyjal,1573,priest,discipline,104,59,45
Klttzz,sargeras,1573,priest,discipline,36,20,16
Erinzdern,quelthalas,1573,priest,discipline,53,29,24
Kihlupr,frostmourne,1573,priest,discipline,58,25,33
Säcrilege,drakkari,1572,priest,discipline,112,59,53
Tokaru,frostmourne,1572,priest,discipline,38,20,18
Sacredlight,malygos,1571,priest,discipline,66,35,31
Grimacê,sargeras,1571,priest,discipline,36,18,18
Crizem,bleeding-hollow,1571,priest,discipline,165,79,86
Valdurai,stormrage,1570,priest,discipline,41,23,18
Änanti,tichondrius,1570,priest,discipline,36,19,17
Life,thrall,1570,priest,discipline,95,48,47
Barthbelro,kiljaeden,1568,priest,discipline,30,19,11
Sasaberry,frostmourne,1567,priest,discipline,54,27,27
Catbabyeah,tichondrius,1566,priest,discipline,24,20,4
Spliffs,tichondrius,1566,priest,discipline,59,20,39
Deathwisher,illidan,1564,priest,discipline,30,18,12
Incisions,moon-guard,1563,priest,discipline,30,20,10
Bubblebuddí,tichondrius,1562,priest,discipline,57,31,26
Yoozi,sargeras,1562,priest,discipline,78,42,36
Sâishâ,proudmoore,1561,priest,discipline,72,27,45
Obscure,malygos,1561,priest,discipline,48,18,30
Shadzx,andorhal,1559,priest,discipline,35,17,18
Moustachío,stormrage,1559,priest,discipline,53,24,29
Wisher,tichondrius,1559,priest,discipline,54,20,34
Melitele,magtheridon,1558,priest,discipline,36,21,15
Vanco,tichondrius,1558,priest,discipline,59,32,27
Twistinfate,hyjal,1558,priest,discipline,119,58,61
Athênå,tichondrius,1557,priest,discipline,72,37,35
Stoneflute,emerald-dream,1551,priest,discipline,87,53,34
Grannieslove,sargeras,1551,priest,discipline,48,28,20
Archìtects,wyrmrest-accord,1550,priest,discipline,36,19,17
Cinsare,moon-guard,1549,priest,discipline,60,35,25
Hennywhite,sargeras,1549,priest,discipline,42,19,23
Haill,quelthalas,1549,priest,discipline,58,26,32
Fámóus,stormrage,1549,priest,discipline,83,30,53
Pinchevato,ragnaros,1548,priest,discipline,110,57,53
Fairlightpp,zuljin,1548,priest,discipline,54,26,28
Kazuret,ragnaros,1547,priest,discipline,128,66,62
Icetraygang,suramar,1545,priest,discipline,154,92,62
Scab,anetheron,1545,priest,discipline,66,25,41
Goo,boulderfist,1544,priest,discipline,36,22,14
Jâldabaoth,area-52,1543,priest,discipline,42,27,15
Zórg,stormrage,1541,priest,discipline,56,30,26
Makuwu,area-52,1541,priest,discipline,93,49,44
Havocshadows,deathwing,1540,priest,discipline,111,73,38
Ballzach,ysera,1540,priest,discipline,152,81,71
Alex,boulderfist,1540,priest,discipline,189,90,99
Mudshadow,tichondrius,1539,priest,discipline,39,21,18
Devinere,tichondrius,1539,priest,discipline,191,96,95
Avis,illidan,1538,priest,discipline,50,33,17
Raydz,altar-of-storms,1538,priest,discipline,102,54,48
Disperse,vashj,1538,priest,discipline,60,26,34
Xerzosh,area-52,1537,priest,discipline,78,47,31
Psycozis,hyjal,1537,priest,discipline,161,85,76
Ðiscipline,kelthuzad,1537,priest,discipline,55,27,28
Nutshotxx,skullcrusher,1537,priest,discipline,119,49,70
Dingldangle,tichondrius,1536,priest,discipline,108,54,54
Natoshi,illidan,1535,priest,discipline,30,16,14
Andrew,sargeras,1534,priest,discipline,24,16,8
Zroheals,illidan,1534,priest,discipline,83,37,46
Swartzp,tichondrius,1531,priest,discipline,63,31,32
Johanna,tichondrius,1530,priest,discipline,24,16,8
Uriyel,quelthalas,1529,priest,discipline,113,58,55
Halö,area-52,1529,priest,discipline,54,26,28
Nidüz,stormrage,1529,priest,discipline,102,48,54
Sleezi,emerald-dream,1528,priest,discipline,24,17,7
Truce,moon-guard,1528,priest,discipline,77,39,38
Friendzonefw,illidan,1526,priest,discipline,72,34,38
Seyr,bleeding-hollow,1524,priest,discipline,101,61,40
Thedude,spirestone,1524,priest,discipline,36,16,20
Nyluh,deathwing,1523,priest,discipline,26,16,10
Sonofbetch,emerald-dream,1523,priest,discipline,55,30,25
Drully,moon-guard,1523,priest,discipline,36,19,17
Madhairy,ragnaros,1522,priest,discipline,126,65,61
Niurouchuan,tichondrius,1522,priest,discipline,123,60,63
Puddín,area-52,1521,priest,discipline,54,30,24
Magpul,arthas,1521,priest,discipline,30,16,14
Winsforgoldd,area-52,1521,priest,discipline,34,17,17
Ezzy,bleeding-hollow,1520,priest,discipline,48,24,24
Joezyxz,tichondrius,1520,priest,discipline,38,18,20
Dædrà,stormrage,1519,priest,discipline,76,37,39
Jaindoe,illidan,1517,priest,discipline,54,32,22
Gus,the-venture-co,1517,priest,discipline,48,26,22
Malavidax,malganis,1517,priest,discipline,84,37,47
Razledazzled,grizzly-hills,1517,priest,discipline,48,21,27
Emotionally,sargeras,1516,priest,discipline,24,16,8
Bonnieron,frostmourne,1516,priest,discipline,77,39,38
Shesaidthat,stormrage,1516,priest,discipline,87,41,46
Keyoshe,altar-of-storms,1515,priest,discipline,36,18,18
Fõrcedtowipe,tichondrius,1515,priest,discipline,156,77,79
Marantbourge,frostmourne,1514,priest,discipline,122,57,65
Arcalon,thrall,1514,priest,discipline,44,19,25
Finnabustt,tichondrius,1513,priest,discipline,64,32,32
Valixia,sargeras,1512,priest,discipline,36,17,19
Luxyel,azralon,1511,priest,discipline,101,42,59
Cexcexyomi,tichondrius,1509,priest,discipline,55,30,25
Bloodytears,kiljaeden,1509,priest,discipline,90,41,49
Sensaye,dalaran,1509,priest,discipline,42,18,24
Cringepriest,area-52,1507,priest,discipline,48,27,21
Alexsp,amanthul,1506,priest,discipline,40,23,17
Yorp,tichondrius,1506,priest,discipline,48,24,24
Nopang,tichondrius,1506,priest,discipline,128,52,76
Zinnar,dalaran,1506,priest,discipline,90,35,55
Altarboy,agamaggan,1505,priest,discipline,62,30,32
Perothon,garrosh,1505,priest,discipline,60,27,33
Këyglock,kelthuzad,1505,priest,discipline,59,26,33
Sorrowful,mannoroth,1504,priest,discipline,24,16,8
Aríola,frostmourne,1503,priest,discipline,52,28,24
Ropriest,frostmourne,1503,priest,discipline,41,18,23
Chainsalight,stormrage,1501,priest,discipline,120,67,53
Luffzie,barthilas,1500,priest,discipline,54,35,19
Vañity,malganis,1500,priest,discipline,48,23,25
Unisia,tichondrius,1500,priest,discipline,84,37,47
Zäelly,moon-guard,1499,priest,discipline,180,94,86
Jpray,bleeding-hollow,1498,priest,discipline,97,53,44
Healther,firetree,1498,priest,discipline,30,16,14
Jugeumx,proudmoore,1498,priest,discipline,36,16,20
Inkders,detheroc,1498,priest,discipline,52,23,29
Swagraptor,stormreaver,1497,priest,discipline,30,18,12
Ferguss,ragnaros,1495,priest,discipline,25,18,7
Tyksu,area-52,1495,priest,discipline,70,35,35
Growth,fizzcrank,1495,priest,discipline,48,20,28
Sgiath,alleria,1493,priest,discipline,36,27,9
Rëckful,area-52,1493,priest,discipline,202,106,96
Amarexlol,stormrage,1492,priest,discipline,48,24,24
Fenian,frostmourne,1491,priest,discipline,77,39,38
Pootzy,malganis,1491,priest,discipline,72,27,45
Rmxx,illidan,1488,priest,discipline,48,24,24
Illuminare,sargeras,1488,priest,discipline,70,34,36
Priøst,tichondrius,1486,priest,discipline,30,23,7
Windroseh,proudmoore,1486,priest,discipline,60,32,28
Aggravating,mugthol,1486,priest,discipline,169,89,80
Griddly,alterac-mountains,1485,priest,discipline,62,34,28
Tëmpting,moon-guard,1485,priest,discipline,50,25,25
Healthreat,area-52,1484,priest,discipline,40,25,15
Lovelike,tichondrius,1484,priest,discipline,39,23,16
Blacklightz,korgath,1483,priest,discipline,91,42,49
Tartapelle,zuljin,1481,priest,discipline,78,44,34
Sstar,area-52,1479,priest,discipline,24,16,8
Bonoo,tichondrius,1478,priest,discipline,162,80,82
Shadowblax,thrall,1478,priest,discipline,92,40,52
Luvenia,sargeras,1477,priest,discipline,72,35,37
Mfynch,sargeras,1476,priest,discipline,36,22,14
Puttles,tichondrius,1476,priest,discipline,48,16,32
Vivián,tichondrius,1475,priest,discipline,45,30,15
Slipzie,sargeras,1475,priest,discipline,53,31,22
Shieldharder,stormrage,1475,priest,discipline,33,16,17
Labraidor,tichondrius,1474,priest,discipline,113,44,69
Swagndragon,zuljin,1473,priest,discipline,80,39,41
Bryelx,ragnaros,1472,priest,discipline,84,40,44
Blobble,tichondrius,1472,priest,discipline,54,20,34
Hasby,area-52,1471,priest,discipline,42,24,18
Ricekak,haomarush,1471,priest,discipline,66,37,29
Rufían,quelthalas,1471,priest,discipline,48,25,23
Haizsu,tichondrius,1471,priest,discipline,35,17,18
Feorlar,tichondrius,1471,priest,discipline,66,32,34
Ixchelune,kelthuzad,1471,priest,discipline,172,82,90
Gommacura,stormrage,1470,priest,discipline,54,28,26
Mse,eonar,1469,priest,discipline,42,21,21
Dreadpriate,emerald-dream,1468,priest,discipline,80,42,38
Tajee,area-52,1467,priest,discipline,48,27,21
Chimiechurro,proudmoore,1467,priest,discipline,60,33,27
Sandfire,thrall,1467,priest,discipline,30,16,14
Stargoddess,illidan,1467,priest,discipline,168,84,84
Bubblerwrapp,malganis,1466,priest,discipline,30,16,14
Yeyoz,tichondrius,1466,priest,discipline,70,33,37
Cherryfuzz,sargeras,1463,priest,discipline,59,32,27
Lilblackguys,stormrage,1463,priest,discipline,78,41,37
Dib,arathor,1463,priest,discipline,48,25,23
Clancygilroy,thrall,1462,priest,discipline,78,40,38
Doesine,area-52,1461,priest,discipline,36,22,14
Braffuki,frostmourne,1461,priest,discipline,77,38,39
Oopsy,bleeding-hollow,1460,priest,discipline,36,17,19
Saiyana,frostmourne,1460,priest,discipline,100,46,54
Syfy,thrall,1460,priest,discipline,108,45,63
Oesobagi,tichondrius,1459,priest,discipline,24,16,8
Tainna,quelthalas,1459,priest,discipline,66,39,27
Sadnez,illidan,1459,priest,discipline,37,21,16
Nerfdisc,azralon,1459,priest,discipline,112,58,54
Bater,mugthol,1458,priest,discipline,28,17,11
Eavin,laughing-skull,1458,priest,discipline,123,63,60
Jacob,shadowmoon,1458,priest,discipline,135,66,69
Whehaw,kelthuzad,1458,priest,discipline,54,26,28
Darenlor,tichondrius,1458,priest,discipline,93,40,53
Kflexx,hydraxis,1457,priest,discipline,52,16,36
Quavö,tichondrius,1456,priest,discipline,54,27,27
Justanoutlaw,darkspear,1455,priest,discipline,30,20,10
Bistek,bleeding-hollow,1455,priest,discipline,101,50,51
Winss,tichondrius,1455,priest,discipline,166,82,84
Approved,moon-guard,1455,priest,discipline,120,55,65
Bøness,area-52,1454,priest,discipline,70,41,29
Hermeneutic,illidan,1454,priest,discipline,39,17,22
Xeras,misha,1452,priest,discipline,47,21,26
Rhima,tichondrius,1450,priest,discipline,65,30,35
Vinvictus,tichondrius,1449,priest,discipline,200,94,106
Specialed,wildhammer,1447,priest,discipline,48,28,20
Phayzz,area-52,1447,priest,discipline,87,47,40
Kimjongdots,illidan,1447,priest,discipline,30,16,14
Zeusqt,azralon,1447,priest,discipline,96,50,46
Nolan,drakkari,1446,priest,discipline,35,22,13
Heallarious,stormrage,1446,priest,discipline,42,26,16
Giveheadpats,moon-guard,1444,priest,discipline,78,35,43
Yótecuro,quelthalas,1443,priest,discipline,66,31,35
Raisonpriest,tichondrius,1442,priest,discipline,84,44,40
Jamesxupttv,draenor,1441,priest,discipline,45,26,19
Mannius,tichondrius,1441,priest,discipline,54,26,28
Kristyenna,boulderfist,1440,priest,discipline,42,20,22
Spookynun,moon-guard,1439,priest,discipline,148,87,61
Cubski,darkspear,1439,priest,discipline,30,15,15
Keepyaheadup,malganis,1438,priest,discipline,18,15,3
Vinnydiesel,tichondrius,1438,priest,discipline,30,15,15
Helarix,malganis,1438,priest,discipline,92,42,50
Wcnmb,blackrock,1437,priest,discipline,24,15,9
Akovob,tichondrius,1437,priest,discipline,44,22,22
Kraamur,area-52,1437,priest,discipline,42,21,21
Moalboal,tichondrius,1437,priest,discipline,54,21,33
Lydra,ragnaros,1436,priest,discipline,151,64,87
Murdock,the-forgotten-coast,1435,priest,discipline,44,25,19
Bootycough,malganis,1435,priest,discipline,63,32,31
Sliding,wyrmrest-accord,1435,priest,discipline,30,15,15
Miix,proudmoore,1434,priest,discipline,18,15,3
Mangueroide,quelthalas,1434,priest,discipline,42,24,18
Shadey,onyxia,1434,priest,discipline,36,15,21
Epitoh,bleeding-hollow,1433,priest,discipline,36,15,21
Amorus,illidan,1432,priest,discipline,60,40,20
Bailez,malganis,1432,priest,discipline,36,18,18
Evilear,tichondrius,1430,priest,discipline,36,15,21
Aåurøra,stormrage,1429,priest,discipline,24,15,9
Cezure,stormrage,1429,priest,discipline,184,99,85
Rôôk,kiljaeden,1429,priest,discipline,50,23,27
Gwyneth,whisperwind,1428,priest,discipline,50,22,28
Rexîfy,zuljin,1427,priest,discipline,29,16,13
Luanwanx,tichondrius,1427,priest,discipline,48,26,22
Oiled,barthilas,1424,priest,discipline,27,18,9
Shadoris,antonidas,1424,priest,discipline,30,15,15
Vandamnation,barthilas,1424,priest,discipline,36,15,21
Ketaminè,tichondrius,1422,priest,discipline,48,25,23
Wpj,barthilas,1422,priest,discipline,51,17,34
Izikial,illidan,1421,priest,discipline,48,24,24
Crashed,frostmourne,1420,priest,discipline,24,16,8
Holycast,arygos,1420,priest,discipline,24,15,9
Sackura,quelthalas,1420,priest,discipline,49,26,23
Machinecoach,stormrage,1419,priest,discipline,30,15,15
Qmabayteckkl,tichondrius,1418,priest,discipline,24,15,9
Laüren,ragnaros,1418,priest,discipline,88,40,48
Holyish,proudmoore,1418,priest,discipline,42,19,23
Powerwordzz,dragonmaw,1416,priest,discipline,42,23,19
Voltstein,dalaran,1416,priest,discipline,56,27,29
Eatmyfear,quelthalas,1414,priest,discipline,98,43,55
Aubine,sargeras,1414,priest,discipline,41,15,26
Triggaz,tichondrius,1413,priest,discipline,59,33,26
Skillfull,chogall,1409,priest,discipline,119,63,56
Umbrous,ysera,1409,priest,discipline,36,15,21
Shelak,frostmourne,1408,priest,discipline,62,33,29
Kawin,goldrinn,1407,priest,discipline,101,54,47
Sunenergy,tichondrius,1407,priest,discipline,78,41,37
Priesmatco,area-52,1407,priest,discipline,48,19,29
Iinu,tichondrius,1405,priest,discipline,71,34,37
Tryst,the-underbog,1404,priest,discipline,60,37,23
Delrey,sargeras,1404,priest,discipline,32,16,16
Langyi,tichondrius,1403,priest,discipline,48,28,20
Kafarmer,frostmourne,1403,priest,discipline,59,34,25
Xyló,area-52,1403,priest,discipline,106,59,47
Bubbahotep,laughing-skull,1402,priest,discipline,34,17,17
Nek,malganis,1400,priest,discipline,67,41,26
Khyonne,nemesis,1400,priest,discipline,68,37,31
Rvxy,tichondrius,1400,priest,discipline,78,42,36
Hunanbeef,kiljaeden,1400,priest,discipline,58,29,29
Akëla,nemesis,1400,priest,discipline,30,15,15
Strawson,quelthalas,1400,priest,discipline,42,19,23
Welovan,sargeras,1399,priest,discipline,34,17,17
Shnítzel,thrall,1399,priest,discipline,103,51,52
Smegmancer,korgath,1399,priest,discipline,54,24,30
Darkquinn,boulderfist,1398,priest,discipline,106,46,60
Shykaii,azralon,1396,priest,discipline,84,47,37
Curemeste,illidan,1396,priest,discipline,36,18,18
Ems,dawnbringer,1394,priest,discipline,29,15,14
Raggasoca,malganis,1393,priest,discipline,99,44,55
Ðiplø,tichondrius,1392,priest,discipline,35,21,14
Ünarû,illidan,1392,priest,discipline,66,38,28
Victrix,tichondrius,1392,priest,discipline,70,27,43
Zivn,tichondrius,1390,priest,discipline,356,185,171
Unholywizard,sargeras,1386,priest,discipline,66,37,29
Dårc,tichondrius,1384,priest,discipline,59,36,23
Bionix,stormrage,1384,priest,discipline,42,23,19
Arkenes,dalaran,1383,priest,discipline,78,41,37
Handyheals,frostmourne,1382,priest,discipline,89,49,40
Mursey,sargeras,1382,priest,discipline,105,48,57
Sistamaggie,bleeding-hollow,1379,priest,discipline,42,21,21
Blodwell,illidan,1378,priest,discipline,72,35,37
Lexinalis,stormrage,1376,priest,discipline,29,17,12
Vincejddp,zuljin,1374,priest,discipline,60,26,34
Bloatie,zuljin,1373,priest,discipline,30,20,10
Risedead,azralon,1373,priest,discipline,91,50,41
Zombieheals,gundrak,1373,priest,discipline,53,27,26
Blaydun,elune,1371,priest,discipline,90,56,34
Karazhan,burning-legion,1371,priest,discipline,44,19,25
Propagàndhi,daggerspine,1371,priest,discipline,53,15,38
Jìtters,silvermoon,1370,priest,discipline,36,17,19
Maid,demon-soul,1368,priest,discipline,39,16,23
Eshimä,quelthalas,1366,priest,discipline,41,25,16
Solsano,stormrage,1365,priest,discipline,76,44,32
Luminous,moon-guard,1365,priest,discipline,131,67,64
Spazmode,malganis,1364,priest,discipline,42,20,22
Halfyo,dragonmaw,1363,priest,discipline,90,49,41
Füuzin,stormrage,1362,priest,discipline,66,34,32
Wrathchildd,azralon,1361,priest,discipline,39,27,12
Angusb,sargeras,1361,priest,discipline,68,27,41
Curasia,drakkari,1360,priest,discipline,57,37,20
Nêrô,dalaran,1359,priest,discipline,48,21,27
Nomsayin,stormrage,1358,priest,discipline,19,15,4
Crucïfïx,stormrage,1358,priest,discipline,70,41,29
Nexoox,drakkari,1358,priest,discipline,42,23,19
Feedya,tichondrius,1358,priest,discipline,227,103,124
Nometh,emerald-dream,1357,priest,discipline,42,18,24
Jilt,aerie-peak,1356,priest,discipline,48,29,19
Aerdune,dalaran,1356,priest,discipline,68,36,32
Artista,quelthalas,1356,priest,discipline,52,24,28
Jaskil,skywall,1355,priest,discipline,42,26,16
Holyfromrmp,tichondrius,1354,priest,discipline,48,24,24
Chìbiusa,gurubashi,1352,priest,discipline,106,52,54
Mitoloshi,ragnaros,1352,priest,discipline,66,31,35
Dxskadi,stormrage,1348,priest,discipline,156,68,88
Yugewap,hyjal,1347,priest,discipline,35,22,13
Theheal,ragnaros,1347,priest,discipline,51,18,33
Pelagius,suramar,1345,priest,discipline,44,19,25
Juliusceazer,skywall,1344,priest,discipline,88,52,36
Temkcalb,ragnaros,1344,priest,discipline,72,36,36
Hoppus,stormrage,1344,priest,discipline,90,44,46
Míssdank,tichondrius,1343,priest,discipline,36,18,18
Snackermz,tichondrius,1343,priest,discipline,35,14,21
Crazykitsune,thaurissan,1342,priest,discipline,42,27,15
Montagehey,illidan,1342,priest,discipline,24,14,10
Klydasoreass,malganis,1342,priest,discipline,24,14,10
Redcoolaid,moon-guard,1341,priest,discipline,24,14,10
Armî,ragnaros,1341,priest,discipline,30,15,15
Zoap,stormrage,1341,priest,discipline,60,26,34
Storylord,malganis,1340,priest,discipline,30,14,16
Yukih,tichondrius,1340,priest,discipline,36,16,20
Fleckyy,tichondrius,1339,priest,discipline,36,14,22
Vehlind,quelthalas,1338,priest,discipline,101,52,49
Knoskeezy,proudmoore,1337,priest,discipline,18,14,4
Maybedead,tichondrius,1337,priest,discipline,24,14,10
Smittën,barthilas,1336,priest,discipline,48,26,22
Ínfocus,area-52,1336,priest,discipline,36,15,21
Metagameswag,tichondrius,1335,priest,discipline,24,14,10
Weapestrong,tichondrius,1333,priest,discipline,24,14,10
Tûbes,trollbane,1333,priest,discipline,89,35,54
Rblood,emerald-dream,1332,priest,discipline,54,33,21
Rickjames,laughing-skull,1330,priest,discipline,44,27,17
Ieveling,skywall,1330,priest,discipline,36,14,22
Xuun,illidan,1329,priest,discipline,71,42,29
Tungus,shadowsong,1329,priest,discipline,88,44,44
Muuq,frostmourne,1328,priest,discipline,39,19,20
Mcfref,tichondrius,1328,priest,discipline,30,14,16
Masochist,barthilas,1327,priest,discipline,48,34,14
Mythica,gurubashi,1327,priest,discipline,84,50,34
Danrien,azralon,1326,priest,discipline,34,20,14
Jâmïè,gurubashi,1325,priest,discipline,18,14,4
Scræm,sargeras,1325,priest,discipline,36,14,22
Edmust,black-dragonflight,1324,priest,discipline,24,14,10
Basisc,frostmourne,1323,priest,discipline,64,36,28
Penetron,tichondrius,1322,priest,discipline,30,14,16
Sineater,zuljin,1321,priest,discipline,30,14,16
Srwilly,ragnaros,1320,priest,discipline,75,39,36
Phasmaaxd,tichondrius,1319,priest,discipline,24,14,10
Nadiaxo,moon-guard,1319,priest,discipline,65,35,30
Huevos,blackwing-lair,1319,priest,discipline,78,38,40
Nøzmonica,kelthuzad,1319,priest,discipline,32,15,17
Benedictüs,tichondrius,1318,priest,discipline,86,42,44
Nonamegame,sargeras,1316,priest,discipline,66,40,26
Bigtimeplay,tichondrius,1315,priest,discipline,24,14,10
Itsme,quelthalas,1312,priest,discipline,47,18,29
Jsuschristix,zuljin,1311,priest,discipline,36,23,13
Pphill,aegwynn,1311,priest,discipline,36,14,22
Inferis,ragnaros,1310,priest,discipline,113,60,53
Gongá,moon-guard,1309,priest,discipline,30,14,16
Badnsweaty,sargeras,1308,priest,discipline,28,15,13
Fanatic,nemesis,1308,priest,discipline,72,37,35
Booyâh,muradin,1308,priest,discipline,54,27,27
Ruthlèss,ragnaros,1305,priest,discipline,54,28,26
Deadpla,ragnaros,1304,priest,discipline,35,14,21
Plznokill,tichondrius,1303,priest,discipline,36,18,18
Poorass,sargeras,1301,priest,discipline,30,19,11
Jaysontatum,gurubashi,1301,priest,discipline,27,16,11
Aedarelyn,ysera,1301,priest,discipline,42,22,20
Souriel,tichondrius,1300,priest,discipline,60,33,27
Krané,area-52,1298,priest,discipline,51,24,27
Wildmanfrank,tichondrius,1297,priest,discipline,37,21,16
Chîna,hyjal,1295,priest,discipline,60,42,18
Dadthegreat,bonechewer,1292,priest,discipline,42,25,17
Halliburton,illidan,1292,priest,discipline,56,26,30
Namî,barthilas,1291,priest,discipline,108,59,49
Joktips,proudmoore,1290,priest,discipline,30,15,15
Malevolently,illidan,1290,priest,discipline,113,49,64
Rmx,illidan,1288,priest,discipline,29,14,15
Mamabless,quelthalas,1287,priest,discipline,208,106,102
Bathenape,bleeding-hollow,1286,priest,discipline,24,15,9
Diabiitus,stormrage,1286,priest,discipline,38,23,15
Markspell,stormrage,1286,priest,discipline,133,72,61
Iwonthealu,senjin,1286,priest,discipline,30,16,14
Brounly,drakkari,1285,priest,discipline,72,36,36
Majesticar,moon-guard,1283,priest,discipline,24,16,8
Jiñx,destromath,1283,priest,discipline,60,25,35
Bonkerwaffle,kelthuzad,1282,priest,discipline,30,20,10
Lifeswap,area-52,1281,priest,discipline,54,21,33
Knifê,moon-guard,1280,priest,discipline,90,46,44
Lawroade,tichondrius,1279,priest,discipline,61,30,31
Dzpi,azralon,1278,priest,discipline,30,15,15
Dahrwin,thrall,1276,priest,discipline,36,20,16
Goodwin,darkspear,1275,priest,discipline,42,24,18
Rbgeezus,lightnings-blade,1275,priest,discipline,107,55,52
Weakwind,burning-blade,1275,priest,discipline,28,14,14
Deadlydocc,illidan,1272,priest,discipline,21,15,6
Geekynerd,frostmourne,1271,priest,discipline,24,15,9
Sappes,area-52,1270,priest,discipline,42,23,19
Themøn,quelthalas,1270,priest,discipline,30,16,14
Purged,shadowmoon,1270,priest,discipline,54,23,31
Sofhya,ragnaros,1269,priest,discipline,76,41,35
Twotimechamp,azshara,1266,priest,discipline,30,16,14
Derlanger,frostmourne,1266,priest,discipline,36,18,18
Femìnazzi,ragnaros,1263,priest,discipline,31,15,16
Kymosolop,sargeras,1258,priest,discipline,25,14,11
Jestiann,aegwynn,1258,priest,discipline,161,83,78
Nijoral,tichondrius,1258,priest,discipline,87,37,50
Kenzao,nemesis,1257,priest,discipline,64,30,34
Zjqf,akama,1257,priest,discipline,107,46,61
Thotznprayrz,bleeding-hollow,1254,priest,discipline,36,23,13
Dosarix,sargeras,1250,priest,discipline,40,23,17
Burpees,dalaran,1250,priest,discipline,28,15,13
Vancake,quelthalas,1250,priest,discipline,150,68,82
Damoclexz,area-52,1249,priest,discipline,48,28,20
Nóin,tichondrius,1249,priest,discipline,42,19,23
Allhubris,stormrage,1248,priest,discipline,24,13,11
Mason,winterhoof,1247,priest,discipline,18,13,5
Kayern,kelthuzad,1247,priest,discipline,18,13,5
Meatboxmoldy,blood-furnace,1247,priest,discipline,24,13,11
Luminatio,quelthalas,1247,priest,discipline,50,26,24
Pce,korialstrasz,1247,priest,discipline,34,13,21
Picurry,frostmourne,1246,priest,discipline,24,13,11
Soaphia,kelthuzad,1245,priest,discipline,36,22,14
Halfcutt,tichondrius,1245,priest,discipline,24,13,11
Staysmall,stormrage,1245,priest,discipline,24,13,11
Tluoc,nemesis,1244,priest,discipline,30,14,16
Leticia,magtheridon,1243,priest,discipline,30,13,17
Meiev,quelthalas,1243,priest,discipline,36,13,23
Zizziz,tichondrius,1242,priest,discipline,24,13,11
Lingdums,tichondrius,1242,priest,discipline,25,13,12
Sanitater,frostmourne,1242,priest,discipline,54,26,28
Grapës,jubeithos,1242,priest,discipline,48,23,25
Lovesy,burning-legion,1241,priest,discipline,24,13,11
Alawn,wyrmrest-accord,1241,priest,discipline,78,30,48
Creòle,area-52,1240,priest,discipline,24,13,11
Mchinder,tanaris,1239,priest,discipline,21,15,6
Betrthenadam,bleeding-hollow,1239,priest,discipline,54,26,28
Santhiel,ragnaros,1239,priest,discipline,30,13,17
Shrax,emerald-dream,1239,priest,discipline,30,13,17
Quickq,barthilas,1237,priest,discipline,24,15,9
Lvcia,thrall,1237,priest,discipline,52,26,26
Tyreliy,eitrigg,1237,priest,discipline,84,40,44
Modotszilla,bleeding-hollow,1237,priest,discipline,30,13,17
Jinniu,azralon,1234,priest,discipline,30,13,17
Saràh,stormscale,1233,priest,discipline,88,39,49
Dlysexic,barthilas,1231,priest,discipline,18,13,5
Rháényra,tichondrius,1231,priest,discipline,24,13,11
Mellerwine,azralon,1231,priest,discipline,124,64,60
Icyspicy,shadowsong,1231,priest,discipline,53,25,28
Holyxb,bleeding-hollow,1231,priest,discipline,36,13,23
Shïtheals,frostmourne,1230,priest,discipline,42,25,17
Mileslol,azgalor,1230,priest,discipline,24,13,11
Aipata,stormrage,1228,priest,discipline,30,17,13
Kurtsheals,destromath,1228,priest,discipline,60,31,29
Aape,frostmourne,1227,priest,discipline,24,13,11
Newchaos,hakkar,1225,priest,discipline,24,13,11
Yeshùa,drakkari,1223,priest,discipline,30,13,17
Ahitaro,ragnaros,1223,priest,discipline,60,18,42
Sauile,kelthuzad,1222,priest,discipline,30,15,15
Kapriestun,tichondrius,1219,priest,discipline,36,21,15
Pixa,tichondrius,1218,priest,discipline,54,25,29
Cajl,dathremar,1217,priest,discipline,55,20,35
Orìsel,wyrmrest-accord,1214,priest,discipline,93,42,51
Tempgnome,stonemaul,1213,priest,discipline,43,21,22
Krypticus,tichondrius,1210,priest,discipline,42,24,18
Deckardkane,stormrage,1209,priest,discipline,32,14,18
Discgolfsux,sargeras,1209,priest,discipline,36,13,23
Kodaks,frostmourne,1208,priest,discipline,75,37,38
Kithlas,emerald-dream,1206,priest,discipline,18,13,5
Nothinsexual,frostmourne,1206,priest,discipline,26,14,12
Dpshealer,azralon,1206,priest,discipline,66,29,37
Tdmheals,zuluhed,1204,priest,discipline,24,18,6
Ithvedriel,moon-guard,1203,priest,discipline,67,32,35
Scrollozaddy,illidan,1201,priest,discipline,30,18,12
Healzyew,dragonmaw,1201,priest,discipline,73,28,45
Aliciab,andorhal,1198,priest,discipline,36,19,17
Fozil,area-52,1194,priest,discipline,62,33,29
Josquin,illidan,1192,priest,discipline,23,13,10
Inarius,dragonblight,1188,priest,discipline,42,17,25
Kruciphix,tichondrius,1187,priest,discipline,29,20,9
Nanabritches,moon-guard,1187,priest,discipline,44,23,21
Unwòke,dalaran,1182,priest,discipline,24,14,10
Doubtmyfaith,frostmourne,1181,priest,discipline,42,21,21
Linarindil,hyjal,1181,priest,discipline,35,15,20
Médíc,dalaran,1178,priest,discipline,30,13,17
Invocational,moon-guard,1175,priest,discipline,29,14,15
Kethseth,ragnaros,1175,priest,discipline,102,45,57
Hiheals,anvilmar,1174,priest,discipline,36,20,16
Mindlames,bleeding-hollow,1173,priest,discipline,68,30,38
Minimelo,stormrage,1172,priest,discipline,23,13,10
Spyzz,gilneas,1172,priest,discipline,36,18,18
Abbot,zangarmarsh,1169,priest,discipline,54,27,27
Sév,frostmane,1169,priest,discipline,160,79,81
Kerazul,sargeras,1169,priest,discipline,42,20,22
Vànhendrix,tichondrius,1167,priest,discipline,17,13,4
Kafzial,zuljin,1162,priest,discipline,74,43,31
Ariavish,area-52,1160,priest,discipline,36,17,19
Yidra,illidan,1159,priest,discipline,24,14,10
Holyycrit,kelthuzad,1158,priest,discipline,24,13,11
Semirg,moon-guard,1158,priest,discipline,30,13,17
Tarny,tichondrius,1157,priest,discipline,22,14,8
Köto,dalaran,1157,priest,discipline,23,13,10
Coldphobia,uldum,1157,priest,discipline,32,14,18
Gobnik,illidan,1156,priest,discipline,24,16,8
Skadín,stormrage,1153,priest,discipline,26,13,13
Optîmuskrayt,tichondrius,1153,priest,discipline,71,35,36
Maraagsdad,tichondrius,1152,priest,discipline,18,12,6
Qenq,tichondrius,1152,priest,discipline,18,12,6
Yobell,tichondrius,1152,priest,discipline,18,12,6
Kalyndaxo,frostmourne,1152,priest,discipline,24,12,12
Swagdemøn,kelthuzad,1152,priest,discipline,24,12,12
Cavatea,illidan,1152,priest,discipline,24,12,12
Ømegagødx,illidan,1152,priest,discipline,30,12,18
Addisonraee,tichondrius,1151,priest,discipline,12,12,0
Highprofile,proudmoore,1151,priest,discipline,18,12,6
Wandynha,nemesis,1151,priest,discipline,18,12,6
Faithbuild,emerald-dream,1151,priest,discipline,18,12,6
Randrimm,stormrage,1151,priest,discipline,24,12,12
Sshhaaddooww,tichondrius,1151,priest,discipline,24,12,12
Alphôn,bleeding-hollow,1151,priest,discipline,24,12,12
Bonehead,warsong,1151,priest,discipline,25,12,13
Attenea,illidan,1151,priest,discipline,36,12,24
Ilmx,illidan,1150,priest,discipline,12,12,0
Syo,dreadmaul,1150,priest,discipline,18,12,6
Abercromby,malganis,1150,priest,discipline,25,12,13
Maxximuss,bleeding-hollow,1150,priest,discipline,42,17,25
Bakara,jubeithos,1150,priest,discipline,36,12,24
Clockwororan,tichondrius,1149,priest,discipline,18,12,6
Profpepper,tichondrius,1149,priest,discipline,18,12,6
Pakc,tichondrius,1149,priest,discipline,24,12,12
Gigaflex,sargeras,1148,priest,discipline,24,12,12
Fádéd,tichondrius,1148,priest,discipline,24,12,12
Metick,illidan,1148,priest,discipline,30,12,18
Ekros,illidan,1147,priest,discipline,25,13,12
Opscurum,bleeding-hollow,1147,priest,discipline,24,12,12
Cigarillõ,thrall,1147,priest,discipline,24,12,12
Rythmzz,kiljaeden,1147,priest,discipline,30,12,18
Scrubgames,garrosh,1146,priest,discipline,12,12,0
Planchebois,zuljin,1146,priest,discipline,24,12,12
Lilbaldjosh,frostmourne,1146,priest,discipline,36,12,24
Merkinhealz,darkspear,1145,priest,discipline,24,12,12
Chiot,tichondrius,1144,priest,discipline,18,12,6
Lethalrosé,thrall,1144,priest,discipline,18,12,6
Mashpotato,aerie-peak,1144,priest,discipline,24,13,11
Saentha,sargeras,1143,priest,discipline,24,12,12
Grimspriest,moon-guard,1143,priest,discipline,24,12,12
Depressedboy,wyrmrest-accord,1143,priest,discipline,24,12,12
Donzorro,ragnaros,1143,priest,discipline,36,14,22
Mutilla,tichondrius,1142,priest,discipline,18,12,6
Norastanne,moon-guard,1142,priest,discipline,24,12,12
Thottee,bleeding-hollow,1142,priest,discipline,36,12,24
Elvspriesly,doomhammer,1138,priest,discipline,104,51,53
Kßnstuff,area-52,1137,priest,discipline,31,13,18
Sadistic,hyjal,1137,priest,discipline,36,12,24
Brotherheals,nagrand,1136,priest,discipline,60,30,30
Terenor,thrall,1136,priest,discipline,36,12,24
Blessings,aerie-peak,1135,priest,discipline,66,34,32
Xmasmiracle,korgath,1134,priest,discipline,58,31,27
Faerline,kelthuzad,1134,priest,discipline,29,12,17
Volkova,quelthalas,1133,priest,discipline,18,12,6
Hideyourkids,stormreaver,1133,priest,discipline,24,12,12
Goodbyekiss,illidan,1131,priest,discipline,48,22,26
Corthien,thrall,1129,priest,discipline,30,12,18
Mäy,greymane,1128,priest,discipline,24,12,12
Cyrilien,tichondrius,1127,priest,discipline,52,29,23
Ragnarøk,warsong,1127,priest,discipline,30,12,18
Testament,greymane,1127,priest,discipline,42,13,29
Wísh,emerald-dream,1126,priest,discipline,36,19,17
Fearnought,stormrage,1125,priest,discipline,22,13,9
Sinnon,turalyon,1121,priest,discipline,24,12,12
Primeevil,black-dragonflight,1119,priest,discipline,24,14,10
Alizeë,illidan,1117,priest,discipline,75,42,33
Finake,kelthuzad,1116,priest,discipline,18,12,6
Armspriest,stormrage,1115,priest,discipline,24,12,12
Vitalizes,nagrand,1114,priest,discipline,30,13,17
Charybdis,bonechewer,1112,priest,discipline,24,16,8
Tetha,fizzcrank,1112,priest,discipline,30,14,16
Drywàter,tichondrius,1108,priest,discipline,69,38,31
Makkima,area-52,1107,priest,discipline,36,14,22
Ickarus,anubarak,1105,priest,discipline,54,26,28
Ataraksija,sargeras,1103,priest,discipline,21,13,8
Súlfuro,quelthalas,1103,priest,discipline,83,39,44
Såge,chogall,1100,priest,discipline,75,37,38
Khamata,kelthuzad,1100,priest,discipline,30,12,18
Goingserious,frostmourne,1099,priest,discipline,51,26,25
Lynnar,stormrage,1097,priest,discipline,30,15,15
Vákc,quelthalas,1096,priest,discipline,23,12,11
Lowkii,malfurion,1095,priest,discipline,23,12,11
Xpera,dalaran,1095,priest,discipline,29,12,17
Kms,sargeras,1094,priest,discipline,21,13,8
Bigdaddyku,hyjal,1088,priest,discipline,34,20,14
Holysmokesx,tichondrius,1087,priest,discipline,22,12,10
Fatherfilth,frostwolf,1086,priest,discipline,30,14,16
Deehilie,illidan,1085,priest,discipline,37,19,18
Vaddaru,kirin-tor,1083,priest,discipline,66,38,28
Slavoj,gurubashi,1083,priest,discipline,29,15,14
Sadury,tichondrius,1081,priest,discipline,47,30,17
Puralux,balnazzar,1080,priest,discipline,24,15,9
Aynone,blood-furnace,1071,priest,discipline,90,42,48
Cypress,dreadmaul,1069,priest,discipline,40,20,20
Miraz,the-venture-co,1067,priest,discipline,17,12,5
Twinkmuncher,proudmoore,1065,priest,discipline,25,12,13
Vahlen,azralon,1062,priest,discipline,23,12,11
Fairylìght,stormrage,1062,priest,discipline,31,12,19
Psÿçhë,stormrage,1056,priest,discipline,18,11,7
Corvenna,zuljin,1056,priest,discipline,18,11,7
Jmjeezy,tichondrius,1056,priest,discipline,18,11,7
Praemal,tichondrius,1056,priest,discipline,18,11,7
Ivorytiger,bleeding-hollow,1056,priest,discipline,24,11,13
Celestiah,kelthuzad,1056,priest,discipline,24,11,13
Azzäm,tichondrius,1056,priest,discipline,24,11,13
Ogneus,crushridge,1056,priest,discipline,30,11,19
Naelsaze,tichondrius,1055,priest,discipline,12,11,1
Shrimpouh,illidan,1055,priest,discipline,18,11,7
Canibumsmoke,illidan,1055,priest,discipline,18,11,7
Haetas,zuljin,1055,priest,discipline,24,11,13
Beejaex,stormreaver,1055,priest,discipline,24,11,13
Oghealz,lightnings-blade,1055,priest,discipline,24,11,13
Tooziq,stormrage,1055,priest,discipline,24,11,13
Astrøpriest,tichondrius,1055,priest,discipline,24,11,13
Turrec,illidan,1054,priest,discipline,12,11,1
Aiss,malganis,1054,priest,discipline,16,12,4
Discgoddess,proudmoore,1054,priest,discipline,18,11,7
Ãbelladanger,area-52,1054,priest,discipline,18,11,7
Dpsmercy,sargeras,1054,priest,discipline,24,11,13
Hadtogothere,kelthuzad,1054,priest,discipline,24,11,13
Herder,zuljin,1053,priest,discipline,18,11,7
Kiritomauti,ragnaros,1053,priest,discipline,18,11,7
Azaradet,ragnaros,1053,priest,discipline,30,11,19
Antagzy,bleeding-hollow,1052,priest,discipline,18,11,7
Naranjitá,ragnaros,1052,priest,discipline,18,11,7
Zadae,area-52,1052,priest,discipline,24,12,12
Silkydeath,frostmourne,1052,priest,discipline,24,11,13
Triangle,draka,1052,priest,discipline,24,11,13
Tammyone,emerald-dream,1051,priest,discipline,18,11,7
Efrem,tichondrius,1051,priest,discipline,54,25,29
Draazja,dalaran,1051,priest,discipline,24,11,13
Darkills,tichondrius,1051,priest,discipline,24,11,13
Gamist,area-52,1051,priest,discipline,24,11,13
Lumia,quelthalas,1051,priest,discipline,30,11,19
Vampiric,laughing-skull,1050,priest,discipline,18,11,7
Docmcstufins,darkspear,1050,priest,discipline,24,11,13
Lalight,tichondrius,1050,priest,discipline,30,11,19
Libationz,area-52,1050,priest,discipline,42,12,30
Takethat,emerald-dream,1049,priest,discipline,18,11,7
Posabilties,bleeding-hollow,1049,priest,discipline,24,11,13
Drinkndrive,tichondrius,1048,priest,discipline,18,11,7
Slippedadisc,kelthuzad,1048,priest,discipline,24,11,13
Tiskka,magtheridon,1047,priest,discipline,30,11,19
Quinnx,tichondrius,1046,priest,discipline,24,11,13
Karminha,azralon,1044,priest,discipline,18,11,7
Erossenin,proudmoore,1044,priest,discipline,24,11,13
Matchakatt,tichondrius,1043,priest,discipline,18,11,7
Lilbabe,stormrage,1043,priest,discipline,24,11,13
Cezanne,tichondrius,1043,priest,discipline,107,47,60
Femalema,tichondrius,1042,priest,discipline,27,13,14
Orzington,laughing-skull,1042,priest,discipline,30,11,19
Dottinu,area-52,1040,priest,discipline,12,11,1
Iwillsaveyou,tichondrius,1039,priest,discipline,28,13,15
Sendia,hydraxis,1038,priest,discipline,66,31,35
Dalowks,area-52,1038,priest,discipline,30,11,19
Khadgrin,kelthuzad,1036,priest,discipline,30,15,15
Sajahsa,moon-guard,1035,priest,discipline,19,12,7
Gungagingong,queldorei,1035,priest,discipline,18,11,7
Jackflashh,hakkar,1033,priest,discipline,48,19,29
Uchihalol,tichondrius,1032,priest,discipline,24,11,13
Geulis,illidan,1030,priest,discipline,65,30,35
Mottsarella,mugthol,1027,priest,discipline,36,22,14
Bröke,nemesis,1024,priest,discipline,24,11,13
Bakharftw,nemesis,1023,priest,discipline,28,17,11
Macoa,zuljin,1023,priest,discipline,30,14,16
Ravnica,kelthuzad,1023,priest,discipline,28,12,16
Lyxx,kelthuzad,1022,priest,discipline,16,12,4
Mxd,bleeding-hollow,1021,priest,discipline,20,12,8
Mgfoxxie,scarlet-crusade,1020,priest,discipline,30,12,18
Nickzx,tichondrius,1019,priest,discipline,22,12,10
Thadan,uldaman,1019,priest,discipline,24,11,13
Ketone,malganis,1018,priest,discipline,45,24,21
Gðttlich,stormrage,1016,priest,discipline,26,12,14
Jèf,stormrage,1015,priest,discipline,23,11,12
Profît,stormrage,1014,priest,discipline,24,12,12
Toastanator,wyrmrest-accord,1012,priest,discipline,65,33,32
Uljinoo,blackwing-lair,1010,priest,discipline,32,13,19
Zhaann,kelthuzad,1009,priest,discipline,24,11,13
Pactosombrio,azralon,1007,priest,discipline,24,11,13
Voidwyrm,tichondrius,1006,priest,discipline,36,14,22
Jebadiia,tichondrius,1005,priest,discipline,28,12,16
Chaøz,emerald-dream,1003,priest,discipline,23,11,12
Safetyy,bleeding-hollow,1003,priest,discipline,23,11,12
Tikel,ragnaros,1001,priest,discipline,21,11,10
Kerith,ragnaros,995,priest,discipline,22,15,7
Pocserpriest,drakkari,990,priest,discipline,26,11,15
Zaemyn,dalaran,987,priest,discipline,26,11,15
Diamontie,tichondrius,977,priest,discipline,26,16,10
Anäster,ragnaros,977,priest,discipline,24,11,13
Alurand,bleeding-hollow,976,priest,discipline,18,11,7
Hanuroa,tichondrius,969,priest,discipline,102,49,53
Varbirttok,sargeras,969,priest,discipline,31,12,19
Sharkda,frostmourne,965,priest,discipline,33,17,16
Tesserak,tichondrius,961,priest,discipline,52,18,34
Swaggie,skullcrusher,960,priest,discipline,12,10,2
Plaguebaby,stormrage,960,priest,discipline,15,11,4
Harlei,tichondrius,960,priest,discipline,18,11,7
Veejae,tichondrius,960,priest,discipline,18,10,8
Dacine,illidan,960,priest,discipline,18,10,8
Bswagxx,illidan,960,priest,discipline,18,10,8
Likehisname,tichondrius,960,priest,discipline,18,10,8
Smitelytius,tichondrius,960,priest,discipline,18,10,8
Klitarus,barthilas,960,priest,discipline,18,10,8
Barley,chogall,960,priest,discipline,18,10,8
Cheechee,executus,960,priest,discipline,18,10,8
Ggwizkaboo,tichondrius,960,priest,discipline,18,10,8
Shadina,gorefiend,960,priest,discipline,18,10,8
Pitayakiller,tichondrius,960,priest,discipline,18,10,8
Belielosong,moon-guard,960,priest,discipline,57,29,28
Anyra,stormrage,960,priest,discipline,24,10,14
Summersetisl,tichondrius,960,priest,discipline,24,10,14
Dayquills,illidan,960,priest,discipline,24,10,14
Fotmtrash,the-underbog,960,priest,discipline,24,10,14
Dëàthwîsh,tichondrius,960,priest,discipline,24,10,14
Aube,frostmourne,960,priest,discipline,27,10,17
Saviorlol,tichondrius,960,priest,discipline,30,10,20
Legendary,ragnaros,960,priest,discipline,30,10,20
Rustypinball,bleeding-hollow,959,priest,discipline,12,10,2
Henchwoman,stormrage,959,priest,discipline,12,10,2
Dellitor,illidan,959,priest,discipline,18,10,8
Nabukom,destromath,959,priest,discipline,18,10,8
Gamepass,tichondrius,959,priest,discipline,18,10,8
Oduum,tichondrius,959,priest,discipline,18,10,8
Heltor,sargeras,959,priest,discipline,18,10,8
Pocket,alleria,959,priest,discipline,18,10,8
Darknus,sargeras,959,priest,discipline,18,10,8
Kukion,uldum,959,priest,discipline,24,10,14
Acpriest,tichondrius,959,priest,discipline,24,10,14
Johadorr,shadowsong,959,priest,discipline,24,10,14
Mosquito,tichondrius,959,priest,discipline,24,10,14
Narodiz,nemesis,959,priest,discipline,24,10,14
Esciel,ragnaros,959,priest,discipline,30,10,20
Stynke,bleeding-hollow,959,priest,discipline,30,10,20
Leliane,tichondrius,958,priest,discipline,18,10,8
Voidathon,sargeras,958,priest,discipline,18,10,8
Ngin,queldorei,958,priest,discipline,18,10,8
Xävier,farstriders,958,priest,discipline,24,10,14
Goodvybes,tichondrius,958,priest,discipline,24,10,14
Luciellis,sargeras,958,priest,discipline,24,10,14
Nelpesh,tichondrius,958,priest,discipline,30,10,20
Wilburre,sargeras,957,priest,discipline,18,10,8
Xora,frostmourne,957,priest,discipline,30,10,20
Chanyt,azralon,956,priest,discipline,12,10,2
Mkowns,tichondrius,956,priest,discipline,18,10,8
Huck,khazgoroth,955,priest,discipline,18,10,8
Bachaterah,skullcrusher,955,priest,discipline,24,10,14
Chastised,moon-guard,955,priest,discipline,93,30,63
Hanklin,lightnings-blade,954,priest,discipline,18,10,8
Napzz,sargeras,954,priest,discipline,18,10,8
Chinsta,tichondrius,954,priest,discipline,24,10,14
Cyphrus,hyjal,954,priest,discipline,24,10,14
Anthoras,stormrage,953,priest,discipline,18,10,8
Flagged,azgalor,953,priest,discipline,24,10,14
Nexp,tichondrius,952,priest,discipline,18,10,8
Jessicä,malganis,952,priest,discipline,18,10,8
Moomagic,sargeras,952,priest,discipline,30,11,19
Steezyy,black-dragonflight,951,priest,discipline,18,10,8
Daijoubu,lightnings-blade,951,priest,discipline,24,10,14
Webbii,frostmourne,951,priest,discipline,24,10,14
Atelios,azralon,948,priest,discipline,12,10,2
Filterz,korgath,948,priest,discipline,24,10,14
Theboogieman,magtheridon,946,priest,discipline,24,10,14
Throwinshadê,stormrage,944,priest,discipline,72,36,36
Elixia,maiev,943,priest,discipline,24,10,14
Praiz,tichondrius,942,priest,discipline,18,12,6
Preezoo,tichondrius,932,priest,discipline,30,10,20
Toastedheal,stormreaver,927,priest,discipline,20,11,9
Dietcokee,stormrage,927,priest,discipline,20,11,9
Kuell,ragnaros,904,priest,discipline,20,11,9
Eluko,tichondrius,904,priest,discipline,21,11,10
Voidwulf,azgalor,903,priest,discipline,54,26,28
Tootsieroll,dark-iron,901,priest,discipline,23,10,13
Paidtowin,frostmourne,895,priest,discipline,26,10,16
Tezcatyo,area-52,891,priest,discipline,17,10,7
Trummp,tichondrius,889,priest,discipline,17,10,7
Serana,maelstrom,882,priest,discipline,89,45,44
Khinthazin,barthilas,878,priest,discipline,42,20,22
Crutch,blackhand,864,priest,discipline,12,9,3
Gillette,thunderlord,864,priest,discipline,12,9,3
Lullabya,tichondrius,864,priest,discipline,12,9,3
Néy,illidan,864,priest,discipline,12,9,3
Marcalus,garrosh,864,priest,discipline,15,9,6
Vcainyfairy,stormrage,864,priest,discipline,18,9,9
Challengerz,suramar,864,priest,discipline,18,9,9
Reedyjrrtv,tichondrius,864,priest,discipline,18,9,9
Cinnalite,darkspear,864,priest,discipline,18,9,9
Zlowbly,ragnaros,864,priest,discipline,18,9,9
Voidgames,area-52,864,priest,discipline,24,9,15
Lostmind,malganis,864,priest,discipline,24,9,15
Soulcleave,dark-iron,864,priest,discipline,24,9,15
Dasaq,sargeras,864,priest,discipline,24,9,15
Rotbaron,bleeding-hollow,864,priest,discipline,24,9,15
Qipriest,tichondrius,864,priest,discipline,36,9,27
Justafkoutpr,gorefiend,863,priest,discipline,12,9,3
Bobelgum,emerald-dream,863,priest,discipline,12,9,3
Starpass,illidan,863,priest,discipline,12,9,3
Holycoww,lightnings-blade,863,priest,discipline,12,9,3
Jhivagosp,tichondrius,863,priest,discipline,12,9,3
Helleamh,tichondrius,863,priest,discipline,12,9,3
Davinatrans,azralon,863,priest,discipline,12,9,3
Dachenchen,tichondrius,863,priest,discipline,12,9,3
Djxkidrock,moon-guard,863,priest,discipline,12,9,3
Pryst,bonechewer,863,priest,discipline,18,9,9
Daburnz,bleeding-hollow,863,priest,discipline,18,9,9
Oprst,tichondrius,863,priest,discipline,18,9,9
Digop,azralon,863,priest,discipline,18,9,9
Fugazy,barthilas,863,priest,discipline,18,9,9
Augustrox,ragnaros,863,priest,discipline,18,9,9
Wonpaipri,frostmourne,863,priest,discipline,24,9,15
Nutsin,tichondrius,863,priest,discipline,24,9,15
Aesudan,dalaran,862,priest,discipline,13,9,4
Rondrica,stormscale,862,priest,discipline,18,9,9
Dokthekim,frostmourne,862,priest,discipline,18,9,9
Ppomx,tichondrius,862,priest,discipline,18,9,9
Satanshealer,terokkar,862,priest,discipline,18,9,9
Easypriest,tichondrius,862,priest,discipline,18,9,9
Supski,destromath,862,priest,discipline,18,9,9
Redclover,tichondrius,862,priest,discipline,18,9,9
Lacerating,illidan,862,priest,discipline,18,9,9
Absørptiøn,area-52,862,priest,discipline,18,9,9
Sinnertitanz,quelthalas,861,priest,discipline,18,9,9
Ayakoji,proudmoore,861,priest,discipline,24,9,15
Séraphin,proudmoore,860,priest,discipline,19,11,8
Imcringing,illidan,860,priest,discipline,18,9,9
Klowdz,burning-blade,860,priest,discipline,18,9,9
Bingleboi,area-52,860,priest,discipline,20,9,11
Moresbo,frostmourne,859,priest,discipline,18,9,9
Vexyy,tichondrius,859,priest,discipline,18,9,9
Chkashaa,emerald-dream,859,priest,discipline,18,9,9
Misfyt,emerald-dream,859,priest,discipline,24,9,15
Howdydoo,azshara,859,priest,discipline,25,9,16
Divinity,hellscream,858,priest,discipline,24,9,15
Presto,kalecgos,857,priest,discipline,12,9,3
Mando,area-52,857,priest,discipline,14,10,4
Osombra,azralon,856,priest,discipline,12,9,3
Phonomena,malganis,856,priest,discipline,18,9,9
Caiitlynn,quelthalas,856,priest,discipline,24,9,15
Igotdots,scilla,854,priest,discipline,42,18,24
Coachbombae,tichondrius,853,priest,discipline,12,9,3
Eneco,alleria,846,priest,discipline,12,9,3
Brahskeet,illidan,841,priest,discipline,30,9,21
Thelonioüs,tichondrius,832,priest,discipline,55,20,35
Toddmund,tichondrius,832,priest,discipline,28,9,19
Rockrock,zuljin,831,priest,discipline,14,11,3
Rigityrekt,aggramar,831,priest,discipline,12,9,3
Kaguyä,ragnaros,830,priest,discipline,17,9,8
Faxingberlin,sargeras,814,priest,discipline,29,9,20
Replacednewb,chogall,813,priest,discipline,15,10,5
Shadowdeathx,bleeding-hollow,813,priest,discipline,17,9,8
Cathêlay,bleeding-hollow,804,priest,discipline,31,12,19
Painpaws,moon-guard,800,priest,discipline,16,9,7
Aladdinlol,tichondrius,799,priest,discipline,28,9,19
Misaosan,azralon,796,priest,discipline,14,9,5
Ðrip,burning-legion,796,priest,discipline,16,9,7
Deusthanatos,medivh,783,priest,discipline,23,9,14
Caz,sargeras,775,priest,discipline,24,12,12
Censyz,tichondrius,768,priest,discipline,12,8,4
Mimz,trollbane,768,priest,discipline,12,8,4
Criiltwo,area-52,768,priest,discipline,12,8,4
Müsic,stormrage,768,priest,discipline,12,8,4
Csjy,illidan,768,priest,discipline,12,8,4
Wholeness,kelthuzad,768,priest,discipline,12,8,4
Merit,emerald-dream,768,priest,discipline,12,8,4
Heeka,kelthuzad,768,priest,discipline,12,8,4
Curney,stormrage,768,priest,discipline,12,8,4
Voltekkeh,tichondrius,768,priest,discipline,12,8,4
Tiestô,tichondrius,768,priest,discipline,12,8,4
Soloqqt,tichondrius,768,priest,discipline,12,8,4
Evèlyn,dathremar,768,priest,discipline,12,8,4
Yansuanmu,tichondrius,768,priest,discipline,12,8,4
Iyoui,tichondrius,768,priest,discipline,12,8,4
Discipline,the-scryers,768,priest,discipline,12,8,4
Soupbean,zuljin,768,priest,discipline,12,8,4
Myòvó,tichondrius,768,priest,discipline,12,8,4
Spriestbro,emerald-dream,768,priest,discipline,12,8,4
Gutrìck,tichondrius,768,priest,discipline,12,8,4
Ñightelf,area-52,768,priest,discipline,12,8,4
Bloodyx,bleeding-hollow,768,priest,discipline,12,8,4
Testzpriests,dalaran,768,priest,discipline,12,8,4
Falsity,kelthuzad,768,priest,discipline,12,8,4
Ahoy,sargeras,768,priest,discipline,16,9,7
Dojacatx,frostmourne,768,priest,discipline,18,8,10
Aikinorz,tichondrius,768,priest,discipline,18,8,10
Papafajita,area-52,768,priest,discipline,18,8,10
Lumies,tichondrius,768,priest,discipline,18,8,10
Sotore,bleeding-hollow,768,priest,discipline,18,8,10
Melielectra,tichondrius,768,priest,discipline,18,8,10
Tshik,ragnaros,768,priest,discipline,18,8,10
Shadowchaos,malganis,768,priest,discipline,18,8,10
Zins,emerald-dream,768,priest,discipline,18,8,10
Vsat,illidan,768,priest,discipline,18,8,10
Smiliebomb,tichondrius,768,priest,discipline,18,8,10
Anahka,tichondrius,768,priest,discipline,18,8,10
Diwara,ragnaros,768,priest,discipline,18,8,10
Youaint,sargeras,768,priest,discipline,18,8,10
Troja,malganis,768,priest,discipline,18,8,10
Manbelow,bleeding-hollow,768,priest,discipline,27,9,18
Dylan,shuhalo,768,priest,discipline,24,8,16
Urgetopurge,dunemaul,767,priest,discipline,12,8,4
Ryuuka,sargeras,767,priest,discipline,12,8,4
Elkies,area-52,767,priest,discipline,12,8,4
Accismus,khadgar,767,priest,discipline,12,8,4
Ÿsk,tichondrius,767,priest,discipline,12,8,4
Jjløver,tichondrius,767,priest,discipline,12,8,4
Lucènt,frostmourne,767,priest,discipline,12,8,4
Sixfiggas,darkspear,767,priest,discipline,12,8,4
Discobluntzz,tichondrius,767,priest,discipline,12,8,4
Silnetlee,tichondrius,767,priest,discipline,12,8,4
Lelyna,stormrage,767,priest,discipline,12,8,4
Alarisa,chogall,767,priest,discipline,12,8,4
Jabreez,illidan,767,priest,discipline,12,8,4
Icônz,malganis,767,priest,discipline,12,8,4
Iulu,doomhammer,767,priest,discipline,12,8,4
Javox,drakkari,767,priest,discipline,12,8,4
Zarfel,ragnaros,767,priest,discipline,12,8,4
Analiesa,moon-guard,767,priest,discipline,18,8,10
Zyklonova,frostmourne,767,priest,discipline,18,8,10
Peristalsis,nesingwary,767,priest,discipline,18,8,10
Hellsembrace,lightbringer,767,priest,discipline,18,8,10
Therialjp,ragnaros,767,priest,discipline,18,8,10
Datspice,stormrage,767,priest,discipline,18,8,10
Ohgiddy,dalaran,767,priest,discipline,18,8,10
Yürika,emerald-dream,767,priest,discipline,24,8,16
Healmegently,bonechewer,767,priest,discipline,24,8,16
Fatherdan,blackrock,767,priest,discipline,24,8,16
Èuneekz,thrall,767,priest,discipline,24,8,16
Zulazane,azralon,766,priest,discipline,12,8,4
Xhaajyh,area-52,766,priest,discipline,12,8,4
Gõd,zuluhed,766,priest,discipline,18,8,10
Spriest,kul-tiras,766,priest,discipline,18,8,10
Jelzz,area-52,766,priest,discipline,18,8,10
Forober,queldorei,766,priest,discipline,33,12,21
Bandaidvibes,tichondrius,765,priest,discipline,12,8,4
Rinmaru,dark-iron,763,priest,discipline,12,8,4
Lätöxïkä,alleria,763,priest,discipline,17,8,9
Rókue,silvermoon,763,priest,discipline,18,8,10
Foxyy,wildhammer,763,priest,discipline,18,8,10
Sölemn,barthilas,763,priest,discipline,18,8,10
Badazzfrank,tichondrius,762,priest,discipline,18,8,10
Holyhog,whisperwind,761,priest,discipline,24,8,16
Fluxus,sargeras,760,priest,discipline,12,8,4
Jtewatch,zuljin,759,priest,discipline,12,8,4
Rescueherø,tichondrius,744,priest,discipline,18,8,10
Pokebox,frostmourne,735,priest,discipline,16,8,8
Skall,kirin-tor,729,priest,discipline,23,8,15
Muhfinx,tichondrius,719,priest,discipline,11,8,3
Invoice,bloodscalp,719,priest,discipline,17,8,9
Vtp,frostmourne,719,priest,discipline,17,8,9
Pðpë,area-52,718,priest,discipline,11,8,3
Fadewench,sargeras,718,priest,discipline,17,9,8
Trashdiscx,stormrage,707,priest,discipline,25,11,14
Sätîvá,tichondrius,703,priest,discipline,14,8,6
Dotersacer,quelthalas,701,priest,discipline,11,8,3
Azrïel,mannoroth,700,priest,discipline,17,8,9
Läsombra,area-52,684,priest,discipline,17,9,8
Washdp,frostmourne,672,priest,discipline,12,7,5
Waggers,moon-guard,672,priest,discipline,12,7,5
Littleshower,illidan,672,priest,discipline,12,7,5
Sylvphrena,stormrage,672,priest,discipline,12,7,5
Iol,spinebreaker,672,priest,discipline,12,7,5
Kazgry,illidan,672,priest,discipline,12,7,5
Walpurgis,skywall,672,priest,discipline,12,7,5
Greyx,moon-guard,672,priest,discipline,12,7,5
Phrìke,illidan,672,priest,discipline,12,7,5
Wheresmyvape,tichondrius,672,priest,discipline,12,7,5
Raivn,illidan,672,priest,discipline,12,7,5
Littlehcl,tichondrius,672,priest,discipline,12,7,5
Fäÿë,tichondrius,672,priest,discipline,12,7,5
Bòngu,tichondrius,672,priest,discipline,12,7,5
Dráugr,ragnaros,672,priest,discipline,12,7,5
Teiam,skullcrusher,672,priest,discipline,12,7,5
Wöödy,area-52,672,priest,discipline,12,7,5
Kencys,tichondrius,672,priest,discipline,12,7,5
Lyrä,kiljaeden,672,priest,discipline,12,7,5
Senpriest,ragnaros,672,priest,discipline,12,7,5
Ffej,bleeding-hollow,672,priest,discipline,12,7,5
Sentenel,duskwood,672,priest,discipline,12,7,5
Dirtydebbie,lightnings-blade,672,priest,discipline,12,7,5
Weezyxo,tichondrius,672,priest,discipline,12,7,5
Peelforheals,nordrassil,672,priest,discipline,12,7,5
Hypes,korgath,672,priest,discipline,12,7,5
Nosgoróth,quelthalas,672,priest,discipline,12,7,5
Dbod,tichondrius,672,priest,discipline,12,7,5
Taboogie,tichondrius,672,priest,discipline,12,7,5
Sadsadge,sargeras,672,priest,discipline,12,7,5
Ryno,cenarion-circle,672,priest,discipline,12,7,5
Bigchalupaz,sargeras,672,priest,discipline,12,7,5
Eggsdenny,illidan,672,priest,discipline,12,7,5
Sibble,boulderfist,672,priest,discipline,12,7,5
Tîg,nemesis,672,priest,discipline,15,7,8
Xayda,area-52,672,priest,discipline,18,7,11
Joeybats,frostwolf,672,priest,discipline,18,7,11
Louisé,hydraxis,672,priest,discipline,18,7,11
Hadoka,ragnaros,672,priest,discipline,18,7,11
Vizzy,stormrage,672,priest,discipline,18,7,11
Tomseleck,frostmourne,672,priest,discipline,18,7,11
Rigotakx,illidan,672,priest,discipline,18,7,11
Glöws,area-52,672,priest,discipline,18,7,11
Mastahspell,illidan,672,priest,discipline,18,7,11
Iwillrezguys,tichondrius,672,priest,discipline,18,7,11
Horzp,bleeding-hollow,672,priest,discipline,24,7,17
Stríkes,emerald-dream,672,priest,discipline,24,7,17
Onikûdaki,sargeras,672,priest,discipline,24,7,17
Lamont,archimonde,672,priest,discipline,24,7,17
Mahelet,drakkari,671,priest,discipline,12,7,5
Bombinburbon,durotan,671,priest,discipline,12,7,5
Jeremey,darkspear,671,priest,discipline,12,7,5
Honypot,ysondre,671,priest,discipline,12,7,5
Demonwizard,sargeras,671,priest,discipline,12,7,5
Fatherjerry,kiljaeden,671,priest,discipline,12,7,5
Discbubbles,moonrunner,671,priest,discipline,12,7,5
Unholyio,barthilas,671,priest,discipline,12,7,5
Lucsor,malganis,671,priest,discipline,12,7,5
Linlight,stormrage,671,priest,discipline,12,7,5
Travakel,proudmoore,671,priest,discipline,12,7,5
Methodist,sargeras,671,priest,discipline,12,7,5
Maenard,emerald-dream,671,priest,discipline,12,7,5
Zarfs,burning-blade,671,priest,discipline,12,7,5
Xiöm,quelthalas,671,priest,discipline,12,7,5
Debigheal,stormrage,671,priest,discipline,12,7,5
Lightschosen,malganis,671,priest,discipline,12,7,5
Meditåtion,tichondrius,671,priest,discipline,18,7,11
Elexy,tichondrius,671,priest,discipline,18,7,11
Randomheal,dunemaul,671,priest,discipline,18,7,11
Jeresh,sargeras,671,priest,discipline,36,7,29
Xð,jubeithos,670,priest,discipline,12,7,5
Panelopie,maiev,670,priest,discipline,12,7,5
Kaeshia,proudmoore,670,priest,discipline,12,7,5
Fesix,akama,670,priest,discipline,12,7,5
Riotgearmd,sargeras,670,priest,discipline,12,7,5
Donus,frostmane,670,priest,discipline,12,7,5
Pico,spirestone,670,priest,discipline,12,7,5
Jivita,lightbringer,670,priest,discipline,12,7,5
Samsunglions,tichondrius,670,priest,discipline,12,7,5
Happydot,stormrage,670,priest,discipline,12,7,5
Cvstodia,tichondrius,670,priest,discipline,12,7,5
Londog,vashj,670,priest,discipline,12,7,5
Antìdote,tichondrius,670,priest,discipline,12,7,5
Spiceenjoyer,emerald-dream,670,priest,discipline,15,8,7
Donoras,ursin,669,priest,discipline,12,7,5
Jikoguu,stormscale,669,priest,discipline,18,7,11
Gabryanna,emerald-dream,669,priest,discipline,18,7,11
Nielic,arygos,668,priest,discipline,12,7,5
Albertth,ragnaros,668,priest,discipline,18,7,11
Butterblessr,thunderlord,668,priest,discipline,19,7,12
Mortecraft,sargeras,666,priest,discipline,12,7,5
Eluv,area-52,666,priest,discipline,18,7,11
Trustheals,tichondrius,665,priest,discipline,12,7,5
Crossblesser,alleria,663,priest,discipline,12,7,5
Alterboy,garrosh,658,priest,discipline,12,7,5
Sisterdeáth,area-52,657,priest,discipline,18,7,11
Sinthe,stormrage,655,priest,discipline,12,8,4
Rcx,sargeras,655,priest,discipline,17,7,10
Ohsop,chogall,640,priest,discipline,16,7,9
Spicer,eredar,639,priest,discipline,11,7,4
Psyches,dalaran,639,priest,discipline,14,8,6
Alomari,zuljin,639,priest,discipline,14,8,6
Lalo,bleeding-hollow,638,priest,discipline,23,7,16
Fumes,ghostlands,638,priest,discipline,24,7,17
Jeffo,baelgun,636,priest,discipline,17,7,10
Kitenix,proudmoore,636,priest,discipline,23,7,16
Futatsi,zuljin,634,priest,discipline,23,7,16
Briefs,stormrage,624,priest,discipline,9,8,1
Swagacious,malganis,624,priest,discipline,13,8,5
Holysmegma,dreadmaul,623,priest,discipline,11,7,4
Penitentrowr,illidan,622,priest,discipline,15,7,8
Archcerion,stormreaver,621,priest,discipline,15,8,7
Youngboys,stormreaver,617,priest,discipline,17,11,6
Arzaei,quelthalas,608,priest,discipline,16,7,9
Åffliction,sargeras,607,priest,discipline,11,7,4
Played,dark-iron,607,priest,discipline,26,7,19
Codiroli,tichondrius,606,priest,discipline,14,7,7
Forprophet,proudmoore,606,priest,discipline,22,7,15
Dreamskull,aegwynn,605,priest,discipline,14,7,7
Dotsfortots,malfurion,591,priest,discipline,11,7,4
Lusch,stormscale,589,priest,discipline,19,10,9
Eudog,zuljin,576,priest,discipline,6,6,0
Syndrox,kelthuzad,576,priest,discipline,6,6,0
Euphotic,tichondrius,576,priest,discipline,6,6,0
Delai,dalaran,576,priest,discipline,6,6,0
Porffy,malygos,576,priest,discipline,6,6,0
Wizeau,dalaran,576,priest,discipline,6,6,0
Thirddps,illidan,576,priest,discipline,6,6,0
Zygotes,tichondrius,576,priest,discipline,6,6,0
Protega,illidan,576,priest,discipline,6,6,0
Themoon,tichondrius,576,priest,discipline,6,6,0
Septmoon,tichondrius,576,priest,discipline,6,6,0
Eldoras,zuljin,576,priest,discipline,6,6,0
Janna,jubeithos,576,priest,discipline,12,6,6
Cäpriestsunn,thrall,576,priest,discipline,12,6,6
Glitterballs,khazgoroth,576,priest,discipline,12,6,6
Pewwpew,malganis,576,priest,discipline,12,6,6
Joní,malganis,576,priest,discipline,12,6,6
Nelfpriest,khadgar,576,priest,discipline,12,6,6
Tamzy,eredar,576,priest,discipline,12,6,6
Drerrdaytv,kelthuzad,576,priest,discipline,12,6,6
Darkinfusion,illidan,576,priest,discipline,12,6,6
Wv,kelthuzad,576,priest,discipline,12,6,6
Shoepooper,kelthuzad,576,priest,discipline,12,6,6
Cazuex,ragnaros,576,priest,discipline,12,6,6
Thelastfight,frostmourne,576,priest,discipline,12,6,6
Syncope,garona,576,priest,discipline,12,6,6
Vanderbeek,frostmourne,576,priest,discipline,12,6,6
Tanzen,andorhal,576,priest,discipline,12,6,6
Redkiwi,illidan,576,priest,discipline,12,6,6
Slobmygnob,illidan,576,priest,discipline,12,6,6
Pheener,stormreaver,576,priest,discipline,12,6,6
Scripture,stormreaver,576,priest,discipline,12,6,6
Hiraa,frostmourne,576,priest,discipline,12,6,6
Jùdas,ravencrest,576,priest,discipline,12,6,6
Xiaochenchen,tichondrius,576,priest,discipline,12,6,6
Bloodfaith,stormrage,576,priest,discipline,12,6,6
Compåctdisc,sargeras,576,priest,discipline,12,6,6
Bigsmart,tichondrius,576,priest,discipline,12,6,6
Methodist,proudmoore,576,priest,discipline,12,6,6
Kawasakix,tichondrius,576,priest,discipline,12,6,6
Ilovemia,zuljin,576,priest,discipline,12,6,6
Napr,proudmoore,576,priest,discipline,12,6,6
Shakky,queldorei,576,priest,discipline,12,6,6
Prostrat,deathwing,576,priest,discipline,12,6,6
Bladam,bleeding-hollow,576,priest,discipline,12,6,6
Tuxen,wyrmrest-accord,576,priest,discipline,12,6,6
Wodpriestx,stormrage,576,priest,discipline,12,6,6
Azurestorm,tichondrius,576,priest,discipline,12,6,6
Zerola,sargeras,576,priest,discipline,12,6,6
Jimmythedon,mugthol,576,priest,discipline,12,6,6
Purpskurp,stormrage,576,priest,discipline,12,6,6
Wabie,illidan,576,priest,discipline,12,6,6
Randompreest,stormrage,576,priest,discipline,12,6,6
Saintjpii,tichondrius,576,priest,discipline,12,6,6
Daddydoeet,zuljin,576,priest,discipline,12,6,6
Cency,tichondrius,576,priest,discipline,12,6,6
Trezz,hakkar,576,priest,discipline,12,6,6
Blinxed,tichondrius,576,priest,discipline,12,6,6
Caveron,tichondrius,576,priest,discipline,12,6,6
Lemmiewinkzx,sargeras,576,priest,discipline,12,6,6
Jpgpng,tichondrius,576,priest,discipline,12,6,6
Lisau,tichondrius,576,priest,discipline,12,6,6
Mthwz,tichondrius,576,priest,discipline,12,6,6
Epik,moknathal,576,priest,discipline,12,6,6
Rellington,frostwolf,576,priest,discipline,12,6,6
Physics,frostmane,576,priest,discipline,12,6,6
Fatherjohnny,azuremyst,576,priest,discipline,12,6,6
Tricklee,tichondrius,576,priest,discipline,12,6,6
Wøah,stormrage,576,priest,discipline,12,6,6
Repriest,malganis,576,priest,discipline,18,6,12
Peaky,moonrunner,576,priest,discipline,18,6,12
Ärchangél,tichondrius,576,priest,discipline,18,6,12
Padragon,tichondrius,576,priest,discipline,18,6,12
Synaptikk,proudmoore,576,priest,discipline,18,6,12
Hårper,area-52,576,priest,discipline,18,6,12
Hideyason,area-52,576,priest,discipline,18,6,12
Keepsleepin,stormrage,576,priest,discipline,18,6,12
Priestmass,dalaran,576,priest,discipline,18,6,12
Fartnutts,dalaran,576,priest,discipline,18,6,12
Sandelios,aggramar,576,priest,discipline,18,6,12
Reiae,malganis,576,priest,discipline,27,7,20
Drupith,dalaran,576,priest,discipline,24,6,18
Thaldrum,tichondrius,576,priest,discipline,24,6,18
Astrìx,tichondrius,575,priest,discipline,6,6,0
Kephrek,eonar,575,priest,discipline,6,6,0
Wickedmoon,emerald-dream,575,priest,discipline,12,6,6
Göats,emerald-dream,575,priest,discipline,12,6,6
Kajagoogoö,emerald-dream,575,priest,discipline,12,6,6
Pacopriest,tichondrius,575,priest,discipline,12,6,6
Demimo,frostwolf,575,priest,discipline,12,6,6
Silveri,thrall,575,priest,discipline,12,6,6
Knez,ragnaros,575,priest,discipline,12,6,6
Ðohko,ragnaros,575,priest,discipline,12,6,6
Discotecno,tichondrius,575,priest,discipline,12,6,6
Draiger,quelthalas,575,priest,discipline,12,6,6
Aanora,illidan,575,priest,discipline,12,6,6
Brahmin,nazjatar,575,priest,discipline,12,6,6
Jeraphìm,tichondrius,575,priest,discipline,12,6,6
Soméone,sargeras,575,priest,discipline,12,6,6
Ðelight,ragnaros,575,priest,discipline,12,6,6
Aloragon,tichondrius,575,priest,discipline,12,6,6
Exanthrope,stormrage,575,priest,discipline,12,6,6
Peeinbottles,stormrage,575,priest,discipline,16,7,9
Biltpeter,tichondrius,575,priest,discipline,15,6,9
Squatrack,tichondrius,575,priest,discipline,18,6,12
Eîr,tichondrius,575,priest,discipline,24,6,18
Phaille,chromaggus,574,priest,discipline,12,6,6
Reilean,sargeras,573,priest,discipline,12,6,6
Ságrádá,area-52,573,priest,discipline,12,6,6
Prebruisz,baelgun,573,priest,discipline,12,6,6
Lookfig,frostmourne,573,priest,discipline,18,6,12
Bigchip,sargeras,573,priest,discipline,24,6,18
Novoc,blackhand,572,priest,discipline,12,6,6
Clergy,arthas,571,priest,discipline,12,6,6
Lördgrim,stormrage,571,priest,discipline,12,6,6
Thøt,malganis,570,priest,discipline,12,6,6
Jaster,proudmoore,570,priest,discipline,14,6,8
Cravex,stormrage,569,priest,discipline,12,6,6
Crossbones,cenarion-circle,566,priest,discipline,12,6,6
Emmarîl,sargeras,559,priest,discipline,17,6,11
Svrite,area-52,558,priest,discipline,17,6,11
Rymzxx,ragnaros,555,priest,discipline,13,7,6
Baali,moon-guard,543,priest,discipline,11,6,5
Earface,blades-edge,543,priest,discipline,14,7,7
Awaken,nerzhul,543,priest,discipline,17,6,11
Krindil,korgath,543,priest,discipline,17,6,11
Harborcoat,whisperwind,542,priest,discipline,17,6,11
Googolplex,tichondrius,528,priest,discipline,9,7,2
Moonlightx,destromath,528,priest,discipline,9,7,2
Nuvea,tichondrius,528,priest,discipline,15,6,9
Lesserfaith,sargeras,528,priest,discipline,15,6,9
Unholydomina,zuljin,525,priest,discipline,9,6,3
Dotdotdead,earthen-ring,522,priest,discipline,16,7,9
Ethari,crushridge,520,priest,discipline,21,7,14
Chapitä,drakkari,512,priest,discipline,10,6,4
Swapsy,illidan,511,priest,discipline,11,6,5
Lilmad,stormrage,511,priest,discipline,20,6,14
Nicety,skywall,511,priest,discipline,20,6,14
Moneymurph,blackrock,511,priest,discipline,26,6,20
Athzziry,ragnaros,507,priest,discipline,15,6,9
Cellestine,aggramar,496,priest,discipline,19,6,13
Subvert,zuljin,480,priest,discipline,6,5,1
Feymuhs,blackrock,480,priest,discipline,6,5,1
Azari,illidan,480,priest,discipline,6,5,1
Hateutoo,sargeras,480,priest,discipline,6,5,1
Akkassha,zuljin,480,priest,discipline,6,5,1
Afflickzz,kelthuzad,480,priest,discipline,6,5,1
Lildubs,bloodhoof,480,priest,discipline,6,5,1
Kebab,tichondrius,480,priest,discipline,6,5,1
Wagonss,stormrage,480,priest,discipline,6,5,1
Jerserra,emerald-dream,480,priest,discipline,6,5,1
Sixnoh,moonrunner,480,priest,discipline,6,5,1
Arfaxad,quelthalas,480,priest,discipline,6,5,1
Halcyon,eonar,480,priest,discipline,6,5,1
Çøçø,tichondrius,480,priest,discipline,6,5,1
ßræcher,black-dragonflight,480,priest,discipline,6,5,1
Elimix,frostmourne,480,priest,discipline,6,5,1
Jinforever,tichondrius,480,priest,discipline,6,5,1
Stegp,kelthuzad,480,priest,discipline,6,5,1
Hm,the-scryers,480,priest,discipline,6,5,1
Despairx,tichondrius,480,priest,discipline,6,5,1
Brian,lightnings-blade,480,priest,discipline,10,6,4
Jacqueline,tichondrius,480,priest,discipline,12,5,7
Whosjoe,tichondrius,480,priest,discipline,12,5,7
Jonesypriest,tichondrius,480,priest,discipline,12,5,7
Góndhi,tichondrius,480,priest,discipline,12,5,7
Ptam,tichondrius,480,priest,discipline,12,5,7
Rúbybest,tichondrius,480,priest,discipline,12,5,7
Qoon,tichondrius,480,priest,discipline,12,5,7
Arcosis,turalyon,480,priest,discipline,12,5,7
Justgoon,tichondrius,480,priest,discipline,12,5,7
Jarzo,thunderhorn,480,priest,discipline,12,5,7
Healryyduff,barthilas,480,priest,discipline,12,5,7
Lchcl,tichondrius,480,priest,discipline,12,5,7
Alleeyy,tichondrius,480,priest,discipline,12,5,7
Krazyapollo,tichondrius,480,priest,discipline,12,5,7
Humblemumble,barthilas,480,priest,discipline,12,5,7
Sungji,tichondrius,480,priest,discipline,12,5,7
Matics,tichondrius,480,priest,discipline,12,5,7
Iamrisen,tichondrius,480,priest,discipline,12,5,7
Discobish,sargeras,480,priest,discipline,12,5,7
Drmattydubz,tichondrius,480,priest,discipline,12,5,7
Doublesix,malganis,480,priest,discipline,12,5,7
Euphorz,tichondrius,480,priest,discipline,12,5,7
Gránd,emerald-dream,480,priest,discipline,12,5,7
Wtfamdoing,quelthalas,480,priest,discipline,12,5,7
Renfury,bleeding-hollow,480,priest,discipline,12,5,7
Câstiêl,malganis,480,priest,discipline,12,5,7
Nursébeardy,whisperwind,480,priest,discipline,12,5,7
Takedisdisc,tichondrius,480,priest,discipline,12,5,7
Shôta,kelthuzad,480,priest,discipline,12,5,7
Lge,kelthuzad,480,priest,discipline,12,5,7
Ón,tichondrius,480,priest,discipline,12,5,7
Asmødeus,bleeding-hollow,480,priest,discipline,12,5,7
Htx,dunemaul,480,priest,discipline,12,5,7
Forsakenz,jaedenar,480,priest,discipline,12,5,7
Fishondabeat,proudmoore,480,priest,discipline,12,5,7
Lolkwtf,sargeras,480,priest,discipline,12,5,7
Rompenepes,drakkari,480,priest,discipline,12,5,7
Karmatron,chogall,480,priest,discipline,12,5,7
Ajazz,zuljin,480,priest,discipline,12,5,7
Vérse,stormrage,480,priest,discipline,12,5,7
Gurkorr,boulderfist,480,priest,discipline,12,5,7
Ophiuchus,jubeithos,480,priest,discipline,12,5,7
Bluffzp,boulderfist,480,priest,discipline,12,5,7
Auras,boulderfist,480,priest,discipline,12,5,7
Dweem,stormrage,480,priest,discipline,12,5,7
Skwishee,illidan,480,priest,discipline,12,5,7
Äpriest,sargeras,480,priest,discipline,12,5,7
Giraffebaitt,zuljin,480,priest,discipline,12,5,7
Rofrofmu,aegwynn,480,priest,discipline,12,5,7
Raslin,bonechewer,480,priest,discipline,12,5,7
Alëssana,illidan,480,priest,discipline,12,5,7
Makeshiftz,zuljin,480,priest,discipline,12,5,7
ßlackøut,sargeras,480,priest,discipline,12,5,7
Ajxoz,thrall,480,priest,discipline,12,5,7
Criminalsp,frostmourne,480,priest,discipline,12,5,7
Goonie,spirestone,480,priest,discipline,12,5,7
Naxiest,stormrage,480,priest,discipline,12,5,7
Smightful,garona,480,priest,discipline,12,5,7
Amperx,wyrmrest-accord,480,priest,discipline,12,5,7
Ggsaurusrex,area-52,480,priest,discipline,12,5,7
Dippyboi,whisperwind,480,priest,discipline,12,5,7
Vania,tortheldrin,480,priest,discipline,12,5,7
Batiatus,moon-guard,480,priest,discipline,12,5,7
Pumice,destromath,480,priest,discipline,12,5,7
Soulbane,frostmourne,480,priest,discipline,12,5,7
Manascythe,illidan,480,priest,discipline,12,5,7
Sabela,moon-guard,480,priest,discipline,12,5,7
Hotlink,daggerspine,480,priest,discipline,12,5,7
Stubby,shadowsong,480,priest,discipline,12,5,7
Cheekypriest,stormrage,480,priest,discipline,12,5,7
Pibkac,stormrage,480,priest,discipline,12,5,7
Bubblebeasst,area-52,480,priest,discipline,12,5,7
Hottymcdotty,black-dragonflight,480,priest,discipline,12,5,7
Taikosqt,azralon,480,priest,discipline,12,5,7
Yaheals,gorefiend,480,priest,discipline,12,5,7
Feyns,illidan,480,priest,discipline,12,5,7
Blavkata,area-52,480,priest,discipline,12,5,7
Tòxìç,stormrage,480,priest,discipline,12,5,7
Mywifesaidno,sargeras,480,priest,discipline,12,5,7
Anellas,sargeras,480,priest,discipline,12,5,7
Somethingkoo,sargeras,480,priest,discipline,17,7,10
Fleshliight,area-52,480,priest,discipline,15,6,9
Gatty,kiljaeden,480,priest,discipline,13,5,8
Naniwa,ragnaros,480,priest,discipline,16,6,10
Bebe,fizzcrank,480,priest,discipline,18,5,13
Aguadejamica,tichondrius,480,priest,discipline,18,5,13
Melforn,moon-guard,480,priest,discipline,18,5,13
Healiesuwu,kiljaeden,480,priest,discipline,18,5,13
Mygameslaggy,area-52,480,priest,discipline,18,5,13
Ghettobarbie,kelthuzad,479,priest,discipline,6,5,1
Remixcandoit,malganis,479,priest,discipline,6,5,1
Kasamm,nazjatar,479,priest,discipline,6,5,1
Cheuksin,korgath,479,priest,discipline,6,5,1
Berzap,frostmourne,479,priest,discipline,6,5,1
Sevioletté,wyrmrest-accord,479,priest,discipline,6,5,1
Chofis,nathrezim,479,priest,discipline,12,5,7
Drayen,korgath,479,priest,discipline,12,5,7
Hèáls,tichondrius,479,priest,discipline,12,5,7
Averli,moon-guard,479,priest,discipline,12,5,7
Blackbubba,tichondrius,479,priest,discipline,12,5,7
Chopstix,senjin,479,priest,discipline,12,5,7
Gaaq,stormrage,479,priest,discipline,12,5,7
Rhaist,sargeras,479,priest,discipline,12,5,7
Msdash,tichondrius,479,priest,discipline,12,5,7
Frazzysparks,stormrage,479,priest,discipline,12,5,7
Techninë,chogall,479,priest,discipline,12,5,7
Mangoes,scilla,479,priest,discipline,14,5,9
Healloween,stormrage,478,priest,discipline,6,5,1
Whitegirlirl,blackrock,478,priest,discipline,6,5,1
Psïren,quelthalas,477,priest,discipline,12,5,7
Lotzofhealz,wyrmrest-accord,476,priest,discipline,12,5,7
Delithara,tichondrius,474,priest,discipline,12,5,7
Iseeyoulookn,stormrage,460,priest,discipline,17,7,10
Faíthless,sargeras,447,priest,discipline,11,5,6
Shadowkr,tichondrius,447,priest,discipline,11,5,6
Néylo,illidan,447,priest,discipline,11,5,6
Hungzilla,malganis,447,priest,discipline,11,5,6
Leorid,stormrage,447,priest,discipline,17,5,12
Watchemeyolo,tichondrius,432,priest,discipline,15,5,10
Slumpbusterx,bonechewer,415,priest,discipline,14,5,9
Melsebek,stormrage,415,priest,discipline,20,5,15
Elbowbeans,tichondrius,414,priest,discipline,16,5,11
Brotatochip,andorhal,400,priest,discipline,13,5,8
Jinxaleyster,ragnaros,399,priest,discipline,5,5,0
Whodatpriest,blackhand,399,priest,discipline,5,5,0
Wodturbo,bleeding-hollow,384,priest,discipline,6,4,2
Prniss,tichondrius,384,priest,discipline,6,4,2
Miniambá,tichondrius,384,priest,discipline,6,4,2
Demongodtren,blackrock,384,priest,discipline,6,4,2
Lavazzå,tichondrius,384,priest,discipline,6,4,2
Holyster,tichondrius,384,priest,discipline,6,4,2
Zaperama,tichondrius,384,priest,discipline,6,4,2
Priêsty,stormrage,384,priest,discipline,6,4,2
Béépboop,tichondrius,384,priest,discipline,6,4,2
Powerranger,senjin,384,priest,discipline,6,4,2
Sensitive,eitrigg,384,priest,discipline,6,4,2
Dreaminz,tichondrius,384,priest,discipline,6,4,2
Auttø,area-52,384,priest,discipline,6,4,2
Kiriko,mannoroth,384,priest,discipline,6,4,2
Ticheals,tichondrius,384,priest,discipline,6,4,2
Tomp,tichondrius,384,priest,discipline,6,4,2
Mechahomo,dalaran,384,priest,discipline,6,4,2
Chocopp,illidan,384,priest,discipline,6,4,2
Johncrank,bleeding-hollow,384,priest,discipline,6,4,2
Dimedaddy,tichondrius,384,priest,discipline,6,4,2
Abstention,area-52,384,priest,discipline,6,4,2
Knucklesandy,tichondrius,384,priest,discipline,6,4,2
Chü,dalaran,384,priest,discipline,6,4,2
Djchickpea,chogall,384,priest,discipline,6,4,2
Anymoon,tichondrius,384,priest,discipline,6,4,2
Nordheal,stormrage,384,priest,discipline,6,4,2
Aurajade,queldorei,384,priest,discipline,6,4,2
Ranthrough,tichondrius,384,priest,discipline,6,4,2
Zil,spinebreaker,384,priest,discipline,6,4,2
Febronia,aerie-peak,384,priest,discipline,6,4,2
Deathrina,moon-guard,384,priest,discipline,6,4,2
Celani,gilneas,384,priest,discipline,6,4,2
Lexaprö,moon-guard,384,priest,discipline,6,4,2
Lilazngirl,stormrage,384,priest,discipline,6,4,2
Goyqqp,illidan,384,priest,discipline,6,4,2
Bendoverbb,tichondrius,384,priest,discipline,6,4,2
Bubbleboi,malganis,384,priest,discipline,6,4,2
Priesticules,illidan,384,priest,discipline,6,4,2
Mightydrëk,malganis,384,priest,discipline,6,4,2
Mitras,moon-guard,384,priest,discipline,6,4,2
Healaryduff,skullcrusher,384,priest,discipline,6,4,2
Mattgarska,tichondrius,384,priest,discipline,6,4,2
Jaxthree,illidan,384,priest,discipline,6,4,2
Ahealer,alterac-mountains,384,priest,discipline,6,4,2
Prïestitute,zuljin,384,priest,discipline,6,4,2
Hawtzp,stormrage,384,priest,discipline,6,4,2
Babygsuss,tichondrius,384,priest,discipline,6,4,2
Granger,senjin,384,priest,discipline,6,4,2
Wilita,drakkari,384,priest,discipline,6,4,2
Yotinha,stormrage,384,priest,discipline,6,4,2
Kencyx,tichondrius,384,priest,discipline,6,4,2
Merçy,zuljin,384,priest,discipline,6,4,2
Fûsoya,zuljin,384,priest,discipline,6,4,2
Sebpriest,proudmoore,384,priest,discipline,6,4,2
Soupbeanx,zuljin,384,priest,discipline,6,4,2
Xaerwolaeth,area-52,384,priest,discipline,6,4,2
Thrudarkness,thrall,384,priest,discipline,6,4,2
Nikkazul,drakkari,384,priest,discipline,6,4,2
Fialiadia,illidan,384,priest,discipline,6,4,2
Ruems,area-52,384,priest,discipline,6,4,2
June,dragonmaw,384,priest,discipline,6,4,2
Moselol,tichondrius,384,priest,discipline,6,4,2
Hyoeun,dragonmaw,384,priest,discipline,6,4,2
Sñ,illidan,384,priest,discipline,6,4,2
Spyderco,mugthol,384,priest,discipline,6,4,2
Dawnsy,arygos,384,priest,discipline,6,4,2
Yea,shadow-council,384,priest,discipline,6,4,2
Clarity,arthas,384,priest,discipline,6,4,2
Blzy,area-52,384,priest,discipline,6,4,2
Äni,sargeras,384,priest,discipline,6,4,2
Lelenia,tichondrius,384,priest,discipline,6,4,2
Deathlullaby,malganis,384,priest,discipline,6,4,2
Lithelin,frostmourne,384,priest,discipline,6,4,2
Subscribe,khazgoroth,384,priest,discipline,6,4,2
Narakku,sargeras,384,priest,discipline,6,4,2
Cathiah,darkspear,384,priest,discipline,6,4,2
Lebanese,frostmourne,384,priest,discipline,6,4,2
Spacecowboyz,stormrage,384,priest,discipline,6,4,2
Feelmyheels,frostmourne,384,priest,discipline,6,4,2
Payperbuff,tichondrius,384,priest,discipline,6,4,2
Lovesthebox,frostmourne,384,priest,discipline,6,4,2
Kyoku,tanaris,384,priest,discipline,6,4,2
Batface,frostmourne,384,priest,discipline,6,4,2
Stepbrohelp,barthilas,384,priest,discipline,6,4,2
Popeachini,sargeras,384,priest,discipline,6,4,2
Phurbosjr,sargeras,384,priest,discipline,6,4,2
Saintpleb,sargeras,384,priest,discipline,6,4,2
Atyourcervix,emerald-dream,384,priest,discipline,6,4,2
Faeleath,emerald-dream,384,priest,discipline,6,4,2
Yunganal,sargeras,384,priest,discipline,6,4,2
Gardiancloun,sargeras,384,priest,discipline,6,4,2
Mswatermelon,malganis,384,priest,discipline,10,5,5
Brodel,dark-iron,384,priest,discipline,9,4,5
Nvøsuperstar,zuljin,384,priest,discipline,15,5,10
Akewnón,stormrage,384,priest,discipline,12,4,8
Phobe,windrunner,384,priest,discipline,12,4,8
Flexxwzkaboo,thrall,384,priest,discipline,12,4,8
Fatherßrian,draktharon,384,priest,discipline,12,4,8
Larisa,moon-guard,384,priest,discipline,12,4,8
Chaxiubao,stormrage,384,priest,discipline,12,4,8
Barclan,destromath,384,priest,discipline,12,4,8
Srazul,azralon,384,priest,discipline,12,4,8
Noveh,tichondrius,384,priest,discipline,12,4,8
Ioudas,ragnaros,384,priest,discipline,12,4,8
Conorpriest,tichondrius,384,priest,discipline,12,4,8
Vyvivienx,tichondrius,384,priest,discipline,12,4,8
Disperse,sargeras,384,priest,discipline,12,4,8
Lìlí,tichondrius,384,priest,discipline,12,4,8
Holyshiitzz,illidan,384,priest,discipline,12,4,8
Plebiss,burning-blade,384,priest,discipline,12,4,8
Adofthealer,illidan,384,priest,discipline,12,4,8
Yeeseafood,tichondrius,384,priest,discipline,12,4,8
Mudbuttman,kelthuzad,384,priest,discipline,12,4,8
Echoos,proudmoore,384,priest,discipline,12,4,8
Nancynibbler,bleeding-hollow,384,priest,discipline,12,4,8
Sìrena,tichondrius,384,priest,discipline,12,4,8
Chernota,kiljaeden,384,priest,discipline,12,4,8
Jiangfeng,tichondrius,384,priest,discipline,12,4,8
Healbilli,archimonde,384,priest,discipline,12,4,8
Jonahas,sargeras,384,priest,discipline,12,4,8
Littlean,frostmourne,384,priest,discipline,12,4,8
Goosepvp,tichondrius,384,priest,discipline,12,4,8
Papabrokuttv,sargeras,384,priest,discipline,12,4,8
Pnub,aggramar,384,priest,discipline,12,4,8
Gloomyspp,illidan,384,priest,discipline,12,4,8
ßoogey,tichondrius,384,priest,discipline,12,4,8
Zaphfkiel,ragnaros,384,priest,discipline,12,4,8
Hysteria,dalaran,384,priest,discipline,12,4,8
Wìd,khazgoroth,384,priest,discipline,12,4,8
Lankyschlong,frostmourne,384,priest,discipline,12,4,8
Polythis,kelthuzad,384,priest,discipline,18,4,14
Kibariyb,drakkari,384,priest,discipline,18,4,14
Fujinpriest,azralon,384,priest,discipline,18,4,14
Rainms,sargeras,384,priest,discipline,18,4,14
Tmpriest,tichondrius,384,priest,discipline,18,4,14
Fanaeth,arathor,383,priest,discipline,6,4,2
Discodork,bleeding-hollow,383,priest,discipline,6,4,2
Itchybubble,emerald-dream,383,priest,discipline,6,4,2
Shén,barthilas,383,priest,discipline,6,4,2
Anakou,emerald-dream,383,priest,discipline,6,4,2
Lifesavér,tichondrius,383,priest,discipline,6,4,2
Mirex,tichondrius,383,priest,discipline,6,4,2
Castnngcouch,tichondrius,383,priest,discipline,12,4,8
Sybal,suramar,383,priest,discipline,12,4,8
Theleena,malorne,383,priest,discipline,12,4,8
Goldenlilly,moon-guard,383,priest,discipline,12,4,8
Whatisholy,bleeding-hollow,383,priest,discipline,12,4,8
Marpi,quelthalas,383,priest,discipline,18,4,14
Sublety,aerie-peak,382,priest,discipline,12,4,8
Malhotra,amanthul,381,priest,discipline,12,4,8
Primela,sargeras,381,priest,discipline,12,4,8
Touchedbygud,frostmourne,381,priest,discipline,12,4,8
Burtier,zuljin,367,priest,discipline,11,4,7
Elomszz,tichondrius,352,priest,discipline,10,4,6
Itssehctap,chogall,351,priest,discipline,8,5,3
Onineko,bleeding-hollow,351,priest,discipline,11,4,7
Kuwapre,proudmoore,336,priest,discipline,9,5,4
Proftimothy,tichondrius,336,priest,discipline,9,5,4
Rosabell,ragnaros,336,priest,discipline,21,4,17
Xiangjiao,tichondrius,330,priest,discipline,17,6,11
Brock,lightbringer,330,priest,discipline,15,5,10
Shadowdaddy,barthilas,320,priest,discipline,10,4,6
Aveil,bloodscalp,320,priest,discipline,10,4,6
Toxictampax,azjolnerub,320,priest,discipline,17,4,13
Pyta,frostmourne,319,priest,discipline,8,4,4
Smarttakka,emerald-dream,319,priest,discipline,8,4,4
Oneinurdome,moknathal,319,priest,discipline,8,4,4
Healmedaddyy,korgath,319,priest,discipline,14,4,10
Klizzy,tichondrius,319,priest,discipline,14,4,10
Thekingheals,draenor,304,priest,discipline,11,5,6
Cromagnøn,dalaran,288,priest,discipline,6,3,3
Chervz,chogall,288,priest,discipline,6,3,3
Buc,barthilas,288,priest,discipline,6,3,3
Sassygayboyx,bleeding-hollow,288,priest,discipline,6,3,3
Empyreanlite,dalaran,288,priest,discipline,6,3,3
Gekko,azgalor,288,priest,discipline,6,3,3
Mks,barthilas,288,priest,discipline,6,3,3
Ifortalot,lothar,288,priest,discipline,6,3,3
Amãnita,illidan,288,priest,discipline,6,3,3
Freck,stormrage,288,priest,discipline,6,3,3
Wiseguise,illidan,288,priest,discipline,6,3,3
Sæýfír,illidan,288,priest,discipline,6,3,3
Bunked,bleeding-hollow,288,priest,discipline,6,3,3
Danceofpales,bleeding-hollow,288,priest,discipline,6,3,3
Vezaxx,barthilas,288,priest,discipline,6,3,3
Megz,zuljin,288,priest,discipline,6,3,3
Adelda,nazjatar,288,priest,discipline,6,3,3
Iamsatan,illidan,288,priest,discipline,6,3,3
Gawlas,azshara,288,priest,discipline,6,3,3
Frye,bleeding-hollow,288,priest,discipline,6,3,3
Luxah,bloodhoof,288,priest,discipline,6,3,3
Pilixil,bleeding-hollow,288,priest,discipline,6,3,3
Priestreto,zuljin,288,priest,discipline,6,3,3
Kelody,zuljin,288,priest,discipline,6,3,3
Pumpkinpino,stormrage,288,priest,discipline,6,3,3
Alleviate,frostmourne,288,priest,discipline,6,3,3
Treri,bleeding-hollow,288,priest,discipline,6,3,3
Dradinx,illidan,288,priest,discipline,6,3,3
Punchyxz,illidan,288,priest,discipline,6,3,3
Fidalus,stormrage,288,priest,discipline,6,3,3
Healyhaney,stormrage,288,priest,discipline,6,3,3
Furydos,zuljin,288,priest,discipline,6,3,3
Keyohh,tichondrius,288,priest,discipline,6,3,3
Àneres,illidan,288,priest,discipline,6,3,3
Smirkinlive,illidan,288,priest,discipline,6,3,3
Epicp,sargeras,288,priest,discipline,6,3,3
Bestworldxz,illidan,288,priest,discipline,6,3,3
Kwaremont,sargeras,288,priest,discipline,6,3,3
Nyxvoid,ragnaros,288,priest,discipline,6,3,3
Nikci,tichondrius,288,priest,discipline,6,3,3
Dgpriest,tichondrius,288,priest,discipline,6,3,3
Jexso,tichondrius,288,priest,discipline,6,3,3
Bakerstr,tichondrius,288,priest,discipline,6,3,3
Gaudthree,tichondrius,288,priest,discipline,6,3,3
Darkispriest,tichondrius,288,priest,discipline,6,3,3
Spiritbear,thrall,288,priest,discipline,6,3,3
Jjaeminkim,area-52,288,priest,discipline,6,3,3
Kleiâ,tichondrius,288,priest,discipline,6,3,3
Bernietopper,tichondrius,288,priest,discipline,6,3,3
Vanzera,thrall,288,priest,discipline,6,3,3
Wale,akama,288,priest,discipline,6,3,3
Valtres,tichondrius,288,priest,discipline,6,3,3
Flab,tichondrius,288,priest,discipline,6,3,3
Yannigirl,area-52,288,priest,discipline,6,3,3
Rotnn,thrall,288,priest,discipline,6,3,3
Lostnthought,aggramar,288,priest,discipline,6,3,3
Ultradumb,ragnaros,288,priest,discipline,6,3,3
Daryldeath,tichondrius,288,priest,discipline,6,3,3
Aia,frostwolf,288,priest,discipline,6,3,3
Irar,tichondrius,288,priest,discipline,6,3,3
Oxicontin,sargeras,288,priest,discipline,6,3,3
Calcifer,drakkari,288,priest,discipline,6,3,3
Aspéct,aegwynn,288,priest,discipline,6,3,3
Kaiah,gorefiend,288,priest,discipline,6,3,3
Killduran,hellscream,288,priest,discipline,6,3,3
Blackdeathx,tichondrius,288,priest,discipline,6,3,3
Tmall,tichondrius,288,priest,discipline,6,3,3
Bananass,sargeras,288,priest,discipline,6,3,3
Aupascamarad,tichondrius,288,priest,discipline,6,3,3
Havefaith,whisperwind,288,priest,discipline,6,3,3
Boppdot,tichondrius,288,priest,discipline,6,3,3
Xusin,tichondrius,288,priest,discipline,6,3,3
Såx,stormreaver,288,priest,discipline,6,3,3
Tooeasy,vashj,288,priest,discipline,6,3,3
Mindgamez,stormreaver,288,priest,discipline,6,3,3
Xeras,ravencrest,288,priest,discipline,6,3,3
Elise,ravenholdt,288,priest,discipline,6,3,3
Bessias,area-52,288,priest,discipline,6,3,3
Zzavidwong,tichondrius,288,priest,discipline,6,3,3
Jinzp,area-52,288,priest,discipline,6,3,3
Psyfriend,area-52,288,priest,discipline,6,3,3
Velandrys,earthen-ring,288,priest,discipline,6,3,3
Poøpoopeepee,tichondrius,288,priest,discipline,6,3,3
Frotters,kiljaeden,288,priest,discipline,6,3,3
Tarwow,moon-guard,288,priest,discipline,6,3,3
Supaflute,tichondrius,288,priest,discipline,6,3,3
Serenderpity,moon-guard,288,priest,discipline,6,3,3
Grafîx,frostmourne,288,priest,discipline,6,3,3
Wïgjaw,tichondrius,288,priest,discipline,6,3,3
Wøo,area-52,288,priest,discipline,6,3,3
Haruspex,azralon,288,priest,discipline,6,3,3
Filthmaster,moon-guard,288,priest,discipline,6,3,3
Pollyphia,kiljaeden,288,priest,discipline,6,3,3
Heratic,malganis,288,priest,discipline,6,3,3
Kawesha,emerald-dream,288,priest,discipline,6,3,3
Germanica,area-52,288,priest,discipline,6,3,3
Moirâ,silvermoon,288,priest,discipline,6,3,3
Sandreth,bonechewer,288,priest,discipline,6,3,3
Methandrial,hyjal,288,priest,discipline,6,3,3
Fausto,kiljaeden,288,priest,discipline,6,3,3
Nokizzgrizz,sargeras,288,priest,discipline,6,3,3
Priestøuchme,tichondrius,288,priest,discipline,6,3,3
Kencyy,tichondrius,288,priest,discipline,6,3,3
Mcfluffin,aggramar,288,priest,discipline,6,3,3
Alladys,shattered-hand,288,priest,discipline,6,3,3
Xiaz,lightbringer,288,priest,discipline,6,3,3
Sojumike,proudmoore,288,priest,discipline,6,3,3
Zuuji,frostmourne,288,priest,discipline,6,3,3
Dakp,sargeras,288,priest,discipline,6,3,3
Kujox,tichondrius,288,priest,discipline,6,3,3
Ivf,darrowmere,288,priest,discipline,6,3,3
Icarryozz,darkspear,288,priest,discipline,6,3,3
Dynopriest,kelthuzad,288,priest,discipline,6,3,3
Bigsàd,proudmoore,288,priest,discipline,6,3,3
Khaospriest,proudmoore,288,priest,discipline,6,3,3
Stankychimpo,malganis,288,priest,discipline,6,3,3
Minzyx,tichondrius,288,priest,discipline,6,3,3
Bigpoppapwn,darkspear,288,priest,discipline,6,3,3
Oofx,darkspear,288,priest,discipline,6,3,3
Niniua,tichondrius,288,priest,discipline,6,3,3
Idhealthat,tichondrius,288,priest,discipline,6,3,3
Lobstersock,malganis,288,priest,discipline,6,3,3
Midget,darkspear,288,priest,discipline,6,3,3
Bgundy,sargeras,288,priest,discipline,6,3,3
Sòraka,tichondrius,288,priest,discipline,6,3,3
Sabene,greymane,288,priest,discipline,6,3,3
Yunnan,executus,288,priest,discipline,6,3,3
Toteme,proudmoore,288,priest,discipline,6,3,3
Swinee,tichondrius,288,priest,discipline,6,3,3
Kaldoon,azjolnerub,288,priest,discipline,6,3,3
Tigrania,proudmoore,288,priest,discipline,6,3,3
Psychiatrist,darkspear,288,priest,discipline,10,3,7
Showakoi,ragnaros,288,priest,discipline,16,4,12
Theophobe,illidan,288,priest,discipline,16,4,12
Bree,area-52,288,priest,discipline,12,3,9
Solestro,malganis,288,priest,discipline,12,3,9
Frag,frostmourne,288,priest,discipline,12,3,9
Quartzolio,azralon,288,priest,discipline,12,3,9
Ulzaar,nerzhul,288,priest,discipline,12,3,9
Gloomswrath,illidan,288,priest,discipline,12,3,9
Manryu,tichondrius,288,priest,discipline,12,3,9
Hail,kaelthas,288,priest,discipline,12,3,9
Bån,ragnaros,288,priest,discipline,12,3,9
Shenanígans,malganis,288,priest,discipline,12,3,9
Aaxahfon,moon-guard,288,priest,discipline,12,3,9
Die,crushridge,288,priest,discipline,12,3,9
Phillyrivers,area-52,288,priest,discipline,12,3,9
Krewtoo,illidan,288,priest,discipline,12,3,9
Zsofi,rivendare,288,priest,discipline,12,3,9
Gwenoviere,whisperwind,288,priest,discipline,12,3,9
Xalatath,stormrage,288,priest,discipline,12,3,9
Slackinhealz,thrall,288,priest,discipline,12,3,9
Oniizanagi,thrall,288,priest,discipline,12,3,9
Soleyxo,frostmourne,288,priest,discipline,12,3,9
Shastea,crushridge,288,priest,discipline,12,3,9
Oomed,bonechewer,288,priest,discipline,12,3,9
Chaddadbod,emerald-dream,288,priest,discipline,12,3,9
Kurnak,arthas,288,priest,discipline,12,3,9
Abefromann,sargeras,288,priest,discipline,12,3,9
Xyberius,barthilas,288,priest,discipline,12,3,9
Doomageddon,thorium-brotherhood,288,priest,discipline,12,3,9
Zrn,bleeding-hollow,288,priest,discipline,12,3,9
Realheal,tichondrius,288,priest,discipline,12,3,9
Lightshizzle,illidan,288,priest,discipline,12,3,9
Itha,illidan,288,priest,discipline,12,3,9
Paztech,arthas,288,priest,discipline,12,3,9
Sportsgloss,tichondrius,288,priest,discipline,12,3,9
Pïque,proudmoore,288,priest,discipline,12,3,9
Datdarnbéar,stormrage,288,priest,discipline,12,3,9
Skimpdubs,bleeding-hollow,288,priest,discipline,12,3,9
Pedialyte,kiljaeden,288,priest,discipline,12,3,9
Muriaticacid,tichondrius,288,priest,discipline,12,3,9
Kuriyasu,emerald-dream,288,priest,discipline,15,3,12
Kaztorz,tichondrius,288,priest,discipline,16,3,13
Moc,jubeithos,288,priest,discipline,18,3,15
Pravant,illidan,288,priest,discipline,18,3,15
Chirho,malganis,288,priest,discipline,18,3,15
Imgold,emerald-dream,287,priest,discipline,6,3,3
Solzal,korgath,287,priest,discipline,6,3,3
Priestkofwa,tichondrius,287,priest,discipline,12,3,9
Kagayaku,aegwynn,287,priest,discipline,12,3,9
Kataró,tichondrius,286,priest,discipline,12,3,9
Oogs,tichondrius,271,priest,discipline,17,3,14
Poodledad,wyrmrest-accord,255,priest,discipline,8,4,4
Plaguepumper,sargeras,255,priest,discipline,11,3,8
Prèèst,proudmoore,255,priest,discipline,11,3,8
Stormlighter,proudmoore,255,priest,discipline,11,3,8
Mawwt,moon-guard,239,priest,discipline,5,3,2
Murillio,moon-guard,239,priest,discipline,5,3,2
Frenchfries,sargeras,239,priest,discipline,5,3,2
Skruffles,black-dragonflight,239,priest,discipline,5,3,2
Jtheals,illidan,239,priest,discipline,5,3,2
Canô,quelthalas,239,priest,discipline,5,3,2
Islada,illidan,233,priest,discipline,18,4,14
Holyshield,jubeithos,223,priest,discipline,8,3,5
Termiina,hyjal,208,priest,discipline,7,3,4
Reâpêr,kelthuzad,201,priest,discipline,13,4,9
Jedrick,malganis,192,priest,discipline,4,3,1
Zortroz,tichondrius,192,priest,discipline,4,3,1
Notthebappo,malganis,192,priest,discipline,11,4,7
Tedesq,stormrage,192,priest,discipline,9,3,6
Helorren,nagrand,192,priest,discipline,6,2,4
Verboden,kelthuzad,192,priest,discipline,6,2,4
Davedawg,emerald-dream,192,priest,discipline,6,2,4
Issaley,tichondrius,192,priest,discipline,6,2,4
Mayzal,emerald-dream,192,priest,discipline,6,2,4
Keaina,malganis,192,priest,discipline,6,2,4
Genevieve,aggramar,192,priest,discipline,6,2,4
Holyshafted,kelthuzad,192,priest,discipline,6,2,4
Nevertelsp,malganis,192,priest,discipline,6,2,4
Disconelf,barthilas,192,priest,discipline,6,2,4
Lunarras,aggramar,192,priest,discipline,6,2,4
Patagoniabae,kelthuzad,192,priest,discipline,6,2,4
Plaguesus,dalaran,192,priest,discipline,6,2,4
Thangthangin,icecrown,192,priest,discipline,6,2,4
Gnralways,andorhal,192,priest,discipline,6,2,4
Kaeruz,stormrage,192,priest,discipline,6,2,4
Whitesharks,tichondrius,192,priest,discipline,6,2,4
Prff,ragnaros,192,priest,discipline,6,2,4
Trienolone,emerald-dream,192,priest,discipline,6,2,4
Rbmxp,barthilas,192,priest,discipline,6,2,4
Robbailey,dalvengyr,192,priest,discipline,6,2,4
Discountay,burning-legion,192,priest,discipline,6,2,4
Coldstone,bloodhoof,192,priest,discipline,6,2,4
Dilonpi,area-52,192,priest,discipline,6,2,4
Yoxxoo,tichondrius,192,priest,discipline,6,2,4
Icychain,area-52,192,priest,discipline,6,2,4
Stennic,emerald-dream,192,priest,discipline,6,2,4
Meaning,tichondrius,192,priest,discipline,6,2,4
Phatheals,norgannon,192,priest,discipline,6,2,4
Pòba,malganis,192,priest,discipline,6,2,4
Pingleangel,tichondrius,192,priest,discipline,6,2,4
Makdaddy,skullcrusher,192,priest,discipline,6,2,4
Chazzwizz,area-52,192,priest,discipline,6,2,4
Halloweenx,area-52,192,priest,discipline,6,2,4
Overpriest,ragnaros,192,priest,discipline,6,2,4
Penicilin,terokkar,192,priest,discipline,6,2,4
Mindgoblin,terokkar,192,priest,discipline,6,2,4
Holdenhuff,sargeras,192,priest,discipline,6,2,4
Heartsblood,whisperwind,192,priest,discipline,6,2,4
Myeryc,frostmourne,192,priest,discipline,6,2,4
Qnarisha,tichondrius,192,priest,discipline,6,2,4
Jaq,altar-of-storms,192,priest,discipline,6,2,4
Vivø,nemesis,192,priest,discipline,6,2,4
Ayani,khadgar,192,priest,discipline,6,2,4
Keygodx,illidan,192,priest,discipline,6,2,4
Spampws,aerie-peak,192,priest,discipline,6,2,4
Ninbara,tichondrius,192,priest,discipline,6,2,4
Slenden,illidan,192,priest,discipline,6,2,4
Shastyr,tichondrius,192,priest,discipline,6,2,4
Carboload,thrall,192,priest,discipline,6,2,4
Benjamints,thrall,192,priest,discipline,6,2,4
Novakaynersj,anetheron,192,priest,discipline,6,2,4
Shalther,thrall,192,priest,discipline,6,2,4
Goatedhp,dalaran,192,priest,discipline,6,2,4
Discogs,frostmourne,192,priest,discipline,6,2,4
Holymagetv,tichondrius,192,priest,discipline,6,2,4
Mhanaburn,nerzhul,192,priest,discipline,6,2,4
Kìttý,cenarius,192,priest,discipline,6,2,4
Ôp,sargeras,192,priest,discipline,6,2,4
Bestwizardx,tichondrius,192,priest,discipline,6,2,4
Tulip,frostmourne,192,priest,discipline,6,2,4
Galestick,illidan,192,priest,discipline,6,2,4
Noteenurse,blackrock,192,priest,discipline,6,2,4
Holytipz,stormrage,192,priest,discipline,6,2,4
Wise,wildhammer,192,priest,discipline,6,2,4
Altaeres,tichondrius,192,priest,discipline,6,2,4
Googus,bleeding-hollow,192,priest,discipline,6,2,4
Dxs,hydraxis,192,priest,discipline,6,2,4
Dinkk,stormrage,192,priest,discipline,6,2,4
Dimanche,thunderlord,192,priest,discipline,6,2,4
Releknosleep,frostwolf,192,priest,discipline,6,2,4
Skêptic,tichondrius,192,priest,discipline,6,2,4
Skellieman,malorne,192,priest,discipline,6,2,4
Budheals,spirestone,192,priest,discipline,6,2,4
Gödtier,frostwolf,192,priest,discipline,6,2,4
Glauga,azralon,192,priest,discipline,6,2,4
Hankspank,hakkar,192,priest,discipline,6,2,4
Gwendalynne,tichondrius,192,priest,discipline,6,2,4
Kimbeloria,bleeding-hollow,192,priest,discipline,6,2,4
Haushauha,azralon,192,priest,discipline,6,2,4
Goosemongler,bleeding-hollow,192,priest,discipline,6,2,4
Çherished,stormrage,192,priest,discipline,6,2,4
Coffeek,sargeras,192,priest,discipline,6,2,4
Roivas,bleeding-hollow,192,priest,discipline,6,2,4
Pimeharder,tichondrius,192,priest,discipline,6,2,4
Kustem,tichondrius,192,priest,discipline,6,2,4
Bradythree,moon-guard,192,priest,discipline,6,2,4
Smallz,silvermoon,192,priest,discipline,6,2,4
Stiffmeister,bleeding-hollow,192,priest,discipline,6,2,4
Bmox,borean-tundra,192,priest,discipline,6,2,4
Onjah,kiljaeden,192,priest,discipline,6,2,4
Nejisaiyan,sargeras,192,priest,discipline,6,2,4
Lúçíd,sargeras,192,priest,discipline,6,2,4
Bigskill,proudmoore,192,priest,discipline,6,2,4
Arodar,wyrmrest-accord,192,priest,discipline,6,2,4
Krevs,proudmoore,192,priest,discipline,6,2,4
Gwenholy,hakkar,192,priest,discipline,6,2,4
Giannis,garrosh,192,priest,discipline,6,2,4
Helibix,bleeding-hollow,192,priest,discipline,6,2,4
Easywins,sargeras,192,priest,discipline,6,2,4
Tyrea,kiljaeden,192,priest,discipline,6,2,4
Príest,nordrassil,192,priest,discipline,6,2,4
Schadên,wyrmrest-accord,192,priest,discipline,6,2,4
Nars,draka,192,priest,discipline,6,2,4
Irixus,zuljin,192,priest,discipline,6,2,4
Cub,darkspear,192,priest,discipline,6,2,4
Linkolln,sargeras,192,priest,discipline,6,2,4
Holydrop,sargeras,192,priest,discipline,6,2,4
Dabrat,darkspear,192,priest,discipline,6,2,4
Rickmason,frostmane,192,priest,discipline,6,2,4
Brokennurse,area-52,192,priest,discipline,7,2,5
Patchyemoly,frostmourne,192,priest,discipline,8,2,6
Ularim,tichondrius,192,priest,discipline,12,2,10
Nearo,barthilas,192,priest,discipline,12,2,10
Ggums,tichondrius,192,priest,discipline,12,2,10
Lûdløw,kelthuzad,192,priest,discipline,12,2,10
Toguol,stormrage,192,priest,discipline,12,2,10
Jugeum,proudmoore,192,priest,discipline,12,2,10
Canyounaut,kelthuzad,192,priest,discipline,12,2,10
Meatbaoo,tichondrius,192,priest,discipline,12,2,10
Evvylou,stormrage,192,priest,discipline,12,2,10
Fearward,silvermoon,192,priest,discipline,12,2,10
Kagemetsu,sargeras,192,priest,discipline,12,2,10
Bolognypony,norgannon,192,priest,discipline,12,2,10
Lípjju,tichondrius,192,priest,discipline,12,2,10
Grâfix,barthilas,192,priest,discipline,12,2,10
Fiéstah,illidan,192,priest,discipline,12,2,10
Feff,shuhalo,192,priest,discipline,12,2,10
Väin,proudmoore,191,priest,discipline,6,2,4
Mynigajeff,zuljin,185,priest,discipline,14,4,10
Gabuncher,barthilas,175,priest,discipline,11,2,9
Akåsha,zuljin,175,priest,discipline,11,2,9
Imamu,tichondrius,167,priest,discipline,25,11,14
Yait,tichondrius,159,priest,discipline,5,2,3
Dinogingy,lightbringer,159,priest,discipline,5,2,3
Pochis,bleeding-hollow,159,priest,discipline,8,3,5
Yayoo,exodar,144,priest,discipline,9,2,7
Mesiausx,stormrage,138,priest,discipline,8,3,5
Prayanmantis,tichondrius,138,priest,discipline,8,3,5
Ibangedaqt,malganis,138,priest,discipline,11,3,8
Ariadneminos,illidan,138,priest,discipline,11,3,8
Dangerhealz,frostmourne,128,priest,discipline,4,2,2
Aerîs,magtheridon,127,priest,discipline,14,2,12
Cityboyy,tichondrius,112,priest,discipline,7,2,5
Deckx,khazgoroth,96,priest,discipline,3,2,1
Waterßoÿ,emerald-dream,96,priest,discipline,3,2,1
Juvell,illidan,96,priest,discipline,3,2,1
Standback,wyrmrest-accord,96,priest,discipline,3,2,1
Lildes,tichondrius,96,priest,discipline,6,1,5
Púrg,frostmourne,96,priest,discipline,6,1,5
Kunof,ragnaros,96,priest,discipline,6,1,5
Kyrabon,ragnaros,96,priest,discipline,6,1,5
Oymay,illidan,96,priest,discipline,6,1,5
Kireepilef,ragnaros,96,priest,discipline,6,1,5
Apbrady,sargeras,96,priest,discipline,6,1,5
Baerybonds,kiljaeden,96,priest,discipline,6,1,5
Halfcab,runetotem,96,priest,discipline,6,1,5
Fatherwyatt,bleeding-hollow,96,priest,discipline,6,1,5
Keynnish,sargeras,96,priest,discipline,6,1,5
Gódriç,emerald-dream,96,priest,discipline,6,1,5
Luxury,blackrock,96,priest,discipline,6,1,5
Lindsanp,illidan,96,priest,discipline,6,1,5
Bunnychloe,sargeras,96,priest,discipline,6,1,5
Sussywussy,stormrage,96,priest,discipline,6,1,5
Djriest,sargeras,96,priest,discipline,6,1,5
Lenigrast,blackrock,96,priest,discipline,6,1,5
Aarei,stormrage,96,priest,discipline,6,1,5
Necrodiva,magtheridon,96,priest,discipline,6,1,5
Powerwordqt,kalecgos,96,priest,discipline,6,1,5
Shadeven,nagrand,96,priest,discipline,6,1,5
Ndz,wyrmrest-accord,96,priest,discipline,6,1,5
Religions,wyrmrest-accord,96,priest,discipline,6,1,5
Lifejuice,tichondrius,96,priest,discipline,6,1,5
Shwayp,zuljin,96,priest,discipline,6,1,5
Nineoneoneh,stormrage,96,priest,discipline,6,1,5
Ugamie,proudmoore,96,priest,discipline,6,1,5
Rickitz,bleeding-hollow,96,priest,discipline,6,1,5
Aeøns,sargeras,96,priest,discipline,6,1,5
Namemetwo,malganis,96,priest,discipline,6,1,5
Imhotap,illidan,96,priest,discipline,6,1,5
Priestmika,illidan,96,priest,discipline,6,1,5
Shaylari,kelthuzad,96,priest,discipline,6,1,5
Thh,emerald-dream,96,priest,discipline,6,1,5
Nekkz,sargeras,96,priest,discipline,6,1,5
Maomaoangel,tichondrius,96,priest,discipline,6,1,5
Hionlife,tichondrius,96,priest,discipline,6,1,5
Drmuhammad,sargeras,96,priest,discipline,6,1,5
Clárke,tichondrius,96,priest,discipline,6,1,5
Regzi,stormrage,96,priest,discipline,6,1,5
Wilcarfegus,draka,96,priest,discipline,6,1,5
Sukeena,malganis,96,priest,discipline,6,1,5
Cenzlyor,arthas,96,priest,discipline,6,1,5
Mêga,illidan,96,priest,discipline,6,1,5
Someonesxy,aggramar,96,priest,discipline,6,1,5
Blosinrosin,lightbringer,96,priest,discipline,6,1,5
Shåde,skullcrusher,96,priest,discipline,6,1,5
Runecarver,anvilmar,96,priest,discipline,6,1,5
Barelylegalx,tichondrius,96,priest,discipline,6,1,5
Zachlol,area-52,96,priest,discipline,6,1,5
Kagura,dunemaul,96,priest,discipline,6,1,5
Galice,archimonde,96,priest,discipline,6,1,5
Veiveilol,tichondrius,96,priest,discipline,6,1,5
Pavarotti,laughing-skull,96,priest,discipline,6,1,5
Prayforhealz,tichondrius,96,priest,discipline,6,1,5
Nonbinary,trollbane,96,priest,discipline,6,1,5
Edessa,lothar,96,priest,discipline,6,1,5
Scenekîd,moon-guard,96,priest,discipline,6,1,5
Junethegreat,tichondrius,96,priest,discipline,6,1,5
Uckuck,illidan,96,priest,discipline,6,1,5
Torgasm,frostmourne,96,priest,discipline,6,1,5
Kryoff,illidan,96,priest,discipline,6,1,5
Chewboppa,zuljin,96,priest,discipline,6,1,5
Ilikis,tichondrius,96,priest,discipline,6,1,5
Shadowgobbo,thrall,96,priest,discipline,6,1,5
Throwshade,moon-guard,96,priest,discipline,6,1,5
Bibops,area-52,96,priest,discipline,6,1,5
Minamy,tichondrius,96,priest,discipline,6,1,5
Common,tichondrius,96,priest,discipline,6,1,5
Momorabbit,tichondrius,96,priest,discipline,6,1,5
Gringotaco,tichondrius,96,priest,discipline,6,1,5
Thasar,azgalor,96,priest,discipline,6,1,5
Yessír,stormrage,96,priest,discipline,6,1,5
Moonideli,moon-guard,96,priest,discipline,6,1,5
Vandi,moon-guard,96,priest,discipline,6,1,5
Senbonzaküra,azralon,96,priest,discipline,6,1,5
Gustavustus,barthilas,96,priest,discipline,6,1,5
Ivermectin,eredar,96,priest,discipline,6,1,5
Goneqt,illidan,96,priest,discipline,6,1,5
Fades,hellscream,96,priest,discipline,6,1,5
Tichealstwo,tichondrius,96,priest,discipline,6,1,5
Spspsp,illidan,96,priest,discipline,6,1,5
Billyscousin,chogall,96,priest,discipline,6,1,5
Snotanygood,alleria,96,priest,discipline,6,1,5
Robinophelia,sargeras,96,priest,discipline,6,1,5
Vetisrx,thrall,96,priest,discipline,6,1,5
Ssmushi,tichondrius,96,priest,discipline,12,1,11
Dawnside,wyrmrest-accord,96,priest,discipline,12,1,11
Felixfire,moon-guard,96,priest,discipline,12,1,11
Erinyn,area-52,96,priest,discipline,12,1,11
Ergoproxy,barthilas,96,priest,discipline,12,1,11
Mallzahar,darkspear,96,priest,discipline,12,1,11
Sifts,proudmoore,96,priest,discipline,12,1,11
Timéo,zuljin,96,priest,discipline,18,1,17
Mixxd,shuhalo,95,priest,discipline,6,1,5
Flexeggette,illidan,84,priest,discipline,13,4,9
Sáito,area-52,79,priest,discipline,5,1,4
Wyldpiece,frostmourne,42,priest,discipline,7,3,4
Jqueryy,tichondrius,42,priest,discipline,11,3,8
Londy,area-52,42,priest,discipline,16,3,13
Alathan,sargeras,31,priest,discipline,2,1,1
Nås,elune,31,priest,discipline,2,1,1
Yeazy,stormrage,2296,priest,shadow,108,62,46
Jennaôrtega,tichondrius,2258,priest,shadow,78,50,28
Orchidp,tichondrius,2230,priest,shadow,155,98,57
Techbadar,tichondrius,2185,priest,shadow,125,65,60
Geovanni,barthilas,2147,priest,shadow,89,47,42
Eradication,frostmourne,2146,priest,shadow,82,55,27
Kishoengi,sargeras,2121,priest,shadow,68,45,23
Mearas,kelthuzad,2113,priest,shadow,76,46,30
Kottun,stormrage,2110,priest,shadow,66,38,28
Lìám,frostmourne,2110,priest,shadow,187,102,85
Yeona,tichondrius,2107,priest,shadow,89,51,38
Dyrr,barthilas,2107,priest,shadow,84,45,39
Bayter,frostmourne,2105,priest,shadow,181,97,84
Edd,tichondrius,2090,priest,shadow,137,69,68
Zlipz,frostmourne,2087,priest,shadow,54,35,19
Viyana,stormrage,2070,priest,shadow,138,74,64
Strwbrynaner,sargeras,2063,priest,shadow,72,40,32
Knowknow,tichondrius,2013,priest,shadow,108,57,51
Ousïa,quelthalas,2007,priest,shadow,66,34,32
Ejr,altar-of-storms,1986,priest,shadow,66,35,31
Laundryday,korgath,1985,priest,shadow,84,43,41
Soapee,illidan,1982,priest,shadow,143,75,68
Blax,stormscale,1977,priest,shadow,60,35,25
Scandi,tichondrius,1969,priest,shadow,48,30,18
Babyh,tichondrius,1959,priest,shadow,65,34,31
Nekroscream,queldorei,1948,priest,shadow,47,27,20
Kiriko,mannoroth,1946,priest,shadow,65,39,26
Maìden,sargeras,1940,priest,shadow,36,23,13
Ombravuota,blades-edge,1935,priest,shadow,111,57,54
Arobahn,tichondrius,1924,priest,shadow,69,36,33
Moraver,kelthuzad,1907,priest,shadow,36,20,16
Apbrady,sargeras,1906,priest,shadow,60,31,29
Sin,guldan,1901,priest,shadow,198,109,89
Kuraga,bleeding-hollow,1899,priest,shadow,240,130,110
Erebusz,tichondrius,1894,priest,shadow,54,29,25
Omenx,emerald-dream,1893,priest,shadow,36,23,13
Griffsp,sargeras,1892,priest,shadow,149,76,73
Meehx,illidan,1886,priest,shadow,102,65,37
Yenïza,illidan,1886,priest,shadow,84,41,43
Stinkiez,area-52,1885,priest,shadow,110,60,50
Vtp,frostmourne,1882,priest,shadow,86,45,41
Keygodx,illidan,1881,priest,shadow,47,31,16
Maskali,tichondrius,1877,priest,shadow,60,29,31
Xiaozhui,tichondrius,1868,priest,shadow,51,27,24
Creapture,zuluhed,1867,priest,shadow,36,24,12
Katallyst,tichondrius,1865,priest,shadow,53,28,25
Voidkay,tichondrius,1862,priest,shadow,42,35,7
Plztrainme,spinebreaker,1861,priest,shadow,82,47,35
Gâdzêd,kelthuzad,1856,priest,shadow,39,27,12
Itkev,area-52,1854,priest,shadow,35,27,8
Metasp,sargeras,1854,priest,shadow,54,30,24
Kattallyst,tichondrius,1851,priest,shadow,42,24,18
Dotall,illidan,1849,priest,shadow,59,41,18
Echoos,proudmoore,1849,priest,shadow,42,28,14
Disemble,illidan,1848,priest,shadow,48,24,24
Yoggismydad,emerald-dream,1847,priest,shadow,48,29,19
Sapoopettas,quelthalas,1845,priest,shadow,54,26,28
Zçythe,tichondrius,1844,priest,shadow,54,28,26
Remixsp,malganis,1840,priest,shadow,42,24,18
Bagjoe,illidan,1839,priest,shadow,74,43,31
Sleepynuj,stormrage,1838,priest,shadow,42,32,10
Impérial,stormrage,1835,priest,shadow,145,93,52
Louloudots,malganis,1835,priest,shadow,60,31,29
Phubar,stormreaver,1831,priest,shadow,78,34,44
Yb,kelthuzad,1829,priest,shadow,54,32,22
Auttø,area-52,1829,priest,shadow,45,26,19
Kalantris,ragnaros,1828,priest,shadow,64,41,23
Giriosp,thrall,1827,priest,shadow,31,22,9
Pbxx,tichondrius,1826,priest,shadow,46,27,19
Ptam,tichondrius,1825,priest,shadow,47,26,21
Idiotgarbage,moon-guard,1824,priest,shadow,48,26,22
Evenly,tichondrius,1822,priest,shadow,90,51,39
Snozberry,malganis,1822,priest,shadow,66,36,30
Mindslips,tichondrius,1821,priest,shadow,144,82,62
Mythsnake,ragnaros,1819,priest,shadow,43,25,18
Vil,lightnings-blade,1819,priest,shadow,90,50,40
Spamndam,tichondrius,1815,priest,shadow,24,19,5
Ysuran,moon-guard,1815,priest,shadow,144,82,62
Irasponsible,stormrage,1814,priest,shadow,42,23,19
Holytalk,tichondrius,1814,priest,shadow,60,30,30
Bearoom,frostmourne,1813,priest,shadow,48,33,15
Melonsoda,stormrage,1813,priest,shadow,48,26,22
Axelrod,tichondrius,1810,priest,shadow,42,27,15
Greaterfade,stormrage,1810,priest,shadow,48,26,22
Crbandit,moon-guard,1809,priest,shadow,55,42,13
Llamabush,malganis,1809,priest,shadow,39,26,13
Girthed,bloodscalp,1809,priest,shadow,56,36,20
Cixelpvp,area-52,1809,priest,shadow,54,26,28
Jomm,area-52,1805,priest,shadow,69,37,32
Exoticfather,area-52,1805,priest,shadow,60,30,30
Puppyboyx,moon-guard,1805,priest,shadow,56,27,29
Panndaz,tichondrius,1803,priest,shadow,30,19,11
Metricdotem,terenas,1803,priest,shadow,42,26,16
Brickzyhehe,dalaran,1803,priest,shadow,89,46,43
Estéve,wyrmrest-accord,1803,priest,shadow,65,33,32
Welplayedman,emerald-dream,1800,priest,shadow,36,22,14
Soyul,tichondrius,1795,priest,shadow,66,38,28
Zlowbly,ragnaros,1790,priest,shadow,77,41,36
Cheesëburg,illidan,1786,priest,shadow,36,21,15
Hollister,illidan,1786,priest,shadow,186,101,85
Jojotwo,illidan,1777,priest,shadow,54,27,27
Soar,ravencrest,1769,priest,shadow,35,20,15
Resonator,laughing-skull,1762,priest,shadow,40,19,21
Xayp,kelthuzad,1760,priest,shadow,77,58,19
Evx,demon-soul,1759,priest,shadow,84,47,37
Afromon,suramar,1748,priest,shadow,54,36,18
Derisha,ragnaros,1745,priest,shadow,48,28,20
Zhiwanam,tichondrius,1744,priest,shadow,53,31,22
Palmerin,ravencrest,1743,priest,shadow,63,35,28
Tomcruisé,zuljin,1742,priest,shadow,48,27,21
Shelize,kirin-tor,1741,priest,shadow,101,53,48
Doublesix,malganis,1740,priest,shadow,42,26,16
Delasoul,malganis,1740,priest,shadow,45,27,18
Lauretânia,nemesis,1737,priest,shadow,48,28,20
Helmsman,tichondrius,1735,priest,shadow,52,27,25
Ericzssp,tichondrius,1732,priest,shadow,35,21,14
Expr,area-52,1730,priest,shadow,36,22,14
Dildocrates,darkspear,1730,priest,shadow,48,28,20
Emopriestqt,tichondrius,1730,priest,shadow,92,53,39
Inflate,frostmourne,1727,priest,shadow,42,23,19
Gusho,frostmourne,1727,priest,shadow,127,68,59
Ðantex,thrall,1727,priest,shadow,94,50,44
Yberisa,zuljin,1724,priest,shadow,37,25,12
Peggable,moon-guard,1718,priest,shadow,42,23,19
Brokentrojan,moon-guard,1718,priest,shadow,48,23,25
Zlips,frostmourne,1716,priest,shadow,41,20,21
Atarri,illidan,1715,priest,shadow,36,22,14
Kovie,twisting-nether,1714,priest,shadow,100,65,35
Wafflezsp,frostmourne,1710,priest,shadow,84,39,45
Keliarc,sargeras,1703,priest,shadow,36,22,14
Hástür,quelthalas,1702,priest,shadow,67,37,30
Twoboo,bleeding-hollow,1701,priest,shadow,72,40,32
Voidazepam,zuljin,1700,priest,shadow,84,49,35
Deadsp,thrall,1693,priest,shadow,79,41,38
Vashrapani,stormrage,1691,priest,shadow,93,51,42
Mindgoblin,terokkar,1689,priest,shadow,36,18,18
Mindburn,nemesis,1689,priest,shadow,48,19,29
Snookp,kiljaeden,1687,priest,shadow,70,34,36
Scalpell,tichondrius,1684,priest,shadow,88,50,38
Pesca,proudmoore,1681,priest,shadow,42,26,16
Woodney,ragnaros,1676,priest,shadow,30,19,11
Darkvagician,malganis,1676,priest,shadow,36,19,17
Throwshade,moon-guard,1673,priest,shadow,54,33,21
Shadowblastx,sargeras,1668,priest,shadow,42,25,17
Desaros,tichondrius,1667,priest,shadow,42,24,18
Felrynpr,malganis,1665,priest,shadow,35,21,14
Garpd,tichondrius,1664,priest,shadow,36,24,12
Mushill,tichondrius,1662,priest,shadow,48,26,22
Mamísonga,ragnaros,1658,priest,shadow,32,18,14
Ilovealina,gorefiend,1653,priest,shadow,30,21,9
Talbadar,tichondrius,1652,priest,shadow,30,22,8
Asmødeus,bleeding-hollow,1651,priest,shadow,41,23,18
Sênju,thrall,1650,priest,shadow,41,20,21
Disxlyec,barthilas,1640,priest,shadow,47,25,22
Cavaliersr,ragnaros,1637,priest,shadow,84,48,36
Slasheal,caelestrasz,1633,priest,shadow,84,43,41
Dillydackx,sargeras,1631,priest,shadow,66,39,27
Cixelp,area-52,1631,priest,shadow,42,23,19
Giveheadpats,moon-guard,1629,priest,shadow,104,60,44
Amarexlol,stormrage,1629,priest,shadow,54,30,24
Safe,illidan,1629,priest,shadow,97,51,46
Eunu,tichondrius,1628,priest,shadow,33,21,12
Tamajka,the-forgotten-coast,1625,priest,shadow,27,18,9
Ellindria,spinebreaker,1622,priest,shadow,30,18,12
Shalla,blackrock,1621,priest,shadow,60,31,29
Bandages,stormreaver,1619,priest,shadow,74,42,32
Iogical,kelthuzad,1618,priest,shadow,116,70,46
Krazé,tichondrius,1617,priest,shadow,48,26,22
Skrillô,emerald-dream,1617,priest,shadow,42,20,22
Heàvenly,moon-guard,1616,priest,shadow,30,20,10
Jeanbi,ragnaros,1615,priest,shadow,88,55,33
Insanity,azuremyst,1615,priest,shadow,71,37,34
Shwayp,zuljin,1612,priest,shadow,30,17,13
Littlewench,sargeras,1609,priest,shadow,43,25,18
Manofmystery,dalaran,1605,priest,shadow,30,19,11
Pestee,quelthalas,1598,priest,shadow,94,61,33
Nishishabi,tichondrius,1598,priest,shadow,36,17,19
Wifegrip,tichondrius,1598,priest,shadow,42,19,23
Shadowkr,tichondrius,1594,priest,shadow,36,21,15
Zachlol,area-52,1594,priest,shadow,60,32,28
Solstunn,moon-guard,1594,priest,shadow,42,22,20
Sigx,area-52,1590,priest,shadow,24,17,7
Edai,malganis,1590,priest,shadow,81,43,38
Plaguesus,dalaran,1589,priest,shadow,36,19,17
Sarâda,moon-guard,1585,priest,shadow,115,61,54
Occult,bloodscalp,1582,priest,shadow,51,24,27
Khelleya,moon-guard,1578,priest,shadow,42,24,18
Holydose,moon-guard,1577,priest,shadow,42,18,24
Saintpleb,sargeras,1571,priest,shadow,56,37,19
Ezrashade,tichondrius,1570,priest,shadow,65,34,31
Voiders,area-52,1567,priest,shadow,85,52,33
Marantbourge,frostmourne,1566,priest,shadow,75,45,30
Sorrentin,ragnaros,1566,priest,shadow,58,31,27
Voidshift,tichondrius,1564,priest,shadow,106,56,50
Manifestor,illidan,1562,priest,shadow,74,43,31
Manic,skywall,1558,priest,shadow,78,42,36
Alex,boulderfist,1557,priest,shadow,54,31,23
Orgasmiq,frostmourne,1557,priest,shadow,36,18,18
Fig,nazgrel,1556,priest,shadow,54,27,27
Sodíum,wyrmrest-accord,1553,priest,shadow,36,17,19
Softs,area-52,1549,priest,shadow,83,42,41
Nevertelsp,malganis,1544,priest,shadow,35,25,10
Aethestan,zuljin,1544,priest,shadow,41,18,23
Crazyherb,azralon,1533,priest,shadow,60,34,26
Carniosso,azralon,1532,priest,shadow,36,19,17
Mealmassttr,frostmourne,1531,priest,shadow,36,18,18
Hotphoyou,moon-guard,1529,priest,shadow,48,31,17
Lowkii,malfurion,1528,priest,shadow,45,33,12
Numinous,wyrmrest-accord,1527,priest,shadow,32,20,12
Wenger,crushridge,1526,priest,shadow,66,32,34
Purpskurp,stormrage,1525,priest,shadow,42,20,22
Sochron,stormrage,1525,priest,shadow,56,25,31
Clownface,tichondrius,1523,priest,shadow,24,16,8
Nexumbra,dunemaul,1521,priest,shadow,42,22,20
Shadowdurps,area-52,1520,priest,shadow,42,21,21
Partypriest,tichondrius,1520,priest,shadow,48,23,25
Márceline,stormrage,1514,priest,shadow,60,37,23
Azagthøth,ravenholdt,1513,priest,shadow,192,99,93
Priestine,dreadmaul,1512,priest,shadow,84,41,43
Ussmissouri,area-52,1510,priest,shadow,30,16,14
Swungzebra,stormrage,1506,priest,shadow,102,59,43
Pepps,proudmoore,1504,priest,shadow,94,49,45
Swp,sargeras,1499,priest,shadow,30,21,9
Silero,dalaran,1497,priest,shadow,30,20,10
Iuka,emerald-dream,1493,priest,shadow,35,17,18
Fïo,proudmoore,1488,priest,shadow,66,32,34
Ratleen,malganis,1488,priest,shadow,134,61,73
Ranthrough,tichondrius,1482,priest,shadow,30,20,10
Deeaann,tichondrius,1480,priest,shadow,83,44,39
Antìdote,tichondrius,1474,priest,shadow,74,42,32
Dotdotwin,illidan,1472,priest,shadow,59,35,24
Methandrial,hyjal,1469,priest,shadow,42,22,20
Trenbologni,illidan,1466,priest,shadow,78,44,34
Toddmund,tichondrius,1466,priest,shadow,29,16,13
Plzdontlos,hyjal,1461,priest,shadow,36,22,14
Bigmollet,tichondrius,1461,priest,shadow,62,26,36
Fritzi,shattered-hand,1456,priest,shadow,30,17,13
Habann,frostmourne,1456,priest,shadow,89,47,42
Kokai,area-52,1440,priest,shadow,18,15,3
Pboo,tichondrius,1439,priest,shadow,30,15,15
Onegil,tichondrius,1436,priest,shadow,75,38,37
Aguitardient,ragnaros,1432,priest,shadow,30,18,12
Londy,area-52,1432,priest,shadow,140,68,72
ßroßraßroski,sargeras,1431,priest,shadow,36,22,14
Krytical,illidan,1431,priest,shadow,50,29,21
Minamy,tichondrius,1430,priest,shadow,24,15,9
Vynlanesh,illidan,1429,priest,shadow,42,16,26
Brokenspc,tichondrius,1426,priest,shadow,24,15,9
Nuggs,mannoroth,1425,priest,shadow,30,15,15
Cuaiminator,ragnaros,1422,priest,shadow,60,32,28
Delbringer,moon-guard,1419,priest,shadow,25,16,9
Rida,zuljin,1419,priest,shadow,32,20,12
Whitehandpr,tichondrius,1419,priest,shadow,123,57,66
Kilal,sargeras,1414,priest,shadow,30,20,10
Graviton,tichondrius,1414,priest,shadow,24,15,9
Strokkerx,azralon,1411,priest,shadow,30,19,11
Lelyna,stormrage,1411,priest,shadow,30,18,12
Urspareparts,sargeras,1405,priest,shadow,75,42,33
Blackoss,sargeras,1402,priest,shadow,29,15,14
Kydraah,ragnaros,1402,priest,shadow,29,15,14
Thelordx,barthilas,1400,priest,shadow,36,16,20
Stusy,tichondrius,1396,priest,shadow,41,28,13
Bigboyadam,frostmourne,1396,priest,shadow,34,23,11
Moralism,moon-guard,1395,priest,shadow,73,43,30
Xedus,mannoroth,1390,priest,shadow,28,19,9
Dipírex,azralon,1389,priest,shadow,84,40,44
Lilmix,hydraxis,1388,priest,shadow,35,22,13
Kadralin,illidan,1387,priest,shadow,36,16,20
Fäÿë,tichondrius,1386,priest,shadow,54,26,28
Tyisanity,tichondrius,1381,priest,shadow,50,23,27
Healztonic,dalaran,1380,priest,shadow,72,32,40
Marni,akama,1378,priest,shadow,24,15,9
Snuffp,sargeras,1378,priest,shadow,60,37,23
Wongÿ,tichondrius,1377,priest,shadow,24,20,4
Miniimenx,azralon,1375,priest,shadow,41,29,12
Locjawbe,area-52,1372,priest,shadow,23,16,7
Spõõky,illidan,1368,priest,shadow,26,15,11
Voidscrypt,thrall,1364,priest,shadow,83,50,33
Mamofwar,arthas,1353,priest,shadow,60,28,32
Sandelios,aggramar,1351,priest,shadow,30,20,10
Cmg,sargeras,1344,priest,shadow,24,14,10
Urelz,illidan,1343,priest,shadow,18,14,4
Flay,dragonmaw,1342,priest,shadow,18,14,4
Pengwinxl,agamaggan,1342,priest,shadow,24,14,10
Cixelp,tichondrius,1342,priest,shadow,30,14,16
Shén,barthilas,1336,priest,shadow,77,51,26
Bastét,skullcrusher,1336,priest,shadow,75,41,34
Shadork,area-52,1335,priest,shadow,25,15,10
Mindboink,malganis,1335,priest,shadow,61,31,30
Cyanovoid,thrall,1332,priest,shadow,24,14,10
Nøfaith,area-52,1330,priest,shadow,36,14,22
Frorgnence,stormrage,1328,priest,shadow,24,16,8
Fâêlyn,wyrmrest-accord,1327,priest,shadow,34,15,19
Maynard,ragnaros,1323,priest,shadow,30,16,14
Ajazz,zuljin,1321,priest,shadow,24,14,10
Rammstèin,sargeras,1314,priest,shadow,30,14,16
Timreaper,barthilas,1311,priest,shadow,35,21,14
Uncletouches,thrall,1303,priest,shadow,30,14,16
Kuazi,khazgoroth,1301,priest,shadow,65,25,40
Øvøxø,emerald-dream,1295,priest,shadow,33,15,18
Cheez,tichondrius,1293,priest,shadow,31,14,17
Alvorr,ragnaros,1292,priest,shadow,24,15,9
Astoshan,moon-guard,1292,priest,shadow,29,18,11
Ancene,illidan,1290,priest,shadow,42,24,18
Pumpss,area-52,1287,priest,shadow,26,15,11
Xannis,thrall,1285,priest,shadow,30,14,16
Synergize,korgath,1282,priest,shadow,48,25,23
Zyræl,stormrage,1280,priest,shadow,61,26,35
Dawnkìn,bleeding-hollow,1279,priest,shadow,30,14,16
Saphet,draktharon,1273,priest,shadow,22,19,3
Imabeast,stormrage,1268,priest,shadow,30,15,15
Greyyan,wyrmrest-accord,1258,priest,shadow,65,34,31
Bugsbright,tichondrius,1257,priest,shadow,50,21,29
Boogle,frostmourne,1254,priest,shadow,29,14,15
Álvarez,tichondrius,1253,priest,shadow,32,16,16
Jwx,malganis,1248,priest,shadow,18,13,5
Criminalsp,frostmourne,1248,priest,shadow,18,13,5
Drossv,shadowmoon,1247,priest,shadow,30,13,17
Chinchillin,demon-soul,1246,priest,shadow,54,32,22
Avraf,sargeras,1246,priest,shadow,24,13,11
Headbrake,malganis,1246,priest,shadow,24,13,11
Bubblepop,blackhand,1245,priest,shadow,18,13,5
Yayonaise,tichondrius,1244,priest,shadow,24,13,11
Crayon,stormrage,1244,priest,shadow,30,13,17
Suicider,emerald-dream,1244,priest,shadow,60,19,41
Mepisth,sargeras,1243,priest,shadow,18,13,5
Hüde,stormrage,1243,priest,shadow,54,26,28
Dovoso,kargath,1242,priest,shadow,24,13,11
Ascian,daggerspine,1239,priest,shadow,30,13,17
Dilly,tichondrius,1238,priest,shadow,21,14,7
Iuvrainee,area-52,1236,priest,shadow,24,13,11
Milkgrabber,bleeding-hollow,1235,priest,shadow,24,13,11
Sorrowful,mannoroth,1208,priest,shadow,29,13,16
Senumbra,tichondrius,1199,priest,shadow,30,13,17
Aedaki,garona,1178,priest,shadow,24,14,10
Nums,tichondrius,1168,priest,shadow,24,13,11
Pdfileclass,tichondrius,1152,priest,shadow,12,12,0
Targora,lightninghoof,1152,priest,shadow,18,12,6
Invain,executus,1151,priest,shadow,18,12,6
Stresscube,tichondrius,1151,priest,shadow,22,13,9
Ouazza8140BF,dalaran,1148,priest,shadow,18,12,6
Aflstan,frostmourne,1146,priest,shadow,45,27,18
Iminyou,kelthuzad,1144,priest,shadow,18,12,6
Darksheals,barthilas,1143,priest,shadow,24,18,6
Knglizward,stormrage,1140,priest,shadow,59,33,26
Abolita,korgath,1112,priest,shadow,54,26,28
Aformoflove,tichondrius,1087,priest,shadow,23,12,11
Chádeervas,nemesis,1074,priest,shadow,21,12,9
Manofmystery,drenden,1071,priest,shadow,17,12,5
Poague,area-52,1056,priest,shadow,18,11,7
Discipline,chogall,1056,priest,shadow,18,11,7
Patagoniabae,kelthuzad,1055,priest,shadow,12,11,1
Taylorsp,tichondrius,1055,priest,shadow,18,11,7
Xaneo,kelthuzad,1055,priest,shadow,18,11,7
Psyfiend,alterac-mountains,1055,priest,shadow,18,11,7
Goodlife,frostmourne,1055,priest,shadow,18,11,7
Nvøsuperstar,zuljin,1055,priest,shadow,24,11,13
Büd,sargeras,1054,priest,shadow,18,11,7
Fouroneo,tichondrius,1054,priest,shadow,18,11,7
Ashidox,proudmoore,1054,priest,shadow,21,12,9
Kultil,dalaran,1053,priest,shadow,18,11,7
Harisleidy,quelthalas,1050,priest,shadow,18,11,7
Xammys,malganis,1043,priest,shadow,18,11,7
Layrissa,whisperwind,1043,priest,shadow,18,11,7
Chewthefat,darkspear,1023,priest,shadow,23,11,12
Azheel,stormrage,1022,priest,shadow,23,11,12
Galice,archimonde,1004,priest,shadow,42,19,23
Healtheze,kelthuzad,989,priest,shadow,14,11,3
Jhivagosp,tichondrius,988,priest,shadow,22,11,11
Vílja,moon-guard,982,priest,shadow,29,11,18
Urmorphine,area-52,969,priest,shadow,110,54,56
Discountay,burning-legion,965,priest,shadow,20,11,9
Wizkxg,tichondrius,960,priest,shadow,12,10,2
Claudiosip,tichondrius,960,priest,shadow,12,10,2
Mmrassassin,stormrage,960,priest,shadow,12,10,2
Gelato,velen,960,priest,shadow,18,10,8
Verbeka,nemesis,959,priest,shadow,12,10,2
Synergia,drakkari,959,priest,shadow,12,10,2
Xtradotz,tichondrius,959,priest,shadow,18,10,8
Philmacrakn,stormrage,959,priest,shadow,18,10,8
Mêdúsa,area-52,959,priest,shadow,18,10,8
Nodoubt,barthilas,959,priest,shadow,24,10,14
Terý,dalaran,959,priest,shadow,24,10,14
Fantasía,moon-guard,959,priest,shadow,30,10,20
Ightdoe,zuljin,958,priest,shadow,12,10,2
Porffy,malygos,958,priest,shadow,18,10,8
Volkova,quelthalas,958,priest,shadow,18,10,8
Adopted,wyrmrest-accord,957,priest,shadow,18,10,8
Nightcráwler,illidan,957,priest,shadow,18,10,8
Coors,lightnings-blade,956,priest,shadow,18,10,8
Rizzle,emerald-dream,956,priest,shadow,18,10,8
Kibariyb,drakkari,956,priest,shadow,24,10,14
Gankdalf,draktharon,955,priest,shadow,18,10,8
Thrageqt,sargeras,908,priest,shadow,20,11,9
Machinecoach,stormrage,895,priest,shadow,22,10,12
Yoggsarodney,tichondrius,880,priest,shadow,13,10,3
Palumorp,deathwing,864,priest,shadow,12,9,3
Sinkz,ragnaros,864,priest,shadow,12,9,3
Gershwinner,daggerspine,864,priest,shadow,18,9,9
Jthreetx,kelthuzad,864,priest,shadow,18,9,9
Bloodify,azralon,863,priest,shadow,12,9,3
Darkshadows,ravenholdt,863,priest,shadow,12,9,3
Sempiternus,barthilas,863,priest,shadow,18,9,9
Delrey,sargeras,863,priest,shadow,18,9,9
Vaala,jubeithos,863,priest,shadow,18,9,9
Stepho,dalaran,863,priest,shadow,18,9,9
Ðecease,thrall,863,priest,shadow,18,9,9
Esteedees,bonechewer,863,priest,shadow,18,9,9
Dirtyysanta,tichondrius,863,priest,shadow,18,9,9
Fancycorpse,tichondrius,863,priest,shadow,24,9,15
Rhick,azralon,862,priest,shadow,12,9,3
Malikeht,drakkari,862,priest,shadow,12,9,3
Shadowyeti,illidan,862,priest,shadow,12,9,3
Touchypriest,jaedenar,862,priest,shadow,18,9,9
Constentien,tichondrius,862,priest,shadow,18,9,9
Dóctóre,thrall,862,priest,shadow,18,9,9
Shadowflux,thunderlord,862,priest,shadow,30,9,21
Grimdox,tichondrius,861,priest,shadow,12,9,3
Wobbleskank,tichondrius,861,priest,shadow,12,9,3
Melas,stormrage,861,priest,shadow,24,9,15
Viejiyoh,ragnaros,860,priest,shadow,18,9,9
Hibot,illidan,849,priest,shadow,18,9,9
Kagamì,frostmane,843,priest,shadow,31,9,22
Cymin,dalaran,816,priest,shadow,21,10,11
Stylonious,hyjal,815,priest,shadow,15,9,6
Buc,barthilas,813,priest,shadow,15,9,6
Pocket,alleria,800,priest,shadow,16,9,7
Kwõnc,tichondrius,799,priest,shadow,11,9,2
Chenny,darkspear,798,priest,shadow,14,9,5
Bobbyvagene,area-52,768,priest,shadow,12,8,4
Nohealerhere,frostmourne,768,priest,shadow,12,8,4
Silmeriá,darkspear,768,priest,shadow,12,8,4
Lastbubble,area-52,768,priest,shadow,12,8,4
Oxycodex,thrall,768,priest,shadow,12,8,4
Saintjudys,tichondrius,768,priest,shadow,12,8,4
Nutdrip,tichondrius,768,priest,shadow,12,8,4
Stungods,frostmourne,768,priest,shadow,12,8,4
Skraitbussin,tichondrius,768,priest,shadow,12,8,4
Remedio,emerald-dream,768,priest,shadow,15,8,7
Originull,emerald-dream,768,priest,shadow,18,8,10
Àústîn,moon-guard,768,priest,shadow,18,8,10
Madcaddies,bonechewer,768,priest,shadow,18,8,10
Skepix,lightbringer,768,priest,shadow,18,8,10
Lillyp,malganis,768,priest,shadow,18,8,10
Deacoderx,area-52,768,priest,shadow,18,8,10
Chazzwizz,area-52,768,priest,shadow,18,8,10
Krelaeren,tichondrius,768,priest,shadow,24,8,16
Hairyboxx,frostmourne,767,priest,shadow,12,8,4
Rogspriest,sargeras,767,priest,shadow,12,8,4
Tungus,shadowsong,767,priest,shadow,12,8,4
Trollypriest,darkspear,767,priest,shadow,12,8,4
Frankeebutt,stormrage,767,priest,shadow,12,8,4
Rhoku,nesingwary,767,priest,shadow,12,8,4
Flickmybick,sargeras,767,priest,shadow,15,9,6
Whorticiå,area-52,767,priest,shadow,18,8,10
Badxjuju,frostmourne,767,priest,shadow,18,8,10
Priestzerath,azralon,767,priest,shadow,18,8,10
Chinkatron,frostmourne,767,priest,shadow,18,8,10
Dayquills,illidan,767,priest,shadow,18,8,10
Krypts,shadow-council,766,priest,shadow,12,8,4
Aránhell,ragnaros,766,priest,shadow,12,8,4
Solrina,khazgoroth,766,priest,shadow,12,8,4
Xora,frostmourne,766,priest,shadow,12,8,4
Bûdussy,bonechewer,766,priest,shadow,18,8,10
Jinzan,stormrage,766,priest,shadow,18,8,10
Antoz,kelthuzad,763,priest,shadow,12,8,4
Castnngcouch,tichondrius,762,priest,shadow,18,8,10
Drkwispers,stormrage,762,priest,shadow,18,8,10
Zolgeta,exodar,760,priest,shadow,12,8,4
Battlepope,the-scryers,755,priest,shadow,20,9,11
Memoria,emerald-dream,751,priest,shadow,15,9,6
Xmewo,sargeras,751,priest,shadow,17,8,9
Vinasky,moon-guard,735,priest,shadow,20,9,11
Vyabl,thrall,734,priest,shadow,18,9,9
Võid,tichondrius,719,priest,shadow,17,8,9
Meegoshy,azuremyst,718,priest,shadow,17,8,9
Illushadio,area-52,717,priest,shadow,11,8,3
Mikó,dawnbringer,714,priest,shadow,29,10,19
Moonlightx,destromath,672,priest,shadow,12,7,5
Duhpriest,frostmourne,672,priest,shadow,12,7,5
Fatzoid,the-forgotten-coast,672,priest,shadow,12,7,5
Nightelffeet,stormrage,672,priest,shadow,12,7,5
Scarabless,bleeding-hollow,672,priest,shadow,12,7,5
Fireballingg,tichondrius,672,priest,shadow,12,7,5
Iluvwizkx,malganis,672,priest,shadow,12,7,5
Soný,stormrage,672,priest,shadow,12,7,5
Evilgeniusx,area-52,672,priest,shadow,12,7,5
Simplyfaded,black-dragonflight,672,priest,shadow,12,7,5
Xtcbtc,sargeras,672,priest,shadow,12,7,5
Tye,medivh,672,priest,shadow,12,7,5
Smitepie,malganis,672,priest,shadow,12,7,5
Shmage,malganis,672,priest,shadow,12,7,5
Bucksp,zuljin,672,priest,shadow,12,7,5
Pwrwordsquee,lightbringer,672,priest,shadow,12,7,5
Jeängrey,tichondrius,672,priest,shadow,12,7,5
Grëýmåttèr,moon-guard,672,priest,shadow,12,7,5
Didy,dark-iron,672,priest,shadow,12,7,5
Bigweebo,sargeras,672,priest,shadow,12,7,5
Blackaries,frostmourne,672,priest,shadow,12,7,5
Raptorjésus,azjolnerub,672,priest,shadow,12,7,5
Acpriest,tichondrius,672,priest,shadow,18,7,11
Evelën,azralon,672,priest,shadow,18,7,11
Chês,tichondrius,672,priest,shadow,24,7,17
Voltstein,dalaran,671,priest,shadow,12,7,5
Darkrics,barthilas,671,priest,shadow,12,7,5
Shadyvoodoo,barthilas,671,priest,shadow,12,7,5
Moonpenance,windrunner,671,priest,shadow,12,7,5
Beckðn,tichondrius,671,priest,shadow,12,7,5
Mortivore,azralon,671,priest,shadow,18,7,11
Havefaith,whisperwind,671,priest,shadow,18,7,11
Deffaultz,turalyon,671,priest,shadow,18,7,11
Montcrief,tichondrius,670,priest,shadow,12,7,5
Tonybromoo,kelthuzad,670,priest,shadow,12,7,5
Iseeyoulookn,stormrage,670,priest,shadow,16,8,8
Shadzie,sargeras,670,priest,shadow,18,7,11
Gabryanna,emerald-dream,669,priest,shadow,24,7,17
Metaila,aerie-peak,639,priest,shadow,11,7,4
Flowerpetals,emerald-dream,599,priest,shadow,21,7,14
Mastahmind,illidan,591,priest,shadow,13,7,6
Ìforted,zuljin,587,priest,shadow,19,7,12
Àx,draka,584,priest,shadow,17,8,9
Sydgames,area-52,576,priest,shadow,6,6,0
Madmelter,emerald-dream,576,priest,shadow,6,6,0
Inflìctìøn,frostmourne,576,priest,shadow,6,6,0
Freebolte,frostmourne,576,priest,shadow,6,6,0
Moonwald,moon-guard,576,priest,shadow,6,6,0
Dernièreplac,blackrock,576,priest,shadow,8,6,2
Deckx,khazgoroth,576,priest,shadow,10,7,3
Voidhearted,tichondrius,576,priest,shadow,12,6,6
Studiosxz,tichondrius,576,priest,shadow,12,6,6
Verbane,frostmourne,576,priest,shadow,12,6,6
Mks,barthilas,576,priest,shadow,12,6,6
Nüt,malganis,576,priest,shadow,12,6,6
Pootzy,malganis,576,priest,shadow,12,6,6
Radicional,azralon,576,priest,shadow,12,6,6
Imhðtep,ragnaros,576,priest,shadow,12,6,6
Cathery,tichondrius,576,priest,shadow,12,6,6
Murkqz,stormrage,576,priest,shadow,12,6,6
Heàl,akama,576,priest,shadow,12,6,6
Rachelstarrx,hyjal,576,priest,shadow,12,6,6
Ikillfast,tichondrius,576,priest,shadow,12,6,6
Evansong,frostmane,576,priest,shadow,12,6,6
Tiernocookie,illidan,576,priest,shadow,12,6,6
Spriestbro,emerald-dream,576,priest,shadow,12,6,6
Imshadow,azralon,576,priest,shadow,12,6,6
Korrà,turalyon,576,priest,shadow,12,6,6
Qadris,tichondrius,576,priest,shadow,12,6,6
Lostnlight,aggramar,576,priest,shadow,12,6,6
Shadeven,nagrand,576,priest,shadow,12,6,6
Sakuraginero,illidan,576,priest,shadow,12,6,6
Sped,saurfang,576,priest,shadow,12,6,6
Finfangfoom,laughing-skull,576,priest,shadow,18,6,12
Mindgamez,stormreaver,576,priest,shadow,18,6,12
Swurvexo,bleeding-hollow,576,priest,shadow,18,6,12
Soulrulerx,tichondrius,576,priest,shadow,18,6,12
Aeingel,amanthul,576,priest,shadow,18,6,12
Niurouchuan,tichondrius,576,priest,shadow,18,6,12
Cykle,blackrock,576,priest,shadow,24,6,18
Crashed,frostmourne,575,priest,shadow,12,6,6
Thügñästy,darkspear,575,priest,shadow,12,6,6
Drsonny,proudmoore,575,priest,shadow,12,6,6
Xð,jubeithos,575,priest,shadow,12,6,6
Likeleela,azshara,575,priest,shadow,18,6,12
Duhk,moon-guard,574,priest,shadow,12,6,6
Jamashud,mannoroth,571,priest,shadow,12,6,6
Rotass,hyjal,559,priest,shadow,11,6,5
Niark,frostmourne,527,priest,shadow,11,6,5
Totorostarp,tichondrius,521,priest,shadow,22,8,14
Fedodesubaco,gallywix,517,priest,shadow,15,7,8
Exen,moon-guard,511,priest,shadow,12,7,5
Suirr,tichondrius,480,priest,shadow,6,5,1
Bradythree,moon-guard,480,priest,shadow,6,5,1
Wololo,emerald-dream,480,priest,shadow,6,5,1
Pristoleiro,azralon,480,priest,shadow,6,5,1
ßarracuda,illidan,480,priest,shadow,6,5,1
Arthrix,sargeras,480,priest,shadow,6,5,1
Everblack,executus,480,priest,shadow,6,5,1
Jezebëll,nemesis,480,priest,shadow,6,5,1
Gles,quelthalas,480,priest,shadow,6,5,1
Valerift,moon-guard,480,priest,shadow,6,5,1
Voltétt,tichondrius,480,priest,shadow,6,5,1
Fiéstah,illidan,480,priest,shadow,6,5,1
Lucifena,darkspear,480,priest,shadow,6,5,1
Chervz,chogall,480,priest,shadow,6,5,1
Deuz,quelthalas,480,priest,shadow,6,5,1
Tensorflow,tichondrius,480,priest,shadow,6,5,1
Rykispriest,tichondrius,480,priest,shadow,6,5,1
Kaidow,wyrmrest-accord,480,priest,shadow,6,5,1
Ðemi,zuljin,480,priest,shadow,6,5,1
Rattyp,barthilas,480,priest,shadow,6,5,1
Megamind,elune,480,priest,shadow,6,5,1
Dazull,bleeding-hollow,480,priest,shadow,6,5,1
Øbara,frostmourne,480,priest,shadow,10,6,4
Pokeyoobutt,hydraxis,480,priest,shadow,12,5,7
Flukex,tichondrius,480,priest,shadow,12,5,7
Moä,nemesis,480,priest,shadow,12,5,7
Sársaukis,illidan,480,priest,shadow,12,5,7
Orderic,ragnaros,480,priest,shadow,12,5,7
Royx,stormreaver,480,priest,shadow,12,5,7
Keepsleepin,stormrage,480,priest,shadow,12,5,7
Task,korgath,480,priest,shadow,12,5,7
Cryptron,tichondrius,480,priest,shadow,12,5,7
Helleamh,tichondrius,480,priest,shadow,12,5,7
Littledog,velen,480,priest,shadow,12,5,7
Pottime,tichondrius,480,priest,shadow,12,5,7
Minnowhead,kelthuzad,480,priest,shadow,12,5,7
Lyriczx,kelthuzad,480,priest,shadow,12,5,7
Spriest,kul-tiras,480,priest,shadow,12,5,7
Dispèrsion,darkspear,480,priest,shadow,12,5,7
Healixd,area-52,480,priest,shadow,12,5,7
Faydes,arthas,480,priest,shadow,13,5,8
Stillmatick,tichondrius,480,priest,shadow,16,6,10
Zerohoür,emerald-dream,480,priest,shadow,16,6,10
Nedajoon,tichondrius,480,priest,shadow,17,6,11
Ericxd,area-52,480,priest,shadow,18,5,13
Sybal,suramar,480,priest,shadow,19,5,14
Shadøwheal,stormrage,479,priest,shadow,6,5,1
Amestroada,nemesis,479,priest,shadow,12,5,7
Ragnálodbrok,ragnaros,479,priest,shadow,12,5,7
Wolfeclipse,sargeras,479,priest,shadow,12,5,7
Antiraus,aerie-peak,478,priest,shadow,12,5,7
Wiiuwiiu,malganis,447,priest,shadow,11,5,6
Sôuljah,skywall,447,priest,shadow,11,5,6
Forober,queldorei,446,priest,shadow,10,6,4
Jydge,tichondrius,431,priest,shadow,9,6,3
Reignsp,malganis,400,priest,shadow,7,5,2
Ampela,dalaran,400,priest,shadow,13,5,8
Nizr,bleeding-hollow,399,priest,shadow,5,5,0
Nås,elune,384,priest,shadow,6,4,2
Floofball,medivh,384,priest,shadow,6,4,2
Ruzhi,moon-guard,384,priest,shadow,6,4,2
Whosjoe,tichondrius,384,priest,shadow,6,4,2
Wetleaftx,chogall,384,priest,shadow,6,4,2
Itha,illidan,384,priest,shadow,6,4,2
Chicoryx,illidan,384,priest,shadow,6,4,2
Despairx,tichondrius,384,priest,shadow,6,4,2
Bubbyflay,area-52,384,priest,shadow,6,4,2
Saevita,area-52,384,priest,shadow,6,4,2
Ciem,tichondrius,384,priest,shadow,6,4,2
Sungsh,zuljin,384,priest,shadow,6,4,2
Yuricksus,malganis,384,priest,shadow,6,4,2
Mòrbídìtý,area-52,384,priest,shadow,6,4,2
Ikiteforhash,zuljin,384,priest,shadow,6,4,2
Prydas,tichondrius,384,priest,shadow,6,4,2
Härpocrates,area-52,384,priest,shadow,6,4,2
Virsyti,area-52,384,priest,shadow,6,4,2
Tiinkerbell,moon-guard,384,priest,shadow,6,4,2
Comoli,tichondrius,384,priest,shadow,6,4,2
Shieldspamx,tichondrius,384,priest,shadow,6,4,2
Rôss,tichondrius,384,priest,shadow,6,4,2
Duckdemon,ragnaros,384,priest,shadow,6,4,2
Kynyssaelz,proudmoore,384,priest,shadow,6,4,2
Ramaven,arygos,384,priest,shadow,6,4,2
Bax,kilrogg,384,priest,shadow,6,4,2
Killían,darkspear,384,priest,shadow,6,4,2
Pluse,bonechewer,384,priest,shadow,6,4,2
Diskordia,stormrage,384,priest,shadow,6,4,2
Lawgiva,thrall,384,priest,shadow,6,4,2
Nozp,stormrage,384,priest,shadow,6,4,2
Icarryozz,darkspear,384,priest,shadow,6,4,2
Uploading,moon-guard,384,priest,shadow,6,4,2
Voidathon,sargeras,384,priest,shadow,6,4,2
Airil,mugthol,384,priest,shadow,6,4,2
Jah,frostmourne,384,priest,shadow,6,4,2
Mentalprison,khazgoroth,384,priest,shadow,6,4,2
Sãoleozinho,azralon,384,priest,shadow,6,4,2
Delai,dalaran,384,priest,shadow,6,4,2
Haedn,azralon,384,priest,shadow,6,4,2
Guillotine,azralon,384,priest,shadow,6,4,2
Sînkaî,demon-soul,384,priest,shadow,6,4,2
Ayzen,emerald-dream,384,priest,shadow,6,4,2
Minarhy,moon-guard,384,priest,shadow,6,4,2
Couldntbeme,sargeras,384,priest,shadow,6,4,2
Sleezi,emerald-dream,384,priest,shadow,6,4,2
Plushys,emerald-dream,384,priest,shadow,6,4,2
Prostrat,deathwing,384,priest,shadow,6,4,2
Marfas,illidan,384,priest,shadow,8,5,3
Mfn,deathwing,384,priest,shadow,11,4,7
Himikko,illidan,384,priest,shadow,12,4,8
Nyktøs,quelthalas,384,priest,shadow,12,4,8
Gromkekz,area-52,384,priest,shadow,12,4,8
Vaeryl,stormrage,384,priest,shadow,12,4,8
Lätöxïkä,alleria,384,priest,shadow,12,4,8
Influencing,moon-guard,384,priest,shadow,12,4,8
Mannyelf,ragnaros,384,priest,shadow,12,4,8
Tokaru,frostmourne,384,priest,shadow,12,4,8
Alucardibee,turalyon,384,priest,shadow,12,4,8
Deathbyhot,gorefiend,384,priest,shadow,12,4,8
Dialis,frostmourne,384,priest,shadow,12,4,8
Holydrop,sargeras,384,priest,shadow,12,4,8
Elogant,frostmourne,384,priest,shadow,12,4,8
Akuvurá,nemesis,384,priest,shadow,12,4,8
Reverendpope,tichondrius,384,priest,shadow,12,4,8
Heheheg,tichondrius,384,priest,shadow,12,4,8
Arca,cenarion-circle,384,priest,shadow,18,4,14
Scormm,runetotem,383,priest,shadow,6,4,2
Jammý,barthilas,383,priest,shadow,12,4,8
Whisper,zuljin,383,priest,shadow,12,4,8
Kkpriest,frostmourne,382,priest,shadow,6,4,2
Geulis,illidan,382,priest,shadow,12,4,8
Thotsndots,blood-furnace,351,priest,shadow,8,5,3
Maldicius,emerald-dream,351,priest,shadow,11,4,7
Dtbündertree,nordrassil,319,priest,shadow,5,4,1
Whittysp,tichondrius,288,priest,shadow,6,3,3
Seniorpickle,emerald-dream,288,priest,shadow,6,3,3
Bbeaie,tichondrius,288,priest,shadow,6,3,3
Drognar,lightbringer,288,priest,shadow,6,3,3
Döllyy,illidan,288,priest,shadow,6,3,3
Nawzyh,emerald-dream,288,priest,shadow,6,3,3
Zuuji,frostmourne,288,priest,shadow,6,3,3
Alykus,emerald-dream,288,priest,shadow,6,3,3
Leyspring,moon-guard,288,priest,shadow,6,3,3
Voidballs,tichondrius,288,priest,shadow,6,3,3
Xuxu,frostmourne,288,priest,shadow,6,3,3
Empyreanlite,dalaran,288,priest,shadow,6,3,3
Halîth,terenas,288,priest,shadow,6,3,3
Valloren,kalecgos,288,priest,shadow,6,3,3
Jeffgordo,tichondrius,288,priest,shadow,6,3,3
Studpriest,tichondrius,288,priest,shadow,6,3,3
Badbwoi,frostmourne,288,priest,shadow,6,3,3
Ripchadman,tichondrius,288,priest,shadow,6,3,3
Hriest,tichondrius,288,priest,shadow,6,3,3
Chroma,amanthul,288,priest,shadow,6,3,3
ßoy,amanthul,288,priest,shadow,6,3,3
Ossirus,emerald-dream,288,priest,shadow,6,3,3
Snackabre,moon-guard,288,priest,shadow,6,3,3
Toxictampax,azjolnerub,288,priest,shadow,6,3,3
Disembly,illidan,288,priest,shadow,6,3,3
Fhelurian,quelthalas,288,priest,shadow,6,3,3
Foli,zuljin,288,priest,shadow,6,3,3
Dumpesitwo,frostmourne,288,priest,shadow,6,3,3
Furìøns,nemesis,288,priest,shadow,6,3,3
Likesshadows,tichondrius,288,priest,shadow,6,3,3
Intheway,bleeding-hollow,288,priest,shadow,6,3,3
Vanisa,hellscream,288,priest,shadow,6,3,3
Eraseme,bleeding-hollow,288,priest,shadow,6,3,3
Goblindruid,bleeding-hollow,288,priest,shadow,6,3,3
Moselol,tichondrius,288,priest,shadow,6,3,3
Heihunüwang,kargath,288,priest,shadow,6,3,3
Chü,dalaran,288,priest,shadow,6,3,3
Fenix,bloodhoof,288,priest,shadow,6,3,3
Wrathhealer,hellscream,288,priest,shadow,6,3,3
Samio,area-52,288,priest,shadow,6,3,3
Showakoi,ragnaros,288,priest,shadow,6,3,3
Creata,frostmourne,288,priest,shadow,6,3,3
Xxmewo,sargeras,288,priest,shadow,6,3,3
Îcecube,sargeras,288,priest,shadow,6,3,3
Hårper,area-52,288,priest,shadow,6,3,3
Woosanghong,tichondrius,288,priest,shadow,6,3,3
Dorraheals,tichondrius,288,priest,shadow,6,3,3
Haransimongo,area-52,288,priest,shadow,6,3,3
Cappoo,tichondrius,288,priest,shadow,6,3,3
Aliciab,andorhal,288,priest,shadow,6,3,3
Twistedtéa,garrosh,288,priest,shadow,6,3,3
Lucènt,frostmourne,288,priest,shadow,6,3,3
Kindyx,ragnaros,288,priest,shadow,6,3,3
Jeseck,quelthalas,288,priest,shadow,6,3,3
Etherrion,area-52,288,priest,shadow,6,3,3
Mallox,quelthalas,288,priest,shadow,6,3,3
Sealife,kelthuzad,288,priest,shadow,6,3,3
Diddlur,black-dragonflight,288,priest,shadow,6,3,3
Rigotakx,illidan,288,priest,shadow,6,3,3
Aeøns,sargeras,288,priest,shadow,6,3,3
Nizanz,illidan,288,priest,shadow,6,3,3
Synisteria,sargeras,288,priest,shadow,6,3,3
Reâpêr,kelthuzad,288,priest,shadow,6,3,3
Shadhoee,sargeras,288,priest,shadow,6,3,3
Jugeum,proudmoore,288,priest,shadow,6,3,3
Caiitlynn,quelthalas,288,priest,shadow,6,3,3
Sybenela,proudmoore,288,priest,shadow,12,3,9
Azrothlol,kul-tiras,288,priest,shadow,12,3,9
Leach,darkspear,288,priest,shadow,12,3,9
Shadowpain,the-underbog,288,priest,shadow,12,3,9
Stantz,burning-legion,288,priest,shadow,12,3,9
Csonka,stormrage,288,priest,shadow,12,3,9
Shadowbishop,barthilas,287,priest,shadow,6,3,3
Grímmz,veknilash,287,priest,shadow,7,3,4
Bwansandi,blackrock,275,priest,shadow,32,7,25
Holydestroyr,dentarg,240,priest,shadow,15,3,12
Vtplz,bleeding-hollow,192,priest,shadow,4,3,1
Shadowblax,thrall,192,priest,shadow,4,3,1
Alip,tichondrius,192,priest,shadow,4,3,1
Slctivhealng,area-52,192,priest,shadow,6,2,4
Onlyphantoms,kelthuzad,192,priest,shadow,6,2,4
Horsegirls,kelthuzad,192,priest,shadow,6,2,4
Selspriest,kelthuzad,192,priest,shadow,6,2,4
Xionys,sargeras,192,priest,shadow,6,2,4
Apâthy,area-52,192,priest,shadow,6,2,4
Arzeuz,ragnaros,192,priest,shadow,6,2,4
Benjamints,thrall,192,priest,shadow,6,2,4
Fatzzbtw,illidan,192,priest,shadow,6,2,4
Anxìetý,area-52,192,priest,shadow,6,2,4
Jojoxxz,illidan,192,priest,shadow,6,2,4
Kälashnikova,ragnaros,192,priest,shadow,6,2,4
Dotdotdead,earthen-ring,192,priest,shadow,6,2,4
Psychohazard,area-52,192,priest,shadow,6,2,4
Darkenside,moon-guard,192,priest,shadow,6,2,4
Yungjim,the-forgotten-coast,192,priest,shadow,6,2,4
Brounly,drakkari,192,priest,shadow,6,2,4
Hail,kaelthas,192,priest,shadow,6,2,4
Dogfrompark,illidan,192,priest,shadow,6,2,4
Bumbleedot,azralon,192,priest,shadow,6,2,4
Bmô,stormrage,192,priest,shadow,6,2,4
Ëlliot,stormrage,192,priest,shadow,6,2,4
Kabutta,stormrage,192,priest,shadow,6,2,4
Lifejuice,tichondrius,192,priest,shadow,6,2,4
Murkqz,azralon,192,priest,shadow,6,2,4
Brothofnzoth,emerald-dream,192,priest,shadow,6,2,4
Xeras,ravencrest,192,priest,shadow,6,2,4
Projectalice,ravencrest,192,priest,shadow,6,2,4
Såx,stormreaver,192,priest,shadow,6,2,4
Cryptoccocus,zuljin,192,priest,shadow,6,2,4
Lolsithlord,tichondrius,192,priest,shadow,6,2,4
Layons,nemesis,192,priest,shadow,6,2,4
Phéonìx,zuljin,192,priest,shadow,6,2,4
Lontra,zangarmarsh,192,priest,shadow,6,2,4
Hurtfeet,sargeras,192,priest,shadow,6,2,4
Tenaebreu,tichondrius,192,priest,shadow,6,2,4
Ptheld,tichondrius,192,priest,shadow,6,2,4
Drupith,dalaran,192,priest,shadow,6,2,4
Kryoff,illidan,192,priest,shadow,6,2,4
Byungsik,terenas,192,priest,shadow,6,2,4
Laokele,tichondrius,192,priest,shadow,6,2,4
Hygeïa,lightbringer,192,priest,shadow,6,2,4
Hevnlyst,proudmoore,192,priest,shadow,6,2,4
Furryoflife,suramar,192,priest,shadow,6,2,4
Midget,darkspear,192,priest,shadow,6,2,4
Shmmoie,frostmourne,192,priest,shadow,6,2,4
Púrg,frostmourne,192,priest,shadow,6,2,4
Halselin,senjin,192,priest,shadow,6,2,4
Senadori,azjolnerub,192,priest,shadow,6,2,4
Innergee,aegwynn,192,priest,shadow,6,2,4
Warklaw,frostmourne,192,priest,shadow,6,2,4
Sshhaaddooww,tichondrius,192,priest,shadow,6,2,4
Scenekîd,moon-guard,192,priest,shadow,6,2,4
Pikeysplol,illidan,192,priest,shadow,6,2,4
Scaryspise,nathrezim,192,priest,shadow,6,2,4
Optimism,frostmane,192,priest,shadow,6,2,4
Quinnx,tichondrius,192,priest,shadow,6,2,4
Kulrig,shuhalo,192,priest,shadow,12,2,10
Alizhe,ragnaros,192,priest,shadow,12,2,10
Ozztwo,tichondrius,192,priest,shadow,12,2,10
Farnkxd,bleeding-hollow,192,priest,shadow,12,2,10
Deadcode,frostmane,192,priest,shadow,13,2,11
Gobananas,bleeding-hollow,159,priest,shadow,5,2,3
Tiizz,malganis,159,priest,shadow,5,2,3
Ashtahius,ragnaros,159,priest,shadow,5,2,3
Zyrith,sargeras,159,priest,shadow,9,2,7
Gaeira,azralon,159,priest,shadow,11,2,9
Sgiath,alleria,138,priest,shadow,9,4,5
Winss,tichondrius,128,priest,shadow,4,2,2
Samsypriest,frostmourne,126,priest,shadow,4,4,0
Shadowjisha,emerald-dream,96,priest,shadow,3,2,1
Libationz,area-52,96,priest,shadow,3,2,1
Clamchowdy,kiljaeden,96,priest,shadow,3,2,1
Pnub,aggramar,96,priest,shadow,3,2,1
Priestthingz,area-52,96,priest,shadow,8,2,6
Ibangedaqt,malganis,96,priest,shadow,6,1,5
Milliyakk,area-52,96,priest,shadow,6,1,5
Jxkep,frostmourne,96,priest,shadow,6,1,5
Shadowreck,malganis,96,priest,shadow,6,1,5
Sadury,tichondrius,96,priest,shadow,6,1,5
Irilde,proudmoore,96,priest,shadow,6,1,5
Omygawd,tichondrius,96,priest,shadow,6,1,5
Baerybonds,kiljaeden,96,priest,shadow,6,1,5
Oxyy,aerie-peak,96,priest,shadow,6,1,5
Óst,tichondrius,96,priest,shadow,6,1,5
Teccalil,tichondrius,96,priest,shadow,6,1,5
Lôvecraft,frostmourne,96,priest,shadow,6,1,5
Lleak,tichondrius,96,priest,shadow,6,1,5
Lukaspriest,proudmoore,96,priest,shadow,6,1,5
Kelody,zuljin,96,priest,shadow,6,1,5
Vdip,illidan,96,priest,shadow,6,1,5
Mangemoélqc,darkspear,96,priest,shadow,6,1,5
Dadsalad,zuljin,96,priest,shadow,6,1,5
Vyndictus,shattered-hand,96,priest,shadow,6,1,5
Drosslolz,illidan,96,priest,shadow,6,1,5
Shadolord,illidan,96,priest,shadow,6,1,5
Daemoon,deathwing,96,priest,shadow,6,1,5
Jèf,stormrage,96,priest,shadow,6,1,5
Lilskizz,dalaran,96,priest,shadow,6,1,5
Dawnbréaker,azralon,96,priest,shadow,6,1,5
Althlon,emerald-dream,96,priest,shadow,6,1,5
Amikam,barthilas,96,priest,shadow,6,1,5
Whatsittoya,tichondrius,96,priest,shadow,6,1,5
Galestick,illidan,96,priest,shadow,6,1,5
Shadylotion,stormrage,96,priest,shadow,6,1,5
Jpray,bleeding-hollow,96,priest,shadow,12,1,11
Kunof,ragnaros,79,priest,shadow,5,1,4
Tmpriest,tichondrius,79,priest,shadow,5,1,4
Bublethenrun,cenarius,48,priest,shadow,3,1,2
Fledgeling,frostmourne,31,priest,shadow,2,1,1
Trågédy,azjolnerub,16,priest,shadow,1,1,0
Weran,tichondrius,1890,rogue,outlaw,54,28,26
Millspec,tichondrius,1762,rogue,outlaw,117,58,59
Xylvána,kiljaeden,1697,rogue,outlaw,60,30,30
Dennerdz,tichondrius,1688,rogue,outlaw,47,19,28
Lycanthropî,illidan,1655,rogue,outlaw,80,37,43
Welinth,thunderlord,1646,rogue,outlaw,170,84,86
Lazeestab,sargeras,1630,rogue,outlaw,95,55,40
Supherr,sargeras,1616,rogue,outlaw,35,18,17
Jmaxx,tichondrius,1603,rogue,outlaw,45,29,16
Lardiconn,thrall,1600,rogue,outlaw,36,26,10
Gnøver,ragnaros,1585,rogue,outlaw,88,45,43
Yellowrose,kelthuzad,1564,rogue,outlaw,26,17,9
Trêl,velen,1534,rogue,outlaw,42,22,20
Mirâge,illidan,1533,rogue,outlaw,50,28,22
Karambit,frostmourne,1530,rogue,outlaw,66,28,38
Kentaki,tichondrius,1515,rogue,outlaw,60,33,27
Supine,illidan,1512,rogue,outlaw,97,51,46
Jolly,frostmourne,1440,rogue,outlaw,47,19,28
Gotosor,quelthalas,1427,rogue,outlaw,59,31,28
Sapsis,shandris,1409,rogue,outlaw,47,22,25
Shindeiru,area-52,1399,rogue,outlaw,43,30,13
Blackmont,bleeding-hollow,1379,rogue,outlaw,30,17,13
Combo,norgannon,1378,rogue,outlaw,24,18,6
Bleaklord,emerald-dream,1373,rogue,outlaw,48,17,31
Disrawen,ragnaros,1354,rogue,outlaw,144,65,79
Jakamungo,area-52,1315,rogue,outlaw,36,17,19
Hobblefoot,proudmoore,1300,rogue,outlaw,34,18,16
Wátchyoúrbák,wyrmrest-accord,1247,rogue,outlaw,30,14,16
Redimído,quelthalas,1244,rogue,outlaw,27,14,13
Fastblast,wyrmrest-accord,1146,rogue,outlaw,24,12,12
Johnnyelbows,tichondrius,1078,rogue,outlaw,27,13,14
Wujn,tichondrius,1050,rogue,outlaw,24,11,13
Lumifer,quelthalas,1050,rogue,outlaw,54,18,36
Azarha,zuljin,1035,rogue,outlaw,30,15,15
Farstrider,tichondrius,1029,rogue,outlaw,54,20,34
Zarthrox,bladefist,1027,rogue,outlaw,24,12,12
Thuganomics,dark-iron,1008,rogue,outlaw,27,12,15
Adevoir,hakkar,998,rogue,outlaw,30,13,17
Emoond,ragnaros,989,rogue,outlaw,27,13,14
Larmx,tichondrius,960,rogue,outlaw,24,10,14
Inhume,eredar,960,rogue,outlaw,24,10,14
Dvn,stormrage,959,rogue,outlaw,18,10,8
Quapi,tichondrius,959,rogue,outlaw,18,10,8
Dross,shadowmoon,958,rogue,outlaw,24,10,14
Itsuksiko,quelthalas,957,rogue,outlaw,16,11,5
Preceptor,azralon,956,rogue,outlaw,24,10,14
Ntrfighter,tichondrius,949,rogue,outlaw,24,10,14
Shninzy,senjin,910,rogue,outlaw,31,11,20
Jenaki,gurubashi,907,rogue,outlaw,23,10,13
Omnïslash,stormrage,863,rogue,outlaw,24,9,15
Stabbythorus,stormrage,862,rogue,outlaw,18,9,9
Bebesita,sisters-of-elune,860,rogue,outlaw,18,9,9
Mabushi,sargeras,853,rogue,outlaw,30,9,21
Phraze,silvermoon,840,rogue,outlaw,24,11,13
Coalie,tichondrius,816,rogue,outlaw,15,9,6
Deepsyo,frostmourne,768,rogue,outlaw,12,8,4
Houlton,moon-guard,767,rogue,outlaw,12,8,4
Slitherex,thunderlord,763,rogue,outlaw,21,9,12
Thompson,bloodscalp,672,rogue,outlaw,12,7,5
Sadiator,illidan,672,rogue,outlaw,12,7,5
Luolan,kargath,672,rogue,outlaw,30,7,23
Reyskywalker,kelthuzad,671,rogue,outlaw,12,7,5
Drsinz,tichondrius,671,rogue,outlaw,18,7,11
Evilkoreanz,tichondrius,670,rogue,outlaw,12,7,5
Cosmicò,trollbane,670,rogue,outlaw,12,7,5
Roxy,ghostlands,623,rogue,outlaw,17,7,10
Straite,area-52,576,rogue,outlaw,12,6,6
Snakeblisken,emerald-dream,576,rogue,outlaw,12,6,6
Esky,tichondrius,576,rogue,outlaw,12,6,6
Tarnished,ravenholdt,576,rogue,outlaw,12,6,6
Deeppockets,sargeras,576,rogue,outlaw,12,6,6
Xyleth,azgalor,575,rogue,outlaw,12,6,6
Mechamind,draka,574,rogue,outlaw,12,6,6
Deddyy,zuljin,574,rogue,outlaw,18,6,12
Marraya,area-52,573,rogue,outlaw,12,6,6
Bonizzi,stormrage,573,rogue,outlaw,12,6,6
Listrew,stormrage,571,rogue,outlaw,12,6,6
Maglove,nemesis,571,rogue,outlaw,12,6,6
Lesty,kelthuzad,480,rogue,outlaw,6,5,1
Càgil,stormrage,480,rogue,outlaw,6,5,1
Tsubamë,tichondrius,480,rogue,outlaw,6,5,1
Tmpikaboo,tichondrius,480,rogue,outlaw,6,5,1
Galfuran,burning-legion,480,rogue,outlaw,12,5,7
Spikiera,silvermoon,480,rogue,outlaw,18,5,13
Darthkelso,arathor,465,rogue,outlaw,24,5,19
Krypticstab,malganis,384,rogue,outlaw,6,4,2
Kents,tichondrius,384,rogue,outlaw,6,4,2
Alandoril,tichondrius,384,rogue,outlaw,6,4,2
Showclass,stormrage,384,rogue,outlaw,12,4,8
Earthinhorn,frostmourne,384,rogue,outlaw,12,4,8
Subnini,kelthuzad,384,rogue,outlaw,18,4,14
Gheez,quelthalas,383,rogue,outlaw,6,4,2
Katanië,moon-guard,383,rogue,outlaw,12,4,8
Houdinilogic,skullcrusher,381,rogue,outlaw,12,4,8
Fennick,tanaris,351,rogue,outlaw,11,4,7
Mgzx,tichondrius,288,rogue,outlaw,6,3,3
Homeschoolx,moon-guard,288,rogue,outlaw,6,3,3
Alexdelion,tichondrius,288,rogue,outlaw,6,3,3
Bootypie,hyjal,288,rogue,outlaw,6,3,3
Movze,area-52,288,rogue,outlaw,6,3,3
Karmagoodttv,stormrage,288,rogue,outlaw,6,3,3
Drakariano,ragnaros,288,rogue,outlaw,6,3,3
Hedillyan,azralon,288,rogue,outlaw,6,3,3
Drpibb,ghostlands,288,rogue,outlaw,12,3,9
Xzarfi,moon-guard,288,rogue,outlaw,18,3,15
Stabyou,sentinels,287,rogue,outlaw,6,3,3
Fryphilip,dalaran,256,rogue,outlaw,10,3,7
Hotboxthefox,illidan,253,rogue,outlaw,11,3,8
Prisonshank,arthas,192,rogue,outlaw,6,2,4
Zogbu,stormrage,192,rogue,outlaw,6,2,4
Touchthetip,bleeding-hollow,192,rogue,outlaw,6,2,4
Slobernocker,stormrage,192,rogue,outlaw,6,2,4
Blingtronx,malganis,192,rogue,outlaw,6,2,4
Jsyn,kiljaeden,192,rogue,outlaw,6,2,4
Asdestroyerr,tichondrius,192,rogue,outlaw,6,2,4
Mud,saurfang,192,rogue,outlaw,6,2,4
Sxs,kiljaeden,192,rogue,outlaw,6,2,4
Creamcakepop,stormrage,192,rogue,outlaw,6,2,4
Duskeron,cenarius,192,rogue,outlaw,6,2,4
Remonezero,moon-guard,192,rogue,outlaw,6,2,4
Badpatatas,proudmoore,192,rogue,outlaw,6,2,4
Òklahomie,frostwolf,191,rogue,outlaw,6,2,4
Grimthorn,icecrown,191,rogue,outlaw,6,2,4
Philliamson,azgalor,190,rogue,outlaw,12,2,10
Rinestiria,arthas,96,rogue,outlaw,6,1,5
Slowtime,quelthalas,96,rogue,outlaw,6,1,5
Xm,sargeras,96,rogue,outlaw,6,1,5
Downsix,sargeras,96,rogue,outlaw,6,1,5
Lu,lethon,96,rogue,outlaw,6,1,5
Sindor,azralon,96,rogue,outlaw,6,1,5
Neilyo,barthilas,96,rogue,outlaw,6,1,5
Happyslice,stormrage,96,rogue,outlaw,6,1,5
Cidi,moon-guard,96,rogue,outlaw,6,1,5
Hîzzÿ,ghostlands,96,rogue,outlaw,12,1,11
Culpera,undermine,95,rogue,outlaw,6,1,5
Ningaturtle,korgath,95,rogue,outlaw,6,1,5
Zelosse,area-52,16,rogue,outlaw,1,1,0
Battzii,wyrmrest-accord,2120,rogue,subtlety,280,148,132
Erebüs,thunderlord,2111,rogue,subtlety,60,41,19
Ymxxworld,tichondrius,1921,rogue,subtlety,66,32,34
Rangoons,tichondrius,1894,rogue,subtlety,60,36,24
Lies,dalaran,1881,rogue,subtlety,66,30,36
Alexdelion,tichondrius,1865,rogue,subtlety,60,31,29
Needbuff,tichondrius,1865,rogue,subtlety,54,25,29
Coopi,tichondrius,1853,rogue,subtlety,115,60,55
Himitu,tichondrius,1849,rogue,subtlety,89,46,43
Coregx,tichondrius,1842,rogue,subtlety,36,24,12
Stunsofpuns,sargeras,1833,rogue,subtlety,60,33,27
Maulline,tichondrius,1828,rogue,subtlety,42,20,22
Stealthypoop,kelthuzad,1825,rogue,subtlety,83,40,43
Smkgpvp,stormrage,1823,rogue,subtlety,68,43,25
Clern,emerald-dream,1818,rogue,subtlety,65,35,30
Celèphaïs,tichondrius,1817,rogue,subtlety,63,30,33
Scuffedjr,tichondrius,1782,rogue,subtlety,60,26,34
Silentkush,arthas,1774,rogue,subtlety,48,28,20
Gyokkó,sargeras,1770,rogue,subtlety,36,20,16
Zerogh,tichondrius,1765,rogue,subtlety,95,56,39
Danrathm,sargeras,1757,rogue,subtlety,61,30,31
Aaronjlol,tichondrius,1747,rogue,subtlety,36,23,13
Yesua,ragnaros,1743,rogue,subtlety,96,52,44
Díor,azralon,1735,rogue,subtlety,118,64,54
Ganknvanish,tichondrius,1723,rogue,subtlety,74,35,39
Dvin,stormrage,1700,rogue,subtlety,48,25,23
Brucerogue,tichondrius,1697,rogue,subtlety,107,56,51
Kellenx,moon-guard,1677,rogue,subtlety,82,38,44
Nicoaa,tichondrius,1668,rogue,subtlety,54,30,24
Jaos,tichondrius,1667,rogue,subtlety,42,22,20
Shinigâmì,tichondrius,1632,rogue,subtlety,42,30,12
Ulley,sargeras,1627,rogue,subtlety,66,33,33
Eekz,illidan,1609,rogue,subtlety,107,68,39
Pxb,sargeras,1609,rogue,subtlety,36,17,19
Poizzon,emerald-dream,1603,rogue,subtlety,35,21,14
Runakó,kelthuzad,1603,rogue,subtlety,48,21,27
Garrotte,tichondrius,1602,rogue,subtlety,51,22,29
Cut,ragnaros,1598,rogue,subtlety,36,20,16
Kalvish,dalaran,1597,rogue,subtlety,29,17,12
Assassìn,moon-guard,1584,rogue,subtlety,92,49,43
Îzu,ysera,1581,rogue,subtlety,45,25,20
Wowamaze,aegwynn,1579,rogue,subtlety,30,20,10
Bruítzy,barthilas,1572,rogue,subtlety,90,40,50
Norbury,tichondrius,1560,rogue,subtlety,35,17,18
Grelinho,stormrage,1554,rogue,subtlety,66,26,40
Furt,frostmourne,1537,rogue,subtlety,32,18,14
Steef,arygos,1532,rogue,subtlety,51,28,23
Fela,crushridge,1531,rogue,subtlety,120,61,59
Kenpàchi,kelthuzad,1527,rogue,subtlety,24,16,8
Zipperx,tichondrius,1507,rogue,subtlety,36,17,19
Illmatíc,kelthuzad,1502,rogue,subtlety,29,16,13
Preceptor,azralon,1499,rogue,subtlety,68,31,37
Galaxybrain,icecrown,1498,rogue,subtlety,120,76,44
Eekz,sargeras,1489,rogue,subtlety,44,20,24
Trizin,frostmourne,1477,rogue,subtlety,60,30,30
Mosedz,tichondrius,1474,rogue,subtlety,48,28,20
Bezeta,azralon,1471,rogue,subtlety,59,32,27
Greasybbsea,illidan,1458,rogue,subtlety,36,17,19
Scenna,stormrage,1457,rogue,subtlety,60,24,36
Turtlespeed,thrall,1451,rogue,subtlety,36,18,18
Sapyalater,thrall,1450,rogue,subtlety,66,38,28
Tulis,frostmourne,1448,rogue,subtlety,90,58,32
Lurios,rivendare,1446,rogue,subtlety,44,22,22
Epipenqt,dark-iron,1431,rogue,subtlety,42,26,16
Trucidovaco,daggerspine,1431,rogue,subtlety,36,16,20
Tarny,illidan,1431,rogue,subtlety,40,17,23
Kainm,stormrage,1427,rogue,subtlety,116,62,54
Bigpump,lothar,1426,rogue,subtlety,30,15,15
Luradfate,dalaran,1424,rogue,subtlety,82,44,38
Neuschurke,warsong,1422,rogue,subtlety,24,17,7
Quinity,wyrmrest-accord,1417,rogue,subtlety,61,32,29
Hunchó,area-52,1415,rogue,subtlety,36,23,13
Fulkrem,wyrmrest-accord,1410,rogue,subtlety,74,34,40
Narcoleptic,dalaran,1394,rogue,subtlety,54,26,28
Åer,dalaran,1393,rogue,subtlety,47,20,27
Sgtbuttfat,dalaran,1385,rogue,subtlety,41,20,21
Secrettecbot,barthilas,1379,rogue,subtlety,24,15,9
Mistnazgul,quelthalas,1365,rogue,subtlety,47,28,19
Ironfistofcn,tichondrius,1364,rogue,subtlety,60,32,28
Odelöt,drakkari,1359,rogue,subtlety,36,22,14
Deadguys,tichondrius,1356,rogue,subtlety,36,16,20
Spacebase,illidan,1337,rogue,subtlety,24,14,10
Sapùwú,stormrage,1327,rogue,subtlety,36,19,17
Chãlons,tichondrius,1327,rogue,subtlety,54,23,31
Killmebaby,lightnings-blade,1322,rogue,subtlety,24,14,10
Raymga,tichondrius,1320,rogue,subtlety,30,19,11
Xleo,drakkari,1315,rogue,subtlety,42,16,26
Rougething,bleeding-hollow,1313,rogue,subtlety,30,14,16
Lisnp,tichondrius,1306,rogue,subtlety,176,83,93
Cv,proudmoore,1304,rogue,subtlety,24,14,10
Lagault,muradin,1300,rogue,subtlety,24,16,8
Pocketman,barthilas,1299,rogue,subtlety,59,24,35
Abacura,moon-guard,1292,rogue,subtlety,36,20,16
Speedboi,skullcrusher,1285,rogue,subtlety,45,29,16
Ikmagine,icecrown,1281,rogue,subtlety,42,17,25
Täy,thrall,1280,rogue,subtlety,47,23,24
Hollfex,nemesis,1265,rogue,subtlety,38,19,19
Gothblade,malganis,1258,rogue,subtlety,30,15,15
Gyrfalcon,spirestone,1255,rogue,subtlety,89,43,46
Lilstab,hakkar,1249,rogue,subtlety,92,46,46
Wazowskiy,tichondrius,1246,rogue,subtlety,36,13,23
Endlesswaltz,zuljin,1243,rogue,subtlety,30,13,17
Prrey,hydraxis,1242,rogue,subtlety,30,13,17
Bobsaget,kiljaeden,1239,rogue,subtlety,30,13,17
Hotcarl,kiljaeden,1227,rogue,subtlety,24,13,11
Klâng,tichondrius,1222,rogue,subtlety,30,13,17
Trâshy,stormrage,1215,rogue,subtlety,25,14,11
Mirajoo,tichondrius,1199,rogue,subtlety,34,15,19
Arbitér,moonrunner,1191,rogue,subtlety,58,20,38
Kylerxius,korgath,1190,rogue,subtlety,30,18,12
Roxeni,tichondrius,1181,rogue,subtlety,28,13,15
Vyrenn,destromath,1177,rogue,subtlety,29,13,16
Lyfallah,proudmoore,1173,rogue,subtlety,58,28,30
Paulpitation,blood-furnace,1155,rogue,subtlety,39,15,24
Mitsurí,sargeras,1152,rogue,subtlety,18,12,6
Slashthunder,blades-edge,1152,rogue,subtlety,18,12,6
Bèstworld,dalaran,1152,rogue,subtlety,24,12,12
Wizlysnipz,tichondrius,1151,rogue,subtlety,18,12,6
Itskanashi,frostmourne,1151,rogue,subtlety,45,18,27
Kaylyth,whisperwind,1151,rogue,subtlety,30,12,18
Stealthyxd,arthas,1150,rogue,subtlety,36,12,24
Dysxliec,dalaran,1149,rogue,subtlety,24,12,12
Sahima,tichondrius,1149,rogue,subtlety,57,27,30
Axtually,proudmoore,1146,rogue,subtlety,24,12,12
Smormu,bonechewer,1144,rogue,subtlety,24,12,12
Oilydaimon,tichondrius,1143,rogue,subtlety,49,23,26
Camlaw,area-52,1140,rogue,subtlety,24,12,12
Abogansterr,ragnaros,1129,rogue,subtlety,48,26,22
Hypermix,tichondrius,1129,rogue,subtlety,24,12,12
Poohpants,frostmourne,1125,rogue,subtlety,48,21,27
Cutthroat,aegwynn,1121,rogue,subtlety,45,20,25
Imgunnacrumb,malganis,1119,rogue,subtlety,30,13,17
Guiguzidr,illidan,1099,rogue,subtlety,36,16,20
Prisonshank,arthas,1093,rogue,subtlety,61,36,25
Jaanmonty,frostmourne,1081,rogue,subtlety,24,12,12
Jeri,gundrak,1070,rogue,subtlety,24,13,11
Sixcombopts,area-52,1056,rogue,subtlety,18,11,7
Onîkudaki,sargeras,1056,rogue,subtlety,24,11,13
Esmeraldas,frostmourne,1054,rogue,subtlety,18,11,7
Haiev,tichondrius,1054,rogue,subtlety,24,11,13
Gankolicious,nerzhul,1053,rogue,subtlety,12,11,1
Wetit,illidan,1053,rogue,subtlety,18,11,7
Corntens,area-52,1050,rogue,subtlety,20,11,9
Négrá,ragnaros,1048,rogue,subtlety,18,11,7
Ðarkrøøxs,stormrage,1048,rogue,subtlety,24,11,13
Laotrec,nemesis,1045,rogue,subtlety,33,12,21
Olg,arathor,1043,rogue,subtlety,71,36,35
Santyno,ragnaros,1041,rogue,subtlety,24,12,12
Soulvex,barthilas,1040,rogue,subtlety,18,11,7
Abaløne,tichondrius,1037,rogue,subtlety,55,22,33
Kaminokage,barthilas,1035,rogue,subtlety,33,12,21
Vanishman,ragnaros,1026,rogue,subtlety,18,11,7
Doklim,spinebreaker,1022,rogue,subtlety,46,26,20
Relidria,thrall,1011,rogue,subtlety,25,16,9
Korviz,area-52,1008,rogue,subtlety,60,30,30
Bloodwish,tichondrius,1007,rogue,subtlety,23,11,12
Liryth,lightninghoof,1005,rogue,subtlety,21,12,9
Kawagreen,tichondrius,990,rogue,subtlety,21,11,10
Hyperdexia,stormrage,987,rogue,subtlety,82,42,40
Bubblesr,whisperwind,980,rogue,subtlety,48,22,26
Shellby,tichondrius,977,rogue,subtlety,26,13,13
Ascherx,veknilash,960,rogue,subtlety,12,10,2
Fátálíty,tichondrius,960,rogue,subtlety,18,10,8
Kidcutti,proudmoore,960,rogue,subtlety,18,10,8
Eazyg,tichondrius,959,rogue,subtlety,18,10,8
Spaca,kelthuzad,959,rogue,subtlety,18,10,8
Rabe,nagrand,959,rogue,subtlety,18,10,8
Blakezilla,tichondrius,958,rogue,subtlety,18,10,8
Lucki,tichondrius,958,rogue,subtlety,18,10,8
Harkknight,sargeras,958,rogue,subtlety,86,44,42
Lululee,tichondrius,958,rogue,subtlety,30,10,20
Aszombie,tichondrius,957,rogue,subtlety,12,10,2
Tapwaterx,illidan,957,rogue,subtlety,24,10,14
Jadier,emerald-dream,955,rogue,subtlety,18,10,8
Kinbaal,bleeding-hollow,955,rogue,subtlety,18,10,8
Kolander,tichondrius,953,rogue,subtlety,21,11,10
Swanl,stormrage,953,rogue,subtlety,24,10,14
Elßronkas,quelthalas,915,rogue,subtlety,18,10,8
Kachimodo,illidan,896,rogue,subtlety,24,10,14
Meer,balnazzar,865,rogue,subtlety,16,11,5
Bimbogirl,dalaran,865,rogue,subtlety,22,11,11
Tmpikaboo,tichondrius,864,rogue,subtlety,12,9,3
Roguesparrow,illidan,864,rogue,subtlety,18,9,9
Illoo,frostmourne,863,rogue,subtlety,18,9,9
Proddivus,stormrage,863,rogue,subtlety,30,9,21
Neilyo,barthilas,862,rogue,subtlety,18,9,9
Vanvanlords,azralon,862,rogue,subtlety,24,9,15
Emrogr,tichondrius,860,rogue,subtlety,18,9,9
Lesliechow,sargeras,859,rogue,subtlety,22,12,10
Overzz,azralon,859,rogue,subtlety,21,9,12
Jhors,tichondrius,856,rogue,subtlety,18,9,9
Variat,azralon,855,rogue,subtlety,24,9,15
Esker,dragonmaw,854,rogue,subtlety,18,9,9
Suñg,tichondrius,854,rogue,subtlety,24,9,15
Cahlee,sargeras,847,rogue,subtlety,23,10,13
Cutindle,illidan,842,rogue,subtlety,18,9,9
Skallywagg,emerald-dream,842,rogue,subtlety,18,9,9
Nadari,cenarius,837,rogue,subtlety,24,9,15
Flashmob,zuljin,831,rogue,subtlety,20,10,10
Worrglaive,dalaran,814,rogue,subtlety,11,9,2
Fearnomore,destromath,810,rogue,subtlety,30,12,18
Stabem,moon-guard,768,rogue,subtlety,12,8,4
Ojibwe,tichondrius,768,rogue,subtlety,12,8,4
Ozzinton,kelthuzad,768,rogue,subtlety,12,8,4
Czd,frostmourne,768,rogue,subtlety,12,8,4
Originalfake,sargeras,768,rogue,subtlety,12,8,4
Köfy,quelthalas,768,rogue,subtlety,17,8,9
Saltypwncake,illidan,768,rogue,subtlety,18,8,10
Ilesire,frostmourne,767,rogue,subtlety,18,8,10
Usernameqtxo,kelthuzad,767,rogue,subtlety,18,8,10
Reclusivexo,tichondrius,767,rogue,subtlety,18,8,10
Errorless,moon-guard,767,rogue,subtlety,18,8,10
Eraticrogue,illidan,767,rogue,subtlety,18,8,10
Razmir,malfurion,766,rogue,subtlety,18,8,10
Yato,mugthol,764,rogue,subtlety,12,8,4
Mcromance,khadgar,764,rogue,subtlety,24,8,16
Riskgo,frostwolf,759,rogue,subtlety,18,8,10
Draculà,wyrmrest-accord,758,rogue,subtlety,18,8,10
Alexon,wyrmrest-accord,749,rogue,subtlety,42,15,27
Arakine,uldaman,748,rogue,subtlety,15,9,6
Humphugull,skullcrusher,735,rogue,subtlety,17,8,9
Venace,agamaggan,733,rogue,subtlety,17,8,9
Bladefang,quelthalas,732,rogue,subtlety,17,10,7
Drsinz,tichondrius,729,rogue,subtlety,26,10,16
Slackness,bleeding-hollow,725,rogue,subtlety,18,9,9
Ikerz,tichondrius,719,rogue,subtlety,15,8,7
Kerimoynihan,barthilas,695,rogue,subtlety,24,8,16
Joeyzord,stormrage,672,rogue,subtlety,12,7,5
Rõý,area-52,672,rogue,subtlety,12,7,5
Frooty,stormrage,672,rogue,subtlety,12,7,5
Bobfoonk,tichondrius,672,rogue,subtlety,12,7,5
Àsgà,area-52,672,rogue,subtlety,12,7,5
Axerax,draka,672,rogue,subtlety,12,7,5
Clicksbtns,area-52,672,rogue,subtlety,18,7,11
Memoríst,frostmourne,672,rogue,subtlety,18,7,11
Niwbor,azralon,672,rogue,subtlety,24,7,17
Toxsith,tichondrius,671,rogue,subtlety,12,7,5
Keepitshadow,frostmourne,671,rogue,subtlety,12,7,5
Pichichi,frostmourne,671,rogue,subtlety,12,7,5
Murked,barthilas,671,rogue,subtlety,12,7,5
Christiaan,area-52,671,rogue,subtlety,12,7,5
Gannjalord,frostmane,671,rogue,subtlety,18,7,11
Nezumikami,malganis,671,rogue,subtlety,18,7,11
Søprøle,ragnaros,670,rogue,subtlety,12,7,5
Pleodonis,tichondrius,670,rogue,subtlety,24,7,17
Rykojin,sargeras,669,rogue,subtlety,12,7,5
Anteccessor,tichondrius,669,rogue,subtlety,18,7,11
Jagó,malganis,667,rogue,subtlety,12,7,5
Chompycat,tichondrius,667,rogue,subtlety,18,7,11
Kody,dalaran,639,rogue,subtlety,17,7,10
Lilshanker,tichondrius,617,rogue,subtlety,22,8,14
Feragho,tichondrius,608,rogue,subtlety,22,7,15
Revelationzz,turalyon,607,rogue,subtlety,11,7,4
Deadshank,bleeding-hollow,576,rogue,subtlety,6,6,0
Gptcodeplay,tichondrius,576,rogue,subtlety,6,6,0
Homarx,quelthalas,576,rogue,subtlety,10,7,3
Ajl,drenden,576,rogue,subtlety,12,6,6
Tmpikaboo,mugthol,576,rogue,subtlety,12,6,6
Jannie,rexxar,576,rogue,subtlety,12,6,6
Unholydood,bonechewer,576,rogue,subtlety,12,6,6
Vlone,icecrown,576,rogue,subtlety,12,6,6
Palumor,deathwing,576,rogue,subtlety,12,6,6
Turec,illidan,576,rogue,subtlety,12,6,6
Håkünämãtåtä,stormrage,576,rogue,subtlety,12,6,6
Rufian,ursin,576,rogue,subtlety,12,6,6
Kindasorry,illidan,576,rogue,subtlety,12,6,6
Fkq,emerald-dream,576,rogue,subtlety,12,6,6
Xedi,illidan,576,rogue,subtlety,12,6,6
Drakariano,ragnaros,576,rogue,subtlety,18,6,12
Swippz,tichondrius,576,rogue,subtlety,18,6,12
Jácket,area-52,576,rogue,subtlety,24,6,18
Maulgryve,frostwolf,575,rogue,subtlety,12,6,6
Thugspice,stormrage,575,rogue,subtlety,12,6,6
Calvin,moon-guard,575,rogue,subtlety,12,6,6
Gank,jubeithos,575,rogue,subtlety,12,6,6
Jinxkiller,tichondrius,575,rogue,subtlety,12,6,6
Threeplates,silvermoon,575,rogue,subtlety,18,6,12
Zogbu,stormrage,575,rogue,subtlety,18,6,12
Alttee,proudmoore,573,rogue,subtlety,12,6,6
Xylow,garona,571,rogue,subtlety,27,6,21
Degrok,quelthalas,568,rogue,subtlety,12,6,6
Eridian,tichondrius,522,rogue,subtlety,19,7,12
Hahaurblind,perenolde,511,rogue,subtlety,16,6,10
Ghoarie,sargeras,480,rogue,subtlety,6,5,1
Dionavelynn,area-52,480,rogue,subtlety,6,5,1
Idsapdat,illidan,480,rogue,subtlety,6,5,1
Wimpz,hyjal,480,rogue,subtlety,6,5,1
Xandroesh,darkspear,480,rogue,subtlety,12,5,7
Blinky,blades-edge,480,rogue,subtlety,12,5,7
Kibbs,korgath,480,rogue,subtlety,12,5,7
Brilliance,skywall,480,rogue,subtlety,12,5,7
Jon,the-venture-co,480,rogue,subtlety,12,5,7
Taidath,area-52,480,rogue,subtlety,12,5,7
Cinnashank,darkspear,480,rogue,subtlety,12,5,7
Defthands,tichondrius,480,rogue,subtlety,12,5,7
Pjh,sargeras,480,rogue,subtlety,12,5,7
Monkeykongr,lightnings-blade,480,rogue,subtlety,12,5,7
Scrubzz,barthilas,480,rogue,subtlety,12,5,7
Uchihaputin,tichondrius,480,rogue,subtlety,12,5,7
Dreamcatcher,azralon,480,rogue,subtlety,12,5,7
Orihimesz,azralon,480,rogue,subtlety,12,5,7
Liqwid,stormrage,480,rogue,subtlety,12,5,7
Twnice,tichondrius,480,rogue,subtlety,12,5,7
Henya,magtheridon,480,rogue,subtlety,12,5,7
Killdrunk,stormrage,480,rogue,subtlety,12,5,7
Tiladar,tichondrius,480,rogue,subtlety,12,5,7
Wowcode,tichondrius,480,rogue,subtlety,12,5,7
Faelanna,stormrage,480,rogue,subtlety,13,5,8
Greasymario,kelthuzad,480,rogue,subtlety,18,5,13
Psychostabby,tichondrius,480,rogue,subtlety,18,5,13
Zitihait,amanthul,479,rogue,subtlety,6,5,1
Qlog,tichondrius,479,rogue,subtlety,12,5,7
Catoline,bleeding-hollow,479,rogue,subtlety,12,5,7
Khorgan,mugthol,479,rogue,subtlety,18,5,13
Silentmoralz,tichondrius,479,rogue,subtlety,23,5,18
Dessenia,illidan,478,rogue,subtlety,8,5,3
Shadownibba,illidan,478,rogue,subtlety,12,5,7
Mhasto,azralon,478,rogue,subtlety,12,5,7
Indivisible,thunderlord,477,rogue,subtlety,12,5,7
Nijanari,wyrmrest-accord,477,rogue,subtlety,18,5,13
Liamoz,amanthul,475,rogue,subtlety,12,5,7
Backtoch,sargeras,447,rogue,subtlety,11,5,6
Sketchyweas,sargeras,426,rogue,subtlety,14,6,8
Cayladin,tichondrius,416,rogue,subtlety,10,5,5
Bloodyhairy,area-52,384,rogue,subtlety,6,4,2
Frusciante,nemesis,384,rogue,subtlety,6,4,2
Bootimus,illidan,384,rogue,subtlety,6,4,2
Donpeon,hellscream,384,rogue,subtlety,6,4,2
Siyeong,tichondrius,384,rogue,subtlety,6,4,2
Wrldstars,illidan,384,rogue,subtlety,6,4,2
Deadopps,stormrage,384,rogue,subtlety,6,4,2
Genève,dreadmaul,384,rogue,subtlety,6,4,2
Klawz,norgannon,384,rogue,subtlety,6,4,2
Acid,warsong,384,rogue,subtlety,6,4,2
Nightcloud,tichondrius,384,rogue,subtlety,6,4,2
Aelnoor,ragnaros,384,rogue,subtlety,6,4,2
Thèllè,sargeras,384,rogue,subtlety,6,4,2
Chauva,zuljin,384,rogue,subtlety,6,4,2
Unoshade,illidan,384,rogue,subtlety,6,4,2
Pwnsauce,frostmourne,384,rogue,subtlety,6,4,2
Unshut,tichondrius,384,rogue,subtlety,6,4,2
Seerenai,moon-guard,384,rogue,subtlety,6,4,2
Foreverioi,tichondrius,384,rogue,subtlety,6,4,2
Coldkill,bleeding-hollow,384,rogue,subtlety,6,4,2
Roguetrix,stormrage,384,rogue,subtlety,6,4,2
Memnõch,emerald-dream,384,rogue,subtlety,6,4,2
Xemnxnt,stormrage,384,rogue,subtlety,6,4,2
Flankks,sargeras,384,rogue,subtlety,12,4,8
Kyubïx,ragnaros,384,rogue,subtlety,12,4,8
Ntshaav,illidan,384,rogue,subtlety,12,4,8
Takamoto,windrunner,384,rogue,subtlety,12,4,8
Tàlion,emerald-dream,384,rogue,subtlety,12,4,8
Muggzy,emerald-dream,384,rogue,subtlety,12,4,8
Mercaderps,frostmourne,384,rogue,subtlety,12,4,8
Elishadowed,proudmoore,384,rogue,subtlety,12,4,8
Zzffqsm,tichondrius,384,rogue,subtlety,12,4,8
Seutobinhaa,stormrage,384,rogue,subtlety,12,4,8
Morpheûs,tichondrius,384,rogue,subtlety,12,4,8
ßaltø,bleeding-hollow,384,rogue,subtlety,12,4,8
Miamiganster,lothar,384,rogue,subtlety,12,4,8
Xiaozhi,tichondrius,384,rogue,subtlety,12,4,8
Lazaruslong,stormrage,384,rogue,subtlety,12,4,8
Zamji,tichondrius,383,rogue,subtlety,6,4,2
Swayo,tichondrius,383,rogue,subtlety,6,4,2
Ràinê,dalaran,383,rogue,subtlety,12,4,8
Hènnéssy,frostmourne,383,rogue,subtlety,12,4,8
Maewyn,aerie-peak,383,rogue,subtlety,13,4,9
Shadowpunx,nemesis,382,rogue,subtlety,6,4,2
Knife,moon-guard,381,rogue,subtlety,12,4,8
Samuraii,zuljin,335,rogue,subtlety,11,4,7
Peeryl,daggerspine,327,rogue,subtlety,15,5,10
Rawdawged,illidan,320,rogue,subtlety,16,4,12
Blakezillax,tichondrius,288,rogue,subtlety,6,3,3
Reverel,tichondrius,288,rogue,subtlety,6,3,3
Sinfate,bleeding-hollow,288,rogue,subtlety,6,3,3
Shreddér,tichondrius,288,rogue,subtlety,6,3,3
Commodore,arthas,288,rogue,subtlety,6,3,3
Anbuartist,dalaran,288,rogue,subtlety,6,3,3
Topfloorboss,illidan,288,rogue,subtlety,6,3,3
Dìngapoof,tichondrius,288,rogue,subtlety,6,3,3
Junemylove,tichondrius,288,rogue,subtlety,6,3,3
Stealthkid,tichondrius,288,rogue,subtlety,6,3,3
Kazzo,tichondrius,288,rogue,subtlety,6,3,3
Isonlydosex,tichondrius,288,rogue,subtlety,6,3,3
Amatoxin,tichondrius,288,rogue,subtlety,6,3,3
Leftyleaf,proudmoore,288,rogue,subtlety,6,3,3
Zarrth,malganis,288,rogue,subtlety,6,3,3
Lxw,frostmourne,288,rogue,subtlety,6,3,3
Corrier,tichondrius,288,rogue,subtlety,6,3,3
Shadxr,tichondrius,288,rogue,subtlety,6,3,3
Whothekilla,tichondrius,288,rogue,subtlety,6,3,3
Støné,azjolnerub,288,rogue,subtlety,6,3,3
Lesty,kelthuzad,288,rogue,subtlety,6,3,3
Gåñðøñ,stormscale,288,rogue,subtlety,6,3,3
Sit,frostwolf,288,rogue,subtlety,6,3,3
Castsequence,khaz-modan,288,rogue,subtlety,6,3,3
Roguish,kiljaeden,288,rogue,subtlety,6,3,3
Noxik,blackrock,288,rogue,subtlety,6,3,3
Mhün,malganis,288,rogue,subtlety,6,3,3
Shadowreapz,barthilas,288,rogue,subtlety,6,3,3
Înfêrnô,emerald-dream,288,rogue,subtlety,6,3,3
Ralæriel,wyrmrest-accord,288,rogue,subtlety,6,3,3
Cron,arygos,288,rogue,subtlety,6,3,3
Darkìs,tichondrius,288,rogue,subtlety,6,3,3
Cydonian,ragnaros,288,rogue,subtlety,6,3,3
Micromoon,windrunner,288,rogue,subtlety,6,3,3
Dödoubleg,stormrage,288,rogue,subtlety,6,3,3
Luriél,stormrage,288,rogue,subtlety,6,3,3
Draiygo,nerzhul,288,rogue,subtlety,6,3,3
Mcnastier,dunemaul,288,rogue,subtlety,6,3,3
Hemorrhages,tichondrius,288,rogue,subtlety,6,3,3
Ãnimefãnx,moon-guard,288,rogue,subtlety,6,3,3
Antijax,stormrage,288,rogue,subtlety,6,3,3
Snackable,tichondrius,288,rogue,subtlety,6,3,3
Xvds,tichondrius,288,rogue,subtlety,6,3,3
Arwy,stormrage,288,rogue,subtlety,6,3,3
Taraminkadot,sargeras,288,rogue,subtlety,9,4,5
ßutthead,malganis,288,rogue,subtlety,7,3,4
Struggle,sargeras,288,rogue,subtlety,12,3,9
Ideology,azgalor,288,rogue,subtlety,12,3,9
Hogstradamus,malganis,288,rogue,subtlety,12,3,9
Miloandotis,malganis,288,rogue,subtlety,12,3,9
Grinz,sargeras,288,rogue,subtlety,12,3,9
Veatrix,zuljin,288,rogue,subtlety,12,3,9
Moufwash,sargeras,288,rogue,subtlety,12,3,9
Kekdasneak,dragonmaw,288,rogue,subtlety,12,3,9
Carpe,barthilas,288,rogue,subtlety,12,3,9
Maløkeirø,stormrage,288,rogue,subtlety,12,3,9
Relaxsingh,tichondrius,288,rogue,subtlety,18,3,15
Witherblade,area-52,287,rogue,subtlety,6,3,3
Framsteg,kelthuzad,287,rogue,subtlety,6,3,3
Toe,boulderfist,287,rogue,subtlety,6,3,3
Cerebrian,malygos,286,rogue,subtlety,6,3,3
Youngdraco,tichondrius,239,rogue,subtlety,5,3,2
Jalaroot,frostmourne,234,rogue,subtlety,11,5,6
Radagon,fenris,234,rogue,subtlety,9,4,5
Gnøver,ragnaros,192,rogue,subtlety,6,2,4
Srmazakre,ragnaros,192,rogue,subtlety,6,2,4
Åaron,thrall,192,rogue,subtlety,6,2,4
Xyltann,bleeding-hollow,192,rogue,subtlety,6,2,4
Icantsleep,tichondrius,192,rogue,subtlety,6,2,4
Tìlt,whisperwind,192,rogue,subtlety,6,2,4
Nemoye,tichondrius,192,rogue,subtlety,6,2,4
Tootsio,tichondrius,192,rogue,subtlety,6,2,4
Elvesnknives,stormrage,192,rogue,subtlety,6,2,4
Chimpo,ravencrest,192,rogue,subtlety,6,2,4
Pikabuu,bleeding-hollow,192,rogue,subtlety,6,2,4
Terrorstrike,tichondrius,192,rogue,subtlety,6,2,4
Meadview,bleeding-hollow,192,rogue,subtlety,6,2,4
Weenies,illidan,192,rogue,subtlety,6,2,4
Jexy,barthilas,192,rogue,subtlety,6,2,4
Nlynn,veknilash,192,rogue,subtlety,6,2,4
Pootymunchin,daggerspine,192,rogue,subtlety,6,2,4
Jsnlol,zuljin,192,rogue,subtlety,6,2,4
Teribád,area-52,192,rogue,subtlety,6,2,4
Grinjuk,area-52,192,rogue,subtlety,6,2,4
Noriel,dathremar,192,rogue,subtlety,6,2,4
Slycndice,tortheldrin,192,rogue,subtlety,6,2,4
Rigotak,illidan,192,rogue,subtlety,6,2,4
Söda,emerald-dream,192,rogue,subtlety,6,2,4
Jujudaddy,darkspear,192,rogue,subtlety,6,2,4
Stanley,mugthol,192,rogue,subtlety,6,2,4
Atulano,wyrmrest-accord,192,rogue,subtlety,6,2,4
Runescape,frostmourne,192,rogue,subtlety,6,2,4
Fofree,hyjal,192,rogue,subtlety,6,2,4
Skitsöu,tichondrius,192,rogue,subtlety,6,2,4
Ghost,shattered-halls,192,rogue,subtlety,6,2,4
Coalie,tichondrius,192,rogue,subtlety,6,2,4
Sapsis,shandris,192,rogue,subtlety,6,2,4
Tothegravetv,sargeras,192,rogue,subtlety,6,2,4
Jâm,nerzhul,192,rogue,subtlety,6,2,4
Zelthy,frostmourne,192,rogue,subtlety,6,2,4
Picaropanda,quelthalas,192,rogue,subtlety,6,2,4
Draef,illidan,192,rogue,subtlety,6,2,4
Slíçk,tichondrius,192,rogue,subtlety,6,2,4
Nubes,illidan,192,rogue,subtlety,6,2,4
Krolczz,tichondrius,192,rogue,subtlety,6,2,4
Falra,wyrmrest-accord,192,rogue,subtlety,6,2,4
Lenik,azuremyst,192,rogue,subtlety,6,2,4
Brustent,icecrown,192,rogue,subtlety,6,2,4
Grue,gundrak,192,rogue,subtlety,6,2,4
Surplus,stormscale,192,rogue,subtlety,6,2,4
Kami,kelthuzad,192,rogue,subtlety,6,2,4
Jeezy,shadowmoon,192,rogue,subtlety,6,2,4
Reflexiv,malganis,192,rogue,subtlety,6,2,4
Joegamer,sargeras,192,rogue,subtlety,6,2,4
Chêckmatê,darkspear,192,rogue,subtlety,6,2,4
Wètdream,sargeras,192,rogue,subtlety,6,2,4
Macklittle,area-52,192,rogue,subtlety,6,2,4
Skorsh,wyrmrest-accord,192,rogue,subtlety,6,2,4
Getfkdkid,tichondrius,192,rogue,subtlety,6,2,4
Toxiccarnage,ghostlands,192,rogue,subtlety,8,2,6
Bâerâ,bloodscalp,192,rogue,subtlety,8,2,6
Kidcudi,bonechewer,192,rogue,subtlety,12,2,10
Flèè,illidan,192,rogue,subtlety,12,2,10
Brickjohnson,illidan,192,rogue,subtlety,12,2,10
Reinaldojr,azralon,192,rogue,subtlety,12,2,10
Onulyo,tichondrius,192,rogue,subtlety,12,2,10
Greyyfox,illidan,192,rogue,subtlety,12,2,10
Kilrogga,azshara,191,rogue,subtlety,6,2,4
Allirra,ragnaros,191,rogue,subtlety,6,2,4
Lancarlorïus,ragnaros,191,rogue,subtlety,6,2,4
Confianzudo,ragnaros,191,rogue,subtlety,6,2,4
Tareduwu,area-52,191,rogue,subtlety,12,2,10
Koobbo,tichondrius,159,rogue,subtlety,5,2,3
Eliasael,moon-guard,159,rogue,subtlety,5,2,3
Suhwooh,area-52,159,rogue,subtlety,5,2,3
Opensap,tichondrius,159,rogue,subtlety,5,2,3
Ganksterqt,dentarg,138,rogue,subtlety,10,3,7
Cheapdeal,frostmourne,128,rogue,subtlety,4,2,2
Fadedx,darkspear,128,rogue,subtlety,4,2,2
Mdrogue,sargeras,128,rogue,subtlety,4,2,2
Swickwockdus,azralon,112,rogue,subtlety,7,2,5
Amonn,arthas,96,rogue,subtlety,3,2,1
Tamsy,the-forgotten-coast,96,rogue,subtlety,3,2,1
Slobernocker,stormrage,96,rogue,subtlety,6,1,5
Hiarolson,stormrage,96,rogue,subtlety,6,1,5
Røgüë,malganis,96,rogue,subtlety,6,1,5
Originkorean,terenas,96,rogue,subtlety,6,1,5
Satanicrizz,tichondrius,96,rogue,subtlety,6,1,5
Nevatell,malganis,96,rogue,subtlety,6,1,5
Steffmaister,tichondrius,96,rogue,subtlety,6,1,5
Frootylol,stormrage,96,rogue,subtlety,6,1,5
Docheatt,dalaran,96,rogue,subtlety,6,1,5
Quackerjacks,lightnings-blade,96,rogue,subtlety,6,1,5
Toodlles,stormrage,96,rogue,subtlety,6,1,5
Bonizzi,stormrage,96,rogue,subtlety,6,1,5
Milafortnite,tichondrius,96,rogue,subtlety,6,1,5
Illidin,executus,96,rogue,subtlety,6,1,5
Shivlightnin,tichondrius,96,rogue,subtlety,6,1,5
Twotimed,magtheridon,96,rogue,subtlety,6,1,5
Jokerr,proudmoore,96,rogue,subtlety,6,1,5
Dabrat,frostwolf,96,rogue,subtlety,6,1,5
Zapersapp,malygos,96,rogue,subtlety,6,1,5
Ballflicker,malganis,96,rogue,subtlety,6,1,5
Kestor,barthilas,96,rogue,subtlety,6,1,5
Dedrater,shadowmoon,96,rogue,subtlety,6,1,5
Twinkrogue,firetree,96,rogue,subtlety,6,1,5
Valekk,stormscale,96,rogue,subtlety,6,1,5
Trinktick,doomhammer,96,rogue,subtlety,6,1,5
Ivanapavlov,kelthuzad,96,rogue,subtlety,6,1,5
Vex,durotan,96,rogue,subtlety,6,1,5
Sxs,kiljaeden,96,rogue,subtlety,6,1,5
Sawred,bonechewer,96,rogue,subtlety,6,1,5
Ricros,bleeding-hollow,89,rogue,subtlety,8,3,5
Drpibb,ghostlands,63,rogue,subtlety,2,2,0
Sabedoria,barthilas,42,rogue,subtlety,10,2,8
Thenelis,dalaran,42,rogue,subtlety,11,2,9
Traumashears,proudmoore,31,rogue,subtlety,2,1,1
Sllabymkcus,sargeras,2126,rogue,assassination,72,37,35
Mirrorx,tichondrius,2024,rogue,assassination,66,34,32
Larmx,tichondrius,1960,rogue,assassination,60,30,30
Zarkk,kelthuzad,1929,rogue,assassination,83,36,47
Snortedgfuel,drenden,1871,rogue,assassination,48,23,25
Lemon,arygos,1851,rogue,assassination,47,20,27
Poonanixo,frostmourne,1846,rogue,assassination,78,38,40
Bloodlessftw,azralon,1840,rogue,assassination,51,24,27
Alethal,tichondrius,1838,rogue,assassination,54,31,23
Jon,the-venture-co,1838,rogue,assassination,54,27,27
Sio,bleeding-hollow,1837,rogue,assassination,60,30,30
Ajúmma,tichondrius,1831,rogue,assassination,57,23,34
Xiaochulol,tichondrius,1808,rogue,assassination,36,19,17
Sairak,tichondrius,1803,rogue,assassination,89,43,46
Plumblossomx,tichondrius,1771,rogue,assassination,42,19,23
Ybby,tichondrius,1714,rogue,assassination,68,34,34
Feinting,moon-guard,1700,rogue,assassination,58,26,32
Niarzz,tichondrius,1692,rogue,assassination,48,28,20
Bellamor,tichondrius,1690,rogue,assassination,78,47,31
Vmoney,draenor,1685,rogue,assassination,30,18,12
Whooxx,khazgoroth,1673,rogue,assassination,66,29,37
Doraz,tichondrius,1670,rogue,assassination,54,28,26
Johnnycryp,barthilas,1650,rogue,assassination,41,21,20
Ivanrah,zuljin,1648,rogue,assassination,45,20,25
Chêckmatê,darkspear,1645,rogue,assassination,48,24,24
Gyutaro,black-dragonflight,1642,rogue,assassination,162,84,78
Rapcher,illidan,1632,rogue,assassination,148,75,73
Osuba,proudmoore,1604,rogue,assassination,60,27,33
Vél,blackrock,1600,rogue,assassination,30,17,13
Sheerlol,stormrage,1596,rogue,assassination,41,20,21
Josex,lightbringer,1589,rogue,assassination,42,17,25
Assassìn,moon-guard,1588,rogue,assassination,30,18,12
Devstrike,sargeras,1587,rogue,assassination,53,25,28
Sparqxx,tichondrius,1583,rogue,assassination,158,79,79
Miamiganster,lothar,1580,rogue,assassination,114,52,62
Xagreth,illidan,1579,rogue,assassination,40,20,20
Coquìn,proudmoore,1552,rogue,assassination,48,27,21
Xilorio,skullcrusher,1552,rogue,assassination,42,23,19
Nsns,drenden,1550,rogue,assassination,119,58,61
Kiosh,tichondrius,1542,rogue,assassination,66,32,34
Foreverioi,tichondrius,1532,rogue,assassination,42,22,20
Jjp,tichondrius,1522,rogue,assassination,36,16,20
Creamypeach,stormrage,1513,rogue,assassination,39,19,20
Staabzz,thrall,1505,rogue,assassination,66,27,39
Sizka,sargeras,1495,rogue,assassination,36,17,19
Stabem,moon-guard,1487,rogue,assassination,153,82,71
Hypnothot,tichondrius,1487,rogue,assassination,78,23,55
Lunatixz,emerald-dream,1477,rogue,assassination,29,16,13
Camlaw,area-52,1477,rogue,assassination,55,26,29
Blackmont,bleeding-hollow,1456,rogue,assassination,60,26,34
Bellicoses,tichondrius,1439,rogue,assassination,77,38,39
Playmaker,frostwolf,1435,rogue,assassination,135,73,62
Lcl,proudmoore,1422,rogue,assassination,142,73,69
Youwho,kiljaeden,1410,rogue,assassination,87,42,45
Riventrix,zuljin,1389,rogue,assassination,41,17,24
Notjawn,arthas,1378,rogue,assassination,54,27,27
Valråvn,bloodscalp,1359,rogue,assassination,23,15,8
Boonee,frostmourne,1345,rogue,assassination,48,21,27
Swexee,area-52,1339,rogue,assassination,60,26,34
Greenlemons,lightnings-blade,1335,rogue,assassination,30,19,11
Wxvi,tichondrius,1327,rogue,assassination,24,14,10
Shankeez,tichondrius,1319,rogue,assassination,30,14,16
Keepitshadow,frostmourne,1317,rogue,assassination,60,32,28
Gorgdrake,illidan,1306,rogue,assassination,53,27,26
Pirrow,moon-guard,1305,rogue,assassination,29,15,14
Paraisbae,tichondrius,1304,rogue,assassination,30,14,16
Aynrand,drakkari,1281,rogue,assassination,36,16,20
Keylâ,thrall,1264,rogue,assassination,44,24,20
Sinnister,queldorei,1259,rogue,assassination,47,20,27
Regios,shadowmoon,1255,rogue,assassination,71,31,40
Spooky,bleeding-hollow,1248,rogue,assassination,30,15,15
Doomcore,barthilas,1246,rogue,assassination,35,17,18
Sênorita,tichondrius,1246,rogue,assassination,36,13,23
Wujn,tichondrius,1233,rogue,assassination,24,13,11
Pst,spirestone,1227,rogue,assassination,24,14,10
Shinobick,kelthuzad,1222,rogue,assassination,30,15,15
Lórdx,illidan,1178,rogue,assassination,50,23,27
Fakie,quelthalas,1177,rogue,assassination,25,15,10
Odetodindel,nerzhul,1175,rogue,assassination,48,27,21
Cutercarver,proudmoore,1151,rogue,assassination,24,12,12
Kenteenx,tichondrius,1151,rogue,assassination,30,12,18
Tortador,quelthalas,1140,rogue,assassination,30,16,14
Powerjuicer,tichondrius,1135,rogue,assassination,25,14,11
Kriszov,moon-guard,1126,rogue,assassination,106,52,54
Morgoophh,azralon,1123,rogue,assassination,44,20,24
Nikhlaus,ragnaros,1107,rogue,assassination,24,13,11
Copler,tichondrius,1098,rogue,assassination,30,12,18
Roguepvp,stormrage,1095,rogue,assassination,52,28,24
Ninjadoo,tichondrius,1075,rogue,assassination,32,12,20
Lycanthropî,illidan,1056,rogue,assassination,24,11,13
Slickyo,malganis,1055,rogue,assassination,18,11,7
Dothras,stormrage,1055,rogue,assassination,39,16,23
Quefist,sargeras,1054,rogue,assassination,20,11,9
Nayle,dalaran,1054,rogue,assassination,24,11,13
Wxva,tichondrius,1054,rogue,assassination,24,11,13
Zipperx,tichondrius,1053,rogue,assassination,30,11,19
Hickery,frostmourne,1053,rogue,assassination,30,11,19
Gogothirteen,kiljaeden,1048,rogue,assassination,24,12,12
Roollz,nemesis,1048,rogue,assassination,24,11,13
Altarys,ragnaros,1016,rogue,assassination,18,11,7
Skigskag,shadowsong,990,rogue,assassination,37,15,22
Strîkér,tichondrius,975,rogue,assassination,19,11,8
Osiriko,thunderlord,963,rogue,assassination,37,18,19
Elinarra,sargeras,960,rogue,assassination,12,10,2
Jonuts,bleeding-hollow,960,rogue,assassination,18,10,8
Beaconlight,tichondrius,960,rogue,assassination,24,10,14
Dizzymoods,stormrage,960,rogue,assassination,24,10,14
Kents,tichondrius,960,rogue,assassination,24,10,14
Ãnimefãnx,moon-guard,957,rogue,assassination,24,10,14
Replayz,stormrage,957,rogue,assassination,30,10,20
Raskapashan,moon-guard,956,rogue,assassination,30,10,20
Indivisible,thunderlord,947,rogue,assassination,18,10,8
Elithr,nemesis,944,rogue,assassination,18,10,8
Mìtsuru,proudmoore,942,rogue,assassination,18,10,8
Smoketoad,tichondrius,938,rogue,assassination,18,10,8
Sergioz,quelthalas,935,rogue,assassination,30,10,20
Atomicgoat,tichondrius,928,rogue,assassination,33,12,21
Ulley,sargeras,926,rogue,assassination,20,11,9
Wolgan,nemesis,916,rogue,assassination,55,25,30
Thenelis,dalaran,897,rogue,assassination,43,10,33
Smkgpvp,stormrage,894,rogue,assassination,17,10,7
Roguecity,tichondrius,877,rogue,assassination,40,10,30
Unlucký,sargeras,864,rogue,assassination,12,9,3
Köfy,quelthalas,864,rogue,assassination,24,9,15
Brendantko,arthas,863,rogue,assassination,18,9,9
Isàputàp,tichondrius,863,rogue,assassination,18,9,9
Purplechil,garrosh,863,rogue,assassination,24,9,15
Cleam,darkspear,861,rogue,assassination,18,9,9
Galaily,proudmoore,859,rogue,assassination,24,9,15
Ballflicker,malganis,857,rogue,assassination,30,9,21
Hiddencosts,proudmoore,856,rogue,assassination,27,10,17
Chingado,kaelthas,855,rogue,assassination,24,9,15
Píxíedúst,black-dragonflight,812,rogue,assassination,34,10,24
Ziggee,sargeras,785,rogue,assassination,20,9,11
Snakegødx,sargeras,768,rogue,assassination,21,9,12
Happyslice,stormrage,767,rogue,assassination,15,9,6
Dianiss,ragnaros,767,rogue,assassination,18,8,10
Zetéra,ragnaros,767,rogue,assassination,18,8,10
Xshadowt,ragnaros,767,rogue,assassination,24,8,16
Mylovejunex,tichondrius,766,rogue,assassination,12,8,4
ßackshots,kelthuzad,766,rogue,assassination,18,8,10
Problemchild,rexxar,765,rogue,assassination,18,8,10
Kindasorry,illidan,764,rogue,assassination,24,8,16
Hattrìck,area-52,763,rogue,assassination,24,8,16
Picaroxp,drakkari,762,rogue,assassination,12,8,4
Snoor,nemesis,753,rogue,assassination,21,9,12
Killua,dalaran,752,rogue,assassination,18,8,10
Zapersapp,malygos,751,rogue,assassination,22,9,13
Apocalipto,barthilas,732,rogue,assassination,29,8,21
Endlesswaltz,zuljin,720,rogue,assassination,21,8,13
Ultranumb,sargeras,714,rogue,assassination,14,9,5
Ghoulzer,tichondrius,704,rogue,assassination,10,8,2
Relän,ragnaros,672,rogue,assassination,12,7,5
Zirkir,mannoroth,672,rogue,assassination,12,7,5
Nogodplsno,stormrage,672,rogue,assassination,18,7,11
Lakeshark,stormrage,672,rogue,assassination,24,7,17
Sangreale,nemesis,671,rogue,assassination,12,7,5
Driprat,area-52,671,rogue,assassination,12,7,5
Alizashea,stormrage,671,rogue,assassination,12,7,5
Johnthefum,malganis,671,rogue,assassination,18,7,11
Showclass,stormrage,671,rogue,assassination,18,7,11
Ezzdeath,tichondrius,671,rogue,assassination,18,7,11
Worm,demon-soul,671,rogue,assassination,18,7,11
Jagó,malganis,669,rogue,assassination,18,7,11
Rodanheim,burning-blade,667,rogue,assassination,18,7,11
Cashbigknife,area-52,667,rogue,assassination,24,7,17
Omnìslash,area-52,655,rogue,assassination,11,7,4
Runakó,kelthuzad,623,rogue,assassination,11,7,4
Pochomän,ragnaros,618,rogue,assassination,16,9,7
Páïgèvêntürã,bleeding-hollow,607,rogue,assassination,14,7,7
Turec,illidan,576,rogue,assassination,12,6,6
Røgüë,malganis,576,rogue,assassination,12,6,6
Nhic,tichondrius,576,rogue,assassination,12,6,6
Mosedz,tichondrius,576,rogue,assassination,12,6,6
Olé,azralon,576,rogue,assassination,12,6,6
Twoheaded,frostmourne,576,rogue,assassination,12,6,6
Stabasaurus,blood-furnace,576,rogue,assassination,12,6,6
Viicky,ghostlands,576,rogue,assassination,12,6,6
Thargal,tichondrius,576,rogue,assassination,12,6,6
Luriél,stormrage,576,rogue,assassination,12,6,6
Grafting,tichondrius,576,rogue,assassination,12,6,6
Bloodygoat,area-52,576,rogue,assassination,12,6,6
Øsi,icecrown,576,rogue,assassination,18,6,12
Leônhart,thrall,576,rogue,assassination,18,6,12
Blaçkout,thrall,575,rogue,assassination,12,6,6
Robinsony,tichondrius,575,rogue,assassination,12,6,6
Aurrora,kiljaeden,574,rogue,assassination,17,6,11
Looprevil,andorhal,572,rogue,assassination,12,6,6
Escape,elune,571,rogue,assassination,12,6,6
Pegglerogue,fizzcrank,571,rogue,assassination,18,6,12
Euweu,nemesis,567,rogue,assassination,18,6,12
Snub,aerie-peak,536,rogue,assassination,22,6,16
Grasiel,tichondrius,528,rogue,assassination,9,6,3
Karing,onyxia,511,rogue,assassination,10,6,4
Seroth,tichondrius,480,rogue,assassination,6,5,1
Lvx,frostmourne,480,rogue,assassination,6,5,1
Pwnsauce,frostmourne,480,rogue,assassination,7,5,2
Breakxcvii,bleeding-hollow,480,rogue,assassination,12,5,7
Tberg,emerald-dream,480,rogue,assassination,12,5,7
Bloore,fizzcrank,480,rogue,assassination,12,5,7
Kidneyshiv,stormrage,480,rogue,assassination,12,5,7
Clairered,tichondrius,480,rogue,assassination,12,5,7
Ånko,tichondrius,480,rogue,assassination,12,5,7
Fuzzyslow,stormrage,480,rogue,assassination,12,5,7
Dysxliec,dalaran,480,rogue,assassination,12,5,7
Spikiera,silvermoon,480,rogue,assassination,12,5,7
Rêdrum,illidan,480,rogue,assassination,30,5,25
Rizzboy,tichondrius,479,rogue,assassination,12,5,7
Mashad,moon-guard,479,rogue,assassination,12,5,7
Rinestiria,arthas,479,rogue,assassination,18,5,13
Maison,ragnaros,478,rogue,assassination,12,5,7
Bonizzi,stormrage,478,rogue,assassination,12,5,7
Lethalist,whisperwind,476,rogue,assassination,12,5,7
Slycndice,tortheldrin,473,rogue,assassination,18,5,13
Savagedeeps,stormreaver,472,rogue,assassination,12,5,7
Julius,malganis,447,rogue,assassination,8,6,2
Hollowtipzz,tichondrius,384,rogue,assassination,6,4,2
Tmpikaboo,tichondrius,384,rogue,assassination,6,4,2
Fofree,hyjal,384,rogue,assassination,6,4,2
Chokonet,gurubashi,384,rogue,assassination,6,4,2
Slizard,boulderfist,384,rogue,assassination,6,4,2
Laotrec,nemesis,384,rogue,assassination,6,4,2
Kayriss,antonidas,384,rogue,assassination,6,4,2
Schleazy,emerald-dream,384,rogue,assassination,6,4,2
Itokuri,ysera,384,rogue,assassination,6,4,2
Onulyo,tichondrius,384,rogue,assassination,6,4,2
Aiden,burning-legion,384,rogue,assassination,6,4,2
Cryoph,illidan,384,rogue,assassination,12,4,8
Gridisx,wyrmrest-accord,384,rogue,assassination,12,4,8
Lesentixd,stormrage,384,rogue,assassination,12,4,8
Pãndã,stormrage,384,rogue,assassination,12,4,8
Pandrogue,shadowsong,384,rogue,assassination,12,4,8
Mydearest,tichondrius,384,rogue,assassination,12,4,8
Rîa,area-52,384,rogue,assassination,12,4,8
Xm,sargeras,384,rogue,assassination,12,4,8
Cv,proudmoore,384,rogue,assassination,12,4,8
Gladlol,stormrage,384,rogue,assassination,18,4,14
Zamorant,emerald-dream,384,rogue,assassination,24,4,20
Sinistro,bleeding-hollow,383,rogue,assassination,6,4,2
Kiorz,tichondrius,383,rogue,assassination,6,4,2
Snoopdrogado,sargeras,383,rogue,assassination,6,4,2
Steeldiesel,sargeras,383,rogue,assassination,12,4,8
Setsu,sargeras,383,rogue,assassination,12,4,8
Corteleve,nemesis,383,rogue,assassination,12,4,8
Tiptoez,bleeding-hollow,382,rogue,assassination,6,4,2
Slootslayer,azshara,382,rogue,assassination,12,4,8
Tralisong,azshara,382,rogue,assassination,12,4,8
Hésta,moon-guard,382,rogue,assassination,12,4,8
Wrinklevoss,proudmoore,382,rogue,assassination,12,4,8
Tolthe,hyjal,351,rogue,assassination,11,4,7
Xvds,tichondrius,319,rogue,assassination,14,4,10
Ziedrich,frostmourne,318,rogue,assassination,10,4,6
Calebrogue,illidan,288,rogue,assassination,6,3,3
Saltypwncake,illidan,288,rogue,assassination,6,3,3
Manersi,akama,288,rogue,assassination,6,3,3
Twinkasz,nemesis,288,rogue,assassination,6,3,3
Prodixybn,illidan,288,rogue,assassination,6,3,3
Punkyass,azralon,288,rogue,assassination,6,3,3
Kargargar,thrall,288,rogue,assassination,6,3,3
Deepman,gorefiend,288,rogue,assassination,6,3,3
Girio,thrall,288,rogue,assassination,6,3,3
Deeshdosh,illidan,288,rogue,assassination,6,3,3
Cjayy,bleeding-hollow,288,rogue,assassination,6,3,3
Wowamaze,aegwynn,288,rogue,assassination,6,3,3
Corrier,tichondrius,288,rogue,assassination,6,3,3
Chipetan,hyjal,288,rogue,assassination,6,3,3
Thâïßòÿgøóñ,jubeithos,288,rogue,assassination,6,3,3
ßåðlåg,skullcrusher,288,rogue,assassination,6,3,3
Bigtengu,tichondrius,288,rogue,assassination,6,3,3
Núm,tichondrius,288,rogue,assassination,6,3,3
Steffmaister,tichondrius,288,rogue,assassination,6,3,3
Dïeb,zuljin,288,rogue,assassination,6,3,3
Jannie,rexxar,288,rogue,assassination,6,3,3
Dockside,stormrage,288,rogue,assassination,6,3,3
Cron,arygos,288,rogue,assassination,6,3,3
Tryedge,moon-guard,288,rogue,assassination,6,3,3
Ahjii,malganis,288,rogue,assassination,12,3,9
Aevaela,duskwood,288,rogue,assassination,12,3,9
Papadopolous,zuluhed,288,rogue,assassination,12,3,9
Trinktick,doomhammer,288,rogue,assassination,12,3,9
Whoox,khazgoroth,288,rogue,assassination,12,3,9
Shortcut,khadgar,288,rogue,assassination,12,3,9
Karmagoodttv,stormrage,288,rogue,assassination,12,3,9
Alttee,proudmoore,288,rogue,assassination,12,3,9
Cydonian,ragnaros,288,rogue,assassination,12,3,9
Sunshinezx,frostmourne,288,rogue,assassination,12,3,9
Adrianstab,dalaran,287,rogue,assassination,6,3,3
Gilhela,bloodhoof,287,rogue,assassination,6,3,3
Moridra,demon-soul,287,rogue,assassination,6,3,3
Slobernocker,stormrage,287,rogue,assassination,6,3,3
Jakkov,blackrock,287,rogue,assassination,12,3,9
Olg,arathor,287,rogue,assassination,12,3,9
Peeryl,daggerspine,286,rogue,assassination,6,3,3
Clothies,zuljin,285,rogue,assassination,12,3,9
Sanguinnar,nemesis,285,rogue,assassination,12,3,9
Synesh,moon-guard,255,rogue,assassination,11,3,8
Thoxic,barthilas,239,rogue,assassination,5,3,2
Tamsy,the-forgotten-coast,239,rogue,assassination,5,3,2
Walnutrog,area-52,234,rogue,assassination,11,5,6
Skairipa,agamaggan,232,rogue,assassination,7,4,3
Pícáróóná,ragnaros,224,rogue,assassination,10,3,7
Bladä,area-52,192,rogue,assassination,6,2,4
Vanishcdc,area-52,192,rogue,assassination,6,2,4
Wowslayer,bleeding-hollow,192,rogue,assassination,6,2,4
Nicknasty,kelthuzad,192,rogue,assassination,6,2,4
Slashinsteev,dalaran,192,rogue,assassination,6,2,4
Ninjamf,bleeding-hollow,192,rogue,assassination,6,2,4
Theblindsap,dalaran,192,rogue,assassination,6,2,4
Apssal,tichondrius,192,rogue,assassination,6,2,4
Cktko,stormrage,192,rogue,assassination,6,2,4
Gentlesaop,blackrock,192,rogue,assassination,6,2,4
Sneakysharky,frostmourne,192,rogue,assassination,6,2,4
Miloandotis,malganis,192,rogue,assassination,6,2,4
Haeqn,nemesis,192,rogue,assassination,6,2,4
Kdrx,thrall,192,rogue,assassination,6,2,4
Mermm,burning-blade,192,rogue,assassination,6,2,4
Stepper,aegwynn,192,rogue,assassination,6,2,4
Vimit,tichondrius,192,rogue,assassination,6,2,4
Quickflash,bloodhoof,192,rogue,assassination,6,2,4
Karlemagne,blackrock,192,rogue,assassination,6,2,4
Sellers,tichondrius,192,rogue,assassination,6,2,4
Støné,azjolnerub,192,rogue,assassination,6,2,4
Jaanmonty,frostmourne,192,rogue,assassination,6,2,4
Frostheartyy,azralon,192,rogue,assassination,6,2,4
Zogbu,stormrage,192,rogue,assassination,6,2,4
Ilesire,frostmourne,192,rogue,assassination,6,2,4
Ennmaa,azralon,192,rogue,assassination,6,2,4
Darkfalleng,azralon,192,rogue,assassination,6,2,4
Escurecer,azralon,192,rogue,assassination,6,2,4
Jerzs,tichondrius,192,rogue,assassination,6,2,4
Roguemain,smolderthorn,192,rogue,assassination,6,2,4
Swickwockdus,azralon,192,rogue,assassination,6,2,4
Skeezy,vashj,192,rogue,assassination,6,2,4
Ssjseem,sargeras,192,rogue,assassination,6,2,4
Lakeshark,tichondrius,192,rogue,assassination,6,2,4
Historymaker,tichondrius,192,rogue,assassination,6,2,4
Gilbertgr,boulderfist,192,rogue,assassination,6,2,4
Nightdelphya,azralon,192,rogue,assassination,6,2,4
Pkkrevolt,archimonde,192,rogue,assassination,6,2,4
Youngtugger,daggerspine,192,rogue,assassination,11,2,9
Liridor,quelthalas,192,rogue,assassination,11,2,9
Nines,icecrown,192,rogue,assassination,12,2,10
Pleodonis,tichondrius,192,rogue,assassination,12,2,10
Bloodwish,tichondrius,192,rogue,assassination,12,2,10
Diatonic,illidan,191,rogue,assassination,6,2,4
Cryptixx,blades-edge,191,rogue,assassination,6,2,4
Dabrat,frostwolf,191,rogue,assassination,12,2,10
Donpablò,area-52,175,rogue,assassination,11,2,9
Stâbitha,bloodscalp,138,rogue,assassination,20,4,16
Superharry,tichondrius,128,rogue,assassination,4,2,2
Teach,illidan,96,rogue,assassination,3,2,1
Slowtime,quelthalas,96,rogue,assassination,6,1,5
Atulano,wyrmrest-accord,96,rogue,assassination,6,1,5
Onetwostep,tichondrius,96,rogue,assassination,6,1,5
Greased,arthas,96,rogue,assassination,6,1,5
Twotimed,magtheridon,96,rogue,assassination,6,1,5
Azrek,sargeras,96,rogue,assassination,6,1,5
Stêf,zuljin,96,rogue,assassination,6,1,5
Rykojin,sargeras,96,rogue,assassination,6,1,5
Brianä,quelthalas,96,rogue,assassination,6,1,5
Deathxx,destromath,96,rogue,assassination,6,1,5
Canesuckr,stormrage,96,rogue,assassination,6,1,5
Assakiller,azralon,96,rogue,assassination,6,1,5
Icantsleep,tichondrius,96,rogue,assassination,6,1,5
Wuzi,azralon,96,rogue,assassination,6,1,5
Darkdessoft,ragnaros,96,rogue,assassination,6,1,5
Touchthetip,bleeding-hollow,96,rogue,assassination,6,1,5
Preceptor,azralon,96,rogue,assassination,6,1,5
Sevrow,wyrmrest-accord,96,rogue,assassination,6,1,5
Lululee,tichondrius,96,rogue,assassination,6,1,5
Vitalz,bloodscalp,96,rogue,assassination,6,1,5
Lu,lethon,96,rogue,assassination,6,1,5
Khlapncheeks,emerald-dream,96,rogue,assassination,6,1,5
Zitihait,amanthul,96,rogue,assassination,6,1,5
Docheatt,dalaran,96,rogue,assassination,6,1,5
Flinchyy,dalaran,96,rogue,assassination,6,1,5
Combøz,tichondrius,96,rogue,assassination,6,1,5
Ntshaav,illidan,96,rogue,assassination,6,1,5
Clicksbtns,area-52,96,rogue,assassination,6,1,5
Elevorra,frostmourne,96,rogue,assassination,6,1,5
Nubes,illidan,96,rogue,assassination,6,1,5
Burtonee,aegwynn,96,rogue,assassination,6,1,5
Scylas,stormrage,96,rogue,assassination,6,1,5
Nebiroth,illidan,96,rogue,assassination,6,1,5
Rokkhan,blackrock,96,rogue,assassination,6,1,5
Kiskapolyus,thrall,96,rogue,assassination,6,1,5
Yohigo,quelthalas,96,rogue,assassination,6,1,5
Enyr,frostmourne,96,rogue,assassination,6,1,5
Vladtsepesh,stormrage,96,rogue,assassination,12,1,11
Kistef,moon-guard,96,rogue,assassination,12,1,11
Voidbrain,area-52,96,rogue,assassination,12,1,11
Sneakyfoot,gorgonnash,95,rogue,assassination,7,1,6
Averagepimpn,tichondrius,79,rogue,assassination,5,1,4
Radiantrogue,nordrassil,79,rogue,assassination,5,1,4
Botches,bonechewer,48,rogue,assassination,3,1,2
Ajy,tichondrius,31,rogue,assassination,2,1,1
Ascherx,illidan,16,rogue,assassination,1,1,0
Timpossible,tichondrius,2135,shaman,restoration,260,138,122
Spagetje,tichondrius,2131,shaman,restoration,78,46,32
Xtremeorc,area-52,2109,shaman,restoration,54,31,23
Zavoky,tichondrius,2108,shaman,restoration,96,56,40
Akwesy,stormrage,2108,shaman,restoration,83,47,36
Shamaen,kelthuzad,2107,shaman,restoration,86,51,35
Selketh,area-52,2107,shaman,restoration,79,46,33
Skipperx,thrall,2097,shaman,restoration,60,37,23
Aameng,tichondrius,2064,shaman,restoration,84,44,40
Plewt,zuljin,2051,shaman,restoration,67,35,32
Iissham,darkspear,2050,shaman,restoration,86,44,42
Itsallgoodx,tichondrius,2008,shaman,restoration,114,55,59
Sizure,frostmourne,2007,shaman,restoration,106,55,51
Ilavayoualot,malganis,2006,shaman,restoration,130,62,68
Smlz,garrosh,1998,shaman,restoration,68,38,30
Berquon,tichondrius,1994,shaman,restoration,72,38,34
Svanteson,wyrmrest-accord,1979,shaman,restoration,78,37,41
Cruv,thrall,1936,shaman,restoration,96,47,49
Slimdavey,tichondrius,1934,shaman,restoration,113,64,49
Jangbi,malganis,1934,shaman,restoration,246,129,117
Kimflo,tichondrius,1931,shaman,restoration,91,48,43
Semtechs,tichondrius,1919,shaman,restoration,124,64,60
Gragomga,area-52,1916,shaman,restoration,78,41,37
Kurtcx,tichondrius,1914,shaman,restoration,153,78,75
Lötus,tichondrius,1906,shaman,restoration,56,34,22
Plorenz,illidan,1905,shaman,restoration,54,34,20
Corianderism,tichondrius,1894,shaman,restoration,65,33,32
Nepos,dragonmaw,1891,shaman,restoration,66,34,32
Däbü,tichondrius,1887,shaman,restoration,84,40,44
Bigbadsac,frostmourne,1884,shaman,restoration,78,38,40
Chomang,stormreaver,1874,shaman,restoration,72,37,35
Dehsaw,illidan,1867,shaman,restoration,96,50,46
Hódoong,tichondrius,1857,shaman,restoration,46,24,22
Peyn,shadowsong,1856,shaman,restoration,54,31,23
Moistbeans,tichondrius,1854,shaman,restoration,48,26,22
Oryxx,kiljaeden,1852,shaman,restoration,48,25,23
Terapatrik,area-52,1850,shaman,restoration,120,59,61
Baodan,azshara,1847,shaman,restoration,83,42,41
Abovesky,proudmoore,1843,shaman,restoration,78,34,44
Shamcena,the-scryers,1842,shaman,restoration,51,28,23
Restobyte,moon-guard,1837,shaman,restoration,42,24,18
Crazyshamañ,akama,1837,shaman,restoration,53,27,26
Caibeeshammy,tichondrius,1835,shaman,restoration,162,77,85
Stormtitan,malganis,1831,shaman,restoration,66,30,36
Chobawn,tichondrius,1829,shaman,restoration,60,32,28
Bluekid,barthilas,1828,shaman,restoration,54,30,24
Hathul,bleeding-hollow,1826,shaman,restoration,60,33,27
Tuskcrusher,dalaran,1825,shaman,restoration,72,30,42
Ogctkoy,illidan,1824,shaman,restoration,102,51,51
Bobbybigdam,tichondrius,1822,shaman,restoration,81,47,34
Cryochemist,tichondrius,1819,shaman,restoration,29,23,6
Dantheman,twisting-nether,1810,shaman,restoration,42,23,19
Meatballs,kirin-tor,1809,shaman,restoration,62,31,31
Desee,bleeding-hollow,1809,shaman,restoration,48,24,24
Willy,icecrown,1807,shaman,restoration,81,41,40
Totemgripper,moon-guard,1804,shaman,restoration,65,39,26
Hydrocheck,tichondrius,1804,shaman,restoration,94,54,40
Astrøcyte,tichondrius,1804,shaman,restoration,96,46,50
Cmsi,tichondrius,1803,shaman,restoration,42,23,19
Podcognito,bleeding-hollow,1802,shaman,restoration,71,44,27
Nktx,tichondrius,1800,shaman,restoration,118,66,52
Shanasty,bleeding-hollow,1797,shaman,restoration,54,29,25
Inmø,ragnaros,1797,shaman,restoration,36,19,17
Nayro,bleeding-hollow,1793,shaman,restoration,181,110,71
Cigaretter,tichondrius,1793,shaman,restoration,56,25,31
Gjök,nemesis,1781,shaman,restoration,48,19,29
Booramqt,tichondrius,1780,shaman,restoration,47,27,20
Dyllbar,tichondrius,1768,shaman,restoration,50,26,24
Mybbro,kiljaeden,1768,shaman,restoration,69,32,37
Shockmematty,tichondrius,1752,shaman,restoration,24,19,5
Boyfromhell,stormrage,1746,shaman,restoration,79,35,44
Hustlenflow,tichondrius,1745,shaman,restoration,42,25,17
Blackfancy,thrall,1744,shaman,restoration,56,32,24
Nemix,barthilas,1737,shaman,restoration,36,22,14
Møp,spirestone,1730,shaman,restoration,103,54,49
Blazingtotem,dunemaul,1723,shaman,restoration,95,47,48
Bômi,tichondrius,1722,shaman,restoration,112,55,57
Samyeh,tichondrius,1721,shaman,restoration,36,24,12
Itsyabøiwill,area-52,1712,shaman,restoration,48,30,18
Nanosec,tichondrius,1711,shaman,restoration,30,18,12
Ravaburst,sargeras,1711,shaman,restoration,48,21,27
Sìxnìne,tichondrius,1706,shaman,restoration,62,28,34
Bozzyy,illidan,1704,shaman,restoration,48,26,22
Cpplol,tichondrius,1702,shaman,restoration,41,25,16
Elementz,tichondrius,1701,shaman,restoration,78,44,34
Vrom,whisperwind,1698,shaman,restoration,42,29,13
Lingduacn,tichondrius,1698,shaman,restoration,36,18,18
Shacewoman,altar-of-storms,1694,shaman,restoration,121,53,68
Ribbeye,tichondrius,1693,shaman,restoration,83,40,43
Ittøki,tichondrius,1689,shaman,restoration,41,24,17
Exshocks,tichondrius,1680,shaman,restoration,42,25,17
Erwin,bonechewer,1679,shaman,restoration,76,45,31
Záheer,arthas,1678,shaman,restoration,48,27,21
Ibreakanklez,bleeding-hollow,1669,shaman,restoration,36,18,18
Raywhiter,tichondrius,1667,shaman,restoration,56,26,30
Moldymeatbox,emerald-dream,1666,shaman,restoration,62,25,37
Foilcap,bonechewer,1663,shaman,restoration,248,122,126
Chazzwozza,area-52,1660,shaman,restoration,41,22,19
Lingdusm,tichondrius,1657,shaman,restoration,36,20,16
Uncleilli,tichondrius,1656,shaman,restoration,41,18,23
Vayces,barthilas,1652,shaman,restoration,128,68,60
Inpantsment,barthilas,1652,shaman,restoration,64,32,32
Peegee,zuluhed,1652,shaman,restoration,54,22,32
Win,blackwing-lair,1651,shaman,restoration,36,21,15
Bolteon,malganis,1648,shaman,restoration,30,21,9
Groundingtot,hydraxis,1648,shaman,restoration,36,22,14
Jsell,zuljin,1646,shaman,restoration,56,28,28
Hairyrichard,zuljin,1645,shaman,restoration,295,161,134
Bigmontana,tichondrius,1644,shaman,restoration,36,21,15
Krazyc,sargeras,1640,shaman,restoration,72,34,38
Rantòn,bleeding-hollow,1640,shaman,restoration,47,22,25
Bwinthewomb,stormrage,1637,shaman,restoration,118,68,50
Cheddaman,kiljaeden,1637,shaman,restoration,48,21,27
Shamsom,tichondrius,1635,shaman,restoration,60,30,30
Sikotics,area-52,1634,shaman,restoration,57,33,24
Quitnectar,aggramar,1633,shaman,restoration,48,24,24
Skoobasteeve,sargeras,1631,shaman,restoration,60,35,25
Shortbusqt,hyjal,1631,shaman,restoration,42,23,19
Wraethy,illidan,1630,shaman,restoration,79,42,37
Phxhouse,illidan,1630,shaman,restoration,216,98,118
Semnicktotem,area-52,1628,shaman,restoration,48,23,25
Lacid,tichondrius,1627,shaman,restoration,62,40,22
Hehew,kelthuzad,1627,shaman,restoration,80,45,35
Furrytotems,darkspear,1626,shaman,restoration,60,30,30
Lilgeeh,kelthuzad,1626,shaman,restoration,36,18,18
Grizze,bonechewer,1626,shaman,restoration,90,41,49
Horizonsham,stormrage,1621,shaman,restoration,30,18,12
Breuer,tichondrius,1616,shaman,restoration,42,20,22
Drammah,malganis,1610,shaman,restoration,48,19,29
Ðoomed,kiljaeden,1608,shaman,restoration,30,19,11
Plzdontlos,illidan,1607,shaman,restoration,113,69,44
Astrauk,nemesis,1606,shaman,restoration,76,43,33
Jizzlewizwiz,tichondrius,1606,shaman,restoration,54,26,28
Hurú,azralon,1604,shaman,restoration,36,21,15
Erbicklet,ragnaros,1604,shaman,restoration,69,34,35
Milkkshake,illidan,1603,shaman,restoration,124,59,65
Gyrogg,scilla,1601,shaman,restoration,339,174,165
Elementàlius,quelthalas,1599,shaman,restoration,54,28,26
Epicthesloth,sargeras,1592,shaman,restoration,35,17,18
Intruzionall,barthilas,1588,shaman,restoration,83,46,37
Bogz,korgath,1586,shaman,restoration,48,20,28
Shawmen,zuljin,1582,shaman,restoration,99,49,50
Blackpïnk,tichondrius,1580,shaman,restoration,66,28,38
Telchar,quelthalas,1579,shaman,restoration,96,58,38
Turborundat,area-52,1579,shaman,restoration,201,115,86
Sewerperson,zuljin,1578,shaman,restoration,36,18,18
Pookiexo,illidan,1572,shaman,restoration,29,17,12
Reppinsix,sargeras,1572,shaman,restoration,35,17,18
Rockzoa,tichondrius,1571,shaman,restoration,42,19,23
Waater,lightbringer,1562,shaman,restoration,86,49,37
Bluepigo,tichondrius,1558,shaman,restoration,47,18,29
Xzxz,sargeras,1556,shaman,restoration,39,24,15
Bigspaghetti,thrall,1555,shaman,restoration,30,17,13
Tzyorz,illidan,1554,shaman,restoration,36,21,15
Akubai,kelthuzad,1550,shaman,restoration,42,22,20
Sasgöb,illidan,1550,shaman,restoration,41,17,24
Zaapi,dalaran,1549,shaman,restoration,48,19,29
Mandleman,tichondrius,1546,shaman,restoration,39,21,18
Steveyy,frostmourne,1544,shaman,restoration,27,17,10
Fujiyama,dark-iron,1544,shaman,restoration,74,39,35
Tyar,area-52,1543,shaman,restoration,137,64,73
Chainstuff,area-52,1541,shaman,restoration,29,17,12
Riptideafk,sargeras,1536,shaman,restoration,48,25,23
Beyoncé,lethon,1534,shaman,restoration,24,16,8
Draidosh,area-52,1532,shaman,restoration,36,23,13
Shamxrob,sargeras,1530,shaman,restoration,54,34,20
Suzhixie,akama,1528,shaman,restoration,36,16,20
Benta,zuljin,1526,shaman,restoration,58,32,26
Rinnan,malganis,1524,shaman,restoration,97,48,49
Platewalrus,illidan,1523,shaman,restoration,30,16,14
Bighaircut,darkspear,1521,shaman,restoration,32,17,15
Goatedsham,dalaran,1520,shaman,restoration,48,26,22
Rocyt,sargeras,1520,shaman,restoration,66,35,31
Enalen,argent-dawn,1515,shaman,restoration,42,24,18
Zuralah,nemesis,1515,shaman,restoration,46,25,21
Foragorn,stormrage,1515,shaman,restoration,61,27,34
Thunderspark,tichondrius,1514,shaman,restoration,24,16,8
Lanzero,chogall,1510,shaman,restoration,36,25,11
Gemoz,tichondrius,1508,shaman,restoration,24,16,8
Charlesby,tichondrius,1508,shaman,restoration,60,37,23
Tevya,dalvengyr,1507,shaman,restoration,30,17,13
Trapghost,cenarius,1506,shaman,restoration,87,41,46
Bigamez,azuremyst,1499,shaman,restoration,60,33,27
Ban,blackrock,1498,shaman,restoration,39,21,18
Hachikø,frostmourne,1498,shaman,restoration,48,22,26
Ärtful,illidan,1492,shaman,restoration,24,18,6
Mentyb,emerald-dream,1491,shaman,restoration,42,16,26
Shockszz,onyxia,1490,shaman,restoration,42,18,24
Cultsulyvahn,tichondrius,1487,shaman,restoration,43,21,22
Packspiritqt,tichondrius,1483,shaman,restoration,30,16,14
Trenhance,stormrage,1481,shaman,restoration,30,23,7
Krewesham,uldaman,1481,shaman,restoration,28,17,11
Worldx,barthilas,1481,shaman,restoration,42,18,24
Killercam,maiev,1479,shaman,restoration,139,65,74
Defac,proudmoore,1477,shaman,restoration,24,17,7
Ryukims,tichondrius,1477,shaman,restoration,35,17,18
Angelabaaby,proudmoore,1475,shaman,restoration,60,28,32
Yossarabi,bleeding-hollow,1474,shaman,restoration,48,20,28
Prowdt,azralon,1473,shaman,restoration,119,61,58
Cinematticz,tichondrius,1471,shaman,restoration,60,33,27
Supdaug,vashj,1468,shaman,restoration,54,29,25
Kantok,quelthalas,1466,shaman,restoration,35,22,13
Orkwa,bleeding-hollow,1465,shaman,restoration,56,28,28
Hirah,frostmourne,1460,shaman,restoration,23,16,7
Ballistíc,boulderfist,1458,shaman,restoration,48,28,20
Nilstorm,quelthalas,1458,shaman,restoration,72,38,34
Goatpornbad,sargeras,1457,shaman,restoration,96,44,52
Ssaotizi,tichondrius,1454,shaman,restoration,196,91,105
Hyonkh,tichondrius,1451,shaman,restoration,65,37,28
Kephax,eonar,1451,shaman,restoration,45,25,20
Tidalstorm,ragnaros,1450,shaman,restoration,90,52,38
Buffduude,shadowsong,1449,shaman,restoration,48,22,26
Ãrthor,stormrage,1444,shaman,restoration,36,21,15
Joltik,area-52,1444,shaman,restoration,173,84,89
Pissticles,bleeding-hollow,1439,shaman,restoration,48,22,26
Message,agamaggan,1437,shaman,restoration,355,176,179
Kafkaesk,tichondrius,1437,shaman,restoration,42,15,27
Creatine,area-52,1436,shaman,restoration,71,37,34
Tenyks,tichondrius,1436,shaman,restoration,51,26,25
Prøduce,tichondrius,1435,shaman,restoration,39,26,13
Wanghaisham,kelthuzad,1435,shaman,restoration,24,15,9
Wardruna,andorhal,1434,shaman,restoration,24,15,9
Shamicare,stormrage,1433,shaman,restoration,125,72,53
Geser,silvermoon,1432,shaman,restoration,44,26,18
Hulan,tichondrius,1432,shaman,restoration,30,15,15
Stylesp,area-52,1431,shaman,restoration,117,55,62
Totem,burning-legion,1431,shaman,restoration,36,16,20
Tundertotem,tichondrius,1430,shaman,restoration,39,24,15
Rumkin,malganis,1429,shaman,restoration,60,34,26
Grymn,sargeras,1427,shaman,restoration,36,15,21
Tumble,frostmourne,1425,shaman,restoration,53,28,25
Kelta,kelthuzad,1423,shaman,restoration,30,15,15
Badião,azralon,1423,shaman,restoration,94,42,52
Vzla,ragnaros,1422,shaman,restoration,54,28,26
Rainz,aggramar,1418,shaman,restoration,30,15,15
Ironcrag,moon-guard,1417,shaman,restoration,60,32,28
Nezzuk,quelthalas,1415,shaman,restoration,36,18,18
Smartakkar,emerald-dream,1414,shaman,restoration,31,21,10
World,frostmourne,1414,shaman,restoration,30,15,15
Strives,icecrown,1414,shaman,restoration,36,15,21
Djshammy,barthilas,1412,shaman,restoration,48,26,22
Catchclause,eonar,1409,shaman,restoration,30,15,15
Wyått,emerald-dream,1408,shaman,restoration,84,40,44
Illiteratex,tichondrius,1406,shaman,restoration,26,16,10
Zizö,barthilas,1404,shaman,restoration,42,19,23
Praxis,tichondrius,1403,shaman,restoration,71,35,36
Harth,zuljin,1402,shaman,restoration,54,29,25
Bluetooth,stormrage,1399,shaman,restoration,65,26,39
Nomediocur,moknathal,1397,shaman,restoration,47,18,29
Drinkharder,stormrage,1395,shaman,restoration,34,16,18
Rizam,malganis,1389,shaman,restoration,42,33,9
Gordonramsai,sargeras,1389,shaman,restoration,42,24,18
Shaquillius,tichondrius,1389,shaman,restoration,36,17,19
Halfinha,nemesis,1389,shaman,restoration,51,22,29
Soowecide,tichondrius,1387,shaman,restoration,60,23,37
ßread,illidan,1386,shaman,restoration,44,19,25
Fungus,firetree,1384,shaman,restoration,42,23,19
Hodoongs,tichondrius,1383,shaman,restoration,37,16,21
Onepunchsham,illidan,1382,shaman,restoration,70,31,39
Xajsham,tichondrius,1381,shaman,restoration,90,48,42
Lanuur,moon-guard,1379,shaman,restoration,54,31,23
Tizz,quelthalas,1376,shaman,restoration,70,37,33
Harigomi,tichondrius,1370,shaman,restoration,58,22,36
Kandin,icecrown,1369,shaman,restoration,54,27,27
Voluptuous,mannoroth,1359,shaman,restoration,271,134,137
Fàrrò,thrall,1355,shaman,restoration,24,17,7
Orjamba,barthilas,1347,shaman,restoration,29,17,12
Crittingbull,veknilash,1347,shaman,restoration,88,42,46
Krilick,blackrock,1346,shaman,restoration,23,15,8
Vlly,tichondrius,1342,shaman,restoration,30,14,16
Wuargh,area-52,1341,shaman,restoration,47,26,21
Gromgrai,bleeding-hollow,1339,shaman,restoration,35,20,15
Kultirio,quelthalas,1339,shaman,restoration,49,26,23
Wawsham,tichondrius,1336,shaman,restoration,36,14,22
Durogh,darkspear,1336,shaman,restoration,36,14,22
Nyathera,barthilas,1335,shaman,restoration,36,21,15
Aseew,drakkari,1334,shaman,restoration,60,28,32
Azhen,ragnaros,1333,shaman,restoration,102,51,51
Pherolex,tichondrius,1331,shaman,restoration,24,14,10
Rogrim,malganis,1331,shaman,restoration,24,14,10
Buffdestru,azralon,1330,shaman,restoration,36,23,13
Køtømine,ragnaros,1326,shaman,restoration,41,26,15
Zuljiba,illidan,1322,shaman,restoration,60,35,25
Restosud,crushridge,1320,shaman,restoration,30,18,12
Shamorrhoids,frostmourne,1318,shaman,restoration,96,51,45
Ithappens,senjin,1310,shaman,restoration,30,16,14
Thomastides,tichondrius,1310,shaman,restoration,66,32,34
Amperage,spirestone,1310,shaman,restoration,31,15,16
Absorblife,barthilas,1309,shaman,restoration,69,31,38
Meatballer,queldorei,1307,shaman,restoration,65,35,30
Greenpiece,azshara,1305,shaman,restoration,76,39,37
Hüsky,dalaran,1303,shaman,restoration,42,14,28
Samanl,tichondrius,1302,shaman,restoration,23,15,8
Tumble,barthilas,1302,shaman,restoration,52,26,26
Kirawindu,zuljin,1300,shaman,restoration,30,17,13
Aelwydx,quelthalas,1298,shaman,restoration,132,69,63
Tedmosbe,tichondrius,1297,shaman,restoration,36,15,21
Charmize,azralon,1295,shaman,restoration,48,23,25
Thunderborn,laughing-skull,1292,shaman,restoration,30,14,16
Slaggdaddy,durotan,1292,shaman,restoration,30,14,16
Afgoox,tichondrius,1291,shaman,restoration,66,36,30
Elemen,quelthalas,1291,shaman,restoration,59,26,33
Aviator,muradin,1288,shaman,restoration,36,19,17
Drazic,area-52,1286,shaman,restoration,49,28,21
Beefstocks,area-52,1284,shaman,restoration,54,28,26
Stargun,korgath,1284,shaman,restoration,147,76,71
Aemi,tichondrius,1279,shaman,restoration,102,45,57
Belgrom,tichondrius,1275,shaman,restoration,36,20,16
Retgarr,tichondrius,1272,shaman,restoration,30,17,13
Angelicrain,stormrage,1269,shaman,restoration,30,16,14
Kiojin,ragnaros,1267,shaman,restoration,52,27,25
Graveman,illidan,1266,shaman,restoration,63,30,33
Lavablurst,stormrage,1265,shaman,restoration,41,16,25
Shiestys,tichondrius,1264,shaman,restoration,33,23,10
Bitxxnumber,tichondrius,1262,shaman,restoration,122,68,54
Defnotheals,kelthuzad,1261,shaman,restoration,84,38,46
Menah,moon-guard,1260,shaman,restoration,36,20,16
Shimansham,aegwynn,1260,shaman,restoration,54,24,30
Hauby,zuljin,1259,shaman,restoration,48,15,33
Oldguy,ragnaros,1256,shaman,restoration,29,14,15
Foodlust,sargeras,1251,shaman,restoration,66,35,31
Feldstar,stormrage,1251,shaman,restoration,89,38,51
Blodbar,kiljaeden,1249,shaman,restoration,36,24,12
Madoka,llane,1248,shaman,restoration,18,13,5
Cæl,azralon,1248,shaman,restoration,29,16,13
Bigwave,zuluhed,1248,shaman,restoration,30,15,15
Prêttylights,bleeding-hollow,1247,shaman,restoration,18,13,5
Tôôz,stormrage,1247,shaman,restoration,18,13,5
Oridean,area-52,1247,shaman,restoration,24,13,11
Toteapole,malganis,1247,shaman,restoration,32,17,15
Miketheseal,bleeding-hollow,1247,shaman,restoration,30,13,17
Brislin,sargeras,1246,shaman,restoration,87,42,45
Ogran,stormscale,1245,shaman,restoration,36,13,23
Tayictwo,tichondrius,1244,shaman,restoration,24,13,11
Heniu,tichondrius,1243,shaman,restoration,30,13,17
Sharmut,bleeding-hollow,1242,shaman,restoration,117,59,58
Trúnks,magtheridon,1241,shaman,restoration,32,15,17
Kachupinsito,ragnaros,1241,shaman,restoration,44,18,26
Lastdwarf,tichondrius,1237,shaman,restoration,18,13,5
Quendella,aggramar,1237,shaman,restoration,24,13,11
Stabix,tichondrius,1237,shaman,restoration,30,16,14
Chingobling,illidan,1234,shaman,restoration,24,13,11
Kinjin,dragonmaw,1232,shaman,restoration,30,13,17
Quakess,zuljin,1232,shaman,restoration,36,13,23
Kikkóman,malganis,1230,shaman,restoration,48,25,23
ßøvîn,thrall,1227,shaman,restoration,24,13,11
Hammerme,barthilas,1227,shaman,restoration,60,19,41
Kaili,illidan,1225,shaman,restoration,18,13,5
Terdsammich,malganis,1225,shaman,restoration,24,14,10
Crazytotems,dalaran,1221,shaman,restoration,82,39,43
Mlpz,black-dragonflight,1220,shaman,restoration,24,13,11
Babytiramisu,stormrage,1217,shaman,restoration,36,16,20
Whoshealing,lightninghoof,1216,shaman,restoration,30,13,17
Truemooin,wyrmrest-accord,1215,shaman,restoration,88,44,44
Ekuku,tichondrius,1215,shaman,restoration,40,19,21
Killdeaderer,barthilas,1209,shaman,restoration,84,51,33
Certz,dark-iron,1209,shaman,restoration,39,15,24
Hasselshock,area-52,1207,shaman,restoration,82,31,51
Jineluki,emerald-dream,1205,shaman,restoration,35,17,18
Patoron,proudmoore,1204,shaman,restoration,34,17,17
Youneverknow,frostmourne,1203,shaman,restoration,54,24,30
Bluffin,stormrage,1200,shaman,restoration,18,14,4
Wuruizec,illidan,1197,shaman,restoration,29,13,16
Käck,tichondrius,1196,shaman,restoration,38,19,19
Furti,daggerspine,1190,shaman,restoration,34,16,18
Mynigabob,zuljin,1186,shaman,restoration,83,47,36
Getwetand,quelthalas,1182,shaman,restoration,103,51,52
Wunderwaffe,the-underbog,1181,shaman,restoration,28,14,14
Rimmington,frostmourne,1179,shaman,restoration,54,24,30
Dcãicer,quelthalas,1178,shaman,restoration,25,15,10
Daddybeaarr,thrall,1178,shaman,restoration,31,14,17
Barbosina,stormrage,1172,shaman,restoration,70,31,39
Ralinta,tichondrius,1170,shaman,restoration,49,14,35
Restoramen,frostmourne,1166,shaman,restoration,24,13,11
Hooldcool,tichondrius,1153,shaman,restoration,41,19,22
Dbmx,tichondrius,1152,shaman,restoration,24,12,12
Namso,tichondrius,1152,shaman,restoration,24,12,12
Üchihamadarâ,tichondrius,1152,shaman,restoration,24,12,12
Rawdòggin,emerald-dream,1152,shaman,restoration,33,13,20
Redbulls,azralon,1151,shaman,restoration,70,39,31
Sunyang,tichondrius,1151,shaman,restoration,24,12,12
Mitchestic,illidan,1151,shaman,restoration,30,12,18
Stórmstruck,area-52,1150,shaman,restoration,18,12,6
Rynoh,dalaran,1149,shaman,restoration,24,12,12
Laterallus,nagrand,1148,shaman,restoration,36,19,17
Bubbacheeks,area-52,1148,shaman,restoration,24,12,12
Shohzegky,azralon,1148,shaman,restoration,61,26,35
Drboidzerg,tichondrius,1147,shaman,restoration,30,18,12
Xiaoxiboy,tichondrius,1147,shaman,restoration,24,12,12
Freesolo,barthilas,1145,shaman,restoration,24,12,12
Wazöö,sargeras,1134,shaman,restoration,51,21,30
Gsync,tichondrius,1131,shaman,restoration,41,27,14
Dahmerjr,area-52,1129,shaman,restoration,24,14,10
Zetli,tichondrius,1120,shaman,restoration,36,12,24
Fencepost,bleeding-hollow,1118,shaman,restoration,18,12,6
Senzxlolxz,lightbringer,1113,shaman,restoration,33,21,12
Shammyguy,stormreaver,1103,shaman,restoration,50,23,27
Xruok,kelthuzad,1102,shaman,restoration,21,13,8
Totemist,tichondrius,1100,shaman,restoration,36,12,24
Mikeoxxgigg,kelthuzad,1095,shaman,restoration,48,28,20
Saicey,zuljin,1092,shaman,restoration,36,16,20
Ðno,frostmourne,1086,shaman,restoration,17,12,5
Stahlman,blackhand,1083,shaman,restoration,42,13,29
Turbluscious,frostmourne,1074,shaman,restoration,49,26,23
Reuxxe,area-52,1071,shaman,restoration,31,13,18
Grimmzhul,daggerspine,1068,shaman,restoration,60,28,32
Delayy,destromath,1064,shaman,restoration,36,13,23
Sekkuo,kiljaeden,1061,shaman,restoration,60,28,32
Biofly,thrall,1056,shaman,restoration,18,11,7
Lfgzookeeper,malganis,1056,shaman,restoration,18,11,7
Censyzz,tichondrius,1056,shaman,restoration,24,11,13
Brocules,aerie-peak,1056,shaman,restoration,24,11,13
Randomshammy,area-52,1055,shaman,restoration,18,11,7
Weoo,doomhammer,1055,shaman,restoration,18,11,7
Urga,hyjal,1055,shaman,restoration,18,11,7
Shamansrock,tichondrius,1055,shaman,restoration,18,11,7
Pericazo,sargeras,1055,shaman,restoration,24,11,13
Rollintotems,bleeding-hollow,1055,shaman,restoration,30,11,19
Wilmar,ragnaros,1054,shaman,restoration,18,11,7
Randomshammy,stormrage,1053,shaman,restoration,18,11,7
Fwwrs,illidan,1052,shaman,restoration,18,11,7
Velesa,kiljaeden,1052,shaman,restoration,30,11,19
Bluebones,frostmane,1050,shaman,restoration,18,11,7
Kaytahn,proudmoore,1049,shaman,restoration,24,11,13
Dextex,azralon,1048,shaman,restoration,35,21,14
Windfrenzy,thrall,1048,shaman,restoration,30,11,19
Subnôize,bleeding-hollow,1046,shaman,restoration,18,11,7
Watchmytrem,ragnaros,1046,shaman,restoration,30,11,19
Tràuma,caelestrasz,1045,shaman,restoration,45,13,32
Gl,nordrassil,1043,shaman,restoration,18,11,7
Saraguthix,dalaran,1043,shaman,restoration,30,11,19
Grullander,hakkar,1040,shaman,restoration,24,14,10
Zugzugthug,moon-guard,1040,shaman,restoration,84,33,51
Exportgold,barthilas,1039,shaman,restoration,24,11,13
Sindury,tichondrius,1034,shaman,restoration,24,11,13
Ozzai,ragnaros,1033,shaman,restoration,36,11,25
Sploosh,norgannon,1031,shaman,restoration,30,15,15
Stormburst,sargeras,1030,shaman,restoration,24,12,12
Mastrionilol,stormrage,1023,shaman,restoration,34,11,23
Mandinga,warsong,1022,shaman,restoration,41,18,23
Littledream,quelthalas,1021,shaman,restoration,28,12,16
Volsdeep,illidan,1007,shaman,restoration,21,11,10
Speedranger,stormrage,1004,shaman,restoration,42,15,27
Taquitho,quelthalas,1003,shaman,restoration,51,18,33
Hentaistorm,kiljaeden,998,shaman,restoration,80,41,39
Unchaman,ragnaros,995,shaman,restoration,32,13,19
Wâgu,moon-guard,992,shaman,restoration,28,11,17
Nottrhall,azralon,990,shaman,restoration,14,11,3
Pèpé,sargeras,990,shaman,restoration,18,13,5
Lavatotem,stormrage,990,shaman,restoration,35,16,19
Peppito,illidan,988,shaman,restoration,19,12,7
Teardrinker,korgath,988,shaman,restoration,30,11,19
Andrastia,thrall,976,shaman,restoration,24,15,9
Njjshamm,thrall,969,shaman,restoration,36,16,20
Twinkolava,nemesis,961,shaman,restoration,19,11,8
Yooseafood,tichondrius,960,shaman,restoration,12,10,2
Hst,barthilas,960,shaman,restoration,18,10,8
Yunotho,sargeras,960,shaman,restoration,18,10,8
Fierymoo,frostmourne,960,shaman,restoration,24,10,14
Chenguanxi,tichondrius,959,shaman,restoration,12,10,2
Nethyxsoy,frostmourne,959,shaman,restoration,12,10,2
Shoxx,wyrmrest-accord,959,shaman,restoration,18,10,8
Forcè,bleeding-hollow,959,shaman,restoration,24,10,14
Jsoto,ghostlands,959,shaman,restoration,24,10,14
Ggoong,tichondrius,959,shaman,restoration,36,10,26
Vinceshamwow,lightbringer,958,shaman,restoration,12,10,2
Zechary,proudmoore,958,shaman,restoration,18,10,8
Torric,kalecgos,958,shaman,restoration,18,10,8
Sleepysham,kelthuzad,958,shaman,restoration,30,10,20
Lawlsham,korgath,957,shaman,restoration,12,10,2
Athayis,malorne,957,shaman,restoration,59,31,28
Karaaka,ysera,956,shaman,restoration,30,10,20
Carltonbanks,aggramar,955,shaman,restoration,24,10,14
Mikeyodinson,area-52,952,shaman,restoration,24,10,14
Bruhh,stormscale,951,shaman,restoration,18,10,8
Soulmiracle,tichondrius,951,shaman,restoration,24,10,14
Dinaliia,lothar,937,shaman,restoration,24,10,14
Anttoekneeoh,thrall,933,shaman,restoration,18,10,8
Boppshock,tichondrius,928,shaman,restoration,16,11,5
Tokuma,illidan,927,shaman,restoration,23,10,13
Héadshot,bleeding-hollow,926,shaman,restoration,29,10,19
Roostershama,tichondrius,925,shaman,restoration,20,11,9
Luto,tichondrius,924,shaman,restoration,25,11,14
Psilocypher,nazjatar,923,shaman,restoration,18,11,7
Klev,frostmourne,921,shaman,restoration,33,12,21
Eekumbokum,bleeding-hollow,917,shaman,restoration,20,11,9
Ragerax,trollbane,911,shaman,restoration,17,12,5
Krolii,tichondrius,904,shaman,restoration,27,10,17
Haether,madoran,902,shaman,restoration,23,10,13
Alestorm,nemesis,899,shaman,restoration,28,12,16
Holdmytotum,tichondrius,895,shaman,restoration,17,10,7
Swifteyy,area-52,883,shaman,restoration,22,10,12
Daddyk,gnomeregan,878,shaman,restoration,13,10,3
Sàuron,tichondrius,874,shaman,restoration,19,10,9
Dogecoincäsh,sargeras,872,shaman,restoration,25,14,11
Èmaxx,barthilas,864,shaman,restoration,12,9,3
Jìmmybuckets,tichondrius,864,shaman,restoration,12,9,3
Seiunsky,area-52,864,shaman,restoration,12,9,3
Orochishaman,stormrage,864,shaman,restoration,12,9,3
Washedupty,illidan,864,shaman,restoration,12,9,3
Yungtooth,emerald-dream,864,shaman,restoration,18,9,9
Kromgul,malfurion,864,shaman,restoration,18,9,9
Sweetpotatoe,malganis,864,shaman,restoration,18,9,9
Scroogz,emerald-dream,864,shaman,restoration,18,9,9
Polarities,malganis,864,shaman,restoration,24,9,15
Wildmaster,ragnaros,864,shaman,restoration,30,9,21
Køre,tichondrius,863,shaman,restoration,12,9,3
Ryeqt,illidan,863,shaman,restoration,18,9,9
Bearmanshrek,tichondrius,863,shaman,restoration,18,9,9
Snoff,burning-blade,863,shaman,restoration,18,9,9
Darcheros,quelthalas,863,shaman,restoration,18,9,9
Jnzz,area-52,863,shaman,restoration,18,9,9
Neosham,frostwolf,863,shaman,restoration,24,9,15
Gangzmmsk,tichondrius,862,shaman,restoration,12,9,3
Drekkhal,area-52,862,shaman,restoration,18,9,9
Bigdictuna,sargeras,862,shaman,restoration,18,9,9
Turtleinmud,frostmourne,862,shaman,restoration,18,9,9
Erthshawk,wildhammer,862,shaman,restoration,18,9,9
Vywolf,frostmourne,862,shaman,restoration,27,11,16
Esanim,tichondrius,860,shaman,restoration,18,9,9
Overcåst,barthilas,860,shaman,restoration,30,9,21
Alraxion,ragnaros,859,shaman,restoration,18,9,9
Wagesisdeath,illidan,859,shaman,restoration,24,9,15
Blois,thunderlord,857,shaman,restoration,18,9,9
Yakella,trollbane,854,shaman,restoration,12,9,3
Mtnju,eredar,852,shaman,restoration,18,9,9
Dabmarinø,tichondrius,850,shaman,restoration,18,9,9
Ayahuassca,illidan,847,shaman,restoration,44,19,25
Rastablaze,darkspear,846,shaman,restoration,41,11,30
Spampurge,blackwing-lair,841,shaman,restoration,25,11,14
Dreadxtotems,illidan,830,shaman,restoration,17,9,8
Deadlyshocks,gilneas,827,shaman,restoration,35,17,18
Angelbie,tichondrius,815,shaman,restoration,15,10,5
Synkrona,tichondrius,810,shaman,restoration,29,11,18
Shamadran,hyjal,794,shaman,restoration,17,9,8
Hoong,garrosh,792,shaman,restoration,20,9,11
Shxl,zuljin,768,shaman,restoration,12,8,4
Xannysnapper,zuljin,768,shaman,restoration,12,8,4
Chairstain,kelthuzad,768,shaman,restoration,12,8,4
Animus,dark-iron,768,shaman,restoration,12,8,4
Multran,stormscale,768,shaman,restoration,12,8,4
Breadx,khaz-modan,768,shaman,restoration,12,8,4
Damoclez,jubeithos,768,shaman,restoration,12,8,4
Bóòchainz,tichondrius,768,shaman,restoration,12,8,4
Hexistential,tichondrius,768,shaman,restoration,12,8,4
Kensyz,tichondrius,768,shaman,restoration,12,8,4
Coreygunz,illidan,768,shaman,restoration,12,8,4
Rookieshaman,tichondrius,768,shaman,restoration,12,8,4
Ggdumpy,tichondrius,768,shaman,restoration,12,8,4
Sin,bleeding-hollow,768,shaman,restoration,12,8,4
Booramz,tichondrius,768,shaman,restoration,12,8,4
Jazzlightnin,tichondrius,768,shaman,restoration,18,8,10
Songo,frostmane,768,shaman,restoration,18,8,10
Wolvez,tichondrius,768,shaman,restoration,18,8,10
Toastjr,frostmourne,768,shaman,restoration,18,8,10
Gorillox,chogall,768,shaman,restoration,18,8,10
Taronì,zuljin,768,shaman,restoration,18,8,10
Goranzo,emerald-dream,768,shaman,restoration,18,8,10
Pingatronx,ragnaros,768,shaman,restoration,18,8,10
Mistarklean,malganis,768,shaman,restoration,24,8,16
Klimax,tichondrius,767,shaman,restoration,12,8,4
Veeve,kelthuzad,767,shaman,restoration,12,8,4
Totemism,warsong,767,shaman,restoration,12,8,4
Squirtrussel,boulderfist,767,shaman,restoration,12,8,4
Kabasan,illidan,767,shaman,restoration,18,8,10
Zombaschamy,ragnaros,767,shaman,restoration,18,8,10
Badgeshock,area-52,767,shaman,restoration,18,8,10
Agrîm,tichondrius,767,shaman,restoration,24,8,16
Skylet,azralon,766,shaman,restoration,18,8,10
Tákhisis,darkspear,766,shaman,restoration,18,8,10
Magatotem,sargeras,766,shaman,restoration,24,8,16
Angron,barthilas,765,shaman,restoration,12,8,4
Darrann,kiljaeden,765,shaman,restoration,12,8,4
ßøn,altar-of-storms,762,shaman,restoration,12,8,4
Faegle,area-52,757,shaman,restoration,18,8,10
Getpurged,thrall,751,shaman,restoration,17,8,9
Shubba,thrall,747,shaman,restoration,12,8,4
Treris,bleeding-hollow,719,shaman,restoration,11,8,3
Notragii,kelthuzad,719,shaman,restoration,17,8,9
Immabòt,tichondrius,719,shaman,restoration,17,8,9
Shocksauce,tichondrius,714,shaman,restoration,23,11,12
Luxiaa,tichondrius,714,shaman,restoration,23,9,14
Trouvaille,tichondrius,714,shaman,restoration,25,9,16
Kencyzz,tichondrius,703,shaman,restoration,11,8,3
Xinz,guldan,703,shaman,restoration,11,8,3
Garbagedump,burning-legion,703,shaman,restoration,14,8,6
Thuntard,bleeding-hollow,672,shaman,restoration,12,7,5
Restosêxual,tichondrius,672,shaman,restoration,12,7,5
Cruelface,sargeras,672,shaman,restoration,12,7,5
Magma,spirestone,672,shaman,restoration,12,7,5
Sorgal,area-52,672,shaman,restoration,12,7,5
Crakmane,kelthuzad,672,shaman,restoration,12,7,5
Gornu,nemesis,672,shaman,restoration,12,7,5
Dadbar,tichondrius,672,shaman,restoration,12,7,5
Elîas,tichondrius,672,shaman,restoration,12,7,5
Cardïß,tichondrius,672,shaman,restoration,12,7,5
Kencyi,tichondrius,672,shaman,restoration,12,7,5
Symbox,tichondrius,672,shaman,restoration,12,7,5
Specifyz,arathor,672,shaman,restoration,12,7,5
Girthquake,agamaggan,672,shaman,restoration,12,7,5
Colterr,thunderhorn,672,shaman,restoration,12,7,5
Dizzyswift,tichondrius,672,shaman,restoration,12,7,5
Raxshock,stormrage,672,shaman,restoration,12,7,5
Flexexpress,stormrage,672,shaman,restoration,12,7,5
Privxd,bleeding-hollow,672,shaman,restoration,12,7,5
Santiagodx,ragnaros,672,shaman,restoration,12,7,5
Mastrionilol,dragonmaw,672,shaman,restoration,18,7,11
Brainal,sargeras,672,shaman,restoration,18,7,11
Chessyc,ragnaros,672,shaman,restoration,18,7,11
Squimbert,tichondrius,672,shaman,restoration,18,7,11
Improvize,malganis,672,shaman,restoration,18,7,11
Chlckenx,tichondrius,672,shaman,restoration,18,7,11
Nosekandyz,chogall,672,shaman,restoration,18,7,11
Keybordternr,tichondrius,672,shaman,restoration,18,7,11
Dawnyshock,arygos,672,shaman,restoration,24,7,17
Lurue,tichondrius,671,shaman,restoration,12,7,5
Chitoss,gorgonnash,671,shaman,restoration,12,7,5
Pakdis,sargeras,671,shaman,restoration,12,7,5
Shaokhang,emerald-dream,671,shaman,restoration,18,7,11
Hamshamwitch,shadowmoon,671,shaman,restoration,18,7,11
Kwzy,stormrage,671,shaman,restoration,18,7,11
Caobuloso,azralon,671,shaman,restoration,18,7,11
Lvcianrs,thrall,671,shaman,restoration,18,7,11
Crynoobs,senjin,670,shaman,restoration,12,7,5
Mengemort,crushridge,670,shaman,restoration,12,7,5
Kunio,proudmoore,670,shaman,restoration,12,7,5
Bethorá,suramar,670,shaman,restoration,12,7,5
Shamanastic,tichondrius,670,shaman,restoration,12,7,5
Stormcallerr,sargeras,670,shaman,restoration,12,7,5
Totori,stormscale,670,shaman,restoration,12,7,5
Genjuu,proudmoore,670,shaman,restoration,18,7,11
Lechaman,hakkar,670,shaman,restoration,30,7,23
Vulkova,illidan,669,shaman,restoration,18,7,11
Cameltotêm,frostmourne,666,shaman,restoration,12,7,5
Lfhotmoms,moon-guard,665,shaman,restoration,11,9,2
Ruadhri,moon-guard,665,shaman,restoration,12,7,5
Superchunk,shattered-hand,661,shaman,restoration,12,7,5
Slothstorm,barthilas,657,shaman,restoration,23,10,13
Springtide,thrall,639,shaman,restoration,11,7,4
Tawahka,hyjal,638,shaman,restoration,20,8,12
Oceangrown,emerald-dream,623,shaman,restoration,11,7,4
Deacoderz,area-52,618,shaman,restoration,14,8,6
Matrìx,sargeras,594,shaman,restoration,26,8,18
Kaaying,tichondrius,592,shaman,restoration,19,7,12
Onpoint,frostmourne,591,shaman,restoration,11,7,4
Yoshìmìtsu,illidan,576,shaman,restoration,6,6,0
Gödöfbüdå,tichondrius,576,shaman,restoration,6,6,0
Kassix,illidan,576,shaman,restoration,6,6,0
Diulama,tichondrius,576,shaman,restoration,6,6,0
Pangniu,illidan,576,shaman,restoration,6,6,0
Jordnöt,moon-guard,576,shaman,restoration,9,6,3
Ggezlmao,bleeding-hollow,576,shaman,restoration,12,6,6
Szeav,tichondrius,576,shaman,restoration,12,6,6
Atsukaia,tichondrius,576,shaman,restoration,12,6,6
Pex,sargeras,576,shaman,restoration,12,6,6
Ccmeifbald,moon-guard,576,shaman,restoration,12,6,6
Ataia,tichondrius,576,shaman,restoration,12,6,6
Bigdampurge,illidan,576,shaman,restoration,12,6,6
Lunds,tichondrius,576,shaman,restoration,12,6,6
Xenvale,illidan,576,shaman,restoration,12,6,6
Weqeqwqwqex,ragnaros,576,shaman,restoration,12,6,6
Chocopuff,bleeding-hollow,576,shaman,restoration,12,6,6
Aespeon,stormrage,576,shaman,restoration,12,6,6
Medullarum,suramar,576,shaman,restoration,12,6,6
Motatos,malganis,576,shaman,restoration,12,6,6
Shamfold,illidan,576,shaman,restoration,12,6,6
Ryùko,proudmoore,576,shaman,restoration,12,6,6
Cencyzz,tichondrius,576,shaman,restoration,12,6,6
Icehole,kelthuzad,576,shaman,restoration,12,6,6
Chrigshock,black-dragonflight,576,shaman,restoration,12,6,6
Trewlolz,sargeras,576,shaman,restoration,12,6,6
Lamente,ragnaros,576,shaman,restoration,12,6,6
Potf,illidan,576,shaman,restoration,12,6,6
Nickwoper,emerald-dream,576,shaman,restoration,12,6,6
Fevolution,dreadmaul,576,shaman,restoration,12,6,6
Littleshasha,tichondrius,576,shaman,restoration,12,6,6
Ruupaul,kiljaeden,576,shaman,restoration,12,6,6
Conjunction,azjolnerub,576,shaman,restoration,12,6,6
Huroth,proudmoore,576,shaman,restoration,18,6,12
Kellogsz,malganis,576,shaman,restoration,18,6,12
Jukedlawl,illidan,576,shaman,restoration,18,6,12
Zeonard,ragnaros,576,shaman,restoration,18,6,12
Shampowl,jaedenar,576,shaman,restoration,20,6,14
Anußis,stormrage,576,shaman,restoration,24,6,18
Pushaheal,tichondrius,575,shaman,restoration,12,6,6
Fallhazard,malganis,575,shaman,restoration,12,6,6
Zqshaman,tichondrius,575,shaman,restoration,12,6,6
Redds,tichondrius,575,shaman,restoration,12,6,6
Ryuukas,illidan,575,shaman,restoration,12,6,6
Kisimi,proudmoore,575,shaman,restoration,12,6,6
Shockburst,dalaran,575,shaman,restoration,12,6,6
Toroph,azralon,575,shaman,restoration,12,6,6
Tagliatelle,kelthuzad,575,shaman,restoration,15,7,8
Numbreseven,frostmourne,575,shaman,restoration,14,6,8
Bearlysober,draka,575,shaman,restoration,18,6,12
Lokhtar,zuljin,574,shaman,restoration,12,6,6
Dodirt,laughing-skull,574,shaman,restoration,12,6,6
Kikahna,stormreaver,574,shaman,restoration,15,7,8
Kunshíí,bleeding-hollow,574,shaman,restoration,15,6,9
Tabby,emerald-dream,574,shaman,restoration,18,6,12
Twoflower,frostmourne,574,shaman,restoration,24,6,18
Shammystic,quelthalas,570,shaman,restoration,24,6,18
Gimlyman,madoran,567,shaman,restoration,12,6,6
Bloodmoôn,frostmourne,566,shaman,restoration,18,6,12
Ulala,azshara,559,shaman,restoration,32,10,22
Hazorele,nagrand,547,shaman,restoration,18,9,9
Hoghlinn,stormrage,541,shaman,restoration,8,7,1
Tsunamic,sargeras,528,shaman,restoration,15,6,9
Ttvfoxyllama,tichondrius,522,shaman,restoration,22,8,14
Warríed,sargeras,511,shaman,restoration,11,6,5
Tequíla,quelthalas,480,shaman,restoration,6,5,1
Naisayyds,tichondrius,480,shaman,restoration,6,5,1
Goobie,crushridge,480,shaman,restoration,6,5,1
Cantshear,zuljin,480,shaman,restoration,6,5,1
Lavamon,illidan,480,shaman,restoration,6,5,1
Dgshaman,tichondrius,480,shaman,restoration,6,5,1
Blueclass,akama,480,shaman,restoration,6,5,1
Oprawinfuryy,thrall,480,shaman,restoration,6,5,1
Çhïcagø,aegwynn,480,shaman,restoration,6,5,1
Blowurbubble,tichondrius,480,shaman,restoration,6,5,1
Bakenquake,tichondrius,480,shaman,restoration,6,5,1
Hexgodx,illidan,480,shaman,restoration,6,5,1
Owtyobwol,area-52,480,shaman,restoration,6,5,1
Nediar,tichondrius,480,shaman,restoration,6,5,1
Slm,bleeding-hollow,480,shaman,restoration,6,5,1
Montageb,illidan,480,shaman,restoration,9,6,3
Laodo,tichondrius,480,shaman,restoration,10,6,4
Totemfizzle,spirestone,480,shaman,restoration,12,5,7
Shakrakhan,tichondrius,480,shaman,restoration,12,5,7
Devastian,quelthalas,480,shaman,restoration,12,5,7
Astotems,tichondrius,480,shaman,restoration,12,5,7
Sâxman,stormreaver,480,shaman,restoration,12,5,7
Nøir,drakkari,480,shaman,restoration,12,5,7
Totemgoddess,nemesis,480,shaman,restoration,12,5,7
Earthentotem,tichondrius,480,shaman,restoration,12,5,7
Saviørkai,barthilas,480,shaman,restoration,12,5,7
Kwesy,tichondrius,480,shaman,restoration,12,5,7
Nagish,alexstrasza,480,shaman,restoration,12,5,7
Shämpäin,moon-guard,480,shaman,restoration,12,5,7
Jisthexx,senjin,480,shaman,restoration,12,5,7
Synkronaqt,tichondrius,480,shaman,restoration,12,5,7
Woodrose,frostmourne,480,shaman,restoration,12,5,7
Deathwards,frostmane,480,shaman,restoration,12,5,7
Azrlol,illidan,480,shaman,restoration,12,5,7
Boryndor,stormrage,480,shaman,restoration,12,5,7
Zingysham,tichondrius,480,shaman,restoration,12,5,7
Vegaslights,tichondrius,480,shaman,restoration,12,5,7
Maakasarg,tichondrius,480,shaman,restoration,12,5,7
Huulu,blades-edge,480,shaman,restoration,12,5,7
Juicypork,moon-guard,480,shaman,restoration,12,5,7
Shamankie,tichondrius,480,shaman,restoration,12,5,7
Deyodin,illidan,480,shaman,restoration,12,5,7
Baltarian,emerald-dream,480,shaman,restoration,12,5,7
Kakiscala,proudmoore,480,shaman,restoration,12,5,7
Ericzlassoz,tichondrius,480,shaman,restoration,12,5,7
Maserati,korialstrasz,480,shaman,restoration,12,5,7
Larvabust,azralon,480,shaman,restoration,12,5,7
Rugmat,tichondrius,480,shaman,restoration,12,5,7
Derbain,caelestrasz,480,shaman,restoration,12,5,7
Mvpstorm,darkspear,480,shaman,restoration,12,5,7
Weebzealot,kelthuzad,480,shaman,restoration,12,5,7
Sixtyninelol,thunderlord,480,shaman,restoration,12,5,7
Edisto,darkspear,480,shaman,restoration,12,5,7
Doop,kiljaeden,480,shaman,restoration,12,5,7
Thunderphury,proudmoore,480,shaman,restoration,18,5,13
Animac,bleeding-hollow,480,shaman,restoration,18,5,13
Laydboiyo,tichondrius,480,shaman,restoration,18,5,13
Rekashaki,illidan,480,shaman,restoration,18,5,13
Siyusm,illidan,480,shaman,restoration,24,5,19
Sâvage,zuljin,479,shaman,restoration,6,5,1
Greenberry,bonechewer,479,shaman,restoration,10,6,4
Beardedone,durotan,479,shaman,restoration,12,5,7
Fläkky,area-52,479,shaman,restoration,12,5,7
Highmountain,tichondrius,479,shaman,restoration,12,5,7
Tattoö,elune,479,shaman,restoration,12,5,7
Blkpowerfist,malganis,479,shaman,restoration,12,5,7
Nytestalker,sargeras,479,shaman,restoration,18,5,13
Amonamarth,tichondrius,478,shaman,restoration,12,5,7
Tharapita,bleeding-hollow,478,shaman,restoration,15,6,9
Dennwoop,sargeras,478,shaman,restoration,16,6,10
Stahlye,proudmoore,477,shaman,restoration,6,5,1
Uderlol,tichondrius,448,shaman,restoration,10,5,5
Akhae,duskwood,445,shaman,restoration,14,6,8
Lampstand,wildhammer,431,shaman,restoration,11,5,6
Hicys,azralon,425,shaman,restoration,8,8,0
Vogaz,ragnaros,416,shaman,restoration,16,5,11
Lebs,barthilas,415,shaman,restoration,8,5,3
Clapton,darkspear,400,shaman,restoration,19,5,14
Shamankofwa,tichondrius,384,shaman,restoration,6,4,2
Gulmuwu,zuljin,384,shaman,restoration,6,4,2
Balsonz,zuljin,384,shaman,restoration,6,4,2
Fluxxy,tichondrius,384,shaman,restoration,6,4,2
Éarl,sargeras,384,shaman,restoration,6,4,2
Kustum,tichondrius,384,shaman,restoration,6,4,2
Xillicit,sargeras,384,shaman,restoration,6,4,2
Sweatshirtz,tanaris,384,shaman,restoration,6,4,2
Thonty,sargeras,384,shaman,restoration,6,4,2
Murm,burning-blade,384,shaman,restoration,6,4,2
Glark,tichondrius,384,shaman,restoration,6,4,2
Smeeza,frostmourne,384,shaman,restoration,6,4,2
Sagester,illidan,384,shaman,restoration,6,4,2
Drfentanylx,emerald-dream,384,shaman,restoration,6,4,2
Cháningtotem,frostmourne,384,shaman,restoration,6,4,2
Jaegertotem,stormrage,384,shaman,restoration,6,4,2
Problamatic,tichondrius,384,shaman,restoration,6,4,2
Bakayarøu,tichondrius,384,shaman,restoration,6,4,2
Thormodin,destromath,384,shaman,restoration,6,4,2
Shamakazi,tichondrius,384,shaman,restoration,6,4,2
Awyiss,dreadmaul,384,shaman,restoration,6,4,2
Ârtík,tichondrius,384,shaman,restoration,6,4,2
Intravz,tichondrius,384,shaman,restoration,6,4,2
Nepshock,stormrage,384,shaman,restoration,6,4,2
Curador,nemesis,384,shaman,restoration,6,4,2
Viprus,nerzhul,384,shaman,restoration,6,4,2
Totempack,stormrage,384,shaman,restoration,6,4,2
Bigboorst,kelthuzad,384,shaman,restoration,6,4,2
Bhann,tichondrius,384,shaman,restoration,6,4,2
Zerwyn,senjin,384,shaman,restoration,6,4,2
Tisaa,tichondrius,384,shaman,restoration,6,4,2
Tarròò,bleeding-hollow,384,shaman,restoration,6,4,2
Teftx,area-52,384,shaman,restoration,6,4,2
Kimchimi,tichondrius,384,shaman,restoration,6,4,2
Shyva,frostmourne,384,shaman,restoration,6,4,2
Tpokes,sargeras,384,shaman,restoration,6,4,2
Healswin,sargeras,384,shaman,restoration,12,4,8
Bazinguinha,azralon,384,shaman,restoration,12,4,8
Kermut,frostmourne,384,shaman,restoration,12,4,8
Pjtremblay,frostmourne,384,shaman,restoration,12,4,8
Besylate,illidan,384,shaman,restoration,12,4,8
Cosmô,sargeras,384,shaman,restoration,12,4,8
Spiritwler,tichondrius,384,shaman,restoration,12,4,8
Ayev,illidan,384,shaman,restoration,12,4,8
Misakism,sargeras,384,shaman,restoration,12,4,8
Romcomx,tichondrius,384,shaman,restoration,12,4,8
Muscleyuan,tichondrius,384,shaman,restoration,12,4,8
Qitian,tichondrius,384,shaman,restoration,12,4,8
Galeswind,sargeras,384,shaman,restoration,12,4,8
Fluiid,tichondrius,384,shaman,restoration,12,4,8
Petzah,barthilas,384,shaman,restoration,12,4,8
Boyyo,maiev,384,shaman,restoration,12,4,8
Dawny,arygos,384,shaman,restoration,12,4,8
Taò,tichondrius,384,shaman,restoration,12,4,8
Evilabev,bonechewer,384,shaman,restoration,12,4,8
Milkstress,whisperwind,384,shaman,restoration,12,4,8
Santral,ragnaros,384,shaman,restoration,13,4,9
Dukaman,malganis,384,shaman,restoration,18,4,14
Bigripnow,sargeras,384,shaman,restoration,18,4,14
Conductivity,frostmourne,384,shaman,restoration,18,4,14
Hexnation,frostmourne,383,shaman,restoration,6,4,2
Syü,hyjal,383,shaman,restoration,6,4,2
Rikswordfire,wyrmrest-accord,383,shaman,restoration,12,4,8
Huugsnkissez,sargeras,383,shaman,restoration,12,4,8
Shockshow,zuljin,382,shaman,restoration,12,4,8
Doomgodx,tichondrius,382,shaman,restoration,12,4,8
Turbö,hyjal,382,shaman,restoration,12,4,8
Rainingheals,auchindoun,352,shaman,restoration,14,5,9
Shamanakin,emerald-dream,351,shaman,restoration,8,5,3
Koomrog,frostmourne,351,shaman,restoration,8,5,3
Moocatpie,illidan,351,shaman,restoration,11,4,7
Tineer,tichondrius,336,shaman,restoration,9,4,5
Hwyl,frostmourne,335,shaman,restoration,11,4,7
Avidas,malganis,331,shaman,restoration,15,4,11
Eloquent,emerald-dream,328,shaman,restoration,12,5,7
Msooli,tichondrius,319,shaman,restoration,5,4,1
Elevatezxo,stormrage,304,shaman,restoration,7,4,3
Kawixxi,ysondre,301,shaman,restoration,7,4,3
Kanntok,quelthalas,288,shaman,restoration,6,3,3
Megadabs,malganis,288,shaman,restoration,6,3,3
Turksham,tichondrius,288,shaman,restoration,6,3,3
Apathcat,the-forgotten-coast,288,shaman,restoration,6,3,3
Momolagbbit,tichondrius,288,shaman,restoration,6,3,3
Hexmix,muradin,288,shaman,restoration,6,3,3
Obrahma,burning-legion,288,shaman,restoration,6,3,3
Bombadil,korgath,288,shaman,restoration,6,3,3
Uggerz,barthilas,288,shaman,restoration,6,3,3
Nanishock,area-52,288,shaman,restoration,6,3,3
Shamjam,moon-guard,288,shaman,restoration,6,3,3
Laucian,malganis,288,shaman,restoration,6,3,3
Zinns,dalaran,288,shaman,restoration,6,3,3
Scadouche,korgath,288,shaman,restoration,6,3,3
Daggonet,sargeras,288,shaman,restoration,6,3,3
Mythruxx,sargeras,288,shaman,restoration,6,3,3
Samac,ravencrest,288,shaman,restoration,6,3,3
Sumdumshaman,illidan,288,shaman,restoration,6,3,3
Tigs,alleria,288,shaman,restoration,6,3,3
Naturasol,quelthalas,288,shaman,restoration,6,3,3
Wreckaholic,alterac-mountains,288,shaman,restoration,6,3,3
Ketaminedrip,illidan,288,shaman,restoration,6,3,3
Catnïp,maelstrom,288,shaman,restoration,6,3,3
Youngie,dathremar,288,shaman,restoration,6,3,3
Oilburner,malganis,288,shaman,restoration,6,3,3
Ajj,thrall,288,shaman,restoration,6,3,3
Bovinefever,kiljaeden,288,shaman,restoration,6,3,3
Fruityrudyy,area-52,288,shaman,restoration,6,3,3
Totumstroker,thrall,288,shaman,restoration,6,3,3
Taproots,ursin,288,shaman,restoration,6,3,3
Bigbadpercy,frostmourne,288,shaman,restoration,6,3,3
Spiritbb,area-52,288,shaman,restoration,6,3,3
Eleresto,tichondrius,288,shaman,restoration,6,3,3
Abev,bonechewer,288,shaman,restoration,6,3,3
Mudtide,tichondrius,288,shaman,restoration,6,3,3
Digglr,tichondrius,288,shaman,restoration,6,3,3
Millionvoltz,tichondrius,288,shaman,restoration,6,3,3
Skrubbles,bleeding-hollow,288,shaman,restoration,6,3,3
Sonsii,tichondrius,288,shaman,restoration,6,3,3
Yunqboichay,kelthuzad,288,shaman,restoration,6,3,3
Ixis,bleeding-hollow,288,shaman,restoration,6,3,3
Zoltide,sargeras,288,shaman,restoration,6,3,3
Vernzi,laughing-skull,288,shaman,restoration,6,3,3
Cloudsh,silvermoon,288,shaman,restoration,6,3,3
Hannamayzing,arathor,288,shaman,restoration,6,3,3
Ñoobshaman,tichondrius,288,shaman,restoration,6,3,3
Sreve,malganis,288,shaman,restoration,6,3,3
Restoele,tichondrius,288,shaman,restoration,6,3,3
Jîneth,tichondrius,288,shaman,restoration,6,3,3
Voron,kiljaeden,288,shaman,restoration,6,3,3
Wastedlink,tichondrius,288,shaman,restoration,6,3,3
Shearx,illidan,288,shaman,restoration,6,3,3
Slimshämmy,area-52,288,shaman,restoration,6,3,3
Meanbetty,illidan,288,shaman,restoration,6,3,3
Akupapu,illidan,288,shaman,restoration,6,3,3
Sliccricc,doomhammer,288,shaman,restoration,6,3,3
Spencêrf,illidan,288,shaman,restoration,6,3,3
Shamanese,emerald-dream,288,shaman,restoration,6,3,3
Cloudycloud,tichondrius,288,shaman,restoration,6,3,3
Slëvin,frostmourne,288,shaman,restoration,6,3,3
Gattious,illidan,288,shaman,restoration,6,3,3
Porkbrains,emerald-dream,288,shaman,restoration,10,4,6
Ragnarüz,ragnaros,288,shaman,restoration,13,4,9
Rebelutioni,lothar,288,shaman,restoration,11,3,8
Galarix,nerzhul,288,shaman,restoration,12,3,9
Scion,thaurissan,288,shaman,restoration,12,3,9
Sooweecide,tichondrius,288,shaman,restoration,12,3,9
Chocobomb,burning-blade,288,shaman,restoration,12,3,9
Mochomò,ragnaros,288,shaman,restoration,12,3,9
Meatyball,tichondrius,288,shaman,restoration,12,3,9
Possessing,illidan,288,shaman,restoration,12,3,9
Zéwel,tichondrius,288,shaman,restoration,12,3,9
Showkinho,azralon,288,shaman,restoration,12,3,9
Dragum,blackrock,288,shaman,restoration,12,3,9
Trysts,wyrmrest-accord,288,shaman,restoration,12,3,9
Alphamael,lightbringer,288,shaman,restoration,13,3,10
Chablez,shattered-hand,287,shaman,restoration,6,3,3
Trovac,azralon,287,shaman,restoration,6,3,3
Churgarm,zuljin,287,shaman,restoration,12,3,9
Aureal,malganis,282,shaman,restoration,10,6,4
Tarlonygg,malganis,281,shaman,restoration,15,6,9
Polared,hyjal,256,shaman,restoration,10,3,7
Hilung,lightnings-blade,255,shaman,restoration,11,3,8
Glocksitotem,malganis,240,shaman,restoration,9,3,6
Lickerman,stormreaver,239,shaman,restoration,5,3,2
Shamyshame,quelthalas,234,shaman,restoration,6,4,2
Circuits,malganis,234,shaman,restoration,11,5,6
Kencysz,tichondrius,234,shaman,restoration,11,4,7
Shamanbini,tichondrius,192,shaman,restoration,4,3,1
Yoloswage,tichondrius,192,shaman,restoration,9,3,6
Linkandwink,nerzhul,192,shaman,restoration,6,2,4
Óompaloompa,frostmourne,192,shaman,restoration,6,2,4
Kupnicki,zuljin,192,shaman,restoration,6,2,4
Huukron,emerald-dream,192,shaman,restoration,6,2,4
Relâx,icecrown,192,shaman,restoration,6,2,4
Jimmybutler,tichondrius,192,shaman,restoration,6,2,4
Chainandrain,frostmourne,192,shaman,restoration,6,2,4
Thunderfucj,tichondrius,192,shaman,restoration,6,2,4
Sphaerus,tichondrius,192,shaman,restoration,6,2,4
Ara,zuljin,192,shaman,restoration,6,2,4
Duality,shattered-halls,192,shaman,restoration,6,2,4
Texmawave,moon-guard,192,shaman,restoration,6,2,4
Bloodlustxo,frostmourne,192,shaman,restoration,6,2,4
Twistër,illidan,192,shaman,restoration,6,2,4
Waterspinach,tichondrius,192,shaman,restoration,6,2,4
Tremór,frostmourne,192,shaman,restoration,6,2,4
Ioki,spirestone,192,shaman,restoration,6,2,4
Eatmymeatbal,illidan,192,shaman,restoration,6,2,4
Plutoshaker,tichondrius,192,shaman,restoration,6,2,4
Zhangyider,illidan,192,shaman,restoration,6,2,4
Dabrat,lightnings-blade,192,shaman,restoration,6,2,4
Keldara,aerie-peak,192,shaman,restoration,6,2,4
Wasiri,illidan,192,shaman,restoration,6,2,4
Timbosteve,thrall,192,shaman,restoration,6,2,4
Amdshaman,thrall,192,shaman,restoration,6,2,4
Applicable,tichondrius,192,shaman,restoration,6,2,4
Handzum,blades-edge,192,shaman,restoration,6,2,4
Lolcàt,tichondrius,192,shaman,restoration,6,2,4
Eccentrix,mannoroth,192,shaman,restoration,6,2,4
Raxxom,tichondrius,192,shaman,restoration,6,2,4
Hefestos,nemesis,192,shaman,restoration,6,2,4
Thundertusks,norgannon,192,shaman,restoration,6,2,4
Xoweeknd,stormrage,192,shaman,restoration,6,2,4
Shazik,spirestone,192,shaman,restoration,6,2,4
Dallìa,tichondrius,192,shaman,restoration,6,2,4
Yngvii,tichondrius,192,shaman,restoration,6,2,4
Flubydont,icecrown,192,shaman,restoration,6,2,4
Notviscent,illidan,192,shaman,restoration,6,2,4
Bitruff,tichondrius,192,shaman,restoration,6,2,4
Purpose,nerzhul,192,shaman,restoration,6,2,4
Nottoshammy,dalaran,192,shaman,restoration,6,2,4
Ituma,tichondrius,192,shaman,restoration,6,2,4
Macdab,malganis,192,shaman,restoration,6,2,4
Lollzerz,the-forgotten-coast,192,shaman,restoration,6,2,4
Julíp,tichondrius,192,shaman,restoration,6,2,4
Umadilia,area-52,192,shaman,restoration,6,2,4
Zâppý,stormrage,192,shaman,restoration,6,2,4
Oomme,area-52,192,shaman,restoration,6,2,4
Krisu,kelthuzad,192,shaman,restoration,6,2,4
Shäman,anetheron,192,shaman,restoration,6,2,4
Sid,frostmourne,192,shaman,restoration,6,2,4
Flamehorns,malganis,192,shaman,restoration,6,2,4
Aderra,garrosh,192,shaman,restoration,6,2,4
Juraf,malganis,192,shaman,restoration,6,2,4
Drünk,hyjal,192,shaman,restoration,6,2,4
Daintydan,illidan,192,shaman,restoration,6,2,4
Gwenstifani,sargeras,192,shaman,restoration,6,2,4
Sannyasin,azralon,192,shaman,restoration,6,2,4
Shamiggels,sargeras,192,shaman,restoration,6,2,4
Konga,korialstrasz,192,shaman,restoration,6,2,4
Lequandarius,sargeras,192,shaman,restoration,6,2,4
Kitanoo,kiljaeden,192,shaman,restoration,12,2,10
Pýe,bleeding-hollow,192,shaman,restoration,12,2,10
Kayadee,stormrage,192,shaman,restoration,12,2,10
Soomer,frostmourne,192,shaman,restoration,12,2,10
Bizzy,black-dragonflight,192,shaman,restoration,12,2,10
Monchsham,area-52,192,shaman,restoration,13,2,11
Shockbot,stormscale,192,shaman,restoration,18,2,16
Vazan,arthas,191,shaman,restoration,6,2,4
Malsturm,stormrage,191,shaman,restoration,6,2,4
Fóurelements,malganis,191,shaman,restoration,6,2,4
Oninobu,sargeras,128,shaman,restoration,4,2,2
Nagiska,ragnaros,112,shaman,restoration,7,2,5
Hueymagoo,firetree,112,shaman,restoration,13,2,11
Jbahr,hyjal,96,shaman,restoration,3,2,1
Galiffa,area-52,96,shaman,restoration,6,1,5
Bootsix,area-52,96,shaman,restoration,6,1,5
Meshugga,scarlet-crusade,96,shaman,restoration,6,1,5
Shamnnoodlez,area-52,96,shaman,restoration,6,1,5
Ogeez,area-52,96,shaman,restoration,6,1,5
Shamoover,kelthuzad,96,shaman,restoration,6,1,5
Tchamí,blackrock,96,shaman,restoration,6,1,5
Dodey,malganis,96,shaman,restoration,6,1,5
Average,bonechewer,96,shaman,restoration,6,1,5
Pootergash,shadowmoon,96,shaman,restoration,6,1,5
Teathin,ragnaros,96,shaman,restoration,6,1,5
Billydreams,drakkari,96,shaman,restoration,6,1,5
Twizzhurp,bleeding-hollow,96,shaman,restoration,6,1,5
Papatooties,tichondrius,96,shaman,restoration,6,1,5
Restoz,thrall,96,shaman,restoration,6,1,5
Cluffatty,tichondrius,96,shaman,restoration,6,1,5
Iightning,frostwolf,96,shaman,restoration,6,1,5
Célty,moon-guard,96,shaman,restoration,6,1,5
Dasckisham,area-52,96,shaman,restoration,6,1,5
Mcwindyfists,zuljin,96,shaman,restoration,6,1,5
Dùffman,jubeithos,96,shaman,restoration,6,1,5
Sshhammann,tichondrius,96,shaman,restoration,6,1,5
Goresx,tichondrius,96,shaman,restoration,6,1,5
Finnaburstt,tichondrius,96,shaman,restoration,6,1,5
Dókki,tichondrius,96,shaman,restoration,6,1,5
Thenewsherek,maelstrom,96,shaman,restoration,6,1,5
Finark,tichondrius,96,shaman,restoration,7,1,6
Tinytiddies,chogall,96,shaman,restoration,12,1,11
Meatlog,dalaran,96,shaman,restoration,12,1,11
Njolmir,khazgoroth,96,shaman,restoration,12,1,11
Tehbeast,khadgar,96,shaman,restoration,12,1,11
Edemental,area-52,96,shaman,restoration,12,1,11
Hexpert,firetree,96,shaman,restoration,12,1,11
Interwebzz,tichondrius,95,shaman,restoration,18,1,17
Dirtyshammy,mugthol,79,shaman,restoration,11,1,10
Ryforges,frostmourne,63,shaman,restoration,2,2,0
Annöying,ysera,42,shaman,restoration,6,2,4
Darkn,cenarion-circle,31,shaman,restoration,2,1,1
Cashe,kiljaeden,2368,shaman,elemental,126,80,46
Thegloc,illidan,2168,shaman,elemental,59,36,23
Crøwgød,tichondrius,2152,shaman,elemental,73,46,27
Jimmysporty,malganis,2135,shaman,elemental,84,43,41
Jgmbs,dalaran,2134,shaman,elemental,106,64,42
Hitzz,malganis,2127,shaman,elemental,78,49,29
Iavalash,bleeding-hollow,2125,shaman,elemental,142,74,68
Isdozzy,tichondrius,2090,shaman,elemental,59,36,23
Manofsand,drenden,2087,shaman,elemental,95,54,41
Ranjeesh,frostmourne,2070,shaman,elemental,108,61,47
Jeasham,malganis,2047,shaman,elemental,89,46,43
Meatbeaterx,aggramar,2038,shaman,elemental,42,26,16
Bøøgaa,proudmoore,2038,shaman,elemental,65,37,28
Trenzix,sargeras,2009,shaman,elemental,112,59,53
Bronzer,tichondrius,2008,shaman,elemental,43,31,12
Bakenquake,tichondrius,1947,shaman,elemental,92,48,44
Hollowbaby,tichondrius,1938,shaman,elemental,42,29,13
Kaandel,azralon,1931,shaman,elemental,78,35,43
Ultron,deathwing,1890,shaman,elemental,143,74,69
Sasageyo,tichondrius,1863,shaman,elemental,46,30,16
Lardaz,darkspear,1859,shaman,elemental,42,24,18
Itzgucci,illidan,1853,shaman,elemental,51,31,20
Chemjenn,korgath,1838,shaman,elemental,84,37,47
Gaymakaí,sargeras,1828,shaman,elemental,48,27,21
Molerat,illidan,1821,shaman,elemental,104,47,57
Notbpage,burning-blade,1809,shaman,elemental,72,40,32
Tisaa,tichondrius,1807,shaman,elemental,42,19,23
Elefusion,sargeras,1806,shaman,elemental,36,22,14
Swigadee,tichondrius,1806,shaman,elemental,72,33,39
Safeword,nesingwary,1803,shaman,elemental,44,27,17
Nonomori,frostmourne,1802,shaman,elemental,48,30,18
Torchic,drakkari,1801,shaman,elemental,60,31,29
Monkeysham,dathremar,1800,shaman,elemental,48,30,18
Utilitytotem,moon-guard,1800,shaman,elemental,102,56,46
Chunchünmaru,area-52,1793,shaman,elemental,53,28,25
Soyboyxxo,barthilas,1793,shaman,elemental,65,34,31
Makazar,tichondrius,1792,shaman,elemental,36,21,15
Matikz,boulderfist,1791,shaman,elemental,100,54,46
Zqsyyds,illidan,1770,shaman,elemental,35,19,16
Detonations,tichondrius,1765,shaman,elemental,30,20,10
Møp,spirestone,1764,shaman,elemental,48,30,18
Hotdogwaterx,tichondrius,1760,shaman,elemental,48,33,15
Ãmg,tichondrius,1751,shaman,elemental,30,22,8
Brezel,azralon,1740,shaman,elemental,42,27,15
Yejinok,tichondrius,1735,shaman,elemental,36,22,14
Hexistential,tichondrius,1731,shaman,elemental,34,26,8
Uglymuger,tichondrius,1730,shaman,elemental,62,30,32
Skkarz,malganis,1728,shaman,elemental,30,21,9
Bronzers,tichondrius,1723,shaman,elemental,30,18,12
Apyôn,tichondrius,1719,shaman,elemental,42,24,18
Ayumihamasai,tichondrius,1710,shaman,elemental,54,30,24
Notahappyone,area-52,1703,shaman,elemental,48,34,14
Mytotemisbig,lothar,1694,shaman,elemental,59,38,21
Emppege,tichondrius,1691,shaman,elemental,51,24,27
Taranís,sargeras,1689,shaman,elemental,36,18,18
Sonire,tichondrius,1684,shaman,elemental,108,51,57
Snookìe,sargeras,1681,shaman,elemental,42,20,22
Deckìn,proudmoore,1659,shaman,elemental,94,52,42
Dyxlol,tichondrius,1652,shaman,elemental,56,25,31
Thaelia,azgalor,1650,shaman,elemental,40,23,17
Hexzy,moon-guard,1645,shaman,elemental,47,23,24
Shockisha,sisters-of-elune,1644,shaman,elemental,52,23,29
Streetmeat,crushridge,1642,shaman,elemental,61,32,29
Gangstà,stormrage,1633,shaman,elemental,36,18,18
Dampenedxx,bleeding-hollow,1631,shaman,elemental,42,22,20
Meatbeaterx,bleeding-hollow,1630,shaman,elemental,30,17,13
Fiftybeers,frostmourne,1627,shaman,elemental,35,19,16
Orksham,tichondrius,1624,shaman,elemental,36,17,19
Buju,bleeding-hollow,1618,shaman,elemental,48,30,18
Loxshox,gnomeregan,1617,shaman,elemental,104,54,50
Illmental,kelthuzad,1616,shaman,elemental,58,29,29
Mulak,frostmourne,1616,shaman,elemental,110,54,56
Donkeyteeth,bleeding-hollow,1612,shaman,elemental,24,17,7
Juicébox,tichondrius,1612,shaman,elemental,30,17,13
Thündermoose,tichondrius,1608,shaman,elemental,42,21,21
Jaimenohex,illidan,1603,shaman,elemental,36,19,17
Imnumberl,sargeras,1602,shaman,elemental,66,44,22
Opaltsing,tichondrius,1601,shaman,elemental,39,19,20
Zipzsham,maiev,1599,shaman,elemental,27,22,5
Reckfulq,proudmoore,1599,shaman,elemental,24,17,7
Igotu,tichondrius,1595,shaman,elemental,30,17,13
Smoketide,stormrage,1595,shaman,elemental,41,18,23
Mackq,tichondrius,1593,shaman,elemental,43,20,23
Tulol,tichondrius,1579,shaman,elemental,84,38,46
Powerdown,blackrock,1577,shaman,elemental,35,17,18
Washedupty,illidan,1560,shaman,elemental,78,39,39
Tuntar,ragnaros,1557,shaman,elemental,60,34,26
Climhazard,senjin,1555,shaman,elemental,36,18,18
Ssjgreen,illidan,1550,shaman,elemental,30,17,13
Doodleburger,dathremar,1545,shaman,elemental,50,41,9
Billycool,tichondrius,1535,shaman,elemental,24,16,8
Kawj,eonar,1535,shaman,elemental,24,16,8
Óompaloompa,frostmourne,1534,shaman,elemental,30,18,12
Harrypotqueu,zuljin,1527,shaman,elemental,30,16,14
Carondes,proudmoore,1524,shaman,elemental,30,16,14
Draghul,frostwolf,1520,shaman,elemental,41,23,18
Billydreams,drakkari,1507,shaman,elemental,77,31,46
Hadèes,zuljin,1506,shaman,elemental,78,36,42
Zap,wyrmrest-accord,1504,shaman,elemental,30,16,14
Zeylhe,proudmoore,1502,shaman,elemental,36,16,20
Soulrak,tichondrius,1499,shaman,elemental,42,19,23
Cyhren,illidan,1487,shaman,elemental,30,16,14
Huskër,tichondrius,1483,shaman,elemental,58,35,23
Gloi,ragnaros,1481,shaman,elemental,31,19,12
Joehogan,stormrage,1463,shaman,elemental,61,37,24
Zugzugthug,moon-guard,1449,shaman,elemental,35,22,13
Sweatshock,frostmourne,1446,shaman,elemental,36,22,14
Shampainn,demon-soul,1445,shaman,elemental,42,24,18
Osev,stormrage,1438,shaman,elemental,24,15,9
Biberom,kelthuzad,1434,shaman,elemental,57,32,25
Sleepysham,kelthuzad,1430,shaman,elemental,30,15,15
Shockay,tichondrius,1429,shaman,elemental,38,16,22
Gumballin,sargeras,1421,shaman,elemental,76,37,39
Flüke,tichondrius,1417,shaman,elemental,30,15,15
Chajaa,ragnaros,1415,shaman,elemental,30,15,15
Dumpweed,stormscale,1413,shaman,elemental,42,21,21
Malrom,kelthuzad,1409,shaman,elemental,115,63,52
Mhaal,wyrmrest-accord,1392,shaman,elemental,68,29,39
Liloggie,illidan,1385,shaman,elemental,23,15,8
Elementàlius,quelthalas,1383,shaman,elemental,23,15,8
Ceedlamb,kelthuzad,1381,shaman,elemental,66,34,32
Zechary,proudmoore,1372,shaman,elemental,48,19,29
Hurky,sargeras,1369,shaman,elemental,55,29,26
Ekstasiel,azralon,1362,shaman,elemental,42,23,19
Clapton,darkspear,1361,shaman,elemental,35,15,20
Saraguthix,dalaran,1357,shaman,elemental,36,15,21
Evilraven,tichondrius,1353,shaman,elemental,113,50,63
Conductivity,frostmourne,1351,shaman,elemental,30,15,15
Hufflefluffs,kiljaeden,1349,shaman,elemental,32,18,14
Hexecute,tichondrius,1344,shaman,elemental,24,14,10
Morluné,tichondrius,1343,shaman,elemental,33,16,17
Telain,quelthalas,1340,shaman,elemental,42,20,22
Scherzer,frostwolf,1340,shaman,elemental,30,14,16
Zugzugdogg,destromath,1339,shaman,elemental,24,14,10
Illbuyurmom,tichondrius,1333,shaman,elemental,31,14,17
Totem,burning-legion,1327,shaman,elemental,24,14,10
Jaapo,barthilas,1326,shaman,elemental,36,19,17
Luvstospooj,thaurissan,1325,shaman,elemental,49,21,28
Tenyks,tichondrius,1305,shaman,elemental,28,15,13
Hueymagoo,firetree,1295,shaman,elemental,24,14,10
Orkuss,illidan,1281,shaman,elemental,23,14,9
Johnsju,sargeras,1278,shaman,elemental,28,14,14
Cptnmagma,bleeding-hollow,1271,shaman,elemental,48,23,25
Shamanzinh,azralon,1260,shaman,elemental,30,16,14
Scaman,tichondrius,1248,shaman,elemental,24,13,11
Robot,illidan,1248,shaman,elemental,24,13,11
Hecstacy,dalaran,1245,shaman,elemental,18,13,5
Zhokal,quelthalas,1245,shaman,elemental,71,41,30
Tyar,area-52,1242,shaman,elemental,21,14,7
Taxd,sargeras,1242,shaman,elemental,24,13,11
Clarix,quelthalas,1241,shaman,elemental,24,13,11
Edenorion,ragnaros,1238,shaman,elemental,40,20,20
Indika,stormrage,1234,shaman,elemental,24,13,11
Øten,area-52,1214,shaman,elemental,30,20,10
Beerofdoom,proudmoore,1214,shaman,elemental,30,15,15
Yasuriyamile,illidan,1214,shaman,elemental,48,19,29
Moacmathi,quelthalas,1210,shaman,elemental,42,16,26
Rafiki,haomarush,1196,shaman,elemental,36,14,22
Forgediniron,stormrage,1195,shaman,elemental,36,17,19
Firecracker,warsong,1179,shaman,elemental,45,27,18
Vkzz,sargeras,1167,shaman,elemental,31,13,18
Rolltìde,tichondrius,1163,shaman,elemental,45,24,21
Zoeytur,sargeras,1152,shaman,elemental,24,12,12
Joedna,tichondrius,1151,shaman,elemental,24,12,12
Kang,terenas,1150,shaman,elemental,18,12,6
Smiteums,sargeras,1150,shaman,elemental,24,12,12
Setò,quelthalas,1149,shaman,elemental,18,12,6
Generators,area-52,1147,shaman,elemental,24,12,12
Shockazulu,vashj,1132,shaman,elemental,30,17,13
Shamanic,dunemaul,1125,shaman,elemental,47,18,29
Johnwilke,area-52,1123,shaman,elemental,43,17,26
Bravederp,kelthuzad,1120,shaman,elemental,63,31,32
Sshaman,tichondrius,1119,shaman,elemental,28,12,16
Rss,barthilas,1111,shaman,elemental,23,12,11
Yodahh,daggerspine,1110,shaman,elemental,24,13,11
Kumer,tichondrius,1099,shaman,elemental,17,12,5
Gahaa,tichondrius,1099,shaman,elemental,17,12,5
Lenin,nathrezim,1085,shaman,elemental,20,12,8
Gravygumdrop,tichondrius,1085,shaman,elemental,26,12,14
Topax,vashj,1083,shaman,elemental,17,12,5
Omnath,zuluhed,1083,shaman,elemental,35,19,16
Shammpain,barthilas,1074,shaman,elemental,35,19,16
Semasham,khazgoroth,1068,shaman,elemental,25,12,13
Saanrixa,jubeithos,1061,shaman,elemental,48,15,33
Petrafk,illidan,1056,shaman,elemental,18,11,7
Bestshamus,sargeras,1056,shaman,elemental,18,11,7
Miroen,tichondrius,1056,shaman,elemental,24,11,13
Highsteakss,tichondrius,1055,shaman,elemental,12,11,1
Bismarks,frostmourne,1055,shaman,elemental,18,11,7
Kymo,tichondrius,1055,shaman,elemental,18,11,7
Hexxás,bloodscalp,1055,shaman,elemental,21,12,9
Thuntard,bleeding-hollow,1055,shaman,elemental,24,11,13
Dtab,tichondrius,1054,shaman,elemental,18,11,7
Kigoros,bleeding-hollow,1054,shaman,elemental,18,11,7
Sumnah,sargeras,1054,shaman,elemental,42,22,20
Rollypolli,gnomeregan,1052,shaman,elemental,66,34,32
Taeilendar,ragnaros,1050,shaman,elemental,24,11,13
Wälee,sargeras,1048,shaman,elemental,59,30,29
Skwiglz,tichondrius,1045,shaman,elemental,63,29,34
Minzysm,illidan,1045,shaman,elemental,24,11,13
Baltharzhard,saurfang,1040,shaman,elemental,24,11,13
Darkrock,echo-isles,1033,shaman,elemental,24,12,12
Mistayl,bleeding-hollow,968,shaman,elemental,30,12,18
Dewoverload,garithos,960,shaman,elemental,12,10,2
Smrtdeath,zuljin,960,shaman,elemental,12,10,2
Starmaker,malganis,960,shaman,elemental,18,10,8
Electriik,kiljaeden,959,shaman,elemental,12,10,2
Ñîmåbè,tichondrius,959,shaman,elemental,18,10,8
Heavyboxer,tichondrius,958,shaman,elemental,24,10,14
Thundermatt,aegwynn,958,shaman,elemental,24,10,14
Moartotems,kelthuzad,957,shaman,elemental,12,10,2
Korlog,tichondrius,957,shaman,elemental,12,10,2
Shockshammy,kiljaeden,956,shaman,elemental,18,10,8
Honeybean,tichondrius,956,shaman,elemental,24,10,14
Chaposz,tichondrius,955,shaman,elemental,24,10,14
Tinkd,stormrage,953,shaman,elemental,18,10,8
Izreborn,tichondrius,953,shaman,elemental,24,10,14
Zugdabou,bonechewer,941,shaman,elemental,24,10,14
Gorron,frostwolf,929,shaman,elemental,24,10,14
Zappynips,frostmourne,909,shaman,elemental,17,10,7
Aragog,malygos,899,shaman,elemental,32,16,16
Alphamael,lightbringer,893,shaman,elemental,23,10,13
Ffaísca,azralon,890,shaman,elemental,22,10,12
Threehandz,bleeding-hollow,886,shaman,elemental,55,20,35
Trilz,barthilas,880,shaman,elemental,19,10,9
Jer,tichondrius,864,shaman,elemental,12,9,3
Tremordrfear,lightbringer,864,shaman,elemental,12,9,3
Pikopiko,tichondrius,864,shaman,elemental,12,9,3
Däbü,tichondrius,864,shaman,elemental,18,9,9
Buffele,tichondrius,864,shaman,elemental,18,9,9
Triknolov,dalaran,864,shaman,elemental,18,9,9
Earthclap,tichondrius,864,shaman,elemental,24,9,15
Ðomzy,tichondrius,863,shaman,elemental,12,9,3
Poseidon,kiljaeden,863,shaman,elemental,18,9,9
Earthfirex,ragnaros,863,shaman,elemental,18,9,9
Daddykooll,tichondrius,863,shaman,elemental,18,9,9
Thaél,proudmoore,863,shaman,elemental,24,9,15
Tottemic,blackrock,862,shaman,elemental,18,9,9
Srbski,emerald-dream,862,shaman,elemental,18,9,9
Ragnards,ragnaros,862,shaman,elemental,24,9,15
Yasmiel,zuljin,862,shaman,elemental,30,9,21
Stitchis,black-dragonflight,861,shaman,elemental,18,9,9
Grandwolf,ragnaros,861,shaman,elemental,18,9,9
Drazzella,arthas,861,shaman,elemental,24,9,15
Grukall,galakrond,860,shaman,elemental,12,9,3
Ayahuaskah,illidan,860,shaman,elemental,18,9,9
Venekk,shattered-hand,859,shaman,elemental,18,9,9
Velekar,moon-guard,858,shaman,elemental,24,9,15
Gorakh,illidan,856,shaman,elemental,18,9,9
Vegaslights,tichondrius,816,shaman,elemental,21,9,12
Cheweydadawg,shandris,799,shaman,elemental,17,9,8
Morabebi,tichondrius,768,shaman,elemental,12,8,4
Luhz,tichondrius,768,shaman,elemental,12,8,4
Àspect,aegwynn,768,shaman,elemental,12,8,4
Blmqt,stormrage,768,shaman,elemental,12,8,4
Bagovs,tichondrius,768,shaman,elemental,12,8,4
Cepheí,bleeding-hollow,768,shaman,elemental,18,8,10
Gambezee,kelthuzad,768,shaman,elemental,18,8,10
Krupto,tichondrius,768,shaman,elemental,18,8,10
Momothewolf,malganis,767,shaman,elemental,12,8,4
Endorovich,mannoroth,767,shaman,elemental,18,8,10
Isekai,alterac-mountains,767,shaman,elemental,24,8,16
Cheddatotz,illidan,764,shaman,elemental,12,8,4
Sanlu,tichondrius,751,shaman,elemental,18,8,10
Hüsky,dalaran,735,shaman,elemental,17,8,9
Golozok,zuljin,734,shaman,elemental,17,8,9
Malosa,hyjal,734,shaman,elemental,23,8,15
Lowiqpleb,tichondrius,719,shaman,elemental,17,8,9
Blacklm,tichondrius,672,shaman,elemental,12,7,5
Pipesable,ragnaros,672,shaman,elemental,12,7,5
Pericazo,sargeras,672,shaman,elemental,12,7,5
Tatespeech,barthilas,672,shaman,elemental,12,7,5
Owtyobwol,area-52,672,shaman,elemental,12,7,5
Ðøææøð,stormrage,672,shaman,elemental,12,7,5
Drmeatballmd,tichondrius,672,shaman,elemental,12,7,5
Thoraq,bleeding-hollow,672,shaman,elemental,12,7,5
Ayetex,kelthuzad,672,shaman,elemental,12,7,5
Spoonforkorc,thrall,672,shaman,elemental,12,7,5
Cuban,kelthuzad,672,shaman,elemental,12,7,5
Humorlava,tichondrius,672,shaman,elemental,12,7,5
Desdìnova,tortheldrin,672,shaman,elemental,18,7,11
Letronix,azralon,672,shaman,elemental,18,7,11
Neotrad,proudmoore,672,shaman,elemental,18,7,11
Kkangsiki,tichondrius,672,shaman,elemental,18,7,11
Jacori,malganis,671,shaman,elemental,12,7,5
Lenå,moon-guard,671,shaman,elemental,12,7,5
Vktr,drakkari,671,shaman,elemental,18,7,11
Galabanjø,malganis,671,shaman,elemental,18,7,11
Yippeekiyay,zuluhed,671,shaman,elemental,21,8,13
Exoticz,barthilas,671,shaman,elemental,26,7,19
Xoelement,borean-tundra,669,shaman,elemental,12,7,5
Grimlên,skullcrusher,669,shaman,elemental,18,7,11
Phuamya,dalaran,667,shaman,elemental,12,7,5
Geladoo,gallywix,666,shaman,elemental,18,7,11
Jyster,area-52,664,shaman,elemental,24,7,17
Cheesewheelz,arthas,651,shaman,elemental,22,7,15
Megalithic,moon-guard,639,shaman,elemental,14,8,6
Koongram,area-52,623,shaman,elemental,11,7,4
Bushdeedit,stormrage,623,shaman,elemental,17,7,10
Gorjun,stormrage,600,shaman,elemental,21,10,11
Illchayqt,frostmourne,591,shaman,elemental,11,7,4
Sugirukifuja,stormrage,589,shaman,elemental,11,7,4
Jerkdaddy,aggramar,576,shaman,elemental,6,6,0
Boltadeez,tichondrius,576,shaman,elemental,6,6,0
Kasparøv,tichondrius,576,shaman,elemental,6,6,0
Getwetand,quelthalas,576,shaman,elemental,12,6,6
Squealer,sargeras,576,shaman,elemental,12,6,6
Doommjölnir,sargeras,576,shaman,elemental,12,6,6
Innvious,sargeras,576,shaman,elemental,12,6,6
Tairen,ragnaros,576,shaman,elemental,12,6,6
Storminlorka,sargeras,576,shaman,elemental,12,6,6
Eimear,kelthuzad,576,shaman,elemental,12,6,6
Doorti,area-52,576,shaman,elemental,12,6,6
Zzarit,tichondrius,576,shaman,elemental,13,6,7
Uglymugshock,tichondrius,576,shaman,elemental,18,6,12
Mavz,moon-guard,576,shaman,elemental,18,6,12
Datbigthing,frostmourne,576,shaman,elemental,18,6,12
Mittss,sargeras,575,shaman,elemental,12,6,6
Shøckolate,magtheridon,575,shaman,elemental,12,6,6
Shachone,zuljin,575,shaman,elemental,12,6,6
Nemei,zuljin,575,shaman,elemental,12,6,6
Drewshammy,zuljin,575,shaman,elemental,12,6,6
Seinnome,azralon,575,shaman,elemental,12,6,6
Teekona,tichondrius,575,shaman,elemental,12,6,6
Moctezumma,area-52,575,shaman,elemental,12,6,6
Totempaul,frostmourne,570,shaman,elemental,18,6,12
Asy,tichondrius,559,shaman,elemental,11,6,5
Aitex,kelthuzad,543,shaman,elemental,15,7,8
Thanen,the-scryers,541,shaman,elemental,16,6,10
Aseew,drakkari,522,shaman,elemental,21,9,12
Nazz,cenarion-circle,480,shaman,elemental,6,5,1
Kebboz,frostmourne,480,shaman,elemental,6,5,1
Handzum,blades-edge,480,shaman,elemental,6,5,1
Sxr,moon-guard,480,shaman,elemental,6,5,1
Lff,stormrage,480,shaman,elemental,6,5,1
Totemzie,illidan,480,shaman,elemental,6,5,1
Vulcansh,azralon,480,shaman,elemental,6,5,1
Lfhotmoms,moon-guard,480,shaman,elemental,6,5,1
Farku,illidan,480,shaman,elemental,6,5,1
ßævis,magtheridon,480,shaman,elemental,6,5,1
Kanasya,quelthalas,480,shaman,elemental,12,5,7
Ratson,ragnaros,480,shaman,elemental,12,5,7
Slumpinator,tichondrius,480,shaman,elemental,12,5,7
Cùìó,barthilas,480,shaman,elemental,12,5,7
Wobbleshock,tichondrius,480,shaman,elemental,12,5,7
Zajashuna,malganis,480,shaman,elemental,12,5,7
Xodeus,frostmourne,480,shaman,elemental,12,5,7
Stayz,tichondrius,480,shaman,elemental,12,5,7
Daerönn,azralon,480,shaman,elemental,12,5,7
Jènova,whisperwind,480,shaman,elemental,12,5,7
Chomolungma,azralon,480,shaman,elemental,12,5,7
Dansham,zuljin,480,shaman,elemental,12,5,7
Eluulne,silvermoon,480,shaman,elemental,12,5,7
Baddaboom,sargeras,480,shaman,elemental,12,5,7
Richode,burning-legion,480,shaman,elemental,12,5,7
Flamestrife,illidan,480,shaman,elemental,12,5,7
Totemchucker,stormrage,480,shaman,elemental,15,6,9
Olani,nesingwary,480,shaman,elemental,15,6,9
Advìl,area-52,480,shaman,elemental,18,5,13
Nøir,drakkari,480,shaman,elemental,18,5,13
Killdeaderer,barthilas,479,shaman,elemental,6,5,1
Ðarkvolts,stormrage,479,shaman,elemental,12,5,7
Dizzytotem,dalaran,478,shaman,elemental,12,5,7
Dellnar,nagrand,478,shaman,elemental,12,5,7
Geodude,executus,447,shaman,elemental,11,5,6
Kinjin,dragonmaw,415,shaman,elemental,14,5,9
Pubechin,jubeithos,384,shaman,elemental,6,4,2
Glizzyjamon,sargeras,384,shaman,elemental,6,4,2
Jensenx,proudmoore,384,shaman,elemental,6,4,2
Clamson,tichondrius,384,shaman,elemental,6,4,2
Zenan,stormreaver,384,shaman,elemental,6,4,2
Wodgodx,sargeras,384,shaman,elemental,6,4,2
Lukora,stonemaul,384,shaman,elemental,6,4,2
Drakhe,proudmoore,384,shaman,elemental,6,4,2
Graveshocks,illidan,384,shaman,elemental,6,4,2
Plotious,antonidas,384,shaman,elemental,6,4,2
Rahkarg,korgath,384,shaman,elemental,6,4,2
Dragaru,illidan,384,shaman,elemental,6,4,2
Blueku,tichondrius,384,shaman,elemental,6,4,2
Shammyqua,tichondrius,384,shaman,elemental,6,4,2
Bazinguinha,azralon,384,shaman,elemental,6,4,2
Walabi,tichondrius,384,shaman,elemental,6,4,2
Seraøth,area-52,384,shaman,elemental,6,4,2
Bigdaddyion,thrall,384,shaman,elemental,6,4,2
Thandius,arygos,384,shaman,elemental,6,4,2
Thorlottie,stormrage,384,shaman,elemental,6,4,2
Ktom,runetotem,384,shaman,elemental,6,4,2
Dgshaman,tichondrius,384,shaman,elemental,6,4,2
Munchies,madoran,384,shaman,elemental,6,4,2
Magtark,frostwolf,384,shaman,elemental,6,4,2
Vodord,arathor,384,shaman,elemental,6,4,2
Nírnez,ragnaros,384,shaman,elemental,6,4,2
Novoz,tichondrius,384,shaman,elemental,6,4,2
Notragii,kelthuzad,384,shaman,elemental,6,4,2
Groundme,malganis,384,shaman,elemental,6,4,2
Borgmash,chogall,384,shaman,elemental,6,4,2
Skyten,quelthalas,384,shaman,elemental,12,4,8
Elryl,sargeras,384,shaman,elemental,12,4,8
Grimitt,suramar,384,shaman,elemental,12,4,8
Helapoon,area-52,384,shaman,elemental,12,4,8
Lavasurge,area-52,384,shaman,elemental,12,4,8
Pozcaster,tichondrius,384,shaman,elemental,12,4,8
Feetfungus,area-52,384,shaman,elemental,12,4,8
Kushnations,chogall,384,shaman,elemental,12,4,8
Hansolorz,tichondrius,384,shaman,elemental,18,4,14
Vjeze,frostmourne,384,shaman,elemental,18,4,14
Pepîllo,ragnaros,384,shaman,elemental,24,4,20
Thanwirn,ragnaros,383,shaman,elemental,6,4,2
Shamarock,stonemaul,383,shaman,elemental,6,4,2
Machalo,sargeras,383,shaman,elemental,12,4,8
Zappz,thunderlord,382,shaman,elemental,6,4,2
Coffeeblacc,magtheridon,379,shaman,elemental,12,4,8
Syile,stormrage,351,shaman,elemental,8,5,3
Råys,turalyon,350,shaman,elemental,11,4,7
Stormfronts,kelthuzad,336,shaman,elemental,9,4,5
Taraneh,garrosh,325,shaman,elemental,15,5,10
Sweetbabyraé,bleeding-hollow,304,shaman,elemental,7,4,3
Tsunamibrew,moon-guard,302,shaman,elemental,9,4,5
Shizamm,hyjal,288,shaman,elemental,6,3,3
Luxenor,kelthuzad,288,shaman,elemental,6,3,3
Chonkymilk,illidan,288,shaman,elemental,6,3,3
Ragor,quelthalas,288,shaman,elemental,6,3,3
Exceedër,ragnaros,288,shaman,elemental,6,3,3
Jaycobb,area-52,288,shaman,elemental,6,3,3
Kowabounga,ragnaros,288,shaman,elemental,6,3,3
Zon,laughing-skull,288,shaman,elemental,6,3,3
Zlateral,malganis,288,shaman,elemental,6,3,3
Procdepartme,area-52,288,shaman,elemental,6,3,3
Talfur,area-52,288,shaman,elemental,6,3,3
Groundfaults,bleeding-hollow,288,shaman,elemental,6,3,3
Mabite,frostmourne,288,shaman,elemental,6,3,3
Blaydin,elune,288,shaman,elemental,6,3,3
Beatryx,the-scryers,288,shaman,elemental,6,3,3
Mønønøke,tichondrius,288,shaman,elemental,6,3,3
Shàman,durotan,288,shaman,elemental,6,3,3
Blakki,barthilas,288,shaman,elemental,6,3,3
Bolteon,malganis,288,shaman,elemental,6,3,3
Sin,bleeding-hollow,288,shaman,elemental,6,3,3
Shadeele,cenarius,288,shaman,elemental,6,3,3
Shajay,area-52,288,shaman,elemental,6,3,3
Autisty,sargeras,288,shaman,elemental,6,3,3
Jnzz,area-52,288,shaman,elemental,6,3,3
Vanëssão,stormrage,288,shaman,elemental,6,3,3
Kimkar,bleeding-hollow,288,shaman,elemental,6,3,3
Shammany,stormrage,288,shaman,elemental,6,3,3
Hexoffend,zuljin,288,shaman,elemental,6,3,3
Ioki,spirestone,288,shaman,elemental,6,3,3
Doop,kiljaeden,288,shaman,elemental,6,3,3
Healingtime,nerzhul,288,shaman,elemental,6,3,3
Passion,sargeras,288,shaman,elemental,6,3,3
Maldini,tol-barad,288,shaman,elemental,6,3,3
Tokelahoma,stormrage,288,shaman,elemental,6,3,3
Shambix,illidan,288,shaman,elemental,6,3,3
Éarl,sargeras,288,shaman,elemental,6,3,3
Caserguy,sargeras,288,shaman,elemental,6,3,3
Simada,tichondrius,288,shaman,elemental,6,3,3
Finark,tichondrius,288,shaman,elemental,6,3,3
Rokogg,thrall,288,shaman,elemental,6,3,3
Orkshammy,illidan,288,shaman,elemental,6,3,3
Arckos,thrall,288,shaman,elemental,6,3,3
Ggoong,tichondrius,288,shaman,elemental,6,3,3
Dràgoon,thrall,288,shaman,elemental,6,3,3
Trenhance,stormrage,288,shaman,elemental,6,3,3
Totemtown,darkspear,288,shaman,elemental,6,3,3
Ryukims,tichondrius,288,shaman,elemental,6,3,3
Largerwang,sargeras,288,shaman,elemental,6,3,3
Deyodin,illidan,288,shaman,elemental,6,3,3
Ieeguen,tichondrius,288,shaman,elemental,6,3,3
Imense,sargeras,288,shaman,elemental,6,3,3
Axelsteel,illidan,288,shaman,elemental,6,3,3
Earthfurÿ,quelthalas,288,shaman,elemental,6,3,3
Gödöfbüdå,tichondrius,288,shaman,elemental,6,3,3
Noslol,bronzebeard,288,shaman,elemental,6,3,3
Fluffyhex,sargeras,288,shaman,elemental,6,3,3
Gjaj,tichondrius,288,shaman,elemental,6,3,3
Shiggenbasta,tichondrius,288,shaman,elemental,6,3,3
Caninius,sargeras,288,shaman,elemental,6,3,3
Drazziqt,malganis,288,shaman,elemental,6,3,3
Hydroponicz,sargeras,288,shaman,elemental,6,3,3
Bizle,jaedenar,288,shaman,elemental,6,3,3
Grimnur,bleeding-hollow,288,shaman,elemental,11,3,8
Oznog,bleeding-hollow,288,shaman,elemental,12,3,9
Yunow,ragnaros,288,shaman,elemental,12,3,9
Emptee,area-52,288,shaman,elemental,12,3,9
Káládin,malganis,288,shaman,elemental,12,3,9
Treesntotemz,darkspear,287,shaman,elemental,6,3,3
Strikzjr,frostmourne,287,shaman,elemental,6,3,3
Potatopirate,burning-legion,287,shaman,elemental,12,3,9
Cropdustr,sargeras,286,shaman,elemental,6,3,3
Cardanø,illidan,271,shaman,elemental,17,3,14
Hannibol,tichondrius,255,shaman,elemental,11,3,8
Oxxnabatko,amanthul,240,shaman,elemental,9,3,6
Sarafehna,wyrmrest-accord,239,shaman,elemental,5,3,2
Spunjie,frostmourne,239,shaman,elemental,5,3,2
Mercs,frostmourne,234,shaman,elemental,17,8,9
Dmt,exodar,224,shaman,elemental,10,3,7
Zeldrys,emerald-dream,192,shaman,elemental,6,2,4
Matzahmeal,skywall,192,shaman,elemental,6,2,4
Kanbar,emerald-dream,192,shaman,elemental,6,2,4
Smellyogre,area-52,192,shaman,elemental,6,2,4
Funeropolis,stormrage,192,shaman,elemental,6,2,4
Twistedteas,tichondrius,192,shaman,elemental,6,2,4
Krilick,blackrock,192,shaman,elemental,6,2,4
Univearth,emerald-dream,192,shaman,elemental,6,2,4
Yangsangchu,tichondrius,192,shaman,elemental,6,2,4
Pacapinchhit,azgalor,192,shaman,elemental,6,2,4
Bitflip,jubeithos,192,shaman,elemental,6,2,4
Asanako,illidan,192,shaman,elemental,6,2,4
Gorillox,chogall,192,shaman,elemental,6,2,4
Shåmwowz,sargeras,192,shaman,elemental,6,2,4
Rubmytotêm,tichondrius,192,shaman,elemental,6,2,4
Shamsky,tichondrius,192,shaman,elemental,6,2,4
Grandmaster,frostmourne,192,shaman,elemental,6,2,4
Manitbaggins,earthen-ring,192,shaman,elemental,6,2,4
Sgorr,illidan,192,shaman,elemental,6,2,4
Blastj,tichondrius,192,shaman,elemental,6,2,4
Oriyani,sargeras,192,shaman,elemental,6,2,4
Ôprawindfury,mugthol,192,shaman,elemental,6,2,4
Dadadabang,frostmourne,192,shaman,elemental,6,2,4
Dehsaw,illidan,192,shaman,elemental,6,2,4
Soartotes,sargeras,192,shaman,elemental,6,2,4
Bigbadbolt,malganis,192,shaman,elemental,6,2,4
Trizzeh,moon-guard,192,shaman,elemental,6,2,4
Sumyl,ragnaros,192,shaman,elemental,6,2,4
Tampíco,ragnaros,192,shaman,elemental,6,2,4
Fatherrtime,illidan,192,shaman,elemental,6,2,4
Sid,frostmourne,192,shaman,elemental,6,2,4
Sjostrom,proudmoore,192,shaman,elemental,6,2,4
Saltywap,proudmoore,192,shaman,elemental,6,2,4
Delement,ragnaros,192,shaman,elemental,6,2,4
Ladash,ragnaros,192,shaman,elemental,6,2,4
Yellowfev,thrall,192,shaman,elemental,6,2,4
Snewboii,malganis,192,shaman,elemental,6,2,4
Wempa,moon-guard,192,shaman,elemental,6,2,4
Naextramus,ragnaros,192,shaman,elemental,6,2,4
Ric,malganis,192,shaman,elemental,6,2,4
Deggle,frostwolf,192,shaman,elemental,6,2,4
Zaxibow,area-52,192,shaman,elemental,6,2,4
Mîkâ,area-52,192,shaman,elemental,6,2,4
Zuroster,kiljaeden,192,shaman,elemental,7,2,5
Fluffy,smolderthorn,192,shaman,elemental,12,2,10
Fulingyu,moon-guard,192,shaman,elemental,12,2,10
Rìddles,malygos,192,shaman,elemental,12,2,10
Harrìson,tichondrius,192,shaman,elemental,12,2,10
Nomahuata,cenarion-circle,192,shaman,elemental,12,2,10
Nuggitz,tichondrius,191,shaman,elemental,6,2,4
Hazzardttvz,illidan,159,shaman,elemental,5,2,3
Kidkovid,illidan,159,shaman,elemental,17,2,15
Uracemytotem,kiljaeden,138,shaman,elemental,10,3,7
Mynigabob,zuljin,128,shaman,elemental,4,2,2
Rahloo,sargeras,127,shaman,elemental,8,2,6
Toxidizetkö,azralon,96,shaman,elemental,6,1,5
Gan,silvermoon,96,shaman,elemental,6,1,5
Eravas,thrall,96,shaman,elemental,6,1,5
Oohkillemm,silvermoon,96,shaman,elemental,6,1,5
Obiwonsamdi,illidan,96,shaman,elemental,6,1,5
Teathin,ragnaros,96,shaman,elemental,6,1,5
Drmn,frostmourne,96,shaman,elemental,6,1,5
Mugiwára,ragnaros,96,shaman,elemental,6,1,5
Healsquish,area-52,96,shaman,elemental,6,1,5
Toho,ragnaros,96,shaman,elemental,6,1,5
Winiethepoöh,stormrage,96,shaman,elemental,6,1,5
Ludacrìtz,stormrage,96,shaman,elemental,6,1,5
Groovesh,thrall,96,shaman,elemental,6,1,5
Stormklepter,fizzcrank,96,shaman,elemental,6,1,5
Oldshammy,eldrethalas,96,shaman,elemental,6,1,5
Zral,emerald-dream,96,shaman,elemental,6,1,5
Jalgago,tichondrius,96,shaman,elemental,6,1,5
Sinsar,illidan,96,shaman,elemental,6,1,5
Rythia,elune,96,shaman,elemental,6,1,5
Bullcowsby,darkspear,96,shaman,elemental,6,1,5
Ripklanian,blood-furnace,96,shaman,elemental,6,1,5
Shøckys,tichondrius,96,shaman,elemental,6,1,5
Jedley,azshara,96,shaman,elemental,6,1,5
Sàuron,tichondrius,96,shaman,elemental,6,1,5
Ëìê,tichondrius,96,shaman,elemental,18,1,17
Eleshamanz,tichondrius,79,shaman,elemental,5,1,4
Doughboy,khadgar,64,shaman,elemental,4,1,3
Babyblake,malganis,63,shaman,elemental,2,2,0
Gurdle,frostwolf,48,shaman,elemental,3,1,2
Hentaistorm,kiljaeden,48,shaman,elemental,3,1,2
Fwwrs,illidan,31,shaman,elemental,2,1,1
Veggiess,emerald-dream,2194,shaman,enhancement,150,79,71
Nopnopajnin,tichondrius,2156,shaman,enhancement,88,45,43
Alleys,tichondrius,2145,shaman,enhancement,159,81,78
Aýanokoji,tichondrius,2138,shaman,enhancement,79,43,36
Doomwìnds,stormrage,2133,shaman,enhancement,132,76,56
Baseballcap,sargeras,2130,shaman,enhancement,84,54,30
Dopeysimida,illidan,2129,shaman,enhancement,59,41,18
Mítsurí,tichondrius,2121,shaman,enhancement,70,36,34
Ftyue,area-52,2116,shaman,enhancement,112,59,53
Zarktwo,azralon,2049,shaman,enhancement,96,49,47
Jimmyjobs,tichondrius,2027,shaman,enhancement,66,44,22
Stew,illidan,1996,shaman,enhancement,71,42,29
Musclebrain,tichondrius,1994,shaman,enhancement,120,57,63
Axegerd,quelthalas,1987,shaman,enhancement,87,49,38
Shakeys,tichondrius,1978,shaman,enhancement,65,40,25
Saul,tichondrius,1969,shaman,enhancement,42,29,13
Zootywild,tichondrius,1963,shaman,enhancement,123,69,54
Realypump,area-52,1959,shaman,enhancement,60,36,24
Futeuncle,tichondrius,1957,shaman,enhancement,48,26,22
Musclebrainz,tichondrius,1952,shaman,enhancement,54,26,28
Opoy,sargeras,1942,shaman,enhancement,115,62,53
Eityhdz,tichondrius,1934,shaman,enhancement,263,139,124
Imchuckbass,tichondrius,1922,shaman,enhancement,80,42,38
Jayhastotems,area-52,1918,shaman,enhancement,90,67,23
Zarasvati,tichondrius,1917,shaman,enhancement,89,45,44
Skydre,area-52,1916,shaman,enhancement,47,28,19
Rauthgar,dalaran,1915,shaman,enhancement,60,32,28
Balgron,emerald-dream,1902,shaman,enhancement,46,23,23
Grommi,proudmoore,1902,shaman,enhancement,120,58,62
Artenior,stormrage,1897,shaman,enhancement,71,37,34
Beañ,barthilas,1894,shaman,enhancement,159,85,74
Dano,tichondrius,1887,shaman,enhancement,42,24,18
Rozboiclique,frostmourne,1875,shaman,enhancement,126,84,42
Swrdfsh,tichondrius,1864,shaman,enhancement,102,54,48
Lavitris,illidan,1854,shaman,enhancement,42,29,13
Rawdòggin,emerald-dream,1844,shaman,enhancement,42,30,12
Megalithic,moon-guard,1840,shaman,enhancement,62,44,18
Novedz,illidan,1839,shaman,enhancement,56,32,24
Wetdraenei,moon-guard,1835,shaman,enhancement,127,71,56
Doomberrie,thrall,1832,shaman,enhancement,54,34,20
Watergirl,thaurissan,1828,shaman,enhancement,74,41,33
Konfuzious,emerald-dream,1826,shaman,enhancement,75,47,28
Ohmálley,tichondrius,1825,shaman,enhancement,47,29,18
Blueraccoon,tichondrius,1821,shaman,enhancement,57,35,22
Hooftoface,moon-guard,1821,shaman,enhancement,72,40,32
Gladdorta,azralon,1821,shaman,enhancement,54,30,24
Heisna,stormrage,1820,shaman,enhancement,150,85,65
Mcshockturds,tichondrius,1819,shaman,enhancement,77,48,29
Stormrageman,tichondrius,1818,shaman,enhancement,57,35,22
Undertów,area-52,1818,shaman,enhancement,42,24,18
Harrypotqueu,zuljin,1817,shaman,enhancement,54,29,25
Louiev,bleeding-hollow,1812,shaman,enhancement,48,28,20
Legendslayar,area-52,1811,shaman,enhancement,42,27,15
Typhe,bleeding-hollow,1811,shaman,enhancement,30,19,11
Kltz,sargeras,1811,shaman,enhancement,35,21,14
Superchief,altar-of-storms,1809,shaman,enhancement,60,32,28
Bikboisteez,barthilas,1808,shaman,enhancement,92,47,45
Lashandtrash,tichondrius,1806,shaman,enhancement,30,19,11
Niuniudada,illidan,1805,shaman,enhancement,84,39,45
Madonion,zuljin,1803,shaman,enhancement,60,31,29
Zanderpla,kelthuzad,1797,shaman,enhancement,48,27,21
Wingshaman,illidan,1796,shaman,enhancement,132,76,56
Landlordxx,area-52,1795,shaman,enhancement,52,32,20
Garai,emerald-dream,1778,shaman,enhancement,87,45,42
Plsnerfret,stormrage,1767,shaman,enhancement,36,26,10
Vanhalestorm,frostmourne,1756,shaman,enhancement,52,26,26
Xibalba,khaz-modan,1751,shaman,enhancement,24,19,5
Darkcnight,stormrage,1749,shaman,enhancement,30,22,8
Soshatsumi,tichondrius,1749,shaman,enhancement,76,42,34
Slapnarp,wyrmrest-accord,1747,shaman,enhancement,54,29,25
Slashpity,stormrage,1743,shaman,enhancement,48,30,18
Smxxn,tichondrius,1741,shaman,enhancement,48,22,26
Nyckysh,illidan,1734,shaman,enhancement,36,25,11
Keyturn,tichondrius,1734,shaman,enhancement,42,19,23
Bbshock,stormrage,1727,shaman,enhancement,78,48,30
Windshearbøt,tichondrius,1723,shaman,enhancement,42,23,19
Bestshamus,sargeras,1715,shaman,enhancement,45,25,20
Døømsdáy,thrall,1713,shaman,enhancement,48,30,18
Thrallas,frostmourne,1713,shaman,enhancement,42,26,16
Elryl,sargeras,1712,shaman,enhancement,90,52,38
Sassyx,steamwheedle-cartel,1711,shaman,enhancement,36,20,16
Btruez,tichondrius,1702,shaman,enhancement,48,26,22
Wrathics,emerald-dream,1702,shaman,enhancement,60,32,28
Spippippin,illidan,1702,shaman,enhancement,50,24,26
Pla,tichondrius,1699,shaman,enhancement,89,56,33
Tastydonut,blackrock,1699,shaman,enhancement,41,24,17
Bitsuey,frostmourne,1698,shaman,enhancement,48,28,20
Halfzugzug,sargeras,1697,shaman,enhancement,30,21,9
Reflexsivx,malganis,1694,shaman,enhancement,42,27,15
Xiaoxiaoxi,tichondrius,1694,shaman,enhancement,42,23,19
Miketideson,proudmoore,1693,shaman,enhancement,72,38,34
Zappithorus,stormrage,1691,shaman,enhancement,36,24,12
Bòómz,stormrage,1691,shaman,enhancement,76,36,40
Electricity,tichondrius,1691,shaman,enhancement,67,27,40
Shamezee,stormreaver,1689,shaman,enhancement,47,22,25
Jàro,thrall,1688,shaman,enhancement,42,20,22
Temar,sargeras,1687,shaman,enhancement,45,30,15
Xaltas,moon-guard,1685,shaman,enhancement,42,29,13
Ðr,earthen-ring,1680,shaman,enhancement,80,49,31
Windfury,chogall,1678,shaman,enhancement,42,23,19
Lustingchery,area-52,1674,shaman,enhancement,33,20,13
Onlyshams,dalaran,1666,shaman,enhancement,36,22,14
Plzbuffme,dalaran,1664,shaman,enhancement,50,31,19
Timzero,tichondrius,1659,shaman,enhancement,36,22,14
Windflex,emerald-dream,1656,shaman,enhancement,68,34,34
Xakaeri,hyjal,1655,shaman,enhancement,36,20,16
Kalvishdam,dalaran,1653,shaman,enhancement,30,21,9
Shamanees,area-52,1653,shaman,enhancement,48,27,21
Iamashaman,malganis,1646,shaman,enhancement,248,121,127
Blakki,barthilas,1641,shaman,enhancement,42,25,17
Askpuntee,sargeras,1635,shaman,enhancement,42,25,17
Tettnanger,azralon,1630,shaman,enhancement,31,19,12
Antek,quelthalas,1626,shaman,enhancement,108,61,47
Hxzard,stormrage,1626,shaman,enhancement,36,17,19
Åvarice,shattered-halls,1626,shaman,enhancement,54,22,32
Turdfergesen,destromath,1621,shaman,enhancement,41,19,22
Ceasebelief,tichondrius,1619,shaman,enhancement,30,21,9
Shamgawd,illidan,1617,shaman,enhancement,36,20,16
Smartbunny,illidan,1612,shaman,enhancement,156,79,77
Robdaman,tichondrius,1607,shaman,enhancement,24,18,6
Rukagar,barthilas,1607,shaman,enhancement,30,17,13
Ëxceeder,ragnaros,1606,shaman,enhancement,36,20,16
Turbowolf,sargeras,1606,shaman,enhancement,56,23,33
Kindaretro,tichondrius,1605,shaman,enhancement,42,27,15
Orkuss,illidan,1602,shaman,enhancement,36,19,17
Beaviis,frostmourne,1601,shaman,enhancement,30,20,10
Eyecandi,barthilas,1596,shaman,enhancement,52,27,25
Smash,fenris,1596,shaman,enhancement,76,38,38
Haishoe,stormrage,1592,shaman,enhancement,36,22,14
Gorillahazed,tichondrius,1590,shaman,enhancement,72,34,38
Gìmli,tichondrius,1581,shaman,enhancement,35,20,15
Sonofabat,spirestone,1580,shaman,enhancement,46,24,22
Zeroshocks,kelthuzad,1572,shaman,enhancement,30,19,11
Gambazzlok,terokkar,1566,shaman,enhancement,36,22,14
Jerykco,drakkari,1564,shaman,enhancement,30,18,12
Ragnarocck,sargeras,1563,shaman,enhancement,42,19,23
Uracemytotem,kiljaeden,1562,shaman,enhancement,84,51,33
Dcg,hyjal,1555,shaman,enhancement,35,17,18
Elementin,kelthuzad,1553,shaman,enhancement,60,30,30
Totemnikiel,stormrage,1544,shaman,enhancement,66,28,38
Poizele,tichondrius,1540,shaman,enhancement,166,93,73
Small,alleria,1538,shaman,enhancement,60,32,28
Aibheit,area-52,1535,shaman,enhancement,18,17,1
Larrylardazz,tichondrius,1529,shaman,enhancement,85,51,34
Loadiez,frostmourne,1527,shaman,enhancement,30,21,9
Krûde,tichondrius,1524,shaman,enhancement,41,27,14
Speedrush,nagrand,1520,shaman,enhancement,26,18,8
Zavar,tichondrius,1518,shaman,enhancement,41,20,21
Hephron,area-52,1516,shaman,enhancement,66,30,36
Mindfields,barthilas,1511,shaman,enhancement,67,38,29
Hehew,kelthuzad,1508,shaman,enhancement,36,23,13
Deshamann,illidan,1507,shaman,enhancement,59,24,35
Thromjin,ragnaros,1506,shaman,enhancement,24,16,8
Kronkxd,malganis,1501,shaman,enhancement,30,16,14
Nøname,azshara,1493,shaman,enhancement,78,35,43
Quakenbake,emerald-dream,1491,shaman,enhancement,33,20,13
Shamom,silver-hand,1478,shaman,enhancement,48,27,21
Chalked,stormrage,1478,shaman,enhancement,84,41,43
Ventus,thrall,1471,shaman,enhancement,42,20,22
Dankthunda,stormrage,1468,shaman,enhancement,30,18,12
Shamann,azshara,1452,shaman,enhancement,45,25,20
Ràntòn,bleeding-hollow,1451,shaman,enhancement,23,16,7
Atthegates,illidan,1445,shaman,enhancement,72,27,45
Flirstatic,nemesis,1444,shaman,enhancement,47,27,20
Surtel,tichondrius,1443,shaman,enhancement,48,20,28
Whírlwínd,area-52,1439,shaman,enhancement,24,15,9
Tamtam,gorefiend,1438,shaman,enhancement,24,15,9
Algresh,muradin,1437,shaman,enhancement,30,15,15
Kushnations,chogall,1437,shaman,enhancement,30,15,15
Qvibin,tichondrius,1435,shaman,enhancement,30,21,9
Daddyzap,stormrage,1435,shaman,enhancement,98,54,44
Däbü,tichondrius,1435,shaman,enhancement,30,15,15
Stonetrog,blackrock,1428,shaman,enhancement,18,15,3
Iamurfather,magtheridon,1428,shaman,enhancement,41,21,20
Convolutedx,tichondrius,1427,shaman,enhancement,30,15,15
Wautyriex,area-52,1426,shaman,enhancement,36,15,21
Rexoss,hyjal,1422,shaman,enhancement,85,43,42
Silyshamshyt,stormrage,1421,shaman,enhancement,24,15,9
Mixn,frostmourne,1421,shaman,enhancement,39,24,15
ßurstmedaddy,bleeding-hollow,1420,shaman,enhancement,24,17,7
Mybadshawty,tichondrius,1419,shaman,enhancement,55,26,29
Shamwows,dalaran,1418,shaman,enhancement,47,18,29
Montí,moon-guard,1414,shaman,enhancement,30,21,9
Lazugga,area-52,1410,shaman,enhancement,63,35,28
Fhenh,proudmoore,1408,shaman,enhancement,64,35,29
Armønixx,ragnaros,1404,shaman,enhancement,54,30,24
Struck,emerald-dream,1398,shaman,enhancement,54,35,19
Firevag,hakkar,1398,shaman,enhancement,36,22,14
Raazzasham,moon-guard,1398,shaman,enhancement,60,31,29
Djelemental,darkspear,1394,shaman,enhancement,27,17,10
Wortwort,tichondrius,1389,shaman,enhancement,36,15,21
Zktz,warsong,1385,shaman,enhancement,31,17,14
Shamikazi,crushridge,1380,shaman,enhancement,36,18,18
Gettatotem,frostmourne,1373,shaman,enhancement,30,17,13
Drumman,skullcrusher,1370,shaman,enhancement,47,28,19
Deyodin,illidan,1367,shaman,enhancement,20,15,5
Tyzek,illidan,1363,shaman,enhancement,36,22,14
Uglykunt,barthilas,1360,shaman,enhancement,90,52,38
Rbmx,frostmourne,1355,shaman,enhancement,46,28,18
Taò,tichondrius,1346,shaman,enhancement,39,22,17
Split,zuljin,1346,shaman,enhancement,82,42,40
Venmoo,illidan,1343,shaman,enhancement,24,14,10
Keyturns,tichondrius,1342,shaman,enhancement,18,14,4
Tsaheylu,barthilas,1342,shaman,enhancement,48,22,26
Kaediea,moon-guard,1341,shaman,enhancement,18,14,4
Prymalfury,illidan,1340,shaman,enhancement,48,20,28
Shockmehard,area-52,1339,shaman,enhancement,35,32,3
Stickysham,illidan,1339,shaman,enhancement,24,16,8
Stormgraves,moon-guard,1337,shaman,enhancement,24,14,10
Tandrian,daggerspine,1336,shaman,enhancement,30,14,16
Thromir,blackwing-lair,1333,shaman,enhancement,30,17,13
Thunda,black-dragonflight,1331,shaman,enhancement,18,14,4
Keeba,wyrmrest-accord,1329,shaman,enhancement,24,14,10
Grx,tichondrius,1328,shaman,enhancement,24,14,10
Grohltusk,barthilas,1324,shaman,enhancement,36,20,16
Bessame,sargeras,1320,shaman,enhancement,82,41,41
Raylord,ragnaros,1311,shaman,enhancement,77,41,36
Shamrockcawk,malganis,1310,shaman,enhancement,18,14,4
Shipmatekev,sargeras,1305,shaman,enhancement,24,14,10
Obeilius,illidan,1303,shaman,enhancement,49,25,24
Datblueboi,dalaran,1297,shaman,enhancement,70,37,33
Netherfury,illidan,1295,shaman,enhancement,36,23,13
Murlook,sargeras,1292,shaman,enhancement,58,37,21
Heäven,malganis,1291,shaman,enhancement,50,22,28
Lüca,wyrmrest-accord,1284,shaman,enhancement,58,28,30
Midwestern,emerald-dream,1278,shaman,enhancement,26,14,12
Zechary,proudmoore,1273,shaman,enhancement,54,33,21
Rokogg,thrall,1270,shaman,enhancement,75,39,36
Gorebog,feathermoon,1259,shaman,enhancement,42,23,19
Hammeredd,hyjal,1249,shaman,enhancement,24,15,9
Nygiants,tichondrius,1247,shaman,enhancement,18,13,5
Stýlébéñdér,kelthuzad,1246,shaman,enhancement,18,13,5
Ironaddictz,kiljaeden,1239,shaman,enhancement,24,13,11
Synivabyatch,eonar,1238,shaman,enhancement,24,13,11
Woof,agamaggan,1238,shaman,enhancement,24,13,11
Vapus,area-52,1238,shaman,enhancement,83,42,41
Piffenstien,malganis,1236,shaman,enhancement,30,14,16
Drakhe,proudmoore,1235,shaman,enhancement,26,13,13
Nÿh,quelthalas,1234,shaman,enhancement,24,13,11
Willy,icecrown,1230,shaman,enhancement,23,13,10
Scrötotem,saurfang,1229,shaman,enhancement,24,13,11
Robis,thrall,1228,shaman,enhancement,42,19,23
Djasura,blackhand,1228,shaman,enhancement,35,15,20
Lamagra,nemesis,1227,shaman,enhancement,18,13,5
Schlemiel,barthilas,1222,shaman,enhancement,72,30,42
Enhancementz,azralon,1220,shaman,enhancement,48,29,19
Khormac,moon-guard,1218,shaman,enhancement,21,13,8
Johnwilke,area-52,1216,shaman,enhancement,83,37,46
Shamorrhoids,frostmourne,1203,shaman,enhancement,71,36,35
Gdiafplox,thunderhorn,1186,shaman,enhancement,36,18,18
Vozs,proudmoore,1182,shaman,enhancement,48,26,22
Nîghtstalker,vashj,1166,shaman,enhancement,34,15,19
Finnaburstt,tichondrius,1162,shaman,enhancement,54,29,25
Parallels,blackrock,1161,shaman,enhancement,45,16,29
Splendapapi,stormrage,1155,shaman,enhancement,38,13,25
Gangmember,shadowmoon,1152,shaman,enhancement,18,12,6
Crownsx,tichondrius,1152,shaman,enhancement,24,12,12
Crowns,tichondrius,1152,shaman,enhancement,24,12,12
Stewtwo,illidan,1151,shaman,enhancement,21,12,9
Dalianyen,bladefist,1151,shaman,enhancement,24,12,12
Lutheran,dragonmaw,1151,shaman,enhancement,35,14,21
Justincasé,sargeras,1146,shaman,enhancement,30,12,18
Thewindman,sargeras,1144,shaman,enhancement,30,12,18
Hanhze,quelthalas,1142,shaman,enhancement,24,15,9
Earthfirex,ragnaros,1142,shaman,enhancement,24,12,12
Fourstorms,gundrak,1141,shaman,enhancement,37,19,18
Sydstorm,frostmourne,1137,shaman,enhancement,18,12,6
Whydead,sargeras,1133,shaman,enhancement,24,12,12
Popz,dark-iron,1128,shaman,enhancement,18,12,6
ßøn,altar-of-storms,1125,shaman,enhancement,33,16,17
Astroglyde,emerald-dream,1123,shaman,enhancement,24,12,12
Sinsar,illidan,1113,shaman,enhancement,29,12,17
Derzwaz,draka,1110,shaman,enhancement,23,12,11
Lassoway,illidan,1110,shaman,enhancement,30,12,18
Synshenrongt,thrall,1108,shaman,enhancement,124,47,77
Hannibol,tichondrius,1108,shaman,enhancement,60,22,38
Ashida,stormrage,1086,shaman,enhancement,26,14,12
Pedaphil,frostmourne,1056,shaman,enhancement,18,11,7
Vortexfury,area-52,1055,shaman,enhancement,18,11,7
Leaning,wyrmrest-accord,1055,shaman,enhancement,18,11,7
Kiddfurious,kelthuzad,1055,shaman,enhancement,24,11,13
Anadal,kargath,1055,shaman,enhancement,24,11,13
Tdlz,tichondrius,1054,shaman,enhancement,12,11,1
Metako,sargeras,1054,shaman,enhancement,24,11,13
Peepingtotem,tichondrius,1052,shaman,enhancement,24,11,13
Thilv,ravenholdt,1051,shaman,enhancement,18,11,7
Friednocap,kelthuzad,1051,shaman,enhancement,24,11,13
Dronesum,tichondrius,1050,shaman,enhancement,24,11,13
Cayed,stormscale,1050,shaman,enhancement,24,11,13
Leschaises,skullcrusher,1044,shaman,enhancement,18,11,7
Jamblee,sargeras,1043,shaman,enhancement,18,11,7
Dirtyunique,tichondrius,1043,shaman,enhancement,24,11,13
Onezap,trollbane,1042,shaman,enhancement,24,11,13
Bobaflexqt,korgath,1039,shaman,enhancement,18,11,7
Killbro,blackrock,1038,shaman,enhancement,30,11,19
Omaguap,tichondrius,1019,shaman,enhancement,20,12,8
Stormwolf,azjolnerub,1011,shaman,enhancement,30,16,14
Pùffball,anvilmar,1010,shaman,enhancement,39,20,19
Bigbólts,emerald-dream,1001,shaman,enhancement,18,12,6
Nankdug,tichondrius,1000,shaman,enhancement,21,11,10
Neyavv,tichondrius,1000,shaman,enhancement,27,12,15
Slaughterdog,coilfang,995,shaman,enhancement,22,13,9
Drokron,azralon,988,shaman,enhancement,17,11,6
Clumpen,thunderhorn,964,shaman,enhancement,23,11,12
Enhance,sargeras,960,shaman,enhancement,18,10,8
Mcb,barthilas,960,shaman,enhancement,18,10,8
Beanerburst,frostwolf,960,shaman,enhancement,24,11,13
Syraak,elune,959,shaman,enhancement,12,10,2
Vonnsmallpp,area-52,959,shaman,enhancement,18,10,8
Unezx,tichondrius,958,shaman,enhancement,12,10,2
Lakindrentv,gorefiend,958,shaman,enhancement,18,10,8
Asumo,azralon,958,shaman,enhancement,21,11,10
Lavabone,dalaran,957,shaman,enhancement,30,10,20
Súrtr,sargeras,955,shaman,enhancement,18,10,8
Teeroll,frostmourne,954,shaman,enhancement,18,10,8
Aelpian,emerald-dream,954,shaman,enhancement,18,10,8
Zzar,daggerspine,954,shaman,enhancement,18,10,8
Iamegirl,moon-guard,935,shaman,enhancement,23,10,13
Konga,korialstrasz,924,shaman,enhancement,20,11,9
Shammybreakx,malganis,920,shaman,enhancement,29,15,14
Oct,thrall,912,shaman,enhancement,36,18,18
Ongruge,hyjal,912,shaman,enhancement,42,14,28
Grimlên,skullcrusher,910,shaman,enhancement,32,12,20
Fwwrs,illidan,905,shaman,enhancement,20,11,9
Cseril,bonechewer,897,shaman,enhancement,30,12,18
Boombigshaq,ysera,895,shaman,enhancement,14,10,4
Jyupaonaiwa,tichondrius,864,shaman,enhancement,12,9,3
Poseidonxd,lightbringer,864,shaman,enhancement,12,9,3
Lickerman,stormreaver,863,shaman,enhancement,12,9,3
Kandin,icecrown,863,shaman,enhancement,18,9,9
Hellamental,malganis,863,shaman,enhancement,18,9,9
Chaac,firetree,863,shaman,enhancement,18,9,9
Rubious,cenarius,863,shaman,enhancement,19,9,10
Rikswordfire,wyrmrest-accord,859,shaman,enhancement,18,9,9
Mairn,tichondrius,859,shaman,enhancement,18,9,9
Whichdoctah,proudmoore,858,shaman,enhancement,24,9,15
Svddëndëath,sargeras,851,shaman,enhancement,30,9,21
Pingatronx,ragnaros,849,shaman,enhancement,19,12,7
Googurt,barthilas,831,shaman,enhancement,17,9,8
Britisy,stormrage,825,shaman,enhancement,24,10,14
Thunderlaw,area-52,800,shaman,enhancement,22,9,13
Dugomik,malganis,782,shaman,enhancement,13,9,4
Earthlsflat,tichondrius,781,shaman,enhancement,13,9,4
Gamergirlx,area-52,768,shaman,enhancement,12,8,4
Valkriie,tichondrius,768,shaman,enhancement,12,8,4
Totemclass,bleeding-hollow,768,shaman,enhancement,12,8,4
Gatorwaves,bleeding-hollow,768,shaman,enhancement,12,8,4
Mobiediqônú,skywall,768,shaman,enhancement,12,8,4
Crøwgød,tichondrius,768,shaman,enhancement,12,8,4
Täcti,tichondrius,768,shaman,enhancement,12,8,4
Riptiedx,barthilas,768,shaman,enhancement,12,8,4
Onamakawash,black-dragonflight,768,shaman,enhancement,12,8,4
Anzet,ragnaros,768,shaman,enhancement,12,8,4
Arázi,wyrmrest-accord,768,shaman,enhancement,18,8,10
Sethbrogen,vashj,768,shaman,enhancement,18,8,10
Thuntard,bleeding-hollow,768,shaman,enhancement,24,8,16
Keroh,blackrock,767,shaman,enhancement,12,8,4
Elevatezxo,stormrage,767,shaman,enhancement,12,8,4
Sparkqt,sargeras,767,shaman,enhancement,12,8,4
Cowely,madoran,767,shaman,enhancement,12,8,4
Faultline,khadgar,767,shaman,enhancement,12,8,4
Blasho,ragnaros,767,shaman,enhancement,12,8,4
Amasaei,bleeding-hollow,767,shaman,enhancement,18,8,10
Cuban,kelthuzad,767,shaman,enhancement,18,8,10
Stubbywayne,area-52,767,shaman,enhancement,18,8,10
Trulos,stormrage,766,shaman,enhancement,12,8,4
Holosoul,bleeding-hollow,766,shaman,enhancement,24,8,16
Shimshak,destromath,756,shaman,enhancement,18,8,10
Dedlystorm,dalaran,754,shaman,enhancement,12,8,4
Kumu,stormscale,735,shaman,enhancement,11,8,3
Ryb,sargeras,735,shaman,enhancement,14,9,5
Radan,kelthuzad,735,shaman,enhancement,17,8,9
Dàfèng,wyrmrest-accord,719,shaman,enhancement,23,8,15
Àspec,aegwynn,704,shaman,enhancement,10,8,2
Sevare,area-52,704,shaman,enhancement,16,8,8
Dashinra,stormrage,702,shaman,enhancement,14,8,6
Psilocypher,nazjatar,700,shaman,enhancement,14,8,6
Overpowered,korgath,672,shaman,enhancement,12,7,5
Jofstrom,tichondrius,672,shaman,enhancement,12,7,5
Peynful,shadowsong,672,shaman,enhancement,12,7,5
Pizzashaman,illidan,672,shaman,enhancement,12,7,5
Flukz,nazjatar,672,shaman,enhancement,12,7,5
Shmnsm,kiljaeden,672,shaman,enhancement,12,7,5
Asy,tichondrius,672,shaman,enhancement,12,7,5
Yaytotems,sargeras,672,shaman,enhancement,12,7,5
Tootshock,illidan,672,shaman,enhancement,12,7,5
Jazzlightnin,tichondrius,672,shaman,enhancement,12,7,5
Shockshack,illidan,672,shaman,enhancement,12,7,5
Marginalized,tichondrius,672,shaman,enhancement,12,7,5
Shokaria,frostwolf,672,shaman,enhancement,17,8,9
Cwippin,proudmoore,672,shaman,enhancement,18,7,11
Cammeez,area-52,672,shaman,enhancement,18,7,11
Elementalïst,durotan,671,shaman,enhancement,12,7,5
Hexondabeach,barthilas,671,shaman,enhancement,12,7,5
Clenlift,emerald-dream,671,shaman,enhancement,12,7,5
Zald,shattered-halls,671,shaman,enhancement,18,7,11
Dimitrio,azralon,671,shaman,enhancement,18,7,11
Gaelfury,malganis,671,shaman,enhancement,18,7,11
Velekar,moon-guard,671,shaman,enhancement,21,8,13
Drewshammy,zuljin,670,shaman,enhancement,12,7,5
Totesmagotes,scilla,670,shaman,enhancement,12,7,5
Orcgirth,kiljaeden,670,shaman,enhancement,21,8,13
Allmeatie,hyjal,669,shaman,enhancement,12,7,5
Helljumper,illidan,669,shaman,enhancement,21,8,13
Zatchbell,lightnings-blade,668,shaman,enhancement,12,7,5
Blaçktide,thrall,665,shaman,enhancement,12,7,5
Scams,bleeding-hollow,664,shaman,enhancement,12,7,5
Facebooksux,sargeras,657,shaman,enhancement,12,7,5
Orfelix,nemesis,656,shaman,enhancement,24,7,17
Wonima,tichondrius,639,shaman,enhancement,17,7,10
Chapope,quelthalas,637,shaman,enhancement,10,8,2
Deemmorti,stormrage,623,shaman,enhancement,17,7,10
Zmogon,quelthalas,607,shaman,enhancement,20,7,13
Kamíhameha,stormrage,603,shaman,enhancement,26,8,18
Eanne,moon-guard,592,shaman,enhancement,19,7,12
Shammich,vashj,576,shaman,enhancement,6,6,0
Möuthbläster,malganis,576,shaman,enhancement,6,6,0
Totegoat,nazjatar,576,shaman,enhancement,6,6,0
Nomoreswap,zuljin,576,shaman,enhancement,6,6,0
Ftierspec,frostmourne,576,shaman,enhancement,6,6,0
Clappadactyl,frostmourne,576,shaman,enhancement,12,6,6
Muisor,quelthalas,576,shaman,enhancement,12,6,6
Forksin,tichondrius,576,shaman,enhancement,12,6,6
Kyzen,tichondrius,576,shaman,enhancement,12,6,6
Finaplex,spirestone,576,shaman,enhancement,12,6,6
Mudroller,moon-guard,576,shaman,enhancement,12,6,6
Mackandal,tichondrius,576,shaman,enhancement,12,6,6
Lavamon,illidan,576,shaman,enhancement,12,6,6
Fischerman,barthilas,576,shaman,enhancement,12,6,6
Ephraalin,frostmourne,576,shaman,enhancement,12,6,6
Scarlo,bleeding-hollow,576,shaman,enhancement,12,6,6
Pinechanga,ragnaros,576,shaman,enhancement,12,6,6
Leotis,tichondrius,576,shaman,enhancement,12,6,6
Yakora,stormrage,576,shaman,enhancement,12,6,6
Groovesh,thrall,576,shaman,enhancement,14,6,8
Volsdeep,illidan,576,shaman,enhancement,18,6,12
Ferdashock,tichondrius,576,shaman,enhancement,18,6,12
Getacho,stormrage,576,shaman,enhancement,24,6,18
Naextramus,ragnaros,575,shaman,enhancement,12,6,6
Somethingdop,sargeras,575,shaman,enhancement,12,6,6
Nuofu,illidan,575,shaman,enhancement,16,7,9
Møp,spirestone,575,shaman,enhancement,18,6,12
Talfur,area-52,575,shaman,enhancement,18,6,12
Xapoxy,nemesis,574,shaman,enhancement,12,6,6
Obrahma,burning-legion,574,shaman,enhancement,12,6,6
Charr,nemesis,571,shaman,enhancement,12,6,6
Fadesrp,moon-guard,571,shaman,enhancement,12,6,6
Zalkran,area-52,569,shaman,enhancement,12,6,6
Tukkutz,moon-guard,526,shaman,enhancement,15,6,9
Pwnskillz,area-52,525,shaman,enhancement,11,6,5
Noveske,arthas,522,shaman,enhancement,15,7,8
Zaxibow,area-52,496,shaman,enhancement,19,6,13
Fiercegoblin,drakkari,493,shaman,enhancement,19,6,13
Ggsggs,akama,480,shaman,enhancement,6,5,1
Toobeastly,deathwing,480,shaman,enhancement,6,5,1
Tizzl,kelthuzad,480,shaman,enhancement,6,5,1
Pwnôgraphy,kelthuzad,480,shaman,enhancement,6,5,1
Popsmoke,gnomeregan,480,shaman,enhancement,6,5,1
Iava,dalaran,480,shaman,enhancement,6,5,1
Nakamora,tichondrius,480,shaman,enhancement,6,5,1
Beatmán,blades-edge,480,shaman,enhancement,6,5,1
Geeblast,area-52,480,shaman,enhancement,6,5,1
Mynigabob,zuljin,480,shaman,enhancement,6,5,1
Raídyn,sargeras,480,shaman,enhancement,6,5,1
Bofah,draktharon,480,shaman,enhancement,6,5,1
Daysub,crushridge,480,shaman,enhancement,6,5,1
Rokudo,dragonmaw,480,shaman,enhancement,6,5,1
Nekorii,bleeding-hollow,480,shaman,enhancement,6,5,1
Meatlog,dalaran,480,shaman,enhancement,12,5,7
Norlak,antonidas,480,shaman,enhancement,12,5,7
Shometrin,tichondrius,480,shaman,enhancement,12,5,7
Stankydad,tichondrius,480,shaman,enhancement,12,5,7
Kultirio,quelthalas,480,shaman,enhancement,12,5,7
Spencesham,sargeras,480,shaman,enhancement,12,5,7
Shomani,madoran,480,shaman,enhancement,12,5,7
Boboyaga,emerald-dream,480,shaman,enhancement,12,5,7
Matzahmeal,skywall,480,shaman,enhancement,12,5,7
Earthclap,tichondrius,480,shaman,enhancement,12,5,7
Aldinatir,ragnaros,480,shaman,enhancement,12,5,7
Scrototæm,area-52,480,shaman,enhancement,12,5,7
Ishano,area-52,480,shaman,enhancement,12,5,7
Makocc,tichondrius,480,shaman,enhancement,14,5,9
Gyokuken,stormrage,480,shaman,enhancement,18,5,13
Hazorele,nagrand,479,shaman,enhancement,12,5,7
Deathjoker,icecrown,479,shaman,enhancement,12,5,7
Vladd,hellscream,479,shaman,enhancement,12,5,7
Tugnar,ragnaros,479,shaman,enhancement,12,5,7
Stroheim,warsong,478,shaman,enhancement,6,5,1
Brorogan,aerie-peak,478,shaman,enhancement,12,5,7
Enkkiz,ragnaros,477,shaman,enhancement,12,5,7
Çhïcagø,aegwynn,448,shaman,enhancement,10,5,5
Baloneyfiveo,kiljaeden,447,shaman,enhancement,14,6,8
Mastrionilol,dragonmaw,384,shaman,enhancement,6,4,2
Shomminn,tichondrius,384,shaman,enhancement,6,4,2
Mullten,sargeras,384,shaman,enhancement,6,4,2
Indaka,kiljaeden,384,shaman,enhancement,6,4,2
Angrytotems,ragnaros,384,shaman,enhancement,6,4,2
Jènova,whisperwind,384,shaman,enhancement,6,4,2
Kylani,thrall,384,shaman,enhancement,6,4,2
Protoaster,tichondrius,384,shaman,enhancement,6,4,2
Shalkahn,malganis,384,shaman,enhancement,6,4,2
Ezzroz,guldan,384,shaman,enhancement,6,4,2
Cinderfury,magtheridon,384,shaman,enhancement,6,4,2
Yildiri,area-52,384,shaman,enhancement,6,4,2
Bioshocked,korgath,384,shaman,enhancement,6,4,2
Grimwind,tichondrius,384,shaman,enhancement,6,4,2
Djshammy,barthilas,384,shaman,enhancement,6,4,2
Hooluu,frostmourne,384,shaman,enhancement,6,4,2
Jäyp,thrall,384,shaman,enhancement,6,4,2
Lukora,stonemaul,384,shaman,enhancement,6,4,2
Agpx,tichondrius,384,shaman,enhancement,6,4,2
Sorgal,area-52,384,shaman,enhancement,6,4,2
Slurslinger,area-52,384,shaman,enhancement,6,4,2
Gorgrom,thunderlord,384,shaman,enhancement,6,4,2
Kungfuvoodoo,tichondrius,384,shaman,enhancement,6,4,2
Shamcowhah,frostmourne,384,shaman,enhancement,6,4,2
Utilitytotem,moon-guard,384,shaman,enhancement,6,4,2
Rtÿo,area-52,384,shaman,enhancement,6,4,2
Katojune,tichondrius,384,shaman,enhancement,6,4,2
Raxabico,nemesis,384,shaman,enhancement,12,4,8
Borwald,dalaran,384,shaman,enhancement,12,4,8
Shabenn,proudmoore,384,shaman,enhancement,12,4,8
Wagar,dawnbringer,384,shaman,enhancement,12,4,8
Gaurudon,zuljin,384,shaman,enhancement,12,4,8
Gangdan,emerald-dream,384,shaman,enhancement,12,4,8
Durozu,tichondrius,384,shaman,enhancement,12,4,8
Vertrág,malganis,384,shaman,enhancement,12,4,8
Ghogann,bleeding-hollow,383,shaman,enhancement,6,4,2
Kalashnikov,maiev,383,shaman,enhancement,12,4,8
Ðg,tichondrius,382,shaman,enhancement,12,4,8
Thanwirn,ragnaros,381,shaman,enhancement,12,4,8
Admetis,vashj,351,shaman,enhancement,17,4,13
Groundfaults,bleeding-hollow,335,shaman,enhancement,11,4,7
Jeaunoo,darkspear,330,shaman,enhancement,14,5,9
Thorael,borean-tundra,319,shaman,enhancement,5,4,1
Sasageyo,tichondrius,319,shaman,enhancement,8,4,4
Tempestsmash,tichondrius,304,shaman,enhancement,7,4,3
Gorszu,proudmoore,288,shaman,enhancement,6,3,3
Enhpower,area-52,288,shaman,enhancement,6,3,3
Cowaii,illidan,288,shaman,enhancement,6,3,3
Kidkovid,illidan,288,shaman,enhancement,6,3,3
Gingeroo,stonemaul,288,shaman,enhancement,6,3,3
Lightnessx,stormrage,288,shaman,enhancement,6,3,3
Vanmaichet,azshara,288,shaman,enhancement,6,3,3
Sourcreamqtx,stormrage,288,shaman,enhancement,6,3,3
Lennylemons,stormrage,288,shaman,enhancement,6,3,3
Ban,blackrock,288,shaman,enhancement,6,3,3
Newele,thrall,288,shaman,enhancement,6,3,3
Argena,bonechewer,288,shaman,enhancement,6,3,3
Haititnahtou,kaelthas,288,shaman,enhancement,6,3,3
Painfury,zuljin,288,shaman,enhancement,6,3,3
Korgen,area-52,288,shaman,enhancement,6,3,3
Freshoranges,blood-furnace,288,shaman,enhancement,6,3,3
Slowkeeper,azralon,288,shaman,enhancement,6,3,3
Radiology,garithos,288,shaman,enhancement,6,3,3
Chamxz,ragnaros,288,shaman,enhancement,6,3,3
Jokerxksx,tichondrius,288,shaman,enhancement,6,3,3
Argues,tichondrius,288,shaman,enhancement,6,3,3
Dalsun,turalyon,288,shaman,enhancement,6,3,3
Olxsixsm,illidan,288,shaman,enhancement,6,3,3
Stoneseed,steamwheedle-cartel,288,shaman,enhancement,6,3,3
Volrog,magtheridon,288,shaman,enhancement,6,3,3
Jibbajabber,laughing-skull,288,shaman,enhancement,6,3,3
Bloodytotemz,emerald-dream,288,shaman,enhancement,6,3,3
Alablast,malganis,288,shaman,enhancement,6,3,3
Gojiras,barthilas,288,shaman,enhancement,6,3,3
Tyven,tichondrius,288,shaman,enhancement,6,3,3
Zoma,elune,288,shaman,enhancement,6,3,3
Emtflakes,darkspear,288,shaman,enhancement,6,3,3
Mundi,madoran,288,shaman,enhancement,6,3,3
Jumoma,thrall,288,shaman,enhancement,6,3,3
Swifteyy,area-52,288,shaman,enhancement,6,3,3
Sleepysham,kelthuzad,288,shaman,enhancement,6,3,3
Ginjij,thrall,288,shaman,enhancement,6,3,3
Shamaro,malganis,288,shaman,enhancement,6,3,3
Stormwolf,emerald-dream,288,shaman,enhancement,6,3,3
Dogcompany,tichondrius,288,shaman,enhancement,6,3,3
Torvi,saurfang,288,shaman,enhancement,6,3,3
Adhdeeznuts,frostmourne,288,shaman,enhancement,6,3,3
Tumble,frostmourne,288,shaman,enhancement,6,3,3
Getwetand,quelthalas,288,shaman,enhancement,6,3,3
Aruçar,drakkari,288,shaman,enhancement,6,3,3
Fevolution,dreadmaul,288,shaman,enhancement,6,3,3
Luxenor,kelthuzad,288,shaman,enhancement,6,3,3
Eliteshamann,tichondrius,288,shaman,enhancement,6,3,3
Arckos,thrall,288,shaman,enhancement,6,3,3
Corkrain,sargeras,288,shaman,enhancement,6,3,3
Slowdown,malganis,288,shaman,enhancement,6,3,3
Mavz,moon-guard,288,shaman,enhancement,6,3,3
Botu,malorne,288,shaman,enhancement,6,3,3
Smeeza,frostmourne,288,shaman,enhancement,6,3,3
Hammaam,illidan,288,shaman,enhancement,12,3,9
Drgiggleheim,tichondrius,288,shaman,enhancement,12,3,9
Jireñ,area-52,288,shaman,enhancement,12,3,9
Malsturm,stormrage,288,shaman,enhancement,12,3,9
Regeneration,darkspear,288,shaman,enhancement,12,3,9
Orcshamen,tichondrius,288,shaman,enhancement,12,3,9
Aegaeonlol,tichondrius,288,shaman,enhancement,12,3,9
Jajxshammy,rivendare,288,shaman,enhancement,12,3,9
Wickyz,moon-guard,288,shaman,enhancement,12,3,9
Smeagðl,tichondrius,288,shaman,enhancement,12,3,9
Gwyste,moon-guard,288,shaman,enhancement,12,3,9
Gudac,tichondrius,288,shaman,enhancement,12,3,9
Hordeymaori,saurfang,287,shaman,enhancement,6,3,3
Thanen,the-scryers,287,shaman,enhancement,8,3,5
Calich,kelthuzad,255,shaman,enhancement,11,4,7
Curtrex,amanthul,239,shaman,enhancement,5,3,2
Caobuloso,azralon,239,shaman,enhancement,5,3,2
Thorsén,ursin,239,shaman,enhancement,11,3,8
Smooths,bloodscalp,234,shaman,enhancement,19,5,14
Hurrikaine,dalaran,192,shaman,enhancement,6,2,4
Harvesting,azralon,192,shaman,enhancement,6,2,4
Lenin,nathrezim,192,shaman,enhancement,6,2,4
Díesel,azralon,192,shaman,enhancement,6,2,4
Vitaminc,garona,192,shaman,enhancement,6,2,4
Bitxxnumber,tichondrius,192,shaman,enhancement,6,2,4
Zeldrys,emerald-dream,192,shaman,enhancement,6,2,4
Böc,tichondrius,192,shaman,enhancement,6,2,4
Harrìson,tichondrius,192,shaman,enhancement,6,2,4
Pissticles,bleeding-hollow,192,shaman,enhancement,6,2,4
Thorlottie,stormrage,192,shaman,enhancement,6,2,4
ßeesy,emerald-dream,192,shaman,enhancement,6,2,4
Tøtëm,tichondrius,192,shaman,enhancement,6,2,4
Jammylol,frostmourne,192,shaman,enhancement,6,2,4
Hammerdog,illidan,192,shaman,enhancement,6,2,4
Vjeze,frostmourne,192,shaman,enhancement,6,2,4
Scarshamxn,frostmourne,192,shaman,enhancement,6,2,4
Shámdemons,area-52,192,shaman,enhancement,6,2,4
Boj,magtheridon,192,shaman,enhancement,6,2,4
Shamanakin,emerald-dream,192,shaman,enhancement,6,2,4
Dadajuju,azralon,192,shaman,enhancement,6,2,4
Tyranitaur,frostmourne,192,shaman,enhancement,6,2,4
Killavicious,area-52,192,shaman,enhancement,6,2,4
Kulnash,auchindoun,192,shaman,enhancement,6,2,4
Totemzie,illidan,192,shaman,enhancement,6,2,4
Ceedlamb,kelthuzad,192,shaman,enhancement,6,2,4
Ectomee,tichondrius,192,shaman,enhancement,6,2,4
Stormfronts,kelthuzad,192,shaman,enhancement,6,2,4
Cutedraenei,destromath,192,shaman,enhancement,6,2,4
Amärök,area-52,192,shaman,enhancement,6,2,4
Hazak,nemesis,192,shaman,enhancement,6,2,4
Bullcowsby,darkspear,192,shaman,enhancement,6,2,4
Jasonnworb,tichondrius,192,shaman,enhancement,6,2,4
Sparklebunny,dark-iron,192,shaman,enhancement,6,2,4
Shamflu,tichondrius,192,shaman,enhancement,6,2,4
Stallos,zuljin,192,shaman,enhancement,6,2,4
Brofessor,frostwolf,192,shaman,enhancement,6,2,4
Shamnick,malganis,192,shaman,enhancement,6,2,4
Meattoilet,tichondrius,192,shaman,enhancement,6,2,4
Girthquake,agamaggan,192,shaman,enhancement,6,2,4
Zentius,thunderhorn,192,shaman,enhancement,6,2,4
Hothandxo,illidan,192,shaman,enhancement,6,2,4
Durogh,darkspear,192,shaman,enhancement,6,2,4
Mishalla,tichondrius,192,shaman,enhancement,6,2,4
Tamzlol,the-forgotten-coast,192,shaman,enhancement,6,2,4
Reptimus,sargeras,192,shaman,enhancement,6,2,4
Canabal,eonar,192,shaman,enhancement,6,2,4
Twistër,illidan,192,shaman,enhancement,6,2,4
Zeebouzy,illidan,192,shaman,enhancement,6,2,4
Shocksrus,arthas,192,shaman,enhancement,6,2,4
Macumbolo,nemesis,192,shaman,enhancement,6,2,4
Hagass,tichondrius,192,shaman,enhancement,6,2,4
Mercó,bleeding-hollow,192,shaman,enhancement,6,2,4
Hèllzpyro,sargeras,192,shaman,enhancement,6,2,4
Jackofstorms,veknilash,192,shaman,enhancement,6,2,4
Soapmactavis,sargeras,192,shaman,enhancement,6,2,4
Spiderjohn,sargeras,192,shaman,enhancement,6,2,4
Solka,illidan,192,shaman,enhancement,6,2,4
Dennwoop,sargeras,192,shaman,enhancement,6,2,4
Jahahahamon,arthas,192,shaman,enhancement,6,2,4
Thrallzballz,firetree,192,shaman,enhancement,6,2,4
Electrica,quelthalas,192,shaman,enhancement,6,2,4
Pericazo,sargeras,192,shaman,enhancement,6,2,4
Zuljiba,illidan,192,shaman,enhancement,12,2,10
Calmconflict,daggerspine,191,shaman,enhancement,6,2,4
Skuffedx,spirestone,159,shaman,enhancement,5,2,3
Nuggitz,tichondrius,159,shaman,enhancement,5,2,3
Badgeshock,area-52,128,shaman,enhancement,4,2,2
Intress,moon-guard,128,shaman,enhancement,4,2,2
Ludacrìtz,stormrage,112,shaman,enhancement,7,2,5
Tekdar,kiljaeden,96,shaman,enhancement,3,2,1
Wälee,sargeras,96,shaman,enhancement,6,1,5
Orendail,jubeithos,96,shaman,enhancement,6,1,5
Paramecium,sargeras,96,shaman,enhancement,6,1,5
Alferian,moon-guard,96,shaman,enhancement,6,1,5
Kumboi,frostmourne,96,shaman,enhancement,6,1,5
Kinjin,dragonmaw,96,shaman,enhancement,6,1,5
Beazel,moon-guard,96,shaman,enhancement,6,1,5
Drekkhal,area-52,96,shaman,enhancement,6,1,5
Axshaman,darkspear,96,shaman,enhancement,6,1,5
Sweettooth,area-52,96,shaman,enhancement,6,1,5
Shockfreak,stormrage,96,shaman,enhancement,6,1,5
Acéz,korgath,96,shaman,enhancement,6,1,5
Balldo,stormrage,96,shaman,enhancement,6,1,5
Sèktor,dalaran,96,shaman,enhancement,6,1,5
Karmar,proudmoore,96,shaman,enhancement,6,1,5
Niteshammy,lothar,96,shaman,enhancement,6,1,5
Axelsteel,illidan,96,shaman,enhancement,6,1,5
Geladoo,gallywix,96,shaman,enhancement,6,1,5
Zapsquidzap,illidan,96,shaman,enhancement,6,1,5
Wangbangjr,mugthol,96,shaman,enhancement,6,1,5
Zoeyzour,illidan,96,shaman,enhancement,6,1,5
Azzula,tichondrius,96,shaman,enhancement,7,1,6
Threehandz,bleeding-hollow,96,shaman,enhancement,8,1,7
Poagrious,bonechewer,96,shaman,enhancement,12,1,11
Smokeymcpots,khazgoroth,95,shaman,enhancement,6,1,5
Dilldoughnut,sargeras,79,shaman,enhancement,5,1,4
Reavs,illidan,42,shaman,enhancement,10,2,8
Mlx,proudmoore,2345,warlock,demonology,113,66,47
Wildimp,aerie-peak,2190,warlock,demonology,78,45,33
Beyourselff,tichondrius,2156,warlock,demonology,85,45,40
Gentleq,tichondrius,2149,warlock,demonology,99,53,46
Wzxx,tichondrius,2143,warlock,demonology,66,37,29
Fishorz,tichondrius,2128,warlock,demonology,89,47,42
Awdam,tichondrius,2114,warlock,demonology,96,50,46
Ensebado,azralon,2111,warlock,demonology,140,78,62
Falco,azshara,2110,warlock,demonology,66,38,28
Cosmosxx,illidan,2110,warlock,demonology,112,58,54
Ztlivid,area-52,2050,warlock,demonology,129,70,59
Ogchaos,tichondrius,2041,warlock,demonology,72,40,32
Nocrackrocks,stormrage,2037,warlock,demonology,105,61,44
Etuskaa,tichondrius,2015,warlock,demonology,80,42,38
Zuelu,tichondrius,2012,warlock,demonology,55,33,22
Sslock,sargeras,2008,warlock,demonology,71,37,34
Ziffy,emerald-dream,2008,warlock,demonology,66,34,32
Wesyane,anetheron,2004,warlock,demonology,79,39,40
Amazingamez,sargeras,1992,warlock,demonology,109,54,55
Extreme,blackwing-lair,1978,warlock,demonology,78,53,25
Petattack,nerzhul,1968,warlock,demonology,107,54,53
Kaossqt,azralon,1949,warlock,demonology,72,35,37
Bronzerl,tichondrius,1947,warlock,demonology,29,21,8
Lrry,dalaran,1947,warlock,demonology,66,47,19
Ihaveapowers,maiev,1935,warlock,demonology,90,45,45
Toiletghost,tichondrius,1934,warlock,demonology,38,25,13
Elbrujon,sargeras,1933,warlock,demonology,59,31,28
Erock,korgath,1922,warlock,demonology,36,29,7
Lilballz,tichondrius,1909,warlock,demonology,36,20,16
Daerde,malganis,1900,warlock,demonology,47,27,20
Siphoned,darkspear,1900,warlock,demonology,53,27,26
Ofc,malganis,1899,warlock,demonology,42,26,16
Deadlpoo,stormscale,1899,warlock,demonology,81,41,40
Littlerod,tichondrius,1896,warlock,demonology,30,20,10
Ketahole,warsong,1895,warlock,demonology,57,30,27
Gianni,chogall,1893,warlock,demonology,59,28,31
Kimchiblast,tichondrius,1876,warlock,demonology,48,28,20
Sàill,tichondrius,1871,warlock,demonology,35,22,13
Bigdaddylol,ragnaros,1849,warlock,demonology,53,30,23
Unhòólylck,ragnaros,1848,warlock,demonology,46,25,21
Thranlock,area-52,1846,warlock,demonology,60,33,27
Rakudemon,ragnaros,1833,warlock,demonology,135,72,63
Spicyfingers,illidan,1829,warlock,demonology,48,29,19
Evildeath,tichondrius,1829,warlock,demonology,48,26,22
Stopdot,lightnings-blade,1829,warlock,demonology,58,31,27
Ceeloftw,tichondrius,1827,warlock,demonology,72,36,36
Xoboroz,moon-guard,1827,warlock,demonology,60,29,31
Zydiva,sargeras,1826,warlock,demonology,58,31,27
Playtoy,moon-guard,1826,warlock,demonology,142,71,71
Castingfear,barthilas,1825,warlock,demonology,48,27,21
Babydots,stormreaver,1825,warlock,demonology,82,41,41
Villaìn,moon-guard,1817,warlock,demonology,75,34,41
Boltqt,tichondrius,1815,warlock,demonology,36,22,14
Ltr,moon-guard,1811,warlock,demonology,30,22,8
Abrocket,alleria,1811,warlock,demonology,30,19,11
Naughtybolts,sargeras,1811,warlock,demonology,32,20,12
Voidxo,tichondrius,1811,warlock,demonology,36,22,14
Kerrigan,the-venture-co,1810,warlock,demonology,54,33,21
Errogant,area-52,1810,warlock,demonology,60,30,30
Chaosthekid,malganis,1807,warlock,demonology,40,25,15
Xacayth,ragnaros,1804,warlock,demonology,80,47,33
Darkborkain,tichondrius,1803,warlock,demonology,30,19,11
Vexxes,malganis,1803,warlock,demonology,54,29,25
Debao,malganis,1802,warlock,demonology,48,25,23
Thelockzx,azralon,1801,warlock,demonology,60,28,32
Paygo,tichondrius,1795,warlock,demonology,30,19,11
Hugebolt,tichondrius,1793,warlock,demonology,48,28,20
Atheø,ragnaros,1791,warlock,demonology,36,19,17
Spreadlove,emerald-dream,1766,warlock,demonology,126,68,58
Jaganshi,tichondrius,1764,warlock,demonology,46,26,20
Milkybøng,area-52,1763,warlock,demonology,87,57,30
Döremi,tichondrius,1760,warlock,demonology,35,21,14
Arcinian,kelthuzad,1760,warlock,demonology,60,34,26
Dowal,whisperwind,1747,warlock,demonology,42,23,19
Mcpickls,illidan,1740,warlock,demonology,48,26,22
Chanigay,tichondrius,1737,warlock,demonology,35,20,15
Dreadlõck,malganis,1737,warlock,demonology,78,39,39
Sofan,dalaran,1729,warlock,demonology,40,25,15
Huajianmanwu,tichondrius,1727,warlock,demonology,106,52,54
Overclocked,destromath,1726,warlock,demonology,24,18,6
Domenic,sentinels,1725,warlock,demonology,46,26,20
Playßøy,area-52,1724,warlock,demonology,30,18,12
Fatass,cairne,1724,warlock,demonology,30,18,12
Tessarath,area-52,1721,warlock,demonology,30,18,12
Bahamas,bleeding-hollow,1719,warlock,demonology,48,24,24
Muchas,area-52,1717,warlock,demonology,30,18,12
Fadedemon,area-52,1716,warlock,demonology,42,32,10
Aramith,tichondrius,1715,warlock,demonology,42,25,17
Bwonsamdijin,tichondrius,1700,warlock,demonology,54,24,30
Wildimpx,sargeras,1698,warlock,demonology,36,20,16
Yükina,stormrage,1696,warlock,demonology,30,20,10
Ourlegacy,tichondrius,1695,warlock,demonology,40,24,16
Fksm,tichondrius,1692,warlock,demonology,36,20,16
Stopdottroll,zuljin,1690,warlock,demonology,30,18,12
Dìablo,area-52,1690,warlock,demonology,60,34,26
Axelrodx,tichondrius,1689,warlock,demonology,24,18,6
Metrow,area-52,1688,warlock,demonology,30,18,12
Leeka,tichondrius,1687,warlock,demonology,48,23,25
Lockiator,moon-guard,1686,warlock,demonology,41,24,17
Smallj,zuljin,1685,warlock,demonology,30,19,11
Eazyw,stormrage,1685,warlock,demonology,53,21,32
Notomorrow,tichondrius,1682,warlock,demonology,128,78,50
Vcain,stormrage,1680,warlock,demonology,60,29,31
Säbrine,zuljin,1679,warlock,demonology,73,35,38
Erlandesher,tichondrius,1677,warlock,demonology,30,19,11
Jyhoona,chromaggus,1673,warlock,demonology,130,67,63
Shinyballz,tichondrius,1673,warlock,demonology,35,18,17
Sharaßha,moon-guard,1671,warlock,demonology,33,20,13
Xadge,tichondrius,1668,warlock,demonology,35,19,16
Aroug,aggramar,1665,warlock,demonology,78,38,40
Ðëâthløck,tichondrius,1663,warlock,demonology,35,22,13
Harrydotterr,bonechewer,1658,warlock,demonology,30,18,12
Toestye,lightbringer,1656,warlock,demonology,78,43,35
Atheô,ragnaros,1655,warlock,demonology,41,22,19
Magë,ursin,1655,warlock,demonology,42,22,20
Gihaewon,tichondrius,1650,warlock,demonology,30,20,10
Caesaros,quelthalas,1649,warlock,demonology,36,20,16
Xaryl,stormrage,1646,warlock,demonology,48,25,23
Soreanus,illidan,1645,warlock,demonology,42,28,14
Zantology,frostmourne,1644,warlock,demonology,48,29,19
Amour,wyrmrest-accord,1644,warlock,demonology,52,25,27
Demonicsmoke,darrowmere,1638,warlock,demonology,89,49,40
Blastfinger,tichondrius,1637,warlock,demonology,42,24,18
Fearedu,thunderhorn,1633,warlock,demonology,101,47,54
Hoana,azralon,1630,warlock,demonology,75,47,28
Innocentius,illidan,1630,warlock,demonology,70,37,33
Tarth,sargeras,1627,warlock,demonology,36,21,15
Dëvïl,ragnaros,1626,warlock,demonology,30,21,9
Juxsr,nerzhul,1624,warlock,demonology,36,21,15
Altairo,illidan,1621,warlock,demonology,36,20,16
Missalice,nesingwary,1619,warlock,demonology,30,17,13
Btsfangirl,moon-guard,1619,warlock,demonology,41,20,21
Mhael,lightninghoof,1618,warlock,demonology,30,20,10
Forsâken,tichondrius,1618,warlock,demonology,83,39,44
Buymymixtåpe,ursin,1615,warlock,demonology,33,21,12
Åmön,zuljin,1615,warlock,demonology,42,20,22
Eastwitch,ragnaros,1615,warlock,demonology,36,17,19
Xlilgee,kelthuzad,1614,warlock,demonology,30,17,13
Abismoarmdr,ragnaros,1613,warlock,demonology,115,66,49
Alndron,thrall,1613,warlock,demonology,36,17,19
Juswannarock,tichondrius,1610,warlock,demonology,39,21,18
Rathul,bonechewer,1609,warlock,demonology,31,18,13
Fullxd,quelthalas,1607,warlock,demonology,36,24,12
Ciprýan,azralon,1607,warlock,demonology,42,20,22
Phóbòs,tichondrius,1605,warlock,demonology,30,20,10
Warlocklmao,malganis,1594,warlock,demonology,36,19,17
Beatinu,draenor,1592,warlock,demonology,30,19,11
Houdneeznuts,tichondrius,1591,warlock,demonology,67,36,31
Doombaby,zuljin,1588,warlock,demonology,48,30,18
Mixtape,stormrage,1582,warlock,demonology,30,18,12
Spooknjuke,bleeding-hollow,1576,warlock,demonology,35,24,11
Cinderwhip,moon-guard,1560,warlock,demonology,87,43,44
Redbullsz,bleeding-hollow,1549,warlock,demonology,56,27,29
Wickdways,daggerspine,1546,warlock,demonology,54,32,22
Bauchalain,area-52,1541,warlock,demonology,36,21,15
Eriand,nordrassil,1534,warlock,demonology,42,23,19
Isometrics,barthilas,1534,warlock,demonology,30,16,14
Soulrulerxc,tichondrius,1534,warlock,demonology,30,16,14
Canobio,tichondrius,1531,warlock,demonology,18,16,2
Cambolts,tichondrius,1523,warlock,demonology,30,16,14
Wollylock,dark-iron,1520,warlock,demonology,52,25,27
Zver,drakkari,1515,warlock,demonology,24,16,8
Curseifier,frostmourne,1514,warlock,demonology,38,19,19
Yanlexx,stormrage,1512,warlock,demonology,62,29,33
Obséssèd,aggramar,1510,warlock,demonology,30,16,14
Raidspot,bleeding-hollow,1509,warlock,demonology,30,18,12
Krolczdots,tichondrius,1505,warlock,demonology,30,18,12
Parmenides,tichondrius,1502,warlock,demonology,112,56,56
Bigdotenergi,tichondrius,1501,warlock,demonology,24,16,8
Icemanliddel,area-52,1500,warlock,demonology,35,16,19
Funkminot,illidan,1496,warlock,demonology,133,66,67
Dárklórd,dalaran,1491,warlock,demonology,90,48,42
Blavindy,illidan,1489,warlock,demonology,48,24,24
Fãttyqt,sargeras,1452,warlock,demonology,34,24,10
Iselltacos,dalaran,1451,warlock,demonology,25,16,9
Dreamsw,frostmourne,1439,warlock,demonology,24,15,9
Darkwîngduck,illidan,1439,warlock,demonology,24,15,9
Lamo,dawnbringer,1438,warlock,demonology,70,33,37
Teivlol,mugthol,1437,warlock,demonology,24,15,9
Sosahawk,stormrage,1437,warlock,demonology,30,15,15
Chaosboltlol,tichondrius,1436,warlock,demonology,30,15,15
Proletariat,moon-guard,1432,warlock,demonology,36,22,14
Cornboil,tichondrius,1431,warlock,demonology,55,27,28
Kandrus,moon-guard,1430,warlock,demonology,80,36,44
Dlchem,tichondrius,1425,warlock,demonology,24,15,9
Mcjoy,akama,1422,warlock,demonology,42,26,16
Silentfears,tichondrius,1414,warlock,demonology,19,15,4
Synisterlock,moon-guard,1405,warlock,demonology,30,16,14
Deathcyth,crushridge,1403,warlock,demonology,59,31,28
Suminl,tichondrius,1392,warlock,demonology,24,15,9
Mysteryannie,tichondrius,1371,warlock,demonology,70,42,28
Broccoleh,area-52,1344,warlock,demonology,24,14,10
Dlhmlock,tichondrius,1343,warlock,demonology,18,14,4
Biubius,tichondrius,1343,warlock,demonology,24,14,10
Xygg,tichondrius,1343,warlock,demonology,24,14,10
Alisa,moon-guard,1343,warlock,demonology,24,14,10
Dotman,tichondrius,1343,warlock,demonology,24,14,10
Wrathh,stormscale,1343,warlock,demonology,27,15,12
Drakatattwo,tichondrius,1343,warlock,demonology,30,14,16
Awangdemon,tichondrius,1341,warlock,demonology,36,14,22
Dogegg,tichondrius,1340,warlock,demonology,30,14,16
Demonalien,malganis,1339,warlock,demonology,18,14,4
Zhoull,thrall,1336,warlock,demonology,36,15,21
Gotfear,zuljin,1335,warlock,demonology,57,31,26
Salacia,chogall,1328,warlock,demonology,36,18,18
Eldriptch,kelthuzad,1325,warlock,demonology,27,15,12
Eriebos,area-52,1323,warlock,demonology,28,15,13
Jokerks,tichondrius,1310,warlock,demonology,23,14,9
Ktlock,frostmourne,1306,warlock,demonology,29,15,14
Arlenna,sargeras,1302,warlock,demonology,68,26,42
Shadowflame,skullcrusher,1299,warlock,demonology,85,45,40
Gauul,illidan,1281,warlock,demonology,70,39,31
Heathncraig,illidan,1279,warlock,demonology,50,29,21
Kuyog,illidan,1279,warlock,demonology,30,14,16
Screampied,sargeras,1279,warlock,demonology,53,24,29
Harambê,sargeras,1248,warlock,demonology,18,13,5
Oymmander,illidan,1248,warlock,demonology,18,13,5
Scalpelx,tichondrius,1248,warlock,demonology,18,13,5
Drakatat,tichondrius,1248,warlock,demonology,24,13,11
Ediya,tichondrius,1248,warlock,demonology,24,13,11
Deathboltx,zuljin,1248,warlock,demonology,24,13,11
Necronemesis,arthas,1243,warlock,demonology,24,13,11
Th,kiljaeden,1241,warlock,demonology,30,13,17
Tizzy,malganis,1210,warlock,demonology,18,13,5
Wazog,jubeithos,1203,warlock,demonology,24,13,11
Narmazulnn,area-52,1180,warlock,demonology,17,13,4
Artmaster,nordrassil,1174,warlock,demonology,30,20,10
Medzor,tichondrius,1152,warlock,demonology,24,12,12
Skanckqt,malganis,1150,warlock,demonology,18,12,6
Valkynaris,chogall,1150,warlock,demonology,18,12,6
Bagn,tichondrius,1150,warlock,demonology,18,12,6
Aomniloltv,zuljin,1150,warlock,demonology,18,12,6
Felorc,wyrmrest-accord,1150,warlock,demonology,24,13,11
Eternalsmile,tichondrius,1149,warlock,demonology,18,12,6
Lockedinn,mannoroth,1149,warlock,demonology,24,12,12
Bic,thrall,1148,warlock,demonology,18,12,6
Yuengling,illidan,1148,warlock,demonology,24,12,12
Tickleskin,windrunner,1146,warlock,demonology,25,13,12
Diabolock,proudmoore,1146,warlock,demonology,24,12,12
Sugarwaffles,area-52,1144,warlock,demonology,18,12,6
Kìllèrgf,area-52,1144,warlock,demonology,30,12,18
Critthis,illidan,1141,warlock,demonology,24,12,12
Arcaangell,sargeras,1117,warlock,demonology,36,16,20
Löksöflöve,sargeras,1101,warlock,demonology,60,25,35
Saltiernuts,malganis,1093,warlock,demonology,36,15,21
Gromy,lightnings-blade,1084,warlock,demonology,23,12,11
Lilmollyboy,demon-soul,1068,warlock,demonology,13,12,1
Bøltqt,tichondrius,1056,warlock,demonology,12,11,1
Coèrce,tichondrius,1056,warlock,demonology,18,11,7
Zörkô,zuljin,1056,warlock,demonology,18,11,7
Demondisco,tichondrius,1056,warlock,demonology,24,11,13
Zzooxxqt,area-52,1056,warlock,demonology,24,11,13
Maadhum,illidan,1056,warlock,demonology,27,12,15
Aidadeshu,tichondrius,1055,warlock,demonology,24,11,13
Comina,kelthuzad,1055,warlock,demonology,24,11,13
Lockeslock,sargeras,1055,warlock,demonology,24,11,13
Shooterg,tichondrius,1055,warlock,demonology,24,11,13
Drain,proudmoore,1054,warlock,demonology,12,11,1
Avoidence,tanaris,1050,warlock,demonology,18,11,7
Dcpwns,arthas,1050,warlock,demonology,24,11,13
Zinkro,quelthalas,1049,warlock,demonology,22,12,10
Tròll,moon-guard,1049,warlock,demonology,54,25,29
Tartamuda,ragnaros,1037,warlock,demonology,30,11,19
Wls,frostmourne,1006,warlock,demonology,23,11,12
Bleachkk,tichondrius,960,warlock,demonology,12,10,2
Tazerr,sargeras,960,warlock,demonology,18,10,8
Idiocy,stormrage,960,warlock,demonology,18,10,8
Persistencss,tichondrius,960,warlock,demonology,18,10,8
Reneqtxo,jubeithos,960,warlock,demonology,18,10,8
Xiyangpvp,tichondrius,960,warlock,demonology,18,10,8
Joung,tichondrius,960,warlock,demonology,18,10,8
Slothycrip,emerald-dream,960,warlock,demonology,24,10,14
Fabriziø,ragnaros,959,warlock,demonology,12,10,2
Dawdrax,gallywix,958,warlock,demonology,12,10,2
Daesire,moon-guard,957,warlock,demonology,18,10,8
Hulkyy,illidan,955,warlock,demonology,24,10,14
Valerilma,azralon,954,warlock,demonology,18,10,8
Methrocks,emerald-dream,953,warlock,demonology,24,10,14
Apples,ravencrest,894,warlock,demonology,17,10,7
Stonelocke,area-52,864,warlock,demonology,12,9,3
Almostoogood,illidan,864,warlock,demonology,12,9,3
Discordance,zuljin,864,warlock,demonology,12,9,3
Impenjoyer,tichondrius,864,warlock,demonology,12,9,3
Evanylock,proudmoore,864,warlock,demonology,18,9,9
Lowrcase,zuljin,864,warlock,demonology,18,9,9
Deboltzaru,ragnaros,864,warlock,demonology,19,9,10
Mälwaré,tichondrius,864,warlock,demonology,23,9,14
Jorloz,ragnaros,863,warlock,demonology,12,9,3
Flocka,agamaggan,863,warlock,demonology,12,9,3
Ezgamejr,tichondrius,863,warlock,demonology,12,9,3
Skullsoul,arthas,863,warlock,demonology,18,9,9
Xephostwo,area-52,863,warlock,demonology,18,9,9
Jerclard,proudmoore,863,warlock,demonology,18,9,9
Criticalpets,stormrage,863,warlock,demonology,18,9,9
Päpï,tichondrius,862,warlock,demonology,12,9,3
Superjuno,sargeras,862,warlock,demonology,12,9,3
Fearmebro,bleeding-hollow,862,warlock,demonology,12,9,3
Guisls,azralon,862,warlock,demonology,24,9,15
Uzag,mugthol,859,warlock,demonology,18,9,9
Demoniclily,kiljaeden,816,warlock,demonology,21,9,12
Haxtoss,stormrage,815,warlock,demonology,11,9,2
Narcan,arthas,797,warlock,demonology,17,9,8
Yoyoling,illidan,794,warlock,demonology,19,10,9
Politepvperx,kelthuzad,783,warlock,demonology,11,9,2
Monstir,sargeras,781,warlock,demonology,19,9,10
Asmion,earthen-ring,768,warlock,demonology,12,8,4
Pvtpotato,tichondrius,768,warlock,demonology,12,8,4
Chipt,kelthuzad,768,warlock,demonology,12,8,4
Westhofs,sargeras,768,warlock,demonology,12,8,4
Rakshama,chogall,768,warlock,demonology,12,8,4
Suzüki,tichondrius,768,warlock,demonology,12,8,4
Lentil,zuljin,768,warlock,demonology,12,8,4
Gnumbnutz,blades-edge,768,warlock,demonology,12,8,4
Marshyxd,tichondrius,768,warlock,demonology,12,8,4
Miredö,tichondrius,768,warlock,demonology,12,8,4
Syraxi,illidan,768,warlock,demonology,12,8,4
Mukkamuk,shadowmoon,768,warlock,demonology,12,8,4
Bestwarlock,skywall,768,warlock,demonology,12,8,4
Archibalding,area-52,768,warlock,demonology,12,8,4
Joseph,draktharon,768,warlock,demonology,18,8,10
Bïcho,queldorei,768,warlock,demonology,18,8,10
Avery,mannoroth,768,warlock,demonology,18,8,10
Demyo,tichondrius,768,warlock,demonology,18,8,10
Nismo,trollbane,768,warlock,demonology,18,8,10
Hâm,dalaran,768,warlock,demonology,30,8,22
Rosacrutian,tichondrius,767,warlock,demonology,12,8,4
Shâdowman,stormrage,767,warlock,demonology,12,8,4
Gibberishss,tichondrius,767,warlock,demonology,12,8,4
Krumlax,thrall,767,warlock,demonology,12,8,4
Fullmelt,azjolnerub,767,warlock,demonology,18,8,10
Cvntpvntcans,kelthuzad,764,warlock,demonology,18,8,10
Pulentinskin,quelthalas,764,warlock,demonology,24,8,16
Døtyou,area-52,735,warlock,demonology,17,8,9
Eklypso,kelthuzad,714,warlock,demonology,20,9,11
Sasaology,frostmourne,703,warlock,demonology,14,8,6
Twinklockxx,mannoroth,703,warlock,demonology,17,8,9
Bluffzlock,boulderfist,702,warlock,demonology,11,8,3
Løckyun,tichondrius,672,warlock,demonology,12,7,5
Sorenbjerga,zuljin,672,warlock,demonology,12,7,5
Procalypse,stormrage,672,warlock,demonology,12,7,5
Agla,quelthalas,672,warlock,demonology,12,7,5
Isömetrics,barthilas,672,warlock,demonology,12,7,5
Maral,kelthuzad,672,warlock,demonology,12,7,5
Protomán,agamaggan,672,warlock,demonology,12,7,5
Percadu,barthilas,672,warlock,demonology,12,7,5
Jojofann,nemesis,672,warlock,demonology,12,7,5
Betterone,azralon,672,warlock,demonology,12,7,5
Larixpotanin,tichondrius,672,warlock,demonology,12,7,5
Djvetis,blackhand,672,warlock,demonology,12,7,5
Xyguoguo,tichondrius,672,warlock,demonology,12,7,5
Ministàff,ursin,672,warlock,demonology,12,7,5
Dadtired,tichondrius,672,warlock,demonology,12,7,5
Aruotnof,nemesis,672,warlock,demonology,12,7,5
Matrriixx,proudmoore,672,warlock,demonology,18,7,11
Boltsfordays,dalaran,672,warlock,demonology,18,7,11
Evarona,gorefiend,672,warlock,demonology,18,7,11
Glortheeb,spirestone,671,warlock,demonology,12,7,5
Guldorum,kiljaeden,671,warlock,demonology,12,7,5
Celindeyn,stormrage,671,warlock,demonology,12,7,5
Saldori,malganis,671,warlock,demonology,12,7,5
Elioknight,area-52,671,warlock,demonology,12,7,5
Dotsfired,crushridge,671,warlock,demonology,18,7,11
Menedemus,amanthul,671,warlock,demonology,18,7,11
Deanwarlock,sargeras,670,warlock,demonology,12,7,5
Tsmcfker,tichondrius,654,warlock,demonology,17,7,10
Chaosboltex,tichondrius,618,warlock,demonology,14,8,6
Welendiock,malganis,616,warlock,demonology,22,9,13
Ritzhul,nordrassil,576,warlock,demonology,6,6,0
Nezsarek,sargeras,576,warlock,demonology,6,6,0
Phyxylock,stormrage,576,warlock,demonology,6,6,0
Empiratore,quelthalas,576,warlock,demonology,6,6,0
Destructio,tichondrius,576,warlock,demonology,12,6,6
Babyaga,illidan,576,warlock,demonology,12,6,6
Seekma,gallywix,576,warlock,demonology,12,6,6
Muchopower,ragnaros,576,warlock,demonology,12,6,6
Bellath,azralon,576,warlock,demonology,12,6,6
Zoerina,fizzcrank,576,warlock,demonology,12,6,6
Projectpump,kelthuzad,576,warlock,demonology,12,6,6
Marothredd,nathrezim,576,warlock,demonology,12,6,6
Ccona,tichondrius,576,warlock,demonology,12,6,6
Leine,proudmoore,576,warlock,demonology,12,6,6
Speakeasy,malygos,576,warlock,demonology,12,6,6
Scarletdemon,malganis,576,warlock,demonology,12,6,6
Yaldin,nemesis,576,warlock,demonology,12,6,6
Dalah,illidan,576,warlock,demonology,12,6,6
Kyralena,stormrage,576,warlock,demonology,12,6,6
Juleno,quelthalas,576,warlock,demonology,15,7,8
Artzul,tichondrius,576,warlock,demonology,15,7,8
Dreadful,frostmourne,576,warlock,demonology,18,6,12
Sylvanes,emerald-dream,575,warlock,demonology,12,6,6
Snuffer,detheroc,575,warlock,demonology,12,6,6
Voidgown,moon-guard,575,warlock,demonology,12,6,6
Lemongillo,stormrage,575,warlock,demonology,12,6,6
Tsunamibaby,anvilmar,575,warlock,demonology,12,6,6
Undeadcurse,frostmourne,574,warlock,demonology,24,6,18
Westhøf,sargeras,543,warlock,demonology,11,6,5
Zeeref,stormrage,543,warlock,demonology,12,6,6
Kronicdotz,bleeding-hollow,528,warlock,demonology,9,7,2
Penzer,stormrage,528,warlock,demonology,15,6,9
Zjxy,tichondrius,480,warlock,demonology,6,5,1
Dätura,tichondrius,480,warlock,demonology,6,5,1
Ötì,altar-of-storms,480,warlock,demonology,6,5,1
Symplicìty,area-52,480,warlock,demonology,6,5,1
Fatals,thrall,480,warlock,demonology,6,5,1
Gavvi,frostmourne,480,warlock,demonology,6,5,1
Tiatiatia,illidan,480,warlock,demonology,6,5,1
Sinixx,tichondrius,480,warlock,demonology,6,5,1
Aînzooalgown,ragnaros,480,warlock,demonology,6,5,1
Meltlordqt,mannoroth,480,warlock,demonology,6,5,1
Qp,thrall,480,warlock,demonology,6,5,1
Smartpimp,tichondrius,480,warlock,demonology,6,5,1
Cidkagenou,sargeras,480,warlock,demonology,7,5,2
Rasildur,ragnaros,480,warlock,demonology,12,5,7
Liuh,tichondrius,480,warlock,demonology,12,5,7
Grandpapapa,tichondrius,480,warlock,demonology,12,5,7
Sinápsís,ragnaros,480,warlock,demonology,12,5,7
Yungwilly,silvermoon,480,warlock,demonology,12,5,7
Dewandoritos,kelthuzad,480,warlock,demonology,12,5,7
Søcks,tichondrius,480,warlock,demonology,12,5,7
Mânuel,akama,480,warlock,demonology,12,5,7
Invisibles,barthilas,480,warlock,demonology,12,5,7
Alataar,sargeras,480,warlock,demonology,12,5,7
Patoquenn,azralon,480,warlock,demonology,12,5,7
Feinnx,dalaran,480,warlock,demonology,12,5,7
Zarinista,veknilash,480,warlock,demonology,12,5,7
Grineed,emerald-dream,480,warlock,demonology,12,5,7
Dapperdanxy,tichondrius,480,warlock,demonology,12,5,7
Tribulatiön,moon-guard,480,warlock,demonology,12,5,7
Shadü,tichondrius,480,warlock,demonology,19,5,14
Nécromonster,illidan,479,warlock,demonology,12,5,7
Braylon,azuremyst,479,warlock,demonology,12,5,7
Omegawarlock,quelthalas,479,warlock,demonology,18,5,13
Sathorastus,spirestone,448,warlock,demonology,10,6,4
Agaros,zuljin,426,warlock,demonology,17,6,11
Shadowmoonon,tichondrius,400,warlock,demonology,13,5,8
Kotica,stormrage,398,warlock,demonology,10,5,5
Michae,tichondrius,384,warlock,demonology,6,4,2
Lukelock,azralon,384,warlock,demonology,6,4,2
Quonton,tichondrius,384,warlock,demonology,6,4,2
Doomdm,zuljin,384,warlock,demonology,6,4,2
Kyrionn,azralon,384,warlock,demonology,6,4,2
Brujever,ragnaros,384,warlock,demonology,6,4,2
Blliizz,aegwynn,384,warlock,demonology,6,4,2
Goorock,area-52,384,warlock,demonology,6,4,2
Fokâi,sargeras,384,warlock,demonology,6,4,2
Valerik,azralon,384,warlock,demonology,6,4,2
Lambe,tichondrius,384,warlock,demonology,6,4,2
Kronii,jubeithos,384,warlock,demonology,6,4,2
Nüts,blackrock,384,warlock,demonology,6,4,2
Oniyooshi,kelthuzad,384,warlock,demonology,6,4,2
Bellatriks,nemesis,384,warlock,demonology,6,4,2
Hélà,sargeras,384,warlock,demonology,6,4,2
Ethero,emerald-dream,384,warlock,demonology,6,4,2
Dashaad,illidan,384,warlock,demonology,6,4,2
Nerolock,frostmourne,384,warlock,demonology,6,4,2
Bigfatballz,tichondrius,384,warlock,demonology,6,4,2
Hordefella,malganis,384,warlock,demonology,6,4,2
Ardam,cenarion-circle,384,warlock,demonology,6,4,2
Menemies,malganis,384,warlock,demonology,6,4,2
Thefunk,tichondrius,384,warlock,demonology,6,4,2
Hecataeus,stormrage,384,warlock,demonology,6,4,2
Meep,madoran,384,warlock,demonology,6,4,2
Zorah,quelthalas,384,warlock,demonology,6,4,2
Conjur,barthilas,384,warlock,demonology,6,4,2
Coomerdoomer,stormrage,384,warlock,demonology,6,4,2
Alchan,tichondrius,384,warlock,demonology,6,4,2
Eflock,barthilas,384,warlock,demonology,6,4,2
Vesaloth,zuljin,384,warlock,demonology,6,4,2
Logixo,sargeras,384,warlock,demonology,7,4,3
Warlooch,area-52,384,warlock,demonology,9,5,4
Garcheros,ragnaros,384,warlock,demonology,9,5,4
Tahmrin,quelthalas,384,warlock,demonology,12,4,8
Dogcookie,moon-guard,384,warlock,demonology,12,4,8
Uarus,tichondrius,384,warlock,demonology,12,4,8
Millions,barthilas,384,warlock,demonology,12,4,8
Arsaurelica,blackrock,384,warlock,demonology,12,4,8
Ven,dalaran,384,warlock,demonology,12,4,8
Warlack,jubeithos,384,warlock,demonology,12,4,8
Çheesestick,dalaran,384,warlock,demonology,12,4,8
Puchador,sargeras,384,warlock,demonology,12,4,8
Naz,shadowsong,384,warlock,demonology,12,4,8
Vasqu,stormrage,384,warlock,demonology,12,4,8
Soulrman,tichondrius,384,warlock,demonology,12,4,8
Ddorangmoon,tichondrius,384,warlock,demonology,12,4,8
Ragnalock,laughing-skull,384,warlock,demonology,14,4,10
Tofulery,tichondrius,384,warlock,demonology,18,4,14
Alaren,korgath,384,warlock,demonology,24,4,20
Sharee,azuremyst,363,warlock,demonology,11,4,7
Ärminvßuurën,barthilas,351,warlock,demonology,11,4,7
Minichompei,frostmourne,319,warlock,demonology,5,4,1
Freshimps,blood-furnace,288,warlock,demonology,6,3,3
Rumpology,illidan,288,warlock,demonology,6,3,3
Spookyfurry,area-52,288,warlock,demonology,6,3,3
Darthael,stormrage,288,warlock,demonology,6,3,3
Emperator,quelthalas,288,warlock,demonology,6,3,3
Mongobros,illidan,288,warlock,demonology,6,3,3
Tynks,mannoroth,288,warlock,demonology,6,3,3
Psyløck,bleeding-hollow,288,warlock,demonology,6,3,3
Asmodeun,malganis,288,warlock,demonology,6,3,3
Sangala,malganis,288,warlock,demonology,6,3,3
Sooshi,malganis,288,warlock,demonology,6,3,3
Drerrday,kelthuzad,288,warlock,demonology,6,3,3
Keezus,area-52,288,warlock,demonology,6,3,3
Locksoul,area-52,288,warlock,demonology,6,3,3
Drelgun,aerie-peak,288,warlock,demonology,6,3,3
Bbangtimo,tichondrius,288,warlock,demonology,6,3,3
Diebydots,blackrock,288,warlock,demonology,6,3,3
Azland,proudmoore,288,warlock,demonology,6,3,3
Ðemented,bleeding-hollow,288,warlock,demonology,6,3,3
Dapete,malorne,288,warlock,demonology,6,3,3
Elementzero,malorne,288,warlock,demonology,6,3,3
Mindfulchimp,sargeras,288,warlock,demonology,6,3,3
Deadlylock,gilneas,288,warlock,demonology,6,3,3
Nockdreal,azralon,288,warlock,demonology,6,3,3
Nightterrour,frostmourne,288,warlock,demonology,6,3,3
Hauntsin,hyjal,288,warlock,demonology,6,3,3
Saffuky,frostmourne,288,warlock,demonology,6,3,3
Schrader,sargeras,288,warlock,demonology,6,3,3
Bral,hyjal,288,warlock,demonology,6,3,3
Capslock,arthas,288,warlock,demonology,6,3,3
Cragalt,tichondrius,288,warlock,demonology,6,3,3
Jennifear,sargeras,288,warlock,demonology,6,3,3
Juankkii,bonechewer,288,warlock,demonology,6,3,3
Asiopdu,tichondrius,288,warlock,demonology,6,3,3
Jæja,wyrmrest-accord,288,warlock,demonology,6,3,3
Raegon,kiljaeden,288,warlock,demonology,6,3,3
Niava,tichondrius,288,warlock,demonology,6,3,3
Graveland,frostwolf,288,warlock,demonology,6,3,3
Pollodelight,deathwing,288,warlock,demonology,6,3,3
Schofen,tichondrius,288,warlock,demonology,6,3,3
Ðamndaddy,sargeras,288,warlock,demonology,6,3,3
Soulruler,tichondrius,288,warlock,demonology,6,3,3
Neruvian,tichondrius,288,warlock,demonology,6,3,3
Hgma,tichondrius,288,warlock,demonology,6,3,3
Gandreleda,wyrmrest-accord,288,warlock,demonology,10,4,6
Paleontology,moon-guard,288,warlock,demonology,8,3,5
Crispee,azuremyst,288,warlock,demonology,12,3,9
Canning,shuhalo,288,warlock,demonology,12,3,9
Killvilock,kelthuzad,288,warlock,demonology,12,3,9
Agertis,frostmourne,288,warlock,demonology,12,3,9
Dàmagicman,drakthul,288,warlock,demonology,12,3,9
Orbvoid,sargeras,287,warlock,demonology,12,3,9
Ijustsharded,area-52,255,warlock,demonology,11,3,8
Bänno,bleeding-hollow,239,warlock,demonology,5,3,2
Slugworth,rivendare,239,warlock,demonology,5,3,2
Quetzâlcoâtl,sargeras,239,warlock,demonology,5,3,2
Uwantpeach,tichondrius,239,warlock,demonology,5,3,2
Kaertis,emerald-dream,192,warlock,demonology,9,3,6
Creepydotman,mannoroth,192,warlock,demonology,6,2,4
Constantine,exodar,192,warlock,demonology,6,2,4
Heartpvp,tichondrius,192,warlock,demonology,6,2,4
Adlfcritler,emerald-dream,192,warlock,demonology,6,2,4
Greenbeanzs,tichondrius,192,warlock,demonology,6,2,4
Yuckytoetoe,emerald-dream,192,warlock,demonology,6,2,4
Watchmeport,onyxia,192,warlock,demonology,6,2,4
Lilbiackguy,stormrage,192,warlock,demonology,6,2,4
Infecçäo,stormrage,192,warlock,demonology,6,2,4
Anukh,emerald-dream,192,warlock,demonology,6,2,4
Xuker,tichondrius,192,warlock,demonology,6,2,4
Vendareth,earthen-ring,192,warlock,demonology,6,2,4
Eddybigbolts,tichondrius,192,warlock,demonology,6,2,4
Caesis,illidan,192,warlock,demonology,6,2,4
Buboñic,area-52,192,warlock,demonology,6,2,4
Boon,spirestone,192,warlock,demonology,6,2,4
Davidofbowie,burning-legion,192,warlock,demonology,6,2,4
Rokdas,area-52,192,warlock,demonology,6,2,4
Knobbynobbas,stormrage,192,warlock,demonology,6,2,4
Diekast,tichondrius,192,warlock,demonology,6,2,4
Lazymongoose,frostmourne,192,warlock,demonology,6,2,4
Zalissel,proudmoore,192,warlock,demonology,6,2,4
Nanicide,kelthuzad,192,warlock,demonology,6,2,4
Xoxoxu,frostmourne,192,warlock,demonology,6,2,4
Destructo,illidan,192,warlock,demonology,6,2,4
Rôsé,tichondrius,192,warlock,demonology,6,2,4
Shadowhax,area-52,192,warlock,demonology,6,2,4
Damerus,illidan,192,warlock,demonology,6,2,4
Draino,tichondrius,192,warlock,demonology,6,2,4
Barbieelf,sargeras,192,warlock,demonology,6,2,4
Daliadark,sargeras,192,warlock,demonology,6,2,4
Ziroken,crushridge,192,warlock,demonology,6,2,4
Vexice,firetree,192,warlock,demonology,6,2,4
Sakyameil,area-52,192,warlock,demonology,6,2,4
Irene,nagrand,192,warlock,demonology,6,2,4
Breeak,sargeras,192,warlock,demonology,6,2,4
Koffay,bleeding-hollow,192,warlock,demonology,6,2,4
Sheshð,stormrage,192,warlock,demonology,6,2,4
Qic,runetotem,192,warlock,demonology,6,2,4
Geauxst,tichondrius,192,warlock,demonology,6,2,4
Warfeen,malganis,192,warlock,demonology,6,2,4
Kuroyt,drakkari,192,warlock,demonology,12,2,10
Jafi,coilfang,159,warlock,demonology,5,2,3
Gartlarrey,daggerspine,158,warlock,demonology,14,3,11
Cslice,magtheridon,128,warlock,demonology,4,2,2
Tazlock,blackrock,128,warlock,demonology,10,2,8
Uggaboogga,malganis,96,warlock,demonology,6,1,5
Badstepbro,sargeras,96,warlock,demonology,6,1,5
Thugpenus,frostmane,96,warlock,demonology,6,1,5
Decrepticus,kargath,96,warlock,demonology,6,1,5
Erimegara,ragnaros,96,warlock,demonology,6,1,5
Fashon,barthilas,96,warlock,demonology,6,1,5
Strax,shattered-hand,96,warlock,demonology,6,1,5
Flangy,kiljaeden,96,warlock,demonology,6,1,5
Sinful,darkspear,96,warlock,demonology,6,1,5
Bmó,stormrage,96,warlock,demonology,6,1,5
Halloweèn,kelthuzad,96,warlock,demonology,6,1,5
Xalithra,moon-guard,96,warlock,demonology,6,1,5
Rylal,illidan,96,warlock,demonology,6,1,5
Shortbuhz,tichondrius,96,warlock,demonology,6,1,5
Ñinelyfe,frostmourne,96,warlock,demonology,6,1,5
Borthrel,moon-guard,96,warlock,demonology,6,1,5
Amauder,moon-guard,96,warlock,demonology,6,1,5
Jazzycj,bleeding-hollow,96,warlock,demonology,6,1,5
Nùts,frostmourne,96,warlock,demonology,6,1,5
Velondris,illidan,96,warlock,demonology,6,1,5
Hâunted,khazgoroth,96,warlock,demonology,6,1,5
Laklin,stormscale,96,warlock,demonology,6,1,5
Fearedit,bleeding-hollow,96,warlock,demonology,6,1,5
Damdochael,bleeding-hollow,96,warlock,demonology,6,1,5
Bilidin,azralon,96,warlock,demonology,6,1,5
Overlard,illidan,96,warlock,demonology,6,1,5
Malzahard,ragnaros,96,warlock,demonology,6,1,5
Fluximilian,azralon,96,warlock,demonology,7,1,6
Kecca,azralon,96,warlock,demonology,15,1,14
Shaurial,zuljin,48,warlock,demonology,3,1,2
Reverence,tichondrius,2283,warlock,destruction,101,64,37
Søülætër,bleeding-hollow,2161,warlock,destruction,66,42,24
Voidchaos,whisperwind,2156,warlock,destruction,114,59,55
Impenjoyer,tichondrius,2154,warlock,destruction,66,41,25
Playßøy,area-52,2154,warlock,destruction,78,45,33
Ellynaria,nemesis,2142,warlock,destruction,78,51,27
Kamohoalii,bleeding-hollow,2142,warlock,destruction,60,39,21
Tomatobob,thrall,2136,warlock,destruction,84,44,40
Mengqil,tichondrius,2132,warlock,destruction,91,49,42
Deideimeow,illidan,2130,warlock,destruction,65,42,23
Ihavestds,tichondrius,2129,warlock,destruction,54,31,23
Sockems,guldan,2125,warlock,destruction,90,51,39
Mjn,tichondrius,2123,warlock,destruction,91,47,44
Dxxz,tichondrius,2121,warlock,destruction,73,43,30
Zyzx,malganis,2120,warlock,destruction,59,37,22
Bananapan,tichondrius,2116,warlock,destruction,66,44,22
Usurpest,bleeding-hollow,2114,warlock,destruction,79,50,29
Singleaf,stormrage,2113,warlock,destruction,81,47,34
Idotû,tichondrius,2107,warlock,destruction,66,41,25
Stingzz,azralon,2106,warlock,destruction,61,38,23
Chaosboltex,tichondrius,2106,warlock,destruction,72,41,31
Babyaga,illidan,2106,warlock,destruction,85,42,43
Jcm,hyjal,2104,warlock,destruction,59,41,18
Bufflockmore,tichondrius,2103,warlock,destruction,112,62,50
Kaytoxic,tichondrius,2103,warlock,destruction,72,39,33
Ohmend,thrall,2102,warlock,destruction,69,45,24
Rainbowdate,tichondrius,2101,warlock,destruction,36,29,7
Implify,tichondrius,2101,warlock,destruction,142,73,69
Pillçosby,bleeding-hollow,2080,warlock,destruction,66,37,29
Dae,burning-legion,2073,warlock,destruction,53,36,17
Thugonomicz,demon-soul,2071,warlock,destruction,54,37,17
Diabolicalz,sargeras,2067,warlock,destruction,81,42,39
Dottle,frostmourne,2064,warlock,destruction,60,36,24
Warlockwars,amanthul,2054,warlock,destruction,118,66,52
Dean,frostmourne,2051,warlock,destruction,54,28,26
Revenid,tichondrius,2049,warlock,destruction,72,42,30
Duukka,malganis,2044,warlock,destruction,72,42,30
Dannyl,tichondrius,2043,warlock,destruction,48,33,15
Hàrrydotter,darkspear,2041,warlock,destruction,58,36,22
Warzog,wyrmrest-accord,2038,warlock,destruction,53,35,18
Nðm,tichondrius,2036,warlock,destruction,66,36,30
Drexia,tichondrius,2034,warlock,destruction,42,32,10
Darthael,stormrage,2031,warlock,destruction,116,73,43
Instabilityx,tichondrius,2028,warlock,destruction,71,42,29
Audition,ragnaros,2026,warlock,destruction,90,47,43
Jonboyy,illidan,2026,warlock,destruction,66,34,32
Disembolt,illidan,2021,warlock,destruction,54,32,22
Truetime,tichondrius,2016,warlock,destruction,66,38,28
Mclovn,suramar,2015,warlock,destruction,65,36,29
Albbanoo,tichondrius,2014,warlock,destruction,89,50,39
Leredi,stormrage,2013,warlock,destruction,110,56,54
Tacobelf,magtheridon,2010,warlock,destruction,117,68,49
Breeped,tichondrius,2006,warlock,destruction,84,55,29
Luvana,kelthuzad,2001,warlock,destruction,59,37,22
Butteredbun,stormrage,1998,warlock,destruction,84,52,32
Truenatestes,proudmoore,1993,warlock,destruction,41,24,17
Milkdrunk,blackrock,1992,warlock,destruction,77,45,32
Kyranu,tichondrius,1990,warlock,destruction,83,45,38
Usainboltzz,tichondrius,1986,warlock,destruction,36,30,6
Kaidow,tichondrius,1981,warlock,destruction,60,40,20
Brainless,tichondrius,1980,warlock,destruction,61,40,21
Demonman,kirin-tor,1978,warlock,destruction,54,33,21
Uwantpeach,tichondrius,1975,warlock,destruction,36,29,7
Quinsnyder,zuljin,1973,warlock,destruction,67,35,32
Dazzuu,illidan,1972,warlock,destruction,95,51,44
Zeari,sargeras,1972,warlock,destruction,109,55,54
Dodgeykun,khaz-modan,1970,warlock,destruction,66,39,27
Salanzø,bleeding-hollow,1965,warlock,destruction,54,31,23
Mizmagius,moon-guard,1965,warlock,destruction,65,31,34
Hudwinx,illidan,1961,warlock,destruction,54,36,18
Kruxxqt,illidan,1961,warlock,destruction,96,52,44
Blackyeonnam,tichondrius,1959,warlock,destruction,86,46,40
Colombø,gallywix,1942,warlock,destruction,92,46,46
Ignorai,illidan,1935,warlock,destruction,94,56,38
Scørrgx,azralon,1934,warlock,destruction,60,30,30
Abrocket,alleria,1931,warlock,destruction,59,33,26
Rizzard,lightnings-blade,1930,warlock,destruction,53,32,21
Amgs,frostmourne,1930,warlock,destruction,77,46,31
Sourslock,shadowsong,1929,warlock,destruction,72,44,28
Archimondee,rivendare,1927,warlock,destruction,78,39,39
Felfeels,area-52,1926,warlock,destruction,54,33,21
Fingerslock,malganis,1926,warlock,destruction,96,50,46
Drakedogee,illidan,1926,warlock,destruction,42,21,21
Thumperrz,frostmourne,1919,warlock,destruction,48,28,20
Chaosjedi,stormrage,1916,warlock,destruction,54,31,23
Barbieelf,sargeras,1907,warlock,destruction,55,37,18
Foresthills,sargeras,1905,warlock,destruction,48,27,21
Hellsparks,malganis,1903,warlock,destruction,48,29,19
Lopenx,korgath,1903,warlock,destruction,58,30,28
Ozmat,spirestone,1900,warlock,destruction,36,20,16
Zaef,kelthuzad,1894,warlock,destruction,31,21,10
Kaelith,kelthuzad,1894,warlock,destruction,91,46,45
Maadhum,illidan,1894,warlock,destruction,72,32,40
Stilltrilly,tichondrius,1892,warlock,destruction,36,25,11
Sinápsís,ragnaros,1886,warlock,destruction,42,27,15
Roxmysox,darkspear,1875,warlock,destruction,78,40,38
Hahahahahha,stormrage,1874,warlock,destruction,41,28,13
Sarcophagus,duskwood,1869,warlock,destruction,66,33,33
Alchandil,tichondrius,1868,warlock,destruction,36,26,10
Reneqtxo,frostmourne,1866,warlock,destruction,68,47,21
Dustywlx,area-52,1865,warlock,destruction,74,45,29
Ghoul,demon-soul,1860,warlock,destruction,36,21,15
Calvarr,bleeding-hollow,1859,warlock,destruction,54,32,22
Soulrulerxc,tichondrius,1854,warlock,destruction,42,27,15
Darksummoner,kaelthas,1853,warlock,destruction,84,46,38
Maggotworm,sargeras,1851,warlock,destruction,99,65,34
Warcalk,stormrage,1849,warlock,destruction,48,30,18
Synkz,blood-furnace,1849,warlock,destruction,42,24,18
Loopsy,stormrage,1849,warlock,destruction,49,26,23
Sosahawk,stormrage,1848,warlock,destruction,72,53,19
Genzy,tichondrius,1847,warlock,destruction,54,24,30
Lemmepvponu,illidan,1846,warlock,destruction,59,28,31
Brujoalfa,ragnaros,1845,warlock,destruction,63,43,20
Dreadful,frostmourne,1845,warlock,destruction,54,34,20
Ñpç,bleeding-hollow,1844,warlock,destruction,83,44,39
Amez,grizzly-hills,1843,warlock,destruction,54,30,24
Chilipeppa,wyrmrest-accord,1842,warlock,destruction,36,27,9
Benafflockzz,kelthuzad,1840,warlock,destruction,66,44,22
Disgustingfk,illidan,1840,warlock,destruction,54,32,22
Darkmagicc,tichondrius,1840,warlock,destruction,60,31,29
Enter,saurfang,1838,warlock,destruction,36,24,12
Wife,bleeding-hollow,1836,warlock,destruction,60,31,29
Mcdudebro,malganis,1835,warlock,destruction,30,20,10
Nosw,bleeding-hollow,1835,warlock,destruction,42,26,16
Badstep,tichondrius,1835,warlock,destruction,51,30,21
Yuoalx,tichondrius,1835,warlock,destruction,48,28,20
Darkwidow,sargeras,1835,warlock,destruction,84,43,41
Shadowhax,area-52,1835,warlock,destruction,72,35,37
Gigabiga,area-52,1834,warlock,destruction,24,20,4
Soragen,barthilas,1834,warlock,destruction,54,37,17
Twinklockxx,mannoroth,1833,warlock,destruction,71,32,39
Beegbeechy,nesingwary,1832,warlock,destruction,48,31,17
Destroyy,greymane,1830,warlock,destruction,42,23,19
Pernicious,bladefist,1830,warlock,destruction,71,32,39
Cux,malganis,1829,warlock,destruction,54,29,25
Nezlock,moon-guard,1829,warlock,destruction,92,45,47
Shequita,stormrage,1825,warlock,destruction,48,37,11
Doughnut,mugthol,1825,warlock,destruction,48,30,18
Agaros,zuljin,1825,warlock,destruction,49,30,19
Dipicrowcaw,tichondrius,1822,warlock,destruction,24,19,5
Róckroad,lightnings-blade,1820,warlock,destruction,42,26,16
Drâkedog,illidan,1819,warlock,destruction,30,22,8
Latchlock,malganis,1817,warlock,destruction,66,42,24
Nvlnx,tichondrius,1817,warlock,destruction,48,27,21
Wraithlord,chogall,1816,warlock,destruction,51,32,19
Bismorc,frostmourne,1816,warlock,destruction,42,23,19
Dunnin,dalaran,1815,warlock,destruction,36,22,14
Horror,moon-guard,1815,warlock,destruction,36,19,17
Shinjuro,stormrage,1814,warlock,destruction,36,24,12
Cc,hellscream,1813,warlock,destruction,44,33,11
Sacalawia,drakkari,1813,warlock,destruction,45,27,18
Zauber,magtheridon,1812,warlock,destruction,44,29,15
Destructio,tichondrius,1812,warlock,destruction,54,31,23
Marshyw,tichondrius,1812,warlock,destruction,36,19,17
Nevermindxd,barthilas,1812,warlock,destruction,60,30,30
Naroy,malygos,1811,warlock,destruction,38,21,17
Zarinista,veknilash,1811,warlock,destruction,61,30,31
Sidgnosis,stormrage,1810,warlock,destruction,39,26,13
Venticm,tichondrius,1810,warlock,destruction,42,26,16
Alchan,tichondrius,1810,warlock,destruction,65,38,27
Tonnon,stormrage,1810,warlock,destruction,72,42,30
Omnireaper,tichondrius,1810,warlock,destruction,54,29,25
Oof,dalaran,1809,warlock,destruction,30,22,8
Feardotjpg,stormrage,1807,warlock,destruction,36,27,9
Drthiccbolts,malganis,1807,warlock,destruction,47,29,18
Aidadeshu,tichondrius,1807,warlock,destruction,60,32,28
Yeepzbytre,bleeding-hollow,1806,warlock,destruction,42,32,10
Nigthdeath,nemesis,1806,warlock,destruction,173,91,82
Döremi,tichondrius,1805,warlock,destruction,48,28,20
Vulcke,kelthuzad,1805,warlock,destruction,47,23,24
Tommybahama,velen,1804,warlock,destruction,46,32,14
Expiredfood,stormreaver,1803,warlock,destruction,42,26,16
Giantgobrin,zuljin,1802,warlock,destruction,30,20,10
Woahlock,thrall,1802,warlock,destruction,40,22,18
Yidhra,aerie-peak,1801,warlock,destruction,75,46,29
Rizzofsparta,stormrage,1801,warlock,destruction,42,25,17
Xervas,frostmourne,1800,warlock,destruction,54,33,21
Soulbane,nemesis,1800,warlock,destruction,36,22,14
Twilson,moon-guard,1798,warlock,destruction,48,27,21
Sherlóck,duskwood,1798,warlock,destruction,54,28,26
Rhelialock,stormrage,1797,warlock,destruction,30,19,11
Deadlpoo,stormscale,1794,warlock,destruction,73,34,39
Salival,chogall,1786,warlock,destruction,24,19,5
Popdotdropit,frostwolf,1781,warlock,destruction,60,38,22
Sweatystain,tichondrius,1777,warlock,destruction,40,26,14
Dragonixs,ragnaros,1776,warlock,destruction,78,42,36
Freddiewill,tichondrius,1775,warlock,destruction,42,28,14
Payn,kiljaeden,1772,warlock,destruction,48,24,24
Alùcärd,tichondrius,1772,warlock,destruction,54,25,29
Wwlock,area-52,1768,warlock,destruction,68,36,32
Niava,tichondrius,1764,warlock,destruction,48,26,22
Insanetroll,stormrage,1760,warlock,destruction,36,25,11
Magnetix,arthas,1758,warlock,destruction,115,61,54
Nick,llane,1757,warlock,destruction,36,23,13
Làsko,area-52,1756,warlock,destruction,66,36,30
Locodwarf,frostmourne,1755,warlock,destruction,203,96,107
Gotthmog,nerzhul,1749,warlock,destruction,42,26,16
Isodjdojk,sargeras,1747,warlock,destruction,46,25,21
Struggles,emerald-dream,1746,warlock,destruction,124,66,58
Xavier,wyrmrest-accord,1744,warlock,destruction,41,23,18
Reallymagic,malganis,1743,warlock,destruction,83,49,34
Benafflockz,kelthuzad,1734,warlock,destruction,29,19,10
Sitomey,emerald-dream,1733,warlock,destruction,42,25,17
Oblivious,firetree,1731,warlock,destruction,96,51,45
Firenzy,dalaran,1730,warlock,destruction,48,28,20
Derok,bleeding-hollow,1729,warlock,destruction,119,62,57
Cróhns,bleeding-hollow,1727,warlock,destruction,58,43,15
Daylyt,sargeras,1723,warlock,destruction,27,19,8
Ribman,stormrage,1722,warlock,destruction,36,18,18
Cocaineparty,tichondrius,1721,warlock,destruction,47,28,19
Inmøtion,tichondrius,1721,warlock,destruction,36,18,18
Eggós,sargeras,1719,warlock,destruction,72,33,39
Meatmanxtrem,sargeras,1717,warlock,destruction,48,27,21
Spooked,khadgar,1716,warlock,destruction,36,24,12
Kartharian,wyrmrest-accord,1713,warlock,destruction,41,20,21
Hehimx,bleeding-hollow,1711,warlock,destruction,24,18,6
Screampies,tichondrius,1711,warlock,destruction,40,25,15
Symaitiel,azralon,1710,warlock,destruction,54,29,25
Bod,bleeding-hollow,1709,warlock,destruction,30,18,12
Richãrd,area-52,1709,warlock,destruction,49,26,23
Gimmeprecog,tichondrius,1708,warlock,destruction,23,18,5
Hakai,bleeding-hollow,1708,warlock,destruction,38,26,12
Seangnong,tichondrius,1708,warlock,destruction,30,18,12
Neverending,malganis,1707,warlock,destruction,31,18,13
Heckindoggø,tichondrius,1707,warlock,destruction,41,22,19
Fredwinsta,laughing-skull,1706,warlock,destruction,24,18,6
Evatar,malganis,1705,warlock,destruction,30,19,11
Urukái,dalaran,1705,warlock,destruction,36,22,14
Eggpower,tichondrius,1703,warlock,destruction,40,23,17
Razzakka,stormrage,1703,warlock,destruction,71,38,33
Grandmama,tichondrius,1702,warlock,destruction,36,21,15
Puchador,sargeras,1701,warlock,destruction,54,27,27
Wolfstein,tichondrius,1699,warlock,destruction,24,18,6
Famerap,tichondrius,1699,warlock,destruction,30,20,10
Karimbenzema,tichondrius,1698,warlock,destruction,36,24,12
Nasn,black-dragonflight,1698,warlock,destruction,44,28,16
Daartaru,quelthalas,1698,warlock,destruction,90,48,42
Krikxy,tichondrius,1697,warlock,destruction,44,24,20
Iskiplegday,illidan,1697,warlock,destruction,101,43,58
Sairic,azralon,1696,warlock,destruction,36,30,6
Stormrift,sargeras,1696,warlock,destruction,48,29,19
Bigjmmywiggl,illidan,1694,warlock,destruction,49,30,19
Rotshtëin,tichondrius,1694,warlock,destruction,60,30,30
Pk,azralon,1691,warlock,destruction,24,18,6
Dferreira,azralon,1691,warlock,destruction,96,56,40
Spaceghóst,bleeding-hollow,1691,warlock,destruction,57,33,24
Cbx,kelthuzad,1690,warlock,destruction,36,28,8
Chaosbeard,korgath,1690,warlock,destruction,62,36,26
Demonicsnap,bleeding-hollow,1689,warlock,destruction,41,24,17
Mephizar,moon-guard,1689,warlock,destruction,44,25,19
Løcalplugxø,barthilas,1688,warlock,destruction,30,29,1
Doclove,destromath,1688,warlock,destruction,47,26,21
Hâm,dalaran,1688,warlock,destruction,78,40,38
Realgodlock,proudmoore,1687,warlock,destruction,51,25,26
Bobbyshmurdå,frostmourne,1686,warlock,destruction,48,29,19
Blackchinese,zuljin,1685,warlock,destruction,90,45,45
Cvoaw,bonechewer,1683,warlock,destruction,36,23,13
Meep,madoran,1682,warlock,destruction,53,34,19
Leeroydots,area-52,1678,warlock,destruction,36,25,11
Katrisse,aegwynn,1678,warlock,destruction,48,27,21
Yoyoyosup,stormrage,1676,warlock,destruction,30,22,8
Punstable,tichondrius,1676,warlock,destruction,35,23,12
Ðiêsel,malganis,1676,warlock,destruction,54,31,23
Sîthfu,tichondrius,1675,warlock,destruction,121,68,53
Suaveaye,tichondrius,1674,warlock,destruction,36,21,15
Luhgëek,tichondrius,1674,warlock,destruction,35,20,15
Jennifear,sargeras,1673,warlock,destruction,42,27,15
Farathos,ragnaros,1668,warlock,destruction,69,43,26
Vasago,jubeithos,1667,warlock,destruction,37,23,14
Chaosbôlt,proudmoore,1667,warlock,destruction,60,30,30
Kissmybolts,frostmourne,1666,warlock,destruction,42,23,19
Ardentia,malganis,1664,warlock,destruction,48,28,20
Babybolt,frostmourne,1664,warlock,destruction,48,22,26
Olgee,tortheldrin,1663,warlock,destruction,53,30,23
Scârecrow,stormrage,1661,warlock,destruction,42,26,16
Fearmebro,bleeding-hollow,1660,warlock,destruction,118,62,56
Halloweèn,kelthuzad,1658,warlock,destruction,95,53,42
Cairo,emerald-dream,1658,warlock,destruction,126,68,58
Agni,gurubashi,1658,warlock,destruction,60,31,29
Scathey,area-52,1654,warlock,destruction,59,37,22
Kernlberton,tichondrius,1652,warlock,destruction,36,22,14
Zoagen,ragnaros,1650,warlock,destruction,28,20,8
Azaradx,sargeras,1647,warlock,destruction,24,18,6
Napiersdot,tichondrius,1646,warlock,destruction,36,21,15
Keylloggz,sargeras,1646,warlock,destruction,50,28,22
Critthis,illidan,1644,warlock,destruction,35,25,10
Devilman,darkspear,1643,warlock,destruction,109,57,52
Feetsampler,stormrage,1643,warlock,destruction,40,18,22
Debigbolt,area-52,1642,warlock,destruction,30,22,8
Barovir,tichondrius,1642,warlock,destruction,42,22,20
Åbyssal,stormrage,1638,warlock,destruction,42,29,13
Demonclock,sargeras,1637,warlock,destruction,39,24,15
Killabeesack,tichondrius,1635,warlock,destruction,43,25,18
Drain,proudmoore,1634,warlock,destruction,48,30,18
Doombaby,zuljin,1632,warlock,destruction,70,45,25
Kogath,thunderlord,1632,warlock,destruction,68,41,27
Marcelium,greymane,1631,warlock,destruction,24,17,7
Dotandforget,tichondrius,1631,warlock,destruction,30,21,9
Leônidos,ghostlands,1631,warlock,destruction,48,27,21
Lafourche,tichondrius,1631,warlock,destruction,48,26,22
Dipixyz,tichondrius,1630,warlock,destruction,30,17,13
Psyløck,bleeding-hollow,1629,warlock,destruction,48,29,19
Whitexzz,tichondrius,1629,warlock,destruction,30,17,13
Dewandoritos,kelthuzad,1629,warlock,destruction,30,17,13
Igortrikadva,zuljin,1629,warlock,destruction,30,17,13
Deboltzaru,ragnaros,1629,warlock,destruction,53,30,23
Deangood,tichondrius,1629,warlock,destruction,47,24,23
Deathair,tichondrius,1626,warlock,destruction,30,17,13
Mânuel,akama,1625,warlock,destruction,24,17,7
Tìdals,zuljin,1624,warlock,destruction,27,18,9
Matafé,kelthuzad,1623,warlock,destruction,30,20,10
Boxtrolls,ragnaros,1623,warlock,destruction,30,17,13
Thotblood,stormrage,1622,warlock,destruction,24,18,6
Herpalock,illidan,1622,warlock,destruction,42,20,22
Elmobolt,thrall,1620,warlock,destruction,37,27,10
Sslock,sargeras,1619,warlock,destruction,30,17,13
Penzer,stormrage,1618,warlock,destruction,36,20,16
Tribulatiön,moon-guard,1617,warlock,destruction,101,59,42
Dolut,azralon,1617,warlock,destruction,54,31,23
Restolock,destromath,1617,warlock,destruction,60,34,26
Sithaholic,wildhammer,1616,warlock,destruction,30,17,13
Thegodd,nemesis,1616,warlock,destruction,36,17,19
Brettmackson,area-52,1615,warlock,destruction,40,26,14
Josaith,moon-guard,1614,warlock,destruction,71,42,29
Belzebud,area-52,1612,warlock,destruction,93,56,37
Wzxx,tichondrius,1612,warlock,destruction,46,22,24
Positivity,thunderhorn,1610,warlock,destruction,24,17,7
Shadøwy,nemesis,1610,warlock,destruction,95,51,44
Brickedx,malfurion,1609,warlock,destruction,71,35,36
Bytezlk,area-52,1608,warlock,destruction,24,17,7
Lostanubis,tichondrius,1607,warlock,destruction,39,24,15
Sakyameil,area-52,1607,warlock,destruction,36,21,15
Zetsu,zuljin,1604,warlock,destruction,99,56,43
Mamosa,stormrage,1603,warlock,destruction,48,34,14
Kurifodo,illidan,1603,warlock,destruction,47,27,20
Nosferatu,arthas,1602,warlock,destruction,26,20,6
Daimonic,bronzebeard,1602,warlock,destruction,24,17,7
Hynnis,nemesis,1602,warlock,destruction,42,27,15
Dapete,malorne,1600,warlock,destruction,36,26,10
Medzor,tichondrius,1600,warlock,destruction,33,20,13
Bellaswans,hyjal,1599,warlock,destruction,30,20,10
Breeak,sargeras,1599,warlock,destruction,30,19,11
Closetslut,moon-guard,1596,warlock,destruction,24,20,4
Dotcoin,tichondrius,1594,warlock,destruction,30,17,13
Infecçäo,stormrage,1592,warlock,destruction,36,24,12
Omegapasta,illidan,1592,warlock,destruction,36,19,17
Demonkiiller,kelthuzad,1591,warlock,destruction,48,19,29
Buffwarlocks,senjin,1587,warlock,destruction,48,26,22
Muffîn,moon-guard,1586,warlock,destruction,56,36,20
Tothegrave,sargeras,1585,warlock,destruction,35,22,13
Vileröze,zuljin,1585,warlock,destruction,36,19,17
Buu,veknilash,1585,warlock,destruction,36,19,17
Ezdagor,quelthalas,1584,warlock,destruction,82,49,33
Kuroyt,drakkari,1583,warlock,destruction,42,26,16
Zimer,moon-guard,1581,warlock,destruction,42,22,20
Bbclover,thrall,1579,warlock,destruction,29,19,10
Nefandous,malganis,1578,warlock,destruction,54,36,18
Butterboyx,stormrage,1578,warlock,destruction,30,18,12
Bénâfflock,area-52,1577,warlock,destruction,48,27,21
Locknug,tichondrius,1574,warlock,destruction,66,40,26
Melôck,area-52,1569,warlock,destruction,30,20,10
Warmandei,dalaran,1567,warlock,destruction,30,18,12
Razlock,moon-guard,1567,warlock,destruction,118,60,58
Koramoz,area-52,1566,warlock,destruction,33,19,14
Uow,stormrage,1564,warlock,destruction,42,20,22
Larryfisher,drenden,1561,warlock,destruction,24,17,7
Terrorbytes,frostmourne,1561,warlock,destruction,42,21,21
Dartthvader,azralon,1561,warlock,destruction,38,18,20
Noggét,frostmourne,1558,warlock,destruction,72,42,30
Khurze,area-52,1558,warlock,destruction,57,29,28
Mindrekt,azralon,1557,warlock,destruction,30,23,7
Anujy,moon-guard,1551,warlock,destruction,42,27,15
Wiildgoose,area-52,1550,warlock,destruction,30,21,9
Resuah,tichondrius,1549,warlock,destruction,51,25,26
Stocktonslap,saurfang,1548,warlock,destruction,49,30,19
Bayfayth,zuljin,1546,warlock,destruction,92,52,40
Jnxzlock,sargeras,1546,warlock,destruction,61,34,27
Feardadots,tichondrius,1545,warlock,destruction,27,20,7
Sagatt,illidan,1545,warlock,destruction,36,19,17
Galfear,malganis,1544,warlock,destruction,135,70,65
Dragoska,kiljaeden,1540,warlock,destruction,30,17,13
Yisuschríst,quelthalas,1540,warlock,destruction,35,18,17
Cryptos,kalecgos,1538,warlock,destruction,32,20,12
Hadouh,stormrage,1537,warlock,destruction,29,17,12
Korose,tichondrius,1536,warlock,destruction,90,45,45
Turiggyjr,tichondrius,1535,warlock,destruction,24,16,8
Siccwidit,area-52,1535,warlock,destruction,72,34,38
Chadica,malganis,1534,warlock,destruction,18,16,2
Odiums,area-52,1534,warlock,destruction,57,35,22
Bosongo,boulderfist,1534,warlock,destruction,59,35,24
Thinktank,tichondrius,1534,warlock,destruction,30,16,14
Sonlyc,tichondrius,1533,warlock,destruction,36,16,20
Scarletdemon,malganis,1532,warlock,destruction,65,35,30
Neverportx,kirin-tor,1532,warlock,destruction,30,16,14
Gatewayoncd,frostmourne,1532,warlock,destruction,42,21,21
Mayelinvail,moon-guard,1530,warlock,destruction,18,16,2
Rocketman,hydraxis,1528,warlock,destruction,24,16,8
Brucelock,proudmoore,1528,warlock,destruction,24,16,8
Dxhusky,illidan,1528,warlock,destruction,30,16,14
Somethingud,tichondrius,1527,warlock,destruction,77,31,46
Mursay,tichondrius,1526,warlock,destruction,18,16,2
Vamprixlz,illidan,1526,warlock,destruction,18,16,2
Invaderzem,tichondrius,1525,warlock,destruction,36,18,18
Isarac,zuljin,1524,warlock,destruction,54,35,19
Derfflinger,tichondrius,1520,warlock,destruction,84,37,47
Cheqmate,moon-guard,1516,warlock,destruction,31,17,14
Politex,malganis,1513,warlock,destruction,64,40,24
Antinurse,bleeding-hollow,1512,warlock,destruction,30,16,14
Joseph,draktharon,1509,warlock,destruction,66,35,31
Dynamó,tichondrius,1509,warlock,destruction,56,29,27
Mcjoy,akama,1508,warlock,destruction,153,80,73
Espyn,silvermoon,1508,warlock,destruction,64,26,38
Kuoma,boulderfist,1507,warlock,destruction,85,41,44
Flor,khadgar,1505,warlock,destruction,54,28,26
Droptopp,malganis,1503,warlock,destruction,24,16,8
Wheremyshoes,area-52,1503,warlock,destruction,87,37,50
Ðarkñess,burning-legion,1502,warlock,destruction,48,25,23
Illinkin,illidan,1498,warlock,destruction,30,16,14
Hrrpeuh,zuljin,1498,warlock,destruction,34,16,18
Balveer,tichondrius,1497,warlock,destruction,29,16,13
Xêlsnåp,steamwheedle-cartel,1495,warlock,destruction,55,34,21
Niked,sargeras,1489,warlock,destruction,78,46,32
Sauromann,sargeras,1488,warlock,destruction,30,19,11
Austeeny,wyrmrest-accord,1483,warlock,destruction,25,17,8
Humanreapers,malganis,1482,warlock,destruction,31,22,9
Dercair,korgath,1480,warlock,destruction,30,18,12
Beyourselff,tichondrius,1479,warlock,destruction,35,16,19
Tofulery,tichondrius,1475,warlock,destruction,50,23,27
Demondots,sargeras,1474,warlock,destruction,36,22,14
Bauchalain,area-52,1474,warlock,destruction,38,19,19
Magy,deathwing,1467,warlock,destruction,30,21,9
Lockybalboah,turalyon,1465,warlock,destruction,48,25,23
Meatybolts,nagrand,1462,warlock,destruction,60,36,24
Nattydots,sargeras,1459,warlock,destruction,35,17,18
Jierd,tichondrius,1457,warlock,destruction,28,16,12
Fshi,frostmourne,1451,warlock,destruction,50,30,20
Nezsarek,sargeras,1449,warlock,destruction,93,38,55
Yaldin,nemesis,1448,warlock,destruction,58,35,23
Dloq,azgalor,1445,warlock,destruction,72,46,26
Calidaze,tichondrius,1445,warlock,destruction,32,17,15
Stølo,deathwing,1444,warlock,destruction,48,35,13
Maleficmango,tichondrius,1444,warlock,destruction,36,23,13
Jugaa,arthas,1442,warlock,destruction,29,21,8
Heresucacok,frostmourne,1439,warlock,destruction,24,15,9
Danaowns,spirestone,1439,warlock,destruction,30,15,15
Spectro,laughing-skull,1438,warlock,destruction,18,15,3
Sâlâñzø,bleeding-hollow,1438,warlock,destruction,18,15,3
Narila,firetree,1438,warlock,destruction,24,15,9
Bagpipes,tichondrius,1437,warlock,destruction,18,15,3
Goofycupcake,drakthul,1437,warlock,destruction,18,15,3
Neghros,illidan,1437,warlock,destruction,24,15,9
Lockssy,tichondrius,1437,warlock,destruction,84,52,32
Imbooms,blackrock,1437,warlock,destruction,30,15,15
Artzul,tichondrius,1436,warlock,destruction,60,25,35
Pheadas,deathwing,1435,warlock,destruction,30,15,15
Madthelock,sargeras,1435,warlock,destruction,36,15,21
Rakshama,chogall,1434,warlock,destruction,30,15,15
Sickgurl,stormrage,1432,warlock,destruction,30,19,11
Fartymårty,tichondrius,1427,warlock,destruction,30,15,15
Aluaris,earthen-ring,1426,warlock,destruction,18,15,3
Blockk,moknathal,1426,warlock,destruction,36,17,19
Straightlock,sargeras,1424,warlock,destruction,47,19,28
Kanekiskid,mannoroth,1423,warlock,destruction,42,29,13
Fearloom,tichondrius,1422,warlock,destruction,94,49,45
Wizlox,illidan,1422,warlock,destruction,54,22,32
Tulu,muradin,1421,warlock,destruction,42,26,16
Borthrel,moon-guard,1421,warlock,destruction,54,31,23
Decrepticus,kargath,1419,warlock,destruction,44,26,18
Kascade,drakkari,1418,warlock,destruction,24,15,9
Gingerlocky,barthilas,1417,warlock,destruction,64,32,32
Deatthmoon,stormrage,1415,warlock,destruction,24,15,9
Chàõs,tichondrius,1415,warlock,destruction,24,15,9
Hurriicane,stormrage,1415,warlock,destruction,57,35,22
Jezwazerox,area-52,1413,warlock,destruction,69,36,33
Agonie,tichondrius,1413,warlock,destruction,78,39,39
Budgetkroozz,illidan,1413,warlock,destruction,30,15,15
Bilidin,azralon,1413,warlock,destruction,93,41,52
Vindicated,azgalor,1412,warlock,destruction,25,20,5
Yorchziel,ragnaros,1412,warlock,destruction,88,47,41
Guula,alexstrasza,1412,warlock,destruction,30,15,15
Javirr,ragnaros,1411,warlock,destruction,24,15,9
Demontos,darkspear,1411,warlock,destruction,36,18,18
Thicclöcc,tichondrius,1410,warlock,destruction,30,15,15
Parmenides,tichondrius,1410,warlock,destruction,42,19,23
Johnnybegood,frostmourne,1409,warlock,destruction,24,15,9
Gluestik,shadowmoon,1409,warlock,destruction,30,15,15
Lightname,arthas,1404,warlock,destruction,24,17,7
Adderall,altar-of-storms,1402,warlock,destruction,42,20,22
Warlockgomes,azralon,1401,warlock,destruction,55,25,30
Demonicus,thunderlord,1400,warlock,destruction,36,16,20
Momshutup,sargeras,1397,warlock,destruction,23,15,8
Lladyyheartt,nesingwary,1395,warlock,destruction,36,21,15
Getpissed,emerald-dream,1395,warlock,destruction,59,30,29
Hellcon,area-52,1392,warlock,destruction,34,24,10
Noxdolor,stormreaver,1390,warlock,destruction,24,15,9
Belchanor,illidan,1390,warlock,destruction,101,56,45
Jecklez,tichondrius,1384,warlock,destruction,129,70,59
Yipláw,stormrage,1383,warlock,destruction,24,16,8
Discordant,trollbane,1383,warlock,destruction,24,16,8
Dunbu,illidan,1382,warlock,destruction,57,32,25
Kalellock,azralon,1379,warlock,destruction,48,23,25
Coreleron,proudmoore,1378,warlock,destruction,43,20,23
Felacid,tichondrius,1377,warlock,destruction,42,23,19
Connect,borean-tundra,1371,warlock,destruction,35,18,17
Tunacanthicc,moon-guard,1370,warlock,destruction,43,18,25
Wackykid,azralon,1367,warlock,destruction,38,16,22
Picklepuller,arthas,1364,warlock,destruction,24,15,9
Spongebobjrj,tichondrius,1363,warlock,destruction,30,18,12
Shadowxlock,misha,1362,warlock,destruction,36,18,18
Munar,quelthalas,1357,warlock,destruction,69,32,37
Xoxoxu,frostmourne,1352,warlock,destruction,26,15,11
Ptheven,area-52,1351,warlock,destruction,28,19,9
Celeden,emerald-dream,1348,warlock,destruction,24,16,8
Dotsyu,frostmourne,1346,warlock,destruction,38,19,19
Soulruler,tichondrius,1344,warlock,destruction,24,14,10
Spreadnhiv,thrall,1344,warlock,destruction,42,18,24
Notprint,sargeras,1343,warlock,destruction,24,14,10
Súpersonic,tichondrius,1343,warlock,destruction,24,14,10
Dovahkini,stormrage,1340,warlock,destruction,18,14,4
Scãryz,jubeithos,1338,warlock,destruction,42,25,17
Lockfaceguy,agamaggan,1338,warlock,destruction,24,14,10
Deammon,tichondrius,1337,warlock,destruction,18,14,4
Andelaylas,tichondrius,1337,warlock,destruction,18,14,4
Éx,jubeithos,1337,warlock,destruction,18,14,4
Extinção,azralon,1336,warlock,destruction,38,25,13
Swapsfour,area-52,1334,warlock,destruction,24,14,10
Bobbygoulant,tichondrius,1328,warlock,destruction,133,60,73
Ehcsrop,doomhammer,1323,warlock,destruction,26,15,11
Necrotic,antonidas,1316,warlock,destruction,36,16,20
Lilbiackguy,stormrage,1312,warlock,destruction,24,15,9
Mocreia,azralon,1310,warlock,destruction,29,17,12
Memon,frostmane,1309,warlock,destruction,30,16,14
Lòthloria,mannoroth,1309,warlock,destruction,48,22,26
Lapidate,malganis,1307,warlock,destruction,23,14,9
Pwz,azralon,1307,warlock,destruction,38,20,18
Razizzles,malganis,1302,warlock,destruction,36,23,13
Voidchaos,korgath,1300,warlock,destruction,18,14,4
Nueleth,frostmourne,1298,warlock,destruction,23,14,9
Tanskeeh,sargeras,1298,warlock,destruction,34,16,18
Philsbad,lightbringer,1290,warlock,destruction,23,14,9
Levantine,barthilas,1286,warlock,destruction,33,14,19
Zalord,mannoroth,1286,warlock,destruction,35,14,21
Whathurts,tichondrius,1278,warlock,destruction,37,14,23
Mantis,proudmoore,1276,warlock,destruction,31,14,17
Kâyn,area-52,1275,warlock,destruction,23,14,9
Ahrimus,area-52,1275,warlock,destruction,28,14,14
Pruevolf,tichondrius,1267,warlock,destruction,56,24,32
Verdoso,stormrage,1261,warlock,destruction,24,14,10
Magiaoscurax,quelthalas,1258,warlock,destruction,30,14,16
Cørruption,emerald-dream,1253,warlock,destruction,38,20,18
Darkÿoda,malganis,1253,warlock,destruction,32,14,18
Conradlenoir,illidan,1248,warlock,destruction,18,13,5
Vugaddi,illidan,1248,warlock,destruction,18,13,5
Deathhawkz,ravencrest,1248,warlock,destruction,18,13,5
Ltoplaylock,area-52,1248,warlock,destruction,18,13,5
Frightbright,sargeras,1247,warlock,destruction,18,13,5
Boltsnhoes,illidan,1247,warlock,destruction,18,13,5
Doublebolt,illidan,1247,warlock,destruction,27,17,10
Chaosbolt,bloodhoof,1247,warlock,destruction,24,13,11
Kimsoul,zuljin,1247,warlock,destruction,24,13,11
Gianni,chogall,1246,warlock,destruction,18,13,5
Bigdamege,tichondrius,1246,warlock,destruction,22,14,8
Hauntsin,hyjal,1246,warlock,destruction,30,13,17
Pantypeeler,barthilas,1245,warlock,destruction,24,15,9
Destructo,illidan,1245,warlock,destruction,30,13,17
Uranusa,proudmoore,1243,warlock,destruction,30,13,17
Guldåniel,tichondrius,1242,warlock,destruction,24,13,11
Spòngwò,tichondrius,1242,warlock,destruction,24,13,11
Obscurity,tichondrius,1238,warlock,destruction,24,13,11
Covírus,azralon,1237,warlock,destruction,18,13,5
Chaosage,sargeras,1237,warlock,destruction,18,13,5
Burnzul,bleeding-hollow,1237,warlock,destruction,24,13,11
Fiddlesticks,draka,1236,warlock,destruction,18,13,5
Rainymood,frostmourne,1233,warlock,destruction,18,13,5
Munick,spirestone,1233,warlock,destruction,24,13,11
Chaotíc,zuljin,1231,warlock,destruction,24,13,11
Nhen,daggerspine,1228,warlock,destruction,59,37,22
Ellneggro,zuljin,1226,warlock,destruction,18,13,5
Jhop,sargeras,1226,warlock,destruction,18,13,5
Gorelami,tichondrius,1226,warlock,destruction,24,13,11
Chaosmorty,tichondrius,1225,warlock,destruction,24,13,11
Kyrionn,azralon,1225,warlock,destruction,24,13,11
Cascades,icecrown,1224,warlock,destruction,36,16,20
Lolimalock,bleeding-hollow,1215,warlock,destruction,29,14,15
Vexedconvex,area-52,1214,warlock,destruction,133,56,77
Daeykras,crushridge,1209,warlock,destruction,28,17,11
Karadelice,stormrage,1200,warlock,destruction,30,13,17
Zydaria,stormrage,1196,warlock,destruction,24,15,9
Kecca,azralon,1195,warlock,destruction,30,13,17
Fanzhiyi,illidan,1193,warlock,destruction,22,16,6
Kärên,proudmoore,1185,warlock,destruction,20,15,5
Deertz,zuljin,1183,warlock,destruction,22,13,9
Iiferna,sargeras,1177,warlock,destruction,77,33,44
Ilovedemons,aegwynn,1168,warlock,destruction,42,26,16
Bawldimort,stormrage,1165,warlock,destruction,89,46,43
Zíppen,proudmoore,1158,warlock,destruction,39,21,18
Guldoom,tichondrius,1152,warlock,destruction,12,12,0
Epícburn,illidan,1152,warlock,destruction,18,12,6
Laiquisha,zuljin,1152,warlock,destruction,19,12,7
Eav,area-52,1151,warlock,destruction,18,12,6
Wreyz,mannoroth,1151,warlock,destruction,18,12,6
Chaoticchaos,kelthuzad,1151,warlock,destruction,18,12,6
Flûké,tichondrius,1151,warlock,destruction,24,12,12
Oceangrownx,emerald-dream,1151,warlock,destruction,24,12,12
Asmit,firetree,1151,warlock,destruction,28,13,15
Cesily,frostmourne,1150,warlock,destruction,24,12,12
Isoldmysoul,stormrage,1150,warlock,destruction,33,13,20
Shadowfork,illidan,1149,warlock,destruction,18,12,6
Iggyiggy,sargeras,1149,warlock,destruction,24,12,12
Podda,shuhalo,1148,warlock,destruction,18,12,6
Omarlil,kelthuzad,1147,warlock,destruction,18,12,6
Screwed,tichondrius,1146,warlock,destruction,36,12,24
Sunkuna,aerie-peak,1141,warlock,destruction,36,13,23
Nadek,tichondrius,1140,warlock,destruction,24,12,12
Lessance,dalaran,1138,warlock,destruction,24,12,12
Bénn,moon-guard,1136,warlock,destruction,42,28,14
Rodimus,hyjal,1121,warlock,destruction,54,32,22
Demofire,tichondrius,1119,warlock,destruction,22,12,10
Zhaphrax,frostmourne,1113,warlock,destruction,29,12,17
Undies,demon-soul,1106,warlock,destruction,24,12,12
Covenslave,nemesis,1106,warlock,destruction,151,66,85
Cheiff,tichondrius,1104,warlock,destruction,36,14,22
Mazewl,illidan,1103,warlock,destruction,15,13,2
Anstik,area-52,1103,warlock,destruction,15,13,2
Laklin,stormscale,1098,warlock,destruction,27,13,14
Madgettike,stormrage,1094,warlock,destruction,36,22,14
Mindfulchimp,sargeras,1092,warlock,destruction,23,12,11
Felinå,hyjal,1076,warlock,destruction,27,14,13
Spicywhite,tichondrius,1072,warlock,destruction,19,12,7
Handler,earthen-ring,1071,warlock,destruction,30,20,10
Nikôlas,stormrage,1070,warlock,destruction,36,18,18
Grandpa,daggerspine,1069,warlock,destruction,19,12,7
Bumbleebolt,azralon,1056,warlock,destruction,12,11,1
Odjure,zuljin,1056,warlock,destruction,12,11,1
Boltsnhoez,tichondrius,1056,warlock,destruction,16,12,4
Hiddentech,saurfang,1056,warlock,destruction,18,11,7
Vapeboi,bleeding-hollow,1056,warlock,destruction,18,11,7
Lockonomicz,tichondrius,1056,warlock,destruction,18,11,7
Evilempire,sargeras,1056,warlock,destruction,18,11,7
Lockfoxyy,tichondrius,1056,warlock,destruction,18,11,7
Dance,sargeras,1055,warlock,destruction,12,11,1
Pyralock,malfurion,1055,warlock,destruction,12,11,1
Alktrz,azralon,1055,warlock,destruction,18,11,7
Verminosa,nemesis,1055,warlock,destruction,18,11,7
Sahdude,illidan,1055,warlock,destruction,18,11,7
Mindheist,stormrage,1055,warlock,destruction,18,11,7
Verbzz,tichondrius,1055,warlock,destruction,18,11,7
Tuzadin,tichondrius,1055,warlock,destruction,18,11,7
Veerdz,area-52,1055,warlock,destruction,24,11,13
Ole,area-52,1055,warlock,destruction,24,11,13
Bellanomikus,stormrage,1054,warlock,destruction,18,11,7
Krokusx,illidan,1054,warlock,destruction,18,11,7
Azlloa,tichondrius,1054,warlock,destruction,18,11,7
Faënn,zuljin,1053,warlock,destruction,18,11,7
Dinglerdots,tichondrius,1052,warlock,destruction,12,11,1
Cenich,darkspear,1052,warlock,destruction,18,11,7
Baldandugly,illidan,1052,warlock,destruction,18,11,7
Sidious,jubeithos,1050,warlock,destruction,18,11,7
Thralord,blackrock,1049,warlock,destruction,18,11,7
Tirp,illidan,1048,warlock,destruction,24,11,13
Pokemebutt,hydraxis,1046,warlock,destruction,18,11,7
Avae,frostmourne,1046,warlock,destruction,18,11,7
Haloren,moon-guard,1044,warlock,destruction,18,11,7
Kracky,tichondrius,1043,warlock,destruction,50,29,21
Nathalyâ,drakkari,1041,warlock,destruction,36,17,19
Felqueenn,windrunner,1038,warlock,destruction,18,11,7
Maldíta,quelthalas,1038,warlock,destruction,30,11,19
Baiss,tichondrius,1030,warlock,destruction,18,11,7
Matdamon,barthilas,1029,warlock,destruction,30,11,19
Noriaeradra,illidan,1025,warlock,destruction,24,13,11
Shedara,ragnaros,1023,warlock,destruction,17,11,6
Tott,hellscream,1023,warlock,destruction,17,11,6
Evanylock,proudmoore,1022,warlock,destruction,23,11,12
Faliceu,sargeras,1006,warlock,destruction,26,11,15
Pigmahz,malganis,1005,warlock,destruction,23,11,12
Warlockmf,sargeras,1003,warlock,destruction,17,11,6
Panyc,tichondrius,1002,warlock,destruction,23,11,12
Rauwërrs,azralon,992,warlock,destruction,27,12,15
Nevermorde,area-52,986,warlock,destruction,23,11,12
Hanoaa,tichondrius,975,warlock,destruction,11,11,0
Austen,tichondrius,966,warlock,destruction,31,11,20
Areufearious,sargeras,960,warlock,destruction,12,10,2
Wanglock,blackrock,960,warlock,destruction,12,10,2
Letmecastpls,tichondrius,960,warlock,destruction,12,10,2
Rettek,bleeding-hollow,960,warlock,destruction,12,10,2
Metamòrph,malganis,960,warlock,destruction,12,10,2
Fxckyuo,tichondrius,960,warlock,destruction,12,10,2
Nino,barthilas,960,warlock,destruction,12,10,2
Lilshedon,kelthuzad,960,warlock,destruction,12,10,2
Kammuany,sargeras,960,warlock,destruction,12,10,2
Maldivà,tichondrius,960,warlock,destruction,12,10,2
Drwongmd,sargeras,960,warlock,destruction,12,10,2
Crayonchewer,alleria,960,warlock,destruction,18,10,8
Contägion,bleeding-hollow,960,warlock,destruction,18,10,8
Nightmanx,sargeras,960,warlock,destruction,18,10,8
Veryezgame,tichondrius,960,warlock,destruction,18,10,8
Vvivienx,tichondrius,960,warlock,destruction,18,10,8
Ticklebolts,tichondrius,960,warlock,destruction,24,10,14
Aemma,proudmoore,959,warlock,destruction,12,10,2
Foxar,stormrage,959,warlock,destruction,12,10,2
Percaddict,illidan,959,warlock,destruction,12,10,2
Notatryhard,emerald-dream,959,warlock,destruction,18,10,8
Veleza,kiljaeden,959,warlock,destruction,18,10,8
Charnoob,kelthuzad,959,warlock,destruction,18,10,8
Jaspieno,illidan,959,warlock,destruction,18,10,8
Covidmaster,frostmourne,959,warlock,destruction,18,10,8
Knockknock,llane,959,warlock,destruction,18,10,8
Drdoom,sargeras,959,warlock,destruction,18,10,8
Kylaria,emerald-dream,959,warlock,destruction,18,10,8
Maral,kelthuzad,959,warlock,destruction,18,10,8
Mchawi,tichondrius,959,warlock,destruction,18,10,8
Wickedry,antonidas,959,warlock,destruction,18,10,8
Juicestarr,barthilas,959,warlock,destruction,24,10,14
Pykorrg,ragnaros,959,warlock,destruction,24,10,14
Yuh,moon-guard,958,warlock,destruction,12,10,2
Trobgol,bleeding-hollow,958,warlock,destruction,12,10,2
Macdeezylock,sargeras,958,warlock,destruction,18,10,8
Tergale,illidan,958,warlock,destruction,18,10,8
Løvesick,zuljin,957,warlock,destruction,24,10,14
Ltr,moon-guard,956,warlock,destruction,12,10,2
Lockerdoo,aegwynn,956,warlock,destruction,18,10,8
Graced,dalaran,956,warlock,destruction,18,10,8
Flxmin,area-52,956,warlock,destruction,24,10,14
Friendd,frostmourne,955,warlock,destruction,18,10,8
Chaoticstorm,area-52,955,warlock,destruction,18,10,8
Sylestrio,feathermoon,955,warlock,destruction,18,10,8
Plagueis,zuluhed,955,warlock,destruction,24,10,14
Dvorakk,frostmourne,954,warlock,destruction,15,11,4
Locker,lightnings-blade,954,warlock,destruction,18,10,8
Harleyjames,ravenholdt,953,warlock,destruction,18,10,8
Chachanoobx,sargeras,952,warlock,destruction,12,10,2
Punjj,jubeithos,952,warlock,destruction,18,10,8
Sojupain,kaelthas,950,warlock,destruction,12,10,2
Awfeelya,sargeras,950,warlock,destruction,18,10,8
Zaeloc,ragnaros,950,warlock,destruction,36,10,26
Luke,lightnings-blade,946,warlock,destruction,12,10,2
Hamadan,azralon,946,warlock,destruction,24,10,14
Kemchaos,illidan,946,warlock,destruction,24,10,14
Mogran,twisting-nether,934,warlock,destruction,18,10,8
Goal,malganis,927,warlock,destruction,20,11,9
Astarõth,zuljin,926,warlock,destruction,26,11,15
Rotfull,burning-legion,925,warlock,destruction,27,11,16
Kidsoul,illidan,921,warlock,destruction,28,13,15
Twohandedkil,stormrage,920,warlock,destruction,26,11,15
Xekk,wyrmrest-accord,910,warlock,destruction,23,10,13
Taìnted,lightbringer,896,warlock,destruction,16,10,6
Ppoonlock,tichondrius,896,warlock,destruction,22,10,12
Funnysoxx,caelestrasz,895,warlock,destruction,16,10,6
Fiennx,dalaran,894,warlock,destruction,17,10,7
Katsby,moon-guard,894,warlock,destruction,17,10,7
Notchinese,kiljaeden,893,warlock,destruction,17,10,7
Marlett,destromath,892,warlock,destruction,42,22,20
Glenfarclas,tichondrius,879,warlock,destruction,19,10,9
Caesaros,quelthalas,875,warlock,destruction,19,10,9
Kimis,azralon,865,warlock,destruction,18,10,8
Lokiy,ragnaros,864,warlock,destruction,12,9,3
Liuh,tichondrius,864,warlock,destruction,12,9,3
Gottawiz,illidan,864,warlock,destruction,12,9,3
Nocrackrocks,stormrage,864,warlock,destruction,12,9,3
Sëcond,azralon,864,warlock,destruction,12,9,3
Snerp,frostmourne,864,warlock,destruction,12,9,3
Lysitheä,moon-guard,864,warlock,destruction,12,9,3
Curse,agamaggan,864,warlock,destruction,12,9,3
Nos,bleeding-hollow,864,warlock,destruction,12,9,3
Pauldiesel,ragnaros,864,warlock,destruction,12,9,3
Bourrasq,illidan,864,warlock,destruction,12,9,3
Oymmander,illidan,864,warlock,destruction,18,9,9
Reflexlock,malganis,864,warlock,destruction,18,9,9
Bigolehogger,area-52,864,warlock,destruction,18,9,9
Äran,azralon,864,warlock,destruction,18,9,9
Miroir,illidan,864,warlock,destruction,18,9,9
Scarified,illidan,864,warlock,destruction,18,9,9
Wiredftw,illidan,864,warlock,destruction,18,9,9
Voidxo,tichondrius,864,warlock,destruction,18,9,9
Ahrimaan,illidan,863,warlock,destruction,12,9,3
Gòtti,frostmourne,863,warlock,destruction,12,9,3
Hädes,frostwolf,863,warlock,destruction,12,9,3
Buffwarlockz,stormrage,863,warlock,destruction,12,9,3
Azrezzael,area-52,863,warlock,destruction,12,9,3
Pacopico,illidan,863,warlock,destruction,12,9,3
Aryoc,ragnaros,863,warlock,destruction,12,9,3
Ragnalock,laughing-skull,863,warlock,destruction,12,9,3
Greedy,garrosh,863,warlock,destruction,12,9,3
Unprønuncea,azralon,863,warlock,destruction,13,9,4
Glergarby,stormscale,863,warlock,destruction,15,10,5
Ruknài,barthilas,863,warlock,destruction,18,9,9
Nethron,the-venture-co,863,warlock,destruction,18,9,9
Thravis,tichondrius,863,warlock,destruction,18,9,9
Wåbi,tichondrius,863,warlock,destruction,18,9,9
Nigsy,nagrand,863,warlock,destruction,18,9,9
Kairiesmirk,illidan,863,warlock,destruction,19,9,10
Goarage,tichondrius,863,warlock,destruction,22,10,12
Omleaf,malganis,863,warlock,destruction,24,9,15
Gingerspise,nathrezim,863,warlock,destruction,24,9,15
Goomgoom,doomhammer,863,warlock,destruction,24,9,15
Rokdas,area-52,863,warlock,destruction,24,9,15
Namig,aerie-peak,862,warlock,destruction,12,9,3
Locklockdead,earthen-ring,862,warlock,destruction,12,9,3
Pyresworn,wyrmrest-accord,862,warlock,destruction,12,9,3
Cogitoergo,stormrage,862,warlock,destruction,12,9,3
Taylôr,proudmoore,862,warlock,destruction,18,9,9
Jugerdotz,sargeras,862,warlock,destruction,18,9,9
Aksness,stormrage,862,warlock,destruction,18,9,9
Artheás,azralon,862,warlock,destruction,18,9,9
Breaad,tichondrius,862,warlock,destruction,24,9,15
Çrayoneater,tichondrius,862,warlock,destruction,24,9,15
Xenagos,antonidas,862,warlock,destruction,24,9,15
Huuchie,moon-guard,861,warlock,destruction,12,9,3
Eurygnomous,thrall,861,warlock,destruction,18,9,9
Gnomlette,smolderthorn,861,warlock,destruction,27,10,17
Evilyññ,tichondrius,860,warlock,destruction,18,9,9
Cælohin,tichondrius,860,warlock,destruction,18,9,9
Aeonora,akama,858,warlock,destruction,12,9,3
Jakeyboii,frostmourne,858,warlock,destruction,15,10,5
Cynwise,arathor,858,warlock,destruction,18,9,9
Hookslinger,barthilas,856,warlock,destruction,18,9,9
Shadohz,lightnings-blade,855,warlock,destruction,12,9,3
Theporkchunk,nordrassil,855,warlock,destruction,12,9,3
Josemb,ragnaros,853,warlock,destruction,18,9,9
Aerozyn,wyrmrest-accord,852,warlock,destruction,18,9,9
Klummzy,tichondrius,850,warlock,destruction,18,9,9
Nocchi,amanthul,832,warlock,destruction,16,9,7
Freakdoa,blades-edge,831,warlock,destruction,41,15,26
Sutra,tichondrius,806,warlock,destruction,17,9,8
Zoluraan,proudmoore,803,warlock,destruction,15,9,6
Parishiltoon,frostmourne,799,warlock,destruction,17,9,8
Memnøch,emerald-dream,798,warlock,destruction,17,9,8
Jaboltz,tichondrius,784,warlock,destruction,13,9,4
Tempestzone,barthilas,775,warlock,destruction,19,10,9
Bigulinhos,nemesis,768,warlock,destruction,12,8,4
Dmox,darkspear,768,warlock,destruction,12,8,4
Diznei,nemesis,768,warlock,destruction,12,8,4
Dxhusky,tichondrius,768,warlock,destruction,12,8,4
Thragèqt,sargeras,768,warlock,destruction,12,8,4
Dàmagicman,drakthul,768,warlock,destruction,12,8,4
Manapouli,area-52,768,warlock,destruction,12,8,4
Shinagae,tichondrius,768,warlock,destruction,12,8,4
Smeezles,frostmourne,768,warlock,destruction,12,8,4
Janeciap,tichondrius,768,warlock,destruction,12,8,4
Flackory,tichondrius,768,warlock,destruction,12,8,4
Flavakid,malganis,768,warlock,destruction,12,8,4
Fearsponce,dragonmaw,768,warlock,destruction,12,8,4
Clorvenna,zuljin,768,warlock,destruction,12,8,4
Hordeadlock,illidan,768,warlock,destruction,12,8,4
Nahz,tichondrius,768,warlock,destruction,12,8,4
Belandyr,stormrage,768,warlock,destruction,12,8,4
Bopplock,tichondrius,768,warlock,destruction,12,8,4
Ashlet,kelthuzad,768,warlock,destruction,12,8,4
Slpxoxo,sargeras,768,warlock,destruction,12,8,4
Narzhul,drakkari,768,warlock,destruction,12,8,4
Osmatz,area-52,768,warlock,destruction,12,8,4
Vigius,dalaran,768,warlock,destruction,12,8,4
Munje,bleeding-hollow,768,warlock,destruction,12,8,4
Aptukk,archimonde,768,warlock,destruction,12,8,4
Millidots,bleeding-hollow,768,warlock,destruction,12,8,4
Nyhn,bleeding-hollow,768,warlock,destruction,13,8,5
Radicalz,ragnaros,768,warlock,destruction,14,8,6
Esså,jaedenar,768,warlock,destruction,18,8,10
Theredwoman,emerald-dream,768,warlock,destruction,18,8,10
Westhofxx,sargeras,768,warlock,destruction,18,8,10
Reficul,frostmourne,768,warlock,destruction,18,8,10
Lockforyou,frostmourne,767,warlock,destruction,12,8,4
Bunnyhugs,gorefiend,767,warlock,destruction,12,8,4
Yonz,area-52,767,warlock,destruction,12,8,4
Zaintv,illidan,767,warlock,destruction,12,8,4
Lilibe,tichondrius,767,warlock,destruction,12,8,4
Xerozus,tichondrius,767,warlock,destruction,12,8,4
Accentuate,tichondrius,767,warlock,destruction,12,8,4
Vilebeing,frostmourne,767,warlock,destruction,12,8,4
Stankbigly,thrall,767,warlock,destruction,12,8,4
Freggen,shadowsong,767,warlock,destruction,12,8,4
Egirlgamer,sargeras,767,warlock,destruction,12,8,4
Hellbòund,mugthol,767,warlock,destruction,18,8,10
Jerearderedo,thrall,767,warlock,destruction,18,8,10
Gridwild,drakkari,767,warlock,destruction,18,8,10
Shikyo,lightnings-blade,767,warlock,destruction,18,8,10
Windwolff,dalvengyr,767,warlock,destruction,18,8,10
Lockednloade,tichondrius,766,warlock,destruction,12,8,4
Raglans,amanthul,766,warlock,destruction,12,8,4
Doomers,frostmourne,766,warlock,destruction,12,8,4
Mandley,nazgrel,766,warlock,destruction,18,8,10
Stinkychef,hyjal,765,warlock,destruction,12,8,4
Beldiinlock,khazgoroth,765,warlock,destruction,12,8,4
Telvanni,sargeras,765,warlock,destruction,12,8,4
Dewars,aggramar,765,warlock,destruction,24,8,16
Esoo,kul-tiras,763,warlock,destruction,12,8,4
Kelifan,sargeras,763,warlock,destruction,18,8,10
Caryn,dalaran,763,warlock,destruction,18,8,10
Nanodingo,tichondrius,762,warlock,destruction,18,8,10
Vampir,hellscream,762,warlock,destruction,18,8,10
Mshyde,gurubashi,760,warlock,destruction,12,8,4
Rageraff,trollbane,758,warlock,destruction,12,8,4
Escro,azgalor,753,warlock,destruction,12,8,4
Sotera,bleeding-hollow,719,warlock,destruction,11,8,3
Remua,tichondrius,719,warlock,destruction,11,8,3
Ðemented,bleeding-hollow,719,warlock,destruction,11,8,3
Bäbz,barthilas,703,warlock,destruction,11,8,3
Tinyjo,sargeras,703,warlock,destruction,11,8,3
Punishment,jubeithos,702,warlock,destruction,11,8,3
Felancholy,illidan,699,warlock,destruction,11,8,3
Getfeared,emerald-dream,672,warlock,destruction,10,8,2
Westhofz,sargeras,672,warlock,destruction,12,7,5
Almostoogood,illidan,672,warlock,destruction,12,7,5
Trastham,malganis,672,warlock,destruction,12,7,5
Luciusvrenus,tichondrius,672,warlock,destruction,12,7,5
Dipgodx,bleeding-hollow,672,warlock,destruction,12,7,5
Puginlock,illidan,672,warlock,destruction,12,7,5
Snikpan,silver-hand,672,warlock,destruction,12,7,5
Uggaboogga,malganis,672,warlock,destruction,12,7,5
Mattypatty,the-forgotten-coast,672,warlock,destruction,12,7,5
Drugmuffin,tichondrius,672,warlock,destruction,12,7,5
Ðòt,nagrand,672,warlock,destruction,12,7,5
Ðòm,tichondrius,672,warlock,destruction,12,7,5
Zelophobiaz,crushridge,672,warlock,destruction,12,7,5
Sixonenine,boulderfist,672,warlock,destruction,12,7,5
Cyio,zuljin,672,warlock,destruction,12,7,5
Poock,goldrinn,672,warlock,destruction,12,7,5
Starta,tichondrius,672,warlock,destruction,12,7,5
Clingrita,tichondrius,672,warlock,destruction,12,7,5
Lockdogg,mannoroth,672,warlock,destruction,12,7,5
Nooko,frostmourne,672,warlock,destruction,12,7,5
Flicks,arthas,672,warlock,destruction,12,7,5
Dötkill,illidan,672,warlock,destruction,12,7,5
Qualio,thrall,672,warlock,destruction,12,7,5
Says,gorefiend,672,warlock,destruction,12,7,5
Busterbob,tichondrius,672,warlock,destruction,12,7,5
Geekmonster,tichondrius,672,warlock,destruction,12,7,5
Hellfires,ragnaros,672,warlock,destruction,12,7,5
Rickyspanish,malygos,672,warlock,destruction,12,7,5
Cragalt,tichondrius,672,warlock,destruction,12,7,5
Kountdrakula,tichondrius,672,warlock,destruction,12,7,5
Blair,wildhammer,672,warlock,destruction,12,7,5
Boodizz,frostmourne,672,warlock,destruction,12,7,5
Misolock,sargeras,672,warlock,destruction,12,7,5
Forestfruit,tichondrius,672,warlock,destruction,12,7,5
Sendnudez,nemesis,672,warlock,destruction,12,7,5
Woopie,malfurion,672,warlock,destruction,12,7,5
Warsmock,tichondrius,672,warlock,destruction,12,7,5
Falcorr,area-52,672,warlock,destruction,16,8,8
Sladez,tichondrius,672,warlock,destruction,18,7,11
Dmacxl,tichondrius,672,warlock,destruction,18,7,11
Aroris,silver-hand,671,warlock,destruction,12,7,5
Boltondahoes,sargeras,671,warlock,destruction,12,7,5
Varuuss,ragnaros,671,warlock,destruction,12,7,5
Watchmegate,darkspear,671,warlock,destruction,12,7,5
Atrofourth,tichondrius,671,warlock,destruction,12,7,5
Irunaways,stormrage,671,warlock,destruction,12,7,5
Wollylock,dark-iron,671,warlock,destruction,18,7,11
Altazor,thunderlord,671,warlock,destruction,24,7,17
Mèrlin,aerie-peak,670,warlock,destruction,12,7,5
Necrodeath,malygos,670,warlock,destruction,12,7,5
Gambel,duskwood,669,warlock,destruction,18,7,11
Juan,borean-tundra,668,warlock,destruction,18,7,11
Sneakywarlok,dalaran,668,warlock,destruction,19,7,12
Voidxx,tichondrius,639,warlock,destruction,11,7,4
Ðeãdman,bleeding-hollow,638,warlock,destruction,14,8,6
Koitis,tichondrius,607,warlock,destruction,8,7,1
Rakudemon,ragnaros,607,warlock,destruction,14,7,7
Furrlokc,tichondrius,607,warlock,destruction,16,7,9
Toby,azralon,592,warlock,destruction,13,7,6
Darknessgodd,goldrinn,591,warlock,destruction,13,7,6
Darkmagician,kelthuzad,576,warlock,destruction,6,6,0
Notstingz,azralon,576,warlock,destruction,6,6,0
Whodatman,illidan,576,warlock,destruction,6,6,0
Kòngal,tichondrius,576,warlock,destruction,6,6,0
Blanklee,tichondrius,576,warlock,destruction,6,6,0
Winipuhmalo,quelthalas,576,warlock,destruction,6,6,0
Inaane,thrall,576,warlock,destruction,6,6,0
Ebølarot,tichondrius,576,warlock,destruction,6,6,0
Malevolent,velen,576,warlock,destruction,6,6,0
Menggoth,tichondrius,576,warlock,destruction,6,6,0
Schrader,sargeras,576,warlock,destruction,6,6,0
Absoluté,nemesis,576,warlock,destruction,6,6,0
Chaoscoach,sargeras,576,warlock,destruction,6,6,0
Dipixd,tichondrius,576,warlock,destruction,6,6,0
Loksoflove,tichondrius,576,warlock,destruction,6,6,0
Redsolojdc,tichondrius,576,warlock,destruction,6,6,0
Lokintots,darkspear,576,warlock,destruction,6,6,0
Mitchosx,frostmourne,576,warlock,destruction,6,6,0
Edeklock,frostmourne,576,warlock,destruction,6,6,0
Hommer,tichondrius,576,warlock,destruction,9,7,2
Necroboi,alterac-mountains,576,warlock,destruction,10,7,3
Broovid,tichondrius,576,warlock,destruction,13,7,6
Charmandfarm,nerzhul,576,warlock,destruction,12,6,6
Perples,dalaran,576,warlock,destruction,12,6,6
Draxxus,barthilas,576,warlock,destruction,12,6,6
Dauntx,proudmoore,576,warlock,destruction,12,6,6
Vravras,kelthuzad,576,warlock,destruction,12,6,6
Crimsonela,emerald-dream,576,warlock,destruction,12,6,6
Flu,darkspear,576,warlock,destruction,12,6,6
Daenon,kiljaeden,576,warlock,destruction,12,6,6
Gneçro,area-52,576,warlock,destruction,12,6,6
Kyoarnez,quelthalas,576,warlock,destruction,12,6,6
Andrewpg,zuljin,576,warlock,destruction,12,6,6
Kulgar,aerie-peak,576,warlock,destruction,12,6,6
Mothmayhem,moon-guard,576,warlock,destruction,12,6,6
Shigero,tichondrius,576,warlock,destruction,12,6,6
Marware,quelthalas,576,warlock,destruction,12,6,6
Zantology,frostmourne,576,warlock,destruction,12,6,6
Dipz,zuljin,576,warlock,destruction,12,6,6
Emptysoul,illidan,576,warlock,destruction,12,6,6
Asamsbinladn,illidan,576,warlock,destruction,12,6,6
Wolfib,tichondrius,576,warlock,destruction,12,6,6
Alizondemdik,azralon,576,warlock,destruction,12,6,6
Plutö,thrall,576,warlock,destruction,12,6,6
Morcegø,azralon,576,warlock,destruction,12,6,6
Pikslol,bleeding-hollow,576,warlock,destruction,12,6,6
Aldaill,moon-guard,576,warlock,destruction,12,6,6
Damdochael,bleeding-hollow,576,warlock,destruction,12,6,6
Soulripped,area-52,576,warlock,destruction,12,6,6
Sauzith,area-52,576,warlock,destruction,12,6,6
Ronnietherat,tichondrius,576,warlock,destruction,12,6,6
Kmüz,drakkari,576,warlock,destruction,12,6,6
Sumrule,dreadmaul,576,warlock,destruction,12,6,6
Greasymario,area-52,576,warlock,destruction,16,7,9
Feoona,hyjal,576,warlock,destruction,18,6,12
Bêlthazor,kelthuzad,576,warlock,destruction,18,6,12
Majinbuû,malganis,576,warlock,destruction,18,6,12
Tenletters,kirin-tor,576,warlock,destruction,18,6,12
Daimon,kaelthas,575,warlock,destruction,12,6,6
Méhoe,bleeding-hollow,575,warlock,destruction,12,6,6
Felryssa,kiljaeden,575,warlock,destruction,12,6,6
Beelzibub,firetree,575,warlock,destruction,12,6,6
Crankshaft,nordrassil,575,warlock,destruction,12,6,6
Disrespex,kelthuzad,575,warlock,destruction,12,6,6
Superbroly,area-52,575,warlock,destruction,12,6,6
Oluluo,andorhal,575,warlock,destruction,18,6,12
Trayga,illidan,574,warlock,destruction,6,6,0
Hungovermate,barthilas,574,warlock,destruction,12,6,6
Supercracker,bleeding-hollow,572,warlock,destruction,18,6,12
Rustý,illidan,557,warlock,destruction,11,6,5
Ralerhard,kelthuzad,544,warlock,destruction,16,6,10
Drdotngo,tichondrius,543,warlock,destruction,8,7,1
Woezz,tichondrius,528,warlock,destruction,15,6,9
Tm,dalaran,527,warlock,destruction,11,6,5
Loch,destromath,527,warlock,destruction,11,6,5
Lyonesse,frostmourne,527,warlock,destruction,11,6,5
Exillis,barthilas,527,warlock,destruction,17,6,11
Demotional,wyrmrest-accord,511,warlock,destruction,8,6,2
Medeia,tichondrius,511,warlock,destruction,11,6,5
Davnport,frostmourne,511,warlock,destruction,14,6,8
Blodrain,tichondrius,480,warlock,destruction,6,5,1
Lockbtw,altar-of-storms,480,warlock,destruction,6,5,1
Maèlstrom,area-52,480,warlock,destruction,6,5,1
Buboñic,area-52,480,warlock,destruction,6,5,1
Threeinches,kelthuzad,480,warlock,destruction,6,5,1
Hellparks,malganis,480,warlock,destruction,6,5,1
Kubera,mannoroth,480,warlock,destruction,6,5,1
Khaozx,ragnaros,480,warlock,destruction,6,5,1
Wenotcoo,tichondrius,480,warlock,destruction,6,5,1
Krokodiil,tichondrius,480,warlock,destruction,6,5,1
Xidothewitch,stormrage,480,warlock,destruction,6,5,1
Phyxylock,stormrage,480,warlock,destruction,6,5,1
Ikite,zuljin,480,warlock,destruction,6,5,1
Rothslock,tichondrius,480,warlock,destruction,6,5,1
Evapilot,tichondrius,480,warlock,destruction,6,5,1
Zycas,tichondrius,480,warlock,destruction,6,5,1
Drakwlya,tichondrius,480,warlock,destruction,6,5,1
Fabiusbilex,tichondrius,480,warlock,destruction,6,5,1
Destructium,stormrage,480,warlock,destruction,6,5,1
Unicornspit,tichondrius,480,warlock,destruction,6,5,1
Virûs,vashj,480,warlock,destruction,6,5,1
Pressurë,tichondrius,480,warlock,destruction,6,5,1
Indelock,drenden,480,warlock,destruction,6,5,1
Addonic,hyjal,480,warlock,destruction,6,5,1
Arnan,korgath,480,warlock,destruction,6,5,1
Elprup,tichondrius,480,warlock,destruction,6,5,1
Beranflakes,darkspear,480,warlock,destruction,6,5,1
Cloperry,area-52,480,warlock,destruction,6,5,1
Yuckytoetoe,emerald-dream,480,warlock,destruction,6,5,1
Limeriax,emerald-dream,480,warlock,destruction,6,5,1
Humblegodd,illidan,480,warlock,destruction,6,5,1
Khrom,illidan,480,warlock,destruction,6,5,1
Ascendant,amanthul,480,warlock,destruction,6,5,1
Selwitch,dalaran,480,warlock,destruction,6,5,1
Jalean,illidan,480,warlock,destruction,6,5,1
Wodwarlock,thrall,480,warlock,destruction,6,5,1
Bumbleebolts,azralon,480,warlock,destruction,6,5,1
Dkdakìng,dalaran,480,warlock,destruction,6,5,1
Mydots,frostmourne,480,warlock,destruction,6,5,1
Delarae,frostmourne,480,warlock,destruction,6,5,1
Gnimms,sargeras,480,warlock,destruction,12,5,7
Gallynna,moon-guard,480,warlock,destruction,12,5,7
Totsdots,blackrock,480,warlock,destruction,12,5,7
Beetlejoos,stormreaver,480,warlock,destruction,12,5,7
Gameface,garrosh,480,warlock,destruction,12,5,7
Justganmore,tichondrius,480,warlock,destruction,12,5,7
Jeramie,darkspear,480,warlock,destruction,12,5,7
Dialalock,frostmourne,480,warlock,destruction,12,5,7
Hellslayer,frostmourne,480,warlock,destruction,12,5,7
Topboypepito,tichondrius,480,warlock,destruction,12,5,7
Mitryc,illidan,480,warlock,destruction,12,5,7
Jankity,kelthuzad,480,warlock,destruction,12,5,7
Chazzlock,area-52,480,warlock,destruction,12,5,7
Rytaint,emerald-dream,480,warlock,destruction,12,5,7
Lildottythot,malganis,480,warlock,destruction,12,5,7
Bellgrande,shadowmoon,480,warlock,destruction,12,5,7
Errogant,area-52,480,warlock,destruction,12,5,7
Pveisboring,tichondrius,480,warlock,destruction,12,5,7
Lockandload,malfurion,480,warlock,destruction,12,5,7
Shadowflame,skullcrusher,480,warlock,destruction,12,5,7
Yurick,frostmourne,480,warlock,destruction,12,5,7
Souljäboy,bleeding-hollow,480,warlock,destruction,12,5,7
Necrotic,mannoroth,480,warlock,destruction,12,5,7
Seraphserius,laughing-skull,480,warlock,destruction,12,5,7
Hargol,azralon,480,warlock,destruction,12,5,7
Snapp,kelthuzad,480,warlock,destruction,12,5,7
Dottcha,blackrock,480,warlock,destruction,18,5,13
Degred,tichondrius,479,warlock,destruction,9,6,3
Vordz,amanthul,479,warlock,destruction,12,5,7
Loccdawg,laughing-skull,479,warlock,destruction,12,5,7
Githany,hyjal,479,warlock,destruction,12,5,7
Wìckedelf,area-52,477,warlock,destruction,9,6,3
Pancakestack,stormrage,477,warlock,destruction,18,5,13
Marvolö,darkspear,476,warlock,destruction,12,5,7
Klapincheeks,malganis,468,warlock,destruction,38,8,30
Mordror,azralon,462,warlock,destruction,11,5,6
Getsmoked,moknathal,447,warlock,destruction,11,5,6
Døtbomb,stormrage,447,warlock,destruction,11,5,6
Britnyfears,korgath,447,warlock,destruction,16,5,11
Notoriusmma,illidan,432,warlock,destruction,13,7,6
Buildsuccess,tichondrius,431,warlock,destruction,11,5,6
Brútek,moon-guard,431,warlock,destruction,11,5,6
Castngcouch,tichondrius,425,warlock,destruction,15,7,8
Empowerdlock,garrosh,416,warlock,destruction,10,5,5
Superspreadr,silvermoon,384,warlock,destruction,6,4,2
Danoinfelizz,nemesis,384,warlock,destruction,6,4,2
Savlonicsego,stormrage,384,warlock,destruction,6,4,2
Moramont,stormrage,384,warlock,destruction,6,4,2
Eazyw,stormrage,384,warlock,destruction,6,4,2
Eatmybeef,ravencrest,384,warlock,destruction,6,4,2
Demondan,magtheridon,384,warlock,destruction,6,4,2
Stizzy,eredar,384,warlock,destruction,6,4,2
Dotorama,sargeras,384,warlock,destruction,6,4,2
Xivra,thrall,384,warlock,destruction,6,4,2
Laytome,stormreaver,384,warlock,destruction,6,4,2
Eyoeyo,tichondrius,384,warlock,destruction,6,4,2
Lockiana,zuljin,384,warlock,destruction,6,4,2
Newty,zuljin,384,warlock,destruction,6,4,2
Honne,sargeras,384,warlock,destruction,6,4,2
Bhris,wildhammer,384,warlock,destruction,6,4,2
Dazedl,stormrage,384,warlock,destruction,6,4,2
Calcadius,zuljin,384,warlock,destruction,6,4,2
Deathtones,moon-guard,384,warlock,destruction,6,4,2
Arredivh,blackhand,384,warlock,destruction,6,4,2
Deebeel,sargeras,384,warlock,destruction,6,4,2
Gavrhin,area-52,384,warlock,destruction,6,4,2
Identiti,tichondrius,384,warlock,destruction,6,4,2
Squishyboy,tichondrius,384,warlock,destruction,6,4,2
Conspiration,sargeras,384,warlock,destruction,6,4,2
Ardamelech,quelthalas,384,warlock,destruction,6,4,2
Thinkchair,sargeras,384,warlock,destruction,6,4,2
Dadtired,tichondrius,384,warlock,destruction,6,4,2
Strykerliath,bleeding-hollow,384,warlock,destruction,6,4,2
Mérli,quelthalas,384,warlock,destruction,6,4,2
Drgiggles,tichondrius,384,warlock,destruction,6,4,2
Qfear,tichondrius,384,warlock,destruction,6,4,2
Asalaviik,illidan,384,warlock,destruction,6,4,2
Fullmelt,azjolnerub,384,warlock,destruction,6,4,2
Moóndust,bleeding-hollow,384,warlock,destruction,6,4,2
Carmelasin,moon-guard,384,warlock,destruction,6,4,2
Toastwl,tichondrius,384,warlock,destruction,6,4,2
Sdiaz,illidan,384,warlock,destruction,6,4,2
Sprenn,bleeding-hollow,384,warlock,destruction,6,4,2
Corruptblxck,tichondrius,384,warlock,destruction,6,4,2
Fatherbolt,tichondrius,384,warlock,destruction,6,4,2
Shivalx,tichondrius,384,warlock,destruction,6,4,2
Thelynx,chogall,384,warlock,destruction,6,4,2
Drezx,frostmourne,384,warlock,destruction,6,4,2
Zonss,tichondrius,384,warlock,destruction,6,4,2
Ëliphas,tichondrius,384,warlock,destruction,6,4,2
Extreme,blackwing-lair,384,warlock,destruction,6,4,2
Locean,tichondrius,384,warlock,destruction,6,4,2
Grammapatty,tichondrius,384,warlock,destruction,6,4,2
Donttouchme,azralon,384,warlock,destruction,6,4,2
Doubledigit,tichondrius,384,warlock,destruction,6,4,2
Agla,quelthalas,384,warlock,destruction,6,4,2
Gordoxin,area-52,384,warlock,destruction,6,4,2
Salties,magtheridon,384,warlock,destruction,6,4,2
Missmonday,tichondrius,384,warlock,destruction,6,4,2
Yury,scarlet-crusade,384,warlock,destruction,6,4,2
Rendori,the-scryers,384,warlock,destruction,6,4,2
Saltiez,sargeras,384,warlock,destruction,6,4,2
Overlard,illidan,384,warlock,destruction,6,4,2
Tahmrin,quelthalas,384,warlock,destruction,6,4,2
Iamfear,shuhalo,384,warlock,destruction,6,4,2
Wafflezcb,frostmourne,384,warlock,destruction,6,4,2
Jxstinl,tichondrius,384,warlock,destruction,6,4,2
Ozidus,tichondrius,384,warlock,destruction,6,4,2
Trewlocke,sargeras,384,warlock,destruction,6,4,2
Lemonfire,area-52,384,warlock,destruction,6,4,2
Viejitaa,quelthalas,384,warlock,destruction,6,4,2
Outkãst,illidan,384,warlock,destruction,6,4,2
Canobio,tichondrius,384,warlock,destruction,6,4,2
Chumbing,sargeras,384,warlock,destruction,6,4,2
Pengliyuaner,illidan,384,warlock,destruction,6,4,2
Wreckquiem,burning-blade,384,warlock,destruction,6,4,2
Norastrum,area-52,384,warlock,destruction,6,4,2
Vyrecks,hyjal,384,warlock,destruction,6,4,2
Eriess,burning-blade,384,warlock,destruction,6,4,2
Smnslock,emerald-dream,384,warlock,destruction,6,4,2
Wiredftwx,illidan,384,warlock,destruction,6,4,2
Ihaveapowers,maiev,384,warlock,destruction,6,4,2
Tonifortnite,emerald-dream,384,warlock,destruction,6,4,2
Manethail,aegwynn,384,warlock,destruction,6,4,2
Zyraxx,moon-guard,384,warlock,destruction,6,4,2
Raxxis,moon-guard,384,warlock,destruction,6,4,2
Sonovabeech,winterhoof,384,warlock,destruction,6,4,2
Fearem,tichondrius,384,warlock,destruction,6,4,2
Ñever,winterhoof,384,warlock,destruction,6,4,2
Baphomët,tichondrius,384,warlock,destruction,6,4,2
Palumorl,deathwing,384,warlock,destruction,6,4,2
Cosmosxx,illidan,384,warlock,destruction,6,4,2
Dottzie,malganis,384,warlock,destruction,6,4,2
Necrotko,malganis,384,warlock,destruction,6,4,2
Rodneyjones,emerald-dream,384,warlock,destruction,6,4,2
Malagas,tichondrius,384,warlock,destruction,6,4,2
Drböb,area-52,384,warlock,destruction,6,4,2
Warfeen,malganis,384,warlock,destruction,6,4,2
Saicinxd,darkspear,384,warlock,destruction,6,4,2
Galtur,azralon,384,warlock,destruction,6,4,2
Coil,kiljaeden,384,warlock,destruction,6,4,2
Frem,eonar,384,warlock,destruction,6,4,2
Sugmabone,zuluhed,384,warlock,destruction,6,4,2
Cowboydann,malganis,384,warlock,destruction,6,4,2
Saruon,proudmoore,384,warlock,destruction,6,4,2
Asiopdu,tichondrius,384,warlock,destruction,6,4,2
Homeboyardee,the-venture-co,384,warlock,destruction,6,4,2
Litemeatlary,kelthuzad,384,warlock,destruction,6,4,2
Roota,dalaran,384,warlock,destruction,6,4,2
Ztc,dalaran,384,warlock,destruction,6,4,2
Cursebolt,tichondrius,384,warlock,destruction,6,4,2
Kápz,darkspear,384,warlock,destruction,6,4,2
Soulicit,kelthuzad,384,warlock,destruction,6,4,2
Slappndemons,mugthol,384,warlock,destruction,6,4,2
Menedemus,amanthul,384,warlock,destruction,6,4,2
Ahp,stormrage,384,warlock,destruction,9,5,4
Darksòúl,stormrage,384,warlock,destruction,12,4,8
Soulinite,fizzcrank,384,warlock,destruction,12,4,8
Flocka,agamaggan,384,warlock,destruction,12,4,8
Valerilma,azralon,384,warlock,destruction,12,4,8
Fowll,frostwolf,384,warlock,destruction,12,4,8
Lockyy,khaz-modan,384,warlock,destruction,12,4,8
Paparoxy,illidan,384,warlock,destruction,12,4,8
Daedayus,frostwolf,384,warlock,destruction,12,4,8
Rumpology,illidan,384,warlock,destruction,12,4,8
Stepmommie,moon-guard,384,warlock,destruction,12,4,8
Jáws,zuljin,384,warlock,destruction,12,4,8
Oxylock,magtheridon,384,warlock,destruction,12,4,8
Syileria,frostmourne,384,warlock,destruction,12,4,8
Locdup,sargeras,384,warlock,destruction,12,4,8
Carcine,frostwolf,384,warlock,destruction,12,4,8
Mozbet,kiljaeden,384,warlock,destruction,12,4,8
Pãni,area-52,384,warlock,destruction,12,4,8
Destructing,hyjal,384,warlock,destruction,12,4,8
Felnightz,area-52,384,warlock,destruction,12,4,8
Offendor,stormrage,384,warlock,destruction,12,4,8
Threk,quelthalas,384,warlock,destruction,12,4,8
Perfidien,tichondrius,384,warlock,destruction,12,4,8
Nazrakin,malganis,384,warlock,destruction,12,4,8
Catastrophk,malganis,384,warlock,destruction,12,4,8
Cursedoll,ragnaros,384,warlock,destruction,12,4,8
Evarona,gorefiend,384,warlock,destruction,12,4,8
Moreedotss,malganis,384,warlock,destruction,18,4,14
Fearlord,shattered-hand,384,warlock,destruction,18,4,14
Ravikk,dalaran,384,warlock,destruction,18,4,14
Siliconsnipe,tichondrius,383,warlock,destruction,6,4,2
Mysophobia,frostmourne,383,warlock,destruction,6,4,2
Halkroz,nathrezim,383,warlock,destruction,6,4,2
Downing,drakkari,383,warlock,destruction,12,4,8
Shooterg,tichondrius,383,warlock,destruction,12,4,8
Asheräh,stormrage,383,warlock,destruction,12,4,8
Kurmenos,uldum,382,warlock,destruction,6,4,2
Mageline,thrall,382,warlock,destruction,18,4,14
Valintine,khadgar,367,warlock,destruction,9,5,4
Friend,frostmourne,367,warlock,destruction,11,4,7
Vanvídd,ragnaros,351,warlock,destruction,11,4,7
Promethian,proudmoore,351,warlock,destruction,11,4,7
Gobbledeez,moknathal,349,warlock,destruction,13,5,8
Lökdown,dalaran,330,warlock,destruction,9,7,2
Tharki,darkspear,330,warlock,destruction,7,5,2
Sooshi,malganis,330,warlock,destruction,11,6,5
Lockazo,quelthalas,330,warlock,destruction,11,6,5
Sojulord,sargeras,320,warlock,destruction,10,4,6
Trundle,area-52,319,warlock,destruction,5,4,1
Saintläurent,bleeding-hollow,319,warlock,destruction,5,4,1
Romminus,cenarius,304,warlock,destruction,7,4,3
Darthzugzug,gorefiend,288,warlock,destruction,6,3,3
Muchopower,ragnaros,288,warlock,destruction,6,3,3
Pennÿ,quelthalas,288,warlock,destruction,6,3,3
Seeword,sargeras,288,warlock,destruction,6,3,3
Papablasty,nagrand,288,warlock,destruction,6,3,3
Ticktóck,ghostlands,288,warlock,destruction,6,3,3
Eiram,ragnaros,288,warlock,destruction,6,3,3
Devi,destromath,288,warlock,destruction,6,3,3
Atheô,ragnaros,288,warlock,destruction,6,3,3
Carpedemon,malganis,288,warlock,destruction,6,3,3
Tamzlock,the-forgotten-coast,288,warlock,destruction,6,3,3
Nismo,trollbane,288,warlock,destruction,6,3,3
Macnab,malganis,288,warlock,destruction,6,3,3
Síkaría,malganis,288,warlock,destruction,6,3,3
Lübelock,illidan,288,warlock,destruction,6,3,3
Fungiforest,kelthuzad,288,warlock,destruction,6,3,3
Rightwaylovê,illidan,288,warlock,destruction,6,3,3
Drelgun,aerie-peak,288,warlock,destruction,6,3,3
Avadakedavra,warsong,288,warlock,destruction,6,3,3
Eldriptch,kelthuzad,288,warlock,destruction,6,3,3
Nihilus,anvilmar,288,warlock,destruction,6,3,3
Iemonv,vashj,288,warlock,destruction,6,3,3
Speakeasy,malygos,288,warlock,destruction,6,3,3
Deejaye,frostmourne,288,warlock,destruction,6,3,3
Lockedyaup,skullcrusher,288,warlock,destruction,6,3,3
Vafa,kelthuzad,288,warlock,destruction,6,3,3
Foxfoxfel,thrall,288,warlock,destruction,6,3,3
Milkybøng,area-52,288,warlock,destruction,6,3,3
Dashaad,illidan,288,warlock,destruction,6,3,3
Dìpndots,wyrmrest-accord,288,warlock,destruction,6,3,3
Vxms,barthilas,288,warlock,destruction,6,3,3
Siphoned,darkspear,288,warlock,destruction,6,3,3
Blaxzlock,stormscale,288,warlock,destruction,6,3,3
Slantsix,tichondrius,288,warlock,destruction,6,3,3
Shaddaj,illidan,288,warlock,destruction,6,3,3
Jishtructo,frostmourne,288,warlock,destruction,6,3,3
Oleg,bleeding-hollow,288,warlock,destruction,6,3,3
Necrotiá,tichondrius,288,warlock,destruction,6,3,3
Wondon,tichondrius,288,warlock,destruction,6,3,3
Zuelu,tichondrius,288,warlock,destruction,6,3,3
Freestyle,blackwater-raiders,288,warlock,destruction,6,3,3
Lillpfudd,area-52,288,warlock,destruction,6,3,3
Shutupthug,illidan,288,warlock,destruction,6,3,3
Fatals,thrall,288,warlock,destruction,6,3,3
Blastamastah,tichondrius,288,warlock,destruction,6,3,3
Crashcrash,area-52,288,warlock,destruction,6,3,3
Drazh,area-52,288,warlock,destruction,6,3,3
Unquit,frostmourne,288,warlock,destruction,6,3,3
Kreemy,ysera,288,warlock,destruction,6,3,3
Skullsoul,arthas,288,warlock,destruction,6,3,3
Damerus,illidan,288,warlock,destruction,6,3,3
Xblessed,stormrage,288,warlock,destruction,6,3,3
Ragnorök,medivh,288,warlock,destruction,6,3,3
Shatteroidz,darkspear,288,warlock,destruction,6,3,3
Meltingface,bleeding-hollow,288,warlock,destruction,6,3,3
Insànity,bleeding-hollow,288,warlock,destruction,6,3,3
Aruotnof,nemesis,288,warlock,destruction,6,3,3
Youkeyoh,illidan,288,warlock,destruction,6,3,3
Daemonixx,vashj,288,warlock,destruction,6,3,3
Yuvirayz,illidan,288,warlock,destruction,6,3,3
Neversoft,bleeding-hollow,288,warlock,destruction,6,3,3
Warlocknroll,frostmourne,288,warlock,destruction,6,3,3
Massivebolts,area-52,288,warlock,destruction,6,3,3
Rainali,tichondrius,288,warlock,destruction,6,3,3
Iongestpp,bleeding-hollow,288,warlock,destruction,6,3,3
Gurlock,illidan,288,warlock,destruction,6,3,3
Maleficist,bleeding-hollow,288,warlock,destruction,6,3,3
Geofar,bleeding-hollow,288,warlock,destruction,6,3,3
Mordekhay,tichondrius,288,warlock,destruction,6,3,3
Asetiks,tichondrius,288,warlock,destruction,6,3,3
Markov,goldrinn,288,warlock,destruction,6,3,3
Saffuky,frostmourne,288,warlock,destruction,6,3,3
Dotington,frostmourne,288,warlock,destruction,6,3,3
Souldotz,proudmoore,288,warlock,destruction,6,3,3
Embraces,tichondrius,288,warlock,destruction,6,3,3
Famelol,tichondrius,288,warlock,destruction,6,3,3
Thewkama,tichondrius,288,warlock,destruction,6,3,3
Djvetis,blackhand,288,warlock,destruction,6,3,3
Joung,tichondrius,288,warlock,destruction,6,3,3
Ðëâthløck,tichondrius,288,warlock,destruction,6,3,3
Matilla,tichondrius,288,warlock,destruction,6,3,3
Háydn,azuremyst,288,warlock,destruction,6,3,3
Tørturë,tichondrius,288,warlock,destruction,6,3,3
Naparima,stormreaver,288,warlock,destruction,6,3,3
Bhalthazar,staghelm,288,warlock,destruction,6,3,3
Dogcookie,moon-guard,288,warlock,destruction,6,3,3
Faldoras,kalecgos,288,warlock,destruction,6,3,3
Zephee,queldorei,288,warlock,destruction,6,3,3
Demfearslol,terokkar,288,warlock,destruction,6,3,3
Eskyx,tichondrius,288,warlock,destruction,6,3,3
Bobthedoc,sargeras,288,warlock,destruction,6,3,3
Cocoabuttâ,stormrage,288,warlock,destruction,6,3,3
Hachiui,galakrond,288,warlock,destruction,6,3,3
Luxenna,malganis,288,warlock,destruction,6,3,3
Anastadora,proudmoore,288,warlock,destruction,6,3,3
Dluttysots,emerald-dream,288,warlock,destruction,6,3,3
Uwubolt,moon-guard,288,warlock,destruction,6,3,3
Creedmore,sargeras,288,warlock,destruction,6,3,3
Hauntgød,tichondrius,288,warlock,destruction,6,3,3
Poggyjones,tichondrius,288,warlock,destruction,6,3,3
Amauder,moon-guard,288,warlock,destruction,6,3,3
Nutzosaurus,darkspear,288,warlock,destruction,6,3,3
Ÿoucantwin,kiljaeden,288,warlock,destruction,6,3,3
Ceeloftw,tichondrius,288,warlock,destruction,6,3,3
Shâdowman,stormrage,288,warlock,destruction,6,3,3
Phénom,tichondrius,288,warlock,destruction,6,3,3
Gattsonn,kiljaeden,288,warlock,destruction,6,3,3
Bunami,kiljaeden,288,warlock,destruction,6,3,3
Feartool,stormrage,288,warlock,destruction,6,3,3
Pheríe,sargeras,288,warlock,destruction,6,3,3
Mokfernal,tichondrius,288,warlock,destruction,6,3,3
Tanathoz,thrall,288,warlock,destruction,16,4,12
Drwolfman,bonechewer,288,warlock,destruction,12,3,9
Blindingsun,kiljaeden,288,warlock,destruction,12,3,9
Drsmegmaz,dreadmaul,288,warlock,destruction,12,3,9
Darkhadouken,sargeras,288,warlock,destruction,12,3,9
Gorgaron,zuljin,288,warlock,destruction,12,3,9
Gdpx,malganis,288,warlock,destruction,12,3,9
Mireffect,auchindoun,288,warlock,destruction,12,3,9
Rabiesdot,tichondrius,288,warlock,destruction,12,3,9
Gukky,misha,287,warlock,destruction,6,3,3
Izmadara,frostmane,287,warlock,destruction,6,3,3
Verybaked,sargeras,287,warlock,destruction,6,3,3
Kklock,frostmourne,287,warlock,destruction,6,3,3
Infortunium,sargeras,287,warlock,destruction,6,3,3
Trrolling,jubeithos,287,warlock,destruction,12,5,7
Alvatio,tichondrius,287,warlock,destruction,12,3,9
Myshadow,gorefiend,287,warlock,destruction,18,3,15
Casusita,area-52,286,warlock,destruction,6,3,3
Drunklockdot,tichondrius,271,warlock,destruction,11,3,8
Nobuyori,tichondrius,255,warlock,destruction,11,3,8
Draisien,moon-guard,250,warlock,destruction,7,5,2
Nawtychannel,aegwynn,239,warlock,destruction,5,3,2
Nozixx,thrall,224,warlock,destruction,10,3,7
Particles,proudmoore,192,warlock,destruction,4,3,1
Glôck,lightbringer,192,warlock,destruction,4,3,1
Perfidious,altar-of-storms,192,warlock,destruction,4,3,1
Diabolock,proudmoore,192,warlock,destruction,6,2,4
Mistrnesbitt,malganis,192,warlock,destruction,6,2,4
Deiformis,malganis,192,warlock,destruction,6,2,4
Cursé,stormrage,192,warlock,destruction,6,2,4
Peeberson,tichondrius,192,warlock,destruction,6,2,4
Belford,tichondrius,192,warlock,destruction,6,2,4
Nazug,dark-iron,192,warlock,destruction,6,2,4
Chrishasnen,moon-guard,192,warlock,destruction,6,2,4
Aededa,proudmoore,192,warlock,destruction,6,2,4
Omegawarlock,quelthalas,192,warlock,destruction,6,2,4
Dotcòm,illidan,192,warlock,destruction,6,2,4
Outlanderr,tichondrius,192,warlock,destruction,6,2,4
Jarasseck,malganis,192,warlock,destruction,6,2,4
Morganith,ravenholdt,192,warlock,destruction,6,2,4
Abbyshapiro,kelthuzad,192,warlock,destruction,6,2,4
Terminall,quelthalas,192,warlock,destruction,6,2,4
Dêmonique,azralon,192,warlock,destruction,6,2,4
Ðuckworth,azralon,192,warlock,destruction,6,2,4
Screampied,sargeras,192,warlock,destruction,6,2,4
Ricklock,aggramar,192,warlock,destruction,6,2,4
Cloudynightz,tichondrius,192,warlock,destruction,6,2,4
Iadminl,moon-guard,192,warlock,destruction,6,2,4
Sugarfire,nemesis,192,warlock,destruction,6,2,4
Dedremus,korialstrasz,192,warlock,destruction,6,2,4
Hollows,burning-blade,192,warlock,destruction,6,2,4
Voltshot,tichondrius,192,warlock,destruction,6,2,4
Theboss,arygos,192,warlock,destruction,6,2,4
Adalaya,emerald-dream,192,warlock,destruction,6,2,4
Rxjr,sargeras,192,warlock,destruction,6,2,4
Revenus,tichondrius,192,warlock,destruction,6,2,4
Oldwing,illidan,192,warlock,destruction,6,2,4
Zoboo,zuljin,192,warlock,destruction,6,2,4
Cityswimmer,malganis,192,warlock,destruction,6,2,4
Mutexlock,whisperwind,192,warlock,destruction,6,2,4
Albuuss,daggerspine,192,warlock,destruction,6,2,4
Gadalann,area-52,192,warlock,destruction,6,2,4
Grandpapapa,tichondrius,192,warlock,destruction,6,2,4
Donutd,stormrage,192,warlock,destruction,6,2,4
Apokálipse,frostmourne,192,warlock,destruction,6,2,4
Nameflagged,arathor,192,warlock,destruction,6,2,4
Yetiaids,tichondrius,192,warlock,destruction,6,2,4
Cholock,anubarak,192,warlock,destruction,6,2,4
Conorloco,tichondrius,192,warlock,destruction,6,2,4
Sorenbjerga,zuljin,192,warlock,destruction,6,2,4
Cynnd,tichondrius,192,warlock,destruction,6,2,4
Disapoin,stormrage,192,warlock,destruction,6,2,4
Falsaqt,area-52,192,warlock,destruction,6,2,4
Loçkshow,hyjal,192,warlock,destruction,6,2,4
Gingery,the-underbog,192,warlock,destruction,6,2,4
Nuradzec,illidan,192,warlock,destruction,6,2,4
Sinnâcle,illidan,192,warlock,destruction,6,2,4
Dotte,tichondrius,192,warlock,destruction,6,2,4
Ihatemyson,tichondrius,192,warlock,destruction,6,2,4
Grix,uldaman,192,warlock,destruction,6,2,4
Savemykoalas,tichondrius,192,warlock,destruction,6,2,4
Lazzie,thrall,192,warlock,destruction,6,2,4
Spicyfingers,illidan,192,warlock,destruction,6,2,4
Ourlegacy,tichondrius,192,warlock,destruction,6,2,4
Sathorastus,spirestone,192,warlock,destruction,6,2,4
Muffinlol,frostmourne,192,warlock,destruction,6,2,4
Shanelle,korgath,192,warlock,destruction,6,2,4
Tacticalderp,bleeding-hollow,192,warlock,destruction,6,2,4
Fjklock,nemesis,192,warlock,destruction,6,2,4
Tlock,azjolnerub,192,warlock,destruction,6,2,4
Imindanger,frostmourne,192,warlock,destruction,6,2,4
Chuwhee,sargeras,192,warlock,destruction,6,2,4
Ibanez,bleeding-hollow,192,warlock,destruction,6,2,4
Gihaewon,tichondrius,192,warlock,destruction,6,2,4
Deanwarlock,sargeras,192,warlock,destruction,6,2,4
Dach,moon-guard,192,warlock,destruction,6,2,4
Medraut,wyrmrest-accord,192,warlock,destruction,6,2,4
Daesire,moon-guard,192,warlock,destruction,6,2,4
Zunexx,malganis,192,warlock,destruction,6,2,4
Oopsíe,nagrand,192,warlock,destruction,6,2,4
Guisls,azralon,192,warlock,destruction,6,2,4
Ramone,turalyon,192,warlock,destruction,6,2,4
Qbl,wyrmrest-accord,192,warlock,destruction,6,2,4
Yungwilly,silvermoon,192,warlock,destruction,6,2,4
Ðamndaddy,sargeras,192,warlock,destruction,6,2,4
Harambê,sargeras,192,warlock,destruction,6,2,4
Tarth,sargeras,192,warlock,destruction,6,2,4
Sinsky,darkspear,192,warlock,destruction,6,2,4
Dotdoctor,thrall,192,warlock,destruction,9,2,7
Superbvious,lothar,192,warlock,destruction,12,2,10
Asumi,nemesis,192,warlock,destruction,12,2,10
Luntrazz,arthas,192,warlock,destruction,12,2,10
Brough,illidan,192,warlock,destruction,12,2,10
Dapperdanxy,tichondrius,192,warlock,destruction,12,2,10
Mystickittie,aerie-peak,191,warlock,destruction,6,2,4
Eldrien,spirestone,191,warlock,destruction,6,2,4
Fearfeaster,tichondrius,159,warlock,destruction,5,2,3
Prds,illidan,159,warlock,destruction,5,2,3
Dotyoazz,stormrage,159,warlock,destruction,5,2,3
Hayhatchie,nagrand,159,warlock,destruction,5,2,3
Eatmyboltz,hyjal,159,warlock,destruction,5,2,3
Predictions,sargeras,138,warlock,destruction,9,3,6
Rosacrutian,tichondrius,128,warlock,destruction,4,2,2
Deathboltx,zuljin,96,warlock,destruction,3,2,1
Crankak,zuljin,96,warlock,destruction,3,2,1
Cursedtool,quelthalas,96,warlock,destruction,3,2,1
Nazgal,tichondrius,96,warlock,destruction,3,2,1
Goodforyou,stormscale,96,warlock,destruction,3,2,1
Blastyboat,terenas,96,warlock,destruction,6,1,5
Dessoft,ragnaros,96,warlock,destruction,6,1,5
Demonist,moon-guard,96,warlock,destruction,6,1,5
Esoteríc,sargeras,96,warlock,destruction,6,1,5
Amour,wyrmrest-accord,96,warlock,destruction,6,1,5
Daemonddred,hakkar,96,warlock,destruction,6,1,5
Sheara,silver-hand,96,warlock,destruction,6,1,5
Pspot,kiljaeden,96,warlock,destruction,6,1,5
Teefgap,sargeras,96,warlock,destruction,6,1,5
Jill,thunderhorn,96,warlock,destruction,6,1,5
Proletariat,moon-guard,96,warlock,destruction,6,1,5
Juniorsalanu,quelthalas,96,warlock,destruction,6,1,5
Corezach,proudmoore,96,warlock,destruction,6,1,5
Gulgrin,eldrethalas,96,warlock,destruction,6,1,5
Sumonníng,tichondrius,96,warlock,destruction,6,1,5
Adlfcritler,emerald-dream,96,warlock,destruction,6,1,5
Siinistuh,tichondrius,96,warlock,destruction,6,1,5
Fearfactory,lethon,96,warlock,destruction,6,1,5
Saytiri,tichondrius,96,warlock,destruction,6,1,5
Panna,tichondrius,96,warlock,destruction,6,1,5
Shadü,tichondrius,96,warlock,destruction,6,1,5
Cornboil,tichondrius,96,warlock,destruction,6,1,5
Lazymongoose,frostmourne,96,warlock,destruction,6,1,5
Ezgamejr,tichondrius,96,warlock,destruction,6,1,5
Resima,stormscale,96,warlock,destruction,6,1,5
Voky,whisperwind,96,warlock,destruction,6,1,5
Kurtcodrain,blackhand,96,warlock,destruction,6,1,5
Darkmatter,frostmourne,96,warlock,destruction,6,1,5
Vendareth,earthen-ring,96,warlock,destruction,6,1,5
Plaguedoctor,stormrage,96,warlock,destruction,6,1,5
Lockedinn,mannoroth,96,warlock,destruction,6,1,5
Liljamie,stormrage,96,warlock,destruction,6,1,5
Shendù,stormrage,96,warlock,destruction,6,1,5
Bigdoinks,nagrand,96,warlock,destruction,6,1,5
Evilbacon,stormrage,96,warlock,destruction,6,1,5
Vexxes,malganis,96,warlock,destruction,6,1,5
Biigdaddyy,kelthuzad,96,warlock,destruction,6,1,5
Zedonius,dragonmaw,96,warlock,destruction,6,1,5
Kaotiq,area-52,96,warlock,destruction,6,1,5
Katastrophïk,area-52,96,warlock,destruction,6,1,5
Giggideez,bleeding-hollow,96,warlock,destruction,6,1,5
Yuengling,illidan,96,warlock,destruction,6,1,5
Elaïla,area-52,96,warlock,destruction,6,1,5
Mílkduds,zuljin,96,warlock,destruction,6,1,5
Mcpickl,illidan,96,warlock,destruction,6,1,5
Wesyane,anetheron,96,warlock,destruction,6,1,5
Gsr,bleeding-hollow,96,warlock,destruction,6,1,5
Tartamuda,ragnaros,96,warlock,destruction,6,1,5
Koillock,bleeding-hollow,96,warlock,destruction,6,1,5
Kraguenöth,drakkari,96,warlock,destruction,6,1,5
Wherelock,area-52,96,warlock,destruction,7,1,6
Beamac,cenarius,96,warlock,destruction,8,1,7
Anubís,vashj,79,warlock,destruction,5,1,4
Chéztér,proudmoore,79,warlock,destruction,11,1,10
Saltboi,azjolnerub,64,warlock,destruction,4,1,3
Mickylock,tichondrius,48,warlock,destruction,3,1,2
Umdur,zuljin,48,warlock,destruction,3,1,2
Humanwarlock,spirestone,42,warlock,destruction,9,2,7
Moräl,frostmourne,31,warlock,destruction,2,1,1
Amarexd,stormrage,31,warlock,destruction,2,1,1
Nt,burning-legion,16,warlock,destruction,1,1,0
Cabelas,tichondrius,2121,warrior,fury,77,41,36
Grimgrip,frostmane,2114,warrior,fury,72,43,29
Riproarin,stormrage,2105,warrior,fury,92,53,39
Americanbull,moon-guard,2011,warrior,fury,133,70,63
Thrator,wyrmrest-accord,1996,warrior,fury,72,33,39
Eno,ragnaros,1967,warrior,fury,57,41,16
Ragwreck,bleeding-hollow,1959,warrior,fury,68,35,33
Melifehorde,tichondrius,1904,warrior,fury,150,79,71
Lahired,drakkari,1886,warrior,fury,89,40,49
Dowser,goldrinn,1874,warrior,fury,72,40,32
Warqt,kelthuzad,1851,warrior,fury,59,32,27
Joshiman,area-52,1846,warrior,fury,54,27,27
Hlt,tichondrius,1839,warrior,fury,48,28,20
Jenjang,proudmoore,1834,warrior,fury,83,52,31
Zanzaa,sargeras,1830,warrior,fury,67,37,30
Shibaraku,tichondrius,1828,warrior,fury,66,37,29
Soymong,frostmourne,1825,warrior,fury,116,74,42
Mty,tichondrius,1824,warrior,fury,54,35,19
Szauren,stormrage,1824,warrior,fury,63,31,32
Bosswin,tichondrius,1820,warrior,fury,53,28,25
Skyja,quelthalas,1820,warrior,fury,42,22,20
Wienertoes,tichondrius,1820,warrior,fury,78,40,38
Isahri,moon-guard,1818,warrior,fury,110,64,46
Brodestar,sargeras,1816,warrior,fury,30,20,10
Neôn,frostmourne,1815,warrior,fury,66,37,29
Donutwar,proudmoore,1813,warrior,fury,54,30,24
Kennäy,azralon,1810,warrior,fury,46,28,18
Psychogenic,barthilas,1810,warrior,fury,102,60,42
Killuall,sargeras,1807,warrior,fury,42,23,19
Yawdamper,illidan,1805,warrior,fury,51,32,19
Seoní,wyrmrest-accord,1805,warrior,fury,76,43,33
Bigfatork,area-52,1803,warrior,fury,58,31,27
Franticlol,tichondrius,1802,warrior,fury,90,59,31
Cubie,malganis,1802,warrior,fury,75,40,35
Ágsdóùblémàú,bleeding-hollow,1797,warrior,fury,84,48,36
Rekatron,area-52,1783,warrior,fury,49,25,24
Sandronb,illidan,1781,warrior,fury,60,28,32
Beanstrom,tichondrius,1779,warrior,fury,53,29,24
Sàndman,malganis,1775,warrior,fury,39,23,16
Kholusia,kul-tiras,1766,warrior,fury,59,31,28
Choppiechop,area-52,1763,warrior,fury,36,24,12
Gooberbear,frostmourne,1763,warrior,fury,85,50,35
Vèév,proudmoore,1761,warrior,fury,36,24,12
Zujuzo,moon-guard,1753,warrior,fury,66,39,27
Escånor,moon-guard,1728,warrior,fury,25,19,6
Chopped,wyrmrest-accord,1725,warrior,fury,69,30,39
Gazzef,thrall,1718,warrior,fury,42,22,20
Ragwreckz,bleeding-hollow,1717,warrior,fury,40,25,15
Thugdorr,sargeras,1705,warrior,fury,96,51,45
Cabelastwo,tichondrius,1698,warrior,fury,30,20,10
Zangetsy,sargeras,1696,warrior,fury,51,32,19
Mochigome,moon-guard,1696,warrior,fury,97,49,48
Wampzug,azshara,1693,warrior,fury,42,24,18
Festergrin,area-52,1692,warrior,fury,36,21,15
Blgjb,tichondrius,1691,warrior,fury,54,23,31
Faren,agamaggan,1683,warrior,fury,81,49,32
Ðåddý,stormrage,1682,warrior,fury,101,51,50
Scrotedog,area-52,1680,warrior,fury,55,24,31
Fearless,moon-guard,1675,warrior,fury,102,56,46
Morfoggore,ragnaros,1673,warrior,fury,55,25,30
Gaazhel,quelthalas,1667,warrior,fury,67,36,31
Veyrin,stormrage,1665,warrior,fury,66,40,26
Tøpg,sargeras,1651,warrior,fury,43,23,20
Barafang,wyrmrest-accord,1649,warrior,fury,156,80,76
Larrybiscuit,moon-guard,1644,warrior,fury,72,46,26
Ragnararagor,ragnaros,1641,warrior,fury,156,82,74
Zyzz,scarlet-crusade,1640,warrior,fury,42,24,18
Scolpi,stormrage,1640,warrior,fury,58,31,27
Wolfcultist,moon-guard,1634,warrior,fury,93,44,49
Rikbielo,dragonmaw,1631,warrior,fury,49,31,18
Warsongwolf,tichondrius,1623,warrior,fury,64,32,32
Ediann,elune,1619,warrior,fury,71,42,29
Shadax,bleeding-hollow,1613,warrior,fury,44,24,20
Sithlõrd,moon-guard,1608,warrior,fury,48,25,23
Jimjinjin,tichondrius,1606,warrior,fury,36,20,16
Eggroll,emerald-dream,1605,warrior,fury,60,35,25
Påpi,sargeras,1604,warrior,fury,42,28,14
Apocalyptist,stormrage,1603,warrior,fury,45,23,22
Lilgucci,stonemaul,1602,warrior,fury,36,20,16
Bulgrim,moon-guard,1601,warrior,fury,42,21,21
Keltanas,quelthalas,1596,warrior,fury,41,21,20
Tádakatsu,sargeras,1594,warrior,fury,91,49,42
Gigatroll,tichondrius,1592,warrior,fury,59,30,29
Dripgodx,malganis,1585,warrior,fury,36,20,16
Igoboom,bleeding-hollow,1585,warrior,fury,46,25,21
Ruuthless,sargeras,1581,warrior,fury,40,23,17
Furíous,thunderhorn,1580,warrior,fury,42,20,22
Daedrion,dalaran,1579,warrior,fury,30,19,11
Jorked,drakkari,1574,warrior,fury,36,21,15
Onionsauce,frostmourne,1570,warrior,fury,60,30,30
Colorx,sargeras,1569,warrior,fury,40,22,18
Darkbunny,thaurissan,1569,warrior,fury,42,21,21
Wöûlöû,trollbane,1559,warrior,fury,67,37,30
Damonadrann,proudmoore,1552,warrior,fury,30,17,13
Gnomageddon,anetheron,1551,warrior,fury,35,17,18
Alteryx,sargeras,1548,warrior,fury,83,48,35
Zareshi,sargeras,1546,warrior,fury,116,64,52
Raggnarsøøn,ragnaros,1544,warrior,fury,87,40,47
Ragemane,illidan,1528,warrior,fury,24,16,8
Slughorn,moon-guard,1522,warrior,fury,30,16,14
Warrmachine,mannoroth,1520,warrior,fury,132,75,57
Chounshiryu,drakkari,1520,warrior,fury,135,71,64
Rendwarchief,garrosh,1520,warrior,fury,36,17,19
Zitfrlt,wildhammer,1518,warrior,fury,72,32,40
Youaredafeds,moon-guard,1517,warrior,fury,59,34,25
Crushanater,tichondrius,1514,warrior,fury,30,17,13
Playbox,area-52,1514,warrior,fury,83,37,46
Hairygrundel,area-52,1512,warrior,fury,24,16,8
Mytharion,sargeras,1511,warrior,fury,30,18,12
Anandamide,frostwolf,1503,warrior,fury,51,27,24
Nimna,moon-guard,1499,warrior,fury,59,29,30
Zuggrok,zuljin,1499,warrior,fury,36,16,20
Venirith,moon-guard,1495,warrior,fury,64,34,30
Crohdey,madoran,1489,warrior,fury,78,43,35
Albinosword,azralon,1488,warrior,fury,74,37,37
Romus,spirestone,1485,warrior,fury,24,16,8
Ikoré,saurfang,1480,warrior,fury,81,44,37
Tenger,velen,1474,warrior,fury,58,31,27
Rhann,kelthuzad,1473,warrior,fury,36,20,16
Karusuke,stormrage,1472,warrior,fury,36,21,15
Dwarlan,stormrage,1455,warrior,fury,42,26,16
Gûard,stormrage,1454,warrior,fury,29,19,10
Wurrukattezz,tichondrius,1449,warrior,fury,32,19,13
Elken,haomarush,1436,warrior,fury,36,20,16
Brøsk,azralon,1433,warrior,fury,36,17,19
Éomer,eitrigg,1428,warrior,fury,42,27,15
Iskandr,amanthul,1428,warrior,fury,39,19,20
Eatmyblade,wyrmrest-accord,1428,warrior,fury,94,42,52
Fearlessly,moon-guard,1425,warrior,fury,48,25,23
Gorrtog,stormrage,1425,warrior,fury,60,25,35
Know,anetheron,1423,warrior,fury,27,17,10
Tyroe,thunderhorn,1421,warrior,fury,24,15,9
Majindoom,illidan,1418,warrior,fury,47,27,20
Apeal,skullcrusher,1415,warrior,fury,60,32,28
Mankus,tichondrius,1409,warrior,fury,72,35,37
Exëqt,area-52,1404,warrior,fury,60,25,35
Xurug,zuljin,1400,warrior,fury,30,15,15
Slaggdad,illidan,1395,warrior,fury,62,26,36
Burtiera,wyrmrest-accord,1394,warrior,fury,18,15,3
Zekken,blades-edge,1392,warrior,fury,65,33,32
Heenguer,azralon,1391,warrior,fury,54,27,27
Fearlessxq,tichondrius,1390,warrior,fury,66,35,31
Swiftslaýer,vashj,1383,warrior,fury,35,16,19
Onîkudakì,sargeras,1382,warrior,fury,35,17,18
Lyonele,moon-guard,1380,warrior,fury,33,19,14
Hellframe,ysondre,1377,warrior,fury,36,17,19
Swiffy,stormrage,1375,warrior,fury,46,29,17
Kaladbolg,tichondrius,1369,warrior,fury,24,15,9
Wuushang,area-52,1369,warrior,fury,36,21,15
Jírky,ragnaros,1365,warrior,fury,78,39,39
Nebgleb,bleeding-hollow,1360,warrior,fury,24,16,8
Emotionaldps,malygos,1360,warrior,fury,141,74,67
Fendimonster,tichondrius,1357,warrior,fury,68,39,29
Matthegreat,area-52,1354,warrior,fury,45,22,23
Rageinc,jubeithos,1347,warrior,fury,56,24,32
Bondeye,stormrage,1325,warrior,fury,83,38,45
Dhaemom,azralon,1324,warrior,fury,47,23,24
Ivanzaytsev,ragnaros,1321,warrior,fury,66,32,34
Galaxarr,bonechewer,1319,warrior,fury,65,32,33
Cohëëd,kelthuzad,1318,warrior,fury,36,16,20
Darkduke,tichondrius,1307,warrior,fury,23,14,9
Spaceguybro,whisperwind,1298,warrior,fury,30,14,16
Xeto,ragnaros,1296,warrior,fury,34,20,14
Fabian,kelthuzad,1296,warrior,fury,76,40,36
Ivoryana,kelthuzad,1295,warrior,fury,42,23,19
Tüssèll,khazgoroth,1295,warrior,fury,91,44,47
Kelandrin,illidan,1292,warrior,fury,24,15,9
Savikk,earthen-ring,1287,warrior,fury,36,21,15
Varlekt,frostmourne,1285,warrior,fury,30,16,14
Wakkawar,stormrage,1285,warrior,fury,36,19,17
Lighttaker,proudmoore,1284,warrior,fury,30,17,13
Tdaddy,lightbringer,1280,warrior,fury,91,47,44
Attractive,silvermoon,1271,warrior,fury,42,21,21
Rsage,lightbringer,1269,warrior,fury,60,31,29
Grumok,tichondrius,1267,warrior,fury,26,14,12
Vandrad,stormrage,1255,warrior,fury,98,43,55
Wariorphilip,moon-guard,1250,warrior,fury,30,18,12
Weesten,aerie-peak,1249,warrior,fury,48,29,19
Braxxínn,tichondrius,1247,warrior,fury,18,13,5
Grosjambes,turalyon,1244,warrior,fury,24,16,8
Torkscreww,bleeding-hollow,1243,warrior,fury,24,13,11
Brutality,kirin-tor,1237,warrior,fury,24,13,11
Kaíroz,quelthalas,1223,warrior,fury,30,19,11
Furiousangel,area-52,1223,warrior,fury,30,16,14
Vornicar,moon-guard,1221,warrior,fury,32,14,18
Youserg,khazgoroth,1221,warrior,fury,46,18,28
Elonownesme,zuljin,1216,warrior,fury,24,13,11
Koraciá,illidan,1215,warrior,fury,36,17,19
Tenebrocity,stormrage,1213,warrior,fury,42,19,23
Breinan,ragnaros,1205,warrior,fury,51,26,25
Rendus,hyjal,1198,warrior,fury,54,21,33
Nemesioh,tichondrius,1174,warrior,fury,47,19,28
Zorhn,skywall,1161,warrior,fury,24,18,6
Furrytakeda,kelthuzad,1151,warrior,fury,24,12,12
Stavsie,tichondrius,1150,warrior,fury,18,12,6
Ganzism,tichondrius,1150,warrior,fury,24,12,12
Notcoverage,tichondrius,1150,warrior,fury,24,12,12
Zombad,azralon,1148,warrior,fury,18,12,6
Zarxc,quelthalas,1147,warrior,fury,24,12,12
Kellyboitv,frostmourne,1146,warrior,fury,30,12,18
Honduranhary,sargeras,1145,warrior,fury,22,13,9
Kanekhy,ragnaros,1143,warrior,fury,28,13,15
Thywub,proudmoore,1140,warrior,fury,24,12,12
Balbyo,shattered-hand,1139,warrior,fury,24,12,12
Morguez,tichondrius,1138,warrior,fury,24,12,12
Originalkhan,stormrage,1138,warrior,fury,30,12,18
Talismantate,quelthalas,1135,warrior,fury,18,12,6
Darthwarr,bleeding-hollow,1134,warrior,fury,18,14,4
Makcumba,ragnaros,1132,warrior,fury,24,12,12
Chahta,shadowsong,1125,warrior,fury,18,12,6
Roxon,hellscream,1117,warrior,fury,62,31,31
Líliúm,ragnaros,1111,warrior,fury,25,15,10
Sphílly,thrall,1107,warrior,fury,36,19,17
Renseven,frostmourne,1107,warrior,fury,24,12,12
Tyraelius,kiljaeden,1103,warrior,fury,39,24,15
Lucymay,kelthuzad,1097,warrior,fury,24,14,10
Fatguy,tichondrius,1078,warrior,fury,59,29,30
Badoosh,kaelthas,1075,warrior,fury,17,12,5
Rekill,emerald-dream,1055,warrior,fury,18,11,7
Nicfury,alterac-mountains,1055,warrior,fury,18,11,7
Ganzar,nesingwary,1055,warrior,fury,18,11,7
Tctc,emerald-dream,1055,warrior,fury,18,11,7
Robocöp,quelthalas,1054,warrior,fury,18,11,7
Atracasöl,ragnaros,1053,warrior,fury,18,11,7
Zerkxi,kelthuzad,1053,warrior,fury,18,11,7
Zèldris,gallywix,1053,warrior,fury,64,34,30
Trco,quelthalas,1047,warrior,fury,18,11,7
Garmeg,nemesis,1041,warrior,fury,42,16,26
Rumka,draktharon,1015,warrior,fury,65,26,39
Brodîn,tichondrius,1010,warrior,fury,24,13,11
Wyrmscream,moon-guard,1008,warrior,fury,78,37,41
Zweihänder,nemesis,1005,warrior,fury,17,11,6
Crazysharpz,thaurissan,1001,warrior,fury,29,12,17
Yêawen,tichondrius,990,warrior,fury,20,11,9
Curacao,dark-iron,987,warrior,fury,26,11,15
Pulp,sargeras,976,warrior,fury,19,11,8
Oddyseey,moon-guard,960,warrior,fury,12,10,2
Smexxin,tichondrius,960,warrior,fury,18,10,8
Éeu,anubarak,960,warrior,fury,90,45,45
Khrull,khazgoroth,958,warrior,fury,18,10,8
Celere,azralon,958,warrior,fury,24,10,14
Arfzz,zangarmarsh,957,warrior,fury,18,10,8
Rafurk,area-52,957,warrior,fury,18,10,8
Aarmii,ragnaros,957,warrior,fury,18,10,8
Limpninny,dalaran,957,warrior,fury,21,10,11
Gorbagglúk,azralon,926,warrior,fury,24,12,12
Sperow,malygos,925,warrior,fury,20,11,9
Ghostlyedge,turalyon,918,warrior,fury,72,25,47
Hammerock,ragnaros,910,warrior,fury,17,10,7
Bargorengar,skullcrusher,910,warrior,fury,89,43,46
Garce,aerie-peak,908,warrior,fury,17,10,7
Samdarkblade,kilrogg,898,warrior,fury,33,10,23
Firmware,illidan,896,warrior,fury,22,10,12
Grievouz,nemesis,894,warrior,fury,17,10,7
Hùlksmâsh,zuljin,892,warrior,fury,18,11,7
Agragar,zuljin,864,warrior,fury,12,9,3
Cannabiddies,illidan,864,warrior,fury,18,9,9
Astrëa,quelthalas,864,warrior,fury,18,9,9
Hoodlark,lightbringer,863,warrior,fury,12,9,3
Kombatwombat,kaelthas,863,warrior,fury,12,9,3
Liltom,sargeras,863,warrior,fury,18,9,9
Setseno,stormrage,863,warrior,fury,18,9,9
Zastrow,dalaran,863,warrior,fury,18,9,9
Gzilla,queldorei,863,warrior,fury,24,9,15
Nowarriororc,thrall,862,warrior,fury,18,9,9
Tanorai,area-52,862,warrior,fury,18,9,9
Errejota,illidan,862,warrior,fury,24,9,15
Wazy,ragnaros,862,warrior,fury,24,9,15
Rageraz,trollbane,860,warrior,fury,12,9,3
Maddzspin,tichondrius,860,warrior,fury,18,9,9
Asuna,burning-blade,860,warrior,fury,18,9,9
Stunninchaos,shattered-hand,859,warrior,fury,24,9,15
Lovehandlez,proudmoore,858,warrior,fury,18,9,9
Goinberserk,tichondrius,854,warrior,fury,22,9,13
Trufsoturi,bleeding-hollow,845,warrior,fury,23,9,14
Kajing,boulderfist,836,warrior,fury,19,10,9
Machâ,illidan,830,warrior,fury,17,9,8
Jellyjamz,zuljin,825,warrior,fury,24,9,15
Chillawigs,kelthuzad,816,warrior,fury,15,10,5
Cüba,nemesis,770,warrior,fury,24,9,15
Rimshotts,sargeras,768,warrior,fury,12,8,4
Sonyanalogue,frostmourne,768,warrior,fury,12,8,4
Ymìr,moon-guard,768,warrior,fury,12,8,4
Bamag,dethecus,768,warrior,fury,12,8,4
Jimseung,tichondrius,768,warrior,fury,18,8,10
Asstastic,bonechewer,768,warrior,fury,18,8,10
Radisa,sargeras,768,warrior,fury,18,8,10
Ssamba,shattered-hand,768,warrior,fury,18,8,10
Icebringer,frostmourne,768,warrior,fury,24,8,16
Bigßiceps,tichondrius,767,warrior,fury,12,8,4
Galigiggs,emerald-dream,767,warrior,fury,12,8,4
Kortera,malganis,767,warrior,fury,12,8,4
Mulish,frostmourne,767,warrior,fury,19,10,9
Bigjier,proudmoore,767,warrior,fury,18,8,10
Wíldcat,illidan,767,warrior,fury,18,8,10
Zêtt,drakkari,767,warrior,fury,18,8,10
Theßull,frostmourne,766,warrior,fury,12,8,4
Corbray,frostmourne,766,warrior,fury,24,8,16
Skipowawa,area-52,763,warrior,fury,18,8,10
Trendxx,stormrage,763,warrior,fury,24,8,16
Irontarkus,garrosh,762,warrior,fury,12,8,4
Creedz,dreadmaul,761,warrior,fury,18,8,10
Alandris,icecrown,760,warrior,fury,18,10,8
Uhtred,moonrunner,757,warrior,fury,18,8,10
Rôxi,malganis,735,warrior,fury,17,8,9
Trôca,ragnaros,713,warrior,fury,18,11,7
Pigonhae,zuljin,713,warrior,fury,19,10,9
Eleronogoth,draka,704,warrior,fury,16,8,8
Kolosaltwo,tichondrius,703,warrior,fury,11,8,3
Buckleboot,illidan,672,warrior,fury,12,7,5
Ciege,illidan,672,warrior,fury,12,7,5
Sypii,malganis,672,warrior,fury,12,7,5
Giannï,chogall,672,warrior,fury,12,7,5
Kilp,thrall,672,warrior,fury,12,7,5
Whitetaure,arthas,672,warrior,fury,12,7,5
Eino,llane,672,warrior,fury,12,7,5
Illaedan,quelthalas,672,warrior,fury,12,7,5
Lòrdnasher,tichondrius,672,warrior,fury,12,7,5
Damburga,tichondrius,672,warrior,fury,12,7,5
Ðow,burning-blade,672,warrior,fury,12,7,5
Funsyze,garona,672,warrior,fury,12,7,5
Ruckw,stormrage,672,warrior,fury,12,7,5
Maar,lightbringer,672,warrior,fury,12,7,5
Dós,emerald-dream,672,warrior,fury,12,7,5
Canduin,queldorei,672,warrior,fury,12,7,5
Youjumpijump,frostmourne,672,warrior,fury,18,7,11
Mardrex,korgath,672,warrior,fury,18,7,11
Warhand,frostmourne,672,warrior,fury,18,7,11
Nokak,borean-tundra,671,warrior,fury,12,7,5
Iorak,queldorei,671,warrior,fury,12,7,5
Akusenshi,dragonblight,671,warrior,fury,12,7,5
Calzonez,bloodscalp,671,warrior,fury,12,7,5
Tayne,ragnaros,671,warrior,fury,12,7,5
Pelikanesis,arthas,671,warrior,fury,12,7,5
Mikejustice,kelthuzad,671,warrior,fury,15,8,7
Ragnir,kelthuzad,671,warrior,fury,18,7,11
Remudan,tichondrius,671,warrior,fury,18,7,11
Violençe,malganis,671,warrior,fury,18,7,11
Jubeithos,draktharon,671,warrior,fury,18,7,11
Judessi,kiljaeden,670,warrior,fury,12,7,5
Ganon,garrosh,670,warrior,fury,12,7,5
Tiqokz,sargeras,670,warrior,fury,12,7,5
Siiss,stormrage,665,warrior,fury,21,9,12
Ashwalker,malganis,639,warrior,fury,14,8,6
Velarrine,illidan,639,warrior,fury,17,7,10
Wintz,dreadmaul,638,warrior,fury,14,8,6
Donjuan,skullcrusher,637,warrior,fury,20,8,12
Ourhero,malganis,623,warrior,fury,15,7,8
Furryhorv,frostmourne,608,warrior,fury,22,7,15
Vorthax,korgath,607,warrior,fury,14,7,7
Noktyn,haomarush,591,warrior,fury,11,7,4
Taiine,moon-guard,576,warrior,fury,6,6,0
Harlow,spirestone,576,warrior,fury,12,6,6
Alysson,moon-guard,576,warrior,fury,12,6,6
Endurefen,sargeras,576,warrior,fury,12,6,6
Braxtön,moon-guard,576,warrior,fury,12,6,6
Whateverzhan,tichondrius,576,warrior,fury,12,6,6
Assaulttank,drenden,576,warrior,fury,12,6,6
Lurtras,exodar,576,warrior,fury,12,6,6
Snowflakee,jaedenar,576,warrior,fury,12,6,6
Prestico,ragnaros,576,warrior,fury,12,6,6
Vinvivenna,emerald-dream,576,warrior,fury,12,6,6
Endlesskilla,destromath,576,warrior,fury,12,6,6
Strongerjaw,tichondrius,576,warrior,fury,12,6,6
Tacrolimus,thrall,576,warrior,fury,12,6,6
Eazyc,tichondrius,576,warrior,fury,12,6,6
Dëåth,azgalor,576,warrior,fury,12,6,6
Ggull,tichondrius,576,warrior,fury,12,6,6
Kaivax,tichondrius,576,warrior,fury,12,6,6
Carnemølida,thrall,576,warrior,fury,12,6,6
Venóm,moon-guard,576,warrior,fury,12,6,6
Disarmed,proudmoore,576,warrior,fury,12,6,6
Soulfang,stormscale,576,warrior,fury,12,6,6
Progesterone,bleeding-hollow,576,warrior,fury,12,6,6
Ðrënch,tichondrius,576,warrior,fury,12,6,6
Rohkvan,illidan,576,warrior,fury,12,6,6
Digitaldj,frostmourne,576,warrior,fury,18,6,12
Eregor,sargeras,576,warrior,fury,18,6,12
Noten,thunderlord,575,warrior,fury,12,6,6
Isitorganic,nesingwary,575,warrior,fury,12,6,6
Joxer,nordrassil,575,warrior,fury,12,6,6
Xenyn,malganis,575,warrior,fury,12,6,6
Sálieri,ragnaros,575,warrior,fury,12,6,6
Trackhawk,moon-guard,575,warrior,fury,12,6,6
Khargrok,ragnaros,575,warrior,fury,12,6,6
Undmyaxe,shattered-halls,575,warrior,fury,12,6,6
Uggtrick,zuljin,575,warrior,fury,12,6,6
Luckychaos,bleeding-hollow,575,warrior,fury,12,6,6
Rekitralph,tichondrius,575,warrior,fury,12,6,6
Redblade,bleeding-hollow,575,warrior,fury,18,6,12
Badairplane,gilneas,574,warrior,fury,12,6,6
Kurishjadar,tichondrius,574,warrior,fury,18,6,12
Owwycowwy,area-52,573,warrior,fury,18,6,12
Xfootman,quelthalas,570,warrior,fury,12,6,6
Orrof,antonidas,559,warrior,fury,17,6,11
Moriax,azralon,558,warrior,fury,17,6,11
Jonÿ,sargeras,549,warrior,fury,15,7,8
Freakin,ragnaros,543,warrior,fury,16,6,10
Ghonad,windrunner,541,warrior,fury,17,6,11
Sinbãd,sargeras,527,warrior,fury,11,6,5
Nïckböï,misha,519,warrior,fury,11,6,5
Antei,thunderlord,511,warrior,fury,11,6,5
Groguu,windrunner,480,warrior,fury,6,5,1
Hydrolisk,area-52,480,warrior,fury,6,5,1
Yepkorean,tichondrius,480,warrior,fury,6,5,1
Shimizuken,tichondrius,480,warrior,fury,6,5,1
Alarìon,malganis,480,warrior,fury,6,5,1
Azázyel,quelthalas,480,warrior,fury,6,5,1
Bornclueless,illidan,480,warrior,fury,6,5,1
Invinciblé,tichondrius,480,warrior,fury,6,5,1
Coldshots,stormreaver,480,warrior,fury,6,5,1
Deseroth,illidan,480,warrior,fury,6,5,1
Orkussw,illidan,480,warrior,fury,6,5,1
Slamuëladams,bleeding-hollow,480,warrior,fury,12,5,7
Clansy,moon-guard,480,warrior,fury,12,5,7
Gorehardt,illidan,480,warrior,fury,12,5,7
Iwillcrushyo,darkspear,480,warrior,fury,12,5,7
Conflíct,illidan,480,warrior,fury,12,5,7
Kræzee,kelthuzad,480,warrior,fury,12,5,7
Chop,khadgar,480,warrior,fury,12,5,7
Wrniss,tichondrius,480,warrior,fury,12,5,7
Wangjianguo,illidan,480,warrior,fury,12,5,7
Pápý,ragnaros,480,warrior,fury,12,5,7
Brainhaze,tichondrius,480,warrior,fury,12,5,7
Trekk,azralon,480,warrior,fury,12,5,7
Chainsa,stormrage,480,warrior,fury,12,5,7
Kratøz,tichondrius,480,warrior,fury,12,5,7
Yzoth,sargeras,480,warrior,fury,12,5,7
Warroiser,quelthalas,480,warrior,fury,12,5,7
Rinima,tichondrius,480,warrior,fury,12,5,7
Sugmad,area-52,480,warrior,fury,12,5,7
Maltrate,hyjal,480,warrior,fury,12,5,7
Axesomebody,tichondrius,480,warrior,fury,12,5,7
Dragonrage,tanaris,480,warrior,fury,18,5,13
Zirtag,proudmoore,479,warrior,fury,6,5,1
Olegg,laughing-skull,479,warrior,fury,12,5,7
Zephyron,moonrunner,479,warrior,fury,12,5,7
Warsero,tichondrius,479,warrior,fury,12,5,7
Arrad,sargeras,479,warrior,fury,18,5,13
Keateane,frostmourne,478,warrior,fury,6,5,1
Crashacorn,stormrage,476,warrior,fury,12,5,7
Fabszord,nemesis,476,warrior,fury,12,5,7
Veganwarrior,quelthalas,469,warrior,fury,18,5,13
Rageverd,malganis,432,warrior,fury,9,5,4
Avatarl,ragnaros,432,warrior,fury,15,5,10
Thalloom,thaurissan,432,warrior,fury,15,5,10
Smallestwar,zuljin,431,warrior,fury,15,5,10
Panterra,azralon,426,warrior,fury,16,7,9
Israelelel,azralon,416,warrior,fury,10,5,5
Stompgnomes,malganis,414,warrior,fury,14,5,9
Chippurrz,illidan,399,warrior,fury,5,5,0
Drashi,nazjatar,384,warrior,fury,6,4,2
Jàmiè,wyrmrest-accord,384,warrior,fury,6,4,2
Sarachnis,area-52,384,warrior,fury,6,4,2
Wishayzka,drakkari,384,warrior,fury,6,4,2
Slashen,sargeras,384,warrior,fury,6,4,2
Chash,frostmourne,384,warrior,fury,6,4,2
Techanina,aerie-peak,384,warrior,fury,6,4,2
Willcharge,tichondrius,384,warrior,fury,6,4,2
Varkiren,moon-guard,384,warrior,fury,6,4,2
Ymirock,area-52,384,warrior,fury,6,4,2
Akaínu,area-52,384,warrior,fury,6,4,2
Braxxinn,tichondrius,384,warrior,fury,6,4,2
Unpaused,kelthuzad,384,warrior,fury,6,4,2
Phandrosa,ragnaros,384,warrior,fury,6,4,2
Zerríck,moon-guard,384,warrior,fury,6,4,2
Suzushi,tichondrius,384,warrior,fury,6,4,2
Breké,moon-guard,384,warrior,fury,6,4,2
Goremack,hellscream,384,warrior,fury,6,4,2
Testees,senjin,384,warrior,fury,6,4,2
Mers,garrosh,384,warrior,fury,6,4,2
Zikeno,dalaran,384,warrior,fury,6,4,2
Blackbaba,illidan,384,warrior,fury,6,4,2
Tyranatusk,malganis,384,warrior,fury,6,4,2
Beforever,kiljaeden,384,warrior,fury,6,4,2
Marimadelene,aegwynn,384,warrior,fury,6,4,2
Varith,sargeras,384,warrior,fury,6,4,2
Hasbullá,ragnaros,384,warrior,fury,6,4,2
Gtrain,barthilas,384,warrior,fury,6,4,2
Nikomasked,kelthuzad,384,warrior,fury,6,4,2
Cidrick,stormrage,384,warrior,fury,6,4,2
Zartren,khazgoroth,384,warrior,fury,6,4,2
Arågòrn,stormrage,384,warrior,fury,6,4,2
Lilcha,stormrage,384,warrior,fury,6,4,2
Murghol,malganis,384,warrior,fury,6,4,2
Hellsinga,stormrage,384,warrior,fury,6,4,2
Negrus,sargeras,384,warrior,fury,11,4,7
Arágorn,sargeras,384,warrior,fury,11,4,7
Skrot,stormrage,384,warrior,fury,12,4,8
Gorm,greymane,384,warrior,fury,12,4,8
Çampbêll,area-52,384,warrior,fury,12,4,8
Hukzula,illidan,384,warrior,fury,12,4,8
Dotlom,wyrmrest-accord,384,warrior,fury,12,4,8
Muradinpica,stormrage,384,warrior,fury,12,4,8
Daelganis,sargeras,384,warrior,fury,12,4,8
Rezzett,wyrmrest-accord,384,warrior,fury,12,4,8
Oohsht,tichondrius,384,warrior,fury,12,4,8
Easons,tichondrius,384,warrior,fury,12,4,8
Osannd,tichondrius,384,warrior,fury,12,4,8
Goatmanee,tichondrius,384,warrior,fury,12,4,8
Ghurrk,hyjal,384,warrior,fury,12,4,8
Eamonvalda,dalaran,384,warrior,fury,12,4,8
Cryposlice,malganis,384,warrior,fury,12,4,8
Cjay,bleeding-hollow,384,warrior,fury,12,4,8
Groggam,illidan,384,warrior,fury,12,4,8
Mäjka,dalaran,384,warrior,fury,12,4,8
Lsays,tichondrius,384,warrior,fury,18,4,14
Awell,azralon,383,warrior,fury,6,4,2
Drovik,malygos,383,warrior,fury,12,4,8
Hæmomancy,moon-guard,383,warrior,fury,12,4,8
Assmut,stormrage,383,warrior,fury,12,4,8
Rahmholz,bonechewer,383,warrior,fury,12,4,8
Anger,zuljin,383,warrior,fury,24,4,20
Bonebreakr,tichondrius,381,warrior,fury,24,4,20
Baxel,arthas,367,warrior,fury,11,4,7
Zovudo,area-52,351,warrior,fury,8,5,3
Huleo,tichondrius,330,warrior,fury,14,5,9
Demøletiøn,stormrage,288,warrior,fury,6,3,3
Squonks,kelthuzad,288,warrior,fury,6,3,3
Pancárcho,quelthalas,288,warrior,fury,6,3,3
Riggs,stonemaul,288,warrior,fury,6,3,3
Riechst,quelthalas,288,warrior,fury,6,3,3
Kåyotix,proudmoore,288,warrior,fury,6,3,3
Lightswords,stormrage,288,warrior,fury,6,3,3
Vongrave,moonrunner,288,warrior,fury,6,3,3
Jethrix,kelthuzad,288,warrior,fury,6,3,3
Rowdyanders,area-52,288,warrior,fury,6,3,3
Kíngkaisér,azralon,288,warrior,fury,6,3,3
Doczz,malganis,288,warrior,fury,6,3,3
Kreamyumyums,tichondrius,288,warrior,fury,6,3,3
Kénblock,tichondrius,288,warrior,fury,6,3,3
Guillotinè,area-52,288,warrior,fury,6,3,3
Kàli,kiljaeden,288,warrior,fury,6,3,3
Ironbark,elune,288,warrior,fury,6,3,3
Barbarìan,bleeding-hollow,288,warrior,fury,6,3,3
Aeros,winterhoof,288,warrior,fury,6,3,3
Painfulsin,tichondrius,288,warrior,fury,6,3,3
Xragnar,area-52,288,warrior,fury,6,3,3
Zangre,stormrage,288,warrior,fury,6,3,3
Slãmpiece,stormrage,288,warrior,fury,6,3,3
Executie,duskwood,288,warrior,fury,6,3,3
Tâlos,magtheridon,288,warrior,fury,6,3,3
Hithen,quelthalas,288,warrior,fury,6,3,3
Rynkae,moon-guard,288,warrior,fury,6,3,3
Decimateme,tichondrius,288,warrior,fury,6,3,3
Wwesheamus,frostmourne,288,warrior,fury,6,3,3
Buhurt,sargeras,288,warrior,fury,6,3,3
Colössal,moon-guard,288,warrior,fury,6,3,3
Beârz,the-underbog,288,warrior,fury,6,3,3
Lechee,silvermoon,288,warrior,fury,6,3,3
Philsbbqnow,dark-iron,288,warrior,fury,6,3,3
Zerrekarr,wyrmrest-accord,288,warrior,fury,6,3,3
Vodak,daggerspine,288,warrior,fury,6,3,3
Maarilayne,wyrmrest-accord,288,warrior,fury,6,3,3
Kimed,nordrassil,288,warrior,fury,6,3,3
Corvesio,wyrmrest-accord,288,warrior,fury,6,3,3
Drumann,hyjal,288,warrior,fury,6,3,3
Veevz,proudmoore,288,warrior,fury,12,3,9
Thänatøs,nemesis,288,warrior,fury,12,3,9
Flexìn,tichondrius,288,warrior,fury,12,3,9
Tríxman,moon-guard,288,warrior,fury,12,3,9
Ratface,frostmourne,288,warrior,fury,12,3,9
Banggo,frostmourne,288,warrior,fury,12,3,9
Supersquish,moon-guard,288,warrior,fury,12,3,9
Siegeshatter,moon-guard,288,warrior,fury,12,3,9
Axekill,bleeding-hollow,288,warrior,fury,12,3,9
Rólex,tichondrius,288,warrior,fury,12,3,9
Krimmjðw,sargeras,288,warrior,fury,12,3,9
Kuragdem,trollbane,288,warrior,fury,12,3,9
Kimuraa,hyjal,288,warrior,fury,12,3,9
Lootacris,illidan,288,warrior,fury,12,3,9
Disclone,tichondrius,287,warrior,fury,6,3,3
Lourdadmiwal,aegwynn,287,warrior,fury,6,3,3
Eadsmasher,jubeithos,287,warrior,fury,6,3,3
Monsterpepe,tichondrius,287,warrior,fury,12,3,9
Boothtowolf,the-forgotten-coast,286,warrior,fury,6,3,3
Bigdaddyzees,bleeding-hollow,255,warrior,fury,11,3,8
Offthecharts,mannoroth,254,warrior,fury,11,3,8
Leturen,emerald-dream,240,warrior,fury,13,4,9
Leónard,moon-guard,239,warrior,fury,5,3,2
Shapur,tichondrius,239,warrior,fury,5,3,2
Chupelo,tichondrius,239,warrior,fury,5,3,2
Moelolita,illidan,239,warrior,fury,5,3,2
Warchine,malganis,234,warrior,fury,9,4,5
Reagzy,stormrage,234,warrior,fury,10,4,6
Schlosh,laughing-skull,223,warrior,fury,8,3,5
Çórý,area-52,192,warrior,fury,4,3,1
Shaøkahn,azralon,192,warrior,fury,9,3,6
Jägernaught,stormrage,192,warrior,fury,6,2,4
Boombop,zuljin,192,warrior,fury,6,2,4
Hughmungús,frostmourne,192,warrior,fury,6,2,4
Clerond,tichondrius,192,warrior,fury,6,2,4
Noor,tichondrius,192,warrior,fury,6,2,4
Wariorwang,tichondrius,192,warrior,fury,6,2,4
Rundai,zuljin,192,warrior,fury,6,2,4
Nordrages,stormrage,192,warrior,fury,6,2,4
Basedaf,frostmourne,192,warrior,fury,6,2,4
Itzyourmom,nazjatar,192,warrior,fury,6,2,4
Sabers,mannoroth,192,warrior,fury,6,2,4
Warbane,barthilas,192,warrior,fury,6,2,4
Therealflex,zuljin,192,warrior,fury,6,2,4
Plidan,shuhalo,192,warrior,fury,6,2,4
Xorjak,tichondrius,192,warrior,fury,6,2,4
Beatmeat,frostmourne,192,warrior,fury,6,2,4
Xårren,stormrage,192,warrior,fury,6,2,4
Gromkhor,tichondrius,192,warrior,fury,6,2,4
Shrexecute,tichondrius,192,warrior,fury,6,2,4
Kokixz,tichondrius,192,warrior,fury,6,2,4
Riftgar,hyjal,192,warrior,fury,6,2,4
Rägnarök,stormrage,192,warrior,fury,6,2,4
Starshattr,bleeding-hollow,192,warrior,fury,6,2,4
Bladetko,tichondrius,192,warrior,fury,6,2,4
Bighamm,tichondrius,192,warrior,fury,6,2,4
Bobisyourmom,tichondrius,192,warrior,fury,6,2,4
Aboveaverage,arthas,192,warrior,fury,6,2,4
Axesage,tichondrius,192,warrior,fury,6,2,4
Sveenn,area-52,192,warrior,fury,6,2,4
Ultraa,lightbringer,192,warrior,fury,6,2,4
Painstake,illidan,192,warrior,fury,6,2,4
Cellyndia,area-52,192,warrior,fury,6,2,4
Darkarus,drakkari,192,warrior,fury,6,2,4
Erikx,ragnaros,192,warrior,fury,6,2,4
Còlòssal,moknathal,192,warrior,fury,6,2,4
Halò,thrall,192,warrior,fury,6,2,4
Xauce,queldorei,192,warrior,fury,6,2,4
Tempusbane,proudmoore,192,warrior,fury,6,2,4
Horahloux,ragnaros,192,warrior,fury,6,2,4
Galadon,amanthul,192,warrior,fury,6,2,4
Good,garona,192,warrior,fury,6,2,4
Mfgodofwar,kelthuzad,192,warrior,fury,6,2,4
Krodah,quelthalas,192,warrior,fury,6,2,4
Illicitiri,sargeras,192,warrior,fury,6,2,4
Ragetide,illidan,192,warrior,fury,6,2,4
Maintarget,malganis,192,warrior,fury,6,2,4
Yükana,quelthalas,192,warrior,fury,6,2,4
Gangelx,illidan,192,warrior,fury,6,2,4
Barcëlð,frostmourne,192,warrior,fury,6,2,4
Blademaw,stormreaver,192,warrior,fury,6,2,4
Ëdwärd,moon-guard,192,warrior,fury,6,2,4
Zareos,azralon,192,warrior,fury,6,2,4
Jäëgër,moon-guard,192,warrior,fury,6,2,4
Sîn,sargeras,192,warrior,fury,6,2,4
Kachigas,sargeras,192,warrior,fury,6,2,4
Gromtalin,sargeras,192,warrior,fury,6,2,4
Twilightzza,sargeras,192,warrior,fury,6,2,4
Tankieone,aggramar,192,warrior,fury,8,2,6
Bonesheild,ursin,192,warrior,fury,11,2,9
Queterompo,ragnaros,192,warrior,fury,12,2,10
Cannan,the-underbog,192,warrior,fury,12,2,10
Doappy,darkspear,192,warrior,fury,12,2,10
Werrewolf,kul-tiras,191,warrior,fury,6,2,4
Shoteiotoshi,ragnaros,191,warrior,fury,6,2,4
Rediger,aggramar,190,warrior,fury,4,3,1
Crankyhorn,stormrage,159,warrior,fury,5,2,3
Forerunner,tichondrius,128,warrior,fury,4,2,2
Rhohan,ysera,128,warrior,fury,4,2,2
Aftershóck,daggerspine,96,warrior,fury,6,1,5
Spartacam,frostmourne,96,warrior,fury,6,1,5
Aladarith,moon-guard,96,warrior,fury,6,1,5
Genesisxp,barthilas,96,warrior,fury,6,1,5
ßallinjr,illidan,96,warrior,fury,6,1,5
Grândmâ,zuljin,96,warrior,fury,6,1,5
Tamagoshi,kiljaeden,96,warrior,fury,6,1,5
Norru,moon-guard,96,warrior,fury,6,1,5
Dokoba,bleeding-hollow,96,warrior,fury,6,1,5
Apolio,magtheridon,96,warrior,fury,6,1,5
Magarrior,shadowsong,96,warrior,fury,6,1,5
Kevinersaa,frostmourne,96,warrior,fury,6,1,5
Icon,tichondrius,96,warrior,fury,6,1,5
Warrbull,spirestone,96,warrior,fury,6,1,5
Baeowar,area-52,96,warrior,fury,6,1,5
Hìm,tichondrius,96,warrior,fury,6,1,5
Arkayla,moon-guard,96,warrior,fury,6,1,5
Srze,azralon,96,warrior,fury,6,1,5
Carnagè,area-52,96,warrior,fury,6,1,5
Xochicotzin,mugthol,96,warrior,fury,6,1,5
Orsex,ragnaros,96,warrior,fury,6,1,5
Polox,ragnaros,96,warrior,fury,6,1,5
Ustadbaba,area-52,96,warrior,fury,6,1,5
Nasrôth,korialstrasz,96,warrior,fury,6,1,5
Freanor,azralon,96,warrior,fury,6,1,5
Neotico,quelthalas,96,warrior,fury,6,1,5
Gymnopolar,barthilas,96,warrior,fury,6,1,5
Horabad,terenas,96,warrior,fury,6,1,5
Jujuassgeter,darkspear,96,warrior,fury,12,1,11
Glennyballs,dalaran,95,warrior,fury,6,1,5
Cremosö,azralon,64,warrior,fury,4,1,3
Cenanuandra,gnomeregan,16,warrior,fury,1,1,0
Thiccbiscuit,area-52,2209,warrior,arms,128,66,62
Zhanwudix,tichondrius,2162,warrior,arms,111,62,49
Killbørn,azralon,2158,warrior,arms,78,42,36
Ðêed,area-52,2133,warrior,arms,81,46,35
Río,area-52,2133,warrior,arms,106,54,52
Huzha,tichondrius,2114,warrior,arms,117,64,53
Warried,sargeras,2113,warrior,arms,66,37,29
Strife,sargeras,2112,warrior,arms,56,32,24
Todory,moon-guard,2111,warrior,arms,137,69,68
Edgarllama,sargeras,2103,warrior,arms,87,48,39
Schonkopf,moon-guard,2100,warrior,arms,90,46,44
Leans,sargeras,2048,warrior,arms,143,78,65
Exzistance,area-52,2026,warrior,arms,71,40,31
Gyracide,area-52,2022,warrior,arms,98,48,50
Icarryrats,tichondrius,1995,warrior,arms,65,32,33
Sziw,tichondrius,1981,warrior,arms,138,76,62
Vituu,sargeras,1979,warrior,arms,87,41,46
Perfs,bleeding-hollow,1969,warrior,arms,60,32,28
Turtleboy,feathermoon,1964,warrior,arms,56,34,22
ßallinjr,illidan,1964,warrior,arms,72,37,35
Massacretko,area-52,1962,warrior,arms,88,50,38
Ssamök,ragnaros,1960,warrior,arms,143,69,74
Ironbad,sargeras,1957,warrior,arms,66,35,31
Trezturbo,tichondrius,1941,warrior,arms,60,37,23
Yermalx,tichondrius,1941,warrior,arms,54,30,24
Vø,agamaggan,1940,warrior,arms,87,41,46
Hapigirl,tichondrius,1929,warrior,arms,42,30,12
Ricorecklezz,korgath,1925,warrior,arms,66,32,34
Lyrics,tichondrius,1920,warrior,arms,56,29,27
Tryhardr,sargeras,1918,warrior,arms,36,25,11
Salgadoryan,stormrage,1916,warrior,arms,65,32,33
Exespamtwo,area-52,1914,warrior,arms,84,49,35
Cosmicsteel,tichondrius,1908,warrior,arms,88,51,37
Yermalt,tichondrius,1905,warrior,arms,80,41,39
Islonely,tichondrius,1902,warrior,arms,72,34,38
Og,shattered-hand,1900,warrior,arms,41,25,16
Kimchikick,tichondrius,1899,warrior,arms,126,64,62
Executeqt,azralon,1893,warrior,arms,83,50,33
Ignid,tichondrius,1893,warrior,arms,60,26,34
Bhaldur,sargeras,1889,warrior,arms,74,43,31
Etchiasoko,gurubashi,1888,warrior,arms,42,30,12
Ælilblessedñ,azralon,1881,warrior,arms,118,60,58
Mítos,quelthalas,1880,warrior,arms,120,61,59
Masumura,kaelthas,1876,warrior,arms,44,24,20
Zindawg,frostmourne,1875,warrior,arms,112,56,56
Ikkyuo,proudmoore,1872,warrior,arms,54,27,27
Zacharyx,tichondrius,1868,warrior,arms,119,59,60
Zankets,area-52,1866,warrior,arms,84,40,44
Bacchanal,illidan,1864,warrior,arms,66,32,34
Foxxfighter,thrall,1863,warrior,arms,47,29,18
Huugg,skullcrusher,1860,warrior,arms,63,34,29
Smorc,stormrage,1860,warrior,arms,54,28,26
Destrey,emerald-dream,1859,warrior,arms,59,34,25
Pezy,frostmourne,1859,warrior,arms,108,53,55
Pooshshi,illidan,1855,warrior,arms,60,29,31
Evnine,illidan,1853,warrior,arms,39,29,10
Ksharer,tichondrius,1853,warrior,arms,65,31,34
Icon,tichondrius,1846,warrior,arms,46,35,11
Blozar,illidan,1846,warrior,arms,60,30,30
Blackpînk,tichondrius,1845,warrior,arms,54,32,22
Pdbq,tichondrius,1845,warrior,arms,48,28,20
Battousai,kiljaeden,1844,warrior,arms,54,27,27
Joshiguy,area-52,1844,warrior,arms,72,33,39
Sukonamí,draka,1842,warrior,arms,60,33,27
Krunnknator,azralon,1840,warrior,arms,41,26,15
Kigame,tichondrius,1840,warrior,arms,96,53,43
Uzza,stormrage,1838,warrior,arms,60,34,26
Ânticide,darkspear,1836,warrior,arms,70,36,34
Fleegugeegu,malganis,1834,warrior,arms,90,45,45
Brilliance,suramar,1832,warrior,arms,60,30,30
Darrowshire,moon-guard,1831,warrior,arms,41,23,18
Ruinenlust,zuljin,1828,warrior,arms,60,28,32
Undefied,moon-guard,1827,warrior,arms,39,25,14
Spìke,thrall,1827,warrior,arms,137,68,69
Samuluo,tichondrius,1827,warrior,arms,66,30,36
Blaíze,ragnaros,1826,warrior,arms,44,24,20
Grayview,sargeras,1826,warrior,arms,77,41,36
Warriorbloo,sargeras,1825,warrior,arms,72,39,33
Lebanesemvp,tichondrius,1825,warrior,arms,85,45,40
Granzelion,tichondrius,1825,warrior,arms,66,31,35
Marfas,hyjal,1824,warrior,arms,105,56,49
Ruzoc,frostmourne,1824,warrior,arms,100,43,57
Ígnatius,malganis,1823,warrior,arms,36,27,9
Coby,wildhammer,1823,warrior,arms,65,36,29
Cloudxxy,kiljaeden,1821,warrior,arms,51,27,24
Anautumnday,tichondrius,1820,warrior,arms,48,24,24
Honock,ragnaros,1820,warrior,arms,72,34,38
Berzek,area-52,1816,warrior,arms,59,23,36
Destram,kelthuzad,1815,warrior,arms,107,57,50
Zapatín,quelthalas,1814,warrior,arms,67,32,35
Mäddôx,tichondrius,1814,warrior,arms,126,60,66
Paoxiaolol,tichondrius,1813,warrior,arms,55,35,20
Ðìbs,moon-guard,1813,warrior,arms,59,31,28
Xîonorc,ragnaros,1813,warrior,arms,108,54,54
Sanquelme,ragnaros,1812,warrior,arms,57,31,26
Knuklez,tichondrius,1811,warrior,arms,64,33,31
Dangerousd,kiljaeden,1811,warrior,arms,60,30,30
Kaimedran,moon-guard,1810,warrior,arms,48,30,18
Jadeemerald,kelthuzad,1810,warrior,arms,54,31,23
Missrend,hyjal,1810,warrior,arms,78,39,39
Melifehorde,tichondrius,1809,warrior,arms,42,25,17
Møcat,illidan,1809,warrior,arms,90,52,38
Ciz,emerald-dream,1808,warrior,arms,64,34,30
Crøm,tichondrius,1807,warrior,arms,48,29,19
Kawakamigens,azralon,1806,warrior,arms,54,25,29
Sickwidit,kiljaeden,1805,warrior,arms,49,28,21
Noblewinter,sargeras,1805,warrior,arms,36,19,17
Menethíl,tichondrius,1805,warrior,arms,52,27,25
Blackpinkx,tichondrius,1804,warrior,arms,42,19,23
Chakø,tichondrius,1803,warrior,arms,66,36,30
Hìm,tichondrius,1801,warrior,arms,54,28,26
Strongbaby,tichondrius,1800,warrior,arms,42,23,19
Dogmar,staghelm,1800,warrior,arms,68,35,33
Zira,thrall,1800,warrior,arms,115,59,56
Këther,tichondrius,1800,warrior,arms,66,33,33
Cåfe,tichondrius,1798,warrior,arms,83,50,33
Sponsored,argent-dawn,1792,warrior,arms,59,26,33
Archosaurs,illidan,1791,warrior,arms,42,19,23
Meccsecute,tichondrius,1787,warrior,arms,84,44,40
Solastro,malganis,1778,warrior,arms,44,23,21
Nanchobo,tichondrius,1778,warrior,arms,66,28,38
Cushman,tichondrius,1776,warrior,arms,66,40,26
Orçaos,ragnaros,1772,warrior,arms,114,65,49
Madwolf,tichondrius,1770,warrior,arms,61,27,34
Narwhål,tichondrius,1768,warrior,arms,78,35,43
Kromgrall,tichondrius,1766,warrior,arms,101,49,52
Rólex,tichondrius,1766,warrior,arms,54,25,29
Krbigcow,tichondrius,1764,warrior,arms,96,49,47
Arivok,hyjal,1764,warrior,arms,53,24,29
Madblackcat,illidan,1762,warrior,arms,34,22,12
Wulouzhan,tichondrius,1759,warrior,arms,65,39,26
Dawxw,thrall,1759,warrior,arms,41,24,17
Recksus,tichondrius,1755,warrior,arms,36,27,9
Stáclin,ragnaros,1754,warrior,arms,208,125,83
Anti,nerzhul,1754,warrior,arms,51,27,24
Matesan,jubeithos,1753,warrior,arms,42,25,17
Wartrue,tichondrius,1753,warrior,arms,84,40,44
Hoodrch,azralon,1747,warrior,arms,59,31,28
Tankypandazd,stormrage,1746,warrior,arms,144,64,80
Ollena,wyrmrest-accord,1743,warrior,arms,66,32,34
Støne,draktharon,1742,warrior,arms,47,27,20
Ürürææae,sargeras,1740,warrior,arms,144,69,75
Twshizgd,proudmoore,1737,warrior,arms,72,37,35
Goodlikeplay,ragnaros,1735,warrior,arms,42,22,20
Comehnrfce,illidan,1733,warrior,arms,62,26,36
Kylewalker,tichondrius,1733,warrior,arms,65,26,39
Barrbarossa,stormrage,1732,warrior,arms,68,31,37
Dawx,thrall,1731,warrior,arms,47,24,23
Rocta,tichondrius,1726,warrior,arms,62,36,26
Brøly,sargeras,1726,warrior,arms,72,34,38
Isnlonely,tichondrius,1725,warrior,arms,30,18,12
Aggnilia,proudmoore,1723,warrior,arms,60,26,34
Wolfsbanne,khadgar,1722,warrior,arms,90,53,37
Swordborne,moon-guard,1722,warrior,arms,94,43,51
Itsfall,tichondrius,1721,warrior,arms,42,21,21
Noodlezz,moon-guard,1719,warrior,arms,53,23,30
Icanfixher,moon-guard,1718,warrior,arms,201,93,108
Azaks,drakkari,1717,warrior,arms,30,18,12
Kraftyx,bleeding-hollow,1714,warrior,arms,30,21,9
Asstastic,bonechewer,1714,warrior,arms,119,53,66
Bigladmike,sargeras,1714,warrior,arms,48,21,27
Chimbrila,azralon,1714,warrior,arms,66,27,39
Basedaf,frostmourne,1713,warrior,arms,78,42,36
Bakadoom,illidan,1712,warrior,arms,36,21,15
Jonathann,suramar,1711,warrior,arms,84,37,47
Rebied,ragnaros,1711,warrior,arms,54,22,32
Lindsanv,illidan,1710,warrior,arms,74,44,30
Draus,nemesis,1710,warrior,arms,65,35,30
Wartruë,tichondrius,1709,warrior,arms,97,55,42
Boomergodx,stormrage,1708,warrior,arms,78,43,35
Smashies,kelthuzad,1708,warrior,arms,47,24,23
Rageroidz,area-52,1706,warrior,arms,30,18,12
Pachacutecxx,ragnaros,1706,warrior,arms,45,25,20
Tùngrâu,frostmourne,1702,warrior,arms,112,57,55
Yonkerss,garrosh,1699,warrior,arms,71,37,34
Dramalas,lightbringer,1699,warrior,arms,119,61,58
Randydanger,illidan,1698,warrior,arms,54,24,30
Glocç,sargeras,1696,warrior,arms,46,25,21
Trackstarz,llane,1695,warrior,arms,66,41,25
Colössal,moon-guard,1690,warrior,arms,82,43,39
Zaràki,area-52,1688,warrior,arms,162,86,76
Elpappa,tichondrius,1686,warrior,arms,36,31,5
Vascoes,alleria,1686,warrior,arms,93,50,43
Beanbags,zangarmarsh,1686,warrior,arms,48,24,24
Meowdaa,proudmoore,1686,warrior,arms,72,24,48
Bebob,tichondrius,1684,warrior,arms,62,33,29
Bmo,chogall,1684,warrior,arms,87,44,43
Frëdsmite,kelthuzad,1684,warrior,arms,81,39,42
Raveve,area-52,1683,warrior,arms,41,23,18
Nazraill,aggramar,1683,warrior,arms,75,42,33
Darkduet,tichondrius,1683,warrior,arms,46,20,26
Szw,tichondrius,1682,warrior,arms,41,29,12
Adaana,kargath,1681,warrior,arms,42,26,16
Bugsberserk,tichondrius,1680,warrior,arms,95,52,43
Gtr,illidan,1679,warrior,arms,48,31,17
Nozmok,proudmoore,1678,warrior,arms,42,21,21
Kazecap,proudmoore,1678,warrior,arms,48,22,26
Crowsfall,aggramar,1677,warrior,arms,124,64,60
Partyx,tichondrius,1677,warrior,arms,122,62,60
Foraken,dragonmaw,1671,warrior,arms,36,22,14
Qingmei,illidan,1670,warrior,arms,60,26,34
Razw,frostmourne,1666,warrior,arms,30,19,11
Xiaoheihei,tichondrius,1666,warrior,arms,41,20,21
Smokes,sargeras,1665,warrior,arms,66,29,37
Jottman,tichondrius,1665,warrior,arms,66,29,37
Legoyoda,zuljin,1663,warrior,arms,54,29,25
Athalen,nemesis,1663,warrior,arms,53,25,28
Ystkk,tichondrius,1662,warrior,arms,42,25,17
Khørnë,ragnaros,1661,warrior,arms,54,30,24
Genghiz,azralon,1660,warrior,arms,30,20,10
Twilightrain,tichondrius,1660,warrior,arms,165,92,73
Delakos,frostmourne,1658,warrior,arms,60,35,25
Illing,tichondrius,1657,warrior,arms,106,57,49
Orclog,illidan,1653,warrior,arms,30,18,12
Thrator,wyrmrest-accord,1653,warrior,arms,36,21,15
Elchacál,ragnaros,1651,warrior,arms,42,20,22
Sonjeba,malganis,1650,warrior,arms,47,21,26
Kames,garrosh,1650,warrior,arms,54,24,30
Slaught,kelthuzad,1647,warrior,arms,53,25,28
Axazel,drakkari,1646,warrior,arms,38,21,17
Hjogg,moon-guard,1644,warrior,arms,42,22,20
Rainingblooð,blackrock,1644,warrior,arms,97,50,47
Fluffyarm,sargeras,1642,warrior,arms,102,51,51
Ragefused,illidan,1642,warrior,arms,78,36,42
Amlahj,stormrage,1640,warrior,arms,47,26,21
Fulaixiong,illidan,1639,warrior,arms,51,34,17
Hickorie,sargeras,1637,warrior,arms,48,25,23
Ngu,eldrethalas,1636,warrior,arms,53,26,27
Krakatóa,kelthuzad,1633,warrior,arms,30,19,11
Hanadaddy,frostmourne,1629,warrior,arms,48,26,22
Bøek,area-52,1629,warrior,arms,60,25,35
Tiredkev,tichondrius,1628,warrior,arms,36,20,16
Zeroskill,cenarius,1626,warrior,arms,60,28,32
Gutting,moon-guard,1625,warrior,arms,36,18,18
Crushedlol,bleeding-hollow,1624,warrior,arms,30,17,13
Jgillz,sargeras,1624,warrior,arms,30,17,13
Betterthanu,azralon,1624,warrior,arms,42,18,24
Franziskaner,frostmourne,1624,warrior,arms,60,24,36
Testflight,tichondrius,1623,warrior,arms,54,30,24
Bwandøn,moon-guard,1623,warrior,arms,76,38,38
Bromro,tichondrius,1623,warrior,arms,54,24,30
Kilgorath,area-52,1622,warrior,arms,48,19,29
Mynameyaff,tichondrius,1621,warrior,arms,75,44,31
Mistrpower,bleeding-hollow,1617,warrior,arms,72,42,30
Seblleddo,drakkari,1617,warrior,arms,30,17,13
Achilex,sargeras,1617,warrior,arms,127,66,61
Timbermack,moon-guard,1615,warrior,arms,78,43,35
Ichirisw,tichondrius,1615,warrior,arms,47,23,24
Peinx,ragnaros,1614,warrior,arms,30,17,13
Willcharge,tichondrius,1614,warrior,arms,49,17,32
Xwarz,drakkari,1610,warrior,arms,36,17,19
Thebigsmash,tichondrius,1609,warrior,arms,42,23,19
Swagramarr,area-52,1609,warrior,arms,57,31,26
Aumni,illidan,1609,warrior,arms,71,33,38
Furydudz,tichondrius,1607,warrior,arms,42,21,21
Brainhaze,tichondrius,1606,warrior,arms,48,21,27
Mitigated,bleeding-hollow,1605,warrior,arms,42,22,20
Myxz,barthilas,1605,warrior,arms,120,59,61
Ethuil,azshara,1605,warrior,arms,53,23,30
Ðrex,nagrand,1603,warrior,arms,36,22,14
Bleedx,bleeding-hollow,1603,warrior,arms,51,30,21
Sosimi,tichondrius,1602,warrior,arms,48,28,20
Yabahdabah,stormrage,1599,warrior,arms,69,38,31
Stick,tichondrius,1599,warrior,arms,59,32,27
Groundpound,sargeras,1598,warrior,arms,36,19,17
Lostsummer,frostmourne,1598,warrior,arms,46,24,22
Patwong,frostmourne,1597,warrior,arms,66,36,30
Lôwkeyfix,illidan,1597,warrior,arms,42,20,22
Wutains,tichondrius,1589,warrior,arms,36,19,17
Cutgirl,quelthalas,1589,warrior,arms,44,19,25
Arx,frostwolf,1588,warrior,arms,71,38,33
Beaerboy,darkspear,1586,warrior,arms,60,29,31
Arkkaine,sargeras,1586,warrior,arms,48,23,25
Themudcrab,frostmourne,1586,warrior,arms,51,22,29
Sheetss,tichondrius,1585,warrior,arms,48,23,25
Hônor,ragnaros,1585,warrior,arms,36,17,19
Dukà,hyjal,1582,warrior,arms,42,24,18
Traumaj,bleeding-hollow,1581,warrior,arms,79,45,34
Hydrolisk,area-52,1581,warrior,arms,108,54,54
Dokgö,tichondrius,1581,warrior,arms,48,20,28
Brayitann,illidan,1579,warrior,arms,25,19,6
Garrmash,hyjal,1577,warrior,arms,80,39,41
Därkzh,stormrage,1576,warrior,arms,30,20,10
Titanzz,quelthalas,1573,warrior,arms,36,20,16
Blodreìna,hyjal,1572,warrior,arms,42,20,22
Yarock,malganis,1571,warrior,arms,84,38,46
Pepétí,azralon,1571,warrior,arms,71,32,39
Matrias,tichondrius,1570,warrior,arms,60,36,24
Jrod,boulderfist,1570,warrior,arms,150,78,72
Roidraging,thunderlord,1570,warrior,arms,80,35,45
Rongor,drakkari,1569,warrior,arms,36,18,18
Sulze,tichondrius,1569,warrior,arms,87,37,50
Cniggs,korgath,1567,warrior,arms,55,35,20
Jdubzr,frostmourne,1566,warrior,arms,42,18,24
Meatbone,emerald-dream,1565,warrior,arms,72,41,31
Pigzig,nagrand,1564,warrior,arms,36,18,18
Malerick,illidan,1564,warrior,arms,45,19,26
Chogar,proudmoore,1562,warrior,arms,64,34,30
Naejwar,ragnaros,1558,warrior,arms,78,43,35
Skronkar,illidan,1557,warrior,arms,54,27,27
Ashbringera,proudmoore,1556,warrior,arms,78,40,38
Dann,ragnaros,1555,warrior,arms,72,35,37
Sakutarou,lightbringer,1551,warrior,arms,106,47,59
Ghóstx,alleria,1550,warrior,arms,53,37,16
Línfert,stormrage,1550,warrior,arms,35,20,15
Trágus,azralon,1548,warrior,arms,41,24,17
Juuz,frostmourne,1548,warrior,arms,90,43,47
Ramzeé,kelthuzad,1547,warrior,arms,55,33,22
Smokedaperc,illidan,1547,warrior,arms,59,34,25
Garadiels,tichondrius,1547,warrior,arms,55,24,31
Homebody,uldaman,1546,warrior,arms,26,18,8
Fyruz,sargeras,1545,warrior,arms,62,35,27
Ewenki,tichondrius,1544,warrior,arms,58,32,26
Zyppz,sargeras,1543,warrior,arms,38,26,12
Know,anetheron,1542,warrior,arms,98,45,53
Ryängosling,azralon,1540,warrior,arms,120,65,55
Lsays,tichondrius,1540,warrior,arms,56,29,27
Slitt,azralon,1539,warrior,arms,30,18,12
Toughguts,saurfang,1539,warrior,arms,38,21,17
Orgnosh,tichondrius,1537,warrior,arms,66,34,32
Tríxman,moon-guard,1536,warrior,arms,83,50,33
Hookahboss,area-52,1534,warrior,arms,28,17,11
Ashantia,stormrage,1532,warrior,arms,55,29,26
Yunnkel,ragnaros,1532,warrior,arms,58,30,28
Dpoy,tichondrius,1532,warrior,arms,36,16,20
Pipedoctor,kelthuzad,1531,warrior,arms,24,16,8
Rokgral,tichondrius,1531,warrior,arms,56,29,27
Bigbait,hyjal,1529,warrior,arms,36,16,20
Lehzera,frostmourne,1526,warrior,arms,44,20,24
Sineatér,frostmourne,1526,warrior,arms,41,18,23
Sinsinatra,azralon,1524,warrior,arms,127,62,65
Magicalol,tichondrius,1523,warrior,arms,30,16,14
Stinkyw,tichondrius,1522,warrior,arms,37,21,16
Ottø,area-52,1522,warrior,arms,54,28,26
Monstersynde,nemesis,1522,warrior,arms,60,30,30
Orahard,illidan,1522,warrior,arms,82,37,45
Gryffith,bleeding-hollow,1522,warrior,arms,42,16,26
Rads,stormscale,1520,warrior,arms,50,30,20
Randysnapper,zuljin,1519,warrior,arms,24,16,8
Fraannky,windrunner,1519,warrior,arms,42,24,18
Utgarde,stormrage,1519,warrior,arms,146,77,69
Ichigö,gundrak,1519,warrior,arms,51,25,26
Tuvia,malganis,1514,warrior,arms,137,69,68
Wingedknight,malganis,1514,warrior,arms,84,39,45
Ÿüñí,tichondrius,1514,warrior,arms,36,16,20
Firesx,tichondrius,1512,warrior,arms,30,17,13
Bìgpoppapump,tichondrius,1511,warrior,arms,36,17,19
Spartacam,frostmourne,1509,warrior,arms,66,33,33
Michaelrossx,bloodhoof,1509,warrior,arms,126,61,65
Lyliumn,frostmourne,1508,warrior,arms,42,19,23
Tcchmm,akama,1508,warrior,arms,47,21,26
Machete,nemesis,1507,warrior,arms,76,40,36
Rukittenme,area-52,1507,warrior,arms,36,16,20
Bbyè,tichondrius,1502,warrior,arms,44,19,25
Duroxzee,area-52,1500,warrior,arms,132,74,58
Tatsuu,tichondrius,1500,warrior,arms,129,59,70
Executie,duskwood,1499,warrior,arms,67,34,33
Rampage,azralon,1498,warrior,arms,89,46,43
Zalakan,malganis,1497,warrior,arms,24,16,8
Slamix,area-52,1497,warrior,arms,24,16,8
Thurman,spirestone,1497,warrior,arms,36,23,13
Lòrdnasher,tichondrius,1496,warrior,arms,42,24,18
Spartiguss,emerald-dream,1496,warrior,arms,29,16,13
Gorenay,nemesis,1496,warrior,arms,30,16,14
Hotdadparty,frostmourne,1496,warrior,arms,54,25,29
Flintish,moon-guard,1495,warrior,arms,42,27,15
Damiansuv,moon-guard,1494,warrior,arms,135,65,70
Stickybladez,frostmourne,1491,warrior,arms,60,29,31
Destructör,nagrand,1491,warrior,arms,45,21,24
Tenchuu,azralon,1491,warrior,arms,47,21,26
Dotlom,wyrmrest-accord,1490,warrior,arms,54,23,31
Warriordanim,tichondrius,1489,warrior,arms,100,41,59
Ôxluck,ragnaros,1489,warrior,arms,74,27,47
Taywar,sargeras,1488,warrior,arms,42,20,22
Ihadnochoice,barthilas,1486,warrior,arms,112,54,58
Muskratz,tichondrius,1485,warrior,arms,30,16,14
Karnakk,thrall,1485,warrior,arms,41,16,25
Ogeezus,crushridge,1484,warrior,arms,36,17,19
Shiv,illidan,1484,warrior,arms,48,22,26
Dorianfrost,ravenholdt,1483,warrior,arms,54,20,34
Tern,emerald-dream,1481,warrior,arms,58,33,25
Xenogears,boulderfist,1480,warrior,arms,84,46,38
Arot,bloodhoof,1479,warrior,arms,75,34,41
Velarrine,illidan,1479,warrior,arms,62,27,35
Rainzy,stormrage,1476,warrior,arms,36,16,20
Muertededios,quelthalas,1475,warrior,arms,111,57,54
Weedow,proudmoore,1474,warrior,arms,29,16,13
Johnnysmizle,kelthuzad,1473,warrior,arms,35,16,19
Frashes,darkspear,1472,warrior,arms,42,20,22
Zänn,dalaran,1471,warrior,arms,54,35,19
Wouili,zuljin,1470,warrior,arms,64,42,22
Arctures,stormrage,1470,warrior,arms,54,33,21
Ghostss,tichondrius,1470,warrior,arms,49,23,26
Kowboy,stormrage,1469,warrior,arms,66,32,34
Aaryn,caelestrasz,1468,warrior,arms,74,43,31
Rittylord,frostmourne,1468,warrior,arms,36,17,19
Banhaezzi,tichondrius,1468,warrior,arms,90,42,48
Ðarkstar,zuljin,1465,warrior,arms,117,54,63
Eggroll,emerald-dream,1465,warrior,arms,47,17,30
Gwendolynl,hyjal,1464,warrior,arms,55,29,26
Sertss,proudmoore,1462,warrior,arms,71,30,41
Bùlk,barthilas,1460,warrior,arms,35,17,18
Warlow,korgath,1458,warrior,arms,58,26,32
Mommysharky,illidan,1457,warrior,arms,36,26,10
Naxxiki,wyrmrest-accord,1457,warrior,arms,24,17,7
Zeerohkool,malganis,1457,warrior,arms,68,31,37
Lunartime,sargeras,1457,warrior,arms,36,16,20
Jotto,zuljin,1455,warrior,arms,36,18,18
Xaka,tichondrius,1455,warrior,arms,42,19,23
Zhânshen,tichondrius,1454,warrior,arms,42,21,21
Mailløche,bleeding-hollow,1452,warrior,arms,60,32,28
Biznizwar,sargeras,1450,warrior,arms,118,58,60
Shortgoofy,sargeras,1446,warrior,arms,80,35,45
Kirown,quelthalas,1446,warrior,arms,38,16,22
Shawnemd,proudmoore,1445,warrior,arms,54,29,25
Fuknazum,gundrak,1440,warrior,arms,72,36,36
Allgas,barthilas,1439,warrior,arms,48,30,18
Crownzz,tichondrius,1439,warrior,arms,30,15,15
Karrok,zuluhed,1439,warrior,arms,96,41,55
Hoboedd,area-52,1438,warrior,arms,28,16,12
Ariést,bleeding-hollow,1435,warrior,arms,30,15,15
Grumtak,azralon,1434,warrior,arms,29,16,13
Xenowar,alleria,1434,warrior,arms,66,29,37
Heater,stormrage,1433,warrior,arms,24,15,9
Doublezuglol,tichondrius,1433,warrior,arms,24,15,9
Bigglyjoobs,tichondrius,1432,warrior,arms,30,15,15
Badguys,illidan,1431,warrior,arms,36,15,21
Maktarax,zuljin,1428,warrior,arms,34,15,19
Shiiftybuga,frostmourne,1427,warrior,arms,50,27,23
Machineofwar,zuluhed,1427,warrior,arms,96,46,50
Dji,tichondrius,1425,warrior,arms,137,67,70
Aloregorey,malganis,1425,warrior,arms,72,29,43
Rèckit,thrall,1424,warrior,arms,30,15,15
Tergll,illidan,1423,warrior,arms,51,23,28
Saîyanroyce,barthilas,1422,warrior,arms,101,49,52
Deamonkiller,kelthuzad,1421,warrior,arms,49,24,25
Mahkrash,quelthalas,1420,warrior,arms,41,19,22
Amaragos,tichondrius,1419,warrior,arms,24,17,7
Noyel,tichondrius,1419,warrior,arms,30,15,15
Indominate,tichondrius,1419,warrior,arms,44,16,28
Alator,gorgonnash,1416,warrior,arms,24,15,9
Iigotu,tichondrius,1416,warrior,arms,78,35,43
Kilrosao,nordrassil,1415,warrior,arms,47,26,21
Armamortal,kelthuzad,1415,warrior,arms,70,34,36
Ártorius,sargeras,1415,warrior,arms,36,17,19
Ukris,area-52,1414,warrior,arms,83,45,38
Kahuwuna,tichondrius,1414,warrior,arms,30,15,15
Korboc,malganis,1413,warrior,arms,48,23,25
Saleem,tichondrius,1413,warrior,arms,67,32,35
Xunxie,tichondrius,1410,warrior,arms,35,16,19
Cjz,tichondrius,1409,warrior,arms,36,22,14
Eîghtysîx,sargeras,1408,warrior,arms,58,23,35
Unstàble,frostmourne,1405,warrior,arms,36,16,20
Itskel,stormreaver,1404,warrior,arms,36,16,20
Aloloco,ragnaros,1403,warrior,arms,66,30,36
Torimzor,nemesis,1402,warrior,arms,78,42,36
Powerhard,area-52,1402,warrior,arms,30,16,14
Armsprotfury,tichondrius,1401,warrior,arms,24,16,8
Naughtytwat,tichondrius,1400,warrior,arms,141,66,75
Graelus,terenas,1399,warrior,arms,31,17,14
Nabiouscx,malganis,1399,warrior,arms,48,18,30
Doomreaper,hellscream,1398,warrior,arms,35,18,17
Kadira,stormrage,1397,warrior,arms,78,30,48
Aldérmach,zuljin,1395,warrior,arms,52,26,26
Mjorn,sargeras,1392,warrior,arms,58,28,30
Fatnfurious,dunemaul,1392,warrior,arms,44,21,23
Chanchoswar,ragnaros,1392,warrior,arms,57,23,34
Nicegirl,sargeras,1391,warrior,arms,69,36,33
Áres,malganis,1390,warrior,arms,72,40,32
Apallô,tichondrius,1390,warrior,arms,53,22,31
Azog,bleeding-hollow,1389,warrior,arms,42,24,18
Khargrok,ragnaros,1389,warrior,arms,30,15,15
Kakamallo,black-dragonflight,1388,warrior,arms,100,50,50
Ralphy,lightnings-blade,1388,warrior,arms,48,24,24
Radamäntthys,nemesis,1388,warrior,arms,42,15,27
Braxin,dalaran,1387,warrior,arms,30,16,14
Jeffe,khadgar,1385,warrior,arms,50,19,31
Luosifen,tichondrius,1384,warrior,arms,59,26,33
Nviv,proudmoore,1382,warrior,arms,60,26,34
Supremegalek,tichondrius,1381,warrior,arms,39,21,18
Warsaínt,area-52,1381,warrior,arms,42,20,22
Verain,thrall,1381,warrior,arms,36,17,19
Unkultom,stormrage,1378,warrior,arms,33,17,16
Luckyw,draktharon,1375,warrior,arms,42,23,19
Qtcrow,frostmourne,1372,warrior,arms,42,23,19
Irix,tichondrius,1372,warrior,arms,62,32,30
Nagaboner,frostmourne,1371,warrior,arms,47,25,22
Kissmyaxê,tichondrius,1367,warrior,arms,33,15,18
Asc,barthilas,1365,warrior,arms,87,47,40
Wapistun,thrall,1365,warrior,arms,30,15,15
Sevala,spinebreaker,1363,warrior,arms,46,26,20
Slickpapi,area-52,1362,warrior,arms,75,33,42
Saltyundies,tichondrius,1361,warrior,arms,81,34,47
Mervyn,aegwynn,1360,warrior,arms,48,29,19
Korsarro,frostmourne,1357,warrior,arms,68,32,36
Ëssex,tichondrius,1356,warrior,arms,48,19,29
Pvpheart,tichondrius,1355,warrior,arms,41,26,15
Chawp,emerald-dream,1355,warrior,arms,41,23,18
Aesom,wyrmrest-accord,1355,warrior,arms,97,52,45
Vanglorio,azralon,1354,warrior,arms,54,29,25
Wellowarr,moon-guard,1352,warrior,arms,72,31,41
Neozsmash,thrall,1349,warrior,arms,30,16,14
Ludicrous,dreadmaul,1348,warrior,arms,67,29,38
Thegoochgoon,malorne,1347,warrior,arms,57,31,26
Avoraçado,nemesis,1347,warrior,arms,42,16,26
Rasgriz,moon-guard,1346,warrior,arms,43,20,23
Zroz,ragnaros,1345,warrior,arms,30,17,13
Xufoxpikmin,gurubashi,1345,warrior,arms,64,26,38
ßaldbornë,stormrage,1344,warrior,arms,94,47,47
Excaliburz,frostmourne,1344,warrior,arms,59,29,30
Sludgthwaps,stormrage,1344,warrior,arms,36,17,19
Ddaÿ,tichondrius,1342,warrior,arms,36,14,22
Bahlahkay,proudmoore,1341,warrior,arms,30,14,16
Kalpok,tichondrius,1340,warrior,arms,28,15,13
Sunamys,illidan,1340,warrior,arms,36,14,22
Bozzy,illidan,1339,warrior,arms,30,14,16
Jimjinjin,tichondrius,1338,warrior,arms,24,14,10
Kelidar,kaelthas,1338,warrior,arms,42,22,20
Tzumugi,ragnaros,1338,warrior,arms,126,57,69
Putong,tichondrius,1337,warrior,arms,29,19,10
Lowlow,lightbringer,1337,warrior,arms,30,15,15
Kourny,frostmourne,1337,warrior,arms,60,29,31
Thorado,nemesis,1337,warrior,arms,45,19,26
Dewbae,whisperwind,1336,warrior,arms,24,14,10
Jalaskâ,azralon,1336,warrior,arms,30,16,14
Fartazz,zuljin,1336,warrior,arms,30,14,16
Viagraliker,tichondrius,1336,warrior,arms,44,19,25
Ybo,illidan,1333,warrior,arms,63,39,24
Morhgath,bonechewer,1333,warrior,arms,30,15,15
Morioso,boulderfist,1331,warrior,arms,36,14,22
Zenrrei,ragnaros,1330,warrior,arms,24,14,10
Papaming,tichondrius,1330,warrior,arms,48,21,27
Volstraya,frostmourne,1328,warrior,arms,30,14,16
Flexeçute,moon-guard,1326,warrior,arms,30,14,16
Nerdstompêr,illidan,1326,warrior,arms,36,14,22
Aoste,tichondrius,1324,warrior,arms,31,16,15
Rokó,illidan,1324,warrior,arms,42,16,26
Waraze,tichondrius,1320,warrior,arms,30,14,16
Rekem,malganis,1320,warrior,arms,60,27,33
Ønì,tichondrius,1319,warrior,arms,42,33,9
Niudazhuang,tichondrius,1318,warrior,arms,70,39,31
Bagur,ragnaros,1317,warrior,arms,29,16,13
Chargeback,zuljin,1317,warrior,arms,52,28,24
Orcaine,ursin,1315,warrior,arms,41,27,14
Hôdû,tichondrius,1314,warrior,arms,63,31,32
Overswing,tichondrius,1314,warrior,arms,42,14,28
Coolade,thunderhorn,1312,warrior,arms,46,18,28
Thelgrath,quelthalas,1311,warrior,arms,42,20,22
Loothar,goldrinn,1305,warrior,arms,42,20,22
Aleniá,tichondrius,1304,warrior,arms,62,31,31
Killtarget,tichondrius,1303,warrior,arms,61,32,29
Legolant,uther,1301,warrior,arms,30,14,16
Retros,kelthuzad,1299,warrior,arms,60,28,32
Deadee,aerie-peak,1297,warrior,arms,64,30,34
Spritez,malganis,1296,warrior,arms,55,21,34
Forakenna,dragonmaw,1295,warrior,arms,17,14,3
Bajheera,sargeras,1295,warrior,arms,23,14,9
Beeny,tichondrius,1295,warrior,arms,33,14,19
Kiddoe,rivendare,1294,warrior,arms,54,27,27
Rockystyle,proudmoore,1293,warrior,arms,42,24,18
Dubstoob,illidan,1293,warrior,arms,49,24,25
Gromkhor,tichondrius,1292,warrior,arms,29,14,15
Solano,illidan,1290,warrior,arms,24,15,9
Grumok,tichondrius,1289,warrior,arms,57,24,33
Kannzox,quelthalas,1288,warrior,arms,49,21,28
Raekor,tichondrius,1286,warrior,arms,24,15,9
Aràthor,stormrage,1284,warrior,arms,48,22,26
Momojojo,daggerspine,1280,warrior,arms,20,15,5
Zeerohkool,tichondrius,1279,warrior,arms,60,21,39
Knghtofseven,nemesis,1278,warrior,arms,60,32,28
Shadowstingg,tichondrius,1277,warrior,arms,34,14,20
Tkazo,tichondrius,1275,warrior,arms,23,14,9
Groxxigore,chogall,1274,warrior,arms,30,18,12
Calynn,frostmourne,1273,warrior,arms,84,42,42
Darkfang,icecrown,1268,warrior,arms,30,14,16
Swamis,stormreaver,1265,warrior,arms,30,15,15
Krimmjðw,sargeras,1263,warrior,arms,36,14,22
Sherway,quelthalas,1262,warrior,arms,95,50,45
Laynarri,hyjal,1262,warrior,arms,48,22,26
Queterompo,ragnaros,1255,warrior,arms,60,33,27
Brontok,darkspear,1255,warrior,arms,29,15,14
Barricade,velen,1250,warrior,arms,77,35,42
Brynjah,azralon,1249,warrior,arms,72,31,41
Coldlòve,akama,1248,warrior,arms,18,13,5
Lagzistance,area-52,1248,warrior,arms,24,13,11
Areaves,moon-guard,1247,warrior,arms,24,13,11
Vatix,sargeras,1247,warrior,arms,24,13,11
Invalidoath,tichondrius,1247,warrior,arms,24,13,11
Kruma,stormscale,1247,warrior,arms,25,13,12
Dhaemom,azralon,1247,warrior,arms,60,30,30
Soloqandy,moon-guard,1247,warrior,arms,30,13,17
Scotteh,eredar,1247,warrior,arms,30,13,17
Míasma,ragnaros,1247,warrior,arms,36,13,23
Chaytin,bleeding-hollow,1246,warrior,arms,20,13,7
Hbrandy,tichondrius,1246,warrior,arms,24,13,11
Damage,malganis,1246,warrior,arms,30,13,17
Blaiize,ragnaros,1245,warrior,arms,36,13,23
Qookymonster,zuljin,1244,warrior,arms,36,18,18
Blíding,ragnaros,1243,warrior,arms,39,14,25
Ystk,tichondrius,1242,warrior,arms,24,13,11
Methwitch,moon-guard,1240,warrior,arms,24,13,11
Danield,illidan,1240,warrior,arms,36,13,23
Amputate,akama,1240,warrior,arms,36,13,23
Balroge,illidan,1239,warrior,arms,24,13,11
Mitigation,hyjal,1239,warrior,arms,34,15,19
Thorablade,barthilas,1239,warrior,arms,72,31,41
Noitrak,azralon,1239,warrior,arms,33,14,19
Ãleister,stormrage,1238,warrior,arms,39,17,22
Morfoggore,ragnaros,1238,warrior,arms,30,13,17
Theokos,dalaran,1238,warrior,arms,30,13,17
Nikon,bleeding-hollow,1237,warrior,arms,30,13,17
Creøn,silvermoon,1236,warrior,arms,30,13,17
Mickyplate,tichondrius,1235,warrior,arms,54,25,29
Ragetodef,illidan,1235,warrior,arms,30,13,17
Hoodlord,tichondrius,1234,warrior,arms,54,24,30
Standsonkegs,illidan,1233,warrior,arms,30,13,17
Crú,stormrage,1232,warrior,arms,24,13,11
Dimus,area-52,1232,warrior,arms,30,13,17
Dcashmoney,moon-guard,1232,warrior,arms,36,13,23
Ôn,tichondrius,1231,warrior,arms,42,13,29
Gorash,gundrak,1230,warrior,arms,69,33,36
Brocky,malorne,1230,warrior,arms,199,84,115
Valder,akama,1226,warrior,arms,24,13,11
Rárict,moon-guard,1226,warrior,arms,28,14,14
Gritrog,thrall,1225,warrior,arms,32,23,9
Tunchi,runetotem,1224,warrior,arms,90,47,43
Tommytimbo,destromath,1224,warrior,arms,31,13,18
Juff,hakkar,1223,warrior,arms,24,13,11
Armorlancer,stormrage,1223,warrior,arms,24,13,11
Coisini,tichondrius,1223,warrior,arms,32,14,18
Kenshín,ragnaros,1222,warrior,arms,41,14,27
Diamict,wyrmrest-accord,1221,warrior,arms,18,13,5
Helandas,moknathal,1221,warrior,arms,61,33,28
Hadesz,nazjatar,1220,warrior,arms,54,27,27
Rekcd,sargeras,1217,warrior,arms,18,13,5
Bigsvit,trollbane,1217,warrior,arms,36,20,16
Tenebrous,nemesis,1217,warrior,arms,36,13,23
Dippindabz,area-52,1213,warrior,arms,47,26,21
Pandaniela,area-52,1212,warrior,arms,24,15,9
Thebruce,nemesis,1211,warrior,arms,48,24,24
Deomer,quelthalas,1211,warrior,arms,30,14,16
Baadomishram,ragnaros,1208,warrior,arms,30,14,16
Wankcelot,kiljaeden,1203,warrior,arms,36,15,21
Aclipse,nagrand,1197,warrior,arms,65,34,31
Nosetackle,area-52,1197,warrior,arms,52,26,26
Kustybuckets,korgath,1192,warrior,arms,28,14,14
Yuccaleaptus,area-52,1191,warrior,arms,59,27,32
Bazironbeard,ravencrest,1190,warrior,arms,17,13,4
Cowbøycrytoo,azralon,1189,warrior,arms,56,30,26
Demðnslayer,kelthuzad,1189,warrior,arms,48,23,25
Xyazhiro,ragnaros,1185,warrior,arms,42,19,23
Vemue,tichondrius,1184,warrior,arms,90,39,51
Lícketysplít,ysondre,1182,warrior,arms,22,13,9
Theregulator,area-52,1182,warrior,arms,36,20,16
Varekai,frostmourne,1181,warrior,arms,26,14,12
Shingeki,wyrmrest-accord,1179,warrior,arms,108,51,57
Archonian,stormscale,1177,warrior,arms,28,18,10
Orsex,ragnaros,1176,warrior,arms,26,13,13
Zarrock,emerald-dream,1174,warrior,arms,26,14,12
Süspicious,malfurion,1174,warrior,arms,35,14,21
Arthwarf,proudmoore,1174,warrior,arms,35,14,21
Rauh,emerald-dream,1171,warrior,arms,22,13,9
Mortilant,perenolde,1167,warrior,arms,63,28,35
Hoobaz,area-52,1166,warrior,arms,22,13,9
Medusaann,proudmoore,1166,warrior,arms,33,15,18
Soltrain,stormrage,1165,warrior,arms,32,14,18
Annaliyah,wyrmrest-accord,1162,warrior,arms,48,26,22
Youtank,kiljaeden,1159,warrior,arms,60,29,31
Bùbbájr,emerald-dream,1152,warrior,arms,18,12,6
Bighamm,tichondrius,1151,warrior,arms,18,12,6
Gravewurm,twisting-nether,1151,warrior,arms,18,12,6
Yossarrion,frostwolf,1151,warrior,arms,24,12,12
Cammerz,area-52,1151,warrior,arms,30,12,18
Hàru,illidan,1150,warrior,arms,18,12,6
Einnarr,tichondrius,1150,warrior,arms,19,12,7
Picarus,thunderhorn,1150,warrior,arms,24,12,12
Malakaimapk,korgath,1150,warrior,arms,24,12,12
Slamuëladams,bleeding-hollow,1150,warrior,arms,30,12,18
Gordofofo,azralon,1149,warrior,arms,18,12,6
Chinamonk,tichondrius,1149,warrior,arms,24,12,12
Pelonna,drakkari,1148,warrior,arms,24,12,12
Woth,deathwing,1148,warrior,arms,24,12,12
Dragvovar,thrall,1148,warrior,arms,30,12,18
Suicider,stormrage,1148,warrior,arms,30,12,18
Isildur,nerzhul,1147,warrior,arms,24,15,9
Misclickëd,dalaran,1147,warrior,arms,24,12,12
Vodkagoblin,sargeras,1147,warrior,arms,24,12,12
Oppressor,darkspear,1145,warrior,arms,24,12,12
Scrümp,illidan,1145,warrior,arms,25,12,13
Kénjar,tichondrius,1144,warrior,arms,18,12,6
Skittlesxo,bleeding-hollow,1144,warrior,arms,24,12,12
Dúmßlòwn,tichondrius,1144,warrior,arms,78,27,51
Invared,stormrage,1143,warrior,arms,18,12,6
Jichelei,tichondrius,1143,warrior,arms,24,12,12
Dolkal,tichondrius,1143,warrior,arms,30,12,18
Dinogc,barthilas,1141,warrior,arms,24,12,12
Yisunshin,azralon,1141,warrior,arms,24,12,12
Hblock,barthilas,1140,warrior,arms,24,12,12
Carriney,illidan,1139,warrior,arms,47,24,23
Brocc,tichondrius,1139,warrior,arms,24,12,12
Sloppyglucks,moon-guard,1138,warrior,arms,24,12,12
Tappia,quelthalas,1138,warrior,arms,36,12,24
Warrimon,nemesis,1138,warrior,arms,36,12,24
Drahconian,aggramar,1134,warrior,arms,24,12,12
Tripleblack,mugthol,1132,warrior,arms,18,12,6
Anotee,kelthuzad,1132,warrior,arms,41,22,19
Ragebladë,tichondrius,1131,warrior,arms,42,26,16
Stoul,illidan,1129,warrior,arms,24,18,6
Macsen,zuljin,1129,warrior,arms,24,12,12
Lunks,kelthuzad,1128,warrior,arms,18,12,6
Gooshin,sargeras,1128,warrior,arms,24,12,12
Dsz,nemesis,1128,warrior,arms,29,13,16
Kuchikilla,borean-tundra,1127,warrior,arms,24,12,12
Ujumpijump,andorhal,1126,warrior,arms,30,12,18
Cocainiouz,dalaran,1125,warrior,arms,30,13,17
Clovê,ragnaros,1118,warrior,arms,30,18,12
Rayks,tichondrius,1118,warrior,arms,24,12,12
Thunderclapz,stormscale,1114,warrior,arms,24,12,12
Looffy,saurfang,1114,warrior,arms,30,12,18
Storkos,moon-guard,1113,warrior,arms,47,23,24
Alejandros,azgalor,1111,warrior,arms,23,12,11
Warriorlee,jubeithos,1111,warrior,arms,44,19,25
Jhave,ragnaros,1111,warrior,arms,30,12,18
Târtàrûs,tichondrius,1108,warrior,arms,24,15,9
Dvhwec,tichondrius,1105,warrior,arms,28,12,16
Purefury,whisperwind,1103,warrior,arms,75,33,42
Thebeastwar,area-52,1101,warrior,arms,36,19,17
Tipincider,perenolde,1100,warrior,arms,21,12,9
Aelrog,malganis,1098,warrior,arms,52,25,27
Âmânthul,alexstrasza,1097,warrior,arms,34,19,15
Tyrantwolf,ragnaros,1097,warrior,arms,45,17,28
Knocks,blackrock,1094,warrior,arms,21,13,8
Melankoma,sargeras,1094,warrior,arms,30,12,18
Arrogated,emerald-dream,1092,warrior,arms,84,41,43
Zaexx,stormrage,1090,warrior,arms,23,12,11
Shishokun,quelthalas,1085,warrior,arms,34,15,19
Flexakute,malganis,1080,warrior,arms,20,12,8
Scaredwarr,stormrage,1079,warrior,arms,24,13,11
Kannerhus,quelthalas,1078,warrior,arms,32,13,19
Njjszn,thrall,1074,warrior,arms,72,31,41
Ødïñ,sargeras,1071,warrior,arms,75,37,38
Brotu,nemesis,1070,warrior,arms,82,43,39
Selathiel,burning-blade,1070,warrior,arms,28,12,16
Pangpou,tichondrius,1067,warrior,arms,30,12,18
Raserei,moonrunner,1063,warrior,arms,63,28,35
Imcute,senjin,1058,warrior,arms,60,21,39
Midorikwa,area-52,1056,warrior,arms,18,11,7
Buckwar,zuljin,1056,warrior,arms,24,11,13
Wizcleavuh,area-52,1056,warrior,arms,24,11,13
Nuqipq,tichondrius,1056,warrior,arms,24,11,13
Aranacn,tichondrius,1055,warrior,arms,12,11,1
Pkgd,tichondrius,1055,warrior,arms,12,11,1
Turtlestorm,tichondrius,1055,warrior,arms,18,11,7
Gladiator,azshara,1055,warrior,arms,18,11,7
Jericho,kiljaeden,1055,warrior,arms,18,11,7
Belàriá,tichondrius,1055,warrior,arms,24,11,13
Feedzz,area-52,1055,warrior,arms,24,11,13
Gannïcûs,drakkari,1055,warrior,arms,24,11,13
Laddèrx,area-52,1055,warrior,arms,24,11,13
Abomlnatlon,tichondrius,1055,warrior,arms,24,11,13
Hofukumizuki,tichondrius,1055,warrior,arms,30,11,19
Stooklol,tichondrius,1055,warrior,arms,30,11,19
Datneck,tichondrius,1054,warrior,arms,18,11,7
Babybears,tichondrius,1054,warrior,arms,24,11,13
Wolfsrage,frostmourne,1054,warrior,arms,30,11,19
Okita,bleeding-hollow,1054,warrior,arms,30,11,19
Awm,wyrmrest-accord,1053,warrior,arms,24,11,13
Aggorak,illidan,1053,warrior,arms,24,11,13
Wmf,frostmourne,1051,warrior,arms,30,11,19
Drillbit,wyrmrest-accord,1051,warrior,arms,30,11,19
Athin,azralon,1050,warrior,arms,24,11,13
Sheriff,eldrethalas,1050,warrior,arms,24,11,13
Beowúlf,burning-blade,1050,warrior,arms,30,11,19
Myceliumlog,frostmourne,1049,warrior,arms,18,11,7
Týrodar,moon-guard,1049,warrior,arms,24,11,13
Snewdawg,malganis,1048,warrior,arms,22,12,10
Yirko,quelthalas,1048,warrior,arms,32,11,21
Dwarfanage,tichondrius,1047,warrior,arms,28,12,16
Blaxst,gorgonnash,1046,warrior,arms,30,16,14
Midge,proudmoore,1044,warrior,arms,59,30,29
Orphasmic,moon-guard,1044,warrior,arms,36,11,25
Carrito,perenolde,1041,warrior,arms,20,13,7
Creator,dalaran,1041,warrior,arms,24,11,13
Stolz,dragonmaw,1040,warrior,arms,24,11,13
Titanika,wyrmrest-accord,1039,warrior,arms,36,11,25
Yamadaflash,tichondrius,1038,warrior,arms,25,12,13
Dylaiin,kelthuzad,1038,warrior,arms,30,11,19
Rageloading,amanthul,1037,warrior,arms,18,11,7
Wrekkshop,tichondrius,1037,warrior,arms,27,13,14
Wrrx,frostmourne,1037,warrior,arms,24,11,13
Nobowar,tichondrius,1032,warrior,arms,24,11,13
Robotríp,illidan,1031,warrior,arms,24,11,13
Pingorosho,quelthalas,1029,warrior,arms,24,11,13
Malok,deathwing,1028,warrior,arms,45,13,32
Cronie,steamwheedle-cartel,1027,warrior,arms,36,16,20
Galuf,malygos,1014,warrior,arms,18,11,7
Tucô,skullcrusher,1010,warrior,arms,43,20,23
Kalnor,dark-iron,1009,warrior,arms,26,12,14
Bionikus,nemesis,1009,warrior,arms,60,25,35
Ivanovh,quelthalas,1009,warrior,arms,39,16,23
Halis,illidan,1006,warrior,arms,21,13,8
Blackstamp,tichondrius,1006,warrior,arms,35,18,17
Starplatinum,aerie-peak,1004,warrior,arms,32,11,21
Kreeper,farstriders,1001,warrior,arms,23,11,12
Krostyx,ragnaros,1000,warrior,arms,24,13,11
Lokityr,tichondrius,995,warrior,arms,42,16,26
Kyritto,azralon,994,warrior,arms,35,18,17
Altruiel,sargeras,994,warrior,arms,39,19,20
Hagud,tichondrius,993,warrior,arms,23,11,12
Potan,thrall,992,warrior,arms,36,12,24
Szee,tichondrius,991,warrior,arms,17,11,6
Elsamok,ragnaros,991,warrior,arms,17,11,6
Kalaxe,quelthalas,990,warrior,arms,36,11,25
Ambiss,azjolnerub,988,warrior,arms,23,11,12
Budzie,frostwolf,984,warrior,arms,22,11,11
Thråsh,area-52,977,warrior,arms,36,16,20
Sudokubrain,tichondrius,974,warrior,arms,19,11,8
Warthorns,malganis,973,warrior,arms,25,11,14
Anticiðe,zuljin,960,warrior,arms,12,10,2
Swifty,anvilmar,960,warrior,arms,18,10,8
Escanòr,malganis,960,warrior,arms,18,10,8
Paoxiaoevs,tichondrius,960,warrior,arms,18,10,8
Szew,tichondrius,960,warrior,arms,18,10,8
Facefïster,malganis,960,warrior,arms,18,10,8
Adios,tichondrius,960,warrior,arms,18,10,8
Choppin,sargeras,960,warrior,arms,24,10,14
Arthurjlol,tichondrius,960,warrior,arms,24,10,14
Jarheadz,bleeding-hollow,960,warrior,arms,24,10,14
Nightheller,stormrage,960,warrior,arms,24,10,14
Iløveaysla,azralon,960,warrior,arms,30,10,20
Shadderaz,sargeras,959,warrior,arms,12,10,2
Shinigamix,steamwheedle-cartel,959,warrior,arms,18,10,8
Rafheeki,tichondrius,959,warrior,arms,18,10,8
Ragedump,shadowsong,959,warrior,arms,18,10,8
Crystaríum,stormrage,959,warrior,arms,18,10,8
Grimjouw,sargeras,959,warrior,arms,18,10,8
Hildemir,tichondrius,959,warrior,arms,18,10,8
Mecc,tichondrius,959,warrior,arms,24,10,14
Drdelicious,tichondrius,959,warrior,arms,24,10,14
Icrìtmypants,dragonmaw,958,warrior,arms,18,10,8
Glacierrsz,sargeras,958,warrior,arms,18,10,8
Painfulsin,tichondrius,958,warrior,arms,18,10,8
Cokeroom,tichondrius,958,warrior,arms,18,10,8
Macray,proudmoore,958,warrior,arms,18,10,8
Flavor,aegwynn,958,warrior,arms,24,10,14
Moozz,dreadmaul,958,warrior,arms,24,10,14
Soez,tichondrius,957,warrior,arms,16,11,5
Stygïàn,draenor,957,warrior,arms,68,37,31
Nyle,zuljin,957,warrior,arms,24,10,14
Doomtree,zuljin,956,warrior,arms,12,10,2
Numb,moon-guard,956,warrior,arms,26,11,15
Colosal,drakkari,955,warrior,arms,12,10,2
Bigster,malganis,955,warrior,arms,18,10,8
Klouddraft,tichondrius,955,warrior,arms,18,10,8
Pocketaxe,blackwater-raiders,955,warrior,arms,66,32,34
Fòntaine,shandris,954,warrior,arms,18,10,8
Erple,eldrethalas,954,warrior,arms,36,10,26
Coffeebottom,wyrmrest-accord,953,warrior,arms,18,10,8
Toky,malganis,952,warrior,arms,18,10,8
Bfrenzy,dalaran,952,warrior,arms,24,10,14
Creepi,sargeras,952,warrior,arms,24,10,14
Aaltara,barthilas,951,warrior,arms,18,10,8
Rageinice,tichondrius,951,warrior,arms,24,10,14
Helaume,arathor,950,warrior,arms,18,10,8
Discopogo,nemesis,950,warrior,arms,24,10,14
Waabi,emerald-dream,949,warrior,arms,18,10,8
Royye,blood-furnace,949,warrior,arms,18,10,8
Tikkò,tichondrius,946,warrior,arms,24,10,14
Småckin,frostmourne,945,warrior,arms,18,10,8
Rockedanger,stormrage,942,warrior,arms,19,12,7
Meatdrps,frostmane,941,warrior,arms,26,11,15
Bersorcker,ragnaros,925,warrior,arms,20,11,9
Iyamii,hyjal,921,warrior,arms,17,10,7
Darkthok,drakkari,918,warrior,arms,28,12,16
Squeekzz,frostmane,914,warrior,arms,23,10,13
Shazbøt,tichondrius,911,warrior,arms,27,10,17
Skarkla,thrall,911,warrior,arms,29,10,19
Jägernaught,stormrage,910,warrior,arms,23,10,13
Gargameld,stormrage,909,warrior,arms,18,10,8
Jeffo,amanthul,905,warrior,arms,20,11,9
Spitts,frostmourne,904,warrior,arms,21,10,11
Atrocithy,ragnaros,896,warrior,arms,16,10,6
Rookìe,illidan,894,warrior,arms,23,10,13
Vamtoro,illidan,888,warrior,arms,16,10,6
Wallzar,sargeras,887,warrior,arms,20,10,10
Breyns,garrosh,875,warrior,arms,19,10,9
Sígmar,dreadmaul,869,warrior,arms,18,10,8
Moonyxx,frostmourne,864,warrior,arms,12,9,3
Dedgamesucks,darkspear,864,warrior,arms,12,9,3
Dripgodx,malganis,864,warrior,arms,12,9,3
Youngmoneyd,illidan,864,warrior,arms,12,9,3
Dalan,korgath,864,warrior,arms,12,9,3
Stÿgian,blood-furnace,864,warrior,arms,18,9,9
Ârmstrong,quelthalas,864,warrior,arms,18,9,9
Goonassassin,tichondrius,864,warrior,arms,18,9,9
Alchera,fizzcrank,864,warrior,arms,18,9,9
Legday,stormrage,864,warrior,arms,18,9,9
Wtbfriends,malganis,864,warrior,arms,18,9,9
Falindrah,moon-guard,864,warrior,arms,18,9,9
Bigbrick,stormrage,864,warrior,arms,18,9,9
Flexìn,tichondrius,864,warrior,arms,18,9,9
Scoopdog,stormrage,864,warrior,arms,18,9,9
Maddawgg,mugthol,864,warrior,arms,18,9,9
Ogrelurd,malygos,864,warrior,arms,18,9,9
Sharer,tichondrius,864,warrior,arms,18,9,9
Rogôsh,tichondrius,864,warrior,arms,24,9,15
Jiszle,sargeras,864,warrior,arms,24,9,15
Thugdorr,sargeras,864,warrior,arms,24,9,15
Sejac,moon-guard,864,warrior,arms,24,9,15
Reave,wyrmrest-accord,863,warrior,arms,12,9,3
Nibbzy,sargeras,863,warrior,arms,12,9,3
Druckerz,lightnings-blade,863,warrior,arms,18,9,9
Terneitor,ragnaros,863,warrior,arms,18,9,9
Sleazedog,kelthuzad,863,warrior,arms,18,9,9
Bozwar,tichondrius,863,warrior,arms,18,9,9
Metalwarr,illidan,863,warrior,arms,18,9,9
Erradic,sargeras,863,warrior,arms,18,9,9
Chañ,tichondrius,863,warrior,arms,18,9,9
Suntore,malganis,863,warrior,arms,18,9,9
Kralo,moon-guard,863,warrior,arms,21,10,11
Gorez,ragnaros,863,warrior,arms,22,10,12
Theisius,tichondrius,863,warrior,arms,21,9,12
Wrecktang,tichondrius,863,warrior,arms,24,9,15
Kelmor,thunderhorn,863,warrior,arms,24,9,15
Wargorin,bleeding-hollow,862,warrior,arms,18,9,9
Golkän,goldrinn,862,warrior,arms,18,9,9
Topmeoff,bleeding-hollow,862,warrior,arms,24,9,15
Lögän,azralon,862,warrior,arms,24,9,15
Thedin,gorefiend,861,warrior,arms,30,9,21
Greywo,tichondrius,860,warrior,arms,12,9,3
Shattering,fizzcrank,860,warrior,arms,18,9,9
Torkus,ragnaros,860,warrior,arms,18,9,9
Gunnaoffxans,sargeras,860,warrior,arms,18,9,9
Stormit,illidan,860,warrior,arms,19,9,10
Dysensor,illidan,860,warrior,arms,24,9,15
Golîath,mannoroth,860,warrior,arms,24,9,15
Layllassa,moon-guard,860,warrior,arms,24,9,15
Depthsii,lightbringer,859,warrior,arms,18,9,9
Gusbus,malganis,859,warrior,arms,18,9,9
Nishtana,quelthalas,859,warrior,arms,18,9,9
Vio,mannoroth,859,warrior,arms,18,9,9
Tasesino,quelthalas,859,warrior,arms,24,9,15
Lujzika,stormreaver,859,warrior,arms,27,10,17
Tolette,quelthalas,858,warrior,arms,18,9,9
Bargorengar,skullcrusher,858,warrior,arms,24,11,13
Superpot,bleeding-hollow,858,warrior,arms,24,9,15
Indoondabeat,azgalor,857,warrior,arms,26,10,16
Karusuke,stormrage,857,warrior,arms,24,9,15
Preschool,sargeras,854,warrior,arms,12,9,3
Garusok,thrall,853,warrior,arms,12,9,3
Bigolpeen,sargeras,852,warrior,arms,18,9,9
Asiyurekhans,borean-tundra,851,warrior,arms,12,9,3
Riuk,goldrinn,846,warrior,arms,18,9,9
Jaimey,malganis,845,warrior,arms,23,9,14
Rainiki,stormrage,845,warrior,arms,24,9,15
Macdollibee,barthilas,834,warrior,arms,18,9,9
Roughknuckle,kelthuzad,831,warrior,arms,17,9,8
Krimgar,quelthalas,831,warrior,arms,22,9,13
Sindevelor,tichondrius,830,warrior,arms,19,10,9
Stormlørd,frostmourne,830,warrior,arms,26,10,16
Psýchótic,tichondrius,827,warrior,arms,17,9,8
Panzerian,area-52,826,warrior,arms,17,9,8
Eskama,hyjal,823,warrior,arms,23,9,14
Kolosal,tichondrius,816,warrior,arms,15,9,6
Pusspeepers,kelthuzad,816,warrior,arms,21,9,12
Tunasurprize,stormrage,814,warrior,arms,21,9,12
Yummysushi,gorgonnash,806,warrior,arms,34,10,24
Gigazug,stormrage,799,warrior,arms,20,9,11
Fatmân,tichondrius,798,warrior,arms,22,9,13
Sayyaf,moon-guard,798,warrior,arms,34,9,25
Sneaknyoface,sargeras,797,warrior,arms,20,9,11
Vandalizer,sargeras,788,warrior,arms,20,10,10
Stufit,emerald-dream,783,warrior,arms,13,9,4
Gohrgroc,quelthalas,768,warrior,arms,12,8,4
Executiepie,hyjal,768,warrior,arms,12,8,4
Récksus,tichondrius,768,warrior,arms,12,8,4
Smallbrainx,tichondrius,768,warrior,arms,12,8,4
Dadslapper,illidan,768,warrior,arms,12,8,4
Retrospex,black-dragonflight,768,warrior,arms,12,8,4
Saucebussin,emerald-dream,768,warrior,arms,12,8,4
Mezdrì,quelthalas,768,warrior,arms,12,8,4
Slvrback,stormrage,768,warrior,arms,12,8,4
Varrior,wyrmrest-accord,768,warrior,arms,12,8,4
Janjannodie,tichondrius,768,warrior,arms,12,8,4
Raahjz,sargeras,768,warrior,arms,12,8,4
Hõdõnsin,tichondrius,768,warrior,arms,12,8,4
Bigdude,frostwolf,768,warrior,arms,12,8,4
Dreadtøøth,tichondrius,768,warrior,arms,18,8,10
Murderbell,tichondrius,768,warrior,arms,18,8,10
Necroticism,bleeding-hollow,768,warrior,arms,18,8,10
Tuggernaut,khadgar,768,warrior,arms,18,8,10
Tastý,moon-guard,768,warrior,arms,18,8,10
Betterwar,zuljin,768,warrior,arms,18,8,10
Jianhung,tichondrius,768,warrior,arms,18,8,10
Wârtorn,darkspear,768,warrior,arms,18,8,10
Auzery,emerald-dream,768,warrior,arms,18,8,10
Kanamechan,area-52,768,warrior,arms,18,8,10
Killborn,tichondrius,768,warrior,arms,24,8,16
Yueren,tichondrius,768,warrior,arms,24,8,16
Iwillcrushyo,darkspear,768,warrior,arms,24,8,16
Ochinching,tichondrius,768,warrior,arms,24,8,16
Grimreáper,bleeding-hollow,768,warrior,arms,24,8,16
Cgelangdula,tichondrius,768,warrior,arms,24,8,16
Drjuicce,tichondrius,767,warrior,arms,12,8,4
Kixxel,sargeras,767,warrior,arms,12,8,4
Sharpen,terokkar,767,warrior,arms,12,8,4
Draganovich,aerie-peak,767,warrior,arms,12,8,4
Angrybulky,illidan,767,warrior,arms,12,8,4
Riskydevil,azralon,767,warrior,arms,12,8,4
Kàkarot,illidan,767,warrior,arms,12,8,4
Holddapoop,area-52,767,warrior,arms,12,8,4
Silverkiller,drakkari,767,warrior,arms,12,8,4
Executefreak,illidan,767,warrior,arms,12,8,4
Um,moon-guard,767,warrior,arms,12,8,4
Chupelo,tichondrius,767,warrior,arms,12,8,4
Winota,frostmourne,767,warrior,arms,12,8,4
Vecira,moon-guard,767,warrior,arms,12,8,4
Haldeer,shadow-council,767,warrior,arms,12,8,4
Bullmastic,deathwing,767,warrior,arms,16,9,7
Nanor,zuljin,767,warrior,arms,18,8,10
Cevadix,azralon,767,warrior,arms,18,8,10
Ihazlolstorm,area-52,767,warrior,arms,18,8,10
Moarbrainz,mannoroth,767,warrior,arms,18,8,10
Croxxs,aegwynn,767,warrior,arms,18,8,10
Empriux,quelthalas,767,warrior,arms,18,8,10
Saskouach,stormrage,767,warrior,arms,20,8,12
Zareos,azralon,767,warrior,arms,24,8,16
Radagøn,drakkari,767,warrior,arms,24,8,16
Kinzi,quelthalas,767,warrior,arms,24,8,16
Xenoblade,wildhammer,767,warrior,arms,24,8,16
Techanina,aerie-peak,767,warrior,arms,24,8,16
Gorepig,sargeras,767,warrior,arms,24,8,16
Belldor,barthilas,767,warrior,arms,30,8,22
Jackhanma,kelthuzad,766,warrior,arms,12,8,4
Ragarok,jubeithos,766,warrior,arms,12,8,4
Warrdawg,tichondrius,766,warrior,arms,12,8,4
Nervoxztwo,ragnaros,766,warrior,arms,18,8,10
Rineer,tichondrius,766,warrior,arms,18,8,10
Sálieri,ragnaros,766,warrior,arms,18,8,10
Akj,sargeras,766,warrior,arms,22,8,14
Catastrophie,mugthol,765,warrior,arms,24,8,16
Loktarrogar,illidan,765,warrior,arms,24,8,16
Nosfuratuzod,frostmourne,764,warrior,arms,18,8,10
Alexarchos,chogall,764,warrior,arms,18,8,10
Friends,azjolnerub,763,warrior,arms,18,8,10
Thing,gorgonnash,763,warrior,arms,18,8,10
Sllvrbck,tichondrius,762,warrior,arms,16,9,7
Revenn,greymane,761,warrior,arms,12,8,4
Deathsmirk,illidan,761,warrior,arms,25,10,15
Rágnárr,ragnaros,759,warrior,arms,18,8,10
Gohawn,hyjal,757,warrior,arms,21,9,12
Trapwar,malganis,755,warrior,arms,12,8,4
Vetinari,nazjatar,735,warrior,arms,11,8,3
Davidorco,drakkari,734,warrior,arms,17,8,9
Casmier,tichondrius,734,warrior,arms,17,8,9
Whiteclouds,blood-furnace,723,warrior,arms,24,8,16
Mêlo,area-52,719,warrior,arms,17,8,9
Gwlade,sargeras,718,warrior,arms,11,8,3
Tribbally,silver-hand,718,warrior,arms,11,8,3
Layoon,azralon,718,warrior,arms,17,8,9
Wreckthis,area-52,718,warrior,arms,17,8,9
Pongk,tichondrius,714,warrior,arms,33,9,24
Malathire,illidan,703,warrior,arms,16,8,8
Bloodbath,kiljaeden,703,warrior,arms,17,8,9
Zuggarnaught,tichondrius,701,warrior,arms,16,8,8
ßloodshed,frostmourne,688,warrior,arms,13,8,5
Elfmonger,proudmoore,687,warrior,arms,13,8,5
Wreckerr,area-52,680,warrior,arms,20,10,10
Heojae,tichondrius,672,warrior,arms,12,7,5
Nerdstorm,tichondrius,672,warrior,arms,12,7,5
Dáinsleif,frostmourne,672,warrior,arms,12,7,5
Dashballer,sargeras,672,warrior,arms,12,7,5
Jahrakál,thunderlord,672,warrior,arms,12,7,5
Toxxel,wyrmrest-accord,672,warrior,arms,12,7,5
Peeb,tichondrius,672,warrior,arms,12,7,5
Skolltonxoxo,tichondrius,672,warrior,arms,12,7,5
Cugij,frostmourne,672,warrior,arms,12,7,5
Magnusz,zuljin,672,warrior,arms,12,7,5
Turtleofhope,barthilas,672,warrior,arms,12,7,5
Studdythejet,zuljin,672,warrior,arms,12,7,5
Leoneceo,azralon,672,warrior,arms,12,7,5
Hannibalkng,zangarmarsh,672,warrior,arms,12,7,5
Vids,aegwynn,672,warrior,arms,12,7,5
Grounyl,azralon,672,warrior,arms,12,7,5
Yrz,malganis,672,warrior,arms,12,7,5
Goldbêrg,malganis,672,warrior,arms,12,7,5
Salthouse,sargeras,672,warrior,arms,12,7,5
Stompyocouch,mugthol,672,warrior,arms,12,7,5
Kâdé,malganis,672,warrior,arms,12,7,5
Havocsmash,tichondrius,672,warrior,arms,12,7,5
Mardrex,korgath,672,warrior,arms,12,7,5
Arsis,whisperwind,672,warrior,arms,12,7,5
Ttl,dalaran,672,warrior,arms,12,7,5
Edgárllama,sargeras,672,warrior,arms,12,7,5
Nikomasked,kelthuzad,672,warrior,arms,12,7,5
Furryhorv,frostmourne,672,warrior,arms,12,7,5
Warrgawd,illidan,672,warrior,arms,12,7,5
Ryalaeth,moon-guard,672,warrior,arms,12,7,5
Okayge,proudmoore,672,warrior,arms,12,7,5
Xdoombringer,area-52,672,warrior,arms,12,7,5
Turecw,illidan,672,warrior,arms,12,7,5
Pocserwar,drakkari,672,warrior,arms,12,7,5
Faronstompz,sargeras,672,warrior,arms,12,7,5
Warginger,malygos,672,warrior,arms,12,7,5
Zaynafein,emerald-dream,672,warrior,arms,12,7,5
Roiboy,stormrage,672,warrior,arms,12,7,5
Battousäi,kiljaeden,672,warrior,arms,12,7,5
Gbrz,stormrage,672,warrior,arms,12,7,5
Dtrumpo,moon-guard,672,warrior,arms,12,7,5
Bloodshêdz,stormrage,672,warrior,arms,12,7,5
Imyourdaddy,chogall,672,warrior,arms,16,8,8
Kimed,nordrassil,672,warrior,arms,18,7,11
Yamzprime,stormrage,672,warrior,arms,18,7,11
Hydranoid,ragnaros,672,warrior,arms,18,7,11
Ivory,emerald-dream,672,warrior,arms,18,7,11
Bornne,doomhammer,672,warrior,arms,18,7,11
Wargasmx,tichondrius,672,warrior,arms,18,7,11
Blightscream,bleeding-hollow,672,warrior,arms,18,7,11
Urscrewed,frostmane,672,warrior,arms,18,7,11
Timotheapple,stormrage,672,warrior,arms,18,7,11
Warhji,malganis,672,warrior,arms,18,7,11
Môrôdin,area-52,672,warrior,arms,18,7,11
Sinbãd,sargeras,672,warrior,arms,18,7,11
Ryänlord,mugthol,672,warrior,arms,18,7,11
Goyqqw,illidan,672,warrior,arms,18,7,11
Thètrùth,duskwood,672,warrior,arms,18,7,11
Danceylol,barthilas,672,warrior,arms,18,7,11
Festerclaws,wyrmrest-accord,672,warrior,arms,24,7,17
Yeawen,tichondrius,672,warrior,arms,24,7,17
Crnogorac,hakkar,671,warrior,arms,12,7,5
Jedeva,stormrage,671,warrior,arms,12,7,5
Furiousangel,area-52,671,warrior,arms,12,7,5
Baul,area-52,671,warrior,arms,12,7,5
Nightshauyia,kelthuzad,671,warrior,arms,12,7,5
Nehpets,akama,671,warrior,arms,12,7,5
Calmaah,frostmourne,671,warrior,arms,12,7,5
Rägar,quelthalas,671,warrior,arms,12,7,5
Dizgraceful,malganis,671,warrior,arms,12,7,5
Glizzarms,dalaran,671,warrior,arms,12,7,5
Irongummy,frostmourne,671,warrior,arms,12,7,5
Pipeman,blackhand,671,warrior,arms,12,7,5
Makcumba,ragnaros,671,warrior,arms,12,7,5
Jodoro,malfurion,671,warrior,arms,12,7,5
Tamagoshi,kiljaeden,671,warrior,arms,12,7,5
Arox,ghostlands,671,warrior,arms,12,7,5
Bulletfodder,tichondrius,671,warrior,arms,12,7,5
Grimus,bleeding-hollow,671,warrior,arms,12,7,5
Maddzspin,tichondrius,671,warrior,arms,12,7,5
Qetimporta,quelthalas,671,warrior,arms,12,7,5
Gunnëy,malganis,671,warrior,arms,12,7,5
Vauquelin,tichondrius,671,warrior,arms,18,7,11
Aisinbro,illidan,671,warrior,arms,18,7,11
Dualip,tichondrius,671,warrior,arms,18,7,11
Chumbinhu,stormrage,671,warrior,arms,18,7,11
Swordmasters,icecrown,671,warrior,arms,18,7,11
Plssaveme,ysera,671,warrior,arms,18,7,11
Nraged,illidan,670,warrior,arms,12,7,5
Noobslayr,wyrmrest-accord,670,warrior,arms,12,7,5
Droogust,tichondrius,670,warrior,arms,12,7,5
Franc,kiljaeden,670,warrior,arms,18,7,11
Schizogeist,malganis,670,warrior,arms,18,7,11
Dizzygal,hyjal,670,warrior,arms,18,7,11
Dhano,drakkari,670,warrior,arms,18,7,11
Gíal,ragnaros,670,warrior,arms,24,7,17
Reidahn,zuljin,670,warrior,arms,24,7,17
Vezixx,dragonmaw,669,warrior,arms,12,7,5
Harnor,garrosh,669,warrior,arms,18,7,11
Teyliemond,amanthul,668,warrior,arms,12,7,5
Fkndog,tichondrius,668,warrior,arms,18,7,11
Úmarth,azralon,668,warrior,arms,18,7,11
Rogkhan,tichondrius,667,warrior,arms,18,7,11
Kevasaurr,sargeras,667,warrior,arms,24,7,17
Prunebery,area-52,666,warrior,arms,12,7,5
Marcolatus,ragnaros,666,warrior,arms,18,7,11
Terribletom,stormrage,665,warrior,arms,18,7,11
Jötunn,dalaran,663,warrior,arms,12,7,5
Gongos,doomhammer,663,warrior,arms,18,7,11
Dierdris,gnomeregan,659,warrior,arms,13,7,6
Parmizan,hydraxis,639,warrior,arms,16,7,9
Casteleiro,azralon,639,warrior,arms,20,8,12
Fewfingers,sargeras,638,warrior,arms,16,7,9
Monowarx,frostmourne,638,warrior,arms,22,7,15
Twinxin,thrall,637,warrior,arms,17,7,10
Irishhammer,malfurion,637,warrior,arms,17,7,10
Brutallicus,kelthuzad,624,warrior,arms,9,8,1
Kratosxx,quelthalas,623,warrior,arms,11,7,4
Perrin,burning-blade,623,warrior,arms,17,7,10
Bigboycandy,malganis,621,warrior,arms,11,7,4
Estivador,kelthuzad,617,warrior,arms,26,8,18
Exxic,zuljin,606,warrior,arms,14,7,7
Neekka,tichondrius,605,warrior,arms,16,7,9
Dishonorkill,dentarg,592,warrior,arms,13,7,6
Akkar,gilneas,576,warrior,arms,6,6,0
Bean,ragnaros,576,warrior,arms,6,6,0
Joebo,thrall,576,warrior,arms,6,6,0
Szeo,tichondrius,576,warrior,arms,6,6,0
Dóminus,malfurion,576,warrior,arms,6,6,0
Stoneshield,senjin,576,warrior,arms,6,6,0
Eiendira,proudmoore,576,warrior,arms,12,6,6
Tmjakeful,area-52,576,warrior,arms,12,6,6
Doves,tichondrius,576,warrior,arms,12,6,6
Hololeave,tichondrius,576,warrior,arms,12,6,6
Amortens,area-52,576,warrior,arms,12,6,6
Atuey,area-52,576,warrior,arms,12,6,6
Hülkamanïa,sargeras,576,warrior,arms,12,6,6
Anukhar,emerald-dream,576,warrior,arms,12,6,6
Xargosh,magtheridon,576,warrior,arms,12,6,6
Kaìju,dragonmaw,576,warrior,arms,12,6,6
Truecarnage,emerald-dream,576,warrior,arms,12,6,6
Assamith,nemesis,576,warrior,arms,12,6,6
Dissector,ragnaros,576,warrior,arms,12,6,6
Bonclay,nerzhul,576,warrior,arms,12,6,6
Gormag,sargeras,576,warrior,arms,12,6,6
Breaker,undermine,576,warrior,arms,12,6,6
Sigfir,ragnaros,576,warrior,arms,12,6,6
Headsour,thunderhorn,576,warrior,arms,12,6,6
Fûry,barthilas,576,warrior,arms,12,6,6
Glourfindel,quelthalas,576,warrior,arms,12,6,6
Wurua,tichondrius,576,warrior,arms,12,6,6
Justfair,barthilas,576,warrior,arms,12,6,6
Blazight,dunemaul,576,warrior,arms,12,6,6
Aladarith,moon-guard,576,warrior,arms,12,6,6
Monkeystrike,barthilas,576,warrior,arms,12,6,6
Sunderstruck,boulderfist,576,warrior,arms,12,6,6
Überwältigen,thrall,576,warrior,arms,12,6,6
Kilgrah,emerald-dream,576,warrior,arms,12,6,6
Ashtonx,sargeras,576,warrior,arms,12,6,6
Raahj,sargeras,576,warrior,arms,12,6,6
Starshattr,bleeding-hollow,576,warrior,arms,12,6,6
Cathillex,eonar,576,warrior,arms,12,6,6
Bamxz,sargeras,576,warrior,arms,12,6,6
Tàlent,thrall,576,warrior,arms,12,6,6
Gladdz,moon-guard,576,warrior,arms,12,6,6
Geubsalx,tichondrius,576,warrior,arms,12,6,6
Sigrik,moon-guard,576,warrior,arms,12,6,6
Kaÿip,tichondrius,576,warrior,arms,12,6,6
Cassetto,icecrown,576,warrior,arms,12,6,6
Zuans,azralon,576,warrior,arms,12,6,6
Moxxyy,tichondrius,576,warrior,arms,12,6,6
Riggragg,tichondrius,576,warrior,arms,12,6,6
Jdubz,frostmourne,576,warrior,arms,12,6,6
Grantlol,illidan,576,warrior,arms,12,6,6
Bagginses,quelthalas,576,warrior,arms,12,6,6
Rargou,illidan,576,warrior,arms,12,6,6
Zizwe,proudmoore,576,warrior,arms,12,6,6
Adryina,zuljin,576,warrior,arms,12,6,6
Maintarget,malganis,576,warrior,arms,12,6,6
Ratherfull,ragnaros,576,warrior,arms,12,6,6
Deathengine,area-52,576,warrior,arms,12,6,6
Bryk,korgath,576,warrior,arms,12,6,6
Luminiere,sargeras,576,warrior,arms,12,6,6
Flidumpling,tichondrius,576,warrior,arms,12,6,6
Lionbuster,ragnaros,576,warrior,arms,12,6,6
Areiana,stormrage,576,warrior,arms,12,6,6
Rembrand,blackhand,576,warrior,arms,12,6,6
Arozay,illidan,576,warrior,arms,12,6,6
Bamlin,sargeras,576,warrior,arms,12,6,6
Maywarro,ragnaros,576,warrior,arms,12,6,6
Jaybers,malganis,576,warrior,arms,12,6,6
Auxthas,tichondrius,576,warrior,arms,12,6,6
Roflcombo,illidan,576,warrior,arms,12,6,6
Ganzism,tichondrius,576,warrior,arms,13,6,7
Asgér,quelthalas,576,warrior,arms,18,6,12
Flexinbooty,kelthuzad,576,warrior,arms,18,6,12
Browneyed,area-52,576,warrior,arms,18,6,12
Scumrat,frostmourne,576,warrior,arms,18,6,12
Thecolor,tichondrius,576,warrior,arms,18,6,12
Hariban,shuhalo,576,warrior,arms,18,6,12
Májorrobot,area-52,576,warrior,arms,18,6,12
Nillor,emerald-dream,576,warrior,arms,18,6,12
Egoist,malganis,576,warrior,arms,18,6,12
Benw,dawnbringer,576,warrior,arms,18,6,12
Nyloras,illidan,576,warrior,arms,18,6,12
Kennäy,azralon,576,warrior,arms,18,6,12
Odrath,tichondrius,576,warrior,arms,18,6,12
Boblennon,tichondrius,576,warrior,arms,18,6,12
Xgraves,sargeras,576,warrior,arms,18,6,12
Kurodia,quelthalas,576,warrior,arms,24,6,18
Contentious,moon-guard,576,warrior,arms,24,6,18
Warwslayer,tichondrius,576,warrior,arms,24,6,18
Fenømenoide,ragnaros,575,warrior,arms,6,6,0
Ðhrâgøn,ragnaros,575,warrior,arms,6,6,0
Nospace,tichondrius,575,warrior,arms,12,6,6
Elpish,ragnaros,575,warrior,arms,12,6,6
Ereborh,ragnaros,575,warrior,arms,12,6,6
Balthazãr,quelthalas,575,warrior,arms,12,6,6
Amrap,dentarg,575,warrior,arms,12,6,6
Teyrn,stormrage,575,warrior,arms,12,6,6
Thornakh,stormrage,575,warrior,arms,12,6,6
Bolx,archimonde,575,warrior,arms,12,6,6
Pandatrue,azralon,575,warrior,arms,12,6,6
Pangean,sargeras,575,warrior,arms,12,6,6
Kitonic,proudmoore,575,warrior,arms,12,6,6
Uragiri,shadowsong,575,warrior,arms,12,6,6
Babyguns,tichondrius,575,warrior,arms,12,6,6
Carken,kiljaeden,575,warrior,arms,12,6,6
Xvett,drakkari,575,warrior,arms,12,6,6
Gahii,barthilas,575,warrior,arms,12,6,6
Percthirty,blackrock,575,warrior,arms,12,6,6
Marvél,quelthalas,575,warrior,arms,15,7,8
Kapalua,darkspear,575,warrior,arms,13,6,7
Eorik,stormrage,575,warrior,arms,18,6,12
Umogarmac,draktharon,575,warrior,arms,18,6,12
Guitter,nazjatar,575,warrior,arms,18,6,12
Filthyrandy,proudmoore,575,warrior,arms,18,6,12
Dragmös,nemesis,574,warrior,arms,6,6,0
Iblowloads,illidan,574,warrior,arms,12,6,6
Darkshrek,quelthalas,574,warrior,arms,12,6,6
Rafaelwar,drakkari,573,warrior,arms,12,6,6
Jragonmaster,borean-tundra,573,warrior,arms,18,6,12
Ugrundan,zuljin,572,warrior,arms,18,6,12
Märiä,ragnaros,571,warrior,arms,12,6,6
Ballzindeep,tichondrius,543,warrior,arms,8,7,1
Marvachi,moon-guard,543,warrior,arms,8,7,1
Outo,stormrage,543,warrior,arms,11,6,5
Tastyskeet,illidan,543,warrior,arms,11,6,5
Gorakis,barthilas,543,warrior,arms,14,7,7
Hexenbæne,tichondrius,542,warrior,arms,11,6,5
Verigislena,moon-guard,542,warrior,arms,14,7,7
Hjoz,illidan,541,warrior,arms,10,6,4
Tandiko,wyrmrest-accord,527,warrior,arms,11,6,5
Sudavis,alleria,524,warrior,arms,11,6,5
Lionssong,bleeding-hollow,522,warrior,arms,17,9,8
Hrókr,kiljaeden,522,warrior,arms,19,8,11
Warrage,kiljaeden,519,warrior,arms,21,9,12
Sáítámá,tichondrius,512,warrior,arms,16,6,10
Bløødy,lethon,511,warrior,arms,8,6,2
Droguernaut,tichondrius,511,warrior,arms,14,6,8
Bigdingus,frostwolf,511,warrior,arms,14,6,8
Bluthammer,wyrmrest-accord,511,warrior,arms,14,6,8
Jackjaeger,area-52,511,warrior,arms,16,6,10
Rhohan,ysera,511,warrior,arms,17,6,11
Ruiend,bonechewer,510,warrior,arms,14,6,8
Ripstorm,emerald-dream,510,warrior,arms,14,6,8
Lishajr,malganis,507,warrior,arms,8,6,2
Magarrior,shadowsong,495,warrior,arms,13,7,6
Noor,tichondrius,480,warrior,arms,6,5,1
Rickywarx,illidan,480,warrior,arms,6,5,1
Vanlur,khaz-modan,480,warrior,arms,6,5,1
Kappis,illidan,480,warrior,arms,6,5,1
Jackox,sargeras,480,warrior,arms,6,5,1
Houk,frostmourne,480,warrior,arms,6,5,1
Ryü,khaz-modan,480,warrior,arms,6,5,1
Iskandr,amanthul,480,warrior,arms,6,5,1
Ketasshi,kelthuzad,480,warrior,arms,6,5,1
Vainamóinen,kelthuzad,480,warrior,arms,6,5,1
Biggesttoees,tichondrius,480,warrior,arms,6,5,1
Geàrbreaker,tichondrius,480,warrior,arms,6,5,1
Billythunda,tichondrius,480,warrior,arms,6,5,1
Domminux,darkspear,480,warrior,arms,6,5,1
Hotshótz,kelthuzad,480,warrior,arms,6,5,1
Hashwar,area-52,480,warrior,arms,6,5,1
Tigris,nesingwary,480,warrior,arms,6,5,1
Kydrav,khadgar,480,warrior,arms,6,5,1
Ousetadoidao,nemesis,480,warrior,arms,6,5,1
Onefourfifty,tichondrius,480,warrior,arms,6,5,1
Roadglide,korgath,480,warrior,arms,6,5,1
Noreaga,tichondrius,480,warrior,arms,6,5,1
Ashrah,emerald-dream,480,warrior,arms,6,5,1
Jarlaix,dragonmaw,480,warrior,arms,6,5,1
Gízzmo,tichondrius,480,warrior,arms,6,5,1
Dukagã,tichondrius,480,warrior,arms,6,5,1
Tâlos,magtheridon,480,warrior,arms,6,5,1
Lexíbelle,korgath,480,warrior,arms,6,5,1
Armsupx,tichondrius,480,warrior,arms,6,5,1
Himurinha,nemesis,480,warrior,arms,6,5,1
Loveføx,stormrage,480,warrior,arms,6,5,1
Grehk,sargeras,480,warrior,arms,6,5,1
Clamjammed,thrall,480,warrior,arms,12,5,7
Spincycle,khadgar,480,warrior,arms,12,5,7
Empyrius,exodar,480,warrior,arms,12,5,7
Duckyuwu,tichondrius,480,warrior,arms,12,5,7
Buffwar,tichondrius,480,warrior,arms,12,5,7
Ligerii,quelthalas,480,warrior,arms,12,5,7
Durres,tichondrius,480,warrior,arms,12,5,7
Schoolbuhs,tichondrius,480,warrior,arms,12,5,7
Felorelea,moon-guard,480,warrior,arms,12,5,7
Himer,tichondrius,480,warrior,arms,12,5,7
Ahkimih,ragnaros,480,warrior,arms,12,5,7
Kpc,tichondrius,480,warrior,arms,12,5,7
Arcâdio,cairne,480,warrior,arms,12,5,7
Bddg,tichondrius,480,warrior,arms,12,5,7
Blackwulff,korgath,480,warrior,arms,12,5,7
Exëqt,nemesis,480,warrior,arms,12,5,7
Hatedßyßlízz,moon-guard,480,warrior,arms,12,5,7
Horsekok,tichondrius,480,warrior,arms,12,5,7
Mirado,tichondrius,480,warrior,arms,12,5,7
Hoodlark,lightbringer,480,warrior,arms,12,5,7
Jehocc,tichondrius,480,warrior,arms,12,5,7
Purrava,tichondrius,480,warrior,arms,12,5,7
Targos,frostwolf,480,warrior,arms,12,5,7
Huleo,tichondrius,480,warrior,arms,12,5,7
Wydstepwar,malganis,480,warrior,arms,12,5,7
Gonzwold,drenden,480,warrior,arms,12,5,7
Kasheeka,spirestone,480,warrior,arms,12,5,7
Shwip,tichondrius,480,warrior,arms,12,5,7
Kaikah,aegwynn,480,warrior,arms,12,5,7
Slamoholic,turalyon,480,warrior,arms,12,5,7
Angertooth,tichondrius,480,warrior,arms,12,5,7
Warthok,turalyon,480,warrior,arms,12,5,7
Lanco,kiljaeden,480,warrior,arms,12,5,7
Superdah,kiljaeden,480,warrior,arms,12,5,7
Dillý,area-52,480,warrior,arms,12,5,7
Andrexion,moon-guard,480,warrior,arms,12,5,7
Automator,proudmoore,480,warrior,arms,12,5,7
Elky,area-52,480,warrior,arms,12,5,7
Karik,proudmoore,480,warrior,arms,12,5,7
Martydom,proudmoore,480,warrior,arms,12,5,7
Elíte,kelthuzad,480,warrior,arms,12,5,7
Takenotez,sargeras,480,warrior,arms,12,5,7
Axellent,gilneas,480,warrior,arms,12,5,7
Sabers,mannoroth,480,warrior,arms,12,5,7
Furyass,bleeding-hollow,480,warrior,arms,12,5,7
Ezgamelol,azralon,480,warrior,arms,12,5,7
Dynamiite,bleeding-hollow,480,warrior,arms,12,5,7
Notmagnusz,zuljin,480,warrior,arms,12,5,7
Lorinzer,zuljin,480,warrior,arms,12,5,7
Duxor,sargeras,480,warrior,arms,12,5,7
Areiden,sargeras,480,warrior,arms,12,5,7
Deadhate,sargeras,480,warrior,arms,12,5,7
Wootzu,zuljin,480,warrior,arms,12,5,7
Wargasms,alterac-mountains,480,warrior,arms,12,5,7
Peters,malfurion,480,warrior,arms,12,5,7
Ecopolis,azshara,480,warrior,arms,12,5,7
Maniel,greymane,480,warrior,arms,12,5,7
Dondà,illidan,480,warrior,arms,12,5,7
Onionion,stormrage,480,warrior,arms,12,5,7
Gentlehugs,illidan,480,warrior,arms,12,5,7
Zewl,barthilas,480,warrior,arms,12,5,7
Unitsven,barthilas,480,warrior,arms,12,5,7
Easylel,stormrage,480,warrior,arms,12,5,7
Wheyprotein,illidan,480,warrior,arms,12,5,7
Supermieo,illidan,480,warrior,arms,12,5,7
Excalibruh,frostmourne,480,warrior,arms,12,5,7
Loucha,nagrand,480,warrior,arms,12,5,7
Sideon,frostmourne,480,warrior,arms,12,5,7
Grandtank,veknilash,480,warrior,arms,15,6,9
Mág,burning-legion,480,warrior,arms,13,5,8
Siegfriéd,bleeding-hollow,480,warrior,arms,14,5,9
Tigershárk,tichondrius,480,warrior,arms,16,5,11
Nïcowo,ragnaros,480,warrior,arms,26,8,18
Longzhan,tichondrius,480,warrior,arms,18,5,13
Zastrow,dalaran,480,warrior,arms,18,5,13
Omlas,azralon,480,warrior,arms,18,5,13
Goaco,drakkari,480,warrior,arms,18,5,13
Mahoogler,hakkar,480,warrior,arms,18,5,13
Bruttallis,frostmane,480,warrior,arms,18,5,13
Loosz,stormrage,480,warrior,arms,18,5,13
Modzilla,aerie-peak,480,warrior,arms,18,5,13
Odrak,ragnaros,480,warrior,arms,18,5,13
Soupwar,moon-guard,480,warrior,arms,18,5,13
Dropopen,tichondrius,480,warrior,arms,18,5,13
Cyllyzie,emerald-dream,480,warrior,arms,18,5,13
Raves,quelthalas,480,warrior,arms,18,5,13
Rinngo,proudmoore,479,warrior,arms,6,5,1
Tanger,korgath,479,warrior,arms,6,5,1
Adunken,ragnaros,479,warrior,arms,6,5,1
Arrozkonlech,proudmoore,479,warrior,arms,10,6,4
Trufsoturi,bleeding-hollow,479,warrior,arms,12,5,7
Dirtyrandy,zuluhed,479,warrior,arms,12,5,7
Sweetdeé,zuljin,479,warrior,arms,12,5,7
Alderr,frostmourne,479,warrior,arms,12,5,7
Loaksz,tichondrius,479,warrior,arms,12,5,7
Wondaimon,drakkari,479,warrior,arms,12,5,7
Mezi,tichondrius,479,warrior,arms,12,5,7
Synestira,frostmourne,479,warrior,arms,12,5,7
Tarmer,moon-guard,479,warrior,arms,12,5,7
Cueromodel,ragnaros,479,warrior,arms,12,5,7
Azaeil,tanaris,479,warrior,arms,12,5,7
Féril,ragnaros,479,warrior,arms,12,5,7
Helscreem,hyjal,479,warrior,arms,18,5,13
Dëkm,quelthalas,479,warrior,arms,18,5,13
Skumwarr,moon-guard,479,warrior,arms,22,5,17
Fleshtuxedo,stormrage,478,warrior,arms,6,5,1
Otyek,proudmoore,478,warrior,arms,12,5,7
Brutallypwnd,tichondrius,477,warrior,arms,6,5,1
Tmible,ragnaros,477,warrior,arms,6,5,1
Lazyclap,nagrand,477,warrior,arms,18,5,13
Lieutemajor,nemesis,476,warrior,arms,13,5,8
Orkuduro,azralon,474,warrior,arms,18,5,13
Sick,azralon,448,warrior,arms,10,6,4
Danalle,area-52,448,warrior,arms,10,6,4
Notcoverage,tichondrius,447,warrior,arms,11,5,6
Soulcalibur,zuljin,447,warrior,arms,17,5,12
Dontkiteme,frostmourne,447,warrior,arms,17,5,12
Jrodrick,nemesis,432,warrior,arms,9,6,3
Danzohh,dalaran,432,warrior,arms,15,5,10
Boombasta,shuhalo,426,warrior,arms,15,6,9
Thano,kiljaeden,415,warrior,arms,10,5,5
Edwiddin,frostmourne,415,warrior,arms,14,5,9
Gushyguts,tichondrius,399,warrior,arms,13,5,8
Jsolucky,thrall,384,warrior,arms,6,4,2
Swillzz,illidan,384,warrior,arms,6,4,2
Gamörä,illidan,384,warrior,arms,6,4,2
Shaõkahn,nemesis,384,warrior,arms,6,4,2
Paí,nemesis,384,warrior,arms,6,4,2
Donivan,illidan,384,warrior,arms,6,4,2
Sìkarío,illidan,384,warrior,arms,6,4,2
Lootacris,illidan,384,warrior,arms,6,4,2
Dazfury,barthilas,384,warrior,arms,6,4,2
Aægekaz,proudmoore,384,warrior,arms,6,4,2
Traglos,ragnaros,384,warrior,arms,6,4,2
Koalabear,shadow-council,384,warrior,arms,6,4,2
Nànchobo,tichondrius,384,warrior,arms,6,4,2
Northhill,tichondrius,384,warrior,arms,6,4,2
Larrythelob,kelthuzad,384,warrior,arms,6,4,2
Fazeo,madoran,384,warrior,arms,6,4,2
Bütch,stormrage,384,warrior,arms,6,4,2
Diãbel,azralon,384,warrior,arms,6,4,2
Virillius,wyrmrest-accord,384,warrior,arms,6,4,2
Dathalidus,area-52,384,warrior,arms,6,4,2
Elbelgon,ragnaros,384,warrior,arms,6,4,2
Tickej,dragonmaw,384,warrior,arms,6,4,2
Homicideted,frostmourne,384,warrior,arms,6,4,2
Míaguiulfo,ragnaros,384,warrior,arms,6,4,2
Blazingguard,stormrage,384,warrior,arms,6,4,2
Kevy,arygos,384,warrior,arms,6,4,2
Wariorwang,tichondrius,384,warrior,arms,6,4,2
Raime,sargeras,384,warrior,arms,6,4,2
Styiex,ragnaros,384,warrior,arms,6,4,2
Blakeb,area-52,384,warrior,arms,6,4,2
Islik,stormrage,384,warrior,arms,6,4,2
Zarttorius,quelthalas,384,warrior,arms,6,4,2
Chopped,wyrmrest-accord,384,warrior,arms,6,4,2
Karrosh,agamaggan,384,warrior,arms,6,4,2
Trevmo,bloodscalp,384,warrior,arms,6,4,2
Bajheeraz,sargeras,384,warrior,arms,6,4,2
Sakuraya,tichondrius,384,warrior,arms,6,4,2
Boomtacular,moon-guard,384,warrior,arms,6,4,2
Hordrek,moon-guard,384,warrior,arms,6,4,2
Amérus,moon-guard,384,warrior,arms,6,4,2
Winso,blood-furnace,384,warrior,arms,6,4,2
Omnïslash,tichondrius,384,warrior,arms,6,4,2
Hamur,azralon,384,warrior,arms,6,4,2
Bricksquad,mannoroth,384,warrior,arms,6,4,2
Blokz,arthas,384,warrior,arms,6,4,2
Relerocker,area-52,384,warrior,arms,6,4,2
Vâìn,tichondrius,384,warrior,arms,6,4,2
Swordfighter,moon-guard,384,warrior,arms,6,4,2
Còlòssal,moknathal,384,warrior,arms,6,4,2
Bailo,dathremar,384,warrior,arms,6,4,2
Hipower,lethon,384,warrior,arms,6,4,2
Keffdog,laughing-skull,384,warrior,arms,6,4,2
Vapòr,frostmourne,384,warrior,arms,6,4,2
Bloodbottle,darkspear,384,warrior,arms,6,4,2
Rezzett,wyrmrest-accord,384,warrior,arms,6,4,2
Itsaustinn,sargeras,384,warrior,arms,6,4,2
Hamburgezo,quelthalas,384,warrior,arms,6,4,2
Bruisebanner,area-52,384,warrior,arms,6,4,2
Rohta,kiljaeden,384,warrior,arms,6,4,2
Flëët,tichondrius,384,warrior,arms,6,4,2
Appolyonn,hyjal,384,warrior,arms,6,4,2
Illmindofboo,tichondrius,384,warrior,arms,6,4,2
Brøxigár,quelthalas,384,warrior,arms,6,4,2
Toungy,kelthuzad,384,warrior,arms,6,4,2
Airhood,frostmourne,384,warrior,arms,6,4,2
Bottlecaps,shadowmoon,384,warrior,arms,6,4,2
Ailes,hakkar,384,warrior,arms,6,4,2
Ricksanches,shadowmoon,384,warrior,arms,6,4,2
Jakslasfa,aegwynn,384,warrior,arms,6,4,2
Fancysin,malganis,384,warrior,arms,6,4,2
Tsutsana,lightninghoof,384,warrior,arms,6,4,2
Vodkalol,bleeding-hollow,384,warrior,arms,6,4,2
Izârâk,frostmourne,384,warrior,arms,6,4,2
Thiccyb,area-52,384,warrior,arms,6,4,2
Punknicanor,quelthalas,384,warrior,arms,6,4,2
Kriegsheer,bleeding-hollow,384,warrior,arms,6,4,2
Zenchi,nerzhul,384,warrior,arms,6,4,2
Fulreck,tichondrius,384,warrior,arms,6,4,2
Balakay,drenden,384,warrior,arms,6,4,2
Swaystko,sargeras,384,warrior,arms,6,4,2
Gnasty,hyjal,384,warrior,arms,6,4,2
Yivicus,sargeras,384,warrior,arms,6,4,2
Varyanguard,quelthalas,384,warrior,arms,6,4,2
Odalp,tichondrius,384,warrior,arms,6,4,2
Cecchino,zuluhed,384,warrior,arms,6,4,2
Maltrate,hyjal,384,warrior,arms,9,5,4
Crackersmack,stormrage,384,warrior,arms,9,5,4
Greenishfox,illidan,384,warrior,arms,9,5,4
Maxprotein,area-52,384,warrior,arms,8,4,4
Tdestroy,ragnaros,384,warrior,arms,9,4,5
Overfury,azralon,384,warrior,arms,12,4,8
Demonsláyer,illidan,384,warrior,arms,12,4,8
Izhansheni,illidan,384,warrior,arms,12,4,8
Misakizs,illidan,384,warrior,arms,12,4,8
Koraciá,illidan,384,warrior,arms,12,4,8
Tehfury,area-52,384,warrior,arms,12,4,8
Licona,wyrmrest-accord,384,warrior,arms,12,4,8
Iridikron,dalaran,384,warrior,arms,12,4,8
Rexxous,hyjal,384,warrior,arms,12,4,8
Lundyswung,silver-hand,384,warrior,arms,12,4,8
Hameey,sargeras,384,warrior,arms,12,4,8
Hârambe,kiljaeden,384,warrior,arms,12,4,8
Snack,stormreaver,384,warrior,arms,12,4,8
Ballsy,fenris,384,warrior,arms,12,4,8
Durango,duskwood,384,warrior,arms,12,4,8
Layøut,azralon,384,warrior,arms,12,4,8
Tusktrollmon,illidan,384,warrior,arms,12,4,8
Iargestpp,bleeding-hollow,384,warrior,arms,12,4,8
Warbeshar,area-52,384,warrior,arms,12,4,8
Ronak,vashj,384,warrior,arms,12,4,8
Enilaw,proudmoore,384,warrior,arms,12,4,8
Daymiian,blackrock,384,warrior,arms,12,4,8
Renclave,wyrmrest-accord,384,warrior,arms,12,4,8
Turkin,proudmoore,384,warrior,arms,12,4,8
Rawlur,zuljin,384,warrior,arms,12,4,8
Còsmico,trollbane,384,warrior,arms,12,4,8
Bigbadbaka,thaurissan,384,warrior,arms,12,4,8
Kolossux,ragnaros,384,warrior,arms,12,4,8
Sandrine,fizzcrank,384,warrior,arms,12,4,8
Chadblade,tichondrius,384,warrior,arms,12,4,8
Steelfist,grizzly-hills,384,warrior,arms,12,4,8
Palumorw,deathwing,384,warrior,arms,12,4,8
Grândmâ,zuljin,384,warrior,arms,12,4,8
Angrybrog,malfurion,384,warrior,arms,12,4,8
Draiken,dalaran,384,warrior,arms,12,4,8
Fatherkelso,tichondrius,384,warrior,arms,12,4,8
Handikap,stormrage,384,warrior,arms,12,4,8
Warriormikey,tichondrius,384,warrior,arms,12,4,8
Rocketbom,tichondrius,384,warrior,arms,12,4,8
Wárriór,tichondrius,384,warrior,arms,12,4,8
Twoshoutz,stormrage,384,warrior,arms,12,4,8
Tappyc,tichondrius,384,warrior,arms,12,4,8
Icestormray,illidan,384,warrior,arms,12,4,8
Marsshine,tichondrius,384,warrior,arms,12,4,8
Dirkdallas,tichondrius,384,warrior,arms,12,4,8
Volkz,ragnaros,384,warrior,arms,12,4,8
Franticlol,tichondrius,384,warrior,arms,12,4,8
Lui,the-forgotten-coast,384,warrior,arms,12,4,8
Nginx,queldorei,384,warrior,arms,12,4,8
Paratech,thrall,384,warrior,arms,12,4,8
Visenyä,mannoroth,384,warrior,arms,12,4,8
Realthiccbbw,tichondrius,384,warrior,arms,12,4,8
Gangaa,barthilas,384,warrior,arms,12,4,8
Guerra,goldrinn,384,warrior,arms,12,4,8
Zugface,tichondrius,384,warrior,arms,12,4,8
Laokan,illidan,384,warrior,arms,12,4,8
Käggai,khadgar,384,warrior,arms,12,4,8
Brownman,saurfang,384,warrior,arms,12,4,8
Ðirtyboy,tichondrius,384,warrior,arms,12,4,8
Koei,illidan,384,warrior,arms,12,4,8
Heliza,ragnaros,384,warrior,arms,12,4,8
Genesisxp,barthilas,384,warrior,arms,12,4,8
Ygucheng,emerald-dream,384,warrior,arms,13,4,9
Xunaco,quelthalas,384,warrior,arms,17,4,13
Sartin,boulderfist,384,warrior,arms,18,4,14
Gladicus,zuljin,384,warrior,arms,18,4,14
Cowsgomerr,tichondrius,384,warrior,arms,18,4,14
Casablancas,azralon,384,warrior,arms,18,4,14
Asphyxiating,illidan,384,warrior,arms,18,4,14
Noppô,tichondrius,384,warrior,arms,18,4,14
Shìromìzù,eredar,383,warrior,arms,6,4,2
Rebelzudo,azralon,383,warrior,arms,6,4,2
Môgwai,kelthuzad,383,warrior,arms,6,4,2
Yeit,tichondrius,383,warrior,arms,6,4,2
Tookbeki,tichondrius,383,warrior,arms,6,4,2
Tÿ,haomarush,383,warrior,arms,9,5,4
Spitbeard,kargath,383,warrior,arms,12,4,8
Tanatos,the-venture-co,383,warrior,arms,12,4,8
Bitiatus,scilla,383,warrior,arms,12,4,8
Christellà,dalaran,383,warrior,arms,18,4,14
Acanof,azjolnerub,382,warrior,arms,6,4,2
Warsins,bonechewer,367,warrior,arms,17,4,13
Everchosen,proudmoore,352,warrior,arms,10,4,6
Thøros,moon-guard,351,warrior,arms,11,4,7
Vaetren,area-52,351,warrior,arms,11,4,7
Jindyn,boulderfist,349,warrior,arms,10,4,6
Ginormous,rivendare,336,warrior,arms,9,4,5
Toir,bladefist,335,warrior,arms,11,4,7
Macray,zuljin,330,warrior,arms,18,5,13
Machatlan,stormrage,324,warrior,arms,16,7,9
Lildumptruck,emerald-dream,320,warrior,arms,10,4,6
Painstake,illidan,320,warrior,arms,19,5,14
Furykets,proudmoore,319,warrior,arms,5,4,1
Toetoeto,darrowmere,319,warrior,arms,5,4,1
Cptdrako,alterac-mountains,319,warrior,arms,8,4,4
Tyférious,tichondrius,319,warrior,arms,14,4,10
Handkerchief,bleeding-hollow,304,warrior,arms,7,4,3
Kleavage,korgath,304,warrior,arms,13,4,9
Nitechaos,thrall,302,warrior,arms,7,5,2
Lucidx,malfurion,288,warrior,arms,6,3,3
Schlosh,laughing-skull,288,warrior,arms,6,3,3
Idarkshakra,illidan,288,warrior,arms,6,3,3
Vexwar,bleeding-hollow,288,warrior,arms,6,3,3
Nukehazard,bleeding-hollow,288,warrior,arms,6,3,3
Pummels,area-52,288,warrior,arms,6,3,3
Oxia,quelthalas,288,warrior,arms,6,3,3
Cbum,quelthalas,288,warrior,arms,6,3,3
Carnith,arthas,288,warrior,arms,6,3,3
Asgaurdius,thunderlord,288,warrior,arms,6,3,3
Hanginaround,zuluhed,288,warrior,arms,6,3,3
Magthor,warsong,288,warrior,arms,6,3,3
Jerveen,quelthalas,288,warrior,arms,6,3,3
Qutuz,illidan,288,warrior,arms,6,3,3
Flexyx,arthas,288,warrior,arms,6,3,3
Mfmuggz,thunderlord,288,warrior,arms,6,3,3
Zeldrissx,quelthalas,288,warrior,arms,6,3,3
Execute,kirin-tor,288,warrior,arms,6,3,3
Warnuk,lightnings-blade,288,warrior,arms,6,3,3
Tbagg,area-52,288,warrior,arms,6,3,3
Grognäk,malganis,288,warrior,arms,6,3,3
Dazuu,illidan,288,warrior,arms,6,3,3
Mortaryon,malganis,288,warrior,arms,6,3,3
Hopefulki,duskwood,288,warrior,arms,6,3,3
Drakr,ragnaros,288,warrior,arms,6,3,3
Beerstorm,stormrage,288,warrior,arms,6,3,3
Mavrus,malganis,288,warrior,arms,6,3,3
Daduké,stormrage,288,warrior,arms,6,3,3
Magnuszx,zuljin,288,warrior,arms,6,3,3
Ålbedo,malganis,288,warrior,arms,6,3,3
Girthstick,eredar,288,warrior,arms,6,3,3
Imperiial,stormrage,288,warrior,arms,6,3,3
Assmut,stormrage,288,warrior,arms,6,3,3
Kilrok,thunderlord,288,warrior,arms,6,3,3
Igoon,dentarg,288,warrior,arms,6,3,3
Estiria,kelthuzad,288,warrior,arms,6,3,3
Bøgz,kelthuzad,288,warrior,arms,6,3,3
Daedrion,dalaran,288,warrior,arms,6,3,3
Gläedr,dalaran,288,warrior,arms,6,3,3
Philbert,alexstrasza,288,warrior,arms,6,3,3
Cryptex,illidan,288,warrior,arms,6,3,3
Fakktwo,blackhand,288,warrior,arms,6,3,3
Doucherocket,kelthuzad,288,warrior,arms,6,3,3
Grapegush,bleeding-hollow,288,warrior,arms,6,3,3
Evôlutiôn,kelthuzad,288,warrior,arms,6,3,3
Salveknight,ragnaros,288,warrior,arms,6,3,3
Fyle,stormrage,288,warrior,arms,6,3,3
Hazew,kelthuzad,288,warrior,arms,6,3,3
Drugdilla,zuljin,288,warrior,arms,6,3,3
Allmotor,zuljin,288,warrior,arms,6,3,3
Badboyjan,tichondrius,288,warrior,arms,6,3,3
Wtssap,ragnaros,288,warrior,arms,6,3,3
Ellx,sargeras,288,warrior,arms,6,3,3
Inkurushio,suramar,288,warrior,arms,6,3,3
Dre,anubarak,288,warrior,arms,6,3,3
Biorhn,area-52,288,warrior,arms,6,3,3
Outterspace,illidan,288,warrior,arms,6,3,3
Kokurawr,burning-legion,288,warrior,arms,6,3,3
Yawdamper,illidan,288,warrior,arms,6,3,3
Tokugawaieya,nemesis,288,warrior,arms,6,3,3
Mõgorrin,area-52,288,warrior,arms,6,3,3
Haowar,tichondrius,288,warrior,arms,6,3,3
Rendron,frostmourne,288,warrior,arms,6,3,3
Monardaid,uldum,288,warrior,arms,6,3,3
Retrô,uldum,288,warrior,arms,6,3,3
Seymourbot,illidan,288,warrior,arms,6,3,3
Tread,mugthol,288,warrior,arms,6,3,3
Polox,ragnaros,288,warrior,arms,6,3,3
Bachyr,stormrage,288,warrior,arms,6,3,3
Az,malorne,288,warrior,arms,6,3,3
Faelzerá,azralon,288,warrior,arms,6,3,3
Onebraincell,stormrage,288,warrior,arms,6,3,3
Elessarr,moon-guard,288,warrior,arms,6,3,3
Readytoflee,moon-guard,288,warrior,arms,6,3,3
Demetrïus,moon-guard,288,warrior,arms,6,3,3
Moonsworn,moon-guard,288,warrior,arms,6,3,3
Notawar,stormrage,288,warrior,arms,6,3,3
Taürok,azralon,288,warrior,arms,6,3,3
Venecus,stormrage,288,warrior,arms,6,3,3
Orkussw,illidan,288,warrior,arms,6,3,3
Sambojüjü,stormrage,288,warrior,arms,6,3,3
Croton,moon-guard,288,warrior,arms,6,3,3
Matasimio,drakkari,288,warrior,arms,6,3,3
Caalypso,stormrage,288,warrior,arms,6,3,3
Delphont,stormrage,288,warrior,arms,6,3,3
Kushe,moon-guard,288,warrior,arms,6,3,3
Hukzula,illidan,288,warrior,arms,6,3,3
Endurefen,sargeras,288,warrior,arms,6,3,3
Dublinn,llane,288,warrior,arms,6,3,3
Trackhawk,moon-guard,288,warrior,arms,6,3,3
Osselan,moon-guard,288,warrior,arms,6,3,3
Kryptïç,moon-guard,288,warrior,arms,6,3,3
Mikero,terenas,288,warrior,arms,6,3,3
Clerond,tichondrius,288,warrior,arms,6,3,3
Spirìt,illidan,288,warrior,arms,6,3,3
Buffalobob,bronzebeard,288,warrior,arms,6,3,3
Stewwar,wyrmrest-accord,288,warrior,arms,6,3,3
Deadhawk,wyrmrest-accord,288,warrior,arms,6,3,3
Jasonsdady,illidan,288,warrior,arms,6,3,3
Zemi,sargeras,288,warrior,arms,6,3,3
Varith,sargeras,288,warrior,arms,6,3,3
Jutank,sargeras,288,warrior,arms,6,3,3
Gorek,illidan,288,warrior,arms,6,3,3
Liltotey,frostmourne,288,warrior,arms,6,3,3
Skullsplittr,illidan,288,warrior,arms,6,3,3
Helrise,sargeras,288,warrior,arms,6,3,3
Smashndspin,sargeras,288,warrior,arms,6,3,3
Flynnstone,tichondrius,288,warrior,arms,6,3,3
Robodad,illidan,288,warrior,arms,6,3,3
Kazabare,tichondrius,288,warrior,arms,6,3,3
Heylol,blackhand,288,warrior,arms,6,3,3
Baye,kargath,288,warrior,arms,6,3,3
Vinetic,kiljaeden,288,warrior,arms,6,3,3
Rockybâlboa,illidan,288,warrior,arms,6,3,3
Sodarzok,thaurissan,288,warrior,arms,6,3,3
Davien,tichondrius,288,warrior,arms,6,3,3
Swizzly,tichondrius,288,warrior,arms,6,3,3
Biggieswords,madoran,288,warrior,arms,6,3,3
Dabdaddyy,dawnbringer,288,warrior,arms,6,3,3
Chadwarr,tichondrius,288,warrior,arms,6,3,3
Tharsìs,emerald-dream,288,warrior,arms,6,3,3
Mcluffin,proudmoore,288,warrior,arms,6,3,3
Orryn,proudmoore,288,warrior,arms,6,3,3
Filth,tichondrius,288,warrior,arms,6,3,3
Uzy,proudmoore,288,warrior,arms,6,3,3
Bornclueless,illidan,288,warrior,arms,6,3,3
Tothepain,thrall,288,warrior,arms,6,3,3
Painremaìns,dunemaul,288,warrior,arms,6,3,3
Solembuumm,illidan,288,warrior,arms,6,3,3
Hìtchslap,tichondrius,288,warrior,arms,6,3,3
Êraser,tichondrius,288,warrior,arms,6,3,3
Ðuffman,jubeithos,288,warrior,arms,6,3,3
Chillimus,tichondrius,288,warrior,arms,6,3,3
Sauceslinga,frostmourne,288,warrior,arms,6,3,3
Kuntahkintah,tichondrius,288,warrior,arms,6,3,3
Nazakeen,tichondrius,288,warrior,arms,6,3,3
Cheekclapps,tichondrius,288,warrior,arms,6,3,3
Milbën,tichondrius,288,warrior,arms,6,3,3
Vikkz,frostmourne,288,warrior,arms,6,3,3
Telynne,frostmourne,288,warrior,arms,6,3,3
Robostergler,tichondrius,288,warrior,arms,6,3,3
Swifty,tichondrius,288,warrior,arms,6,3,3
Shiromiya,tichondrius,288,warrior,arms,6,3,3
Kénblock,tichondrius,288,warrior,arms,6,3,3
Husyuzhi,tichondrius,288,warrior,arms,6,3,3
Soyu,tichondrius,288,warrior,arms,6,3,3
Rockhardt,tichondrius,288,warrior,arms,6,3,3
Robio,tichondrius,288,warrior,arms,6,3,3
Huffzo,tichondrius,288,warrior,arms,6,3,3
Slamedi,frostmourne,288,warrior,arms,6,3,3
Thunderess,illidan,288,warrior,arms,6,3,3
Fivewarrior,tichondrius,288,warrior,arms,6,3,3
Tinylimbs,frostmourne,288,warrior,arms,6,3,3
Joran,dathremar,288,warrior,arms,9,4,5
Ohdang,dark-iron,288,warrior,arms,8,3,5
Shewar,ragnaros,288,warrior,arms,9,3,6
Regthar,illidan,288,warrior,arms,11,3,8
Galehna,ragnaros,288,warrior,arms,11,3,8
Smallraccoon,tichondrius,288,warrior,arms,12,3,9
Scrubzwarr,barthilas,288,warrior,arms,12,3,9
Huacai,tichondrius,288,warrior,arms,12,3,9
Brokthard,ragnaros,288,warrior,arms,12,3,9
Edmaghar,ragnaros,288,warrior,arms,12,3,9
Ävdol,emerald-dream,288,warrior,arms,12,3,9
Tsathoggua,kiljaeden,288,warrior,arms,12,3,9
Koberos,queldorei,288,warrior,arms,12,3,9
Legnar,malganis,288,warrior,arms,12,3,9
Odinsglory,mugthol,288,warrior,arms,12,3,9
Kregnar,gundrak,288,warrior,arms,12,3,9
Warrbull,spirestone,288,warrior,arms,12,3,9
Ontull,emerald-dream,288,warrior,arms,12,3,9
Ghianna,quelthalas,288,warrior,arms,12,3,9
Cowboybeast,tanaris,288,warrior,arms,12,3,9
Notoxzy,tichondrius,288,warrior,arms,12,3,9
Kkuzo,bleeding-hollow,288,warrior,arms,12,3,9
Brütalize,wyrmrest-accord,288,warrior,arms,12,3,9
Kero,malganis,288,warrior,arms,12,3,9
Morgithia,suramar,288,warrior,arms,12,3,9
Xdragonfirex,terenas,288,warrior,arms,12,3,9
Kiillwar,smolderthorn,288,warrior,arms,12,3,9
Friendnoodle,frostmourne,288,warrior,arms,12,3,9
Pretending,dalaran,288,warrior,arms,12,3,9
Greenmachine,twisting-nether,288,warrior,arms,12,3,9
Nirax,burning-legion,288,warrior,arms,14,3,11
Gorrthrax,area-52,288,warrior,arms,18,3,15
Khallell,illidan,288,warrior,arms,18,3,15
Kì,moon-guard,287,warrior,arms,6,3,3
Aquannas,bloodscalp,287,warrior,arms,6,3,3
Theøcritus,korgath,287,warrior,arms,6,3,3
Yanïka,barthilas,287,warrior,arms,6,3,3
Tramplehaste,barthilas,287,warrior,arms,6,3,3
Yomaaln,blackrock,287,warrior,arms,6,3,3
Saintgeorge,thorium-brotherhood,287,warrior,arms,6,3,3
Leosax,drakthul,287,warrior,arms,12,3,9
Borgosa,wyrmrest-accord,287,warrior,arms,18,3,15
Såmmÿ,moon-guard,286,warrior,arms,6,3,3
Raktrazbirt,dalaran,286,warrior,arms,6,3,3
Gladiattor,tol-barad,286,warrior,arms,12,3,9
Dazanor,moon-guard,271,warrior,arms,11,3,8
Azindar,gilneas,256,warrior,arms,4,4,0
Thorsën,sargeras,256,warrior,arms,8,4,4
Spicywagyu,tichondrius,255,warrior,arms,11,3,8
Valde,stormrage,240,warrior,arms,9,3,6
Likearock,thrall,239,warrior,arms,5,3,2
Kalphok,tichondrius,239,warrior,arms,5,3,2
ßlitzxkreig,tichondrius,239,warrior,arms,5,3,2
Rynrak,tichondrius,239,warrior,arms,5,3,2
Bersérk,area-52,234,warrior,arms,8,5,3
Nayaqt,tichondrius,223,warrior,arms,8,3,5
Typhön,tichondrius,223,warrior,arms,14,3,11
Condemnd,area-52,207,warrior,arms,8,3,5
Elyn,tichondrius,192,warrior,arms,4,3,1
Cugino,tichondrius,192,warrior,arms,9,3,6
Berru,bleeding-hollow,192,warrior,arms,9,3,6
Icebringer,frostmourne,192,warrior,arms,6,2,4
Neltar,nagrand,192,warrior,arms,6,2,4
Rushour,quelthalas,192,warrior,arms,6,2,4
Anabolicjim,frostmourne,192,warrior,arms,6,2,4
Orcbreaker,quelthalas,192,warrior,arms,6,2,4
Helminth,kirin-tor,192,warrior,arms,6,2,4
Titanrage,tichondrius,192,warrior,arms,6,2,4
Gátzú,ragnaros,192,warrior,arms,6,2,4
Flexid,tichondrius,192,warrior,arms,6,2,4
Endlesskilla,destromath,192,warrior,arms,6,2,4
Irondefense,thrall,192,warrior,arms,6,2,4
Airolol,tichondrius,192,warrior,arms,6,2,4
Thedargz,trollbane,192,warrior,arms,6,2,4
Pippysmallz,tichondrius,192,warrior,arms,6,2,4
Mongofiera,quelthalas,192,warrior,arms,6,2,4
Warney,tichondrius,192,warrior,arms,6,2,4
Loveliuna,illidan,192,warrior,arms,6,2,4
Hbbaboy,nagrand,192,warrior,arms,6,2,4
Annubiis,tichondrius,192,warrior,arms,6,2,4
Bigdickgomez,frostmourne,192,warrior,arms,6,2,4
Shrexecute,tichondrius,192,warrior,arms,6,2,4
Atróx,quelthalas,192,warrior,arms,6,2,4
Lawyer,quelthalas,192,warrior,arms,6,2,4
Aistine,alterac-mountains,192,warrior,arms,6,2,4
Broodthorne,tichondrius,192,warrior,arms,6,2,4
Kratøz,tichondrius,192,warrior,arms,6,2,4
Cupper,tichondrius,192,warrior,arms,6,2,4
Sosaalmigh,tichondrius,192,warrior,arms,6,2,4
Drashka,ragnaros,192,warrior,arms,6,2,4
Esko,tichondrius,192,warrior,arms,6,2,4
Braxxinn,tichondrius,192,warrior,arms,6,2,4
Hagger,quelthalas,192,warrior,arms,6,2,4
Qqmachine,tichondrius,192,warrior,arms,6,2,4
Hugz,thrall,192,warrior,arms,6,2,4
Primørdíal,tichondrius,192,warrior,arms,6,2,4
Sylvannlee,tichondrius,192,warrior,arms,6,2,4
Wxxz,tichondrius,192,warrior,arms,6,2,4
Ningz,tichondrius,192,warrior,arms,6,2,4
Drtbag,tichondrius,192,warrior,arms,6,2,4
Blacksmiff,malganis,192,warrior,arms,6,2,4
Osannd,tichondrius,192,warrior,arms,6,2,4
Shiestyzug,tichondrius,192,warrior,arms,6,2,4
Aventajadu,ragnaros,192,warrior,arms,6,2,4
Linios,tichondrius,192,warrior,arms,6,2,4
Tüssèll,khazgoroth,192,warrior,arms,6,2,4
Spredforbred,area-52,192,warrior,arms,6,2,4
Nogèt,frostmourne,192,warrior,arms,6,2,4
Düde,whisperwind,192,warrior,arms,6,2,4
Brewstrike,dalaran,192,warrior,arms,6,2,4
Brenrainn,thrall,192,warrior,arms,6,2,4
Bladebuster,stormrage,192,warrior,arms,6,2,4
Bbyzugga,kelthuzad,192,warrior,arms,6,2,4
Kamuwarr,azralon,192,warrior,arms,6,2,4
Dahakawar,malganis,192,warrior,arms,6,2,4
Sypii,malganis,192,warrior,arms,6,2,4
Verwischen,zuljin,192,warrior,arms,6,2,4
Befòx,tichondrius,192,warrior,arms,6,2,4
Trouz,ragnaros,192,warrior,arms,6,2,4
Bigdaddyxo,whisperwind,192,warrior,arms,6,2,4
Danskmand,tichondrius,192,warrior,arms,6,2,4
Tsurik,malfurion,192,warrior,arms,6,2,4
Kagerou,ragnaros,192,warrior,arms,6,2,4
Trôca,ragnaros,192,warrior,arms,6,2,4
Fabszord,nemesis,192,warrior,arms,6,2,4
Moosoka,malorne,192,warrior,arms,6,2,4
Riggs,stonemaul,192,warrior,arms,6,2,4
Pép,malganis,192,warrior,arms,6,2,4
Daechoochoo,frostwolf,192,warrior,arms,6,2,4
Flexo,moon-guard,192,warrior,arms,6,2,4
Annihilataur,blackhand,192,warrior,arms,6,2,4
Joekenshield,stonemaul,192,warrior,arms,6,2,4
Vegr,queldorei,192,warrior,arms,6,2,4
Fugmaface,sargeras,192,warrior,arms,6,2,4
Playbox,area-52,192,warrior,arms,6,2,4
Magnar,zuljin,192,warrior,arms,6,2,4
Swìll,illidan,192,warrior,arms,6,2,4
Rahgnarson,kelthuzad,192,warrior,arms,6,2,4
Lgnasty,area-52,192,warrior,arms,6,2,4
Pollere,firetree,192,warrior,arms,6,2,4
Slamzftw,stormreaver,192,warrior,arms,6,2,4
Wolfcultist,moon-guard,192,warrior,arms,6,2,4
Noblêsix,dalaran,192,warrior,arms,6,2,4
Kostikk,tichondrius,192,warrior,arms,6,2,4
Ogpapabear,stormscale,192,warrior,arms,6,2,4
Naelynh,quelthalas,192,warrior,arms,6,2,4
Donni,kelthuzad,192,warrior,arms,6,2,4
Brutekush,barthilas,192,warrior,arms,6,2,4
Rí,moon-guard,192,warrior,arms,6,2,4
Bogii,area-52,192,warrior,arms,6,2,4
Daddymoist,moon-guard,192,warrior,arms,6,2,4
Maxalyss,stormrage,192,warrior,arms,6,2,4
Kirikash,illidan,192,warrior,arms,6,2,4
Jerebeloz,proudmoore,192,warrior,arms,6,2,4
Zerosends,kelthuzad,192,warrior,arms,6,2,4
Deldramor,proudmoore,192,warrior,arms,6,2,4
Kinaed,durotan,192,warrior,arms,6,2,4
Valestrike,moon-guard,192,warrior,arms,6,2,4
Iapologiz,illidan,192,warrior,arms,6,2,4
Xurug,zuljin,192,warrior,arms,6,2,4
Bilmuuri,illidan,192,warrior,arms,6,2,4
Gurgak,illidan,192,warrior,arms,6,2,4
Jakelope,proudmoore,192,warrior,arms,6,2,4
Uprisèn,illidan,192,warrior,arms,6,2,4
Taigola,aggramar,192,warrior,arms,6,2,4
Jäëgër,moon-guard,192,warrior,arms,6,2,4
Orcbum,kiljaeden,192,warrior,arms,6,2,4
Huri,nemesis,192,warrior,arms,6,2,4
Wakkawar,stormrage,192,warrior,arms,6,2,4
Pandamoanman,moon-guard,192,warrior,arms,6,2,4
Squonks,kelthuzad,192,warrior,arms,6,2,4
Ggrone,ragnaros,192,warrior,arms,6,2,4
Bondadoso,stormrage,192,warrior,arms,6,2,4
Chura,kiljaeden,192,warrior,arms,6,2,4
Åmowarr,illidan,192,warrior,arms,6,2,4
Èxecutè,area-52,192,warrior,arms,6,2,4
Relaxnerdlol,antonidas,192,warrior,arms,6,2,4
Ðêad,area-52,192,warrior,arms,6,2,4
Corazondleón,ragnaros,192,warrior,arms,6,2,4
Zekken,blades-edge,192,warrior,arms,6,2,4
Llewellenar,stormrage,192,warrior,arms,6,2,4
Scrubwarrior,black-dragonflight,192,warrior,arms,6,2,4
Thresdan,emerald-dream,192,warrior,arms,6,2,4
Deloum,tichondrius,192,warrior,arms,6,2,4
Luckychaos,bleeding-hollow,192,warrior,arms,6,2,4
Mindgoblin,bleeding-hollow,192,warrior,arms,6,2,4
Ronipastrami,kelthuzad,192,warrior,arms,6,2,4
Negrolas,nemesis,192,warrior,arms,6,2,4
Berserkchow,sargeras,192,warrior,arms,6,2,4
Chronek,sargeras,192,warrior,arms,6,2,4
Reignwolf,azralon,192,warrior,arms,6,2,4
Bkdorbandit,illidan,192,warrior,arms,6,2,4
Tobiwan,ragnaros,192,warrior,arms,6,2,4
Wooglinx,stormrage,192,warrior,arms,6,2,4
Slaten,barthilas,192,warrior,arms,6,2,4
Léonwow,tichondrius,192,warrior,arms,6,2,4
Nordrages,stormrage,192,warrior,arms,6,2,4
Valky,sargeras,192,warrior,arms,6,2,4
Frankal,aegwynn,192,warrior,arms,6,2,4
Hawaiianko,guldan,192,warrior,arms,6,2,4
Akaínu,area-52,192,warrior,arms,6,2,4
Wl,ragnaros,192,warrior,arms,6,2,4
Shrëkslovaki,tichondrius,192,warrior,arms,6,2,4
Flakesskillz,darkspear,192,warrior,arms,6,2,4
Trigon,chromaggus,192,warrior,arms,6,2,4
Guanabacoa,area-52,192,warrior,arms,6,2,4
Vynfull,area-52,192,warrior,arms,6,2,4
Tâte,sargeras,192,warrior,arms,6,2,4
Hellabandz,bleeding-hollow,192,warrior,arms,6,2,4
Sygw,area-52,192,warrior,arms,6,2,4
Uldrath,hyjal,192,warrior,arms,6,2,4
Burstful,bleeding-hollow,192,warrior,arms,6,2,4
Ciskokido,illidan,192,warrior,arms,6,2,4
Ðåddý,stormrage,192,warrior,arms,6,2,4
Hkbdynamus,black-dragonflight,192,warrior,arms,6,2,4
Rekshor,wyrmrest-accord,192,warrior,arms,6,2,4
Minnysota,area-52,192,warrior,arms,6,2,4
Rendus,hyjal,192,warrior,arms,6,2,4
Lopotron,sargeras,192,warrior,arms,6,2,4
Kimuraa,hyjal,192,warrior,arms,6,2,4
Guroku,tichondrius,192,warrior,arms,6,2,4
Hamslamm,area-52,192,warrior,arms,6,2,4
Passionjar,bleeding-hollow,192,warrior,arms,6,2,4
Suhwoosh,bleeding-hollow,192,warrior,arms,10,3,7
Hiddensquids,laughing-skull,192,warrior,arms,11,2,9
Rios,jubeithos,192,warrior,arms,12,2,10
Kurzix,crushridge,192,warrior,arms,12,2,10
Boardslide,proudmoore,192,warrior,arms,12,2,10
Sõnics,tichondrius,192,warrior,arms,12,2,10
Haruq,tichondrius,192,warrior,arms,12,2,10
Warhoofz,malganis,192,warrior,arms,12,2,10
Metalchileno,ragnaros,192,warrior,arms,12,2,10
Gornal,sargeras,192,warrior,arms,12,2,10
Item,nerzhul,192,warrior,arms,12,2,10
Retiarius,tichondrius,192,warrior,arms,12,2,10
Kaimera,echo-isles,192,warrior,arms,12,2,10
Gadderhammer,azgalor,192,warrior,arms,12,2,10
Deathhit,barthilas,191,warrior,arms,6,2,4
Pumpuup,bleeding-hollow,191,warrior,arms,6,2,4
Blackkcow,zuljin,191,warrior,arms,6,2,4
Hazell,gundrak,191,warrior,arms,6,2,4
Krátös,farstriders,191,warrior,arms,6,2,4
Tankadin,dragonmaw,191,warrior,arms,6,2,4
Ybsorc,kelthuzad,160,warrior,arms,10,2,8
Brysontiller,frostmourne,159,warrior,arms,5,2,3
Swordblood,ragnaros,159,warrior,arms,5,2,3
Ediict,illidan,159,warrior,arms,5,2,3
Vapyr,moon-guard,159,warrior,arms,5,2,3
Nècroxious,hellscream,159,warrior,arms,5,2,3
Kellsbro,hyjal,159,warrior,arms,5,2,3
Eatscrayons,barthilas,159,warrior,arms,11,2,9
Randywar,tichondrius,144,warrior,arms,9,2,7
Meadsweats,tichondrius,138,warrior,arms,11,6,5
Strongtall,tichondrius,138,warrior,arms,12,3,9
Syradar,ragnaros,112,warrior,arms,7,2,5
Kevs,sargeras,96,warrior,arms,3,2,1
Ragemane,illidan,96,warrior,arms,3,2,1
Battosaì,bonechewer,96,warrior,arms,3,2,1
Azyxia,emerald-dream,96,warrior,arms,3,2,1
Orgreshin,area-52,96,warrior,arms,3,2,1
Rapcherawr,illidan,96,warrior,arms,3,2,1
Arantxa,destromath,96,warrior,arms,6,1,5
Danzael,quelthalas,96,warrior,arms,6,1,5
Weechubber,bleeding-hollow,96,warrior,arms,6,1,5
Amberlym,ragnaros,96,warrior,arms,6,1,5
Däger,ragnaros,96,warrior,arms,6,1,5
Smoogzz,tichondrius,96,warrior,arms,6,1,5
Warrmachine,scarlet-crusade,96,warrior,arms,6,1,5
Bootysmelly,mannoroth,96,warrior,arms,6,1,5
Zørg,bleeding-hollow,96,warrior,arms,6,1,5
Battlestance,shadowsong,96,warrior,arms,6,1,5
Caynos,stormrage,96,warrior,arms,6,1,5
Roxesc,area-52,96,warrior,arms,6,1,5
Wmuuzh,quelthalas,96,warrior,arms,6,1,5
Cindabotica,sargeras,96,warrior,arms,6,1,5
Kintownhero,aegwynn,96,warrior,arms,6,1,5
Sneeze,kul-tiras,96,warrior,arms,6,1,5
Jimhoffa,bonechewer,96,warrior,arms,6,1,5
Klobnslob,mannoroth,96,warrior,arms,6,1,5
Immortal,icecrown,96,warrior,arms,6,1,5
Dámöuse,stormrage,96,warrior,arms,6,1,5
Doriax,sentinels,96,warrior,arms,6,1,5
Erhue,sargeras,96,warrior,arms,6,1,5
Bootstraps,hyjal,96,warrior,arms,6,1,5
Dokoba,bleeding-hollow,96,warrior,arms,6,1,5
Bhuppzz,barthilas,96,warrior,arms,6,1,5
Neotico,quelthalas,96,warrior,arms,6,1,5
Flabergaster,skullcrusher,96,warrior,arms,6,1,5
Codey,stormrage,96,warrior,arms,6,1,5
Rollz,amanthul,96,warrior,arms,6,1,5
Kanekhy,ragnaros,96,warrior,arms,6,1,5
Beatmeat,frostmourne,96,warrior,arms,6,1,5
Zépileque,azralon,96,warrior,arms,6,1,5
Adav,arthas,96,warrior,arms,6,1,5
Blitzkrieegz,drakkari,96,warrior,arms,6,1,5
Vayper,illidan,96,warrior,arms,6,1,5
Meytuglin,stormrage,96,warrior,arms,6,1,5
Paralyzed,malganis,96,warrior,arms,6,1,5
Berawar,tichondrius,96,warrior,arms,6,1,5
Tangö,barthilas,96,warrior,arms,6,1,5
Draxxarlol,zuljin,96,warrior,arms,6,1,5
Beenbag,aerie-peak,96,warrior,arms,6,1,5
Kevinersaa,frostmourne,96,warrior,arms,6,1,5
Killimanjaro,aggramar,96,warrior,arms,6,1,5
Eightballerz,barthilas,96,warrior,arms,6,1,5
Callad,tichondrius,96,warrior,arms,6,1,5
Tfd,tichondrius,96,warrior,arms,6,1,5
Ohhgeekush,proudmoore,96,warrior,arms,6,1,5
Augutra,moon-guard,96,warrior,arms,6,1,5
Vhagaar,emerald-dream,96,warrior,arms,6,1,5
Goywarr,illidan,96,warrior,arms,6,1,5
Sugarpanties,moon-guard,96,warrior,arms,6,1,5
Alvitr,kelthuzad,96,warrior,arms,6,1,5
Beastro,rexxar,96,warrior,arms,6,1,5
Devilsbane,khaz-modan,96,warrior,arms,6,1,5
Kluster,kelthuzad,96,warrior,arms,6,1,5
Gorgan,ragnaros,96,warrior,arms,6,1,5
Skärz,azshara,96,warrior,arms,6,1,5
Jazz,frostwolf,96,warrior,arms,6,1,5
Kåyotix,proudmoore,96,warrior,arms,6,1,5
Beatstickz,malganis,96,warrior,arms,6,1,5
Erwin,kiljaeden,96,warrior,arms,6,1,5
Berzerk,dentarg,96,warrior,arms,6,1,5
Aidenwr,area-52,96,warrior,arms,6,1,5
Hergo,spirestone,96,warrior,arms,6,1,5
Porori,proudmoore,96,warrior,arms,6,1,5
Kargan,thrall,96,warrior,arms,6,1,5
Ghostierip,illidan,96,warrior,arms,6,1,5
Wolurog,emerald-dream,96,warrior,arms,6,1,5
Flexxinpapi,exodar,96,warrior,arms,6,1,5
Grosjambes,turalyon,96,warrior,arms,6,1,5
Wienertoes,tichondrius,96,warrior,arms,6,1,5
Dogmar,moon-guard,96,warrior,arms,6,1,5
Soymong,frostmourne,96,warrior,arms,6,1,5
Durseyturm,area-52,96,warrior,arms,6,1,5
Xkickaxes,tichondrius,96,warrior,arms,6,1,5
Fréäkk,ragnaros,96,warrior,arms,6,1,5
Faintswar,stormrage,96,warrior,arms,6,1,5
Bigwarrior,stonemaul,96,warrior,arms,6,1,5
Noktyn,haomarush,96,warrior,arms,6,1,5
Shagstrike,azralon,96,warrior,arms,6,1,5
Montibello,moon-guard,96,warrior,arms,6,1,5
Ryank,bonechewer,96,warrior,arms,6,1,5
Uub,malganis,96,warrior,arms,6,1,5
Baaltica,ragnaros,96,warrior,arms,6,1,5
Gordurin,akama,96,warrior,arms,6,1,5
Ragnarloðbró,tichondrius,96,warrior,arms,6,1,5
Odyssey,vashj,96,warrior,arms,12,1,11
Bushwook,emerald-dream,96,warrior,arms,12,1,11
Dicedup,stormrage,96,warrior,arms,12,1,11
Falkur,amanthul,96,warrior,arms,12,1,11
Macbride,blackrock,96,warrior,arms,12,1,11
Drdalidou,zuljin,96,warrior,arms,12,1,11
Møønnlight,quelthalas,79,warrior,arms,5,1,4
Rokmok,frostmane,79,warrior,arms,5,1,4
Roxon,hellscream,79,warrior,arms,5,1,4
Loomine,illidan,79,warrior,arms,5,1,4
Savagetko,illidan,79,warrior,arms,5,1,4
Garrossh,thunderhorn,64,warrior,arms,4,1,3
Haveya,ghostlands,48,warrior,arms,3,1,2
Warriorba,tichondrius,48,warrior,arms,3,1,2
Rumka,draktharon,42,warrior,arms,6,2,4
Goofyahwok,doomhammer,42,warrior,arms,9,2,7
Billy,area-52,31,warrior,arms,2,1,1
Shwutty,stormrage,16,warrior,arms,1,1,0
Zachw,stormrage,16,warrior,arms,1,1,0
Berserko,gurubashi,16,warrior,arms,1,1,0
Psyrush,area-52,16,warrior,arms,7,1,6
Americanbull,moon-guard,1455,warrior,protection,62,34,28
Graventhal,tichondrius,1192,warrior,protection,47,22,25
Appolyonn,hyjal,855,warrior,protection,30,12,18
Thororan,whisperwind,845,warrior,protection,27,10,17
Logan,twisting-nether,564,warrior,protection,14,6,8
Mileigh,kelthuzad,479,warrior,protection,18,5,13
Stophitingme,bloodscalp,469,warrior,protection,18,5,13
Dabdaddyy,dawnbringer,384,warrior,protection,6,4,2
Percaderp,barthilas,384,warrior,protection,6,4,2
Kidkolby,moon-guard,384,warrior,protection,12,4,8
Ksubîî,frostmourne,288,warrior,protection,6,3,3
Toothnnailz,destromath,284,warrior,protection,12,3,9
Executespam,madoran,192,warrior,protection,6,2,4
Littlefatman,terokkar,192,warrior,protection,12,2,10
Jindyn,boulderfist,95,warrior,protection,6,1,5
