realm,rating,cls,spec,play,win,lose
bleeding-hollow,1523,deathknight,blood,60,31,29
moon-guard,1144,deathknight,blood,60,23,37
bleeding-hollow,1046,deathknight,blood,30,11,19
eredar,854,deathknight,blood,18,9,9
malganis,575,deathknight,blood,12,6,6
sargeras,477,deathknight,blood,12,5,7
area-52,384,deathknight,blood,6,4,2
area-52,288,deathknight,blood,12,3,9
misha,191,deathknight,blood,12,2,10
barthilas,96,deathknight,blood,6,1,5
firetree,96,deathknight,blood,6,1,5
darkspear,96,deathknight,blood,6,1,5
bleeding-hollow,64,deathknight,blood,4,1,3
malganis,2107,deathknight,unholy,134,70,64
illidan,2105,deathknight,unholy,98,53,45
area-52,2105,deathknight,unholy,83,43,40
tichondrius,2041,deathknight,unholy,78,41,37
illidan,1993,deathknight,unholy,65,31,34
tichondrius,1976,deathknight,unholy,48,30,18
kelthuzad,1948,deathknight,unholy,228,115,113
malganis,1945,deathknight,unholy,58,27,31
thrall,1934,deathknight,unholy,68,42,26
sargeras,1919,deathknight,unholy,132,61,71
illidan,1917,deathknight,unholy,85,41,44
tichondrius,1915,deathknight,unholy,41,21,20
kelthuzad,1914,deathknight,unholy,67,31,36
tichondrius,1913,deathknight,unholy,76,32,44
malganis,1912,deathknight,unholy,72,41,31
sargeras,1901,deathknight,unholy,114,51,63
tichondrius,1901,deathknight,unholy,71,31,40
the-scryers,1900,deathknight,unholy,83,47,36
tichondrius,1889,deathknight,unholy,60,33,27
area-52,1884,deathknight,unholy,101,48,53
ragnaros,1881,deathknight,unholy,48,25,23
malganis,1879,deathknight,unholy,84,42,42
tichondrius,1876,deathknight,unholy,151,77,74
zuljin,1869,deathknight,unholy,50,31,19
moon-guard,1865,deathknight,unholy,220,104,116
area-52,1861,deathknight,unholy,42,22,20
azralon,1860,deathknight,unholy,106,53,53
area-52,1859,deathknight,unholy,55,30,25
tichondrius,1855,deathknight,unholy,118,58,60
stormrage,1849,deathknight,unholy,87,49,38
black-dragonflight,1848,deathknight,unholy,96,51,45
quelthalas,1846,deathknight,unholy,72,34,38
kargath,1841,deathknight,unholy,103,60,43
doomhammer,1834,deathknight,unholy,78,43,35
stormrage,1832,deathknight,unholy,36,22,14
ragnaros,1827,deathknight,unholy,42,21,21
blackrock,1825,deathknight,unholy,54,32,22
grizzly-hills,1822,deathknight,unholy,65,27,38
stormrage,1820,deathknight,unholy,59,31,28
tichondrius,1818,deathknight,unholy,60,27,33
malganis,1816,deathknight,unholy,56,27,29
maiev,1809,deathknight,unholy,113,60,53
tichondrius,1807,deathknight,unholy,59,35,24
area-52,1806,deathknight,unholy,54,25,29
area-52,1806,deathknight,unholy,76,35,41
ragnaros,1803,deathknight,unholy,66,29,37
tichondrius,1800,deathknight,unholy,70,39,31
proudmoore,1800,deathknight,unholy,37,20,17
sargeras,1800,deathknight,unholy,118,59,59
tichondrius,1798,deathknight,unholy,102,51,51
tichondrius,1793,deathknight,unholy,41,30,11
bleeding-hollow,1790,deathknight,unholy,42,19,23
emerald-dream,1784,deathknight,unholy,56,28,28
tichondrius,1775,deathknight,unholy,42,22,20
tichondrius,1766,deathknight,unholy,75,31,44
shandris,1763,deathknight,unholy,99,49,50
firetree,1761,deathknight,unholy,67,35,32
bleeding-hollow,1756,deathknight,unholy,66,29,37
tichondrius,1751,deathknight,unholy,48,26,22
tichondrius,1748,deathknight,unholy,54,21,33
proudmoore,1747,deathknight,unholy,147,77,70
area-52,1746,deathknight,unholy,89,40,49
gilneas,1745,deathknight,unholy,72,40,32
quelthalas,1734,deathknight,unholy,74,36,38
barthilas,1732,deathknight,unholy,63,36,27
frostmourne,1728,deathknight,unholy,276,143,133
jubeithos,1721,deathknight,unholy,63,35,28
area-52,1718,deathknight,unholy,78,36,42
stormrage,1712,deathknight,unholy,48,24,24
area-52,1710,deathknight,unholy,64,36,28
drakkari,1710,deathknight,unholy,84,45,39
azralon,1707,deathknight,unholy,75,36,39
steamwheedle-cartel,1706,deathknight,unholy,36,18,18
stormrage,1706,deathknight,unholy,54,25,29
frostmourne,1690,deathknight,unholy,84,44,40
tichondrius,1690,deathknight,unholy,100,50,50
azralon,1690,deathknight,unholy,36,18,18
lightnings-blade,1688,deathknight,unholy,54,28,26
ragnaros,1687,deathknight,unholy,30,19,11
andorhal,1675,deathknight,unholy,72,31,41
tichondrius,1673,deathknight,unholy,39,22,17
tichondrius,1672,deathknight,unholy,78,38,40
tichondrius,1672,deathknight,unholy,66,27,39
quelthalas,1672,deathknight,unholy,67,25,42
tichondrius,1670,deathknight,unholy,40,21,19
tichondrius,1667,deathknight,unholy,42,23,19
malganis,1667,deathknight,unholy,42,23,19
barthilas,1663,deathknight,unholy,137,69,68
moon-guard,1663,deathknight,unholy,119,58,61
aggramar,1662,deathknight,unholy,35,20,15
moon-guard,1658,deathknight,unholy,72,40,32
sargeras,1650,deathknight,unholy,60,31,29
thrall,1644,deathknight,unholy,41,23,18
bonechewer,1642,deathknight,unholy,86,49,37
tichondrius,1638,deathknight,unholy,41,18,23
nagrand,1635,deathknight,unholy,41,22,19
the-venture-co,1634,deathknight,unholy,78,47,31
quelthalas,1634,deathknight,unholy,102,54,48
gorefiend,1632,deathknight,unholy,60,29,31
azralon,1629,deathknight,unholy,53,30,23
quelthalas,1628,deathknight,unholy,40,25,15
emerald-dream,1628,deathknight,unholy,67,37,30
malganis,1628,deathknight,unholy,84,39,45
proudmoore,1627,deathknight,unholy,191,97,94
thrall,1625,deathknight,unholy,71,39,32
tichondrius,1624,deathknight,unholy,61,26,35
tichondrius,1622,deathknight,unholy,30,17,13
darrowmere,1618,deathknight,unholy,36,23,13
garona,1618,deathknight,unholy,64,33,31
azralon,1616,deathknight,unholy,41,20,21
ragnaros,1615,deathknight,unholy,96,45,51
tichondrius,1614,deathknight,unholy,51,26,25
sargeras,1612,deathknight,unholy,42,21,21
vashj,1610,deathknight,unholy,35,22,13
daggerspine,1608,deathknight,unholy,36,20,16
azralon,1605,deathknight,unholy,108,63,45
sargeras,1604,deathknight,unholy,42,21,21
tichondrius,1604,deathknight,unholy,42,20,22
malganis,1604,deathknight,unholy,36,17,19
azralon,1604,deathknight,unholy,90,39,51
bleeding-hollow,1603,deathknight,unholy,95,53,42
tichondrius,1603,deathknight,unholy,78,42,36
moon-guard,1603,deathknight,unholy,54,28,26
perenolde,1602,deathknight,unholy,83,35,48
sargeras,1600,deathknight,unholy,36,21,15
moon-guard,1596,deathknight,unholy,60,35,25
moon-guard,1596,deathknight,unholy,42,23,19
wyrmrest-accord,1592,deathknight,unholy,85,43,42
saurfang,1574,deathknight,unholy,41,20,21
stormrage,1573,deathknight,unholy,40,20,20
tichondrius,1572,deathknight,unholy,30,20,10
ragnaros,1571,deathknight,unholy,42,23,19
sargeras,1568,deathknight,unholy,51,27,24
illidan,1565,deathknight,unholy,71,37,34
illidan,1564,deathknight,unholy,61,24,37
sargeras,1556,deathknight,unholy,53,28,25
area-52,1555,deathknight,unholy,30,21,9
sargeras,1554,deathknight,unholy,62,29,33
dalaran,1551,deathknight,unholy,36,20,16
proudmoore,1550,deathknight,unholy,90,48,42
ragnaros,1549,deathknight,unholy,46,17,29
illidan,1542,deathknight,unholy,66,34,32
quelthalas,1541,deathknight,unholy,63,31,32
frostmourne,1538,deathknight,unholy,44,17,27
azralon,1533,deathknight,unholy,90,45,45
sargeras,1531,deathknight,unholy,43,26,17
tichondrius,1531,deathknight,unholy,30,16,14
illidan,1530,deathknight,unholy,24,16,8
moonrunner,1530,deathknight,unholy,39,23,16
malganis,1528,deathknight,unholy,23,17,6
ragnaros,1521,deathknight,unholy,33,17,16
tichondrius,1519,deathknight,unholy,36,17,19
proudmoore,1516,deathknight,unholy,66,29,37
stormreaver,1513,deathknight,unholy,30,16,14
quelthalas,1513,deathknight,unholy,106,48,58
area-52,1513,deathknight,unholy,36,16,20
ragnaros,1505,deathknight,unholy,24,20,4
gorefiend,1505,deathknight,unholy,77,43,34
illidan,1504,deathknight,unholy,175,91,84
maiev,1504,deathknight,unholy,81,31,50
azralon,1502,deathknight,unholy,89,43,46
arthas,1498,deathknight,unholy,59,30,29
ragnaros,1492,deathknight,unholy,54,25,29
area-52,1492,deathknight,unholy,58,24,34
bleeding-hollow,1490,deathknight,unholy,56,25,31
tichondrius,1488,deathknight,unholy,49,28,21
firetree,1483,deathknight,unholy,66,40,26
sargeras,1483,deathknight,unholy,33,16,17
azralon,1482,deathknight,unholy,42,25,17
illidan,1482,deathknight,unholy,66,36,30
tichondrius,1481,deathknight,unholy,145,77,68
garrosh,1477,deathknight,unholy,66,32,34
kelthuzad,1476,deathknight,unholy,41,16,25
proudmoore,1474,deathknight,unholy,30,17,13
moon-guard,1474,deathknight,unholy,101,52,49
tichondrius,1466,deathknight,unholy,54,24,30
zuljin,1461,deathknight,unholy,54,24,30
tichondrius,1458,deathknight,unholy,83,35,48
blackhand,1457,deathknight,unholy,97,58,39
malganis,1455,deathknight,unholy,132,66,66
shattered-hand,1448,deathknight,unholy,70,36,34
malfurion,1447,deathknight,unholy,38,17,21
kelthuzad,1445,deathknight,unholy,29,16,13
malganis,1442,deathknight,unholy,42,26,16
dalaran,1442,deathknight,unholy,211,110,101
malganis,1438,deathknight,unholy,30,17,13
frostmourne,1437,deathknight,unholy,31,16,15
kelthuzad,1434,deathknight,unholy,54,27,27
tichondrius,1434,deathknight,unholy,30,15,15
cenarion-circle,1432,deathknight,unholy,24,15,9
tichondrius,1430,deathknight,unholy,48,15,33
area-52,1429,deathknight,unholy,40,16,24
tichondrius,1426,deathknight,unholy,24,15,9
korgath,1423,deathknight,unholy,24,15,9
zuljin,1422,deathknight,unholy,24,15,9
shattered-hand,1422,deathknight,unholy,36,19,17
ysera,1420,deathknight,unholy,97,43,54
ragnaros,1415,deathknight,unholy,35,19,16
tichondrius,1414,deathknight,unholy,30,19,11
chogall,1414,deathknight,unholy,30,15,15
frostwolf,1405,deathknight,unholy,66,29,37
malganis,1398,deathknight,unholy,85,40,45
wyrmrest-accord,1384,deathknight,unholy,67,35,32
frostmourne,1381,deathknight,unholy,75,36,39
ghostlands,1380,deathknight,unholy,50,26,24
tichondrius,1375,deathknight,unholy,42,21,21
illidan,1374,deathknight,unholy,24,16,8
bleeding-hollow,1374,deathknight,unholy,41,23,18
tichondrius,1372,deathknight,unholy,30,15,15
illidan,1367,deathknight,unholy,33,16,17
borean-tundra,1364,deathknight,unholy,72,32,40
ragnaros,1361,deathknight,unholy,63,38,25
quelthalas,1357,deathknight,unholy,67,31,36
sargeras,1356,deathknight,unholy,57,24,33
stormrage,1354,deathknight,unholy,90,49,41
blackrock,1349,deathknight,unholy,45,24,21
shandris,1343,deathknight,unholy,93,47,46
tichondrius,1342,deathknight,unholy,24,14,10
ragnaros,1342,deathknight,unholy,36,14,22
ragnaros,1339,deathknight,unholy,24,14,10
arthas,1335,deathknight,unholy,46,19,27
illidan,1333,deathknight,unholy,36,14,22
tichondrius,1332,deathknight,unholy,78,38,40
stormrage,1330,deathknight,unholy,52,18,34
proudmoore,1326,deathknight,unholy,30,14,16
lightbringer,1321,deathknight,unholy,100,51,49
dalaran,1321,deathknight,unholy,30,15,15
area-52,1321,deathknight,unholy,30,14,16
moon-guard,1320,deathknight,unholy,60,30,30
hyjal,1316,deathknight,unholy,30,17,13
moon-guard,1315,deathknight,unholy,151,77,74
norgannon,1307,deathknight,unholy,49,23,26
area-52,1306,deathknight,unholy,72,32,40
moon-guard,1304,deathknight,unholy,44,20,24
tichondrius,1304,deathknight,unholy,40,14,26
emerald-dream,1299,deathknight,unholy,36,15,21
draka,1292,deathknight,unholy,28,14,14
sargeras,1290,deathknight,unholy,25,16,9
stormrage,1279,deathknight,unholy,29,18,11
aegwynn,1274,deathknight,unholy,32,14,18
kelthuzad,1273,deathknight,unholy,60,35,25
thrall,1271,deathknight,unholy,24,14,10
barthilas,1267,deathknight,unholy,57,25,32
wyrmrest-accord,1265,deathknight,unholy,42,19,23
misha,1258,deathknight,unholy,72,37,35
ragnaros,1252,deathknight,unholy,48,25,23
moon-guard,1249,deathknight,unholy,45,24,21
ragnaros,1249,deathknight,unholy,50,25,25
tichondrius,1248,deathknight,unholy,24,13,11
stormrage,1248,deathknight,unholy,48,21,27
illidan,1247,deathknight,unholy,24,13,11
tichondrius,1247,deathknight,unholy,36,13,23
ragnaros,1246,deathknight,unholy,63,32,31
tichondrius,1246,deathknight,unholy,30,13,17
tichondrius,1246,deathknight,unholy,30,13,17
frostmourne,1242,deathknight,unholy,30,13,17
tichondrius,1239,deathknight,unholy,24,14,10
quelthalas,1239,deathknight,unholy,84,34,50
kelthuzad,1238,deathknight,unholy,36,13,23
stormrage,1234,deathknight,unholy,18,13,5
kelthuzad,1231,deathknight,unholy,24,13,11
tichondrius,1226,deathknight,unholy,31,13,18
malganis,1223,deathknight,unholy,36,19,17
dalaran,1222,deathknight,unholy,30,13,17
area-52,1221,deathknight,unholy,33,14,19
sargeras,1220,deathknight,unholy,66,30,36
doomhammer,1217,deathknight,unholy,68,35,33
nemesis,1207,deathknight,unholy,54,25,29
ragnaros,1206,deathknight,unholy,29,13,16
bleeding-hollow,1192,deathknight,unholy,38,15,23
sargeras,1166,deathknight,unholy,36,19,17
kelthuzad,1165,deathknight,unholy,30,14,16
tichondrius,1152,deathknight,unholy,24,12,12
tichondrius,1152,deathknight,unholy,24,12,12
bleeding-hollow,1152,deathknight,unholy,30,12,18
tichondrius,1151,deathknight,unholy,24,12,12
blackrock,1150,deathknight,unholy,30,12,18
borean-tundra,1149,deathknight,unholy,24,12,12
tichondrius,1149,deathknight,unholy,36,12,24
tichondrius,1148,deathknight,unholy,24,12,12
area-52,1148,deathknight,unholy,30,12,18
azralon,1148,deathknight,unholy,41,15,26
queldorei,1148,deathknight,unholy,36,13,23
thunderlord,1147,deathknight,unholy,25,12,13
kiljaeden,1146,deathknight,unholy,18,12,6
ragnaros,1143,deathknight,unholy,18,12,6
kelthuzad,1142,deathknight,unholy,18,12,6
anvilmar,1140,deathknight,unholy,24,12,12
emerald-dream,1139,deathknight,unholy,24,12,12
tichondrius,1139,deathknight,unholy,30,12,18
sargeras,1138,deathknight,unholy,18,12,6
sargeras,1135,deathknight,unholy,18,12,6
tichondrius,1135,deathknight,unholy,19,12,7
area-52,1121,deathknight,unholy,24,12,12
sargeras,1102,deathknight,unholy,26,13,13
nemesis,1100,deathknight,unholy,29,15,14
gorgonnash,1097,deathknight,unholy,72,37,35
kelthuzad,1090,deathknight,unholy,23,12,11
tichondrius,1085,deathknight,unholy,22,12,10
illidan,1084,deathknight,unholy,32,12,20
stormrage,1056,deathknight,unholy,18,11,7
tichondrius,1056,deathknight,unholy,24,11,13
azralon,1056,deathknight,unholy,24,11,13
thrall,1054,deathknight,unholy,18,11,7
blades-edge,1053,deathknight,unholy,18,11,7
barthilas,1053,deathknight,unholy,30,11,19
stormrage,1053,deathknight,unholy,36,11,25
shadowmoon,1051,deathknight,unholy,30,11,19
the-venture-co,1050,deathknight,unholy,24,11,13
shadowmoon,1049,deathknight,unholy,18,11,7
hyjal,1044,deathknight,unholy,30,18,12
zuljin,1026,deathknight,unholy,74,35,39
darrowmere,1023,deathknight,unholy,36,22,14
tichondrius,1023,deathknight,unholy,40,11,29
azralon,1016,deathknight,unholy,106,51,55
azralon,1006,deathknight,unholy,26,11,15
zuljin,996,deathknight,unholy,18,11,7
moon-guard,990,deathknight,unholy,17,11,6
azjolnerub,963,deathknight,unholy,55,20,35
bleeding-hollow,960,deathknight,unholy,12,10,2
malganis,960,deathknight,unholy,18,10,8
caelestrasz,960,deathknight,unholy,78,26,52
illidan,959,deathknight,unholy,12,10,2
illidan,959,deathknight,unholy,20,11,9
quelthalas,959,deathknight,unholy,24,10,14
illidan,959,deathknight,unholy,24,10,14
tichondrius,958,deathknight,unholy,12,10,2
wyrmrest-accord,958,deathknight,unholy,24,10,14
wyrmrest-accord,956,deathknight,unholy,18,10,8
bonechewer,956,deathknight,unholy,30,10,20
kiljaeden,956,deathknight,unholy,30,10,20
sargeras,955,deathknight,unholy,18,10,8
nemesis,955,deathknight,unholy,30,10,20
tichondrius,949,deathknight,unholy,18,10,8
eredar,947,deathknight,unholy,18,10,8
thrall,943,deathknight,unholy,18,10,8
azralon,937,deathknight,unholy,28,11,17
zuluhed,934,deathknight,unholy,18,10,8
zuluhed,876,deathknight,unholy,24,12,12
muradin,876,deathknight,unholy,38,17,21
illidan,864,deathknight,unholy,12,9,3
tichondrius,864,deathknight,unholy,18,9,9
barthilas,864,deathknight,unholy,24,9,15
sargeras,864,deathknight,unholy,24,9,15
area-52,864,deathknight,unholy,30,9,21
kelthuzad,863,deathknight,unholy,12,9,3
moon-guard,863,deathknight,unholy,18,9,9
blood-furnace,863,deathknight,unholy,18,9,9
skullcrusher,862,deathknight,unholy,18,9,9
ragnaros,862,deathknight,unholy,24,9,15
area-52,861,deathknight,unholy,18,9,9
tichondrius,861,deathknight,unholy,18,9,9
smolderthorn,861,deathknight,unholy,24,10,14
malganis,860,deathknight,unholy,12,9,3
ragnaros,860,deathknight,unholy,18,9,9
illidan,860,deathknight,unholy,24,9,15
stormreaver,859,deathknight,unholy,18,9,9
spinebreaker,859,deathknight,unholy,21,10,11
kalecgos,859,deathknight,unholy,19,9,10
tichondrius,857,deathknight,unholy,18,9,9
aerie-peak,856,deathknight,unholy,24,9,15
eredar,854,deathknight,unholy,18,9,9
malganis,853,deathknight,unholy,18,9,9
lightbringer,853,deathknight,unholy,30,9,21
illidan,850,deathknight,unholy,18,9,9
trollbane,828,deathknight,unholy,18,9,9
azralon,815,deathknight,unholy,17,9,8
drakkari,796,deathknight,unholy,14,9,5
tichondrius,793,deathknight,unholy,14,9,5
dathremar,792,deathknight,unholy,14,9,5
illidan,768,deathknight,unholy,12,8,4
illidan,768,deathknight,unholy,15,9,6
stormrage,768,deathknight,unholy,18,8,10
tichondrius,768,deathknight,unholy,18,8,10
tichondrius,768,deathknight,unholy,18,8,10
stormrage,768,deathknight,unholy,18,8,10
sargeras,768,deathknight,unholy,24,8,16
thrall,768,deathknight,unholy,24,8,16
area-52,768,deathknight,unholy,24,8,16
gorefiend,768,deathknight,unholy,24,8,16
proudmoore,768,deathknight,unholy,30,8,22
bleeding-hollow,767,deathknight,unholy,12,8,4
area-52,767,deathknight,unholy,18,8,10
illidan,767,deathknight,unholy,18,8,10
kelthuzad,767,deathknight,unholy,18,8,10
shadow-council,766,deathknight,unholy,12,8,4
saurfang,765,deathknight,unholy,12,8,4
drakkari,765,deathknight,unholy,18,8,10
malganis,765,deathknight,unholy,18,8,10
tichondrius,761,deathknight,unholy,24,10,14
area-52,735,deathknight,unholy,17,8,9
tichondrius,720,deathknight,unholy,27,8,19
quelthalas,719,deathknight,unholy,17,8,9
twisting-nether,719,deathknight,unholy,17,8,9
malganis,717,deathknight,unholy,17,8,9
darkspear,712,deathknight,unholy,18,9,9
sargeras,703,deathknight,unholy,16,8,8
tichondrius,700,deathknight,unholy,14,8,6
drakkari,672,deathknight,unholy,12,7,5
korgath,672,deathknight,unholy,12,7,5
frostmourne,672,deathknight,unholy,12,7,5
sargeras,672,deathknight,unholy,12,7,5
sargeras,672,deathknight,unholy,12,7,5
tichondrius,672,deathknight,unholy,12,7,5
ysera,672,deathknight,unholy,12,7,5
tichondrius,672,deathknight,unholy,12,7,5
emerald-dream,672,deathknight,unholy,12,7,5
stormrage,672,deathknight,unholy,12,7,5
tichondrius,672,deathknight,unholy,12,7,5
bleeding-hollow,672,deathknight,unholy,12,7,5
tichondrius,672,deathknight,unholy,12,7,5
ravenholdt,672,deathknight,unholy,12,7,5
illidan,672,deathknight,unholy,12,7,5
barthilas,672,deathknight,unholy,12,7,5
stormrage,672,deathknight,unholy,18,7,11
dalaran,672,deathknight,unholy,18,7,11
malganis,672,deathknight,unholy,18,7,11
tichondrius,672,deathknight,unholy,18,7,11
area-52,672,deathknight,unholy,18,7,11
darkspear,672,deathknight,unholy,18,7,11
tichondrius,672,deathknight,unholy,18,7,11
illidan,672,deathknight,unholy,24,7,17
crushridge,672,deathknight,unholy,30,7,23
area-52,671,deathknight,unholy,12,7,5
cairne,671,deathknight,unholy,12,7,5
zuljin,671,deathknight,unholy,12,7,5
llane,671,deathknight,unholy,12,7,5
nemesis,671,deathknight,unholy,15,8,7
emerald-dream,671,deathknight,unholy,18,7,11
archimonde,671,deathknight,unholy,18,7,11
quelthalas,671,deathknight,unholy,30,7,23
frostmourne,669,deathknight,unholy,12,7,5
tichondrius,669,deathknight,unholy,12,7,5
dragonmaw,667,deathknight,unholy,12,7,5
illidan,666,deathknight,unholy,21,8,13
moon-guard,665,deathknight,unholy,12,7,5
dentarg,649,deathknight,unholy,18,7,11
azralon,620,deathknight,unholy,17,7,10
quelthalas,591,deathknight,unholy,11,7,4
area-52,576,deathknight,unholy,12,6,6
tichondrius,576,deathknight,unholy,12,6,6
tichondrius,576,deathknight,unholy,12,6,6
ragnaros,576,deathknight,unholy,12,6,6
malganis,576,deathknight,unholy,12,6,6
nemesis,576,deathknight,unholy,12,6,6
stormrage,576,deathknight,unholy,12,6,6
sargeras,576,deathknight,unholy,12,6,6
tichondrius,576,deathknight,unholy,12,6,6
moon-guard,576,deathknight,unholy,12,6,6
proudmoore,576,deathknight,unholy,12,6,6
ragnaros,576,deathknight,unholy,12,6,6
ragnaros,576,deathknight,unholy,12,6,6
doomhammer,576,deathknight,unholy,12,6,6
destromath,576,deathknight,unholy,12,6,6
illidan,576,deathknight,unholy,12,6,6
zuljin,576,deathknight,unholy,12,6,6
arthas,576,deathknight,unholy,12,6,6
ysera,576,deathknight,unholy,12,6,6
bladefist,576,deathknight,unholy,12,6,6
azgalor,576,deathknight,unholy,12,6,6
caelestrasz,576,deathknight,unholy,12,6,6
illidan,576,deathknight,unholy,12,6,6
ragnaros,576,deathknight,unholy,18,6,12
ragnaros,576,deathknight,unholy,18,6,12
agamaggan,576,deathknight,unholy,18,6,12
kul-tiras,576,deathknight,unholy,18,6,12
bleeding-hollow,576,deathknight,unholy,19,6,13
tichondrius,576,deathknight,unholy,24,6,18
zuljin,576,deathknight,unholy,24,6,18
drenden,576,deathknight,unholy,24,6,18
tichondrius,575,deathknight,unholy,12,6,6
nemesis,575,deathknight,unholy,12,6,6
darkspear,575,deathknight,unholy,12,6,6
skullcrusher,575,deathknight,unholy,12,6,6
uther,575,deathknight,unholy,12,6,6
quelthalas,575,deathknight,unholy,12,6,6
executus,575,deathknight,unholy,12,6,6
muradin,575,deathknight,unholy,18,6,12
tichondrius,575,deathknight,unholy,18,6,12
bonechewer,574,deathknight,unholy,12,6,6
ragnaros,574,deathknight,unholy,18,6,12
darkspear,574,deathknight,unholy,18,6,12
bonechewer,572,deathknight,unholy,12,6,6
kiljaeden,572,deathknight,unholy,18,6,12
hakkar,571,deathknight,unholy,12,6,6
stormreaver,559,deathknight,unholy,23,6,17
barthilas,558,deathknight,unholy,13,7,6
area-52,543,deathknight,unholy,11,6,5
area-52,527,deathknight,unholy,11,6,5
tichondrius,522,deathknight,unholy,21,8,13
tichondrius,522,deathknight,unholy,22,7,15
eitrigg,512,deathknight,unholy,16,6,10
malganis,511,deathknight,unholy,11,6,5
kelthuzad,511,deathknight,unholy,21,7,14
area-52,496,deathknight,unholy,13,6,7
boulderfist,480,deathknight,unholy,6,5,1
proudmoore,480,deathknight,unholy,6,5,1
barthilas,480,deathknight,unholy,6,5,1
stormrage,480,deathknight,unholy,12,5,7
stormrage,480,deathknight,unholy,12,5,7
kiljaeden,480,deathknight,unholy,12,5,7
stormrage,480,deathknight,unholy,12,5,7
illidan,480,deathknight,unholy,12,5,7
tichondrius,480,deathknight,unholy,12,5,7
sargeras,480,deathknight,unholy,12,5,7
turalyon,480,deathknight,unholy,12,5,7
turalyon,480,deathknight,unholy,12,5,7
windrunner,480,deathknight,unholy,12,5,7
sargeras,480,deathknight,unholy,12,5,7
elune,480,deathknight,unholy,12,5,7
chogall,480,deathknight,unholy,12,5,7
aerie-peak,480,deathknight,unholy,12,5,7
moon-guard,480,deathknight,unholy,18,5,13
tichondrius,480,deathknight,unholy,18,5,13
bleeding-hollow,480,deathknight,unholy,18,5,13
tanaris,480,deathknight,unholy,18,5,13
sargeras,480,deathknight,unholy,18,5,13
thunderlord,480,deathknight,unholy,18,5,13
zuljin,480,deathknight,unholy,25,5,20
azralon,479,deathknight,unholy,12,5,7
proudmoore,479,deathknight,unholy,12,5,7
tichondrius,479,deathknight,unholy,12,5,7
nemesis,479,deathknight,unholy,12,5,7
akama,479,deathknight,unholy,12,5,7
kiljaeden,479,deathknight,unholy,12,5,7
emerald-dream,478,deathknight,unholy,6,5,1
burning-legion,472,deathknight,unholy,12,5,7
bleeding-hollow,468,deathknight,unholy,19,9,10
malganis,463,deathknight,unholy,17,5,12
bleeding-hollow,463,deathknight,unholy,17,5,12
hyjal,447,deathknight,unholy,11,5,6
frostmourne,447,deathknight,unholy,11,5,6
ysera,432,deathknight,unholy,9,6,3
aggramar,430,deathknight,unholy,11,5,6
tichondrius,426,deathknight,unholy,16,6,10
illidan,415,deathknight,unholy,8,5,3
chogall,415,deathknight,unholy,10,5,5
burning-legion,415,deathknight,unholy,20,5,15
echo-isles,399,deathknight,unholy,5,5,0
quelthalas,384,deathknight,unholy,6,4,2
illidan,384,deathknight,unholy,6,4,2
stormscale,384,deathknight,unholy,6,4,2
drakkari,384,deathknight,unholy,6,4,2
illidan,384,deathknight,unholy,6,4,2
thrall,384,deathknight,unholy,6,4,2
ragnaros,384,deathknight,unholy,6,4,2
ragnaros,384,deathknight,unholy,6,4,2
tichondrius,384,deathknight,unholy,6,4,2
dalaran,384,deathknight,unholy,6,4,2
khaz-modan,384,deathknight,unholy,6,4,2
tichondrius,384,deathknight,unholy,6,4,2
tichondrius,384,deathknight,unholy,6,4,2
moon-guard,384,deathknight,unholy,6,4,2
area-52,384,deathknight,unholy,6,4,2
barthilas,384,deathknight,unholy,6,4,2
tichondrius,384,deathknight,unholy,6,4,2
frostmourne,384,deathknight,unholy,6,4,2
zuljin,384,deathknight,unholy,6,4,2
dawnbringer,384,deathknight,unholy,6,4,2
sargeras,384,deathknight,unholy,6,4,2
frostmourne,384,deathknight,unholy,6,4,2
stormrage,384,deathknight,unholy,7,4,3
sargeras,384,deathknight,unholy,10,5,5
frostmourne,384,deathknight,unholy,12,4,8
darkspear,384,deathknight,unholy,12,4,8
dathremar,384,deathknight,unholy,12,4,8
frostmourne,384,deathknight,unholy,12,4,8
proudmoore,384,deathknight,unholy,12,4,8
proudmoore,384,deathknight,unholy,12,4,8
azralon,384,deathknight,unholy,12,4,8
frostmane,384,deathknight,unholy,12,4,8
arthas,384,deathknight,unholy,12,4,8
moon-guard,384,deathknight,unholy,12,4,8
proudmoore,384,deathknight,unholy,12,4,8
nemesis,384,deathknight,unholy,12,4,8
tichondrius,384,deathknight,unholy,12,4,8
dalaran,384,deathknight,unholy,12,4,8
malfurion,384,deathknight,unholy,12,4,8
sargeras,384,deathknight,unholy,12,4,8
tichondrius,384,deathknight,unholy,12,4,8
illidan,384,deathknight,unholy,12,4,8
thunderlord,384,deathknight,unholy,12,4,8
sargeras,384,deathknight,unholy,12,4,8
madoran,384,deathknight,unholy,12,4,8
ragnaros,384,deathknight,unholy,12,4,8
twisting-nether,384,deathknight,unholy,12,4,8
demon-soul,384,deathknight,unholy,12,4,8
whisperwind,384,deathknight,unholy,12,4,8
moon-guard,384,deathknight,unholy,12,4,8
stormrage,384,deathknight,unholy,12,4,8
moon-guard,384,deathknight,unholy,18,4,14
bleeding-hollow,384,deathknight,unholy,18,4,14
trollbane,383,deathknight,unholy,6,4,2
quelthalas,383,deathknight,unholy,11,6,5
sargeras,383,deathknight,unholy,12,4,8
ragnaros,383,deathknight,unholy,12,4,8
wyrmrest-accord,382,deathknight,unholy,6,4,2
zuljin,382,deathknight,unholy,10,6,4
quelthalas,333,deathknight,unholy,9,4,5
quelthalas,320,deathknight,unholy,10,4,6
azuremyst,319,deathknight,unholy,5,4,1
stormrage,318,deathknight,unholy,5,4,1
tichondrius,288,deathknight,unholy,6,3,3
tichondrius,288,deathknight,unholy,6,3,3
illidan,288,deathknight,unholy,6,3,3
tichondrius,288,deathknight,unholy,6,3,3
aegwynn,288,deathknight,unholy,6,3,3
nemesis,288,deathknight,unholy,6,3,3
tichondrius,288,deathknight,unholy,6,3,3
kiljaeden,288,deathknight,unholy,6,3,3
nemesis,288,deathknight,unholy,6,3,3
sargeras,288,deathknight,unholy,6,3,3
stormrage,288,deathknight,unholy,6,3,3
stormrage,288,deathknight,unholy,6,3,3
kiljaeden,288,deathknight,unholy,6,3,3
ragnaros,288,deathknight,unholy,6,3,3
tichondrius,288,deathknight,unholy,6,3,3
kiljaeden,288,deathknight,unholy,6,3,3
bleeding-hollow,288,deathknight,unholy,6,3,3
sargeras,288,deathknight,unholy,6,3,3
arthas,288,deathknight,unholy,6,3,3
moon-guard,288,deathknight,unholy,6,3,3
hyjal,288,deathknight,unholy,6,3,3
senjin,288,deathknight,unholy,6,3,3
area-52,288,deathknight,unholy,6,3,3
thunderlord,288,deathknight,unholy,6,3,3
moon-guard,288,deathknight,unholy,6,3,3
illidan,288,deathknight,unholy,6,3,3
tichondrius,288,deathknight,unholy,6,3,3
elune,288,deathknight,unholy,6,3,3
area-52,288,deathknight,unholy,6,3,3
tichondrius,288,deathknight,unholy,6,3,3
zuluhed,288,deathknight,unholy,6,3,3
burning-blade,288,deathknight,unholy,6,3,3
kelthuzad,288,deathknight,unholy,6,3,3
sargeras,288,deathknight,unholy,6,3,3
tichondrius,288,deathknight,unholy,6,3,3
zuljin,288,deathknight,unholy,6,3,3
sargeras,288,deathknight,unholy,6,3,3
dalaran,288,deathknight,unholy,6,3,3
frostmourne,288,deathknight,unholy,6,3,3
stormrage,288,deathknight,unholy,6,3,3
illidan,288,deathknight,unholy,6,3,3
darkspear,288,deathknight,unholy,6,3,3
illidan,288,deathknight,unholy,6,3,3
frostmourne,288,deathknight,unholy,6,3,3
moon-guard,288,deathknight,unholy,6,3,3
blood-furnace,288,deathknight,unholy,6,3,3
tichondrius,288,deathknight,unholy,6,3,3
tichondrius,288,deathknight,unholy,6,3,3
skywall,288,deathknight,unholy,6,3,3
nazjatar,288,deathknight,unholy,6,3,3
wyrmrest-accord,288,deathknight,unholy,6,3,3
area-52,288,deathknight,unholy,9,4,5
frostmourne,288,deathknight,unholy,12,3,9
caelestrasz,288,deathknight,unholy,12,3,9
stormrage,288,deathknight,unholy,12,3,9
barthilas,288,deathknight,unholy,12,3,9
tichondrius,288,deathknight,unholy,12,3,9
kelthuzad,288,deathknight,unholy,12,3,9
area-52,288,deathknight,unholy,12,3,9
moon-guard,288,deathknight,unholy,12,3,9
wyrmrest-accord,288,deathknight,unholy,12,3,9
stormrage,288,deathknight,unholy,12,3,9
malganis,288,deathknight,unholy,18,3,15
stormrage,287,deathknight,unholy,9,3,6
emerald-dream,287,deathknight,unholy,15,4,11
stormrage,286,deathknight,unholy,6,3,3
moon-guard,286,deathknight,unholy,6,3,3
ysera,286,deathknight,unholy,6,3,3
suramar,271,deathknight,unholy,11,3,8
frostmane,255,deathknight,unholy,11,3,8
blackhand,240,deathknight,unholy,9,3,6
tichondrius,239,deathknight,unholy,5,3,2
stormrage,234,deathknight,unholy,10,6,4
drakkari,233,deathknight,unholy,8,4,4
quelthalas,192,deathknight,unholy,4,3,1
ragnaros,192,deathknight,unholy,4,3,1
area-52,192,deathknight,unholy,9,4,5
aerie-peak,192,deathknight,unholy,9,3,6
sargeras,192,deathknight,unholy,6,2,4
ghostlands,192,deathknight,unholy,6,2,4
bleeding-hollow,192,deathknight,unholy,6,2,4
moon-guard,192,deathknight,unholy,6,2,4
daggerspine,192,deathknight,unholy,6,2,4
tichondrius,192,deathknight,unholy,6,2,4
bleeding-hollow,192,deathknight,unholy,6,2,4
ragnaros,192,deathknight,unholy,6,2,4
ragnaros,192,deathknight,unholy,6,2,4
ragnaros,192,deathknight,unholy,6,2,4
frostmourne,192,deathknight,unholy,6,2,4
ragnaros,192,deathknight,unholy,6,2,4
moon-guard,192,deathknight,unholy,6,2,4
illidan,192,deathknight,unholy,6,2,4
moon-guard,192,deathknight,unholy,6,2,4
quelthalas,192,deathknight,unholy,6,2,4
tichondrius,192,deathknight,unholy,6,2,4
dreadmaul,192,deathknight,unholy,6,2,4
thrall,192,deathknight,unholy,6,2,4
drakthul,192,deathknight,unholy,6,2,4
sargeras,192,deathknight,unholy,6,2,4
tichondrius,192,deathknight,unholy,6,2,4
goldrinn,192,deathknight,unholy,6,2,4
stormrage,192,deathknight,unholy,6,2,4
barthilas,192,deathknight,unholy,6,2,4
stormrage,192,deathknight,unholy,6,2,4
tichondrius,192,deathknight,unholy,6,2,4
illidan,192,deathknight,unholy,6,2,4
frostmourne,192,deathknight,unholy,6,2,4
elune,192,deathknight,unholy,6,2,4
malganis,192,deathknight,unholy,6,2,4
area-52,192,deathknight,unholy,6,2,4
ragnaros,192,deathknight,unholy,6,2,4
area-52,192,deathknight,unholy,6,2,4
garithos,192,deathknight,unholy,6,2,4
zuljin,192,deathknight,unholy,6,2,4
area-52,192,deathknight,unholy,6,2,4
azralon,192,deathknight,unholy,6,2,4
proudmoore,192,deathknight,unholy,6,2,4
area-52,192,deathknight,unholy,6,2,4
proudmoore,192,deathknight,unholy,6,2,4
bleeding-hollow,192,deathknight,unholy,6,2,4
hyjal,192,deathknight,unholy,6,2,4
kiljaeden,192,deathknight,unholy,6,2,4
sargeras,192,deathknight,unholy,12,2,10
hyjal,192,deathknight,unholy,12,2,10
stormrage,192,deathknight,unholy,12,2,10
malganis,192,deathknight,unholy,12,2,10
quelthalas,191,deathknight,unholy,6,4,2
illidan,191,deathknight,unholy,6,2,4
drenden,191,deathknight,unholy,6,2,4
moon-guard,160,deathknight,unholy,10,2,8
emerald-dream,159,deathknight,unholy,5,2,3
malganis,159,deathknight,unholy,5,2,3
dragonmaw,138,deathknight,unholy,8,4,4
tichondrius,128,deathknight,unholy,4,2,2
jubeithos,127,deathknight,unholy,8,2,6
barthilas,96,deathknight,unholy,6,1,5
proudmoore,96,deathknight,unholy,6,1,5
zuljin,96,deathknight,unholy,6,1,5
zuljin,96,deathknight,unholy,6,1,5
barthilas,96,deathknight,unholy,6,1,5
tichondrius,96,deathknight,unholy,6,1,5
tichondrius,96,deathknight,unholy,6,1,5
tichondrius,96,deathknight,unholy,6,1,5
firetree,96,deathknight,unholy,6,1,5
frostmane,96,deathknight,unholy,6,1,5
tichondrius,96,deathknight,unholy,6,1,5
elune,96,deathknight,unholy,6,1,5
tichondrius,96,deathknight,unholy,6,1,5
thaurissan,96,deathknight,unholy,6,1,5
thrall,96,deathknight,unholy,6,1,5
tichondrius,96,deathknight,unholy,6,1,5
illidan,96,deathknight,unholy,6,1,5
dalaran,96,deathknight,unholy,6,1,5
illidan,96,deathknight,unholy,6,1,5
tichondrius,96,deathknight,unholy,6,1,5
stormrage,96,deathknight,unholy,6,1,5
quelthalas,96,deathknight,unholy,6,1,5
ragnaros,96,deathknight,unholy,6,1,5
bleeding-hollow,96,deathknight,unholy,6,1,5
zuljin,96,deathknight,unholy,6,1,5
ragnaros,96,deathknight,unholy,6,1,5
doomhammer,96,deathknight,unholy,6,1,5
hydraxis,96,deathknight,unholy,6,1,5
frostmourne,96,deathknight,unholy,6,1,5
frostmourne,96,deathknight,unholy,6,1,5
thrall,96,deathknight,unholy,6,1,5
emerald-dream,96,deathknight,unholy,6,1,5
deathwing,96,deathknight,unholy,6,1,5
sargeras,96,deathknight,unholy,7,1,6
jubeithos,95,deathknight,unholy,6,1,5
azralon,95,deathknight,unholy,12,1,11
barthilas,79,deathknight,unholy,5,1,4
stormrage,63,deathknight,unholy,2,2,0
frostmourne,63,deathknight,unholy,2,2,0
darrowmere,42,deathknight,unholy,8,2,6
tichondrius,42,deathknight,unholy,10,2,8
shuhalo,31,deathknight,unholy,2,1,1
area-52,2164,deathknight,frost,199,101,98
tichondrius,1949,deathknight,frost,78,43,35
nemesis,1809,deathknight,frost,48,26,22
malganis,1803,deathknight,frost,69,40,29
destromath,1772,deathknight,frost,77,41,36
tichondrius,1768,deathknight,frost,48,22,26
ragnaros,1766,deathknight,frost,78,38,40
illidan,1763,deathknight,frost,41,19,22
tichondrius,1740,deathknight,frost,54,27,27
illidan,1700,deathknight,frost,63,34,29
illidan,1670,deathknight,frost,27,21,6
quelthalas,1645,deathknight,frost,96,43,53
hyjal,1626,deathknight,frost,58,26,32
illidan,1623,deathknight,frost,42,20,22
dalaran,1617,deathknight,frost,36,17,19
aerie-peak,1613,deathknight,frost,60,31,29
tichondrius,1532,deathknight,frost,30,16,14
quelthalas,1527,deathknight,frost,66,37,29
caelestrasz,1522,deathknight,frost,77,41,36
dathremar,1521,deathknight,frost,69,36,33
stormrage,1517,deathknight,frost,97,44,53
thaurissan,1499,deathknight,frost,79,31,48
tichondrius,1477,deathknight,frost,36,16,20
quelthalas,1441,deathknight,frost,42,18,24
onyxia,1429,deathknight,frost,48,22,26
moon-guard,1405,deathknight,frost,72,37,35
illidan,1398,deathknight,frost,41,22,19
tichondrius,1374,deathknight,frost,54,25,29
dalaran,1372,deathknight,frost,36,16,20
kelthuzad,1362,deathknight,frost,46,22,24
tichondrius,1358,deathknight,frost,51,31,20
azralon,1354,deathknight,frost,39,17,22
stormrage,1354,deathknight,frost,48,20,28
tichondrius,1353,deathknight,frost,42,19,23
blackrock,1341,deathknight,frost,18,14,4
malganis,1335,deathknight,frost,114,56,58
wyrmrest-accord,1326,deathknight,frost,81,34,47
nemesis,1317,deathknight,frost,132,64,68
malganis,1304,deathknight,frost,60,29,31
illidan,1267,deathknight,frost,62,30,32
quelthalas,1264,deathknight,frost,36,15,21
destromath,1250,deathknight,frost,51,22,29
frostmourne,1235,deathknight,frost,24,13,11
tichondrius,1233,deathknight,frost,30,18,12
illidan,1230,deathknight,frost,33,20,13
illidan,1214,deathknight,frost,42,25,17
sargeras,1210,deathknight,frost,76,45,31
veknilash,1204,deathknight,frost,66,32,34
nemesis,1186,deathknight,frost,111,58,53
tanaris,1137,deathknight,frost,30,12,18
ragnaros,1135,deathknight,frost,42,14,28
sargeras,1126,deathknight,frost,28,13,15
quelthalas,1101,deathknight,frost,66,31,35
frostmourne,1087,deathknight,frost,84,43,41
quelthalas,1077,deathknight,frost,22,12,10
lightbringer,1056,deathknight,frost,18,11,7
perenolde,1055,deathknight,frost,24,11,13
nemesis,1042,deathknight,frost,18,12,6
tichondrius,1038,deathknight,frost,23,11,12
boulderfist,996,deathknight,frost,23,12,11
azgalor,994,deathknight,frost,29,12,17
bleeding-hollow,959,deathknight,frost,18,10,8
illidan,959,deathknight,frost,24,10,14
stormrage,957,deathknight,frost,18,10,8
barthilas,897,deathknight,frost,46,22,24
blood-furnace,890,deathknight,frost,18,10,8
ragnaros,864,deathknight,frost,12,9,3
proudmoore,864,deathknight,frost,18,9,9
malganis,863,deathknight,frost,18,9,9
quelthalas,862,deathknight,frost,18,9,9
tichondrius,862,deathknight,frost,30,9,21
vashj,861,deathknight,frost,12,9,3
gorefiend,861,deathknight,frost,18,9,9
blackhand,860,deathknight,frost,18,9,9
gallywix,856,deathknight,frost,24,9,15
amanthul,839,deathknight,frost,20,9,11
ragnaros,827,deathknight,frost,17,9,8
onyxia,823,deathknight,frost,18,9,9
ragnaros,768,deathknight,frost,12,8,4
sargeras,768,deathknight,frost,24,8,16
emerald-dream,767,deathknight,frost,12,8,4
moon-guard,767,deathknight,frost,18,8,10
scilla,766,deathknight,frost,12,8,4
wyrmrest-accord,766,deathknight,frost,12,8,4
azjolnerub,765,deathknight,frost,12,8,4
moon-guard,762,deathknight,frost,12,8,4
tichondrius,760,deathknight,frost,21,9,12
trollbane,738,deathknight,frost,24,8,16
arthas,733,deathknight,frost,27,9,18
illidan,727,deathknight,frost,21,8,13
zuljin,688,deathknight,frost,21,10,11
frostmourne,688,deathknight,frost,19,8,11
windrunner,680,deathknight,frost,24,9,15
illidan,672,deathknight,frost,12,7,5
emerald-dream,672,deathknight,frost,12,7,5
runetotem,672,deathknight,frost,12,7,5
deathwing,672,deathknight,frost,12,7,5
ragnaros,672,deathknight,frost,12,7,5
tichondrius,672,deathknight,frost,15,8,7
stormrage,672,deathknight,frost,18,7,11
korgath,672,deathknight,frost,18,7,11
azralon,671,deathknight,frost,12,7,5
barthilas,671,deathknight,frost,18,7,11
quelthalas,671,deathknight,frost,18,7,11
zuljin,671,deathknight,frost,30,7,23
area-52,670,deathknight,frost,18,7,11
moon-guard,665,deathknight,frost,18,7,11
stormrage,623,deathknight,frost,11,7,4
kiljaeden,607,deathknight,frost,11,7,4
emerald-dream,576,deathknight,frost,12,6,6
tichondrius,576,deathknight,frost,12,6,6
wyrmrest-accord,576,deathknight,frost,12,6,6
tichondrius,576,deathknight,frost,12,6,6
tichondrius,576,deathknight,frost,12,6,6
zuljin,576,deathknight,frost,12,6,6
barthilas,576,deathknight,frost,12,6,6
zuljin,576,deathknight,frost,18,6,12
sargeras,576,deathknight,frost,18,6,12
sargeras,574,deathknight,frost,12,6,6
darkspear,573,deathknight,frost,12,6,6
area-52,573,deathknight,frost,12,6,6
tichondrius,572,deathknight,frost,12,6,6
wildhammer,569,deathknight,frost,12,6,6
azralon,541,deathknight,frost,17,6,11
tichondrius,522,deathknight,frost,22,8,14
moon-guard,511,deathknight,frost,20,6,14
moon-guard,480,deathknight,frost,12,5,7
chogall,480,deathknight,frost,12,5,7
frostmourne,480,deathknight,frost,12,5,7
emerald-dream,480,deathknight,frost,12,5,7
kelthuzad,480,deathknight,frost,12,5,7
sargeras,480,deathknight,frost,12,5,7
tichondrius,480,deathknight,frost,12,5,7
zuluhed,480,deathknight,frost,12,5,7
lothar,480,deathknight,frost,12,5,7
illidan,480,deathknight,frost,18,5,13
stormrage,479,deathknight,frost,6,5,1
darkspear,477,deathknight,frost,12,5,7
nemesis,477,deathknight,frost,24,5,19
daggerspine,431,deathknight,frost,11,5,6
wyrmrest-accord,413,deathknight,frost,24,6,18
zuluhed,412,deathknight,frost,11,5,6
elune,384,deathknight,frost,6,4,2
ragnaros,384,deathknight,frost,6,4,2
quelthalas,384,deathknight,frost,6,4,2
ragnaros,384,deathknight,frost,6,4,2
sargeras,384,deathknight,frost,6,4,2
tichondrius,384,deathknight,frost,6,4,2
thrall,384,deathknight,frost,6,4,2
barthilas,384,deathknight,frost,12,4,8
doomhammer,384,deathknight,frost,12,4,8
dalaran,384,deathknight,frost,12,4,8
sargeras,384,deathknight,frost,12,4,8
blackhand,384,deathknight,frost,12,4,8
nemesis,384,deathknight,frost,18,4,14
boulderfist,383,deathknight,frost,12,4,8
caelestrasz,383,deathknight,frost,12,4,8
stormrage,383,deathknight,frost,12,4,8
aerie-peak,383,deathknight,frost,18,4,14
argent-dawn,382,deathknight,frost,6,4,2
stormrage,382,deathknight,frost,12,4,8
bleeding-hollow,351,deathknight,frost,11,4,7
area-52,288,deathknight,frost,6,3,3
barthilas,288,deathknight,frost,6,3,3
area-52,288,deathknight,frost,6,3,3
barthilas,288,deathknight,frost,6,3,3
stormrage,288,deathknight,frost,6,3,3
lightbringer,288,deathknight,frost,6,3,3
area-52,288,deathknight,frost,6,3,3
nemesis,288,deathknight,frost,6,3,3
nesingwary,288,deathknight,frost,6,3,3
aegwynn,288,deathknight,frost,6,3,3
skullcrusher,288,deathknight,frost,6,3,3
chogall,288,deathknight,frost,6,3,3
bloodhoof,288,deathknight,frost,6,3,3
barthilas,288,deathknight,frost,6,3,3
ragnaros,288,deathknight,frost,6,3,3
quelthalas,288,deathknight,frost,6,3,3
deathwing,288,deathknight,frost,6,3,3
tichondrius,288,deathknight,frost,6,3,3
tichondrius,288,deathknight,frost,6,3,3
sargeras,288,deathknight,frost,6,3,3
hyjal,288,deathknight,frost,10,4,6
tichondrius,288,deathknight,frost,12,3,9
stormrage,288,deathknight,frost,12,3,9
area-52,288,deathknight,frost,12,3,9
barthilas,288,deathknight,frost,12,3,9
kelthuzad,287,deathknight,frost,6,3,3
ravencrest,287,deathknight,frost,12,3,9
area-52,255,deathknight,frost,8,4,4
stormrage,239,deathknight,frost,5,3,2
ragnaros,192,deathknight,frost,9,3,6
illidan,192,deathknight,frost,6,2,4
sargeras,192,deathknight,frost,6,2,4
azralon,192,deathknight,frost,6,2,4
azralon,192,deathknight,frost,6,2,4
sargeras,192,deathknight,frost,6,2,4
illidan,192,deathknight,frost,6,2,4
bonechewer,192,deathknight,frost,6,2,4
stormrage,192,deathknight,frost,6,2,4
sargeras,192,deathknight,frost,6,2,4
sargeras,192,deathknight,frost,6,2,4
proudmoore,192,deathknight,frost,6,2,4
stormrage,192,deathknight,frost,6,2,4
elune,192,deathknight,frost,6,2,4
zuljin,192,deathknight,frost,6,2,4
frostmourne,192,deathknight,frost,6,2,4
kelthuzad,192,deathknight,frost,6,2,4
boulderfist,192,deathknight,frost,6,2,4
tichondrius,192,deathknight,frost,6,2,4
tichondrius,192,deathknight,frost,6,2,4
uldum,192,deathknight,frost,6,2,4
quelthalas,192,deathknight,frost,12,2,10
drakkari,192,deathknight,frost,12,2,10
maiev,191,deathknight,frost,6,2,4
ragnaros,191,deathknight,frost,6,2,4
quelthalas,191,deathknight,frost,6,2,4
dalvengyr,159,deathknight,frost,5,2,3
moon-guard,127,deathknight,frost,8,2,6
tichondrius,110,deathknight,frost,7,2,5
proudmoore,96,deathknight,frost,3,2,1
stormrage,96,deathknight,frost,6,1,5
frostmourne,96,deathknight,frost,6,1,5
emerald-dream,96,deathknight,frost,6,1,5
bleeding-hollow,96,deathknight,frost,6,1,5
muradin,96,deathknight,frost,6,1,5
sargeras,96,deathknight,frost,6,1,5
quelthalas,96,deathknight,frost,6,1,5
illidan,96,deathknight,frost,6,1,5
kelthuzad,96,deathknight,frost,6,1,5
bleeding-hollow,96,deathknight,frost,6,1,5
stormrage,96,deathknight,frost,6,1,5
proudmoore,96,deathknight,frost,6,1,5
garithos,96,deathknight,frost,6,1,5
whisperwind,96,deathknight,frost,6,1,5
quelthalas,96,deathknight,frost,6,1,5
dalaran,96,deathknight,frost,6,1,5
proudmoore,96,deathknight,frost,6,1,5
dalaran,96,deathknight,frost,6,1,5
wyrmrest-accord,96,deathknight,frost,6,1,5
illidan,96,deathknight,frost,6,1,5
ragnaros,96,deathknight,frost,6,1,5
bleeding-hollow,96,deathknight,frost,6,1,5
tichondrius,48,deathknight,frost,3,1,2
ghostlands,48,deathknight,frost,3,1,2
lightnings-blade,48,deathknight,frost,3,1,2
hyjal,42,deathknight,frost,9,2,7
aggramar,31,deathknight,frost,2,1,1
stormrage,16,deathknight,frost,1,1,0
tichondrius,2209,demonhunter,havoc,150,78,72
area-52,2112,demonhunter,havoc,66,39,27
sargeras,2106,demonhunter,havoc,78,42,36
sargeras,2102,demonhunter,havoc,115,62,53
malganis,2088,demonhunter,havoc,78,41,37
tichondrius,2053,demonhunter,havoc,179,88,91
malganis,2020,demonhunter,havoc,83,41,42
eldrethalas,2015,demonhunter,havoc,87,46,41
tichondrius,2004,demonhunter,havoc,144,70,74
tichondrius,1983,demonhunter,havoc,96,53,43
ragnaros,1957,demonhunter,havoc,82,43,39
moon-guard,1946,demonhunter,havoc,82,41,41
frostmourne,1937,demonhunter,havoc,142,71,71
durotan,1936,demonhunter,havoc,78,41,37
aegwynn,1932,demonhunter,havoc,136,74,62
sargeras,1931,demonhunter,havoc,71,40,31
tichondrius,1921,demonhunter,havoc,66,37,29
illidan,1921,demonhunter,havoc,59,28,31
malganis,1906,demonhunter,havoc,108,50,58
illidan,1905,demonhunter,havoc,78,36,42
area-52,1899,demonhunter,havoc,54,32,22
tichondrius,1892,demonhunter,havoc,54,32,22
bleeding-hollow,1884,demonhunter,havoc,60,28,32
tichondrius,1874,demonhunter,havoc,84,47,37
sargeras,1873,demonhunter,havoc,36,23,13
malganis,1872,demonhunter,havoc,72,39,33
tichondrius,1872,demonhunter,havoc,42,20,22
sargeras,1867,demonhunter,havoc,72,32,40
hydraxis,1863,demonhunter,havoc,78,41,37
area-52,1863,demonhunter,havoc,54,28,26
wyrmrest-accord,1855,demonhunter,havoc,108,62,46
area-52,1848,demonhunter,havoc,46,27,19
malygos,1848,demonhunter,havoc,68,38,30
sargeras,1846,demonhunter,havoc,47,23,24
wyrmrest-accord,1842,demonhunter,havoc,47,24,23
tichondrius,1840,demonhunter,havoc,48,24,24
tichondrius,1830,demonhunter,havoc,106,58,48
kirin-tor,1828,demonhunter,havoc,221,120,101
thrall,1825,demonhunter,havoc,112,65,47
area-52,1825,demonhunter,havoc,84,36,48
tichondrius,1823,demonhunter,havoc,35,20,15
dalaran,1821,demonhunter,havoc,84,54,30
dalaran,1820,demonhunter,havoc,61,32,29
aggramar,1820,demonhunter,havoc,48,22,26
nemesis,1817,demonhunter,havoc,42,23,19
firetree,1817,demonhunter,havoc,90,48,42
tichondrius,1815,demonhunter,havoc,53,32,21
nesingwary,1813,demonhunter,havoc,54,25,29
malganis,1812,demonhunter,havoc,36,19,17
terenas,1811,demonhunter,havoc,56,32,24
bleeding-hollow,1810,demonhunter,havoc,81,47,34
wyrmrest-accord,1808,demonhunter,havoc,36,22,14
sargeras,1807,demonhunter,havoc,133,76,57
bleeding-hollow,1807,demonhunter,havoc,150,81,69
tichondrius,1805,demonhunter,havoc,66,32,34
nemesis,1801,demonhunter,havoc,69,35,34
black-dragonflight,1800,demonhunter,havoc,38,20,18
tichondrius,1800,demonhunter,havoc,47,23,24
azralon,1799,demonhunter,havoc,121,71,50
area-52,1798,demonhunter,havoc,69,42,27
tichondrius,1797,demonhunter,havoc,36,19,17
moon-guard,1791,demonhunter,havoc,68,30,38
azgalor,1790,demonhunter,havoc,88,45,43
stormrage,1785,demonhunter,havoc,96,48,48
tichondrius,1782,demonhunter,havoc,36,23,13
area-52,1777,demonhunter,havoc,30,22,8
tichondrius,1777,demonhunter,havoc,72,43,29
tichondrius,1773,demonhunter,havoc,54,27,27
area-52,1765,demonhunter,havoc,108,59,49
ragnaros,1761,demonhunter,havoc,42,21,21
stormscale,1757,demonhunter,havoc,35,19,16
moon-guard,1756,demonhunter,havoc,29,19,10
area-52,1756,demonhunter,havoc,54,28,26
quelthalas,1755,demonhunter,havoc,56,28,28
emerald-dream,1749,demonhunter,havoc,48,31,17
sargeras,1746,demonhunter,havoc,60,36,24
tichondrius,1740,demonhunter,havoc,53,26,27
tichondrius,1737,demonhunter,havoc,84,41,43
tichondrius,1737,demonhunter,havoc,48,23,25
lightnings-blade,1735,demonhunter,havoc,73,39,34
stormrage,1734,demonhunter,havoc,54,33,21
barthilas,1731,demonhunter,havoc,47,25,22
illidan,1731,demonhunter,havoc,54,26,28
malganis,1718,demonhunter,havoc,24,18,6
tichondrius,1717,demonhunter,havoc,153,79,74
bleeding-hollow,1717,demonhunter,havoc,55,28,27
thrall,1717,demonhunter,havoc,48,22,26
malganis,1715,demonhunter,havoc,48,25,23
nemesis,1714,demonhunter,havoc,38,22,16
tichondrius,1713,demonhunter,havoc,65,36,29
ghostlands,1712,demonhunter,havoc,42,22,20
tichondrius,1712,demonhunter,havoc,66,31,35
area-52,1711,demonhunter,havoc,41,24,17
malganis,1711,demonhunter,havoc,46,25,21
bleeding-hollow,1709,demonhunter,havoc,78,34,44
azralon,1707,demonhunter,havoc,47,23,24
sargeras,1703,demonhunter,havoc,54,34,20
area-52,1703,demonhunter,havoc,60,31,29
burning-blade,1699,demonhunter,havoc,47,31,16
zuljin,1699,demonhunter,havoc,48,31,17
sargeras,1696,demonhunter,havoc,36,24,12
sargeras,1695,demonhunter,havoc,34,27,7
tichondrius,1695,demonhunter,havoc,44,23,21
malganis,1692,demonhunter,havoc,88,55,33
moon-guard,1691,demonhunter,havoc,41,26,15
tichondrius,1691,demonhunter,havoc,35,19,16
area-52,1691,demonhunter,havoc,36,18,18
malganis,1690,demonhunter,havoc,96,54,42
area-52,1689,demonhunter,havoc,66,40,26
sargeras,1688,demonhunter,havoc,48,26,22
illidan,1675,demonhunter,havoc,102,45,57
stormrage,1670,demonhunter,havoc,36,20,16
exodar,1668,demonhunter,havoc,92,53,39
area-52,1664,demonhunter,havoc,36,25,11
area-52,1660,demonhunter,havoc,37,21,16
tichondrius,1655,demonhunter,havoc,46,25,21
arthas,1654,demonhunter,havoc,30,19,11
azralon,1650,demonhunter,havoc,36,22,14
kelthuzad,1649,demonhunter,havoc,30,21,9
azralon,1649,demonhunter,havoc,81,40,41
malganis,1647,demonhunter,havoc,40,21,19
cairne,1646,demonhunter,havoc,45,22,23
ragnaros,1645,demonhunter,havoc,48,20,28
tichondrius,1642,demonhunter,havoc,65,34,31
tichondrius,1641,demonhunter,havoc,45,20,25
tichondrius,1640,demonhunter,havoc,66,35,31
illidan,1635,demonhunter,havoc,29,19,10
area-52,1635,demonhunter,havoc,36,18,18
area-52,1634,demonhunter,havoc,36,23,13
dalaran,1634,demonhunter,havoc,48,30,18
khaz-modan,1631,demonhunter,havoc,36,23,13
illidan,1630,demonhunter,havoc,30,17,13
hyjal,1629,demonhunter,havoc,72,36,36
tichondrius,1628,demonhunter,havoc,60,31,29
frostmourne,1624,demonhunter,havoc,42,19,23
zuljin,1623,demonhunter,havoc,40,21,19
stormrage,1621,demonhunter,havoc,48,19,29
wyrmrest-accord,1620,demonhunter,havoc,30,20,10
area-52,1619,demonhunter,havoc,42,22,20
illidan,1615,demonhunter,havoc,42,19,23
area-52,1610,demonhunter,havoc,42,20,22
dalvengyr,1609,demonhunter,havoc,36,19,17
tichondrius,1605,demonhunter,havoc,48,18,30
gilneas,1604,demonhunter,havoc,80,47,33
malganis,1604,demonhunter,havoc,54,31,23
gilneas,1602,demonhunter,havoc,70,35,35
area-52,1601,demonhunter,havoc,49,26,23
tichondrius,1600,demonhunter,havoc,42,19,23
korgath,1597,demonhunter,havoc,38,20,18
zuljin,1595,demonhunter,havoc,30,18,12
stormrage,1594,demonhunter,havoc,24,17,7
moonrunner,1594,demonhunter,havoc,62,32,30
ragnaros,1589,demonhunter,havoc,53,29,24
zuljin,1589,demonhunter,havoc,42,19,23
tichondrius,1581,demonhunter,havoc,30,20,10
ragnaros,1581,demonhunter,havoc,60,26,34
balnazzar,1580,demonhunter,havoc,42,18,24
dalaran,1577,demonhunter,havoc,35,19,16
sargeras,1577,demonhunter,havoc,90,44,46
stormrage,1574,demonhunter,havoc,30,17,13
tichondrius,1565,demonhunter,havoc,39,19,20
ragnaros,1562,demonhunter,havoc,78,34,44
tichondrius,1561,demonhunter,havoc,60,32,28
area-52,1561,demonhunter,havoc,39,19,20
tichondrius,1558,demonhunter,havoc,47,26,21
stormrage,1557,demonhunter,havoc,29,17,12
kelthuzad,1553,demonhunter,havoc,30,18,12
zuljin,1550,demonhunter,havoc,54,28,26
illidan,1549,demonhunter,havoc,36,20,16
kiljaeden,1541,demonhunter,havoc,39,18,21
barthilas,1541,demonhunter,havoc,54,23,31
dalaran,1541,demonhunter,havoc,53,17,36
malfurion,1540,demonhunter,havoc,42,21,21
moon-guard,1533,demonhunter,havoc,52,30,22
illidan,1532,demonhunter,havoc,36,16,20
wyrmrest-accord,1532,demonhunter,havoc,64,28,36
blackrock,1527,demonhunter,havoc,38,21,17
wyrmrest-accord,1527,demonhunter,havoc,78,41,37
illidan,1524,demonhunter,havoc,24,17,7
frostwolf,1521,demonhunter,havoc,76,41,35
dreadmaul,1520,demonhunter,havoc,40,22,18
sargeras,1511,demonhunter,havoc,31,17,14
proudmoore,1503,demonhunter,havoc,36,16,20
barthilas,1499,demonhunter,havoc,42,16,26
tichondrius,1497,demonhunter,havoc,65,33,32
tichondrius,1495,demonhunter,havoc,61,33,28
tichondrius,1492,demonhunter,havoc,79,39,40
eitrigg,1488,demonhunter,havoc,51,27,24
area-52,1488,demonhunter,havoc,42,22,20
burning-blade,1487,demonhunter,havoc,50,19,31
illidan,1484,demonhunter,havoc,50,25,25
area-52,1482,demonhunter,havoc,62,31,31
ragnaros,1480,demonhunter,havoc,53,25,28
ragnaros,1477,demonhunter,havoc,30,16,14
bleeding-hollow,1473,demonhunter,havoc,29,16,13
frostmourne,1473,demonhunter,havoc,29,16,13
tichondrius,1472,demonhunter,havoc,31,19,12
stormrage,1469,demonhunter,havoc,54,20,34
azralon,1466,demonhunter,havoc,88,47,41
doomhammer,1464,demonhunter,havoc,36,17,19
barthilas,1463,demonhunter,havoc,42,17,25
tichondrius,1462,demonhunter,havoc,30,16,14
burning-legion,1462,demonhunter,havoc,72,37,35
malganis,1460,demonhunter,havoc,29,16,13
tichondrius,1459,demonhunter,havoc,36,16,20
sargeras,1458,demonhunter,havoc,28,18,10
emerald-dream,1458,demonhunter,havoc,36,18,18
thrall,1457,demonhunter,havoc,54,34,20
ragnaros,1457,demonhunter,havoc,75,33,42
tichondrius,1455,demonhunter,havoc,30,18,12
sargeras,1454,demonhunter,havoc,48,25,23
grizzly-hills,1452,demonhunter,havoc,37,20,17
sargeras,1452,demonhunter,havoc,36,19,17
emerald-dream,1452,demonhunter,havoc,54,26,28
duskwood,1451,demonhunter,havoc,83,42,41
barthilas,1445,demonhunter,havoc,60,36,24
tichondrius,1442,demonhunter,havoc,26,16,10
earthen-ring,1438,demonhunter,havoc,47,22,25
kelthuzad,1438,demonhunter,havoc,60,27,33
quelthalas,1435,demonhunter,havoc,24,17,7
tichondrius,1435,demonhunter,havoc,24,15,9
emerald-dream,1435,demonhunter,havoc,30,15,15
quelthalas,1435,demonhunter,havoc,30,15,15
frostmourne,1432,demonhunter,havoc,36,15,21
illidan,1431,demonhunter,havoc,84,48,36
tichondrius,1429,demonhunter,havoc,72,32,40
tichondrius,1425,demonhunter,havoc,75,42,33
zangarmarsh,1421,demonhunter,havoc,36,18,18
frostmourne,1420,demonhunter,havoc,42,18,24
tichondrius,1419,demonhunter,havoc,48,30,18
emerald-dream,1417,demonhunter,havoc,88,47,41
thrall,1413,demonhunter,havoc,30,15,15
bleeding-hollow,1412,demonhunter,havoc,43,23,20
quelthalas,1410,demonhunter,havoc,30,15,15
area-52,1404,demonhunter,havoc,253,133,120
zuljin,1402,demonhunter,havoc,37,19,18
frostmourne,1402,demonhunter,havoc,34,15,19
azralon,1401,demonhunter,havoc,54,34,20
nazgrel,1400,demonhunter,havoc,24,15,9
area-52,1398,demonhunter,havoc,43,21,22
jubeithos,1397,demonhunter,havoc,102,56,46
malfurion,1394,demonhunter,havoc,42,24,18
silvermoon,1390,demonhunter,havoc,87,43,44
thunderlord,1389,demonhunter,havoc,86,39,47
tichondrius,1387,demonhunter,havoc,42,27,15
area-52,1378,demonhunter,havoc,57,23,34
tichondrius,1371,demonhunter,havoc,42,25,17
barthilas,1370,demonhunter,havoc,54,28,26
wildhammer,1365,demonhunter,havoc,45,29,16
saurfang,1364,demonhunter,havoc,57,24,33
sargeras,1356,demonhunter,havoc,102,53,49
frostmourne,1353,demonhunter,havoc,35,19,16
tichondrius,1348,demonhunter,havoc,36,17,19
magtheridon,1345,demonhunter,havoc,24,16,8
stormrage,1344,demonhunter,havoc,69,37,32
ragnaros,1342,demonhunter,havoc,100,50,50
tichondrius,1342,demonhunter,havoc,36,14,22
ragnaros,1334,demonhunter,havoc,42,14,28
tichondrius,1332,demonhunter,havoc,24,14,10
tichondrius,1331,demonhunter,havoc,18,14,4
thrall,1331,demonhunter,havoc,24,14,10
darkspear,1328,demonhunter,havoc,36,19,17
quelthalas,1327,demonhunter,havoc,78,31,47
tichondrius,1324,demonhunter,havoc,126,62,64
area-52,1322,demonhunter,havoc,24,14,10
bonechewer,1320,demonhunter,havoc,40,23,17
stormrage,1316,demonhunter,havoc,30,16,14
bleeding-hollow,1314,demonhunter,havoc,48,20,28
frostmourne,1313,demonhunter,havoc,25,15,10
moon-guard,1300,demonhunter,havoc,80,47,33
stormrage,1300,demonhunter,havoc,96,47,49
jubeithos,1300,demonhunter,havoc,42,15,27
haomarush,1299,demonhunter,havoc,54,28,26
tichondrius,1294,demonhunter,havoc,71,33,38
ragnaros,1287,demonhunter,havoc,46,15,31
rivendare,1286,demonhunter,havoc,36,14,22
bonechewer,1282,demonhunter,havoc,36,21,15
tichondrius,1279,demonhunter,havoc,74,37,37
khazgoroth,1272,demonhunter,havoc,36,14,22
korgath,1268,demonhunter,havoc,36,14,22
azralon,1266,demonhunter,havoc,24,14,10
stormrage,1265,demonhunter,havoc,96,41,55
chogall,1260,demonhunter,havoc,36,20,16
tichondrius,1259,demonhunter,havoc,30,14,16
skullcrusher,1257,demonhunter,havoc,31,14,17
stormrage,1254,demonhunter,havoc,36,14,22
tichondrius,1249,demonhunter,havoc,53,30,23
sargeras,1247,demonhunter,havoc,24,13,11
frostmourne,1247,demonhunter,havoc,30,15,15
caelestrasz,1246,demonhunter,havoc,36,19,17
illidan,1246,demonhunter,havoc,30,13,17
tichondrius,1246,demonhunter,havoc,30,13,17
bleeding-hollow,1244,demonhunter,havoc,42,26,16
ragnaros,1244,demonhunter,havoc,24,13,11
frostmourne,1244,demonhunter,havoc,30,13,17
frostmourne,1242,demonhunter,havoc,64,31,33
stormrage,1242,demonhunter,havoc,34,15,19
malganis,1239,demonhunter,havoc,36,13,23
thrall,1238,demonhunter,havoc,30,14,16
emerald-dream,1237,demonhunter,havoc,55,28,27
emerald-dream,1237,demonhunter,havoc,30,13,17
moon-guard,1231,demonhunter,havoc,36,23,13
tichondrius,1229,demonhunter,havoc,30,13,17
sargeras,1225,demonhunter,havoc,24,14,10
eldrethalas,1219,demonhunter,havoc,24,16,8
proudmoore,1219,demonhunter,havoc,56,28,28
ragnaros,1216,demonhunter,havoc,30,14,16
tichondrius,1213,demonhunter,havoc,24,14,10
ragnaros,1212,demonhunter,havoc,28,13,15
arthas,1209,demonhunter,havoc,42,18,24
malganis,1205,demonhunter,havoc,28,13,15
thrall,1202,demonhunter,havoc,88,44,44
malganis,1200,demonhunter,havoc,44,24,20
stormrage,1194,demonhunter,havoc,53,32,21
area-52,1192,demonhunter,havoc,48,29,19
barthilas,1192,demonhunter,havoc,74,38,36
illidan,1184,demonhunter,havoc,30,14,16
sargeras,1183,demonhunter,havoc,16,13,3
tichondrius,1182,demonhunter,havoc,28,13,15
frostmourne,1182,demonhunter,havoc,112,51,61
durotan,1179,demonhunter,havoc,23,13,10
illidan,1174,demonhunter,havoc,29,13,16
bleeding-hollow,1170,demonhunter,havoc,63,28,35
barthilas,1162,demonhunter,havoc,18,14,4
wyrmrest-accord,1162,demonhunter,havoc,37,13,24
quelthalas,1160,demonhunter,havoc,27,14,13
kelthuzad,1152,demonhunter,havoc,24,12,12
jubeithos,1151,demonhunter,havoc,24,12,12
wyrmrest-accord,1151,demonhunter,havoc,24,12,12
silvermoon,1151,demonhunter,havoc,24,12,12
tichondrius,1150,demonhunter,havoc,24,12,12
emerald-dream,1150,demonhunter,havoc,30,12,18
korgath,1147,demonhunter,havoc,19,13,6
frostmourne,1147,demonhunter,havoc,24,12,12
nordrassil,1145,demonhunter,havoc,18,12,6
area-52,1145,demonhunter,havoc,24,12,12
malganis,1142,demonhunter,havoc,24,12,12
stormrage,1141,demonhunter,havoc,21,13,8
tichondrius,1140,demonhunter,havoc,30,14,16
tichondrius,1138,demonhunter,havoc,18,12,6
hakkar,1138,demonhunter,havoc,31,17,14
area-52,1138,demonhunter,havoc,30,12,18
area-52,1136,demonhunter,havoc,25,12,13
warsong,1130,demonhunter,havoc,30,19,11
malganis,1126,demonhunter,havoc,24,16,8
malorne,1124,demonhunter,havoc,24,18,6
illidan,1123,demonhunter,havoc,96,52,44
kelthuzad,1118,demonhunter,havoc,29,13,16
darkspear,1118,demonhunter,havoc,29,12,17
kiljaeden,1115,demonhunter,havoc,50,22,28
thrall,1101,demonhunter,havoc,41,22,19
area-52,1091,demonhunter,havoc,31,13,18
stormscale,1087,demonhunter,havoc,47,26,21
stormreaver,1084,demonhunter,havoc,32,12,20
illidan,1080,demonhunter,havoc,56,25,31
bloodscalp,1076,demonhunter,havoc,36,15,21
quelthalas,1059,demonhunter,havoc,18,12,6
veknilash,1059,demonhunter,havoc,72,41,31
area-52,1056,demonhunter,havoc,18,11,7
tanaris,1055,demonhunter,havoc,18,11,7
sargeras,1055,demonhunter,havoc,18,11,7
frostmourne,1055,demonhunter,havoc,18,11,7
tichondrius,1055,demonhunter,havoc,18,11,7
malganis,1054,demonhunter,havoc,18,11,7
tichondrius,1054,demonhunter,havoc,18,11,7
kiljaeden,1054,demonhunter,havoc,24,11,13
stormrage,1054,demonhunter,havoc,30,11,19
tichondrius,1053,demonhunter,havoc,18,11,7
quelthalas,1052,demonhunter,havoc,18,11,7
azralon,1051,demonhunter,havoc,24,11,13
area-52,1051,demonhunter,havoc,26,11,15
stormrage,1049,demonhunter,havoc,41,18,23
tichondrius,1049,demonhunter,havoc,29,11,18
moon-guard,1048,demonhunter,havoc,24,11,13
bleeding-hollow,1047,demonhunter,havoc,33,17,16
black-dragonflight,1047,demonhunter,havoc,30,11,19
ragnaros,1042,demonhunter,havoc,18,11,7
sargeras,1042,demonhunter,havoc,24,11,13
lightnings-blade,1041,demonhunter,havoc,18,11,7
drenden,1041,demonhunter,havoc,18,11,7
bleeding-hollow,1041,demonhunter,havoc,26,11,15
quelthalas,1036,demonhunter,havoc,30,16,14
dalaran,1036,demonhunter,havoc,30,11,19
wildhammer,1027,demonhunter,havoc,48,24,24
tichondrius,1022,demonhunter,havoc,23,11,12
azralon,1008,demonhunter,havoc,36,13,23
zuljin,1007,demonhunter,havoc,23,11,12
bleeding-hollow,1007,demonhunter,havoc,42,20,22
kirin-tor,1005,demonhunter,havoc,23,12,11
azralon,1004,demonhunter,havoc,23,11,12
quelthalas,1000,demonhunter,havoc,21,12,9
drakkari,1000,demonhunter,havoc,45,22,23
sargeras,993,demonhunter,havoc,18,11,7
moon-guard,993,demonhunter,havoc,48,27,21
frostmourne,991,demonhunter,havoc,24,12,12
tichondrius,991,demonhunter,havoc,26,11,15
stormrage,990,demonhunter,havoc,22,11,11
frostmourne,988,demonhunter,havoc,23,11,12
malganis,986,demonhunter,havoc,22,11,11
tichondrius,975,demonhunter,havoc,14,11,3
thunderlord,964,demonhunter,havoc,48,25,23
dalaran,960,demonhunter,havoc,18,10,8
tichondrius,960,demonhunter,havoc,24,10,14
tichondrius,959,demonhunter,havoc,24,10,14
ragnaros,959,demonhunter,havoc,24,10,14
stormrage,958,demonhunter,havoc,21,13,8
tichondrius,958,demonhunter,havoc,18,10,8
malganis,958,demonhunter,havoc,18,10,8
tichondrius,958,demonhunter,havoc,24,10,14
tichondrius,958,demonhunter,havoc,24,10,14
malganis,957,demonhunter,havoc,18,10,8
stormrage,957,demonhunter,havoc,18,10,8
frostmourne,956,demonhunter,havoc,18,10,8
tichondrius,956,demonhunter,havoc,18,10,8
area-52,955,demonhunter,havoc,18,10,8
amanthul,953,demonhunter,havoc,24,10,14
azralon,945,demonhunter,havoc,42,21,21
sargeras,932,demonhunter,havoc,27,10,17
fizzcrank,929,demonhunter,havoc,17,10,7
korialstrasz,929,demonhunter,havoc,36,12,24
illidan,926,demonhunter,havoc,23,10,13
frostmane,924,demonhunter,havoc,22,10,12
tichondrius,911,demonhunter,havoc,23,10,13
uther,911,demonhunter,havoc,23,10,13
stormrage,895,demonhunter,havoc,14,10,4
kelthuzad,895,demonhunter,havoc,23,10,13
dalaran,895,demonhunter,havoc,24,10,14
thrall,894,demonhunter,havoc,30,15,15
blood-furnace,884,demonhunter,havoc,54,25,29
illidan,880,demonhunter,havoc,25,10,15
barthilas,878,demonhunter,havoc,22,10,12
emerald-dream,875,demonhunter,havoc,24,12,12
bonechewer,874,demonhunter,havoc,20,11,9
barthilas,868,demonhunter,havoc,26,10,16
barthilas,864,demonhunter,havoc,12,9,3
barthilas,864,demonhunter,havoc,12,9,3
tichondrius,864,demonhunter,havoc,18,9,9
tichondrius,864,demonhunter,havoc,18,9,9
aegwynn,864,demonhunter,havoc,21,10,11
dalaran,863,demonhunter,havoc,12,9,3
area-52,863,demonhunter,havoc,15,10,5
tichondrius,863,demonhunter,havoc,15,10,5
sargeras,863,demonhunter,havoc,15,10,5
bleeding-hollow,863,demonhunter,havoc,18,9,9
tichondrius,863,demonhunter,havoc,18,9,9
shadowsong,863,demonhunter,havoc,18,9,9
bleeding-hollow,863,demonhunter,havoc,24,9,15
stormrage,861,demonhunter,havoc,18,9,9
dalaran,860,demonhunter,havoc,12,9,3
stormrage,860,demonhunter,havoc,18,9,9
stormrage,859,demonhunter,havoc,24,9,15
korgath,858,demonhunter,havoc,24,9,15
moon-guard,857,demonhunter,havoc,18,9,9
zuljin,855,demonhunter,havoc,18,9,9
tichondrius,853,demonhunter,havoc,24,9,15
stormrage,852,demonhunter,havoc,18,9,9
tichondrius,847,demonhunter,havoc,15,10,5
nagrand,846,demonhunter,havoc,87,37,50
nemesis,843,demonhunter,havoc,24,11,13
stormrage,831,demonhunter,havoc,20,10,10
emerald-dream,816,demonhunter,havoc,15,10,5
stormreaver,809,demonhunter,havoc,15,12,3
area-52,794,demonhunter,havoc,14,9,5
dragonblight,790,demonhunter,havoc,14,9,5
tichondrius,768,demonhunter,havoc,12,8,4
malganis,768,demonhunter,havoc,12,8,4
proudmoore,768,demonhunter,havoc,12,8,4
thunderhorn,768,demonhunter,havoc,12,8,4
sargeras,768,demonhunter,havoc,13,8,5
ragnaros,768,demonhunter,havoc,18,8,10
tichondrius,768,demonhunter,havoc,18,8,10
arthas,768,demonhunter,havoc,18,8,10
zuljin,768,demonhunter,havoc,18,8,10
frostmourne,768,demonhunter,havoc,18,8,10
illidan,768,demonhunter,havoc,18,8,10
tichondrius,768,demonhunter,havoc,19,8,11
sargeras,768,demonhunter,havoc,24,8,16
malganis,767,demonhunter,havoc,12,8,4
kelthuzad,767,demonhunter,havoc,12,8,4
stonemaul,767,demonhunter,havoc,12,8,4
earthen-ring,767,demonhunter,havoc,12,8,4
illidan,767,demonhunter,havoc,12,8,4
darkspear,767,demonhunter,havoc,15,9,6
frostmourne,766,demonhunter,havoc,12,8,4
perenolde,766,demonhunter,havoc,12,8,4
gurubashi,766,demonhunter,havoc,18,8,10
arthas,765,demonhunter,havoc,24,8,16
kiljaeden,764,demonhunter,havoc,12,8,4
illidan,764,demonhunter,havoc,18,8,10
area-52,763,demonhunter,havoc,12,8,4
mugthol,763,demonhunter,havoc,18,8,10
illidan,762,demonhunter,havoc,12,8,4
quelthalas,762,demonhunter,havoc,18,8,10
drakkari,752,demonhunter,havoc,18,8,10
garrosh,752,demonhunter,havoc,18,8,10
gorefiend,748,demonhunter,havoc,12,8,4
ragnaros,734,demonhunter,havoc,22,8,14
area-52,714,demonhunter,havoc,20,9,11
thunderhorn,699,demonhunter,havoc,42,16,26
proudmoore,696,demonhunter,havoc,11,8,3
bleeding-hollow,672,demonhunter,havoc,12,7,5
azralon,672,demonhunter,havoc,12,7,5
stormrage,672,demonhunter,havoc,12,7,5
illidan,672,demonhunter,havoc,12,7,5
tichondrius,672,demonhunter,havoc,12,7,5
bleeding-hollow,672,demonhunter,havoc,12,7,5
whisperwind,672,demonhunter,havoc,12,7,5
zuljin,672,demonhunter,havoc,12,7,5
tichondrius,672,demonhunter,havoc,12,7,5
bleeding-hollow,672,demonhunter,havoc,12,7,5
khaz-modan,672,demonhunter,havoc,12,7,5
stormrage,672,demonhunter,havoc,12,7,5
durotan,672,demonhunter,havoc,13,7,6
malganis,672,demonhunter,havoc,18,7,11
kelthuzad,672,demonhunter,havoc,18,7,11
moon-guard,672,demonhunter,havoc,18,7,11
stormrage,672,demonhunter,havoc,18,7,11
frostmourne,672,demonhunter,havoc,18,7,11
sargeras,672,demonhunter,havoc,18,7,11
kiljaeden,672,demonhunter,havoc,18,7,11
frostmourne,672,demonhunter,havoc,18,7,11
area-52,672,demonhunter,havoc,24,7,17
stormscale,672,demonhunter,havoc,24,7,17
azjolnerub,672,demonhunter,havoc,24,7,17
shuhalo,671,demonhunter,havoc,12,7,5
emerald-dream,671,demonhunter,havoc,12,7,5
stormrage,671,demonhunter,havoc,12,7,5
moon-guard,671,demonhunter,havoc,12,7,5
kelthuzad,671,demonhunter,havoc,12,7,5
drakkari,671,demonhunter,havoc,12,7,5
tichondrius,671,demonhunter,havoc,12,7,5
tichondrius,671,demonhunter,havoc,12,7,5
area-52,671,demonhunter,havoc,18,7,11
ragnaros,671,demonhunter,havoc,24,7,17
area-52,670,demonhunter,havoc,12,7,5
area-52,670,demonhunter,havoc,12,7,5
kiljaeden,668,demonhunter,havoc,18,7,11
blood-furnace,666,demonhunter,havoc,12,7,5
burning-legion,658,demonhunter,havoc,12,7,5
thrall,657,demonhunter,havoc,12,7,5
stormscale,653,demonhunter,havoc,21,8,13
kiljaeden,639,demonhunter,havoc,10,7,3
azralon,639,demonhunter,havoc,17,7,10
emerald-dream,633,demonhunter,havoc,17,7,10
sargeras,624,demonhunter,havoc,15,7,8
moon-guard,624,demonhunter,havoc,21,7,14
tichondrius,623,demonhunter,havoc,11,7,4
aerie-peak,623,demonhunter,havoc,17,7,10
bonechewer,612,demonhunter,havoc,15,8,7
aegwynn,607,demonhunter,havoc,8,7,1
tichondrius,607,demonhunter,havoc,14,7,7
tichondrius,576,demonhunter,havoc,12,6,6
tichondrius,576,demonhunter,havoc,12,6,6
tichondrius,576,demonhunter,havoc,12,6,6
korgath,576,demonhunter,havoc,12,6,6
malganis,576,demonhunter,havoc,12,6,6
malganis,576,demonhunter,havoc,12,6,6
winterhoof,576,demonhunter,havoc,12,6,6
bonechewer,576,demonhunter,havoc,12,6,6
bleeding-hollow,576,demonhunter,havoc,12,6,6
boulderfist,576,demonhunter,havoc,12,6,6
ragnaros,576,demonhunter,havoc,12,6,6
area-52,576,demonhunter,havoc,12,6,6
azralon,576,demonhunter,havoc,12,6,6
azralon,576,demonhunter,havoc,12,6,6
illidan,576,demonhunter,havoc,12,6,6
sargeras,576,demonhunter,havoc,12,6,6
bleeding-hollow,576,demonhunter,havoc,12,6,6
sargeras,576,demonhunter,havoc,12,6,6
illidan,576,demonhunter,havoc,12,6,6
moon-guard,576,demonhunter,havoc,12,6,6
trollbane,576,demonhunter,havoc,12,6,6
mugthol,576,demonhunter,havoc,12,6,6
borean-tundra,576,demonhunter,havoc,18,6,12
ragnaros,576,demonhunter,havoc,18,6,12
tichondrius,576,demonhunter,havoc,19,6,13
tichondrius,576,demonhunter,havoc,24,6,18
kiljaeden,575,demonhunter,havoc,12,6,6
stormrage,575,demonhunter,havoc,12,6,6
aegwynn,575,demonhunter,havoc,12,6,6
illidan,575,demonhunter,havoc,12,6,6
tichondrius,575,demonhunter,havoc,12,6,6
azshara,575,demonhunter,havoc,12,6,6
laughing-skull,575,demonhunter,havoc,12,6,6
tichondrius,575,demonhunter,havoc,12,6,6
stormrage,575,demonhunter,havoc,12,6,6
malorne,575,demonhunter,havoc,12,6,6
proudmoore,575,demonhunter,havoc,12,6,6
gurubashi,575,demonhunter,havoc,12,6,6
tichondrius,574,demonhunter,havoc,18,6,12
kelthuzad,574,demonhunter,havoc,18,6,12
tichondrius,569,demonhunter,havoc,12,6,6
terokkar,569,demonhunter,havoc,12,6,6
ghostlands,568,demonhunter,havoc,12,6,6
illidan,567,demonhunter,havoc,12,6,6
ragnaros,541,demonhunter,havoc,10,7,3
boulderfist,525,demonhunter,havoc,11,6,5
sargeras,519,demonhunter,havoc,17,9,8
tichondrius,512,demonhunter,havoc,10,6,4
azralon,511,demonhunter,havoc,14,6,8
moon-guard,491,demonhunter,havoc,13,6,7
gilneas,480,demonhunter,havoc,6,5,1
frostmourne,480,demonhunter,havoc,6,5,1
quelthalas,480,demonhunter,havoc,6,5,1
kelthuzad,480,demonhunter,havoc,6,5,1
tichondrius,480,demonhunter,havoc,6,5,1
sargeras,480,demonhunter,havoc,6,5,1
emerald-dream,480,demonhunter,havoc,6,5,1
sargeras,480,demonhunter,havoc,6,5,1
tichondrius,480,demonhunter,havoc,6,5,1
tichondrius,480,demonhunter,havoc,6,5,1
area-52,480,demonhunter,havoc,12,5,7
moon-guard,480,demonhunter,havoc,12,5,7
area-52,480,demonhunter,havoc,12,5,7
destromath,480,demonhunter,havoc,12,5,7
illidan,480,demonhunter,havoc,12,5,7
area-52,480,demonhunter,havoc,12,5,7
tichondrius,480,demonhunter,havoc,12,5,7
bleeding-hollow,480,demonhunter,havoc,12,5,7
korgath,480,demonhunter,havoc,12,5,7
kelthuzad,480,demonhunter,havoc,12,5,7
tichondrius,480,demonhunter,havoc,12,5,7
bleeding-hollow,480,demonhunter,havoc,12,5,7
tichondrius,480,demonhunter,havoc,12,5,7
proudmoore,480,demonhunter,havoc,12,5,7
malganis,480,demonhunter,havoc,12,5,7
stormrage,480,demonhunter,havoc,12,5,7
illidan,480,demonhunter,havoc,12,5,7
ragnaros,480,demonhunter,havoc,12,5,7
tichondrius,480,demonhunter,havoc,12,5,7
drakkari,480,demonhunter,havoc,12,5,7
tichondrius,480,demonhunter,havoc,12,5,7
moon-guard,480,demonhunter,havoc,12,5,7
stormrage,480,demonhunter,havoc,12,5,7
azralon,480,demonhunter,havoc,12,5,7
azralon,480,demonhunter,havoc,12,5,7
tichondrius,480,demonhunter,havoc,12,5,7
tichondrius,480,demonhunter,havoc,12,5,7
area-52,480,demonhunter,havoc,12,5,7
frostmourne,480,demonhunter,havoc,12,5,7
zuljin,480,demonhunter,havoc,12,5,7
bloodhoof,480,demonhunter,havoc,12,5,7
tichondrius,480,demonhunter,havoc,12,5,7
blackrock,480,demonhunter,havoc,12,5,7
stormrage,480,demonhunter,havoc,18,5,13
dark-iron,480,demonhunter,havoc,18,5,13
tichondrius,479,demonhunter,havoc,6,5,1
tichondrius,479,demonhunter,havoc,6,5,1
goldrinn,478,demonhunter,havoc,12,5,7
bonechewer,478,demonhunter,havoc,12,5,7
tichondrius,477,demonhunter,havoc,6,5,1
emerald-dream,475,demonhunter,havoc,12,5,7
tichondrius,473,demonhunter,havoc,12,5,7
thrall,472,demonhunter,havoc,12,5,7
cairne,472,demonhunter,havoc,12,5,7
frostmourne,463,demonhunter,havoc,11,5,6
scilla,448,demonhunter,havoc,10,5,5
thrall,447,demonhunter,havoc,11,5,6
elune,443,demonhunter,havoc,8,6,2
stormrage,431,demonhunter,havoc,11,5,6
executus,430,demonhunter,havoc,15,6,9
proudmoore,416,demonhunter,havoc,10,5,5
emerald-dream,415,demonhunter,havoc,14,5,9
sargeras,415,demonhunter,havoc,14,5,9
tichondrius,415,demonhunter,havoc,14,5,9
bleeding-hollow,384,demonhunter,havoc,11,8,3
area-52,384,demonhunter,havoc,6,4,2
proudmoore,384,demonhunter,havoc,6,4,2
drakkari,384,demonhunter,havoc,6,4,2
destromath,384,demonhunter,havoc,6,4,2
barthilas,384,demonhunter,havoc,6,4,2
kelthuzad,384,demonhunter,havoc,6,4,2
illidan,384,demonhunter,havoc,6,4,2
dalaran,384,demonhunter,havoc,6,4,2
sargeras,384,demonhunter,havoc,6,4,2
gallywix,384,demonhunter,havoc,6,4,2
stormrage,384,demonhunter,havoc,6,4,2
tichondrius,384,demonhunter,havoc,6,4,2
stormrage,384,demonhunter,havoc,6,4,2
kiljaeden,384,demonhunter,havoc,6,4,2
kelthuzad,384,demonhunter,havoc,6,4,2
stormrage,384,demonhunter,havoc,6,4,2
moon-guard,384,demonhunter,havoc,6,4,2
illidan,384,demonhunter,havoc,6,4,2
illidan,384,demonhunter,havoc,6,4,2
tichondrius,384,demonhunter,havoc,6,4,2
darrowmere,384,demonhunter,havoc,6,4,2
tichondrius,384,demonhunter,havoc,6,4,2
illidan,384,demonhunter,havoc,6,4,2
illidan,384,demonhunter,havoc,6,4,2
illidan,384,demonhunter,havoc,6,4,2
anvilmar,384,demonhunter,havoc,6,4,2
tichondrius,384,demonhunter,havoc,6,4,2
area-52,384,demonhunter,havoc,6,4,2
tichondrius,384,demonhunter,havoc,6,4,2
emerald-dream,384,demonhunter,havoc,6,4,2
illidan,384,demonhunter,havoc,6,4,2
tichondrius,384,demonhunter,havoc,6,4,2
silver-hand,384,demonhunter,havoc,6,4,2
frostmourne,384,demonhunter,havoc,6,4,2
frostmourne,384,demonhunter,havoc,6,4,2
tichondrius,384,demonhunter,havoc,6,4,2
quelthalas,384,demonhunter,havoc,6,4,2
tichondrius,384,demonhunter,havoc,6,4,2
illidan,384,demonhunter,havoc,6,4,2
illidan,384,demonhunter,havoc,6,4,2
zuljin,384,demonhunter,havoc,17,6,11
thrall,384,demonhunter,havoc,12,4,8
barthilas,384,demonhunter,havoc,12,4,8
proudmoore,384,demonhunter,havoc,12,4,8
dalaran,384,demonhunter,havoc,12,4,8
zuljin,384,demonhunter,havoc,12,4,8
illidan,384,demonhunter,havoc,12,4,8
tichondrius,384,demonhunter,havoc,12,4,8
tichondrius,384,demonhunter,havoc,12,4,8
kelthuzad,384,demonhunter,havoc,12,4,8
whisperwind,384,demonhunter,havoc,12,4,8
illidan,384,demonhunter,havoc,12,4,8
drakkari,384,demonhunter,havoc,12,4,8
illidan,384,demonhunter,havoc,12,4,8
tichondrius,384,demonhunter,havoc,12,4,8
tichondrius,384,demonhunter,havoc,12,4,8
bleeding-hollow,384,demonhunter,havoc,12,4,8
darkspear,384,demonhunter,havoc,12,4,8
quelthalas,384,demonhunter,havoc,12,4,8
thrall,384,demonhunter,havoc,12,4,8
sargeras,384,demonhunter,havoc,12,4,8
illidan,384,demonhunter,havoc,12,4,8
bleeding-hollow,384,demonhunter,havoc,12,4,8
illidan,384,demonhunter,havoc,12,4,8
proudmoore,384,demonhunter,havoc,12,4,8
ragnaros,384,demonhunter,havoc,12,4,8
moon-guard,384,demonhunter,havoc,12,4,8
blood-furnace,384,demonhunter,havoc,12,4,8
malganis,384,demonhunter,havoc,18,4,14
lightbringer,383,demonhunter,havoc,9,5,4
darkspear,383,demonhunter,havoc,12,4,8
zuljin,383,demonhunter,havoc,12,4,8
ragnaros,382,demonhunter,havoc,6,4,2
darrowmere,351,demonhunter,havoc,11,4,7
bleeding-hollow,336,demonhunter,havoc,9,4,5
area-52,336,demonhunter,havoc,15,5,10
dragonmaw,336,demonhunter,havoc,15,4,11
area-52,335,demonhunter,havoc,11,4,7
kelthuzad,330,demonhunter,havoc,17,5,12
malygos,318,demonhunter,havoc,8,4,4
wyrmrest-accord,304,demonhunter,havoc,11,5,6
durotan,288,demonhunter,havoc,6,3,3
stormrage,288,demonhunter,havoc,6,3,3
quelthalas,288,demonhunter,havoc,6,3,3
illidan,288,demonhunter,havoc,6,3,3
illidan,288,demonhunter,havoc,6,3,3
lightbringer,288,demonhunter,havoc,6,3,3
illidan,288,demonhunter,havoc,6,3,3
draenor,288,demonhunter,havoc,6,3,3
illidan,288,demonhunter,havoc,6,3,3
silvermoon,288,demonhunter,havoc,6,3,3
malganis,288,demonhunter,havoc,6,3,3
malganis,288,demonhunter,havoc,6,3,3
bleeding-hollow,288,demonhunter,havoc,6,3,3
malganis,288,demonhunter,havoc,6,3,3
moon-guard,288,demonhunter,havoc,6,3,3
kelthuzad,288,demonhunter,havoc,6,3,3
whisperwind,288,demonhunter,havoc,6,3,3
zuljin,288,demonhunter,havoc,6,3,3
azralon,288,demonhunter,havoc,6,3,3
guldan,288,demonhunter,havoc,6,3,3
skullcrusher,288,demonhunter,havoc,6,3,3
stormrage,288,demonhunter,havoc,6,3,3
drakthul,288,demonhunter,havoc,6,3,3
area-52,288,demonhunter,havoc,6,3,3
illidan,288,demonhunter,havoc,6,3,3
area-52,288,demonhunter,havoc,6,3,3
azralon,288,demonhunter,havoc,6,3,3
silvermoon,288,demonhunter,havoc,6,3,3
zuljin,288,demonhunter,havoc,6,3,3
area-52,288,demonhunter,havoc,6,3,3
blood-furnace,288,demonhunter,havoc,6,3,3
area-52,288,demonhunter,havoc,6,3,3
area-52,288,demonhunter,havoc,6,3,3
area-52,288,demonhunter,havoc,6,3,3
tichondrius,288,demonhunter,havoc,6,3,3
grizzly-hills,288,demonhunter,havoc,6,3,3
tichondrius,288,demonhunter,havoc,6,3,3
illidan,288,demonhunter,havoc,6,3,3
tichondrius,288,demonhunter,havoc,6,3,3
dalaran,288,demonhunter,havoc,6,3,3
tichondrius,288,demonhunter,havoc,6,3,3
sargeras,288,demonhunter,havoc,6,3,3
barthilas,288,demonhunter,havoc,6,3,3
tichondrius,288,demonhunter,havoc,6,3,3
executus,288,demonhunter,havoc,6,3,3
darkspear,288,demonhunter,havoc,6,3,3
tichondrius,288,demonhunter,havoc,6,3,3
queldorei,288,demonhunter,havoc,6,3,3
thunderhorn,288,demonhunter,havoc,6,3,3
emerald-dream,288,demonhunter,havoc,6,3,3
tichondrius,288,demonhunter,havoc,6,3,3
sargeras,288,demonhunter,havoc,6,3,3
frostmourne,288,demonhunter,havoc,6,3,3
sargeras,288,demonhunter,havoc,6,3,3
frostmourne,288,demonhunter,havoc,6,3,3
bonechewer,288,demonhunter,havoc,6,3,3
tichondrius,288,demonhunter,havoc,6,3,3
azjolnerub,288,demonhunter,havoc,6,3,3
khazgoroth,288,demonhunter,havoc,6,3,3
nathrezim,288,demonhunter,havoc,6,3,3
nemesis,288,demonhunter,havoc,15,4,11
amanthul,288,demonhunter,havoc,12,3,9
area-52,288,demonhunter,havoc,12,3,9
zuljin,288,demonhunter,havoc,12,3,9
blades-edge,288,demonhunter,havoc,12,3,9
quelthalas,288,demonhunter,havoc,12,3,9
tichondrius,288,demonhunter,havoc,12,3,9
daggerspine,288,demonhunter,havoc,12,3,9
tol-barad,288,demonhunter,havoc,12,3,9
area-52,288,demonhunter,havoc,12,3,9
illidan,288,demonhunter,havoc,12,3,9
kelthuzad,288,demonhunter,havoc,12,3,9
dalaran,288,demonhunter,havoc,12,3,9
stormscale,288,demonhunter,havoc,18,3,15
stormrage,287,demonhunter,havoc,6,3,3
illidan,287,demonhunter,havoc,6,3,3
senjin,287,demonhunter,havoc,6,3,3
stormrage,287,demonhunter,havoc,6,3,3
malganis,287,demonhunter,havoc,14,4,10
garrosh,287,demonhunter,havoc,12,3,9
emerald-dream,239,demonhunter,havoc,5,3,2
illidan,239,demonhunter,havoc,5,3,2
moon-guard,234,demonhunter,havoc,8,5,3
draenor,231,demonhunter,havoc,16,6,10
azralon,223,demonhunter,havoc,8,3,5
quelthalas,208,demonhunter,havoc,7,3,4
tichondrius,192,demonhunter,havoc,4,3,1
moon-guard,192,demonhunter,havoc,8,3,5
barthilas,192,demonhunter,havoc,6,2,4
tichondrius,192,demonhunter,havoc,6,2,4
area-52,192,demonhunter,havoc,6,2,4
tichondrius,192,demonhunter,havoc,6,2,4
illidan,192,demonhunter,havoc,6,2,4
ragnaros,192,demonhunter,havoc,6,2,4
illidan,192,demonhunter,havoc,6,2,4
quelthalas,192,demonhunter,havoc,6,2,4
tichondrius,192,demonhunter,havoc,6,2,4
illidan,192,demonhunter,havoc,6,2,4
saurfang,192,demonhunter,havoc,6,2,4
azralon,192,demonhunter,havoc,6,2,4
thrall,192,demonhunter,havoc,6,2,4
tichondrius,192,demonhunter,havoc,6,2,4
frostmourne,192,demonhunter,havoc,6,2,4
thrall,192,demonhunter,havoc,6,2,4
thrall,192,demonhunter,havoc,6,2,4
bonechewer,192,demonhunter,havoc,6,2,4
illidan,192,demonhunter,havoc,6,2,4
frostmourne,192,demonhunter,havoc,6,2,4
tichondrius,192,demonhunter,havoc,6,2,4
malganis,192,demonhunter,havoc,6,2,4
wyrmrest-accord,192,demonhunter,havoc,6,2,4
bleeding-hollow,192,demonhunter,havoc,6,2,4
eitrigg,192,demonhunter,havoc,6,2,4
tichondrius,192,demonhunter,havoc,6,2,4
zuljin,192,demonhunter,havoc,6,2,4
drakkari,192,demonhunter,havoc,6,2,4
malganis,192,demonhunter,havoc,6,2,4
emerald-dream,192,demonhunter,havoc,6,2,4
bladefist,192,demonhunter,havoc,6,2,4
steamwheedle-cartel,192,demonhunter,havoc,6,2,4
moon-guard,192,demonhunter,havoc,6,2,4
thrall,192,demonhunter,havoc,6,2,4
blackrock,192,demonhunter,havoc,6,2,4
whisperwind,192,demonhunter,havoc,6,2,4
aerie-peak,192,demonhunter,havoc,6,2,4
tichondrius,192,demonhunter,havoc,6,2,4
dalaran,192,demonhunter,havoc,6,2,4
the-forgotten-coast,192,demonhunter,havoc,6,2,4
borean-tundra,192,demonhunter,havoc,6,2,4
tichondrius,192,demonhunter,havoc,6,2,4
stormrage,192,demonhunter,havoc,6,2,4
demon-soul,192,demonhunter,havoc,6,2,4
twisting-nether,192,demonhunter,havoc,6,2,4
stormrage,192,demonhunter,havoc,6,2,4
destromath,192,demonhunter,havoc,6,2,4
norgannon,192,demonhunter,havoc,6,2,4
drakthul,192,demonhunter,havoc,6,2,4
khaz-modan,192,demonhunter,havoc,6,2,4
burning-legion,192,demonhunter,havoc,6,2,4
blades-edge,192,demonhunter,havoc,6,2,4
frostwolf,192,demonhunter,havoc,6,2,4
zuluhed,192,demonhunter,havoc,6,2,4
stormrage,192,demonhunter,havoc,6,2,4
firetree,192,demonhunter,havoc,6,2,4
stormrage,192,demonhunter,havoc,6,2,4
kiljaeden,192,demonhunter,havoc,6,2,4
sargeras,192,demonhunter,havoc,6,2,4
sargeras,192,demonhunter,havoc,6,2,4
area-52,192,demonhunter,havoc,6,2,4
sargeras,192,demonhunter,havoc,6,2,4
sargeras,192,demonhunter,havoc,6,2,4
azralon,192,demonhunter,havoc,6,2,4
dethecus,192,demonhunter,havoc,6,2,4
area-52,192,demonhunter,havoc,6,2,4
area-52,192,demonhunter,havoc,6,2,4
ragnaros,192,demonhunter,havoc,10,3,7
stormrage,192,demonhunter,havoc,7,2,5
sargeras,192,demonhunter,havoc,7,2,5
cenarion-circle,192,demonhunter,havoc,8,2,6
ravencrest,192,demonhunter,havoc,12,2,10
illidan,192,demonhunter,havoc,12,2,10
area-52,192,demonhunter,havoc,12,2,10
frostmourne,192,demonhunter,havoc,12,2,10
ragnaros,192,demonhunter,havoc,12,2,10
bleeding-hollow,192,demonhunter,havoc,12,2,10
tichondrius,191,demonhunter,havoc,6,2,4
dalaran,191,demonhunter,havoc,6,2,4
stormrage,191,demonhunter,havoc,6,2,4
wyrmrest-accord,191,demonhunter,havoc,6,2,4
moon-guard,190,demonhunter,havoc,12,2,10
malganis,159,demonhunter,havoc,5,2,3
sargeras,138,demonhunter,havoc,15,3,12
zuljin,128,demonhunter,havoc,4,2,2
area-52,128,demonhunter,havoc,4,2,2
azralon,127,demonhunter,havoc,14,2,12
tichondrius,96,demonhunter,havoc,3,2,1
tichondrius,96,demonhunter,havoc,6,1,5
area-52,96,demonhunter,havoc,6,1,5
stormrage,96,demonhunter,havoc,6,1,5
scilla,96,demonhunter,havoc,6,1,5
sargeras,96,demonhunter,havoc,6,1,5
burning-legion,96,demonhunter,havoc,6,1,5
emerald-dream,96,demonhunter,havoc,6,1,5
tichondrius,96,demonhunter,havoc,6,1,5
emerald-dream,96,demonhunter,havoc,6,1,5
emerald-dream,96,demonhunter,havoc,6,1,5
tichondrius,96,demonhunter,havoc,6,1,5
zuljin,96,demonhunter,havoc,6,1,5
illidan,96,demonhunter,havoc,6,1,5
sargeras,96,demonhunter,havoc,6,1,5
frostmourne,96,demonhunter,havoc,6,1,5
bonechewer,96,demonhunter,havoc,6,1,5
area-52,96,demonhunter,havoc,6,1,5
tichondrius,96,demonhunter,havoc,6,1,5
illidan,96,demonhunter,havoc,6,1,5
ragnaros,96,demonhunter,havoc,6,1,5
tichondrius,96,demonhunter,havoc,6,1,5
ragnaros,96,demonhunter,havoc,6,1,5
wyrmrest-accord,96,demonhunter,havoc,6,1,5
drakkari,96,demonhunter,havoc,6,1,5
tichondrius,96,demonhunter,havoc,6,1,5
uther,96,demonhunter,havoc,6,1,5
drakkari,96,demonhunter,havoc,6,1,5
tichondrius,96,demonhunter,havoc,6,1,5
tichondrius,96,demonhunter,havoc,6,1,5
tichondrius,96,demonhunter,havoc,6,1,5
tichondrius,96,demonhunter,havoc,6,1,5
nerzhul,96,demonhunter,havoc,6,1,5
durotan,96,demonhunter,havoc,7,1,6
area-52,96,demonhunter,havoc,9,1,8
proudmoore,96,demonhunter,havoc,12,1,11
thrall,96,demonhunter,havoc,12,1,11
proudmoore,95,demonhunter,havoc,6,1,5
malganis,79,demonhunter,havoc,5,1,4
illidan,79,demonhunter,havoc,5,1,4
moon-guard,64,demonhunter,havoc,4,1,3
stormrage,48,demonhunter,havoc,3,1,2
darkspear,48,demonhunter,havoc,3,1,2
stormrage,42,demonhunter,havoc,16,5,11
ragnaros,42,demonhunter,havoc,8,2,6
dreadmaul,31,demonhunter,havoc,2,1,1
illidan,31,demonhunter,havoc,2,1,1
shadowmoon,31,demonhunter,havoc,2,1,1
darkspear,16,demonhunter,havoc,1,1,0
stonemaul,1457,demonhunter,vengeance,66,31,35
proudmoore,1063,demonhunter,vengeance,23,14,9
frostmourne,288,demonhunter,vengeance,6,3,3
tichondrius,287,demonhunter,vengeance,6,3,3
moon-guard,286,demonhunter,vengeance,6,3,3
tichondrius,96,demonhunter,vengeance,6,1,5
tichondrius,2238,druid,restoration,86,53,33
tichondrius,2148,druid,restoration,119,70,49
tichondrius,2141,druid,restoration,179,92,87
ragnaros,2108,druid,restoration,135,68,67
stormrage,2104,druid,restoration,60,37,23
dathremar,2037,druid,restoration,90,43,47
moonrunner,2032,druid,restoration,51,32,19
tichondrius,2025,druid,restoration,59,32,27
illidan,2000,druid,restoration,123,70,53
zuljin,1952,druid,restoration,89,51,38
tichondrius,1942,druid,restoration,113,56,57
tichondrius,1941,druid,restoration,84,49,35
area-52,1921,druid,restoration,72,38,34
tichondrius,1915,druid,restoration,166,73,93
eredar,1898,druid,restoration,72,39,33
zuljin,1882,druid,restoration,42,30,12
zuljin,1875,druid,restoration,65,30,35
illidan,1872,druid,restoration,64,32,32
rexxar,1869,druid,restoration,72,37,35
stormrage,1867,druid,restoration,42,25,17
tichondrius,1855,druid,restoration,118,63,55
tichondrius,1855,druid,restoration,73,35,38
bleeding-hollow,1847,druid,restoration,42,23,19
tichondrius,1839,druid,restoration,66,36,30
dalaran,1836,druid,restoration,62,36,26
icecrown,1836,druid,restoration,54,31,23
tichondrius,1835,druid,restoration,113,55,58
stormrage,1834,druid,restoration,53,25,28
tichondrius,1828,druid,restoration,48,29,19
tichondrius,1825,druid,restoration,60,24,36
area-52,1819,druid,restoration,45,32,13
tichondrius,1818,druid,restoration,59,31,28
tichondrius,1817,druid,restoration,36,22,14
ragnaros,1811,druid,restoration,71,33,38
nemesis,1810,druid,restoration,30,19,11
tichondrius,1810,druid,restoration,36,22,14
bleeding-hollow,1809,druid,restoration,66,31,35
ravencrest,1805,druid,restoration,65,31,34
gurubashi,1804,druid,restoration,47,24,23
auchindoun,1801,druid,restoration,59,35,24
shadowsong,1800,druid,restoration,41,28,13
sargeras,1800,druid,restoration,81,44,37
stormrage,1799,druid,restoration,201,110,91
arthas,1799,druid,restoration,133,69,64
illidan,1798,druid,restoration,48,29,19
illidan,1794,druid,restoration,123,67,56
tichondrius,1786,druid,restoration,48,22,26
tichondrius,1785,druid,restoration,46,25,21
illidan,1781,druid,restoration,54,29,25
sargeras,1780,druid,restoration,36,19,17
dalaran,1772,druid,restoration,76,43,33
sargeras,1769,druid,restoration,29,19,10
dathremar,1738,druid,restoration,40,21,19
stormrage,1737,druid,restoration,54,23,31
dark-iron,1736,druid,restoration,54,23,31
barthilas,1730,druid,restoration,44,24,20
tichondrius,1719,druid,restoration,42,24,18
tichondrius,1707,druid,restoration,76,32,44
tichondrius,1699,druid,restoration,39,23,16
stormrage,1698,druid,restoration,66,39,27
stormrage,1693,druid,restoration,198,113,85
illidan,1685,druid,restoration,29,18,11
daggerspine,1678,druid,restoration,54,27,27
lightbringer,1678,druid,restoration,108,43,65
tichondrius,1672,druid,restoration,36,18,18
proudmoore,1668,druid,restoration,66,35,31
uther,1664,druid,restoration,47,21,26
zuljin,1662,druid,restoration,55,30,25
tichondrius,1660,druid,restoration,36,20,16
kelthuzad,1653,druid,restoration,36,21,15
area-52,1650,druid,restoration,45,23,22
tichondrius,1650,druid,restoration,36,18,18
zuluhed,1649,druid,restoration,42,22,20
tichondrius,1649,druid,restoration,162,84,78
tichondrius,1648,druid,restoration,42,21,21
illidan,1647,druid,restoration,42,21,21
sargeras,1643,druid,restoration,60,25,35
kilrogg,1638,druid,restoration,54,37,17
dalaran,1636,druid,restoration,48,26,22
area-52,1634,druid,restoration,94,49,45
stormrage,1630,druid,restoration,31,17,14
tichondrius,1628,druid,restoration,30,17,13
tichondrius,1624,druid,restoration,54,26,28
malganis,1622,druid,restoration,36,20,16
tichondrius,1617,druid,restoration,36,17,19
frostmourne,1615,druid,restoration,60,35,25
spirestone,1615,druid,restoration,68,36,32
sargeras,1612,druid,restoration,30,25,5
tichondrius,1611,druid,restoration,35,17,18
tichondrius,1610,druid,restoration,30,18,12
kelthuzad,1606,druid,restoration,68,41,27
quelthalas,1600,druid,restoration,57,36,21
tichondrius,1600,druid,restoration,36,19,17
malganis,1597,druid,restoration,57,26,31
tichondrius,1596,druid,restoration,43,25,18
blackrock,1595,druid,restoration,65,31,34
frostmourne,1587,druid,restoration,114,59,55
frostmourne,1584,druid,restoration,66,25,41
tichondrius,1583,druid,restoration,45,25,20
tichondrius,1582,druid,restoration,59,33,26
tichondrius,1574,druid,restoration,48,22,26
bleeding-hollow,1567,druid,restoration,100,62,38
frostmourne,1566,druid,restoration,30,19,11
tichondrius,1566,druid,restoration,215,107,108
frostmourne,1563,druid,restoration,138,64,74
sargeras,1558,druid,restoration,75,39,36
barthilas,1555,druid,restoration,52,20,32
sargeras,1553,druid,restoration,42,19,23
tichondrius,1546,druid,restoration,58,37,21
wyrmrest-accord,1544,druid,restoration,170,94,76
tichondrius,1542,druid,restoration,36,22,14
tichondrius,1541,druid,restoration,60,25,35
stormrage,1538,druid,restoration,98,53,45
tichondrius,1537,druid,restoration,93,51,42
eonar,1533,druid,restoration,49,32,17
dreadmaul,1531,druid,restoration,39,18,21
tichondrius,1526,druid,restoration,105,56,49
tichondrius,1525,druid,restoration,30,16,14
emerald-dream,1524,druid,restoration,117,61,56
ragnaros,1523,druid,restoration,41,24,17
bleeding-hollow,1523,druid,restoration,36,16,20
thrall,1519,druid,restoration,42,21,21
area-52,1516,druid,restoration,104,46,58
tichondrius,1506,druid,restoration,64,34,30
dentarg,1505,druid,restoration,37,19,18
tichondrius,1500,druid,restoration,106,57,49
illidan,1497,druid,restoration,66,29,37
moon-guard,1489,druid,restoration,99,44,55
moon-guard,1483,druid,restoration,22,17,5
bleeding-hollow,1483,druid,restoration,48,29,19
tichondrius,1479,druid,restoration,51,24,27
sargeras,1469,druid,restoration,36,16,20
stormrage,1460,druid,restoration,24,16,8
dalaran,1459,druid,restoration,36,19,17
stormrage,1452,druid,restoration,76,35,41
mugthol,1451,druid,restoration,103,56,47
tichondrius,1447,druid,restoration,54,25,29
frostmourne,1439,druid,restoration,100,44,56
malganis,1438,druid,restoration,51,27,24
tichondrius,1436,druid,restoration,24,15,9
illidan,1436,druid,restoration,63,35,28
azralon,1432,druid,restoration,72,33,39
tichondrius,1428,druid,restoration,30,15,15
illidan,1427,druid,restoration,63,31,32
emerald-dream,1425,druid,restoration,114,62,52
darkspear,1423,druid,restoration,96,51,45
tichondrius,1415,druid,restoration,32,18,14
frostmourne,1414,druid,restoration,48,21,27
sargeras,1412,druid,restoration,26,15,11
moon-guard,1402,druid,restoration,36,22,14
suramar,1400,druid,restoration,42,28,14
tichondrius,1400,druid,restoration,116,64,52
stonemaul,1399,druid,restoration,30,18,12
gnomeregan,1397,druid,restoration,99,34,65
stormrage,1395,druid,restoration,81,46,35
nazgrel,1393,druid,restoration,48,25,23
burning-blade,1387,druid,restoration,54,30,24
spinebreaker,1385,druid,restoration,98,48,50
tichondrius,1381,druid,restoration,57,36,21
proudmoore,1378,druid,restoration,30,17,13
stormrage,1374,druid,restoration,54,22,32
stormrage,1373,druid,restoration,27,16,11
moon-guard,1369,druid,restoration,84,43,41
trollbane,1359,druid,restoration,54,26,28
magtheridon,1358,druid,restoration,36,20,16
kaelthas,1356,druid,restoration,72,27,45
emerald-dream,1355,druid,restoration,102,53,49
tichondrius,1354,druid,restoration,90,55,35
thrall,1353,druid,restoration,77,40,37
tichondrius,1347,druid,restoration,38,22,16
illidan,1343,druid,restoration,58,32,26
dalaran,1343,druid,restoration,30,14,16
illidan,1342,druid,restoration,24,14,10
area-52,1342,druid,restoration,24,14,10
demon-soul,1341,druid,restoration,30,21,9
area-52,1339,druid,restoration,42,14,28
chogall,1338,druid,restoration,30,14,16
hydraxis,1338,druid,restoration,30,14,16
area-52,1338,druid,restoration,78,32,46
tichondrius,1332,druid,restoration,36,18,18
stormrage,1327,druid,restoration,24,14,10
sargeras,1323,druid,restoration,136,70,66
moon-guard,1323,druid,restoration,36,15,21
tichondrius,1321,druid,restoration,130,71,59
stormreaver,1319,druid,restoration,36,23,13
tichondrius,1318,druid,restoration,30,14,16
sargeras,1314,druid,restoration,36,15,21
moon-guard,1313,druid,restoration,24,14,10
lightnings-blade,1313,druid,restoration,30,14,16
zuluhed,1312,druid,restoration,30,14,16
ragnaros,1311,druid,restoration,72,38,34
tichondrius,1310,druid,restoration,43,21,22
thunderhorn,1309,druid,restoration,30,18,12
moon-guard,1309,druid,restoration,29,15,14
illidan,1307,druid,restoration,65,30,35
frostmourne,1297,druid,restoration,24,14,10
malganis,1295,druid,restoration,30,18,12
stormrage,1295,druid,restoration,44,20,24
area-52,1290,druid,restoration,94,44,50
barthilas,1284,druid,restoration,48,18,30
azralon,1274,druid,restoration,26,17,9
azralon,1267,druid,restoration,36,18,18
burning-blade,1265,druid,restoration,95,43,52
lightninghoof,1257,druid,restoration,91,50,41
quelthalas,1257,druid,restoration,65,34,31
moon-guard,1257,druid,restoration,109,48,61
area-52,1256,druid,restoration,30,16,14
illidan,1250,druid,restoration,28,15,13
darkspear,1250,druid,restoration,36,15,21
malganis,1249,druid,restoration,57,25,32
tichondrius,1249,druid,restoration,48,15,33
tichondrius,1247,druid,restoration,30,13,17
tichondrius,1246,druid,restoration,24,13,11
stormrage,1244,druid,restoration,24,13,11
tichondrius,1244,druid,restoration,42,22,20
kiljaeden,1243,druid,restoration,30,16,14
stormrage,1242,druid,restoration,24,13,11
moon-guard,1242,druid,restoration,30,16,14
azralon,1239,druid,restoration,18,13,5
stormrage,1238,druid,restoration,24,13,11
tichondrius,1238,druid,restoration,30,13,17
emerald-dream,1235,druid,restoration,30,13,17
illidan,1232,druid,restoration,103,56,47
eonar,1231,druid,restoration,71,29,42
aerie-peak,1226,druid,restoration,121,62,59
area-52,1226,druid,restoration,66,31,35
moon-guard,1225,druid,restoration,96,50,46
moon-guard,1220,druid,restoration,78,35,43
stormrage,1218,druid,restoration,29,18,11
hyjal,1217,druid,restoration,24,13,11
moon-guard,1217,druid,restoration,30,13,17
korgath,1214,druid,restoration,36,16,20
frostmourne,1209,druid,restoration,24,15,9
bonechewer,1203,druid,restoration,42,16,26
stormrage,1202,druid,restoration,24,13,11
kelthuzad,1200,druid,restoration,24,13,11
skullcrusher,1196,druid,restoration,63,36,27
kelthuzad,1193,druid,restoration,39,18,21
frostmourne,1191,druid,restoration,80,38,42
area-52,1190,druid,restoration,31,14,17
quelthalas,1188,druid,restoration,48,22,26
tichondrius,1188,druid,restoration,54,22,32
drakkari,1187,druid,restoration,36,20,16
illidan,1187,druid,restoration,44,22,22
chogall,1186,druid,restoration,48,25,23
aerie-peak,1185,druid,restoration,93,46,47
moon-guard,1183,druid,restoration,17,13,4
moon-guard,1178,druid,restoration,29,15,14
stormscale,1171,druid,restoration,30,14,16
tichondrius,1170,druid,restoration,93,51,42
norgannon,1170,druid,restoration,106,50,56
proudmoore,1165,druid,restoration,202,102,100
stormscale,1164,druid,restoration,58,22,36
moon-guard,1163,druid,restoration,100,48,52
frostmourne,1162,druid,restoration,23,13,10
drakthul,1162,druid,restoration,30,15,15
vashj,1159,druid,restoration,48,24,24
sargeras,1157,druid,restoration,42,22,20
nemesis,1156,druid,restoration,60,30,30
tichondrius,1156,druid,restoration,33,15,18
deathwing,1154,druid,restoration,19,13,6
kelthuzad,1152,druid,restoration,24,12,12
tichondrius,1152,druid,restoration,24,12,12
area-52,1151,druid,restoration,24,12,12
illidan,1151,druid,restoration,30,12,18
sargeras,1151,druid,restoration,30,12,18
tichondrius,1150,druid,restoration,22,13,9
sargeras,1150,druid,restoration,24,12,12
nemesis,1149,druid,restoration,30,12,18
jubeithos,1149,druid,restoration,54,14,40
boulderfist,1145,druid,restoration,33,14,19
tichondrius,1144,druid,restoration,24,12,12
tichondrius,1137,druid,restoration,23,13,10
azralon,1131,druid,restoration,48,23,25
khazgoroth,1128,druid,restoration,23,13,10
garona,1121,druid,restoration,27,21,6
tichondrius,1120,druid,restoration,18,12,6
tichondrius,1118,druid,restoration,23,12,11
stormrage,1111,druid,restoration,36,12,24
barthilas,1110,druid,restoration,71,37,34
warsong,1109,druid,restoration,33,22,11
tichondrius,1109,druid,restoration,30,17,13
frostmourne,1109,druid,restoration,48,19,29
hyjal,1108,druid,restoration,101,47,54
stormrage,1106,druid,restoration,30,12,18
uther,1099,druid,restoration,26,14,12
tichondrius,1095,druid,restoration,38,19,19
tichondrius,1091,druid,restoration,61,35,26
hellscream,1089,druid,restoration,48,24,24
sargeras,1072,druid,restoration,38,14,24
dalaran,1067,druid,restoration,19,12,7
stormrage,1066,druid,restoration,48,23,25
tichondrius,1064,druid,restoration,18,13,5
area-52,1064,druid,restoration,36,16,20
nazgrel,1063,druid,restoration,40,21,19
lethon,1062,druid,restoration,40,25,15
proudmoore,1056,druid,restoration,18,11,7
burning-blade,1056,druid,restoration,24,11,13
illidan,1056,druid,restoration,24,11,13
tichondrius,1055,druid,restoration,18,11,7
tichondrius,1055,druid,restoration,18,11,7
frostmourne,1055,druid,restoration,24,11,13
akama,1054,druid,restoration,42,26,16
dalaran,1054,druid,restoration,48,19,29
jubeithos,1052,druid,restoration,18,11,7
malygos,1052,druid,restoration,26,15,11
vashj,1052,druid,restoration,21,12,9
stormrage,1052,druid,restoration,60,28,32
stormrage,1051,druid,restoration,35,12,23
illidan,1050,druid,restoration,30,11,19
darkspear,1049,druid,restoration,24,18,6
tichondrius,1049,druid,restoration,48,25,23
stormrage,1047,druid,restoration,48,23,25
aerie-peak,1044,druid,restoration,30,16,14
ghostlands,1043,druid,restoration,55,27,28
sargeras,1041,druid,restoration,18,11,7
runetotem,1040,druid,restoration,35,15,20
tichondrius,1039,druid,restoration,18,11,7
stormrage,1035,druid,restoration,30,11,19
azralon,1032,druid,restoration,85,43,42
ragnaros,1031,druid,restoration,76,35,41
zuljin,1031,druid,restoration,59,24,35
tichondrius,1020,druid,restoration,18,11,7
proudmoore,1006,druid,restoration,20,12,8
area-52,1006,druid,restoration,30,16,14
proudmoore,1006,druid,restoration,30,13,17
andorhal,1005,druid,restoration,32,12,20
frostmourne,1000,druid,restoration,15,12,3
sargeras,1000,druid,restoration,26,12,14
tichondrius,999,druid,restoration,24,12,12
sargeras,996,druid,restoration,29,16,13
emerald-dream,989,druid,restoration,61,35,26
tichondrius,985,druid,restoration,30,11,19
mannoroth,983,druid,restoration,51,31,20
aegwynn,976,druid,restoration,24,13,11
stormscale,962,druid,restoration,44,21,23
kelthuzad,960,druid,restoration,12,10,2
sargeras,960,druid,restoration,18,10,8
tichondrius,959,druid,restoration,12,10,2
tichondrius,959,druid,restoration,18,10,8
burning-legion,959,druid,restoration,18,10,8
frostmourne,959,druid,restoration,24,10,14
akama,958,druid,restoration,12,10,2
tichondrius,956,druid,restoration,18,10,8
stormrage,955,druid,restoration,12,10,2
sargeras,954,druid,restoration,24,10,14
frostmourne,952,druid,restoration,12,10,2
illidan,952,druid,restoration,18,10,8
tichondrius,952,druid,restoration,24,10,14
tichondrius,951,druid,restoration,18,10,8
bleeding-hollow,950,druid,restoration,54,27,27
aegwynn,949,druid,restoration,47,23,24
frostmourne,946,druid,restoration,24,10,14
stormrage,942,druid,restoration,18,10,8
cenarion-circle,941,druid,restoration,28,13,15
azgalor,940,druid,restoration,33,17,16
quelthalas,939,druid,restoration,71,38,33
sargeras,936,druid,restoration,71,37,34
kargath,917,druid,restoration,23,10,13
arthas,910,druid,restoration,29,10,19
frostmane,907,druid,restoration,18,10,8
tichondrius,905,druid,restoration,22,12,10
azralon,903,druid,restoration,44,22,22
amanthul,892,druid,restoration,24,10,14
emerald-dream,877,druid,restoration,21,11,10
dalaran,876,druid,restoration,42,13,29
demon-soul,864,druid,restoration,12,9,3
tichondrius,864,druid,restoration,12,9,3
area-52,864,druid,restoration,12,9,3
sargeras,864,druid,restoration,12,9,3
icecrown,864,druid,restoration,18,9,9
tichondrius,864,druid,restoration,18,9,9
malganis,864,druid,restoration,18,9,9
blackrock,864,druid,restoration,25,9,16
frostmourne,863,druid,restoration,18,9,9
thaurissan,862,druid,restoration,18,9,9
frostmourne,861,druid,restoration,18,9,9
moon-guard,861,druid,restoration,18,9,9
sargeras,861,druid,restoration,30,9,21
quelthalas,854,druid,restoration,18,9,9
azralon,854,druid,restoration,24,9,15
bleeding-hollow,852,druid,restoration,20,11,9
tichondrius,847,druid,restoration,18,9,9
drakkari,846,druid,restoration,19,10,9
thrall,846,druid,restoration,24,9,15
ragnaros,846,druid,restoration,42,13,29
illidan,838,druid,restoration,48,19,29
frostmourne,807,druid,restoration,22,11,11
kelthuzad,807,druid,restoration,72,23,49
stormreaver,804,druid,restoration,42,17,25
arygos,800,druid,restoration,16,9,7
tichondrius,798,druid,restoration,22,9,13
tichondrius,768,druid,restoration,12,8,4
illidan,768,druid,restoration,12,8,4
sargeras,768,druid,restoration,12,8,4
bleeding-hollow,768,druid,restoration,12,8,4
tichondrius,768,druid,restoration,12,8,4
illidan,768,druid,restoration,12,8,4
tichondrius,768,druid,restoration,12,8,4
stormrage,768,druid,restoration,18,8,10
alexstrasza,767,druid,restoration,12,8,4
drenden,767,druid,restoration,12,8,4
tichondrius,767,druid,restoration,12,8,4
ragnaros,767,druid,restoration,12,8,4
tichondrius,767,druid,restoration,18,8,10
nemesis,767,druid,restoration,18,8,10
tichondrius,766,druid,restoration,18,8,10
tichondrius,765,druid,restoration,12,8,4
eredar,764,druid,restoration,12,8,4
sargeras,764,druid,restoration,18,8,10
arthas,764,druid,restoration,24,8,16
frostmourne,763,druid,restoration,18,8,10
proudmoore,762,druid,restoration,18,8,10
lothar,761,druid,restoration,12,8,4
tichondrius,759,druid,restoration,24,8,16
zuljin,756,druid,restoration,18,8,10
proudmoore,753,druid,restoration,12,8,4
tichondrius,748,druid,restoration,50,10,40
nerzhul,747,druid,restoration,12,8,4
bleeding-hollow,720,druid,restoration,15,9,6
the-forgotten-coast,719,druid,restoration,15,9,6
barthilas,717,druid,restoration,23,8,15
ursin,706,druid,restoration,24,8,16
frostmourne,702,druid,restoration,11,8,3
nemesis,692,druid,restoration,28,9,19
nathrezim,672,druid,restoration,12,7,5
archimonde,672,druid,restoration,12,7,5
tichondrius,672,druid,restoration,12,7,5
sargeras,672,druid,restoration,12,7,5
icecrown,672,druid,restoration,12,7,5
malganis,672,druid,restoration,12,7,5
tichondrius,672,druid,restoration,12,7,5
barthilas,672,druid,restoration,18,7,11
tichondrius,672,druid,restoration,18,7,11
twisting-nether,672,druid,restoration,18,7,11
malganis,672,druid,restoration,18,7,11
bleeding-hollow,672,druid,restoration,24,7,17
area-52,672,druid,restoration,24,7,17
sargeras,671,druid,restoration,12,7,5
dalaran,671,druid,restoration,12,7,5
shadowmoon,671,druid,restoration,12,7,5
kelthuzad,671,druid,restoration,12,7,5
tichondrius,671,druid,restoration,12,7,5
malganis,671,druid,restoration,12,7,5
tichondrius,671,druid,restoration,18,7,11
illidan,671,druid,restoration,30,7,23
proudmoore,670,druid,restoration,12,7,5
kelthuzad,670,druid,restoration,12,7,5
tichondrius,670,druid,restoration,12,7,5
ragnaros,670,druid,restoration,12,7,5
kiljaeden,670,druid,restoration,12,7,5
sargeras,670,druid,restoration,18,7,11
lightbringer,670,druid,restoration,18,7,11
dentarg,670,druid,restoration,24,7,17
malganis,669,druid,restoration,18,7,11
tichondrius,668,druid,restoration,24,7,17
area-52,667,druid,restoration,12,7,5
echo-isles,665,druid,restoration,18,7,11
sargeras,639,druid,restoration,14,8,6
malfurion,639,druid,restoration,14,8,6
kiljaeden,639,druid,restoration,17,7,10
ysera,639,druid,restoration,28,7,21
frostmourne,622,druid,restoration,15,8,7
nagrand,619,druid,restoration,15,8,7
dentarg,612,druid,restoration,25,8,17
tichondrius,607,druid,restoration,15,8,7
moon-guard,585,druid,restoration,11,7,4
crushridge,576,druid,restoration,6,6,0
tichondrius,576,druid,restoration,6,6,0
illidan,576,druid,restoration,12,6,6
arygos,576,druid,restoration,12,6,6
nemesis,576,druid,restoration,12,6,6
tichondrius,576,druid,restoration,12,6,6
area-52,576,druid,restoration,12,6,6
illidan,576,druid,restoration,12,6,6
bloodhoof,576,druid,restoration,12,6,6
ysera,576,druid,restoration,12,6,6
mugthol,576,druid,restoration,12,6,6
laughing-skull,576,druid,restoration,12,6,6
executus,576,druid,restoration,12,6,6
zuljin,576,druid,restoration,12,6,6
sargeras,576,druid,restoration,12,6,6
tichondrius,576,druid,restoration,18,6,12
sargeras,576,druid,restoration,18,6,12
anubarak,576,druid,restoration,18,6,12
sargeras,576,druid,restoration,18,6,12
ragnaros,576,druid,restoration,18,6,12
proudmoore,576,druid,restoration,18,6,12
sargeras,575,druid,restoration,12,6,6
stormrage,575,druid,restoration,12,6,6
illidan,575,druid,restoration,12,6,6
tichondrius,575,druid,restoration,12,6,6
stormrage,575,druid,restoration,12,6,6
burning-legion,575,druid,restoration,12,6,6
barthilas,575,druid,restoration,16,7,9
tichondrius,575,druid,restoration,18,6,12
sargeras,575,druid,restoration,39,7,32
ragnaros,574,druid,restoration,6,6,0
moon-guard,574,druid,restoration,12,6,6
tichondrius,574,druid,restoration,12,6,6
emerald-dream,574,druid,restoration,18,6,12
area-52,572,druid,restoration,12,6,6
blackrock,570,druid,restoration,12,6,6
azralon,570,druid,restoration,12,6,6
alexstrasza,569,druid,restoration,12,6,6
thorium-brotherhood,565,druid,restoration,12,6,6
stormrage,552,druid,restoration,36,6,30
proudmoore,547,druid,restoration,24,6,18
arathor,544,druid,restoration,16,6,10
tichondrius,541,druid,restoration,20,7,13
azralon,520,druid,restoration,17,10,7
tichondrius,510,druid,restoration,16,6,10
tichondrius,480,druid,restoration,6,5,1
ragnaros,480,druid,restoration,6,5,1
tichondrius,480,druid,restoration,6,5,1
tichondrius,480,druid,restoration,6,5,1
frostmourne,480,druid,restoration,6,5,1
magtheridon,480,druid,restoration,6,5,1
stormrage,480,druid,restoration,6,5,1
stormrage,480,druid,restoration,6,5,1
ragnaros,480,druid,restoration,6,5,1
gurubashi,480,druid,restoration,6,5,1
area-52,480,druid,restoration,6,5,1
stormrage,480,druid,restoration,6,5,1
sargeras,480,druid,restoration,6,5,1
tichondrius,480,druid,restoration,6,5,1
tichondrius,480,druid,restoration,6,5,1
aggramar,480,druid,restoration,6,5,1
stormrage,480,druid,restoration,12,5,7
illidan,480,druid,restoration,12,5,7
sargeras,480,druid,restoration,12,5,7
korialstrasz,480,druid,restoration,12,5,7
frostmourne,480,druid,restoration,12,5,7
emerald-dream,480,druid,restoration,12,5,7
malganis,480,druid,restoration,12,5,7
illidan,480,druid,restoration,12,5,7
illidan,480,druid,restoration,12,5,7
tichondrius,480,druid,restoration,12,5,7
thrall,480,druid,restoration,12,5,7
zuljin,480,druid,restoration,12,5,7
laughing-skull,480,druid,restoration,12,5,7
tichondrius,480,druid,restoration,12,5,7
stormrage,480,druid,restoration,16,5,11
kelthuzad,480,druid,restoration,18,5,13
onyxia,480,druid,restoration,30,5,25
frostmourne,479,druid,restoration,12,5,7
moon-guard,479,druid,restoration,12,5,7
tichondrius,479,druid,restoration,12,5,7
frostmourne,479,druid,restoration,24,5,19
darkspear,478,druid,restoration,13,6,7
tichondrius,478,druid,restoration,12,5,7
dragonmaw,478,druid,restoration,12,5,7
malganis,478,druid,restoration,12,5,7
drakthul,478,druid,restoration,12,5,7
elune,477,druid,restoration,18,5,13
detheroc,476,druid,restoration,12,5,7
zuljin,476,druid,restoration,12,5,7
sargeras,476,druid,restoration,12,5,7
khadgar,475,druid,restoration,12,5,7
grizzly-hills,475,druid,restoration,18,5,13
proudmoore,473,druid,restoration,12,5,7
tichondrius,447,druid,restoration,8,6,2
malganis,447,druid,restoration,11,5,6
area-52,432,druid,restoration,15,6,9
tichondrius,415,druid,restoration,14,5,9
frostmourne,384,druid,restoration,6,4,2
stormrage,384,druid,restoration,6,4,2
kelthuzad,384,druid,restoration,6,4,2
sargeras,384,druid,restoration,6,4,2
blackrock,384,druid,restoration,6,4,2
area-52,384,druid,restoration,6,4,2
ragnaros,384,druid,restoration,6,4,2
moon-guard,384,druid,restoration,6,4,2
frostmourne,384,druid,restoration,6,4,2
azshara,384,druid,restoration,6,4,2
tichondrius,384,druid,restoration,6,4,2
quelthalas,384,druid,restoration,6,4,2
shattered-halls,384,druid,restoration,6,4,2
tichondrius,384,druid,restoration,6,4,2
barthilas,384,druid,restoration,6,4,2
eldrethalas,384,druid,restoration,6,4,2
kelthuzad,384,druid,restoration,6,4,2
sargeras,384,druid,restoration,6,4,2
illidan,384,druid,restoration,12,4,8
frostmourne,384,druid,restoration,12,4,8
illidan,384,druid,restoration,12,4,8
kelthuzad,384,druid,restoration,12,4,8
bladefist,384,druid,restoration,12,4,8
proudmoore,384,druid,restoration,12,4,8
illidan,384,druid,restoration,12,4,8
sargeras,384,druid,restoration,12,4,8
skullcrusher,384,druid,restoration,12,4,8
ragnaros,384,druid,restoration,12,4,8
silvermoon,384,druid,restoration,12,4,8
stormrage,384,druid,restoration,12,4,8
illidan,384,druid,restoration,12,4,8
frostmourne,384,druid,restoration,12,4,8
tichondrius,384,druid,restoration,12,4,8
thrall,384,druid,restoration,18,4,14
runetotem,383,druid,restoration,12,4,8
stormrage,383,druid,restoration,12,4,8
ragnaros,383,druid,restoration,12,4,8
emerald-dream,383,druid,restoration,12,4,8
proudmoore,383,druid,restoration,12,4,8
emerald-dream,383,druid,restoration,12,4,8
moon-guard,383,druid,restoration,18,4,14
thaurissan,383,druid,restoration,18,4,14
proudmoore,382,druid,restoration,6,4,2
thrall,382,druid,restoration,12,4,8
tichondrius,382,druid,restoration,12,4,8
quelthalas,381,druid,restoration,12,4,8
moon-guard,381,druid,restoration,18,4,14
bonechewer,379,druid,restoration,12,4,8
crushridge,379,druid,restoration,12,4,8
ragnaros,377,druid,restoration,22,10,12
sargeras,367,druid,restoration,11,4,7
tichondrius,330,druid,restoration,7,5,2
sargeras,330,druid,restoration,8,5,3
mugthol,319,druid,restoration,6,4,2
the-venture-co,318,druid,restoration,8,4,4
kelthuzad,288,druid,restoration,6,3,3
tichondrius,288,druid,restoration,6,3,3
tichondrius,288,druid,restoration,6,3,3
stormrage,288,druid,restoration,6,3,3
azralon,288,druid,restoration,6,3,3
zuljin,288,druid,restoration,6,3,3
zuljin,288,druid,restoration,6,3,3
bleeding-hollow,288,druid,restoration,6,3,3
illidan,288,druid,restoration,6,3,3
quelthalas,288,druid,restoration,6,3,3
frostmane,288,druid,restoration,6,3,3
tichondrius,288,druid,restoration,6,3,3
sargeras,288,druid,restoration,6,3,3
area-52,288,druid,restoration,6,3,3
area-52,288,druid,restoration,6,3,3
tichondrius,288,druid,restoration,6,3,3
tichondrius,288,druid,restoration,6,3,3
frostmourne,288,druid,restoration,6,3,3
illidan,288,druid,restoration,6,3,3
area-52,288,druid,restoration,6,3,3
thorium-brotherhood,288,druid,restoration,6,3,3
moon-guard,288,druid,restoration,6,3,3
altar-of-storms,288,druid,restoration,6,3,3
sargeras,288,druid,restoration,6,3,3
proudmoore,288,druid,restoration,6,3,3
tichondrius,288,druid,restoration,6,3,3
dalaran,288,druid,restoration,6,3,3
dalaran,288,druid,restoration,6,3,3
nemesis,288,druid,restoration,6,3,3
tichondrius,288,druid,restoration,6,3,3
kelthuzad,288,druid,restoration,6,3,3
tichondrius,288,druid,restoration,6,3,3
moon-guard,288,druid,restoration,6,3,3
malganis,288,druid,restoration,6,3,3
dark-iron,288,druid,restoration,6,3,3
silvermoon,288,druid,restoration,6,3,3
ragnaros,288,druid,restoration,6,3,3
malganis,288,druid,restoration,6,3,3
emerald-dream,288,druid,restoration,6,3,3
sargeras,288,druid,restoration,6,3,3
burning-legion,288,druid,restoration,6,3,3
moon-guard,288,druid,restoration,6,3,3
moon-guard,288,druid,restoration,6,3,3
quelthalas,288,druid,restoration,6,3,3
illidan,288,druid,restoration,6,3,3
terenas,288,druid,restoration,6,3,3
zuljin,288,druid,restoration,9,3,6
stormrage,288,druid,restoration,12,3,9
kiljaeden,288,druid,restoration,12,3,9
stormrage,288,druid,restoration,12,3,9
wyrmrest-accord,288,druid,restoration,12,3,9
sargeras,288,druid,restoration,12,3,9
anvilmar,288,druid,restoration,12,3,9
ysera,288,druid,restoration,12,3,9
frostmourne,288,druid,restoration,12,3,9
area-52,288,druid,restoration,12,3,9
frostmourne,288,druid,restoration,12,3,9
tichondrius,288,druid,restoration,12,3,9
tichondrius,288,druid,restoration,12,3,9
khadgar,288,druid,restoration,12,3,9
area-52,288,druid,restoration,12,3,9
bleeding-hollow,288,druid,restoration,18,3,15
draenor,288,druid,restoration,18,3,15
frostmourne,287,druid,restoration,6,3,3
perenolde,287,druid,restoration,6,3,3
senjin,287,druid,restoration,6,3,3
illidan,287,druid,restoration,6,3,3
duskwood,287,druid,restoration,6,3,3
kiljaeden,287,druid,restoration,12,3,9
tichondrius,287,druid,restoration,18,3,15
ursin,286,druid,restoration,6,3,3
illidan,286,druid,restoration,12,3,9
illidan,256,druid,restoration,10,3,7
destromath,239,druid,restoration,5,3,2
emerald-dream,239,druid,restoration,5,3,2
tichondrius,233,druid,restoration,13,4,9
tichondrius,223,druid,restoration,8,3,5
stormrage,192,druid,restoration,9,3,6
sargeras,192,druid,restoration,6,2,4
illidan,192,druid,restoration,6,2,4
tichondrius,192,druid,restoration,6,2,4
altar-of-storms,192,druid,restoration,6,2,4
ragnaros,192,druid,restoration,6,2,4
stormrage,192,druid,restoration,6,2,4
burning-legion,192,druid,restoration,6,2,4
tichondrius,192,druid,restoration,6,2,4
ragnaros,192,druid,restoration,6,2,4
lightninghoof,192,druid,restoration,6,2,4
azralon,192,druid,restoration,6,2,4
malganis,192,druid,restoration,6,2,4
korgath,192,druid,restoration,6,2,4
earthen-ring,192,druid,restoration,6,2,4
stormrage,192,druid,restoration,6,2,4
malganis,192,druid,restoration,6,2,4
skywall,192,druid,restoration,6,2,4
thrall,192,druid,restoration,6,2,4
area-52,192,druid,restoration,6,2,4
tichondrius,192,druid,restoration,6,2,4
thrall,192,druid,restoration,6,2,4
kelthuzad,192,druid,restoration,6,2,4
tichondrius,192,druid,restoration,6,2,4
area-52,192,druid,restoration,6,2,4
illidan,192,druid,restoration,6,2,4
tichondrius,192,druid,restoration,6,2,4
kelthuzad,192,druid,restoration,6,2,4
illidan,192,druid,restoration,6,2,4
magtheridon,192,druid,restoration,6,2,4
crushridge,192,druid,restoration,6,2,4
stormrage,192,druid,restoration,6,2,4
stormrage,192,druid,restoration,6,2,4
proudmoore,192,druid,restoration,6,2,4
illidan,192,druid,restoration,6,2,4
azralon,192,druid,restoration,6,2,4
area-52,192,druid,restoration,6,2,4
tichondrius,192,druid,restoration,6,2,4
tichondrius,192,druid,restoration,6,2,4
stormrage,192,druid,restoration,6,2,4
tichondrius,192,druid,restoration,6,2,4
stormrage,192,druid,restoration,6,2,4
spinebreaker,192,druid,restoration,6,2,4
kelthuzad,192,druid,restoration,6,2,4
tichondrius,192,druid,restoration,6,2,4
stormrage,192,druid,restoration,6,2,4
bleeding-hollow,192,druid,restoration,6,2,4
barthilas,192,druid,restoration,6,2,4
barthilas,192,druid,restoration,6,2,4
frostwolf,192,druid,restoration,10,3,7
frostmane,192,druid,restoration,12,2,10
archimonde,192,druid,restoration,12,2,10
emerald-dream,192,druid,restoration,12,2,10
ragnaros,192,druid,restoration,12,2,10
dalaran,192,druid,restoration,12,2,10
tichondrius,192,druid,restoration,12,2,10
arthas,192,druid,restoration,12,2,10
whisperwind,192,druid,restoration,12,2,10
frostmourne,192,druid,restoration,12,2,10
tichondrius,192,druid,restoration,12,2,10
tichondrius,192,druid,restoration,12,2,10
sargeras,192,druid,restoration,12,2,10
frostmourne,192,druid,restoration,18,2,16
aegwynn,192,druid,restoration,18,2,16
dunemaul,192,druid,restoration,18,2,16
ragnaros,192,druid,restoration,21,2,19
dalaran,191,druid,restoration,6,2,4
tichondrius,191,druid,restoration,6,2,4
emerald-dream,191,druid,restoration,12,2,10
stormrage,175,druid,restoration,17,3,14
malganis,175,druid,restoration,22,3,19
tichondrius,159,druid,restoration,11,4,7
zuljin,144,druid,restoration,3,3,0
rexxar,128,druid,restoration,4,2,2
tichondrius,96,druid,restoration,6,1,5
tichondrius,96,druid,restoration,6,1,5
khazgoroth,96,druid,restoration,6,1,5
skullcrusher,96,druid,restoration,6,1,5
tichondrius,96,druid,restoration,6,1,5
firetree,96,druid,restoration,6,1,5
bleeding-hollow,96,druid,restoration,6,1,5
frostmourne,96,druid,restoration,6,1,5
quelthalas,96,druid,restoration,6,1,5
illidan,96,druid,restoration,6,1,5
stormscale,96,druid,restoration,6,1,5
cairne,96,druid,restoration,6,1,5
azralon,96,druid,restoration,6,1,5
ragnaros,96,druid,restoration,6,1,5
kelthuzad,96,druid,restoration,6,1,5
stormrage,96,druid,restoration,6,1,5
tichondrius,96,druid,restoration,6,1,5
moon-guard,96,druid,restoration,6,1,5
demon-soul,96,druid,restoration,6,1,5
frostmourne,96,druid,restoration,6,1,5
tichondrius,96,druid,restoration,6,1,5
skywall,96,druid,restoration,6,1,5
tichondrius,96,druid,restoration,6,1,5
sargeras,96,druid,restoration,6,1,5
lightnings-blade,96,druid,restoration,6,1,5
emerald-dream,96,druid,restoration,6,1,5
greymane,96,druid,restoration,6,1,5
shadowsong,96,druid,restoration,16,2,14
sargeras,96,druid,restoration,11,1,10
aegwynn,96,druid,restoration,11,1,10
duskwood,96,druid,restoration,12,1,11
tichondrius,96,druid,restoration,18,1,17
blood-furnace,95,druid,restoration,9,2,7
sargeras,79,druid,restoration,5,1,4
kelthuzad,64,druid,restoration,16,1,15
area-52,63,druid,restoration,2,2,0
fenris,16,druid,restoration,6,1,5
tichondrius,1562,druid,guardian,30,19,11
gallywix,1107,druid,guardian,36,12,24
proudmoore,1062,druid,guardian,30,15,15
burning-legion,669,druid,guardian,12,7,5
wyrmrest-accord,659,druid,guardian,12,7,5
draenor,570,druid,guardian,12,6,6
proudmoore,480,druid,guardian,12,5,7
quelthalas,472,druid,guardian,15,6,9
feathermoon,383,druid,guardian,6,4,2
rivendare,383,druid,guardian,12,4,8
altar-of-storms,288,druid,guardian,12,3,9
illidan,288,druid,guardian,12,3,9
whisperwind,288,druid,guardian,12,3,9
anetheron,288,druid,guardian,12,3,9
uldaman,286,druid,guardian,6,3,3
shadowsong,286,druid,guardian,6,3,3
moon-guard,192,druid,guardian,6,2,4
queldorei,96,druid,guardian,6,1,5
kelthuzad,96,druid,guardian,6,1,5
sargeras,96,druid,guardian,6,1,5
dalaran,96,druid,guardian,12,1,11
zuljin,95,druid,guardian,6,1,5
stormrage,2128,druid,feral,95,61,34
alleria,2124,druid,feral,84,50,34
sargeras,2031,druid,feral,153,80,73
sargeras,2020,druid,feral,96,51,45
tichondrius,1999,druid,feral,77,49,28
stormrage,1985,druid,feral,69,35,34
stormrage,1981,druid,feral,59,32,27
lightbringer,1967,druid,feral,59,36,23
quelthalas,1967,druid,feral,88,49,39
stormreaver,1961,druid,feral,60,32,28
kiljaeden,1948,druid,feral,62,32,30
sargeras,1941,druid,feral,44,29,15
jubeithos,1938,druid,feral,59,31,28
area-52,1900,druid,feral,241,129,112
ravencrest,1897,druid,feral,60,33,27
steamwheedle-cartel,1896,druid,feral,84,42,42
stormrage,1872,druid,feral,36,26,10
tichondrius,1866,druid,feral,65,34,31
quelthalas,1852,druid,feral,60,27,33
tichondrius,1827,druid,feral,66,35,31
emerald-dream,1823,druid,feral,60,43,17
azralon,1822,druid,feral,168,86,82
tichondrius,1812,druid,feral,60,26,34
sargeras,1808,druid,feral,53,25,28
tichondrius,1794,druid,feral,66,30,36
illidan,1770,druid,feral,36,22,14
dragonmaw,1765,druid,feral,50,27,23
whisperwind,1745,druid,feral,42,25,17
frostmourne,1745,druid,feral,42,21,21
illidan,1741,druid,feral,148,74,74
quelthalas,1739,druid,feral,53,22,31
sargeras,1730,druid,feral,54,25,29
sargeras,1725,druid,feral,51,26,25
tichondrius,1723,druid,feral,46,26,20
tichondrius,1700,druid,feral,48,30,18
stormrage,1688,druid,feral,30,20,10
moon-guard,1683,druid,feral,66,33,33
thrall,1679,druid,feral,60,31,29
stormrage,1673,druid,feral,121,63,58
destromath,1666,druid,feral,84,39,45
tichondrius,1663,druid,feral,36,22,14
tichondrius,1661,druid,feral,33,23,10
nesingwary,1659,druid,feral,87,45,42
tichondrius,1650,druid,feral,36,19,17
moon-guard,1645,druid,feral,34,19,15
bladefist,1637,druid,feral,40,22,18
windrunner,1635,druid,feral,78,40,38
area-52,1631,druid,feral,38,22,16
drenden,1630,druid,feral,36,22,14
zuljin,1630,druid,feral,60,31,29
emerald-dream,1625,druid,feral,62,34,28
sargeras,1621,druid,feral,61,28,33
area-52,1620,druid,feral,77,40,37
andorhal,1619,druid,feral,59,23,36
scilla,1618,druid,feral,36,17,19
stormreaver,1618,druid,feral,66,31,35
ragnaros,1617,druid,feral,36,19,17
sargeras,1612,druid,feral,53,25,28
sargeras,1611,druid,feral,30,21,9
mannoroth,1603,druid,feral,24,17,7
illidan,1600,druid,feral,59,27,32
dunemaul,1598,druid,feral,48,23,25
whisperwind,1595,druid,feral,40,17,23
frostwolf,1592,druid,feral,110,58,52
emerald-dream,1583,druid,feral,36,19,17
emerald-dream,1583,druid,feral,48,21,27
stormrage,1573,druid,feral,42,25,17
bleeding-hollow,1567,druid,feral,44,19,25
nerzhul,1563,druid,feral,48,19,29
tichondrius,1558,druid,feral,98,54,44
eitrigg,1558,druid,feral,96,47,49
tichondrius,1556,druid,feral,64,26,38
ragnaros,1554,druid,feral,72,38,34
nemesis,1551,druid,feral,36,25,11
frostmourne,1548,druid,feral,54,27,27
tichondrius,1548,druid,feral,49,18,31
sargeras,1535,druid,feral,30,16,14
darkspear,1535,druid,feral,66,24,42
kelthuzad,1524,druid,feral,63,32,31
nemesis,1502,druid,feral,66,36,30
illidan,1496,druid,feral,46,27,19
stormrage,1496,druid,feral,108,53,55
illidan,1490,druid,feral,84,43,41
crushridge,1484,druid,feral,42,17,25
malganis,1477,druid,feral,42,21,21
frostmourne,1476,druid,feral,66,32,34
saurfang,1475,druid,feral,58,38,20
illidan,1475,druid,feral,60,27,33
area-52,1474,druid,feral,114,50,64
barthilas,1471,druid,feral,42,22,20
ragnaros,1470,druid,feral,84,42,42
stormrage,1458,druid,feral,186,89,97
sargeras,1447,druid,feral,47,28,19
quelthalas,1443,druid,feral,33,20,13
the-venture-co,1442,druid,feral,36,20,16
spinebreaker,1442,druid,feral,66,30,36
ravencrest,1440,druid,feral,106,46,60
firetree,1439,druid,feral,30,15,15
tichondrius,1435,druid,feral,152,68,84
tichondrius,1421,druid,feral,110,57,53
zuljin,1415,druid,feral,66,22,44
illidan,1412,druid,feral,24,15,9
zuljin,1410,druid,feral,29,18,11
shattered-halls,1409,druid,feral,24,15,9
tichondrius,1404,druid,feral,35,15,20
malygos,1394,druid,feral,60,28,32
korgath,1388,druid,feral,60,28,32
tichondrius,1386,druid,feral,81,42,39
stormrage,1382,druid,feral,34,16,18
tichondrius,1379,druid,feral,66,33,33
burning-legion,1372,druid,feral,113,54,59
moon-guard,1361,druid,feral,30,15,15
quelthalas,1359,druid,feral,48,17,31
quelthalas,1357,druid,feral,44,20,24
frostmourne,1350,druid,feral,84,34,50
stormrage,1348,druid,feral,42,20,22
bleeding-hollow,1343,druid,feral,24,14,10
stormrage,1341,druid,feral,30,14,16
kelthuzad,1339,druid,feral,30,14,16
proudmoore,1338,druid,feral,29,14,15
quelthalas,1338,druid,feral,36,14,22
tichondrius,1337,druid,feral,36,14,22
boulderfist,1335,druid,feral,33,15,18
illidan,1329,druid,feral,78,41,37
moon-guard,1325,druid,feral,214,112,102
tichondrius,1322,druid,feral,83,37,46
frostmourne,1320,druid,feral,30,17,13
tichondrius,1319,druid,feral,24,14,10
lothar,1317,druid,feral,48,25,23
kiljaeden,1317,druid,feral,48,25,23
sargeras,1317,druid,feral,29,14,15
frostmourne,1311,druid,feral,22,15,7
kelthuzad,1309,druid,feral,29,14,15
stormrage,1307,druid,feral,34,17,17
frostmourne,1305,druid,feral,29,14,15
dalaran,1297,druid,feral,93,50,43
barthilas,1295,druid,feral,18,14,4
tichondrius,1295,druid,feral,41,25,16
illidan,1281,druid,feral,46,24,22
tichondrius,1281,druid,feral,42,19,23
ragnaros,1272,druid,feral,58,27,31
stormrage,1257,druid,feral,29,17,12
tichondrius,1249,druid,feral,156,78,78
mugthol,1247,druid,feral,33,14,19
stormrage,1245,druid,feral,48,13,35
tichondrius,1243,druid,feral,42,13,29
ravencrest,1242,druid,feral,33,17,16
malganis,1242,druid,feral,30,14,16
stormrage,1237,druid,feral,24,13,11
azgalor,1237,druid,feral,26,14,12
proudmoore,1236,druid,feral,30,13,17
zuluhed,1235,druid,feral,36,19,17
norgannon,1232,druid,feral,42,16,26
hyjal,1222,druid,feral,35,22,13
bleeding-hollow,1214,druid,feral,30,13,17
illidan,1214,druid,feral,37,16,21
aegwynn,1210,druid,feral,59,36,23
proudmoore,1206,druid,feral,48,23,25
tichondrius,1199,druid,feral,58,29,29
tichondrius,1175,druid,feral,26,13,13
tichondrius,1171,druid,feral,33,14,19
chogall,1168,druid,feral,22,13,9
stormrage,1161,druid,feral,48,31,17
area-52,1158,druid,feral,29,13,16
tichondrius,1155,druid,feral,43,18,25
blackwater-raiders,1152,druid,feral,24,12,12
stormrage,1151,druid,feral,24,12,12
ragnaros,1149,druid,feral,27,13,14
queldorei,1147,druid,feral,30,12,18
sargeras,1143,druid,feral,96,43,53
zuljin,1142,druid,feral,30,12,18
dreadmaul,1141,druid,feral,56,31,25
thrall,1133,druid,feral,51,27,24
sargeras,1132,druid,feral,81,40,41
area-52,1128,druid,feral,24,12,12
azralon,1122,druid,feral,36,13,23
thrall,1116,druid,feral,30,12,18
dalaran,1103,druid,feral,31,13,18
tichondrius,1100,druid,feral,24,12,12
sargeras,1094,druid,feral,23,12,11
whisperwind,1093,druid,feral,24,14,10
proudmoore,1086,druid,feral,23,12,11
illidan,1067,druid,feral,30,12,18
barthilas,1060,druid,feral,25,12,13
tichondrius,1056,druid,feral,18,11,7
norgannon,1056,druid,feral,18,11,7
proudmoore,1056,druid,feral,18,11,7
sargeras,1056,druid,feral,18,11,7
kiljaeden,1056,druid,feral,18,11,7
frostmourne,1056,druid,feral,24,11,13
sargeras,1056,druid,feral,30,11,19
malganis,1054,druid,feral,18,11,7
azuremyst,1054,druid,feral,24,11,13
moon-guard,1053,druid,feral,18,11,7
illidan,1053,druid,feral,24,11,13
tichondrius,1052,druid,feral,53,26,27
illidan,1052,druid,feral,24,11,13
drenden,1051,druid,feral,16,12,4
zuljin,1051,druid,feral,24,11,13
malganis,1050,druid,feral,25,11,14
illidan,1050,druid,feral,36,11,25
emerald-dream,1049,druid,feral,36,11,25
stormrage,1048,druid,feral,24,11,13
tichondrius,1048,druid,feral,30,11,19
frostmourne,1047,druid,feral,18,12,6
blackhand,1045,druid,feral,30,11,19
azralon,1040,druid,feral,29,11,18
sargeras,1035,druid,feral,42,21,21
sargeras,1030,druid,feral,30,12,18
moon-guard,1022,druid,feral,29,11,18
grizzly-hills,1018,druid,feral,29,12,17
aerie-peak,1018,druid,feral,47,14,33
frostmourne,1006,druid,feral,26,12,14
illidan,995,druid,feral,24,11,13
blades-edge,970,druid,feral,41,18,23
tichondrius,960,druid,feral,18,10,8
tichondrius,960,druid,feral,26,10,16
sargeras,959,druid,feral,12,10,2
tichondrius,959,druid,feral,18,10,8
stormrage,959,druid,feral,24,10,14
illidan,959,druid,feral,24,10,14
tichondrius,958,druid,feral,24,10,14
moon-guard,957,druid,feral,27,11,16
tichondrius,956,druid,feral,18,10,8
mugthol,956,druid,feral,18,10,8
sargeras,956,druid,feral,30,10,20
quelthalas,952,druid,feral,18,10,8
stormrage,945,druid,feral,24,10,14
illidan,938,druid,feral,18,10,8
ragnaros,937,druid,feral,24,10,14
aegwynn,933,druid,feral,30,15,15
thunderhorn,924,druid,feral,30,15,15
sargeras,911,druid,feral,34,10,24
hyjal,864,druid,feral,12,9,3
ravencrest,864,druid,feral,18,9,9
nemesis,864,druid,feral,24,9,15
zuljin,864,druid,feral,24,9,15
cenarius,864,druid,feral,30,9,21
akama,863,druid,feral,18,9,9
stormrage,863,druid,feral,18,9,9
bleeding-hollow,863,druid,feral,18,9,9
nemesis,862,druid,feral,18,9,9
sargeras,861,druid,feral,18,9,9
barthilas,860,druid,feral,12,9,3
stormrage,853,druid,feral,24,9,15
azralon,852,druid,feral,26,9,17
thrall,852,druid,feral,30,9,21
kelthuzad,837,druid,feral,17,9,8
anetheron,822,druid,feral,30,12,18
ragnaros,814,druid,feral,17,9,8
proudmoore,810,druid,feral,17,9,8
stormrage,804,druid,feral,30,9,21
tichondrius,797,druid,feral,20,9,11
barthilas,768,druid,feral,12,8,4
vashj,768,druid,feral,12,8,4
sargeras,768,druid,feral,12,8,4
malganis,768,druid,feral,18,8,10
emerald-dream,768,druid,feral,18,8,10
tichondrius,767,druid,feral,12,8,4
darkspear,767,druid,feral,18,8,10
dark-iron,767,druid,feral,18,8,10
tichondrius,767,druid,feral,18,8,10
greymane,767,druid,feral,22,9,13
sargeras,765,druid,feral,18,8,10
kelthuzad,764,druid,feral,30,8,22
stormrage,762,druid,feral,12,8,4
queldorei,762,druid,feral,30,8,22
stormrage,757,druid,feral,24,8,16
bleeding-hollow,752,druid,feral,12,8,4
ragnaros,748,druid,feral,20,9,11
dalaran,741,druid,feral,18,8,10
moon-guard,720,druid,feral,21,8,13
ragnaros,716,druid,feral,17,8,9
sargeras,703,druid,feral,28,8,20
stormrage,684,druid,feral,19,8,11
stormrage,672,druid,feral,12,7,5
tichondrius,672,druid,feral,12,7,5
stormrage,672,druid,feral,12,7,5
proudmoore,672,druid,feral,12,7,5
zuljin,672,druid,feral,12,7,5
area-52,672,druid,feral,12,7,5
sargeras,672,druid,feral,12,7,5
stormrage,672,druid,feral,18,7,11
anvilmar,672,druid,feral,18,7,11
area-52,672,druid,feral,18,7,11
zuljin,672,druid,feral,18,7,11
terenas,672,druid,feral,24,7,17
lothar,671,druid,feral,12,7,5
khaz-modan,671,druid,feral,12,7,5
sargeras,671,druid,feral,12,7,5
anubarak,671,druid,feral,12,7,5
blackrock,671,druid,feral,18,7,11
quelthalas,671,druid,feral,18,7,11
malganis,671,druid,feral,18,7,11
stormrage,671,druid,feral,18,7,11
kiljaeden,671,druid,feral,18,7,11
suramar,671,druid,feral,18,7,11
trollbane,671,druid,feral,18,7,11
tichondrius,670,druid,feral,12,7,5
daggerspine,669,druid,feral,18,7,11
amanthul,668,druid,feral,18,7,11
malorne,663,druid,feral,12,7,5
the-venture-co,656,druid,feral,18,7,11
senjin,648,druid,feral,18,7,11
tichondrius,640,druid,feral,16,7,9
malganis,639,druid,feral,11,7,4
korgath,639,druid,feral,17,7,10
bonechewer,632,druid,feral,19,9,10
tichondrius,623,druid,feral,11,7,4
trollbane,623,druid,feral,16,8,8
stormrage,622,druid,feral,11,7,4
whisperwind,606,druid,feral,16,7,9
uldum,605,druid,feral,11,7,4
zuljin,585,druid,feral,20,8,12
proudmoore,583,druid,feral,22,8,14
sargeras,576,druid,feral,6,6,0
ragnaros,576,druid,feral,6,6,0
illidan,576,druid,feral,12,6,6
tichondrius,576,druid,feral,12,6,6
emerald-dream,576,druid,feral,12,6,6
cairne,576,druid,feral,12,6,6
sargeras,576,druid,feral,12,6,6
sargeras,576,druid,feral,12,6,6
moon-guard,576,druid,feral,12,6,6
ragnaros,576,druid,feral,12,6,6
stormrage,576,druid,feral,15,6,9
azshara,576,druid,feral,18,6,12
eldrethalas,576,druid,feral,18,6,12
stormrage,576,druid,feral,18,6,12
azuremyst,576,druid,feral,18,6,12
korgath,576,druid,feral,18,6,12
quelthalas,576,druid,feral,18,6,12
blackwing-lair,576,druid,feral,18,6,12
barthilas,576,druid,feral,24,6,18
area-52,575,druid,feral,12,6,6
emerald-dream,575,druid,feral,12,6,6
ragnaros,575,druid,feral,12,6,6
tichondrius,575,druid,feral,12,6,6
frostmourne,575,druid,feral,12,6,6
sargeras,575,druid,feral,12,6,6
drakkari,575,druid,feral,18,6,12
whisperwind,574,druid,feral,12,6,6
sargeras,573,druid,feral,18,6,12
zuljin,570,druid,feral,12,6,6
the-forgotten-coast,570,druid,feral,12,6,6
nemesis,569,druid,feral,18,6,12
bonechewer,566,druid,feral,12,6,6
tichondrius,562,druid,feral,24,6,18
kiljaeden,543,druid,feral,17,6,11
stormreaver,528,druid,feral,9,7,2
skullcrusher,528,druid,feral,15,6,9
area-52,527,druid,feral,11,6,5
frostmourne,512,druid,feral,16,6,10
tichondrius,511,druid,feral,17,6,11
lightbringer,508,druid,feral,11,6,5
kelthuzad,495,druid,feral,18,6,12
tichondrius,480,druid,feral,6,5,1
illidan,480,druid,feral,6,5,1
elune,480,druid,feral,6,5,1
jubeithos,480,druid,feral,6,5,1
sargeras,480,druid,feral,6,5,1
icecrown,480,druid,feral,6,5,1
illidan,480,druid,feral,12,5,7
wyrmrest-accord,480,druid,feral,12,5,7
proudmoore,480,druid,feral,12,5,7
illidan,480,druid,feral,12,5,7
bleeding-hollow,480,druid,feral,12,5,7
sargeras,480,druid,feral,12,5,7
tichondrius,480,druid,feral,12,5,7
spirestone,480,druid,feral,12,5,7
aegwynn,480,druid,feral,12,5,7
tichondrius,480,druid,feral,12,5,7
stormrage,480,druid,feral,12,5,7
kelthuzad,480,druid,feral,12,5,7
lightninghoof,480,druid,feral,12,5,7
tichondrius,480,druid,feral,18,5,13
frostmourne,480,druid,feral,18,5,13
stormrage,480,druid,feral,18,5,13
area-52,479,druid,feral,6,5,1
silvermoon,479,druid,feral,12,5,7
area-52,479,druid,feral,12,5,7
moon-guard,479,druid,feral,12,5,7
lightnings-blade,479,druid,feral,12,5,7
wyrmrest-accord,479,druid,feral,12,5,7
kelthuzad,479,druid,feral,12,5,7
argent-dawn,479,druid,feral,12,5,7
cenarius,477,druid,feral,12,5,7
thrall,477,druid,feral,12,5,7
stormrage,431,druid,feral,11,5,6
stormscale,426,druid,feral,7,7,0
tichondrius,415,druid,feral,8,5,3
bleeding-hollow,415,druid,feral,11,5,6
stormrage,415,druid,feral,11,5,6
dalaran,384,druid,feral,6,4,2
bloodhoof,384,druid,feral,6,4,2
frostmourne,384,druid,feral,6,4,2
tichondrius,384,druid,feral,6,4,2
tichondrius,384,druid,feral,6,4,2
bleeding-hollow,384,druid,feral,6,4,2
frostmourne,384,druid,feral,6,4,2
sargeras,384,druid,feral,6,4,2
tichondrius,384,druid,feral,6,4,2
zuljin,384,druid,feral,6,4,2
area-52,384,druid,feral,6,4,2
tichondrius,384,druid,feral,6,4,2
moon-guard,384,druid,feral,6,4,2
tichondrius,384,druid,feral,6,4,2
azralon,384,druid,feral,6,4,2
tichondrius,384,druid,feral,6,4,2
area-52,384,druid,feral,6,4,2
lightbringer,384,druid,feral,6,4,2
tichondrius,384,druid,feral,6,4,2
malganis,384,druid,feral,9,4,5
tichondrius,384,druid,feral,12,4,8
darkspear,384,druid,feral,12,4,8
tichondrius,384,druid,feral,12,4,8
vashj,384,druid,feral,12,4,8
bleeding-hollow,384,druid,feral,12,4,8
zuljin,384,druid,feral,12,4,8
sargeras,384,druid,feral,12,4,8
tichondrius,384,druid,feral,12,4,8
illidan,384,druid,feral,12,4,8
sargeras,384,druid,feral,12,4,8
tichondrius,384,druid,feral,12,4,8
darrowmere,384,druid,feral,12,4,8
burning-legion,384,druid,feral,12,4,8
area-52,384,druid,feral,18,4,14
durotan,383,druid,feral,6,4,2
quelthalas,383,druid,feral,12,4,8
quelthalas,383,druid,feral,12,4,8
quelthalas,383,druid,feral,12,4,8
sargeras,383,druid,feral,12,4,8
kelthuzad,383,druid,feral,12,4,8
tichondrius,383,druid,feral,24,4,20
perenolde,383,druid,feral,30,4,26
area-52,382,druid,feral,12,4,8
smolderthorn,382,druid,feral,12,4,8
windrunner,382,druid,feral,18,4,14
area-52,351,druid,feral,8,5,3
ravencrest,351,druid,feral,11,4,7
quelthalas,330,druid,feral,28,6,22
dalaran,288,druid,feral,6,3,3
moon-guard,288,druid,feral,6,3,3
tichondrius,288,druid,feral,6,3,3
malfurion,288,druid,feral,6,3,3
destromath,288,druid,feral,6,3,3
area-52,288,druid,feral,6,3,3
dalaran,288,druid,feral,6,3,3
tortheldrin,288,druid,feral,6,3,3
azralon,288,druid,feral,6,3,3
andorhal,288,druid,feral,6,3,3
stormrage,288,druid,feral,6,3,3
khadgar,288,druid,feral,6,3,3
skullcrusher,288,druid,feral,6,3,3
area-52,288,druid,feral,6,3,3
azshara,288,druid,feral,6,3,3
area-52,288,druid,feral,6,3,3
azralon,288,druid,feral,6,3,3
kelthuzad,288,druid,feral,6,3,3
azralon,288,druid,feral,6,3,3
area-52,288,druid,feral,6,3,3
illidan,288,druid,feral,6,3,3
tichondrius,288,druid,feral,6,3,3
moon-guard,288,druid,feral,6,3,3
hellscream,288,druid,feral,6,3,3
proudmoore,288,druid,feral,6,3,3
tichondrius,288,druid,feral,6,3,3
senjin,288,druid,feral,6,3,3
stormreaver,288,druid,feral,6,3,3
malganis,288,druid,feral,6,3,3
kiljaeden,288,druid,feral,6,3,3
frostmourne,288,druid,feral,6,3,3
area-52,288,druid,feral,6,3,3
tichondrius,288,druid,feral,6,3,3
tichondrius,288,druid,feral,6,3,3
sargeras,288,druid,feral,6,3,3
sargeras,288,druid,feral,6,3,3
stormrage,288,druid,feral,6,3,3
tichondrius,288,druid,feral,6,3,3
tichondrius,288,druid,feral,6,3,3
moon-guard,288,druid,feral,6,3,3
tichondrius,288,druid,feral,6,3,3
tichondrius,288,druid,feral,6,3,3
firetree,288,druid,feral,6,3,3
hyjal,288,druid,feral,6,3,3
bladefist,288,druid,feral,6,3,3
ragnaros,288,druid,feral,6,3,3
moon-guard,288,druid,feral,6,3,3
aerie-peak,288,druid,feral,6,3,3
kul-tiras,288,druid,feral,6,3,3
sargeras,288,druid,feral,6,3,3
drakkari,288,druid,feral,8,3,5
stormscale,288,druid,feral,12,3,9
zuljin,288,druid,feral,12,3,9
grizzly-hills,288,druid,feral,12,3,9
tichondrius,288,druid,feral,12,3,9
dalaran,288,druid,feral,12,3,9
frostmourne,288,druid,feral,12,3,9
emerald-dream,288,druid,feral,12,3,9
dalaran,287,druid,feral,8,4,4
illidan,287,druid,feral,6,3,3
uldaman,287,druid,feral,6,3,3
moon-guard,287,druid,feral,6,3,3
emerald-dream,287,druid,feral,6,3,3
stormrage,286,druid,feral,6,3,3
tichondrius,255,druid,feral,11,3,8
emerald-dream,239,druid,feral,5,3,2
dentarg,239,druid,feral,5,3,2
stormrage,239,druid,feral,5,3,2
zuljin,221,druid,feral,29,8,21
ragnaros,192,druid,feral,4,3,1
emerald-dream,192,druid,feral,9,3,6
zuljin,192,druid,feral,9,3,6
hydraxis,192,druid,feral,6,2,4
dalaran,192,druid,feral,6,2,4
moon-guard,192,druid,feral,6,2,4
medivh,192,druid,feral,6,2,4
moon-guard,192,druid,feral,6,2,4
laughing-skull,192,druid,feral,6,2,4
thrall,192,druid,feral,6,2,4
area-52,192,druid,feral,6,2,4
area-52,192,druid,feral,6,2,4
deathwing,192,druid,feral,6,2,4
illidan,192,druid,feral,6,2,4
illidan,192,druid,feral,6,2,4
illidan,192,druid,feral,6,2,4
moonrunner,192,druid,feral,6,2,4
nerzhul,192,druid,feral,6,2,4
lightnings-blade,192,druid,feral,6,2,4
stormrage,192,druid,feral,6,2,4
tichondrius,192,druid,feral,6,2,4
malganis,192,druid,feral,6,2,4
illidan,192,druid,feral,6,2,4
malganis,192,druid,feral,6,2,4
tichondrius,192,druid,feral,6,2,4
kiljaeden,192,druid,feral,6,2,4
tichondrius,192,druid,feral,6,2,4
tichondrius,192,druid,feral,6,2,4
azralon,192,druid,feral,6,2,4
antonidas,192,druid,feral,6,2,4
frostmourne,192,druid,feral,6,2,4
sargeras,192,druid,feral,6,2,4
sargeras,192,druid,feral,6,2,4
tichondrius,192,druid,feral,6,2,4
kiljaeden,192,druid,feral,6,2,4
illidan,192,druid,feral,6,2,4
sargeras,192,druid,feral,6,2,4
tichondrius,192,druid,feral,6,2,4
tichondrius,192,druid,feral,6,2,4
tichondrius,192,druid,feral,6,2,4
ragnaros,192,druid,feral,12,2,10
blades-edge,192,druid,feral,12,2,10
shattered-hand,192,druid,feral,12,2,10
moon-guard,192,druid,feral,12,2,10
azralon,192,druid,feral,12,2,10
stormreaver,192,druid,feral,12,2,10
crushridge,192,druid,feral,12,2,10
zuljin,192,druid,feral,12,2,10
boulderfist,192,druid,feral,12,2,10
bleeding-hollow,192,druid,feral,12,2,10
kiljaeden,192,druid,feral,12,2,10
tichondrius,175,druid,feral,11,2,9
bleeding-hollow,159,druid,feral,5,2,3
stormrage,138,druid,feral,7,3,4
darkspear,128,druid,feral,4,2,2
drenden,96,druid,feral,3,2,1
malganis,96,druid,feral,6,1,5
stormrage,96,druid,feral,6,1,5
malganis,96,druid,feral,6,1,5
alterac-mountains,96,druid,feral,6,1,5
drakkari,96,druid,feral,6,1,5
moon-guard,96,druid,feral,6,1,5
emerald-dream,96,druid,feral,6,1,5
sargeras,96,druid,feral,6,1,5
emerald-dream,96,druid,feral,6,1,5
moon-guard,96,druid,feral,6,1,5
area-52,96,druid,feral,6,1,5
area-52,96,druid,feral,6,1,5
azralon,96,druid,feral,6,1,5
tichondrius,96,druid,feral,6,1,5
deathwing,96,druid,feral,6,1,5
blades-edge,96,druid,feral,6,1,5
skywall,96,druid,feral,6,1,5
sargeras,96,druid,feral,6,1,5
zuljin,96,druid,feral,6,1,5
emerald-dream,96,druid,feral,6,1,5
zuljin,96,druid,feral,6,1,5
aegwynn,96,druid,feral,6,1,5
zuljin,96,druid,feral,6,1,5
earthen-ring,96,druid,feral,6,1,5
ragnaros,96,druid,feral,6,1,5
tichondrius,96,druid,feral,6,1,5
tichondrius,96,druid,feral,6,1,5
tichondrius,96,druid,feral,6,1,5
garona,96,druid,feral,6,1,5
sargeras,96,druid,feral,6,1,5
black-dragonflight,96,druid,feral,6,1,5
tichondrius,96,druid,feral,6,1,5
agamaggan,96,druid,feral,6,1,5
bleeding-hollow,96,druid,feral,6,1,5
tichondrius,96,druid,feral,6,1,5
auchindoun,96,druid,feral,6,1,5
tichondrius,96,druid,feral,6,1,5
laughing-skull,96,druid,feral,6,1,5
darkspear,96,druid,feral,6,1,5
frostmourne,96,druid,feral,6,1,5
moon-guard,96,druid,feral,6,1,5
dalaran,96,druid,feral,6,1,5
kelthuzad,96,druid,feral,6,1,5
illidan,96,druid,feral,6,1,5
skywall,96,druid,feral,6,1,5
illidan,96,druid,feral,6,1,5
stormrage,96,druid,feral,6,1,5
illidan,96,druid,feral,6,1,5
emerald-dream,96,druid,feral,12,1,11
zuljin,96,druid,feral,12,1,11
quelthalas,95,druid,feral,6,1,5
frostmourne,79,druid,feral,5,1,4
bleeding-hollow,48,druid,feral,3,1,2
nemesis,31,druid,feral,2,1,1
kelthuzad,16,druid,feral,1,1,0
hyjal,16,druid,feral,1,1,0
tichondrius,2324,druid,balance,83,54,29
tanaris,2277,druid,balance,120,68,52
balnazzar,2236,druid,balance,124,85,39
tichondrius,2231,druid,balance,105,60,45
tichondrius,2228,druid,balance,94,55,39
illidan,2213,druid,balance,78,46,32
illidan,2173,druid,balance,102,61,41
illidan,2164,druid,balance,66,38,28
shadowsong,2157,druid,balance,72,41,31
farstriders,2147,druid,balance,98,51,47
frostmourne,2141,druid,balance,60,41,19
quelthalas,2137,druid,balance,89,58,31
tichondrius,2135,druid,balance,102,52,50
tichondrius,2134,druid,balance,96,50,46
malganis,2131,druid,balance,88,47,41
illidan,2130,druid,balance,53,43,10
frostmourne,2104,druid,balance,60,32,28
tichondrius,2102,druid,balance,78,49,29
stormrage,2099,druid,balance,98,50,48
stormrage,2097,druid,balance,71,42,29
tichondrius,2086,druid,balance,66,39,27
dentarg,2075,druid,balance,144,74,70
cenarion-circle,2064,druid,balance,66,36,30
tichondrius,2058,druid,balance,54,32,22
illidan,2052,druid,balance,72,42,30
malganis,2049,druid,balance,62,44,18
darkspear,2044,druid,balance,141,81,60
frostmourne,2029,druid,balance,156,87,69
stormrage,2018,druid,balance,72,44,28
aerie-peak,2011,druid,balance,96,53,43
moon-guard,1990,druid,balance,70,36,34
darkspear,1987,druid,balance,36,29,7
stormrage,1987,druid,balance,97,52,45
tichondrius,1984,druid,balance,40,29,11
azralon,1984,druid,balance,66,47,19
area-52,1981,druid,balance,30,21,9
malganis,1979,druid,balance,54,33,21
zuljin,1977,druid,balance,69,42,27
frostmourne,1971,druid,balance,100,55,45
tichondrius,1965,druid,balance,64,34,30
quelthalas,1960,druid,balance,56,33,23
tichondrius,1959,druid,balance,58,31,27
dalaran,1955,druid,balance,62,43,19
tichondrius,1954,druid,balance,68,40,28
zuljin,1945,druid,balance,48,31,17
nagrand,1938,druid,balance,170,87,83
tichondrius,1937,druid,balance,59,36,23
tichondrius,1937,druid,balance,60,31,29
arygos,1933,druid,balance,78,50,28
azralon,1930,druid,balance,65,35,30
sargeras,1922,druid,balance,78,46,32
tichondrius,1911,druid,balance,67,37,30
sargeras,1908,druid,balance,60,38,22
moon-guard,1899,druid,balance,52,31,21
blackrock,1899,druid,balance,42,23,19
azralon,1896,druid,balance,72,34,38
tichondrius,1893,druid,balance,42,26,16
illidan,1885,druid,balance,56,35,21
area-52,1884,druid,balance,63,42,21
tichondrius,1883,druid,balance,66,33,33
kelthuzad,1877,druid,balance,60,35,25
tichondrius,1870,druid,balance,72,47,25
zuljin,1864,druid,balance,33,24,9
hellscream,1863,druid,balance,30,26,4
bleeding-hollow,1858,druid,balance,68,40,28
laughing-skull,1858,druid,balance,78,43,35
tichondrius,1853,druid,balance,57,37,20
bleeding-hollow,1853,druid,balance,54,34,20
thrall,1853,druid,balance,68,35,33
azralon,1850,druid,balance,45,32,13
tichondrius,1840,druid,balance,36,23,13
tichondrius,1840,druid,balance,78,49,29
dalaran,1835,druid,balance,116,71,45
quelthalas,1833,druid,balance,113,59,54
nemesis,1829,druid,balance,42,25,17
queldorei,1829,druid,balance,66,31,35
kelthuzad,1828,druid,balance,87,47,40
firetree,1827,druid,balance,66,42,24
area-52,1827,druid,balance,42,23,19
illidan,1823,druid,balance,72,32,40
frostmourne,1821,druid,balance,66,38,28
malganis,1818,druid,balance,48,29,19
malganis,1818,druid,balance,180,102,78
tichondrius,1817,druid,balance,42,25,17
area-52,1816,druid,balance,48,30,18
chogall,1815,druid,balance,48,34,14
zuljin,1814,druid,balance,36,19,17
illidan,1810,druid,balance,66,39,27
tichondrius,1810,druid,balance,54,30,24
tichondrius,1809,druid,balance,36,27,9
tichondrius,1808,druid,balance,54,30,24
nemesis,1806,druid,balance,71,41,30
cairne,1805,druid,balance,48,31,17
nordrassil,1801,druid,balance,112,59,53
duskwood,1800,druid,balance,57,38,19
illidan,1791,druid,balance,53,32,21
eldrethalas,1790,druid,balance,48,32,16
thrall,1790,druid,balance,116,73,43
sargeras,1789,druid,balance,36,24,12
kelthuzad,1781,druid,balance,48,31,17
illidan,1774,druid,balance,87,57,30
zuljin,1774,druid,balance,40,26,14
tichondrius,1772,druid,balance,89,44,45
tichondrius,1771,druid,balance,50,29,21
tichondrius,1770,druid,balance,54,30,24
tichondrius,1769,druid,balance,47,24,23
tichondrius,1768,druid,balance,48,26,22
zuljin,1767,druid,balance,47,25,22
thrall,1766,druid,balance,60,39,21
tichondrius,1765,druid,balance,42,32,10
tichondrius,1765,druid,balance,48,28,20
sargeras,1760,druid,balance,60,45,15
ragnaros,1756,druid,balance,72,44,28
quelthalas,1756,druid,balance,48,27,21
kelthuzad,1753,druid,balance,54,27,27
illidan,1750,druid,balance,75,44,31
illidan,1749,druid,balance,54,34,20
tichondrius,1743,druid,balance,53,31,22
tichondrius,1742,druid,balance,30,19,11
stormrage,1737,druid,balance,128,69,59
azralon,1736,druid,balance,60,37,23
tichondrius,1734,druid,balance,30,20,10
magtheridon,1734,druid,balance,42,25,17
stormrage,1734,druid,balance,96,48,48
sargeras,1730,druid,balance,67,37,30
sargeras,1730,druid,balance,174,96,78
area-52,1728,druid,balance,54,25,29
hyjal,1722,druid,balance,48,26,22
barthilas,1721,druid,balance,35,19,16
sargeras,1721,druid,balance,148,72,76
area-52,1721,druid,balance,240,116,124
area-52,1719,druid,balance,42,24,18
frostmourne,1718,druid,balance,42,27,15
tichondrius,1718,druid,balance,48,24,24
illidan,1718,druid,balance,42,21,21
sargeras,1715,druid,balance,71,39,32
bleeding-hollow,1713,druid,balance,24,18,6
stormrage,1711,druid,balance,75,43,32
moon-guard,1708,druid,balance,77,45,32
sargeras,1707,druid,balance,24,18,6
zuljin,1703,druid,balance,45,28,17
moon-guard,1702,druid,balance,81,42,39
tichondrius,1701,druid,balance,47,28,19
stormrage,1697,druid,balance,75,41,34
kelthuzad,1695,druid,balance,54,43,11
tichondrius,1687,druid,balance,34,23,11
tichondrius,1683,druid,balance,24,19,5
hyjal,1682,druid,balance,30,21,9
sargeras,1678,druid,balance,106,49,57
emerald-dream,1674,druid,balance,165,92,73
area-52,1671,druid,balance,54,35,19
malganis,1668,druid,balance,78,43,35
ysera,1665,druid,balance,48,25,23
tichondrius,1664,druid,balance,42,25,17
stormrage,1664,druid,balance,105,56,49
rexxar,1660,druid,balance,54,36,18
area-52,1660,druid,balance,41,21,20
moon-guard,1657,druid,balance,30,18,12
tichondrius,1654,druid,balance,54,34,20
kelthuzad,1653,druid,balance,36,19,17
moon-guard,1653,druid,balance,71,35,36
malganis,1652,druid,balance,53,34,19
tichondrius,1646,druid,balance,73,30,43
kelthuzad,1644,druid,balance,42,29,13
frostmourne,1640,druid,balance,66,37,29
aerie-peak,1639,druid,balance,26,18,8
illidan,1638,druid,balance,72,36,36
barthilas,1637,druid,balance,30,19,11
emerald-dream,1636,druid,balance,32,21,11
aggramar,1635,druid,balance,35,18,17
moon-guard,1631,druid,balance,24,17,7
tichondrius,1630,druid,balance,48,36,12
sargeras,1627,druid,balance,24,17,7
sargeras,1625,druid,balance,29,18,11
tichondrius,1624,druid,balance,24,17,7
nemesis,1624,druid,balance,60,39,21
moon-guard,1624,druid,balance,35,21,14
tichondrius,1623,druid,balance,30,20,10
tichondrius,1621,druid,balance,24,17,7
blackrock,1621,druid,balance,61,30,31
tichondrius,1619,druid,balance,29,24,5
wyrmrest-accord,1619,druid,balance,30,23,7
wyrmrest-accord,1619,druid,balance,30,17,13
proudmoore,1618,druid,balance,42,28,14
moon-guard,1618,druid,balance,89,53,36
bloodhoof,1618,druid,balance,42,22,20
proudmoore,1617,druid,balance,75,37,38
tichondrius,1614,druid,balance,54,30,24
tichondrius,1613,druid,balance,30,17,13
daggerspine,1608,druid,balance,41,28,13
frostmourne,1608,druid,balance,41,20,21
area-52,1603,druid,balance,78,49,29
moon-guard,1603,druid,balance,125,70,55
tichondrius,1596,druid,balance,24,17,7
darkspear,1595,druid,balance,54,29,25
silvermoon,1586,druid,balance,36,23,13
hyjal,1582,druid,balance,54,31,23
illidan,1582,druid,balance,62,33,29
ysondre,1580,druid,balance,65,35,30
azjolnerub,1579,druid,balance,30,21,9
bleeding-hollow,1578,druid,balance,66,37,29
tichondrius,1575,druid,balance,38,25,13
stormrage,1573,druid,balance,90,46,44
malganis,1572,druid,balance,37,20,17
tichondrius,1567,druid,balance,48,29,19
stormrage,1563,druid,balance,79,44,35
kelthuzad,1559,druid,balance,124,73,51
azralon,1559,druid,balance,73,42,31
stormrage,1559,druid,balance,79,42,37
area-52,1558,druid,balance,57,32,25
kiljaeden,1558,druid,balance,42,19,23
stormrage,1554,druid,balance,42,21,21
emerald-dream,1549,druid,balance,47,27,20
velen,1544,druid,balance,28,18,10
tichondrius,1540,druid,balance,192,103,89
stormrage,1537,druid,balance,84,38,46
tichondrius,1535,druid,balance,24,16,8
illidan,1535,druid,balance,66,40,26
frostmourne,1535,druid,balance,103,57,46
tichondrius,1535,druid,balance,90,48,42
proudmoore,1535,druid,balance,44,22,22
malganis,1534,druid,balance,18,16,2
tichondrius,1534,druid,balance,30,16,14
emerald-dream,1532,druid,balance,42,23,19
khadgar,1532,druid,balance,36,18,18
tichondrius,1532,druid,balance,36,16,20
sargeras,1524,druid,balance,30,16,14
tichondrius,1523,druid,balance,24,16,8
tichondrius,1517,druid,balance,57,30,27
sargeras,1517,druid,balance,36,17,19
area-52,1510,druid,balance,24,16,8
sargeras,1510,druid,balance,30,18,12
tichondrius,1509,druid,balance,74,45,29
tichondrius,1505,druid,balance,55,34,21
illidan,1505,druid,balance,71,42,29
ghostlands,1504,druid,balance,71,40,31
malganis,1501,druid,balance,24,16,8
tichondrius,1495,druid,balance,49,25,24
lightnings-blade,1494,druid,balance,139,70,69
illidan,1492,druid,balance,54,23,31
kaelthas,1491,druid,balance,57,36,21
auchindoun,1487,druid,balance,54,31,23
blackrock,1485,druid,balance,42,22,20
proudmoore,1484,druid,balance,45,32,13
malorne,1484,druid,balance,95,53,42
ragnaros,1482,druid,balance,29,16,13
kelthuzad,1481,druid,balance,99,55,44
tichondrius,1477,druid,balance,54,33,21
ragnaros,1477,druid,balance,66,37,29
proudmoore,1474,druid,balance,72,36,36
cenarion-circle,1473,druid,balance,89,54,35
malganis,1469,druid,balance,42,30,12
tichondrius,1468,druid,balance,53,28,25
barthilas,1462,druid,balance,66,29,37
illidan,1459,druid,balance,27,17,10
frostmourne,1455,druid,balance,27,19,8
sargeras,1453,druid,balance,36,22,14
stormrage,1452,druid,balance,78,42,36
tichondrius,1452,druid,balance,35,16,19
proudmoore,1451,druid,balance,71,37,34
quelthalas,1449,druid,balance,72,33,39
frostwolf,1447,druid,balance,27,16,11
illidan,1447,druid,balance,78,41,37
bleeding-hollow,1445,druid,balance,48,32,16
the-forgotten-coast,1445,druid,balance,32,19,13
emerald-dream,1445,druid,balance,48,27,21
proudmoore,1442,druid,balance,30,17,13
korgath,1441,druid,balance,54,32,22
frostmourne,1438,druid,balance,34,18,16
moon-guard,1437,druid,balance,55,25,30
shattered-halls,1433,druid,balance,41,18,23
stormrage,1432,druid,balance,30,19,11
area-52,1432,druid,balance,41,18,23
illidan,1431,druid,balance,18,15,3
tichondrius,1431,druid,balance,42,30,12
wyrmrest-accord,1426,druid,balance,62,33,29
tichondrius,1424,druid,balance,36,17,19
thrall,1423,druid,balance,24,15,9
chogall,1423,druid,balance,54,32,22
dalaran,1421,druid,balance,24,17,7
dragonmaw,1420,druid,balance,30,15,15
kelthuzad,1420,druid,balance,30,15,15
tichondrius,1415,druid,balance,66,38,28
stormrage,1414,druid,balance,18,15,3
stormrage,1413,druid,balance,125,65,60
aggramar,1410,druid,balance,42,17,25
frostmourne,1409,druid,balance,24,15,9
moon-guard,1408,druid,balance,23,18,5
tichondrius,1405,druid,balance,35,22,13
kiljaeden,1404,druid,balance,26,17,9
stonemaul,1403,druid,balance,92,53,39
stormrage,1402,druid,balance,30,19,11
goldrinn,1402,druid,balance,239,114,125
tichondrius,1401,druid,balance,30,15,15
tichondrius,1399,druid,balance,48,27,21
thrall,1398,druid,balance,69,32,37
tichondrius,1396,druid,balance,24,19,5
nemesis,1396,druid,balance,33,17,16
sargeras,1391,druid,balance,70,42,28
mannoroth,1385,druid,balance,70,33,37
blackrock,1378,druid,balance,177,89,88
wyrmrest-accord,1374,druid,balance,41,23,18
malganis,1374,druid,balance,54,27,27
tichondrius,1374,druid,balance,40,18,22
tichondrius,1373,druid,balance,36,20,16
frostmourne,1364,druid,balance,24,16,8
jubeithos,1364,druid,balance,36,20,16
aerie-peak,1363,druid,balance,72,34,38
sargeras,1360,druid,balance,72,41,31
frostmourne,1358,druid,balance,24,17,7
sargeras,1353,druid,balance,23,15,8
icecrown,1348,druid,balance,60,34,26
frostmourne,1345,druid,balance,41,21,20
barthilas,1343,druid,balance,35,19,16
ragnaros,1339,druid,balance,22,15,7
ragnaros,1336,druid,balance,24,15,9
barthilas,1334,druid,balance,24,14,10
earthen-ring,1333,druid,balance,40,20,20
tichondrius,1332,druid,balance,27,15,12
tichondrius,1330,druid,balance,35,26,9
bleeding-hollow,1329,druid,balance,21,15,6
stormrage,1329,druid,balance,36,14,22
zuljin,1328,druid,balance,24,14,10
garrosh,1326,druid,balance,30,14,16
emerald-dream,1324,druid,balance,22,15,7
tichondrius,1324,druid,balance,101,60,41
malganis,1319,druid,balance,24,14,10
malganis,1319,druid,balance,24,14,10
azralon,1318,druid,balance,24,17,7
quelthalas,1317,druid,balance,24,14,10
sargeras,1313,druid,balance,30,20,10
tichondrius,1311,druid,balance,49,27,22
nagrand,1310,druid,balance,43,27,16
sargeras,1308,druid,balance,24,14,10
tichondrius,1307,druid,balance,42,21,21
stormrage,1306,druid,balance,19,15,4
ragnaros,1298,druid,balance,49,19,30
stormreaver,1296,druid,balance,36,19,17
sargeras,1293,druid,balance,44,23,21
area-52,1289,druid,balance,34,18,16
moon-guard,1289,druid,balance,181,89,92
frostmourne,1272,druid,balance,72,30,42
tichondrius,1271,druid,balance,24,18,6
ragnaros,1271,druid,balance,24,14,10
malganis,1269,druid,balance,52,24,28
tichondrius,1268,druid,balance,30,15,15
azralon,1265,druid,balance,29,14,15
zuljin,1262,druid,balance,21,14,7
tichondrius,1262,druid,balance,24,14,10
bonechewer,1262,druid,balance,36,16,20
stormrage,1260,druid,balance,45,19,26
tichondrius,1259,druid,balance,57,24,33
nemesis,1249,druid,balance,30,17,13
illidan,1248,druid,balance,24,13,11
uther,1246,druid,balance,24,13,11
emerald-dream,1245,druid,balance,18,13,5
stormrage,1244,druid,balance,21,15,6
frostmourne,1241,druid,balance,24,13,11
drakkari,1241,druid,balance,30,14,16
azralon,1240,druid,balance,24,13,11
bleeding-hollow,1238,druid,balance,24,13,11
kelthuzad,1237,druid,balance,30,13,17
area-52,1234,druid,balance,24,13,11
zuljin,1234,druid,balance,30,13,17
bleeding-hollow,1230,druid,balance,18,13,5
tichondrius,1228,druid,balance,30,13,17
illidan,1226,druid,balance,24,13,11
malganis,1222,druid,balance,24,13,11
goldrinn,1222,druid,balance,33,15,18
illidan,1220,druid,balance,18,13,5
tichondrius,1220,druid,balance,35,19,16
frostmourne,1219,druid,balance,18,13,5
frostmourne,1219,druid,balance,18,13,5
tichondrius,1219,druid,balance,46,19,27
bleeding-hollow,1215,druid,balance,62,33,29
area-52,1211,druid,balance,37,17,20
proudmoore,1209,druid,balance,26,14,12
tichondrius,1202,druid,balance,28,14,14
stormrage,1200,druid,balance,75,41,34
sargeras,1192,druid,balance,30,17,13
korgath,1191,druid,balance,83,41,42
tichondrius,1188,druid,balance,42,20,22
shuhalo,1185,druid,balance,72,35,37
tichondrius,1181,druid,balance,70,39,31
illidan,1177,druid,balance,30,15,15
tichondrius,1177,druid,balance,67,32,35
sargeras,1177,druid,balance,29,13,16
blackrock,1171,druid,balance,30,16,14
mannoroth,1154,druid,balance,34,16,18
black-dragonflight,1151,druid,balance,18,12,6
kelthuzad,1151,druid,balance,18,12,6
zuljin,1151,druid,balance,18,12,6
arthas,1150,druid,balance,24,12,12
caelestrasz,1148,druid,balance,18,12,6
nazjatar,1144,druid,balance,18,12,6
aegwynn,1144,druid,balance,45,25,20
frostmourne,1137,druid,balance,18,12,6
tichondrius,1135,druid,balance,24,12,12
proudmoore,1134,druid,balance,24,12,12
azralon,1130,druid,balance,18,12,6
ravencrest,1129,druid,balance,24,12,12
moon-guard,1118,druid,balance,48,27,21
illidan,1111,druid,balance,18,12,6
tichondrius,1103,druid,balance,17,12,5
sargeras,1095,druid,balance,22,13,9
ragnaros,1094,druid,balance,29,12,17
illidan,1090,druid,balance,27,13,14
tichondrius,1089,druid,balance,35,15,20
illidan,1088,druid,balance,22,12,10
deathwing,1070,druid,balance,17,12,5
thrall,1064,druid,balance,36,18,18
blackrock,1059,druid,balance,30,13,17
tichondrius,1056,druid,balance,18,11,7
dalaran,1056,druid,balance,18,11,7
kelthuzad,1056,druid,balance,18,11,7
tichondrius,1055,druid,balance,12,11,1
malganis,1055,druid,balance,18,11,7
stormrage,1055,druid,balance,18,11,7
burning-legion,1055,druid,balance,18,11,7
sargeras,1055,druid,balance,18,11,7
zuljin,1055,druid,balance,18,11,7
tichondrius,1055,druid,balance,18,11,7
tichondrius,1055,druid,balance,24,11,13
bleeding-hollow,1055,druid,balance,24,11,13
frostmourne,1055,druid,balance,24,11,13
tichondrius,1054,druid,balance,18,11,7
stonemaul,1054,druid,balance,18,11,7
blackrock,1054,druid,balance,18,11,7
ragnaros,1054,druid,balance,18,11,7
kiljaeden,1054,druid,balance,18,11,7
thrall,1054,druid,balance,18,11,7
malganis,1054,druid,balance,24,13,11
kelthuzad,1053,druid,balance,18,11,7
tichondrius,1053,druid,balance,18,11,7
illidan,1053,druid,balance,22,12,10
tichondrius,1051,druid,balance,18,11,7
moon-guard,1051,druid,balance,18,11,7
illidan,1050,druid,balance,18,11,7
quelthalas,1050,druid,balance,45,23,22
tichondrius,1050,druid,balance,24,11,13
tichondrius,1048,druid,balance,24,11,13
tichondrius,1047,druid,balance,22,11,11
stormrage,1047,druid,balance,24,11,13
moon-guard,1046,druid,balance,18,11,7
lightninghoof,1044,druid,balance,24,11,13
aerie-peak,1042,druid,balance,24,11,13
moon-guard,1040,druid,balance,33,13,20
kelthuzad,1036,druid,balance,30,12,18
malganis,1035,druid,balance,18,11,7
frostmourne,1014,druid,balance,19,12,7
draenor,1012,druid,balance,23,11,12
ragnaros,1011,druid,balance,18,11,7
blackrock,1010,druid,balance,18,11,7
mannoroth,989,druid,balance,26,17,9
norgannon,987,druid,balance,20,11,9
nemesis,987,druid,balance,20,11,9
tichondrius,986,druid,balance,86,46,40
tichondrius,983,druid,balance,15,12,3
rivendare,980,druid,balance,22,11,11
lightbringer,977,druid,balance,36,21,15
illidan,977,druid,balance,32,12,20
arthas,960,druid,balance,12,10,2
frostmane,960,druid,balance,12,10,2
zuljin,960,druid,balance,12,10,2
bleeding-hollow,960,druid,balance,12,10,2
tichondrius,960,druid,balance,18,10,8
wyrmrest-accord,960,druid,balance,18,10,8
tichondrius,960,druid,balance,18,10,8
sargeras,959,druid,balance,12,10,2
proudmoore,959,druid,balance,12,10,2
tichondrius,959,druid,balance,18,10,8
moon-guard,959,druid,balance,18,10,8
hyjal,959,druid,balance,18,10,8
tichondrius,958,druid,balance,12,10,2
sargeras,958,druid,balance,18,10,8
veknilash,958,druid,balance,24,10,14
illidan,957,druid,balance,12,10,2
thunderlord,956,druid,balance,18,10,8
tichondrius,956,druid,balance,18,10,8
bleeding-hollow,955,druid,balance,18,10,8
zuljin,955,druid,balance,18,10,8
darkspear,955,druid,balance,18,10,8
dalaran,953,druid,balance,24,10,14
sargeras,952,druid,balance,18,10,8
thunderlord,952,druid,balance,18,10,8
bloodhoof,952,druid,balance,18,10,8
draka,952,druid,balance,34,15,19
kaelthas,947,druid,balance,54,28,26
moon-guard,909,druid,balance,29,13,16
nazjatar,900,druid,balance,37,11,26
tichondrius,878,druid,balance,25,10,15
bloodscalp,864,druid,balance,12,9,3
thrall,864,druid,balance,12,9,3
tichondrius,864,druid,balance,12,9,3
tichondrius,864,druid,balance,12,9,3
tichondrius,864,druid,balance,18,9,9
illidan,864,druid,balance,18,9,9
tichondrius,864,druid,balance,18,9,9
thrall,864,druid,balance,18,9,9
tichondrius,864,druid,balance,18,9,9
sargeras,864,druid,balance,18,9,9
darkspear,864,druid,balance,24,9,15
tichondrius,864,druid,balance,30,9,21
trollbane,863,druid,balance,12,9,3
thrall,863,druid,balance,12,9,3
tichondrius,863,druid,balance,12,9,3
aerie-peak,863,druid,balance,18,9,9
chogall,863,druid,balance,18,9,9
sargeras,863,druid,balance,18,9,9
bonechewer,862,druid,balance,12,9,3
azralon,862,druid,balance,12,9,3
illidan,862,druid,balance,12,9,3
tichondrius,862,druid,balance,13,9,4
area-52,862,druid,balance,18,9,9
thrall,861,druid,balance,12,9,3
tichondrius,861,druid,balance,18,9,9
tichondrius,860,druid,balance,18,9,9
tichondrius,858,druid,balance,24,9,15
magtheridon,858,druid,balance,24,9,15
barthilas,857,druid,balance,18,9,9
malganis,842,druid,balance,24,11,13
zuluhed,815,druid,balance,17,9,8
area-52,804,druid,balance,114,44,70
firetree,783,druid,balance,11,9,2
kaelthas,768,druid,balance,12,8,4
zuljin,768,druid,balance,12,8,4
sargeras,768,druid,balance,12,8,4
area-52,768,druid,balance,12,8,4
emerald-dream,768,druid,balance,12,8,4
bleeding-hollow,768,druid,balance,12,8,4
sargeras,768,druid,balance,12,8,4
nerzhul,768,druid,balance,12,8,4
nordrassil,768,druid,balance,12,8,4
bleeding-hollow,768,druid,balance,12,8,4
frostmourne,768,druid,balance,12,8,4
tichondrius,768,druid,balance,12,8,4
tichondrius,768,druid,balance,12,8,4
tichondrius,768,druid,balance,18,8,10
tichondrius,768,druid,balance,18,8,10
rivendare,768,druid,balance,18,8,10
malganis,767,druid,balance,12,8,4
arygos,767,druid,balance,12,8,4
tichondrius,767,druid,balance,12,8,4
chogall,767,druid,balance,12,8,4
tichondrius,767,druid,balance,12,8,4
nemesis,767,druid,balance,12,8,4
area-52,767,druid,balance,15,9,6
malganis,767,druid,balance,18,8,10
zuljin,767,druid,balance,18,8,10
spinebreaker,767,druid,balance,24,8,16
frostmourne,766,druid,balance,12,8,4
stonemaul,765,druid,balance,12,8,4
blackhand,765,druid,balance,15,9,6
senjin,765,druid,balance,18,8,10
tichondrius,764,druid,balance,18,8,10
barthilas,764,druid,balance,26,8,18
area-52,763,druid,balance,12,8,4
ragnaros,762,druid,balance,12,8,4
sargeras,762,druid,balance,18,8,10
illidan,759,druid,balance,12,8,4
antonidas,756,druid,balance,12,8,4
lightbringer,735,druid,balance,14,9,5
tichondrius,734,druid,balance,10,9,1
tichondrius,687,druid,balance,13,8,5
alexstrasza,672,druid,balance,12,7,5
thrall,672,druid,balance,12,7,5
zuljin,672,druid,balance,12,7,5
kelthuzad,672,druid,balance,12,7,5
drakkari,672,druid,balance,12,7,5
ragnaros,672,druid,balance,12,7,5
chogall,672,druid,balance,12,7,5
illidan,672,druid,balance,12,7,5
tichondrius,672,druid,balance,12,7,5
area-52,672,druid,balance,12,7,5
bleeding-hollow,672,druid,balance,12,7,5
tichondrius,672,druid,balance,12,7,5
sargeras,672,druid,balance,12,7,5
kelthuzad,672,druid,balance,12,7,5
lightbringer,672,druid,balance,12,7,5
azralon,672,druid,balance,12,7,5
muradin,672,druid,balance,12,7,5
illidan,672,druid,balance,18,7,11
illidan,672,druid,balance,18,7,11
bleeding-hollow,672,druid,balance,18,7,11
tichondrius,672,druid,balance,18,7,11
tichondrius,671,druid,balance,12,7,5
zuljin,671,druid,balance,12,7,5
area-52,671,druid,balance,12,7,5
zuljin,671,druid,balance,12,7,5
moon-guard,671,druid,balance,12,7,5
area-52,671,druid,balance,12,7,5
tichondrius,671,druid,balance,12,7,5
stormrage,671,druid,balance,18,7,11
thrall,671,druid,balance,18,7,11
aegwynn,671,druid,balance,18,7,11
agamaggan,671,druid,balance,18,7,11
farstriders,670,druid,balance,12,7,5
nerzhul,670,druid,balance,12,7,5
illidan,670,druid,balance,12,7,5
tichondrius,669,druid,balance,12,7,5
frostmourne,669,druid,balance,12,7,5
tichondrius,668,druid,balance,12,7,5
frostwolf,664,druid,balance,12,7,5
stormrage,664,druid,balance,15,8,7
spirestone,659,druid,balance,12,7,5
darkspear,639,druid,balance,17,7,10
terenas,624,druid,balance,9,7,2
illidan,618,druid,balance,16,11,5
quelthalas,618,druid,balance,18,8,10
moon-guard,616,druid,balance,15,7,8
thrall,608,druid,balance,16,7,9
emerald-dream,607,druid,balance,11,7,4
tichondrius,576,druid,balance,6,6,0
bleeding-hollow,576,druid,balance,6,6,0
illidan,576,druid,balance,6,6,0
tichondrius,576,druid,balance,6,6,0
arathor,576,druid,balance,6,6,0
frostmourne,576,druid,balance,6,6,0
frostmourne,576,druid,balance,6,6,0
area-52,576,druid,balance,12,6,6
executus,576,druid,balance,12,6,6
demon-soul,576,druid,balance,12,6,6
garona,576,druid,balance,12,6,6
kelthuzad,576,druid,balance,12,6,6
kiljaeden,576,druid,balance,12,6,6
illidan,576,druid,balance,12,6,6
emerald-dream,576,druid,balance,12,6,6
tichondrius,576,druid,balance,12,6,6
stormrage,576,druid,balance,12,6,6
tichondrius,576,druid,balance,12,6,6
eitrigg,576,druid,balance,12,6,6
malganis,576,druid,balance,12,6,6
illidan,576,druid,balance,12,6,6
frostmourne,576,druid,balance,12,6,6
sargeras,576,druid,balance,12,6,6
kiljaeden,576,druid,balance,12,6,6
ragnaros,576,druid,balance,12,6,6
arthas,576,druid,balance,12,6,6
bleeding-hollow,576,druid,balance,12,6,6
cenarius,576,druid,balance,12,6,6
zuljin,576,druid,balance,12,6,6
stormrage,576,druid,balance,12,6,6
nerzhul,576,druid,balance,12,6,6
frostmourne,576,druid,balance,12,6,6
tichondrius,576,druid,balance,12,6,6
tichondrius,576,druid,balance,13,6,7
tichondrius,576,druid,balance,16,7,9
moon-guard,576,druid,balance,16,6,10
stormrage,576,druid,balance,18,6,12
stormreaver,576,druid,balance,18,6,12
mannoroth,576,druid,balance,18,6,12
azralon,575,druid,balance,6,6,0
area-52,575,druid,balance,6,6,0
area-52,575,druid,balance,12,6,6
bloodhoof,575,druid,balance,12,6,6
khazgoroth,575,druid,balance,12,6,6
moon-guard,575,druid,balance,12,6,6
sargeras,575,druid,balance,12,6,6
echo-isles,575,druid,balance,12,6,6
ragnaros,575,druid,balance,12,6,6
illidan,575,druid,balance,12,6,6
tichondrius,575,druid,balance,12,6,6
illidan,575,druid,balance,18,6,12
stormrage,575,druid,balance,18,6,12
arygos,575,druid,balance,18,6,12
drakkari,573,druid,balance,6,6,0
cenarius,572,druid,balance,12,6,6
anetheron,543,druid,balance,11,6,5
tichondrius,527,druid,balance,11,6,5
wyrmrest-accord,511,druid,balance,8,6,2
stormrage,511,druid,balance,11,6,5
tichondrius,511,druid,balance,20,6,14
laughing-skull,509,druid,balance,14,6,8
illidan,480,druid,balance,6,5,1
illidan,480,druid,balance,6,5,1
illidan,480,druid,balance,6,5,1
spinebreaker,480,druid,balance,6,5,1
kelthuzad,480,druid,balance,6,5,1
tichondrius,480,druid,balance,6,5,1
ragnaros,480,druid,balance,6,5,1
nerzhul,480,druid,balance,6,5,1
tichondrius,480,druid,balance,6,5,1
destromath,480,druid,balance,6,5,1
thunderlord,480,druid,balance,6,5,1
tichondrius,480,druid,balance,6,5,1
azralon,480,druid,balance,6,5,1
stormrage,480,druid,balance,6,5,1
stormrage,480,druid,balance,6,5,1
tichondrius,480,druid,balance,6,5,1
frostwolf,480,druid,balance,6,5,1
bleeding-hollow,480,druid,balance,6,5,1
tichondrius,480,druid,balance,6,5,1
azralon,480,druid,balance,6,5,1
tichondrius,480,druid,balance,6,5,1
thunderlord,480,druid,balance,6,5,1
bonechewer,480,druid,balance,6,5,1
sargeras,480,druid,balance,6,5,1
tichondrius,480,druid,balance,6,5,1
tichondrius,480,druid,balance,6,5,1
emerald-dream,480,druid,balance,6,5,1
bloodscalp,480,druid,balance,6,5,1
azralon,480,druid,balance,9,6,3
sargeras,480,druid,balance,12,5,7
ragnaros,480,druid,balance,12,5,7
bleeding-hollow,480,druid,balance,12,5,7
moon-guard,480,druid,balance,12,5,7
sargeras,480,druid,balance,12,5,7
gurubashi,480,druid,balance,12,5,7
gnomeregan,480,druid,balance,12,5,7
sargeras,480,druid,balance,12,5,7
tichondrius,480,druid,balance,12,5,7
illidan,480,druid,balance,12,5,7
illidan,480,druid,balance,12,5,7
sargeras,480,druid,balance,12,5,7
proudmoore,480,druid,balance,12,5,7
trollbane,480,druid,balance,12,5,7
tichondrius,480,druid,balance,12,5,7
stormrage,480,druid,balance,12,5,7
tichondrius,480,druid,balance,12,5,7
emerald-dream,480,druid,balance,12,5,7
tichondrius,480,druid,balance,12,5,7
illidan,480,druid,balance,18,5,13
barthilas,480,druid,balance,18,5,13
proudmoore,479,druid,balance,12,5,7
anubarak,479,druid,balance,12,5,7
malganis,479,druid,balance,12,5,7
frostmourne,479,druid,balance,12,5,7
jubeithos,479,druid,balance,18,5,13
hyjal,447,druid,balance,14,6,8
exodar,416,druid,balance,16,5,11
bleeding-hollow,414,druid,balance,8,5,3
elune,384,druid,balance,6,4,2
llane,384,druid,balance,6,4,2
bleeding-hollow,384,druid,balance,6,4,2
ragnaros,384,druid,balance,6,4,2
tichondrius,384,druid,balance,6,4,2
ysera,384,druid,balance,6,4,2
bleeding-hollow,384,druid,balance,6,4,2
tichondrius,384,druid,balance,6,4,2
ragnaros,384,druid,balance,6,4,2
zuljin,384,druid,balance,6,4,2
maelstrom,384,druid,balance,6,4,2
tichondrius,384,druid,balance,6,4,2
area-52,384,druid,balance,6,4,2
sargeras,384,druid,balance,6,4,2
tichondrius,384,druid,balance,6,4,2
area-52,384,druid,balance,6,4,2
dalaran,384,druid,balance,6,4,2
frostwolf,384,druid,balance,6,4,2
frostmourne,384,druid,balance,6,4,2
spirestone,384,druid,balance,6,4,2
tichondrius,384,druid,balance,6,4,2
moon-guard,384,druid,balance,6,4,2
kirin-tor,384,druid,balance,6,4,2
frostmourne,384,druid,balance,6,4,2
frostmourne,384,druid,balance,6,4,2
frostmourne,384,druid,balance,6,4,2
stormrage,384,druid,balance,6,4,2
stormreaver,384,druid,balance,6,4,2
thrall,384,druid,balance,6,4,2
tichondrius,384,druid,balance,6,4,2
ursin,384,druid,balance,6,4,2
lightbringer,384,druid,balance,6,4,2
barthilas,384,druid,balance,6,4,2
stormrage,384,druid,balance,6,4,2
sargeras,384,druid,balance,6,4,2
stormrage,384,druid,balance,6,4,2
darkspear,384,druid,balance,6,4,2
sargeras,384,druid,balance,6,4,2
illidan,384,druid,balance,6,4,2
azralon,384,druid,balance,6,4,2
baelgun,384,druid,balance,6,4,2
dalaran,384,druid,balance,6,4,2
area-52,384,druid,balance,6,4,2
tichondrius,384,druid,balance,6,4,2
kelthuzad,384,druid,balance,6,4,2
tichondrius,384,druid,balance,6,4,2
area-52,384,druid,balance,6,4,2
tichondrius,384,druid,balance,6,4,2
sargeras,384,druid,balance,6,4,2
malganis,384,druid,balance,6,4,2
illidan,384,druid,balance,6,4,2
stormrage,384,druid,balance,9,5,4
thrall,384,druid,balance,10,5,5
tichondrius,384,druid,balance,12,4,8
stormrage,384,druid,balance,12,4,8
illidan,384,druid,balance,12,4,8
sargeras,384,druid,balance,12,4,8
tichondrius,384,druid,balance,12,4,8
malganis,384,druid,balance,12,4,8
sargeras,384,druid,balance,12,4,8
proudmoore,384,druid,balance,12,4,8
arthas,384,druid,balance,12,4,8
runetotem,384,druid,balance,12,4,8
sargeras,384,druid,balance,12,4,8
area-52,384,druid,balance,12,4,8
jaedenar,384,druid,balance,12,4,8
lightbringer,384,druid,balance,12,4,8
stormrage,384,druid,balance,12,4,8
area-52,384,druid,balance,12,4,8
area-52,384,druid,balance,12,4,8
tichondrius,384,druid,balance,12,4,8
stormrage,384,druid,balance,12,4,8
area-52,384,druid,balance,12,4,8
warsong,384,druid,balance,18,4,14
frostwolf,383,druid,balance,6,4,2
kiljaeden,383,druid,balance,6,4,2
moon-guard,383,druid,balance,6,4,2
laughing-skull,383,druid,balance,12,4,8
ysera,382,druid,balance,12,4,8
area-52,360,druid,balance,16,7,9
tichondrius,330,druid,balance,9,6,3
sargeras,330,druid,balance,11,6,5
tichondrius,288,druid,balance,6,3,3
tichondrius,288,druid,balance,6,3,3
lothar,288,druid,balance,6,3,3
frostmourne,288,druid,balance,6,3,3
frostmourne,288,druid,balance,6,3,3
dalaran,288,druid,balance,6,3,3
emerald-dream,288,druid,balance,6,3,3
dalaran,288,druid,balance,6,3,3
tichondrius,288,druid,balance,6,3,3
burning-legion,288,druid,balance,6,3,3
tichondrius,288,druid,balance,6,3,3
frostmourne,288,druid,balance,6,3,3
frostmourne,288,druid,balance,6,3,3
thunderlord,288,druid,balance,6,3,3
emerald-dream,288,druid,balance,6,3,3
blackrock,288,druid,balance,6,3,3
thrall,288,druid,balance,6,3,3
bleeding-hollow,288,druid,balance,6,3,3
moon-guard,288,druid,balance,6,3,3
malganis,288,druid,balance,6,3,3
tichondrius,288,druid,balance,6,3,3
proudmoore,288,druid,balance,6,3,3
tichondrius,288,druid,balance,6,3,3
shattered-hand,288,druid,balance,6,3,3
thrall,288,druid,balance,6,3,3
tichondrius,288,druid,balance,6,3,3
frostmourne,288,druid,balance,6,3,3
tichondrius,288,druid,balance,6,3,3
bronzebeard,288,druid,balance,6,3,3
stormrage,288,druid,balance,6,3,3
illidan,288,druid,balance,6,3,3
tichondrius,288,druid,balance,6,3,3
malganis,288,druid,balance,6,3,3
area-52,288,druid,balance,6,3,3
wyrmrest-accord,288,druid,balance,6,3,3
area-52,288,druid,balance,6,3,3
bleeding-hollow,288,druid,balance,6,3,3
tichondrius,288,druid,balance,6,3,3
sargeras,288,druid,balance,6,3,3
boulderfist,288,druid,balance,6,3,3
area-52,288,druid,balance,6,3,3
illidan,288,druid,balance,6,3,3
crushridge,288,druid,balance,6,3,3
sargeras,288,druid,balance,6,3,3
ragnaros,288,druid,balance,6,3,3
illidan,288,druid,balance,6,3,3
magtheridon,288,druid,balance,6,3,3
hyjal,288,druid,balance,6,3,3
tichondrius,288,druid,balance,6,3,3
kiljaeden,288,druid,balance,6,3,3
illidan,288,druid,balance,8,3,5
emerald-dream,288,druid,balance,8,3,5
moon-guard,288,druid,balance,12,3,9
tichondrius,288,druid,balance,12,3,9
stormrage,288,druid,balance,12,3,9
sargeras,288,druid,balance,12,3,9
wyrmrest-accord,288,druid,balance,12,3,9
arthas,288,druid,balance,12,3,9
tichondrius,288,druid,balance,12,3,9
frostmourne,288,druid,balance,12,3,9
tol-barad,288,druid,balance,12,3,9
vashj,288,druid,balance,12,3,9
nemesis,288,druid,balance,19,3,16
quelthalas,286,druid,balance,6,3,3
destromath,286,druid,balance,6,3,3
sargeras,255,druid,balance,11,3,8
stormrage,239,druid,balance,5,3,2
tichondrius,239,druid,balance,5,3,2
jubeithos,223,druid,balance,14,3,11
tichondrius,208,druid,balance,7,3,4
frostmourne,208,druid,balance,7,3,4
tichondrius,192,druid,balance,6,2,4
bleeding-hollow,192,druid,balance,6,2,4
ragnaros,192,druid,balance,6,2,4
bleeding-hollow,192,druid,balance,6,2,4
stormrage,192,druid,balance,6,2,4
tichondrius,192,druid,balance,6,2,4
illidan,192,druid,balance,6,2,4
bonechewer,192,druid,balance,6,2,4
sargeras,192,druid,balance,6,2,4
tichondrius,192,druid,balance,6,2,4
stormrage,192,druid,balance,6,2,4
hyjal,192,druid,balance,6,2,4
malganis,192,druid,balance,6,2,4
illidan,192,druid,balance,6,2,4
uther,192,druid,balance,6,2,4
stormrage,192,druid,balance,6,2,4
sargeras,192,druid,balance,6,2,4
stormrage,192,druid,balance,6,2,4
kiljaeden,192,druid,balance,6,2,4
barthilas,192,druid,balance,6,2,4
nemesis,192,druid,balance,6,2,4
echo-isles,192,druid,balance,6,2,4
dalaran,192,druid,balance,6,2,4
barthilas,192,druid,balance,6,2,4
azralon,192,druid,balance,6,2,4
aerie-peak,192,druid,balance,6,2,4
kelthuzad,192,druid,balance,6,2,4
tichondrius,192,druid,balance,6,2,4
kelthuzad,192,druid,balance,6,2,4
tichondrius,192,druid,balance,6,2,4
laughing-skull,192,druid,balance,6,2,4
area-52,192,druid,balance,6,2,4
fizzcrank,192,druid,balance,6,2,4
azralon,192,druid,balance,6,2,4
quelthalas,192,druid,balance,6,2,4
malganis,192,druid,balance,6,2,4
quelthalas,192,druid,balance,6,2,4
kelthuzad,192,druid,balance,6,2,4
quelthalas,192,druid,balance,6,2,4
tichondrius,192,druid,balance,6,2,4
malfurion,192,druid,balance,6,2,4
sargeras,192,druid,balance,6,2,4
nemesis,192,druid,balance,6,2,4
icecrown,192,druid,balance,6,2,4
tichondrius,192,druid,balance,6,2,4
lothar,192,druid,balance,6,2,4
zuljin,192,druid,balance,6,2,4
tichondrius,192,druid,balance,6,2,4
barthilas,192,druid,balance,6,2,4
tichondrius,192,druid,balance,6,2,4
lightnings-blade,192,druid,balance,6,2,4
tichondrius,192,druid,balance,6,2,4
tichondrius,192,druid,balance,6,2,4
moon-guard,192,druid,balance,6,2,4
stormrage,192,druid,balance,6,2,4
frostmourne,192,druid,balance,6,2,4
tichondrius,192,druid,balance,6,2,4
ragnaros,192,druid,balance,6,2,4
thrall,192,druid,balance,6,2,4
tichondrius,192,druid,balance,6,2,4
moon-guard,192,druid,balance,6,2,4
moon-guard,192,druid,balance,6,2,4
illidan,192,druid,balance,12,2,10
azralon,192,druid,balance,12,2,10
emerald-dream,191,druid,balance,12,2,10
kalecgos,159,druid,balance,5,2,3
lightbringer,159,druid,balance,5,2,3
malganis,159,druid,balance,5,2,3
sargeras,96,druid,balance,3,2,1
frostmourne,96,druid,balance,3,2,1
bleeding-hollow,96,druid,balance,3,2,1
stormrage,96,druid,balance,6,1,5
proudmoore,96,druid,balance,6,1,5
malganis,96,druid,balance,6,1,5
turalyon,96,druid,balance,6,1,5
whisperwind,96,druid,balance,6,1,5
steamwheedle-cartel,96,druid,balance,6,1,5
emerald-dream,96,druid,balance,6,1,5
barthilas,96,druid,balance,6,1,5
stormrage,96,druid,balance,6,1,5
area-52,96,druid,balance,6,1,5
thrall,96,druid,balance,6,1,5
fizzcrank,96,druid,balance,6,1,5
bonechewer,96,druid,balance,6,1,5
illidan,96,druid,balance,6,1,5
ragnaros,96,druid,balance,6,1,5
frostmourne,96,druid,balance,6,1,5
emerald-dream,96,druid,balance,6,1,5
nordrassil,96,druid,balance,6,1,5
tichondrius,96,druid,balance,6,1,5
stormrage,96,druid,balance,6,1,5
emerald-dream,96,druid,balance,6,1,5
khadgar,96,druid,balance,6,1,5
emerald-dream,96,druid,balance,6,1,5
proudmoore,96,druid,balance,6,1,5
illidan,96,druid,balance,6,1,5
bleeding-hollow,96,druid,balance,6,1,5
stormrage,96,druid,balance,6,1,5
aegwynn,96,druid,balance,6,1,5
elune,96,druid,balance,6,1,5
akama,96,druid,balance,6,1,5
arthas,79,druid,balance,5,2,3
spirestone,79,druid,balance,5,1,4
kelthuzad,79,druid,balance,5,1,4
nemesis,79,druid,balance,5,1,4
illidan,79,druid,balance,5,1,4
darkspear,63,druid,balance,2,2,0
illidan,63,druid,balance,2,2,0
area-52,48,druid,balance,3,1,2
skullcrusher,42,druid,balance,8,2,6
darkspear,31,druid,balance,2,1,1
stormrage,31,druid,balance,2,1,1
stormrage,2180,evoker,preservation,78,42,36
whisperwind,2080,evoker,preservation,149,75,74
scilla,2041,evoker,preservation,120,55,65
tichondrius,2022,evoker,preservation,90,48,42
malganis,1992,evoker,preservation,132,60,72
thrall,1991,evoker,preservation,78,38,40
stormrage,1950,evoker,preservation,251,131,120
emerald-dream,1933,evoker,preservation,54,26,28
tichondrius,1917,evoker,preservation,57,27,30
dunemaul,1899,evoker,preservation,51,32,19
moonrunner,1897,evoker,preservation,48,26,22
area-52,1867,evoker,preservation,48,25,23
zuljin,1839,evoker,preservation,72,38,34
area-52,1834,evoker,preservation,60,29,31
ragnaros,1833,evoker,preservation,70,35,35
sargeras,1833,evoker,preservation,69,28,41
moon-guard,1827,evoker,preservation,101,58,43
thunderhorn,1821,evoker,preservation,66,43,23
illidan,1818,evoker,preservation,130,70,60
tichondrius,1816,evoker,preservation,54,28,26
tichondrius,1810,evoker,preservation,54,28,26
ragnaros,1807,evoker,preservation,66,31,35
malganis,1806,evoker,preservation,66,30,36
stormrage,1805,evoker,preservation,60,32,28
proudmoore,1801,evoker,preservation,48,22,26
ragnaros,1800,evoker,preservation,70,33,37
sargeras,1768,evoker,preservation,93,49,44
illidan,1765,evoker,preservation,54,28,26
tichondrius,1762,evoker,preservation,78,42,36
black-dragonflight,1754,evoker,preservation,285,143,142
hellscream,1750,evoker,preservation,78,40,38
tichondrius,1747,evoker,preservation,72,31,41
area-52,1745,evoker,preservation,60,37,23
firetree,1740,evoker,preservation,193,103,90
illidan,1740,evoker,preservation,38,19,19
area-52,1735,evoker,preservation,50,29,21
silvermoon,1734,evoker,preservation,132,63,69
stormrage,1734,evoker,preservation,61,25,36
tichondrius,1715,evoker,preservation,30,18,12
stormrage,1714,evoker,preservation,124,52,72
tichondrius,1687,evoker,preservation,30,18,12
tichondrius,1684,evoker,preservation,161,73,88
tichondrius,1670,evoker,preservation,84,35,49
stormscale,1665,evoker,preservation,77,42,35
illidan,1664,evoker,preservation,60,25,35
barthilas,1649,evoker,preservation,62,31,31
mugthol,1634,evoker,preservation,67,37,30
bleeding-hollow,1633,evoker,preservation,53,30,23
malganis,1629,evoker,preservation,66,33,33
bleeding-hollow,1627,evoker,preservation,48,22,26
tichondrius,1625,evoker,preservation,24,17,7
jubeithos,1621,evoker,preservation,48,23,25
moon-guard,1621,evoker,preservation,54,22,32
turalyon,1612,evoker,preservation,69,36,33
tichondrius,1610,evoker,preservation,97,51,46
bleeding-hollow,1603,evoker,preservation,70,32,38
lightbringer,1600,evoker,preservation,24,17,7
wyrmrest-accord,1600,evoker,preservation,52,20,32
quelthalas,1598,evoker,preservation,79,43,36
malganis,1574,evoker,preservation,51,25,26
bleeding-hollow,1572,evoker,preservation,172,72,100
stormrage,1562,evoker,preservation,86,40,46
emerald-dream,1539,evoker,preservation,36,18,18
magtheridon,1536,evoker,preservation,48,29,19
bleeding-hollow,1533,evoker,preservation,24,16,8
haomarush,1529,evoker,preservation,24,16,8
bleeding-hollow,1524,evoker,preservation,92,53,39
magtheridon,1516,evoker,preservation,116,63,53
kelthuzad,1508,evoker,preservation,50,26,24
tichondrius,1508,evoker,preservation,42,20,22
illidan,1504,evoker,preservation,61,39,22
fizzcrank,1502,evoker,preservation,48,23,25
moon-guard,1499,evoker,preservation,87,37,50
tichondrius,1486,evoker,preservation,84,44,40
sisters-of-elune,1486,evoker,preservation,94,49,45
malganis,1483,evoker,preservation,106,52,54
illidan,1477,evoker,preservation,48,30,18
wyrmrest-accord,1470,evoker,preservation,142,77,65
dalvengyr,1468,evoker,preservation,41,17,24
bleeding-hollow,1466,evoker,preservation,36,20,16
azralon,1463,evoker,preservation,41,19,22
proudmoore,1454,evoker,preservation,68,30,38
ragnaros,1447,evoker,preservation,108,57,51
zuluhed,1445,evoker,preservation,30,16,14
illidan,1443,evoker,preservation,48,28,20
gnomeregan,1441,evoker,preservation,48,28,20
frostmane,1441,evoker,preservation,96,41,55
malganis,1438,evoker,preservation,249,111,138
kiljaeden,1437,evoker,preservation,48,28,20
frostmourne,1431,evoker,preservation,62,25,37
malganis,1429,evoker,preservation,22,17,5
tichondrius,1429,evoker,preservation,30,15,15
tichondrius,1428,evoker,preservation,30,15,15
malganis,1426,evoker,preservation,48,27,21
kiljaeden,1425,evoker,preservation,53,29,24
area-52,1416,evoker,preservation,59,32,27
auchindoun,1416,evoker,preservation,36,15,21
moon-guard,1411,evoker,preservation,41,20,21
illidan,1406,evoker,preservation,36,15,21
tichondrius,1406,evoker,preservation,90,28,62
sargeras,1405,evoker,preservation,54,32,22
blackhand,1399,evoker,preservation,58,35,23
tichondrius,1398,evoker,preservation,58,27,31
stormrage,1396,evoker,preservation,46,23,23
illidan,1389,evoker,preservation,45,23,22
tichondrius,1389,evoker,preservation,59,24,35
frostmourne,1383,evoker,preservation,48,32,16
kiljaeden,1374,evoker,preservation,50,28,22
dalaran,1373,evoker,preservation,29,15,14
shuhalo,1368,evoker,preservation,33,18,15
ragnaros,1362,evoker,preservation,105,49,56
bleeding-hollow,1357,evoker,preservation,43,16,27
lightbringer,1356,evoker,preservation,54,29,25
tichondrius,1350,evoker,preservation,42,23,19
illidan,1345,evoker,preservation,108,60,48
barthilas,1334,evoker,preservation,30,14,16
malganis,1328,evoker,preservation,23,16,7
proudmoore,1328,evoker,preservation,140,68,72
kelthuzad,1327,evoker,preservation,35,23,12
proudmoore,1315,evoker,preservation,57,26,31
dawnbringer,1313,evoker,preservation,30,17,13
bladefist,1308,evoker,preservation,36,14,22
executus,1304,evoker,preservation,36,18,18
area-52,1294,evoker,preservation,42,15,27
azralon,1289,evoker,preservation,30,14,16
moon-guard,1286,evoker,preservation,29,14,15
korgath,1285,evoker,preservation,62,29,33
darkspear,1282,evoker,preservation,70,36,34
aegwynn,1281,evoker,preservation,39,24,15
blackhand,1272,evoker,preservation,53,28,25
wyrmrest-accord,1269,evoker,preservation,36,23,13
tichondrius,1258,evoker,preservation,107,60,47
illidan,1258,evoker,preservation,41,22,19
frostmourne,1258,evoker,preservation,84,37,47
emerald-dream,1255,evoker,preservation,159,75,84
stormreaver,1255,evoker,preservation,58,23,35
nemesis,1253,evoker,preservation,84,35,49
area-52,1252,evoker,preservation,47,25,22
area-52,1251,evoker,preservation,29,14,15
khaz-modan,1251,evoker,preservation,84,31,53
tichondrius,1248,evoker,preservation,63,35,28
tichondrius,1247,evoker,preservation,30,13,17
moon-guard,1245,evoker,preservation,31,13,18
kiljaeden,1238,evoker,preservation,24,13,11
frostmane,1236,evoker,preservation,30,13,17
stormscale,1235,evoker,preservation,30,13,17
moon-guard,1231,evoker,preservation,61,38,23
tichondrius,1228,evoker,preservation,55,33,22
stormscale,1228,evoker,preservation,36,15,21
area-52,1228,evoker,preservation,46,14,32
daggerspine,1227,evoker,preservation,112,52,60
tichondrius,1219,evoker,preservation,41,13,28
jubeithos,1213,evoker,preservation,18,13,5
durotan,1212,evoker,preservation,48,26,22
stormreaver,1211,evoker,preservation,36,19,17
azralon,1210,evoker,preservation,36,18,18
tichondrius,1206,evoker,preservation,30,15,15
kelthuzad,1205,evoker,preservation,75,34,41
kargath,1204,evoker,preservation,39,16,23
tichondrius,1202,evoker,preservation,30,13,17
thrall,1199,evoker,preservation,72,35,37
sargeras,1193,evoker,preservation,54,22,32
tichondrius,1189,evoker,preservation,48,15,33
moon-guard,1188,evoker,preservation,53,23,30
illidan,1181,evoker,preservation,25,14,11
illidan,1178,evoker,preservation,35,18,17
ghostlands,1171,evoker,preservation,36,17,19
wyrmrest-accord,1171,evoker,preservation,48,17,31
illidan,1166,evoker,preservation,24,13,11
trollbane,1165,evoker,preservation,29,15,14
sargeras,1155,evoker,preservation,24,13,11
elune,1152,evoker,preservation,18,12,6
executus,1152,evoker,preservation,30,12,18
stormrage,1151,evoker,preservation,18,12,6
area-52,1150,evoker,preservation,24,12,12
ragnaros,1150,evoker,preservation,24,12,12
magtheridon,1143,evoker,preservation,48,18,30
stormrage,1142,evoker,preservation,30,12,18
barthilas,1137,evoker,preservation,23,13,10
azshara,1136,evoker,preservation,48,23,25
akama,1133,evoker,preservation,45,17,28
zuljin,1131,evoker,preservation,18,14,4
bleeding-hollow,1131,evoker,preservation,24,12,12
tichondrius,1122,evoker,preservation,24,13,11
stormreaver,1120,evoker,preservation,68,38,30
tichondrius,1119,evoker,preservation,24,12,12
tichondrius,1118,evoker,preservation,28,13,15
stormrage,1114,evoker,preservation,44,17,27
illidan,1110,evoker,preservation,46,24,22
tichondrius,1105,evoker,preservation,51,26,25
spinebreaker,1100,evoker,preservation,15,13,2
malganis,1097,evoker,preservation,81,39,42
cenarion-circle,1096,evoker,preservation,80,47,33
zuljin,1083,evoker,preservation,24,13,11
tichondrius,1082,evoker,preservation,43,24,19
kelthuzad,1075,evoker,preservation,30,20,10
zuljin,1066,evoker,preservation,30,14,16
ragnaros,1059,evoker,preservation,29,13,16
lightbringer,1055,evoker,preservation,18,11,7
tichondrius,1052,evoker,preservation,18,11,7
sargeras,1051,evoker,preservation,24,11,13
sargeras,1048,evoker,preservation,24,11,13
bloodhoof,1043,evoker,preservation,24,11,13
blood-furnace,1039,evoker,preservation,24,11,13
zuljin,1038,evoker,preservation,41,23,18
sargeras,1037,evoker,preservation,18,11,7
tichondrius,1035,evoker,preservation,34,12,22
illidan,1034,evoker,preservation,18,13,5
gallywix,1032,evoker,preservation,36,24,12
moon-guard,1026,evoker,preservation,39,12,27
boulderfist,1025,evoker,preservation,28,12,16
terokkar,1022,evoker,preservation,53,25,28
area-52,1017,evoker,preservation,23,11,12
kelthuzad,1015,evoker,preservation,16,12,4
area-52,1001,evoker,preservation,49,26,23
ghostlands,1000,evoker,preservation,32,14,18
illidan,998,evoker,preservation,50,21,29
altar-of-storms,998,evoker,preservation,36,11,25
kelthuzad,995,evoker,preservation,23,13,10
vashj,989,evoker,preservation,27,13,14
sargeras,987,evoker,preservation,81,38,43
tichondrius,978,evoker,preservation,30,17,13
sargeras,971,evoker,preservation,135,50,85
illidan,960,evoker,preservation,18,10,8
frostmourne,960,evoker,preservation,24,10,14
tichondrius,960,evoker,preservation,24,10,14
warsong,959,evoker,preservation,12,10,2
sargeras,959,evoker,preservation,12,10,2
lightnings-blade,958,evoker,preservation,18,10,8
proudmoore,957,evoker,preservation,18,10,8
illidan,957,evoker,preservation,18,10,8
hyjal,955,evoker,preservation,18,10,8
moon-guard,955,evoker,preservation,24,10,14
barthilas,954,evoker,preservation,18,10,8
skullcrusher,953,evoker,preservation,18,10,8
stormrage,949,evoker,preservation,18,10,8
bonechewer,949,evoker,preservation,36,11,25
illidan,942,evoker,preservation,18,10,8
sargeras,941,evoker,preservation,18,10,8
tichondrius,935,evoker,preservation,134,63,71
illidan,928,evoker,preservation,24,11,13
lothar,926,evoker,preservation,26,11,15
spirestone,923,evoker,preservation,18,10,8
sargeras,911,evoker,preservation,17,10,7
nazjatar,904,evoker,preservation,30,16,14
area-52,902,evoker,preservation,71,26,45
illidan,902,evoker,preservation,30,10,20
ragnaros,893,evoker,preservation,17,10,7
tichondrius,893,evoker,preservation,20,10,10
ragnaros,879,evoker,preservation,41,21,20
illidan,867,evoker,preservation,50,23,27
illidan,864,evoker,preservation,12,9,3
whisperwind,863,evoker,preservation,18,9,9
stormrage,863,evoker,preservation,18,9,9
moon-guard,863,evoker,preservation,18,9,9
dalaran,863,evoker,preservation,18,9,9
kelthuzad,863,evoker,preservation,24,9,15
khazgoroth,862,evoker,preservation,12,9,3
tichondrius,862,evoker,preservation,24,9,15
azralon,861,evoker,preservation,16,10,6
malganis,861,evoker,preservation,18,9,9
quelthalas,861,evoker,preservation,42,18,24
tichondrius,861,evoker,preservation,24,9,15
emerald-dream,860,evoker,preservation,30,9,21
tichondrius,857,evoker,preservation,18,9,9
kiljaeden,850,evoker,preservation,55,19,36
tichondrius,843,evoker,preservation,18,9,9
icecrown,825,evoker,preservation,18,10,8
garrosh,824,evoker,preservation,40,9,31
barthilas,822,evoker,preservation,24,9,15
sargeras,799,evoker,preservation,17,9,8
wyrmrest-accord,798,evoker,preservation,20,9,11
stormrage,790,evoker,preservation,18,9,9
malganis,768,evoker,preservation,12,8,4
stormrage,768,evoker,preservation,12,8,4
frostmourne,768,evoker,preservation,18,8,10
tichondrius,768,evoker,preservation,18,8,10
malganis,767,evoker,preservation,12,8,4
azralon,767,evoker,preservation,18,8,10
bloodscalp,766,evoker,preservation,12,8,4
quelthalas,766,evoker,preservation,18,8,10
nerzhul,765,evoker,preservation,18,8,10
sargeras,764,evoker,preservation,12,8,4
kelthuzad,762,evoker,preservation,18,8,10
moon-guard,761,evoker,preservation,19,10,9
tichondrius,759,evoker,preservation,18,8,10
kelthuzad,758,evoker,preservation,18,8,10
anvilmar,751,evoker,preservation,20,9,11
burning-legion,748,evoker,preservation,18,8,10
daggerspine,736,evoker,preservation,28,9,19
illidan,735,evoker,preservation,22,8,14
area-52,731,evoker,preservation,17,8,9
black-dragonflight,729,evoker,preservation,14,9,5
tichondrius,714,evoker,preservation,28,9,19
chogall,708,evoker,preservation,17,8,9
arthas,700,evoker,preservation,20,8,12
illidan,685,evoker,preservation,11,8,3
mannoroth,672,evoker,preservation,12,7,5
area-52,672,evoker,preservation,12,7,5
tichondrius,672,evoker,preservation,12,7,5
bleeding-hollow,672,evoker,preservation,12,7,5
stormrage,672,evoker,preservation,12,7,5
area-52,672,evoker,preservation,12,7,5
tichondrius,672,evoker,preservation,12,7,5
tichondrius,672,evoker,preservation,13,7,6
malganis,672,evoker,preservation,18,7,11
illidan,672,evoker,preservation,18,7,11
zuljin,672,evoker,preservation,18,7,11
tichondrius,672,evoker,preservation,18,7,11
tichondrius,672,evoker,preservation,18,7,11
emerald-dream,672,evoker,preservation,18,7,11
emerald-dream,672,evoker,preservation,18,7,11
dalaran,671,evoker,preservation,12,7,5
illidan,671,evoker,preservation,12,7,5
area-52,671,evoker,preservation,12,7,5
tichondrius,671,evoker,preservation,18,7,11
dalaran,671,evoker,preservation,18,7,11
azralon,670,evoker,preservation,12,7,5
aerie-peak,670,evoker,preservation,19,9,10
malganis,670,evoker,preservation,30,7,23
sargeras,669,evoker,preservation,18,7,11
trollbane,669,evoker,preservation,18,7,11
ragnaros,667,evoker,preservation,12,7,5
proudmoore,666,evoker,preservation,18,7,11
tichondrius,661,evoker,preservation,18,7,11
proudmoore,660,evoker,preservation,18,7,11
doomhammer,659,evoker,preservation,12,7,5
emerald-dream,650,evoker,preservation,29,7,22
sargeras,640,evoker,preservation,17,7,10
moon-guard,638,evoker,preservation,23,7,16
blackrock,637,evoker,preservation,17,7,10
malganis,635,evoker,preservation,14,8,6
nerzhul,629,evoker,preservation,16,8,8
sargeras,623,evoker,preservation,12,8,4
area-52,620,evoker,preservation,11,7,4
barthilas,620,evoker,preservation,11,7,4
illidan,618,evoker,preservation,20,8,12
barthilas,618,evoker,preservation,26,8,18
moon-guard,617,evoker,preservation,11,7,4
moon-guard,617,evoker,preservation,16,8,8
moon-guard,604,evoker,preservation,36,7,29
tichondrius,584,evoker,preservation,19,7,12
dalaran,576,evoker,preservation,6,6,0
tichondrius,576,evoker,preservation,6,6,0
lightbringer,576,evoker,preservation,6,6,0
stormrage,576,evoker,preservation,12,6,6
stormrage,576,evoker,preservation,12,6,6
area-52,576,evoker,preservation,12,6,6
tichondrius,576,evoker,preservation,12,6,6
malganis,576,evoker,preservation,12,6,6
zuljin,576,evoker,preservation,12,6,6
zuljin,576,evoker,preservation,12,6,6
malganis,576,evoker,preservation,12,6,6
icecrown,576,evoker,preservation,12,6,6
rivendare,576,evoker,preservation,12,6,6
tichondrius,576,evoker,preservation,12,6,6
area-52,576,evoker,preservation,12,6,6
thrall,576,evoker,preservation,12,6,6
area-52,576,evoker,preservation,12,6,6
khadgar,576,evoker,preservation,12,6,6
drakkari,576,evoker,preservation,12,6,6
ragnaros,576,evoker,preservation,15,7,8
illidan,576,evoker,preservation,18,6,12
proudmoore,576,evoker,preservation,18,6,12
sargeras,576,evoker,preservation,18,6,12
dragonblight,576,evoker,preservation,18,6,12
stormrage,575,evoker,preservation,6,6,0
malganis,575,evoker,preservation,12,6,6
zuljin,575,evoker,preservation,12,6,6
tichondrius,575,evoker,preservation,12,6,6
stormrage,575,evoker,preservation,12,6,6
sargeras,575,evoker,preservation,18,6,12
bonechewer,575,evoker,preservation,18,6,12
garithos,574,evoker,preservation,6,6,0
area-52,574,evoker,preservation,12,6,6
frostwolf,574,evoker,preservation,12,6,6
moon-guard,574,evoker,preservation,18,6,12
illidan,568,evoker,preservation,12,6,6
sargeras,528,evoker,preservation,17,6,11
cenarius,521,evoker,preservation,15,7,8
drakkari,521,evoker,preservation,15,7,8
sargeras,521,evoker,preservation,20,7,13
tichondrius,511,evoker,preservation,14,6,8
stormrage,480,evoker,preservation,6,5,1
tichondrius,480,evoker,preservation,6,5,1
balnazzar,480,evoker,preservation,6,5,1
tichondrius,480,evoker,preservation,6,5,1
kelthuzad,480,evoker,preservation,6,5,1
kul-tiras,480,evoker,preservation,12,5,7
bleeding-hollow,480,evoker,preservation,12,5,7
tichondrius,480,evoker,preservation,12,5,7
stormrage,480,evoker,preservation,12,5,7
frostwolf,480,evoker,preservation,12,5,7
malganis,480,evoker,preservation,12,5,7
illidan,480,evoker,preservation,12,5,7
area-52,480,evoker,preservation,12,5,7
zuljin,480,evoker,preservation,12,5,7
frostmourne,480,evoker,preservation,12,5,7
mannoroth,480,evoker,preservation,12,5,7
tichondrius,480,evoker,preservation,15,5,10
sargeras,480,evoker,preservation,24,5,19
kirin-tor,479,evoker,preservation,6,5,1
malganis,479,evoker,preservation,6,5,1
illidan,479,evoker,preservation,6,5,1
jubeithos,479,evoker,preservation,12,5,7
dreadmaul,479,evoker,preservation,12,5,7
moon-guard,479,evoker,preservation,12,5,7
tichondrius,479,evoker,preservation,12,5,7
sargeras,479,evoker,preservation,12,5,7
icecrown,479,evoker,preservation,12,5,7
sargeras,478,evoker,preservation,12,5,7
akama,477,evoker,preservation,12,5,7
sargeras,475,evoker,preservation,12,5,7
illidan,426,evoker,preservation,28,6,22
frostmourne,416,evoker,preservation,10,5,5
emerald-dream,408,evoker,preservation,20,5,15
shattered-hand,399,evoker,preservation,5,5,0
illidan,384,evoker,preservation,6,4,2
frostmourne,384,evoker,preservation,6,4,2
stormrage,384,evoker,preservation,6,4,2
velen,384,evoker,preservation,6,4,2
bleeding-hollow,384,evoker,preservation,6,4,2
tichondrius,384,evoker,preservation,6,4,2
thorium-brotherhood,384,evoker,preservation,6,4,2
shadowsong,384,evoker,preservation,6,4,2
dalaran,384,evoker,preservation,6,4,2
tichondrius,384,evoker,preservation,6,4,2
korgath,384,evoker,preservation,6,4,2
hyjal,384,evoker,preservation,6,4,2
area-52,384,evoker,preservation,6,4,2
quelthalas,384,evoker,preservation,6,4,2
emerald-dream,384,evoker,preservation,6,4,2
frostmourne,384,evoker,preservation,6,4,2
arthas,384,evoker,preservation,6,4,2
tichondrius,384,evoker,preservation,6,4,2
shadow-council,384,evoker,preservation,6,4,2
malganis,384,evoker,preservation,6,4,2
illidan,384,evoker,preservation,6,4,2
stormrage,384,evoker,preservation,10,5,5
tichondrius,384,evoker,preservation,8,4,4
tichondrius,384,evoker,preservation,12,4,8
sargeras,384,evoker,preservation,12,4,8
illidan,384,evoker,preservation,12,4,8
firetree,384,evoker,preservation,12,4,8
wyrmrest-accord,384,evoker,preservation,12,4,8
wyrmrest-accord,384,evoker,preservation,12,4,8
ragnaros,384,evoker,preservation,12,4,8
sargeras,384,evoker,preservation,12,4,8
moon-guard,384,evoker,preservation,12,4,8
tichondrius,384,evoker,preservation,12,4,8
thrall,384,evoker,preservation,12,4,8
burning-legion,384,evoker,preservation,12,4,8
stormrage,384,evoker,preservation,12,4,8
dentarg,384,evoker,preservation,18,4,14
thrall,384,evoker,preservation,18,4,14
durotan,383,evoker,preservation,6,4,2
wyrmrest-accord,383,evoker,preservation,6,4,2
ragnaros,383,evoker,preservation,8,4,4
baelgun,383,evoker,preservation,12,4,8
tichondrius,382,evoker,preservation,6,4,2
illidan,382,evoker,preservation,12,4,8
moon-guard,380,evoker,preservation,12,4,8
moknathal,366,evoker,preservation,11,4,7
boulderfist,365,evoker,preservation,9,6,3
tichondrius,352,evoker,preservation,10,4,6
darkspear,351,evoker,preservation,11,4,7
thunderhorn,330,evoker,preservation,17,5,12
illidan,320,evoker,preservation,14,4,10
ysera,304,evoker,preservation,7,4,3
stormrage,288,evoker,preservation,6,3,3
illidan,288,evoker,preservation,6,3,3
nerzhul,288,evoker,preservation,6,3,3
moon-guard,288,evoker,preservation,6,3,3
tichondrius,288,evoker,preservation,6,3,3
malganis,288,evoker,preservation,6,3,3
antonidas,288,evoker,preservation,6,3,3
tichondrius,288,evoker,preservation,6,3,3
korgath,288,evoker,preservation,6,3,3
stormreaver,288,evoker,preservation,6,3,3
nemesis,288,evoker,preservation,6,3,3
sargeras,288,evoker,preservation,6,3,3
illidan,288,evoker,preservation,6,3,3
stormrage,288,evoker,preservation,6,3,3
caelestrasz,288,evoker,preservation,6,3,3
tichondrius,288,evoker,preservation,6,3,3
tichondrius,288,evoker,preservation,6,3,3
emerald-dream,288,evoker,preservation,6,3,3
tichondrius,288,evoker,preservation,6,3,3
frostmourne,288,evoker,preservation,6,3,3
tichondrius,288,evoker,preservation,6,3,3
zuljin,288,evoker,preservation,6,3,3
area-52,288,evoker,preservation,6,3,3
frostmourne,288,evoker,preservation,6,3,3
anvilmar,288,evoker,preservation,6,3,3
quelthalas,288,evoker,preservation,6,3,3
sargeras,288,evoker,preservation,6,3,3
sargeras,288,evoker,preservation,6,3,3
tichondrius,288,evoker,preservation,6,3,3
madoran,288,evoker,preservation,6,3,3
boulderfist,288,evoker,preservation,6,3,3
tichondrius,288,evoker,preservation,6,3,3
sargeras,288,evoker,preservation,6,3,3
tichondrius,288,evoker,preservation,6,3,3
proudmoore,288,evoker,preservation,12,3,9
malganis,288,evoker,preservation,12,3,9
malganis,288,evoker,preservation,12,3,9
tichondrius,288,evoker,preservation,12,3,9
suramar,288,evoker,preservation,12,3,9
area-52,288,evoker,preservation,12,3,9
stormscale,288,evoker,preservation,12,3,9
elune,288,evoker,preservation,12,3,9
tichondrius,288,evoker,preservation,13,3,10
blades-edge,288,evoker,preservation,18,3,15
area-52,287,evoker,preservation,6,3,3
silvermoon,287,evoker,preservation,6,3,3
burning-legion,287,evoker,preservation,6,3,3
bleeding-hollow,287,evoker,preservation,12,3,9
draka,287,evoker,preservation,18,3,15
tichondrius,255,evoker,preservation,11,3,8
illidan,234,evoker,preservation,15,4,11
kelthuzad,208,evoker,preservation,7,3,4
moon-guard,192,evoker,preservation,6,2,4
tichondrius,192,evoker,preservation,6,2,4
detheroc,192,evoker,preservation,6,2,4
tichondrius,192,evoker,preservation,6,2,4
lothar,192,evoker,preservation,6,2,4
sargeras,192,evoker,preservation,6,2,4
emerald-dream,192,evoker,preservation,6,2,4
zuljin,192,evoker,preservation,6,2,4
azralon,192,evoker,preservation,6,2,4
barthilas,192,evoker,preservation,6,2,4
tichondrius,192,evoker,preservation,6,2,4
malganis,192,evoker,preservation,6,2,4
illidan,192,evoker,preservation,6,2,4
bleeding-hollow,192,evoker,preservation,6,2,4
frostmourne,192,evoker,preservation,6,2,4
illidan,192,evoker,preservation,6,2,4
burning-blade,192,evoker,preservation,6,2,4
malganis,192,evoker,preservation,6,2,4
azralon,192,evoker,preservation,6,2,4
zuljin,192,evoker,preservation,6,2,4
proudmoore,192,evoker,preservation,6,2,4
area-52,192,evoker,preservation,6,2,4
frostmane,192,evoker,preservation,6,2,4
area-52,192,evoker,preservation,6,2,4
frostmourne,192,evoker,preservation,6,2,4
frostmourne,192,evoker,preservation,6,2,4
area-52,192,evoker,preservation,6,2,4
tichondrius,192,evoker,preservation,6,2,4
bonechewer,192,evoker,preservation,12,2,10
moon-guard,192,evoker,preservation,12,2,10
dalaran,192,evoker,preservation,12,2,10
thrall,192,evoker,preservation,12,2,10
tichondrius,192,evoker,preservation,12,2,10
aerie-peak,191,evoker,preservation,4,3,1
ragnaros,191,evoker,preservation,6,2,4
emerald-dream,191,evoker,preservation,6,2,4
thrall,191,evoker,preservation,6,2,4
mugthol,191,evoker,preservation,6,2,4
illidan,191,evoker,preservation,12,2,10
azjolnerub,138,evoker,preservation,8,3,5
stormrage,138,evoker,preservation,14,3,11
tichondrius,128,evoker,preservation,4,2,2
emerald-dream,96,evoker,preservation,6,1,5
thrall,96,evoker,preservation,6,1,5
zuljin,96,evoker,preservation,6,1,5
tichondrius,96,evoker,preservation,6,1,5
wyrmrest-accord,96,evoker,preservation,6,1,5
tichondrius,96,evoker,preservation,6,1,5
tichondrius,96,evoker,preservation,6,1,5
stormrage,96,evoker,preservation,6,1,5
frostmourne,96,evoker,preservation,6,1,5
tichondrius,96,evoker,preservation,6,1,5
frostmourne,96,evoker,preservation,6,1,5
chogall,96,evoker,preservation,6,1,5
spirestone,96,evoker,preservation,6,1,5
zuljin,96,evoker,preservation,6,1,5
barthilas,96,evoker,preservation,6,1,5
tichondrius,96,evoker,preservation,6,1,5
quelthalas,96,evoker,preservation,6,1,5
frostmourne,96,evoker,preservation,10,1,9
area-52,96,evoker,preservation,12,1,11
chogall,96,evoker,preservation,12,1,11
proudmoore,96,evoker,preservation,12,1,11
zuluhed,9,evoker,preservation,9,3,6
tichondrius,2119,evoker,devastation,84,47,37
proudmoore,2100,evoker,devastation,102,59,43
proudmoore,2073,evoker,devastation,125,65,60
tichondrius,1991,evoker,devastation,68,42,26
bleeding-hollow,1965,evoker,devastation,84,44,40
area-52,1964,evoker,devastation,72,39,33
illidan,1942,evoker,devastation,123,63,60
area-52,1941,evoker,devastation,52,30,22
emerald-dream,1940,evoker,devastation,194,94,100
area-52,1919,evoker,devastation,138,73,65
moon-guard,1917,evoker,devastation,78,39,39
stormrage,1904,evoker,devastation,114,66,48
illidan,1896,evoker,devastation,71,34,37
borean-tundra,1894,evoker,devastation,60,39,21
illidan,1890,evoker,devastation,96,61,35
staghelm,1886,evoker,devastation,48,25,23
illidan,1854,evoker,devastation,96,51,45
area-52,1854,evoker,devastation,131,68,63
emerald-dream,1850,evoker,devastation,46,25,21
zuljin,1827,evoker,devastation,42,27,15
dalaran,1826,evoker,devastation,42,30,12
sargeras,1826,evoker,devastation,36,22,14
mannoroth,1826,evoker,devastation,71,40,31
zuljin,1823,evoker,devastation,85,37,48
thrall,1820,evoker,devastation,102,63,39
tichondrius,1818,evoker,devastation,140,67,73
sargeras,1816,evoker,devastation,36,20,16
moon-guard,1809,evoker,devastation,122,82,40
twisting-nether,1808,evoker,devastation,91,49,42
alterac-mountains,1800,evoker,devastation,169,92,77
ragnaros,1782,evoker,devastation,257,135,122
sargeras,1776,evoker,devastation,96,50,46
thrall,1772,evoker,devastation,70,37,33
frostmourne,1769,evoker,devastation,48,29,19
shuhalo,1763,evoker,devastation,54,24,30
blackhand,1761,evoker,devastation,90,45,45
malganis,1744,evoker,devastation,66,40,26
arygos,1743,evoker,devastation,41,25,16
stormrage,1728,evoker,devastation,64,36,28
tichondrius,1720,evoker,devastation,48,27,21
wyrmrest-accord,1718,evoker,devastation,36,22,14
illidan,1711,evoker,devastation,108,48,60
tichondrius,1709,evoker,devastation,43,29,14
tichondrius,1697,evoker,devastation,114,56,58
stormrage,1696,evoker,devastation,36,22,14
gilneas,1691,evoker,devastation,74,45,29
tichondrius,1690,evoker,devastation,54,25,29
tichondrius,1685,evoker,devastation,40,24,16
area-52,1678,evoker,devastation,114,58,56
tichondrius,1674,evoker,devastation,64,28,36
malganis,1660,evoker,devastation,57,27,30
tichondrius,1655,evoker,devastation,59,28,31
illidan,1653,evoker,devastation,42,24,18
drakkari,1652,evoker,devastation,48,25,23
stormrage,1650,evoker,devastation,48,21,27
frostmourne,1644,evoker,devastation,29,18,11
zuljin,1643,evoker,devastation,48,23,25
tichondrius,1629,evoker,devastation,102,55,47
moon-guard,1629,evoker,devastation,96,49,47
barthilas,1618,evoker,devastation,30,20,10
tichondrius,1618,evoker,devastation,60,31,29
proudmoore,1615,evoker,devastation,102,57,45
ragnaros,1607,evoker,devastation,89,45,44
magtheridon,1606,evoker,devastation,99,55,44
shattered-hand,1594,evoker,devastation,126,66,60
stormrage,1593,evoker,devastation,69,33,36
thunderlord,1592,evoker,devastation,130,68,62
stormrage,1590,evoker,devastation,37,19,18
thrall,1589,evoker,devastation,35,20,15
azralon,1589,evoker,devastation,44,24,20
wyrmrest-accord,1589,evoker,devastation,135,73,62
lothar,1587,evoker,devastation,41,23,18
tichondrius,1575,evoker,devastation,52,32,20
ysera,1567,evoker,devastation,55,28,27
wyrmrest-accord,1566,evoker,devastation,56,33,23
drenden,1564,evoker,devastation,42,18,24
tichondrius,1558,evoker,devastation,36,20,16
firetree,1556,evoker,devastation,60,33,27
tichondrius,1554,evoker,devastation,83,41,42
sargeras,1549,evoker,devastation,36,19,17
area-52,1549,evoker,devastation,84,41,43
firetree,1543,evoker,devastation,44,23,21
tichondrius,1542,evoker,devastation,42,20,22
tichondrius,1523,evoker,devastation,75,40,35
tichondrius,1520,evoker,devastation,30,21,9
sargeras,1509,evoker,devastation,30,16,14
sargeras,1508,evoker,devastation,42,20,22
area-52,1507,evoker,devastation,30,16,14
tichondrius,1505,evoker,devastation,36,17,19
area-52,1504,evoker,devastation,176,89,87
kiljaeden,1498,evoker,devastation,30,16,14
tichondrius,1486,evoker,devastation,30,16,14
frostmourne,1485,evoker,devastation,36,21,15
icecrown,1478,evoker,devastation,54,30,24
gilneas,1478,evoker,devastation,35,16,19
moon-guard,1475,evoker,devastation,23,17,6
moon-guard,1475,evoker,devastation,36,19,17
tichondrius,1468,evoker,devastation,90,38,52
elune,1459,evoker,devastation,36,16,20
zuljin,1456,evoker,devastation,36,22,14
proudmoore,1450,evoker,devastation,48,22,26
stormrage,1449,evoker,devastation,59,35,24
area-52,1448,evoker,devastation,48,25,23
boulderfist,1446,evoker,devastation,42,21,21
emerald-dream,1446,evoker,devastation,36,16,20
korgath,1445,evoker,devastation,42,24,18
tichondrius,1439,evoker,devastation,24,15,9
tichondrius,1435,evoker,devastation,58,39,19
tichondrius,1431,evoker,devastation,42,23,19
illidan,1423,evoker,devastation,36,16,20
sargeras,1419,evoker,devastation,36,15,21
illidan,1418,evoker,devastation,64,26,38
tichondrius,1416,evoker,devastation,78,40,38
cenarius,1409,evoker,devastation,84,33,51
bleeding-hollow,1402,evoker,devastation,54,25,29
sargeras,1400,evoker,devastation,30,17,13
moon-guard,1396,evoker,devastation,53,27,26
kiljaeden,1396,evoker,devastation,51,25,26
azralon,1395,evoker,devastation,72,41,31
thrall,1394,evoker,devastation,37,22,15
tichondrius,1394,evoker,devastation,57,33,24
chogall,1390,evoker,devastation,26,16,10
tichondrius,1377,evoker,devastation,64,32,32
zuljin,1375,evoker,devastation,35,15,20
proudmoore,1366,evoker,devastation,78,33,45
malganis,1365,evoker,devastation,93,50,43
frostmourne,1365,evoker,devastation,32,15,17
tichondrius,1362,evoker,devastation,55,30,25
illidan,1360,evoker,devastation,82,42,40
moon-guard,1357,evoker,devastation,30,18,12
wyrmrest-accord,1352,evoker,devastation,54,27,27
bleeding-hollow,1350,evoker,devastation,36,22,14
emerald-dream,1342,evoker,devastation,34,26,8
wyrmrest-accord,1341,evoker,devastation,30,16,14
zuljin,1340,evoker,devastation,85,42,43
bleeding-hollow,1339,evoker,devastation,18,14,4
blackrock,1332,evoker,devastation,36,19,17
sargeras,1328,evoker,devastation,24,14,10
quelthalas,1328,evoker,devastation,106,56,50
area-52,1320,evoker,devastation,31,18,13
skywall,1319,evoker,devastation,24,14,10
bleeding-hollow,1310,evoker,devastation,24,14,10
illidan,1309,evoker,devastation,35,15,20
thrall,1296,evoker,devastation,60,33,27
stormrage,1296,evoker,devastation,48,21,27
ysera,1287,evoker,devastation,54,27,27
thrall,1277,evoker,devastation,70,35,35
blackrock,1263,evoker,devastation,23,14,9
tortheldrin,1261,evoker,devastation,48,23,25
tichondrius,1247,evoker,devastation,24,13,11
area-52,1246,evoker,devastation,34,21,13
area-52,1246,evoker,devastation,24,13,11
wyrmrest-accord,1244,evoker,devastation,27,14,13
mannoroth,1241,evoker,devastation,24,13,11
frostmourne,1240,evoker,devastation,30,13,17
agamaggan,1239,evoker,devastation,18,13,5
illidan,1239,evoker,devastation,54,22,32
dalaran,1235,evoker,devastation,24,13,11
proudmoore,1235,evoker,devastation,69,31,38
bleeding-hollow,1221,evoker,devastation,19,14,5
thrall,1204,evoker,devastation,29,13,16
stormrage,1201,evoker,devastation,24,14,10
arthas,1199,evoker,devastation,29,13,16
tichondrius,1178,evoker,devastation,29,16,13
drakkari,1178,evoker,devastation,64,30,34
malganis,1178,evoker,devastation,41,19,22
scarlet-crusade,1153,evoker,devastation,30,18,12
kelthuzad,1149,evoker,devastation,24,14,10
skullcrusher,1148,evoker,devastation,24,12,12
moon-guard,1147,evoker,devastation,24,12,12
argent-dawn,1147,evoker,devastation,24,12,12
vashj,1146,evoker,devastation,24,13,11
stormrage,1145,evoker,devastation,30,12,18
barthilas,1139,evoker,devastation,36,15,21
dalaran,1138,evoker,devastation,24,12,12
area-52,1133,evoker,devastation,24,12,12
sargeras,1114,evoker,devastation,30,15,15
azralon,1111,evoker,devastation,36,21,15
tichondrius,1107,evoker,devastation,64,25,39
tichondrius,1103,evoker,devastation,29,12,17
illidan,1099,evoker,devastation,28,13,15
tichondrius,1097,evoker,devastation,24,13,11
moon-guard,1087,evoker,devastation,28,12,16
malganis,1086,evoker,devastation,31,13,18
sargeras,1082,evoker,devastation,26,12,14
wyrmrest-accord,1076,evoker,devastation,27,12,15
illidan,1063,evoker,devastation,28,12,16
thunderlord,1058,evoker,devastation,24,13,11
caelestrasz,1056,evoker,devastation,15,12,3
tichondrius,1055,evoker,devastation,18,11,7
bloodscalp,1055,evoker,devastation,24,11,13
emerald-dream,1054,evoker,devastation,18,11,7
stormrage,1054,evoker,devastation,24,11,13
jubeithos,1048,evoker,devastation,18,11,7
sargeras,1046,evoker,devastation,18,11,7
azralon,1042,evoker,devastation,30,20,10
bleeding-hollow,1041,evoker,devastation,24,11,13
stormrage,1038,evoker,devastation,24,16,8
lethon,1019,evoker,devastation,24,12,12
tichondrius,1009,evoker,devastation,49,26,23
khazgoroth,1006,evoker,devastation,15,11,4
dalaran,960,evoker,devastation,18,10,8
moon-guard,960,evoker,devastation,18,10,8
skullcrusher,960,evoker,devastation,24,10,14
proudmoore,959,evoker,devastation,12,10,2
barthilas,959,evoker,devastation,18,10,8
stormreaver,959,evoker,devastation,18,10,8
area-52,959,evoker,devastation,18,10,8
kelthuzad,958,evoker,devastation,18,10,8
moon-guard,956,evoker,devastation,24,10,14
ragnaros,948,evoker,devastation,24,10,14
drakkari,924,evoker,devastation,14,11,3
silvermoon,909,evoker,devastation,24,10,14
black-dragonflight,902,evoker,devastation,38,19,19
aegwynn,864,evoker,devastation,12,9,3
sargeras,864,evoker,devastation,12,9,3
duskwood,864,evoker,devastation,12,9,3
hyjal,864,evoker,devastation,18,9,9
tichondrius,864,evoker,devastation,18,9,9
lightnings-blade,864,evoker,devastation,18,9,9
frostwolf,863,evoker,devastation,18,9,9
ragnaros,863,evoker,devastation,18,9,9
saurfang,863,evoker,devastation,18,9,9
tichondrius,861,evoker,devastation,18,9,9
arthas,861,evoker,devastation,18,9,9
skullcrusher,859,evoker,devastation,18,9,9
moon-guard,857,evoker,devastation,24,9,15
stormrage,857,evoker,devastation,60,17,43
stormrage,855,evoker,devastation,12,9,3
draenor,855,evoker,devastation,18,9,9
emerald-dream,849,evoker,devastation,26,10,16
area-52,846,evoker,devastation,17,9,8
moon-guard,843,evoker,devastation,20,9,11
dalaran,831,evoker,devastation,17,9,8
greymane,814,evoker,devastation,15,9,6
frostmourne,812,evoker,devastation,17,9,8
stormrage,811,evoker,devastation,15,9,6
frostmourne,768,evoker,devastation,12,8,4
wyrmrest-accord,768,evoker,devastation,12,8,4
thunderhorn,768,evoker,devastation,12,8,4
stormrage,768,evoker,devastation,18,8,10
area-52,768,evoker,devastation,21,9,12
malganis,767,evoker,devastation,12,8,4
drakkari,767,evoker,devastation,12,8,4
akama,767,evoker,devastation,18,8,10
moon-guard,767,evoker,devastation,18,8,10
frostmourne,767,evoker,devastation,18,8,10
area-52,766,evoker,devastation,18,8,10
illidan,766,evoker,devastation,18,8,10
azgalor,764,evoker,devastation,24,8,16
illidan,754,evoker,devastation,12,8,4
thrall,736,evoker,devastation,10,9,1
illidan,728,evoker,devastation,48,10,38
stormrage,699,evoker,devastation,17,8,9
ghostlands,693,evoker,devastation,14,8,6
wyrmrest-accord,672,evoker,devastation,12,7,5
smolderthorn,672,evoker,devastation,12,7,5
norgannon,672,evoker,devastation,12,7,5
illidan,672,evoker,devastation,12,7,5
area-52,672,evoker,devastation,12,7,5
tichondrius,672,evoker,devastation,12,7,5
tichondrius,672,evoker,devastation,16,8,8
proudmoore,672,evoker,devastation,18,7,11
altar-of-storms,672,evoker,devastation,18,7,11
proudmoore,672,evoker,devastation,18,7,11
illidan,672,evoker,devastation,24,7,17
tichondrius,671,evoker,devastation,12,7,5
rexxar,671,evoker,devastation,12,7,5
azralon,671,evoker,devastation,12,7,5
bleeding-hollow,671,evoker,devastation,12,7,5
illidan,671,evoker,devastation,12,7,5
illidan,671,evoker,devastation,12,7,5
ragnaros,671,evoker,devastation,12,7,5
ragnaros,671,evoker,devastation,12,7,5
gorefiend,671,evoker,devastation,18,7,11
emerald-dream,670,evoker,devastation,12,7,5
wyrmrest-accord,670,evoker,devastation,12,7,5
tichondrius,670,evoker,devastation,12,7,5
frostmourne,670,evoker,devastation,18,7,11
kiljaeden,670,evoker,devastation,18,7,11
blackrock,667,evoker,devastation,18,7,11
tichondrius,662,evoker,devastation,12,7,5
azralon,623,evoker,devastation,15,7,8
norgannon,607,evoker,devastation,16,7,9
altar-of-storms,591,evoker,devastation,13,7,6
elune,576,evoker,devastation,6,6,0
moon-guard,576,evoker,devastation,6,6,0
sargeras,576,evoker,devastation,6,6,0
thrall,576,evoker,devastation,6,6,0
emerald-dream,576,evoker,devastation,10,7,3
tichondrius,576,evoker,devastation,12,6,6
mugthol,576,evoker,devastation,12,6,6
moon-guard,576,evoker,devastation,12,6,6
wyrmrest-accord,576,evoker,devastation,12,6,6
thrall,576,evoker,devastation,12,6,6
quelthalas,576,evoker,devastation,12,6,6
blackrock,576,evoker,devastation,12,6,6
illidan,576,evoker,devastation,12,6,6
thunderlord,576,evoker,devastation,12,6,6
firetree,576,evoker,devastation,12,6,6
dentarg,576,evoker,devastation,12,6,6
daggerspine,576,evoker,devastation,12,6,6
zangarmarsh,576,evoker,devastation,18,6,12
stormrage,576,evoker,devastation,18,6,12
azuremyst,575,evoker,devastation,12,6,6
moon-guard,575,evoker,devastation,12,6,6
borean-tundra,575,evoker,devastation,12,6,6
illidan,575,evoker,devastation,12,6,6
burning-legion,575,evoker,devastation,12,6,6
thrall,575,evoker,devastation,13,6,7
caelestrasz,574,evoker,devastation,12,6,6
azralon,574,evoker,devastation,12,6,6
tichondrius,574,evoker,devastation,24,6,18
malganis,573,evoker,devastation,12,6,6
stormrage,573,evoker,devastation,12,6,6
wyrmrest-accord,572,evoker,devastation,12,6,6
thunderlord,556,evoker,devastation,30,6,24
sisters-of-elune,542,evoker,devastation,11,6,5
emerald-dream,527,evoker,devastation,11,6,5
area-52,522,evoker,devastation,16,8,8
kelthuzad,495,evoker,devastation,19,6,13
tichondrius,480,evoker,devastation,6,5,1
barthilas,480,evoker,devastation,6,5,1
tichondrius,480,evoker,devastation,6,5,1
korgath,480,evoker,devastation,6,5,1
zuljin,480,evoker,devastation,6,5,1
tichondrius,480,evoker,devastation,6,5,1
malganis,480,evoker,devastation,6,5,1
baelgun,480,evoker,devastation,12,5,7
illidan,480,evoker,devastation,12,5,7
sargeras,480,evoker,devastation,12,5,7
illidan,480,evoker,devastation,12,5,7
trollbane,480,evoker,devastation,12,5,7
frostmourne,480,evoker,devastation,12,5,7
moon-guard,480,evoker,devastation,12,5,7
stormrage,480,evoker,devastation,12,5,7
moon-guard,480,evoker,devastation,12,5,7
hyjal,480,evoker,devastation,12,5,7
saurfang,480,evoker,devastation,12,5,7
bloodhoof,480,evoker,devastation,12,5,7
illidan,480,evoker,devastation,12,5,7
malganis,480,evoker,devastation,12,5,7
sargeras,480,evoker,devastation,12,5,7
haomarush,480,evoker,devastation,12,5,7
greymane,480,evoker,devastation,12,5,7
executus,480,evoker,devastation,12,5,7
stonemaul,480,evoker,devastation,18,5,13
area-52,480,evoker,devastation,18,5,13
amanthul,479,evoker,devastation,6,5,1
ragnaros,479,evoker,devastation,6,5,1
azralon,479,evoker,devastation,12,5,7
frostmourne,479,evoker,devastation,12,5,7
zuljin,479,evoker,devastation,12,5,7
lothar,479,evoker,devastation,12,5,7
illidan,479,evoker,devastation,12,5,7
tichondrius,479,evoker,devastation,21,6,15
bonechewer,478,evoker,devastation,18,5,13
wyrmrest-accord,477,evoker,devastation,6,5,1
kaelthas,477,evoker,devastation,12,5,7
stormrage,474,evoker,devastation,12,5,7
proudmoore,473,evoker,devastation,14,5,9
tichondrius,426,evoker,devastation,17,7,10
stormrage,399,evoker,devastation,5,5,0
thunderlord,398,evoker,devastation,10,5,5
archimonde,384,evoker,devastation,6,4,2
winterhoof,384,evoker,devastation,6,4,2
tichondrius,384,evoker,devastation,6,4,2
illidan,384,evoker,devastation,6,4,2
tichondrius,384,evoker,devastation,6,4,2
moon-guard,384,evoker,devastation,6,4,2
tichondrius,384,evoker,devastation,6,4,2
frostmourne,384,evoker,devastation,6,4,2
area-52,384,evoker,devastation,6,4,2
ragnaros,384,evoker,devastation,6,4,2
wyrmrest-accord,384,evoker,devastation,6,4,2
suramar,384,evoker,devastation,6,4,2
tichondrius,384,evoker,devastation,6,4,2
kelthuzad,384,evoker,devastation,6,4,2
whisperwind,384,evoker,devastation,6,4,2
whisperwind,384,evoker,devastation,6,4,2
kelthuzad,384,evoker,devastation,6,4,2
tichondrius,384,evoker,devastation,6,4,2
zuljin,384,evoker,devastation,6,4,2
shadowmoon,384,evoker,devastation,6,4,2
zangarmarsh,384,evoker,devastation,6,4,2
thrall,384,evoker,devastation,6,4,2
malganis,384,evoker,devastation,6,4,2
wyrmrest-accord,384,evoker,devastation,6,4,2
quelthalas,384,evoker,devastation,6,4,2
dalaran,384,evoker,devastation,6,4,2
ragnaros,384,evoker,devastation,6,4,2
stonemaul,384,evoker,devastation,6,4,2
kelthuzad,384,evoker,devastation,6,4,2
stormrage,384,evoker,devastation,6,4,2
sargeras,384,evoker,devastation,12,4,8
zuljin,384,evoker,devastation,12,4,8
bleeding-hollow,384,evoker,devastation,12,4,8
nazjatar,384,evoker,devastation,12,4,8
stormrage,384,evoker,devastation,12,4,8
illidan,384,evoker,devastation,12,4,8
dalaran,384,evoker,devastation,12,4,8
area-52,384,evoker,devastation,12,4,8
darkspear,384,evoker,devastation,12,4,8
spirestone,384,evoker,devastation,18,4,14
azuremyst,383,evoker,devastation,6,4,2
stormrage,383,evoker,devastation,6,4,2
area-52,383,evoker,devastation,6,4,2
tichondrius,383,evoker,devastation,6,4,2
thrall,352,evoker,devastation,10,4,6
area-52,336,evoker,devastation,9,4,5
stormrage,335,evoker,devastation,11,4,7
stormrage,329,evoker,devastation,14,5,9
area-52,319,evoker,devastation,5,4,1
wyrmrest-accord,288,evoker,devastation,6,3,3
area-52,288,evoker,devastation,6,3,3
darkspear,288,evoker,devastation,6,3,3
drakkari,288,evoker,devastation,6,3,3
moon-guard,288,evoker,devastation,6,3,3
black-dragonflight,288,evoker,devastation,6,3,3
quelthalas,288,evoker,devastation,6,3,3
tichondrius,288,evoker,devastation,6,3,3
area-52,288,evoker,devastation,6,3,3
thrall,288,evoker,devastation,6,3,3
kelthuzad,288,evoker,devastation,6,3,3
frostwolf,288,evoker,devastation,6,3,3
tichondrius,288,evoker,devastation,6,3,3
stormrage,288,evoker,devastation,6,3,3
auchindoun,288,evoker,devastation,6,3,3
moon-guard,288,evoker,devastation,6,3,3
zuljin,288,evoker,devastation,6,3,3
stormrage,288,evoker,devastation,6,3,3
tichondrius,288,evoker,devastation,6,3,3
anubarak,288,evoker,devastation,6,3,3
tichondrius,288,evoker,devastation,6,3,3
aegwynn,288,evoker,devastation,6,3,3
zuljin,288,evoker,devastation,6,3,3
stormrage,288,evoker,devastation,6,3,3
kiljaeden,288,evoker,devastation,6,3,3
tichondrius,288,evoker,devastation,6,3,3
ragnaros,288,evoker,devastation,6,3,3
sargeras,288,evoker,devastation,6,3,3
frostmourne,288,evoker,devastation,6,3,3
azralon,288,evoker,devastation,6,3,3
emerald-dream,288,evoker,devastation,6,3,3
azralon,288,evoker,devastation,6,3,3
area-52,288,evoker,devastation,10,4,6
stormrage,288,evoker,devastation,12,3,9
antonidas,288,evoker,devastation,12,3,9
duskwood,288,evoker,devastation,12,3,9
emerald-dream,288,evoker,devastation,12,3,9
tichondrius,288,evoker,devastation,12,3,9
wyrmrest-accord,288,evoker,devastation,12,3,9
area-52,287,evoker,devastation,6,3,3
thrall,287,evoker,devastation,6,3,3
aerie-peak,287,evoker,devastation,6,3,3
uldaman,286,evoker,devastation,6,3,3
akama,240,evoker,devastation,9,3,6
moon-guard,239,evoker,devastation,11,3,8
tichondrius,224,evoker,devastation,10,3,7
zuljin,192,evoker,devastation,6,2,4
stormrage,192,evoker,devastation,6,2,4
area-52,192,evoker,devastation,6,2,4
area-52,192,evoker,devastation,6,2,4
bleeding-hollow,192,evoker,devastation,6,2,4
frostmourne,192,evoker,devastation,6,2,4
amanthul,192,evoker,devastation,6,2,4
area-52,192,evoker,devastation,6,2,4
frostmourne,192,evoker,devastation,6,2,4
kelthuzad,192,evoker,devastation,6,2,4
kelthuzad,192,evoker,devastation,6,2,4
ghostlands,192,evoker,devastation,6,2,4
malganis,192,evoker,devastation,6,2,4
nazjatar,192,evoker,devastation,6,2,4
illidan,192,evoker,devastation,6,2,4
ragnaros,192,evoker,devastation,6,2,4
madoran,192,evoker,devastation,6,2,4
tichondrius,192,evoker,devastation,6,2,4
drakkari,192,evoker,devastation,6,2,4
moon-guard,192,evoker,devastation,6,2,4
illidan,192,evoker,devastation,6,2,4
wyrmrest-accord,192,evoker,devastation,6,2,4
azralon,192,evoker,devastation,6,2,4
emerald-dream,192,evoker,devastation,6,2,4
moon-guard,192,evoker,devastation,6,2,4
illidan,192,evoker,devastation,6,2,4
sargeras,192,evoker,devastation,6,2,4
emerald-dream,192,evoker,devastation,6,2,4
illidan,192,evoker,devastation,6,2,4
terenas,192,evoker,devastation,6,2,4
scarlet-crusade,192,evoker,devastation,6,2,4
lightbringer,192,evoker,devastation,6,2,4
tichondrius,192,evoker,devastation,6,2,4
tichondrius,192,evoker,devastation,6,2,4
nerzhul,192,evoker,devastation,6,2,4
tichondrius,192,evoker,devastation,6,2,4
tol-barad,192,evoker,devastation,6,2,4
stormreaver,192,evoker,devastation,6,2,4
uther,192,evoker,devastation,6,2,4
tichondrius,192,evoker,devastation,6,2,4
hyjal,192,evoker,devastation,6,2,4
thorium-brotherhood,192,evoker,devastation,6,2,4
tichondrius,192,evoker,devastation,6,2,4
tichondrius,192,evoker,devastation,6,2,4
illidan,192,evoker,devastation,8,2,6
thrall,191,evoker,devastation,6,2,4
tichondrius,159,evoker,devastation,5,2,3
moon-guard,159,evoker,devastation,5,2,3
tichondrius,159,evoker,devastation,5,2,3
tichondrius,144,evoker,devastation,9,2,7
illidan,128,evoker,devastation,4,2,2
frostmourne,128,evoker,devastation,4,2,2
azralon,112,evoker,devastation,7,2,5
frostmourne,96,evoker,devastation,3,2,1
sargeras,96,evoker,devastation,3,2,1
ragnaros,96,evoker,devastation,6,1,5
sargeras,96,evoker,devastation,6,1,5
tichondrius,96,evoker,devastation,6,1,5
tichondrius,96,evoker,devastation,6,1,5
frostmourne,96,evoker,devastation,6,1,5
senjin,96,evoker,devastation,6,1,5
wyrmrest-accord,96,evoker,devastation,6,1,5
illidan,96,evoker,devastation,6,1,5
bleeding-hollow,96,evoker,devastation,6,1,5
thrall,96,evoker,devastation,6,1,5
bleeding-hollow,96,evoker,devastation,6,1,5
frostmourne,96,evoker,devastation,6,1,5
barthilas,96,evoker,devastation,6,1,5
quelthalas,96,evoker,devastation,6,1,5
drakkari,96,evoker,devastation,6,1,5
malganis,96,evoker,devastation,6,1,5
ragnaros,96,evoker,devastation,6,1,5
daggerspine,96,evoker,devastation,12,1,11
durotan,96,evoker,devastation,12,1,11
shattered-hand,64,evoker,devastation,4,1,3
area-52,64,evoker,devastation,4,1,3
area-52,64,evoker,devastation,4,1,3
icecrown,48,evoker,devastation,3,1,2
lightbringer,31,evoker,devastation,2,1,1
magtheridon,16,evoker,devastation,1,1,0
emerald-dream,2136,hunter,marksmanship,82,44,38
tichondrius,2041,hunter,marksmanship,63,33,30
area-52,2026,hunter,marksmanship,90,48,42
kiljaeden,1980,hunter,marksmanship,95,51,44
spinebreaker,1884,hunter,marksmanship,54,33,21
tichondrius,1866,hunter,marksmanship,120,57,63
tichondrius,1839,hunter,marksmanship,177,86,91
sargeras,1812,hunter,marksmanship,96,51,45
tichondrius,1810,hunter,marksmanship,86,43,43
tichondrius,1804,hunter,marksmanship,89,42,47
tichondrius,1803,hunter,marksmanship,50,23,27
quelthalas,1801,hunter,marksmanship,60,32,28
deathwing,1778,hunter,marksmanship,48,27,21
frostmourne,1765,hunter,marksmanship,48,21,27
tichondrius,1762,hunter,marksmanship,77,37,40
illidan,1758,hunter,marksmanship,54,29,25
tichondrius,1746,hunter,marksmanship,84,33,51
stormrage,1729,hunter,marksmanship,72,36,36
malorne,1728,hunter,marksmanship,60,30,30
thrall,1727,hunter,marksmanship,42,23,19
tichondrius,1715,hunter,marksmanship,30,19,11
tichondrius,1713,hunter,marksmanship,48,24,24
tichondrius,1708,hunter,marksmanship,48,21,27
bleeding-hollow,1701,hunter,marksmanship,42,26,16
tichondrius,1698,hunter,marksmanship,71,40,31
illidan,1693,hunter,marksmanship,42,21,21
blackrock,1691,hunter,marksmanship,36,20,16
stormrage,1682,hunter,marksmanship,54,28,26
malganis,1677,hunter,marksmanship,42,23,19
tichondrius,1672,hunter,marksmanship,48,23,25
bleeding-hollow,1669,hunter,marksmanship,68,31,37
illidan,1666,hunter,marksmanship,60,23,37
proudmoore,1648,hunter,marksmanship,54,25,29
tichondrius,1644,hunter,marksmanship,36,22,14
bleeding-hollow,1632,hunter,marksmanship,168,89,79
daggerspine,1628,hunter,marksmanship,59,37,22
sargeras,1621,hunter,marksmanship,101,56,45
sargeras,1613,hunter,marksmanship,36,20,16
tichondrius,1604,hunter,marksmanship,42,17,25
proudmoore,1602,hunter,marksmanship,41,17,24
zuljin,1601,hunter,marksmanship,30,21,9
malganis,1587,hunter,marksmanship,55,29,26
sargeras,1583,hunter,marksmanship,36,17,19
frostmourne,1570,hunter,marksmanship,60,32,28
jubeithos,1563,hunter,marksmanship,48,19,29
tichondrius,1559,hunter,marksmanship,30,17,13
sargeras,1558,hunter,marksmanship,72,37,35
tichondrius,1555,hunter,marksmanship,36,19,17
tichondrius,1551,hunter,marksmanship,41,17,24
icecrown,1533,hunter,marksmanship,66,34,32
sargeras,1528,hunter,marksmanship,71,33,38
malganis,1524,hunter,marksmanship,36,16,20
arthas,1520,hunter,marksmanship,84,39,45
area-52,1519,hunter,marksmanship,63,30,33
tichondrius,1519,hunter,marksmanship,36,16,20
ragnaros,1518,hunter,marksmanship,45,21,24
zuljin,1510,hunter,marksmanship,77,41,36
barthilas,1510,hunter,marksmanship,47,23,24
area-52,1509,hunter,marksmanship,30,16,14
zuluhed,1467,hunter,marksmanship,61,25,36
stormrage,1461,hunter,marksmanship,42,17,25
area-52,1460,hunter,marksmanship,95,48,47
quelthalas,1447,hunter,marksmanship,36,18,18
drakkari,1442,hunter,marksmanship,50,21,29
nagrand,1438,hunter,marksmanship,34,18,16
ysondre,1438,hunter,marksmanship,42,17,25
shadowmoon,1423,hunter,marksmanship,36,16,20
stormrage,1415,hunter,marksmanship,24,16,8
quelthalas,1409,hunter,marksmanship,42,19,23
ragnaros,1409,hunter,marksmanship,59,25,34
tichondrius,1409,hunter,marksmanship,36,15,21
kelthuzad,1408,hunter,marksmanship,48,22,26
zuljin,1406,hunter,marksmanship,30,17,13
area-52,1403,hunter,marksmanship,66,34,32
illidan,1395,hunter,marksmanship,54,22,32
tichondrius,1392,hunter,marksmanship,23,15,8
nemesis,1390,hunter,marksmanship,36,16,20
bladefist,1387,hunter,marksmanship,24,16,8
frostwolf,1387,hunter,marksmanship,36,15,21
goldrinn,1374,hunter,marksmanship,36,19,17
ragnaros,1370,hunter,marksmanship,47,23,24
drakkari,1356,hunter,marksmanship,42,24,18
moon-guard,1356,hunter,marksmanship,42,19,23
zuljin,1350,hunter,marksmanship,85,42,43
moon-guard,1349,hunter,marksmanship,68,34,34
illidan,1345,hunter,marksmanship,36,18,18
illidan,1340,hunter,marksmanship,33,14,19
moon-guard,1337,hunter,marksmanship,42,27,15
illidan,1336,hunter,marksmanship,24,14,10
silvermoon,1336,hunter,marksmanship,57,25,32
whisperwind,1335,hunter,marksmanship,25,17,8
azralon,1323,hunter,marksmanship,36,14,22
proudmoore,1320,hunter,marksmanship,89,46,43
korgath,1318,hunter,marksmanship,22,15,7
illidan,1317,hunter,marksmanship,40,18,22
malganis,1315,hunter,marksmanship,98,44,54
azgalor,1314,hunter,marksmanship,40,22,18
dalaran,1311,hunter,marksmanship,73,38,35
skullcrusher,1306,hunter,marksmanship,38,21,17
sargeras,1304,hunter,marksmanship,29,14,15
illidan,1299,hunter,marksmanship,115,47,68
nemesis,1291,hunter,marksmanship,85,44,41
aegwynn,1290,hunter,marksmanship,48,18,30
area-52,1288,hunter,marksmanship,34,14,20
stormrage,1281,hunter,marksmanship,41,21,20
destromath,1274,hunter,marksmanship,38,16,22
stormrage,1269,hunter,marksmanship,119,58,61
sargeras,1268,hunter,marksmanship,38,19,19
thrall,1257,hunter,marksmanship,24,14,10
kelthuzad,1257,hunter,marksmanship,47,22,25
stormrage,1255,hunter,marksmanship,30,17,13
thrall,1255,hunter,marksmanship,42,21,21
illidan,1254,hunter,marksmanship,31,21,10
gundrak,1253,hunter,marksmanship,29,18,11
zuljin,1251,hunter,marksmanship,43,18,25
area-52,1246,hunter,marksmanship,30,13,17
kelthuzad,1244,hunter,marksmanship,33,15,18
stormrage,1243,hunter,marksmanship,24,13,11
ragnaros,1242,hunter,marksmanship,36,17,19
illidan,1240,hunter,marksmanship,24,13,11
tichondrius,1240,hunter,marksmanship,30,13,17
ragnaros,1239,hunter,marksmanship,38,21,17
amanthul,1237,hunter,marksmanship,78,34,44
drakkari,1236,hunter,marksmanship,30,13,17
zuljin,1235,hunter,marksmanship,30,13,17
azralon,1230,hunter,marksmanship,42,18,24
blackrock,1229,hunter,marksmanship,24,13,11
destromath,1228,hunter,marksmanship,33,14,19
terenas,1226,hunter,marksmanship,30,13,17
stormrage,1226,hunter,marksmanship,33,14,19
laughing-skull,1224,hunter,marksmanship,90,42,48
illidan,1223,hunter,marksmanship,30,13,17
tichondrius,1223,hunter,marksmanship,37,14,23
lothar,1220,hunter,marksmanship,58,28,30
gurubashi,1216,hunter,marksmanship,25,13,12
proudmoore,1215,hunter,marksmanship,24,13,11
aegwynn,1208,hunter,marksmanship,46,20,26
gurubashi,1205,hunter,marksmanship,30,15,15
sargeras,1194,hunter,marksmanship,75,34,41
tichondrius,1191,hunter,marksmanship,54,26,28
amanthul,1190,hunter,marksmanship,39,21,18
lightninghoof,1190,hunter,marksmanship,29,13,16
misha,1189,hunter,marksmanship,43,19,24
area-52,1187,hunter,marksmanship,45,24,21
darkspear,1186,hunter,marksmanship,29,16,13
illidan,1177,hunter,marksmanship,47,19,28
tichondrius,1176,hunter,marksmanship,41,20,21
tichondrius,1170,hunter,marksmanship,29,14,15
ragnaros,1166,hunter,marksmanship,45,24,21
azralon,1163,hunter,marksmanship,38,17,21
stormreaver,1161,hunter,marksmanship,36,13,23
black-dragonflight,1158,hunter,marksmanship,18,13,5
korgath,1151,hunter,marksmanship,53,30,23
frostmourne,1151,hunter,marksmanship,24,12,12
tichondrius,1151,hunter,marksmanship,24,12,12
emerald-dream,1148,hunter,marksmanship,24,12,12
kiljaeden,1145,hunter,marksmanship,24,12,12
korgath,1144,hunter,marksmanship,24,12,12
barthilas,1144,hunter,marksmanship,30,12,18
stormrage,1143,hunter,marksmanship,30,12,18
frostmourne,1142,hunter,marksmanship,24,12,12
greymane,1140,hunter,marksmanship,18,12,6
senjin,1136,hunter,marksmanship,24,12,12
frostmourne,1129,hunter,marksmanship,24,12,12
zuluhed,1127,hunter,marksmanship,36,13,23
tichondrius,1122,hunter,marksmanship,24,12,12
frostmourne,1119,hunter,marksmanship,16,13,3
wyrmrest-accord,1119,hunter,marksmanship,30,14,16
azralon,1116,hunter,marksmanship,29,12,17
sargeras,1114,hunter,marksmanship,91,46,45
quelthalas,1106,hunter,marksmanship,47,25,22
moon-guard,1101,hunter,marksmanship,22,13,9
frostwolf,1101,hunter,marksmanship,94,49,45
azralon,1097,hunter,marksmanship,36,25,11
cenarius,1095,hunter,marksmanship,24,13,11
moon-guard,1088,hunter,marksmanship,78,34,44
tichondrius,1081,hunter,marksmanship,61,32,29
area-52,1065,hunter,marksmanship,23,12,11
azralon,1065,hunter,marksmanship,28,14,14
darrowmere,1065,hunter,marksmanship,30,13,17
tichondrius,1061,hunter,marksmanship,30,12,18
stormrage,1061,hunter,marksmanship,48,19,29
tichondrius,1056,hunter,marksmanship,18,11,7
blackrock,1056,hunter,marksmanship,18,11,7
ragnaros,1054,hunter,marksmanship,24,11,13
malganis,1053,hunter,marksmanship,24,11,13
stormrage,1050,hunter,marksmanship,24,11,13
sargeras,1049,hunter,marksmanship,24,11,13
azralon,1047,hunter,marksmanship,66,27,39
norgannon,1046,hunter,marksmanship,30,11,19
moon-guard,1039,hunter,marksmanship,18,11,7
thunderlord,1036,hunter,marksmanship,41,18,23
thrall,1031,hunter,marksmanship,18,11,7
azralon,1027,hunter,marksmanship,30,13,17
bleeding-hollow,1026,hunter,marksmanship,30,15,15
hakkar,1019,hunter,marksmanship,40,22,18
quelthalas,1017,hunter,marksmanship,30,11,19
illidan,1015,hunter,marksmanship,39,23,16
senjin,1010,hunter,marksmanship,48,20,28
boulderfist,1006,hunter,marksmanship,24,13,11
gallywix,997,hunter,marksmanship,48,23,25
ragnaros,988,hunter,marksmanship,23,11,12
ragnaros,988,hunter,marksmanship,65,31,34
frostmourne,987,hunter,marksmanship,21,11,10
area-52,986,hunter,marksmanship,36,15,21
jubeithos,983,hunter,marksmanship,49,27,22
illidan,968,hunter,marksmanship,18,12,6
cairne,968,hunter,marksmanship,52,24,28
wyrmrest-accord,960,hunter,marksmanship,12,10,2
tichondrius,960,hunter,marksmanship,18,10,8
sargeras,960,hunter,marksmanship,18,10,8
antonidas,960,hunter,marksmanship,24,10,14
tichondrius,960,hunter,marksmanship,30,10,20
area-52,959,hunter,marksmanship,12,10,2
illidan,959,hunter,marksmanship,66,29,37
stormrage,959,hunter,marksmanship,30,10,20
azralon,958,hunter,marksmanship,18,10,8
area-52,958,hunter,marksmanship,18,10,8
area-52,958,hunter,marksmanship,27,11,16
bleeding-hollow,957,hunter,marksmanship,24,10,14
azralon,957,hunter,marksmanship,30,10,20
moon-guard,956,hunter,marksmanship,29,11,18
proudmoore,956,hunter,marksmanship,30,10,20
kelthuzad,955,hunter,marksmanship,21,11,10
burning-legion,953,hunter,marksmanship,12,10,2
hyjal,953,hunter,marksmanship,18,10,8
bleeding-hollow,953,hunter,marksmanship,18,10,8
stormrage,952,hunter,marksmanship,30,10,20
grizzly-hills,951,hunter,marksmanship,18,10,8
eredar,951,hunter,marksmanship,30,12,18
ragnaros,949,hunter,marksmanship,24,10,14
quelthalas,947,hunter,marksmanship,18,10,8
illidan,939,hunter,marksmanship,24,10,14
black-dragonflight,936,hunter,marksmanship,48,24,24
tichondrius,935,hunter,marksmanship,59,28,31
tichondrius,927,hunter,marksmanship,62,23,39
azralon,923,hunter,marksmanship,41,22,19
black-dragonflight,922,hunter,marksmanship,18,10,8
perenolde,920,hunter,marksmanship,29,10,19
azgalor,913,hunter,marksmanship,23,12,11
sargeras,910,hunter,marksmanship,21,11,10
deathwing,906,hunter,marksmanship,23,10,13
stormrage,906,hunter,marksmanship,57,23,34
korgath,901,hunter,marksmanship,29,11,18
ragnaros,865,hunter,marksmanship,89,33,56
ragnaros,864,hunter,marksmanship,18,9,9
area-52,864,hunter,marksmanship,18,9,9
frostmourne,864,hunter,marksmanship,24,9,15
quelthalas,864,hunter,marksmanship,24,9,15
frostmourne,864,hunter,marksmanship,24,9,15
bleeding-hollow,863,hunter,marksmanship,12,9,3
tichondrius,863,hunter,marksmanship,12,9,3
demon-soul,863,hunter,marksmanship,12,9,3
tichondrius,863,hunter,marksmanship,18,9,9
burning-legion,863,hunter,marksmanship,18,9,9
stormrage,863,hunter,marksmanship,18,9,9
stormrage,863,hunter,marksmanship,18,9,9
elune,863,hunter,marksmanship,24,9,15
emerald-dream,862,hunter,marksmanship,12,9,3
area-52,862,hunter,marksmanship,18,9,9
hydraxis,862,hunter,marksmanship,18,9,9
azralon,860,hunter,marksmanship,17,10,7
bleeding-hollow,860,hunter,marksmanship,18,9,9
moon-guard,859,hunter,marksmanship,18,9,9
gurubashi,858,hunter,marksmanship,18,9,9
uldum,857,hunter,marksmanship,12,9,3
emerald-dream,855,hunter,marksmanship,24,9,15
malygos,824,hunter,marksmanship,18,9,9
azralon,802,hunter,marksmanship,21,10,11
illidan,780,hunter,marksmanship,30,9,21
stormrage,768,hunter,marksmanship,12,8,4
frostmourne,768,hunter,marksmanship,18,8,10
azralon,768,hunter,marksmanship,18,8,10
bleeding-hollow,768,hunter,marksmanship,18,8,10
ragnaros,768,hunter,marksmanship,18,8,10
stormrage,768,hunter,marksmanship,24,8,16
dalaran,768,hunter,marksmanship,24,8,16
stormrage,767,hunter,marksmanship,18,8,10
emerald-dream,767,hunter,marksmanship,18,8,10
drakkari,767,hunter,marksmanship,18,8,10
wyrmrest-accord,767,hunter,marksmanship,18,8,10
burning-blade,767,hunter,marksmanship,18,8,10
quelthalas,766,hunter,marksmanship,12,8,4
tichondrius,766,hunter,marksmanship,12,8,4
moon-guard,766,hunter,marksmanship,12,8,4
quelthalas,766,hunter,marksmanship,18,8,10
altar-of-storms,766,hunter,marksmanship,18,8,10
dalaran,765,hunter,marksmanship,12,8,4
sargeras,765,hunter,marksmanship,19,10,9
barthilas,765,hunter,marksmanship,21,10,11
proudmoore,764,hunter,marksmanship,18,8,10
arthas,762,hunter,marksmanship,18,8,10
thunderlord,760,hunter,marksmanship,12,8,4
ragnaros,751,hunter,marksmanship,12,8,4
azgalor,751,hunter,marksmanship,24,8,16
khadgar,750,hunter,marksmanship,18,8,10
korgath,749,hunter,marksmanship,12,8,4
dalaran,749,hunter,marksmanship,22,8,14
malganis,703,hunter,marksmanship,11,8,3
kiljaeden,686,hunter,marksmanship,36,9,27
ragnaros,672,hunter,marksmanship,12,7,5
khazgoroth,672,hunter,marksmanship,12,7,5
emerald-dream,672,hunter,marksmanship,12,7,5
bleeding-hollow,672,hunter,marksmanship,12,7,5
tol-barad,672,hunter,marksmanship,12,7,5
lightnings-blade,672,hunter,marksmanship,12,7,5
stormrage,672,hunter,marksmanship,12,7,5
tichondrius,672,hunter,marksmanship,12,7,5
sargeras,672,hunter,marksmanship,12,7,5
stormrage,672,hunter,marksmanship,12,7,5
tichondrius,672,hunter,marksmanship,12,7,5
medivh,672,hunter,marksmanship,12,7,5
stormrage,672,hunter,marksmanship,14,7,7
hyjal,672,hunter,marksmanship,18,7,11
khazgoroth,672,hunter,marksmanship,18,7,11
proudmoore,671,hunter,marksmanship,12,7,5
azralon,671,hunter,marksmanship,12,7,5
ragnaros,671,hunter,marksmanship,12,7,5
area-52,671,hunter,marksmanship,12,7,5
wyrmrest-accord,671,hunter,marksmanship,12,7,5
quelthalas,671,hunter,marksmanship,12,7,5
sargeras,671,hunter,marksmanship,12,7,5
emerald-dream,671,hunter,marksmanship,12,7,5
kelthuzad,671,hunter,marksmanship,12,7,5
proudmoore,671,hunter,marksmanship,12,7,5
stormrage,671,hunter,marksmanship,12,7,5
thrall,671,hunter,marksmanship,18,7,11
sargeras,671,hunter,marksmanship,18,7,11
kiljaeden,671,hunter,marksmanship,18,7,11
tichondrius,671,hunter,marksmanship,18,7,11
tichondrius,671,hunter,marksmanship,18,7,11
quelthalas,671,hunter,marksmanship,18,7,11
quelthalas,671,hunter,marksmanship,18,7,11
malganis,671,hunter,marksmanship,18,7,11
bleeding-hollow,670,hunter,marksmanship,12,7,5
tichondrius,670,hunter,marksmanship,18,7,11
stormrage,670,hunter,marksmanship,18,7,11
stormrage,670,hunter,marksmanship,18,7,11
barthilas,668,hunter,marksmanship,12,7,5
stormrage,666,hunter,marksmanship,12,7,5
stormrage,665,hunter,marksmanship,12,7,5
maelstrom,661,hunter,marksmanship,18,7,11
azralon,657,hunter,marksmanship,12,7,5
nemesis,656,hunter,marksmanship,30,7,23
area-52,640,hunter,marksmanship,22,7,15
barthilas,639,hunter,marksmanship,23,7,16
tichondrius,638,hunter,marksmanship,14,8,6
tichondrius,623,hunter,marksmanship,16,8,8
saurfang,607,hunter,marksmanship,11,7,4
sargeras,607,hunter,marksmanship,17,7,10
tichondrius,607,hunter,marksmanship,20,7,13
thrall,591,hunter,marksmanship,11,7,4
illidan,576,hunter,marksmanship,6,6,0
tichondrius,576,hunter,marksmanship,12,6,6
sargeras,576,hunter,marksmanship,12,6,6
illidan,576,hunter,marksmanship,12,6,6
nerzhul,576,hunter,marksmanship,12,6,6
dalaran,576,hunter,marksmanship,12,6,6
garona,576,hunter,marksmanship,12,6,6
illidan,576,hunter,marksmanship,12,6,6
drakkari,576,hunter,marksmanship,12,6,6
azralon,576,hunter,marksmanship,12,6,6
icecrown,576,hunter,marksmanship,12,6,6
moon-guard,576,hunter,marksmanship,12,6,6
daggerspine,576,hunter,marksmanship,12,6,6
azralon,576,hunter,marksmanship,12,6,6
moon-guard,576,hunter,marksmanship,12,6,6
frostmourne,576,hunter,marksmanship,12,6,6
kelthuzad,576,hunter,marksmanship,12,6,6
proudmoore,576,hunter,marksmanship,12,6,6
moon-guard,576,hunter,marksmanship,12,6,6
bleeding-hollow,576,hunter,marksmanship,12,6,6
wyrmrest-accord,576,hunter,marksmanship,12,6,6
ragnaros,576,hunter,marksmanship,12,6,6
area-52,576,hunter,marksmanship,12,6,6
undermine,576,hunter,marksmanship,12,6,6
illidan,576,hunter,marksmanship,18,6,12
ragnaros,576,hunter,marksmanship,18,6,12
azshara,576,hunter,marksmanship,18,6,12
goldrinn,576,hunter,marksmanship,24,6,18
tichondrius,575,hunter,marksmanship,12,6,6
frostmourne,575,hunter,marksmanship,12,6,6
malganis,575,hunter,marksmanship,12,6,6
kelthuzad,575,hunter,marksmanship,12,6,6
queldorei,575,hunter,marksmanship,12,6,6
sargeras,575,hunter,marksmanship,12,6,6
azralon,575,hunter,marksmanship,12,6,6
azralon,575,hunter,marksmanship,12,6,6
aerie-peak,575,hunter,marksmanship,12,6,6
tichondrius,575,hunter,marksmanship,12,6,6
nemesis,575,hunter,marksmanship,12,6,6
zuljin,575,hunter,marksmanship,18,6,12
hakkar,575,hunter,marksmanship,24,6,18
zuljin,574,hunter,marksmanship,12,6,6
stormrage,574,hunter,marksmanship,12,6,6
stormrage,574,hunter,marksmanship,12,6,6
scilla,574,hunter,marksmanship,14,6,8
kelthuzad,573,hunter,marksmanship,18,6,12
barthilas,572,hunter,marksmanship,12,6,6
chogall,557,hunter,marksmanship,11,6,5
destromath,543,hunter,marksmanship,11,6,5
azralon,534,hunter,marksmanship,14,7,7
eredar,522,hunter,marksmanship,16,7,9
burning-blade,522,hunter,marksmanship,16,7,9
kelthuzad,511,hunter,marksmanship,16,6,10
moon-guard,510,hunter,marksmanship,14,6,8
lightnings-blade,510,hunter,marksmanship,16,6,10
tichondrius,480,hunter,marksmanship,6,5,1
stormrage,480,hunter,marksmanship,6,5,1
quelthalas,480,hunter,marksmanship,6,5,1
moon-guard,480,hunter,marksmanship,6,5,1
tichondrius,480,hunter,marksmanship,6,5,1
stormrage,480,hunter,marksmanship,6,5,1
zuljin,480,hunter,marksmanship,6,5,1
illidan,480,hunter,marksmanship,6,5,1
tichondrius,480,hunter,marksmanship,6,5,1
tichondrius,480,hunter,marksmanship,7,5,2
tichondrius,480,hunter,marksmanship,9,6,3
nordrassil,480,hunter,marksmanship,9,5,4
illidan,480,hunter,marksmanship,12,5,7
frostmourne,480,hunter,marksmanship,12,5,7
sargeras,480,hunter,marksmanship,12,5,7
proudmoore,480,hunter,marksmanship,12,5,7
the-underbog,480,hunter,marksmanship,12,5,7
aggramar,480,hunter,marksmanship,12,5,7
ragnaros,480,hunter,marksmanship,12,5,7
tichondrius,480,hunter,marksmanship,12,5,7
tichondrius,480,hunter,marksmanship,12,5,7
illidan,480,hunter,marksmanship,12,5,7
kelthuzad,480,hunter,marksmanship,12,5,7
aggramar,480,hunter,marksmanship,12,5,7
stormrage,480,hunter,marksmanship,12,5,7
tichondrius,480,hunter,marksmanship,12,5,7
tichondrius,480,hunter,marksmanship,12,5,7
stormrage,480,hunter,marksmanship,12,5,7
emerald-dream,480,hunter,marksmanship,18,5,13
proudmoore,480,hunter,marksmanship,18,5,13
nerzhul,480,hunter,marksmanship,18,5,13
illidan,480,hunter,marksmanship,18,5,13
zuljin,480,hunter,marksmanship,18,5,13
ragnaros,480,hunter,marksmanship,18,5,13
lightbringer,480,hunter,marksmanship,18,5,13
tichondrius,480,hunter,marksmanship,18,5,13
malganis,480,hunter,marksmanship,19,5,14
winterhoof,479,hunter,marksmanship,6,5,1
illidan,479,hunter,marksmanship,6,5,1
zuljin,479,hunter,marksmanship,6,5,1
aggramar,479,hunter,marksmanship,6,5,1
area-52,479,hunter,marksmanship,12,5,7
emerald-dream,479,hunter,marksmanship,12,5,7
illidan,479,hunter,marksmanship,12,5,7
area-52,479,hunter,marksmanship,12,5,7
blood-furnace,479,hunter,marksmanship,12,5,7
terenas,479,hunter,marksmanship,12,5,7
barthilas,479,hunter,marksmanship,18,5,13
wyrmrest-accord,479,hunter,marksmanship,18,5,13
archimonde,479,hunter,marksmanship,18,5,13
tichondrius,478,hunter,marksmanship,13,6,7
greymane,478,hunter,marksmanship,12,5,7
tol-barad,478,hunter,marksmanship,12,5,7
tichondrius,478,hunter,marksmanship,18,5,13
sentinels,477,hunter,marksmanship,12,5,7
nazgrel,474,hunter,marksmanship,12,5,7
area-52,447,hunter,marksmanship,11,5,6
stormrage,432,hunter,marksmanship,9,5,4
thunderhorn,431,hunter,marksmanship,11,5,6
kalecgos,415,hunter,marksmanship,8,5,3
moon-guard,384,hunter,marksmanship,6,4,2
sargeras,384,hunter,marksmanship,6,4,2
garona,384,hunter,marksmanship,6,4,2
burning-blade,384,hunter,marksmanship,6,4,2
zuljin,384,hunter,marksmanship,6,4,2
nemesis,384,hunter,marksmanship,6,4,2
tichondrius,384,hunter,marksmanship,6,4,2
firetree,384,hunter,marksmanship,6,4,2
darkspear,384,hunter,marksmanship,6,4,2
moon-guard,384,hunter,marksmanship,6,4,2
dreadmaul,384,hunter,marksmanship,6,4,2
ragnaros,384,hunter,marksmanship,6,4,2
azralon,384,hunter,marksmanship,6,4,2
illidan,384,hunter,marksmanship,6,4,2
area-52,384,hunter,marksmanship,6,4,2
kelthuzad,384,hunter,marksmanship,6,4,2
demon-soul,384,hunter,marksmanship,6,4,2
tichondrius,384,hunter,marksmanship,6,4,2
illidan,384,hunter,marksmanship,6,4,2
tichondrius,384,hunter,marksmanship,6,4,2
guldan,384,hunter,marksmanship,6,4,2
sargeras,384,hunter,marksmanship,6,4,2
tichondrius,384,hunter,marksmanship,6,4,2
frostmourne,384,hunter,marksmanship,6,4,2
tichondrius,384,hunter,marksmanship,6,4,2
azralon,384,hunter,marksmanship,6,4,2
tichondrius,384,hunter,marksmanship,6,4,2
illidan,384,hunter,marksmanship,6,4,2
ragnaros,384,hunter,marksmanship,6,4,2
burning-legion,384,hunter,marksmanship,6,4,2
stormrage,384,hunter,marksmanship,6,4,2
area-52,384,hunter,marksmanship,6,4,2
tichondrius,384,hunter,marksmanship,6,4,2
dalaran,384,hunter,marksmanship,6,4,2
azgalor,384,hunter,marksmanship,6,4,2
area-52,384,hunter,marksmanship,6,4,2
dalaran,384,hunter,marksmanship,6,4,2
ragnaros,384,hunter,marksmanship,6,4,2
tichondrius,384,hunter,marksmanship,6,4,2
nemesis,384,hunter,marksmanship,12,4,8
area-52,384,hunter,marksmanship,12,4,8
azralon,384,hunter,marksmanship,12,4,8
ragnaros,384,hunter,marksmanship,12,4,8
drakkari,384,hunter,marksmanship,12,4,8
malganis,384,hunter,marksmanship,12,4,8
blackhand,384,hunter,marksmanship,12,4,8
darkspear,384,hunter,marksmanship,12,4,8
blackhand,384,hunter,marksmanship,12,4,8
thrall,384,hunter,marksmanship,12,4,8
illidan,384,hunter,marksmanship,12,4,8
thrall,384,hunter,marksmanship,12,4,8
azralon,384,hunter,marksmanship,12,4,8
illidan,384,hunter,marksmanship,12,4,8
tichondrius,384,hunter,marksmanship,12,4,8
stormrage,384,hunter,marksmanship,12,4,8
durotan,384,hunter,marksmanship,12,4,8
kargath,384,hunter,marksmanship,12,4,8
jaedenar,384,hunter,marksmanship,12,4,8
arthas,384,hunter,marksmanship,12,4,8
destromath,384,hunter,marksmanship,12,4,8
sargeras,384,hunter,marksmanship,12,4,8
tichondrius,384,hunter,marksmanship,12,4,8
bleeding-hollow,384,hunter,marksmanship,12,4,8
quelthalas,384,hunter,marksmanship,16,4,12
kiljaeden,384,hunter,marksmanship,18,4,14
sargeras,384,hunter,marksmanship,19,4,15
stormrage,383,hunter,marksmanship,6,4,2
quelthalas,383,hunter,marksmanship,6,4,2
stormrage,383,hunter,marksmanship,6,4,2
frostmourne,383,hunter,marksmanship,6,4,2
malganis,383,hunter,marksmanship,6,4,2
aggramar,383,hunter,marksmanship,6,4,2
azshara,383,hunter,marksmanship,8,4,4
tichondrius,383,hunter,marksmanship,12,4,8
area-52,383,hunter,marksmanship,12,4,8
frostmourne,383,hunter,marksmanship,12,4,8
frostmourne,383,hunter,marksmanship,12,4,8
tichondrius,383,hunter,marksmanship,12,4,8
laughing-skull,383,hunter,marksmanship,12,4,8
eitrigg,383,hunter,marksmanship,12,4,8
azralon,383,hunter,marksmanship,18,4,14
emerald-dream,382,hunter,marksmanship,6,4,2
vashj,382,hunter,marksmanship,12,4,8
frostmourne,382,hunter,marksmanship,12,4,8
blood-furnace,381,hunter,marksmanship,12,4,8
wyrmrest-accord,381,hunter,marksmanship,12,4,8
area-52,367,hunter,marksmanship,11,4,7
area-52,351,hunter,marksmanship,16,4,12
zuljin,336,hunter,marksmanship,9,4,5
tichondrius,330,hunter,marksmanship,14,5,9
tichondrius,330,hunter,marksmanship,14,5,9
tichondrius,319,hunter,marksmanship,5,4,1
destromath,319,hunter,marksmanship,12,5,7
the-forgotten-coast,304,hunter,marksmanship,13,4,9
tichondrius,288,hunter,marksmanship,6,3,3
blackrock,288,hunter,marksmanship,6,3,3
tichondrius,288,hunter,marksmanship,6,3,3
tichondrius,288,hunter,marksmanship,6,3,3
azralon,288,hunter,marksmanship,6,3,3
emerald-dream,288,hunter,marksmanship,6,3,3
emerald-dream,288,hunter,marksmanship,6,3,3
wyrmrest-accord,288,hunter,marksmanship,6,3,3
aegwynn,288,hunter,marksmanship,6,3,3
spinebreaker,288,hunter,marksmanship,6,3,3
sargeras,288,hunter,marksmanship,6,3,3
bleeding-hollow,288,hunter,marksmanship,6,3,3
illidan,288,hunter,marksmanship,6,3,3
tichondrius,288,hunter,marksmanship,6,3,3
illidan,288,hunter,marksmanship,6,3,3
emerald-dream,288,hunter,marksmanship,6,3,3
illidan,288,hunter,marksmanship,6,3,3
dark-iron,288,hunter,marksmanship,6,3,3
tichondrius,288,hunter,marksmanship,6,3,3
moon-guard,288,hunter,marksmanship,6,3,3
ravencrest,288,hunter,marksmanship,6,3,3
illidan,288,hunter,marksmanship,6,3,3
tichondrius,288,hunter,marksmanship,6,3,3
sargeras,288,hunter,marksmanship,6,3,3
aegwynn,288,hunter,marksmanship,6,3,3
ragnaros,288,hunter,marksmanship,6,3,3
area-52,288,hunter,marksmanship,6,3,3
lethon,288,hunter,marksmanship,6,3,3
thaurissan,288,hunter,marksmanship,6,3,3
frostmourne,288,hunter,marksmanship,6,3,3
tichondrius,288,hunter,marksmanship,6,3,3
sargeras,288,hunter,marksmanship,6,3,3
zuljin,288,hunter,marksmanship,6,3,3
ragnaros,288,hunter,marksmanship,6,3,3
tichondrius,288,hunter,marksmanship,6,3,3
the-forgotten-coast,288,hunter,marksmanship,6,3,3
frostmourne,288,hunter,marksmanship,6,3,3
illidan,288,hunter,marksmanship,6,3,3
tichondrius,288,hunter,marksmanship,6,3,3
sargeras,288,hunter,marksmanship,6,3,3
moon-guard,288,hunter,marksmanship,6,3,3
dalaran,288,hunter,marksmanship,6,3,3
illidan,288,hunter,marksmanship,6,3,3
sargeras,288,hunter,marksmanship,6,3,3
maiev,288,hunter,marksmanship,6,3,3
dunemaul,288,hunter,marksmanship,6,3,3
tichondrius,288,hunter,marksmanship,6,3,3
tichondrius,288,hunter,marksmanship,6,3,3
tichondrius,288,hunter,marksmanship,6,3,3
frostmourne,288,hunter,marksmanship,6,3,3
kelthuzad,288,hunter,marksmanship,6,3,3
stormrage,288,hunter,marksmanship,6,3,3
quelthalas,288,hunter,marksmanship,6,3,3
area-52,288,hunter,marksmanship,6,3,3
mugthol,288,hunter,marksmanship,6,3,3
tichondrius,288,hunter,marksmanship,6,3,3
frostmourne,288,hunter,marksmanship,6,3,3
tichondrius,288,hunter,marksmanship,6,3,3
stormrage,288,hunter,marksmanship,6,3,3
stormrage,288,hunter,marksmanship,6,3,3
tichondrius,288,hunter,marksmanship,6,3,3
stormscale,288,hunter,marksmanship,6,3,3
malganis,288,hunter,marksmanship,7,3,4
sargeras,288,hunter,marksmanship,15,4,11
quelthalas,288,hunter,marksmanship,12,3,9
dalaran,288,hunter,marksmanship,12,3,9
bleeding-hollow,288,hunter,marksmanship,12,3,9
fizzcrank,288,hunter,marksmanship,12,3,9
quelthalas,288,hunter,marksmanship,12,3,9
zuljin,288,hunter,marksmanship,12,3,9
tichondrius,288,hunter,marksmanship,12,3,9
tichondrius,288,hunter,marksmanship,12,3,9
malganis,288,hunter,marksmanship,12,3,9
trollbane,288,hunter,marksmanship,12,3,9
sargeras,288,hunter,marksmanship,12,3,9
moon-guard,288,hunter,marksmanship,12,3,9
nerzhul,288,hunter,marksmanship,12,3,9
frostmane,288,hunter,marksmanship,12,3,9
queldorei,288,hunter,marksmanship,12,3,9
illidan,288,hunter,marksmanship,13,3,10
moon-guard,288,hunter,marksmanship,15,3,12
drakkari,288,hunter,marksmanship,18,3,15
ragnaros,287,hunter,marksmanship,6,3,3
quelthalas,287,hunter,marksmanship,6,3,3
dragonmaw,287,hunter,marksmanship,6,3,3
dentarg,287,hunter,marksmanship,6,3,3
ragnaros,287,hunter,marksmanship,6,3,3
gallywix,287,hunter,marksmanship,6,3,3
tichondrius,287,hunter,marksmanship,12,3,9
hellscream,286,hunter,marksmanship,6,3,3
tichondrius,286,hunter,marksmanship,6,3,3
bleeding-hollow,286,hunter,marksmanship,6,3,3
hydraxis,240,hunter,marksmanship,9,3,6
azralon,239,hunter,marksmanship,5,3,2
kul-tiras,239,hunter,marksmanship,5,3,2
area-52,234,hunter,marksmanship,7,4,3
moon-guard,234,hunter,marksmanship,10,4,6
frostmourne,208,hunter,marksmanship,7,3,4
undermine,202,hunter,marksmanship,11,4,7
zuljin,192,hunter,marksmanship,6,2,4
queldorei,192,hunter,marksmanship,6,2,4
proudmoore,192,hunter,marksmanship,6,2,4
tichondrius,192,hunter,marksmanship,6,2,4
doomhammer,192,hunter,marksmanship,6,2,4
tichondrius,192,hunter,marksmanship,6,2,4
blood-furnace,192,hunter,marksmanship,6,2,4
tichondrius,192,hunter,marksmanship,6,2,4
tichondrius,192,hunter,marksmanship,6,2,4
blood-furnace,192,hunter,marksmanship,6,2,4
tichondrius,192,hunter,marksmanship,6,2,4
bleeding-hollow,192,hunter,marksmanship,6,2,4
bleeding-hollow,192,hunter,marksmanship,6,2,4
tichondrius,192,hunter,marksmanship,6,2,4
shattered-halls,192,hunter,marksmanship,6,2,4
azuremyst,192,hunter,marksmanship,6,2,4
aegwynn,192,hunter,marksmanship,6,2,4
shadowmoon,192,hunter,marksmanship,6,2,4
tichondrius,192,hunter,marksmanship,6,2,4
bleeding-hollow,192,hunter,marksmanship,6,2,4
sargeras,192,hunter,marksmanship,6,2,4
burning-legion,192,hunter,marksmanship,6,2,4
earthen-ring,192,hunter,marksmanship,6,2,4
bleeding-hollow,192,hunter,marksmanship,6,2,4
ravencrest,192,hunter,marksmanship,6,2,4
nemesis,192,hunter,marksmanship,6,2,4
quelthalas,192,hunter,marksmanship,6,2,4
tichondrius,192,hunter,marksmanship,6,2,4
tichondrius,192,hunter,marksmanship,6,2,4
illidan,192,hunter,marksmanship,6,2,4
ragnaros,192,hunter,marksmanship,6,2,4
malganis,192,hunter,marksmanship,6,2,4
akama,192,hunter,marksmanship,6,2,4
icecrown,192,hunter,marksmanship,6,2,4
sargeras,192,hunter,marksmanship,6,2,4
malganis,192,hunter,marksmanship,6,2,4
area-52,192,hunter,marksmanship,6,2,4
hyjal,192,hunter,marksmanship,6,2,4
ragnaros,192,hunter,marksmanship,6,2,4
sargeras,192,hunter,marksmanship,6,2,4
kelthuzad,192,hunter,marksmanship,6,2,4
proudmoore,192,hunter,marksmanship,6,2,4
kelthuzad,192,hunter,marksmanship,6,2,4
sargeras,192,hunter,marksmanship,6,2,4
ragnaros,192,hunter,marksmanship,6,2,4
frostwolf,192,hunter,marksmanship,6,2,4
nagrand,192,hunter,marksmanship,6,2,4
malganis,192,hunter,marksmanship,6,2,4
illidan,192,hunter,marksmanship,6,2,4
moon-guard,192,hunter,marksmanship,6,2,4
frostmourne,192,hunter,marksmanship,6,2,4
alexstrasza,192,hunter,marksmanship,6,2,4
moon-guard,192,hunter,marksmanship,6,2,4
area-52,192,hunter,marksmanship,6,2,4
dragonblight,192,hunter,marksmanship,6,2,4
area-52,192,hunter,marksmanship,6,2,4
draka,192,hunter,marksmanship,6,2,4
moon-guard,192,hunter,marksmanship,6,2,4
tichondrius,192,hunter,marksmanship,6,2,4
quelthalas,192,hunter,marksmanship,6,2,4
wyrmrest-accord,192,hunter,marksmanship,6,2,4
thrall,192,hunter,marksmanship,6,2,4
area-52,192,hunter,marksmanship,6,2,4
azralon,192,hunter,marksmanship,6,2,4
frostmourne,192,hunter,marksmanship,6,2,4
area-52,192,hunter,marksmanship,6,2,4
stormrage,192,hunter,marksmanship,6,2,4
spinebreaker,192,hunter,marksmanship,6,2,4
frostmourne,192,hunter,marksmanship,6,2,4
ragnaros,192,hunter,marksmanship,9,2,7
jubeithos,192,hunter,marksmanship,12,2,10
azralon,192,hunter,marksmanship,12,2,10
aegwynn,192,hunter,marksmanship,12,2,10
malganis,192,hunter,marksmanship,12,2,10
queldorei,192,hunter,marksmanship,12,2,10
skullcrusher,192,hunter,marksmanship,12,2,10
tichondrius,192,hunter,marksmanship,12,2,10
kelthuzad,192,hunter,marksmanship,12,2,10
illidan,192,hunter,marksmanship,12,2,10
altar-of-storms,192,hunter,marksmanship,12,2,10
lightnings-blade,192,hunter,marksmanship,12,2,10
destromath,192,hunter,marksmanship,12,2,10
fenris,192,hunter,marksmanship,12,2,10
stormrage,192,hunter,marksmanship,12,2,10
ragnaros,192,hunter,marksmanship,18,2,16
illidan,191,hunter,marksmanship,6,2,4
borean-tundra,191,hunter,marksmanship,6,2,4
frostmourne,191,hunter,marksmanship,6,2,4
lightnings-blade,191,hunter,marksmanship,6,2,4
malganis,191,hunter,marksmanship,6,2,4
stormrage,160,hunter,marksmanship,10,2,8
azshara,159,hunter,marksmanship,5,2,3
shadowsong,159,hunter,marksmanship,5,2,3
moon-guard,159,hunter,marksmanship,5,2,3
veknilash,159,hunter,marksmanship,5,2,3
ragnaros,144,hunter,marksmanship,6,3,3
azralon,138,hunter,marksmanship,8,3,5
drenden,138,hunter,marksmanship,12,4,8
zuluhed,138,hunter,marksmanship,16,4,12
frostmourne,137,hunter,marksmanship,9,5,4
arathor,137,hunter,marksmanship,13,3,10
tichondrius,128,hunter,marksmanship,4,2,2
tichondrius,127,hunter,marksmanship,8,2,6
azralon,127,hunter,marksmanship,8,2,6
stormrage,110,hunter,marksmanship,7,2,5
dalaran,96,hunter,marksmanship,3,2,1
blood-furnace,96,hunter,marksmanship,6,1,5
area-52,96,hunter,marksmanship,6,1,5
dragonmaw,96,hunter,marksmanship,6,1,5
ragnaros,96,hunter,marksmanship,6,1,5
tichondrius,96,hunter,marksmanship,6,1,5
archimonde,96,hunter,marksmanship,6,1,5
drakkari,96,hunter,marksmanship,6,1,5
thrall,96,hunter,marksmanship,6,1,5
area-52,96,hunter,marksmanship,6,1,5
nemesis,96,hunter,marksmanship,6,1,5
windrunner,96,hunter,marksmanship,6,1,5
tichondrius,96,hunter,marksmanship,6,1,5
hyjal,96,hunter,marksmanship,6,1,5
khadgar,96,hunter,marksmanship,6,1,5
zuluhed,96,hunter,marksmanship,6,1,5
skullcrusher,96,hunter,marksmanship,6,1,5
frostmourne,96,hunter,marksmanship,6,1,5
zuljin,96,hunter,marksmanship,6,1,5
wyrmrest-accord,96,hunter,marksmanship,6,1,5
tichondrius,96,hunter,marksmanship,6,1,5
frostmourne,96,hunter,marksmanship,6,1,5
tichondrius,96,hunter,marksmanship,6,1,5
quelthalas,96,hunter,marksmanship,6,1,5
malganis,96,hunter,marksmanship,6,1,5
kul-tiras,96,hunter,marksmanship,6,1,5
barthilas,96,hunter,marksmanship,6,1,5
tichondrius,96,hunter,marksmanship,6,1,5
azjolnerub,96,hunter,marksmanship,6,1,5
tichondrius,96,hunter,marksmanship,6,1,5
sargeras,96,hunter,marksmanship,6,1,5
stormscale,96,hunter,marksmanship,6,1,5
nesingwary,96,hunter,marksmanship,6,1,5
tichondrius,96,hunter,marksmanship,6,1,5
cenarius,96,hunter,marksmanship,6,1,5
tichondrius,96,hunter,marksmanship,6,1,5
sargeras,96,hunter,marksmanship,6,1,5
kelthuzad,96,hunter,marksmanship,6,1,5
illidan,96,hunter,marksmanship,12,1,11
illidan,96,hunter,marksmanship,12,1,11
turalyon,95,hunter,marksmanship,6,1,5
blood-furnace,95,hunter,marksmanship,6,1,5
moon-guard,95,hunter,marksmanship,6,1,5
illidan,79,hunter,marksmanship,5,1,4
ragnaros,79,hunter,marksmanship,5,1,4
illidan,79,hunter,marksmanship,5,1,4
tichondrius,64,hunter,marksmanship,4,1,3
tichondrius,64,hunter,marksmanship,4,1,3
executus,48,hunter,marksmanship,3,1,2
tichondrius,42,hunter,marksmanship,14,2,12
darkspear,31,hunter,marksmanship,2,1,1
malganis,31,hunter,marksmanship,2,1,1
tichondrius,31,hunter,marksmanship,2,1,1
aerie-peak,31,hunter,marksmanship,2,1,1
dalaran,2208,hunter,survival,111,58,53
stormrage,2170,hunter,survival,90,47,43
tichondrius,2127,hunter,survival,74,45,29
stormrage,2120,hunter,survival,111,57,54
stormrage,2109,hunter,survival,115,59,56
emerald-dream,2108,hunter,survival,100,52,48
stormrage,2100,hunter,survival,120,64,56
moon-guard,2071,hunter,survival,72,44,28
tichondrius,2040,hunter,survival,99,51,48
shattered-hand,2025,hunter,survival,111,56,55
tichondrius,2015,hunter,survival,72,37,35
emerald-dream,2009,hunter,survival,60,39,21
frostmourne,1989,hunter,survival,71,37,34
wyrmrest-accord,1987,hunter,survival,79,40,39
tichondrius,1986,hunter,survival,84,42,42
sargeras,1970,hunter,survival,42,29,13
azralon,1953,hunter,survival,72,36,36
tichondrius,1942,hunter,survival,59,32,27
emerald-dream,1930,hunter,survival,99,54,45
darkspear,1925,hunter,survival,56,30,26
tichondrius,1917,hunter,survival,83,46,37
bleeding-hollow,1911,hunter,survival,66,35,31
tichondrius,1910,hunter,survival,60,29,31
azralon,1910,hunter,survival,95,43,52
stormrage,1898,hunter,survival,78,44,34
ragnaros,1893,hunter,survival,78,42,36
kelthuzad,1888,hunter,survival,54,29,25
barthilas,1885,hunter,survival,60,34,26
quelthalas,1885,hunter,survival,106,58,48
bladefist,1872,hunter,survival,87,44,43
area-52,1866,hunter,survival,82,40,42
frostmourne,1858,hunter,survival,48,30,18
sargeras,1834,hunter,survival,42,26,16
tichondrius,1829,hunter,survival,30,24,6
ragnaros,1821,hunter,survival,36,25,11
tichondrius,1821,hunter,survival,155,80,75
wyrmrest-accord,1820,hunter,survival,66,33,33
sargeras,1818,hunter,survival,40,23,17
khaz-modan,1815,hunter,survival,54,34,20
tichondrius,1814,hunter,survival,84,46,38
emerald-dream,1811,hunter,survival,47,32,15
emerald-dream,1810,hunter,survival,57,38,19
tichondrius,1802,hunter,survival,58,29,29
nemesis,1800,hunter,survival,48,31,17
sargeras,1800,hunter,survival,66,29,37
stormrage,1768,hunter,survival,78,46,32
area-52,1765,hunter,survival,111,55,56
quelthalas,1761,hunter,survival,96,50,46
tichondrius,1753,hunter,survival,60,30,30
zuljin,1738,hunter,survival,54,25,29
illidan,1732,hunter,survival,30,20,10
deathwing,1730,hunter,survival,42,22,20
wyrmrest-accord,1725,hunter,survival,53,34,19
kelthuzad,1712,hunter,survival,35,21,14
tichondrius,1710,hunter,survival,24,18,6
tichondrius,1709,hunter,survival,48,28,20
sargeras,1706,hunter,survival,30,18,12
area-52,1705,hunter,survival,30,18,12
frostmourne,1699,hunter,survival,48,23,25
thrall,1686,hunter,survival,30,20,10
tichondrius,1673,hunter,survival,36,20,16
stormrage,1673,hunter,survival,50,26,24
zuljin,1672,hunter,survival,45,23,22
quelthalas,1671,hunter,survival,99,48,51
rivendare,1670,hunter,survival,59,29,30
illidan,1664,hunter,survival,48,24,24
moon-guard,1661,hunter,survival,35,19,16
aggramar,1658,hunter,survival,30,20,10
emerald-dream,1658,hunter,survival,29,18,11
tichondrius,1641,hunter,survival,49,24,25
thrall,1638,hunter,survival,89,47,42
area-52,1625,hunter,survival,36,17,19
tichondrius,1623,hunter,survival,30,17,13
sargeras,1618,hunter,survival,35,22,13
darkspear,1615,hunter,survival,48,22,26
moon-guard,1604,hunter,survival,84,41,43
area-52,1602,hunter,survival,42,27,15
barthilas,1600,hunter,survival,69,37,32
senjin,1593,hunter,survival,60,26,34
sargeras,1587,hunter,survival,30,19,11
kelthuzad,1579,hunter,survival,79,46,33
wyrmrest-accord,1579,hunter,survival,130,70,60
tichondrius,1579,hunter,survival,46,20,26
moon-guard,1574,hunter,survival,45,22,23
bleeding-hollow,1569,hunter,survival,54,31,23
emerald-dream,1564,hunter,survival,38,23,15
frostmourne,1556,hunter,survival,35,18,17
azralon,1551,hunter,survival,103,58,45
nesingwary,1550,hunter,survival,42,22,20
sargeras,1541,hunter,survival,41,23,18
tichondrius,1535,hunter,survival,30,18,12
tichondrius,1531,hunter,survival,36,16,20
stormrage,1530,hunter,survival,24,16,8
moknathal,1524,hunter,survival,54,27,27
kaelthas,1520,hunter,survival,66,31,35
darkspear,1519,hunter,survival,30,16,14
moon-guard,1514,hunter,survival,42,25,17
proudmoore,1510,hunter,survival,36,16,20
haomarush,1494,hunter,survival,57,30,27
moon-guard,1491,hunter,survival,54,30,24
laughing-skull,1490,hunter,survival,52,28,24
ragnaros,1477,hunter,survival,48,24,24
frostmourne,1472,hunter,survival,39,20,19
ragnaros,1458,hunter,survival,117,54,63
ragnaros,1456,hunter,survival,42,19,23
ragnaros,1443,hunter,survival,60,31,29
ragnaros,1442,hunter,survival,35,20,15
zuljin,1439,hunter,survival,23,16,7
tichondrius,1435,hunter,survival,71,31,40
illidan,1432,hunter,survival,36,15,21
zuljin,1425,hunter,survival,24,15,9
proudmoore,1425,hunter,survival,30,15,15
kelthuzad,1425,hunter,survival,73,31,42
tichondrius,1422,hunter,survival,30,15,15
moon-guard,1422,hunter,survival,59,29,30
tichondrius,1409,hunter,survival,30,15,15
quelthalas,1409,hunter,survival,39,18,21
barthilas,1406,hunter,survival,54,30,24
tichondrius,1401,hunter,survival,49,26,23
stormreaver,1395,hunter,survival,66,28,38
sargeras,1389,hunter,survival,48,19,29
ragnaros,1385,hunter,survival,33,15,18
tol-barad,1367,hunter,survival,38,17,21
sargeras,1358,hunter,survival,60,29,31
bleeding-hollow,1354,hunter,survival,36,16,20
stormscale,1352,hunter,survival,55,19,36
tichondrius,1343,hunter,survival,18,14,4
zuljin,1343,hunter,survival,24,14,10
dark-iron,1341,hunter,survival,18,14,4
malganis,1339,hunter,survival,24,14,10
tichondrius,1339,hunter,survival,56,23,33
stormrage,1337,hunter,survival,24,15,9
frostmourne,1337,hunter,survival,36,18,18
tichondrius,1334,hunter,survival,24,14,10
kiljaeden,1329,hunter,survival,62,27,35
jubeithos,1328,hunter,survival,24,14,10
khazgoroth,1317,hunter,survival,48,28,20
black-dragonflight,1314,hunter,survival,30,14,16
stormrage,1307,hunter,survival,30,23,7
emerald-dream,1303,hunter,survival,36,20,16
gorefiend,1292,hunter,survival,31,14,17
tichondrius,1268,hunter,survival,66,30,36
quelthalas,1262,hunter,survival,30,18,12
ragnaros,1259,hunter,survival,56,28,28
queldorei,1251,hunter,survival,29,14,15
ragnaros,1247,hunter,survival,18,13,5
frostmourne,1247,hunter,survival,18,13,5
illidan,1246,hunter,survival,24,13,11
barthilas,1245,hunter,survival,30,13,17
sargeras,1223,hunter,survival,36,13,23
kargath,1213,hunter,survival,18,13,5
tichondrius,1213,hunter,survival,24,13,11
tichondrius,1213,hunter,survival,24,13,11
azralon,1203,hunter,survival,18,13,5
stormrage,1185,hunter,survival,24,13,11
tichondrius,1178,hunter,survival,46,21,25
wyrmrest-accord,1152,hunter,survival,18,12,6
azralon,1151,hunter,survival,24,12,12
illidan,1150,hunter,survival,18,12,6
tichondrius,1149,hunter,survival,18,12,6
tichondrius,1147,hunter,survival,24,12,12
proudmoore,1144,hunter,survival,24,12,12
bleeding-hollow,1141,hunter,survival,30,12,18
sargeras,1139,hunter,survival,24,12,12
emerald-dream,1138,hunter,survival,18,12,6
stormrage,1068,hunter,survival,17,12,5
stormrage,1066,hunter,survival,33,12,21
tichondrius,1056,hunter,survival,18,11,7
barthilas,1056,hunter,survival,18,11,7
nemesis,1056,hunter,survival,18,11,7
tichondrius,1056,hunter,survival,24,11,13
tichondrius,1056,hunter,survival,30,11,19
tichondrius,1055,hunter,survival,18,11,7
azralon,1055,hunter,survival,18,11,7
wyrmrest-accord,1054,hunter,survival,18,11,7
tichondrius,1054,hunter,survival,24,11,13
nemesis,1053,hunter,survival,18,11,7
hakkar,1053,hunter,survival,18,11,7
area-52,1018,hunter,survival,48,27,21
dragonblight,1001,hunter,survival,29,18,11
nesingwary,1001,hunter,survival,22,12,10
ragnaros,999,hunter,survival,21,11,10
dalaran,996,hunter,survival,29,11,18
stormrage,988,hunter,survival,17,11,6
smolderthorn,985,hunter,survival,20,11,9
azralon,970,hunter,survival,24,11,13
illidan,960,hunter,survival,12,10,2
duskwood,960,hunter,survival,18,10,8
tichondrius,960,hunter,survival,18,10,8
illidan,960,hunter,survival,24,10,14
tichondrius,960,hunter,survival,24,10,14
sargeras,960,hunter,survival,24,10,14
sargeras,959,hunter,survival,12,10,2
tichondrius,959,hunter,survival,18,10,8
bleeding-hollow,959,hunter,survival,18,10,8
tichondrius,959,hunter,survival,24,10,14
barthilas,959,hunter,survival,24,10,14
tichondrius,958,hunter,survival,18,10,8
stormrage,956,hunter,survival,18,10,8
medivh,943,hunter,survival,17,10,7
zuljin,927,hunter,survival,26,11,15
dark-iron,925,hunter,survival,32,11,21
malganis,892,hunter,survival,20,10,10
tichondrius,864,hunter,survival,12,9,3
tichondrius,864,hunter,survival,12,9,3
tichondrius,864,hunter,survival,15,10,5
thunderhorn,864,hunter,survival,18,9,9
kiljaeden,864,hunter,survival,18,9,9
tichondrius,864,hunter,survival,18,9,9
senjin,863,hunter,survival,12,9,3
drenden,863,hunter,survival,12,9,3
hyjal,863,hunter,survival,12,9,3
area-52,863,hunter,survival,12,9,3
stormrage,863,hunter,survival,15,10,5
tichondrius,863,hunter,survival,18,9,9
drakkari,863,hunter,survival,18,9,9
frostmourne,861,hunter,survival,18,9,9
frostmourne,768,hunter,survival,12,8,4
frostmourne,768,hunter,survival,12,8,4
illidan,768,hunter,survival,12,8,4
illidan,768,hunter,survival,12,8,4
illidan,768,hunter,survival,14,8,6
bleeding-hollow,768,hunter,survival,18,8,10
kelthuzad,768,hunter,survival,18,8,10
sargeras,767,hunter,survival,12,8,4
area-52,767,hunter,survival,12,8,4
azralon,767,hunter,survival,12,8,4
zuljin,767,hunter,survival,12,8,4
vashj,767,hunter,survival,12,8,4
borean-tundra,767,hunter,survival,18,8,10
azralon,767,hunter,survival,18,8,10
stormrage,767,hunter,survival,30,8,22
ragnaros,766,hunter,survival,12,8,4
wyrmrest-accord,763,hunter,survival,12,8,4
thunderlord,751,hunter,survival,12,8,4
illidan,735,hunter,survival,14,9,5
bleeding-hollow,719,hunter,survival,17,8,9
wyrmrest-accord,713,hunter,survival,23,10,13
area-52,672,hunter,survival,12,7,5
ghostlands,672,hunter,survival,12,7,5
auchindoun,672,hunter,survival,12,7,5
ragnaros,672,hunter,survival,12,7,5
sargeras,672,hunter,survival,12,7,5
frostmourne,672,hunter,survival,12,7,5
tichondrius,672,hunter,survival,12,7,5
frostmourne,672,hunter,survival,12,7,5
stormrage,672,hunter,survival,18,7,11
illidan,672,hunter,survival,18,7,11
bleeding-hollow,672,hunter,survival,18,7,11
proudmoore,672,hunter,survival,18,7,11
tichondrius,672,hunter,survival,18,7,11
zuljin,672,hunter,survival,18,7,11
emerald-dream,672,hunter,survival,24,7,17
runetotem,671,hunter,survival,15,8,7
darkspear,665,hunter,survival,12,7,5
azralon,663,hunter,survival,12,7,5
ravencrest,639,hunter,survival,17,7,10
ragnaros,638,hunter,survival,18,8,10
drakkari,638,hunter,survival,17,7,10
ragnaros,638,hunter,survival,20,8,12
nagrand,624,hunter,survival,15,7,8
stormrage,605,hunter,survival,11,7,4
ragnaros,576,hunter,survival,6,6,0
kiljaeden,576,hunter,survival,6,6,0
illidan,576,hunter,survival,10,7,3
moon-guard,576,hunter,survival,12,6,6
moon-guard,576,hunter,survival,12,6,6
frostmourne,576,hunter,survival,12,6,6
tichondrius,576,hunter,survival,12,6,6
tichondrius,576,hunter,survival,12,6,6
area-52,576,hunter,survival,12,6,6
firetree,576,hunter,survival,12,6,6
frostwolf,576,hunter,survival,12,6,6
tichondrius,576,hunter,survival,12,6,6
stormrage,576,hunter,survival,12,6,6
tichondrius,576,hunter,survival,12,6,6
dalaran,576,hunter,survival,12,6,6
area-52,576,hunter,survival,18,6,12
bloodhoof,576,hunter,survival,18,6,12
blackrock,576,hunter,survival,24,6,18
illidan,575,hunter,survival,12,6,6
ragnaros,575,hunter,survival,12,6,6
proudmoore,575,hunter,survival,12,6,6
azralon,575,hunter,survival,16,7,9
illidan,573,hunter,survival,18,6,12
ragnaros,559,hunter,survival,11,6,5
moon-guard,528,hunter,survival,9,7,2
tichondrius,526,hunter,survival,17,6,11
drenden,511,hunter,survival,11,6,5
tichondrius,480,hunter,survival,6,5,1
tichondrius,480,hunter,survival,6,5,1
sargeras,480,hunter,survival,6,5,1
nemesis,480,hunter,survival,6,5,1
emerald-dream,480,hunter,survival,6,5,1
tichondrius,480,hunter,survival,6,5,1
zuljin,480,hunter,survival,6,5,1
tichondrius,480,hunter,survival,6,5,1
khadgar,480,hunter,survival,6,5,1
madoran,480,hunter,survival,6,5,1
stormrage,480,hunter,survival,12,5,7
azralon,480,hunter,survival,12,5,7
sargeras,480,hunter,survival,12,5,7
stonemaul,480,hunter,survival,12,5,7
kalecgos,480,hunter,survival,12,5,7
vashj,480,hunter,survival,15,6,9
illidan,480,hunter,survival,18,5,13
skullcrusher,479,hunter,survival,12,5,7
moon-guard,479,hunter,survival,13,5,8
aegwynn,479,hunter,survival,18,5,13
tichondrius,448,hunter,survival,10,5,5
sargeras,416,hunter,survival,10,5,5
moon-guard,400,hunter,survival,7,5,2
tichondrius,400,hunter,survival,13,5,8
azralon,384,hunter,survival,6,4,2
bleeding-hollow,384,hunter,survival,6,4,2
illidan,384,hunter,survival,6,4,2
ragnaros,384,hunter,survival,6,4,2
tichondrius,384,hunter,survival,6,4,2
area-52,384,hunter,survival,6,4,2
moon-guard,384,hunter,survival,6,4,2
emerald-dream,384,hunter,survival,6,4,2
twisting-nether,384,hunter,survival,6,4,2
moon-guard,384,hunter,survival,6,4,2
area-52,384,hunter,survival,6,4,2
frostmourne,384,hunter,survival,6,4,2
stormrage,384,hunter,survival,6,4,2
tichondrius,384,hunter,survival,6,4,2
area-52,384,hunter,survival,6,4,2
tichondrius,384,hunter,survival,6,4,2
stormrage,384,hunter,survival,6,4,2
hyjal,384,hunter,survival,6,4,2
haomarush,384,hunter,survival,10,5,5
illidan,384,hunter,survival,12,4,8
sargeras,384,hunter,survival,12,4,8
ragnaros,384,hunter,survival,12,4,8
norgannon,384,hunter,survival,12,4,8
stormrage,384,hunter,survival,12,4,8
tichondrius,384,hunter,survival,12,4,8
stormrage,384,hunter,survival,12,4,8
illidan,384,hunter,survival,12,4,8
wyrmrest-accord,384,hunter,survival,12,4,8
illidan,384,hunter,survival,12,4,8
frostmourne,384,hunter,survival,12,4,8
antonidas,384,hunter,survival,12,4,8
illidan,384,hunter,survival,12,4,8
tichondrius,384,hunter,survival,12,4,8
nagrand,383,hunter,survival,18,4,14
tichondrius,351,hunter,survival,11,4,7
barthilas,351,hunter,survival,12,4,8
tichondrius,288,hunter,survival,6,3,3
barthilas,288,hunter,survival,6,3,3
tichondrius,288,hunter,survival,6,3,3
thunderlord,288,hunter,survival,6,3,3
quelthalas,288,hunter,survival,6,3,3
bleeding-hollow,288,hunter,survival,6,3,3
tichondrius,288,hunter,survival,6,3,3
wyrmrest-accord,288,hunter,survival,6,3,3
frostmourne,288,hunter,survival,6,3,3
nemesis,288,hunter,survival,6,3,3
bleeding-hollow,288,hunter,survival,6,3,3
tichondrius,288,hunter,survival,6,3,3
area-52,288,hunter,survival,6,3,3
tichondrius,288,hunter,survival,6,3,3
stormrage,288,hunter,survival,6,3,3
frostmourne,288,hunter,survival,6,3,3
stormrage,288,hunter,survival,6,3,3
frostmourne,288,hunter,survival,6,3,3
frostmourne,288,hunter,survival,6,3,3
tichondrius,288,hunter,survival,6,3,3
maiev,288,hunter,survival,6,3,3
ragnaros,288,hunter,survival,6,3,3
darkspear,288,hunter,survival,6,3,3
moon-guard,288,hunter,survival,6,3,3
sargeras,288,hunter,survival,6,3,3
sargeras,288,hunter,survival,6,3,3
sargeras,288,hunter,survival,6,3,3
illidan,288,hunter,survival,6,3,3
emerald-dream,288,hunter,survival,6,3,3
dalaran,288,hunter,survival,6,3,3
sargeras,288,hunter,survival,6,3,3
sargeras,288,hunter,survival,6,3,3
spinebreaker,288,hunter,survival,6,3,3
illidan,288,hunter,survival,6,3,3
ragnaros,288,hunter,survival,6,3,3
ragnaros,288,hunter,survival,6,3,3
akama,288,hunter,survival,12,3,9
blades-edge,288,hunter,survival,12,3,9
ragnaros,288,hunter,survival,12,3,9
kelthuzad,288,hunter,survival,12,3,9
stormrage,288,hunter,survival,12,3,9
ragnaros,288,hunter,survival,12,3,9
illidan,288,hunter,survival,12,3,9
feathermoon,240,hunter,survival,15,3,12
malganis,239,hunter,survival,5,3,2
azralon,239,hunter,survival,5,3,2
cenarion-circle,232,hunter,survival,14,4,10
dalaran,223,hunter,survival,8,3,5
azshara,192,hunter,survival,6,2,4
stormrage,192,hunter,survival,6,2,4
stormrage,192,hunter,survival,6,2,4
tichondrius,192,hunter,survival,6,2,4
area-52,192,hunter,survival,6,2,4
korgath,192,hunter,survival,6,2,4
ragnaros,192,hunter,survival,6,2,4
sargeras,192,hunter,survival,6,2,4
stormrage,192,hunter,survival,6,2,4
sargeras,192,hunter,survival,6,2,4
daggerspine,192,hunter,survival,6,2,4
tichondrius,192,hunter,survival,6,2,4
ragnaros,192,hunter,survival,6,2,4
bonechewer,192,hunter,survival,6,2,4
dalaran,192,hunter,survival,6,2,4
area-52,192,hunter,survival,6,2,4
malganis,192,hunter,survival,6,2,4
aggramar,192,hunter,survival,6,2,4
area-52,192,hunter,survival,6,2,4
stormrage,192,hunter,survival,6,2,4
aerie-peak,192,hunter,survival,6,2,4
frostmourne,192,hunter,survival,6,2,4
arygos,192,hunter,survival,6,2,4
tichondrius,192,hunter,survival,6,2,4
area-52,192,hunter,survival,6,2,4
tichondrius,192,hunter,survival,6,2,4
thrall,192,hunter,survival,6,2,4
tichondrius,192,hunter,survival,6,2,4
firetree,192,hunter,survival,6,2,4
azralon,192,hunter,survival,6,2,4
moon-guard,192,hunter,survival,6,2,4
tichondrius,192,hunter,survival,6,2,4
azralon,192,hunter,survival,6,2,4
frostmourne,192,hunter,survival,12,2,10
tichondrius,192,hunter,survival,12,2,10
sargeras,192,hunter,survival,12,2,10
area-52,138,hunter,survival,8,3,5
quelthalas,128,hunter,survival,4,2,2
tichondrius,128,hunter,survival,4,2,2
stormreaver,128,hunter,survival,5,2,3
emerald-dream,96,hunter,survival,6,1,5
moon-guard,96,hunter,survival,6,1,5
wyrmrest-accord,96,hunter,survival,6,1,5
tichondrius,96,hunter,survival,6,1,5
azralon,96,hunter,survival,6,1,5
tichondrius,96,hunter,survival,6,1,5
mannoroth,96,hunter,survival,6,1,5
azralon,96,hunter,survival,6,1,5
bleeding-hollow,96,hunter,survival,6,1,5
aerie-peak,96,hunter,survival,6,1,5
darrowmere,96,hunter,survival,6,1,5
thrall,96,hunter,survival,6,1,5
malganis,96,hunter,survival,6,1,5
tichondrius,79,hunter,survival,5,1,4
illidan,79,hunter,survival,5,1,4
tichondrius,31,hunter,survival,2,1,1
tichondrius,31,hunter,survival,8,1,7
shuhalo,2183,hunter,beastmastery,89,47,42
bleeding-hollow,2165,hunter,beastmastery,124,66,58
tichondrius,2049,hunter,beastmastery,88,42,46
agamaggan,2038,hunter,beastmastery,62,34,28
tichondrius,2035,hunter,beastmastery,69,34,35
ragnaros,2035,hunter,beastmastery,107,52,55
sargeras,2005,hunter,beastmastery,48,26,22
tichondrius,1998,hunter,beastmastery,81,40,41
tichondrius,1993,hunter,beastmastery,36,21,15
tichondrius,1987,hunter,beastmastery,66,41,25
illidan,1980,hunter,beastmastery,106,62,44
darkspear,1957,hunter,beastmastery,78,37,41
tichondrius,1952,hunter,beastmastery,89,44,45
anvilmar,1931,hunter,beastmastery,126,62,64
sargeras,1915,hunter,beastmastery,70,34,36
tichondrius,1911,hunter,beastmastery,54,25,29
cairne,1910,hunter,beastmastery,108,61,47
frostmourne,1903,hunter,beastmastery,39,21,18
emerald-dream,1899,hunter,beastmastery,131,60,71
illidan,1895,hunter,beastmastery,57,32,25
tichondrius,1894,hunter,beastmastery,78,40,38
tichondrius,1886,hunter,beastmastery,88,43,45
tichondrius,1885,hunter,beastmastery,50,31,19
frostmourne,1878,hunter,beastmastery,61,35,26
tichondrius,1869,hunter,beastmastery,50,27,23
kelthuzad,1868,hunter,beastmastery,116,59,57
stormrage,1867,hunter,beastmastery,104,54,50
sargeras,1862,hunter,beastmastery,72,32,40
arthas,1860,hunter,beastmastery,54,28,26
tichondrius,1855,hunter,beastmastery,44,22,22
stormrage,1849,hunter,beastmastery,47,26,21
durotan,1844,hunter,beastmastery,37,22,15
tichondrius,1843,hunter,beastmastery,54,27,27
frostmourne,1843,hunter,beastmastery,54,25,29
moon-guard,1842,hunter,beastmastery,98,58,40
kiljaeden,1839,hunter,beastmastery,65,32,33
ragnaros,1838,hunter,beastmastery,60,30,30
sargeras,1834,hunter,beastmastery,54,24,30
frostmane,1833,hunter,beastmastery,36,21,15
tichondrius,1832,hunter,beastmastery,83,36,47
ragnaros,1829,hunter,beastmastery,82,46,36
sargeras,1825,hunter,beastmastery,41,21,20
illidan,1825,hunter,beastmastery,125,60,65
quelthalas,1822,hunter,beastmastery,66,31,35
tichondrius,1820,hunter,beastmastery,59,30,29
illidan,1820,hunter,beastmastery,78,39,39
malganis,1819,hunter,beastmastery,78,40,38
tichondrius,1817,hunter,beastmastery,74,43,31
nemesis,1816,hunter,beastmastery,34,22,12
tichondrius,1815,hunter,beastmastery,69,33,36
tichondrius,1814,hunter,beastmastery,47,30,17
tichondrius,1813,hunter,beastmastery,40,25,15
barthilas,1813,hunter,beastmastery,57,28,29
stormrage,1811,hunter,beastmastery,48,22,26
dalaran,1810,hunter,beastmastery,110,61,49
tichondrius,1809,hunter,beastmastery,42,22,20
tichondrius,1805,hunter,beastmastery,68,34,34
sargeras,1804,hunter,beastmastery,48,28,20
azralon,1802,hunter,beastmastery,60,32,28
emerald-dream,1798,hunter,beastmastery,60,37,23
nemesis,1797,hunter,beastmastery,108,51,57
tichondrius,1795,hunter,beastmastery,66,27,39
tichondrius,1793,hunter,beastmastery,108,63,45
magtheridon,1791,hunter,beastmastery,111,54,57
hyjal,1775,hunter,beastmastery,48,30,18
fenris,1764,hunter,beastmastery,39,24,15
kiljaeden,1764,hunter,beastmastery,43,21,22
proudmoore,1750,hunter,beastmastery,41,28,13
zuljin,1747,hunter,beastmastery,42,27,15
ursin,1743,hunter,beastmastery,48,26,22
proudmoore,1743,hunter,beastmastery,47,21,26
tichondrius,1740,hunter,beastmastery,60,28,32
illidan,1733,hunter,beastmastery,32,20,12
darkspear,1732,hunter,beastmastery,63,39,24
greymane,1732,hunter,beastmastery,62,29,33
frostmourne,1730,hunter,beastmastery,64,30,34
tichondrius,1729,hunter,beastmastery,48,22,26
malganis,1727,hunter,beastmastery,65,39,26
frostmourne,1724,hunter,beastmastery,53,33,20
dawnbringer,1721,hunter,beastmastery,54,32,22
illidan,1721,hunter,beastmastery,124,64,60
ragnaros,1721,hunter,beastmastery,77,38,39
shadowmoon,1720,hunter,beastmastery,150,70,80
sargeras,1712,hunter,beastmastery,30,18,12
arthas,1711,hunter,beastmastery,174,86,88
frostmourne,1708,hunter,beastmastery,24,18,6
area-52,1707,hunter,beastmastery,108,55,53
lightnings-blade,1701,hunter,beastmastery,60,25,35
zuljin,1694,hunter,beastmastery,25,19,6
gurubashi,1694,hunter,beastmastery,42,21,21
tichondrius,1694,hunter,beastmastery,118,58,60
sargeras,1694,hunter,beastmastery,52,21,31
illidan,1692,hunter,beastmastery,42,25,17
tichondrius,1688,hunter,beastmastery,43,23,20
tichondrius,1687,hunter,beastmastery,35,18,17
blades-edge,1682,hunter,beastmastery,36,21,15
queldorei,1676,hunter,beastmastery,96,48,48
bleeding-hollow,1675,hunter,beastmastery,40,22,18
azgalor,1674,hunter,beastmastery,36,23,13
tichondrius,1666,hunter,beastmastery,66,34,32
tichondrius,1663,hunter,beastmastery,61,25,36
illidan,1662,hunter,beastmastery,49,26,23
anvilmar,1660,hunter,beastmastery,30,18,12
illidan,1656,hunter,beastmastery,48,29,19
sargeras,1653,hunter,beastmastery,46,20,26
quelthalas,1650,hunter,beastmastery,35,18,17
kilrogg,1647,hunter,beastmastery,155,70,85
staghelm,1646,hunter,beastmastery,38,20,18
tichondrius,1645,hunter,beastmastery,45,27,18
stormrage,1636,hunter,beastmastery,59,26,33
khazgoroth,1635,hunter,beastmastery,47,22,25
frostmourne,1634,hunter,beastmastery,103,57,46
stormrage,1633,hunter,beastmastery,41,19,22
cenarius,1627,hunter,beastmastery,36,17,19
tichondrius,1627,hunter,beastmastery,72,30,42
illidan,1624,hunter,beastmastery,24,17,7
terenas,1622,hunter,beastmastery,54,29,25
ragnaros,1618,hunter,beastmastery,36,21,15
tichondrius,1616,hunter,beastmastery,108,64,44
illidan,1616,hunter,beastmastery,42,21,21
illidan,1613,hunter,beastmastery,36,20,16
tichondrius,1613,hunter,beastmastery,36,20,16
sargeras,1611,hunter,beastmastery,102,46,56
tichondrius,1608,hunter,beastmastery,66,42,24
khazgoroth,1607,hunter,beastmastery,66,32,34
azralon,1606,hunter,beastmastery,42,18,24
tichondrius,1603,hunter,beastmastery,32,19,13
suramar,1601,hunter,beastmastery,48,26,22
boulderfist,1599,hunter,beastmastery,36,17,19
tichondrius,1599,hunter,beastmastery,36,17,19
stormrage,1598,hunter,beastmastery,36,21,15
ragnaros,1597,hunter,beastmastery,41,17,24
sargeras,1588,hunter,beastmastery,30,19,11
tichondrius,1585,hunter,beastmastery,41,23,18
garona,1585,hunter,beastmastery,45,24,21
illidan,1581,hunter,beastmastery,42,23,19
tichondrius,1578,hunter,beastmastery,72,40,32
vashj,1578,hunter,beastmastery,71,39,32
malganis,1578,hunter,beastmastery,42,18,24
bleeding-hollow,1575,hunter,beastmastery,49,24,25
dragonmaw,1575,hunter,beastmastery,175,83,92
barthilas,1573,hunter,beastmastery,36,23,13
darkspear,1569,hunter,beastmastery,31,18,13
illidan,1563,hunter,beastmastery,42,27,15
kiljaeden,1561,hunter,beastmastery,36,18,18
tichondrius,1544,hunter,beastmastery,36,25,11
sargeras,1540,hunter,beastmastery,60,39,21
moon-guard,1540,hunter,beastmastery,42,24,18
tortheldrin,1539,hunter,beastmastery,48,26,22
cairne,1539,hunter,beastmastery,42,22,20
frostmourne,1538,hunter,beastmastery,42,23,19
area-52,1531,hunter,beastmastery,79,46,33
tichondrius,1530,hunter,beastmastery,30,16,14
burning-blade,1530,hunter,beastmastery,101,48,53
tichondrius,1526,hunter,beastmastery,30,16,14
illidan,1520,hunter,beastmastery,29,19,10
thrall,1516,hunter,beastmastery,30,21,9
garona,1514,hunter,beastmastery,29,17,12
tichondrius,1511,hunter,beastmastery,84,41,43
tichondrius,1510,hunter,beastmastery,50,29,21
proudmoore,1507,hunter,beastmastery,82,39,43
drakkari,1506,hunter,beastmastery,36,16,20
destromath,1503,hunter,beastmastery,72,35,37
emerald-dream,1491,hunter,beastmastery,66,35,31
ragnaros,1491,hunter,beastmastery,42,18,24
tichondrius,1489,hunter,beastmastery,72,36,36
warsong,1487,hunter,beastmastery,41,22,19
shuhalo,1485,hunter,beastmastery,43,21,22
blades-edge,1484,hunter,beastmastery,36,22,14
korgath,1481,hunter,beastmastery,27,17,10
frostmourne,1481,hunter,beastmastery,42,18,24
darkspear,1478,hunter,beastmastery,28,17,11
area-52,1476,hunter,beastmastery,42,22,20
kiljaeden,1476,hunter,beastmastery,97,47,50
moon-guard,1474,hunter,beastmastery,66,31,35
quelthalas,1472,hunter,beastmastery,27,17,10
ragnaros,1471,hunter,beastmastery,93,56,37
thrall,1462,hunter,beastmastery,40,19,21
alexstrasza,1459,hunter,beastmastery,60,35,25
muradin,1454,hunter,beastmastery,42,22,20
barthilas,1454,hunter,beastmastery,77,35,42
nerzhul,1452,hunter,beastmastery,75,36,39
shattered-hand,1451,hunter,beastmastery,29,16,13
ragnaros,1439,hunter,beastmastery,24,15,9
zuljin,1439,hunter,beastmastery,30,15,15
drakkari,1438,hunter,beastmastery,30,16,14
tichondrius,1437,hunter,beastmastery,53,29,24
tichondrius,1437,hunter,beastmastery,36,15,21
stormrage,1436,hunter,beastmastery,35,21,14
frostmourne,1434,hunter,beastmastery,27,16,11
stormrage,1428,hunter,beastmastery,81,33,48
illidan,1426,hunter,beastmastery,23,17,6
tichondrius,1426,hunter,beastmastery,86,50,36
tichondrius,1424,hunter,beastmastery,54,24,30
tichondrius,1418,hunter,beastmastery,42,22,20
proudmoore,1416,hunter,beastmastery,48,20,28
darkspear,1413,hunter,beastmastery,24,15,9
bleeding-hollow,1403,hunter,beastmastery,30,15,15
barthilas,1402,hunter,beastmastery,41,15,26
korgath,1399,hunter,beastmastery,65,37,28
nemesis,1396,hunter,beastmastery,90,45,45
tichondrius,1396,hunter,beastmastery,42,21,21
bleeding-hollow,1392,hunter,beastmastery,36,15,21
area-52,1380,hunter,beastmastery,70,40,30
frostmourne,1375,hunter,beastmastery,59,33,26
illidan,1373,hunter,beastmastery,36,21,15
kelthuzad,1370,hunter,beastmastery,40,20,20
kelthuzad,1370,hunter,beastmastery,36,16,20
tichondrius,1369,hunter,beastmastery,60,26,34
malganis,1364,hunter,beastmastery,36,22,14
tichondrius,1359,hunter,beastmastery,35,15,20
frostmourne,1356,hunter,beastmastery,32,18,14
barthilas,1354,hunter,beastmastery,38,17,21
illidan,1341,hunter,beastmastery,24,14,10
velen,1341,hunter,beastmastery,75,35,40
illidan,1341,hunter,beastmastery,73,33,40
area-52,1340,hunter,beastmastery,41,20,21
stormrage,1339,hunter,beastmastery,30,14,16
zuljin,1336,hunter,beastmastery,66,34,32
bonechewer,1336,hunter,beastmastery,70,35,35
wyrmrest-accord,1331,hunter,beastmastery,24,15,9
illidan,1330,hunter,beastmastery,54,24,30
malganis,1328,hunter,beastmastery,108,54,54
maelstrom,1328,hunter,beastmastery,29,14,15
sargeras,1328,hunter,beastmastery,42,14,28
tichondrius,1323,hunter,beastmastery,42,20,22
sargeras,1318,hunter,beastmastery,42,18,24
stormrage,1317,hunter,beastmastery,36,17,19
frostmourne,1317,hunter,beastmastery,33,15,18
nemesis,1314,hunter,beastmastery,36,18,18
barthilas,1314,hunter,beastmastery,66,30,36
illidan,1310,hunter,beastmastery,66,32,34
area-52,1305,hunter,beastmastery,29,14,15
kirin-tor,1290,hunter,beastmastery,123,66,57
area-52,1283,hunter,beastmastery,30,14,16
quelthalas,1277,hunter,beastmastery,63,31,32
azgalor,1274,hunter,beastmastery,62,29,33
tichondrius,1270,hunter,beastmastery,30,18,12
darkspear,1270,hunter,beastmastery,36,15,21
nemesis,1266,hunter,beastmastery,24,14,10
frostmourne,1261,hunter,beastmastery,30,14,16
draenor,1247,hunter,beastmastery,125,64,61
dragonmaw,1247,hunter,beastmastery,41,20,21
area-52,1247,hunter,beastmastery,30,13,17
tichondrius,1247,hunter,beastmastery,36,13,23
skywall,1246,hunter,beastmastery,22,14,8
nemesis,1245,hunter,beastmastery,24,13,11
thunderhorn,1244,hunter,beastmastery,60,30,30
azralon,1243,hunter,beastmastery,18,13,5
tichondrius,1243,hunter,beastmastery,41,21,20
nemesis,1235,hunter,beastmastery,36,17,19
draktharon,1231,hunter,beastmastery,23,15,8
tichondrius,1231,hunter,beastmastery,30,13,17
shuhalo,1227,hunter,beastmastery,24,13,11
tortheldrin,1219,hunter,beastmastery,29,14,15
thrall,1218,hunter,beastmastery,32,13,19
darkspear,1214,hunter,beastmastery,24,14,10
moon-guard,1214,hunter,beastmastery,23,13,10
gurubashi,1214,hunter,beastmastery,36,16,20
tichondrius,1211,hunter,beastmastery,32,14,18
kiljaeden,1208,hunter,beastmastery,36,15,21
tichondrius,1198,hunter,beastmastery,23,13,10
proudmoore,1196,hunter,beastmastery,24,13,11
area-52,1190,hunter,beastmastery,29,13,16
frostmourne,1188,hunter,beastmastery,47,20,27
auchindoun,1185,hunter,beastmastery,30,15,15
frostmane,1182,hunter,beastmastery,35,15,20
area-52,1180,hunter,beastmastery,52,20,32
illidan,1160,hunter,beastmastery,55,26,29
alexstrasza,1158,hunter,beastmastery,70,28,42
khadgar,1155,hunter,beastmastery,24,13,11
ragnaros,1154,hunter,beastmastery,47,20,27
illidan,1152,hunter,beastmastery,18,12,6
frostmourne,1152,hunter,beastmastery,28,13,15
tichondrius,1151,hunter,beastmastery,24,12,12
dragonmaw,1151,hunter,beastmastery,30,12,18
malganis,1150,hunter,beastmastery,24,12,12
ragnaros,1149,hunter,beastmastery,24,12,12
illidan,1149,hunter,beastmastery,24,12,12
tichondrius,1148,hunter,beastmastery,18,12,6
tichondrius,1147,hunter,beastmastery,35,14,21
queldorei,1145,hunter,beastmastery,18,12,6
illidan,1145,hunter,beastmastery,24,12,12
thrall,1144,hunter,beastmastery,21,13,8
arygos,1141,hunter,beastmastery,24,12,12
illidan,1129,hunter,beastmastery,24,12,12
tichondrius,1127,hunter,beastmastery,24,12,12
stormrage,1127,hunter,beastmastery,24,12,12
thrall,1117,hunter,beastmastery,42,17,25
stormrage,1107,hunter,beastmastery,23,12,11
ragnaros,1097,hunter,beastmastery,24,14,10
nemesis,1094,hunter,beastmastery,23,12,11
aerie-peak,1085,hunter,beastmastery,27,12,15
stormreaver,1073,hunter,beastmastery,72,37,35
malganis,1071,hunter,beastmastery,30,14,16
tichondrius,1060,hunter,beastmastery,20,12,8
azralon,1056,hunter,beastmastery,18,11,7
tichondrius,1055,hunter,beastmastery,18,11,7
fizzcrank,1055,hunter,beastmastery,18,11,7
stormrage,1054,hunter,beastmastery,12,11,1
tichondrius,1054,hunter,beastmastery,18,11,7
emerald-dream,1054,hunter,beastmastery,18,11,7
arathor,1054,hunter,beastmastery,18,11,7
illidan,1054,hunter,beastmastery,30,11,19
malygos,1053,hunter,beastmastery,18,11,7
agamaggan,1053,hunter,beastmastery,18,11,7
draka,1051,hunter,beastmastery,24,11,13
nathrezim,1051,hunter,beastmastery,24,11,13
ragnaros,1050,hunter,beastmastery,18,11,7
area-52,1050,hunter,beastmastery,22,12,10
wyrmrest-accord,1050,hunter,beastmastery,24,11,13
malganis,1047,hunter,beastmastery,12,11,1
korgath,1047,hunter,beastmastery,24,11,13
draktharon,1047,hunter,beastmastery,25,11,14
drakkari,1047,hunter,beastmastery,30,11,19
frostmourne,1046,hunter,beastmastery,24,11,13
moon-guard,1045,hunter,beastmastery,24,11,13
barthilas,1044,hunter,beastmastery,18,11,7
moon-guard,1044,hunter,beastmastery,23,12,11
altar-of-storms,1043,hunter,beastmastery,18,11,7
tichondrius,1042,hunter,beastmastery,30,11,19
winterhoof,1040,hunter,beastmastery,29,13,16
lightninghoof,1035,hunter,beastmastery,53,18,35
quelthalas,1032,hunter,beastmastery,24,11,13
cenarion-circle,1032,hunter,beastmastery,30,11,19
dentarg,1030,hunter,beastmastery,18,11,7
baelgun,1026,hunter,beastmastery,75,34,41
tichondrius,1023,hunter,beastmastery,17,11,6
illidan,1020,hunter,beastmastery,18,11,7
azralon,1016,hunter,beastmastery,24,15,9
azgalor,1011,hunter,beastmastery,31,12,19
illidan,1007,hunter,beastmastery,29,11,18
norgannon,1001,hunter,beastmastery,20,12,8
silver-hand,1001,hunter,beastmastery,51,27,24
emerald-dream,996,hunter,beastmastery,108,53,55
tichondrius,960,hunter,beastmastery,12,10,2
tichondrius,960,hunter,beastmastery,16,11,5
tichondrius,960,hunter,beastmastery,18,10,8
tichondrius,960,hunter,beastmastery,18,10,8
hyjal,960,hunter,beastmastery,18,10,8
illidan,960,hunter,beastmastery,18,10,8
tichondrius,960,hunter,beastmastery,18,10,8
tichondrius,960,hunter,beastmastery,18,10,8
aerie-peak,960,hunter,beastmastery,18,10,8
tichondrius,960,hunter,beastmastery,18,10,8
malganis,960,hunter,beastmastery,21,11,10
frostmourne,960,hunter,beastmastery,24,10,14
sargeras,960,hunter,beastmastery,24,10,14
illidan,960,hunter,beastmastery,24,10,14
illidan,959,hunter,beastmastery,16,11,5
bleeding-hollow,959,hunter,beastmastery,18,10,8
illidan,959,hunter,beastmastery,18,10,8
tichondrius,959,hunter,beastmastery,18,10,8
aggramar,959,hunter,beastmastery,18,10,8
illidan,959,hunter,beastmastery,18,10,8
destromath,959,hunter,beastmastery,19,10,9
tichondrius,959,hunter,beastmastery,24,10,14
ragnaros,959,hunter,beastmastery,24,10,14
tichondrius,959,hunter,beastmastery,24,10,14
illidan,959,hunter,beastmastery,24,10,14
moon-guard,959,hunter,beastmastery,24,10,14
kalecgos,958,hunter,beastmastery,18,10,8
wildhammer,958,hunter,beastmastery,18,10,8
kelthuzad,958,hunter,beastmastery,18,10,8
ragnaros,957,hunter,beastmastery,24,10,14
azralon,957,hunter,beastmastery,24,10,14
tichondrius,956,hunter,beastmastery,24,10,14
tichondrius,954,hunter,beastmastery,24,10,14
khazgoroth,951,hunter,beastmastery,18,10,8
moon-guard,951,hunter,beastmastery,24,10,14
andorhal,950,hunter,beastmastery,24,10,14
area-52,948,hunter,beastmastery,24,10,14
cairne,943,hunter,beastmastery,24,11,13
stormrage,927,hunter,beastmastery,20,11,9
earthen-ring,915,hunter,beastmastery,35,10,25
tichondrius,907,hunter,beastmastery,21,10,11
proudmoore,905,hunter,beastmastery,29,11,18
sargeras,899,hunter,beastmastery,23,10,13
kelthuzad,888,hunter,beastmastery,17,10,7
tichondrius,869,hunter,beastmastery,44,17,27
bleeding-hollow,864,hunter,beastmastery,12,9,3
illidan,864,hunter,beastmastery,12,9,3
sargeras,864,hunter,beastmastery,12,9,3
tichondrius,864,hunter,beastmastery,18,9,9
sargeras,864,hunter,beastmastery,18,9,9
frostmourne,864,hunter,beastmastery,18,9,9
drenden,864,hunter,beastmastery,18,9,9
illidan,864,hunter,beastmastery,18,9,9
bleeding-hollow,864,hunter,beastmastery,18,9,9
elune,864,hunter,beastmastery,18,9,9
sargeras,864,hunter,beastmastery,18,9,9
tichondrius,864,hunter,beastmastery,18,9,9
malganis,864,hunter,beastmastery,24,9,15
kiljaeden,863,hunter,beastmastery,12,9,3
moon-guard,863,hunter,beastmastery,12,9,3
moon-guard,863,hunter,beastmastery,12,9,3
quelthalas,863,hunter,beastmastery,18,9,9
moon-guard,863,hunter,beastmastery,18,9,9
frostmourne,863,hunter,beastmastery,18,9,9
sargeras,863,hunter,beastmastery,24,9,15
zuljin,863,hunter,beastmastery,30,9,21
tichondrius,862,hunter,beastmastery,12,9,3
tichondrius,862,hunter,beastmastery,18,9,9
stormscale,862,hunter,beastmastery,18,9,9
tichondrius,861,hunter,beastmastery,12,9,3
dalaran,861,hunter,beastmastery,24,9,15
malganis,860,hunter,beastmastery,12,9,3
tichondrius,860,hunter,beastmastery,18,9,9
nerzhul,860,hunter,beastmastery,30,9,21
azralon,860,hunter,beastmastery,36,9,27
tichondrius,859,hunter,beastmastery,18,9,9
khadgar,858,hunter,beastmastery,24,9,15
bleeding-hollow,856,hunter,beastmastery,12,9,3
kaelthas,856,hunter,beastmastery,18,9,9
daggerspine,855,hunter,beastmastery,24,9,15
malganis,854,hunter,beastmastery,24,9,15
sargeras,853,hunter,beastmastery,22,10,12
emerald-dream,844,hunter,beastmastery,12,9,3
emerald-dream,830,hunter,beastmastery,17,9,8
mannoroth,828,hunter,beastmastery,17,9,8
kiljaeden,814,hunter,beastmastery,29,9,20
alexstrasza,811,hunter,beastmastery,11,9,2
ragnaros,768,hunter,beastmastery,12,8,4
area-52,768,hunter,beastmastery,12,8,4
illidan,768,hunter,beastmastery,12,8,4
stormreaver,768,hunter,beastmastery,12,8,4
sargeras,768,hunter,beastmastery,12,8,4
illidan,768,hunter,beastmastery,12,8,4
tichondrius,768,hunter,beastmastery,15,9,6
frostmourne,768,hunter,beastmastery,18,8,10
tichondrius,768,hunter,beastmastery,18,8,10
sargeras,768,hunter,beastmastery,18,8,10
tichondrius,768,hunter,beastmastery,18,8,10
tichondrius,768,hunter,beastmastery,18,8,10
agamaggan,768,hunter,beastmastery,18,8,10
zuljin,768,hunter,beastmastery,18,8,10
sargeras,768,hunter,beastmastery,18,8,10
quelthalas,768,hunter,beastmastery,24,8,16
frostmourne,767,hunter,beastmastery,12,8,4
emerald-dream,767,hunter,beastmastery,12,8,4
tichondrius,767,hunter,beastmastery,12,8,4
illidan,767,hunter,beastmastery,12,8,4
azralon,767,hunter,beastmastery,12,8,4
saurfang,767,hunter,beastmastery,15,9,6
sargeras,767,hunter,beastmastery,18,8,10
proudmoore,767,hunter,beastmastery,18,8,10
stormrage,767,hunter,beastmastery,18,8,10
sargeras,767,hunter,beastmastery,18,8,10
blackrock,767,hunter,beastmastery,18,8,10
lightbringer,767,hunter,beastmastery,18,8,10
azjolnerub,766,hunter,beastmastery,12,8,4
deathwing,766,hunter,beastmastery,18,8,10
tichondrius,765,hunter,beastmastery,12,8,4
tichondrius,765,hunter,beastmastery,16,9,7
illidan,764,hunter,beastmastery,18,8,10
tichondrius,762,hunter,beastmastery,18,8,10
whisperwind,760,hunter,beastmastery,27,9,18
shuhalo,759,hunter,beastmastery,36,8,28
skullcrusher,758,hunter,beastmastery,24,8,16
doomhammer,757,hunter,beastmastery,18,8,10
aggramar,733,hunter,beastmastery,17,8,9
tichondrius,720,hunter,beastmastery,15,8,7
drenden,715,hunter,beastmastery,15,8,7
hyjal,711,hunter,beastmastery,15,9,6
area-52,704,hunter,beastmastery,20,9,11
nordrassil,703,hunter,beastmastery,14,8,6
tichondrius,687,hunter,beastmastery,11,8,3
sargeras,672,hunter,beastmastery,12,7,5
malganis,672,hunter,beastmastery,12,7,5
malganis,672,hunter,beastmastery,12,7,5
barthilas,672,hunter,beastmastery,12,7,5
aggramar,672,hunter,beastmastery,12,7,5
area-52,672,hunter,beastmastery,12,7,5
area-52,672,hunter,beastmastery,12,7,5
emerald-dream,672,hunter,beastmastery,12,7,5
saurfang,672,hunter,beastmastery,12,7,5
area-52,672,hunter,beastmastery,12,7,5
dalaran,672,hunter,beastmastery,12,7,5
dalaran,672,hunter,beastmastery,12,7,5
arthas,672,hunter,beastmastery,12,7,5
tichondrius,672,hunter,beastmastery,12,7,5
malganis,672,hunter,beastmastery,12,7,5
tichondrius,672,hunter,beastmastery,12,7,5
frostwolf,672,hunter,beastmastery,12,7,5
tichondrius,672,hunter,beastmastery,12,7,5
area-52,672,hunter,beastmastery,12,7,5
firetree,672,hunter,beastmastery,12,7,5
moon-guard,672,hunter,beastmastery,12,7,5
nazjatar,672,hunter,beastmastery,12,7,5
illidan,672,hunter,beastmastery,12,7,5
illidan,672,hunter,beastmastery,12,7,5
tichondrius,672,hunter,beastmastery,12,7,5
zuluhed,672,hunter,beastmastery,12,7,5
lightnings-blade,672,hunter,beastmastery,12,7,5
sentinels,672,hunter,beastmastery,12,7,5
kiljaeden,672,hunter,beastmastery,12,7,5
hyjal,672,hunter,beastmastery,12,7,5
eredar,672,hunter,beastmastery,15,7,8
malganis,672,hunter,beastmastery,18,7,11
ragnaros,672,hunter,beastmastery,18,7,11
area-52,672,hunter,beastmastery,18,7,11
illidan,672,hunter,beastmastery,18,7,11
tichondrius,672,hunter,beastmastery,18,7,11
ragnaros,672,hunter,beastmastery,18,7,11
stormrage,672,hunter,beastmastery,18,7,11
proudmoore,672,hunter,beastmastery,21,8,13
sargeras,672,hunter,beastmastery,30,7,23
quelthalas,671,hunter,beastmastery,12,7,5
emerald-dream,671,hunter,beastmastery,12,7,5
baelgun,671,hunter,beastmastery,12,7,5
perenolde,671,hunter,beastmastery,12,7,5
stormrage,671,hunter,beastmastery,12,7,5
blood-furnace,671,hunter,beastmastery,12,7,5
borean-tundra,671,hunter,beastmastery,12,7,5
stormrage,671,hunter,beastmastery,12,7,5
bleeding-hollow,671,hunter,beastmastery,12,7,5
illidan,671,hunter,beastmastery,18,7,11
wyrmrest-accord,671,hunter,beastmastery,18,7,11
thrall,671,hunter,beastmastery,18,7,11
tichondrius,671,hunter,beastmastery,18,7,11
tichondrius,670,hunter,beastmastery,16,8,8
hellscream,670,hunter,beastmastery,18,7,11
kelthuzad,670,hunter,beastmastery,18,7,11
borean-tundra,670,hunter,beastmastery,24,7,17
stormrage,669,hunter,beastmastery,18,7,11
azralon,669,hunter,beastmastery,18,7,11
darkspear,666,hunter,beastmastery,12,7,5
illidan,666,hunter,beastmastery,18,7,11
tichondrius,663,hunter,beastmastery,27,8,19
burning-blade,659,hunter,beastmastery,12,7,5
area-52,657,hunter,beastmastery,21,8,13
illidan,623,hunter,beastmastery,15,8,7
tichondrius,608,hunter,beastmastery,16,7,9
hyjal,607,hunter,beastmastery,11,7,4
cenarius,604,hunter,beastmastery,14,7,7
tichondrius,576,hunter,beastmastery,6,6,0
area-52,576,hunter,beastmastery,6,6,0
area-52,576,hunter,beastmastery,6,6,0
icecrown,576,hunter,beastmastery,6,6,0
illidan,576,hunter,beastmastery,6,6,0
zuljin,576,hunter,beastmastery,6,6,0
illidan,576,hunter,beastmastery,6,6,0
sargeras,576,hunter,beastmastery,12,6,6
quelthalas,576,hunter,beastmastery,12,6,6
zuljin,576,hunter,beastmastery,12,6,6
zuljin,576,hunter,beastmastery,12,6,6
tortheldrin,576,hunter,beastmastery,12,6,6
barthilas,576,hunter,beastmastery,12,6,6
lightbringer,576,hunter,beastmastery,12,6,6
tichondrius,576,hunter,beastmastery,12,6,6
thorium-brotherhood,576,hunter,beastmastery,12,6,6
burning-legion,576,hunter,beastmastery,12,6,6
gorefiend,576,hunter,beastmastery,12,6,6
quelthalas,576,hunter,beastmastery,12,6,6
ragnaros,576,hunter,beastmastery,12,6,6
kelthuzad,576,hunter,beastmastery,12,6,6
tichondrius,576,hunter,beastmastery,12,6,6
frostmourne,576,hunter,beastmastery,12,6,6
wyrmrest-accord,576,hunter,beastmastery,12,6,6
dalaran,576,hunter,beastmastery,12,6,6
thrall,576,hunter,beastmastery,12,6,6
tichondrius,576,hunter,beastmastery,12,6,6
azralon,576,hunter,beastmastery,12,6,6
stormrage,576,hunter,beastmastery,12,6,6
sargeras,576,hunter,beastmastery,12,6,6
stormrage,576,hunter,beastmastery,12,6,6
aegwynn,576,hunter,beastmastery,12,6,6
vashj,576,hunter,beastmastery,12,6,6
terokkar,576,hunter,beastmastery,12,6,6
ragnaros,576,hunter,beastmastery,16,7,9
boulderfist,576,hunter,beastmastery,17,6,11
bleeding-hollow,576,hunter,beastmastery,18,6,12
malganis,576,hunter,beastmastery,18,6,12
tichondrius,576,hunter,beastmastery,18,6,12
tichondrius,576,hunter,beastmastery,18,6,12
frostmourne,576,hunter,beastmastery,18,6,12
sargeras,576,hunter,beastmastery,24,6,18
bleeding-hollow,576,hunter,beastmastery,24,6,18
tichondrius,576,hunter,beastmastery,24,6,18
darkspear,575,hunter,beastmastery,6,6,0
darkspear,575,hunter,beastmastery,12,6,6
malganis,575,hunter,beastmastery,12,6,6
area-52,575,hunter,beastmastery,12,6,6
stormrage,575,hunter,beastmastery,12,6,6
drenden,575,hunter,beastmastery,18,6,12
wyrmrest-accord,575,hunter,beastmastery,18,6,12
destromath,575,hunter,beastmastery,18,6,12
area-52,575,hunter,beastmastery,18,6,12
agamaggan,574,hunter,beastmastery,12,6,6
aegwynn,574,hunter,beastmastery,12,6,6
ragnaros,574,hunter,beastmastery,18,6,12
bleeding-hollow,573,hunter,beastmastery,12,6,6
gallywix,573,hunter,beastmastery,18,6,12
tichondrius,572,hunter,beastmastery,12,6,6
borean-tundra,572,hunter,beastmastery,12,6,6
emerald-dream,566,hunter,beastmastery,12,6,6
tichondrius,544,hunter,beastmastery,22,6,16
tichondrius,521,hunter,beastmastery,15,7,8
area-52,512,hunter,beastmastery,10,6,4
tichondrius,480,hunter,beastmastery,6,5,1
quelthalas,480,hunter,beastmastery,6,5,1
area-52,480,hunter,beastmastery,6,5,1
tichondrius,480,hunter,beastmastery,6,5,1
area-52,480,hunter,beastmastery,6,5,1
bleeding-hollow,480,hunter,beastmastery,6,5,1
tichondrius,480,hunter,beastmastery,6,5,1
sargeras,480,hunter,beastmastery,6,5,1
sargeras,480,hunter,beastmastery,6,5,1
lightbringer,480,hunter,beastmastery,6,5,1
alterac-mountains,480,hunter,beastmastery,6,5,1
kilrogg,480,hunter,beastmastery,6,5,1
moon-guard,480,hunter,beastmastery,6,5,1
moon-guard,480,hunter,beastmastery,6,5,1
frostmourne,480,hunter,beastmastery,6,5,1
dalaran,480,hunter,beastmastery,6,5,1
sargeras,480,hunter,beastmastery,6,5,1
frostmourne,480,hunter,beastmastery,6,5,1
sargeras,480,hunter,beastmastery,6,5,1
sargeras,480,hunter,beastmastery,6,5,1
arygos,480,hunter,beastmastery,12,5,7
aggramar,480,hunter,beastmastery,12,5,7
tichondrius,480,hunter,beastmastery,12,5,7
quelthalas,480,hunter,beastmastery,12,5,7
zuljin,480,hunter,beastmastery,12,5,7
tichondrius,480,hunter,beastmastery,12,5,7
tichondrius,480,hunter,beastmastery,12,5,7
kiljaeden,480,hunter,beastmastery,12,5,7
azjolnerub,480,hunter,beastmastery,12,5,7
tichondrius,480,hunter,beastmastery,12,5,7
stormrage,480,hunter,beastmastery,12,5,7
destromath,480,hunter,beastmastery,12,5,7
agamaggan,480,hunter,beastmastery,12,5,7
moon-guard,480,hunter,beastmastery,12,5,7
ragnaros,480,hunter,beastmastery,12,5,7
illidan,480,hunter,beastmastery,12,5,7
stormrage,480,hunter,beastmastery,12,5,7
malorne,480,hunter,beastmastery,12,5,7
stormrage,480,hunter,beastmastery,12,5,7
proudmoore,480,hunter,beastmastery,12,5,7
kelthuzad,480,hunter,beastmastery,12,5,7
illidan,480,hunter,beastmastery,12,5,7
bleeding-hollow,480,hunter,beastmastery,12,5,7
emerald-dream,480,hunter,beastmastery,12,5,7
azralon,480,hunter,beastmastery,12,5,7
zuljin,480,hunter,beastmastery,12,5,7
emerald-dream,480,hunter,beastmastery,12,5,7
dragonmaw,480,hunter,beastmastery,14,5,9
nemesis,480,hunter,beastmastery,18,5,13
malganis,480,hunter,beastmastery,18,5,13
bleeding-hollow,480,hunter,beastmastery,18,5,13
tichondrius,480,hunter,beastmastery,18,5,13
area-52,479,hunter,beastmastery,6,5,1
malganis,479,hunter,beastmastery,6,5,1
bladefist,479,hunter,beastmastery,6,5,1
ragnaros,479,hunter,beastmastery,6,5,1
azralon,479,hunter,beastmastery,12,5,7
nerzhul,479,hunter,beastmastery,12,5,7
quelthalas,479,hunter,beastmastery,12,5,7
barthilas,479,hunter,beastmastery,12,5,7
magtheridon,479,hunter,beastmastery,18,5,13
muradin,477,hunter,beastmastery,12,5,7
tichondrius,448,hunter,beastmastery,10,5,5
zuluhed,447,hunter,beastmastery,11,5,6
frostwolf,447,hunter,beastmastery,11,5,6
korgath,447,hunter,beastmastery,11,5,6
tichondrius,447,hunter,beastmastery,11,5,6
korialstrasz,447,hunter,beastmastery,19,6,13
azjolnerub,431,hunter,beastmastery,11,5,6
burning-legion,431,hunter,beastmastery,11,5,6
ragnaros,431,hunter,beastmastery,11,5,6
bleeding-hollow,431,hunter,beastmastery,17,5,12
fizzcrank,415,hunter,beastmastery,11,5,6
zuljin,415,hunter,beastmastery,11,5,6
dalaran,397,hunter,beastmastery,7,5,2
sargeras,384,hunter,beastmastery,6,4,2
sargeras,384,hunter,beastmastery,6,4,2
stormrage,384,hunter,beastmastery,6,4,2
tichondrius,384,hunter,beastmastery,6,4,2
zuluhed,384,hunter,beastmastery,6,4,2
stormrage,384,hunter,beastmastery,6,4,2
tichondrius,384,hunter,beastmastery,6,4,2
kelthuzad,384,hunter,beastmastery,6,4,2
blackrock,384,hunter,beastmastery,6,4,2
tichondrius,384,hunter,beastmastery,6,4,2
stormrage,384,hunter,beastmastery,6,4,2
stormrage,384,hunter,beastmastery,6,4,2
area-52,384,hunter,beastmastery,6,4,2
hyjal,384,hunter,beastmastery,6,4,2
stormreaver,384,hunter,beastmastery,6,4,2
illidan,384,hunter,beastmastery,6,4,2
dalaran,384,hunter,beastmastery,6,4,2
sargeras,384,hunter,beastmastery,6,4,2
bonechewer,384,hunter,beastmastery,6,4,2
sargeras,384,hunter,beastmastery,6,4,2
tichondrius,384,hunter,beastmastery,6,4,2
dalaran,384,hunter,beastmastery,6,4,2
icecrown,384,hunter,beastmastery,6,4,2
illidan,384,hunter,beastmastery,6,4,2
kelthuzad,384,hunter,beastmastery,6,4,2
thrall,384,hunter,beastmastery,6,4,2
thunderlord,384,hunter,beastmastery,6,4,2
ysera,384,hunter,beastmastery,6,4,2
illidan,384,hunter,beastmastery,6,4,2
trollbane,384,hunter,beastmastery,6,4,2
destromath,384,hunter,beastmastery,6,4,2
stormrage,384,hunter,beastmastery,6,4,2
frostwolf,384,hunter,beastmastery,6,4,2
moon-guard,384,hunter,beastmastery,6,4,2
tichondrius,384,hunter,beastmastery,6,4,2
tichondrius,384,hunter,beastmastery,6,4,2
frostmourne,384,hunter,beastmastery,6,4,2
zuljin,384,hunter,beastmastery,6,4,2
tichondrius,384,hunter,beastmastery,6,4,2
moon-guard,384,hunter,beastmastery,6,4,2
area-52,384,hunter,beastmastery,6,4,2
area-52,384,hunter,beastmastery,6,4,2
frostmourne,384,hunter,beastmastery,6,4,2
proudmoore,384,hunter,beastmastery,8,4,4
quelthalas,384,hunter,beastmastery,10,4,6
illidan,384,hunter,beastmastery,12,4,8
khadgar,384,hunter,beastmastery,12,4,8
tichondrius,384,hunter,beastmastery,12,4,8
alexstrasza,384,hunter,beastmastery,12,4,8
bloodscalp,384,hunter,beastmastery,12,4,8
boulderfist,384,hunter,beastmastery,12,4,8
tichondrius,384,hunter,beastmastery,12,4,8
akama,384,hunter,beastmastery,12,4,8
illidan,384,hunter,beastmastery,12,4,8
lothar,384,hunter,beastmastery,12,4,8
area-52,384,hunter,beastmastery,12,4,8
bleeding-hollow,384,hunter,beastmastery,12,4,8
kelthuzad,384,hunter,beastmastery,12,4,8
tichondrius,384,hunter,beastmastery,12,4,8
area-52,384,hunter,beastmastery,12,4,8
malganis,384,hunter,beastmastery,12,4,8
nagrand,384,hunter,beastmastery,12,4,8
azralon,384,hunter,beastmastery,12,4,8
nagrand,384,hunter,beastmastery,12,4,8
stormrage,384,hunter,beastmastery,12,4,8
area-52,384,hunter,beastmastery,12,4,8
stormrage,384,hunter,beastmastery,12,4,8
malganis,384,hunter,beastmastery,12,4,8
proudmoore,384,hunter,beastmastery,12,4,8
stormrage,384,hunter,beastmastery,12,4,8
malganis,384,hunter,beastmastery,12,4,8
nordrassil,384,hunter,beastmastery,12,4,8
stormrage,384,hunter,beastmastery,12,4,8
tichondrius,384,hunter,beastmastery,15,4,11
frostmourne,384,hunter,beastmastery,18,4,14
tichondrius,384,hunter,beastmastery,18,4,14
arthas,384,hunter,beastmastery,23,4,19
drakkari,383,hunter,beastmastery,6,4,2
bonechewer,383,hunter,beastmastery,6,4,2
drakthul,383,hunter,beastmastery,6,4,2
emerald-dream,383,hunter,beastmastery,6,4,2
mannoroth,383,hunter,beastmastery,12,4,8
ragnaros,383,hunter,beastmastery,12,4,8
azshara,383,hunter,beastmastery,12,4,8
azralon,383,hunter,beastmastery,12,4,8
illidan,383,hunter,beastmastery,12,4,8
tichondrius,383,hunter,beastmastery,12,4,8
stormrage,383,hunter,beastmastery,13,4,9
bleeding-hollow,382,hunter,beastmastery,12,4,8
dalaran,382,hunter,beastmastery,14,4,10
bleeding-hollow,377,hunter,beastmastery,11,6,5
chogall,351,hunter,beastmastery,11,4,7
frostmourne,334,hunter,beastmastery,11,4,7
kelthuzad,319,hunter,beastmastery,5,4,1
quelthalas,319,hunter,beastmastery,14,4,10
zuljin,288,hunter,beastmastery,6,3,3
warsong,288,hunter,beastmastery,6,3,3
moon-guard,288,hunter,beastmastery,6,3,3
the-scryers,288,hunter,beastmastery,6,3,3
ragnaros,288,hunter,beastmastery,6,3,3
area-52,288,hunter,beastmastery,6,3,3
proudmoore,288,hunter,beastmastery,6,3,3
gilneas,288,hunter,beastmastery,6,3,3
ragnaros,288,hunter,beastmastery,6,3,3
area-52,288,hunter,beastmastery,6,3,3
frostmourne,288,hunter,beastmastery,6,3,3
proudmoore,288,hunter,beastmastery,6,3,3
bloodhoof,288,hunter,beastmastery,6,3,3
proudmoore,288,hunter,beastmastery,6,3,3
bloodhoof,288,hunter,beastmastery,6,3,3
khazgoroth,288,hunter,beastmastery,6,3,3
malorne,288,hunter,beastmastery,6,3,3
tichondrius,288,hunter,beastmastery,6,3,3
emerald-dream,288,hunter,beastmastery,6,3,3
skullcrusher,288,hunter,beastmastery,6,3,3
thrall,288,hunter,beastmastery,6,3,3
area-52,288,hunter,beastmastery,6,3,3
darkspear,288,hunter,beastmastery,6,3,3
thunderlord,288,hunter,beastmastery,6,3,3
tichondrius,288,hunter,beastmastery,6,3,3
blades-edge,288,hunter,beastmastery,6,3,3
sargeras,288,hunter,beastmastery,6,3,3
tichondrius,288,hunter,beastmastery,6,3,3
uldum,288,hunter,beastmastery,6,3,3
dalaran,288,hunter,beastmastery,6,3,3
aerie-peak,288,hunter,beastmastery,6,3,3
tichondrius,288,hunter,beastmastery,6,3,3
sargeras,288,hunter,beastmastery,6,3,3
illidan,288,hunter,beastmastery,6,3,3
illidan,288,hunter,beastmastery,6,3,3
wyrmrest-accord,288,hunter,beastmastery,6,3,3
stormrage,288,hunter,beastmastery,6,3,3
stormrage,288,hunter,beastmastery,6,3,3
tichondrius,288,hunter,beastmastery,6,3,3
wyrmrest-accord,288,hunter,beastmastery,6,3,3
moon-guard,288,hunter,beastmastery,6,3,3
emerald-dream,288,hunter,beastmastery,6,3,3
illidan,288,hunter,beastmastery,6,3,3
nemesis,288,hunter,beastmastery,6,3,3
shadowsong,288,hunter,beastmastery,6,3,3
sargeras,288,hunter,beastmastery,6,3,3
skullcrusher,288,hunter,beastmastery,6,3,3
the-underbog,288,hunter,beastmastery,6,3,3
mugthol,288,hunter,beastmastery,6,3,3
kelthuzad,288,hunter,beastmastery,6,3,3
tichondrius,288,hunter,beastmastery,6,3,3
antonidas,288,hunter,beastmastery,6,3,3
jubeithos,288,hunter,beastmastery,6,3,3
chromaggus,288,hunter,beastmastery,6,3,3
quelthalas,288,hunter,beastmastery,6,3,3
malganis,288,hunter,beastmastery,6,3,3
muradin,288,hunter,beastmastery,6,3,3
area-52,288,hunter,beastmastery,6,3,3
bleeding-hollow,288,hunter,beastmastery,6,3,3
ragnaros,288,hunter,beastmastery,6,3,3
azralon,288,hunter,beastmastery,6,3,3
illidan,288,hunter,beastmastery,6,3,3
stormrage,288,hunter,beastmastery,6,3,3
illidan,288,hunter,beastmastery,6,3,3
stormrage,288,hunter,beastmastery,6,3,3
emerald-dream,288,hunter,beastmastery,6,3,3
stormrage,288,hunter,beastmastery,6,3,3
stormrage,288,hunter,beastmastery,6,3,3
illidan,288,hunter,beastmastery,6,3,3
maiev,288,hunter,beastmastery,9,3,6
cairne,288,hunter,beastmastery,10,3,7
frostmourne,288,hunter,beastmastery,11,3,8
ragnaros,288,hunter,beastmastery,12,3,9
caelestrasz,288,hunter,beastmastery,12,3,9
frostmourne,288,hunter,beastmastery,12,3,9
gallywix,288,hunter,beastmastery,12,3,9
amanthul,288,hunter,beastmastery,12,3,9
moon-guard,288,hunter,beastmastery,12,3,9
kelthuzad,288,hunter,beastmastery,12,3,9
zuljin,288,hunter,beastmastery,12,3,9
quelthalas,288,hunter,beastmastery,12,3,9
dark-iron,288,hunter,beastmastery,12,3,9
sargeras,288,hunter,beastmastery,12,3,9
nemesis,288,hunter,beastmastery,12,3,9
lightbringer,288,hunter,beastmastery,12,3,9
veknilash,288,hunter,beastmastery,12,3,9
sargeras,288,hunter,beastmastery,12,3,9
nerzhul,288,hunter,beastmastery,12,3,9
laughing-skull,288,hunter,beastmastery,12,3,9
emerald-dream,288,hunter,beastmastery,12,3,9
ragnaros,288,hunter,beastmastery,12,3,9
khadgar,288,hunter,beastmastery,18,3,15
lightnings-blade,287,hunter,beastmastery,6,3,3
suramar,287,hunter,beastmastery,12,3,9
blades-edge,285,hunter,beastmastery,12,3,9
ragnaros,281,hunter,beastmastery,14,5,9
destromath,271,hunter,beastmastery,11,3,8
azgalor,255,hunter,beastmastery,8,4,4
tichondrius,255,hunter,beastmastery,9,4,5
blood-furnace,255,hunter,beastmastery,11,3,8
hydraxis,240,hunter,beastmastery,15,3,12
tichondrius,239,hunter,beastmastery,5,3,2
stormrage,234,hunter,beastmastery,17,6,11
tichondrius,223,hunter,beastmastery,8,3,5
zuljin,192,hunter,beastmastery,4,3,1
zuljin,192,hunter,beastmastery,6,2,4
zuljin,192,hunter,beastmastery,6,2,4
tichondrius,192,hunter,beastmastery,6,2,4
tichondrius,192,hunter,beastmastery,6,2,4
stormrage,192,hunter,beastmastery,6,2,4
tichondrius,192,hunter,beastmastery,6,2,4
illidan,192,hunter,beastmastery,6,2,4
tichondrius,192,hunter,beastmastery,6,2,4
tichondrius,192,hunter,beastmastery,6,2,4
cenarius,192,hunter,beastmastery,6,2,4
the-forgotten-coast,192,hunter,beastmastery,6,2,4
demon-soul,192,hunter,beastmastery,6,2,4
kelthuzad,192,hunter,beastmastery,6,2,4
tichondrius,192,hunter,beastmastery,6,2,4
blackrock,192,hunter,beastmastery,6,2,4
stormrage,192,hunter,beastmastery,6,2,4
malganis,192,hunter,beastmastery,6,2,4
area-52,192,hunter,beastmastery,6,2,4
tichondrius,192,hunter,beastmastery,6,2,4
nerzhul,192,hunter,beastmastery,6,2,4
nemesis,192,hunter,beastmastery,6,2,4
kiljaeden,192,hunter,beastmastery,6,2,4
stormrage,192,hunter,beastmastery,6,2,4
azjolnerub,192,hunter,beastmastery,6,2,4
illidan,192,hunter,beastmastery,6,2,4
stormrage,192,hunter,beastmastery,6,2,4
drenden,192,hunter,beastmastery,6,2,4
tichondrius,192,hunter,beastmastery,6,2,4
warsong,192,hunter,beastmastery,6,2,4
emerald-dream,192,hunter,beastmastery,6,2,4
boulderfist,192,hunter,beastmastery,6,2,4
area-52,192,hunter,beastmastery,6,2,4
illidan,192,hunter,beastmastery,6,2,4
area-52,192,hunter,beastmastery,6,2,4
illidan,192,hunter,beastmastery,6,2,4
tichondrius,192,hunter,beastmastery,6,2,4
zuljin,192,hunter,beastmastery,6,2,4
wyrmrest-accord,192,hunter,beastmastery,6,2,4
sargeras,192,hunter,beastmastery,6,2,4
stormrage,192,hunter,beastmastery,6,2,4
wyrmrest-accord,192,hunter,beastmastery,6,2,4
tichondrius,192,hunter,beastmastery,6,2,4
dalaran,192,hunter,beastmastery,6,2,4
trollbane,192,hunter,beastmastery,6,2,4
trollbane,192,hunter,beastmastery,6,2,4
sargeras,192,hunter,beastmastery,6,2,4
zangarmarsh,192,hunter,beastmastery,6,2,4
zuljin,192,hunter,beastmastery,6,2,4
illidan,192,hunter,beastmastery,6,2,4
sargeras,192,hunter,beastmastery,6,2,4
malganis,192,hunter,beastmastery,6,2,4
arthas,192,hunter,beastmastery,6,2,4
tichondrius,192,hunter,beastmastery,6,2,4
malganis,192,hunter,beastmastery,6,2,4
darkspear,192,hunter,beastmastery,6,2,4
proudmoore,192,hunter,beastmastery,6,2,4
illidan,192,hunter,beastmastery,6,2,4
stormrage,192,hunter,beastmastery,6,2,4
khadgar,192,hunter,beastmastery,6,2,4
hyjal,192,hunter,beastmastery,6,2,4
tichondrius,192,hunter,beastmastery,6,2,4
darkspear,192,hunter,beastmastery,6,2,4
area-52,192,hunter,beastmastery,6,2,4
dalaran,192,hunter,beastmastery,6,2,4
darkspear,192,hunter,beastmastery,6,2,4
nesingwary,192,hunter,beastmastery,6,2,4
tichondrius,192,hunter,beastmastery,6,2,4
tichondrius,192,hunter,beastmastery,6,2,4
tichondrius,192,hunter,beastmastery,6,2,4
emerald-dream,192,hunter,beastmastery,6,2,4
stormrage,192,hunter,beastmastery,6,2,4
frostmourne,192,hunter,beastmastery,6,2,4
ragnaros,192,hunter,beastmastery,6,2,4
frostmourne,192,hunter,beastmastery,6,2,4
ragnaros,192,hunter,beastmastery,6,2,4
garrosh,192,hunter,beastmastery,6,2,4
frostmourne,192,hunter,beastmastery,6,2,4
stormscale,192,hunter,beastmastery,6,2,4
azralon,192,hunter,beastmastery,6,2,4
moon-guard,192,hunter,beastmastery,6,2,4
azralon,192,hunter,beastmastery,6,2,4
azralon,192,hunter,beastmastery,6,2,4
shandris,192,hunter,beastmastery,6,2,4
emerald-dream,192,hunter,beastmastery,6,2,4
ragnaros,192,hunter,beastmastery,6,2,4
moknathal,192,hunter,beastmastery,6,2,4
barthilas,192,hunter,beastmastery,6,2,4
frostmourne,192,hunter,beastmastery,6,2,4
barthilas,192,hunter,beastmastery,6,2,4
tichondrius,192,hunter,beastmastery,12,2,10
frostmourne,192,hunter,beastmastery,12,2,10
illidan,192,hunter,beastmastery,12,2,10
gurubashi,192,hunter,beastmastery,12,2,10
area-52,192,hunter,beastmastery,12,2,10
tichondrius,192,hunter,beastmastery,12,2,10
tichondrius,192,hunter,beastmastery,12,2,10
barthilas,191,hunter,beastmastery,6,2,4
azralon,191,hunter,beastmastery,6,2,4
gallywix,191,hunter,beastmastery,6,2,4
antonidas,191,hunter,beastmastery,6,2,4
nemesis,169,hunter,beastmastery,11,4,7
lothar,160,hunter,beastmastery,10,2,8
deathwing,159,hunter,beastmastery,5,2,3
tichondrius,159,hunter,beastmastery,5,2,3
tichondrius,144,hunter,beastmastery,9,2,7
stormrage,138,hunter,beastmastery,8,4,4
tichondrius,128,hunter,beastmastery,4,2,2
tichondrius,112,hunter,beastmastery,4,3,1
area-52,96,hunter,beastmastery,3,2,1
tichondrius,96,hunter,beastmastery,3,2,1
tichondrius,96,hunter,beastmastery,3,2,1
ragnaros,96,hunter,beastmastery,3,2,1
aegwynn,96,hunter,beastmastery,6,1,5
kelthuzad,96,hunter,beastmastery,6,1,5
azralon,96,hunter,beastmastery,6,1,5
aegwynn,96,hunter,beastmastery,6,1,5
stormrage,96,hunter,beastmastery,6,1,5
moon-guard,96,hunter,beastmastery,6,1,5
stormrage,96,hunter,beastmastery,6,1,5
azralon,96,hunter,beastmastery,6,1,5
ghostlands,96,hunter,beastmastery,6,1,5
destromath,96,hunter,beastmastery,6,1,5
lightnings-blade,96,hunter,beastmastery,6,1,5
daggerspine,96,hunter,beastmastery,6,1,5
tichondrius,96,hunter,beastmastery,6,1,5
runetotem,96,hunter,beastmastery,6,1,5
amanthul,96,hunter,beastmastery,6,1,5
hyjal,96,hunter,beastmastery,6,1,5
emerald-dream,96,hunter,beastmastery,6,1,5
kelthuzad,96,hunter,beastmastery,6,1,5
azralon,96,hunter,beastmastery,6,1,5
frostmourne,96,hunter,beastmastery,6,1,5
zuljin,96,hunter,beastmastery,6,1,5
malganis,96,hunter,beastmastery,6,1,5
zuljin,96,hunter,beastmastery,6,1,5
bleeding-hollow,96,hunter,beastmastery,6,1,5
llane,96,hunter,beastmastery,6,1,5
firetree,96,hunter,beastmastery,6,1,5
wyrmrest-accord,96,hunter,beastmastery,6,1,5
bleeding-hollow,96,hunter,beastmastery,6,1,5
sargeras,96,hunter,beastmastery,6,1,5
frostmourne,96,hunter,beastmastery,6,1,5
ragnaros,96,hunter,beastmastery,6,1,5
andorhal,96,hunter,beastmastery,6,1,5
kiljaeden,96,hunter,beastmastery,6,1,5
spirestone,96,hunter,beastmastery,6,1,5
kiljaeden,96,hunter,beastmastery,6,1,5
quelthalas,96,hunter,beastmastery,6,1,5
kiljaeden,96,hunter,beastmastery,6,1,5
stormreaver,96,hunter,beastmastery,6,1,5
dalaran,96,hunter,beastmastery,6,1,5
illidan,96,hunter,beastmastery,6,1,5
tichondrius,96,hunter,beastmastery,6,1,5
tichondrius,96,hunter,beastmastery,6,1,5
tichondrius,96,hunter,beastmastery,6,1,5
tichondrius,96,hunter,beastmastery,6,1,5
whisperwind,96,hunter,beastmastery,6,1,5
tichondrius,96,hunter,beastmastery,6,1,5
stormrage,96,hunter,beastmastery,7,1,6
tichondrius,96,hunter,beastmastery,11,1,10
nagrand,96,hunter,beastmastery,12,1,11
tichondrius,96,hunter,beastmastery,12,1,11
tichondrius,96,hunter,beastmastery,12,1,11
thrall,95,hunter,beastmastery,6,1,5
tichondrius,63,hunter,beastmastery,2,2,0
thrall,63,hunter,beastmastery,2,2,0
area-52,63,hunter,beastmastery,2,2,0
ragnaros,48,hunter,beastmastery,3,1,2
proudmoore,48,hunter,beastmastery,3,1,2
tol-barad,48,hunter,beastmastery,3,1,2
emerald-dream,48,hunter,beastmastery,3,1,2
stormrage,42,hunter,beastmastery,9,2,7
stormrage,31,hunter,beastmastery,2,1,1
destromath,31,hunter,beastmastery,2,1,1
moon-guard,31,hunter,beastmastery,2,1,1
sargeras,2233,mage,arcane,100,54,46
sargeras,2123,mage,arcane,76,45,31
tichondrius,2035,mage,arcane,63,36,27
tichondrius,1967,mage,arcane,54,35,19
archimonde,1939,mage,arcane,141,75,66
tichondrius,1860,mage,arcane,42,23,19
tichondrius,1809,mage,arcane,48,26,22
tichondrius,1777,mage,arcane,30,19,11
illidan,1770,mage,arcane,100,53,47
illidan,1715,mage,arcane,30,24,6
tichondrius,1695,mage,arcane,30,23,7
kelthuzad,1683,mage,arcane,36,18,18
area-52,1679,mage,arcane,48,32,16
gorefiend,1672,mage,arcane,42,29,13
stormrage,1672,mage,arcane,36,21,15
tichondrius,1662,mage,arcane,35,21,14
tichondrius,1610,mage,arcane,36,20,16
nazjatar,1566,mage,arcane,66,34,32
tol-barad,1555,mage,arcane,42,19,23
stormscale,1549,mage,arcane,58,32,26
daggerspine,1546,mage,arcane,68,35,33
area-52,1541,mage,arcane,36,20,16
area-52,1535,mage,arcane,66,34,32
tichondrius,1523,mage,arcane,28,17,11
illidan,1498,mage,arcane,71,34,37
quelthalas,1488,mage,arcane,42,25,17
frostmourne,1472,mage,arcane,30,16,14
azralon,1470,mage,arcane,48,28,20
illidan,1469,mage,arcane,36,20,16
thrall,1436,mage,arcane,24,15,9
frostmourne,1426,mage,arcane,36,18,18
kelthuzad,1414,mage,arcane,88,48,40
emerald-dream,1378,mage,arcane,36,21,15
wyrmrest-accord,1341,mage,arcane,24,14,10
area-52,1326,mage,arcane,60,29,31
stormrage,1306,mage,arcane,45,20,25
drakkari,1301,mage,arcane,54,30,24
proudmoore,1300,mage,arcane,30,16,14
area-52,1274,mage,arcane,23,15,8
proudmoore,1267,mage,arcane,52,24,28
sargeras,1266,mage,arcane,36,20,16
stormrage,1255,mage,arcane,107,59,48
kelthuzad,1243,mage,arcane,30,13,17
tichondrius,1241,mage,arcane,18,13,5
tichondrius,1227,mage,arcane,41,25,16
sargeras,1227,mage,arcane,54,20,34
azralon,1199,mage,arcane,101,51,50
area-52,1193,mage,arcane,60,33,27
tichondrius,1152,mage,arcane,24,12,12
zuljin,1150,mage,arcane,24,12,12
illidan,1147,mage,arcane,24,12,12
illidan,1134,mage,arcane,33,13,20
area-52,1111,mage,arcane,58,24,34
sargeras,1084,mage,arcane,20,12,8
tichondrius,1056,mage,arcane,12,11,1
sargeras,1056,mage,arcane,24,11,13
malganis,1055,mage,arcane,12,11,1
illidan,1055,mage,arcane,24,11,13
tichondrius,1052,mage,arcane,30,11,19
sargeras,1049,mage,arcane,23,11,12
proudmoore,1019,mage,arcane,23,11,12
fizzcrank,1018,mage,arcane,24,11,13
frostmourne,986,mage,arcane,89,42,47
stormrage,973,mage,arcane,26,12,14
blackrock,960,mage,arcane,12,10,2
quelthalas,960,mage,arcane,18,10,8
sargeras,959,mage,arcane,18,10,8
illidan,959,mage,arcane,18,10,8
hyjal,955,mage,arcane,18,10,8
whisperwind,954,mage,arcane,24,10,14
alexstrasza,954,mage,arcane,24,10,14
moon-guard,954,mage,arcane,24,10,14
hellscream,935,mage,arcane,60,25,35
moon-guard,926,mage,arcane,30,10,20
borean-tundra,913,mage,arcane,18,10,8
undermine,864,mage,arcane,18,9,9
sargeras,864,mage,arcane,18,9,9
mannoroth,863,mage,arcane,12,9,3
proudmoore,863,mage,arcane,18,9,9
moon-guard,862,mage,arcane,12,9,3
queldorei,832,mage,arcane,18,9,9
zuljin,831,mage,arcane,14,10,4
deathwing,768,mage,arcane,18,8,10
tichondrius,768,mage,arcane,18,8,10
aegwynn,768,mage,arcane,18,8,10
tichondrius,767,mage,arcane,12,8,4
dragonmaw,767,mage,arcane,12,8,4
kiljaeden,767,mage,arcane,12,8,4
area-52,767,mage,arcane,18,8,10
thunderlord,765,mage,arcane,12,8,4
azralon,764,mage,arcane,18,8,10
tichondrius,735,mage,arcane,17,8,9
frostmourne,672,mage,arcane,18,7,11
spirestone,671,mage,arcane,12,7,5
quelthalas,671,mage,arcane,18,7,11
stormrage,670,mage,arcane,12,7,5
onyxia,670,mage,arcane,12,7,5
bladefist,666,mage,arcane,12,7,5
kelthuzad,654,mage,arcane,13,8,5
illidan,639,mage,arcane,16,8,8
misha,638,mage,arcane,16,8,8
bleeding-hollow,576,mage,arcane,12,6,6
ragnaros,576,mage,arcane,12,6,6
goldrinn,575,mage,arcane,12,6,6
kelthuzad,575,mage,arcane,18,6,12
illidan,574,mage,arcane,12,6,6
moon-guard,574,mage,arcane,12,6,6
tichondrius,571,mage,arcane,12,6,6
quelthalas,571,mage,arcane,12,6,6
tichondrius,522,mage,arcane,20,7,13
ragnaros,480,mage,arcane,12,5,7
quelthalas,480,mage,arcane,12,5,7
malganis,480,mage,arcane,12,5,7
quelthalas,479,mage,arcane,12,5,7
dalaran,476,mage,arcane,12,5,7
proudmoore,384,mage,arcane,6,4,2
tichondrius,384,mage,arcane,6,4,2
drakkari,384,mage,arcane,6,4,2
tichondrius,384,mage,arcane,6,4,2
sargeras,384,mage,arcane,6,4,2
tichondrius,384,mage,arcane,6,4,2
sargeras,384,mage,arcane,6,4,2
tichondrius,384,mage,arcane,6,4,2
tichondrius,384,mage,arcane,6,4,2
frostmourne,384,mage,arcane,6,4,2
malganis,384,mage,arcane,6,4,2
tichondrius,384,mage,arcane,6,4,2
korgath,384,mage,arcane,12,4,8
kiljaeden,384,mage,arcane,12,4,8
saurfang,384,mage,arcane,12,4,8
tichondrius,384,mage,arcane,12,4,8
borean-tundra,384,mage,arcane,12,4,8
tichondrius,384,mage,arcane,12,4,8
tichondrius,384,mage,arcane,12,4,8
thrall,288,mage,arcane,6,3,3
illidan,288,mage,arcane,6,3,3
tichondrius,288,mage,arcane,6,3,3
sargeras,288,mage,arcane,6,3,3
stormrage,288,mage,arcane,6,3,3
frostmourne,288,mage,arcane,6,3,3
proudmoore,288,mage,arcane,6,3,3
aerie-peak,288,mage,arcane,6,3,3
sargeras,288,mage,arcane,6,3,3
tichondrius,288,mage,arcane,6,3,3
tichondrius,288,mage,arcane,6,3,3
nemesis,288,mage,arcane,6,3,3
sargeras,288,mage,arcane,6,3,3
zuljin,288,mage,arcane,6,3,3
aerie-peak,288,mage,arcane,6,3,3
azralon,288,mage,arcane,6,3,3
kul-tiras,288,mage,arcane,6,3,3
runetotem,288,mage,arcane,11,3,8
whisperwind,288,mage,arcane,12,3,9
illidan,288,mage,arcane,12,3,9
drakkari,288,mage,arcane,13,3,10
area-52,287,mage,arcane,6,3,3
aegwynn,287,mage,arcane,6,3,3
frostmourne,287,mage,arcane,12,3,9
exodar,287,mage,arcane,12,3,9
stormrage,286,mage,arcane,6,3,3
zuljin,286,mage,arcane,12,3,9
tichondrius,239,mage,arcane,5,3,2
stormrage,192,mage,arcane,6,2,4
windrunner,192,mage,arcane,6,2,4
tichondrius,192,mage,arcane,6,2,4
echo-isles,192,mage,arcane,6,2,4
destromath,192,mage,arcane,6,2,4
illidan,192,mage,arcane,6,2,4
dentarg,192,mage,arcane,6,2,4
stormrage,192,mage,arcane,6,2,4
emerald-dream,192,mage,arcane,6,2,4
tichondrius,192,mage,arcane,6,2,4
skullcrusher,192,mage,arcane,6,2,4
area-52,192,mage,arcane,6,2,4
andorhal,192,mage,arcane,6,2,4
illidan,192,mage,arcane,6,2,4
ragnaros,192,mage,arcane,6,2,4
tichondrius,192,mage,arcane,6,2,4
nemesis,192,mage,arcane,6,2,4
stormrage,192,mage,arcane,6,2,4
nagrand,192,mage,arcane,6,2,4
tichondrius,192,mage,arcane,6,2,4
frostmourne,192,mage,arcane,6,2,4
frostmourne,192,mage,arcane,6,2,4
dreadmaul,192,mage,arcane,6,2,4
quelthalas,192,mage,arcane,12,2,10
emerald-dream,192,mage,arcane,12,2,10
nagrand,96,mage,arcane,9,2,7
tichondrius,96,mage,arcane,6,1,5
stormrage,96,mage,arcane,6,1,5
moon-guard,96,mage,arcane,6,1,5
area-52,96,mage,arcane,6,1,5
turalyon,96,mage,arcane,6,1,5
ragnaros,96,mage,arcane,6,1,5
moon-guard,96,mage,arcane,6,1,5
tichondrius,96,mage,arcane,6,1,5
bleeding-hollow,96,mage,arcane,6,1,5
tichondrius,96,mage,arcane,6,1,5
boulderfist,96,mage,arcane,6,1,5
tichondrius,96,mage,arcane,6,1,5
sargeras,96,mage,arcane,6,1,5
senjin,96,mage,arcane,6,1,5
wyrmrest-accord,96,mage,arcane,6,1,5
emerald-dream,96,mage,arcane,6,1,5
tichondrius,96,mage,arcane,6,1,5
tichondrius,96,mage,arcane,12,1,11
dalaran,95,mage,arcane,6,1,5
dreadmaul,79,mage,arcane,11,1,10
tichondrius,63,mage,arcane,2,2,0
illidan,2122,mage,fire,138,69,69
tichondrius,2092,mage,fire,104,51,53
tichondrius,2068,mage,fire,94,54,40
illidan,2014,mage,fire,186,95,91
tichondrius,2012,mage,fire,78,41,37
tichondrius,1989,mage,fire,122,78,44
sargeras,1985,mage,fire,99,46,53
tichondrius,1933,mage,fire,66,40,26
farstriders,1906,mage,fire,42,23,19
tichondrius,1904,mage,fire,73,34,39
kargath,1893,mage,fire,66,36,30
bleeding-hollow,1893,mage,fire,88,45,43
sargeras,1867,mage,fire,72,33,39
stormrage,1863,mage,fire,42,21,21
area-52,1861,mage,fire,72,37,35
turalyon,1854,mage,fire,102,59,43
malganis,1848,mage,fire,60,35,25
emerald-dream,1847,mage,fire,69,41,28
illidan,1842,mage,fire,65,34,31
tichondrius,1828,mage,fire,47,25,22
darkspear,1824,mage,fire,26,20,6
laughing-skull,1824,mage,fire,34,25,9
malganis,1823,mage,fire,71,56,15
tichondrius,1821,mage,fire,98,57,41
tichondrius,1803,mage,fire,57,36,21
tichondrius,1802,mage,fire,42,22,20
sargeras,1798,mage,fire,75,33,42
zuljin,1774,mage,fire,48,27,21
quelthalas,1774,mage,fire,52,29,23
ragnaros,1762,mage,fire,42,21,21
bloodhoof,1758,mage,fire,84,52,32
stormrage,1755,mage,fire,42,24,18
area-52,1750,mage,fire,83,42,41
zuljin,1747,mage,fire,50,26,24
sargeras,1722,mage,fire,33,19,14
azralon,1718,mage,fire,54,28,26
tichondrius,1718,mage,fire,40,19,21
illidan,1702,mage,fire,35,25,10
tichondrius,1695,mage,fire,30,22,8
sargeras,1683,mage,fire,48,26,22
tichondrius,1674,mage,fire,24,18,6
tichondrius,1673,mage,fire,90,53,37
malganis,1655,mage,fire,48,24,24
proudmoore,1653,mage,fire,48,21,27
tichondrius,1651,mage,fire,42,27,15
tichondrius,1651,mage,fire,42,21,21
senjin,1630,mage,fire,60,30,30
kelthuzad,1621,mage,fire,36,20,16
emerald-dream,1616,mage,fire,48,22,26
stormrage,1615,mage,fire,36,22,14
stormrage,1614,mage,fire,52,34,18
sargeras,1613,mage,fire,97,51,46
tichondrius,1607,mage,fire,48,29,19
tichondrius,1604,mage,fire,49,25,24
barthilas,1602,mage,fire,60,33,27
area-52,1597,mage,fire,42,21,21
frostmourne,1595,mage,fire,42,21,21
stormrage,1583,mage,fire,102,59,43
sentinels,1581,mage,fire,54,31,23
sargeras,1574,mage,fire,42,24,18
sargeras,1573,mage,fire,48,24,24
deathwing,1550,mage,fire,71,42,29
proudmoore,1544,mage,fire,84,51,33
illidan,1540,mage,fire,30,21,9
malganis,1540,mage,fire,54,30,24
hyjal,1534,mage,fire,37,18,19
barthilas,1530,mage,fire,65,32,33
tichondrius,1529,mage,fire,60,31,29
stormrage,1525,mage,fire,29,18,11
azralon,1525,mage,fire,36,16,20
tichondrius,1518,mage,fire,50,24,26
emerald-dream,1515,mage,fire,30,21,9
shadowmoon,1513,mage,fire,35,18,17
tichondrius,1511,mage,fire,30,17,13
darkspear,1510,mage,fire,71,37,34
tichondrius,1510,mage,fire,66,33,33
dentarg,1508,mage,fire,62,40,22
dalaran,1504,mage,fire,47,33,14
frostwolf,1504,mage,fire,30,20,10
tichondrius,1493,mage,fire,47,30,17
moon-guard,1492,mage,fire,32,19,13
ragnaros,1490,mage,fire,59,30,29
stormrage,1484,mage,fire,50,25,25
sargeras,1478,mage,fire,90,44,46
stormrage,1473,mage,fire,36,18,18
barthilas,1473,mage,fire,42,18,24
sargeras,1462,mage,fire,59,28,31
eredar,1453,mage,fire,117,65,52
tichondrius,1449,mage,fire,29,17,12
cenarius,1449,mage,fire,42,20,22
tichondrius,1439,mage,fire,24,15,9
tichondrius,1433,mage,fire,30,18,12
tichondrius,1425,mage,fire,66,30,36
kelthuzad,1416,mage,fire,108,51,57
emerald-dream,1411,mage,fire,39,21,18
illidan,1409,mage,fire,30,16,14
thrall,1403,mage,fire,64,32,32
tichondrius,1395,mage,fire,35,21,14
area-52,1394,mage,fire,66,31,35
stormscale,1393,mage,fire,24,15,9
illidan,1392,mage,fire,71,35,36
illidan,1387,mage,fire,23,15,8
area-52,1387,mage,fire,60,31,29
tichondrius,1384,mage,fire,45,22,23
tichondrius,1344,mage,fire,36,20,16
tichondrius,1343,mage,fire,30,14,16
frostmourne,1336,mage,fire,24,14,10
azralon,1329,mage,fire,87,42,45
stormrage,1317,mage,fire,33,15,18
greymane,1316,mage,fire,43,21,22
tichondrius,1302,mage,fire,40,18,22
area-52,1292,mage,fire,48,25,23
ragnaros,1284,mage,fire,33,16,17
ragnaros,1267,mage,fire,26,14,12
barthilas,1258,mage,fire,36,19,17
tichondrius,1252,mage,fire,38,23,15
stormscale,1246,mage,fire,30,13,17
ragnaros,1245,mage,fire,24,13,11
illidan,1242,mage,fire,24,13,11
proudmoore,1237,mage,fire,60,29,31
tichondrius,1233,mage,fire,24,13,11
sargeras,1233,mage,fire,42,19,23
blades-edge,1227,mage,fire,60,27,33
ravencrest,1221,mage,fire,46,18,28
tichondrius,1218,mage,fire,30,13,17
azralon,1217,mage,fire,18,13,5
ragnaros,1205,mage,fire,30,14,16
frostmourne,1185,mage,fire,48,23,25
tichondrius,1172,mage,fire,96,48,48
illidan,1158,mage,fire,19,13,6
kelthuzad,1152,mage,fire,18,12,6
area-52,1151,mage,fire,18,12,6
tichondrius,1151,mage,fire,24,12,12
ragnaros,1150,mage,fire,30,12,18
malganis,1149,mage,fire,18,12,6
nordrassil,1147,mage,fire,30,14,16
tichondrius,1139,mage,fire,18,12,6
nemesis,1134,mage,fire,18,12,6
stormrage,1132,mage,fire,30,12,18
ragnaros,1127,mage,fire,30,14,16
tichondrius,1119,mage,fire,20,13,7
aerie-peak,1118,mage,fire,30,12,18
quelthalas,1109,mage,fire,27,16,11
hydraxis,1096,mage,fire,17,12,5
deathwing,1096,mage,fire,27,12,15
tichondrius,1095,mage,fire,23,12,11
moon-guard,1093,mage,fire,27,12,15
proudmoore,1093,mage,fire,29,12,17
proudmoore,1082,mage,fire,27,12,15
area-52,1081,mage,fire,23,12,11
moon-guard,1056,mage,fire,18,11,7
drakkari,1056,mage,fire,30,12,18
tichondrius,1055,mage,fire,18,11,7
zuljin,1055,mage,fire,24,11,13
tichondrius,1054,mage,fire,18,11,7
bleeding-hollow,1054,mage,fire,18,11,7
stormrage,1054,mage,fire,18,11,7
turalyon,1051,mage,fire,18,11,7
moon-guard,1051,mage,fire,24,11,13
nagrand,1049,mage,fire,24,11,13
stormrage,1049,mage,fire,24,11,13
tichondrius,1048,mage,fire,24,11,13
antonidas,1045,mage,fire,18,11,7
azralon,1017,mage,fire,23,11,12
barthilas,1004,mage,fire,23,11,12
sargeras,1003,mage,fire,61,35,26
ysera,965,mage,fire,96,40,56
sargeras,959,mage,fire,18,10,8
stormrage,959,mage,fire,18,10,8
sargeras,957,mage,fire,24,10,14
malorne,957,mage,fire,24,10,14
ragnaros,955,mage,fire,18,10,8
frostmourne,955,mage,fire,24,10,14
tichondrius,955,mage,fire,27,11,16
executus,953,mage,fire,24,10,14
vashj,952,mage,fire,24,10,14
tichondrius,946,mage,fire,30,15,15
ragnaros,942,mage,fire,18,10,8
nagrand,928,mage,fire,27,12,15
azralon,906,mage,fire,33,14,19
lightbringer,896,mage,fire,56,25,31
sargeras,886,mage,fire,18,10,8
bleeding-hollow,884,mage,fire,31,11,20
frostmourne,864,mage,fire,18,9,9
moon-guard,864,mage,fire,18,9,9
moon-guard,863,mage,fire,12,9,3
frostmourne,863,mage,fire,18,9,9
moon-guard,863,mage,fire,18,9,9
stormreaver,863,mage,fire,24,9,15
runetotem,862,mage,fire,18,9,9
frostmourne,860,mage,fire,12,9,3
moknathal,860,mage,fire,18,9,9
dalaran,860,mage,fire,24,9,15
malfurion,858,mage,fire,18,9,9
garona,858,mage,fire,21,10,11
frostmourne,857,mage,fire,18,9,9
kelthuzad,830,mage,fire,14,10,4
stormrage,822,mage,fire,24,9,15
tichondrius,814,mage,fire,17,9,8
azralon,768,mage,fire,12,8,4
stormrage,768,mage,fire,12,8,4
tichondrius,768,mage,fire,18,8,10
sargeras,768,mage,fire,18,8,10
shattered-halls,768,mage,fire,24,8,16
tichondrius,767,mage,fire,12,8,4
area-52,766,mage,fire,13,10,3
moon-guard,766,mage,fire,18,8,10
tichondrius,761,mage,fire,24,8,16
illidan,759,mage,fire,18,8,10
windrunner,750,mage,fire,12,8,4
kargath,733,mage,fire,18,8,10
azralon,684,mage,fire,13,8,5
malganis,672,mage,fire,12,7,5
tichondrius,672,mage,fire,12,7,5
frostmane,672,mage,fire,12,7,5
malganis,672,mage,fire,12,7,5
kelthuzad,672,mage,fire,12,7,5
area-52,672,mage,fire,12,7,5
emerald-dream,672,mage,fire,12,7,5
stormrage,672,mage,fire,18,7,11
dalaran,672,mage,fire,18,7,11
emerald-dream,672,mage,fire,18,7,11
daggerspine,671,mage,fire,12,7,5
moon-guard,671,mage,fire,12,7,5
stormrage,671,mage,fire,12,7,5
area-52,671,mage,fire,18,7,11
stormscale,671,mage,fire,18,7,11
draktharon,670,mage,fire,12,7,5
frostmourne,623,mage,fire,11,7,4
tichondrius,607,mage,fire,22,7,15
area-52,591,mage,fire,13,7,6
ragnaros,576,mage,fire,6,6,0
area-52,576,mage,fire,12,6,6
tichondrius,576,mage,fire,12,6,6
tichondrius,576,mage,fire,12,6,6
borean-tundra,576,mage,fire,12,6,6
frostmourne,576,mage,fire,12,6,6
tichondrius,576,mage,fire,12,6,6
frostmourne,576,mage,fire,12,6,6
area-52,576,mage,fire,12,6,6
blood-furnace,576,mage,fire,18,6,12
azralon,575,mage,fire,6,6,0
stormrage,575,mage,fire,12,6,6
bloodhoof,575,mage,fire,12,6,6
khaz-modan,574,mage,fire,12,6,6
sargeras,574,mage,fire,18,6,12
tichondrius,574,mage,fire,18,6,12
nagrand,567,mage,fire,12,6,6
area-52,565,mage,fire,12,6,6
moon-guard,559,mage,fire,18,7,11
stormrage,528,mage,fire,14,8,6
uther,512,mage,fire,16,6,10
tichondrius,480,mage,fire,6,5,1
nemesis,480,mage,fire,6,5,1
frostmourne,480,mage,fire,6,5,1
bleeding-hollow,480,mage,fire,6,5,1
kiljaeden,480,mage,fire,10,6,4
malganis,480,mage,fire,12,5,7
illidan,480,mage,fire,12,5,7
nagrand,480,mage,fire,12,5,7
ragnaros,480,mage,fire,12,5,7
stormrage,480,mage,fire,12,5,7
quelthalas,480,mage,fire,12,5,7
illidan,480,mage,fire,12,5,7
tichondrius,480,mage,fire,12,5,7
darkspear,480,mage,fire,12,5,7
thrall,480,mage,fire,12,5,7
icecrown,480,mage,fire,12,5,7
tichondrius,480,mage,fire,12,5,7
kelthuzad,480,mage,fire,12,5,7
the-underbog,480,mage,fire,12,5,7
zuljin,480,mage,fire,12,5,7
whisperwind,480,mage,fire,12,5,7
tichondrius,480,mage,fire,12,5,7
darkspear,480,mage,fire,12,5,7
tichondrius,480,mage,fire,18,5,13
kelthuzad,480,mage,fire,18,5,13
frostmourne,479,mage,fire,12,5,7
arthas,479,mage,fire,12,5,7
tichondrius,479,mage,fire,24,5,19
bonechewer,478,mage,fire,12,5,7
tichondrius,472,mage,fire,12,5,7
illidan,400,mage,fire,13,5,8
kelthuzad,384,mage,fire,6,4,2
kelthuzad,384,mage,fire,6,4,2
quelthalas,384,mage,fire,6,4,2
tichondrius,384,mage,fire,6,4,2
tichondrius,384,mage,fire,6,4,2
area-52,384,mage,fire,6,4,2
tichondrius,384,mage,fire,6,4,2
stormrage,384,mage,fire,6,4,2
hyjal,384,mage,fire,6,4,2
tichondrius,384,mage,fire,6,4,2
hyjal,384,mage,fire,6,4,2
mugthol,384,mage,fire,6,4,2
tichondrius,384,mage,fire,6,4,2
proudmoore,384,mage,fire,6,4,2
stormrage,384,mage,fire,6,4,2
illidan,384,mage,fire,6,4,2
tichondrius,384,mage,fire,6,4,2
frostmourne,384,mage,fire,6,4,2
sargeras,384,mage,fire,6,4,2
illidan,384,mage,fire,6,4,2
frostmourne,384,mage,fire,6,4,2
tichondrius,384,mage,fire,12,4,8
azralon,384,mage,fire,12,4,8
tichondrius,384,mage,fire,12,4,8
frostmourne,384,mage,fire,12,4,8
dark-iron,384,mage,fire,12,4,8
tichondrius,384,mage,fire,12,4,8
bronzebeard,384,mage,fire,12,4,8
saurfang,384,mage,fire,12,4,8
moon-guard,384,mage,fire,12,4,8
draka,384,mage,fire,12,4,8
bleeding-hollow,384,mage,fire,18,4,14
nemesis,384,mage,fire,18,4,14
illidan,383,mage,fire,6,4,2
moonrunner,383,mage,fire,6,4,2
tichondrius,383,mage,fire,8,4,4
proudmoore,383,mage,fire,12,4,8
moon-guard,383,mage,fire,12,4,8
illidan,383,mage,fire,17,5,12
icecrown,383,mage,fire,18,4,14
nemesis,367,mage,fire,11,4,7
azralon,367,mage,fire,11,4,7
malganis,344,mage,fire,15,6,9
tichondrius,288,mage,fire,6,3,3
tichondrius,288,mage,fire,6,3,3
thrall,288,mage,fire,6,3,3
wildhammer,288,mage,fire,6,3,3
tichondrius,288,mage,fire,6,3,3
whisperwind,288,mage,fire,6,3,3
zuljin,288,mage,fire,6,3,3
tichondrius,288,mage,fire,6,3,3
tichondrius,288,mage,fire,6,3,3
illidan,288,mage,fire,6,3,3
anetheron,288,mage,fire,6,3,3
tichondrius,288,mage,fire,6,3,3
tichondrius,288,mage,fire,6,3,3
tichondrius,288,mage,fire,6,3,3
stormrage,288,mage,fire,6,3,3
bonechewer,288,mage,fire,6,3,3
malganis,288,mage,fire,6,3,3
malorne,288,mage,fire,6,3,3
area-52,288,mage,fire,6,3,3
kelthuzad,288,mage,fire,6,3,3
stormrage,288,mage,fire,6,3,3
ragnaros,288,mage,fire,6,3,3
llane,288,mage,fire,6,3,3
kelthuzad,288,mage,fire,6,3,3
moon-guard,288,mage,fire,6,3,3
dreadmaul,288,mage,fire,6,3,3
silvermoon,288,mage,fire,6,3,3
frostmane,288,mage,fire,6,3,3
dalaran,288,mage,fire,6,3,3
area-52,288,mage,fire,6,3,3
draenor,288,mage,fire,6,3,3
darkspear,288,mage,fire,6,3,3
azuremyst,288,mage,fire,6,3,3
tichondrius,288,mage,fire,11,3,8
proudmoore,288,mage,fire,12,3,9
dalaran,288,mage,fire,12,3,9
tichondrius,288,mage,fire,12,3,9
quelthalas,288,mage,fire,12,3,9
stonemaul,287,mage,fire,6,3,3
destromath,256,mage,fire,10,3,7
alexstrasza,239,mage,fire,5,3,2
barthilas,239,mage,fire,5,3,2
tichondrius,234,mage,fire,16,6,10
amanthul,192,mage,fire,6,2,4
illidan,192,mage,fire,6,2,4
barthilas,192,mage,fire,6,2,4
tichondrius,192,mage,fire,6,2,4
frostmourne,192,mage,fire,6,2,4
quelthalas,192,mage,fire,6,2,4
malganis,192,mage,fire,6,2,4
barthilas,192,mage,fire,6,2,4
bleeding-hollow,192,mage,fire,6,2,4
area-52,192,mage,fire,6,2,4
tichondrius,192,mage,fire,6,2,4
frostmourne,192,mage,fire,6,2,4
tichondrius,192,mage,fire,6,2,4
turalyon,192,mage,fire,6,2,4
quelthalas,192,mage,fire,6,2,4
terenas,192,mage,fire,6,2,4
area-52,192,mage,fire,6,2,4
malganis,192,mage,fire,6,2,4
illidan,192,mage,fire,6,2,4
aegwynn,192,mage,fire,6,2,4
anvilmar,192,mage,fire,6,2,4
warsong,192,mage,fire,6,2,4
tichondrius,192,mage,fire,6,2,4
stormrage,192,mage,fire,6,2,4
tichondrius,192,mage,fire,6,2,4
tanaris,192,mage,fire,6,2,4
malganis,192,mage,fire,6,2,4
tichondrius,192,mage,fire,6,2,4
garona,192,mage,fire,6,2,4
tichondrius,192,mage,fire,6,2,4
stormrage,192,mage,fire,6,2,4
emerald-dream,192,mage,fire,6,2,4
kelthuzad,192,mage,fire,6,2,4
area-52,192,mage,fire,6,2,4
illidan,192,mage,fire,6,2,4
stormscale,192,mage,fire,6,2,4
dunemaul,192,mage,fire,6,2,4
proudmoore,192,mage,fire,6,2,4
kelthuzad,192,mage,fire,6,2,4
area-52,192,mage,fire,6,2,4
frostmourne,192,mage,fire,6,2,4
black-dragonflight,192,mage,fire,6,2,4
sargeras,192,mage,fire,6,2,4
sargeras,192,mage,fire,6,2,4
tichondrius,192,mage,fire,6,2,4
sargeras,192,mage,fire,6,2,4
sargeras,192,mage,fire,6,2,4
tichondrius,192,mage,fire,11,2,9
darrowmere,192,mage,fire,12,2,10
nemesis,160,mage,fire,10,2,8
spirestone,159,mage,fire,5,2,3
quelthalas,144,mage,fire,3,3,0
tichondrius,144,mage,fire,3,3,0
malganis,138,mage,fire,16,3,13
dawnbringer,128,mage,fire,4,2,2
tichondrius,128,mage,fire,4,2,2
tichondrius,112,mage,fire,7,2,5
dalaran,112,mage,fire,7,2,5
moon-guard,96,mage,fire,3,2,1
gorefiend,96,mage,fire,6,1,5
illidan,96,mage,fire,6,1,5
bleeding-hollow,96,mage,fire,6,1,5
thrall,96,mage,fire,6,1,5
frostmourne,96,mage,fire,6,1,5
area-52,96,mage,fire,6,1,5
frostmourne,96,mage,fire,6,1,5
area-52,96,mage,fire,6,1,5
burning-legion,96,mage,fire,6,1,5
frostmourne,96,mage,fire,6,1,5
malganis,96,mage,fire,6,1,5
stormrage,96,mage,fire,6,1,5
azgalor,96,mage,fire,6,1,5
tichondrius,96,mage,fire,6,1,5
stormrage,96,mage,fire,6,1,5
tichondrius,96,mage,fire,6,1,5
area-52,96,mage,fire,6,1,5
wyrmrest-accord,96,mage,fire,6,1,5
tichondrius,96,mage,fire,6,1,5
aegwynn,96,mage,fire,6,1,5
bonechewer,96,mage,fire,6,1,5
malganis,96,mage,fire,6,1,5
dathremar,96,mage,fire,6,1,5
barthilas,96,mage,fire,7,1,6
arthas,96,mage,fire,12,1,11
terokkar,95,mage,fire,6,1,5
kelthuzad,79,mage,fire,5,1,4
frostmourne,79,mage,fire,5,1,4
bleeding-hollow,31,mage,fire,2,1,1
tichondrius,2224,mage,frost,120,65,55
tichondrius,2016,mage,frost,111,59,52
sargeras,1996,mage,frost,48,27,21
stormrage,1991,mage,frost,93,55,38
tichondrius,1969,mage,frost,81,39,42
tichondrius,1962,mage,frost,107,49,58
blackrock,1937,mage,frost,59,32,27
tichondrius,1911,mage,frost,65,31,34
area-52,1909,mage,frost,30,21,9
llane,1877,mage,frost,69,36,33
tichondrius,1869,mage,frost,70,40,30
ragnaros,1857,mage,frost,72,31,41
barthilas,1842,mage,frost,108,54,54
thrall,1831,mage,frost,47,23,24
tichondrius,1823,mage,frost,56,29,27
tichondrius,1818,mage,frost,30,19,11
frostmourne,1816,mage,frost,72,50,22
stormrage,1804,mage,frost,66,29,37
uldum,1796,mage,frost,42,25,17
tichondrius,1788,mage,frost,36,19,17
kelthuzad,1787,mage,frost,53,32,21
ysera,1776,mage,frost,84,47,37
malfurion,1760,mage,frost,66,33,33
aerie-peak,1747,mage,frost,42,23,19
ragnaros,1744,mage,frost,59,34,25
hyjal,1742,mage,frost,42,27,15
sargeras,1733,mage,frost,60,29,31
tichondrius,1727,mage,frost,53,26,27
sargeras,1726,mage,frost,60,29,31
tichondrius,1721,mage,frost,66,29,37
sargeras,1720,mage,frost,32,21,11
illidan,1719,mage,frost,26,20,6
azuremyst,1714,mage,frost,30,18,12
tichondrius,1713,mage,frost,36,18,18
tichondrius,1713,mage,frost,42,18,24
malganis,1705,mage,frost,42,24,18
dalaran,1701,mage,frost,48,24,24
nemesis,1699,mage,frost,105,54,51
stormrage,1689,mage,frost,41,24,17
frostmourne,1685,mage,frost,42,31,11
tichondrius,1679,mage,frost,59,33,26
area-52,1671,mage,frost,35,21,14
illidan,1669,mage,frost,35,18,17
illidan,1662,mage,frost,48,24,24
tichondrius,1661,mage,frost,42,25,17
kelthuzad,1655,mage,frost,75,35,40
area-52,1649,mage,frost,49,26,23
tichondrius,1644,mage,frost,44,29,15
chogall,1644,mage,frost,48,23,25
tichondrius,1642,mage,frost,60,27,33
kiljaeden,1634,mage,frost,183,86,97
moon-guard,1632,mage,frost,26,18,8
blood-furnace,1632,mage,frost,42,25,17
spirestone,1625,mage,frost,36,23,13
moon-guard,1624,mage,frost,78,48,30
tichondrius,1619,mage,frost,93,45,48
kirin-tor,1618,mage,frost,30,17,13
zuljin,1618,mage,frost,36,17,19
nemesis,1614,mage,frost,54,29,25
korgath,1611,mage,frost,80,41,39
quelthalas,1595,mage,frost,50,28,22
tichondrius,1594,mage,frost,36,19,17
tichondrius,1591,mage,frost,43,21,22
tichondrius,1590,mage,frost,120,54,66
tichondrius,1580,mage,frost,30,18,12
black-dragonflight,1577,mage,frost,68,34,34
frostmourne,1575,mage,frost,89,41,48
stormrage,1570,mage,frost,125,68,57
baelgun,1568,mage,frost,48,26,22
moon-guard,1567,mage,frost,47,22,25
tichondrius,1567,mage,frost,41,17,24
moon-guard,1557,mage,frost,54,27,27
skullcrusher,1554,mage,frost,88,55,33
tichondrius,1553,mage,frost,316,157,159
bladefist,1551,mage,frost,76,44,32
stormrage,1549,mage,frost,39,19,20
area-52,1548,mage,frost,42,18,24
stormrage,1546,mage,frost,35,20,15
quelthalas,1536,mage,frost,42,23,19
ragnaros,1530,mage,frost,30,16,14
lightnings-blade,1519,mage,frost,125,58,67
hyjal,1513,mage,frost,36,19,17
dreadmaul,1513,mage,frost,60,28,32
frostmourne,1508,mage,frost,171,90,81
aerie-peak,1501,mage,frost,71,34,37
tichondrius,1500,mage,frost,54,26,28
moon-guard,1497,mage,frost,56,28,28
terenas,1494,mage,frost,66,29,37
malganis,1488,mage,frost,133,66,67
jaedenar,1480,mage,frost,22,17,5
emerald-dream,1478,mage,frost,79,43,36
area-52,1476,mage,frost,72,38,34
barthilas,1476,mage,frost,79,38,41
emerald-dream,1466,mage,frost,47,18,29
proudmoore,1463,mage,frost,36,21,15
nemesis,1463,mage,frost,46,20,26
emerald-dream,1462,mage,frost,33,17,16
illidan,1451,mage,frost,160,90,70
tichondrius,1443,mage,frost,54,24,30
tichondrius,1437,mage,frost,24,15,9
tichondrius,1435,mage,frost,30,15,15
illidan,1431,mage,frost,57,29,28
sargeras,1428,mage,frost,71,34,37
ragnaros,1427,mage,frost,129,65,64
area-52,1418,mage,frost,43,20,23
moon-guard,1415,mage,frost,36,19,17
moon-guard,1410,mage,frost,62,30,32
area-52,1407,mage,frost,128,56,72
barthilas,1406,mage,frost,41,25,16
andorhal,1405,mage,frost,53,29,24
quelthalas,1402,mage,frost,25,17,8
stormrage,1396,mage,frost,37,19,18
azralon,1395,mage,frost,64,34,30
tichondrius,1392,mage,frost,122,56,66
garrosh,1391,mage,frost,33,17,16
zuljin,1388,mage,frost,36,20,16
lightnings-blade,1380,mage,frost,24,15,9
ragnaros,1369,mage,frost,30,16,14
kelthuzad,1346,mage,frost,30,19,11
illidan,1343,mage,frost,30,14,16
illidan,1343,mage,frost,37,17,20
thrall,1340,mage,frost,30,14,16
stormreaver,1339,mage,frost,24,14,10
proudmoore,1336,mage,frost,24,14,10
zuluhed,1330,mage,frost,48,21,27
nemesis,1329,mage,frost,78,44,34
emerald-dream,1328,mage,frost,237,109,128
illidan,1323,mage,frost,18,14,4
barthilas,1317,mage,frost,56,26,30
tichondrius,1316,mage,frost,60,26,34
borean-tundra,1311,mage,frost,59,20,39
tichondrius,1310,mage,frost,27,15,12
proudmoore,1306,mage,frost,54,28,26
alterac-mountains,1305,mage,frost,30,15,15
ragnaros,1298,mage,frost,39,20,19
tichondrius,1297,mage,frost,36,14,22
eonar,1290,mage,frost,81,35,46
emerald-dream,1286,mage,frost,30,14,16
area-52,1281,mage,frost,36,22,14
nazjatar,1270,mage,frost,41,21,20
lothar,1270,mage,frost,29,14,15
stormrage,1269,mage,frost,34,17,17
azralon,1262,mage,frost,42,20,22
tichondrius,1261,mage,frost,30,17,13
dreadmaul,1257,mage,frost,68,30,38
wyrmrest-accord,1254,mage,frost,42,22,20
proudmoore,1252,mage,frost,59,26,33
tichondrius,1247,mage,frost,30,13,17
sargeras,1244,mage,frost,31,14,17
tichondrius,1242,mage,frost,30,13,17
emerald-dream,1238,mage,frost,36,20,16
bleeding-hollow,1238,mage,frost,24,13,11
moonrunner,1229,mage,frost,61,29,32
black-dragonflight,1226,mage,frost,42,16,26
zuljin,1224,mage,frost,30,13,17
tichondrius,1212,mage,frost,24,14,10
tichondrius,1211,mage,frost,30,15,15
sargeras,1197,mage,frost,29,13,16
tichondrius,1195,mage,frost,21,13,8
azralon,1195,mage,frost,29,16,13
area-52,1194,mage,frost,30,21,9
quelthalas,1190,mage,frost,134,61,73
khazgoroth,1189,mage,frost,54,28,26
wyrmrest-accord,1181,mage,frost,43,24,19
thaurissan,1173,mage,frost,30,14,16
tichondrius,1173,mage,frost,39,18,21
lightnings-blade,1170,mage,frost,48,23,25
nerzhul,1169,mage,frost,34,14,20
area-52,1167,mage,frost,80,38,42
tichondrius,1159,mage,frost,114,56,58
stormrage,1151,mage,frost,24,12,12
drakkari,1147,mage,frost,24,12,12
ysera,1144,mage,frost,30,12,18
illidan,1141,mage,frost,30,17,13
echo-isles,1137,mage,frost,100,46,54
quelthalas,1137,mage,frost,46,20,26
bleeding-hollow,1128,mage,frost,41,14,27
ragnaros,1124,mage,frost,32,14,18
dunemaul,1123,mage,frost,27,13,14
aegwynn,1122,mage,frost,30,12,18
area-52,1119,mage,frost,64,28,36
bleeding-hollow,1119,mage,frost,29,12,17
area-52,1119,mage,frost,29,12,17
tichondrius,1116,mage,frost,23,12,11
quelthalas,1115,mage,frost,18,12,6
azjolnerub,1115,mage,frost,30,16,14
ragnaros,1114,mage,frost,29,16,13
zuljin,1109,mage,frost,24,12,12
dalaran,1106,mage,frost,30,18,12
proudmoore,1102,mage,frost,36,18,18
barthilas,1099,mage,frost,21,12,9
bleeding-hollow,1095,mage,frost,35,14,21
stormreaver,1094,mage,frost,22,12,10
tichondrius,1093,mage,frost,23,12,11
quelthalas,1087,mage,frost,17,12,5
moon-guard,1082,mage,frost,42,21,21
area-52,1081,mage,frost,31,13,18
tichondrius,1080,mage,frost,54,21,33
tichondrius,1057,mage,frost,86,34,52
burning-blade,1056,mage,frost,18,11,7
frostmourne,1055,mage,frost,18,11,7
tichondrius,1055,mage,frost,24,11,13
khazgoroth,1054,mage,frost,36,22,14
tichondrius,1054,mage,frost,18,11,7
norgannon,1054,mage,frost,24,11,13
lightnings-blade,1051,mage,frost,24,11,13
wyrmrest-accord,1051,mage,frost,25,11,14
ragnaros,1046,mage,frost,18,11,7
terenas,1044,mage,frost,47,22,25
ragnaros,1043,mage,frost,24,11,13
dunemaul,1040,mage,frost,20,11,9
icecrown,1032,mage,frost,49,13,36
tichondrius,1025,mage,frost,18,14,4
moon-guard,1024,mage,frost,24,11,13
azralon,1017,mage,frost,51,20,31
tichondrius,1014,mage,frost,24,11,13
tichondrius,1006,mage,frost,17,11,6
bleeding-hollow,1005,mage,frost,29,11,18
illidan,989,mage,frost,23,11,12
crushridge,986,mage,frost,52,27,25
skullcrusher,971,mage,frost,25,11,14
archimonde,960,mage,frost,18,11,7
stormreaver,960,mage,frost,18,10,8
skullcrusher,960,mage,frost,24,10,14
bleeding-hollow,959,mage,frost,18,10,8
spinebreaker,959,mage,frost,24,10,14
frostmane,959,mage,frost,27,11,16
frostmourne,958,mage,frost,18,10,8
khazgoroth,957,mage,frost,24,10,14
blackrock,955,mage,frost,30,10,20
emerald-dream,950,mage,frost,16,11,5
ragnaros,946,mage,frost,18,10,8
dalaran,939,mage,frost,18,10,8
malorne,923,mage,frost,30,16,14
drakthul,917,mage,frost,65,28,37
emerald-dream,908,mage,frost,15,11,4
tichondrius,886,mage,frost,57,26,31
illidan,880,mage,frost,19,10,9
stormrage,864,mage,frost,12,9,3
stormrage,864,mage,frost,12,9,3
illidan,864,mage,frost,12,9,3
stormrage,864,mage,frost,18,9,9
tichondrius,864,mage,frost,18,9,9
tichondrius,864,mage,frost,18,9,9
tichondrius,864,mage,frost,30,9,21
kiljaeden,863,mage,frost,12,9,3
proudmoore,863,mage,frost,12,9,3
proudmoore,863,mage,frost,18,9,9
wyrmrest-accord,863,mage,frost,18,9,9
tichondrius,863,mage,frost,18,9,9
destromath,863,mage,frost,18,9,9
stormrage,863,mage,frost,24,9,15
blades-edge,863,mage,frost,24,9,15
frostmourne,863,mage,frost,30,9,21
proudmoore,862,mage,frost,12,9,3
tichondrius,862,mage,frost,18,9,9
burning-legion,862,mage,frost,18,9,9
nagrand,862,mage,frost,18,9,9
tichondrius,862,mage,frost,24,9,15
tichondrius,861,mage,frost,12,9,3
moon-guard,861,mage,frost,20,9,11
emerald-dream,860,mage,frost,16,10,6
anvilmar,859,mage,frost,18,9,9
sargeras,852,mage,frost,24,9,15
ragnaros,851,mage,frost,18,9,9
ragnaros,837,mage,frost,21,11,10
firetree,834,mage,frost,24,9,15
drakkari,831,mage,frost,22,9,13
anvilmar,798,mage,frost,14,9,5
stormrage,783,mage,frost,19,9,10
malganis,771,mage,frost,25,9,16
frostmourne,768,mage,frost,12,8,4
lightnings-blade,768,mage,frost,12,8,4
stormrage,768,mage,frost,12,8,4
tichondrius,768,mage,frost,12,8,4
tichondrius,768,mage,frost,18,8,10
dentarg,768,mage,frost,18,8,10
tichondrius,768,mage,frost,18,8,10
quelthalas,767,mage,frost,12,8,4
blood-furnace,767,mage,frost,12,8,4
dalaran,767,mage,frost,12,8,4
thrall,767,mage,frost,12,8,4
tichondrius,767,mage,frost,18,8,10
ragnaros,767,mage,frost,18,8,10
tichondrius,767,mage,frost,18,8,10
sargeras,767,mage,frost,18,8,10
barthilas,767,mage,frost,18,8,10
mannoroth,767,mage,frost,18,8,10
hyjal,766,mage,frost,12,8,4
zuljin,766,mage,frost,12,8,4
sargeras,763,mage,frost,12,8,4
tichondrius,762,mage,frost,18,8,10
azralon,760,mage,frost,16,9,7
azralon,756,mage,frost,18,8,10
barthilas,751,mage,frost,23,9,14
detheroc,748,mage,frost,12,8,4
emerald-dream,736,mage,frost,16,9,7
alexstrasza,735,mage,frost,29,8,21
tichondrius,719,mage,frost,11,8,3
thrall,719,mage,frost,11,8,3
drakkari,703,mage,frost,14,8,6
moon-guard,683,mage,frost,13,8,5
stormrage,672,mage,frost,12,7,5
kelthuzad,672,mage,frost,12,7,5
illidan,672,mage,frost,12,7,5
proudmoore,672,mage,frost,12,7,5
kelthuzad,672,mage,frost,12,7,5
stormrage,672,mage,frost,12,7,5
tichondrius,672,mage,frost,12,7,5
tichondrius,672,mage,frost,12,7,5
laughing-skull,672,mage,frost,12,7,5
misha,672,mage,frost,16,8,8
thrall,672,mage,frost,17,8,9
barthilas,672,mage,frost,18,7,11
tichondrius,672,mage,frost,18,7,11
tichondrius,672,mage,frost,18,7,11
area-52,672,mage,frost,18,7,11
illidan,671,mage,frost,12,7,5
dunemaul,671,mage,frost,12,7,5
scilla,671,mage,frost,12,7,5
whisperwind,671,mage,frost,12,7,5
illidan,671,mage,frost,12,7,5
tichondrius,671,mage,frost,18,7,11
burning-blade,670,mage,frost,12,7,5
stormrage,670,mage,frost,12,7,5
laughing-skull,670,mage,frost,18,7,11
korgath,669,mage,frost,12,7,5
bleeding-hollow,669,mage,frost,12,7,5
illidan,669,mage,frost,12,7,5
ragnaros,669,mage,frost,13,7,6
muradin,668,mage,frost,12,7,5
amanthul,668,mage,frost,12,7,5
malganis,666,mage,frost,12,7,5
thrall,665,mage,frost,12,7,5
tichondrius,664,mage,frost,12,7,5
emerald-dream,662,mage,frost,12,7,5
frostmourne,659,mage,frost,18,7,11
bladefist,655,mage,frost,23,7,16
malganis,654,mage,frost,23,7,16
barthilas,639,mage,frost,14,8,6
kelthuzad,638,mage,frost,14,8,6
tichondrius,624,mage,frost,15,7,8
blackhand,621,mage,frost,15,8,7
stormrage,607,mage,frost,16,7,9
sargeras,576,mage,frost,12,6,6
tichondrius,576,mage,frost,12,6,6
garrosh,576,mage,frost,12,6,6
illidan,576,mage,frost,12,6,6
quelthalas,576,mage,frost,12,6,6
tichondrius,576,mage,frost,12,6,6
sargeras,576,mage,frost,12,6,6
illidan,576,mage,frost,18,6,12
tichondrius,576,mage,frost,18,6,12
sargeras,576,mage,frost,18,6,12
illidan,575,mage,frost,12,6,6
thrall,575,mage,frost,18,6,12
stonemaul,575,mage,frost,18,6,12
area-52,574,mage,frost,12,6,6
zuljin,574,mage,frost,18,6,12
doomhammer,572,mage,frost,12,6,6
illidan,571,mage,frost,12,6,6
sargeras,571,mage,frost,12,6,6
zuljin,543,mage,frost,11,6,5
azralon,542,mage,frost,8,7,1
elune,528,mage,frost,9,6,3
tichondrius,527,mage,frost,11,6,5
aggramar,519,mage,frost,22,6,16
tichondrius,512,mage,frost,10,6,4
tichondrius,512,mage,frost,10,6,4
sargeras,512,mage,frost,16,6,10
proudmoore,511,mage,frost,11,6,5
area-52,510,mage,frost,17,7,10
warsong,510,mage,frost,20,6,14
stormrage,508,mage,frost,16,6,10
zuljin,480,mage,frost,6,5,1
illidan,480,mage,frost,6,5,1
korgath,480,mage,frost,6,5,1
mugthol,480,mage,frost,6,5,1
area-52,480,mage,frost,6,5,1
tichondrius,480,mage,frost,6,5,1
tichondrius,480,mage,frost,6,5,1
terenas,480,mage,frost,6,5,1
tichondrius,480,mage,frost,6,5,1
garona,480,mage,frost,10,6,4
moon-guard,480,mage,frost,12,5,7
quelthalas,480,mage,frost,12,5,7
stormrage,480,mage,frost,12,5,7
moon-guard,480,mage,frost,12,5,7
tichondrius,480,mage,frost,12,5,7
area-52,480,mage,frost,12,5,7
alexstrasza,480,mage,frost,12,5,7
tichondrius,480,mage,frost,12,5,7
tichondrius,480,mage,frost,12,5,7
kelthuzad,480,mage,frost,12,5,7
frostmourne,480,mage,frost,12,5,7
dentarg,480,mage,frost,12,5,7
blood-furnace,480,mage,frost,12,5,7
frostmourne,480,mage,frost,12,5,7
moon-guard,480,mage,frost,12,5,7
kelthuzad,480,mage,frost,12,5,7
firetree,480,mage,frost,12,5,7
korialstrasz,480,mage,frost,12,5,7
sargeras,480,mage,frost,12,5,7
terenas,480,mage,frost,12,5,7
draka,480,mage,frost,12,5,7
tichondrius,480,mage,frost,12,5,7
tichondrius,480,mage,frost,18,5,13
hakkar,480,mage,frost,18,5,13
tichondrius,480,mage,frost,18,5,13
malganis,479,mage,frost,6,5,1
sargeras,479,mage,frost,6,5,1
moon-guard,479,mage,frost,12,5,7
draka,479,mage,frost,12,5,7
frostmourne,479,mage,frost,12,5,7
sargeras,479,mage,frost,24,5,19
darkspear,478,mage,frost,12,5,7
shattered-halls,477,mage,frost,12,5,7
azralon,476,mage,frost,12,5,7
tichondrius,463,mage,frost,11,5,6
kiljaeden,431,mage,frost,11,5,6
earthen-ring,415,mage,frost,8,5,3
bonechewer,415,mage,frost,11,5,6
boulderfist,414,mage,frost,11,5,6
tichondrius,384,mage,frost,6,4,2
kiljaeden,384,mage,frost,6,4,2
aerie-peak,384,mage,frost,6,4,2
tichondrius,384,mage,frost,6,4,2
quelthalas,384,mage,frost,6,4,2
velen,384,mage,frost,6,4,2
area-52,384,mage,frost,6,4,2
ragnaros,384,mage,frost,6,4,2
illidan,384,mage,frost,6,4,2
proudmoore,384,mage,frost,6,4,2
tichondrius,384,mage,frost,6,4,2
zangarmarsh,384,mage,frost,6,4,2
demon-soul,384,mage,frost,6,4,2
sargeras,384,mage,frost,6,4,2
maelstrom,384,mage,frost,6,4,2
area-52,384,mage,frost,6,4,2
tichondrius,384,mage,frost,6,4,2
nemesis,384,mage,frost,6,4,2
illidan,384,mage,frost,6,4,2
illidan,384,mage,frost,6,4,2
area-52,384,mage,frost,6,4,2
tichondrius,384,mage,frost,6,4,2
malganis,384,mage,frost,6,4,2
mannoroth,384,mage,frost,6,4,2
hyjal,384,mage,frost,6,4,2
stormrage,384,mage,frost,6,4,2
illidan,384,mage,frost,6,4,2
tichondrius,384,mage,frost,6,4,2
bleeding-hollow,384,mage,frost,6,4,2
stormrage,384,mage,frost,6,4,2
the-forgotten-coast,384,mage,frost,6,4,2
darkspear,384,mage,frost,6,4,2
nathrezim,384,mage,frost,6,4,2
tichondrius,384,mage,frost,6,4,2
quelthalas,384,mage,frost,6,4,2
zuljin,384,mage,frost,6,4,2
sargeras,384,mage,frost,9,5,4
malganis,384,mage,frost,9,4,5
shandris,384,mage,frost,12,4,8
anubarak,384,mage,frost,12,4,8
aegwynn,384,mage,frost,12,4,8
illidan,384,mage,frost,12,4,8
frostmourne,384,mage,frost,12,4,8
illidan,384,mage,frost,12,4,8
tichondrius,384,mage,frost,12,4,8
drakkari,384,mage,frost,12,4,8
tichondrius,384,mage,frost,12,4,8
darkspear,384,mage,frost,12,4,8
stormrage,384,mage,frost,12,4,8
frostwolf,384,mage,frost,12,4,8
stormscale,384,mage,frost,12,4,8
moon-guard,384,mage,frost,12,4,8
tichondrius,384,mage,frost,12,4,8
area-52,384,mage,frost,12,4,8
moon-guard,384,mage,frost,12,4,8
tichondrius,384,mage,frost,18,4,14
onyxia,383,mage,frost,6,4,2
hakkar,383,mage,frost,12,4,8
moon-guard,383,mage,frost,12,4,8
mugthol,382,mage,frost,12,4,8
ghostlands,382,mage,frost,12,4,8
malganis,351,mage,frost,8,5,3
whisperwind,351,mage,frost,11,4,7
quelthalas,351,mage,frost,11,4,7
area-52,349,mage,frost,14,7,7
undermine,335,mage,frost,17,4,13
area-52,330,mage,frost,22,7,15
ysera,329,mage,frost,6,5,1
tichondrius,319,mage,frost,5,4,1
sargeras,319,mage,frost,5,4,1
blackrock,317,mage,frost,8,4,4
bleeding-hollow,304,mage,frost,7,4,3
boulderfist,288,mage,frost,6,3,3
bonechewer,288,mage,frost,6,3,3
tichondrius,288,mage,frost,6,3,3
arthas,288,mage,frost,6,3,3
winterhoof,288,mage,frost,6,3,3
hyjal,288,mage,frost,6,3,3
area-52,288,mage,frost,6,3,3
ursin,288,mage,frost,6,3,3
illidan,288,mage,frost,6,3,3
tichondrius,288,mage,frost,6,3,3
elune,288,mage,frost,6,3,3
tichondrius,288,mage,frost,6,3,3
tichondrius,288,mage,frost,6,3,3
area-52,288,mage,frost,6,3,3
zuluhed,288,mage,frost,6,3,3
nemesis,288,mage,frost,6,3,3
bleeding-hollow,288,mage,frost,6,3,3
kelthuzad,288,mage,frost,6,3,3
illidan,288,mage,frost,6,3,3
ragnaros,288,mage,frost,6,3,3
malganis,288,mage,frost,6,3,3
malganis,288,mage,frost,6,3,3
trollbane,288,mage,frost,6,3,3
bleeding-hollow,288,mage,frost,6,3,3
dalaran,288,mage,frost,6,3,3
tichondrius,288,mage,frost,6,3,3
bonechewer,288,mage,frost,6,3,3
nagrand,288,mage,frost,6,3,3
frostmourne,288,mage,frost,6,3,3
llane,288,mage,frost,6,3,3
azralon,288,mage,frost,6,3,3
silvermoon,288,mage,frost,6,3,3
stormrage,288,mage,frost,6,3,3
azralon,288,mage,frost,6,3,3
moon-guard,288,mage,frost,6,3,3
frostmourne,288,mage,frost,6,3,3
emerald-dream,288,mage,frost,6,3,3
drakthul,288,mage,frost,6,3,3
emerald-dream,288,mage,frost,6,3,3
burning-legion,288,mage,frost,6,3,3
barthilas,288,mage,frost,6,3,3
stormrage,288,mage,frost,6,3,3
sargeras,288,mage,frost,6,3,3
malorne,288,mage,frost,6,3,3
darkspear,288,mage,frost,6,3,3
frostmourne,288,mage,frost,6,3,3
moon-guard,288,mage,frost,6,3,3
stormrage,288,mage,frost,6,3,3
tichondrius,288,mage,frost,10,4,6
nordrassil,288,mage,frost,12,3,9
azralon,288,mage,frost,12,3,9
drakkari,288,mage,frost,12,3,9
undermine,288,mage,frost,12,3,9
ragnaros,288,mage,frost,12,3,9
tichondrius,288,mage,frost,12,3,9
aegwynn,288,mage,frost,12,3,9
lightnings-blade,288,mage,frost,12,3,9
illidan,288,mage,frost,12,3,9
area-52,288,mage,frost,12,3,9
caelestrasz,287,mage,frost,6,3,3
drakkari,287,mage,frost,6,3,3
tichondrius,287,mage,frost,8,3,5
bleeding-hollow,286,mage,frost,6,3,3
daggerspine,239,mage,frost,5,3,2
draenor,239,mage,frost,5,3,2
frostmourne,239,mage,frost,5,3,2
jubeithos,239,mage,frost,5,3,2
tichondrius,239,mage,frost,6,3,3
emerald-dream,234,mage,frost,13,4,9
azralon,234,mage,frost,19,4,15
tichondrius,224,mage,frost,10,3,7
greymane,192,mage,frost,4,3,1
blood-furnace,192,mage,frost,4,3,1
perenolde,192,mage,frost,6,2,4
bleeding-hollow,192,mage,frost,6,2,4
barthilas,192,mage,frost,6,2,4
tichondrius,192,mage,frost,6,2,4
tichondrius,192,mage,frost,6,2,4
stormrage,192,mage,frost,6,2,4
nerzhul,192,mage,frost,6,2,4
kul-tiras,192,mage,frost,6,2,4
zuljin,192,mage,frost,6,2,4
frostmourne,192,mage,frost,6,2,4
nerzhul,192,mage,frost,6,2,4
illidan,192,mage,frost,6,2,4
darkspear,192,mage,frost,6,2,4
barthilas,192,mage,frost,6,2,4
kiljaeden,192,mage,frost,6,2,4
thrall,192,mage,frost,6,2,4
nemesis,192,mage,frost,6,2,4
proudmoore,192,mage,frost,6,2,4
boulderfist,192,mage,frost,6,2,4
dentarg,192,mage,frost,6,2,4
kelthuzad,192,mage,frost,6,2,4
frostmourne,192,mage,frost,6,2,4
area-52,192,mage,frost,6,2,4
area-52,192,mage,frost,6,2,4
stonemaul,192,mage,frost,6,2,4
the-underbog,192,mage,frost,6,2,4
kelthuzad,192,mage,frost,6,2,4
velen,192,mage,frost,6,2,4
baelgun,192,mage,frost,6,2,4
tichondrius,192,mage,frost,6,2,4
tichondrius,192,mage,frost,6,2,4
malganis,192,mage,frost,6,2,4
azuremyst,192,mage,frost,6,2,4
tichondrius,192,mage,frost,6,2,4
kelthuzad,192,mage,frost,6,2,4
kelthuzad,192,mage,frost,6,2,4
sargeras,192,mage,frost,6,2,4
turalyon,192,mage,frost,6,2,4
black-dragonflight,192,mage,frost,6,2,4
tichondrius,192,mage,frost,6,2,4
shattered-halls,192,mage,frost,6,2,4
sargeras,192,mage,frost,6,2,4
jaedenar,192,mage,frost,6,2,4
tichondrius,192,mage,frost,6,2,4
proudmoore,192,mage,frost,6,2,4
quelthalas,192,mage,frost,6,2,4
barthilas,192,mage,frost,12,2,10
tichondrius,192,mage,frost,12,2,10
blackrock,192,mage,frost,12,2,10
spirestone,192,mage,frost,12,2,10
barthilas,192,mage,frost,12,2,10
fenris,192,mage,frost,12,2,10
zuljin,192,mage,frost,12,2,10
stormrage,192,mage,frost,12,2,10
shattered-hand,192,mage,frost,12,2,10
malganis,192,mage,frost,12,2,10
tichondrius,192,mage,frost,18,2,16
stormrage,191,mage,frost,4,3,1
stormrage,191,mage,frost,6,2,4
emerald-dream,191,mage,frost,6,2,4
gnomeregan,191,mage,frost,6,2,4
trollbane,191,mage,frost,6,2,4
emerald-dream,175,mage,frost,6,3,3
grizzly-hills,159,mage,frost,5,2,3
shattered-halls,159,mage,frost,5,2,3
tichondrius,144,mage,frost,15,2,13
tichondrius,128,mage,frost,4,2,2
frostmourne,127,mage,frost,4,2,2
bonechewer,126,mage,frost,8,2,6
shattered-hand,96,mage,frost,3,2,1
emerald-dream,96,mage,frost,3,2,1
sargeras,96,mage,frost,6,1,5
malganis,96,mage,frost,6,1,5
kelthuzad,96,mage,frost,6,1,5
quelthalas,96,mage,frost,6,1,5
chogall,96,mage,frost,6,1,5
tichondrius,96,mage,frost,6,1,5
thrall,96,mage,frost,6,1,5
proudmoore,96,mage,frost,6,1,5
andorhal,96,mage,frost,6,1,5
kelthuzad,96,mage,frost,6,1,5
sargeras,96,mage,frost,6,1,5
malganis,96,mage,frost,6,1,5
ragnaros,96,mage,frost,6,1,5
sargeras,96,mage,frost,6,1,5
tichondrius,96,mage,frost,6,1,5
zuljin,96,mage,frost,6,1,5
tichondrius,96,mage,frost,6,1,5
illidan,96,mage,frost,6,1,5
illidan,96,mage,frost,6,1,5
stormrage,96,mage,frost,6,1,5
tichondrius,96,mage,frost,6,1,5
malganis,96,mage,frost,6,1,5
hyjal,96,mage,frost,6,1,5
illidan,96,mage,frost,6,1,5
frostmourne,96,mage,frost,6,1,5
khadgar,96,mage,frost,6,1,5
wyrmrest-accord,96,mage,frost,6,1,5
laughing-skull,96,mage,frost,6,1,5
tichondrius,96,mage,frost,6,1,5
area-52,96,mage,frost,6,1,5
tichondrius,96,mage,frost,6,1,5
tichondrius,96,mage,frost,6,1,5
sargeras,96,mage,frost,12,1,11
suramar,96,mage,frost,12,1,11
tichondrius,96,mage,frost,13,1,12
illidan,79,mage,frost,5,1,4
illidan,79,mage,frost,11,1,10
tichondrius,64,mage,frost,4,1,3
ragnaros,48,mage,frost,3,1,2
cenarion-circle,48,mage,frost,3,1,2
stormreaver,2264,monk,mistweaver,68,47,21
tichondrius,2219,monk,mistweaver,206,121,85
thorium-brotherhood,2209,monk,mistweaver,140,80,60
kelthuzad,2179,monk,mistweaver,98,53,45
sargeras,2175,monk,mistweaver,72,47,25
tichondrius,2138,monk,mistweaver,81,50,31
tichondrius,2135,monk,mistweaver,66,49,17
tichondrius,2134,monk,mistweaver,126,67,59
tichondrius,2129,monk,mistweaver,108,70,38
sargeras,2129,monk,mistweaver,120,63,57
tichondrius,2127,monk,mistweaver,88,49,39
nagrand,2126,monk,mistweaver,68,41,27
kelthuzad,2126,monk,mistweaver,78,47,31
crushridge,2124,monk,mistweaver,102,60,42
tichondrius,2122,monk,mistweaver,90,52,38
tichondrius,2120,monk,mistweaver,89,50,39
proudmoore,2120,monk,mistweaver,99,53,46
emerald-dream,2115,monk,mistweaver,96,48,48
tichondrius,2114,monk,mistweaver,114,64,50
emerald-dream,2113,monk,mistweaver,72,42,30
sargeras,2112,monk,mistweaver,72,42,30
blackrock,2101,monk,mistweaver,107,51,56
sargeras,2094,monk,mistweaver,123,65,58
jubeithos,2093,monk,mistweaver,62,41,21
malganis,2086,monk,mistweaver,90,58,32
mugthol,2077,monk,mistweaver,72,42,30
zuljin,2074,monk,mistweaver,108,60,48
tichondrius,2058,monk,mistweaver,101,61,40
darkspear,2050,monk,mistweaver,65,37,28
tichondrius,2048,monk,mistweaver,66,40,26
emerald-dream,2047,monk,mistweaver,78,38,40
malganis,2039,monk,mistweaver,114,67,47
moon-guard,2031,monk,mistweaver,89,54,35
tichondrius,2020,monk,mistweaver,58,34,24
skullcrusher,2016,monk,mistweaver,60,41,19
area-52,2016,monk,mistweaver,126,63,63
tichondrius,2012,monk,mistweaver,54,34,20
greymane,2010,monk,mistweaver,78,46,32
terenas,2008,monk,mistweaver,355,187,168
tichondrius,1994,monk,mistweaver,102,63,39
kiljaeden,1989,monk,mistweaver,116,65,51
illidan,1987,monk,mistweaver,36,24,12
tichondrius,1950,monk,mistweaver,66,36,30
proudmoore,1950,monk,mistweaver,65,35,30
zuljin,1949,monk,mistweaver,88,54,34
tichondrius,1947,monk,mistweaver,78,39,39
darkspear,1941,monk,mistweaver,48,30,18
malygos,1940,monk,mistweaver,72,41,31
tichondrius,1935,monk,mistweaver,141,91,50
kalecgos,1932,monk,mistweaver,48,32,16
scilla,1928,monk,mistweaver,36,27,9
sargeras,1926,monk,mistweaver,126,64,62
azralon,1924,monk,mistweaver,78,44,34
velen,1923,monk,mistweaver,72,39,33
illidan,1921,monk,mistweaver,43,27,16
tichondrius,1920,monk,mistweaver,54,32,22
quelthalas,1919,monk,mistweaver,67,39,28
nazjatar,1918,monk,mistweaver,160,81,79
illidan,1915,monk,mistweaver,55,28,27
tichondrius,1910,monk,mistweaver,203,117,86
bloodhoof,1907,monk,mistweaver,76,40,36
stormrage,1891,monk,mistweaver,42,30,12
illidan,1889,monk,mistweaver,76,44,32
kelthuzad,1889,monk,mistweaver,179,91,88
icecrown,1887,monk,mistweaver,30,20,10
tichondrius,1885,monk,mistweaver,89,68,21
frostmourne,1883,monk,mistweaver,90,53,37
sargeras,1877,monk,mistweaver,42,28,14
tichondrius,1874,monk,mistweaver,45,30,15
malganis,1873,monk,mistweaver,36,25,11
bleeding-hollow,1873,monk,mistweaver,59,36,23
tichondrius,1871,monk,mistweaver,74,42,32
area-52,1869,monk,mistweaver,96,58,38
tichondrius,1868,monk,mistweaver,41,25,16
bleeding-hollow,1866,monk,mistweaver,42,25,17
stormreaver,1865,monk,mistweaver,48,31,17
quelthalas,1864,monk,mistweaver,174,98,76
tichondrius,1863,monk,mistweaver,39,30,9
tichondrius,1863,monk,mistweaver,59,33,26
tichondrius,1860,monk,mistweaver,65,41,24
barthilas,1860,monk,mistweaver,48,26,22
bleeding-hollow,1859,monk,mistweaver,64,31,33
tichondrius,1857,monk,mistweaver,54,36,18
sargeras,1855,monk,mistweaver,48,26,22
emerald-dream,1849,monk,mistweaver,60,38,22
illidan,1848,monk,mistweaver,48,27,21
tichondrius,1847,monk,mistweaver,56,30,26
tichondrius,1845,monk,mistweaver,42,25,17
emerald-dream,1844,monk,mistweaver,77,45,32
tichondrius,1843,monk,mistweaver,39,25,14
zuljin,1843,monk,mistweaver,60,35,25
illidan,1840,monk,mistweaver,98,65,33
stormrage,1840,monk,mistweaver,83,40,43
moon-guard,1839,monk,mistweaver,59,41,18
illidan,1837,monk,mistweaver,42,34,8
emerald-dream,1837,monk,mistweaver,113,72,41
sargeras,1837,monk,mistweaver,42,25,17
thrall,1837,monk,mistweaver,90,45,45
malganis,1836,monk,mistweaver,48,31,17
thrall,1836,monk,mistweaver,138,88,50
barthilas,1836,monk,mistweaver,109,51,58
tichondrius,1832,monk,mistweaver,182,102,80
tichondrius,1832,monk,mistweaver,60,27,33
turalyon,1831,monk,mistweaver,48,31,17
moon-guard,1831,monk,mistweaver,78,42,36
tichondrius,1827,monk,mistweaver,68,32,36
stormrage,1825,monk,mistweaver,89,56,33
moon-guard,1825,monk,mistweaver,66,35,31
frostmourne,1824,monk,mistweaver,50,31,19
illidan,1824,monk,mistweaver,81,34,47
warsong,1823,monk,mistweaver,80,47,33
illidan,1822,monk,mistweaver,29,20,9
zuljin,1821,monk,mistweaver,80,41,39
stormrage,1819,monk,mistweaver,60,30,30
tichondrius,1818,monk,mistweaver,86,54,32
exodar,1818,monk,mistweaver,117,62,55
barthilas,1817,monk,mistweaver,53,28,25
shattered-hand,1816,monk,mistweaver,30,19,11
jubeithos,1816,monk,mistweaver,105,62,43
sargeras,1815,monk,mistweaver,54,30,24
thrall,1815,monk,mistweaver,107,59,48
malygos,1815,monk,mistweaver,253,126,127
stormrage,1813,monk,mistweaver,90,64,26
khadgar,1813,monk,mistweaver,36,19,17
tichondrius,1811,monk,mistweaver,48,26,22
bonechewer,1810,monk,mistweaver,54,36,18
thunderlord,1808,monk,mistweaver,54,29,25
moon-guard,1807,monk,mistweaver,82,42,40
sargeras,1806,monk,mistweaver,24,19,5
moon-guard,1806,monk,mistweaver,53,30,23
shuhalo,1806,monk,mistweaver,49,26,23
zuljin,1805,monk,mistweaver,42,29,13
twisting-nether,1805,monk,mistweaver,42,23,19
ragnaros,1805,monk,mistweaver,256,139,117
malganis,1805,monk,mistweaver,72,29,43
the-underbog,1804,monk,mistweaver,66,42,24
sargeras,1802,monk,mistweaver,42,25,17
tichondrius,1802,monk,mistweaver,57,33,24
area-52,1802,monk,mistweaver,63,35,28
bleeding-hollow,1802,monk,mistweaver,39,20,19
moknathal,1801,monk,mistweaver,55,36,19
dalaran,1800,monk,mistweaver,35,23,12
stormrage,1799,monk,mistweaver,42,23,19
kelthuzad,1797,monk,mistweaver,116,67,49
tichondrius,1794,monk,mistweaver,67,30,37
caelestrasz,1793,monk,mistweaver,36,25,11
stormrage,1788,monk,mistweaver,47,22,25
ragnaros,1786,monk,mistweaver,30,21,9
frostmane,1783,monk,mistweaver,91,60,31
tichondrius,1782,monk,mistweaver,24,19,5
illidan,1781,monk,mistweaver,30,21,9
kelthuzad,1774,monk,mistweaver,30,19,11
illidan,1773,monk,mistweaver,54,31,23
tichondrius,1773,monk,mistweaver,72,38,34
smolderthorn,1770,monk,mistweaver,262,130,132
area-52,1765,monk,mistweaver,122,67,55
mannoroth,1762,monk,mistweaver,66,38,28
malganis,1758,monk,mistweaver,29,23,6
darkspear,1757,monk,mistweaver,47,29,18
illidan,1755,monk,mistweaver,75,45,30
illidan,1755,monk,mistweaver,60,32,28
tichondrius,1752,monk,mistweaver,68,41,27
stormrage,1750,monk,mistweaver,65,38,27
stormrage,1750,monk,mistweaver,74,42,32
dalaran,1748,monk,mistweaver,93,52,41
tichondrius,1747,monk,mistweaver,47,29,18
proudmoore,1744,monk,mistweaver,65,44,21
tichondrius,1741,monk,mistweaver,42,23,19
stormrage,1734,monk,mistweaver,36,26,10
stormrage,1733,monk,mistweaver,139,83,56
tichondrius,1731,monk,mistweaver,30,22,8
darkspear,1729,monk,mistweaver,78,46,32
quelthalas,1724,monk,mistweaver,59,35,24
frostmourne,1722,monk,mistweaver,47,26,21
tichondrius,1718,monk,mistweaver,42,25,17
stormrage,1717,monk,mistweaver,41,21,20
malganis,1716,monk,mistweaver,68,42,26
sargeras,1716,monk,mistweaver,36,21,15
tichondrius,1714,monk,mistweaver,54,25,29
dentarg,1712,monk,mistweaver,54,32,22
bonechewer,1710,monk,mistweaver,45,27,18
moon-guard,1710,monk,mistweaver,66,36,30
tichondrius,1710,monk,mistweaver,96,51,45
frostmourne,1708,monk,mistweaver,66,34,32
stormrage,1706,monk,mistweaver,36,18,18
tichondrius,1705,monk,mistweaver,30,18,12
illidan,1704,monk,mistweaver,54,34,20
proudmoore,1703,monk,mistweaver,36,22,14
area-52,1700,monk,mistweaver,108,66,42
sargeras,1696,monk,mistweaver,42,29,13
magtheridon,1696,monk,mistweaver,36,24,12
chromaggus,1696,monk,mistweaver,48,27,21
wyrmrest-accord,1695,monk,mistweaver,48,24,24
kelthuzad,1693,monk,mistweaver,36,24,12
ragnaros,1691,monk,mistweaver,100,53,47
tichondrius,1691,monk,mistweaver,65,29,36
area-52,1687,monk,mistweaver,24,19,5
arygos,1686,monk,mistweaver,144,74,70
illidan,1685,monk,mistweaver,48,23,25
illidan,1684,monk,mistweaver,167,86,81
saurfang,1682,monk,mistweaver,71,34,37
hellscream,1682,monk,mistweaver,143,68,75
bleeding-hollow,1681,monk,mistweaver,24,18,6
barthilas,1681,monk,mistweaver,33,20,13
malganis,1681,monk,mistweaver,48,29,19
bleeding-hollow,1681,monk,mistweaver,133,77,56
sargeras,1680,monk,mistweaver,36,30,6
sargeras,1678,monk,mistweaver,48,33,15
aegwynn,1677,monk,mistweaver,66,36,30
tichondrius,1674,monk,mistweaver,30,23,7
illidan,1673,monk,mistweaver,48,26,22
illidan,1671,monk,mistweaver,60,40,20
malganis,1671,monk,mistweaver,42,25,17
scilla,1670,monk,mistweaver,30,20,10
stormreaver,1669,monk,mistweaver,38,24,14
dalaran,1666,monk,mistweaver,263,135,128
tichondrius,1665,monk,mistweaver,74,46,28
illidan,1665,monk,mistweaver,42,25,17
area-52,1662,monk,mistweaver,24,20,4
proudmoore,1659,monk,mistweaver,30,22,8
tichondrius,1659,monk,mistweaver,71,38,33
barthilas,1655,monk,mistweaver,29,21,8
tichondrius,1654,monk,mistweaver,36,24,12
tichondrius,1653,monk,mistweaver,101,40,61
ragnaros,1652,monk,mistweaver,41,24,17
altar-of-storms,1652,monk,mistweaver,43,21,22
tichondrius,1646,monk,mistweaver,30,22,8
zuljin,1644,monk,mistweaver,47,25,22
tichondrius,1641,monk,mistweaver,36,22,14
area-52,1640,monk,mistweaver,21,19,2
zuljin,1639,monk,mistweaver,30,20,10
illidan,1636,monk,mistweaver,78,58,20
tichondrius,1635,monk,mistweaver,48,34,14
stormrage,1635,monk,mistweaver,42,23,19
malganis,1629,monk,mistweaver,36,23,13
zuljin,1629,monk,mistweaver,48,23,25
illidan,1628,monk,mistweaver,47,31,16
azralon,1628,monk,mistweaver,180,101,79
tichondrius,1627,monk,mistweaver,24,17,7
darkspear,1627,monk,mistweaver,28,19,9
proudmoore,1626,monk,mistweaver,59,44,15
bleeding-hollow,1625,monk,mistweaver,42,28,14
tichondrius,1624,monk,mistweaver,24,17,7
frostmourne,1624,monk,mistweaver,30,17,13
stormrage,1623,monk,mistweaver,30,17,13
illidan,1621,monk,mistweaver,24,17,7
thrall,1621,monk,mistweaver,24,17,7
frostmourne,1619,monk,mistweaver,30,17,13
tichondrius,1619,monk,mistweaver,78,42,36
tichondrius,1619,monk,mistweaver,104,47,57
azralon,1618,monk,mistweaver,30,21,9
thrall,1618,monk,mistweaver,45,29,16
kiljaeden,1617,monk,mistweaver,30,17,13
tichondrius,1616,monk,mistweaver,47,26,21
sargeras,1615,monk,mistweaver,30,20,10
thrall,1615,monk,mistweaver,40,25,15
deathwing,1613,monk,mistweaver,24,17,7
tichondrius,1613,monk,mistweaver,62,41,21
thrall,1612,monk,mistweaver,70,46,24
tichondrius,1612,monk,mistweaver,148,77,71
aerie-peak,1611,monk,mistweaver,24,17,7
stormreaver,1610,monk,mistweaver,81,46,35
tichondrius,1610,monk,mistweaver,36,20,16
quelthalas,1610,monk,mistweaver,66,28,38
illidan,1609,monk,mistweaver,32,17,15
durotan,1608,monk,mistweaver,53,30,23
azralon,1608,monk,mistweaver,90,49,41
dalaran,1607,monk,mistweaver,30,22,8
nazjatar,1607,monk,mistweaver,67,45,22
moon-guard,1605,monk,mistweaver,93,60,33
tichondrius,1605,monk,mistweaver,78,43,35
area-52,1605,monk,mistweaver,59,31,28
kiljaeden,1605,monk,mistweaver,66,32,34
wildhammer,1604,monk,mistweaver,61,36,25
bleeding-hollow,1602,monk,mistweaver,128,79,49
tichondrius,1601,monk,mistweaver,46,25,21
emerald-dream,1601,monk,mistweaver,48,24,24
mannoroth,1600,monk,mistweaver,58,41,17
malganis,1599,monk,mistweaver,28,18,10
tichondrius,1599,monk,mistweaver,78,38,40
vashj,1596,monk,mistweaver,48,21,27
area-52,1595,monk,mistweaver,42,23,19
barthilas,1594,monk,mistweaver,44,30,14
ragnaros,1594,monk,mistweaver,58,24,34
kelthuzad,1592,monk,mistweaver,30,19,11
icecrown,1589,monk,mistweaver,31,27,4
trollbane,1589,monk,mistweaver,53,34,19
area-52,1589,monk,mistweaver,42,19,23
stormrage,1586,monk,mistweaver,130,72,58
hyjal,1585,monk,mistweaver,52,30,22
tichondrius,1584,monk,mistweaver,68,34,34
illidan,1583,monk,mistweaver,31,22,9
tichondrius,1581,monk,mistweaver,48,29,19
lightbringer,1581,monk,mistweaver,29,17,12
area-52,1581,monk,mistweaver,29,17,12
ragnaros,1579,monk,mistweaver,53,31,22
proudmoore,1577,monk,mistweaver,102,43,59
malganis,1574,monk,mistweaver,48,25,23
moon-guard,1573,monk,mistweaver,67,41,26
tichondrius,1572,monk,mistweaver,263,132,131
tichondrius,1569,monk,mistweaver,42,21,21
tichondrius,1566,monk,mistweaver,40,23,17
sargeras,1561,monk,mistweaver,87,49,38
bleeding-hollow,1557,monk,mistweaver,100,52,48
tichondrius,1556,monk,mistweaver,41,20,21
ragnaros,1552,monk,mistweaver,200,101,99
sargeras,1550,monk,mistweaver,42,21,21
caelestrasz,1548,monk,mistweaver,30,17,13
illidan,1548,monk,mistweaver,117,62,55
tichondrius,1547,monk,mistweaver,62,27,35
tichondrius,1546,monk,mistweaver,55,33,22
tichondrius,1543,monk,mistweaver,51,29,22
nemesis,1543,monk,mistweaver,38,20,18
sargeras,1542,monk,mistweaver,36,22,14
tichondrius,1542,monk,mistweaver,107,60,47
moon-guard,1539,monk,mistweaver,112,54,58
moon-guard,1534,monk,mistweaver,94,43,51
tichondrius,1533,monk,mistweaver,84,48,36
saurfang,1532,monk,mistweaver,30,16,14
zuljin,1530,monk,mistweaver,72,44,28
illidan,1529,monk,mistweaver,18,16,2
tichondrius,1529,monk,mistweaver,24,16,8
wyrmrest-accord,1529,monk,mistweaver,87,48,39
area-52,1527,monk,mistweaver,38,23,15
azralon,1527,monk,mistweaver,75,41,34
eredar,1527,monk,mistweaver,37,20,17
kelthuzad,1526,monk,mistweaver,30,16,14
tichondrius,1525,monk,mistweaver,30,16,14
stormscale,1524,monk,mistweaver,116,69,47
thaurissan,1522,monk,mistweaver,83,41,42
ragnaros,1522,monk,mistweaver,76,37,39
stormrage,1519,monk,mistweaver,30,16,14
sargeras,1513,monk,mistweaver,48,22,26
bleeding-hollow,1511,monk,mistweaver,36,25,11
korgath,1507,monk,mistweaver,42,26,16
daggerspine,1507,monk,mistweaver,48,23,25
emerald-dream,1496,monk,mistweaver,72,34,38
proudmoore,1493,monk,mistweaver,95,55,40
tichondrius,1487,monk,mistweaver,82,43,39
dawnbringer,1487,monk,mistweaver,62,27,35
azralon,1486,monk,mistweaver,54,33,21
bleeding-hollow,1486,monk,mistweaver,42,23,19
runetotem,1484,monk,mistweaver,33,20,13
sargeras,1483,monk,mistweaver,42,22,20
area-52,1482,monk,mistweaver,64,39,25
tichondrius,1481,monk,mistweaver,36,26,10
tichondrius,1481,monk,mistweaver,46,29,17
nagrand,1481,monk,mistweaver,48,27,21
moon-guard,1480,monk,mistweaver,33,18,15
ysondre,1480,monk,mistweaver,65,31,34
azuremyst,1477,monk,mistweaver,63,41,22
stormrage,1476,monk,mistweaver,42,26,16
malganis,1473,monk,mistweaver,36,26,10
shattered-halls,1473,monk,mistweaver,42,26,16
tichondrius,1472,monk,mistweaver,33,17,16
lothar,1471,monk,mistweaver,42,28,14
caelestrasz,1470,monk,mistweaver,42,19,23
proudmoore,1467,monk,mistweaver,48,22,26
bleeding-hollow,1465,monk,mistweaver,42,27,15
aggramar,1464,monk,mistweaver,30,19,11
frostmourne,1462,monk,mistweaver,54,30,24
dalaran,1459,monk,mistweaver,48,25,23
zuljin,1457,monk,mistweaver,38,18,20
stormrage,1457,monk,mistweaver,78,35,43
sargeras,1457,monk,mistweaver,47,20,27
darkspear,1455,monk,mistweaver,48,19,29
tichondrius,1453,monk,mistweaver,41,25,16
thrall,1453,monk,mistweaver,47,24,23
tichondrius,1451,monk,mistweaver,54,29,25
quelthalas,1450,monk,mistweaver,39,27,12
stormreaver,1446,monk,mistweaver,42,18,24
moon-guard,1445,monk,mistweaver,24,20,4
sargeras,1445,monk,mistweaver,52,27,25
moon-guard,1444,monk,mistweaver,116,63,53
quelthalas,1443,monk,mistweaver,30,19,11
quelthalas,1443,monk,mistweaver,42,18,24
tichondrius,1439,monk,mistweaver,24,15,9
tichondrius,1438,monk,mistweaver,24,15,9
tichondrius,1438,monk,mistweaver,24,15,9
tichondrius,1435,monk,mistweaver,30,15,15
tichondrius,1432,monk,mistweaver,24,16,8
zuljin,1431,monk,mistweaver,21,16,5
kelthuzad,1429,monk,mistweaver,20,17,3
kiljaeden,1428,monk,mistweaver,42,19,23
chogall,1427,monk,mistweaver,53,22,31
stormrage,1425,monk,mistweaver,24,15,9
malganis,1424,monk,mistweaver,24,15,9
hyjal,1421,monk,mistweaver,30,15,15
darkspear,1419,monk,mistweaver,24,15,9
moon-guard,1416,monk,mistweaver,54,32,22
tichondrius,1411,monk,mistweaver,41,25,16
sargeras,1408,monk,mistweaver,60,32,28
boulderfist,1406,monk,mistweaver,41,20,21
stormrage,1404,monk,mistweaver,23,15,8
frostmourne,1403,monk,mistweaver,30,15,15
duskwood,1402,monk,mistweaver,156,68,88
garithos,1398,monk,mistweaver,28,20,8
bleeding-hollow,1398,monk,mistweaver,78,34,44
barthilas,1392,monk,mistweaver,41,16,25
illidan,1390,monk,mistweaver,54,20,34
sargeras,1388,monk,mistweaver,23,15,8
gilneas,1387,monk,mistweaver,30,19,11
tichondrius,1384,monk,mistweaver,26,18,8
tichondrius,1382,monk,mistweaver,24,17,7
tichondrius,1381,monk,mistweaver,29,15,14
ragnaros,1375,monk,mistweaver,36,20,16
lothar,1371,monk,mistweaver,60,33,27
ghostlands,1368,monk,mistweaver,20,15,5
burning-blade,1368,monk,mistweaver,60,30,30
nemesis,1368,monk,mistweaver,43,20,23
agamaggan,1366,monk,mistweaver,30,17,13
gundrak,1363,monk,mistweaver,63,37,26
dalaran,1363,monk,mistweaver,30,16,14
frostmourne,1363,monk,mistweaver,29,15,14
azralon,1362,monk,mistweaver,46,24,22
frostmourne,1355,monk,mistweaver,52,31,21
stormrage,1354,monk,mistweaver,23,15,8
shuhalo,1352,monk,mistweaver,42,23,19
azjolnerub,1348,monk,mistweaver,49,26,23
ragnaros,1347,monk,mistweaver,123,57,66
aerie-peak,1346,monk,mistweaver,59,36,23
turalyon,1346,monk,mistweaver,42,19,23
rivendare,1344,monk,mistweaver,33,17,16
stormreaver,1343,monk,mistweaver,18,14,4
tichondrius,1343,monk,mistweaver,18,14,4
draka,1343,monk,mistweaver,40,25,15
sargeras,1343,monk,mistweaver,24,14,10
spinebreaker,1343,monk,mistweaver,30,14,16
llane,1342,monk,mistweaver,24,14,10
tichondrius,1342,monk,mistweaver,24,14,10
tichondrius,1341,monk,mistweaver,18,14,4
thrall,1340,monk,mistweaver,18,14,4
burning-blade,1339,monk,mistweaver,18,14,4
bleeding-hollow,1337,monk,mistweaver,24,14,10
skullcrusher,1336,monk,mistweaver,24,14,10
tichondrius,1336,monk,mistweaver,24,14,10
exodar,1336,monk,mistweaver,30,17,13
crushridge,1335,monk,mistweaver,24,14,10
drakkari,1335,monk,mistweaver,36,17,19
wyrmrest-accord,1335,monk,mistweaver,35,16,19
tichondrius,1334,monk,mistweaver,24,14,10
ragnaros,1333,monk,mistweaver,59,33,26
whisperwind,1332,monk,mistweaver,24,14,10
moon-guard,1330,monk,mistweaver,24,14,10
tichondrius,1328,monk,mistweaver,24,14,10
sargeras,1325,monk,mistweaver,36,15,21
azgalor,1324,monk,mistweaver,24,14,10
malygos,1323,monk,mistweaver,30,16,14
zuljin,1322,monk,mistweaver,24,15,9
spirestone,1322,monk,mistweaver,24,14,10
gallywix,1321,monk,mistweaver,71,38,33
area-52,1321,monk,mistweaver,50,26,24
tichondrius,1318,monk,mistweaver,77,37,40
frostmourne,1316,monk,mistweaver,24,14,10
spirestone,1316,monk,mistweaver,53,28,25
azralon,1315,monk,mistweaver,35,21,14
tichondrius,1314,monk,mistweaver,36,16,20
azralon,1313,monk,mistweaver,42,20,22
frostmourne,1313,monk,mistweaver,64,28,36
illidan,1309,monk,mistweaver,24,14,10
lothar,1309,monk,mistweaver,31,18,13
frostmourne,1308,monk,mistweaver,24,14,10
thrall,1308,monk,mistweaver,57,32,25
illidan,1305,monk,mistweaver,66,40,26
ravencrest,1305,monk,mistweaver,25,14,11
stormrage,1304,monk,mistweaver,30,15,15
arthas,1302,monk,mistweaver,27,14,13
wyrmrest-accord,1300,monk,mistweaver,175,89,86
bleeding-hollow,1298,monk,mistweaver,24,14,10
moon-guard,1291,monk,mistweaver,78,38,40
kiljaeden,1289,monk,mistweaver,23,14,9
stormreaver,1287,monk,mistweaver,40,16,24
proudmoore,1280,monk,mistweaver,38,22,16
aerie-peak,1279,monk,mistweaver,48,31,17
moon-guard,1279,monk,mistweaver,45,24,21
moon-guard,1277,monk,mistweaver,35,20,15
bleeding-hollow,1272,monk,mistweaver,31,15,16
tichondrius,1270,monk,mistweaver,42,27,15
frostmourne,1262,monk,mistweaver,36,20,16
blades-edge,1262,monk,mistweaver,29,14,15
sargeras,1251,monk,mistweaver,56,24,32
sargeras,1248,monk,mistweaver,18,13,5
illidan,1248,monk,mistweaver,24,13,11
frostmourne,1247,monk,mistweaver,18,13,5
frostmane,1247,monk,mistweaver,18,13,5
grizzly-hills,1247,monk,mistweaver,24,13,11
tichondrius,1247,monk,mistweaver,24,13,11
eitrigg,1247,monk,mistweaver,24,13,11
tichondrius,1247,monk,mistweaver,60,31,29
icecrown,1247,monk,mistweaver,36,13,23
tichondrius,1245,monk,mistweaver,18,13,5
malfurion,1245,monk,mistweaver,60,25,35
ragnaros,1245,monk,mistweaver,45,18,27
azralon,1244,monk,mistweaver,24,13,11
frostwolf,1242,monk,mistweaver,18,13,5
saurfang,1240,monk,mistweaver,24,17,7
doomhammer,1236,monk,mistweaver,39,14,25
elune,1234,monk,mistweaver,30,21,9
spirestone,1234,monk,mistweaver,24,13,11
misha,1232,monk,mistweaver,24,13,11
barthilas,1231,monk,mistweaver,42,20,22
sargeras,1231,monk,mistweaver,48,22,26
stormrage,1229,monk,mistweaver,30,14,16
dalaran,1227,monk,mistweaver,30,13,17
illidan,1226,monk,mistweaver,42,21,21
tichondrius,1222,monk,mistweaver,37,13,24
aerie-peak,1219,monk,mistweaver,32,20,12
gnomeregan,1211,monk,mistweaver,18,13,5
stormscale,1205,monk,mistweaver,45,21,24
wyrmrest-accord,1198,monk,mistweaver,26,14,12
nazgrel,1196,monk,mistweaver,24,13,11
terenas,1187,monk,mistweaver,54,25,29
frostmourne,1178,monk,mistweaver,41,28,13
tichondrius,1176,monk,mistweaver,20,13,7
quelthalas,1176,monk,mistweaver,63,31,32
tichondrius,1175,monk,mistweaver,48,23,25
area-52,1174,monk,mistweaver,42,24,18
emerald-dream,1168,monk,mistweaver,59,24,35
laughing-skull,1166,monk,mistweaver,90,38,52
thrall,1165,monk,mistweaver,28,14,14
tichondrius,1162,monk,mistweaver,76,24,52
amanthul,1155,monk,mistweaver,26,13,13
stormrage,1155,monk,mistweaver,59,29,30
firetree,1153,monk,mistweaver,22,13,9
hyjal,1152,monk,mistweaver,18,12,6
garrosh,1152,monk,mistweaver,18,12,6
tichondrius,1152,monk,mistweaver,30,12,18
shadowsong,1150,monk,mistweaver,24,12,12
illidan,1150,monk,mistweaver,30,12,18
korgath,1149,monk,mistweaver,25,13,12
emerald-dream,1149,monk,mistweaver,24,12,12
silvermoon,1147,monk,mistweaver,18,14,4
tichondrius,1146,monk,mistweaver,18,12,6
proudmoore,1146,monk,mistweaver,29,13,16
area-52,1145,monk,mistweaver,18,12,6
ursin,1145,monk,mistweaver,78,37,41
wyrmrest-accord,1135,monk,mistweaver,45,18,27
nerzhul,1132,monk,mistweaver,99,52,47
tichondrius,1131,monk,mistweaver,18,12,6
sargeras,1131,monk,mistweaver,24,12,12
area-52,1130,monk,mistweaver,26,14,12
ragnaros,1127,monk,mistweaver,35,15,20
sargeras,1125,monk,mistweaver,18,12,6
emerald-dream,1123,monk,mistweaver,198,99,99
zuljin,1114,monk,mistweaver,26,13,13
tichondrius,1111,monk,mistweaver,42,29,13
tichondrius,1108,monk,mistweaver,79,46,33
drakkari,1107,monk,mistweaver,31,15,16
korgath,1106,monk,mistweaver,52,31,21
tichondrius,1104,monk,mistweaver,23,12,11
barthilas,1104,monk,mistweaver,48,22,26
proudmoore,1100,monk,mistweaver,21,13,8
kilrogg,1098,monk,mistweaver,27,13,14
draka,1096,monk,mistweaver,44,30,14
tichondrius,1089,monk,mistweaver,18,13,5
tichondrius,1086,monk,mistweaver,17,12,5
azjolnerub,1078,monk,mistweaver,74,32,42
black-dragonflight,1070,monk,mistweaver,19,12,7
kelthuzad,1056,monk,mistweaver,12,11,1
the-scryers,1056,monk,mistweaver,12,11,1
tichondrius,1056,monk,mistweaver,18,11,7
sargeras,1056,monk,mistweaver,18,11,7
thrall,1056,monk,mistweaver,18,11,7
malganis,1056,monk,mistweaver,24,11,13
kelthuzad,1056,monk,mistweaver,24,11,13
area-52,1056,monk,mistweaver,24,11,13
illidan,1055,monk,mistweaver,18,11,7
thrall,1055,monk,mistweaver,18,11,7
zuljin,1055,monk,mistweaver,18,11,7
tichondrius,1055,monk,mistweaver,18,11,7
frostmourne,1055,monk,mistweaver,24,11,13
ragnaros,1055,monk,mistweaver,24,11,13
proudmoore,1055,monk,mistweaver,24,11,13
hyjal,1054,monk,mistweaver,42,17,25
ragnaros,1054,monk,mistweaver,36,11,25
the-forgotten-coast,1052,monk,mistweaver,18,11,7
turalyon,1052,monk,mistweaver,18,11,7
frostmourne,1052,monk,mistweaver,24,11,13
illidan,1049,monk,mistweaver,18,11,7
andorhal,1049,monk,mistweaver,24,11,13
tichondrius,1047,monk,mistweaver,18,11,7
moon-guard,1044,monk,mistweaver,34,16,18
tichondrius,1042,monk,mistweaver,24,11,13
frostmourne,1039,monk,mistweaver,18,11,7
wyrmrest-accord,1038,monk,mistweaver,48,20,28
tichondrius,1035,monk,mistweaver,166,82,84
dalaran,1033,monk,mistweaver,37,17,20
nemesis,1032,monk,mistweaver,24,11,13
tichondrius,1032,monk,mistweaver,30,11,19
tichondrius,1031,monk,mistweaver,36,20,16
zuljin,1026,monk,mistweaver,12,11,1
nagrand,1016,monk,mistweaver,30,15,15
malganis,1016,monk,mistweaver,28,12,16
hellscream,1015,monk,mistweaver,30,14,16
moon-guard,1014,monk,mistweaver,23,15,8
quelthalas,1007,monk,mistweaver,15,12,3
magtheridon,1007,monk,mistweaver,21,12,9
tichondrius,1000,monk,mistweaver,23,11,12
tichondrius,997,monk,mistweaver,17,11,6
proudmoore,996,monk,mistweaver,18,11,7
ysondre,994,monk,mistweaver,35,24,11
azralon,983,monk,mistweaver,48,27,21
gilneas,983,monk,mistweaver,64,35,29
moknathal,969,monk,mistweaver,32,21,11
arathor,960,monk,mistweaver,12,10,2
ursin,960,monk,mistweaver,12,10,2
tichondrius,960,monk,mistweaver,18,10,8
ragnaros,960,monk,mistweaver,18,10,8
tichondrius,960,monk,mistweaver,18,10,8
emerald-dream,960,monk,mistweaver,18,10,8
illidan,960,monk,mistweaver,18,10,8
frostmourne,960,monk,mistweaver,18,10,8
spirestone,960,monk,mistweaver,24,10,14
ragnaros,959,monk,mistweaver,12,10,2
frostmourne,959,monk,mistweaver,12,10,2
illidan,959,monk,mistweaver,12,10,2
tichondrius,959,monk,mistweaver,15,11,4
tichondrius,959,monk,mistweaver,18,10,8
tichondrius,959,monk,mistweaver,18,10,8
sargeras,959,monk,mistweaver,18,10,8
sargeras,959,monk,mistweaver,18,10,8
frostmourne,959,monk,mistweaver,18,10,8
frostwolf,959,monk,mistweaver,18,10,8
proudmoore,959,monk,mistweaver,48,25,23
arthas,959,monk,mistweaver,24,10,14
tichondrius,958,monk,mistweaver,18,10,8
kelthuzad,958,monk,mistweaver,24,10,14
thrall,955,monk,mistweaver,18,10,8
sargeras,954,monk,mistweaver,18,10,8
deathwing,954,monk,mistweaver,31,14,17
tichondrius,951,monk,mistweaver,24,10,14
illidan,950,monk,mistweaver,18,10,8
moon-guard,949,monk,mistweaver,18,10,8
korgath,947,monk,mistweaver,36,10,26
barthilas,945,monk,mistweaver,69,31,38
tichondrius,926,monk,mistweaver,14,11,3
tichondrius,909,monk,mistweaver,30,17,13
tichondrius,909,monk,mistweaver,27,10,17
quelthalas,908,monk,mistweaver,15,11,4
cenarius,895,monk,mistweaver,11,10,1
illidan,888,monk,mistweaver,15,11,4
tichondrius,878,monk,mistweaver,11,10,1
arthas,864,monk,mistweaver,12,9,3
sargeras,864,monk,mistweaver,12,9,3
malorne,864,monk,mistweaver,12,9,3
alterac-mountains,864,monk,mistweaver,12,9,3
wyrmrest-accord,864,monk,mistweaver,12,9,3
emerald-dream,864,monk,mistweaver,12,9,3
sargeras,864,monk,mistweaver,12,9,3
dalaran,864,monk,mistweaver,12,9,3
tichondrius,864,monk,mistweaver,18,9,9
tichondrius,864,monk,mistweaver,18,9,9
kelthuzad,864,monk,mistweaver,18,9,9
tichondrius,864,monk,mistweaver,18,9,9
area-52,864,monk,mistweaver,18,9,9
sargeras,864,monk,mistweaver,18,9,9
zuluhed,864,monk,mistweaver,24,9,15
skullcrusher,864,monk,mistweaver,24,9,15
malganis,864,monk,mistweaver,69,14,55
dathremar,863,monk,mistweaver,12,9,3
ragnaros,863,monk,mistweaver,12,9,3
dalaran,863,monk,mistweaver,12,9,3
illidan,863,monk,mistweaver,18,9,9
doomhammer,863,monk,mistweaver,18,9,9
illidan,863,monk,mistweaver,18,9,9
kelthuzad,863,monk,mistweaver,18,9,9
gorgonnash,862,monk,mistweaver,12,9,3
nesingwary,862,monk,mistweaver,24,9,15
nemesis,862,monk,mistweaver,24,9,15
tichondrius,861,monk,mistweaver,12,9,3
ragnaros,860,monk,mistweaver,12,9,3
emerald-dream,860,monk,mistweaver,18,9,9
illidan,860,monk,mistweaver,18,9,9
burning-blade,859,monk,mistweaver,24,9,15
bonechewer,858,monk,mistweaver,12,9,3
warsong,855,monk,mistweaver,12,9,3
sargeras,855,monk,mistweaver,24,9,15
moon-guard,855,monk,mistweaver,24,9,15
aerie-peak,851,monk,mistweaver,18,9,9
khazgoroth,847,monk,mistweaver,18,9,9
stormrage,837,monk,mistweaver,32,9,23
madoran,809,monk,mistweaver,27,10,17
mugthol,769,monk,mistweaver,30,10,20
area-52,768,monk,mistweaver,12,8,4
sargeras,768,monk,mistweaver,12,8,4
malganis,768,monk,mistweaver,12,8,4
stormrage,768,monk,mistweaver,12,8,4
stormscale,768,monk,mistweaver,12,8,4
ghostlands,768,monk,mistweaver,12,8,4
thunderlord,768,monk,mistweaver,12,8,4
tichondrius,768,monk,mistweaver,12,8,4
malganis,768,monk,mistweaver,12,8,4
frostmourne,768,monk,mistweaver,12,8,4
tichondrius,768,monk,mistweaver,12,8,4
tichondrius,768,monk,mistweaver,12,8,4
stormrage,768,monk,mistweaver,12,8,4
proudmoore,768,monk,mistweaver,12,8,4
sargeras,768,monk,mistweaver,12,8,4
rexxar,768,monk,mistweaver,18,8,10
zuljin,768,monk,mistweaver,18,8,10
kelthuzad,768,monk,mistweaver,18,8,10
bonechewer,768,monk,mistweaver,18,8,10
tichondrius,768,monk,mistweaver,18,8,10
tichondrius,768,monk,mistweaver,18,8,10
tichondrius,767,monk,mistweaver,12,8,4
frostmourne,767,monk,mistweaver,12,8,4
stormrage,767,monk,mistweaver,12,8,4
lightbringer,767,monk,mistweaver,12,8,4
frostmourne,767,monk,mistweaver,12,8,4
thrall,767,monk,mistweaver,12,8,4
stormreaver,767,monk,mistweaver,12,8,4
ragnaros,767,monk,mistweaver,18,8,10
bleeding-hollow,767,monk,mistweaver,18,8,10
tichondrius,767,monk,mistweaver,18,8,10
aegwynn,766,monk,mistweaver,12,8,4
stormrage,766,monk,mistweaver,12,8,4
wyrmrest-accord,765,monk,mistweaver,12,8,4
tichondrius,765,monk,mistweaver,18,8,10
illidan,765,monk,mistweaver,18,8,10
tichondrius,765,monk,mistweaver,18,8,10
boulderfist,764,monk,mistweaver,12,8,4
fizzcrank,764,monk,mistweaver,18,8,10
quelthalas,745,monk,mistweaver,12,8,4
bleeding-hollow,735,monk,mistweaver,17,8,9
tichondrius,732,monk,mistweaver,14,9,5
frostmourne,720,monk,mistweaver,15,9,6
stormrage,714,monk,mistweaver,21,9,12
illidan,712,monk,mistweaver,15,9,6
tichondrius,703,monk,mistweaver,11,8,3
illidan,703,monk,mistweaver,11,8,3
tichondrius,692,monk,mistweaver,24,8,16
malganis,672,monk,mistweaver,12,7,5
turalyon,672,monk,mistweaver,12,7,5
kiljaeden,672,monk,mistweaver,12,7,5
draktharon,672,monk,mistweaver,12,7,5
ragnaros,672,monk,mistweaver,12,7,5
kelthuzad,672,monk,mistweaver,12,7,5
moon-guard,672,monk,mistweaver,12,7,5
bleeding-hollow,672,monk,mistweaver,12,7,5
tichondrius,672,monk,mistweaver,12,7,5
area-52,672,monk,mistweaver,12,7,5
wyrmrest-accord,672,monk,mistweaver,12,7,5
boulderfist,672,monk,mistweaver,12,7,5
dalaran,672,monk,mistweaver,12,7,5
illidan,672,monk,mistweaver,12,7,5
tichondrius,672,monk,mistweaver,12,7,5
nagrand,672,monk,mistweaver,12,7,5
illidan,672,monk,mistweaver,12,7,5
stormrage,672,monk,mistweaver,12,7,5
barthilas,672,monk,mistweaver,12,7,5
illidan,672,monk,mistweaver,12,7,5
illidan,672,monk,mistweaver,12,7,5
tichondrius,672,monk,mistweaver,12,7,5
barthilas,672,monk,mistweaver,12,7,5
proudmoore,672,monk,mistweaver,12,7,5
thrall,672,monk,mistweaver,12,7,5
tichondrius,672,monk,mistweaver,12,7,5
firetree,672,monk,mistweaver,13,7,6
burning-legion,672,monk,mistweaver,15,8,7
jubeithos,672,monk,mistweaver,14,7,7
tichondrius,672,monk,mistweaver,14,7,7
frostmourne,672,monk,mistweaver,18,7,11
area-52,672,monk,mistweaver,18,7,11
destromath,672,monk,mistweaver,18,7,11
tichondrius,672,monk,mistweaver,18,7,11
emerald-dream,672,monk,mistweaver,24,7,17
tichondrius,671,monk,mistweaver,12,7,5
bleeding-hollow,671,monk,mistweaver,12,7,5
proudmoore,671,monk,mistweaver,12,7,5
bleeding-hollow,671,monk,mistweaver,12,7,5
drakkari,671,monk,mistweaver,12,7,5
tichondrius,671,monk,mistweaver,12,7,5
blackhand,671,monk,mistweaver,12,7,5
skullcrusher,671,monk,mistweaver,13,7,6
wyrmrest-accord,671,monk,mistweaver,16,8,8
trollbane,671,monk,mistweaver,18,7,11
ragnaros,671,monk,mistweaver,18,7,11
ysera,671,monk,mistweaver,18,7,11
malganis,671,monk,mistweaver,24,7,17
ravencrest,670,monk,mistweaver,12,7,5
saurfang,670,monk,mistweaver,28,8,20
uldum,669,monk,mistweaver,18,7,11
blackhand,668,monk,mistweaver,18,7,11
azjolnerub,667,monk,mistweaver,12,7,5
frostmourne,667,monk,mistweaver,18,7,11
stormrage,639,monk,mistweaver,11,7,4
bleeding-hollow,638,monk,mistweaver,14,8,6
tichondrius,624,monk,mistweaver,15,7,8
area-52,624,monk,mistweaver,15,7,8
barthilas,623,monk,mistweaver,11,7,4
crushridge,623,monk,mistweaver,11,7,4
proudmoore,623,monk,mistweaver,11,7,4
tichondrius,623,monk,mistweaver,11,7,4
tichondrius,592,monk,mistweaver,7,7,0
shandris,587,monk,mistweaver,13,7,6
illidan,576,monk,mistweaver,6,6,0
kiljaeden,576,monk,mistweaver,6,6,0
korgath,576,monk,mistweaver,6,6,0
illidan,576,monk,mistweaver,6,6,0
lightbringer,576,monk,mistweaver,6,6,0
malganis,576,monk,mistweaver,6,6,0
zuljin,576,monk,mistweaver,6,6,0
azjolnerub,576,monk,mistweaver,6,6,0
stormreaver,576,monk,mistweaver,6,6,0
boulderfist,576,monk,mistweaver,6,6,0
illidan,576,monk,mistweaver,12,6,6
emerald-dream,576,monk,mistweaver,12,6,6
stormreaver,576,monk,mistweaver,12,6,6
ragnaros,576,monk,mistweaver,12,6,6
tichondrius,576,monk,mistweaver,12,6,6
malganis,576,monk,mistweaver,12,6,6
barthilas,576,monk,mistweaver,12,6,6
skullcrusher,576,monk,mistweaver,12,6,6
thrall,576,monk,mistweaver,12,6,6
area-52,576,monk,mistweaver,12,6,6
area-52,576,monk,mistweaver,12,6,6
korgath,576,monk,mistweaver,12,6,6
bleeding-hollow,576,monk,mistweaver,12,6,6
tichondrius,576,monk,mistweaver,12,6,6
area-52,576,monk,mistweaver,12,6,6
wyrmrest-accord,576,monk,mistweaver,12,6,6
tichondrius,576,monk,mistweaver,12,6,6
area-52,576,monk,mistweaver,12,6,6
dathremar,576,monk,mistweaver,12,6,6
detheroc,576,monk,mistweaver,12,6,6
illidan,576,monk,mistweaver,12,6,6
tichondrius,576,monk,mistweaver,12,6,6
tichondrius,576,monk,mistweaver,12,6,6
illidan,576,monk,mistweaver,12,6,6
area-52,576,monk,mistweaver,12,6,6
kelthuzad,576,monk,mistweaver,18,6,12
ysondre,576,monk,mistweaver,18,6,12
malganis,575,monk,mistweaver,6,6,0
tichondrius,575,monk,mistweaver,12,6,6
barthilas,575,monk,mistweaver,12,6,6
nordrassil,575,monk,mistweaver,12,6,6
azuremyst,575,monk,mistweaver,12,6,6
sargeras,575,monk,mistweaver,12,6,6
area-52,575,monk,mistweaver,12,6,6
stormrage,575,monk,mistweaver,13,6,7
frostmourne,575,monk,mistweaver,18,6,12
area-52,574,monk,mistweaver,12,6,6
illidan,574,monk,mistweaver,12,6,6
illidan,574,monk,mistweaver,18,6,12
skullcrusher,572,monk,mistweaver,12,6,6
tichondrius,571,monk,mistweaver,12,6,6
tichondrius,569,monk,mistweaver,12,6,6
proudmoore,559,monk,mistweaver,17,6,11
sargeras,527,monk,mistweaver,11,6,5
emerald-dream,524,monk,mistweaver,15,7,8
illidan,512,monk,mistweaver,16,6,10
nemesis,511,monk,mistweaver,8,6,2
mannoroth,511,monk,mistweaver,11,6,5
borean-tundra,496,monk,mistweaver,13,6,7
cairne,496,monk,mistweaver,19,6,13
illidan,480,monk,mistweaver,6,5,1
sargeras,480,monk,mistweaver,6,5,1
dreadmaul,480,monk,mistweaver,6,5,1
azshara,480,monk,mistweaver,6,5,1
tichondrius,480,monk,mistweaver,6,5,1
stormrage,480,monk,mistweaver,6,5,1
stormrage,480,monk,mistweaver,6,5,1
ragnaros,480,monk,mistweaver,6,5,1
terenas,480,monk,mistweaver,6,5,1
dragonmaw,480,monk,mistweaver,6,5,1
tichondrius,480,monk,mistweaver,6,5,1
tichondrius,480,monk,mistweaver,6,5,1
tichondrius,480,monk,mistweaver,6,5,1
stormreaver,480,monk,mistweaver,6,5,1
zuljin,480,monk,mistweaver,6,5,1
wyrmrest-accord,480,monk,mistweaver,6,5,1
tichondrius,480,monk,mistweaver,6,5,1
the-forgotten-coast,480,monk,mistweaver,6,5,1
arthas,480,monk,mistweaver,6,5,1
ragnaros,480,monk,mistweaver,6,5,1
tichondrius,480,monk,mistweaver,6,5,1
tichondrius,480,monk,mistweaver,6,5,1
kul-tiras,480,monk,mistweaver,6,5,1
tichondrius,480,monk,mistweaver,12,5,7
illidan,480,monk,mistweaver,12,5,7
stormscale,480,monk,mistweaver,12,5,7
emerald-dream,480,monk,mistweaver,12,5,7
illidan,480,monk,mistweaver,12,5,7
darkspear,480,monk,mistweaver,12,5,7
khadgar,480,monk,mistweaver,12,5,7
sargeras,480,monk,mistweaver,12,5,7
gorgonnash,480,monk,mistweaver,12,5,7
tichondrius,480,monk,mistweaver,12,5,7
rexxar,480,monk,mistweaver,12,5,7
frostmourne,480,monk,mistweaver,12,5,7
area-52,480,monk,mistweaver,12,5,7
illidan,480,monk,mistweaver,12,5,7
kelthuzad,480,monk,mistweaver,12,5,7
hyjal,480,monk,mistweaver,12,5,7
tichondrius,480,monk,mistweaver,12,5,7
azralon,480,monk,mistweaver,12,5,7
turalyon,480,monk,mistweaver,12,5,7
ragnaros,480,monk,mistweaver,18,5,13
emerald-dream,480,monk,mistweaver,18,5,13
tichondrius,480,monk,mistweaver,18,5,13
sargeras,480,monk,mistweaver,24,5,19
tichondrius,479,monk,mistweaver,6,5,1
tichondrius,479,monk,mistweaver,6,5,1
illidan,479,monk,mistweaver,12,5,7
destromath,479,monk,mistweaver,12,5,7
tichondrius,479,monk,mistweaver,12,5,7
cenarius,479,monk,mistweaver,12,5,7
moon-guard,479,monk,mistweaver,12,5,7
tichondrius,479,monk,mistweaver,12,5,7
malganis,479,monk,mistweaver,12,5,7
tichondrius,479,monk,mistweaver,18,5,13
baelgun,478,monk,mistweaver,12,5,7
doomhammer,478,monk,mistweaver,12,5,7
malganis,477,monk,mistweaver,12,5,7
tichondrius,447,monk,mistweaver,11,5,6
tichondrius,440,monk,mistweaver,24,8,16
zuljin,432,monk,mistweaver,9,6,3
tichondrius,432,monk,mistweaver,9,5,4
sargeras,432,monk,mistweaver,9,5,4
tichondrius,432,monk,mistweaver,9,5,4
darkspear,431,monk,mistweaver,11,5,6
tichondrius,431,monk,mistweaver,11,5,6
moon-guard,426,monk,mistweaver,9,6,3
tichondrius,426,monk,mistweaver,13,6,7
zuljin,416,monk,mistweaver,16,5,11
area-52,384,monk,mistweaver,6,4,2
tichondrius,384,monk,mistweaver,6,4,2
sargeras,384,monk,mistweaver,6,4,2
tichondrius,384,monk,mistweaver,6,4,2
emerald-dream,384,monk,mistweaver,6,4,2
arthas,384,monk,mistweaver,6,4,2
thrall,384,monk,mistweaver,6,4,2
sargeras,384,monk,mistweaver,6,4,2
zuljin,384,monk,mistweaver,6,4,2
turalyon,384,monk,mistweaver,6,4,2
cairne,384,monk,mistweaver,6,4,2
illidan,384,monk,mistweaver,6,4,2
nemesis,384,monk,mistweaver,6,4,2
moon-guard,384,monk,mistweaver,6,4,2
area-52,384,monk,mistweaver,6,4,2
duskwood,384,monk,mistweaver,6,4,2
tichondrius,384,monk,mistweaver,6,4,2
tichondrius,384,monk,mistweaver,6,4,2
area-52,384,monk,mistweaver,6,4,2
boulderfist,384,monk,mistweaver,6,4,2
bleeding-hollow,384,monk,mistweaver,6,4,2
tichondrius,384,monk,mistweaver,6,4,2
laughing-skull,384,monk,mistweaver,6,4,2
hellscream,384,monk,mistweaver,6,4,2
lethon,384,monk,mistweaver,6,4,2
barthilas,384,monk,mistweaver,6,4,2
barthilas,384,monk,mistweaver,6,4,2
tichondrius,384,monk,mistweaver,6,4,2
ragnaros,384,monk,mistweaver,6,4,2
emerald-dream,384,monk,mistweaver,6,4,2
tichondrius,384,monk,mistweaver,6,4,2
lightbringer,384,monk,mistweaver,6,4,2
tichondrius,384,monk,mistweaver,6,4,2
sargeras,384,monk,mistweaver,6,4,2
gorefiend,384,monk,mistweaver,6,4,2
skullcrusher,384,monk,mistweaver,6,4,2
tichondrius,384,monk,mistweaver,6,4,2
cenarion-circle,384,monk,mistweaver,6,4,2
tichondrius,384,monk,mistweaver,6,4,2
stormrage,384,monk,mistweaver,6,4,2
tichondrius,384,monk,mistweaver,6,4,2
frostmourne,384,monk,mistweaver,6,4,2
stormrage,384,monk,mistweaver,6,4,2
stormrage,384,monk,mistweaver,6,4,2
stormrage,384,monk,mistweaver,6,4,2
garona,384,monk,mistweaver,6,4,2
veknilash,384,monk,mistweaver,6,4,2
thunderhorn,384,monk,mistweaver,6,4,2
sargeras,384,monk,mistweaver,6,4,2
archimonde,384,monk,mistweaver,6,4,2
illidan,384,monk,mistweaver,9,4,5
illidan,384,monk,mistweaver,15,5,10
emerald-dream,384,monk,mistweaver,12,4,8
moon-guard,384,monk,mistweaver,12,4,8
spirestone,384,monk,mistweaver,12,4,8
boulderfist,384,monk,mistweaver,12,4,8
malganis,384,monk,mistweaver,12,4,8
quelthalas,384,monk,mistweaver,12,4,8
emerald-dream,384,monk,mistweaver,12,4,8
norgannon,384,monk,mistweaver,12,4,8
kelthuzad,384,monk,mistweaver,12,4,8
tichondrius,384,monk,mistweaver,12,4,8
destromath,384,monk,mistweaver,12,4,8
stormrage,384,monk,mistweaver,12,4,8
sargeras,384,monk,mistweaver,12,4,8
malganis,384,monk,mistweaver,12,4,8
barthilas,384,monk,mistweaver,12,4,8
thrall,383,monk,mistweaver,6,4,2
tichondrius,383,monk,mistweaver,12,4,8
bleeding-hollow,383,monk,mistweaver,12,4,8
tichondrius,383,monk,mistweaver,12,4,8
moonrunner,383,monk,mistweaver,12,4,8
aggramar,383,monk,mistweaver,12,4,8
nerzhul,360,monk,mistweaver,13,7,6
stormrage,351,monk,mistweaver,11,4,7
sargeras,335,monk,mistweaver,11,4,7
gorefiend,319,monk,mistweaver,5,4,1
area-52,319,monk,mistweaver,11,4,7
frostmourne,288,monk,mistweaver,10,5,5
kiljaeden,288,monk,mistweaver,6,3,3
kiljaeden,288,monk,mistweaver,6,3,3
kelthuzad,288,monk,mistweaver,6,3,3
frostmourne,288,monk,mistweaver,6,3,3
thaurissan,288,monk,mistweaver,6,3,3
frostmourne,288,monk,mistweaver,6,3,3
whisperwind,288,monk,mistweaver,6,3,3
kelthuzad,288,monk,mistweaver,6,3,3
area-52,288,monk,mistweaver,6,3,3
stormrage,288,monk,mistweaver,6,3,3
tichondrius,288,monk,mistweaver,6,3,3
malganis,288,monk,mistweaver,6,3,3
tichondrius,288,monk,mistweaver,6,3,3
malganis,288,monk,mistweaver,6,3,3
jubeithos,288,monk,mistweaver,6,3,3
ragnaros,288,monk,mistweaver,6,3,3
illidan,288,monk,mistweaver,6,3,3
firetree,288,monk,mistweaver,6,3,3
malganis,288,monk,mistweaver,6,3,3
bleeding-hollow,288,monk,mistweaver,6,3,3
stormrage,288,monk,mistweaver,6,3,3
wildhammer,288,monk,mistweaver,6,3,3
black-dragonflight,288,monk,mistweaver,6,3,3
tichondrius,288,monk,mistweaver,6,3,3
illidan,288,monk,mistweaver,6,3,3
tichondrius,288,monk,mistweaver,6,3,3
stormrage,288,monk,mistweaver,6,3,3
quelthalas,288,monk,mistweaver,6,3,3
sargeras,288,monk,mistweaver,6,3,3
area-52,288,monk,mistweaver,6,3,3
tichondrius,288,monk,mistweaver,6,3,3
tichondrius,288,monk,mistweaver,6,3,3
tichondrius,288,monk,mistweaver,6,3,3
area-52,288,monk,mistweaver,6,3,3
zuljin,288,monk,mistweaver,6,3,3
tichondrius,288,monk,mistweaver,6,3,3
moon-guard,288,monk,mistweaver,6,3,3
ragnaros,288,monk,mistweaver,6,3,3
stormrage,288,monk,mistweaver,6,3,3
tichondrius,288,monk,mistweaver,6,3,3
ragnaros,288,monk,mistweaver,6,3,3
sargeras,288,monk,mistweaver,6,3,3
tichondrius,288,monk,mistweaver,6,3,3
laughing-skull,288,monk,mistweaver,6,3,3
wyrmrest-accord,288,monk,mistweaver,6,3,3
hydraxis,288,monk,mistweaver,6,3,3
bleeding-hollow,288,monk,mistweaver,6,3,3
emerald-dream,288,monk,mistweaver,6,3,3
whisperwind,288,monk,mistweaver,6,3,3
whisperwind,288,monk,mistweaver,6,3,3
bloodhoof,288,monk,mistweaver,6,3,3
sargeras,288,monk,mistweaver,8,3,5
azralon,288,monk,mistweaver,10,3,7
illidan,288,monk,mistweaver,12,3,9
deathwing,288,monk,mistweaver,12,3,9
frostmourne,288,monk,mistweaver,12,3,9
tichondrius,288,monk,mistweaver,12,3,9
nemesis,288,monk,mistweaver,12,3,9
ghostlands,288,monk,mistweaver,12,3,9
stormrage,288,monk,mistweaver,12,3,9
emerald-dream,288,monk,mistweaver,12,3,9
barthilas,288,monk,mistweaver,13,3,10
moon-guard,287,monk,mistweaver,6,3,3
illidan,287,monk,mistweaver,6,3,3
azgalor,287,monk,mistweaver,6,3,3
zuljin,287,monk,mistweaver,6,3,3
kiljaeden,287,monk,mistweaver,12,3,9
frostmourne,287,monk,mistweaver,24,3,21
zuljin,286,monk,mistweaver,9,4,5
moon-guard,265,monk,mistweaver,19,5,14
burning-legion,256,monk,mistweaver,4,4,0
baelgun,256,monk,mistweaver,10,3,7
bleeding-hollow,239,monk,mistweaver,5,3,2
moon-guard,234,monk,mistweaver,8,4,4
wyrmrest-accord,234,monk,mistweaver,10,4,6
kelthuzad,234,monk,mistweaver,16,4,12
darkspear,217,monk,mistweaver,20,4,16
tichondrius,192,monk,mistweaver,4,3,1
stormrage,192,monk,mistweaver,6,2,4
stormrage,192,monk,mistweaver,6,2,4
kiljaeden,192,monk,mistweaver,6,2,4
khazgoroth,192,monk,mistweaver,6,2,4
trollbane,192,monk,mistweaver,6,2,4
tichondrius,192,monk,mistweaver,6,2,4
wyrmrest-accord,192,monk,mistweaver,6,2,4
sargeras,192,monk,mistweaver,6,2,4
zuljin,192,monk,mistweaver,6,2,4
wyrmrest-accord,192,monk,mistweaver,6,2,4
stormrage,192,monk,mistweaver,6,2,4
darkspear,192,monk,mistweaver,6,2,4
nazgrel,192,monk,mistweaver,6,2,4
daggerspine,192,monk,mistweaver,6,2,4
emerald-dream,192,monk,mistweaver,6,2,4
tichondrius,192,monk,mistweaver,6,2,4
tichondrius,192,monk,mistweaver,6,2,4
zuljin,192,monk,mistweaver,6,2,4
tichondrius,192,monk,mistweaver,6,2,4
exodar,192,monk,mistweaver,6,2,4
barthilas,192,monk,mistweaver,6,2,4
tichondrius,192,monk,mistweaver,6,2,4
sargeras,192,monk,mistweaver,6,2,4
goldrinn,192,monk,mistweaver,6,2,4
zuljin,192,monk,mistweaver,6,2,4
bleeding-hollow,192,monk,mistweaver,6,2,4
moonrunner,192,monk,mistweaver,6,2,4
bleeding-hollow,192,monk,mistweaver,6,2,4
sargeras,192,monk,mistweaver,6,2,4
tichondrius,192,monk,mistweaver,6,2,4
aggramar,192,monk,mistweaver,6,2,4
barthilas,192,monk,mistweaver,6,2,4
malganis,192,monk,mistweaver,6,2,4
onyxia,192,monk,mistweaver,6,2,4
sargeras,192,monk,mistweaver,6,2,4
area-52,192,monk,mistweaver,6,2,4
area-52,192,monk,mistweaver,6,2,4
lightnings-blade,192,monk,mistweaver,6,2,4
turalyon,192,monk,mistweaver,6,2,4
area-52,192,monk,mistweaver,6,2,4
silvermoon,192,monk,mistweaver,6,2,4
exodar,192,monk,mistweaver,7,2,5
area-52,192,monk,mistweaver,8,2,6
area-52,192,monk,mistweaver,8,2,6
illidan,192,monk,mistweaver,10,2,8
darkspear,192,monk,mistweaver,12,2,10
zuljin,192,monk,mistweaver,12,2,10
tichondrius,192,monk,mistweaver,12,2,10
frostmourne,192,monk,mistweaver,12,2,10
frostmane,192,monk,mistweaver,12,2,10
boulderfist,192,monk,mistweaver,12,2,10
tichondrius,192,monk,mistweaver,12,2,10
tichondrius,191,monk,mistweaver,6,2,4
malganis,175,monk,mistweaver,11,2,9
azralon,159,monk,mistweaver,5,2,3
illidan,144,monk,mistweaver,3,3,0
tichondrius,138,monk,mistweaver,7,3,4
malganis,138,monk,mistweaver,8,3,5
ragnaros,138,monk,mistweaver,11,3,8
tichondrius,127,monk,mistweaver,8,2,6
sargeras,112,monk,mistweaver,7,2,5
illidan,96,monk,mistweaver,6,1,5
stormrage,96,monk,mistweaver,6,1,5
altar-of-storms,96,monk,mistweaver,6,1,5
illidan,96,monk,mistweaver,6,1,5
tichondrius,96,monk,mistweaver,6,1,5
dragonmaw,96,monk,mistweaver,6,1,5
korialstrasz,96,monk,mistweaver,6,1,5
stormrage,96,monk,mistweaver,6,1,5
illidan,96,monk,mistweaver,6,1,5
ragnaros,96,monk,mistweaver,6,1,5
bloodscalp,96,monk,mistweaver,6,1,5
tichondrius,96,monk,mistweaver,6,1,5
frostmourne,96,monk,mistweaver,6,1,5
nazjatar,96,monk,mistweaver,6,1,5
tichondrius,96,monk,mistweaver,6,1,5
zuljin,96,monk,mistweaver,6,1,5
frostmourne,96,monk,mistweaver,6,1,5
ragnaros,96,monk,mistweaver,12,1,11
tichondrius,96,monk,mistweaver,12,1,11
malfurion,95,monk,mistweaver,6,1,5
thrall,79,monk,mistweaver,5,1,4
arathor,79,monk,mistweaver,5,1,4
frostwolf,79,monk,mistweaver,5,1,4
barthilas,42,monk,mistweaver,6,2,4
arthas,42,monk,mistweaver,17,2,15
tichondrius,31,monk,mistweaver,2,1,1
quelthalas,672,monk,brewmaster,12,7,5
nerzhul,672,monk,brewmaster,21,8,13
tichondrius,288,monk,brewmaster,6,3,3
moon-guard,288,monk,brewmaster,18,3,15
zuljin,192,monk,brewmaster,18,2,16
zuljin,191,monk,brewmaster,6,2,4
sargeras,2250,monk,windwalker,91,51,40
illidan,2208,monk,windwalker,101,54,47
tichondrius,2150,monk,windwalker,132,69,63
nazjatar,2143,monk,windwalker,72,38,34
sargeras,2140,monk,windwalker,125,66,59
tichondrius,2132,monk,windwalker,108,55,53
area-52,2101,monk,windwalker,84,43,41
sargeras,2093,monk,windwalker,108,53,55
ysera,2030,monk,windwalker,46,34,12
quelthalas,2021,monk,windwalker,119,62,57
tichondrius,2012,monk,windwalker,93,46,47
tichondrius,2008,monk,windwalker,152,81,71
tichondrius,2008,monk,windwalker,107,55,52
burning-legion,1986,monk,windwalker,89,47,42
tichondrius,1982,monk,windwalker,238,118,120
dalaran,1969,monk,windwalker,66,38,28
frostmourne,1967,monk,windwalker,66,34,32
frostmourne,1955,monk,windwalker,66,37,29
tichondrius,1942,monk,windwalker,184,99,85
illidan,1933,monk,windwalker,78,39,39
tichondrius,1928,monk,windwalker,114,54,60
tichondrius,1924,monk,windwalker,113,54,59
illidan,1899,monk,windwalker,92,47,45
moon-guard,1899,monk,windwalker,114,57,57
sargeras,1897,monk,windwalker,63,33,30
scilla,1885,monk,windwalker,66,33,33
darkspear,1884,monk,windwalker,30,20,10
stormrage,1880,monk,windwalker,71,39,32
illidan,1844,monk,windwalker,42,29,13
tichondrius,1844,monk,windwalker,70,44,26
uldum,1843,monk,windwalker,70,34,36
stormreaver,1834,monk,windwalker,138,63,75
sargeras,1825,monk,windwalker,42,23,19
wyrmrest-accord,1822,monk,windwalker,59,28,31
bleeding-hollow,1820,monk,windwalker,66,33,33
hyjal,1813,monk,windwalker,42,25,17
bleeding-hollow,1803,monk,windwalker,42,25,17
sargeras,1797,monk,windwalker,42,22,20
tichondrius,1791,monk,windwalker,48,28,20
tichondrius,1785,monk,windwalker,24,19,5
sargeras,1772,monk,windwalker,69,42,27
azralon,1772,monk,windwalker,53,27,26
malganis,1764,monk,windwalker,47,26,21
stormrage,1762,monk,windwalker,42,21,21
tichondrius,1735,monk,windwalker,72,43,29
hellscream,1734,monk,windwalker,55,32,23
sargeras,1733,monk,windwalker,44,26,18
area-52,1729,monk,windwalker,29,21,8
sargeras,1724,monk,windwalker,30,18,12
sargeras,1720,monk,windwalker,36,23,13
bloodscalp,1720,monk,windwalker,48,25,23
kelthuzad,1711,monk,windwalker,56,24,32
tichondrius,1710,monk,windwalker,41,20,21
drakthul,1703,monk,windwalker,42,22,20
stormrage,1700,monk,windwalker,73,44,29
chogall,1698,monk,windwalker,199,105,94
wyrmrest-accord,1696,monk,windwalker,45,23,22
sargeras,1695,monk,windwalker,69,42,27
sargeras,1688,monk,windwalker,55,31,24
barthilas,1686,monk,windwalker,47,22,25
aerie-peak,1678,monk,windwalker,54,24,30
sargeras,1673,monk,windwalker,80,36,44
area-52,1670,monk,windwalker,45,24,21
illidan,1666,monk,windwalker,30,19,11
aggramar,1665,monk,windwalker,71,45,26
stormrage,1665,monk,windwalker,48,23,25
arthas,1663,monk,windwalker,47,23,24
tichondrius,1661,monk,windwalker,40,20,20
barthilas,1659,monk,windwalker,42,22,20
area-52,1658,monk,windwalker,48,29,19
illidan,1645,monk,windwalker,83,46,37
thrall,1645,monk,windwalker,78,39,39
zuljin,1641,monk,windwalker,76,42,34
tichondrius,1637,monk,windwalker,40,21,19
stormrage,1631,monk,windwalker,30,17,13
zuljin,1625,monk,windwalker,42,20,22
bleeding-hollow,1620,monk,windwalker,42,23,19
area-52,1618,monk,windwalker,24,17,7
thrall,1616,monk,windwalker,41,22,19
aerie-peak,1614,monk,windwalker,54,29,25
arthas,1610,monk,windwalker,76,46,30
dawnbringer,1604,monk,windwalker,36,25,11
the-forgotten-coast,1600,monk,windwalker,30,17,13
stormrage,1600,monk,windwalker,59,23,36
proudmoore,1598,monk,windwalker,42,19,23
blackhand,1597,monk,windwalker,35,19,16
moon-guard,1592,monk,windwalker,106,64,42
muradin,1588,monk,windwalker,41,25,16
stonemaul,1588,monk,windwalker,65,31,34
elune,1582,monk,windwalker,58,33,25
tichondrius,1581,monk,windwalker,36,18,18
tichondrius,1580,monk,windwalker,36,18,18
tichondrius,1580,monk,windwalker,48,21,27
darkspear,1579,monk,windwalker,30,20,10
black-dragonflight,1578,monk,windwalker,36,21,15
fizzcrank,1576,monk,windwalker,65,30,35
drakkari,1573,monk,windwalker,59,33,26
azralon,1569,monk,windwalker,117,65,52
tichondrius,1566,monk,windwalker,84,40,44
frostwolf,1561,monk,windwalker,54,22,32
illidan,1560,monk,windwalker,36,25,11
thrall,1551,monk,windwalker,53,25,28
ragnaros,1543,monk,windwalker,123,59,64
tichondrius,1533,monk,windwalker,18,16,2
bonechewer,1533,monk,windwalker,24,16,8
bleeding-hollow,1528,monk,windwalker,27,17,10
proudmoore,1526,monk,windwalker,61,30,31
sargeras,1523,monk,windwalker,24,16,8
wyrmrest-accord,1522,monk,windwalker,36,21,15
malganis,1521,monk,windwalker,54,26,28
emerald-dream,1521,monk,windwalker,44,17,27
tichondrius,1520,monk,windwalker,65,42,23
gorefiend,1517,monk,windwalker,72,40,32
tichondrius,1516,monk,windwalker,72,30,42
stormrage,1513,monk,windwalker,67,35,32
tortheldrin,1509,monk,windwalker,42,16,26
quelthalas,1506,monk,windwalker,84,38,46
area-52,1504,monk,windwalker,30,16,14
thunderlord,1491,monk,windwalker,48,26,22
ragnaros,1488,monk,windwalker,30,16,14
frostmourne,1488,monk,windwalker,74,35,39
illidan,1477,monk,windwalker,74,40,34
tichondrius,1468,monk,windwalker,30,17,13
tichondrius,1467,monk,windwalker,42,18,24
area-52,1461,monk,windwalker,111,58,53
tichondrius,1457,monk,windwalker,42,23,19
stormrage,1456,monk,windwalker,30,17,13
sargeras,1445,monk,windwalker,24,16,8
area-52,1437,monk,windwalker,30,15,15
tichondrius,1429,monk,windwalker,58,25,33
dragonmaw,1427,monk,windwalker,36,15,21
azralon,1406,monk,windwalker,18,15,3
tichondrius,1392,monk,windwalker,68,27,41
farstriders,1386,monk,windwalker,77,36,41
ragnaros,1383,monk,windwalker,34,19,15
sargeras,1372,monk,windwalker,40,19,21
stormreaver,1361,monk,windwalker,54,19,35
kelthuzad,1353,monk,windwalker,24,17,7
thrall,1351,monk,windwalker,54,28,26
lightbringer,1350,monk,windwalker,115,62,53
khadgar,1350,monk,windwalker,34,15,19
dreadmaul,1349,monk,windwalker,36,23,13
ragnaros,1344,monk,windwalker,72,34,38
quelthalas,1343,monk,windwalker,78,38,40
sargeras,1342,monk,windwalker,24,14,10
area-52,1339,monk,windwalker,24,14,10
tichondrius,1339,monk,windwalker,45,20,25
area-52,1338,monk,windwalker,30,14,16
grizzly-hills,1334,monk,windwalker,24,14,10
tichondrius,1332,monk,windwalker,36,22,14
kelthuzad,1326,monk,windwalker,58,32,26
tichondrius,1305,monk,windwalker,36,20,16
frostmourne,1304,monk,windwalker,30,14,16
tichondrius,1294,monk,windwalker,88,40,48
ragnaros,1290,monk,windwalker,52,24,28
tichondrius,1280,monk,windwalker,36,15,21
tichondrius,1265,monk,windwalker,30,15,15
tichondrius,1263,monk,windwalker,42,22,20
tichondrius,1248,monk,windwalker,18,13,5
illidan,1247,monk,windwalker,30,15,15
area-52,1247,monk,windwalker,30,13,17
area-52,1246,monk,windwalker,18,13,5
quelthalas,1246,monk,windwalker,36,13,23
terenas,1245,monk,windwalker,42,19,23
illidan,1243,monk,windwalker,24,13,11
area-52,1241,monk,windwalker,24,13,11
moon-guard,1240,monk,windwalker,48,22,26
vashj,1239,monk,windwalker,18,13,5
tichondrius,1239,monk,windwalker,24,13,11
thrall,1237,monk,windwalker,24,13,11
illidan,1220,monk,windwalker,72,33,39
nemesis,1218,monk,windwalker,34,15,19
frostmourne,1207,monk,windwalker,36,15,21
area-52,1201,monk,windwalker,60,23,37
senjin,1189,monk,windwalker,35,17,18
dalaran,1188,monk,windwalker,36,13,23
azshara,1176,monk,windwalker,30,14,16
elune,1157,monk,windwalker,17,13,4
bleeding-hollow,1152,monk,windwalker,18,12,6
daggerspine,1152,monk,windwalker,22,14,8
ragnaros,1151,monk,windwalker,12,12,0
wyrmrest-accord,1150,monk,windwalker,24,12,12
tichondrius,1150,monk,windwalker,24,12,12
tichondrius,1142,monk,windwalker,24,12,12
kiljaeden,1142,monk,windwalker,24,12,12
medivh,1137,monk,windwalker,53,31,22
skullcrusher,1136,monk,windwalker,18,12,6
area-52,1130,monk,windwalker,54,18,36
chogall,1128,monk,windwalker,42,17,25
stormrage,1118,monk,windwalker,23,12,11
lightbringer,1117,monk,windwalker,23,12,11
wyrmrest-accord,1117,monk,windwalker,24,12,12
kelthuzad,1113,monk,windwalker,30,13,17
drakkari,1108,monk,windwalker,28,13,15
proudmoore,1089,monk,windwalker,39,13,26
area-52,1085,monk,windwalker,75,33,42
wyrmrest-accord,1079,monk,windwalker,24,13,11
kelthuzad,1056,monk,windwalker,18,11,7
bleeding-hollow,1056,monk,windwalker,18,11,7
malganis,1056,monk,windwalker,18,11,7
stormrage,1056,monk,windwalker,24,11,13
zuljin,1055,monk,windwalker,18,11,7
stormrage,1055,monk,windwalker,18,11,7
moon-guard,1055,monk,windwalker,18,11,7
smolderthorn,1055,monk,windwalker,18,11,7
ragnaros,1055,monk,windwalker,24,11,13
mannoroth,1055,monk,windwalker,24,11,13
stormrage,1055,monk,windwalker,36,11,25
tichondrius,1054,monk,windwalker,18,11,7
area-52,1052,monk,windwalker,18,11,7
quelthalas,1051,monk,windwalker,126,62,64
coilfang,1048,monk,windwalker,18,11,7
area-52,1044,monk,windwalker,18,11,7
khazgoroth,1044,monk,windwalker,24,12,12
blackrock,1044,monk,windwalker,35,11,24
dalaran,1043,monk,windwalker,30,11,19
tichondrius,1039,monk,windwalker,23,11,12
emerald-dream,1038,monk,windwalker,24,11,13
skullcrusher,1038,monk,windwalker,30,11,19
moonrunner,1036,monk,windwalker,18,11,7
azralon,1026,monk,windwalker,42,24,18
tichondrius,1023,monk,windwalker,24,11,13
bleeding-hollow,1020,monk,windwalker,18,11,7
tichondrius,960,monk,windwalker,12,10,2
kaelthas,960,monk,windwalker,12,10,2
ravencrest,960,monk,windwalker,12,10,2
tichondrius,960,monk,windwalker,18,10,8
ragnaros,960,monk,windwalker,18,10,8
blades-edge,960,monk,windwalker,24,10,14
tichondrius,960,monk,windwalker,24,10,14
sargeras,959,monk,windwalker,12,10,2
tichondrius,959,monk,windwalker,18,10,8
ragnaros,959,monk,windwalker,18,10,8
proudmoore,958,monk,windwalker,18,10,8
azralon,958,monk,windwalker,24,10,14
daggerspine,957,monk,windwalker,18,10,8
azralon,957,monk,windwalker,24,10,14
stormrage,957,monk,windwalker,30,10,20
hyjal,956,monk,windwalker,18,10,8
tichondrius,953,monk,windwalker,18,10,8
stormreaver,953,monk,windwalker,18,10,8
moon-guard,952,monk,windwalker,18,10,8
sargeras,951,monk,windwalker,18,10,8
goldrinn,950,monk,windwalker,18,10,8
crushridge,949,monk,windwalker,18,10,8
thrall,943,monk,windwalker,29,10,19
tichondrius,938,monk,windwalker,114,52,62
tichondrius,935,monk,windwalker,24,13,11
bonechewer,928,monk,windwalker,22,11,11
moon-guard,892,monk,windwalker,41,18,23
stormrage,864,monk,windwalker,12,9,3
stormrage,864,monk,windwalker,12,9,3
illidan,864,monk,windwalker,12,9,3
area-52,864,monk,windwalker,12,9,3
emerald-dream,864,monk,windwalker,15,9,6
area-52,864,monk,windwalker,18,9,9
zuljin,864,monk,windwalker,18,9,9
zuljin,864,monk,windwalker,18,9,9
tichondrius,864,monk,windwalker,18,9,9
zuljin,864,monk,windwalker,18,9,9
illidan,864,monk,windwalker,18,9,9
tichondrius,864,monk,windwalker,18,9,9
tichondrius,864,monk,windwalker,24,9,15
chogall,864,monk,windwalker,24,9,15
anubarak,864,monk,windwalker,24,9,15
hyjal,863,monk,windwalker,12,9,3
illidan,863,monk,windwalker,12,9,3
borean-tundra,863,monk,windwalker,18,9,9
sargeras,863,monk,windwalker,18,9,9
eonar,863,monk,windwalker,24,9,15
frostmourne,862,monk,windwalker,12,9,3
stormrage,862,monk,windwalker,12,9,3
sargeras,862,monk,windwalker,12,9,3
tichondrius,859,monk,windwalker,18,9,9
malganis,853,monk,windwalker,18,9,9
destromath,839,monk,windwalker,19,10,9
drakkari,832,monk,windwalker,24,10,14
aegwynn,827,monk,windwalker,18,9,9
drakkari,815,monk,windwalker,23,9,14
azralon,814,monk,windwalker,35,10,25
tichondrius,806,monk,windwalker,21,10,11
area-52,784,monk,windwalker,19,9,10
moon-guard,768,monk,windwalker,12,8,4
thrall,768,monk,windwalker,12,8,4
frostmourne,768,monk,windwalker,12,8,4
draenor,768,monk,windwalker,12,8,4
onyxia,768,monk,windwalker,12,8,4
stormrage,768,monk,windwalker,12,8,4
stormrage,768,monk,windwalker,12,8,4
thunderlord,768,monk,windwalker,18,8,10
tichondrius,768,monk,windwalker,18,8,10
dalaran,768,monk,windwalker,18,8,10
aegwynn,768,monk,windwalker,18,8,10
barthilas,768,monk,windwalker,18,8,10
illidan,768,monk,windwalker,18,8,10
onyxia,768,monk,windwalker,24,8,16
zuljin,767,monk,windwalker,18,8,10
tichondrius,767,monk,windwalker,18,8,10
zuljin,766,monk,windwalker,12,8,4
kelthuzad,766,monk,windwalker,12,8,4
destromath,765,monk,windwalker,18,8,10
ragnaros,764,monk,windwalker,24,8,16
greymane,763,monk,windwalker,18,8,10
stormscale,762,monk,windwalker,12,8,4
sargeras,759,monk,windwalker,18,8,10
bleeding-hollow,751,monk,windwalker,17,8,9
drakkari,749,monk,windwalker,24,8,16
emerald-dream,736,monk,windwalker,16,8,8
stormrage,729,monk,windwalker,23,8,15
illidan,720,monk,windwalker,15,9,6
dalaran,714,monk,windwalker,23,12,11
thrall,703,monk,windwalker,11,8,3
illidan,703,monk,windwalker,11,8,3
velen,672,monk,windwalker,12,7,5
bleeding-hollow,672,monk,windwalker,12,7,5
tichondrius,672,monk,windwalker,12,7,5
stormrage,672,monk,windwalker,12,7,5
korgath,672,monk,windwalker,12,7,5
malganis,672,monk,windwalker,12,7,5
barthilas,672,monk,windwalker,12,7,5
moon-guard,672,monk,windwalker,12,7,5
stormrage,672,monk,windwalker,12,7,5
kiljaeden,672,monk,windwalker,12,7,5
stormrage,672,monk,windwalker,12,7,5
area-52,672,monk,windwalker,12,7,5
frostwolf,672,monk,windwalker,12,7,5
sargeras,672,monk,windwalker,12,7,5
kiljaeden,672,monk,windwalker,12,7,5
tichondrius,672,monk,windwalker,12,7,5
stormrage,672,monk,windwalker,18,7,11
tichondrius,672,monk,windwalker,18,7,11
bleeding-hollow,672,monk,windwalker,21,8,13
frostmourne,672,monk,windwalker,23,8,15
sargeras,671,monk,windwalker,12,7,5
sargeras,671,monk,windwalker,12,7,5
tichondrius,670,monk,windwalker,13,8,5
frostmourne,670,monk,windwalker,12,7,5
dalaran,670,monk,windwalker,12,7,5
tichondrius,670,monk,windwalker,12,7,5
tichondrius,667,monk,windwalker,12,7,5
stormscale,666,monk,windwalker,12,7,5
stormrage,666,monk,windwalker,12,7,5
dalvengyr,665,monk,windwalker,12,7,5
frostmourne,655,monk,windwalker,17,7,10
area-52,638,monk,windwalker,17,7,10
nemesis,623,monk,windwalker,11,7,4
emerald-dream,606,monk,windwalker,14,7,7
area-52,591,monk,windwalker,11,7,4
tichondrius,576,monk,windwalker,6,6,0
illidan,576,monk,windwalker,6,6,0
ragnaros,576,monk,windwalker,6,6,0
tichondrius,576,monk,windwalker,12,6,6
emerald-dream,576,monk,windwalker,12,6,6
dalaran,576,monk,windwalker,12,6,6
boulderfist,576,monk,windwalker,12,6,6
azralon,576,monk,windwalker,12,6,6
stormrage,576,monk,windwalker,12,6,6
darkspear,576,monk,windwalker,12,6,6
quelthalas,576,monk,windwalker,12,6,6
vashj,576,monk,windwalker,12,6,6
stormreaver,576,monk,windwalker,12,6,6
durotan,576,monk,windwalker,12,6,6
tichondrius,576,monk,windwalker,12,6,6
eitrigg,576,monk,windwalker,12,6,6
vashj,576,monk,windwalker,12,6,6
illidan,576,monk,windwalker,12,6,6
malganis,576,monk,windwalker,12,6,6
kiljaeden,576,monk,windwalker,12,6,6
nerzhul,576,monk,windwalker,12,6,6
tichondrius,576,monk,windwalker,19,8,11
malygos,576,monk,windwalker,18,6,12
tichondrius,576,monk,windwalker,18,6,12
ragnaros,576,monk,windwalker,18,6,12
kelthuzad,575,monk,windwalker,12,6,6
frostmourne,575,monk,windwalker,12,6,6
emerald-dream,575,monk,windwalker,18,6,12
garithos,574,monk,windwalker,12,6,6
drakkari,574,monk,windwalker,12,6,6
area-52,572,monk,windwalker,12,6,6
tichondrius,570,monk,windwalker,12,6,6
bonechewer,523,monk,windwalker,9,7,2
ragnaros,480,monk,windwalker,6,5,1
tichondrius,480,monk,windwalker,6,5,1
quelthalas,480,monk,windwalker,6,5,1
sargeras,480,monk,windwalker,6,5,1
sargeras,480,monk,windwalker,6,5,1
quelthalas,480,monk,windwalker,6,5,1
area-52,480,monk,windwalker,6,5,1
azralon,480,monk,windwalker,6,5,1
quelthalas,480,monk,windwalker,6,5,1
emerald-dream,480,monk,windwalker,6,5,1
tichondrius,480,monk,windwalker,6,5,1
tichondrius,480,monk,windwalker,6,5,1
tichondrius,480,monk,windwalker,6,5,1
grizzly-hills,480,monk,windwalker,6,5,1
kiljaeden,480,monk,windwalker,6,5,1
kelthuzad,480,monk,windwalker,6,5,1
dalaran,480,monk,windwalker,6,5,1
stormrage,480,monk,windwalker,6,5,1
kelthuzad,480,monk,windwalker,9,5,4
zuljin,480,monk,windwalker,12,5,7
zuljin,480,monk,windwalker,12,5,7
senjin,480,monk,windwalker,12,5,7
medivh,480,monk,windwalker,12,5,7
bleeding-hollow,480,monk,windwalker,12,5,7
barthilas,480,monk,windwalker,12,5,7
alleria,480,monk,windwalker,12,5,7
proudmoore,480,monk,windwalker,12,5,7
tichondrius,480,monk,windwalker,12,5,7
sargeras,480,monk,windwalker,12,5,7
ragnaros,480,monk,windwalker,12,5,7
quelthalas,480,monk,windwalker,12,5,7
area-52,480,monk,windwalker,12,5,7
illidan,480,monk,windwalker,12,5,7
tichondrius,480,monk,windwalker,12,5,7
malganis,480,monk,windwalker,12,5,7
azralon,480,monk,windwalker,18,5,13
emerald-dream,480,monk,windwalker,22,5,17
tichondrius,479,monk,windwalker,6,5,1
stormrage,479,monk,windwalker,9,6,3
barthilas,478,monk,windwalker,6,5,1
azshara,476,monk,windwalker,12,5,7
tichondrius,400,monk,windwalker,7,5,2
kelthuzad,384,monk,windwalker,10,7,3
sargeras,384,monk,windwalker,6,4,2
tichondrius,384,monk,windwalker,6,4,2
barthilas,384,monk,windwalker,6,4,2
ragnaros,384,monk,windwalker,6,4,2
azralon,384,monk,windwalker,6,4,2
bonechewer,384,monk,windwalker,6,4,2
gurubashi,384,monk,windwalker,6,4,2
illidan,384,monk,windwalker,6,4,2
frostmourne,384,monk,windwalker,6,4,2
tichondrius,384,monk,windwalker,6,4,2
tichondrius,384,monk,windwalker,6,4,2
illidan,384,monk,windwalker,6,4,2
tichondrius,384,monk,windwalker,6,4,2
stormrage,384,monk,windwalker,6,4,2
stormrage,384,monk,windwalker,6,4,2
stormrage,384,monk,windwalker,6,4,2
darkspear,384,monk,windwalker,6,4,2
tichondrius,384,monk,windwalker,6,4,2
nemesis,384,monk,windwalker,6,4,2
hellscream,384,monk,windwalker,6,4,2
illidan,384,monk,windwalker,6,4,2
tichondrius,384,monk,windwalker,6,4,2
tichondrius,384,monk,windwalker,6,4,2
tichondrius,384,monk,windwalker,6,4,2
bloodscalp,384,monk,windwalker,6,4,2
tichondrius,384,monk,windwalker,9,5,4
tichondrius,384,monk,windwalker,12,4,8
frostmourne,384,monk,windwalker,12,4,8
tichondrius,384,monk,windwalker,12,4,8
area-52,384,monk,windwalker,12,4,8
bleeding-hollow,384,monk,windwalker,12,4,8
area-52,384,monk,windwalker,12,4,8
tichondrius,384,monk,windwalker,12,4,8
barthilas,384,monk,windwalker,12,4,8
frostwolf,384,monk,windwalker,12,4,8
tichondrius,384,monk,windwalker,12,4,8
tichondrius,384,monk,windwalker,12,4,8
moon-guard,384,monk,windwalker,12,4,8
stormrage,383,monk,windwalker,6,4,2
kelthuzad,383,monk,windwalker,6,4,2
azralon,383,monk,windwalker,6,4,2
azralon,383,monk,windwalker,9,5,4
nagrand,351,monk,windwalker,11,4,7
quelthalas,351,monk,windwalker,11,4,7
jubeithos,334,monk,windwalker,9,4,5
garrosh,304,monk,windwalker,7,4,3
tichondrius,297,monk,windwalker,14,5,9
tichondrius,288,monk,windwalker,6,3,3
tichondrius,288,monk,windwalker,6,3,3
sargeras,288,monk,windwalker,6,3,3
tichondrius,288,monk,windwalker,6,3,3
quelthalas,288,monk,windwalker,6,3,3
tichondrius,288,monk,windwalker,6,3,3
moon-guard,288,monk,windwalker,6,3,3
sargeras,288,monk,windwalker,6,3,3
sargeras,288,monk,windwalker,6,3,3
malganis,288,monk,windwalker,6,3,3
tichondrius,288,monk,windwalker,6,3,3
thrall,288,monk,windwalker,6,3,3
thrall,288,monk,windwalker,6,3,3
tichondrius,288,monk,windwalker,6,3,3
stormrage,288,monk,windwalker,6,3,3
kelthuzad,288,monk,windwalker,6,3,3
gnomeregan,288,monk,windwalker,6,3,3
sargeras,288,monk,windwalker,6,3,3
scilla,288,monk,windwalker,6,3,3
area-52,288,monk,windwalker,6,3,3
tichondrius,288,monk,windwalker,6,3,3
illidan,288,monk,windwalker,6,3,3
area-52,288,monk,windwalker,6,3,3
illidan,288,monk,windwalker,6,3,3
area-52,288,monk,windwalker,6,3,3
tichondrius,288,monk,windwalker,6,3,3
dragonblight,288,monk,windwalker,6,3,3
sentinels,288,monk,windwalker,6,3,3
dragonmaw,288,monk,windwalker,6,3,3
area-52,288,monk,windwalker,6,3,3
tichondrius,288,monk,windwalker,6,3,3
azralon,288,monk,windwalker,6,3,3
tichondrius,288,monk,windwalker,6,3,3
area-52,288,monk,windwalker,6,3,3
dalaran,288,monk,windwalker,6,3,3
stormrage,288,monk,windwalker,6,3,3
tichondrius,288,monk,windwalker,6,3,3
area-52,288,monk,windwalker,6,3,3
draktharon,288,monk,windwalker,6,3,3
burning-legion,288,monk,windwalker,6,3,3
proudmoore,288,monk,windwalker,6,3,3
bleeding-hollow,288,monk,windwalker,6,3,3
frostwolf,288,monk,windwalker,6,3,3
madoran,288,monk,windwalker,6,3,3
zuljin,288,monk,windwalker,6,3,3
barthilas,288,monk,windwalker,6,3,3
kelthuzad,288,monk,windwalker,6,3,3
sargeras,288,monk,windwalker,6,3,3
azralon,288,monk,windwalker,6,3,3
blackrock,288,monk,windwalker,6,3,3
runetotem,288,monk,windwalker,6,3,3
illidan,288,monk,windwalker,12,3,9
kiljaeden,288,monk,windwalker,12,3,9
illidan,288,monk,windwalker,12,3,9
sargeras,288,monk,windwalker,12,3,9
frostmourne,288,monk,windwalker,12,3,9
tichondrius,288,monk,windwalker,18,3,15
tichondrius,271,monk,windwalker,11,3,8
bleeding-hollow,239,monk,windwalker,5,3,2
area-52,239,monk,windwalker,5,3,2
frostmourne,239,monk,windwalker,5,3,2
sargeras,223,monk,windwalker,8,3,5
tichondrius,192,monk,windwalker,4,3,1
stormrage,192,monk,windwalker,4,3,1
tichondrius,192,monk,windwalker,4,3,1
tichondrius,192,monk,windwalker,4,3,1
illidan,192,monk,windwalker,6,2,4
dreadmaul,192,monk,windwalker,6,2,4
barthilas,192,monk,windwalker,6,2,4
dalaran,192,monk,windwalker,6,2,4
barthilas,192,monk,windwalker,6,2,4
illidan,192,monk,windwalker,6,2,4
illidan,192,monk,windwalker,6,2,4
frostmourne,192,monk,windwalker,6,2,4
thrall,192,monk,windwalker,6,2,4
rivendare,192,monk,windwalker,6,2,4
malganis,192,monk,windwalker,6,2,4
norgannon,192,monk,windwalker,6,2,4
muradin,192,monk,windwalker,6,2,4
bonechewer,192,monk,windwalker,6,2,4
kiljaeden,192,monk,windwalker,6,2,4
destromath,192,monk,windwalker,6,2,4
kiljaeden,192,monk,windwalker,6,2,4
tichondrius,192,monk,windwalker,6,2,4
windrunner,192,monk,windwalker,6,2,4
azralon,192,monk,windwalker,6,2,4
tichondrius,192,monk,windwalker,6,2,4
tichondrius,192,monk,windwalker,6,2,4
bleeding-hollow,192,monk,windwalker,6,2,4
bleeding-hollow,192,monk,windwalker,6,2,4
sargeras,192,monk,windwalker,6,2,4
bleeding-hollow,192,monk,windwalker,6,2,4
moon-guard,192,monk,windwalker,6,2,4
gilneas,192,monk,windwalker,6,2,4
altar-of-storms,192,monk,windwalker,6,2,4
altar-of-storms,192,monk,windwalker,6,2,4
sargeras,192,monk,windwalker,6,2,4
moon-guard,192,monk,windwalker,6,2,4
arthas,192,monk,windwalker,6,2,4
area-52,192,monk,windwalker,6,2,4
area-52,192,monk,windwalker,6,2,4
tichondrius,192,monk,windwalker,6,2,4
drakkari,192,monk,windwalker,6,2,4
ragnaros,192,monk,windwalker,6,2,4
moon-guard,192,monk,windwalker,6,2,4
kelthuzad,192,monk,windwalker,6,2,4
stormscale,192,monk,windwalker,6,2,4
sargeras,192,monk,windwalker,6,2,4
ragnaros,192,monk,windwalker,6,2,4
zuluhed,192,monk,windwalker,6,2,4
ragnaros,192,monk,windwalker,6,2,4
ragnaros,192,monk,windwalker,6,2,4
malganis,192,monk,windwalker,6,2,4
moon-guard,192,monk,windwalker,6,2,4
quelthalas,192,monk,windwalker,6,2,4
quelthalas,192,monk,windwalker,6,2,4
sargeras,192,monk,windwalker,12,2,10
ragnaros,192,monk,windwalker,12,2,10
korialstrasz,192,monk,windwalker,12,2,10
wyrmrest-accord,192,monk,windwalker,12,2,10
frostmourne,159,monk,windwalker,5,2,3
tichondrius,159,monk,windwalker,5,2,3
tichondrius,159,monk,windwalker,5,2,3
emerald-dream,159,monk,windwalker,5,2,3
stormrage,159,monk,windwalker,5,2,3
malganis,159,monk,windwalker,5,2,3
hyjal,144,monk,windwalker,9,2,7
sargeras,128,monk,windwalker,4,2,2
bleeding-hollow,128,monk,windwalker,4,2,2
thrall,128,monk,windwalker,4,2,2
tichondrius,96,monk,windwalker,3,2,1
moon-guard,96,monk,windwalker,6,1,5
sargeras,96,monk,windwalker,6,1,5
area-52,96,monk,windwalker,6,1,5
tichondrius,96,monk,windwalker,6,1,5
tichondrius,96,monk,windwalker,6,1,5
ragnaros,96,monk,windwalker,6,1,5
ragnaros,96,monk,windwalker,6,1,5
uldum,96,monk,windwalker,6,1,5
bleeding-hollow,96,monk,windwalker,6,1,5
stormreaver,96,monk,windwalker,6,1,5
moon-guard,96,monk,windwalker,6,1,5
moon-guard,96,monk,windwalker,6,1,5
tichondrius,96,monk,windwalker,6,1,5
thrall,96,monk,windwalker,6,1,5
frostmourne,96,monk,windwalker,6,1,5
tichondrius,96,monk,windwalker,6,1,5
emerald-dream,96,monk,windwalker,6,1,5
azralon,96,monk,windwalker,6,1,5
illidan,96,monk,windwalker,6,1,5
emerald-dream,96,monk,windwalker,6,1,5
ragnaros,96,monk,windwalker,6,1,5
azgalor,96,monk,windwalker,6,1,5
tichondrius,96,monk,windwalker,6,1,5
hyjal,96,monk,windwalker,6,1,5
moon-guard,96,monk,windwalker,6,1,5
tichondrius,96,monk,windwalker,6,1,5
dalaran,96,monk,windwalker,6,1,5
jaedenar,79,monk,windwalker,5,1,4
bonechewer,42,monk,windwalker,10,5,5
mannoroth,31,monk,windwalker,2,1,1
kiljaeden,31,monk,windwalker,2,1,1
moon-guard,16,monk,windwalker,1,1,0
kelthuzad,9,monk,windwalker,8,2,6
arthas,2134,paladin,holy,147,78,69
area-52,2107,paladin,holy,66,37,29
ragnaros,2084,paladin,holy,132,67,65
area-52,2012,paladin,holy,78,35,43
azralon,1935,paladin,holy,136,64,72
sargeras,1909,paladin,holy,125,63,62
tichondrius,1894,paladin,holy,52,29,23
area-52,1893,paladin,holy,36,20,16
black-dragonflight,1887,paladin,holy,50,25,25
area-52,1867,paladin,holy,54,31,23
zuljin,1866,paladin,holy,72,36,36
area-52,1862,paladin,holy,72,38,34
emerald-dream,1859,paladin,holy,56,29,27
ragnaros,1852,paladin,holy,70,38,32
tichondrius,1842,paladin,holy,54,24,30
tichondrius,1839,paladin,holy,116,61,55
tichondrius,1839,paladin,holy,64,30,34
tichondrius,1838,paladin,holy,54,26,28
sargeras,1828,paladin,holy,75,39,36
azralon,1826,paladin,holy,78,34,44
area-52,1820,paladin,holy,126,79,47
area-52,1820,paladin,holy,111,56,55
sargeras,1819,paladin,holy,100,54,46
tichondrius,1815,paladin,holy,332,171,161
kiljaeden,1811,paladin,holy,172,85,87
kelthuzad,1811,paladin,holy,123,59,64
tichondrius,1811,paladin,holy,68,28,40
barthilas,1808,paladin,holy,50,26,24
tichondrius,1808,paladin,holy,73,28,45
muradin,1806,paladin,holy,40,22,18
frostmourne,1801,paladin,holy,72,39,33
frostmane,1796,paladin,holy,71,42,29
muradin,1787,paladin,holy,36,21,15
stormrage,1785,paladin,holy,52,30,22
kiljaeden,1768,paladin,holy,48,24,24
archimonde,1762,paladin,holy,77,32,45
argent-dawn,1759,paladin,holy,42,22,20
burning-legion,1744,paladin,holy,66,42,24
moon-guard,1743,paladin,holy,48,22,26
malganis,1734,paladin,holy,53,24,29
stormrage,1722,paladin,holy,102,55,47
tichondrius,1709,paladin,holy,128,55,73
bloodhoof,1692,paladin,holy,54,23,31
gurubashi,1690,paladin,holy,48,25,23
malorne,1690,paladin,holy,48,24,24
icecrown,1690,paladin,holy,136,66,70
tichondrius,1680,paladin,holy,48,26,22
tichondrius,1678,paladin,holy,218,111,107
barthilas,1677,paladin,holy,100,51,49
area-52,1674,paladin,holy,52,33,19
medivh,1673,paladin,holy,41,25,16
hyjal,1673,paladin,holy,224,123,101
hyjal,1671,paladin,holy,47,26,21
tichondrius,1668,paladin,holy,143,77,66
anetheron,1667,paladin,holy,42,24,18
darkspear,1663,paladin,holy,84,35,49
fizzcrank,1657,paladin,holy,36,20,16
zuluhed,1657,paladin,holy,36,19,17
laughing-skull,1656,paladin,holy,46,22,24
tichondrius,1652,paladin,holy,66,42,24
queldorei,1651,paladin,holy,96,43,53
kiljaeden,1647,paladin,holy,72,31,41
azralon,1643,paladin,holy,30,18,12
emerald-dream,1635,paladin,holy,42,22,20
moon-guard,1634,paladin,holy,64,29,35
tichondrius,1628,paladin,holy,193,101,92
tichondrius,1622,paladin,holy,50,22,28
moon-guard,1617,paladin,holy,84,42,42
tichondrius,1614,paladin,holy,119,58,61
malganis,1608,paladin,holy,36,20,16
bleeding-hollow,1608,paladin,holy,83,45,38
nemesis,1598,paladin,holy,79,39,40
crushridge,1597,paladin,holy,32,18,14
aerie-peak,1596,paladin,holy,88,44,44
bleeding-hollow,1595,paladin,holy,93,46,47
kelthuzad,1589,paladin,holy,48,31,17
tichondrius,1587,paladin,holy,55,22,33
illidan,1577,paladin,holy,70,42,28
frostmourne,1575,paladin,holy,53,22,31
norgannon,1574,paladin,holy,68,32,36
stormrage,1573,paladin,holy,119,55,64
tichondrius,1559,paladin,holy,30,20,10
stormrage,1558,paladin,holy,53,29,24
tichondrius,1543,paladin,holy,138,77,61
illidan,1539,paladin,holy,36,20,16
stormrage,1535,paladin,holy,58,29,29
smolderthorn,1530,paladin,holy,36,22,14
lothar,1529,paladin,holy,74,33,41
kelthuzad,1527,paladin,holy,54,28,26
tichondrius,1526,paladin,holy,60,32,28
frostmourne,1524,paladin,holy,69,34,35
nathrezim,1523,paladin,holy,70,27,43
quelthalas,1520,paladin,holy,78,39,39
stormrage,1514,paladin,holy,105,56,49
thrall,1512,paladin,holy,45,24,21
dalaran,1512,paladin,holy,42,19,23
whisperwind,1510,paladin,holy,42,19,23
stormrage,1507,paladin,holy,30,16,14
tichondrius,1507,paladin,holy,41,21,20
thrall,1494,paladin,holy,84,37,47
quelthalas,1492,paladin,holy,101,46,55
tichondrius,1489,paladin,holy,66,27,39
tichondrius,1488,paladin,holy,66,32,34
nerzhul,1487,paladin,holy,111,52,59
the-scryers,1487,paladin,holy,90,39,51
azralon,1484,paladin,holy,46,24,22
earthen-ring,1484,paladin,holy,90,41,49
sargeras,1483,paladin,holy,50,25,25
tichondrius,1476,paladin,holy,50,25,25
mannoroth,1473,paladin,holy,34,17,17
nemesis,1472,paladin,holy,108,54,54
frostmourne,1465,paladin,holy,72,21,51
tichondrius,1464,paladin,holy,60,24,36
draenor,1461,paladin,holy,77,35,42
aggramar,1461,paladin,holy,56,25,31
frostmourne,1459,paladin,holy,84,48,36
wildhammer,1457,paladin,holy,69,40,29
zuljin,1454,paladin,holy,157,75,82
dentarg,1451,paladin,holy,42,23,19
tichondrius,1448,paladin,holy,80,42,38
ragnaros,1448,paladin,holy,66,31,35
veknilash,1446,paladin,holy,71,32,39
wyrmrest-accord,1445,paladin,holy,60,37,23
tichondrius,1442,paladin,holy,30,17,13
quelthalas,1437,paladin,holy,54,32,22
tichondrius,1428,paladin,holy,33,19,14
ragnaros,1427,paladin,holy,60,23,37
tichondrius,1424,paladin,holy,63,37,26
tichondrius,1423,paladin,holy,66,36,30
tichondrius,1421,paladin,holy,42,15,27
barthilas,1419,paladin,holy,30,15,15
moon-guard,1419,paladin,holy,88,37,51
azralon,1417,paladin,holy,66,24,42
frostmourne,1416,paladin,holy,87,46,41
tichondrius,1413,paladin,holy,79,41,38
tichondrius,1413,paladin,holy,72,30,42
sargeras,1407,paladin,holy,58,27,31
barthilas,1406,paladin,holy,71,41,30
zuljin,1398,paladin,holy,48,23,25
sargeras,1395,paladin,holy,54,29,25
tichondrius,1391,paladin,holy,63,31,32
tichondrius,1389,paladin,holy,36,15,21
kelthuzad,1388,paladin,holy,32,17,15
area-52,1387,paladin,holy,27,15,12
sargeras,1384,paladin,holy,63,26,37
gurubashi,1382,paladin,holy,35,16,19
uther,1382,paladin,holy,36,16,20
tichondrius,1381,paladin,holy,60,23,37
hyjal,1378,paladin,holy,36,17,19
the-venture-co,1371,paladin,holy,34,15,19
frostmourne,1362,paladin,holy,42,24,18
kiljaeden,1351,paladin,holy,48,23,25
malganis,1350,paladin,holy,42,24,18
proudmoore,1349,paladin,holy,48,26,22
sargeras,1346,paladin,holy,36,17,19
bleeding-hollow,1342,paladin,holy,41,20,21
zuljin,1338,paladin,holy,36,14,22
frostmourne,1337,paladin,holy,25,16,9
quelthalas,1334,paladin,holy,138,62,76
executus,1330,paladin,holy,30,14,16
ghostlands,1330,paladin,holy,36,16,20
tichondrius,1330,paladin,holy,42,17,25
tichondrius,1329,paladin,holy,72,33,39
khazgoroth,1327,paladin,holy,42,24,18
tichondrius,1327,paladin,holy,36,14,22
emerald-dream,1326,paladin,holy,42,14,28
laughing-skull,1325,paladin,holy,44,24,20
daggerspine,1324,paladin,holy,75,30,45
frostmourne,1322,paladin,holy,30,15,15
frostmourne,1317,paladin,holy,118,63,55
jubeithos,1316,paladin,holy,71,42,29
azralon,1315,paladin,holy,80,36,44
nemesis,1306,paladin,holy,54,27,27
burning-blade,1305,paladin,holy,38,24,14
amanthul,1305,paladin,holy,30,14,16
stormrage,1292,paladin,holy,30,16,14
azralon,1289,paladin,holy,30,16,14
blackhand,1288,paladin,holy,40,20,20
illidan,1287,paladin,holy,38,15,23
moon-guard,1283,paladin,holy,181,88,93
malganis,1282,paladin,holy,65,29,36
bleeding-hollow,1276,paladin,holy,74,35,39
burning-blade,1272,paladin,holy,43,18,25
bonechewer,1267,paladin,holy,41,23,18
ragnaros,1265,paladin,holy,115,55,60
quelthalas,1264,paladin,holy,36,21,15
dalaran,1258,paladin,holy,101,46,55
quelthalas,1247,paladin,holy,59,28,31
ragnaros,1244,paladin,holy,137,70,67
kelthuzad,1244,paladin,holy,36,13,23
sargeras,1242,paladin,holy,30,13,17
duskwood,1241,paladin,holy,18,13,5
skywall,1241,paladin,holy,30,13,17
nemesis,1238,paladin,holy,24,13,11
boulderfist,1236,paladin,holy,35,16,19
tichondrius,1235,paladin,holy,23,14,9
stormrage,1232,paladin,holy,75,34,41
bleeding-hollow,1229,paladin,holy,84,38,46
azralon,1229,paladin,holy,30,13,17
stonemaul,1229,paladin,holy,66,26,40
vashj,1228,paladin,holy,65,35,30
tichondrius,1226,paladin,holy,46,18,28
skullcrusher,1220,paladin,holy,35,21,14
proudmoore,1220,paladin,holy,109,57,52
drakkari,1218,paladin,holy,106,52,54
tichondrius,1215,paladin,holy,81,35,46
azralon,1214,paladin,holy,73,35,38
barthilas,1208,paladin,holy,42,15,27
tichondrius,1199,paladin,holy,49,28,21
thrall,1196,paladin,holy,31,15,16
kelthuzad,1194,paladin,holy,54,30,24
illidan,1193,paladin,holy,30,17,13
quelthalas,1188,paladin,holy,75,35,40
trollbane,1184,paladin,holy,83,29,54
mugthol,1178,paladin,holy,36,19,17
kargath,1178,paladin,holy,33,16,17
illidan,1177,paladin,holy,38,13,25
hyjal,1172,paladin,holy,60,27,33
frostmourne,1169,paladin,holy,36,20,16
sargeras,1168,paladin,holy,36,14,22
khadgar,1164,paladin,holy,80,39,41
norgannon,1156,paladin,holy,78,45,33
kelthuzad,1152,paladin,holy,67,38,29
tichondrius,1152,paladin,holy,33,14,19
quelthalas,1151,paladin,holy,24,12,12
tichondrius,1150,paladin,holy,24,12,12
tichondrius,1149,paladin,holy,24,12,12
nerzhul,1146,paladin,holy,18,12,6
drakthul,1146,paladin,holy,42,27,15
sargeras,1144,paladin,holy,24,12,12
barthilas,1139,paladin,holy,24,12,12
turalyon,1139,paladin,holy,90,40,50
moon-guard,1138,paladin,holy,30,12,18
nathrezim,1137,paladin,holy,36,13,23
nemesis,1133,paladin,holy,36,20,16
quelthalas,1127,paladin,holy,24,12,12
tichondrius,1127,paladin,holy,59,29,30
azralon,1122,paladin,holy,50,24,26
malganis,1121,paladin,holy,24,16,8
ragnaros,1121,paladin,holy,24,12,12
tichondrius,1119,paladin,holy,35,12,23
zuljin,1115,paladin,holy,61,25,36
kiljaeden,1110,paladin,holy,30,12,18
tichondrius,1103,paladin,holy,27,12,15
zuljin,1100,paladin,holy,17,12,5
tichondrius,1100,paladin,holy,42,15,27
quelthalas,1092,paladin,holy,111,55,56
barthilas,1079,paladin,holy,30,13,17
gallywix,1076,paladin,holy,24,14,10
warsong,1072,paladin,holy,36,25,11
area-52,1067,paladin,holy,34,12,22
illidan,1064,paladin,holy,48,26,22
zuljin,1058,paladin,holy,35,19,16
sargeras,1056,paladin,holy,18,11,7
stormrage,1056,paladin,holy,24,11,13
exodar,1055,paladin,holy,18,11,7
tichondrius,1055,paladin,holy,18,11,7
area-52,1055,paladin,holy,18,11,7
emerald-dream,1055,paladin,holy,30,11,19
sargeras,1054,paladin,holy,12,11,1
stormrage,1054,paladin,holy,24,11,13
tichondrius,1052,paladin,holy,24,11,13
frostmourne,1051,paladin,holy,24,11,13
sargeras,1051,paladin,holy,54,23,31
quelthalas,1044,paladin,holy,24,11,13
detheroc,1040,paladin,holy,73,31,42
sargeras,1032,paladin,holy,30,16,14
onyxia,1029,paladin,holy,54,26,28
ragnaros,1028,paladin,holy,24,11,13
malganis,1017,paladin,holy,40,23,17
dragonmaw,1014,paladin,holy,29,14,15
magtheridon,1014,paladin,holy,30,13,17
gorefiend,1013,paladin,holy,18,12,6
dalaran,1012,paladin,holy,23,11,12
kelthuzad,1010,paladin,holy,95,47,48
burning-legion,1002,paladin,holy,27,12,15
illidan,1000,paladin,holy,30,16,14
tichondrius,999,paladin,holy,29,13,16
auchindoun,988,paladin,holy,25,13,12
frostmourne,988,paladin,holy,26,11,15
emerald-dream,985,paladin,holy,32,11,21
vashj,984,paladin,holy,89,40,49
moon-guard,963,paladin,holy,21,13,8
tichondrius,960,paladin,holy,12,10,2
malganis,960,paladin,holy,15,11,4
tichondrius,960,paladin,holy,24,10,14
tichondrius,960,paladin,holy,30,10,20
stormrage,958,paladin,holy,33,10,23
area-52,955,paladin,holy,30,12,18
illidan,951,paladin,holy,49,15,34
ysondre,950,paladin,holy,18,10,8
tichondrius,945,paladin,holy,18,10,8
illidan,940,paladin,holy,14,10,4
stormrage,938,paladin,holy,24,15,9
mannoroth,933,paladin,holy,18,10,8
moon-guard,929,paladin,holy,71,24,47
illidan,928,paladin,holy,48,21,27
ragnaros,926,paladin,holy,14,11,3
doomhammer,921,paladin,holy,49,24,25
bleeding-hollow,909,paladin,holy,62,28,34
amanthul,897,paladin,holy,84,30,54
tichondrius,894,paladin,holy,23,10,13
azshara,892,paladin,holy,29,13,16
sargeras,864,paladin,holy,12,9,3
illidan,864,paladin,holy,12,9,3
ysera,864,paladin,holy,18,9,9
ragnaros,864,paladin,holy,18,9,9
moon-guard,864,paladin,holy,23,9,14
tichondrius,864,paladin,holy,24,9,15
kelthuzad,864,paladin,holy,24,9,15
tichondrius,862,paladin,holy,24,9,15
nemesis,861,paladin,holy,18,9,9
tichondrius,858,paladin,holy,18,9,9
malganis,857,paladin,holy,24,9,15
thrall,844,paladin,holy,18,9,9
argent-dawn,843,paladin,holy,29,12,17
tichondrius,836,paladin,holy,24,9,15
hydraxis,825,paladin,holy,48,20,28
nerzhul,822,paladin,holy,73,31,42
stormreaver,815,paladin,holy,17,9,8
tichondrius,813,paladin,holy,21,9,12
zuljin,805,paladin,holy,18,9,9
veknilash,776,paladin,holy,42,14,28
tichondrius,768,paladin,holy,12,8,4
ragnaros,768,paladin,holy,18,8,10
frostmourne,768,paladin,holy,18,8,10
azshara,768,paladin,holy,24,8,16
alterac-mountains,767,paladin,holy,12,8,4
nesingwary,767,paladin,holy,12,8,4
sargeras,767,paladin,holy,12,8,4
barthilas,767,paladin,holy,18,8,10
ragnaros,767,paladin,holy,18,8,10
kelthuzad,767,paladin,holy,18,8,10
moon-guard,767,paladin,holy,18,8,10
proudmoore,767,paladin,holy,18,8,10
tichondrius,767,paladin,holy,18,8,10
illidan,767,paladin,holy,24,8,16
frostmourne,766,paladin,holy,12,8,4
stormrage,765,paladin,holy,12,8,4
mannoroth,764,paladin,holy,12,8,4
tichondrius,764,paladin,holy,18,8,10
thrall,763,paladin,holy,18,9,9
frostmourne,763,paladin,holy,18,8,10
barthilas,763,paladin,holy,18,8,10
fizzcrank,757,paladin,holy,18,8,10
runetotem,753,paladin,holy,18,8,10
illidan,750,paladin,holy,12,8,4
eldrethalas,737,paladin,holy,24,8,16
illidan,724,paladin,holy,16,9,7
dalaran,719,paladin,holy,9,9,0
stormreaver,713,paladin,holy,26,9,17
tichondrius,703,paladin,holy,10,8,2
moon-guard,687,paladin,holy,11,8,3
zuljin,672,paladin,holy,12,7,5
illidan,672,paladin,holy,12,7,5
tichondrius,672,paladin,holy,12,7,5
tichondrius,672,paladin,holy,12,7,5
tichondrius,672,paladin,holy,12,7,5
sargeras,672,paladin,holy,12,7,5
area-52,672,paladin,holy,12,7,5
sargeras,672,paladin,holy,12,7,5
sargeras,672,paladin,holy,12,7,5
zuljin,672,paladin,holy,18,7,11
tichondrius,672,paladin,holy,18,7,11
stormrage,672,paladin,holy,18,7,11
illidan,672,paladin,holy,24,7,17
tichondrius,671,paladin,holy,12,7,5
tichondrius,671,paladin,holy,12,7,5
chogall,671,paladin,holy,12,7,5
lightbringer,671,paladin,holy,12,7,5
area-52,671,paladin,holy,18,7,11
area-52,670,paladin,holy,12,7,5
barthilas,670,paladin,holy,12,7,5
stormscale,670,paladin,holy,12,7,5
burning-blade,670,paladin,holy,18,7,11
ragnaros,670,paladin,holy,18,7,11
the-underbog,669,paladin,holy,12,7,5
frostmourne,669,paladin,holy,18,7,11
anvilmar,669,paladin,holy,36,7,29
stormrage,668,paladin,holy,18,7,11
proudmoore,667,paladin,holy,12,7,5
proudmoore,666,paladin,holy,12,7,5
blackhand,654,paladin,holy,24,7,17
tichondrius,638,paladin,holy,17,7,10
wyrmrest-accord,606,paladin,holy,14,7,7
wyrmrest-accord,591,paladin,holy,19,7,12
frostmourne,576,paladin,holy,9,7,2
malorne,576,paladin,holy,12,6,6
tichondrius,576,paladin,holy,12,6,6
tichondrius,576,paladin,holy,12,6,6
tichondrius,576,paladin,holy,12,6,6
tichondrius,576,paladin,holy,12,6,6
elune,576,paladin,holy,12,6,6
frostmourne,576,paladin,holy,12,6,6
sargeras,576,paladin,holy,12,6,6
blackrock,576,paladin,holy,12,6,6
tichondrius,576,paladin,holy,12,6,6
tichondrius,576,paladin,holy,12,6,6
frostmourne,576,paladin,holy,17,6,11
tichondrius,576,paladin,holy,18,6,12
zuljin,576,paladin,holy,18,6,12
ragnaros,576,paladin,holy,24,6,18
azralon,576,paladin,holy,24,6,18
malganis,575,paladin,holy,12,6,6
barthilas,575,paladin,holy,12,6,6
zuljin,575,paladin,holy,12,6,6
area-52,575,paladin,holy,18,6,12
kiljaeden,574,paladin,holy,12,6,6
tichondrius,574,paladin,holy,12,6,6
proudmoore,574,paladin,holy,12,6,6
greymane,574,paladin,holy,12,6,6
bleeding-hollow,573,paladin,holy,18,6,12
sargeras,572,paladin,holy,12,6,6
stormrage,571,paladin,holy,12,6,6
tichondrius,570,paladin,holy,12,6,6
nordrassil,569,paladin,holy,12,6,6
stormrage,569,paladin,holy,24,6,18
wildhammer,569,paladin,holy,24,6,18
kelthuzad,560,paladin,holy,24,6,18
proudmoore,557,paladin,holy,10,7,3
ragnaros,543,paladin,holy,11,6,5
thrall,543,paladin,holy,11,6,5
emerald-dream,543,paladin,holy,16,6,10
quelthalas,543,paladin,holy,20,7,13
moon-guard,542,paladin,holy,14,7,7
daggerspine,542,paladin,holy,26,7,19
zuljin,528,paladin,holy,9,6,3
tichondrius,522,paladin,holy,12,7,5
sargeras,522,paladin,holy,13,7,6
quelthalas,521,paladin,holy,20,8,12
durotan,496,paladin,holy,7,6,1
tichondrius,496,paladin,holy,19,6,13
moon-guard,480,paladin,holy,6,5,1
sargeras,480,paladin,holy,6,5,1
tichondrius,480,paladin,holy,6,5,1
azralon,480,paladin,holy,6,5,1
stormrage,480,paladin,holy,6,5,1
malganis,480,paladin,holy,12,5,7
illidan,480,paladin,holy,12,5,7
bleeding-hollow,480,paladin,holy,12,5,7
ragnaros,480,paladin,holy,12,5,7
anetheron,480,paladin,holy,12,5,7
barthilas,480,paladin,holy,12,5,7
malganis,480,paladin,holy,12,5,7
proudmoore,480,paladin,holy,12,5,7
tichondrius,480,paladin,holy,12,5,7
saurfang,480,paladin,holy,12,5,7
frostmourne,480,paladin,holy,12,5,7
tichondrius,480,paladin,holy,12,5,7
tichondrius,480,paladin,holy,12,5,7
tichondrius,480,paladin,holy,12,5,7
alleria,480,paladin,holy,12,5,7
tichondrius,480,paladin,holy,12,5,7
sargeras,480,paladin,holy,15,6,9
frostmourne,479,paladin,holy,12,5,7
crushridge,479,paladin,holy,12,5,7
quelthalas,479,paladin,holy,12,5,7
malorne,479,paladin,holy,12,5,7
stormrage,479,paladin,holy,12,5,7
thrall,479,paladin,holy,18,5,13
malganis,479,paladin,holy,18,5,13
zuljin,478,paladin,holy,12,5,7
kelthuzad,478,paladin,holy,24,5,19
proudmoore,477,paladin,holy,18,5,13
aerie-peak,468,paladin,holy,24,5,19
azjolnerub,463,paladin,holy,11,5,6
stormrage,432,paladin,holy,15,5,10
sargeras,430,paladin,holy,11,5,6
moon-guard,430,paladin,holy,15,5,10
garrosh,426,paladin,holy,16,7,9
mannoroth,426,paladin,holy,23,6,17
bonechewer,415,paladin,holy,8,5,3
moon-guard,400,paladin,holy,7,5,2
tichondrius,384,paladin,holy,6,4,2
stormrage,384,paladin,holy,6,4,2
ragnaros,384,paladin,holy,6,4,2
bleeding-hollow,384,paladin,holy,6,4,2
garona,384,paladin,holy,6,4,2
zuljin,384,paladin,holy,6,4,2
hakkar,384,paladin,holy,6,4,2
rexxar,384,paladin,holy,6,4,2
korgath,384,paladin,holy,6,4,2
stormrage,384,paladin,holy,6,4,2
daggerspine,384,paladin,holy,6,4,2
mannoroth,384,paladin,holy,6,4,2
frostwolf,384,paladin,holy,6,4,2
black-dragonflight,384,paladin,holy,6,4,2
emerald-dream,384,paladin,holy,6,4,2
tichondrius,384,paladin,holy,6,4,2
barthilas,384,paladin,holy,6,4,2
frostmourne,384,paladin,holy,6,4,2
frostmourne,384,paladin,holy,6,4,2
illidan,384,paladin,holy,6,4,2
moon-guard,384,paladin,holy,12,4,8
illidan,384,paladin,holy,12,4,8
bonechewer,384,paladin,holy,12,4,8
tichondrius,384,paladin,holy,12,4,8
ysera,384,paladin,holy,12,4,8
malganis,384,paladin,holy,12,4,8
baelgun,384,paladin,holy,12,4,8
aggramar,384,paladin,holy,12,4,8
area-52,384,paladin,holy,12,4,8
silver-hand,384,paladin,holy,12,4,8
emerald-dream,384,paladin,holy,12,4,8
hyjal,384,paladin,holy,18,4,14
quelthalas,384,paladin,holy,18,4,14
tichondrius,384,paladin,holy,18,4,14
winterhoof,383,paladin,holy,6,4,2
zuljin,383,paladin,holy,6,4,2
feathermoon,383,paladin,holy,12,4,8
zuljin,383,paladin,holy,12,4,8
tichondrius,383,paladin,holy,12,4,8
frostmourne,383,paladin,holy,12,4,8
barthilas,383,paladin,holy,18,4,14
azralon,383,paladin,holy,18,4,14
skywall,382,paladin,holy,6,4,2
thrall,382,paladin,holy,6,4,2
thrall,382,paladin,holy,18,4,14
area-52,380,paladin,holy,12,4,8
zuljin,379,paladin,holy,12,4,8
stormrage,351,paladin,holy,11,4,7
frostmourne,351,paladin,holy,11,4,7
kelthuzad,336,paladin,holy,15,4,11
emerald-dream,304,paladin,holy,7,4,3
moon-guard,304,paladin,holy,13,4,9
stormrage,288,paladin,holy,6,3,3
bleeding-hollow,288,paladin,holy,6,3,3
stormrage,288,paladin,holy,6,3,3
stormrage,288,paladin,holy,6,3,3
illidan,288,paladin,holy,6,3,3
dalaran,288,paladin,holy,6,3,3
bleeding-hollow,288,paladin,holy,6,3,3
illidan,288,paladin,holy,6,3,3
stormrage,288,paladin,holy,6,3,3
illidan,288,paladin,holy,6,3,3
zuljin,288,paladin,holy,6,3,3
tichondrius,288,paladin,holy,6,3,3
sargeras,288,paladin,holy,6,3,3
firetree,288,paladin,holy,6,3,3
moon-guard,288,paladin,holy,6,3,3
wyrmrest-accord,288,paladin,holy,6,3,3
burning-blade,288,paladin,holy,6,3,3
sargeras,288,paladin,holy,6,3,3
blackrock,288,paladin,holy,6,3,3
cenarius,288,paladin,holy,6,3,3
kelthuzad,288,paladin,holy,6,3,3
hyjal,288,paladin,holy,6,3,3
sargeras,288,paladin,holy,6,3,3
proudmoore,288,paladin,holy,6,3,3
tichondrius,288,paladin,holy,6,3,3
quelthalas,288,paladin,holy,6,3,3
tichondrius,288,paladin,holy,6,3,3
tichondrius,288,paladin,holy,6,3,3
kelthuzad,288,paladin,holy,6,3,3
tichondrius,288,paladin,holy,6,3,3
tichondrius,288,paladin,holy,6,3,3
frostmourne,288,paladin,holy,6,3,3
turalyon,288,paladin,holy,6,3,3
ragnaros,288,paladin,holy,6,3,3
ragnaros,288,paladin,holy,6,3,3
frostmourne,288,paladin,holy,6,3,3
quelthalas,288,paladin,holy,6,3,3
malganis,288,paladin,holy,12,3,9
the-underbog,288,paladin,holy,12,3,9
shandris,288,paladin,holy,12,3,9
wyrmrest-accord,288,paladin,holy,12,3,9
alleria,288,paladin,holy,12,3,9
tichondrius,288,paladin,holy,18,3,15
frostmourne,288,paladin,holy,18,3,15
quelthalas,288,paladin,holy,18,3,15
area-52,288,paladin,holy,18,3,15
sisters-of-elune,287,paladin,holy,12,3,9
exodar,285,paladin,holy,18,3,15
arathor,256,paladin,holy,4,4,0
frostmourne,255,paladin,holy,11,3,8
tichondrius,255,paladin,holy,11,3,8
tichondrius,239,paladin,holy,5,3,2
dalaran,234,paladin,holy,9,4,5
illidan,192,paladin,holy,6,2,4
nemesis,192,paladin,holy,6,2,4
dalaran,192,paladin,holy,6,2,4
quelthalas,192,paladin,holy,6,2,4
thrall,192,paladin,holy,6,2,4
ragnaros,192,paladin,holy,6,2,4
kelthuzad,192,paladin,holy,6,2,4
sargeras,192,paladin,holy,6,2,4
tichondrius,192,paladin,holy,6,2,4
area-52,192,paladin,holy,6,2,4
tichondrius,192,paladin,holy,6,2,4
tichondrius,192,paladin,holy,6,2,4
kelthuzad,192,paladin,holy,6,2,4
barthilas,192,paladin,holy,6,2,4
tichondrius,192,paladin,holy,6,2,4
senjin,192,paladin,holy,6,2,4
barthilas,192,paladin,holy,6,2,4
blackrock,192,paladin,holy,6,2,4
eldrethalas,192,paladin,holy,6,2,4
tichondrius,192,paladin,holy,6,2,4
hyjal,192,paladin,holy,6,2,4
sargeras,192,paladin,holy,6,2,4
stormrage,192,paladin,holy,6,2,4
tichondrius,192,paladin,holy,6,2,4
sargeras,192,paladin,holy,6,2,4
aegwynn,192,paladin,holy,6,2,4
tichondrius,192,paladin,holy,6,2,4
sargeras,192,paladin,holy,6,2,4
kelthuzad,192,paladin,holy,6,2,4
sargeras,192,paladin,holy,6,2,4
azralon,192,paladin,holy,6,2,4
sargeras,192,paladin,holy,6,2,4
tichondrius,192,paladin,holy,6,2,4
azralon,192,paladin,holy,6,2,4
thrall,192,paladin,holy,6,2,4
shadowsong,192,paladin,holy,8,2,6
azralon,192,paladin,holy,12,2,10
lightbringer,192,paladin,holy,12,2,10
proudmoore,192,paladin,holy,12,2,10
area-52,192,paladin,holy,12,2,10
kirin-tor,192,paladin,holy,12,2,10
turalyon,192,paladin,holy,12,2,10
thunderlord,192,paladin,holy,12,2,10
zuljin,192,paladin,holy,12,2,10
terokkar,192,paladin,holy,18,2,16
emerald-dream,191,paladin,holy,6,2,4
sargeras,191,paladin,holy,6,2,4
frostmourne,191,paladin,holy,6,2,4
quelthalas,175,paladin,holy,11,2,9
ragnaros,159,paladin,holy,5,2,3
amanthul,159,paladin,holy,8,3,5
emerald-dream,159,paladin,holy,17,2,15
darkspear,138,paladin,holy,10,4,6
korgath,112,paladin,holy,7,2,5
sargeras,96,paladin,holy,3,2,1
kiljaeden,96,paladin,holy,6,1,5
proudmoore,96,paladin,holy,6,1,5
zuljin,96,paladin,holy,6,1,5
tichondrius,96,paladin,holy,6,1,5
barthilas,96,paladin,holy,6,1,5
elune,96,paladin,holy,6,1,5
lightninghoof,96,paladin,holy,6,1,5
dalvengyr,96,paladin,holy,6,1,5
stormrage,96,paladin,holy,6,1,5
tichondrius,96,paladin,holy,6,1,5
ragnaros,96,paladin,holy,6,1,5
bonechewer,96,paladin,holy,6,1,5
kelthuzad,96,paladin,holy,6,1,5
illidan,96,paladin,holy,6,1,5
wyrmrest-accord,96,paladin,holy,6,1,5
ysera,96,paladin,holy,6,1,5
lightnings-blade,96,paladin,holy,6,1,5
emerald-dream,96,paladin,holy,6,1,5
illidan,96,paladin,holy,6,1,5
emerald-dream,96,paladin,holy,6,1,5
arygos,96,paladin,holy,6,1,5
malganis,96,paladin,holy,6,1,5
sargeras,96,paladin,holy,6,1,5
rivendare,96,paladin,holy,6,1,5
dalaran,96,paladin,holy,6,1,5
skywall,96,paladin,holy,6,1,5
darkspear,96,paladin,holy,6,1,5
thrall,96,paladin,holy,6,1,5
dunemaul,96,paladin,holy,11,1,10
tichondrius,96,paladin,holy,12,1,11
whisperwind,96,paladin,holy,12,1,11
moonrunner,96,paladin,holy,12,1,11
stormrage,96,paladin,holy,12,1,11
quelthalas,96,paladin,holy,12,1,11
dragonmaw,96,paladin,holy,12,1,11
thrall,89,paladin,holy,11,3,8
tichondrius,84,paladin,holy,9,4,5
moon-guard,63,paladin,holy,6,3,3
ghostlands,48,paladin,holy,21,1,20
tichondrius,42,paladin,holy,9,2,7
tichondrius,42,paladin,holy,14,3,11
frostmourne,9,paladin,holy,23,3,20
tichondrius,2192,paladin,retribution,78,43,35
alexstrasza,2167,paladin,retribution,107,56,51
ragnaros,2104,paladin,retribution,125,63,62
tichondrius,2104,paladin,retribution,114,57,57
tichondrius,2101,paladin,retribution,101,53,48
darkspear,2073,paladin,retribution,84,42,42
azralon,2047,paladin,retribution,80,39,41
tichondrius,2040,paladin,retribution,113,57,56
tichondrius,2019,paladin,retribution,87,41,46
frostmourne,1991,paladin,retribution,71,40,31
tichondrius,1985,paladin,retribution,58,29,29
sargeras,1970,paladin,retribution,113,54,59
moon-guard,1958,paladin,retribution,60,33,27
bleeding-hollow,1939,paladin,retribution,99,45,54
ragnaros,1938,paladin,retribution,90,49,41
zuljin,1937,paladin,retribution,96,45,51
khadgar,1920,paladin,retribution,158,95,63
tichondrius,1909,paladin,retribution,78,35,43
tichondrius,1901,paladin,retribution,63,30,33
tichondrius,1900,paladin,retribution,60,30,30
zuluhed,1888,paladin,retribution,42,23,19
zuljin,1885,paladin,retribution,30,20,10
tichondrius,1885,paladin,retribution,49,26,23
black-dragonflight,1884,paladin,retribution,156,72,84
tichondrius,1878,paladin,retribution,101,56,45
earthen-ring,1876,paladin,retribution,66,34,32
stormrage,1866,paladin,retribution,78,43,35
tichondrius,1865,paladin,retribution,72,36,36
tichondrius,1847,paladin,retribution,63,32,31
ragnaros,1847,paladin,retribution,90,42,48
tichondrius,1845,paladin,retribution,77,39,38
malganis,1843,paladin,retribution,46,29,17
proudmoore,1842,paladin,retribution,60,28,32
stormscale,1840,paladin,retribution,52,37,15
area-52,1839,paladin,retribution,41,25,16
agamaggan,1839,paladin,retribution,56,31,25
frostmourne,1839,paladin,retribution,58,29,29
zuljin,1837,paladin,retribution,42,20,22
tichondrius,1836,paladin,retribution,36,23,13
tichondrius,1836,paladin,retribution,60,23,37
illidan,1835,paladin,retribution,70,33,37
tichondrius,1832,paladin,retribution,48,21,27
moon-guard,1829,paladin,retribution,54,31,23
ragnaros,1829,paladin,retribution,161,82,79
illidan,1829,paladin,retribution,75,38,37
kelthuzad,1829,paladin,retribution,47,20,27
stormreaver,1829,paladin,retribution,78,31,47
dalaran,1828,paladin,retribution,66,34,32
moon-guard,1827,paladin,retribution,59,30,29
ragnaros,1826,paladin,retribution,59,30,29
firetree,1826,paladin,retribution,66,29,37
nemesis,1826,paladin,retribution,71,31,40
kelthuzad,1822,paladin,retribution,129,66,63
azralon,1820,paladin,retribution,29,20,9
tichondrius,1819,paladin,retribution,39,20,19
moon-guard,1819,paladin,retribution,48,23,25
area-52,1819,paladin,retribution,107,48,59
stormrage,1818,paladin,retribution,42,25,17
tichondrius,1818,paladin,retribution,69,31,38
ragnaros,1816,paladin,retribution,56,37,19
azralon,1815,paladin,retribution,46,27,19
tichondrius,1815,paladin,retribution,143,68,75
ragnaros,1814,paladin,retribution,36,23,13
tichondrius,1814,paladin,retribution,57,30,27
malganis,1814,paladin,retribution,156,78,78
stormrage,1813,paladin,retribution,78,40,38
tichondrius,1812,paladin,retribution,72,30,42
drakkari,1812,paladin,retribution,78,29,49
area-52,1810,paladin,retribution,120,66,54
sargeras,1807,paladin,retribution,73,39,34
sargeras,1807,paladin,retribution,66,29,37
dalaran,1806,paladin,retribution,30,19,11
moon-guard,1806,paladin,retribution,82,35,47
tichondrius,1805,paladin,retribution,107,58,49
bleeding-hollow,1804,paladin,retribution,59,42,17
tichondrius,1804,paladin,retribution,60,33,27
moon-guard,1804,paladin,retribution,75,36,39
tichondrius,1804,paladin,retribution,111,45,66
tichondrius,1803,paladin,retribution,42,19,23
bleeding-hollow,1802,paladin,retribution,36,19,17
tichondrius,1796,paladin,retribution,47,26,21
tichondrius,1794,paladin,retribution,48,31,17
tichondrius,1790,paladin,retribution,79,34,45
illidan,1778,paladin,retribution,48,26,22
kelthuzad,1777,paladin,retribution,54,26,28
tichondrius,1775,paladin,retribution,79,31,48
stormscale,1772,paladin,retribution,48,25,23
stormrage,1772,paladin,retribution,72,37,35
shadow-council,1768,paladin,retribution,115,54,61
khaz-modan,1766,paladin,retribution,189,109,80
ragnaros,1766,paladin,retribution,48,26,22
akama,1755,paladin,retribution,62,28,34
tichondrius,1751,paladin,retribution,40,23,17
kalecgos,1750,paladin,retribution,48,25,23
ragnaros,1744,paladin,retribution,121,67,54
azgalor,1742,paladin,retribution,67,34,33
thrall,1739,paladin,retribution,89,41,48
thrall,1736,paladin,retribution,48,25,23
lightbringer,1736,paladin,retribution,48,25,23
illidan,1736,paladin,retribution,72,36,36
aggramar,1735,paladin,retribution,72,37,35
tichondrius,1732,paladin,retribution,45,24,21
dalaran,1732,paladin,retribution,40,21,19
tichondrius,1732,paladin,retribution,48,19,29
ragnaros,1729,paladin,retribution,106,54,52
drenden,1728,paladin,retribution,66,28,38
tichondrius,1727,paladin,retribution,79,47,32
tichondrius,1726,paladin,retribution,51,26,25
tichondrius,1723,paladin,retribution,36,18,18
tichondrius,1723,paladin,retribution,72,24,48
area-52,1720,paladin,retribution,34,25,9
stormscale,1718,paladin,retribution,70,33,37
icecrown,1717,paladin,retribution,42,21,21
bleeding-hollow,1716,paladin,retribution,50,23,27
proudmoore,1715,paladin,retribution,54,26,28
area-52,1714,paladin,retribution,54,26,28
barthilas,1713,paladin,retribution,82,40,42
emerald-dream,1712,paladin,retribution,114,60,54
blackhand,1710,paladin,retribution,42,24,18
emerald-dream,1708,paladin,retribution,36,21,15
malganis,1708,paladin,retribution,48,24,24
bleeding-hollow,1708,paladin,retribution,76,29,47
illidan,1707,paladin,retribution,36,18,18
kilrogg,1699,paladin,retribution,52,28,24
tichondrius,1697,paladin,retribution,45,23,22
tichondrius,1693,paladin,retribution,51,25,26
emerald-dream,1689,paladin,retribution,66,30,36
illidan,1689,paladin,retribution,54,23,31
ragnaros,1689,paladin,retribution,78,32,46
tichondrius,1687,paladin,retribution,96,50,46
thrall,1686,paladin,retribution,60,30,30
sargeras,1685,paladin,retribution,60,26,34
moon-guard,1684,paladin,retribution,42,24,18
moon-guard,1684,paladin,retribution,78,43,35
tichondrius,1682,paladin,retribution,40,24,16
ragnaros,1680,paladin,retribution,77,40,37
azralon,1675,paladin,retribution,54,30,24
sargeras,1674,paladin,retribution,42,20,22
frostmourne,1671,paladin,retribution,42,21,21
frostmourne,1671,paladin,retribution,60,24,36
tichondrius,1669,paladin,retribution,53,26,27
tichondrius,1669,paladin,retribution,48,23,25
tichondrius,1667,paladin,retribution,30,19,11
proudmoore,1665,paladin,retribution,53,27,26
nemesis,1663,paladin,retribution,53,22,31
sargeras,1661,paladin,retribution,30,19,11
barthilas,1661,paladin,retribution,36,21,15
stormreaver,1661,paladin,retribution,48,27,21
thrall,1660,paladin,retribution,60,28,32
tichondrius,1656,paladin,retribution,36,20,16
illidan,1653,paladin,retribution,120,69,51
lightbringer,1651,paladin,retribution,64,33,31
wyrmrest-accord,1649,paladin,retribution,72,38,34
ragnaros,1649,paladin,retribution,49,19,30
barthilas,1647,paladin,retribution,66,37,29
ysera,1645,paladin,retribution,64,36,28
proudmoore,1644,paladin,retribution,43,29,14
velen,1643,paladin,retribution,48,27,21
silvermoon,1640,paladin,retribution,66,43,23
tichondrius,1640,paladin,retribution,82,45,37
malganis,1637,paladin,retribution,42,22,20
bladefist,1637,paladin,retribution,42,18,24
frostmourne,1636,paladin,retribution,90,43,47
thrall,1635,paladin,retribution,53,30,23
draka,1634,paladin,retribution,46,22,24
stormrage,1632,paladin,retribution,49,24,25
tichondrius,1632,paladin,retribution,46,21,25
malganis,1631,paladin,retribution,66,31,35
quelthalas,1630,paladin,retribution,41,22,19
bladefist,1630,paladin,retribution,74,37,37
sargeras,1629,paladin,retribution,30,17,13
thunderhorn,1629,paladin,retribution,36,17,19
sargeras,1626,paladin,retribution,72,35,37
zuljin,1624,paladin,retribution,36,20,16
blackrock,1622,paladin,retribution,30,20,10
darkspear,1622,paladin,retribution,30,18,12
illidan,1621,paladin,retribution,36,20,16
moon-guard,1621,paladin,retribution,160,84,76
quelthalas,1620,paladin,retribution,125,61,64
frostmourne,1619,paladin,retribution,48,20,28
bleeding-hollow,1617,paladin,retribution,36,21,15
frostmourne,1615,paladin,retribution,65,34,31
jubeithos,1612,paladin,retribution,41,17,24
stormrage,1612,paladin,retribution,60,24,36
tichondrius,1609,paladin,retribution,100,51,49
nemesis,1609,paladin,retribution,54,21,33
rivendare,1607,paladin,retribution,110,51,59
emerald-dream,1606,paladin,retribution,63,38,25
moon-guard,1606,paladin,retribution,182,86,96
tichondrius,1606,paladin,retribution,54,20,34
stormrage,1605,paladin,retribution,36,19,17
proudmoore,1605,paladin,retribution,52,23,29
illidan,1604,paladin,retribution,36,19,17
area-52,1604,paladin,retribution,72,36,36
tichondrius,1599,paladin,retribution,50,28,22
stormrage,1599,paladin,retribution,36,19,17
azralon,1596,paladin,retribution,42,21,21
sargeras,1595,paladin,retribution,45,26,19
tichondrius,1594,paladin,retribution,36,20,16
ragnaros,1593,paladin,retribution,48,22,26
thrall,1593,paladin,retribution,48,19,29
azralon,1592,paladin,retribution,61,33,28
emerald-dream,1592,paladin,retribution,38,20,18
quelthalas,1588,paladin,retribution,30,21,9
stormrage,1588,paladin,retribution,35,17,18
quelthalas,1587,paladin,retribution,74,38,36
quelthalas,1586,paladin,retribution,36,20,16
lightnings-blade,1584,paladin,retribution,36,19,17
moon-guard,1584,paladin,retribution,36,17,19
malganis,1583,paladin,retribution,60,30,30
icecrown,1581,paladin,retribution,53,30,23
azralon,1580,paladin,retribution,120,68,52
stormrage,1578,paladin,retribution,147,73,74
malygos,1577,paladin,retribution,51,24,27
tichondrius,1576,paladin,retribution,41,18,23
illidan,1576,paladin,retribution,41,17,24
zuljin,1573,paladin,retribution,96,40,56
kelthuzad,1572,paladin,retribution,50,22,28
tichondrius,1572,paladin,retribution,44,18,26
kiljaeden,1571,paladin,retribution,66,24,42
area-52,1570,paladin,retribution,48,27,21
barthilas,1570,paladin,retribution,38,20,18
area-52,1570,paladin,retribution,121,61,60
bleeding-hollow,1568,paladin,retribution,53,23,30
tichondrius,1567,paladin,retribution,48,23,25
magtheridon,1564,paladin,retribution,48,18,30
sargeras,1563,paladin,retribution,44,18,26
darkspear,1561,paladin,retribution,91,51,40
tichondrius,1560,paladin,retribution,36,17,19
firetree,1557,paladin,retribution,37,25,12
proudmoore,1556,paladin,retribution,48,24,24
azralon,1556,paladin,retribution,50,17,33
frostwolf,1555,paladin,retribution,36,17,19
sargeras,1554,paladin,retribution,48,18,30
bleeding-hollow,1553,paladin,retribution,62,32,30
ragnaros,1553,paladin,retribution,58,29,29
wyrmrest-accord,1553,paladin,retribution,71,32,39
stormrage,1553,paladin,retribution,71,29,42
tichondrius,1552,paladin,retribution,32,21,11
stormrage,1552,paladin,retribution,48,25,23
uther,1550,paladin,retribution,68,27,41
moon-guard,1550,paladin,retribution,48,17,31
skullcrusher,1549,paladin,retribution,54,29,25
sargeras,1542,paladin,retribution,90,38,52
moon-guard,1542,paladin,retribution,60,24,36
wyrmrest-accord,1541,paladin,retribution,95,41,54
area-52,1540,paladin,retribution,58,26,32
barthilas,1540,paladin,retribution,72,23,49
sargeras,1538,paladin,retribution,36,20,16
hakkar,1538,paladin,retribution,204,100,104
moon-guard,1537,paladin,retribution,42,25,17
malganis,1535,paladin,retribution,60,23,37
tichondrius,1534,paladin,retribution,18,16,2
sargeras,1534,paladin,retribution,36,16,20
moon-guard,1530,paladin,retribution,30,16,14
sargeras,1527,paladin,retribution,42,20,22
tichondrius,1526,paladin,retribution,24,16,8
icecrown,1525,paladin,retribution,53,37,16
malygos,1525,paladin,retribution,30,17,13
ragnaros,1525,paladin,retribution,83,44,39
korgath,1524,paladin,retribution,38,20,18
ragnaros,1523,paladin,retribution,85,47,38
nemesis,1521,paladin,retribution,24,16,8
moon-guard,1521,paladin,retribution,57,35,22
wyrmrest-accord,1520,paladin,retribution,24,17,7
medivh,1519,paladin,retribution,41,26,15
moon-guard,1518,paladin,retribution,42,16,26
azjolnerub,1516,paladin,retribution,42,20,22
sargeras,1515,paladin,retribution,54,28,26
ragnaros,1515,paladin,retribution,38,18,20
illidan,1514,paladin,retribution,48,16,32
akama,1513,paladin,retribution,48,23,25
sargeras,1508,paladin,retribution,54,31,23
drakkari,1508,paladin,retribution,60,23,37
wyrmrest-accord,1507,paladin,retribution,36,19,17
tichondrius,1506,paladin,retribution,42,16,26
moon-guard,1505,paladin,retribution,48,24,24
stormrage,1505,paladin,retribution,48,21,27
frostmourne,1504,paladin,retribution,36,16,20
ragnaros,1503,paladin,retribution,108,48,60
aggramar,1502,paladin,retribution,97,55,42
kiljaeden,1502,paladin,retribution,30,16,14
tichondrius,1502,paladin,retribution,30,16,14
quelthalas,1498,paladin,retribution,58,38,20
ragnaros,1497,paladin,retribution,36,16,20
moon-guard,1495,paladin,retribution,77,33,44
area-52,1493,paladin,retribution,30,16,14
blackrock,1492,paladin,retribution,46,24,22
stormrage,1492,paladin,retribution,62,30,32
uldum,1491,paladin,retribution,36,21,15
malganis,1484,paladin,retribution,50,20,30
stormscale,1482,paladin,retribution,36,18,18
aerie-peak,1482,paladin,retribution,42,18,24
malganis,1482,paladin,retribution,54,21,33
azgalor,1480,paladin,retribution,60,23,37
thrall,1479,paladin,retribution,38,20,18
wyrmrest-accord,1479,paladin,retribution,72,37,35
thunderlord,1479,paladin,retribution,46,18,28
moon-guard,1474,paladin,retribution,30,19,11
alleria,1471,paladin,retribution,52,28,24
doomhammer,1468,paladin,retribution,30,22,8
proudmoore,1467,paladin,retribution,101,52,49
quelthalas,1466,paladin,retribution,59,32,27
quelthalas,1465,paladin,retribution,65,37,28
illidan,1464,paladin,retribution,36,18,18
proudmoore,1461,paladin,retribution,30,17,13
emerald-dream,1461,paladin,retribution,69,32,37
tichondrius,1460,paladin,retribution,42,24,18
garrosh,1456,paladin,retribution,54,29,25
zuljin,1456,paladin,retribution,48,24,24
bleeding-hollow,1453,paladin,retribution,52,27,25
chogall,1453,paladin,retribution,48,19,29
azralon,1450,paladin,retribution,32,16,16
malygos,1449,paladin,retribution,24,16,8
azralon,1449,paladin,retribution,62,34,28
elune,1446,paladin,retribution,56,29,27
bleeding-hollow,1444,paladin,retribution,90,42,48
nemesis,1442,paladin,retribution,29,19,10
lightbringer,1442,paladin,retribution,54,21,33
executus,1440,paladin,retribution,68,41,27
tichondrius,1439,paladin,retribution,30,16,14
tichondrius,1439,paladin,retribution,37,19,18
tichondrius,1439,paladin,retribution,30,15,15
malganis,1438,paladin,retribution,36,15,21
illidan,1436,paladin,retribution,24,15,9
aerie-peak,1435,paladin,retribution,36,15,21
mannoroth,1434,paladin,retribution,36,15,21
quelthalas,1433,paladin,retribution,30,15,15
sargeras,1433,paladin,retribution,60,23,37
stormrage,1432,paladin,retribution,30,15,15
sargeras,1432,paladin,retribution,36,15,21
tichondrius,1431,paladin,retribution,48,15,33
frostmourne,1430,paladin,retribution,25,18,7
daggerspine,1428,paladin,retribution,34,17,17
quelthalas,1425,paladin,retribution,42,19,23
tichondrius,1425,paladin,retribution,36,15,21
stormreaver,1424,paladin,retribution,24,15,9
proudmoore,1421,paladin,retribution,30,15,15
bleeding-hollow,1420,paladin,retribution,29,16,13
emerald-dream,1419,paladin,retribution,36,17,19
nerzhul,1418,paladin,retribution,24,15,9
sargeras,1418,paladin,retribution,31,15,16
tichondrius,1417,paladin,retribution,49,27,22
khazgoroth,1417,paladin,retribution,36,15,21
barthilas,1413,paladin,retribution,55,28,27
stormrage,1413,paladin,retribution,42,15,27
sargeras,1412,paladin,retribution,65,33,32
aegwynn,1412,paladin,retribution,36,18,18
ragnaros,1412,paladin,retribution,30,15,15
stormrage,1410,paladin,retribution,115,57,58
ragnaros,1409,paladin,retribution,36,15,21
stormrage,1408,paladin,retribution,57,24,33
tichondrius,1406,paladin,retribution,99,50,49
ragnaros,1406,paladin,retribution,53,25,28
steamwheedle-cartel,1405,paladin,retribution,54,22,32
azshara,1404,paladin,retribution,45,20,25
proudmoore,1403,paladin,retribution,48,20,28
tichondrius,1402,paladin,retribution,47,19,28
moon-guard,1397,paladin,retribution,30,15,15
illidan,1393,paladin,retribution,78,36,42
stormrage,1387,paladin,retribution,81,42,39
tichondrius,1385,paladin,retribution,29,15,14
darkspear,1382,paladin,retribution,35,17,18
spirestone,1380,paladin,retribution,66,31,35
kelthuzad,1378,paladin,retribution,36,16,20
senjin,1377,paladin,retribution,35,19,16
ragnaros,1376,paladin,retribution,35,15,20
zuljin,1375,paladin,retribution,48,19,29
area-52,1374,paladin,retribution,57,28,29
zuljin,1372,paladin,retribution,57,30,27
azralon,1368,paladin,retribution,44,21,23
illidan,1367,paladin,retribution,42,17,25
tichondrius,1365,paladin,retribution,34,16,18
illidan,1365,paladin,retribution,76,31,45
quelthalas,1364,paladin,retribution,30,15,15
illidan,1363,paladin,retribution,36,21,15
wyrmrest-accord,1363,paladin,retribution,48,20,28
icecrown,1363,paladin,retribution,39,16,23
ragnaros,1362,paladin,retribution,33,16,17
tichondrius,1357,paladin,retribution,51,29,22
kelthuzad,1357,paladin,retribution,61,32,29
sargeras,1356,paladin,retribution,30,15,15
baelgun,1353,paladin,retribution,80,43,37
emerald-dream,1347,paladin,retribution,72,38,34
moon-guard,1346,paladin,retribution,42,23,19
sargeras,1345,paladin,retribution,34,17,17
illidan,1343,paladin,retribution,30,14,16
tichondrius,1343,paladin,retribution,36,14,22
veknilash,1342,paladin,retribution,47,27,20
earthen-ring,1342,paladin,retribution,30,14,16
kiljaeden,1341,paladin,retribution,24,14,10
frostmourne,1341,paladin,retribution,30,14,16
tichondrius,1340,paladin,retribution,30,14,16
jaedenar,1338,paladin,retribution,42,15,27
frostmourne,1331,paladin,retribution,36,24,12
black-dragonflight,1331,paladin,retribution,24,15,9
bonechewer,1331,paladin,retribution,30,17,13
azgalor,1331,paladin,retribution,36,16,20
illidan,1329,paladin,retribution,30,14,16
quelthalas,1329,paladin,retribution,36,14,22
sargeras,1322,paladin,retribution,36,15,21
area-52,1320,paladin,retribution,24,14,10
frostmourne,1320,paladin,retribution,41,14,27
malganis,1317,paladin,retribution,86,39,47
tichondrius,1316,paladin,retribution,47,21,26
crushridge,1311,paladin,retribution,48,24,24
shadowmoon,1311,paladin,retribution,62,27,35
garrosh,1307,paladin,retribution,36,19,17
frostmourne,1307,paladin,retribution,29,14,15
azralon,1306,paladin,retribution,24,14,10
malygos,1305,paladin,retribution,42,23,19
tichondrius,1305,paladin,retribution,48,19,29
malganis,1300,paladin,retribution,26,15,11
dawnbringer,1300,paladin,retribution,48,21,27
lothar,1298,paladin,retribution,48,31,17
bleeding-hollow,1297,paladin,retribution,30,14,16
nemesis,1297,paladin,retribution,51,23,28
tichondrius,1291,paladin,retribution,22,16,6
bonechewer,1289,paladin,retribution,58,28,30
ragnaros,1289,paladin,retribution,78,33,45
alexstrasza,1288,paladin,retribution,84,36,48
tichondrius,1287,paladin,retribution,42,22,20
stormrage,1286,paladin,retribution,58,28,30
emerald-dream,1278,paladin,retribution,33,14,19
area-52,1276,paladin,retribution,42,22,20
illidan,1273,paladin,retribution,45,24,21
tichondrius,1272,paladin,retribution,30,17,13
gundrak,1271,paladin,retribution,48,24,24
emerald-dream,1268,paladin,retribution,48,18,30
area-52,1264,paladin,retribution,26,14,12
illidan,1262,paladin,retribution,42,16,26
malganis,1260,paladin,retribution,66,28,38
nemesis,1259,paladin,retribution,30,15,15
azgalor,1258,paladin,retribution,36,21,15
ragnaros,1256,paladin,retribution,38,19,19
dalaran,1255,paladin,retribution,30,14,16
moon-guard,1254,paladin,retribution,43,18,25
goldrinn,1254,paladin,retribution,43,14,29
shadow-council,1248,paladin,retribution,24,13,11
tichondrius,1248,paladin,retribution,24,13,11
malganis,1247,paladin,retribution,27,14,13
quelthalas,1246,paladin,retribution,30,13,17
area-52,1246,paladin,retribution,35,15,20
lightbringer,1244,paladin,retribution,18,13,5
ragnaros,1244,paladin,retribution,27,14,13
stormrage,1243,paladin,retribution,28,14,14
kaelthas,1243,paladin,retribution,36,13,23
korgath,1242,paladin,retribution,24,13,11
illidan,1242,paladin,retribution,24,13,11
tichondrius,1242,paladin,retribution,41,19,22
ragnaros,1242,paladin,retribution,30,13,17
moon-guard,1240,paladin,retribution,48,18,30
stormscale,1239,paladin,retribution,24,13,11
stormrage,1238,paladin,retribution,65,31,34
drakkari,1237,paladin,retribution,24,13,11
darkspear,1237,paladin,retribution,82,34,48
andorhal,1237,paladin,retribution,34,14,20
frostmourne,1236,paladin,retribution,36,21,15
quelthalas,1236,paladin,retribution,45,14,31
whisperwind,1234,paladin,retribution,24,13,11
stormrage,1234,paladin,retribution,30,13,17
tichondrius,1233,paladin,retribution,24,13,11
tichondrius,1231,paladin,retribution,30,13,17
tichondrius,1230,paladin,retribution,18,13,5
laughing-skull,1229,paladin,retribution,36,18,18
tichondrius,1229,paladin,retribution,30,13,17
tichondrius,1228,paladin,retribution,28,15,13
stormrage,1228,paladin,retribution,42,19,23
area-52,1222,paladin,retribution,25,14,11
frostmourne,1221,paladin,retribution,24,13,11
quelthalas,1221,paladin,retribution,59,29,30
cenarius,1218,paladin,retribution,106,47,59
tichondrius,1217,paladin,retribution,41,15,26
darkspear,1214,paladin,retribution,74,38,36
ragnaros,1213,paladin,retribution,29,13,16
frostmourne,1212,paladin,retribution,41,18,23
eredar,1206,paladin,retribution,24,13,11
drakkari,1203,paladin,retribution,42,21,21
agamaggan,1201,paladin,retribution,29,13,16
kelthuzad,1198,paladin,retribution,35,13,22
bleeding-hollow,1194,paladin,retribution,36,17,19
azralon,1190,paladin,retribution,34,16,18
sargeras,1189,paladin,retribution,36,13,23
darkspear,1184,paladin,retribution,42,13,29
quelthalas,1176,paladin,retribution,17,13,4
exodar,1171,paladin,retribution,66,36,30
quelthalas,1169,paladin,retribution,21,14,7
tichondrius,1168,paladin,retribution,65,34,31
trollbane,1164,paladin,retribution,68,36,32
the-scryers,1160,paladin,retribution,44,25,19
thrall,1157,paladin,retribution,42,19,23
queldorei,1157,paladin,retribution,52,17,35
sargeras,1152,paladin,retribution,18,12,6
tichondrius,1152,paladin,retribution,24,12,12
azralon,1151,paladin,retribution,18,12,6
dalaran,1151,paladin,retribution,18,12,6
azralon,1151,paladin,retribution,24,12,12
zuljin,1151,paladin,retribution,24,12,12
malganis,1151,paladin,retribution,24,12,12
malganis,1151,paladin,retribution,30,12,18
tichondrius,1151,paladin,retribution,30,12,18
aegwynn,1151,paladin,retribution,36,12,24
tichondrius,1151,paladin,retribution,36,12,24
quelthalas,1150,paladin,retribution,18,12,6
area-52,1150,paladin,retribution,24,12,12
emerald-dream,1150,paladin,retribution,30,12,18
illidan,1150,paladin,retribution,30,12,18
barthilas,1149,paladin,retribution,18,12,6
stormrage,1149,paladin,retribution,30,12,18
wyrmrest-accord,1148,paladin,retribution,24,12,12
sargeras,1148,paladin,retribution,24,12,12
frostmourne,1148,paladin,retribution,36,12,24
darkspear,1147,paladin,retribution,18,12,6
stormrage,1147,paladin,retribution,30,12,18
quelthalas,1146,paladin,retribution,24,12,12
stormrage,1145,paladin,retribution,30,12,18
stormscale,1144,paladin,retribution,24,12,12
tichondrius,1143,paladin,retribution,25,12,13
sargeras,1143,paladin,retribution,30,12,18
azralon,1143,paladin,retribution,36,12,24
stormrage,1142,paladin,retribution,24,12,12
quelthalas,1142,paladin,retribution,36,12,24
kelthuzad,1141,paladin,retribution,18,12,6
sargeras,1141,paladin,retribution,37,14,23
bleeding-hollow,1140,paladin,retribution,30,12,18
tichondrius,1139,paladin,retribution,64,34,30
tichondrius,1138,paladin,retribution,36,16,20
ragnaros,1131,paladin,retribution,28,13,15
arthas,1128,paladin,retribution,33,15,18
bloodscalp,1125,paladin,retribution,62,31,31
ragnaros,1125,paladin,retribution,30,15,15
azralon,1125,paladin,retribution,33,13,20
tichondrius,1119,paladin,retribution,49,26,23
daggerspine,1118,paladin,retribution,60,24,36
thunderlord,1116,paladin,retribution,36,14,22
stormrage,1115,paladin,retribution,20,13,7
icecrown,1115,paladin,retribution,40,12,28
kelthuzad,1110,paladin,retribution,32,13,19
tichondrius,1109,paladin,retribution,38,16,22
azralon,1106,paladin,retribution,18,12,6
hyjal,1106,paladin,retribution,30,13,17
azuremyst,1105,paladin,retribution,30,15,15
moonrunner,1101,paladin,retribution,18,12,6
alexstrasza,1094,paladin,retribution,30,18,12
blood-furnace,1092,paladin,retribution,30,16,14
laughing-skull,1091,paladin,retribution,29,12,17
alleria,1089,paladin,retribution,30,14,16
quelthalas,1089,paladin,retribution,30,12,18
stormscale,1083,paladin,retribution,30,13,17
queldorei,1082,paladin,retribution,24,13,11
gurubashi,1079,paladin,retribution,30,12,18
nagrand,1072,paladin,retribution,42,25,17
arathor,1067,paladin,retribution,33,19,14
tichondrius,1059,paladin,retribution,17,13,4
emerald-dream,1059,paladin,retribution,22,12,10
zuljin,1056,paladin,retribution,18,11,7
bronzebeard,1056,paladin,retribution,24,11,13
illidan,1056,paladin,retribution,24,11,13
ragnaros,1056,paladin,retribution,30,11,19
arthas,1056,paladin,retribution,30,11,19
tichondrius,1055,paladin,retribution,24,11,13
sargeras,1055,paladin,retribution,24,11,13
proudmoore,1055,paladin,retribution,24,11,13
azralon,1055,paladin,retribution,27,12,15
ragnaros,1054,paladin,retribution,20,12,8
blackrock,1054,paladin,retribution,24,11,13
zuljin,1054,paladin,retribution,24,11,13
tichondrius,1053,paladin,retribution,24,11,13
stormrage,1052,paladin,retribution,18,11,7
hyjal,1052,paladin,retribution,24,11,13
barthilas,1052,paladin,retribution,24,11,13
sargeras,1052,paladin,retribution,24,11,13
tichondrius,1052,paladin,retribution,30,11,19
kiljaeden,1051,paladin,retribution,18,11,7
illidan,1051,paladin,retribution,24,11,13
tichondrius,1051,paladin,retribution,28,12,16
hydraxis,1050,paladin,retribution,12,11,1
barthilas,1050,paladin,retribution,117,57,60
eonar,1050,paladin,retribution,24,11,13
turalyon,1049,paladin,retribution,18,11,7
tichondrius,1049,paladin,retribution,24,11,13
dalaran,1048,paladin,retribution,18,11,7
silver-hand,1048,paladin,retribution,24,11,13
kelthuzad,1048,paladin,retribution,24,11,13
frostmourne,1048,paladin,retribution,24,11,13
ragnaros,1046,paladin,retribution,24,11,13
draenor,1046,paladin,retribution,30,11,19
ragnaros,1045,paladin,retribution,25,12,13
tichondrius,1045,paladin,retribution,24,11,13
azralon,1043,paladin,retribution,18,11,7
zuljin,1040,paladin,retribution,18,11,7
sargeras,1040,paladin,retribution,30,18,12
malfurion,1034,paladin,retribution,30,11,19
area-52,1033,paladin,retribution,27,15,12
frostmourne,1033,paladin,retribution,30,14,16
magtheridon,1030,paladin,retribution,39,12,27
illidan,1029,paladin,retribution,36,22,14
tichondrius,1026,paladin,retribution,30,15,15
quelthalas,1016,paladin,retribution,20,12,8
aerie-peak,1013,paladin,retribution,64,24,40
emerald-dream,1002,paladin,retribution,30,13,17
tichondrius,999,paladin,retribution,38,14,24
cenarius,987,paladin,retribution,22,11,11
illidan,977,paladin,retribution,30,15,15
lightbringer,972,paladin,retribution,36,14,22
area-52,961,paladin,retribution,25,11,14
area-52,960,paladin,retribution,18,10,8
tichondrius,960,paladin,retribution,18,10,8
tichondrius,960,paladin,retribution,18,10,8
darkspear,960,paladin,retribution,18,10,8
stormrage,960,paladin,retribution,18,10,8
tichondrius,960,paladin,retribution,24,10,14
illidan,960,paladin,retribution,24,10,14
tichondrius,960,paladin,retribution,24,10,14
tichondrius,960,paladin,retribution,24,10,14
moon-guard,960,paladin,retribution,24,10,14
tichondrius,960,paladin,retribution,30,10,20
ragnaros,959,paladin,retribution,16,11,5
tichondrius,959,paladin,retribution,18,10,8
lightbringer,959,paladin,retribution,18,10,8
sargeras,959,paladin,retribution,18,10,8
emerald-dream,959,paladin,retribution,18,10,8
area-52,959,paladin,retribution,24,10,14
tichondrius,959,paladin,retribution,24,10,14
proudmoore,959,paladin,retribution,24,10,14
malganis,959,paladin,retribution,24,10,14
sargeras,959,paladin,retribution,30,10,20
proudmoore,958,paladin,retribution,18,10,8
zuljin,958,paladin,retribution,18,10,8
arthas,958,paladin,retribution,18,10,8
thunderlord,958,paladin,retribution,21,10,11
moon-guard,958,paladin,retribution,30,10,20
ragnaros,957,paladin,retribution,18,10,8
arygos,957,paladin,retribution,18,10,8
proudmoore,957,paladin,retribution,30,10,20
azralon,956,paladin,retribution,12,10,2
wyrmrest-accord,956,paladin,retribution,18,10,8
bonechewer,956,paladin,retribution,18,10,8
ravencrest,956,paladin,retribution,30,10,20
emerald-dream,955,paladin,retribution,18,10,8
emerald-dream,955,paladin,retribution,18,10,8
frostmourne,955,paladin,retribution,18,10,8
goldrinn,954,paladin,retribution,21,11,10
stormrage,954,paladin,retribution,24,10,14
silver-hand,953,paladin,retribution,18,10,8
thrall,952,paladin,retribution,18,10,8
elune,952,paladin,retribution,25,10,15
jaedenar,951,paladin,retribution,24,10,14
stormrage,950,paladin,retribution,18,10,8
illidan,949,paladin,retribution,78,34,44
quelthalas,946,paladin,retribution,18,10,8
sargeras,943,paladin,retribution,18,10,8
sargeras,938,paladin,retribution,28,13,15
moon-guard,929,paladin,retribution,18,10,8
zuljin,926,paladin,retribution,14,11,3
area-52,926,paladin,retribution,20,11,9
sargeras,925,paladin,retribution,22,10,12
mannoroth,908,paladin,retribution,21,10,11
proudmoore,901,paladin,retribution,23,14,9
hakkar,896,paladin,retribution,30,15,15
tichondrius,896,paladin,retribution,22,10,12
frostmourne,896,paladin,retribution,23,10,13
kelthuzad,894,paladin,retribution,22,10,12
kaelthas,893,paladin,retribution,28,10,18
area-52,890,paladin,retribution,66,29,37
azralon,890,paladin,retribution,28,10,18
emerald-dream,889,paladin,retribution,33,11,22
ursin,883,paladin,retribution,53,25,28
area-52,873,paladin,retribution,24,11,13
tichondrius,864,paladin,retribution,12,9,3
frostmourne,864,paladin,retribution,12,9,3
tichondrius,864,paladin,retribution,12,9,3
kelthuzad,864,paladin,retribution,12,9,3
stormrage,864,paladin,retribution,12,9,3
stormrage,864,paladin,retribution,18,9,9
nemesis,864,paladin,retribution,18,9,9
azralon,864,paladin,retribution,18,9,9
stormrage,864,paladin,retribution,18,9,9
moon-guard,864,paladin,retribution,18,9,9
bloodhoof,864,paladin,retribution,18,9,9
tichondrius,864,paladin,retribution,18,9,9
bleeding-hollow,864,paladin,retribution,18,9,9
azralon,864,paladin,retribution,18,9,9
tichondrius,864,paladin,retribution,18,9,9
tichondrius,864,paladin,retribution,18,9,9
area-52,864,paladin,retribution,18,9,9
area-52,864,paladin,retribution,18,9,9
stormrage,864,paladin,retribution,21,10,11
zuljin,864,paladin,retribution,25,10,15
moon-guard,864,paladin,retribution,24,9,15
malganis,864,paladin,retribution,24,9,15
kelthuzad,864,paladin,retribution,24,9,15
moon-guard,864,paladin,retribution,24,9,15
area-52,864,paladin,retribution,24,9,15
emerald-dream,864,paladin,retribution,24,9,15
sargeras,864,paladin,retribution,27,10,17
sargeras,864,paladin,retribution,30,9,21
stormreaver,863,paladin,retribution,12,9,3
tichondrius,863,paladin,retribution,12,9,3
stormrage,863,paladin,retribution,12,9,3
nemesis,863,paladin,retribution,12,9,3
stormrage,863,paladin,retribution,12,9,3
frostmourne,863,paladin,retribution,18,9,9
illidan,863,paladin,retribution,18,9,9
hydraxis,863,paladin,retribution,18,9,9
wyrmrest-accord,863,paladin,retribution,18,9,9
stormrage,863,paladin,retribution,18,9,9
tichondrius,863,paladin,retribution,18,9,9
moon-guard,863,paladin,retribution,18,9,9
bleeding-hollow,863,paladin,retribution,18,9,9
azralon,863,paladin,retribution,18,9,9
tichondrius,863,paladin,retribution,22,10,12
spirestone,863,paladin,retribution,24,9,15
azralon,863,paladin,retribution,24,9,15
tichondrius,863,paladin,retribution,24,9,15
korgath,863,paladin,retribution,24,9,15
proudmoore,863,paladin,retribution,26,9,17
emerald-dream,863,paladin,retribution,30,9,21
azralon,862,paladin,retribution,12,9,3
azralon,862,paladin,retribution,12,9,3
tichondrius,862,paladin,retribution,12,9,3
illidan,862,paladin,retribution,18,9,9
stormrage,862,paladin,retribution,18,9,9
nemesis,862,paladin,retribution,18,9,9
illidan,862,paladin,retribution,24,9,15
area-52,862,paladin,retribution,24,9,15
area-52,862,paladin,retribution,30,9,21
aerie-peak,861,paladin,retribution,12,9,3
nerzhul,861,paladin,retribution,18,9,9
twisting-nether,861,paladin,retribution,21,10,11
stormrage,861,paladin,retribution,24,9,15
bleeding-hollow,860,paladin,retribution,24,9,15
the-venture-co,859,paladin,retribution,18,9,9
thunderhorn,859,paladin,retribution,18,9,9
grizzly-hills,858,paladin,retribution,18,9,9
tichondrius,858,paladin,retribution,18,9,9
akama,858,paladin,retribution,24,9,15
moon-guard,857,paladin,retribution,15,9,6
barthilas,855,paladin,retribution,30,9,21
moon-guard,845,paladin,retribution,23,9,14
frostmourne,844,paladin,retribution,18,9,9
bleeding-hollow,843,paladin,retribution,24,10,14
dragonmaw,842,paladin,retribution,23,9,14
barthilas,837,paladin,retribution,12,9,3
tichondrius,831,paladin,retribution,23,9,14
tichondrius,815,paladin,retribution,17,9,8
tichondrius,815,paladin,retribution,21,10,11
amanthul,810,paladin,retribution,17,9,8
proudmoore,810,paladin,retribution,28,10,18
bonechewer,808,paladin,retribution,22,9,13
proudmoore,806,paladin,retribution,20,11,9
stormrage,806,paladin,retribution,27,9,18
illidan,799,paladin,retribution,20,9,11
azralon,798,paladin,retribution,22,9,13
rexxar,797,paladin,retribution,33,11,22
bonechewer,782,paladin,retribution,19,9,10
bleeding-hollow,768,paladin,retribution,12,8,4
zuljin,768,paladin,retribution,12,8,4
tichondrius,768,paladin,retribution,12,8,4
antonidas,768,paladin,retribution,12,8,4
azuremyst,768,paladin,retribution,12,8,4
stormrage,768,paladin,retribution,12,8,4
tichondrius,768,paladin,retribution,12,8,4
barthilas,768,paladin,retribution,12,8,4
stormrage,768,paladin,retribution,12,8,4
wyrmrest-accord,768,paladin,retribution,12,8,4
korgath,768,paladin,retribution,12,8,4
sargeras,768,paladin,retribution,12,8,4
zuljin,768,paladin,retribution,16,9,7
azralon,768,paladin,retribution,17,8,9
zuluhed,768,paladin,retribution,18,8,10
tichondrius,768,paladin,retribution,18,8,10
drakkari,768,paladin,retribution,18,8,10
thrall,768,paladin,retribution,18,8,10
tichondrius,768,paladin,retribution,18,8,10
malganis,768,paladin,retribution,18,8,10
dark-iron,768,paladin,retribution,18,8,10
quelthalas,768,paladin,retribution,18,8,10
tichondrius,768,paladin,retribution,18,8,10
kelthuzad,768,paladin,retribution,18,8,10
tichondrius,768,paladin,retribution,18,8,10
quelthalas,768,paladin,retribution,18,8,10
bleeding-hollow,768,paladin,retribution,18,8,10
tichondrius,768,paladin,retribution,24,8,16
tichondrius,768,paladin,retribution,24,8,16
azralon,768,paladin,retribution,24,8,16
moon-guard,768,paladin,retribution,24,8,16
bonechewer,767,paladin,retribution,12,8,4
kelthuzad,767,paladin,retribution,12,8,4
arthas,767,paladin,retribution,12,8,4
zuljin,767,paladin,retribution,12,8,4
tichondrius,767,paladin,retribution,12,8,4
moon-guard,767,paladin,retribution,12,8,4
dalaran,767,paladin,retribution,12,8,4
tichondrius,767,paladin,retribution,12,8,4
barthilas,767,paladin,retribution,12,8,4
rivendare,767,paladin,retribution,12,8,4
quelthalas,767,paladin,retribution,12,8,4
moon-guard,767,paladin,retribution,12,8,4
tichondrius,767,paladin,retribution,12,8,4
sargeras,767,paladin,retribution,18,8,10
skywall,767,paladin,retribution,18,8,10
illidan,767,paladin,retribution,18,8,10
quelthalas,767,paladin,retribution,18,8,10
azuremyst,767,paladin,retribution,18,8,10
farstriders,767,paladin,retribution,18,8,10
sargeras,767,paladin,retribution,18,8,10
korgath,767,paladin,retribution,18,8,10
anvilmar,767,paladin,retribution,18,8,10
the-forgotten-coast,767,paladin,retribution,18,8,10
thunderhorn,767,paladin,retribution,18,8,10
ragnaros,767,paladin,retribution,18,8,10
area-52,767,paladin,retribution,18,8,10
magtheridon,767,paladin,retribution,18,8,10
illidan,767,paladin,retribution,18,8,10
zuljin,766,paladin,retribution,12,8,4
nerzhul,766,paladin,retribution,12,8,4
area-52,766,paladin,retribution,12,8,4
shadowsong,766,paladin,retribution,12,8,4
bladefist,766,paladin,retribution,12,8,4
ysera,766,paladin,retribution,16,9,7
aegwynn,766,paladin,retribution,18,8,10
jubeithos,766,paladin,retribution,18,8,10
stormrage,765,paladin,retribution,12,8,4
emerald-dream,765,paladin,retribution,12,8,4
drakkari,765,paladin,retribution,18,8,10
sargeras,765,paladin,retribution,18,8,10
stormscale,765,paladin,retribution,18,8,10
blades-edge,763,paladin,retribution,18,8,10
quelthalas,763,paladin,retribution,18,8,10
zuljin,763,paladin,retribution,18,8,10
frostmourne,762,paladin,retribution,12,8,4
proudmoore,762,paladin,retribution,12,8,4
drakkari,762,paladin,retribution,18,8,10
garona,761,paladin,retribution,12,8,4
bleeding-hollow,761,paladin,retribution,12,8,4
sargeras,760,paladin,retribution,18,8,10
dalaran,759,paladin,retribution,26,8,18
aggramar,758,paladin,retribution,12,8,4
tichondrius,752,paladin,retribution,12,8,4
nemesis,751,paladin,retribution,18,8,10
shadowmoon,749,paladin,retribution,12,8,4
darkspear,749,paladin,retribution,13,8,5
misha,735,paladin,retribution,17,8,9
ragnaros,718,paladin,retribution,17,8,9
drakkari,718,paladin,retribution,17,8,9
tichondrius,714,paladin,retribution,19,9,10
elune,714,paladin,retribution,21,9,12
frostmourne,711,paladin,retribution,19,9,10
hyjal,701,paladin,retribution,11,9,2
azralon,700,paladin,retribution,14,8,6
tichondrius,700,paladin,retribution,16,8,8
quelthalas,688,paladin,retribution,27,11,16
thrall,684,paladin,retribution,19,8,11
tichondrius,672,paladin,retribution,12,7,5
tichondrius,672,paladin,retribution,12,7,5
wyrmrest-accord,672,paladin,retribution,12,7,5
area-52,672,paladin,retribution,12,7,5
dragonmaw,672,paladin,retribution,12,7,5
burning-legion,672,paladin,retribution,12,7,5
quelthalas,672,paladin,retribution,12,7,5
kelthuzad,672,paladin,retribution,12,7,5
azralon,672,paladin,retribution,12,7,5
thrall,672,paladin,retribution,12,7,5
illidan,672,paladin,retribution,12,7,5
azralon,672,paladin,retribution,12,7,5
moon-guard,672,paladin,retribution,12,7,5
illidan,672,paladin,retribution,12,7,5
cairne,672,paladin,retribution,12,7,5
kiljaeden,672,paladin,retribution,12,7,5
zuljin,672,paladin,retribution,12,7,5
illidan,672,paladin,retribution,12,7,5
sargeras,672,paladin,retribution,12,7,5
bleeding-hollow,672,paladin,retribution,12,7,5
caelestrasz,672,paladin,retribution,12,7,5
azralon,672,paladin,retribution,12,7,5
frostmourne,672,paladin,retribution,12,7,5
area-52,672,paladin,retribution,12,7,5
bleeding-hollow,672,paladin,retribution,12,7,5
tichondrius,672,paladin,retribution,12,7,5
quelthalas,672,paladin,retribution,12,7,5
wyrmrest-accord,672,paladin,retribution,12,7,5
nemesis,672,paladin,retribution,12,7,5
tichondrius,672,paladin,retribution,12,7,5
blackrock,672,paladin,retribution,12,7,5
tichondrius,672,paladin,retribution,12,7,5
tichondrius,672,paladin,retribution,12,7,5
moon-guard,672,paladin,retribution,12,7,5
velen,672,paladin,retribution,12,7,5
moon-guard,672,paladin,retribution,12,7,5
illidan,672,paladin,retribution,12,7,5
drakkari,672,paladin,retribution,16,8,8
proudmoore,672,paladin,retribution,18,7,11
bonechewer,672,paladin,retribution,18,7,11
dalaran,672,paladin,retribution,18,7,11
sargeras,672,paladin,retribution,18,7,11
tichondrius,672,paladin,retribution,18,7,11
area-52,672,paladin,retribution,18,7,11
arathor,672,paladin,retribution,18,7,11
nagrand,672,paladin,retribution,18,7,11
stormrage,672,paladin,retribution,18,7,11
frostmourne,672,paladin,retribution,18,7,11
sargeras,672,paladin,retribution,18,7,11
illidan,672,paladin,retribution,18,7,11
sargeras,672,paladin,retribution,18,7,11
dalaran,672,paladin,retribution,18,7,11
zuljin,672,paladin,retribution,18,7,11
area-52,672,paladin,retribution,18,7,11
area-52,672,paladin,retribution,18,7,11
frostmourne,672,paladin,retribution,18,7,11
sargeras,672,paladin,retribution,18,7,11
kelthuzad,672,paladin,retribution,18,7,11
tichondrius,672,paladin,retribution,18,7,11
kelthuzad,672,paladin,retribution,18,7,11
nemesis,672,paladin,retribution,21,8,13
frostmourne,672,paladin,retribution,19,7,12
zuljin,672,paladin,retribution,20,7,13
stormrage,672,paladin,retribution,24,7,17
illidan,672,paladin,retribution,24,7,17
stormrage,672,paladin,retribution,24,7,17
tichondrius,672,paladin,retribution,24,7,17
kelthuzad,672,paladin,retribution,24,7,17
goldrinn,672,paladin,retribution,24,7,17
sargeras,672,paladin,retribution,24,7,17
illidan,672,paladin,retribution,30,7,23
drakkari,671,paladin,retribution,12,7,5
malganis,671,paladin,retribution,12,7,5
drakkari,671,paladin,retribution,12,7,5
malganis,671,paladin,retribution,12,7,5
sargeras,671,paladin,retribution,12,7,5
stormrage,671,paladin,retribution,12,7,5
crushridge,671,paladin,retribution,12,7,5
nemesis,671,paladin,retribution,12,7,5
dalaran,671,paladin,retribution,12,7,5
stormrage,671,paladin,retribution,12,7,5
korgath,671,paladin,retribution,12,7,5
malfurion,671,paladin,retribution,12,7,5
aegwynn,671,paladin,retribution,12,7,5
stormrage,671,paladin,retribution,12,7,5
fizzcrank,671,paladin,retribution,12,7,5
windrunner,671,paladin,retribution,12,7,5
azralon,671,paladin,retribution,12,7,5
firetree,671,paladin,retribution,12,7,5
dalaran,671,paladin,retribution,16,8,8
azshara,671,paladin,retribution,14,7,7
tichondrius,671,paladin,retribution,15,7,8
jubeithos,671,paladin,retribution,18,7,11
emerald-dream,671,paladin,retribution,18,7,11
proudmoore,671,paladin,retribution,18,7,11
gorefiend,671,paladin,retribution,18,7,11
zuljin,671,paladin,retribution,18,7,11
illidan,671,paladin,retribution,24,7,17
tichondrius,671,paladin,retribution,30,7,23
azshara,670,paladin,retribution,12,7,5
malganis,670,paladin,retribution,12,7,5
sargeras,670,paladin,retribution,16,8,8
illidan,670,paladin,retribution,18,7,11
nemesis,669,paladin,retribution,12,7,5
bonechewer,669,paladin,retribution,13,7,6
azralon,669,paladin,retribution,18,9,9
kul-tiras,669,paladin,retribution,18,7,11
quelthalas,669,paladin,retribution,24,7,17
kelthuzad,668,paladin,retribution,12,7,5
tichondrius,667,paladin,retribution,22,8,14
sargeras,666,paladin,retribution,12,7,5
duskwood,665,paladin,retribution,12,7,5
dalaran,664,paladin,retribution,18,7,11
doomhammer,661,paladin,retribution,12,7,5
proudmoore,661,paladin,retribution,12,7,5
moon-guard,657,paladin,retribution,18,7,11
frostmourne,639,paladin,retribution,20,8,12
quelthalas,639,paladin,retribution,23,7,16
silvermoon,638,paladin,retribution,14,8,6
antonidas,633,paladin,retribution,17,7,10
bleeding-hollow,623,paladin,retribution,11,7,4
illidan,623,paladin,retribution,11,7,4
spirestone,623,paladin,retribution,17,7,10
nathrezim,623,paladin,retribution,17,7,10
kiljaeden,623,paladin,retribution,17,7,10
jubeithos,621,paladin,retribution,21,8,13
moon-guard,618,paladin,retribution,20,8,12
area-52,608,paladin,retribution,16,7,9
nemesis,607,paladin,retribution,14,7,7
tichondrius,607,paladin,retribution,23,7,16
dalaran,607,paladin,retribution,26,7,19
illidan,606,paladin,retribution,13,8,5
nordrassil,602,paladin,retribution,22,7,15
stormrage,595,paladin,retribution,28,9,19
nathrezim,592,paladin,retribution,31,7,24
lightnings-blade,591,paladin,retribution,13,7,6
frostmourne,591,paladin,retribution,15,7,8
sargeras,586,paladin,retribution,21,10,11
sargeras,576,paladin,retribution,6,6,0
drakkari,576,paladin,retribution,6,6,0
moon-guard,576,paladin,retribution,6,6,0
sargeras,576,paladin,retribution,12,6,6
tichondrius,576,paladin,retribution,12,6,6
korgath,576,paladin,retribution,12,6,6
illidan,576,paladin,retribution,12,6,6
sargeras,576,paladin,retribution,12,6,6
zuluhed,576,paladin,retribution,12,6,6
uther,576,paladin,retribution,12,6,6
moon-guard,576,paladin,retribution,12,6,6
azralon,576,paladin,retribution,12,6,6
stormrage,576,paladin,retribution,12,6,6
ragnaros,576,paladin,retribution,12,6,6
stormrage,576,paladin,retribution,12,6,6
azralon,576,paladin,retribution,12,6,6
quelthalas,576,paladin,retribution,12,6,6
proudmoore,576,paladin,retribution,12,6,6
magtheridon,576,paladin,retribution,12,6,6
malganis,576,paladin,retribution,12,6,6
thrall,576,paladin,retribution,12,6,6
area-52,576,paladin,retribution,12,6,6
khaz-modan,576,paladin,retribution,12,6,6
azralon,576,paladin,retribution,12,6,6
magtheridon,576,paladin,retribution,12,6,6
barthilas,576,paladin,retribution,12,6,6
kargath,576,paladin,retribution,12,6,6
area-52,576,paladin,retribution,12,6,6
nemesis,576,paladin,retribution,12,6,6
ragnaros,576,paladin,retribution,12,6,6
moon-guard,576,paladin,retribution,12,6,6
terokkar,576,paladin,retribution,12,6,6
kiljaeden,576,paladin,retribution,12,6,6
tichondrius,576,paladin,retribution,12,6,6
aegwynn,576,paladin,retribution,12,6,6
area-52,576,paladin,retribution,12,6,6
tichondrius,576,paladin,retribution,12,6,6
illidan,576,paladin,retribution,12,6,6
azgalor,576,paladin,retribution,12,6,6
illidan,576,paladin,retribution,12,6,6
blackrock,576,paladin,retribution,12,6,6
darkspear,576,paladin,retribution,12,6,6
emerald-dream,576,paladin,retribution,12,6,6
emerald-dream,576,paladin,retribution,12,6,6
kelthuzad,576,paladin,retribution,12,6,6
barthilas,576,paladin,retribution,12,6,6
moon-guard,576,paladin,retribution,12,6,6
bleeding-hollow,576,paladin,retribution,12,6,6
tichondrius,576,paladin,retribution,12,6,6
emerald-dream,576,paladin,retribution,12,6,6
moon-guard,576,paladin,retribution,12,6,6
tichondrius,576,paladin,retribution,12,6,6
illidan,576,paladin,retribution,12,6,6
tichondrius,576,paladin,retribution,12,6,6
illidan,576,paladin,retribution,12,6,6
frostmourne,576,paladin,retribution,12,6,6
illidan,576,paladin,retribution,12,6,6
barthilas,576,paladin,retribution,15,7,8
tichondrius,576,paladin,retribution,16,7,9
alexstrasza,576,paladin,retribution,16,7,9
moon-guard,576,paladin,retribution,21,7,14
magtheridon,576,paladin,retribution,18,6,12
bladefist,576,paladin,retribution,18,6,12
tichondrius,576,paladin,retribution,18,6,12
area-52,576,paladin,retribution,18,6,12
tortheldrin,576,paladin,retribution,18,6,12
moon-guard,576,paladin,retribution,18,6,12
tichondrius,576,paladin,retribution,18,6,12
ragnaros,576,paladin,retribution,18,6,12
tichondrius,576,paladin,retribution,18,6,12
tichondrius,576,paladin,retribution,18,6,12
sargeras,576,paladin,retribution,18,6,12
tichondrius,576,paladin,retribution,18,6,12
malfurion,576,paladin,retribution,18,6,12
moonrunner,576,paladin,retribution,18,6,12
tichondrius,576,paladin,retribution,18,6,12
emerald-dream,576,paladin,retribution,18,6,12
tichondrius,576,paladin,retribution,18,6,12
stormrage,576,paladin,retribution,18,6,12
eredar,576,paladin,retribution,18,6,12
nemesis,576,paladin,retribution,18,6,12
tichondrius,576,paladin,retribution,20,6,14
azralon,576,paladin,retribution,24,6,18
tichondrius,576,paladin,retribution,24,6,18
zuljin,575,paladin,retribution,6,6,0
azralon,575,paladin,retribution,12,6,6
azralon,575,paladin,retribution,12,6,6
bleeding-hollow,575,paladin,retribution,12,6,6
antonidas,575,paladin,retribution,12,6,6
dragonmaw,575,paladin,retribution,12,6,6
darkspear,575,paladin,retribution,12,6,6
moon-guard,575,paladin,retribution,12,6,6
emerald-dream,575,paladin,retribution,12,6,6
stormrage,575,paladin,retribution,12,6,6
area-52,575,paladin,retribution,12,6,6
cenarius,575,paladin,retribution,12,6,6
mannoroth,575,paladin,retribution,12,6,6
thunderlord,575,paladin,retribution,16,7,9
stormrage,575,paladin,retribution,18,6,12
tichondrius,575,paladin,retribution,18,6,12
nerzhul,574,paladin,retribution,6,6,0
quelthalas,574,paladin,retribution,12,6,6
khaz-modan,574,paladin,retribution,12,6,6
azralon,574,paladin,retribution,12,6,6
azralon,574,paladin,retribution,18,6,12
shadowmoon,574,paladin,retribution,18,6,12
kiljaeden,573,paladin,retribution,20,6,14
wildhammer,571,paladin,retribution,12,6,6
area-52,571,paladin,retribution,12,6,6
area-52,571,paladin,retribution,18,6,12
frostwolf,559,paladin,retribution,17,6,11
tichondrius,543,paladin,retribution,11,6,5
sargeras,543,paladin,retribution,15,7,8
garrosh,543,paladin,retribution,17,6,11
tichondrius,543,paladin,retribution,17,6,11
area-52,543,paladin,retribution,20,7,13
tichondrius,527,paladin,retribution,11,6,5
azjolnerub,527,paladin,retribution,11,6,5
windrunner,522,paladin,retribution,20,7,13
tichondrius,522,paladin,retribution,25,8,17
bleeding-hollow,522,paladin,retribution,22,7,15
altar-of-storms,522,paladin,retribution,24,7,17
saurfang,520,paladin,retribution,12,7,5
tichondrius,511,paladin,retribution,16,6,10
bleeding-hollow,511,paladin,retribution,17,6,11
tichondrius,511,paladin,retribution,20,6,14
quelthalas,495,paladin,retribution,13,6,7
dalaran,494,paladin,retribution,13,6,7
moon-guard,494,paladin,retribution,15,6,9
tichondrius,494,paladin,retribution,16,6,10
area-52,480,paladin,retribution,6,5,1
icecrown,480,paladin,retribution,6,5,1
tichondrius,480,paladin,retribution,6,5,1
stormreaver,480,paladin,retribution,6,5,1
tichondrius,480,paladin,retribution,6,5,1
tichondrius,480,paladin,retribution,6,5,1
tichondrius,480,paladin,retribution,6,5,1
drenden,480,paladin,retribution,6,5,1
moon-guard,480,paladin,retribution,6,5,1
illidan,480,paladin,retribution,6,5,1
sargeras,480,paladin,retribution,6,5,1
stormrage,480,paladin,retribution,6,5,1
sargeras,480,paladin,retribution,6,5,1
sargeras,480,paladin,retribution,6,5,1
tichondrius,480,paladin,retribution,6,5,1
stormrage,480,paladin,retribution,6,5,1
sargeras,480,paladin,retribution,6,5,1
blood-furnace,480,paladin,retribution,6,5,1
stormrage,480,paladin,retribution,6,5,1
nemesis,480,paladin,retribution,6,5,1
sargeras,480,paladin,retribution,6,5,1
kiljaeden,480,paladin,retribution,6,5,1
caelestrasz,480,paladin,retribution,6,5,1
spirestone,480,paladin,retribution,6,5,1
khadgar,480,paladin,retribution,6,5,1
ursin,480,paladin,retribution,9,6,3
emerald-dream,480,paladin,retribution,9,6,3
wyrmrest-accord,480,paladin,retribution,12,5,7
nordrassil,480,paladin,retribution,12,5,7
tichondrius,480,paladin,retribution,12,5,7
kiljaeden,480,paladin,retribution,12,5,7
illidan,480,paladin,retribution,12,5,7
kelthuzad,480,paladin,retribution,12,5,7
frostmourne,480,paladin,retribution,12,5,7
drakkari,480,paladin,retribution,12,5,7
wyrmrest-accord,480,paladin,retribution,12,5,7
stormrage,480,paladin,retribution,12,5,7
medivh,480,paladin,retribution,12,5,7
ragnaros,480,paladin,retribution,12,5,7
garrosh,480,paladin,retribution,12,5,7
ragnaros,480,paladin,retribution,12,5,7
illidan,480,paladin,retribution,12,5,7
moon-guard,480,paladin,retribution,12,5,7
lothar,480,paladin,retribution,12,5,7
sargeras,480,paladin,retribution,12,5,7
bleeding-hollow,480,paladin,retribution,12,5,7
proudmoore,480,paladin,retribution,12,5,7
stormrage,480,paladin,retribution,12,5,7
illidan,480,paladin,retribution,12,5,7
thrall,480,paladin,retribution,12,5,7
moon-guard,480,paladin,retribution,12,5,7
ragnaros,480,paladin,retribution,12,5,7
kiljaeden,480,paladin,retribution,12,5,7
undermine,480,paladin,retribution,12,5,7
stormrage,480,paladin,retribution,12,5,7
proudmoore,480,paladin,retribution,12,5,7
bleeding-hollow,480,paladin,retribution,12,5,7
dalaran,480,paladin,retribution,12,5,7
tichondrius,480,paladin,retribution,12,5,7
tichondrius,480,paladin,retribution,12,5,7
draka,480,paladin,retribution,12,5,7
proudmoore,480,paladin,retribution,12,5,7
aegwynn,480,paladin,retribution,12,5,7
tichondrius,480,paladin,retribution,12,5,7
malganis,480,paladin,retribution,12,5,7
zuljin,480,paladin,retribution,12,5,7
zuljin,480,paladin,retribution,12,5,7
thrall,480,paladin,retribution,12,5,7
barthilas,480,paladin,retribution,12,5,7
stormrage,480,paladin,retribution,12,5,7
emerald-dream,480,paladin,retribution,12,5,7
blades-edge,480,paladin,retribution,12,5,7
tichondrius,480,paladin,retribution,12,5,7
emerald-dream,480,paladin,retribution,12,5,7
kelthuzad,480,paladin,retribution,12,5,7
moon-guard,480,paladin,retribution,12,5,7
emerald-dream,480,paladin,retribution,12,5,7
demon-soul,480,paladin,retribution,12,5,7
tichondrius,480,paladin,retribution,12,5,7
sargeras,480,paladin,retribution,12,5,7
arthas,480,paladin,retribution,12,5,7
arthas,480,paladin,retribution,12,5,7
azralon,480,paladin,retribution,12,5,7
area-52,480,paladin,retribution,12,5,7
kiljaeden,480,paladin,retribution,12,5,7
archimonde,480,paladin,retribution,12,5,7
quelthalas,480,paladin,retribution,12,5,7
korgath,480,paladin,retribution,18,5,13
thunderlord,480,paladin,retribution,18,5,13
kelthuzad,480,paladin,retribution,18,5,13
wyrmrest-accord,480,paladin,retribution,18,5,13
tichondrius,480,paladin,retribution,18,5,13
area-52,480,paladin,retribution,18,5,13
illidan,480,paladin,retribution,18,5,13
azralon,480,paladin,retribution,18,5,13
illidan,480,paladin,retribution,18,5,13
stormrage,480,paladin,retribution,18,5,13
azralon,480,paladin,retribution,18,5,13
illidan,480,paladin,retribution,18,5,13
kelthuzad,480,paladin,retribution,18,5,13
wyrmrest-accord,480,paladin,retribution,18,5,13
shadowmoon,480,paladin,retribution,18,5,13
dragonmaw,480,paladin,retribution,18,5,13
korialstrasz,480,paladin,retribution,18,5,13
nemesis,480,paladin,retribution,18,5,13
kelthuzad,480,paladin,retribution,27,6,21
illidan,480,paladin,retribution,24,5,19
garona,480,paladin,retribution,30,5,25
dalaran,479,paladin,retribution,6,5,1
lethon,479,paladin,retribution,6,5,1
ragnaros,479,paladin,retribution,6,5,1
zuljin,479,paladin,retribution,6,5,1
firetree,479,paladin,retribution,9,6,3
thunderlord,479,paladin,retribution,12,5,7
frostmourne,479,paladin,retribution,12,5,7
stormrage,479,paladin,retribution,12,5,7
terenas,479,paladin,retribution,12,5,7
nerzhul,479,paladin,retribution,12,5,7
moon-guard,479,paladin,retribution,12,5,7
area-52,479,paladin,retribution,12,5,7
zuljin,479,paladin,retribution,12,5,7
stormrage,479,paladin,retribution,18,5,13
illidan,478,paladin,retribution,6,5,1
darrowmere,478,paladin,retribution,12,6,6
destromath,478,paladin,retribution,12,5,7
duskwood,478,paladin,retribution,12,5,7
illidan,478,paladin,retribution,12,5,7
ragnaros,478,paladin,retribution,12,5,7
drakkari,475,paladin,retribution,12,5,7
moon-guard,475,paladin,retribution,12,5,7
dalaran,474,paladin,retribution,12,5,7
proudmoore,473,paladin,retribution,12,5,7
tichondrius,463,paladin,retribution,23,5,18
fizzcrank,457,paladin,retribution,21,7,14
turalyon,431,paladin,retribution,11,5,6
azralon,426,paladin,retribution,12,6,6
frostmourne,426,paladin,retribution,16,7,9
illidan,425,paladin,retribution,17,7,10
quelthalas,416,paladin,retribution,10,5,5
barthilas,416,paladin,retribution,10,5,5
malganis,416,paladin,retribution,16,5,11
stormscale,415,paladin,retribution,14,5,9
thrall,399,paladin,retribution,5,5,0
kelthuzad,399,paladin,retribution,5,5,0
barthilas,384,paladin,retribution,6,4,2
bleeding-hollow,384,paladin,retribution,6,4,2
ragnaros,384,paladin,retribution,6,4,2
ragnaros,384,paladin,retribution,6,4,2
azralon,384,paladin,retribution,6,4,2
ragnaros,384,paladin,retribution,6,4,2
barthilas,384,paladin,retribution,6,4,2
boulderfist,384,paladin,retribution,6,4,2
moon-guard,384,paladin,retribution,6,4,2
sargeras,384,paladin,retribution,6,4,2
caelestrasz,384,paladin,retribution,6,4,2
azralon,384,paladin,retribution,6,4,2
barthilas,384,paladin,retribution,6,4,2
tichondrius,384,paladin,retribution,6,4,2
tichondrius,384,paladin,retribution,6,4,2
drakkari,384,paladin,retribution,6,4,2
area-52,384,paladin,retribution,6,4,2
tichondrius,384,paladin,retribution,6,4,2
zuljin,384,paladin,retribution,6,4,2
azralon,384,paladin,retribution,6,4,2
azralon,384,paladin,retribution,6,4,2
frostwolf,384,paladin,retribution,6,4,2
khadgar,384,paladin,retribution,6,4,2
tichondrius,384,paladin,retribution,6,4,2
area-52,384,paladin,retribution,6,4,2
alleria,384,paladin,retribution,6,4,2
terokkar,384,paladin,retribution,6,4,2
nemesis,384,paladin,retribution,6,4,2
garrosh,384,paladin,retribution,6,4,2
sargeras,384,paladin,retribution,6,4,2
nazjatar,384,paladin,retribution,6,4,2
nerzhul,384,paladin,retribution,6,4,2
hyjal,384,paladin,retribution,6,4,2
emerald-dream,384,paladin,retribution,6,4,2
blackwing-lair,384,paladin,retribution,6,4,2
area-52,384,paladin,retribution,6,4,2
area-52,384,paladin,retribution,6,4,2
skullcrusher,384,paladin,retribution,6,4,2
moonrunner,384,paladin,retribution,6,4,2
stormrage,384,paladin,retribution,6,4,2
quelthalas,384,paladin,retribution,6,4,2
drenden,384,paladin,retribution,6,4,2
kaelthas,384,paladin,retribution,6,4,2
stormrage,384,paladin,retribution,6,4,2
ragnaros,384,paladin,retribution,6,4,2
kelthuzad,384,paladin,retribution,6,4,2
moon-guard,384,paladin,retribution,6,4,2
darkspear,384,paladin,retribution,6,4,2
quelthalas,384,paladin,retribution,6,4,2
blackrock,384,paladin,retribution,6,4,2
quelthalas,384,paladin,retribution,6,4,2
sargeras,384,paladin,retribution,6,4,2
blackrock,384,paladin,retribution,6,4,2
shattered-halls,384,paladin,retribution,6,4,2
stormrage,384,paladin,retribution,6,4,2
icecrown,384,paladin,retribution,6,4,2
warsong,384,paladin,retribution,6,4,2
kelthuzad,384,paladin,retribution,6,4,2
tichondrius,384,paladin,retribution,6,4,2
kelthuzad,384,paladin,retribution,6,4,2
bleeding-hollow,384,paladin,retribution,6,4,2
sargeras,384,paladin,retribution,6,4,2
malganis,384,paladin,retribution,6,4,2
bleeding-hollow,384,paladin,retribution,6,4,2
sargeras,384,paladin,retribution,6,4,2
bleeding-hollow,384,paladin,retribution,6,4,2
tichondrius,384,paladin,retribution,10,5,5
quelthalas,384,paladin,retribution,8,4,4
malganis,384,paladin,retribution,12,4,8
stormscale,384,paladin,retribution,12,4,8
stormrage,384,paladin,retribution,12,4,8
ragnaros,384,paladin,retribution,12,4,8
jubeithos,384,paladin,retribution,12,4,8
tichondrius,384,paladin,retribution,12,4,8
moon-guard,384,paladin,retribution,12,4,8
zuljin,384,paladin,retribution,12,4,8
drakkari,384,paladin,retribution,12,4,8
nordrassil,384,paladin,retribution,12,4,8
thrall,384,paladin,retribution,12,4,8
sargeras,384,paladin,retribution,12,4,8
moon-guard,384,paladin,retribution,12,4,8
stormrage,384,paladin,retribution,12,4,8
illidan,384,paladin,retribution,12,4,8
sargeras,384,paladin,retribution,12,4,8
area-52,384,paladin,retribution,12,4,8
arthas,384,paladin,retribution,12,4,8
moon-guard,384,paladin,retribution,12,4,8
aerie-peak,384,paladin,retribution,12,4,8
illidan,384,paladin,retribution,12,4,8
magtheridon,384,paladin,retribution,12,4,8
kelthuzad,384,paladin,retribution,12,4,8
darkspear,384,paladin,retribution,12,4,8
thunderhorn,384,paladin,retribution,12,4,8
tichondrius,384,paladin,retribution,12,4,8
altar-of-storms,384,paladin,retribution,12,4,8
quelthalas,384,paladin,retribution,12,4,8
tichondrius,384,paladin,retribution,12,4,8
garithos,384,paladin,retribution,12,4,8
zuljin,384,paladin,retribution,12,4,8
blackrock,384,paladin,retribution,12,4,8
stormscale,384,paladin,retribution,12,4,8
nemesis,384,paladin,retribution,12,4,8
tichondrius,384,paladin,retribution,12,4,8
stormrage,384,paladin,retribution,12,4,8
illidan,384,paladin,retribution,12,4,8
sargeras,384,paladin,retribution,12,4,8
drenden,384,paladin,retribution,12,4,8
frostmourne,384,paladin,retribution,12,4,8
shattered-hand,384,paladin,retribution,12,4,8
darrowmere,384,paladin,retribution,12,4,8
barthilas,384,paladin,retribution,12,4,8
illidan,384,paladin,retribution,12,4,8
zuljin,384,paladin,retribution,12,4,8
blackrock,384,paladin,retribution,12,4,8
sargeras,384,paladin,retribution,12,4,8
moon-guard,384,paladin,retribution,12,4,8
korialstrasz,384,paladin,retribution,12,4,8
tichondrius,384,paladin,retribution,12,4,8
ghostlands,384,paladin,retribution,12,4,8
thrall,384,paladin,retribution,12,4,8
azralon,384,paladin,retribution,12,4,8
frostmourne,384,paladin,retribution,12,4,8
moon-guard,384,paladin,retribution,12,4,8
sargeras,384,paladin,retribution,12,4,8
tichondrius,384,paladin,retribution,12,4,8
moon-guard,384,paladin,retribution,12,4,8
velen,384,paladin,retribution,12,4,8
bleeding-hollow,384,paladin,retribution,12,4,8
anvilmar,384,paladin,retribution,12,4,8
bleeding-hollow,384,paladin,retribution,12,4,8
proudmoore,384,paladin,retribution,12,4,8
frostmourne,384,paladin,retribution,12,4,8
arygos,384,paladin,retribution,12,4,8
terokkar,384,paladin,retribution,12,4,8
emerald-dream,384,paladin,retribution,12,4,8
senjin,384,paladin,retribution,12,4,8
azralon,384,paladin,retribution,12,4,8
tichondrius,384,paladin,retribution,12,4,8
tichondrius,384,paladin,retribution,12,4,8
bleeding-hollow,384,paladin,retribution,16,5,11
elune,384,paladin,retribution,15,4,11
frostmourne,384,paladin,retribution,18,4,14
wildhammer,384,paladin,retribution,18,4,14
illidan,384,paladin,retribution,18,4,14
azralon,384,paladin,retribution,18,4,14
illidan,384,paladin,retribution,18,4,14
ragnaros,384,paladin,retribution,18,4,14
jaedenar,384,paladin,retribution,18,4,14
kirin-tor,384,paladin,retribution,18,4,14
area-52,384,paladin,retribution,18,4,14
tichondrius,384,paladin,retribution,18,4,14
area-52,384,paladin,retribution,18,4,14
quelthalas,384,paladin,retribution,18,4,14
stormscale,384,paladin,retribution,18,4,14
blackhand,384,paladin,retribution,18,4,14
quelthalas,384,paladin,retribution,18,4,14
bleeding-hollow,384,paladin,retribution,24,4,20
dalaran,383,paladin,retribution,6,4,2
thunderlord,383,paladin,retribution,6,4,2
drakthul,383,paladin,retribution,6,4,2
zuljin,383,paladin,retribution,6,4,2
twisting-nether,383,paladin,retribution,6,4,2
sargeras,383,paladin,retribution,9,5,4
rivendare,383,paladin,retribution,12,4,8
lightbringer,383,paladin,retribution,12,4,8
hakkar,383,paladin,retribution,12,4,8
sargeras,383,paladin,retribution,18,4,14
azralon,383,paladin,retribution,24,4,20
aegwynn,382,paladin,retribution,6,4,2
stormrage,382,paladin,retribution,6,4,2
tichondrius,367,paladin,retribution,11,4,7
wyrmrest-accord,367,paladin,retribution,11,4,7
boulderfist,352,paladin,retribution,13,5,8
tichondrius,351,paladin,retribution,11,4,7
ragnaros,351,paladin,retribution,13,4,9
nemesis,351,paladin,retribution,20,5,15
laughing-skull,350,paladin,retribution,11,6,5
moon-guard,336,paladin,retribution,9,5,4
quelthalas,335,paladin,retribution,11,4,7
moon-guard,330,paladin,retribution,8,5,3
stormrage,320,paladin,retribution,10,4,6
area-52,320,paladin,retribution,16,4,12
bleeding-hollow,319,paladin,retribution,5,4,1
tichondrius,319,paladin,retribution,5,4,1
skywall,319,paladin,retribution,5,4,1
tichondrius,319,paladin,retribution,8,4,4
moon-guard,319,paladin,retribution,8,4,4
sargeras,319,paladin,retribution,8,4,4
silvermoon,319,paladin,retribution,8,4,4
azshara,319,paladin,retribution,8,4,4
malganis,319,paladin,retribution,9,4,5
tichondrius,319,paladin,retribution,14,4,10
tichondrius,308,paladin,retribution,25,8,17
gallywix,304,paladin,retribution,7,4,3
illidan,304,paladin,retribution,7,4,3
area-52,304,paladin,retribution,7,4,3
frostmourne,304,paladin,retribution,19,4,15
bleeding-hollow,288,paladin,retribution,6,3,3
illidan,288,paladin,retribution,6,3,3
tichondrius,288,paladin,retribution,6,3,3
kiljaeden,288,paladin,retribution,6,3,3
kiljaeden,288,paladin,retribution,6,3,3
kelthuzad,288,paladin,retribution,6,3,3
anvilmar,288,paladin,retribution,6,3,3
bleeding-hollow,288,paladin,retribution,6,3,3
alexstrasza,288,paladin,retribution,6,3,3
cenarius,288,paladin,retribution,6,3,3
farstriders,288,paladin,retribution,6,3,3
illidan,288,paladin,retribution,6,3,3
thrall,288,paladin,retribution,6,3,3
tichondrius,288,paladin,retribution,6,3,3
illidan,288,paladin,retribution,6,3,3
tichondrius,288,paladin,retribution,6,3,3
kelthuzad,288,paladin,retribution,6,3,3
kelthuzad,288,paladin,retribution,6,3,3
hyjal,288,paladin,retribution,6,3,3
bleeding-hollow,288,paladin,retribution,6,3,3
queldorei,288,paladin,retribution,6,3,3
tichondrius,288,paladin,retribution,6,3,3
bleeding-hollow,288,paladin,retribution,6,3,3
hyjal,288,paladin,retribution,6,3,3
proudmoore,288,paladin,retribution,6,3,3
bleeding-hollow,288,paladin,retribution,6,3,3
bleeding-hollow,288,paladin,retribution,6,3,3
kelthuzad,288,paladin,retribution,6,3,3
laughing-skull,288,paladin,retribution,6,3,3
skullcrusher,288,paladin,retribution,6,3,3
illidan,288,paladin,retribution,6,3,3
hyjal,288,paladin,retribution,6,3,3
arathor,288,paladin,retribution,6,3,3
azgalor,288,paladin,retribution,6,3,3
area-52,288,paladin,retribution,6,3,3
proudmoore,288,paladin,retribution,6,3,3
hyjal,288,paladin,retribution,6,3,3
bonechewer,288,paladin,retribution,6,3,3
proudmoore,288,paladin,retribution,6,3,3
dalaran,288,paladin,retribution,6,3,3
illidan,288,paladin,retribution,6,3,3
dalaran,288,paladin,retribution,6,3,3
illidan,288,paladin,retribution,6,3,3
dalaran,288,paladin,retribution,6,3,3
dalaran,288,paladin,retribution,6,3,3
kelthuzad,288,paladin,retribution,6,3,3
proudmoore,288,paladin,retribution,6,3,3
bleeding-hollow,288,paladin,retribution,6,3,3
area-52,288,paladin,retribution,6,3,3
area-52,288,paladin,retribution,6,3,3
area-52,288,paladin,retribution,6,3,3
area-52,288,paladin,retribution,6,3,3
destromath,288,paladin,retribution,6,3,3
dalaran,288,paladin,retribution,6,3,3
thunderlord,288,paladin,retribution,6,3,3
area-52,288,paladin,retribution,6,3,3
dalaran,288,paladin,retribution,6,3,3
dalaran,288,paladin,retribution,6,3,3
tichondrius,288,paladin,retribution,6,3,3
illidan,288,paladin,retribution,6,3,3
mannoroth,288,paladin,retribution,6,3,3
area-52,288,paladin,retribution,6,3,3
stormrage,288,paladin,retribution,6,3,3
tichondrius,288,paladin,retribution,6,3,3
tichondrius,288,paladin,retribution,6,3,3
frostmourne,288,paladin,retribution,6,3,3
moon-guard,288,paladin,retribution,6,3,3
moon-guard,288,paladin,retribution,6,3,3
tichondrius,288,paladin,retribution,6,3,3
tichondrius,288,paladin,retribution,6,3,3
sargeras,288,paladin,retribution,6,3,3
ragnaros,288,paladin,retribution,6,3,3
stormrage,288,paladin,retribution,6,3,3
amanthul,288,paladin,retribution,6,3,3
ragnaros,288,paladin,retribution,6,3,3
quelthalas,288,paladin,retribution,6,3,3
tichondrius,288,paladin,retribution,6,3,3
azralon,288,paladin,retribution,6,3,3
stormrage,288,paladin,retribution,6,3,3
doomhammer,288,paladin,retribution,6,3,3
sargeras,288,paladin,retribution,6,3,3
moon-guard,288,paladin,retribution,6,3,3
moon-guard,288,paladin,retribution,6,3,3
tichondrius,288,paladin,retribution,6,3,3
moon-guard,288,paladin,retribution,6,3,3
kargath,288,paladin,retribution,6,3,3
silvermoon,288,paladin,retribution,6,3,3
ragnaros,288,paladin,retribution,6,3,3
mugthol,288,paladin,retribution,6,3,3
tichondrius,288,paladin,retribution,6,3,3
wyrmrest-accord,288,paladin,retribution,6,3,3
ragnaros,288,paladin,retribution,6,3,3
sargeras,288,paladin,retribution,6,3,3
tichondrius,288,paladin,retribution,6,3,3
frostmourne,288,paladin,retribution,6,3,3
ragnaros,288,paladin,retribution,6,3,3
ragnaros,288,paladin,retribution,6,3,3
shadowsong,288,paladin,retribution,6,3,3
doomhammer,288,paladin,retribution,6,3,3
stormrage,288,paladin,retribution,6,3,3
stormrage,288,paladin,retribution,6,3,3
frostmourne,288,paladin,retribution,6,3,3
executus,288,paladin,retribution,6,3,3
frostmourne,288,paladin,retribution,6,3,3
ragnaros,288,paladin,retribution,6,3,3
tichondrius,288,paladin,retribution,6,3,3
jubeithos,288,paladin,retribution,6,3,3
stormrage,288,paladin,retribution,6,3,3
tichondrius,288,paladin,retribution,6,3,3
stormrage,288,paladin,retribution,6,3,3
sargeras,288,paladin,retribution,6,3,3
sargeras,288,paladin,retribution,6,3,3
stormrage,288,paladin,retribution,6,3,3
kelthuzad,288,paladin,retribution,6,3,3
tichondrius,288,paladin,retribution,6,3,3
tichondrius,288,paladin,retribution,6,3,3
vashj,288,paladin,retribution,6,3,3
frostwolf,288,paladin,retribution,6,3,3
quelthalas,288,paladin,retribution,6,3,3
shandris,288,paladin,retribution,6,3,3
malganis,288,paladin,retribution,6,3,3
azralon,288,paladin,retribution,6,3,3
stormrage,288,paladin,retribution,6,3,3
vashj,288,paladin,retribution,6,3,3
baelgun,288,paladin,retribution,6,3,3
ragnaros,288,paladin,retribution,6,3,3
azralon,288,paladin,retribution,6,3,3
malganis,288,paladin,retribution,6,3,3
nagrand,288,paladin,retribution,6,3,3
stormrage,288,paladin,retribution,6,3,3
emerald-dream,288,paladin,retribution,6,3,3
malganis,288,paladin,retribution,6,3,3
tichondrius,288,paladin,retribution,6,3,3
ragnaros,288,paladin,retribution,6,3,3
dalaran,288,paladin,retribution,7,3,4
tichondrius,288,paladin,retribution,7,3,4
chogall,288,paladin,retribution,10,3,7
tichondrius,288,paladin,retribution,11,3,8
khadgar,288,paladin,retribution,12,3,9
boulderfist,288,paladin,retribution,12,3,9
barthilas,288,paladin,retribution,12,3,9
frostmourne,288,paladin,retribution,12,3,9
malganis,288,paladin,retribution,12,3,9
tichondrius,288,paladin,retribution,12,3,9
kelthuzad,288,paladin,retribution,12,3,9
thunderlord,288,paladin,retribution,12,3,9
alexstrasza,288,paladin,retribution,12,3,9
malganis,288,paladin,retribution,12,3,9
frostmourne,288,paladin,retribution,12,3,9
illidan,288,paladin,retribution,12,3,9
wyrmrest-accord,288,paladin,retribution,12,3,9
zuljin,288,paladin,retribution,12,3,9
stormrage,288,paladin,retribution,12,3,9
thrall,288,paladin,retribution,12,3,9
mugthol,288,paladin,retribution,12,3,9
stormrage,288,paladin,retribution,12,3,9
zuljin,288,paladin,retribution,12,3,9
malganis,288,paladin,retribution,12,3,9
stormrage,288,paladin,retribution,12,3,9
tichondrius,288,paladin,retribution,12,3,9
spirestone,288,paladin,retribution,12,3,9
zuljin,288,paladin,retribution,12,3,9
shandris,288,paladin,retribution,12,3,9
sargeras,288,paladin,retribution,12,3,9
veknilash,288,paladin,retribution,12,3,9
emerald-dream,288,paladin,retribution,12,3,9
moon-guard,288,paladin,retribution,12,3,9
azralon,288,paladin,retribution,12,3,9
tichondrius,288,paladin,retribution,12,3,9
sargeras,288,paladin,retribution,12,3,9
sargeras,288,paladin,retribution,12,3,9
area-52,288,paladin,retribution,12,3,9
moon-guard,288,paladin,retribution,12,3,9
area-52,288,paladin,retribution,12,3,9
tichondrius,288,paladin,retribution,12,3,9
tichondrius,288,paladin,retribution,12,3,9
illidan,288,paladin,retribution,12,3,9
illidan,288,paladin,retribution,12,3,9
smolderthorn,288,paladin,retribution,12,3,9
the-underbog,288,paladin,retribution,12,3,9
sargeras,288,paladin,retribution,12,3,9
moon-guard,288,paladin,retribution,12,3,9
zuljin,288,paladin,retribution,12,3,9
dalaran,288,paladin,retribution,12,3,9
moon-guard,288,paladin,retribution,12,3,9
ragnaros,288,paladin,retribution,12,3,9
drakthul,288,paladin,retribution,12,3,9
illidan,288,paladin,retribution,12,3,9
dalaran,288,paladin,retribution,12,3,9
proudmoore,288,paladin,retribution,12,3,9
dawnbringer,288,paladin,retribution,12,3,9
illidan,288,paladin,retribution,12,3,9
malganis,288,paladin,retribution,17,3,14
tichondrius,288,paladin,retribution,18,3,15
nesingwary,288,paladin,retribution,18,3,15
tichondrius,288,paladin,retribution,24,3,21
mugthol,287,paladin,retribution,6,3,3
hakkar,287,paladin,retribution,6,3,3
kelthuzad,287,paladin,retribution,6,3,3
quelthalas,287,paladin,retribution,12,3,9
agamaggan,281,paladin,retribution,11,5,6
sargeras,272,paladin,retribution,7,5,2
frostmourne,271,paladin,retribution,11,3,8
tichondrius,255,paladin,retribution,8,4,4
alterac-mountains,240,paladin,retribution,9,3,6
tichondrius,239,paladin,retribution,5,3,2
tichondrius,234,paladin,retribution,7,5,2
wyrmrest-accord,234,paladin,retribution,8,4,4
ragnaros,234,paladin,retribution,9,4,5
korgath,234,paladin,retribution,10,4,6
stormrage,234,paladin,retribution,16,4,12
moonrunner,223,paladin,retribution,8,3,5
area-52,192,paladin,retribution,4,3,1
tichondrius,192,paladin,retribution,11,4,7
eredar,192,paladin,retribution,9,3,6
malganis,192,paladin,retribution,6,2,4
emerald-dream,192,paladin,retribution,6,2,4
tichondrius,192,paladin,retribution,6,2,4
silvermoon,192,paladin,retribution,6,2,4
kelthuzad,192,paladin,retribution,6,2,4
emerald-dream,192,paladin,retribution,6,2,4
kelthuzad,192,paladin,retribution,6,2,4
onyxia,192,paladin,retribution,6,2,4
silvermoon,192,paladin,retribution,6,2,4
emerald-dream,192,paladin,retribution,6,2,4
tichondrius,192,paladin,retribution,6,2,4
stormrage,192,paladin,retribution,6,2,4
stormrage,192,paladin,retribution,6,2,4
scilla,192,paladin,retribution,6,2,4
emerald-dream,192,paladin,retribution,6,2,4
tichondrius,192,paladin,retribution,6,2,4
wyrmrest-accord,192,paladin,retribution,6,2,4
emerald-dream,192,paladin,retribution,6,2,4
stormrage,192,paladin,retribution,6,2,4
guldan,192,paladin,retribution,6,2,4
malganis,192,paladin,retribution,6,2,4
wyrmrest-accord,192,paladin,retribution,6,2,4
andorhal,192,paladin,retribution,6,2,4
wyrmrest-accord,192,paladin,retribution,6,2,4
bladefist,192,paladin,retribution,6,2,4
feathermoon,192,paladin,retribution,6,2,4
bleeding-hollow,192,paladin,retribution,6,2,4
quelthalas,192,paladin,retribution,6,2,4
laughing-skull,192,paladin,retribution,6,2,4
tichondrius,192,paladin,retribution,6,2,4
gilneas,192,paladin,retribution,6,2,4
quelthalas,192,paladin,retribution,6,2,4
quelthalas,192,paladin,retribution,6,2,4
emerald-dream,192,paladin,retribution,6,2,4
shandris,192,paladin,retribution,6,2,4
stormrage,192,paladin,retribution,6,2,4
stormrage,192,paladin,retribution,6,2,4
tichondrius,192,paladin,retribution,6,2,4
area-52,192,paladin,retribution,6,2,4
doomhammer,192,paladin,retribution,6,2,4
baelgun,192,paladin,retribution,6,2,4
quelthalas,192,paladin,retribution,6,2,4
area-52,192,paladin,retribution,6,2,4
quelthalas,192,paladin,retribution,6,2,4
the-underbog,192,paladin,retribution,6,2,4
stormrage,192,paladin,retribution,6,2,4
tichondrius,192,paladin,retribution,6,2,4
zuljin,192,paladin,retribution,6,2,4
zuljin,192,paladin,retribution,6,2,4
archimonde,192,paladin,retribution,6,2,4
nemesis,192,paladin,retribution,6,2,4
quelthalas,192,paladin,retribution,6,2,4
zuljin,192,paladin,retribution,6,2,4
wyrmrest-accord,192,paladin,retribution,6,2,4
nerzhul,192,paladin,retribution,6,2,4
the-venture-co,192,paladin,retribution,6,2,4
blackrock,192,paladin,retribution,6,2,4
nordrassil,192,paladin,retribution,6,2,4
arthas,192,paladin,retribution,6,2,4
moon-guard,192,paladin,retribution,6,2,4
muradin,192,paladin,retribution,6,2,4
stormrage,192,paladin,retribution,6,2,4
sargeras,192,paladin,retribution,6,2,4
zuljin,192,paladin,retribution,6,2,4
smolderthorn,192,paladin,retribution,6,2,4
nazjatar,192,paladin,retribution,6,2,4
sargeras,192,paladin,retribution,6,2,4
quelthalas,192,paladin,retribution,6,2,4
kelthuzad,192,paladin,retribution,6,2,4
area-52,192,paladin,retribution,6,2,4
caelestrasz,192,paladin,retribution,6,2,4
malganis,192,paladin,retribution,6,2,4
sargeras,192,paladin,retribution,6,2,4
moon-guard,192,paladin,retribution,6,2,4
tichondrius,192,paladin,retribution,6,2,4
tichondrius,192,paladin,retribution,6,2,4
dalaran,192,paladin,retribution,6,2,4
dalaran,192,paladin,retribution,6,2,4
nazjatar,192,paladin,retribution,6,2,4
area-52,192,paladin,retribution,6,2,4
sargeras,192,paladin,retribution,6,2,4
malfurion,192,paladin,retribution,6,2,4
malganis,192,paladin,retribution,6,2,4
sargeras,192,paladin,retribution,6,2,4
malganis,192,paladin,retribution,6,2,4
azjolnerub,192,paladin,retribution,6,2,4
frostmourne,192,paladin,retribution,6,2,4
darrowmere,192,paladin,retribution,6,2,4
scarlet-crusade,192,paladin,retribution,6,2,4
quelthalas,192,paladin,retribution,6,2,4
dalaran,192,paladin,retribution,6,2,4
khazgoroth,192,paladin,retribution,6,2,4
sargeras,192,paladin,retribution,6,2,4
dalaran,192,paladin,retribution,6,2,4
sargeras,192,paladin,retribution,6,2,4
azralon,192,paladin,retribution,6,2,4
nemesis,192,paladin,retribution,6,2,4
proudmoore,192,paladin,retribution,6,2,4
illidan,192,paladin,retribution,6,2,4
nemesis,192,paladin,retribution,6,2,4
proudmoore,192,paladin,retribution,6,2,4
illidan,192,paladin,retribution,6,2,4
tichondrius,192,paladin,retribution,6,2,4
whisperwind,192,paladin,retribution,6,2,4
moon-guard,192,paladin,retribution,6,2,4
frostmourne,192,paladin,retribution,6,2,4
tichondrius,192,paladin,retribution,6,2,4
ragnaros,192,paladin,retribution,6,2,4
moon-guard,192,paladin,retribution,6,2,4
tichondrius,192,paladin,retribution,6,2,4
thrall,192,paladin,retribution,6,2,4
tichondrius,192,paladin,retribution,6,2,4
barthilas,192,paladin,retribution,6,2,4
proudmoore,192,paladin,retribution,6,2,4
dragonmaw,192,paladin,retribution,6,2,4
muradin,192,paladin,retribution,6,2,4
sargeras,192,paladin,retribution,6,2,4
proudmoore,192,paladin,retribution,6,2,4
frostmourne,192,paladin,retribution,6,2,4
sargeras,192,paladin,retribution,6,2,4
thrall,192,paladin,retribution,6,2,4
moon-guard,192,paladin,retribution,6,2,4
illidan,192,paladin,retribution,6,2,4
proudmoore,192,paladin,retribution,6,2,4
thrall,192,paladin,retribution,6,2,4
ragnaros,192,paladin,retribution,6,2,4
caelestrasz,192,paladin,retribution,6,2,4
tichondrius,192,paladin,retribution,6,2,4
sargeras,192,paladin,retribution,6,2,4
sargeras,192,paladin,retribution,6,2,4
tichondrius,192,paladin,retribution,6,2,4
illidan,192,paladin,retribution,6,2,4
tichondrius,192,paladin,retribution,6,2,4
proudmoore,192,paladin,retribution,6,2,4
barthilas,192,paladin,retribution,6,2,4
illidan,192,paladin,retribution,6,2,4
illidan,192,paladin,retribution,6,2,4
proudmoore,192,paladin,retribution,6,2,4
tichondrius,192,paladin,retribution,6,2,4
tichondrius,192,paladin,retribution,6,2,4
moon-guard,192,paladin,retribution,6,2,4
azralon,192,paladin,retribution,6,2,4
tichondrius,192,paladin,retribution,6,2,4
illidan,192,paladin,retribution,6,2,4
aerie-peak,192,paladin,retribution,6,2,4
nagrand,192,paladin,retribution,6,2,4
tichondrius,192,paladin,retribution,6,2,4
drakkari,192,paladin,retribution,6,2,4
kiljaeden,192,paladin,retribution,6,2,4
azralon,192,paladin,retribution,6,2,4
ragnaros,192,paladin,retribution,6,2,4
area-52,192,paladin,retribution,6,2,4
barthilas,192,paladin,retribution,6,2,4
vashj,192,paladin,retribution,6,2,4
azralon,192,paladin,retribution,6,2,4
illidan,192,paladin,retribution,6,2,4
tichondrius,192,paladin,retribution,6,2,4
ragnaros,192,paladin,retribution,6,2,4
illidan,192,paladin,retribution,6,2,4
garrosh,192,paladin,retribution,6,2,4
ragnaros,192,paladin,retribution,6,2,4
kiljaeden,192,paladin,retribution,6,2,4
barthilas,192,paladin,retribution,6,2,4
moon-guard,192,paladin,retribution,6,2,4
bleeding-hollow,192,paladin,retribution,9,2,7
nemesis,192,paladin,retribution,9,2,7
dalaran,192,paladin,retribution,10,2,8
proudmoore,192,paladin,retribution,11,2,9
frostmourne,192,paladin,retribution,12,2,10
illidan,192,paladin,retribution,12,2,10
quelthalas,192,paladin,retribution,12,2,10
proudmoore,192,paladin,retribution,12,2,10
icecrown,192,paladin,retribution,12,2,10
stormreaver,192,paladin,retribution,12,2,10
blood-furnace,192,paladin,retribution,12,2,10
stormrage,192,paladin,retribution,12,2,10
malganis,192,paladin,retribution,12,2,10
tichondrius,192,paladin,retribution,12,2,10
proudmoore,192,paladin,retribution,12,2,10
tichondrius,192,paladin,retribution,12,2,10
frostmourne,192,paladin,retribution,12,2,10
cenarion-circle,192,paladin,retribution,12,2,10
tichondrius,192,paladin,retribution,12,2,10
illidan,192,paladin,retribution,12,2,10
dalaran,192,paladin,retribution,12,2,10
sargeras,192,paladin,retribution,12,2,10
moonrunner,192,paladin,retribution,12,2,10
sargeras,192,paladin,retribution,12,2,10
quelthalas,192,paladin,retribution,12,2,10
sargeras,192,paladin,retribution,12,2,10
icecrown,192,paladin,retribution,12,2,10
farstriders,192,paladin,retribution,12,2,10
tichondrius,192,paladin,retribution,18,2,16
emerald-dream,192,paladin,retribution,18,2,16
thrall,192,paladin,retribution,18,2,16
nazjatar,191,paladin,retribution,6,2,4
thrall,176,paladin,retribution,7,3,4
malganis,175,paladin,retribution,11,3,8
illidan,175,paladin,retribution,11,2,9
borean-tundra,175,paladin,retribution,11,2,9
illidan,175,paladin,retribution,11,2,9
tichondrius,159,paladin,retribution,5,2,3
azralon,159,paladin,retribution,5,2,3
illidan,159,paladin,retribution,5,2,3
silvermoon,159,paladin,retribution,5,2,3
tichondrius,159,paladin,retribution,5,2,3
dragonmaw,159,paladin,retribution,5,2,3
sargeras,144,paladin,retribution,3,3,0
nemesis,138,paladin,retribution,8,3,5
stormrage,138,paladin,retribution,10,3,7
stormrage,138,paladin,retribution,15,3,12
tichondrius,138,paladin,retribution,16,3,13
bonechewer,138,paladin,retribution,20,3,17
emerald-dream,128,paladin,retribution,4,2,2
frostmourne,128,paladin,retribution,4,2,2
ragnaros,128,paladin,retribution,4,2,2
sargeras,128,paladin,retribution,10,2,8
icecrown,96,paladin,retribution,3,2,1
ragnaros,96,paladin,retribution,3,2,1
wyrmrest-accord,96,paladin,retribution,3,2,1
illidan,96,paladin,retribution,6,1,5
tichondrius,96,paladin,retribution,6,1,5
winterhoof,96,paladin,retribution,6,1,5
baelgun,96,paladin,retribution,6,1,5
illidan,96,paladin,retribution,6,1,5
korgath,96,paladin,retribution,6,1,5
aerie-peak,96,paladin,retribution,6,1,5
aerie-peak,96,paladin,retribution,6,1,5
boulderfist,96,paladin,retribution,6,1,5
illidan,96,paladin,retribution,6,1,5
azralon,96,paladin,retribution,6,1,5
area-52,96,paladin,retribution,6,1,5
illidan,96,paladin,retribution,6,1,5
nerzhul,96,paladin,retribution,6,1,5
lightnings-blade,96,paladin,retribution,6,1,5
moon-guard,96,paladin,retribution,6,1,5
bleeding-hollow,96,paladin,retribution,6,1,5
area-52,96,paladin,retribution,6,1,5
tichondrius,96,paladin,retribution,6,1,5
blackhand,96,paladin,retribution,6,1,5
kul-tiras,96,paladin,retribution,6,1,5
malganis,96,paladin,retribution,6,1,5
area-52,96,paladin,retribution,6,1,5
drakkari,96,paladin,retribution,6,1,5
moon-guard,96,paladin,retribution,6,1,5
tichondrius,96,paladin,retribution,6,1,5
tichondrius,96,paladin,retribution,6,1,5
emerald-dream,96,paladin,retribution,6,1,5
tichondrius,96,paladin,retribution,6,1,5
illidan,96,paladin,retribution,6,1,5
area-52,96,paladin,retribution,6,1,5
stormrage,96,paladin,retribution,6,1,5
ghostlands,96,paladin,retribution,6,1,5
sargeras,96,paladin,retribution,6,1,5
drakkari,96,paladin,retribution,6,1,5
frostwolf,96,paladin,retribution,6,1,5
ragnaros,96,paladin,retribution,6,1,5
illidan,96,paladin,retribution,6,1,5
area-52,96,paladin,retribution,6,1,5
tichondrius,96,paladin,retribution,6,1,5
tichondrius,96,paladin,retribution,6,1,5
quelthalas,96,paladin,retribution,6,1,5
tichondrius,96,paladin,retribution,6,1,5
kelthuzad,96,paladin,retribution,6,1,5
kiljaeden,96,paladin,retribution,6,1,5
stormreaver,96,paladin,retribution,6,1,5
bleeding-hollow,96,paladin,retribution,6,1,5
nemesis,96,paladin,retribution,6,1,5
tichondrius,96,paladin,retribution,6,1,5
illidan,96,paladin,retribution,6,1,5
moon-guard,96,paladin,retribution,6,1,5
area-52,96,paladin,retribution,6,1,5
wyrmrest-accord,96,paladin,retribution,6,1,5
bleeding-hollow,96,paladin,retribution,6,1,5
deathwing,96,paladin,retribution,6,1,5
black-dragonflight,96,paladin,retribution,6,1,5
illidan,96,paladin,retribution,6,1,5
frostmourne,96,paladin,retribution,6,1,5
trollbane,96,paladin,retribution,6,1,5
frostmourne,96,paladin,retribution,6,1,5
tichondrius,96,paladin,retribution,6,1,5
thrall,96,paladin,retribution,6,1,5
agamaggan,96,paladin,retribution,6,1,5
proudmoore,96,paladin,retribution,6,1,5
area-52,96,paladin,retribution,6,1,5
tichondrius,96,paladin,retribution,6,1,5
kelthuzad,96,paladin,retribution,6,1,5
moon-guard,96,paladin,retribution,6,1,5
ragnaros,96,paladin,retribution,6,1,5
sargeras,96,paladin,retribution,6,1,5
malganis,96,paladin,retribution,6,1,5
burning-legion,96,paladin,retribution,6,1,5
arthas,96,paladin,retribution,6,1,5
frostmourne,96,paladin,retribution,6,1,5
tichondrius,96,paladin,retribution,6,1,5
stormrage,96,paladin,retribution,6,1,5
sargeras,96,paladin,retribution,6,1,5
frostmourne,96,paladin,retribution,6,1,5
sargeras,96,paladin,retribution,6,1,5
frostmourne,96,paladin,retribution,6,1,5
tichondrius,96,paladin,retribution,6,1,5
stormrage,96,paladin,retribution,6,1,5
frostmourne,96,paladin,retribution,6,1,5
illidan,96,paladin,retribution,6,1,5
quelthalas,96,paladin,retribution,6,1,5
stormrage,96,paladin,retribution,6,1,5
sargeras,96,paladin,retribution,6,1,5
frostmourne,96,paladin,retribution,6,1,5
stormrage,96,paladin,retribution,6,1,5
akama,96,paladin,retribution,6,1,5
moon-guard,96,paladin,retribution,6,1,5
gallywix,96,paladin,retribution,6,1,5
proudmoore,96,paladin,retribution,6,1,5
area-52,96,paladin,retribution,6,1,5
sargeras,96,paladin,retribution,6,1,5
bloodhoof,96,paladin,retribution,6,1,5
quelthalas,96,paladin,retribution,6,1,5
malganis,96,paladin,retribution,6,1,5
moon-guard,96,paladin,retribution,6,1,5
dalaran,96,paladin,retribution,6,1,5
tichondrius,96,paladin,retribution,6,1,5
moon-guard,96,paladin,retribution,6,1,5
frostmourne,96,paladin,retribution,6,1,5
tichondrius,96,paladin,retribution,6,1,5
ragnaros,96,paladin,retribution,6,1,5
tichondrius,96,paladin,retribution,6,1,5
ragnaros,96,paladin,retribution,6,1,5
illidan,96,paladin,retribution,6,1,5
tichondrius,96,paladin,retribution,6,1,5
stormrage,96,paladin,retribution,6,1,5
nemesis,96,paladin,retribution,6,1,5
bleeding-hollow,96,paladin,retribution,7,1,6
tichondrius,96,paladin,retribution,12,1,11
sargeras,96,paladin,retribution,12,1,11
illidan,96,paladin,retribution,12,1,11
stormreaver,96,paladin,retribution,12,1,11
quelthalas,96,paladin,retribution,12,1,11
tichondrius,96,paladin,retribution,12,1,11
tichondrius,96,paladin,retribution,12,1,11
mannoroth,96,paladin,retribution,12,1,11
quelthalas,96,paladin,retribution,12,1,11
destromath,96,paladin,retribution,12,1,11
tichondrius,96,paladin,retribution,12,1,11
tichondrius,96,paladin,retribution,12,1,11
zuljin,96,paladin,retribution,12,1,11
malfurion,95,paladin,retribution,12,1,11
tichondrius,79,paladin,retribution,5,1,4
stormrage,79,paladin,retribution,5,1,4
illidan,79,paladin,retribution,5,1,4
nemesis,79,paladin,retribution,5,1,4
stormrage,79,paladin,retribution,11,1,10
tichondrius,42,paladin,retribution,10,3,7
emerald-dream,42,paladin,retribution,11,3,8
tichondrius,42,paladin,retribution,9,2,7
galakrond,31,paladin,retribution,2,1,1
ragnaros,31,paladin,retribution,2,1,1
tol-barad,31,paladin,retribution,8,1,7
quelthalas,16,paladin,retribution,1,1,0
quelthalas,1906,paladin,protection,55,39,16
nemesis,1815,paladin,protection,102,62,40
ragnaros,1807,paladin,protection,118,63,55
doomhammer,1791,paladin,protection,87,42,45
tichondrius,1730,paladin,protection,84,47,37
bleeding-hollow,1679,paladin,protection,36,24,12
moon-guard,1665,paladin,protection,48,28,20
tichondrius,1655,paladin,protection,113,56,57
stormrage,1649,paladin,protection,42,30,12
malganis,1621,paladin,protection,54,25,29
frostmourne,1589,paladin,protection,36,17,19
sargeras,1525,paladin,protection,69,31,38
ysondre,1490,paladin,protection,62,27,35
bonechewer,1456,paladin,protection,87,42,45
drakkari,1425,paladin,protection,58,38,20
illidan,1398,paladin,protection,60,29,31
cenarion-circle,1347,paladin,protection,104,38,66
azgalor,1315,paladin,protection,24,14,10
ghostlands,1278,paladin,protection,45,27,18
sargeras,1273,paladin,protection,48,18,30
bleeding-hollow,1161,paladin,protection,65,25,40
sargeras,1050,paladin,protection,24,11,13
bleeding-hollow,958,paladin,protection,18,10,8
bonechewer,953,paladin,protection,12,10,2
malygos,863,paladin,protection,18,9,9
aggramar,768,paladin,protection,18,8,10
area-52,767,paladin,protection,24,8,16
drakkari,766,paladin,protection,12,8,4
dethecus,702,paladin,protection,11,8,3
bleeding-hollow,670,paladin,protection,18,7,11
lightbringer,480,paladin,protection,12,5,7
sisters-of-elune,480,paladin,protection,12,5,7
malfurion,480,paladin,protection,12,5,7
proudmoore,479,paladin,protection,18,5,13
malygos,384,paladin,protection,6,4,2
moon-guard,384,paladin,protection,12,4,8
proudmoore,384,paladin,protection,12,4,8
stormrage,335,paladin,protection,7,7,0
thorium-brotherhood,288,paladin,protection,6,3,3
thorium-brotherhood,288,paladin,protection,6,3,3
quelthalas,288,paladin,protection,6,3,3
tichondrius,288,paladin,protection,12,3,9
moon-guard,240,paladin,protection,9,3,6
saurfang,234,paladin,protection,9,4,5
kelthuzad,192,paladin,protection,6,2,4
korialstrasz,192,paladin,protection,6,2,4
tichondrius,192,paladin,protection,6,2,4
daggerspine,192,paladin,protection,12,2,10
veknilash,96,paladin,protection,8,2,6
tichondrius,96,paladin,protection,6,1,5
sargeras,2082,priest,holy,114,57,57
emerald-dream,2051,priest,holy,90,47,43
burning-legion,1996,priest,holy,222,111,111
tichondrius,1934,priest,holy,80,44,36
tichondrius,1915,priest,holy,81,42,39
frostmourne,1899,priest,holy,54,29,25
gurubashi,1894,priest,holy,36,20,16
illidan,1893,priest,holy,54,29,25
akama,1867,priest,holy,72,45,27
hyjal,1844,priest,holy,54,27,27
illidan,1840,priest,holy,66,33,33
stormrage,1838,priest,holy,177,100,77
sargeras,1835,priest,holy,80,35,45
azralon,1817,priest,holy,59,27,32
tichondrius,1817,priest,holy,60,23,37
area-52,1816,priest,holy,90,53,37
darkspear,1813,priest,holy,36,26,10
nemesis,1813,priest,holy,88,62,26
proudmoore,1813,priest,holy,227,109,118
malganis,1806,priest,holy,171,102,69
tichondrius,1806,priest,holy,96,46,50
tichondrius,1804,priest,holy,145,68,77
tichondrius,1780,priest,holy,102,43,59
moon-guard,1765,priest,holy,72,36,36
shadowsong,1760,priest,holy,94,42,52
stormrage,1747,priest,holy,54,25,29
kelthuzad,1746,priest,holy,96,49,47
sargeras,1730,priest,holy,72,33,39
area-52,1727,priest,holy,135,75,60
area-52,1725,priest,holy,133,68,65
tichondrius,1715,priest,holy,84,50,34
frostmane,1710,priest,holy,95,54,41
frostmourne,1687,priest,holy,95,43,52
illidan,1686,priest,holy,54,21,33
nagrand,1685,priest,holy,38,19,19
tichondrius,1675,priest,holy,48,26,22
tichondrius,1673,priest,holy,42,18,24
illidan,1667,priest,holy,143,88,55
proudmoore,1663,priest,holy,98,48,50
frostmourne,1653,priest,holy,36,18,18
emerald-dream,1638,priest,holy,59,27,32
sargeras,1624,priest,holy,78,40,38
tichondrius,1622,priest,holy,36,21,15
frostmourne,1621,priest,holy,48,21,27
turalyon,1615,priest,holy,36,21,15
drakthul,1611,priest,holy,184,94,90
kelthuzad,1599,priest,holy,88,48,40
frostmourne,1586,priest,holy,42,19,23
moon-guard,1570,priest,holy,84,45,39
thrall,1570,priest,holy,65,33,32
bleeding-hollow,1557,priest,holy,45,22,23
stormrage,1544,priest,holy,84,39,45
illidan,1539,priest,holy,110,54,56
stormrage,1526,priest,holy,67,40,27
tichondrius,1512,priest,holy,180,88,92
malganis,1510,priest,holy,54,23,31
area-52,1509,priest,holy,30,16,14
illidan,1508,priest,holy,42,19,23
chogall,1503,priest,holy,42,18,24
tichondrius,1501,priest,holy,72,31,41
moon-guard,1492,priest,holy,152,74,78
tichondrius,1487,priest,holy,48,16,32
mannoroth,1485,priest,holy,62,28,34
chromaggus,1479,priest,holy,42,17,25
moon-guard,1474,priest,holy,45,20,25
terenas,1472,priest,holy,103,41,62
illidan,1467,priest,holy,50,36,14
frostmourne,1463,priest,holy,36,21,15
mannoroth,1445,priest,holy,48,20,28
wyrmrest-accord,1436,priest,holy,136,84,52
stormrage,1432,priest,holy,54,34,20
tichondrius,1430,priest,holy,44,24,20
proudmoore,1429,priest,holy,36,15,21
stormrage,1427,priest,holy,66,30,36
bleeding-hollow,1423,priest,holy,51,32,19
stormrage,1416,priest,holy,153,73,80
tichondrius,1413,priest,holy,79,33,46
burning-blade,1410,priest,holy,108,54,54
kelthuzad,1400,priest,holy,60,26,34
moon-guard,1386,priest,holy,102,47,55
area-52,1385,priest,holy,29,15,14
tichondrius,1381,priest,holy,49,28,21
tichondrius,1380,priest,holy,36,18,18
proudmoore,1374,priest,holy,78,28,50
frostmourne,1373,priest,holy,76,33,43
greymane,1364,priest,holy,91,44,47
proudmoore,1361,priest,holy,54,28,26
kelthuzad,1353,priest,holy,26,16,10
azralon,1347,priest,holy,53,32,21
area-52,1346,priest,holy,54,27,27
stormrage,1343,priest,holy,30,14,16
sargeras,1342,priest,holy,24,14,10
bleeding-hollow,1339,priest,holy,30,14,16
sargeras,1338,priest,holy,30,14,16
illidan,1330,priest,holy,26,17,9
sargeras,1330,priest,holy,55,23,32
bleeding-hollow,1326,priest,holy,85,52,33
kiljaeden,1322,priest,holy,24,14,10
proudmoore,1314,priest,holy,31,14,17
tichondrius,1310,priest,holy,38,29,9
bleeding-hollow,1309,priest,holy,36,17,19
quelthalas,1306,priest,holy,56,30,26
azralon,1301,priest,holy,84,38,46
dragonmaw,1268,priest,holy,30,14,16
tichondrius,1262,priest,holy,29,14,15
area-52,1261,priest,holy,49,28,21
bonechewer,1256,priest,holy,24,14,10
tichondrius,1247,priest,holy,30,13,17
zuluhed,1243,priest,holy,30,20,10
aegwynn,1243,priest,holy,28,14,14
arthas,1240,priest,holy,42,20,22
zuljin,1235,priest,holy,36,20,16
proudmoore,1235,priest,holy,24,13,11
winterhoof,1229,priest,holy,18,13,5
thunderlord,1229,priest,holy,138,69,69
kelthuzad,1222,priest,holy,79,39,40
sargeras,1218,priest,holy,107,49,58
sisters-of-elune,1214,priest,holy,30,17,13
kelthuzad,1214,priest,holy,30,15,15
kul-tiras,1211,priest,holy,53,26,27
moon-guard,1205,priest,holy,56,27,29
thrall,1205,priest,holy,61,24,37
tichondrius,1201,priest,holy,45,22,23
quelthalas,1201,priest,holy,29,14,15
blackwing-lair,1200,priest,holy,215,106,109
deathwing,1197,priest,holy,53,24,29
illidan,1190,priest,holy,79,42,37
drakkari,1174,priest,holy,54,24,30
aegwynn,1170,priest,holy,60,24,36
ragnaros,1165,priest,holy,89,42,47
azralon,1164,priest,holy,48,23,25
nemesis,1151,priest,holy,30,12,18
quelthalas,1151,priest,holy,30,12,18
wyrmrest-accord,1150,priest,holy,72,29,43
sargeras,1148,priest,holy,24,12,12
quelthalas,1139,priest,holy,24,12,12
thrall,1124,priest,holy,24,12,12
moon-guard,1119,priest,holy,24,12,12
arathor,1114,priest,holy,20,13,7
khazgoroth,1114,priest,holy,66,32,34
azralon,1109,priest,holy,42,17,25
stormscale,1107,priest,holy,66,26,40
illidan,1102,priest,holy,75,34,41
proudmoore,1097,priest,holy,28,12,16
barthilas,1069,priest,holy,25,12,13
illidan,1068,priest,holy,31,12,19
sargeras,1055,priest,holy,24,11,13
bleeding-hollow,1052,priest,holy,24,11,13
earthen-ring,1049,priest,holy,18,11,7
moon-guard,1048,priest,holy,18,11,7
laughing-skull,1047,priest,holy,18,11,7
dathremar,1044,priest,holy,18,11,7
tichondrius,1040,priest,holy,24,11,13
moon-guard,1037,priest,holy,24,11,13
sargeras,1035,priest,holy,30,11,19
demon-soul,1033,priest,holy,140,57,83
sargeras,1013,priest,holy,36,20,16
proudmoore,994,priest,holy,61,28,33
kargath,991,priest,holy,23,11,12
quelthalas,988,priest,holy,29,13,16
dalaran,980,priest,holy,29,12,17
lothar,962,priest,holy,42,19,23
silvermoon,959,priest,holy,11,11,0
bleeding-hollow,959,priest,holy,18,10,8
tichondrius,958,priest,holy,18,10,8
zuljin,957,priest,holy,24,10,14
illidan,955,priest,holy,18,10,8
tichondrius,955,priest,holy,24,10,14
tichondrius,955,priest,holy,36,10,26
nagrand,952,priest,holy,124,60,64
kargath,951,priest,holy,26,10,16
emerald-dream,935,priest,holy,30,12,18
stormrage,930,priest,holy,18,10,8
area-52,926,priest,holy,17,10,7
nagrand,864,priest,holy,18,9,9
azralon,864,priest,holy,18,9,9
moon-guard,864,priest,holy,29,9,20
bleeding-hollow,863,priest,holy,18,9,9
illidan,863,priest,holy,18,9,9
area-52,863,priest,holy,24,9,15
tichondrius,863,priest,holy,24,9,15
chogall,862,priest,holy,18,9,9
sargeras,861,priest,holy,18,9,9
dalaran,860,priest,holy,12,9,3
ragnaros,859,priest,holy,18,9,9
tichondrius,854,priest,holy,24,9,15
doomhammer,846,priest,holy,41,16,25
quelthalas,831,priest,holy,28,9,19
darrowmere,799,priest,holy,26,9,17
emerald-dream,795,priest,holy,16,9,7
tichondrius,784,priest,holy,13,9,4
zuljin,768,priest,holy,12,8,4
stormrage,768,priest,holy,12,8,4
the-underbog,768,priest,holy,12,8,4
tichondrius,768,priest,holy,18,8,10
ragnaros,767,priest,holy,12,8,4
maiev,765,priest,holy,12,8,4
tichondrius,717,priest,holy,15,8,7
aggramar,703,priest,holy,14,9,5
area-52,672,priest,holy,12,7,5
ragnaros,672,priest,holy,12,7,5
whisperwind,672,priest,holy,18,7,11
tichondrius,672,priest,holy,18,7,11
tichondrius,671,priest,holy,12,7,5
illidan,671,priest,holy,16,8,8
wyrmrest-accord,671,priest,holy,18,7,11
area-52,670,priest,holy,18,7,11
malganis,670,priest,holy,18,7,11
illidan,655,priest,holy,23,7,16
illidan,606,priest,holy,16,7,9
tichondrius,603,priest,holy,14,7,7
moon-guard,586,priest,holy,11,7,4
zuljin,576,priest,holy,12,6,6
nemesis,576,priest,holy,12,6,6
ghostlands,576,priest,holy,12,6,6
quelthalas,576,priest,holy,12,6,6
frostmourne,576,priest,holy,12,6,6
area-52,576,priest,holy,12,6,6
dalaran,576,priest,holy,12,6,6
azralon,576,priest,holy,12,6,6
tichondrius,576,priest,holy,18,6,12
barthilas,576,priest,holy,18,6,12
kelthuzad,576,priest,holy,18,6,12
alterac-mountains,576,priest,holy,25,6,19
chogall,575,priest,holy,12,6,6
azralon,575,priest,holy,12,6,6
area-52,575,priest,holy,12,6,6
eonar,575,priest,holy,18,6,12
bleeding-hollow,574,priest,holy,12,6,6
kiljaeden,574,priest,holy,18,6,12
shadowmoon,572,priest,holy,12,6,6
lightbringer,571,priest,holy,12,6,6
hakkar,569,priest,holy,12,6,6
illidan,527,priest,holy,11,6,5
moon-guard,519,priest,holy,21,7,14
frostmourne,511,priest,holy,10,6,4
gorefiend,480,priest,holy,6,5,1
stormscale,480,priest,holy,6,5,1
frostmourne,480,priest,holy,6,5,1
illidan,480,priest,holy,6,5,1
tichondrius,480,priest,holy,10,6,4
thrall,480,priest,holy,12,5,7
moon-guard,480,priest,holy,12,5,7
moknathal,480,priest,holy,12,5,7
drakthul,480,priest,holy,12,5,7
stormrage,480,priest,holy,12,5,7
stormrage,480,priest,holy,12,5,7
ragnaros,480,priest,holy,12,5,7
frostmourne,480,priest,holy,12,5,7
illidan,480,priest,holy,12,5,7
kiljaeden,480,priest,holy,12,5,7
proudmoore,480,priest,holy,12,5,7
kelthuzad,479,priest,holy,6,5,1
thrall,479,priest,holy,11,6,5
nerzhul,479,priest,holy,12,5,7
azralon,479,priest,holy,18,5,13
bleeding-hollow,447,priest,holy,11,5,6
eonar,447,priest,holy,11,5,6
kelthuzad,384,priest,holy,6,4,2
sargeras,384,priest,holy,6,4,2
exodar,384,priest,holy,6,4,2
frostmourne,384,priest,holy,6,4,2
azralon,384,priest,holy,6,4,2
spirestone,384,priest,holy,6,4,2
tichondrius,384,priest,holy,6,4,2
frostmourne,384,priest,holy,6,4,2
eitrigg,384,priest,holy,6,4,2
malganis,384,priest,holy,6,4,2
moon-guard,384,priest,holy,12,4,8
moon-guard,384,priest,holy,12,4,8
tichondrius,384,priest,holy,12,4,8
tichondrius,384,priest,holy,12,4,8
arathor,384,priest,holy,12,4,8
tichondrius,384,priest,holy,12,4,8
barthilas,384,priest,holy,24,4,20
aggramar,383,priest,holy,6,4,2
wyrmrest-accord,383,priest,holy,12,4,8
dethecus,382,priest,holy,6,4,2
dathremar,381,priest,holy,12,4,8
emerald-dream,372,priest,holy,22,8,14
tichondrius,367,priest,holy,11,4,7
frostmourne,350,priest,holy,17,4,13
area-52,336,priest,holy,9,4,5
agamaggan,336,priest,holy,15,4,11
illidan,335,priest,holy,11,4,7
lothar,335,priest,holy,17,4,13
emerald-dream,330,priest,holy,21,5,16
area-52,319,priest,holy,5,4,1
stormrage,288,priest,holy,6,3,3
stormrage,288,priest,holy,6,3,3
blood-furnace,288,priest,holy,6,3,3
fenris,288,priest,holy,6,3,3
moon-guard,288,priest,holy,6,3,3
korgath,288,priest,holy,6,3,3
emerald-dream,288,priest,holy,6,3,3
sargeras,288,priest,holy,6,3,3
thunderlord,288,priest,holy,6,3,3
burning-legion,288,priest,holy,6,3,3
the-forgotten-coast,288,priest,holy,6,3,3
proudmoore,288,priest,holy,6,3,3
ragnaros,288,priest,holy,6,3,3
ragnaros,288,priest,holy,6,3,3
arthas,288,priest,holy,6,3,3
illidan,288,priest,holy,6,3,3
illidan,288,priest,holy,6,3,3
ragnaros,288,priest,holy,6,3,3
azralon,288,priest,holy,6,3,3
firetree,288,priest,holy,6,3,3
sargeras,288,priest,holy,6,3,3
blackrock,288,priest,holy,6,3,3
gorgonnash,288,priest,holy,6,3,3
bladefist,288,priest,holy,6,3,3
area-52,288,priest,holy,12,3,9
aerie-peak,288,priest,holy,12,3,9
tichondrius,288,priest,holy,12,3,9
ragnaros,288,priest,holy,12,3,9
proudmoore,288,priest,holy,12,3,9
malganis,288,priest,holy,12,3,9
vashj,288,priest,holy,12,3,9
suramar,288,priest,holy,18,3,15
ragnaros,287,priest,holy,6,3,3
dalaran,239,priest,holy,5,3,2
tichondrius,234,priest,holy,17,4,13
quelthalas,192,priest,holy,6,2,4
burning-blade,192,priest,holy,6,2,4
jubeithos,192,priest,holy,6,2,4
frostmourne,192,priest,holy,6,2,4
moon-guard,192,priest,holy,6,2,4
frostmourne,192,priest,holy,6,2,4
quelthalas,192,priest,holy,6,2,4
malganis,192,priest,holy,6,2,4
ravencrest,192,priest,holy,6,2,4
terokkar,192,priest,holy,6,2,4
kelthuzad,192,priest,holy,6,2,4
skullcrusher,192,priest,holy,6,2,4
kelthuzad,192,priest,holy,6,2,4
kelthuzad,192,priest,holy,6,2,4
caelestrasz,192,priest,holy,6,2,4
tichondrius,192,priest,holy,6,2,4
stormrage,192,priest,holy,6,2,4
stormrage,192,priest,holy,6,2,4
aerie-peak,192,priest,holy,6,2,4
dalaran,192,priest,holy,6,2,4
frostwolf,192,priest,holy,6,2,4
tichondrius,192,priest,holy,6,2,4
tichondrius,192,priest,holy,6,2,4
sargeras,192,priest,holy,6,2,4
frostmourne,192,priest,holy,12,2,10
moon-guard,192,priest,holy,12,2,10
maiev,192,priest,holy,12,2,10
frostmourne,192,priest,holy,12,2,10
malganis,191,priest,holy,6,2,4
dark-iron,159,priest,holy,5,2,3
area-52,138,priest,holy,11,3,8
cairne,136,priest,holy,9,3,6
stormrage,127,priest,holy,8,2,6
elune,96,priest,holy,6,1,5
illidan,96,priest,holy,6,1,5
illidan,96,priest,holy,6,1,5
tichondrius,96,priest,holy,6,1,5
dunemaul,96,priest,holy,6,1,5
tichondrius,96,priest,holy,6,1,5
tichondrius,96,priest,holy,6,1,5
moon-guard,96,priest,holy,6,1,5
zuljin,96,priest,holy,6,1,5
sargeras,96,priest,holy,6,1,5
stormrage,96,priest,holy,6,1,5
emerald-dream,96,priest,holy,6,1,5
illidan,96,priest,holy,6,1,5
gilneas,96,priest,holy,6,1,5
illidan,96,priest,holy,6,1,5
barthilas,96,priest,holy,6,1,5
lightbringer,96,priest,holy,6,1,5
dalaran,96,priest,holy,6,1,5
wyrmrest-accord,96,priest,holy,12,1,11
thrall,96,priest,holy,12,1,11
sargeras,96,priest,holy,12,1,11
sargeras,79,priest,holy,5,1,4
nagrand,79,priest,holy,11,1,10
doomhammer,31,priest,holy,8,1,7
sargeras,2252,priest,discipline,97,56,41
tichondrius,2243,priest,discipline,84,50,34
nathrezim,2155,priest,discipline,216,114,102
dalaran,2153,priest,discipline,233,121,112
stonemaul,2144,priest,discipline,97,56,41
illidan,2142,priest,discipline,114,64,50
tichondrius,2141,priest,discipline,99,52,47
illidan,2133,priest,discipline,78,46,32
tichondrius,2114,priest,discipline,87,45,42
area-52,2107,priest,discipline,126,67,59
frostmourne,2102,priest,discipline,100,58,42
madoran,2100,priest,discipline,102,52,50
stormrage,2082,priest,discipline,159,90,69
illidan,2044,priest,discipline,54,26,28
shattered-hand,2036,priest,discipline,133,71,62
area-52,2031,priest,discipline,87,47,40
ragnaros,2030,priest,discipline,70,41,29
tichondrius,2029,priest,discipline,148,78,70
spinebreaker,2023,priest,discipline,102,51,51
blackhand,2022,priest,discipline,60,35,25
area-52,2021,priest,discipline,65,44,21
area-52,2017,priest,discipline,184,98,86
illidan,2016,priest,discipline,252,127,125
stormrage,2011,priest,discipline,181,87,94
area-52,2010,priest,discipline,100,57,43
illidan,2003,priest,discipline,67,41,26
moon-guard,2002,priest,discipline,83,41,42
area-52,1996,priest,discipline,93,51,42
sargeras,1995,priest,discipline,201,101,100
azralon,1994,priest,discipline,92,47,45
tichondrius,1981,priest,discipline,87,46,41
illidan,1977,priest,discipline,144,84,60
proudmoore,1974,priest,discipline,46,26,20
bleeding-hollow,1973,priest,discipline,131,60,71
tichondrius,1970,priest,discipline,60,34,26
illidan,1967,priest,discipline,66,37,29
zuljin,1964,priest,discipline,204,106,98
illidan,1962,priest,discipline,90,44,46
ragnaros,1959,priest,discipline,83,46,37
frostwolf,1957,priest,discipline,84,37,47
kelthuzad,1956,priest,discipline,178,88,90
stormrage,1951,priest,discipline,255,139,116
hydraxis,1943,priest,discipline,70,41,29
kelthuzad,1942,priest,discipline,68,36,32
tichondrius,1941,priest,discipline,96,41,55
tichondrius,1940,priest,discipline,34,24,10
frostmourne,1936,priest,discipline,65,30,35
tichondrius,1933,priest,discipline,84,42,42
icecrown,1930,priest,discipline,133,69,64
tichondrius,1926,priest,discipline,71,37,34
tichondrius,1926,priest,discipline,105,48,57
arthas,1925,priest,discipline,60,37,23
zuljin,1924,priest,discipline,152,72,80
tichondrius,1923,priest,discipline,83,35,48
malganis,1914,priest,discipline,27,23,4
nerzhul,1914,priest,discipline,159,79,80
sargeras,1911,priest,discipline,119,64,55
stormrage,1910,priest,discipline,159,90,69
tichondrius,1910,priest,discipline,78,40,38
area-52,1908,priest,discipline,132,83,49
frostmourne,1908,priest,discipline,124,59,65
area-52,1903,priest,discipline,65,42,23
ragnaros,1896,priest,discipline,42,25,17
illidan,1895,priest,discipline,59,27,32
frostmourne,1892,priest,discipline,79,44,35
tichondrius,1891,priest,discipline,151,66,85
tichondrius,1890,priest,discipline,42,20,22
malganis,1890,priest,discipline,48,21,27
stormrage,1884,priest,discipline,74,43,31
sargeras,1883,priest,discipline,42,26,16
sargeras,1881,priest,discipline,78,43,35
moon-guard,1881,priest,discipline,47,21,26
sargeras,1877,priest,discipline,60,34,26
tichondrius,1874,priest,discipline,95,51,44
tichondrius,1873,priest,discipline,42,24,18
antonidas,1873,priest,discipline,113,56,57
tichondrius,1873,priest,discipline,71,33,38
sargeras,1871,priest,discipline,88,51,37
malganis,1870,priest,discipline,60,27,33
sargeras,1868,priest,discipline,36,26,10
malganis,1868,priest,discipline,65,27,38
tichondrius,1867,priest,discipline,78,37,41
zuljin,1867,priest,discipline,77,36,41
sargeras,1863,priest,discipline,81,46,35
tichondrius,1861,priest,discipline,60,29,31
moon-guard,1859,priest,discipline,53,31,22
illidan,1858,priest,discipline,72,39,33
thrall,1857,priest,discipline,67,37,30
akama,1857,priest,discipline,114,59,55
darkspear,1857,priest,discipline,117,57,60
malganis,1856,priest,discipline,82,45,37
tichondrius,1855,priest,discipline,60,27,33
area-52,1854,priest,discipline,42,28,14
tichondrius,1854,priest,discipline,47,30,17
frostmourne,1850,priest,discipline,48,26,22
kiljaeden,1849,priest,discipline,66,34,32
sargeras,1848,priest,discipline,45,29,16
illidan,1847,priest,discipline,60,39,21
tichondrius,1847,priest,discipline,54,29,25
tichondrius,1845,priest,discipline,95,47,48
illidan,1844,priest,discipline,52,30,22
tichondrius,1843,priest,discipline,54,24,30
ragnaros,1842,priest,discipline,42,26,16
trollbane,1841,priest,discipline,128,77,51
frostmourne,1840,priest,discipline,65,30,35
tichondrius,1839,priest,discipline,103,53,50
shadow-council,1839,priest,discipline,62,28,34
tichondrius,1838,priest,discipline,62,33,29
dark-iron,1838,priest,discipline,40,20,20
hakkar,1838,priest,discipline,61,30,31
icecrown,1837,priest,discipline,48,25,23
tichondrius,1836,priest,discipline,42,22,20
ragnaros,1835,priest,discipline,96,53,43
jubeithos,1835,priest,discipline,111,60,51
tichondrius,1835,priest,discipline,40,21,19
illidan,1834,priest,discipline,42,29,13
queldorei,1834,priest,discipline,60,31,29
sargeras,1833,priest,discipline,103,51,52
tichondrius,1830,priest,discipline,114,68,46
darkspear,1830,priest,discipline,72,33,39
tichondrius,1829,priest,discipline,58,28,30
tichondrius,1828,priest,discipline,54,28,26
tichondrius,1827,priest,discipline,60,30,30
sargeras,1827,priest,discipline,68,31,37
sargeras,1826,priest,discipline,72,34,38
bleeding-hollow,1825,priest,discipline,34,23,11
tichondrius,1825,priest,discipline,70,45,25
zuluhed,1825,priest,discipline,66,38,28
thunderlord,1825,priest,discipline,48,26,22
sargeras,1825,priest,discipline,66,35,31
tichondrius,1825,priest,discipline,65,34,31
moon-guard,1825,priest,discipline,88,41,47
perenolde,1824,priest,discipline,42,30,12
stormrage,1824,priest,discipline,48,28,20
deathwing,1824,priest,discipline,54,30,24
tichondrius,1824,priest,discipline,144,79,65
bleeding-hollow,1823,priest,discipline,47,28,19
area-52,1823,priest,discipline,124,67,57
bleeding-hollow,1823,priest,discipline,108,55,53
the-underbog,1822,priest,discipline,49,29,20
sargeras,1822,priest,discipline,54,27,27
illidan,1822,priest,discipline,54,26,28
chogall,1821,priest,discipline,91,43,48
ragnaros,1820,priest,discipline,71,44,27
tichondrius,1820,priest,discipline,60,34,26
kiljaeden,1820,priest,discipline,48,24,24
frostmourne,1819,priest,discipline,54,24,30
illidan,1817,priest,discipline,89,50,39
illidan,1817,priest,discipline,54,25,29
zuljin,1816,priest,discipline,41,24,17
sargeras,1816,priest,discipline,86,48,38
tichondrius,1816,priest,discipline,46,25,21
nemesis,1816,priest,discipline,48,25,23
kelthuzad,1815,priest,discipline,54,30,24
nemesis,1815,priest,discipline,168,91,77
arathor,1815,priest,discipline,42,22,20
quelthalas,1815,priest,discipline,164,81,83
destromath,1815,priest,discipline,96,44,52
moon-guard,1815,priest,discipline,48,22,26
proudmoore,1815,priest,discipline,60,27,33
azralon,1814,priest,discipline,53,30,23
illidan,1814,priest,discipline,96,50,46
twisting-nether,1814,priest,discipline,66,29,37
firetree,1813,priest,discipline,54,33,21
proudmoore,1813,priest,discipline,78,43,35
illidan,1813,priest,discipline,48,26,22
tichondrius,1813,priest,discipline,90,38,52
stormrage,1812,priest,discipline,90,58,32
tichondrius,1812,priest,discipline,44,26,18
skywall,1811,priest,discipline,104,58,46
kelthuzad,1811,priest,discipline,88,41,47
emerald-dream,1810,priest,discipline,72,40,32
emerald-dream,1810,priest,discipline,72,37,35
mannoroth,1810,priest,discipline,96,49,47
proudmoore,1809,priest,discipline,54,37,17
sargeras,1809,priest,discipline,73,43,30
laughing-skull,1809,priest,discipline,108,59,49
tichondrius,1809,priest,discipline,60,28,32
dunemaul,1808,priest,discipline,71,39,32
archimonde,1808,priest,discipline,71,37,34
stormrage,1808,priest,discipline,48,24,24
tichondrius,1807,priest,discipline,54,32,22
area-52,1807,priest,discipline,120,68,52
area-52,1806,priest,discipline,36,24,12
frostmourne,1806,priest,discipline,75,46,29
moon-guard,1806,priest,discipline,58,35,23
area-52,1806,priest,discipline,58,31,27
zuljin,1806,priest,discipline,84,44,40
sargeras,1806,priest,discipline,114,57,57
tichondrius,1805,priest,discipline,30,19,11
illidan,1805,priest,discipline,66,34,32
tichondrius,1804,priest,discipline,44,31,13
tichondrius,1804,priest,discipline,36,24,12
stormrage,1804,priest,discipline,30,19,11
tichondrius,1804,priest,discipline,59,33,26
ragnaros,1804,priest,discipline,47,26,21
frostmane,1804,priest,discipline,145,80,65
tichondrius,1804,priest,discipline,52,28,24
bleeding-hollow,1804,priest,discipline,65,32,33
kiljaeden,1803,priest,discipline,168,99,69
illidan,1803,priest,discipline,102,60,42
illidan,1803,priest,discipline,168,94,74
emerald-dream,1803,priest,discipline,152,85,67
tichondrius,1803,priest,discipline,70,37,33
tichondrius,1802,priest,discipline,51,32,19
illidan,1802,priest,discipline,54,33,21
frostmourne,1802,priest,discipline,125,68,57
tichondrius,1801,priest,discipline,97,68,29
area-52,1801,priest,discipline,83,55,28
sargeras,1800,priest,discipline,131,77,54
illidan,1800,priest,discipline,135,69,66
bleeding-hollow,1800,priest,discipline,42,19,23
moon-guard,1799,priest,discipline,59,35,24
bleeding-hollow,1798,priest,discipline,24,19,5
tichondrius,1795,priest,discipline,89,49,40
barthilas,1793,priest,discipline,58,33,25
zuljin,1789,priest,discipline,114,56,58
tichondrius,1787,priest,discipline,36,22,14
area-52,1787,priest,discipline,46,26,20
rivendare,1786,priest,discipline,112,53,59
quelthalas,1784,priest,discipline,60,29,31
tichondrius,1781,priest,discipline,112,56,56
sargeras,1780,priest,discipline,47,28,19
dalvengyr,1777,priest,discipline,96,55,41
tichondrius,1776,priest,discipline,78,47,31
tichondrius,1775,priest,discipline,37,22,15
tichondrius,1773,priest,discipline,36,19,17
barthilas,1772,priest,discipline,48,30,18
stormrage,1770,priest,discipline,47,25,22
durotan,1770,priest,discipline,96,43,53
tichondrius,1769,priest,discipline,59,23,36
barthilas,1768,priest,discipline,84,47,37
tichondrius,1768,priest,discipline,65,28,37
stormrage,1767,priest,discipline,59,33,26
tichondrius,1767,priest,discipline,66,27,39
tichondrius,1764,priest,discipline,294,146,148
moon-guard,1764,priest,discipline,71,32,39
tichondrius,1763,priest,discipline,59,27,32
stormrage,1759,priest,discipline,83,37,46
sargeras,1758,priest,discipline,96,44,52
sargeras,1757,priest,discipline,244,119,125
mannoroth,1757,priest,discipline,130,60,70
dalaran,1756,priest,discipline,84,42,42
aggramar,1754,priest,discipline,72,33,39
tichondrius,1754,priest,discipline,60,26,34
blades-edge,1752,priest,discipline,341,167,174
tichondrius,1752,priest,discipline,73,29,44
moon-guard,1749,priest,discipline,48,24,24
malygos,1748,priest,discipline,190,96,94
frostmourne,1748,priest,discipline,60,24,36
blackrock,1747,priest,discipline,43,27,16
sargeras,1746,priest,discipline,24,19,5
stormrage,1746,priest,discipline,95,48,47
sargeras,1746,priest,discipline,63,29,34
zuljin,1745,priest,discipline,232,121,111
sargeras,1743,priest,discipline,62,28,34
tichondrius,1743,priest,discipline,44,19,25
emerald-dream,1742,priest,discipline,85,38,47
sargeras,1741,priest,discipline,95,57,38
dalaran,1741,priest,discipline,132,60,72
tichondrius,1741,priest,discipline,54,24,30
bleeding-hollow,1736,priest,discipline,64,35,29
kelthuzad,1736,priest,discipline,84,41,43
frostmourne,1736,priest,discipline,48,20,28
frostmourne,1730,priest,discipline,78,49,29
laughing-skull,1729,priest,discipline,47,30,17
frostmourne,1729,priest,discipline,66,34,32
sargeras,1728,priest,discipline,64,51,13
proudmoore,1728,priest,discipline,107,48,59
icecrown,1723,priest,discipline,54,30,24
stormscale,1723,priest,discipline,34,18,16
vashj,1723,priest,discipline,71,29,42
tichondrius,1723,priest,discipline,90,36,54
wildhammer,1722,priest,discipline,42,24,18
suramar,1722,priest,discipline,36,18,18
tichondrius,1721,priest,discipline,48,27,21
arthas,1721,priest,discipline,36,19,17
tanaris,1718,priest,discipline,54,28,26
tichondrius,1718,priest,discipline,72,33,39
illidan,1717,priest,discipline,30,18,12
barthilas,1716,priest,discipline,74,40,34
tichondrius,1715,priest,discipline,24,18,6
tichondrius,1715,priest,discipline,54,25,29
malganis,1713,priest,discipline,165,83,82
illidan,1713,priest,discipline,48,24,24
wyrmrest-accord,1709,priest,discipline,48,26,22
nerzhul,1708,priest,discipline,65,29,36
dethecus,1707,priest,discipline,36,19,17
illidan,1706,priest,discipline,48,21,27
frostmourne,1705,priest,discipline,35,21,14
bleeding-hollow,1705,priest,discipline,129,61,68
moon-guard,1704,priest,discipline,60,24,36
tichondrius,1703,priest,discipline,41,20,21
tichondrius,1702,priest,discipline,34,20,14
illidan,1702,priest,discipline,89,47,42
saurfang,1702,priest,discipline,72,36,36
emerald-dream,1700,priest,discipline,48,28,20
tichondrius,1700,priest,discipline,46,23,23
stormrage,1700,priest,discipline,131,62,69
stormrage,1699,priest,discipline,48,27,21
tichondrius,1698,priest,discipline,53,24,29
illidan,1697,priest,discipline,49,29,20
bleeding-hollow,1696,priest,discipline,40,27,13
tichondrius,1696,priest,discipline,80,52,28
zuljin,1696,priest,discipline,37,21,16
sargeras,1695,priest,discipline,42,23,19
tichondrius,1690,priest,discipline,74,46,28
tichondrius,1690,priest,discipline,45,26,19
moon-guard,1690,priest,discipline,60,29,31
dathremar,1690,priest,discipline,69,29,40
illidan,1689,priest,discipline,31,18,13
tichondrius,1689,priest,discipline,173,99,74
tichondrius,1688,priest,discipline,63,36,27
queldorei,1688,priest,discipline,48,25,23
tichondrius,1688,priest,discipline,71,35,36
tichondrius,1687,priest,discipline,79,39,40
tichondrius,1686,priest,discipline,126,67,59
gorefiend,1680,priest,discipline,178,91,87
tichondrius,1679,priest,discipline,76,43,33
emerald-dream,1679,priest,discipline,72,39,33
malganis,1679,priest,discipline,105,48,57
sargeras,1676,priest,discipline,59,30,29
tichondrius,1676,priest,discipline,118,59,59
frostmourne,1676,priest,discipline,40,20,20
barthilas,1675,priest,discipline,42,22,20
stormrage,1675,priest,discipline,51,24,27
tichondrius,1674,priest,discipline,54,27,27
illidan,1671,priest,discipline,269,129,140
tichondrius,1669,priest,discipline,155,74,81
tichondrius,1668,priest,discipline,36,23,13
tichondrius,1663,priest,discipline,76,36,40
tichondrius,1663,priest,discipline,55,23,32
stormrage,1662,priest,discipline,29,22,7
sargeras,1662,priest,discipline,66,44,22
tichondrius,1662,priest,discipline,92,50,42
kelthuzad,1662,priest,discipline,95,51,44
dalaran,1662,priest,discipline,40,20,20
moon-guard,1661,priest,discipline,72,33,39
proudmoore,1659,priest,discipline,412,206,206
whisperwind,1659,priest,discipline,42,20,22
sargeras,1659,priest,discipline,161,75,86
tichondrius,1659,priest,discipline,41,18,23
ragnaros,1657,priest,discipline,97,53,44
ragnaros,1657,priest,discipline,36,19,17
garona,1656,priest,discipline,78,43,35
stormrage,1654,priest,discipline,68,36,32
dalaran,1653,priest,discipline,36,23,13
tichondrius,1653,priest,discipline,42,23,19
laughing-skull,1653,priest,discipline,36,18,18
sargeras,1652,priest,discipline,39,25,14
stormrage,1652,priest,discipline,48,25,23
hyjal,1652,priest,discipline,150,66,84
azgalor,1652,priest,discipline,72,31,41
stormreaver,1651,priest,discipline,286,146,140
wildhammer,1650,priest,discipline,82,42,40
bloodhoof,1650,priest,discipline,155,75,80
area-52,1649,priest,discipline,78,43,35
frostmourne,1649,priest,discipline,72,33,39
sargeras,1648,priest,discipline,36,21,15
area-52,1648,priest,discipline,47,22,25
zuluhed,1648,priest,discipline,42,19,23
ravencrest,1647,priest,discipline,43,22,21
tichondrius,1646,priest,discipline,102,56,46
destromath,1646,priest,discipline,78,42,36
tichondrius,1646,priest,discipline,43,20,23
tichondrius,1646,priest,discipline,57,25,32
kelthuzad,1645,priest,discipline,63,35,28
illidan,1645,priest,discipline,42,21,21
frostmourne,1645,priest,discipline,48,22,26
kirin-tor,1645,priest,discipline,48,20,28
frostmourne,1643,priest,discipline,82,39,43
nemesis,1642,priest,discipline,42,25,17
barthilas,1642,priest,discipline,60,26,34
tichondrius,1641,priest,discipline,49,30,19
gorgonnash,1641,priest,discipline,322,173,149
misha,1639,priest,discipline,78,42,36
barthilas,1638,priest,discipline,75,49,26
tichondrius,1637,priest,discipline,41,22,19
emerald-dream,1636,priest,discipline,48,26,22
ragnaros,1634,priest,discipline,46,27,19
sargeras,1634,priest,discipline,42,22,20
whisperwind,1633,priest,discipline,149,77,72
ragnaros,1631,priest,discipline,30,18,12
wyrmrest-accord,1631,priest,discipline,72,39,33
tichondrius,1631,priest,discipline,136,73,63
tichondrius,1631,priest,discipline,216,104,112
illidan,1630,priest,discipline,24,17,7
tichondrius,1630,priest,discipline,75,45,30
ragnaros,1630,priest,discipline,43,21,22
tichondrius,1629,priest,discipline,79,36,43
azralon,1628,priest,discipline,48,22,26
frostmourne,1626,priest,discipline,24,17,7
stormrage,1626,priest,discipline,27,18,9
bleeding-hollow,1626,priest,discipline,51,31,20
moon-guard,1626,priest,discipline,107,57,50
stormrage,1626,priest,discipline,48,25,23
azralon,1626,priest,discipline,41,21,20
emerald-dream,1626,priest,discipline,172,85,87
frostmourne,1626,priest,discipline,132,57,75
nemesis,1625,priest,discipline,98,59,39
dark-iron,1625,priest,discipline,232,114,118
malorne,1624,priest,discipline,156,73,83
area-52,1624,priest,discipline,141,63,78
azralon,1624,priest,discipline,47,20,27
stormrage,1623,priest,discipline,30,17,13
sargeras,1623,priest,discipline,124,70,54
kelthuzad,1621,priest,discipline,30,17,13
azralon,1621,priest,discipline,48,17,31
arthas,1620,priest,discipline,36,20,16
malganis,1620,priest,discipline,48,22,26
illidan,1619,priest,discipline,71,39,32
area-52,1619,priest,discipline,36,17,19
illidan,1619,priest,discipline,47,21,26
tichondrius,1618,priest,discipline,18,17,1
thrall,1618,priest,discipline,58,33,25
tichondrius,1618,priest,discipline,63,34,29
quelthalas,1618,priest,discipline,42,22,20
sargeras,1618,priest,discipline,42,17,25
frostmourne,1617,priest,discipline,49,37,12
azgalor,1616,priest,discipline,35,20,15
sargeras,1615,priest,discipline,66,40,26
silvermoon,1615,priest,discipline,84,45,39
tichondrius,1615,priest,discipline,36,17,19
tichondrius,1614,priest,discipline,100,50,50
sargeras,1613,priest,discipline,64,36,28
shadowmoon,1613,priest,discipline,36,20,16
area-52,1613,priest,discipline,42,21,21
tichondrius,1613,priest,discipline,152,71,81
tichondrius,1612,priest,discipline,30,17,13
nemesis,1611,priest,discipline,36,23,13
illidan,1611,priest,discipline,42,26,16
tichondrius,1610,priest,discipline,67,39,28
stormrage,1610,priest,discipline,71,38,33
malganis,1610,priest,discipline,92,48,44
proudmoore,1610,priest,discipline,131,64,67
illidan,1610,priest,discipline,50,24,26
agamaggan,1610,priest,discipline,54,25,29
azralon,1608,priest,discipline,54,34,20
tichondrius,1608,priest,discipline,111,62,49
area-52,1608,priest,discipline,84,42,42
zuljin,1607,priest,discipline,36,20,16
quelthalas,1605,priest,discipline,30,18,12
bleeding-hollow,1605,priest,discipline,36,20,16
emerald-dream,1605,priest,discipline,185,95,90
emerald-dream,1605,priest,discipline,66,33,33
moon-guard,1604,priest,discipline,65,39,26
bleeding-hollow,1604,priest,discipline,78,37,41
laughing-skull,1604,priest,discipline,78,29,49
sargeras,1603,priest,discipline,30,22,8
kilrogg,1603,priest,discipline,42,22,20
azralon,1603,priest,discipline,149,77,72
bleeding-hollow,1603,priest,discipline,78,36,42
illidan,1602,priest,discipline,42,32,10
stormrage,1602,priest,discipline,36,22,14
stormrage,1602,priest,discipline,36,20,16
stormrage,1602,priest,discipline,159,77,82
frostmourne,1602,priest,discipline,66,27,39
sargeras,1600,priest,discipline,66,36,30
shattered-hand,1600,priest,discipline,78,42,36
area-52,1600,priest,discipline,36,17,19
tichondrius,1600,priest,discipline,52,22,30
tichondrius,1599,priest,discipline,36,21,15
frostmourne,1599,priest,discipline,54,31,23
area-52,1599,priest,discipline,61,31,30
thrall,1599,priest,discipline,48,23,25
illidan,1599,priest,discipline,54,20,34
tichondrius,1598,priest,discipline,129,72,57
darkspear,1598,priest,discipline,36,17,19
stormrage,1598,priest,discipline,71,26,45
zangarmarsh,1596,priest,discipline,62,40,22
ragnaros,1594,priest,discipline,42,22,20
area-52,1594,priest,discipline,63,31,32
tichondrius,1594,priest,discipline,36,17,19
quelthalas,1591,priest,discipline,101,45,56
quelthalas,1591,priest,discipline,48,20,28
thrall,1590,priest,discipline,52,26,26
tichondrius,1590,priest,discipline,90,44,46
tichondrius,1589,priest,discipline,54,28,26
tichondrius,1587,priest,discipline,40,18,22
sargeras,1587,priest,discipline,58,22,36
area-52,1586,priest,discipline,54,31,23
frostmourne,1586,priest,discipline,60,32,28
arthas,1585,priest,discipline,30,17,13
tichondrius,1585,priest,discipline,36,20,16
zuljin,1585,priest,discipline,83,45,38
illidan,1584,priest,discipline,68,33,35
moonrunner,1583,priest,discipline,42,25,17
nemesis,1583,priest,discipline,83,38,45
tichondrius,1582,priest,discipline,93,50,43
azralon,1582,priest,discipline,65,33,32
kelthuzad,1582,priest,discipline,107,51,56
lightbringer,1581,priest,discipline,30,17,13
kelthuzad,1581,priest,discipline,162,83,79
sargeras,1580,priest,discipline,40,24,16
nagrand,1579,priest,discipline,30,17,13
stormrage,1579,priest,discipline,91,48,43
tichondrius,1578,priest,discipline,35,18,17
tichondrius,1578,priest,discipline,42,19,23
bleeding-hollow,1578,priest,discipline,114,51,63
dunemaul,1577,priest,discipline,49,29,20
ravencrest,1576,priest,discipline,54,27,27
hyjal,1573,priest,discipline,104,59,45
sargeras,1573,priest,discipline,36,20,16
quelthalas,1573,priest,discipline,53,29,24
frostmourne,1573,priest,discipline,58,25,33
drakkari,1572,priest,discipline,112,59,53
frostmourne,1572,priest,discipline,38,20,18
malygos,1571,priest,discipline,66,35,31
sargeras,1571,priest,discipline,36,18,18
bleeding-hollow,1571,priest,discipline,165,79,86
stormrage,1570,priest,discipline,41,23,18
tichondrius,1570,priest,discipline,36,19,17
thrall,1570,priest,discipline,95,48,47
kiljaeden,1568,priest,discipline,30,19,11
frostmourne,1567,priest,discipline,54,27,27
tichondrius,1566,priest,discipline,24,20,4
tichondrius,1566,priest,discipline,59,20,39
illidan,1564,priest,discipline,30,18,12
moon-guard,1563,priest,discipline,30,20,10
tichondrius,1562,priest,discipline,57,31,26
sargeras,1562,priest,discipline,78,42,36
proudmoore,1561,priest,discipline,72,27,45
malygos,1561,priest,discipline,48,18,30
andorhal,1559,priest,discipline,35,17,18
stormrage,1559,priest,discipline,53,24,29
tichondrius,1559,priest,discipline,54,20,34
magtheridon,1558,priest,discipline,36,21,15
tichondrius,1558,priest,discipline,59,32,27
hyjal,1558,priest,discipline,119,58,61
tichondrius,1557,priest,discipline,72,37,35
emerald-dream,1551,priest,discipline,87,53,34
sargeras,1551,priest,discipline,48,28,20
wyrmrest-accord,1550,priest,discipline,36,19,17
moon-guard,1549,priest,discipline,60,35,25
sargeras,1549,priest,discipline,42,19,23
quelthalas,1549,priest,discipline,58,26,32
stormrage,1549,priest,discipline,83,30,53
ragnaros,1548,priest,discipline,110,57,53
zuljin,1548,priest,discipline,54,26,28
ragnaros,1547,priest,discipline,128,66,62
suramar,1545,priest,discipline,154,92,62
anetheron,1545,priest,discipline,66,25,41
boulderfist,1544,priest,discipline,36,22,14
area-52,1543,priest,discipline,42,27,15
stormrage,1541,priest,discipline,56,30,26
area-52,1541,priest,discipline,93,49,44
deathwing,1540,priest,discipline,111,73,38
ysera,1540,priest,discipline,152,81,71
boulderfist,1540,priest,discipline,189,90,99
tichondrius,1539,priest,discipline,39,21,18
tichondrius,1539,priest,discipline,191,96,95
illidan,1538,priest,discipline,50,33,17
altar-of-storms,1538,priest,discipline,102,54,48
vashj,1538,priest,discipline,60,26,34
area-52,1537,priest,discipline,78,47,31
hyjal,1537,priest,discipline,161,85,76
kelthuzad,1537,priest,discipline,55,27,28
skullcrusher,1537,priest,discipline,119,49,70
tichondrius,1536,priest,discipline,108,54,54
illidan,1535,priest,discipline,30,16,14
sargeras,1534,priest,discipline,24,16,8
illidan,1534,priest,discipline,83,37,46
tichondrius,1531,priest,discipline,63,31,32
tichondrius,1530,priest,discipline,24,16,8
quelthalas,1529,priest,discipline,113,58,55
area-52,1529,priest,discipline,54,26,28
stormrage,1529,priest,discipline,102,48,54
emerald-dream,1528,priest,discipline,24,17,7
moon-guard,1528,priest,discipline,77,39,38
illidan,1526,priest,discipline,72,34,38
bleeding-hollow,1524,priest,discipline,101,61,40
spirestone,1524,priest,discipline,36,16,20
deathwing,1523,priest,discipline,26,16,10
emerald-dream,1523,priest,discipline,55,30,25
moon-guard,1523,priest,discipline,36,19,17
ragnaros,1522,priest,discipline,126,65,61
tichondrius,1522,priest,discipline,123,60,63
area-52,1521,priest,discipline,54,30,24
arthas,1521,priest,discipline,30,16,14
area-52,1521,priest,discipline,34,17,17
bleeding-hollow,1520,priest,discipline,48,24,24
tichondrius,1520,priest,discipline,38,18,20
stormrage,1519,priest,discipline,76,37,39
illidan,1517,priest,discipline,54,32,22
the-venture-co,1517,priest,discipline,48,26,22
malganis,1517,priest,discipline,84,37,47
grizzly-hills,1517,priest,discipline,48,21,27
sargeras,1516,priest,discipline,24,16,8
frostmourne,1516,priest,discipline,77,39,38
stormrage,1516,priest,discipline,87,41,46
altar-of-storms,1515,priest,discipline,36,18,18
tichondrius,1515,priest,discipline,156,77,79
frostmourne,1514,priest,discipline,122,57,65
thrall,1514,priest,discipline,44,19,25
tichondrius,1513,priest,discipline,64,32,32
sargeras,1512,priest,discipline,36,17,19
azralon,1511,priest,discipline,101,42,59
tichondrius,1509,priest,discipline,55,30,25
kiljaeden,1509,priest,discipline,90,41,49
dalaran,1509,priest,discipline,42,18,24
area-52,1507,priest,discipline,48,27,21
amanthul,1506,priest,discipline,40,23,17
tichondrius,1506,priest,discipline,48,24,24
tichondrius,1506,priest,discipline,128,52,76
dalaran,1506,priest,discipline,90,35,55
agamaggan,1505,priest,discipline,62,30,32
garrosh,1505,priest,discipline,60,27,33
kelthuzad,1505,priest,discipline,59,26,33
mannoroth,1504,priest,discipline,24,16,8
frostmourne,1503,priest,discipline,52,28,24
frostmourne,1503,priest,discipline,41,18,23
stormrage,1501,priest,discipline,120,67,53
barthilas,1500,priest,discipline,54,35,19
malganis,1500,priest,discipline,48,23,25
tichondrius,1500,priest,discipline,84,37,47
moon-guard,1499,priest,discipline,180,94,86
bleeding-hollow,1498,priest,discipline,97,53,44
firetree,1498,priest,discipline,30,16,14
proudmoore,1498,priest,discipline,36,16,20
detheroc,1498,priest,discipline,52,23,29
stormreaver,1497,priest,discipline,30,18,12
ragnaros,1495,priest,discipline,25,18,7
area-52,1495,priest,discipline,70,35,35
fizzcrank,1495,priest,discipline,48,20,28
alleria,1493,priest,discipline,36,27,9
area-52,1493,priest,discipline,202,106,96
stormrage,1492,priest,discipline,48,24,24
frostmourne,1491,priest,discipline,77,39,38
malganis,1491,priest,discipline,72,27,45
illidan,1488,priest,discipline,48,24,24
sargeras,1488,priest,discipline,70,34,36
tichondrius,1486,priest,discipline,30,23,7
proudmoore,1486,priest,discipline,60,32,28
mugthol,1486,priest,discipline,169,89,80
alterac-mountains,1485,priest,discipline,62,34,28
moon-guard,1485,priest,discipline,50,25,25
area-52,1484,priest,discipline,40,25,15
tichondrius,1484,priest,discipline,39,23,16
korgath,1483,priest,discipline,91,42,49
zuljin,1481,priest,discipline,78,44,34
area-52,1479,priest,discipline,24,16,8
tichondrius,1478,priest,discipline,162,80,82
thrall,1478,priest,discipline,92,40,52
sargeras,1477,priest,discipline,72,35,37
sargeras,1476,priest,discipline,36,22,14
tichondrius,1476,priest,discipline,48,16,32
tichondrius,1475,priest,discipline,45,30,15
sargeras,1475,priest,discipline,53,31,22
stormrage,1475,priest,discipline,33,16,17
tichondrius,1474,priest,discipline,113,44,69
zuljin,1473,priest,discipline,80,39,41
ragnaros,1472,priest,discipline,84,40,44
tichondrius,1472,priest,discipline,54,20,34
area-52,1471,priest,discipline,42,24,18
haomarush,1471,priest,discipline,66,37,29
quelthalas,1471,priest,discipline,48,25,23
tichondrius,1471,priest,discipline,35,17,18
tichondrius,1471,priest,discipline,66,32,34
kelthuzad,1471,priest,discipline,172,82,90
stormrage,1470,priest,discipline,54,28,26
eonar,1469,priest,discipline,42,21,21
emerald-dream,1468,priest,discipline,80,42,38
area-52,1467,priest,discipline,48,27,21
proudmoore,1467,priest,discipline,60,33,27
thrall,1467,priest,discipline,30,16,14
illidan,1467,priest,discipline,168,84,84
malganis,1466,priest,discipline,30,16,14
tichondrius,1466,priest,discipline,70,33,37
sargeras,1463,priest,discipline,59,32,27
stormrage,1463,priest,discipline,78,41,37
arathor,1463,priest,discipline,48,25,23
thrall,1462,priest,discipline,78,40,38
area-52,1461,priest,discipline,36,22,14
frostmourne,1461,priest,discipline,77,38,39
bleeding-hollow,1460,priest,discipline,36,17,19
frostmourne,1460,priest,discipline,100,46,54
thrall,1460,priest,discipline,108,45,63
tichondrius,1459,priest,discipline,24,16,8
quelthalas,1459,priest,discipline,66,39,27
illidan,1459,priest,discipline,37,21,16
azralon,1459,priest,discipline,112,58,54
mugthol,1458,priest,discipline,28,17,11
laughing-skull,1458,priest,discipline,123,63,60
shadowmoon,1458,priest,discipline,135,66,69
kelthuzad,1458,priest,discipline,54,26,28
tichondrius,1458,priest,discipline,93,40,53
hydraxis,1457,priest,discipline,52,16,36
tichondrius,1456,priest,discipline,54,27,27
darkspear,1455,priest,discipline,30,20,10
bleeding-hollow,1455,priest,discipline,101,50,51
tichondrius,1455,priest,discipline,166,82,84
moon-guard,1455,priest,discipline,120,55,65
area-52,1454,priest,discipline,70,41,29
illidan,1454,priest,discipline,39,17,22
misha,1452,priest,discipline,47,21,26
tichondrius,1450,priest,discipline,65,30,35
tichondrius,1449,priest,discipline,200,94,106
wildhammer,1447,priest,discipline,48,28,20
area-52,1447,priest,discipline,87,47,40
illidan,1447,priest,discipline,30,16,14
azralon,1447,priest,discipline,96,50,46
drakkari,1446,priest,discipline,35,22,13
stormrage,1446,priest,discipline,42,26,16
moon-guard,1444,priest,discipline,78,35,43
quelthalas,1443,priest,discipline,66,31,35
tichondrius,1442,priest,discipline,84,44,40
draenor,1441,priest,discipline,45,26,19
tichondrius,1441,priest,discipline,54,26,28
boulderfist,1440,priest,discipline,42,20,22
moon-guard,1439,priest,discipline,148,87,61
darkspear,1439,priest,discipline,30,15,15
malganis,1438,priest,discipline,18,15,3
tichondrius,1438,priest,discipline,30,15,15
malganis,1438,priest,discipline,92,42,50
blackrock,1437,priest,discipline,24,15,9
tichondrius,1437,priest,discipline,44,22,22
area-52,1437,priest,discipline,42,21,21
tichondrius,1437,priest,discipline,54,21,33
ragnaros,1436,priest,discipline,151,64,87
the-forgotten-coast,1435,priest,discipline,44,25,19
malganis,1435,priest,discipline,63,32,31
wyrmrest-accord,1435,priest,discipline,30,15,15
proudmoore,1434,priest,discipline,18,15,3
quelthalas,1434,priest,discipline,42,24,18
onyxia,1434,priest,discipline,36,15,21
bleeding-hollow,1433,priest,discipline,36,15,21
illidan,1432,priest,discipline,60,40,20
malganis,1432,priest,discipline,36,18,18
tichondrius,1430,priest,discipline,36,15,21
stormrage,1429,priest,discipline,24,15,9
stormrage,1429,priest,discipline,184,99,85
kiljaeden,1429,priest,discipline,50,23,27
whisperwind,1428,priest,discipline,50,22,28
zuljin,1427,priest,discipline,29,16,13
tichondrius,1427,priest,discipline,48,26,22
barthilas,1424,priest,discipline,27,18,9
antonidas,1424,priest,discipline,30,15,15
barthilas,1424,priest,discipline,36,15,21
tichondrius,1422,priest,discipline,48,25,23
barthilas,1422,priest,discipline,51,17,34
illidan,1421,priest,discipline,48,24,24
frostmourne,1420,priest,discipline,24,16,8
arygos,1420,priest,discipline,24,15,9
quelthalas,1420,priest,discipline,49,26,23
stormrage,1419,priest,discipline,30,15,15
tichondrius,1418,priest,discipline,24,15,9
ragnaros,1418,priest,discipline,88,40,48
proudmoore,1418,priest,discipline,42,19,23
dragonmaw,1416,priest,discipline,42,23,19
dalaran,1416,priest,discipline,56,27,29
quelthalas,1414,priest,discipline,98,43,55
sargeras,1414,priest,discipline,41,15,26
tichondrius,1413,priest,discipline,59,33,26
chogall,1409,priest,discipline,119,63,56
ysera,1409,priest,discipline,36,15,21
frostmourne,1408,priest,discipline,62,33,29
goldrinn,1407,priest,discipline,101,54,47
tichondrius,1407,priest,discipline,78,41,37
area-52,1407,priest,discipline,48,19,29
tichondrius,1405,priest,discipline,71,34,37
the-underbog,1404,priest,discipline,60,37,23
sargeras,1404,priest,discipline,32,16,16
tichondrius,1403,priest,discipline,48,28,20
frostmourne,1403,priest,discipline,59,34,25
area-52,1403,priest,discipline,106,59,47
laughing-skull,1402,priest,discipline,34,17,17
malganis,1400,priest,discipline,67,41,26
nemesis,1400,priest,discipline,68,37,31
tichondrius,1400,priest,discipline,78,42,36
kiljaeden,1400,priest,discipline,58,29,29
nemesis,1400,priest,discipline,30,15,15
quelthalas,1400,priest,discipline,42,19,23
sargeras,1399,priest,discipline,34,17,17
thrall,1399,priest,discipline,103,51,52
korgath,1399,priest,discipline,54,24,30
boulderfist,1398,priest,discipline,106,46,60
azralon,1396,priest,discipline,84,47,37
illidan,1396,priest,discipline,36,18,18
dawnbringer,1394,priest,discipline,29,15,14
malganis,1393,priest,discipline,99,44,55
tichondrius,1392,priest,discipline,35,21,14
illidan,1392,priest,discipline,66,38,28
tichondrius,1392,priest,discipline,70,27,43
tichondrius,1390,priest,discipline,356,185,171
sargeras,1386,priest,discipline,66,37,29
tichondrius,1384,priest,discipline,59,36,23
stormrage,1384,priest,discipline,42,23,19
dalaran,1383,priest,discipline,78,41,37
frostmourne,1382,priest,discipline,89,49,40
sargeras,1382,priest,discipline,105,48,57
bleeding-hollow,1379,priest,discipline,42,21,21
illidan,1378,priest,discipline,72,35,37
stormrage,1376,priest,discipline,29,17,12
zuljin,1374,priest,discipline,60,26,34
zuljin,1373,priest,discipline,30,20,10
azralon,1373,priest,discipline,91,50,41
gundrak,1373,priest,discipline,53,27,26
elune,1371,priest,discipline,90,56,34
burning-legion,1371,priest,discipline,44,19,25
daggerspine,1371,priest,discipline,53,15,38
silvermoon,1370,priest,discipline,36,17,19
demon-soul,1368,priest,discipline,39,16,23
quelthalas,1366,priest,discipline,41,25,16
stormrage,1365,priest,discipline,76,44,32
moon-guard,1365,priest,discipline,131,67,64
malganis,1364,priest,discipline,42,20,22
dragonmaw,1363,priest,discipline,90,49,41
stormrage,1362,priest,discipline,66,34,32
azralon,1361,priest,discipline,39,27,12
sargeras,1361,priest,discipline,68,27,41
drakkari,1360,priest,discipline,57,37,20
dalaran,1359,priest,discipline,48,21,27
stormrage,1358,priest,discipline,19,15,4
stormrage,1358,priest,discipline,70,41,29
drakkari,1358,priest,discipline,42,23,19
tichondrius,1358,priest,discipline,227,103,124
emerald-dream,1357,priest,discipline,42,18,24
aerie-peak,1356,priest,discipline,48,29,19
dalaran,1356,priest,discipline,68,36,32
quelthalas,1356,priest,discipline,52,24,28
skywall,1355,priest,discipline,42,26,16
tichondrius,1354,priest,discipline,48,24,24
gurubashi,1352,priest,discipline,106,52,54
ragnaros,1352,priest,discipline,66,31,35
stormrage,1348,priest,discipline,156,68,88
hyjal,1347,priest,discipline,35,22,13
ragnaros,1347,priest,discipline,51,18,33
suramar,1345,priest,discipline,44,19,25
skywall,1344,priest,discipline,88,52,36
ragnaros,1344,priest,discipline,72,36,36
stormrage,1344,priest,discipline,90,44,46
tichondrius,1343,priest,discipline,36,18,18
tichondrius,1343,priest,discipline,35,14,21
thaurissan,1342,priest,discipline,42,27,15
illidan,1342,priest,discipline,24,14,10
malganis,1342,priest,discipline,24,14,10
moon-guard,1341,priest,discipline,24,14,10
ragnaros,1341,priest,discipline,30,15,15
stormrage,1341,priest,discipline,60,26,34
malganis,1340,priest,discipline,30,14,16
tichondrius,1340,priest,discipline,36,16,20
tichondrius,1339,priest,discipline,36,14,22
quelthalas,1338,priest,discipline,101,52,49
proudmoore,1337,priest,discipline,18,14,4
tichondrius,1337,priest,discipline,24,14,10
barthilas,1336,priest,discipline,48,26,22
area-52,1336,priest,discipline,36,15,21
tichondrius,1335,priest,discipline,24,14,10
tichondrius,1333,priest,discipline,24,14,10
trollbane,1333,priest,discipline,89,35,54
emerald-dream,1332,priest,discipline,54,33,21
laughing-skull,1330,priest,discipline,44,27,17
skywall,1330,priest,discipline,36,14,22
illidan,1329,priest,discipline,71,42,29
shadowsong,1329,priest,discipline,88,44,44
frostmourne,1328,priest,discipline,39,19,20
tichondrius,1328,priest,discipline,30,14,16
barthilas,1327,priest,discipline,48,34,14
gurubashi,1327,priest,discipline,84,50,34
azralon,1326,priest,discipline,34,20,14
gurubashi,1325,priest,discipline,18,14,4
sargeras,1325,priest,discipline,36,14,22
black-dragonflight,1324,priest,discipline,24,14,10
frostmourne,1323,priest,discipline,64,36,28
tichondrius,1322,priest,discipline,30,14,16
zuljin,1321,priest,discipline,30,14,16
ragnaros,1320,priest,discipline,75,39,36
tichondrius,1319,priest,discipline,24,14,10
moon-guard,1319,priest,discipline,65,35,30
blackwing-lair,1319,priest,discipline,78,38,40
kelthuzad,1319,priest,discipline,32,15,17
tichondrius,1318,priest,discipline,86,42,44
sargeras,1316,priest,discipline,66,40,26
tichondrius,1315,priest,discipline,24,14,10
quelthalas,1312,priest,discipline,47,18,29
zuljin,1311,priest,discipline,36,23,13
aegwynn,1311,priest,discipline,36,14,22
ragnaros,1310,priest,discipline,113,60,53
moon-guard,1309,priest,discipline,30,14,16
sargeras,1308,priest,discipline,28,15,13
nemesis,1308,priest,discipline,72,37,35
muradin,1308,priest,discipline,54,27,27
ragnaros,1305,priest,discipline,54,28,26
ragnaros,1304,priest,discipline,35,14,21
tichondrius,1303,priest,discipline,36,18,18
sargeras,1301,priest,discipline,30,19,11
gurubashi,1301,priest,discipline,27,16,11
ysera,1301,priest,discipline,42,22,20
tichondrius,1300,priest,discipline,60,33,27
area-52,1298,priest,discipline,51,24,27
tichondrius,1297,priest,discipline,37,21,16
hyjal,1295,priest,discipline,60,42,18
bonechewer,1292,priest,discipline,42,25,17
illidan,1292,priest,discipline,56,26,30
barthilas,1291,priest,discipline,108,59,49
proudmoore,1290,priest,discipline,30,15,15
illidan,1290,priest,discipline,113,49,64
illidan,1288,priest,discipline,29,14,15
quelthalas,1287,priest,discipline,208,106,102
bleeding-hollow,1286,priest,discipline,24,15,9
stormrage,1286,priest,discipline,38,23,15
stormrage,1286,priest,discipline,133,72,61
senjin,1286,priest,discipline,30,16,14
drakkari,1285,priest,discipline,72,36,36
moon-guard,1283,priest,discipline,24,16,8
destromath,1283,priest,discipline,60,25,35
kelthuzad,1282,priest,discipline,30,20,10
area-52,1281,priest,discipline,54,21,33
moon-guard,1280,priest,discipline,90,46,44
tichondrius,1279,priest,discipline,61,30,31
azralon,1278,priest,discipline,30,15,15
thrall,1276,priest,discipline,36,20,16
darkspear,1275,priest,discipline,42,24,18
lightnings-blade,1275,priest,discipline,107,55,52
burning-blade,1275,priest,discipline,28,14,14
illidan,1272,priest,discipline,21,15,6
frostmourne,1271,priest,discipline,24,15,9
area-52,1270,priest,discipline,42,23,19
quelthalas,1270,priest,discipline,30,16,14
shadowmoon,1270,priest,discipline,54,23,31
ragnaros,1269,priest,discipline,76,41,35
azshara,1266,priest,discipline,30,16,14
frostmourne,1266,priest,discipline,36,18,18
ragnaros,1263,priest,discipline,31,15,16
sargeras,1258,priest,discipline,25,14,11
aegwynn,1258,priest,discipline,161,83,78
tichondrius,1258,priest,discipline,87,37,50
nemesis,1257,priest,discipline,64,30,34
akama,1257,priest,discipline,107,46,61
bleeding-hollow,1254,priest,discipline,36,23,13
sargeras,1250,priest,discipline,40,23,17
dalaran,1250,priest,discipline,28,15,13
quelthalas,1250,priest,discipline,150,68,82
area-52,1249,priest,discipline,48,28,20
tichondrius,1249,priest,discipline,42,19,23
stormrage,1248,priest,discipline,24,13,11
winterhoof,1247,priest,discipline,18,13,5
kelthuzad,1247,priest,discipline,18,13,5
blood-furnace,1247,priest,discipline,24,13,11
quelthalas,1247,priest,discipline,50,26,24
korialstrasz,1247,priest,discipline,34,13,21
frostmourne,1246,priest,discipline,24,13,11
kelthuzad,1245,priest,discipline,36,22,14
tichondrius,1245,priest,discipline,24,13,11
stormrage,1245,priest,discipline,24,13,11
nemesis,1244,priest,discipline,30,14,16
magtheridon,1243,priest,discipline,30,13,17
quelthalas,1243,priest,discipline,36,13,23
tichondrius,1242,priest,discipline,24,13,11
tichondrius,1242,priest,discipline,25,13,12
frostmourne,1242,priest,discipline,54,26,28
jubeithos,1242,priest,discipline,48,23,25
burning-legion,1241,priest,discipline,24,13,11
wyrmrest-accord,1241,priest,discipline,78,30,48
area-52,1240,priest,discipline,24,13,11
tanaris,1239,priest,discipline,21,15,6
bleeding-hollow,1239,priest,discipline,54,26,28
ragnaros,1239,priest,discipline,30,13,17
emerald-dream,1239,priest,discipline,30,13,17
barthilas,1237,priest,discipline,24,15,9
thrall,1237,priest,discipline,52,26,26
eitrigg,1237,priest,discipline,84,40,44
bleeding-hollow,1237,priest,discipline,30,13,17
azralon,1234,priest,discipline,30,13,17
stormscale,1233,priest,discipline,88,39,49
barthilas,1231,priest,discipline,18,13,5
tichondrius,1231,priest,discipline,24,13,11
azralon,1231,priest,discipline,124,64,60
shadowsong,1231,priest,discipline,53,25,28
bleeding-hollow,1231,priest,discipline,36,13,23
frostmourne,1230,priest,discipline,42,25,17
azgalor,1230,priest,discipline,24,13,11
stormrage,1228,priest,discipline,30,17,13
destromath,1228,priest,discipline,60,31,29
frostmourne,1227,priest,discipline,24,13,11
hakkar,1225,priest,discipline,24,13,11
drakkari,1223,priest,discipline,30,13,17
ragnaros,1223,priest,discipline,60,18,42
kelthuzad,1222,priest,discipline,30,15,15
tichondrius,1219,priest,discipline,36,21,15
tichondrius,1218,priest,discipline,54,25,29
dathremar,1217,priest,discipline,55,20,35
wyrmrest-accord,1214,priest,discipline,93,42,51
stonemaul,1213,priest,discipline,43,21,22
tichondrius,1210,priest,discipline,42,24,18
stormrage,1209,priest,discipline,32,14,18
sargeras,1209,priest,discipline,36,13,23
frostmourne,1208,priest,discipline,75,37,38
emerald-dream,1206,priest,discipline,18,13,5
frostmourne,1206,priest,discipline,26,14,12
azralon,1206,priest,discipline,66,29,37
zuluhed,1204,priest,discipline,24,18,6
moon-guard,1203,priest,discipline,67,32,35
illidan,1201,priest,discipline,30,18,12
dragonmaw,1201,priest,discipline,73,28,45
andorhal,1198,priest,discipline,36,19,17
area-52,1194,priest,discipline,62,33,29
illidan,1192,priest,discipline,23,13,10
dragonblight,1188,priest,discipline,42,17,25
tichondrius,1187,priest,discipline,29,20,9
moon-guard,1187,priest,discipline,44,23,21
dalaran,1182,priest,discipline,24,14,10
frostmourne,1181,priest,discipline,42,21,21
hyjal,1181,priest,discipline,35,15,20
dalaran,1178,priest,discipline,30,13,17
moon-guard,1175,priest,discipline,29,14,15
ragnaros,1175,priest,discipline,102,45,57
anvilmar,1174,priest,discipline,36,20,16
bleeding-hollow,1173,priest,discipline,68,30,38
stormrage,1172,priest,discipline,23,13,10
gilneas,1172,priest,discipline,36,18,18
zangarmarsh,1169,priest,discipline,54,27,27
frostmane,1169,priest,discipline,160,79,81
sargeras,1169,priest,discipline,42,20,22
tichondrius,1167,priest,discipline,17,13,4
zuljin,1162,priest,discipline,74,43,31
area-52,1160,priest,discipline,36,17,19
illidan,1159,priest,discipline,24,14,10
kelthuzad,1158,priest,discipline,24,13,11
moon-guard,1158,priest,discipline,30,13,17
tichondrius,1157,priest,discipline,22,14,8
dalaran,1157,priest,discipline,23,13,10
uldum,1157,priest,discipline,32,14,18
illidan,1156,priest,discipline,24,16,8
stormrage,1153,priest,discipline,26,13,13
tichondrius,1153,priest,discipline,71,35,36
tichondrius,1152,priest,discipline,18,12,6
tichondrius,1152,priest,discipline,18,12,6
tichondrius,1152,priest,discipline,18,12,6
frostmourne,1152,priest,discipline,24,12,12
kelthuzad,1152,priest,discipline,24,12,12
illidan,1152,priest,discipline,24,12,12
illidan,1152,priest,discipline,30,12,18
tichondrius,1151,priest,discipline,12,12,0
proudmoore,1151,priest,discipline,18,12,6
nemesis,1151,priest,discipline,18,12,6
emerald-dream,1151,priest,discipline,18,12,6
stormrage,1151,priest,discipline,24,12,12
tichondrius,1151,priest,discipline,24,12,12
bleeding-hollow,1151,priest,discipline,24,12,12
warsong,1151,priest,discipline,25,12,13
illidan,1151,priest,discipline,36,12,24
illidan,1150,priest,discipline,12,12,0
dreadmaul,1150,priest,discipline,18,12,6
malganis,1150,priest,discipline,25,12,13
bleeding-hollow,1150,priest,discipline,42,17,25
jubeithos,1150,priest,discipline,36,12,24
tichondrius,1149,priest,discipline,18,12,6
tichondrius,1149,priest,discipline,18,12,6
tichondrius,1149,priest,discipline,24,12,12
sargeras,1148,priest,discipline,24,12,12
tichondrius,1148,priest,discipline,24,12,12
illidan,1148,priest,discipline,30,12,18
illidan,1147,priest,discipline,25,13,12
bleeding-hollow,1147,priest,discipline,24,12,12
thrall,1147,priest,discipline,24,12,12
kiljaeden,1147,priest,discipline,30,12,18
garrosh,1146,priest,discipline,12,12,0
zuljin,1146,priest,discipline,24,12,12
frostmourne,1146,priest,discipline,36,12,24
darkspear,1145,priest,discipline,24,12,12
tichondrius,1144,priest,discipline,18,12,6
thrall,1144,priest,discipline,18,12,6
aerie-peak,1144,priest,discipline,24,13,11
sargeras,1143,priest,discipline,24,12,12
moon-guard,1143,priest,discipline,24,12,12
wyrmrest-accord,1143,priest,discipline,24,12,12
ragnaros,1143,priest,discipline,36,14,22
tichondrius,1142,priest,discipline,18,12,6
moon-guard,1142,priest,discipline,24,12,12
bleeding-hollow,1142,priest,discipline,36,12,24
doomhammer,1138,priest,discipline,104,51,53
area-52,1137,priest,discipline,31,13,18
hyjal,1137,priest,discipline,36,12,24
nagrand,1136,priest,discipline,60,30,30
thrall,1136,priest,discipline,36,12,24
aerie-peak,1135,priest,discipline,66,34,32
korgath,1134,priest,discipline,58,31,27
kelthuzad,1134,priest,discipline,29,12,17
quelthalas,1133,priest,discipline,18,12,6
stormreaver,1133,priest,discipline,24,12,12
illidan,1131,priest,discipline,48,22,26
thrall,1129,priest,discipline,30,12,18
greymane,1128,priest,discipline,24,12,12
tichondrius,1127,priest,discipline,52,29,23
warsong,1127,priest,discipline,30,12,18
greymane,1127,priest,discipline,42,13,29
emerald-dream,1126,priest,discipline,36,19,17
stormrage,1125,priest,discipline,22,13,9
turalyon,1121,priest,discipline,24,12,12
black-dragonflight,1119,priest,discipline,24,14,10
illidan,1117,priest,discipline,75,42,33
kelthuzad,1116,priest,discipline,18,12,6
stormrage,1115,priest,discipline,24,12,12
nagrand,1114,priest,discipline,30,13,17
bonechewer,1112,priest,discipline,24,16,8
fizzcrank,1112,priest,discipline,30,14,16
tichondrius,1108,priest,discipline,69,38,31
area-52,1107,priest,discipline,36,14,22
anubarak,1105,priest,discipline,54,26,28
sargeras,1103,priest,discipline,21,13,8
quelthalas,1103,priest,discipline,83,39,44
chogall,1100,priest,discipline,75,37,38
kelthuzad,1100,priest,discipline,30,12,18
frostmourne,1099,priest,discipline,51,26,25
stormrage,1097,priest,discipline,30,15,15
quelthalas,1096,priest,discipline,23,12,11
malfurion,1095,priest,discipline,23,12,11
dalaran,1095,priest,discipline,29,12,17
sargeras,1094,priest,discipline,21,13,8
hyjal,1088,priest,discipline,34,20,14
tichondrius,1087,priest,discipline,22,12,10
frostwolf,1086,priest,discipline,30,14,16
illidan,1085,priest,discipline,37,19,18
kirin-tor,1083,priest,discipline,66,38,28
gurubashi,1083,priest,discipline,29,15,14
tichondrius,1081,priest,discipline,47,30,17
balnazzar,1080,priest,discipline,24,15,9
blood-furnace,1071,priest,discipline,90,42,48
dreadmaul,1069,priest,discipline,40,20,20
the-venture-co,1067,priest,discipline,17,12,5
proudmoore,1065,priest,discipline,25,12,13
azralon,1062,priest,discipline,23,12,11
stormrage,1062,priest,discipline,31,12,19
stormrage,1056,priest,discipline,18,11,7
zuljin,1056,priest,discipline,18,11,7
tichondrius,1056,priest,discipline,18,11,7
tichondrius,1056,priest,discipline,18,11,7
bleeding-hollow,1056,priest,discipline,24,11,13
kelthuzad,1056,priest,discipline,24,11,13
tichondrius,1056,priest,discipline,24,11,13
crushridge,1056,priest,discipline,30,11,19
tichondrius,1055,priest,discipline,12,11,1
illidan,1055,priest,discipline,18,11,7
illidan,1055,priest,discipline,18,11,7
zuljin,1055,priest,discipline,24,11,13
stormreaver,1055,priest,discipline,24,11,13
lightnings-blade,1055,priest,discipline,24,11,13
stormrage,1055,priest,discipline,24,11,13
tichondrius,1055,priest,discipline,24,11,13
illidan,1054,priest,discipline,12,11,1
malganis,1054,priest,discipline,16,12,4
proudmoore,1054,priest,discipline,18,11,7
area-52,1054,priest,discipline,18,11,7
sargeras,1054,priest,discipline,24,11,13
kelthuzad,1054,priest,discipline,24,11,13
zuljin,1053,priest,discipline,18,11,7
ragnaros,1053,priest,discipline,18,11,7
ragnaros,1053,priest,discipline,30,11,19
bleeding-hollow,1052,priest,discipline,18,11,7
ragnaros,1052,priest,discipline,18,11,7
area-52,1052,priest,discipline,24,12,12
frostmourne,1052,priest,discipline,24,11,13
draka,1052,priest,discipline,24,11,13
emerald-dream,1051,priest,discipline,18,11,7
tichondrius,1051,priest,discipline,54,25,29
dalaran,1051,priest,discipline,24,11,13
tichondrius,1051,priest,discipline,24,11,13
area-52,1051,priest,discipline,24,11,13
quelthalas,1051,priest,discipline,30,11,19
laughing-skull,1050,priest,discipline,18,11,7
darkspear,1050,priest,discipline,24,11,13
tichondrius,1050,priest,discipline,30,11,19
area-52,1050,priest,discipline,42,12,30
emerald-dream,1049,priest,discipline,18,11,7
bleeding-hollow,1049,priest,discipline,24,11,13
tichondrius,1048,priest,discipline,18,11,7
kelthuzad,1048,priest,discipline,24,11,13
magtheridon,1047,priest,discipline,30,11,19
tichondrius,1046,priest,discipline,24,11,13
azralon,1044,priest,discipline,18,11,7
proudmoore,1044,priest,discipline,24,11,13
tichondrius,1043,priest,discipline,18,11,7
stormrage,1043,priest,discipline,24,11,13
tichondrius,1043,priest,discipline,107,47,60
tichondrius,1042,priest,discipline,27,13,14
laughing-skull,1042,priest,discipline,30,11,19
area-52,1040,priest,discipline,12,11,1
tichondrius,1039,priest,discipline,28,13,15
hydraxis,1038,priest,discipline,66,31,35
area-52,1038,priest,discipline,30,11,19
kelthuzad,1036,priest,discipline,30,15,15
moon-guard,1035,priest,discipline,19,12,7
queldorei,1035,priest,discipline,18,11,7
hakkar,1033,priest,discipline,48,19,29
tichondrius,1032,priest,discipline,24,11,13
illidan,1030,priest,discipline,65,30,35
mugthol,1027,priest,discipline,36,22,14
nemesis,1024,priest,discipline,24,11,13
nemesis,1023,priest,discipline,28,17,11
zuljin,1023,priest,discipline,30,14,16
kelthuzad,1023,priest,discipline,28,12,16
kelthuzad,1022,priest,discipline,16,12,4
bleeding-hollow,1021,priest,discipline,20,12,8
scarlet-crusade,1020,priest,discipline,30,12,18
tichondrius,1019,priest,discipline,22,12,10
uldaman,1019,priest,discipline,24,11,13
malganis,1018,priest,discipline,45,24,21
stormrage,1016,priest,discipline,26,12,14
stormrage,1015,priest,discipline,23,11,12
stormrage,1014,priest,discipline,24,12,12
wyrmrest-accord,1012,priest,discipline,65,33,32
blackwing-lair,1010,priest,discipline,32,13,19
kelthuzad,1009,priest,discipline,24,11,13
azralon,1007,priest,discipline,24,11,13
tichondrius,1006,priest,discipline,36,14,22
tichondrius,1005,priest,discipline,28,12,16
emerald-dream,1003,priest,discipline,23,11,12
bleeding-hollow,1003,priest,discipline,23,11,12
ragnaros,1001,priest,discipline,21,11,10
ragnaros,995,priest,discipline,22,15,7
drakkari,990,priest,discipline,26,11,15
dalaran,987,priest,discipline,26,11,15
tichondrius,977,priest,discipline,26,16,10
ragnaros,977,priest,discipline,24,11,13
bleeding-hollow,976,priest,discipline,18,11,7
tichondrius,969,priest,discipline,102,49,53
sargeras,969,priest,discipline,31,12,19
frostmourne,965,priest,discipline,33,17,16
tichondrius,961,priest,discipline,52,18,34
skullcrusher,960,priest,discipline,12,10,2
stormrage,960,priest,discipline,15,11,4
tichondrius,960,priest,discipline,18,11,7
tichondrius,960,priest,discipline,18,10,8
illidan,960,priest,discipline,18,10,8
illidan,960,priest,discipline,18,10,8
tichondrius,960,priest,discipline,18,10,8
tichondrius,960,priest,discipline,18,10,8
barthilas,960,priest,discipline,18,10,8
chogall,960,priest,discipline,18,10,8
executus,960,priest,discipline,18,10,8
tichondrius,960,priest,discipline,18,10,8
gorefiend,960,priest,discipline,18,10,8
tichondrius,960,priest,discipline,18,10,8
moon-guard,960,priest,discipline,57,29,28
stormrage,960,priest,discipline,24,10,14
tichondrius,960,priest,discipline,24,10,14
illidan,960,priest,discipline,24,10,14
the-underbog,960,priest,discipline,24,10,14
tichondrius,960,priest,discipline,24,10,14
frostmourne,960,priest,discipline,27,10,17
tichondrius,960,priest,discipline,30,10,20
ragnaros,960,priest,discipline,30,10,20
bleeding-hollow,959,priest,discipline,12,10,2
stormrage,959,priest,discipline,12,10,2
illidan,959,priest,discipline,18,10,8
destromath,959,priest,discipline,18,10,8
tichondrius,959,priest,discipline,18,10,8
tichondrius,959,priest,discipline,18,10,8
sargeras,959,priest,discipline,18,10,8
alleria,959,priest,discipline,18,10,8
sargeras,959,priest,discipline,18,10,8
uldum,959,priest,discipline,24,10,14
tichondrius,959,priest,discipline,24,10,14
shadowsong,959,priest,discipline,24,10,14
tichondrius,959,priest,discipline,24,10,14
nemesis,959,priest,discipline,24,10,14
ragnaros,959,priest,discipline,30,10,20
bleeding-hollow,959,priest,discipline,30,10,20
tichondrius,958,priest,discipline,18,10,8
sargeras,958,priest,discipline,18,10,8
queldorei,958,priest,discipline,18,10,8
farstriders,958,priest,discipline,24,10,14
tichondrius,958,priest,discipline,24,10,14
sargeras,958,priest,discipline,24,10,14
tichondrius,958,priest,discipline,30,10,20
sargeras,957,priest,discipline,18,10,8
frostmourne,957,priest,discipline,30,10,20
azralon,956,priest,discipline,12,10,2
tichondrius,956,priest,discipline,18,10,8
khazgoroth,955,priest,discipline,18,10,8
skullcrusher,955,priest,discipline,24,10,14
moon-guard,955,priest,discipline,93,30,63
lightnings-blade,954,priest,discipline,18,10,8
sargeras,954,priest,discipline,18,10,8
tichondrius,954,priest,discipline,24,10,14
hyjal,954,priest,discipline,24,10,14
stormrage,953,priest,discipline,18,10,8
azgalor,953,priest,discipline,24,10,14
tichondrius,952,priest,discipline,18,10,8
malganis,952,priest,discipline,18,10,8
sargeras,952,priest,discipline,30,11,19
black-dragonflight,951,priest,discipline,18,10,8
lightnings-blade,951,priest,discipline,24,10,14
frostmourne,951,priest,discipline,24,10,14
azralon,948,priest,discipline,12,10,2
korgath,948,priest,discipline,24,10,14
magtheridon,946,priest,discipline,24,10,14
stormrage,944,priest,discipline,72,36,36
maiev,943,priest,discipline,24,10,14
tichondrius,942,priest,discipline,18,12,6
tichondrius,932,priest,discipline,30,10,20
stormreaver,927,priest,discipline,20,11,9
stormrage,927,priest,discipline,20,11,9
ragnaros,904,priest,discipline,20,11,9
tichondrius,904,priest,discipline,21,11,10
azgalor,903,priest,discipline,54,26,28
dark-iron,901,priest,discipline,23,10,13
frostmourne,895,priest,discipline,26,10,16
area-52,891,priest,discipline,17,10,7
tichondrius,889,priest,discipline,17,10,7
maelstrom,882,priest,discipline,89,45,44
barthilas,878,priest,discipline,42,20,22
blackhand,864,priest,discipline,12,9,3
thunderlord,864,priest,discipline,12,9,3
tichondrius,864,priest,discipline,12,9,3
illidan,864,priest,discipline,12,9,3
garrosh,864,priest,discipline,15,9,6
stormrage,864,priest,discipline,18,9,9
suramar,864,priest,discipline,18,9,9
tichondrius,864,priest,discipline,18,9,9
darkspear,864,priest,discipline,18,9,9
ragnaros,864,priest,discipline,18,9,9
area-52,864,priest,discipline,24,9,15
malganis,864,priest,discipline,24,9,15
dark-iron,864,priest,discipline,24,9,15
sargeras,864,priest,discipline,24,9,15
bleeding-hollow,864,priest,discipline,24,9,15
tichondrius,864,priest,discipline,36,9,27
gorefiend,863,priest,discipline,12,9,3
emerald-dream,863,priest,discipline,12,9,3
illidan,863,priest,discipline,12,9,3
lightnings-blade,863,priest,discipline,12,9,3
tichondrius,863,priest,discipline,12,9,3
tichondrius,863,priest,discipline,12,9,3
azralon,863,priest,discipline,12,9,3
tichondrius,863,priest,discipline,12,9,3
moon-guard,863,priest,discipline,12,9,3
bonechewer,863,priest,discipline,18,9,9
bleeding-hollow,863,priest,discipline,18,9,9
tichondrius,863,priest,discipline,18,9,9
azralon,863,priest,discipline,18,9,9
barthilas,863,priest,discipline,18,9,9
ragnaros,863,priest,discipline,18,9,9
frostmourne,863,priest,discipline,24,9,15
tichondrius,863,priest,discipline,24,9,15
dalaran,862,priest,discipline,13,9,4
stormscale,862,priest,discipline,18,9,9
frostmourne,862,priest,discipline,18,9,9
tichondrius,862,priest,discipline,18,9,9
terokkar,862,priest,discipline,18,9,9
tichondrius,862,priest,discipline,18,9,9
destromath,862,priest,discipline,18,9,9
tichondrius,862,priest,discipline,18,9,9
illidan,862,priest,discipline,18,9,9
area-52,862,priest,discipline,18,9,9
quelthalas,861,priest,discipline,18,9,9
proudmoore,861,priest,discipline,24,9,15
proudmoore,860,priest,discipline,19,11,8
illidan,860,priest,discipline,18,9,9
burning-blade,860,priest,discipline,18,9,9
area-52,860,priest,discipline,20,9,11
frostmourne,859,priest,discipline,18,9,9
tichondrius,859,priest,discipline,18,9,9
emerald-dream,859,priest,discipline,18,9,9
emerald-dream,859,priest,discipline,24,9,15
azshara,859,priest,discipline,25,9,16
hellscream,858,priest,discipline,24,9,15
kalecgos,857,priest,discipline,12,9,3
area-52,857,priest,discipline,14,10,4
azralon,856,priest,discipline,12,9,3
malganis,856,priest,discipline,18,9,9
quelthalas,856,priest,discipline,24,9,15
scilla,854,priest,discipline,42,18,24
tichondrius,853,priest,discipline,12,9,3
alleria,846,priest,discipline,12,9,3
illidan,841,priest,discipline,30,9,21
tichondrius,832,priest,discipline,55,20,35
tichondrius,832,priest,discipline,28,9,19
zuljin,831,priest,discipline,14,11,3
aggramar,831,priest,discipline,12,9,3
ragnaros,830,priest,discipline,17,9,8
sargeras,814,priest,discipline,29,9,20
chogall,813,priest,discipline,15,10,5
bleeding-hollow,813,priest,discipline,17,9,8
bleeding-hollow,804,priest,discipline,31,12,19
moon-guard,800,priest,discipline,16,9,7
tichondrius,799,priest,discipline,28,9,19
azralon,796,priest,discipline,14,9,5
burning-legion,796,priest,discipline,16,9,7
medivh,783,priest,discipline,23,9,14
sargeras,775,priest,discipline,24,12,12
tichondrius,768,priest,discipline,12,8,4
trollbane,768,priest,discipline,12,8,4
area-52,768,priest,discipline,12,8,4
stormrage,768,priest,discipline,12,8,4
illidan,768,priest,discipline,12,8,4
kelthuzad,768,priest,discipline,12,8,4
emerald-dream,768,priest,discipline,12,8,4
kelthuzad,768,priest,discipline,12,8,4
stormrage,768,priest,discipline,12,8,4
tichondrius,768,priest,discipline,12,8,4
tichondrius,768,priest,discipline,12,8,4
tichondrius,768,priest,discipline,12,8,4
dathremar,768,priest,discipline,12,8,4
tichondrius,768,priest,discipline,12,8,4
tichondrius,768,priest,discipline,12,8,4
the-scryers,768,priest,discipline,12,8,4
zuljin,768,priest,discipline,12,8,4
tichondrius,768,priest,discipline,12,8,4
emerald-dream,768,priest,discipline,12,8,4
tichondrius,768,priest,discipline,12,8,4
area-52,768,priest,discipline,12,8,4
bleeding-hollow,768,priest,discipline,12,8,4
dalaran,768,priest,discipline,12,8,4
kelthuzad,768,priest,discipline,12,8,4
sargeras,768,priest,discipline,16,9,7
frostmourne,768,priest,discipline,18,8,10
tichondrius,768,priest,discipline,18,8,10
area-52,768,priest,discipline,18,8,10
tichondrius,768,priest,discipline,18,8,10
bleeding-hollow,768,priest,discipline,18,8,10
tichondrius,768,priest,discipline,18,8,10
ragnaros,768,priest,discipline,18,8,10
malganis,768,priest,discipline,18,8,10
emerald-dream,768,priest,discipline,18,8,10
illidan,768,priest,discipline,18,8,10
tichondrius,768,priest,discipline,18,8,10
tichondrius,768,priest,discipline,18,8,10
ragnaros,768,priest,discipline,18,8,10
sargeras,768,priest,discipline,18,8,10
malganis,768,priest,discipline,18,8,10
bleeding-hollow,768,priest,discipline,27,9,18
shuhalo,768,priest,discipline,24,8,16
dunemaul,767,priest,discipline,12,8,4
sargeras,767,priest,discipline,12,8,4
area-52,767,priest,discipline,12,8,4
khadgar,767,priest,discipline,12,8,4
tichondrius,767,priest,discipline,12,8,4
tichondrius,767,priest,discipline,12,8,4
frostmourne,767,priest,discipline,12,8,4
darkspear,767,priest,discipline,12,8,4
tichondrius,767,priest,discipline,12,8,4
tichondrius,767,priest,discipline,12,8,4
stormrage,767,priest,discipline,12,8,4
chogall,767,priest,discipline,12,8,4
illidan,767,priest,discipline,12,8,4
malganis,767,priest,discipline,12,8,4
doomhammer,767,priest,discipline,12,8,4
drakkari,767,priest,discipline,12,8,4
ragnaros,767,priest,discipline,12,8,4
moon-guard,767,priest,discipline,18,8,10
frostmourne,767,priest,discipline,18,8,10
nesingwary,767,priest,discipline,18,8,10
lightbringer,767,priest,discipline,18,8,10
ragnaros,767,priest,discipline,18,8,10
stormrage,767,priest,discipline,18,8,10
dalaran,767,priest,discipline,18,8,10
emerald-dream,767,priest,discipline,24,8,16
bonechewer,767,priest,discipline,24,8,16
blackrock,767,priest,discipline,24,8,16
thrall,767,priest,discipline,24,8,16
azralon,766,priest,discipline,12,8,4
area-52,766,priest,discipline,12,8,4
zuluhed,766,priest,discipline,18,8,10
kul-tiras,766,priest,discipline,18,8,10
area-52,766,priest,discipline,18,8,10
queldorei,766,priest,discipline,33,12,21
tichondrius,765,priest,discipline,12,8,4
dark-iron,763,priest,discipline,12,8,4
alleria,763,priest,discipline,17,8,9
silvermoon,763,priest,discipline,18,8,10
wildhammer,763,priest,discipline,18,8,10
barthilas,763,priest,discipline,18,8,10
tichondrius,762,priest,discipline,18,8,10
whisperwind,761,priest,discipline,24,8,16
sargeras,760,priest,discipline,12,8,4
zuljin,759,priest,discipline,12,8,4
tichondrius,744,priest,discipline,18,8,10
frostmourne,735,priest,discipline,16,8,8
kirin-tor,729,priest,discipline,23,8,15
tichondrius,719,priest,discipline,11,8,3
bloodscalp,719,priest,discipline,17,8,9
frostmourne,719,priest,discipline,17,8,9
area-52,718,priest,discipline,11,8,3
sargeras,718,priest,discipline,17,9,8
stormrage,707,priest,discipline,25,11,14
tichondrius,703,priest,discipline,14,8,6
quelthalas,701,priest,discipline,11,8,3
mannoroth,700,priest,discipline,17,8,9
area-52,684,priest,discipline,17,9,8
frostmourne,672,priest,discipline,12,7,5
moon-guard,672,priest,discipline,12,7,5
illidan,672,priest,discipline,12,7,5
stormrage,672,priest,discipline,12,7,5
spinebreaker,672,priest,discipline,12,7,5
illidan,672,priest,discipline,12,7,5
skywall,672,priest,discipline,12,7,5
moon-guard,672,priest,discipline,12,7,5
illidan,672,priest,discipline,12,7,5
tichondrius,672,priest,discipline,12,7,5
illidan,672,priest,discipline,12,7,5
tichondrius,672,priest,discipline,12,7,5
tichondrius,672,priest,discipline,12,7,5
tichondrius,672,priest,discipline,12,7,5
ragnaros,672,priest,discipline,12,7,5
skullcrusher,672,priest,discipline,12,7,5
area-52,672,priest,discipline,12,7,5
tichondrius,672,priest,discipline,12,7,5
kiljaeden,672,priest,discipline,12,7,5
ragnaros,672,priest,discipline,12,7,5
bleeding-hollow,672,priest,discipline,12,7,5
duskwood,672,priest,discipline,12,7,5
lightnings-blade,672,priest,discipline,12,7,5
tichondrius,672,priest,discipline,12,7,5
nordrassil,672,priest,discipline,12,7,5
korgath,672,priest,discipline,12,7,5
quelthalas,672,priest,discipline,12,7,5
tichondrius,672,priest,discipline,12,7,5
tichondrius,672,priest,discipline,12,7,5
sargeras,672,priest,discipline,12,7,5
cenarion-circle,672,priest,discipline,12,7,5
sargeras,672,priest,discipline,12,7,5
illidan,672,priest,discipline,12,7,5
boulderfist,672,priest,discipline,12,7,5
nemesis,672,priest,discipline,15,7,8
area-52,672,priest,discipline,18,7,11
frostwolf,672,priest,discipline,18,7,11
hydraxis,672,priest,discipline,18,7,11
ragnaros,672,priest,discipline,18,7,11
stormrage,672,priest,discipline,18,7,11
frostmourne,672,priest,discipline,18,7,11
illidan,672,priest,discipline,18,7,11
area-52,672,priest,discipline,18,7,11
illidan,672,priest,discipline,18,7,11
tichondrius,672,priest,discipline,18,7,11
bleeding-hollow,672,priest,discipline,24,7,17
emerald-dream,672,priest,discipline,24,7,17
sargeras,672,priest,discipline,24,7,17
archimonde,672,priest,discipline,24,7,17
drakkari,671,priest,discipline,12,7,5
durotan,671,priest,discipline,12,7,5
darkspear,671,priest,discipline,12,7,5
ysondre,671,priest,discipline,12,7,5
sargeras,671,priest,discipline,12,7,5
kiljaeden,671,priest,discipline,12,7,5
moonrunner,671,priest,discipline,12,7,5
barthilas,671,priest,discipline,12,7,5
malganis,671,priest,discipline,12,7,5
stormrage,671,priest,discipline,12,7,5
proudmoore,671,priest,discipline,12,7,5
sargeras,671,priest,discipline,12,7,5
emerald-dream,671,priest,discipline,12,7,5
burning-blade,671,priest,discipline,12,7,5
quelthalas,671,priest,discipline,12,7,5
stormrage,671,priest,discipline,12,7,5
malganis,671,priest,discipline,12,7,5
tichondrius,671,priest,discipline,18,7,11
tichondrius,671,priest,discipline,18,7,11
dunemaul,671,priest,discipline,18,7,11
sargeras,671,priest,discipline,36,7,29
jubeithos,670,priest,discipline,12,7,5
maiev,670,priest,discipline,12,7,5
proudmoore,670,priest,discipline,12,7,5
akama,670,priest,discipline,12,7,5
sargeras,670,priest,discipline,12,7,5
frostmane,670,priest,discipline,12,7,5
spirestone,670,priest,discipline,12,7,5
lightbringer,670,priest,discipline,12,7,5
tichondrius,670,priest,discipline,12,7,5
stormrage,670,priest,discipline,12,7,5
tichondrius,670,priest,discipline,12,7,5
vashj,670,priest,discipline,12,7,5
tichondrius,670,priest,discipline,12,7,5
emerald-dream,670,priest,discipline,15,8,7
ursin,669,priest,discipline,12,7,5
stormscale,669,priest,discipline,18,7,11
emerald-dream,669,priest,discipline,18,7,11
arygos,668,priest,discipline,12,7,5
ragnaros,668,priest,discipline,18,7,11
thunderlord,668,priest,discipline,19,7,12
sargeras,666,priest,discipline,12,7,5
area-52,666,priest,discipline,18,7,11
tichondrius,665,priest,discipline,12,7,5
alleria,663,priest,discipline,12,7,5
garrosh,658,priest,discipline,12,7,5
area-52,657,priest,discipline,18,7,11
stormrage,655,priest,discipline,12,8,4
sargeras,655,priest,discipline,17,7,10
chogall,640,priest,discipline,16,7,9
eredar,639,priest,discipline,11,7,4
dalaran,639,priest,discipline,14,8,6
zuljin,639,priest,discipline,14,8,6
bleeding-hollow,638,priest,discipline,23,7,16
ghostlands,638,priest,discipline,24,7,17
baelgun,636,priest,discipline,17,7,10
proudmoore,636,priest,discipline,23,7,16
zuljin,634,priest,discipline,23,7,16
stormrage,624,priest,discipline,9,8,1
malganis,624,priest,discipline,13,8,5
dreadmaul,623,priest,discipline,11,7,4
illidan,622,priest,discipline,15,7,8
stormreaver,621,priest,discipline,15,8,7
stormreaver,617,priest,discipline,17,11,6
quelthalas,608,priest,discipline,16,7,9
sargeras,607,priest,discipline,11,7,4
dark-iron,607,priest,discipline,26,7,19
tichondrius,606,priest,discipline,14,7,7
proudmoore,606,priest,discipline,22,7,15
aegwynn,605,priest,discipline,14,7,7
malfurion,591,priest,discipline,11,7,4
stormscale,589,priest,discipline,19,10,9
zuljin,576,priest,discipline,6,6,0
kelthuzad,576,priest,discipline,6,6,0
tichondrius,576,priest,discipline,6,6,0
dalaran,576,priest,discipline,6,6,0
malygos,576,priest,discipline,6,6,0
dalaran,576,priest,discipline,6,6,0
illidan,576,priest,discipline,6,6,0
tichondrius,576,priest,discipline,6,6,0
illidan,576,priest,discipline,6,6,0
tichondrius,576,priest,discipline,6,6,0
tichondrius,576,priest,discipline,6,6,0
zuljin,576,priest,discipline,6,6,0
jubeithos,576,priest,discipline,12,6,6
thrall,576,priest,discipline,12,6,6
khazgoroth,576,priest,discipline,12,6,6
malganis,576,priest,discipline,12,6,6
malganis,576,priest,discipline,12,6,6
khadgar,576,priest,discipline,12,6,6
eredar,576,priest,discipline,12,6,6
kelthuzad,576,priest,discipline,12,6,6
illidan,576,priest,discipline,12,6,6
kelthuzad,576,priest,discipline,12,6,6
kelthuzad,576,priest,discipline,12,6,6
ragnaros,576,priest,discipline,12,6,6
frostmourne,576,priest,discipline,12,6,6
garona,576,priest,discipline,12,6,6
frostmourne,576,priest,discipline,12,6,6
andorhal,576,priest,discipline,12,6,6
illidan,576,priest,discipline,12,6,6
illidan,576,priest,discipline,12,6,6
stormreaver,576,priest,discipline,12,6,6
stormreaver,576,priest,discipline,12,6,6
frostmourne,576,priest,discipline,12,6,6
ravencrest,576,priest,discipline,12,6,6
tichondrius,576,priest,discipline,12,6,6
stormrage,576,priest,discipline,12,6,6
sargeras,576,priest,discipline,12,6,6
tichondrius,576,priest,discipline,12,6,6
proudmoore,576,priest,discipline,12,6,6
tichondrius,576,priest,discipline,12,6,6
zuljin,576,priest,discipline,12,6,6
proudmoore,576,priest,discipline,12,6,6
queldorei,576,priest,discipline,12,6,6
deathwing,576,priest,discipline,12,6,6
bleeding-hollow,576,priest,discipline,12,6,6
wyrmrest-accord,576,priest,discipline,12,6,6
stormrage,576,priest,discipline,12,6,6
tichondrius,576,priest,discipline,12,6,6
sargeras,576,priest,discipline,12,6,6
mugthol,576,priest,discipline,12,6,6
stormrage,576,priest,discipline,12,6,6
illidan,576,priest,discipline,12,6,6
stormrage,576,priest,discipline,12,6,6
tichondrius,576,priest,discipline,12,6,6
zuljin,576,priest,discipline,12,6,6
tichondrius,576,priest,discipline,12,6,6
hakkar,576,priest,discipline,12,6,6
tichondrius,576,priest,discipline,12,6,6
tichondrius,576,priest,discipline,12,6,6
sargeras,576,priest,discipline,12,6,6
tichondrius,576,priest,discipline,12,6,6
tichondrius,576,priest,discipline,12,6,6
tichondrius,576,priest,discipline,12,6,6
moknathal,576,priest,discipline,12,6,6
frostwolf,576,priest,discipline,12,6,6
frostmane,576,priest,discipline,12,6,6
azuremyst,576,priest,discipline,12,6,6
tichondrius,576,priest,discipline,12,6,6
stormrage,576,priest,discipline,12,6,6
malganis,576,priest,discipline,18,6,12
moonrunner,576,priest,discipline,18,6,12
tichondrius,576,priest,discipline,18,6,12
tichondrius,576,priest,discipline,18,6,12
proudmoore,576,priest,discipline,18,6,12
area-52,576,priest,discipline,18,6,12
area-52,576,priest,discipline,18,6,12
stormrage,576,priest,discipline,18,6,12
dalaran,576,priest,discipline,18,6,12
dalaran,576,priest,discipline,18,6,12
aggramar,576,priest,discipline,18,6,12
malganis,576,priest,discipline,27,7,20
dalaran,576,priest,discipline,24,6,18
tichondrius,576,priest,discipline,24,6,18
tichondrius,575,priest,discipline,6,6,0
eonar,575,priest,discipline,6,6,0
emerald-dream,575,priest,discipline,12,6,6
emerald-dream,575,priest,discipline,12,6,6
emerald-dream,575,priest,discipline,12,6,6
tichondrius,575,priest,discipline,12,6,6
frostwolf,575,priest,discipline,12,6,6
thrall,575,priest,discipline,12,6,6
ragnaros,575,priest,discipline,12,6,6
ragnaros,575,priest,discipline,12,6,6
tichondrius,575,priest,discipline,12,6,6
quelthalas,575,priest,discipline,12,6,6
illidan,575,priest,discipline,12,6,6
nazjatar,575,priest,discipline,12,6,6
tichondrius,575,priest,discipline,12,6,6
sargeras,575,priest,discipline,12,6,6
ragnaros,575,priest,discipline,12,6,6
tichondrius,575,priest,discipline,12,6,6
stormrage,575,priest,discipline,12,6,6
stormrage,575,priest,discipline,16,7,9
tichondrius,575,priest,discipline,15,6,9
tichondrius,575,priest,discipline,18,6,12
tichondrius,575,priest,discipline,24,6,18
chromaggus,574,priest,discipline,12,6,6
sargeras,573,priest,discipline,12,6,6
area-52,573,priest,discipline,12,6,6
baelgun,573,priest,discipline,12,6,6
frostmourne,573,priest,discipline,18,6,12
sargeras,573,priest,discipline,24,6,18
blackhand,572,priest,discipline,12,6,6
arthas,571,priest,discipline,12,6,6
stormrage,571,priest,discipline,12,6,6
malganis,570,priest,discipline,12,6,6
proudmoore,570,priest,discipline,14,6,8
stormrage,569,priest,discipline,12,6,6
cenarion-circle,566,priest,discipline,12,6,6
sargeras,559,priest,discipline,17,6,11
area-52,558,priest,discipline,17,6,11
ragnaros,555,priest,discipline,13,7,6
moon-guard,543,priest,discipline,11,6,5
blades-edge,543,priest,discipline,14,7,7
nerzhul,543,priest,discipline,17,6,11
korgath,543,priest,discipline,17,6,11
whisperwind,542,priest,discipline,17,6,11
tichondrius,528,priest,discipline,9,7,2
destromath,528,priest,discipline,9,7,2
tichondrius,528,priest,discipline,15,6,9
sargeras,528,priest,discipline,15,6,9
zuljin,525,priest,discipline,9,6,3
earthen-ring,522,priest,discipline,16,7,9
crushridge,520,priest,discipline,21,7,14
drakkari,512,priest,discipline,10,6,4
illidan,511,priest,discipline,11,6,5
stormrage,511,priest,discipline,20,6,14
skywall,511,priest,discipline,20,6,14
blackrock,511,priest,discipline,26,6,20
ragnaros,507,priest,discipline,15,6,9
aggramar,496,priest,discipline,19,6,13
zuljin,480,priest,discipline,6,5,1
blackrock,480,priest,discipline,6,5,1
illidan,480,priest,discipline,6,5,1
sargeras,480,priest,discipline,6,5,1
zuljin,480,priest,discipline,6,5,1
kelthuzad,480,priest,discipline,6,5,1
bloodhoof,480,priest,discipline,6,5,1
tichondrius,480,priest,discipline,6,5,1
stormrage,480,priest,discipline,6,5,1
emerald-dream,480,priest,discipline,6,5,1
moonrunner,480,priest,discipline,6,5,1
quelthalas,480,priest,discipline,6,5,1
eonar,480,priest,discipline,6,5,1
tichondrius,480,priest,discipline,6,5,1
black-dragonflight,480,priest,discipline,6,5,1
frostmourne,480,priest,discipline,6,5,1
tichondrius,480,priest,discipline,6,5,1
kelthuzad,480,priest,discipline,6,5,1
the-scryers,480,priest,discipline,6,5,1
tichondrius,480,priest,discipline,6,5,1
lightnings-blade,480,priest,discipline,10,6,4
tichondrius,480,priest,discipline,12,5,7
tichondrius,480,priest,discipline,12,5,7
tichondrius,480,priest,discipline,12,5,7
tichondrius,480,priest,discipline,12,5,7
tichondrius,480,priest,discipline,12,5,7
tichondrius,480,priest,discipline,12,5,7
tichondrius,480,priest,discipline,12,5,7
turalyon,480,priest,discipline,12,5,7
tichondrius,480,priest,discipline,12,5,7
thunderhorn,480,priest,discipline,12,5,7
barthilas,480,priest,discipline,12,5,7
tichondrius,480,priest,discipline,12,5,7
tichondrius,480,priest,discipline,12,5,7
tichondrius,480,priest,discipline,12,5,7
barthilas,480,priest,discipline,12,5,7
tichondrius,480,priest,discipline,12,5,7
tichondrius,480,priest,discipline,12,5,7
tichondrius,480,priest,discipline,12,5,7
sargeras,480,priest,discipline,12,5,7
tichondrius,480,priest,discipline,12,5,7
malganis,480,priest,discipline,12,5,7
tichondrius,480,priest,discipline,12,5,7
emerald-dream,480,priest,discipline,12,5,7
quelthalas,480,priest,discipline,12,5,7
bleeding-hollow,480,priest,discipline,12,5,7
malganis,480,priest,discipline,12,5,7
whisperwind,480,priest,discipline,12,5,7
tichondrius,480,priest,discipline,12,5,7
kelthuzad,480,priest,discipline,12,5,7
kelthuzad,480,priest,discipline,12,5,7
tichondrius,480,priest,discipline,12,5,7
bleeding-hollow,480,priest,discipline,12,5,7
dunemaul,480,priest,discipline,12,5,7
jaedenar,480,priest,discipline,12,5,7
proudmoore,480,priest,discipline,12,5,7
sargeras,480,priest,discipline,12,5,7
drakkari,480,priest,discipline,12,5,7
chogall,480,priest,discipline,12,5,7
zuljin,480,priest,discipline,12,5,7
stormrage,480,priest,discipline,12,5,7
boulderfist,480,priest,discipline,12,5,7
jubeithos,480,priest,discipline,12,5,7
boulderfist,480,priest,discipline,12,5,7
boulderfist,480,priest,discipline,12,5,7
stormrage,480,priest,discipline,12,5,7
illidan,480,priest,discipline,12,5,7
sargeras,480,priest,discipline,12,5,7
zuljin,480,priest,discipline,12,5,7
aegwynn,480,priest,discipline,12,5,7
bonechewer,480,priest,discipline,12,5,7
illidan,480,priest,discipline,12,5,7
zuljin,480,priest,discipline,12,5,7
sargeras,480,priest,discipline,12,5,7
thrall,480,priest,discipline,12,5,7
frostmourne,480,priest,discipline,12,5,7
spirestone,480,priest,discipline,12,5,7
stormrage,480,priest,discipline,12,5,7
garona,480,priest,discipline,12,5,7
wyrmrest-accord,480,priest,discipline,12,5,7
area-52,480,priest,discipline,12,5,7
whisperwind,480,priest,discipline,12,5,7
tortheldrin,480,priest,discipline,12,5,7
moon-guard,480,priest,discipline,12,5,7
destromath,480,priest,discipline,12,5,7
frostmourne,480,priest,discipline,12,5,7
illidan,480,priest,discipline,12,5,7
moon-guard,480,priest,discipline,12,5,7
daggerspine,480,priest,discipline,12,5,7
shadowsong,480,priest,discipline,12,5,7
stormrage,480,priest,discipline,12,5,7
stormrage,480,priest,discipline,12,5,7
area-52,480,priest,discipline,12,5,7
black-dragonflight,480,priest,discipline,12,5,7
azralon,480,priest,discipline,12,5,7
gorefiend,480,priest,discipline,12,5,7
illidan,480,priest,discipline,12,5,7
area-52,480,priest,discipline,12,5,7
stormrage,480,priest,discipline,12,5,7
sargeras,480,priest,discipline,12,5,7
sargeras,480,priest,discipline,12,5,7
sargeras,480,priest,discipline,17,7,10
area-52,480,priest,discipline,15,6,9
kiljaeden,480,priest,discipline,13,5,8
ragnaros,480,priest,discipline,16,6,10
fizzcrank,480,priest,discipline,18,5,13
tichondrius,480,priest,discipline,18,5,13
moon-guard,480,priest,discipline,18,5,13
kiljaeden,480,priest,discipline,18,5,13
area-52,480,priest,discipline,18,5,13
kelthuzad,479,priest,discipline,6,5,1
malganis,479,priest,discipline,6,5,1
nazjatar,479,priest,discipline,6,5,1
korgath,479,priest,discipline,6,5,1
frostmourne,479,priest,discipline,6,5,1
wyrmrest-accord,479,priest,discipline,6,5,1
nathrezim,479,priest,discipline,12,5,7
korgath,479,priest,discipline,12,5,7
tichondrius,479,priest,discipline,12,5,7
moon-guard,479,priest,discipline,12,5,7
tichondrius,479,priest,discipline,12,5,7
senjin,479,priest,discipline,12,5,7
stormrage,479,priest,discipline,12,5,7
sargeras,479,priest,discipline,12,5,7
tichondrius,479,priest,discipline,12,5,7
stormrage,479,priest,discipline,12,5,7
chogall,479,priest,discipline,12,5,7
scilla,479,priest,discipline,14,5,9
stormrage,478,priest,discipline,6,5,1
blackrock,478,priest,discipline,6,5,1
quelthalas,477,priest,discipline,12,5,7
wyrmrest-accord,476,priest,discipline,12,5,7
tichondrius,474,priest,discipline,12,5,7
stormrage,460,priest,discipline,17,7,10
sargeras,447,priest,discipline,11,5,6
tichondrius,447,priest,discipline,11,5,6
illidan,447,priest,discipline,11,5,6
malganis,447,priest,discipline,11,5,6
stormrage,447,priest,discipline,17,5,12
tichondrius,432,priest,discipline,15,5,10
bonechewer,415,priest,discipline,14,5,9
stormrage,415,priest,discipline,20,5,15
tichondrius,414,priest,discipline,16,5,11
andorhal,400,priest,discipline,13,5,8
ragnaros,399,priest,discipline,5,5,0
blackhand,399,priest,discipline,5,5,0
bleeding-hollow,384,priest,discipline,6,4,2
tichondrius,384,priest,discipline,6,4,2
tichondrius,384,priest,discipline,6,4,2
blackrock,384,priest,discipline,6,4,2
tichondrius,384,priest,discipline,6,4,2
tichondrius,384,priest,discipline,6,4,2
tichondrius,384,priest,discipline,6,4,2
stormrage,384,priest,discipline,6,4,2
tichondrius,384,priest,discipline,6,4,2
senjin,384,priest,discipline,6,4,2
eitrigg,384,priest,discipline,6,4,2
tichondrius,384,priest,discipline,6,4,2
area-52,384,priest,discipline,6,4,2
mannoroth,384,priest,discipline,6,4,2
tichondrius,384,priest,discipline,6,4,2
tichondrius,384,priest,discipline,6,4,2
dalaran,384,priest,discipline,6,4,2
illidan,384,priest,discipline,6,4,2
bleeding-hollow,384,priest,discipline,6,4,2
tichondrius,384,priest,discipline,6,4,2
area-52,384,priest,discipline,6,4,2
tichondrius,384,priest,discipline,6,4,2
dalaran,384,priest,discipline,6,4,2
chogall,384,priest,discipline,6,4,2
tichondrius,384,priest,discipline,6,4,2
stormrage,384,priest,discipline,6,4,2
queldorei,384,priest,discipline,6,4,2
tichondrius,384,priest,discipline,6,4,2
spinebreaker,384,priest,discipline,6,4,2
aerie-peak,384,priest,discipline,6,4,2
moon-guard,384,priest,discipline,6,4,2
gilneas,384,priest,discipline,6,4,2
moon-guard,384,priest,discipline,6,4,2
stormrage,384,priest,discipline,6,4,2
illidan,384,priest,discipline,6,4,2
tichondrius,384,priest,discipline,6,4,2
malganis,384,priest,discipline,6,4,2
illidan,384,priest,discipline,6,4,2
malganis,384,priest,discipline,6,4,2
moon-guard,384,priest,discipline,6,4,2
skullcrusher,384,priest,discipline,6,4,2
tichondrius,384,priest,discipline,6,4,2
illidan,384,priest,discipline,6,4,2
alterac-mountains,384,priest,discipline,6,4,2
zuljin,384,priest,discipline,6,4,2
stormrage,384,priest,discipline,6,4,2
tichondrius,384,priest,discipline,6,4,2
senjin,384,priest,discipline,6,4,2
drakkari,384,priest,discipline,6,4,2
stormrage,384,priest,discipline,6,4,2
tichondrius,384,priest,discipline,6,4,2
zuljin,384,priest,discipline,6,4,2
zuljin,384,priest,discipline,6,4,2
proudmoore,384,priest,discipline,6,4,2
zuljin,384,priest,discipline,6,4,2
area-52,384,priest,discipline,6,4,2
thrall,384,priest,discipline,6,4,2
drakkari,384,priest,discipline,6,4,2
illidan,384,priest,discipline,6,4,2
area-52,384,priest,discipline,6,4,2
dragonmaw,384,priest,discipline,6,4,2
tichondrius,384,priest,discipline,6,4,2
dragonmaw,384,priest,discipline,6,4,2
illidan,384,priest,discipline,6,4,2
mugthol,384,priest,discipline,6,4,2
arygos,384,priest,discipline,6,4,2
shadow-council,384,priest,discipline,6,4,2
arthas,384,priest,discipline,6,4,2
area-52,384,priest,discipline,6,4,2
sargeras,384,priest,discipline,6,4,2
tichondrius,384,priest,discipline,6,4,2
malganis,384,priest,discipline,6,4,2
frostmourne,384,priest,discipline,6,4,2
khazgoroth,384,priest,discipline,6,4,2
sargeras,384,priest,discipline,6,4,2
darkspear,384,priest,discipline,6,4,2
frostmourne,384,priest,discipline,6,4,2
stormrage,384,priest,discipline,6,4,2
frostmourne,384,priest,discipline,6,4,2
tichondrius,384,priest,discipline,6,4,2
frostmourne,384,priest,discipline,6,4,2
tanaris,384,priest,discipline,6,4,2
frostmourne,384,priest,discipline,6,4,2
barthilas,384,priest,discipline,6,4,2
sargeras,384,priest,discipline,6,4,2
sargeras,384,priest,discipline,6,4,2
sargeras,384,priest,discipline,6,4,2
emerald-dream,384,priest,discipline,6,4,2
emerald-dream,384,priest,discipline,6,4,2
sargeras,384,priest,discipline,6,4,2
sargeras,384,priest,discipline,6,4,2
malganis,384,priest,discipline,10,5,5
dark-iron,384,priest,discipline,9,4,5
zuljin,384,priest,discipline,15,5,10
stormrage,384,priest,discipline,12,4,8
windrunner,384,priest,discipline,12,4,8
thrall,384,priest,discipline,12,4,8
draktharon,384,priest,discipline,12,4,8
moon-guard,384,priest,discipline,12,4,8
stormrage,384,priest,discipline,12,4,8
destromath,384,priest,discipline,12,4,8
azralon,384,priest,discipline,12,4,8
tichondrius,384,priest,discipline,12,4,8
ragnaros,384,priest,discipline,12,4,8
tichondrius,384,priest,discipline,12,4,8
tichondrius,384,priest,discipline,12,4,8
sargeras,384,priest,discipline,12,4,8
tichondrius,384,priest,discipline,12,4,8
illidan,384,priest,discipline,12,4,8
burning-blade,384,priest,discipline,12,4,8
illidan,384,priest,discipline,12,4,8
tichondrius,384,priest,discipline,12,4,8
kelthuzad,384,priest,discipline,12,4,8
proudmoore,384,priest,discipline,12,4,8
bleeding-hollow,384,priest,discipline,12,4,8
tichondrius,384,priest,discipline,12,4,8
kiljaeden,384,priest,discipline,12,4,8
tichondrius,384,priest,discipline,12,4,8
archimonde,384,priest,discipline,12,4,8
sargeras,384,priest,discipline,12,4,8
frostmourne,384,priest,discipline,12,4,8
tichondrius,384,priest,discipline,12,4,8
sargeras,384,priest,discipline,12,4,8
aggramar,384,priest,discipline,12,4,8
illidan,384,priest,discipline,12,4,8
tichondrius,384,priest,discipline,12,4,8
ragnaros,384,priest,discipline,12,4,8
dalaran,384,priest,discipline,12,4,8
khazgoroth,384,priest,discipline,12,4,8
frostmourne,384,priest,discipline,12,4,8
kelthuzad,384,priest,discipline,18,4,14
drakkari,384,priest,discipline,18,4,14
azralon,384,priest,discipline,18,4,14
sargeras,384,priest,discipline,18,4,14
tichondrius,384,priest,discipline,18,4,14
arathor,383,priest,discipline,6,4,2
bleeding-hollow,383,priest,discipline,6,4,2
emerald-dream,383,priest,discipline,6,4,2
barthilas,383,priest,discipline,6,4,2
emerald-dream,383,priest,discipline,6,4,2
tichondrius,383,priest,discipline,6,4,2
tichondrius,383,priest,discipline,6,4,2
tichondrius,383,priest,discipline,12,4,8
suramar,383,priest,discipline,12,4,8
malorne,383,priest,discipline,12,4,8
moon-guard,383,priest,discipline,12,4,8
bleeding-hollow,383,priest,discipline,12,4,8
quelthalas,383,priest,discipline,18,4,14
aerie-peak,382,priest,discipline,12,4,8
amanthul,381,priest,discipline,12,4,8
sargeras,381,priest,discipline,12,4,8
frostmourne,381,priest,discipline,12,4,8
zuljin,367,priest,discipline,11,4,7
tichondrius,352,priest,discipline,10,4,6
chogall,351,priest,discipline,8,5,3
bleeding-hollow,351,priest,discipline,11,4,7
proudmoore,336,priest,discipline,9,5,4
tichondrius,336,priest,discipline,9,5,4
ragnaros,336,priest,discipline,21,4,17
tichondrius,330,priest,discipline,17,6,11
lightbringer,330,priest,discipline,15,5,10
barthilas,320,priest,discipline,10,4,6
bloodscalp,320,priest,discipline,10,4,6
azjolnerub,320,priest,discipline,17,4,13
frostmourne,319,priest,discipline,8,4,4
emerald-dream,319,priest,discipline,8,4,4
moknathal,319,priest,discipline,8,4,4
korgath,319,priest,discipline,14,4,10
tichondrius,319,priest,discipline,14,4,10
draenor,304,priest,discipline,11,5,6
dalaran,288,priest,discipline,6,3,3
chogall,288,priest,discipline,6,3,3
barthilas,288,priest,discipline,6,3,3
bleeding-hollow,288,priest,discipline,6,3,3
dalaran,288,priest,discipline,6,3,3
azgalor,288,priest,discipline,6,3,3
barthilas,288,priest,discipline,6,3,3
lothar,288,priest,discipline,6,3,3
illidan,288,priest,discipline,6,3,3
stormrage,288,priest,discipline,6,3,3
illidan,288,priest,discipline,6,3,3
illidan,288,priest,discipline,6,3,3
bleeding-hollow,288,priest,discipline,6,3,3
bleeding-hollow,288,priest,discipline,6,3,3
barthilas,288,priest,discipline,6,3,3
zuljin,288,priest,discipline,6,3,3
nazjatar,288,priest,discipline,6,3,3
illidan,288,priest,discipline,6,3,3
azshara,288,priest,discipline,6,3,3
bleeding-hollow,288,priest,discipline,6,3,3
bloodhoof,288,priest,discipline,6,3,3
bleeding-hollow,288,priest,discipline,6,3,3
zuljin,288,priest,discipline,6,3,3
zuljin,288,priest,discipline,6,3,3
stormrage,288,priest,discipline,6,3,3
frostmourne,288,priest,discipline,6,3,3
bleeding-hollow,288,priest,discipline,6,3,3
illidan,288,priest,discipline,6,3,3
illidan,288,priest,discipline,6,3,3
stormrage,288,priest,discipline,6,3,3
stormrage,288,priest,discipline,6,3,3
zuljin,288,priest,discipline,6,3,3
tichondrius,288,priest,discipline,6,3,3
illidan,288,priest,discipline,6,3,3
illidan,288,priest,discipline,6,3,3
sargeras,288,priest,discipline,6,3,3
illidan,288,priest,discipline,6,3,3
sargeras,288,priest,discipline,6,3,3
ragnaros,288,priest,discipline,6,3,3
tichondrius,288,priest,discipline,6,3,3
tichondrius,288,priest,discipline,6,3,3
tichondrius,288,priest,discipline,6,3,3
tichondrius,288,priest,discipline,6,3,3
tichondrius,288,priest,discipline,6,3,3
tichondrius,288,priest,discipline,6,3,3
thrall,288,priest,discipline,6,3,3
area-52,288,priest,discipline,6,3,3
tichondrius,288,priest,discipline,6,3,3
tichondrius,288,priest,discipline,6,3,3
thrall,288,priest,discipline,6,3,3
akama,288,priest,discipline,6,3,3
tichondrius,288,priest,discipline,6,3,3
tichondrius,288,priest,discipline,6,3,3
area-52,288,priest,discipline,6,3,3
thrall,288,priest,discipline,6,3,3
aggramar,288,priest,discipline,6,3,3
ragnaros,288,priest,discipline,6,3,3
tichondrius,288,priest,discipline,6,3,3
frostwolf,288,priest,discipline,6,3,3
tichondrius,288,priest,discipline,6,3,3
sargeras,288,priest,discipline,6,3,3
drakkari,288,priest,discipline,6,3,3
aegwynn,288,priest,discipline,6,3,3
gorefiend,288,priest,discipline,6,3,3
hellscream,288,priest,discipline,6,3,3
tichondrius,288,priest,discipline,6,3,3
tichondrius,288,priest,discipline,6,3,3
sargeras,288,priest,discipline,6,3,3
tichondrius,288,priest,discipline,6,3,3
whisperwind,288,priest,discipline,6,3,3
tichondrius,288,priest,discipline,6,3,3
tichondrius,288,priest,discipline,6,3,3
stormreaver,288,priest,discipline,6,3,3
vashj,288,priest,discipline,6,3,3
stormreaver,288,priest,discipline,6,3,3
ravencrest,288,priest,discipline,6,3,3
ravenholdt,288,priest,discipline,6,3,3
area-52,288,priest,discipline,6,3,3
tichondrius,288,priest,discipline,6,3,3
area-52,288,priest,discipline,6,3,3
area-52,288,priest,discipline,6,3,3
earthen-ring,288,priest,discipline,6,3,3
tichondrius,288,priest,discipline,6,3,3
kiljaeden,288,priest,discipline,6,3,3
moon-guard,288,priest,discipline,6,3,3
tichondrius,288,priest,discipline,6,3,3
moon-guard,288,priest,discipline,6,3,3
frostmourne,288,priest,discipline,6,3,3
tichondrius,288,priest,discipline,6,3,3
area-52,288,priest,discipline,6,3,3
azralon,288,priest,discipline,6,3,3
moon-guard,288,priest,discipline,6,3,3
kiljaeden,288,priest,discipline,6,3,3
malganis,288,priest,discipline,6,3,3
emerald-dream,288,priest,discipline,6,3,3
area-52,288,priest,discipline,6,3,3
silvermoon,288,priest,discipline,6,3,3
bonechewer,288,priest,discipline,6,3,3
hyjal,288,priest,discipline,6,3,3
kiljaeden,288,priest,discipline,6,3,3
sargeras,288,priest,discipline,6,3,3
tichondrius,288,priest,discipline,6,3,3
tichondrius,288,priest,discipline,6,3,3
aggramar,288,priest,discipline,6,3,3
shattered-hand,288,priest,discipline,6,3,3
lightbringer,288,priest,discipline,6,3,3
proudmoore,288,priest,discipline,6,3,3
frostmourne,288,priest,discipline,6,3,3
sargeras,288,priest,discipline,6,3,3
tichondrius,288,priest,discipline,6,3,3
darrowmere,288,priest,discipline,6,3,3
darkspear,288,priest,discipline,6,3,3
kelthuzad,288,priest,discipline,6,3,3
proudmoore,288,priest,discipline,6,3,3
proudmoore,288,priest,discipline,6,3,3
malganis,288,priest,discipline,6,3,3
tichondrius,288,priest,discipline,6,3,3
darkspear,288,priest,discipline,6,3,3
darkspear,288,priest,discipline,6,3,3
tichondrius,288,priest,discipline,6,3,3
tichondrius,288,priest,discipline,6,3,3
malganis,288,priest,discipline,6,3,3
darkspear,288,priest,discipline,6,3,3
sargeras,288,priest,discipline,6,3,3
tichondrius,288,priest,discipline,6,3,3
greymane,288,priest,discipline,6,3,3
executus,288,priest,discipline,6,3,3
proudmoore,288,priest,discipline,6,3,3
tichondrius,288,priest,discipline,6,3,3
azjolnerub,288,priest,discipline,6,3,3
proudmoore,288,priest,discipline,6,3,3
darkspear,288,priest,discipline,10,3,7
ragnaros,288,priest,discipline,16,4,12
illidan,288,priest,discipline,16,4,12
area-52,288,priest,discipline,12,3,9
malganis,288,priest,discipline,12,3,9
frostmourne,288,priest,discipline,12,3,9
azralon,288,priest,discipline,12,3,9
nerzhul,288,priest,discipline,12,3,9
illidan,288,priest,discipline,12,3,9
tichondrius,288,priest,discipline,12,3,9
kaelthas,288,priest,discipline,12,3,9
ragnaros,288,priest,discipline,12,3,9
malganis,288,priest,discipline,12,3,9
moon-guard,288,priest,discipline,12,3,9
crushridge,288,priest,discipline,12,3,9
area-52,288,priest,discipline,12,3,9
illidan,288,priest,discipline,12,3,9
rivendare,288,priest,discipline,12,3,9
whisperwind,288,priest,discipline,12,3,9
stormrage,288,priest,discipline,12,3,9
thrall,288,priest,discipline,12,3,9
thrall,288,priest,discipline,12,3,9
frostmourne,288,priest,discipline,12,3,9
crushridge,288,priest,discipline,12,3,9
bonechewer,288,priest,discipline,12,3,9
emerald-dream,288,priest,discipline,12,3,9
arthas,288,priest,discipline,12,3,9
sargeras,288,priest,discipline,12,3,9
barthilas,288,priest,discipline,12,3,9
thorium-brotherhood,288,priest,discipline,12,3,9
bleeding-hollow,288,priest,discipline,12,3,9
tichondrius,288,priest,discipline,12,3,9
illidan,288,priest,discipline,12,3,9
illidan,288,priest,discipline,12,3,9
arthas,288,priest,discipline,12,3,9
tichondrius,288,priest,discipline,12,3,9
proudmoore,288,priest,discipline,12,3,9
stormrage,288,priest,discipline,12,3,9
bleeding-hollow,288,priest,discipline,12,3,9
kiljaeden,288,priest,discipline,12,3,9
tichondrius,288,priest,discipline,12,3,9
emerald-dream,288,priest,discipline,15,3,12
tichondrius,288,priest,discipline,16,3,13
jubeithos,288,priest,discipline,18,3,15
illidan,288,priest,discipline,18,3,15
malganis,288,priest,discipline,18,3,15
emerald-dream,287,priest,discipline,6,3,3
korgath,287,priest,discipline,6,3,3
tichondrius,287,priest,discipline,12,3,9
aegwynn,287,priest,discipline,12,3,9
tichondrius,286,priest,discipline,12,3,9
tichondrius,271,priest,discipline,17,3,14
wyrmrest-accord,255,priest,discipline,8,4,4
sargeras,255,priest,discipline,11,3,8
proudmoore,255,priest,discipline,11,3,8
proudmoore,255,priest,discipline,11,3,8
moon-guard,239,priest,discipline,5,3,2
moon-guard,239,priest,discipline,5,3,2
sargeras,239,priest,discipline,5,3,2
black-dragonflight,239,priest,discipline,5,3,2
illidan,239,priest,discipline,5,3,2
quelthalas,239,priest,discipline,5,3,2
illidan,233,priest,discipline,18,4,14
jubeithos,223,priest,discipline,8,3,5
hyjal,208,priest,discipline,7,3,4
kelthuzad,201,priest,discipline,13,4,9
malganis,192,priest,discipline,4,3,1
tichondrius,192,priest,discipline,4,3,1
malganis,192,priest,discipline,11,4,7
stormrage,192,priest,discipline,9,3,6
nagrand,192,priest,discipline,6,2,4
kelthuzad,192,priest,discipline,6,2,4
emerald-dream,192,priest,discipline,6,2,4
tichondrius,192,priest,discipline,6,2,4
emerald-dream,192,priest,discipline,6,2,4
malganis,192,priest,discipline,6,2,4
aggramar,192,priest,discipline,6,2,4
kelthuzad,192,priest,discipline,6,2,4
malganis,192,priest,discipline,6,2,4
barthilas,192,priest,discipline,6,2,4
aggramar,192,priest,discipline,6,2,4
kelthuzad,192,priest,discipline,6,2,4
dalaran,192,priest,discipline,6,2,4
icecrown,192,priest,discipline,6,2,4
andorhal,192,priest,discipline,6,2,4
stormrage,192,priest,discipline,6,2,4
tichondrius,192,priest,discipline,6,2,4
ragnaros,192,priest,discipline,6,2,4
emerald-dream,192,priest,discipline,6,2,4
barthilas,192,priest,discipline,6,2,4
dalvengyr,192,priest,discipline,6,2,4
burning-legion,192,priest,discipline,6,2,4
bloodhoof,192,priest,discipline,6,2,4
area-52,192,priest,discipline,6,2,4
tichondrius,192,priest,discipline,6,2,4
area-52,192,priest,discipline,6,2,4
emerald-dream,192,priest,discipline,6,2,4
tichondrius,192,priest,discipline,6,2,4
norgannon,192,priest,discipline,6,2,4
malganis,192,priest,discipline,6,2,4
tichondrius,192,priest,discipline,6,2,4
skullcrusher,192,priest,discipline,6,2,4
area-52,192,priest,discipline,6,2,4
area-52,192,priest,discipline,6,2,4
ragnaros,192,priest,discipline,6,2,4
terokkar,192,priest,discipline,6,2,4
terokkar,192,priest,discipline,6,2,4
sargeras,192,priest,discipline,6,2,4
whisperwind,192,priest,discipline,6,2,4
frostmourne,192,priest,discipline,6,2,4
tichondrius,192,priest,discipline,6,2,4
altar-of-storms,192,priest,discipline,6,2,4
nemesis,192,priest,discipline,6,2,4
khadgar,192,priest,discipline,6,2,4
illidan,192,priest,discipline,6,2,4
aerie-peak,192,priest,discipline,6,2,4
tichondrius,192,priest,discipline,6,2,4
illidan,192,priest,discipline,6,2,4
tichondrius,192,priest,discipline,6,2,4
thrall,192,priest,discipline,6,2,4
thrall,192,priest,discipline,6,2,4
anetheron,192,priest,discipline,6,2,4
thrall,192,priest,discipline,6,2,4
dalaran,192,priest,discipline,6,2,4
frostmourne,192,priest,discipline,6,2,4
tichondrius,192,priest,discipline,6,2,4
nerzhul,192,priest,discipline,6,2,4
cenarius,192,priest,discipline,6,2,4
sargeras,192,priest,discipline,6,2,4
tichondrius,192,priest,discipline,6,2,4
frostmourne,192,priest,discipline,6,2,4
illidan,192,priest,discipline,6,2,4
blackrock,192,priest,discipline,6,2,4
stormrage,192,priest,discipline,6,2,4
wildhammer,192,priest,discipline,6,2,4
tichondrius,192,priest,discipline,6,2,4
bleeding-hollow,192,priest,discipline,6,2,4
hydraxis,192,priest,discipline,6,2,4
stormrage,192,priest,discipline,6,2,4
thunderlord,192,priest,discipline,6,2,4
frostwolf,192,priest,discipline,6,2,4
tichondrius,192,priest,discipline,6,2,4
malorne,192,priest,discipline,6,2,4
spirestone,192,priest,discipline,6,2,4
frostwolf,192,priest,discipline,6,2,4
azralon,192,priest,discipline,6,2,4
hakkar,192,priest,discipline,6,2,4
tichondrius,192,priest,discipline,6,2,4
bleeding-hollow,192,priest,discipline,6,2,4
azralon,192,priest,discipline,6,2,4
bleeding-hollow,192,priest,discipline,6,2,4
stormrage,192,priest,discipline,6,2,4
sargeras,192,priest,discipline,6,2,4
bleeding-hollow,192,priest,discipline,6,2,4
tichondrius,192,priest,discipline,6,2,4
tichondrius,192,priest,discipline,6,2,4
moon-guard,192,priest,discipline,6,2,4
silvermoon,192,priest,discipline,6,2,4
bleeding-hollow,192,priest,discipline,6,2,4
borean-tundra,192,priest,discipline,6,2,4
kiljaeden,192,priest,discipline,6,2,4
sargeras,192,priest,discipline,6,2,4
sargeras,192,priest,discipline,6,2,4
proudmoore,192,priest,discipline,6,2,4
wyrmrest-accord,192,priest,discipline,6,2,4
proudmoore,192,priest,discipline,6,2,4
hakkar,192,priest,discipline,6,2,4
garrosh,192,priest,discipline,6,2,4
bleeding-hollow,192,priest,discipline,6,2,4
sargeras,192,priest,discipline,6,2,4
kiljaeden,192,priest,discipline,6,2,4
nordrassil,192,priest,discipline,6,2,4
wyrmrest-accord,192,priest,discipline,6,2,4
draka,192,priest,discipline,6,2,4
zuljin,192,priest,discipline,6,2,4
darkspear,192,priest,discipline,6,2,4
sargeras,192,priest,discipline,6,2,4
sargeras,192,priest,discipline,6,2,4
darkspear,192,priest,discipline,6,2,4
frostmane,192,priest,discipline,6,2,4
area-52,192,priest,discipline,7,2,5
frostmourne,192,priest,discipline,8,2,6
tichondrius,192,priest,discipline,12,2,10
barthilas,192,priest,discipline,12,2,10
tichondrius,192,priest,discipline,12,2,10
kelthuzad,192,priest,discipline,12,2,10
stormrage,192,priest,discipline,12,2,10
proudmoore,192,priest,discipline,12,2,10
kelthuzad,192,priest,discipline,12,2,10
tichondrius,192,priest,discipline,12,2,10
stormrage,192,priest,discipline,12,2,10
silvermoon,192,priest,discipline,12,2,10
sargeras,192,priest,discipline,12,2,10
norgannon,192,priest,discipline,12,2,10
tichondrius,192,priest,discipline,12,2,10
barthilas,192,priest,discipline,12,2,10
illidan,192,priest,discipline,12,2,10
shuhalo,192,priest,discipline,12,2,10
proudmoore,191,priest,discipline,6,2,4
zuljin,185,priest,discipline,14,4,10
barthilas,175,priest,discipline,11,2,9
zuljin,175,priest,discipline,11,2,9
tichondrius,167,priest,discipline,25,11,14
tichondrius,159,priest,discipline,5,2,3
lightbringer,159,priest,discipline,5,2,3
bleeding-hollow,159,priest,discipline,8,3,5
exodar,144,priest,discipline,9,2,7
stormrage,138,priest,discipline,8,3,5
tichondrius,138,priest,discipline,8,3,5
malganis,138,priest,discipline,11,3,8
illidan,138,priest,discipline,11,3,8
frostmourne,128,priest,discipline,4,2,2
magtheridon,127,priest,discipline,14,2,12
tichondrius,112,priest,discipline,7,2,5
khazgoroth,96,priest,discipline,3,2,1
emerald-dream,96,priest,discipline,3,2,1
illidan,96,priest,discipline,3,2,1
wyrmrest-accord,96,priest,discipline,3,2,1
tichondrius,96,priest,discipline,6,1,5
frostmourne,96,priest,discipline,6,1,5
ragnaros,96,priest,discipline,6,1,5
ragnaros,96,priest,discipline,6,1,5
illidan,96,priest,discipline,6,1,5
ragnaros,96,priest,discipline,6,1,5
sargeras,96,priest,discipline,6,1,5
kiljaeden,96,priest,discipline,6,1,5
runetotem,96,priest,discipline,6,1,5
bleeding-hollow,96,priest,discipline,6,1,5
sargeras,96,priest,discipline,6,1,5
emerald-dream,96,priest,discipline,6,1,5
blackrock,96,priest,discipline,6,1,5
illidan,96,priest,discipline,6,1,5
sargeras,96,priest,discipline,6,1,5
stormrage,96,priest,discipline,6,1,5
sargeras,96,priest,discipline,6,1,5
blackrock,96,priest,discipline,6,1,5
stormrage,96,priest,discipline,6,1,5
magtheridon,96,priest,discipline,6,1,5
kalecgos,96,priest,discipline,6,1,5
nagrand,96,priest,discipline,6,1,5
wyrmrest-accord,96,priest,discipline,6,1,5
wyrmrest-accord,96,priest,discipline,6,1,5
tichondrius,96,priest,discipline,6,1,5
zuljin,96,priest,discipline,6,1,5
stormrage,96,priest,discipline,6,1,5
proudmoore,96,priest,discipline,6,1,5
bleeding-hollow,96,priest,discipline,6,1,5
sargeras,96,priest,discipline,6,1,5
malganis,96,priest,discipline,6,1,5
illidan,96,priest,discipline,6,1,5
illidan,96,priest,discipline,6,1,5
kelthuzad,96,priest,discipline,6,1,5
emerald-dream,96,priest,discipline,6,1,5
sargeras,96,priest,discipline,6,1,5
tichondrius,96,priest,discipline,6,1,5
tichondrius,96,priest,discipline,6,1,5
sargeras,96,priest,discipline,6,1,5
tichondrius,96,priest,discipline,6,1,5
stormrage,96,priest,discipline,6,1,5
draka,96,priest,discipline,6,1,5
malganis,96,priest,discipline,6,1,5
arthas,96,priest,discipline,6,1,5
illidan,96,priest,discipline,6,1,5
aggramar,96,priest,discipline,6,1,5
lightbringer,96,priest,discipline,6,1,5
skullcrusher,96,priest,discipline,6,1,5
anvilmar,96,priest,discipline,6,1,5
tichondrius,96,priest,discipline,6,1,5
area-52,96,priest,discipline,6,1,5
dunemaul,96,priest,discipline,6,1,5
archimonde,96,priest,discipline,6,1,5
tichondrius,96,priest,discipline,6,1,5
laughing-skull,96,priest,discipline,6,1,5
tichondrius,96,priest,discipline,6,1,5
trollbane,96,priest,discipline,6,1,5
lothar,96,priest,discipline,6,1,5
moon-guard,96,priest,discipline,6,1,5
tichondrius,96,priest,discipline,6,1,5
illidan,96,priest,discipline,6,1,5
frostmourne,96,priest,discipline,6,1,5
illidan,96,priest,discipline,6,1,5
zuljin,96,priest,discipline,6,1,5
tichondrius,96,priest,discipline,6,1,5
thrall,96,priest,discipline,6,1,5
moon-guard,96,priest,discipline,6,1,5
area-52,96,priest,discipline,6,1,5
tichondrius,96,priest,discipline,6,1,5
tichondrius,96,priest,discipline,6,1,5
tichondrius,96,priest,discipline,6,1,5
tichondrius,96,priest,discipline,6,1,5
azgalor,96,priest,discipline,6,1,5
stormrage,96,priest,discipline,6,1,5
moon-guard,96,priest,discipline,6,1,5
moon-guard,96,priest,discipline,6,1,5
azralon,96,priest,discipline,6,1,5
barthilas,96,priest,discipline,6,1,5
eredar,96,priest,discipline,6,1,5
illidan,96,priest,discipline,6,1,5
hellscream,96,priest,discipline,6,1,5
tichondrius,96,priest,discipline,6,1,5
illidan,96,priest,discipline,6,1,5
chogall,96,priest,discipline,6,1,5
alleria,96,priest,discipline,6,1,5
sargeras,96,priest,discipline,6,1,5
thrall,96,priest,discipline,6,1,5
tichondrius,96,priest,discipline,12,1,11
wyrmrest-accord,96,priest,discipline,12,1,11
moon-guard,96,priest,discipline,12,1,11
area-52,96,priest,discipline,12,1,11
barthilas,96,priest,discipline,12,1,11
darkspear,96,priest,discipline,12,1,11
proudmoore,96,priest,discipline,12,1,11
zuljin,96,priest,discipline,18,1,17
shuhalo,95,priest,discipline,6,1,5
illidan,84,priest,discipline,13,4,9
area-52,79,priest,discipline,5,1,4
frostmourne,42,priest,discipline,7,3,4
tichondrius,42,priest,discipline,11,3,8
area-52,42,priest,discipline,16,3,13
sargeras,31,priest,discipline,2,1,1
elune,31,priest,discipline,2,1,1
stormrage,2296,priest,shadow,108,62,46
tichondrius,2258,priest,shadow,78,50,28
tichondrius,2230,priest,shadow,155,98,57
tichondrius,2185,priest,shadow,125,65,60
barthilas,2147,priest,shadow,89,47,42
frostmourne,2146,priest,shadow,82,55,27
sargeras,2121,priest,shadow,68,45,23
kelthuzad,2113,priest,shadow,76,46,30
stormrage,2110,priest,shadow,66,38,28
frostmourne,2110,priest,shadow,187,102,85
tichondrius,2107,priest,shadow,89,51,38
barthilas,2107,priest,shadow,84,45,39
frostmourne,2105,priest,shadow,181,97,84
tichondrius,2090,priest,shadow,137,69,68
frostmourne,2087,priest,shadow,54,35,19
stormrage,2070,priest,shadow,138,74,64
sargeras,2063,priest,shadow,72,40,32
tichondrius,2013,priest,shadow,108,57,51
quelthalas,2007,priest,shadow,66,34,32
altar-of-storms,1986,priest,shadow,66,35,31
korgath,1985,priest,shadow,84,43,41
illidan,1982,priest,shadow,143,75,68
stormscale,1977,priest,shadow,60,35,25
tichondrius,1969,priest,shadow,48,30,18
tichondrius,1959,priest,shadow,65,34,31
queldorei,1948,priest,shadow,47,27,20
mannoroth,1946,priest,shadow,65,39,26
sargeras,1940,priest,shadow,36,23,13
blades-edge,1935,priest,shadow,111,57,54
tichondrius,1924,priest,shadow,69,36,33
kelthuzad,1907,priest,shadow,36,20,16
sargeras,1906,priest,shadow,60,31,29
guldan,1901,priest,shadow,198,109,89
bleeding-hollow,1899,priest,shadow,240,130,110
tichondrius,1894,priest,shadow,54,29,25
emerald-dream,1893,priest,shadow,36,23,13
sargeras,1892,priest,shadow,149,76,73
illidan,1886,priest,shadow,102,65,37
illidan,1886,priest,shadow,84,41,43
area-52,1885,priest,shadow,110,60,50
frostmourne,1882,priest,shadow,86,45,41
illidan,1881,priest,shadow,47,31,16
tichondrius,1877,priest,shadow,60,29,31
tichondrius,1868,priest,shadow,51,27,24
zuluhed,1867,priest,shadow,36,24,12
tichondrius,1865,priest,shadow,53,28,25
tichondrius,1862,priest,shadow,42,35,7
spinebreaker,1861,priest,shadow,82,47,35
kelthuzad,1856,priest,shadow,39,27,12
area-52,1854,priest,shadow,35,27,8
sargeras,1854,priest,shadow,54,30,24
tichondrius,1851,priest,shadow,42,24,18
illidan,1849,priest,shadow,59,41,18
proudmoore,1849,priest,shadow,42,28,14
illidan,1848,priest,shadow,48,24,24
emerald-dream,1847,priest,shadow,48,29,19
quelthalas,1845,priest,shadow,54,26,28
tichondrius,1844,priest,shadow,54,28,26
malganis,1840,priest,shadow,42,24,18
illidan,1839,priest,shadow,74,43,31
stormrage,1838,priest,shadow,42,32,10
stormrage,1835,priest,shadow,145,93,52
malganis,1835,priest,shadow,60,31,29
stormreaver,1831,priest,shadow,78,34,44
kelthuzad,1829,priest,shadow,54,32,22
area-52,1829,priest,shadow,45,26,19
ragnaros,1828,priest,shadow,64,41,23
thrall,1827,priest,shadow,31,22,9
tichondrius,1826,priest,shadow,46,27,19
tichondrius,1825,priest,shadow,47,26,21
moon-guard,1824,priest,shadow,48,26,22
tichondrius,1822,priest,shadow,90,51,39
malganis,1822,priest,shadow,66,36,30
tichondrius,1821,priest,shadow,144,82,62
ragnaros,1819,priest,shadow,43,25,18
lightnings-blade,1819,priest,shadow,90,50,40
tichondrius,1815,priest,shadow,24,19,5
moon-guard,1815,priest,shadow,144,82,62
stormrage,1814,priest,shadow,42,23,19
tichondrius,1814,priest,shadow,60,30,30
frostmourne,1813,priest,shadow,48,33,15
stormrage,1813,priest,shadow,48,26,22
tichondrius,1810,priest,shadow,42,27,15
stormrage,1810,priest,shadow,48,26,22
moon-guard,1809,priest,shadow,55,42,13
malganis,1809,priest,shadow,39,26,13
bloodscalp,1809,priest,shadow,56,36,20
area-52,1809,priest,shadow,54,26,28
area-52,1805,priest,shadow,69,37,32
area-52,1805,priest,shadow,60,30,30
moon-guard,1805,priest,shadow,56,27,29
tichondrius,1803,priest,shadow,30,19,11
terenas,1803,priest,shadow,42,26,16
dalaran,1803,priest,shadow,89,46,43
wyrmrest-accord,1803,priest,shadow,65,33,32
emerald-dream,1800,priest,shadow,36,22,14
tichondrius,1795,priest,shadow,66,38,28
ragnaros,1790,priest,shadow,77,41,36
illidan,1786,priest,shadow,36,21,15
illidan,1786,priest,shadow,186,101,85
illidan,1777,priest,shadow,54,27,27
ravencrest,1769,priest,shadow,35,20,15
laughing-skull,1762,priest,shadow,40,19,21
kelthuzad,1760,priest,shadow,77,58,19
demon-soul,1759,priest,shadow,84,47,37
suramar,1748,priest,shadow,54,36,18
ragnaros,1745,priest,shadow,48,28,20
tichondrius,1744,priest,shadow,53,31,22
ravencrest,1743,priest,shadow,63,35,28
zuljin,1742,priest,shadow,48,27,21
kirin-tor,1741,priest,shadow,101,53,48
malganis,1740,priest,shadow,42,26,16
malganis,1740,priest,shadow,45,27,18
nemesis,1737,priest,shadow,48,28,20
tichondrius,1735,priest,shadow,52,27,25
tichondrius,1732,priest,shadow,35,21,14
area-52,1730,priest,shadow,36,22,14
darkspear,1730,priest,shadow,48,28,20
tichondrius,1730,priest,shadow,92,53,39
frostmourne,1727,priest,shadow,42,23,19
frostmourne,1727,priest,shadow,127,68,59
thrall,1727,priest,shadow,94,50,44
zuljin,1724,priest,shadow,37,25,12
moon-guard,1718,priest,shadow,42,23,19
moon-guard,1718,priest,shadow,48,23,25
frostmourne,1716,priest,shadow,41,20,21
illidan,1715,priest,shadow,36,22,14
twisting-nether,1714,priest,shadow,100,65,35
frostmourne,1710,priest,shadow,84,39,45
sargeras,1703,priest,shadow,36,22,14
quelthalas,1702,priest,shadow,67,37,30
bleeding-hollow,1701,priest,shadow,72,40,32
zuljin,1700,priest,shadow,84,49,35
thrall,1693,priest,shadow,79,41,38
stormrage,1691,priest,shadow,93,51,42
terokkar,1689,priest,shadow,36,18,18
nemesis,1689,priest,shadow,48,19,29
kiljaeden,1687,priest,shadow,70,34,36
tichondrius,1684,priest,shadow,88,50,38
proudmoore,1681,priest,shadow,42,26,16
ragnaros,1676,priest,shadow,30,19,11
malganis,1676,priest,shadow,36,19,17
moon-guard,1673,priest,shadow,54,33,21
sargeras,1668,priest,shadow,42,25,17
tichondrius,1667,priest,shadow,42,24,18
malganis,1665,priest,shadow,35,21,14
tichondrius,1664,priest,shadow,36,24,12
tichondrius,1662,priest,shadow,48,26,22
ragnaros,1658,priest,shadow,32,18,14
gorefiend,1653,priest,shadow,30,21,9
tichondrius,1652,priest,shadow,30,22,8
bleeding-hollow,1651,priest,shadow,41,23,18
thrall,1650,priest,shadow,41,20,21
barthilas,1640,priest,shadow,47,25,22
ragnaros,1637,priest,shadow,84,48,36
caelestrasz,1633,priest,shadow,84,43,41
sargeras,1631,priest,shadow,66,39,27
area-52,1631,priest,shadow,42,23,19
moon-guard,1629,priest,shadow,104,60,44
stormrage,1629,priest,shadow,54,30,24
illidan,1629,priest,shadow,97,51,46
tichondrius,1628,priest,shadow,33,21,12
the-forgotten-coast,1625,priest,shadow,27,18,9
spinebreaker,1622,priest,shadow,30,18,12
blackrock,1621,priest,shadow,60,31,29
stormreaver,1619,priest,shadow,74,42,32
kelthuzad,1618,priest,shadow,116,70,46
tichondrius,1617,priest,shadow,48,26,22
emerald-dream,1617,priest,shadow,42,20,22
moon-guard,1616,priest,shadow,30,20,10
ragnaros,1615,priest,shadow,88,55,33
azuremyst,1615,priest,shadow,71,37,34
zuljin,1612,priest,shadow,30,17,13
sargeras,1609,priest,shadow,43,25,18
dalaran,1605,priest,shadow,30,19,11
quelthalas,1598,priest,shadow,94,61,33
tichondrius,1598,priest,shadow,36,17,19
tichondrius,1598,priest,shadow,42,19,23
tichondrius,1594,priest,shadow,36,21,15
area-52,1594,priest,shadow,60,32,28
moon-guard,1594,priest,shadow,42,22,20
area-52,1590,priest,shadow,24,17,7
malganis,1590,priest,shadow,81,43,38
dalaran,1589,priest,shadow,36,19,17
moon-guard,1585,priest,shadow,115,61,54
bloodscalp,1582,priest,shadow,51,24,27
moon-guard,1578,priest,shadow,42,24,18
moon-guard,1577,priest,shadow,42,18,24
sargeras,1571,priest,shadow,56,37,19
tichondrius,1570,priest,shadow,65,34,31
area-52,1567,priest,shadow,85,52,33
frostmourne,1566,priest,shadow,75,45,30
ragnaros,1566,priest,shadow,58,31,27
tichondrius,1564,priest,shadow,106,56,50
illidan,1562,priest,shadow,74,43,31
skywall,1558,priest,shadow,78,42,36
boulderfist,1557,priest,shadow,54,31,23
frostmourne,1557,priest,shadow,36,18,18
nazgrel,1556,priest,shadow,54,27,27
wyrmrest-accord,1553,priest,shadow,36,17,19
area-52,1549,priest,shadow,83,42,41
malganis,1544,priest,shadow,35,25,10
zuljin,1544,priest,shadow,41,18,23
azralon,1533,priest,shadow,60,34,26
azralon,1532,priest,shadow,36,19,17
frostmourne,1531,priest,shadow,36,18,18
moon-guard,1529,priest,shadow,48,31,17
malfurion,1528,priest,shadow,45,33,12
wyrmrest-accord,1527,priest,shadow,32,20,12
crushridge,1526,priest,shadow,66,32,34
stormrage,1525,priest,shadow,42,20,22
stormrage,1525,priest,shadow,56,25,31
tichondrius,1523,priest,shadow,24,16,8
dunemaul,1521,priest,shadow,42,22,20
area-52,1520,priest,shadow,42,21,21
tichondrius,1520,priest,shadow,48,23,25
stormrage,1514,priest,shadow,60,37,23
ravenholdt,1513,priest,shadow,192,99,93
dreadmaul,1512,priest,shadow,84,41,43
area-52,1510,priest,shadow,30,16,14
stormrage,1506,priest,shadow,102,59,43
proudmoore,1504,priest,shadow,94,49,45
sargeras,1499,priest,shadow,30,21,9
dalaran,1497,priest,shadow,30,20,10
emerald-dream,1493,priest,shadow,35,17,18
proudmoore,1488,priest,shadow,66,32,34
malganis,1488,priest,shadow,134,61,73
tichondrius,1482,priest,shadow,30,20,10
tichondrius,1480,priest,shadow,83,44,39
tichondrius,1474,priest,shadow,74,42,32
illidan,1472,priest,shadow,59,35,24
hyjal,1469,priest,shadow,42,22,20
illidan,1466,priest,shadow,78,44,34
tichondrius,1466,priest,shadow,29,16,13
hyjal,1461,priest,shadow,36,22,14
tichondrius,1461,priest,shadow,62,26,36
shattered-hand,1456,priest,shadow,30,17,13
frostmourne,1456,priest,shadow,89,47,42
area-52,1440,priest,shadow,18,15,3
tichondrius,1439,priest,shadow,30,15,15
tichondrius,1436,priest,shadow,75,38,37
ragnaros,1432,priest,shadow,30,18,12
area-52,1432,priest,shadow,140,68,72
sargeras,1431,priest,shadow,36,22,14
illidan,1431,priest,shadow,50,29,21
tichondrius,1430,priest,shadow,24,15,9
illidan,1429,priest,shadow,42,16,26
tichondrius,1426,priest,shadow,24,15,9
mannoroth,1425,priest,shadow,30,15,15
ragnaros,1422,priest,shadow,60,32,28
moon-guard,1419,priest,shadow,25,16,9
zuljin,1419,priest,shadow,32,20,12
tichondrius,1419,priest,shadow,123,57,66
sargeras,1414,priest,shadow,30,20,10
tichondrius,1414,priest,shadow,24,15,9
azralon,1411,priest,shadow,30,19,11
stormrage,1411,priest,shadow,30,18,12
sargeras,1405,priest,shadow,75,42,33
sargeras,1402,priest,shadow,29,15,14
ragnaros,1402,priest,shadow,29,15,14
barthilas,1400,priest,shadow,36,16,20
tichondrius,1396,priest,shadow,41,28,13
frostmourne,1396,priest,shadow,34,23,11
moon-guard,1395,priest,shadow,73,43,30
mannoroth,1390,priest,shadow,28,19,9
azralon,1389,priest,shadow,84,40,44
hydraxis,1388,priest,shadow,35,22,13
illidan,1387,priest,shadow,36,16,20
tichondrius,1386,priest,shadow,54,26,28
tichondrius,1381,priest,shadow,50,23,27
dalaran,1380,priest,shadow,72,32,40
akama,1378,priest,shadow,24,15,9
sargeras,1378,priest,shadow,60,37,23
tichondrius,1377,priest,shadow,24,20,4
azralon,1375,priest,shadow,41,29,12
area-52,1372,priest,shadow,23,16,7
illidan,1368,priest,shadow,26,15,11
thrall,1364,priest,shadow,83,50,33
arthas,1353,priest,shadow,60,28,32
aggramar,1351,priest,shadow,30,20,10
sargeras,1344,priest,shadow,24,14,10
illidan,1343,priest,shadow,18,14,4
dragonmaw,1342,priest,shadow,18,14,4
agamaggan,1342,priest,shadow,24,14,10
tichondrius,1342,priest,shadow,30,14,16
barthilas,1336,priest,shadow,77,51,26
skullcrusher,1336,priest,shadow,75,41,34
area-52,1335,priest,shadow,25,15,10
malganis,1335,priest,shadow,61,31,30
thrall,1332,priest,shadow,24,14,10
area-52,1330,priest,shadow,36,14,22
stormrage,1328,priest,shadow,24,16,8
wyrmrest-accord,1327,priest,shadow,34,15,19
ragnaros,1323,priest,shadow,30,16,14
zuljin,1321,priest,shadow,24,14,10
sargeras,1314,priest,shadow,30,14,16
barthilas,1311,priest,shadow,35,21,14
thrall,1303,priest,shadow,30,14,16
khazgoroth,1301,priest,shadow,65,25,40
emerald-dream,1295,priest,shadow,33,15,18
tichondrius,1293,priest,shadow,31,14,17
ragnaros,1292,priest,shadow,24,15,9
moon-guard,1292,priest,shadow,29,18,11
illidan,1290,priest,shadow,42,24,18
area-52,1287,priest,shadow,26,15,11
thrall,1285,priest,shadow,30,14,16
korgath,1282,priest,shadow,48,25,23
stormrage,1280,priest,shadow,61,26,35
bleeding-hollow,1279,priest,shadow,30,14,16
draktharon,1273,priest,shadow,22,19,3
stormrage,1268,priest,shadow,30,15,15
wyrmrest-accord,1258,priest,shadow,65,34,31
tichondrius,1257,priest,shadow,50,21,29
frostmourne,1254,priest,shadow,29,14,15
tichondrius,1253,priest,shadow,32,16,16
malganis,1248,priest,shadow,18,13,5
frostmourne,1248,priest,shadow,18,13,5
shadowmoon,1247,priest,shadow,30,13,17
demon-soul,1246,priest,shadow,54,32,22
sargeras,1246,priest,shadow,24,13,11
malganis,1246,priest,shadow,24,13,11
blackhand,1245,priest,shadow,18,13,5
tichondrius,1244,priest,shadow,24,13,11
stormrage,1244,priest,shadow,30,13,17
emerald-dream,1244,priest,shadow,60,19,41
sargeras,1243,priest,shadow,18,13,5
stormrage,1243,priest,shadow,54,26,28
kargath,1242,priest,shadow,24,13,11
daggerspine,1239,priest,shadow,30,13,17
tichondrius,1238,priest,shadow,21,14,7
area-52,1236,priest,shadow,24,13,11
bleeding-hollow,1235,priest,shadow,24,13,11
mannoroth,1208,priest,shadow,29,13,16
tichondrius,1199,priest,shadow,30,13,17
garona,1178,priest,shadow,24,14,10
tichondrius,1168,priest,shadow,24,13,11
tichondrius,1152,priest,shadow,12,12,0
lightninghoof,1152,priest,shadow,18,12,6
executus,1151,priest,shadow,18,12,6
tichondrius,1151,priest,shadow,22,13,9
dalaran,1148,priest,shadow,18,12,6
frostmourne,1146,priest,shadow,45,27,18
kelthuzad,1144,priest,shadow,18,12,6
barthilas,1143,priest,shadow,24,18,6
stormrage,1140,priest,shadow,59,33,26
korgath,1112,priest,shadow,54,26,28
tichondrius,1087,priest,shadow,23,12,11
nemesis,1074,priest,shadow,21,12,9
drenden,1071,priest,shadow,17,12,5
area-52,1056,priest,shadow,18,11,7
chogall,1056,priest,shadow,18,11,7
kelthuzad,1055,priest,shadow,12,11,1
tichondrius,1055,priest,shadow,18,11,7
kelthuzad,1055,priest,shadow,18,11,7
alterac-mountains,1055,priest,shadow,18,11,7
frostmourne,1055,priest,shadow,18,11,7
zuljin,1055,priest,shadow,24,11,13
sargeras,1054,priest,shadow,18,11,7
tichondrius,1054,priest,shadow,18,11,7
proudmoore,1054,priest,shadow,21,12,9
dalaran,1053,priest,shadow,18,11,7
quelthalas,1050,priest,shadow,18,11,7
malganis,1043,priest,shadow,18,11,7
whisperwind,1043,priest,shadow,18,11,7
darkspear,1023,priest,shadow,23,11,12
stormrage,1022,priest,shadow,23,11,12
archimonde,1004,priest,shadow,42,19,23
kelthuzad,989,priest,shadow,14,11,3
tichondrius,988,priest,shadow,22,11,11
moon-guard,982,priest,shadow,29,11,18
area-52,969,priest,shadow,110,54,56
burning-legion,965,priest,shadow,20,11,9
tichondrius,960,priest,shadow,12,10,2
tichondrius,960,priest,shadow,12,10,2
stormrage,960,priest,shadow,12,10,2
velen,960,priest,shadow,18,10,8
nemesis,959,priest,shadow,12,10,2
drakkari,959,priest,shadow,12,10,2
tichondrius,959,priest,shadow,18,10,8
stormrage,959,priest,shadow,18,10,8
area-52,959,priest,shadow,18,10,8
barthilas,959,priest,shadow,24,10,14
dalaran,959,priest,shadow,24,10,14
moon-guard,959,priest,shadow,30,10,20
zuljin,958,priest,shadow,12,10,2
malygos,958,priest,shadow,18,10,8
quelthalas,958,priest,shadow,18,10,8
wyrmrest-accord,957,priest,shadow,18,10,8
illidan,957,priest,shadow,18,10,8
lightnings-blade,956,priest,shadow,18,10,8
emerald-dream,956,priest,shadow,18,10,8
drakkari,956,priest,shadow,24,10,14
draktharon,955,priest,shadow,18,10,8
sargeras,908,priest,shadow,20,11,9
stormrage,895,priest,shadow,22,10,12
tichondrius,880,priest,shadow,13,10,3
deathwing,864,priest,shadow,12,9,3
ragnaros,864,priest,shadow,12,9,3
daggerspine,864,priest,shadow,18,9,9
kelthuzad,864,priest,shadow,18,9,9
azralon,863,priest,shadow,12,9,3
ravenholdt,863,priest,shadow,12,9,3
barthilas,863,priest,shadow,18,9,9
sargeras,863,priest,shadow,18,9,9
jubeithos,863,priest,shadow,18,9,9
dalaran,863,priest,shadow,18,9,9
thrall,863,priest,shadow,18,9,9
bonechewer,863,priest,shadow,18,9,9
tichondrius,863,priest,shadow,18,9,9
tichondrius,863,priest,shadow,24,9,15
azralon,862,priest,shadow,12,9,3
drakkari,862,priest,shadow,12,9,3
illidan,862,priest,shadow,12,9,3
jaedenar,862,priest,shadow,18,9,9
tichondrius,862,priest,shadow,18,9,9
thrall,862,priest,shadow,18,9,9
thunderlord,862,priest,shadow,30,9,21
tichondrius,861,priest,shadow,12,9,3
tichondrius,861,priest,shadow,12,9,3
stormrage,861,priest,shadow,24,9,15
ragnaros,860,priest,shadow,18,9,9
illidan,849,priest,shadow,18,9,9
frostmane,843,priest,shadow,31,9,22
dalaran,816,priest,shadow,21,10,11
hyjal,815,priest,shadow,15,9,6
barthilas,813,priest,shadow,15,9,6
alleria,800,priest,shadow,16,9,7
tichondrius,799,priest,shadow,11,9,2
darkspear,798,priest,shadow,14,9,5
area-52,768,priest,shadow,12,8,4
frostmourne,768,priest,shadow,12,8,4
darkspear,768,priest,shadow,12,8,4
area-52,768,priest,shadow,12,8,4
thrall,768,priest,shadow,12,8,4
tichondrius,768,priest,shadow,12,8,4
tichondrius,768,priest,shadow,12,8,4
frostmourne,768,priest,shadow,12,8,4
tichondrius,768,priest,shadow,12,8,4
emerald-dream,768,priest,shadow,15,8,7
emerald-dream,768,priest,shadow,18,8,10
moon-guard,768,priest,shadow,18,8,10
bonechewer,768,priest,shadow,18,8,10
lightbringer,768,priest,shadow,18,8,10
malganis,768,priest,shadow,18,8,10
area-52,768,priest,shadow,18,8,10
area-52,768,priest,shadow,18,8,10
tichondrius,768,priest,shadow,24,8,16
frostmourne,767,priest,shadow,12,8,4
sargeras,767,priest,shadow,12,8,4
shadowsong,767,priest,shadow,12,8,4
darkspear,767,priest,shadow,12,8,4
stormrage,767,priest,shadow,12,8,4
nesingwary,767,priest,shadow,12,8,4
sargeras,767,priest,shadow,15,9,6
area-52,767,priest,shadow,18,8,10
frostmourne,767,priest,shadow,18,8,10
azralon,767,priest,shadow,18,8,10
frostmourne,767,priest,shadow,18,8,10
illidan,767,priest,shadow,18,8,10
shadow-council,766,priest,shadow,12,8,4
ragnaros,766,priest,shadow,12,8,4
khazgoroth,766,priest,shadow,12,8,4
frostmourne,766,priest,shadow,12,8,4
bonechewer,766,priest,shadow,18,8,10
stormrage,766,priest,shadow,18,8,10
kelthuzad,763,priest,shadow,12,8,4
tichondrius,762,priest,shadow,18,8,10
stormrage,762,priest,shadow,18,8,10
exodar,760,priest,shadow,12,8,4
the-scryers,755,priest,shadow,20,9,11
emerald-dream,751,priest,shadow,15,9,6
sargeras,751,priest,shadow,17,8,9
moon-guard,735,priest,shadow,20,9,11
thrall,734,priest,shadow,18,9,9
tichondrius,719,priest,shadow,17,8,9
azuremyst,718,priest,shadow,17,8,9
area-52,717,priest,shadow,11,8,3
dawnbringer,714,priest,shadow,29,10,19
destromath,672,priest,shadow,12,7,5
frostmourne,672,priest,shadow,12,7,5
the-forgotten-coast,672,priest,shadow,12,7,5
stormrage,672,priest,shadow,12,7,5
bleeding-hollow,672,priest,shadow,12,7,5
tichondrius,672,priest,shadow,12,7,5
malganis,672,priest,shadow,12,7,5
stormrage,672,priest,shadow,12,7,5
area-52,672,priest,shadow,12,7,5
black-dragonflight,672,priest,shadow,12,7,5
sargeras,672,priest,shadow,12,7,5
medivh,672,priest,shadow,12,7,5
malganis,672,priest,shadow,12,7,5
malganis,672,priest,shadow,12,7,5
zuljin,672,priest,shadow,12,7,5
lightbringer,672,priest,shadow,12,7,5
tichondrius,672,priest,shadow,12,7,5
moon-guard,672,priest,shadow,12,7,5
dark-iron,672,priest,shadow,12,7,5
sargeras,672,priest,shadow,12,7,5
frostmourne,672,priest,shadow,12,7,5
azjolnerub,672,priest,shadow,12,7,5
tichondrius,672,priest,shadow,18,7,11
azralon,672,priest,shadow,18,7,11
tichondrius,672,priest,shadow,24,7,17
dalaran,671,priest,shadow,12,7,5
barthilas,671,priest,shadow,12,7,5
barthilas,671,priest,shadow,12,7,5
windrunner,671,priest,shadow,12,7,5
tichondrius,671,priest,shadow,12,7,5
azralon,671,priest,shadow,18,7,11
whisperwind,671,priest,shadow,18,7,11
turalyon,671,priest,shadow,18,7,11
tichondrius,670,priest,shadow,12,7,5
kelthuzad,670,priest,shadow,12,7,5
stormrage,670,priest,shadow,16,8,8
sargeras,670,priest,shadow,18,7,11
emerald-dream,669,priest,shadow,24,7,17
aerie-peak,639,priest,shadow,11,7,4
emerald-dream,599,priest,shadow,21,7,14
illidan,591,priest,shadow,13,7,6
zuljin,587,priest,shadow,19,7,12
draka,584,priest,shadow,17,8,9
area-52,576,priest,shadow,6,6,0
emerald-dream,576,priest,shadow,6,6,0
frostmourne,576,priest,shadow,6,6,0
frostmourne,576,priest,shadow,6,6,0
moon-guard,576,priest,shadow,6,6,0
blackrock,576,priest,shadow,8,6,2
khazgoroth,576,priest,shadow,10,7,3
tichondrius,576,priest,shadow,12,6,6
tichondrius,576,priest,shadow,12,6,6
frostmourne,576,priest,shadow,12,6,6
barthilas,576,priest,shadow,12,6,6
malganis,576,priest,shadow,12,6,6
malganis,576,priest,shadow,12,6,6
azralon,576,priest,shadow,12,6,6
ragnaros,576,priest,shadow,12,6,6
tichondrius,576,priest,shadow,12,6,6
stormrage,576,priest,shadow,12,6,6
akama,576,priest,shadow,12,6,6
hyjal,576,priest,shadow,12,6,6
tichondrius,576,priest,shadow,12,6,6
frostmane,576,priest,shadow,12,6,6
illidan,576,priest,shadow,12,6,6
emerald-dream,576,priest,shadow,12,6,6
azralon,576,priest,shadow,12,6,6
turalyon,576,priest,shadow,12,6,6
tichondrius,576,priest,shadow,12,6,6
aggramar,576,priest,shadow,12,6,6
nagrand,576,priest,shadow,12,6,6
illidan,576,priest,shadow,12,6,6
saurfang,576,priest,shadow,12,6,6
laughing-skull,576,priest,shadow,18,6,12
stormreaver,576,priest,shadow,18,6,12
bleeding-hollow,576,priest,shadow,18,6,12
tichondrius,576,priest,shadow,18,6,12
amanthul,576,priest,shadow,18,6,12
tichondrius,576,priest,shadow,18,6,12
blackrock,576,priest,shadow,24,6,18
frostmourne,575,priest,shadow,12,6,6
darkspear,575,priest,shadow,12,6,6
proudmoore,575,priest,shadow,12,6,6
jubeithos,575,priest,shadow,12,6,6
azshara,575,priest,shadow,18,6,12
moon-guard,574,priest,shadow,12,6,6
mannoroth,571,priest,shadow,12,6,6
hyjal,559,priest,shadow,11,6,5
frostmourne,527,priest,shadow,11,6,5
tichondrius,521,priest,shadow,22,8,14
gallywix,517,priest,shadow,15,7,8
moon-guard,511,priest,shadow,12,7,5
tichondrius,480,priest,shadow,6,5,1
moon-guard,480,priest,shadow,6,5,1
emerald-dream,480,priest,shadow,6,5,1
azralon,480,priest,shadow,6,5,1
illidan,480,priest,shadow,6,5,1
sargeras,480,priest,shadow,6,5,1
executus,480,priest,shadow,6,5,1
nemesis,480,priest,shadow,6,5,1
quelthalas,480,priest,shadow,6,5,1
moon-guard,480,priest,shadow,6,5,1
tichondrius,480,priest,shadow,6,5,1
illidan,480,priest,shadow,6,5,1
darkspear,480,priest,shadow,6,5,1
chogall,480,priest,shadow,6,5,1
quelthalas,480,priest,shadow,6,5,1
tichondrius,480,priest,shadow,6,5,1
tichondrius,480,priest,shadow,6,5,1
wyrmrest-accord,480,priest,shadow,6,5,1
zuljin,480,priest,shadow,6,5,1
barthilas,480,priest,shadow,6,5,1
elune,480,priest,shadow,6,5,1
bleeding-hollow,480,priest,shadow,6,5,1
frostmourne,480,priest,shadow,10,6,4
hydraxis,480,priest,shadow,12,5,7
tichondrius,480,priest,shadow,12,5,7
nemesis,480,priest,shadow,12,5,7
illidan,480,priest,shadow,12,5,7
ragnaros,480,priest,shadow,12,5,7
stormreaver,480,priest,shadow,12,5,7
stormrage,480,priest,shadow,12,5,7
korgath,480,priest,shadow,12,5,7
tichondrius,480,priest,shadow,12,5,7
tichondrius,480,priest,shadow,12,5,7
velen,480,priest,shadow,12,5,7
tichondrius,480,priest,shadow,12,5,7
kelthuzad,480,priest,shadow,12,5,7
kelthuzad,480,priest,shadow,12,5,7
kul-tiras,480,priest,shadow,12,5,7
darkspear,480,priest,shadow,12,5,7
area-52,480,priest,shadow,12,5,7
arthas,480,priest,shadow,13,5,8
tichondrius,480,priest,shadow,16,6,10
emerald-dream,480,priest,shadow,16,6,10
tichondrius,480,priest,shadow,17,6,11
area-52,480,priest,shadow,18,5,13
suramar,480,priest,shadow,19,5,14
stormrage,479,priest,shadow,6,5,1
nemesis,479,priest,shadow,12,5,7
ragnaros,479,priest,shadow,12,5,7
sargeras,479,priest,shadow,12,5,7
aerie-peak,478,priest,shadow,12,5,7
malganis,447,priest,shadow,11,5,6
skywall,447,priest,shadow,11,5,6
queldorei,446,priest,shadow,10,6,4
tichondrius,431,priest,shadow,9,6,3
malganis,400,priest,shadow,7,5,2
dalaran,400,priest,shadow,13,5,8
bleeding-hollow,399,priest,shadow,5,5,0
elune,384,priest,shadow,6,4,2
medivh,384,priest,shadow,6,4,2
moon-guard,384,priest,shadow,6,4,2
tichondrius,384,priest,shadow,6,4,2
chogall,384,priest,shadow,6,4,2
illidan,384,priest,shadow,6,4,2
illidan,384,priest,shadow,6,4,2
tichondrius,384,priest,shadow,6,4,2
area-52,384,priest,shadow,6,4,2
area-52,384,priest,shadow,6,4,2
tichondrius,384,priest,shadow,6,4,2
zuljin,384,priest,shadow,6,4,2
malganis,384,priest,shadow,6,4,2
area-52,384,priest,shadow,6,4,2
zuljin,384,priest,shadow,6,4,2
tichondrius,384,priest,shadow,6,4,2
area-52,384,priest,shadow,6,4,2
area-52,384,priest,shadow,6,4,2
moon-guard,384,priest,shadow,6,4,2
tichondrius,384,priest,shadow,6,4,2
tichondrius,384,priest,shadow,6,4,2
tichondrius,384,priest,shadow,6,4,2
ragnaros,384,priest,shadow,6,4,2
proudmoore,384,priest,shadow,6,4,2
arygos,384,priest,shadow,6,4,2
kilrogg,384,priest,shadow,6,4,2
darkspear,384,priest,shadow,6,4,2
bonechewer,384,priest,shadow,6,4,2
stormrage,384,priest,shadow,6,4,2
thrall,384,priest,shadow,6,4,2
stormrage,384,priest,shadow,6,4,2
darkspear,384,priest,shadow,6,4,2
moon-guard,384,priest,shadow,6,4,2
sargeras,384,priest,shadow,6,4,2
mugthol,384,priest,shadow,6,4,2
frostmourne,384,priest,shadow,6,4,2
khazgoroth,384,priest,shadow,6,4,2
azralon,384,priest,shadow,6,4,2
dalaran,384,priest,shadow,6,4,2
azralon,384,priest,shadow,6,4,2
azralon,384,priest,shadow,6,4,2
demon-soul,384,priest,shadow,6,4,2
emerald-dream,384,priest,shadow,6,4,2
moon-guard,384,priest,shadow,6,4,2
sargeras,384,priest,shadow,6,4,2
emerald-dream,384,priest,shadow,6,4,2
emerald-dream,384,priest,shadow,6,4,2
deathwing,384,priest,shadow,6,4,2
illidan,384,priest,shadow,8,5,3
deathwing,384,priest,shadow,11,4,7
illidan,384,priest,shadow,12,4,8
quelthalas,384,priest,shadow,12,4,8
area-52,384,priest,shadow,12,4,8
stormrage,384,priest,shadow,12,4,8
alleria,384,priest,shadow,12,4,8
moon-guard,384,priest,shadow,12,4,8
ragnaros,384,priest,shadow,12,4,8
frostmourne,384,priest,shadow,12,4,8
turalyon,384,priest,shadow,12,4,8
gorefiend,384,priest,shadow,12,4,8
frostmourne,384,priest,shadow,12,4,8
sargeras,384,priest,shadow,12,4,8
frostmourne,384,priest,shadow,12,4,8
nemesis,384,priest,shadow,12,4,8
tichondrius,384,priest,shadow,12,4,8
tichondrius,384,priest,shadow,12,4,8
cenarion-circle,384,priest,shadow,18,4,14
runetotem,383,priest,shadow,6,4,2
barthilas,383,priest,shadow,12,4,8
zuljin,383,priest,shadow,12,4,8
frostmourne,382,priest,shadow,6,4,2
illidan,382,priest,shadow,12,4,8
blood-furnace,351,priest,shadow,8,5,3
emerald-dream,351,priest,shadow,11,4,7
nordrassil,319,priest,shadow,5,4,1
tichondrius,288,priest,shadow,6,3,3
emerald-dream,288,priest,shadow,6,3,3
tichondrius,288,priest,shadow,6,3,3
lightbringer,288,priest,shadow,6,3,3
illidan,288,priest,shadow,6,3,3
emerald-dream,288,priest,shadow,6,3,3
frostmourne,288,priest,shadow,6,3,3
emerald-dream,288,priest,shadow,6,3,3
moon-guard,288,priest,shadow,6,3,3
tichondrius,288,priest,shadow,6,3,3
frostmourne,288,priest,shadow,6,3,3
dalaran,288,priest,shadow,6,3,3
terenas,288,priest,shadow,6,3,3
kalecgos,288,priest,shadow,6,3,3
tichondrius,288,priest,shadow,6,3,3
tichondrius,288,priest,shadow,6,3,3
frostmourne,288,priest,shadow,6,3,3
tichondrius,288,priest,shadow,6,3,3
tichondrius,288,priest,shadow,6,3,3
amanthul,288,priest,shadow,6,3,3
amanthul,288,priest,shadow,6,3,3
emerald-dream,288,priest,shadow,6,3,3
moon-guard,288,priest,shadow,6,3,3
azjolnerub,288,priest,shadow,6,3,3
illidan,288,priest,shadow,6,3,3
quelthalas,288,priest,shadow,6,3,3
zuljin,288,priest,shadow,6,3,3
frostmourne,288,priest,shadow,6,3,3
nemesis,288,priest,shadow,6,3,3
tichondrius,288,priest,shadow,6,3,3
bleeding-hollow,288,priest,shadow,6,3,3
hellscream,288,priest,shadow,6,3,3
bleeding-hollow,288,priest,shadow,6,3,3
bleeding-hollow,288,priest,shadow,6,3,3
tichondrius,288,priest,shadow,6,3,3
kargath,288,priest,shadow,6,3,3
dalaran,288,priest,shadow,6,3,3
bloodhoof,288,priest,shadow,6,3,3
hellscream,288,priest,shadow,6,3,3
area-52,288,priest,shadow,6,3,3
ragnaros,288,priest,shadow,6,3,3
frostmourne,288,priest,shadow,6,3,3
sargeras,288,priest,shadow,6,3,3
sargeras,288,priest,shadow,6,3,3
area-52,288,priest,shadow,6,3,3
tichondrius,288,priest,shadow,6,3,3
tichondrius,288,priest,shadow,6,3,3
area-52,288,priest,shadow,6,3,3
tichondrius,288,priest,shadow,6,3,3
andorhal,288,priest,shadow,6,3,3
garrosh,288,priest,shadow,6,3,3
frostmourne,288,priest,shadow,6,3,3
ragnaros,288,priest,shadow,6,3,3
quelthalas,288,priest,shadow,6,3,3
area-52,288,priest,shadow,6,3,3
quelthalas,288,priest,shadow,6,3,3
kelthuzad,288,priest,shadow,6,3,3
black-dragonflight,288,priest,shadow,6,3,3
illidan,288,priest,shadow,6,3,3
sargeras,288,priest,shadow,6,3,3
illidan,288,priest,shadow,6,3,3
sargeras,288,priest,shadow,6,3,3
kelthuzad,288,priest,shadow,6,3,3
sargeras,288,priest,shadow,6,3,3
proudmoore,288,priest,shadow,6,3,3
quelthalas,288,priest,shadow,6,3,3
proudmoore,288,priest,shadow,12,3,9
kul-tiras,288,priest,shadow,12,3,9
darkspear,288,priest,shadow,12,3,9
the-underbog,288,priest,shadow,12,3,9
burning-legion,288,priest,shadow,12,3,9
stormrage,288,priest,shadow,12,3,9
barthilas,287,priest,shadow,6,3,3
veknilash,287,priest,shadow,7,3,4
blackrock,275,priest,shadow,32,7,25
dentarg,240,priest,shadow,15,3,12
bleeding-hollow,192,priest,shadow,4,3,1
thrall,192,priest,shadow,4,3,1
tichondrius,192,priest,shadow,4,3,1
area-52,192,priest,shadow,6,2,4
kelthuzad,192,priest,shadow,6,2,4
kelthuzad,192,priest,shadow,6,2,4
kelthuzad,192,priest,shadow,6,2,4
sargeras,192,priest,shadow,6,2,4
area-52,192,priest,shadow,6,2,4
ragnaros,192,priest,shadow,6,2,4
thrall,192,priest,shadow,6,2,4
illidan,192,priest,shadow,6,2,4
area-52,192,priest,shadow,6,2,4
illidan,192,priest,shadow,6,2,4
ragnaros,192,priest,shadow,6,2,4
earthen-ring,192,priest,shadow,6,2,4
area-52,192,priest,shadow,6,2,4
moon-guard,192,priest,shadow,6,2,4
the-forgotten-coast,192,priest,shadow,6,2,4
drakkari,192,priest,shadow,6,2,4
kaelthas,192,priest,shadow,6,2,4
illidan,192,priest,shadow,6,2,4
azralon,192,priest,shadow,6,2,4
stormrage,192,priest,shadow,6,2,4
stormrage,192,priest,shadow,6,2,4
stormrage,192,priest,shadow,6,2,4
tichondrius,192,priest,shadow,6,2,4
azralon,192,priest,shadow,6,2,4
emerald-dream,192,priest,shadow,6,2,4
ravencrest,192,priest,shadow,6,2,4
ravencrest,192,priest,shadow,6,2,4
stormreaver,192,priest,shadow,6,2,4
zuljin,192,priest,shadow,6,2,4
tichondrius,192,priest,shadow,6,2,4
nemesis,192,priest,shadow,6,2,4
zuljin,192,priest,shadow,6,2,4
zangarmarsh,192,priest,shadow,6,2,4
sargeras,192,priest,shadow,6,2,4
tichondrius,192,priest,shadow,6,2,4
tichondrius,192,priest,shadow,6,2,4
dalaran,192,priest,shadow,6,2,4
illidan,192,priest,shadow,6,2,4
terenas,192,priest,shadow,6,2,4
tichondrius,192,priest,shadow,6,2,4
lightbringer,192,priest,shadow,6,2,4
proudmoore,192,priest,shadow,6,2,4
suramar,192,priest,shadow,6,2,4
darkspear,192,priest,shadow,6,2,4
frostmourne,192,priest,shadow,6,2,4
frostmourne,192,priest,shadow,6,2,4
senjin,192,priest,shadow,6,2,4
azjolnerub,192,priest,shadow,6,2,4
aegwynn,192,priest,shadow,6,2,4
frostmourne,192,priest,shadow,6,2,4
tichondrius,192,priest,shadow,6,2,4
moon-guard,192,priest,shadow,6,2,4
illidan,192,priest,shadow,6,2,4
nathrezim,192,priest,shadow,6,2,4
frostmane,192,priest,shadow,6,2,4
tichondrius,192,priest,shadow,6,2,4
shuhalo,192,priest,shadow,12,2,10
ragnaros,192,priest,shadow,12,2,10
tichondrius,192,priest,shadow,12,2,10
bleeding-hollow,192,priest,shadow,12,2,10
frostmane,192,priest,shadow,13,2,11
bleeding-hollow,159,priest,shadow,5,2,3
malganis,159,priest,shadow,5,2,3
ragnaros,159,priest,shadow,5,2,3
sargeras,159,priest,shadow,9,2,7
azralon,159,priest,shadow,11,2,9
alleria,138,priest,shadow,9,4,5
tichondrius,128,priest,shadow,4,2,2
frostmourne,126,priest,shadow,4,4,0
emerald-dream,96,priest,shadow,3,2,1
area-52,96,priest,shadow,3,2,1
kiljaeden,96,priest,shadow,3,2,1
aggramar,96,priest,shadow,3,2,1
area-52,96,priest,shadow,8,2,6
malganis,96,priest,shadow,6,1,5
area-52,96,priest,shadow,6,1,5
frostmourne,96,priest,shadow,6,1,5
malganis,96,priest,shadow,6,1,5
tichondrius,96,priest,shadow,6,1,5
proudmoore,96,priest,shadow,6,1,5
tichondrius,96,priest,shadow,6,1,5
kiljaeden,96,priest,shadow,6,1,5
aerie-peak,96,priest,shadow,6,1,5
tichondrius,96,priest,shadow,6,1,5
tichondrius,96,priest,shadow,6,1,5
frostmourne,96,priest,shadow,6,1,5
tichondrius,96,priest,shadow,6,1,5
proudmoore,96,priest,shadow,6,1,5
zuljin,96,priest,shadow,6,1,5
illidan,96,priest,shadow,6,1,5
darkspear,96,priest,shadow,6,1,5
zuljin,96,priest,shadow,6,1,5
shattered-hand,96,priest,shadow,6,1,5
illidan,96,priest,shadow,6,1,5
illidan,96,priest,shadow,6,1,5
deathwing,96,priest,shadow,6,1,5
stormrage,96,priest,shadow,6,1,5
dalaran,96,priest,shadow,6,1,5
azralon,96,priest,shadow,6,1,5
emerald-dream,96,priest,shadow,6,1,5
barthilas,96,priest,shadow,6,1,5
tichondrius,96,priest,shadow,6,1,5
illidan,96,priest,shadow,6,1,5
stormrage,96,priest,shadow,6,1,5
bleeding-hollow,96,priest,shadow,12,1,11
ragnaros,79,priest,shadow,5,1,4
tichondrius,79,priest,shadow,5,1,4
cenarius,48,priest,shadow,3,1,2
frostmourne,31,priest,shadow,2,1,1
azjolnerub,16,priest,shadow,1,1,0
tichondrius,1890,rogue,outlaw,54,28,26
tichondrius,1762,rogue,outlaw,117,58,59
kiljaeden,1697,rogue,outlaw,60,30,30
tichondrius,1688,rogue,outlaw,47,19,28
illidan,1655,rogue,outlaw,80,37,43
thunderlord,1646,rogue,outlaw,170,84,86
sargeras,1630,rogue,outlaw,95,55,40
sargeras,1616,rogue,outlaw,35,18,17
tichondrius,1603,rogue,outlaw,45,29,16
thrall,1600,rogue,outlaw,36,26,10
ragnaros,1585,rogue,outlaw,88,45,43
kelthuzad,1564,rogue,outlaw,26,17,9
velen,1534,rogue,outlaw,42,22,20
illidan,1533,rogue,outlaw,50,28,22
frostmourne,1530,rogue,outlaw,66,28,38
tichondrius,1515,rogue,outlaw,60,33,27
illidan,1512,rogue,outlaw,97,51,46
frostmourne,1440,rogue,outlaw,47,19,28
quelthalas,1427,rogue,outlaw,59,31,28
shandris,1409,rogue,outlaw,47,22,25
area-52,1399,rogue,outlaw,43,30,13
bleeding-hollow,1379,rogue,outlaw,30,17,13
norgannon,1378,rogue,outlaw,24,18,6
emerald-dream,1373,rogue,outlaw,48,17,31
ragnaros,1354,rogue,outlaw,144,65,79
area-52,1315,rogue,outlaw,36,17,19
proudmoore,1300,rogue,outlaw,34,18,16
wyrmrest-accord,1247,rogue,outlaw,30,14,16
quelthalas,1244,rogue,outlaw,27,14,13
wyrmrest-accord,1146,rogue,outlaw,24,12,12
tichondrius,1078,rogue,outlaw,27,13,14
tichondrius,1050,rogue,outlaw,24,11,13
quelthalas,1050,rogue,outlaw,54,18,36
zuljin,1035,rogue,outlaw,30,15,15
tichondrius,1029,rogue,outlaw,54,20,34
bladefist,1027,rogue,outlaw,24,12,12
dark-iron,1008,rogue,outlaw,27,12,15
hakkar,998,rogue,outlaw,30,13,17
ragnaros,989,rogue,outlaw,27,13,14
tichondrius,960,rogue,outlaw,24,10,14
eredar,960,rogue,outlaw,24,10,14
stormrage,959,rogue,outlaw,18,10,8
tichondrius,959,rogue,outlaw,18,10,8
shadowmoon,958,rogue,outlaw,24,10,14
quelthalas,957,rogue,outlaw,16,11,5
azralon,956,rogue,outlaw,24,10,14
tichondrius,949,rogue,outlaw,24,10,14
senjin,910,rogue,outlaw,31,11,20
gurubashi,907,rogue,outlaw,23,10,13
stormrage,863,rogue,outlaw,24,9,15
stormrage,862,rogue,outlaw,18,9,9
sisters-of-elune,860,rogue,outlaw,18,9,9
sargeras,853,rogue,outlaw,30,9,21
silvermoon,840,rogue,outlaw,24,11,13
tichondrius,816,rogue,outlaw,15,9,6
frostmourne,768,rogue,outlaw,12,8,4
moon-guard,767,rogue,outlaw,12,8,4
thunderlord,763,rogue,outlaw,21,9,12
bloodscalp,672,rogue,outlaw,12,7,5
illidan,672,rogue,outlaw,12,7,5
kargath,672,rogue,outlaw,30,7,23
kelthuzad,671,rogue,outlaw,12,7,5
tichondrius,671,rogue,outlaw,18,7,11
tichondrius,670,rogue,outlaw,12,7,5
trollbane,670,rogue,outlaw,12,7,5
ghostlands,623,rogue,outlaw,17,7,10
area-52,576,rogue,outlaw,12,6,6
emerald-dream,576,rogue,outlaw,12,6,6
tichondrius,576,rogue,outlaw,12,6,6
ravenholdt,576,rogue,outlaw,12,6,6
sargeras,576,rogue,outlaw,12,6,6
azgalor,575,rogue,outlaw,12,6,6
draka,574,rogue,outlaw,12,6,6
zuljin,574,rogue,outlaw,18,6,12
area-52,573,rogue,outlaw,12,6,6
stormrage,573,rogue,outlaw,12,6,6
stormrage,571,rogue,outlaw,12,6,6
nemesis,571,rogue,outlaw,12,6,6
kelthuzad,480,rogue,outlaw,6,5,1
stormrage,480,rogue,outlaw,6,5,1
tichondrius,480,rogue,outlaw,6,5,1
tichondrius,480,rogue,outlaw,6,5,1
burning-legion,480,rogue,outlaw,12,5,7
silvermoon,480,rogue,outlaw,18,5,13
arathor,465,rogue,outlaw,24,5,19
malganis,384,rogue,outlaw,6,4,2
tichondrius,384,rogue,outlaw,6,4,2
tichondrius,384,rogue,outlaw,6,4,2
stormrage,384,rogue,outlaw,12,4,8
frostmourne,384,rogue,outlaw,12,4,8
kelthuzad,384,rogue,outlaw,18,4,14
quelthalas,383,rogue,outlaw,6,4,2
moon-guard,383,rogue,outlaw,12,4,8
skullcrusher,381,rogue,outlaw,12,4,8
tanaris,351,rogue,outlaw,11,4,7
tichondrius,288,rogue,outlaw,6,3,3
moon-guard,288,rogue,outlaw,6,3,3
tichondrius,288,rogue,outlaw,6,3,3
hyjal,288,rogue,outlaw,6,3,3
area-52,288,rogue,outlaw,6,3,3
stormrage,288,rogue,outlaw,6,3,3
ragnaros,288,rogue,outlaw,6,3,3
azralon,288,rogue,outlaw,6,3,3
ghostlands,288,rogue,outlaw,12,3,9
moon-guard,288,rogue,outlaw,18,3,15
sentinels,287,rogue,outlaw,6,3,3
dalaran,256,rogue,outlaw,10,3,7
illidan,253,rogue,outlaw,11,3,8
arthas,192,rogue,outlaw,6,2,4
stormrage,192,rogue,outlaw,6,2,4
bleeding-hollow,192,rogue,outlaw,6,2,4
stormrage,192,rogue,outlaw,6,2,4
malganis,192,rogue,outlaw,6,2,4
kiljaeden,192,rogue,outlaw,6,2,4
tichondrius,192,rogue,outlaw,6,2,4
saurfang,192,rogue,outlaw,6,2,4
kiljaeden,192,rogue,outlaw,6,2,4
stormrage,192,rogue,outlaw,6,2,4
cenarius,192,rogue,outlaw,6,2,4
moon-guard,192,rogue,outlaw,6,2,4
proudmoore,192,rogue,outlaw,6,2,4
frostwolf,191,rogue,outlaw,6,2,4
icecrown,191,rogue,outlaw,6,2,4
azgalor,190,rogue,outlaw,12,2,10
arthas,96,rogue,outlaw,6,1,5
quelthalas,96,rogue,outlaw,6,1,5
sargeras,96,rogue,outlaw,6,1,5
sargeras,96,rogue,outlaw,6,1,5
lethon,96,rogue,outlaw,6,1,5
azralon,96,rogue,outlaw,6,1,5
barthilas,96,rogue,outlaw,6,1,5
stormrage,96,rogue,outlaw,6,1,5
moon-guard,96,rogue,outlaw,6,1,5
ghostlands,96,rogue,outlaw,12,1,11
undermine,95,rogue,outlaw,6,1,5
korgath,95,rogue,outlaw,6,1,5
area-52,16,rogue,outlaw,1,1,0
wyrmrest-accord,2120,rogue,subtlety,280,148,132
thunderlord,2111,rogue,subtlety,60,41,19
tichondrius,1921,rogue,subtlety,66,32,34
tichondrius,1894,rogue,subtlety,60,36,24
dalaran,1881,rogue,subtlety,66,30,36
tichondrius,1865,rogue,subtlety,60,31,29
tichondrius,1865,rogue,subtlety,54,25,29
tichondrius,1853,rogue,subtlety,115,60,55
tichondrius,1849,rogue,subtlety,89,46,43
tichondrius,1842,rogue,subtlety,36,24,12
sargeras,1833,rogue,subtlety,60,33,27
tichondrius,1828,rogue,subtlety,42,20,22
kelthuzad,1825,rogue,subtlety,83,40,43
stormrage,1823,rogue,subtlety,68,43,25
emerald-dream,1818,rogue,subtlety,65,35,30
tichondrius,1817,rogue,subtlety,63,30,33
tichondrius,1782,rogue,subtlety,60,26,34
arthas,1774,rogue,subtlety,48,28,20
sargeras,1770,rogue,subtlety,36,20,16
tichondrius,1765,rogue,subtlety,95,56,39
sargeras,1757,rogue,subtlety,61,30,31
tichondrius,1747,rogue,subtlety,36,23,13
ragnaros,1743,rogue,subtlety,96,52,44
azralon,1735,rogue,subtlety,118,64,54
tichondrius,1723,rogue,subtlety,74,35,39
stormrage,1700,rogue,subtlety,48,25,23
tichondrius,1697,rogue,subtlety,107,56,51
moon-guard,1677,rogue,subtlety,82,38,44
tichondrius,1668,rogue,subtlety,54,30,24
tichondrius,1667,rogue,subtlety,42,22,20
tichondrius,1632,rogue,subtlety,42,30,12
sargeras,1627,rogue,subtlety,66,33,33
illidan,1609,rogue,subtlety,107,68,39
sargeras,1609,rogue,subtlety,36,17,19
emerald-dream,1603,rogue,subtlety,35,21,14
kelthuzad,1603,rogue,subtlety,48,21,27
tichondrius,1602,rogue,subtlety,51,22,29
ragnaros,1598,rogue,subtlety,36,20,16
dalaran,1597,rogue,subtlety,29,17,12
moon-guard,1584,rogue,subtlety,92,49,43
ysera,1581,rogue,subtlety,45,25,20
aegwynn,1579,rogue,subtlety,30,20,10
barthilas,1572,rogue,subtlety,90,40,50
tichondrius,1560,rogue,subtlety,35,17,18
stormrage,1554,rogue,subtlety,66,26,40
frostmourne,1537,rogue,subtlety,32,18,14
arygos,1532,rogue,subtlety,51,28,23
crushridge,1531,rogue,subtlety,120,61,59
kelthuzad,1527,rogue,subtlety,24,16,8
tichondrius,1507,rogue,subtlety,36,17,19
kelthuzad,1502,rogue,subtlety,29,16,13
azralon,1499,rogue,subtlety,68,31,37
icecrown,1498,rogue,subtlety,120,76,44
sargeras,1489,rogue,subtlety,44,20,24
frostmourne,1477,rogue,subtlety,60,30,30
tichondrius,1474,rogue,subtlety,48,28,20
azralon,1471,rogue,subtlety,59,32,27
illidan,1458,rogue,subtlety,36,17,19
stormrage,1457,rogue,subtlety,60,24,36
thrall,1451,rogue,subtlety,36,18,18
thrall,1450,rogue,subtlety,66,38,28
frostmourne,1448,rogue,subtlety,90,58,32
rivendare,1446,rogue,subtlety,44,22,22
dark-iron,1431,rogue,subtlety,42,26,16
daggerspine,1431,rogue,subtlety,36,16,20
illidan,1431,rogue,subtlety,40,17,23
stormrage,1427,rogue,subtlety,116,62,54
lothar,1426,rogue,subtlety,30,15,15
dalaran,1424,rogue,subtlety,82,44,38
warsong,1422,rogue,subtlety,24,17,7
wyrmrest-accord,1417,rogue,subtlety,61,32,29
area-52,1415,rogue,subtlety,36,23,13
wyrmrest-accord,1410,rogue,subtlety,74,34,40
dalaran,1394,rogue,subtlety,54,26,28
dalaran,1393,rogue,subtlety,47,20,27
dalaran,1385,rogue,subtlety,41,20,21
barthilas,1379,rogue,subtlety,24,15,9
quelthalas,1365,rogue,subtlety,47,28,19
tichondrius,1364,rogue,subtlety,60,32,28
drakkari,1359,rogue,subtlety,36,22,14
tichondrius,1356,rogue,subtlety,36,16,20
illidan,1337,rogue,subtlety,24,14,10
stormrage,1327,rogue,subtlety,36,19,17
tichondrius,1327,rogue,subtlety,54,23,31
lightnings-blade,1322,rogue,subtlety,24,14,10
tichondrius,1320,rogue,subtlety,30,19,11
drakkari,1315,rogue,subtlety,42,16,26
bleeding-hollow,1313,rogue,subtlety,30,14,16
tichondrius,1306,rogue,subtlety,176,83,93
proudmoore,1304,rogue,subtlety,24,14,10
muradin,1300,rogue,subtlety,24,16,8
barthilas,1299,rogue,subtlety,59,24,35
moon-guard,1292,rogue,subtlety,36,20,16
skullcrusher,1285,rogue,subtlety,45,29,16
icecrown,1281,rogue,subtlety,42,17,25
thrall,1280,rogue,subtlety,47,23,24
nemesis,1265,rogue,subtlety,38,19,19
malganis,1258,rogue,subtlety,30,15,15
spirestone,1255,rogue,subtlety,89,43,46
hakkar,1249,rogue,subtlety,92,46,46
tichondrius,1246,rogue,subtlety,36,13,23
zuljin,1243,rogue,subtlety,30,13,17
hydraxis,1242,rogue,subtlety,30,13,17
kiljaeden,1239,rogue,subtlety,30,13,17
kiljaeden,1227,rogue,subtlety,24,13,11
tichondrius,1222,rogue,subtlety,30,13,17
stormrage,1215,rogue,subtlety,25,14,11
tichondrius,1199,rogue,subtlety,34,15,19
moonrunner,1191,rogue,subtlety,58,20,38
korgath,1190,rogue,subtlety,30,18,12
tichondrius,1181,rogue,subtlety,28,13,15
destromath,1177,rogue,subtlety,29,13,16
proudmoore,1173,rogue,subtlety,58,28,30
blood-furnace,1155,rogue,subtlety,39,15,24
sargeras,1152,rogue,subtlety,18,12,6
blades-edge,1152,rogue,subtlety,18,12,6
dalaran,1152,rogue,subtlety,24,12,12
tichondrius,1151,rogue,subtlety,18,12,6
frostmourne,1151,rogue,subtlety,45,18,27
whisperwind,1151,rogue,subtlety,30,12,18
arthas,1150,rogue,subtlety,36,12,24
dalaran,1149,rogue,subtlety,24,12,12
tichondrius,1149,rogue,subtlety,57,27,30
proudmoore,1146,rogue,subtlety,24,12,12
bonechewer,1144,rogue,subtlety,24,12,12
tichondrius,1143,rogue,subtlety,49,23,26
area-52,1140,rogue,subtlety,24,12,12
ragnaros,1129,rogue,subtlety,48,26,22
tichondrius,1129,rogue,subtlety,24,12,12
frostmourne,1125,rogue,subtlety,48,21,27
aegwynn,1121,rogue,subtlety,45,20,25
malganis,1119,rogue,subtlety,30,13,17
illidan,1099,rogue,subtlety,36,16,20
arthas,1093,rogue,subtlety,61,36,25
frostmourne,1081,rogue,subtlety,24,12,12
gundrak,1070,rogue,subtlety,24,13,11
area-52,1056,rogue,subtlety,18,11,7
sargeras,1056,rogue,subtlety,24,11,13
frostmourne,1054,rogue,subtlety,18,11,7
tichondrius,1054,rogue,subtlety,24,11,13
nerzhul,1053,rogue,subtlety,12,11,1
illidan,1053,rogue,subtlety,18,11,7
area-52,1050,rogue,subtlety,20,11,9
ragnaros,1048,rogue,subtlety,18,11,7
stormrage,1048,rogue,subtlety,24,11,13
nemesis,1045,rogue,subtlety,33,12,21
arathor,1043,rogue,subtlety,71,36,35
ragnaros,1041,rogue,subtlety,24,12,12
barthilas,1040,rogue,subtlety,18,11,7
tichondrius,1037,rogue,subtlety,55,22,33
barthilas,1035,rogue,subtlety,33,12,21
ragnaros,1026,rogue,subtlety,18,11,7
spinebreaker,1022,rogue,subtlety,46,26,20
thrall,1011,rogue,subtlety,25,16,9
area-52,1008,rogue,subtlety,60,30,30
tichondrius,1007,rogue,subtlety,23,11,12
lightninghoof,1005,rogue,subtlety,21,12,9
tichondrius,990,rogue,subtlety,21,11,10
stormrage,987,rogue,subtlety,82,42,40
whisperwind,980,rogue,subtlety,48,22,26
tichondrius,977,rogue,subtlety,26,13,13
veknilash,960,rogue,subtlety,12,10,2
tichondrius,960,rogue,subtlety,18,10,8
proudmoore,960,rogue,subtlety,18,10,8
tichondrius,959,rogue,subtlety,18,10,8
kelthuzad,959,rogue,subtlety,18,10,8
nagrand,959,rogue,subtlety,18,10,8
tichondrius,958,rogue,subtlety,18,10,8
tichondrius,958,rogue,subtlety,18,10,8
sargeras,958,rogue,subtlety,86,44,42
tichondrius,958,rogue,subtlety,30,10,20
tichondrius,957,rogue,subtlety,12,10,2
illidan,957,rogue,subtlety,24,10,14
emerald-dream,955,rogue,subtlety,18,10,8
bleeding-hollow,955,rogue,subtlety,18,10,8
tichondrius,953,rogue,subtlety,21,11,10
stormrage,953,rogue,subtlety,24,10,14
quelthalas,915,rogue,subtlety,18,10,8
illidan,896,rogue,subtlety,24,10,14
balnazzar,865,rogue,subtlety,16,11,5
dalaran,865,rogue,subtlety,22,11,11
tichondrius,864,rogue,subtlety,12,9,3
illidan,864,rogue,subtlety,18,9,9
frostmourne,863,rogue,subtlety,18,9,9
stormrage,863,rogue,subtlety,30,9,21
barthilas,862,rogue,subtlety,18,9,9
azralon,862,rogue,subtlety,24,9,15
tichondrius,860,rogue,subtlety,18,9,9
sargeras,859,rogue,subtlety,22,12,10
azralon,859,rogue,subtlety,21,9,12
tichondrius,856,rogue,subtlety,18,9,9
azralon,855,rogue,subtlety,24,9,15
dragonmaw,854,rogue,subtlety,18,9,9
tichondrius,854,rogue,subtlety,24,9,15
sargeras,847,rogue,subtlety,23,10,13
illidan,842,rogue,subtlety,18,9,9
emerald-dream,842,rogue,subtlety,18,9,9
cenarius,837,rogue,subtlety,24,9,15
zuljin,831,rogue,subtlety,20,10,10
dalaran,814,rogue,subtlety,11,9,2
destromath,810,rogue,subtlety,30,12,18
moon-guard,768,rogue,subtlety,12,8,4
tichondrius,768,rogue,subtlety,12,8,4
kelthuzad,768,rogue,subtlety,12,8,4
frostmourne,768,rogue,subtlety,12,8,4
sargeras,768,rogue,subtlety,12,8,4
quelthalas,768,rogue,subtlety,17,8,9
illidan,768,rogue,subtlety,18,8,10
frostmourne,767,rogue,subtlety,18,8,10
kelthuzad,767,rogue,subtlety,18,8,10
tichondrius,767,rogue,subtlety,18,8,10
moon-guard,767,rogue,subtlety,18,8,10
illidan,767,rogue,subtlety,18,8,10
malfurion,766,rogue,subtlety,18,8,10
mugthol,764,rogue,subtlety,12,8,4
khadgar,764,rogue,subtlety,24,8,16
frostwolf,759,rogue,subtlety,18,8,10
wyrmrest-accord,758,rogue,subtlety,18,8,10
wyrmrest-accord,749,rogue,subtlety,42,15,27
uldaman,748,rogue,subtlety,15,9,6
skullcrusher,735,rogue,subtlety,17,8,9
agamaggan,733,rogue,subtlety,17,8,9
quelthalas,732,rogue,subtlety,17,10,7
tichondrius,729,rogue,subtlety,26,10,16
bleeding-hollow,725,rogue,subtlety,18,9,9
tichondrius,719,rogue,subtlety,15,8,7
barthilas,695,rogue,subtlety,24,8,16
stormrage,672,rogue,subtlety,12,7,5
area-52,672,rogue,subtlety,12,7,5
stormrage,672,rogue,subtlety,12,7,5
tichondrius,672,rogue,subtlety,12,7,5
area-52,672,rogue,subtlety,12,7,5
draka,672,rogue,subtlety,12,7,5
area-52,672,rogue,subtlety,18,7,11
frostmourne,672,rogue,subtlety,18,7,11
azralon,672,rogue,subtlety,24,7,17
tichondrius,671,rogue,subtlety,12,7,5
frostmourne,671,rogue,subtlety,12,7,5
frostmourne,671,rogue,subtlety,12,7,5
barthilas,671,rogue,subtlety,12,7,5
area-52,671,rogue,subtlety,12,7,5
frostmane,671,rogue,subtlety,18,7,11
malganis,671,rogue,subtlety,18,7,11
ragnaros,670,rogue,subtlety,12,7,5
tichondrius,670,rogue,subtlety,24,7,17
sargeras,669,rogue,subtlety,12,7,5
tichondrius,669,rogue,subtlety,18,7,11
malganis,667,rogue,subtlety,12,7,5
tichondrius,667,rogue,subtlety,18,7,11
dalaran,639,rogue,subtlety,17,7,10
tichondrius,617,rogue,subtlety,22,8,14
tichondrius,608,rogue,subtlety,22,7,15
turalyon,607,rogue,subtlety,11,7,4
bleeding-hollow,576,rogue,subtlety,6,6,0
tichondrius,576,rogue,subtlety,6,6,0
quelthalas,576,rogue,subtlety,10,7,3
drenden,576,rogue,subtlety,12,6,6
mugthol,576,rogue,subtlety,12,6,6
rexxar,576,rogue,subtlety,12,6,6
bonechewer,576,rogue,subtlety,12,6,6
icecrown,576,rogue,subtlety,12,6,6
deathwing,576,rogue,subtlety,12,6,6
illidan,576,rogue,subtlety,12,6,6
stormrage,576,rogue,subtlety,12,6,6
ursin,576,rogue,subtlety,12,6,6
illidan,576,rogue,subtlety,12,6,6
emerald-dream,576,rogue,subtlety,12,6,6
illidan,576,rogue,subtlety,12,6,6
ragnaros,576,rogue,subtlety,18,6,12
tichondrius,576,rogue,subtlety,18,6,12
area-52,576,rogue,subtlety,24,6,18
frostwolf,575,rogue,subtlety,12,6,6
stormrage,575,rogue,subtlety,12,6,6
moon-guard,575,rogue,subtlety,12,6,6
jubeithos,575,rogue,subtlety,12,6,6
tichondrius,575,rogue,subtlety,12,6,6
silvermoon,575,rogue,subtlety,18,6,12
stormrage,575,rogue,subtlety,18,6,12
proudmoore,573,rogue,subtlety,12,6,6
garona,571,rogue,subtlety,27,6,21
quelthalas,568,rogue,subtlety,12,6,6
tichondrius,522,rogue,subtlety,19,7,12
perenolde,511,rogue,subtlety,16,6,10
sargeras,480,rogue,subtlety,6,5,1
area-52,480,rogue,subtlety,6,5,1
illidan,480,rogue,subtlety,6,5,1
hyjal,480,rogue,subtlety,6,5,1
darkspear,480,rogue,subtlety,12,5,7
blades-edge,480,rogue,subtlety,12,5,7
korgath,480,rogue,subtlety,12,5,7
skywall,480,rogue,subtlety,12,5,7
the-venture-co,480,rogue,subtlety,12,5,7
area-52,480,rogue,subtlety,12,5,7
darkspear,480,rogue,subtlety,12,5,7
tichondrius,480,rogue,subtlety,12,5,7
sargeras,480,rogue,subtlety,12,5,7
lightnings-blade,480,rogue,subtlety,12,5,7
barthilas,480,rogue,subtlety,12,5,7
tichondrius,480,rogue,subtlety,12,5,7
azralon,480,rogue,subtlety,12,5,7
azralon,480,rogue,subtlety,12,5,7
stormrage,480,rogue,subtlety,12,5,7
tichondrius,480,rogue,subtlety,12,5,7
magtheridon,480,rogue,subtlety,12,5,7
stormrage,480,rogue,subtlety,12,5,7
tichondrius,480,rogue,subtlety,12,5,7
tichondrius,480,rogue,subtlety,12,5,7
stormrage,480,rogue,subtlety,13,5,8
kelthuzad,480,rogue,subtlety,18,5,13
tichondrius,480,rogue,subtlety,18,5,13
amanthul,479,rogue,subtlety,6,5,1
tichondrius,479,rogue,subtlety,12,5,7
bleeding-hollow,479,rogue,subtlety,12,5,7
mugthol,479,rogue,subtlety,18,5,13
tichondrius,479,rogue,subtlety,23,5,18
illidan,478,rogue,subtlety,8,5,3
illidan,478,rogue,subtlety,12,5,7
azralon,478,rogue,subtlety,12,5,7
thunderlord,477,rogue,subtlety,12,5,7
wyrmrest-accord,477,rogue,subtlety,18,5,13
amanthul,475,rogue,subtlety,12,5,7
sargeras,447,rogue,subtlety,11,5,6
sargeras,426,rogue,subtlety,14,6,8
tichondrius,416,rogue,subtlety,10,5,5
area-52,384,rogue,subtlety,6,4,2
nemesis,384,rogue,subtlety,6,4,2
illidan,384,rogue,subtlety,6,4,2
hellscream,384,rogue,subtlety,6,4,2
tichondrius,384,rogue,subtlety,6,4,2
illidan,384,rogue,subtlety,6,4,2
stormrage,384,rogue,subtlety,6,4,2
dreadmaul,384,rogue,subtlety,6,4,2
norgannon,384,rogue,subtlety,6,4,2
warsong,384,rogue,subtlety,6,4,2
tichondrius,384,rogue,subtlety,6,4,2
ragnaros,384,rogue,subtlety,6,4,2
sargeras,384,rogue,subtlety,6,4,2
zuljin,384,rogue,subtlety,6,4,2
illidan,384,rogue,subtlety,6,4,2
frostmourne,384,rogue,subtlety,6,4,2
tichondrius,384,rogue,subtlety,6,4,2
moon-guard,384,rogue,subtlety,6,4,2
tichondrius,384,rogue,subtlety,6,4,2
bleeding-hollow,384,rogue,subtlety,6,4,2
stormrage,384,rogue,subtlety,6,4,2
emerald-dream,384,rogue,subtlety,6,4,2
stormrage,384,rogue,subtlety,6,4,2
sargeras,384,rogue,subtlety,12,4,8
ragnaros,384,rogue,subtlety,12,4,8
illidan,384,rogue,subtlety,12,4,8
windrunner,384,rogue,subtlety,12,4,8
emerald-dream,384,rogue,subtlety,12,4,8
emerald-dream,384,rogue,subtlety,12,4,8
frostmourne,384,rogue,subtlety,12,4,8
proudmoore,384,rogue,subtlety,12,4,8
tichondrius,384,rogue,subtlety,12,4,8
stormrage,384,rogue,subtlety,12,4,8
tichondrius,384,rogue,subtlety,12,4,8
bleeding-hollow,384,rogue,subtlety,12,4,8
lothar,384,rogue,subtlety,12,4,8
tichondrius,384,rogue,subtlety,12,4,8
stormrage,384,rogue,subtlety,12,4,8
tichondrius,383,rogue,subtlety,6,4,2
tichondrius,383,rogue,subtlety,6,4,2
dalaran,383,rogue,subtlety,12,4,8
frostmourne,383,rogue,subtlety,12,4,8
aerie-peak,383,rogue,subtlety,13,4,9
nemesis,382,rogue,subtlety,6,4,2
moon-guard,381,rogue,subtlety,12,4,8
zuljin,335,rogue,subtlety,11,4,7
daggerspine,327,rogue,subtlety,15,5,10
illidan,320,rogue,subtlety,16,4,12
tichondrius,288,rogue,subtlety,6,3,3
tichondrius,288,rogue,subtlety,6,3,3
bleeding-hollow,288,rogue,subtlety,6,3,3
tichondrius,288,rogue,subtlety,6,3,3
arthas,288,rogue,subtlety,6,3,3
dalaran,288,rogue,subtlety,6,3,3
illidan,288,rogue,subtlety,6,3,3
tichondrius,288,rogue,subtlety,6,3,3
tichondrius,288,rogue,subtlety,6,3,3
tichondrius,288,rogue,subtlety,6,3,3
tichondrius,288,rogue,subtlety,6,3,3
tichondrius,288,rogue,subtlety,6,3,3
tichondrius,288,rogue,subtlety,6,3,3
proudmoore,288,rogue,subtlety,6,3,3
malganis,288,rogue,subtlety,6,3,3
frostmourne,288,rogue,subtlety,6,3,3
tichondrius,288,rogue,subtlety,6,3,3
tichondrius,288,rogue,subtlety,6,3,3
tichondrius,288,rogue,subtlety,6,3,3
azjolnerub,288,rogue,subtlety,6,3,3
kelthuzad,288,rogue,subtlety,6,3,3
stormscale,288,rogue,subtlety,6,3,3
frostwolf,288,rogue,subtlety,6,3,3
khaz-modan,288,rogue,subtlety,6,3,3
kiljaeden,288,rogue,subtlety,6,3,3
blackrock,288,rogue,subtlety,6,3,3
malganis,288,rogue,subtlety,6,3,3
barthilas,288,rogue,subtlety,6,3,3
emerald-dream,288,rogue,subtlety,6,3,3
wyrmrest-accord,288,rogue,subtlety,6,3,3
arygos,288,rogue,subtlety,6,3,3
tichondrius,288,rogue,subtlety,6,3,3
ragnaros,288,rogue,subtlety,6,3,3
windrunner,288,rogue,subtlety,6,3,3
stormrage,288,rogue,subtlety,6,3,3
stormrage,288,rogue,subtlety,6,3,3
nerzhul,288,rogue,subtlety,6,3,3
dunemaul,288,rogue,subtlety,6,3,3
tichondrius,288,rogue,subtlety,6,3,3
moon-guard,288,rogue,subtlety,6,3,3
stormrage,288,rogue,subtlety,6,3,3
tichondrius,288,rogue,subtlety,6,3,3
tichondrius,288,rogue,subtlety,6,3,3
stormrage,288,rogue,subtlety,6,3,3
sargeras,288,rogue,subtlety,9,4,5
malganis,288,rogue,subtlety,7,3,4
sargeras,288,rogue,subtlety,12,3,9
azgalor,288,rogue,subtlety,12,3,9
malganis,288,rogue,subtlety,12,3,9
malganis,288,rogue,subtlety,12,3,9
sargeras,288,rogue,subtlety,12,3,9
zuljin,288,rogue,subtlety,12,3,9
sargeras,288,rogue,subtlety,12,3,9
dragonmaw,288,rogue,subtlety,12,3,9
barthilas,288,rogue,subtlety,12,3,9
stormrage,288,rogue,subtlety,12,3,9
tichondrius,288,rogue,subtlety,18,3,15
area-52,287,rogue,subtlety,6,3,3
kelthuzad,287,rogue,subtlety,6,3,3
boulderfist,287,rogue,subtlety,6,3,3
malygos,286,rogue,subtlety,6,3,3
tichondrius,239,rogue,subtlety,5,3,2
frostmourne,234,rogue,subtlety,11,5,6
fenris,234,rogue,subtlety,9,4,5
ragnaros,192,rogue,subtlety,6,2,4
ragnaros,192,rogue,subtlety,6,2,4
thrall,192,rogue,subtlety,6,2,4
bleeding-hollow,192,rogue,subtlety,6,2,4
tichondrius,192,rogue,subtlety,6,2,4
whisperwind,192,rogue,subtlety,6,2,4
tichondrius,192,rogue,subtlety,6,2,4
tichondrius,192,rogue,subtlety,6,2,4
stormrage,192,rogue,subtlety,6,2,4
ravencrest,192,rogue,subtlety,6,2,4
bleeding-hollow,192,rogue,subtlety,6,2,4
tichondrius,192,rogue,subtlety,6,2,4
bleeding-hollow,192,rogue,subtlety,6,2,4
illidan,192,rogue,subtlety,6,2,4
barthilas,192,rogue,subtlety,6,2,4
veknilash,192,rogue,subtlety,6,2,4
daggerspine,192,rogue,subtlety,6,2,4
zuljin,192,rogue,subtlety,6,2,4
area-52,192,rogue,subtlety,6,2,4
area-52,192,rogue,subtlety,6,2,4
dathremar,192,rogue,subtlety,6,2,4
tortheldrin,192,rogue,subtlety,6,2,4
illidan,192,rogue,subtlety,6,2,4
emerald-dream,192,rogue,subtlety,6,2,4
darkspear,192,rogue,subtlety,6,2,4
mugthol,192,rogue,subtlety,6,2,4
wyrmrest-accord,192,rogue,subtlety,6,2,4
frostmourne,192,rogue,subtlety,6,2,4
hyjal,192,rogue,subtlety,6,2,4
tichondrius,192,rogue,subtlety,6,2,4
shattered-halls,192,rogue,subtlety,6,2,4
tichondrius,192,rogue,subtlety,6,2,4
shandris,192,rogue,subtlety,6,2,4
sargeras,192,rogue,subtlety,6,2,4
nerzhul,192,rogue,subtlety,6,2,4
frostmourne,192,rogue,subtlety,6,2,4
quelthalas,192,rogue,subtlety,6,2,4
illidan,192,rogue,subtlety,6,2,4
tichondrius,192,rogue,subtlety,6,2,4
illidan,192,rogue,subtlety,6,2,4
tichondrius,192,rogue,subtlety,6,2,4
wyrmrest-accord,192,rogue,subtlety,6,2,4
azuremyst,192,rogue,subtlety,6,2,4
icecrown,192,rogue,subtlety,6,2,4
gundrak,192,rogue,subtlety,6,2,4
stormscale,192,rogue,subtlety,6,2,4
kelthuzad,192,rogue,subtlety,6,2,4
shadowmoon,192,rogue,subtlety,6,2,4
malganis,192,rogue,subtlety,6,2,4
sargeras,192,rogue,subtlety,6,2,4
darkspear,192,rogue,subtlety,6,2,4
sargeras,192,rogue,subtlety,6,2,4
area-52,192,rogue,subtlety,6,2,4
wyrmrest-accord,192,rogue,subtlety,6,2,4
tichondrius,192,rogue,subtlety,6,2,4
ghostlands,192,rogue,subtlety,8,2,6
bloodscalp,192,rogue,subtlety,8,2,6
bonechewer,192,rogue,subtlety,12,2,10
illidan,192,rogue,subtlety,12,2,10
illidan,192,rogue,subtlety,12,2,10
azralon,192,rogue,subtlety,12,2,10
tichondrius,192,rogue,subtlety,12,2,10
illidan,192,rogue,subtlety,12,2,10
azshara,191,rogue,subtlety,6,2,4
ragnaros,191,rogue,subtlety,6,2,4
ragnaros,191,rogue,subtlety,6,2,4
ragnaros,191,rogue,subtlety,6,2,4
area-52,191,rogue,subtlety,12,2,10
tichondrius,159,rogue,subtlety,5,2,3
moon-guard,159,rogue,subtlety,5,2,3
area-52,159,rogue,subtlety,5,2,3
tichondrius,159,rogue,subtlety,5,2,3
dentarg,138,rogue,subtlety,10,3,7
frostmourne,128,rogue,subtlety,4,2,2
darkspear,128,rogue,subtlety,4,2,2
sargeras,128,rogue,subtlety,4,2,2
azralon,112,rogue,subtlety,7,2,5
arthas,96,rogue,subtlety,3,2,1
the-forgotten-coast,96,rogue,subtlety,3,2,1
stormrage,96,rogue,subtlety,6,1,5
stormrage,96,rogue,subtlety,6,1,5
malganis,96,rogue,subtlety,6,1,5
terenas,96,rogue,subtlety,6,1,5
tichondrius,96,rogue,subtlety,6,1,5
malganis,96,rogue,subtlety,6,1,5
tichondrius,96,rogue,subtlety,6,1,5
stormrage,96,rogue,subtlety,6,1,5
dalaran,96,rogue,subtlety,6,1,5
lightnings-blade,96,rogue,subtlety,6,1,5
stormrage,96,rogue,subtlety,6,1,5
stormrage,96,rogue,subtlety,6,1,5
tichondrius,96,rogue,subtlety,6,1,5
executus,96,rogue,subtlety,6,1,5
tichondrius,96,rogue,subtlety,6,1,5
magtheridon,96,rogue,subtlety,6,1,5
proudmoore,96,rogue,subtlety,6,1,5
frostwolf,96,rogue,subtlety,6,1,5
malygos,96,rogue,subtlety,6,1,5
malganis,96,rogue,subtlety,6,1,5
barthilas,96,rogue,subtlety,6,1,5
shadowmoon,96,rogue,subtlety,6,1,5
firetree,96,rogue,subtlety,6,1,5
stormscale,96,rogue,subtlety,6,1,5
doomhammer,96,rogue,subtlety,6,1,5
kelthuzad,96,rogue,subtlety,6,1,5
durotan,96,rogue,subtlety,6,1,5
kiljaeden,96,rogue,subtlety,6,1,5
bonechewer,96,rogue,subtlety,6,1,5
bleeding-hollow,89,rogue,subtlety,8,3,5
ghostlands,63,rogue,subtlety,2,2,0
barthilas,42,rogue,subtlety,10,2,8
dalaran,42,rogue,subtlety,11,2,9
proudmoore,31,rogue,subtlety,2,1,1
sargeras,2126,rogue,assassination,72,37,35
tichondrius,2024,rogue,assassination,66,34,32
tichondrius,1960,rogue,assassination,60,30,30
kelthuzad,1929,rogue,assassination,83,36,47
drenden,1871,rogue,assassination,48,23,25
arygos,1851,rogue,assassination,47,20,27
frostmourne,1846,rogue,assassination,78,38,40
azralon,1840,rogue,assassination,51,24,27
tichondrius,1838,rogue,assassination,54,31,23
the-venture-co,1838,rogue,assassination,54,27,27
bleeding-hollow,1837,rogue,assassination,60,30,30
tichondrius,1831,rogue,assassination,57,23,34
tichondrius,1808,rogue,assassination,36,19,17
tichondrius,1803,rogue,assassination,89,43,46
tichondrius,1771,rogue,assassination,42,19,23
tichondrius,1714,rogue,assassination,68,34,34
moon-guard,1700,rogue,assassination,58,26,32
tichondrius,1692,rogue,assassination,48,28,20
tichondrius,1690,rogue,assassination,78,47,31
draenor,1685,rogue,assassination,30,18,12
khazgoroth,1673,rogue,assassination,66,29,37
tichondrius,1670,rogue,assassination,54,28,26
barthilas,1650,rogue,assassination,41,21,20
zuljin,1648,rogue,assassination,45,20,25
darkspear,1645,rogue,assassination,48,24,24
black-dragonflight,1642,rogue,assassination,162,84,78
illidan,1632,rogue,assassination,148,75,73
proudmoore,1604,rogue,assassination,60,27,33
blackrock,1600,rogue,assassination,30,17,13
stormrage,1596,rogue,assassination,41,20,21
lightbringer,1589,rogue,assassination,42,17,25
moon-guard,1588,rogue,assassination,30,18,12
sargeras,1587,rogue,assassination,53,25,28
tichondrius,1583,rogue,assassination,158,79,79
lothar,1580,rogue,assassination,114,52,62
illidan,1579,rogue,assassination,40,20,20
proudmoore,1552,rogue,assassination,48,27,21
skullcrusher,1552,rogue,assassination,42,23,19
drenden,1550,rogue,assassination,119,58,61
tichondrius,1542,rogue,assassination,66,32,34
tichondrius,1532,rogue,assassination,42,22,20
tichondrius,1522,rogue,assassination,36,16,20
stormrage,1513,rogue,assassination,39,19,20
thrall,1505,rogue,assassination,66,27,39
sargeras,1495,rogue,assassination,36,17,19
moon-guard,1487,rogue,assassination,153,82,71
tichondrius,1487,rogue,assassination,78,23,55
emerald-dream,1477,rogue,assassination,29,16,13
area-52,1477,rogue,assassination,55,26,29
bleeding-hollow,1456,rogue,assassination,60,26,34
tichondrius,1439,rogue,assassination,77,38,39
frostwolf,1435,rogue,assassination,135,73,62
proudmoore,1422,rogue,assassination,142,73,69
kiljaeden,1410,rogue,assassination,87,42,45
zuljin,1389,rogue,assassination,41,17,24
arthas,1378,rogue,assassination,54,27,27
bloodscalp,1359,rogue,assassination,23,15,8
frostmourne,1345,rogue,assassination,48,21,27
area-52,1339,rogue,assassination,60,26,34
lightnings-blade,1335,rogue,assassination,30,19,11
tichondrius,1327,rogue,assassination,24,14,10
tichondrius,1319,rogue,assassination,30,14,16
frostmourne,1317,rogue,assassination,60,32,28
illidan,1306,rogue,assassination,53,27,26
moon-guard,1305,rogue,assassination,29,15,14
tichondrius,1304,rogue,assassination,30,14,16
drakkari,1281,rogue,assassination,36,16,20
thrall,1264,rogue,assassination,44,24,20
queldorei,1259,rogue,assassination,47,20,27
shadowmoon,1255,rogue,assassination,71,31,40
bleeding-hollow,1248,rogue,assassination,30,15,15
barthilas,1246,rogue,assassination,35,17,18
tichondrius,1246,rogue,assassination,36,13,23
tichondrius,1233,rogue,assassination,24,13,11
spirestone,1227,rogue,assassination,24,14,10
kelthuzad,1222,rogue,assassination,30,15,15
illidan,1178,rogue,assassination,50,23,27
quelthalas,1177,rogue,assassination,25,15,10
nerzhul,1175,rogue,assassination,48,27,21
proudmoore,1151,rogue,assassination,24,12,12
tichondrius,1151,rogue,assassination,30,12,18
quelthalas,1140,rogue,assassination,30,16,14
tichondrius,1135,rogue,assassination,25,14,11
moon-guard,1126,rogue,assassination,106,52,54
azralon,1123,rogue,assassination,44,20,24
ragnaros,1107,rogue,assassination,24,13,11
tichondrius,1098,rogue,assassination,30,12,18
stormrage,1095,rogue,assassination,52,28,24
tichondrius,1075,rogue,assassination,32,12,20
illidan,1056,rogue,assassination,24,11,13
malganis,1055,rogue,assassination,18,11,7
stormrage,1055,rogue,assassination,39,16,23
sargeras,1054,rogue,assassination,20,11,9
dalaran,1054,rogue,assassination,24,11,13
tichondrius,1054,rogue,assassination,24,11,13
tichondrius,1053,rogue,assassination,30,11,19
frostmourne,1053,rogue,assassination,30,11,19
kiljaeden,1048,rogue,assassination,24,12,12
nemesis,1048,rogue,assassination,24,11,13
ragnaros,1016,rogue,assassination,18,11,7
shadowsong,990,rogue,assassination,37,15,22
tichondrius,975,rogue,assassination,19,11,8
thunderlord,963,rogue,assassination,37,18,19
sargeras,960,rogue,assassination,12,10,2
bleeding-hollow,960,rogue,assassination,18,10,8
tichondrius,960,rogue,assassination,24,10,14
stormrage,960,rogue,assassination,24,10,14
tichondrius,960,rogue,assassination,24,10,14
moon-guard,957,rogue,assassination,24,10,14
stormrage,957,rogue,assassination,30,10,20
moon-guard,956,rogue,assassination,30,10,20
thunderlord,947,rogue,assassination,18,10,8
nemesis,944,rogue,assassination,18,10,8
proudmoore,942,rogue,assassination,18,10,8
tichondrius,938,rogue,assassination,18,10,8
quelthalas,935,rogue,assassination,30,10,20
tichondrius,928,rogue,assassination,33,12,21
sargeras,926,rogue,assassination,20,11,9
nemesis,916,rogue,assassination,55,25,30
dalaran,897,rogue,assassination,43,10,33
stormrage,894,rogue,assassination,17,10,7
tichondrius,877,rogue,assassination,40,10,30
sargeras,864,rogue,assassination,12,9,3
quelthalas,864,rogue,assassination,24,9,15
arthas,863,rogue,assassination,18,9,9
tichondrius,863,rogue,assassination,18,9,9
garrosh,863,rogue,assassination,24,9,15
darkspear,861,rogue,assassination,18,9,9
proudmoore,859,rogue,assassination,24,9,15
malganis,857,rogue,assassination,30,9,21
proudmoore,856,rogue,assassination,27,10,17
kaelthas,855,rogue,assassination,24,9,15
black-dragonflight,812,rogue,assassination,34,10,24
sargeras,785,rogue,assassination,20,9,11
sargeras,768,rogue,assassination,21,9,12
stormrage,767,rogue,assassination,15,9,6
ragnaros,767,rogue,assassination,18,8,10
ragnaros,767,rogue,assassination,18,8,10
ragnaros,767,rogue,assassination,24,8,16
tichondrius,766,rogue,assassination,12,8,4
kelthuzad,766,rogue,assassination,18,8,10
rexxar,765,rogue,assassination,18,8,10
illidan,764,rogue,assassination,24,8,16
area-52,763,rogue,assassination,24,8,16
drakkari,762,rogue,assassination,12,8,4
nemesis,753,rogue,assassination,21,9,12
dalaran,752,rogue,assassination,18,8,10
malygos,751,rogue,assassination,22,9,13
barthilas,732,rogue,assassination,29,8,21
zuljin,720,rogue,assassination,21,8,13
sargeras,714,rogue,assassination,14,9,5
tichondrius,704,rogue,assassination,10,8,2
ragnaros,672,rogue,assassination,12,7,5
mannoroth,672,rogue,assassination,12,7,5
stormrage,672,rogue,assassination,18,7,11
stormrage,672,rogue,assassination,24,7,17
nemesis,671,rogue,assassination,12,7,5
area-52,671,rogue,assassination,12,7,5
stormrage,671,rogue,assassination,12,7,5
malganis,671,rogue,assassination,18,7,11
stormrage,671,rogue,assassination,18,7,11
tichondrius,671,rogue,assassination,18,7,11
demon-soul,671,rogue,assassination,18,7,11
malganis,669,rogue,assassination,18,7,11
burning-blade,667,rogue,assassination,18,7,11
area-52,667,rogue,assassination,24,7,17
area-52,655,rogue,assassination,11,7,4
kelthuzad,623,rogue,assassination,11,7,4
ragnaros,618,rogue,assassination,16,9,7
bleeding-hollow,607,rogue,assassination,14,7,7
illidan,576,rogue,assassination,12,6,6
malganis,576,rogue,assassination,12,6,6
tichondrius,576,rogue,assassination,12,6,6
tichondrius,576,rogue,assassination,12,6,6
azralon,576,rogue,assassination,12,6,6
frostmourne,576,rogue,assassination,12,6,6
blood-furnace,576,rogue,assassination,12,6,6
ghostlands,576,rogue,assassination,12,6,6
tichondrius,576,rogue,assassination,12,6,6
stormrage,576,rogue,assassination,12,6,6
tichondrius,576,rogue,assassination,12,6,6
area-52,576,rogue,assassination,12,6,6
icecrown,576,rogue,assassination,18,6,12
thrall,576,rogue,assassination,18,6,12
thrall,575,rogue,assassination,12,6,6
tichondrius,575,rogue,assassination,12,6,6
kiljaeden,574,rogue,assassination,17,6,11
andorhal,572,rogue,assassination,12,6,6
elune,571,rogue,assassination,12,6,6
fizzcrank,571,rogue,assassination,18,6,12
nemesis,567,rogue,assassination,18,6,12
aerie-peak,536,rogue,assassination,22,6,16
tichondrius,528,rogue,assassination,9,6,3
onyxia,511,rogue,assassination,10,6,4
tichondrius,480,rogue,assassination,6,5,1
frostmourne,480,rogue,assassination,6,5,1
frostmourne,480,rogue,assassination,7,5,2
bleeding-hollow,480,rogue,assassination,12,5,7
emerald-dream,480,rogue,assassination,12,5,7
fizzcrank,480,rogue,assassination,12,5,7
stormrage,480,rogue,assassination,12,5,7
tichondrius,480,rogue,assassination,12,5,7
tichondrius,480,rogue,assassination,12,5,7
stormrage,480,rogue,assassination,12,5,7
dalaran,480,rogue,assassination,12,5,7
silvermoon,480,rogue,assassination,12,5,7
illidan,480,rogue,assassination,30,5,25
tichondrius,479,rogue,assassination,12,5,7
moon-guard,479,rogue,assassination,12,5,7
arthas,479,rogue,assassination,18,5,13
ragnaros,478,rogue,assassination,12,5,7
stormrage,478,rogue,assassination,12,5,7
whisperwind,476,rogue,assassination,12,5,7
tortheldrin,473,rogue,assassination,18,5,13
stormreaver,472,rogue,assassination,12,5,7
malganis,447,rogue,assassination,8,6,2
tichondrius,384,rogue,assassination,6,4,2
tichondrius,384,rogue,assassination,6,4,2
hyjal,384,rogue,assassination,6,4,2
gurubashi,384,rogue,assassination,6,4,2
boulderfist,384,rogue,assassination,6,4,2
nemesis,384,rogue,assassination,6,4,2
antonidas,384,rogue,assassination,6,4,2
emerald-dream,384,rogue,assassination,6,4,2
ysera,384,rogue,assassination,6,4,2
tichondrius,384,rogue,assassination,6,4,2
burning-legion,384,rogue,assassination,6,4,2
illidan,384,rogue,assassination,12,4,8
wyrmrest-accord,384,rogue,assassination,12,4,8
stormrage,384,rogue,assassination,12,4,8
stormrage,384,rogue,assassination,12,4,8
shadowsong,384,rogue,assassination,12,4,8
tichondrius,384,rogue,assassination,12,4,8
area-52,384,rogue,assassination,12,4,8
sargeras,384,rogue,assassination,12,4,8
proudmoore,384,rogue,assassination,12,4,8
stormrage,384,rogue,assassination,18,4,14
emerald-dream,384,rogue,assassination,24,4,20
bleeding-hollow,383,rogue,assassination,6,4,2
tichondrius,383,rogue,assassination,6,4,2
sargeras,383,rogue,assassination,6,4,2
sargeras,383,rogue,assassination,12,4,8
sargeras,383,rogue,assassination,12,4,8
nemesis,383,rogue,assassination,12,4,8
bleeding-hollow,382,rogue,assassination,6,4,2
azshara,382,rogue,assassination,12,4,8
azshara,382,rogue,assassination,12,4,8
moon-guard,382,rogue,assassination,12,4,8
proudmoore,382,rogue,assassination,12,4,8
hyjal,351,rogue,assassination,11,4,7
tichondrius,319,rogue,assassination,14,4,10
frostmourne,318,rogue,assassination,10,4,6
illidan,288,rogue,assassination,6,3,3
illidan,288,rogue,assassination,6,3,3
akama,288,rogue,assassination,6,3,3
nemesis,288,rogue,assassination,6,3,3
illidan,288,rogue,assassination,6,3,3
azralon,288,rogue,assassination,6,3,3
thrall,288,rogue,assassination,6,3,3
gorefiend,288,rogue,assassination,6,3,3
thrall,288,rogue,assassination,6,3,3
illidan,288,rogue,assassination,6,3,3
bleeding-hollow,288,rogue,assassination,6,3,3
aegwynn,288,rogue,assassination,6,3,3
tichondrius,288,rogue,assassination,6,3,3
hyjal,288,rogue,assassination,6,3,3
jubeithos,288,rogue,assassination,6,3,3
skullcrusher,288,rogue,assassination,6,3,3
tichondrius,288,rogue,assassination,6,3,3
tichondrius,288,rogue,assassination,6,3,3
tichondrius,288,rogue,assassination,6,3,3
zuljin,288,rogue,assassination,6,3,3
rexxar,288,rogue,assassination,6,3,3
stormrage,288,rogue,assassination,6,3,3
arygos,288,rogue,assassination,6,3,3
moon-guard,288,rogue,assassination,6,3,3
malganis,288,rogue,assassination,12,3,9
duskwood,288,rogue,assassination,12,3,9
zuluhed,288,rogue,assassination,12,3,9
doomhammer,288,rogue,assassination,12,3,9
khazgoroth,288,rogue,assassination,12,3,9
khadgar,288,rogue,assassination,12,3,9
stormrage,288,rogue,assassination,12,3,9
proudmoore,288,rogue,assassination,12,3,9
ragnaros,288,rogue,assassination,12,3,9
frostmourne,288,rogue,assassination,12,3,9
dalaran,287,rogue,assassination,6,3,3
bloodhoof,287,rogue,assassination,6,3,3
demon-soul,287,rogue,assassination,6,3,3
stormrage,287,rogue,assassination,6,3,3
blackrock,287,rogue,assassination,12,3,9
arathor,287,rogue,assassination,12,3,9
daggerspine,286,rogue,assassination,6,3,3
zuljin,285,rogue,assassination,12,3,9
nemesis,285,rogue,assassination,12,3,9
moon-guard,255,rogue,assassination,11,3,8
barthilas,239,rogue,assassination,5,3,2
the-forgotten-coast,239,rogue,assassination,5,3,2
area-52,234,rogue,assassination,11,5,6
agamaggan,232,rogue,assassination,7,4,3
ragnaros,224,rogue,assassination,10,3,7
area-52,192,rogue,assassination,6,2,4
area-52,192,rogue,assassination,6,2,4
bleeding-hollow,192,rogue,assassination,6,2,4
kelthuzad,192,rogue,assassination,6,2,4
dalaran,192,rogue,assassination,6,2,4
bleeding-hollow,192,rogue,assassination,6,2,4
dalaran,192,rogue,assassination,6,2,4
tichondrius,192,rogue,assassination,6,2,4
stormrage,192,rogue,assassination,6,2,4
blackrock,192,rogue,assassination,6,2,4
frostmourne,192,rogue,assassination,6,2,4
malganis,192,rogue,assassination,6,2,4
nemesis,192,rogue,assassination,6,2,4
thrall,192,rogue,assassination,6,2,4
burning-blade,192,rogue,assassination,6,2,4
aegwynn,192,rogue,assassination,6,2,4
tichondrius,192,rogue,assassination,6,2,4
bloodhoof,192,rogue,assassination,6,2,4
blackrock,192,rogue,assassination,6,2,4
tichondrius,192,rogue,assassination,6,2,4
azjolnerub,192,rogue,assassination,6,2,4
frostmourne,192,rogue,assassination,6,2,4
azralon,192,rogue,assassination,6,2,4
stormrage,192,rogue,assassination,6,2,4
frostmourne,192,rogue,assassination,6,2,4
azralon,192,rogue,assassination,6,2,4
azralon,192,rogue,assassination,6,2,4
azralon,192,rogue,assassination,6,2,4
tichondrius,192,rogue,assassination,6,2,4
smolderthorn,192,rogue,assassination,6,2,4
azralon,192,rogue,assassination,6,2,4
vashj,192,rogue,assassination,6,2,4
sargeras,192,rogue,assassination,6,2,4
tichondrius,192,rogue,assassination,6,2,4
tichondrius,192,rogue,assassination,6,2,4
boulderfist,192,rogue,assassination,6,2,4
azralon,192,rogue,assassination,6,2,4
archimonde,192,rogue,assassination,6,2,4
daggerspine,192,rogue,assassination,11,2,9
quelthalas,192,rogue,assassination,11,2,9
icecrown,192,rogue,assassination,12,2,10
tichondrius,192,rogue,assassination,12,2,10
tichondrius,192,rogue,assassination,12,2,10
illidan,191,rogue,assassination,6,2,4
blades-edge,191,rogue,assassination,6,2,4
frostwolf,191,rogue,assassination,12,2,10
area-52,175,rogue,assassination,11,2,9
bloodscalp,138,rogue,assassination,20,4,16
tichondrius,128,rogue,assassination,4,2,2
illidan,96,rogue,assassination,3,2,1
quelthalas,96,rogue,assassination,6,1,5
wyrmrest-accord,96,rogue,assassination,6,1,5
tichondrius,96,rogue,assassination,6,1,5
arthas,96,rogue,assassination,6,1,5
magtheridon,96,rogue,assassination,6,1,5
sargeras,96,rogue,assassination,6,1,5
zuljin,96,rogue,assassination,6,1,5
sargeras,96,rogue,assassination,6,1,5
quelthalas,96,rogue,assassination,6,1,5
destromath,96,rogue,assassination,6,1,5
stormrage,96,rogue,assassination,6,1,5
azralon,96,rogue,assassination,6,1,5
tichondrius,96,rogue,assassination,6,1,5
azralon,96,rogue,assassination,6,1,5
ragnaros,96,rogue,assassination,6,1,5
bleeding-hollow,96,rogue,assassination,6,1,5
azralon,96,rogue,assassination,6,1,5
wyrmrest-accord,96,rogue,assassination,6,1,5
tichondrius,96,rogue,assassination,6,1,5
bloodscalp,96,rogue,assassination,6,1,5
lethon,96,rogue,assassination,6,1,5
emerald-dream,96,rogue,assassination,6,1,5
amanthul,96,rogue,assassination,6,1,5
dalaran,96,rogue,assassination,6,1,5
dalaran,96,rogue,assassination,6,1,5
tichondrius,96,rogue,assassination,6,1,5
illidan,96,rogue,assassination,6,1,5
area-52,96,rogue,assassination,6,1,5
frostmourne,96,rogue,assassination,6,1,5
illidan,96,rogue,assassination,6,1,5
aegwynn,96,rogue,assassination,6,1,5
stormrage,96,rogue,assassination,6,1,5
illidan,96,rogue,assassination,6,1,5
blackrock,96,rogue,assassination,6,1,5
thrall,96,rogue,assassination,6,1,5
quelthalas,96,rogue,assassination,6,1,5
frostmourne,96,rogue,assassination,6,1,5
stormrage,96,rogue,assassination,12,1,11
moon-guard,96,rogue,assassination,12,1,11
area-52,96,rogue,assassination,12,1,11
gorgonnash,95,rogue,assassination,7,1,6
tichondrius,79,rogue,assassination,5,1,4
nordrassil,79,rogue,assassination,5,1,4
bonechewer,48,rogue,assassination,3,1,2
tichondrius,31,rogue,assassination,2,1,1
illidan,16,rogue,assassination,1,1,0
tichondrius,2135,shaman,restoration,260,138,122
tichondrius,2131,shaman,restoration,78,46,32
area-52,2109,shaman,restoration,54,31,23
tichondrius,2108,shaman,restoration,96,56,40
stormrage,2108,shaman,restoration,83,47,36
kelthuzad,2107,shaman,restoration,86,51,35
area-52,2107,shaman,restoration,79,46,33
thrall,2097,shaman,restoration,60,37,23
tichondrius,2064,shaman,restoration,84,44,40
zuljin,2051,shaman,restoration,67,35,32
darkspear,2050,shaman,restoration,86,44,42
tichondrius,2008,shaman,restoration,114,55,59
frostmourne,2007,shaman,restoration,106,55,51
malganis,2006,shaman,restoration,130,62,68
garrosh,1998,shaman,restoration,68,38,30
tichondrius,1994,shaman,restoration,72,38,34
wyrmrest-accord,1979,shaman,restoration,78,37,41
thrall,1936,shaman,restoration,96,47,49
tichondrius,1934,shaman,restoration,113,64,49
malganis,1934,shaman,restoration,246,129,117
tichondrius,1931,shaman,restoration,91,48,43
tichondrius,1919,shaman,restoration,124,64,60
area-52,1916,shaman,restoration,78,41,37
tichondrius,1914,shaman,restoration,153,78,75
tichondrius,1906,shaman,restoration,56,34,22
illidan,1905,shaman,restoration,54,34,20
tichondrius,1894,shaman,restoration,65,33,32
dragonmaw,1891,shaman,restoration,66,34,32
tichondrius,1887,shaman,restoration,84,40,44
frostmourne,1884,shaman,restoration,78,38,40
stormreaver,1874,shaman,restoration,72,37,35
illidan,1867,shaman,restoration,96,50,46
tichondrius,1857,shaman,restoration,46,24,22
shadowsong,1856,shaman,restoration,54,31,23
tichondrius,1854,shaman,restoration,48,26,22
kiljaeden,1852,shaman,restoration,48,25,23
area-52,1850,shaman,restoration,120,59,61
azshara,1847,shaman,restoration,83,42,41
proudmoore,1843,shaman,restoration,78,34,44
the-scryers,1842,shaman,restoration,51,28,23
moon-guard,1837,shaman,restoration,42,24,18
akama,1837,shaman,restoration,53,27,26
tichondrius,1835,shaman,restoration,162,77,85
malganis,1831,shaman,restoration,66,30,36
tichondrius,1829,shaman,restoration,60,32,28
barthilas,1828,shaman,restoration,54,30,24
bleeding-hollow,1826,shaman,restoration,60,33,27
dalaran,1825,shaman,restoration,72,30,42
illidan,1824,shaman,restoration,102,51,51
tichondrius,1822,shaman,restoration,81,47,34
tichondrius,1819,shaman,restoration,29,23,6
twisting-nether,1810,shaman,restoration,42,23,19
kirin-tor,1809,shaman,restoration,62,31,31
bleeding-hollow,1809,shaman,restoration,48,24,24
icecrown,1807,shaman,restoration,81,41,40
moon-guard,1804,shaman,restoration,65,39,26
tichondrius,1804,shaman,restoration,94,54,40
tichondrius,1804,shaman,restoration,96,46,50
tichondrius,1803,shaman,restoration,42,23,19
bleeding-hollow,1802,shaman,restoration,71,44,27
tichondrius,1800,shaman,restoration,118,66,52
bleeding-hollow,1797,shaman,restoration,54,29,25
ragnaros,1797,shaman,restoration,36,19,17
bleeding-hollow,1793,shaman,restoration,181,110,71
tichondrius,1793,shaman,restoration,56,25,31
nemesis,1781,shaman,restoration,48,19,29
tichondrius,1780,shaman,restoration,47,27,20
tichondrius,1768,shaman,restoration,50,26,24
kiljaeden,1768,shaman,restoration,69,32,37
tichondrius,1752,shaman,restoration,24,19,5
stormrage,1746,shaman,restoration,79,35,44
tichondrius,1745,shaman,restoration,42,25,17
thrall,1744,shaman,restoration,56,32,24
barthilas,1737,shaman,restoration,36,22,14
spirestone,1730,shaman,restoration,103,54,49
dunemaul,1723,shaman,restoration,95,47,48
tichondrius,1722,shaman,restoration,112,55,57
tichondrius,1721,shaman,restoration,36,24,12
area-52,1712,shaman,restoration,48,30,18
tichondrius,1711,shaman,restoration,30,18,12
sargeras,1711,shaman,restoration,48,21,27
tichondrius,1706,shaman,restoration,62,28,34
illidan,1704,shaman,restoration,48,26,22
tichondrius,1702,shaman,restoration,41,25,16
tichondrius,1701,shaman,restoration,78,44,34
whisperwind,1698,shaman,restoration,42,29,13
tichondrius,1698,shaman,restoration,36,18,18
altar-of-storms,1694,shaman,restoration,121,53,68
tichondrius,1693,shaman,restoration,83,40,43
tichondrius,1689,shaman,restoration,41,24,17
tichondrius,1680,shaman,restoration,42,25,17
bonechewer,1679,shaman,restoration,76,45,31
arthas,1678,shaman,restoration,48,27,21
bleeding-hollow,1669,shaman,restoration,36,18,18
tichondrius,1667,shaman,restoration,56,26,30
emerald-dream,1666,shaman,restoration,62,25,37
bonechewer,1663,shaman,restoration,248,122,126
area-52,1660,shaman,restoration,41,22,19
tichondrius,1657,shaman,restoration,36,20,16
tichondrius,1656,shaman,restoration,41,18,23
barthilas,1652,shaman,restoration,128,68,60
barthilas,1652,shaman,restoration,64,32,32
zuluhed,1652,shaman,restoration,54,22,32
blackwing-lair,1651,shaman,restoration,36,21,15
malganis,1648,shaman,restoration,30,21,9
hydraxis,1648,shaman,restoration,36,22,14
zuljin,1646,shaman,restoration,56,28,28
zuljin,1645,shaman,restoration,295,161,134
tichondrius,1644,shaman,restoration,36,21,15
sargeras,1640,shaman,restoration,72,34,38
bleeding-hollow,1640,shaman,restoration,47,22,25
stormrage,1637,shaman,restoration,118,68,50
kiljaeden,1637,shaman,restoration,48,21,27
tichondrius,1635,shaman,restoration,60,30,30
area-52,1634,shaman,restoration,57,33,24
aggramar,1633,shaman,restoration,48,24,24
sargeras,1631,shaman,restoration,60,35,25
hyjal,1631,shaman,restoration,42,23,19
illidan,1630,shaman,restoration,79,42,37
illidan,1630,shaman,restoration,216,98,118
area-52,1628,shaman,restoration,48,23,25
tichondrius,1627,shaman,restoration,62,40,22
kelthuzad,1627,shaman,restoration,80,45,35
darkspear,1626,shaman,restoration,60,30,30
kelthuzad,1626,shaman,restoration,36,18,18
bonechewer,1626,shaman,restoration,90,41,49
stormrage,1621,shaman,restoration,30,18,12
tichondrius,1616,shaman,restoration,42,20,22
malganis,1610,shaman,restoration,48,19,29
kiljaeden,1608,shaman,restoration,30,19,11
illidan,1607,shaman,restoration,113,69,44
nemesis,1606,shaman,restoration,76,43,33
tichondrius,1606,shaman,restoration,54,26,28
azralon,1604,shaman,restoration,36,21,15
ragnaros,1604,shaman,restoration,69,34,35
illidan,1603,shaman,restoration,124,59,65
scilla,1601,shaman,restoration,339,174,165
quelthalas,1599,shaman,restoration,54,28,26
sargeras,1592,shaman,restoration,35,17,18
barthilas,1588,shaman,restoration,83,46,37
korgath,1586,shaman,restoration,48,20,28
zuljin,1582,shaman,restoration,99,49,50
tichondrius,1580,shaman,restoration,66,28,38
quelthalas,1579,shaman,restoration,96,58,38
area-52,1579,shaman,restoration,201,115,86
zuljin,1578,shaman,restoration,36,18,18
illidan,1572,shaman,restoration,29,17,12
sargeras,1572,shaman,restoration,35,17,18
tichondrius,1571,shaman,restoration,42,19,23
lightbringer,1562,shaman,restoration,86,49,37
tichondrius,1558,shaman,restoration,47,18,29
sargeras,1556,shaman,restoration,39,24,15
thrall,1555,shaman,restoration,30,17,13
illidan,1554,shaman,restoration,36,21,15
kelthuzad,1550,shaman,restoration,42,22,20
illidan,1550,shaman,restoration,41,17,24
dalaran,1549,shaman,restoration,48,19,29
tichondrius,1546,shaman,restoration,39,21,18
frostmourne,1544,shaman,restoration,27,17,10
dark-iron,1544,shaman,restoration,74,39,35
area-52,1543,shaman,restoration,137,64,73
area-52,1541,shaman,restoration,29,17,12
sargeras,1536,shaman,restoration,48,25,23
lethon,1534,shaman,restoration,24,16,8
area-52,1532,shaman,restoration,36,23,13
sargeras,1530,shaman,restoration,54,34,20
akama,1528,shaman,restoration,36,16,20
zuljin,1526,shaman,restoration,58,32,26
malganis,1524,shaman,restoration,97,48,49
illidan,1523,shaman,restoration,30,16,14
darkspear,1521,shaman,restoration,32,17,15
dalaran,1520,shaman,restoration,48,26,22
sargeras,1520,shaman,restoration,66,35,31
argent-dawn,1515,shaman,restoration,42,24,18
nemesis,1515,shaman,restoration,46,25,21
stormrage,1515,shaman,restoration,61,27,34
tichondrius,1514,shaman,restoration,24,16,8
chogall,1510,shaman,restoration,36,25,11
tichondrius,1508,shaman,restoration,24,16,8
tichondrius,1508,shaman,restoration,60,37,23
dalvengyr,1507,shaman,restoration,30,17,13
cenarius,1506,shaman,restoration,87,41,46
azuremyst,1499,shaman,restoration,60,33,27
blackrock,1498,shaman,restoration,39,21,18
frostmourne,1498,shaman,restoration,48,22,26
illidan,1492,shaman,restoration,24,18,6
emerald-dream,1491,shaman,restoration,42,16,26
onyxia,1490,shaman,restoration,42,18,24
tichondrius,1487,shaman,restoration,43,21,22
tichondrius,1483,shaman,restoration,30,16,14
stormrage,1481,shaman,restoration,30,23,7
uldaman,1481,shaman,restoration,28,17,11
barthilas,1481,shaman,restoration,42,18,24
maiev,1479,shaman,restoration,139,65,74
proudmoore,1477,shaman,restoration,24,17,7
tichondrius,1477,shaman,restoration,35,17,18
proudmoore,1475,shaman,restoration,60,28,32
bleeding-hollow,1474,shaman,restoration,48,20,28
azralon,1473,shaman,restoration,119,61,58
tichondrius,1471,shaman,restoration,60,33,27
vashj,1468,shaman,restoration,54,29,25
quelthalas,1466,shaman,restoration,35,22,13
bleeding-hollow,1465,shaman,restoration,56,28,28
frostmourne,1460,shaman,restoration,23,16,7
boulderfist,1458,shaman,restoration,48,28,20
quelthalas,1458,shaman,restoration,72,38,34
sargeras,1457,shaman,restoration,96,44,52
tichondrius,1454,shaman,restoration,196,91,105
tichondrius,1451,shaman,restoration,65,37,28
eonar,1451,shaman,restoration,45,25,20
ragnaros,1450,shaman,restoration,90,52,38
shadowsong,1449,shaman,restoration,48,22,26
stormrage,1444,shaman,restoration,36,21,15
area-52,1444,shaman,restoration,173,84,89
bleeding-hollow,1439,shaman,restoration,48,22,26
agamaggan,1437,shaman,restoration,355,176,179
tichondrius,1437,shaman,restoration,42,15,27
area-52,1436,shaman,restoration,71,37,34
tichondrius,1436,shaman,restoration,51,26,25
tichondrius,1435,shaman,restoration,39,26,13
kelthuzad,1435,shaman,restoration,24,15,9
andorhal,1434,shaman,restoration,24,15,9
stormrage,1433,shaman,restoration,125,72,53
silvermoon,1432,shaman,restoration,44,26,18
tichondrius,1432,shaman,restoration,30,15,15
area-52,1431,shaman,restoration,117,55,62
burning-legion,1431,shaman,restoration,36,16,20
tichondrius,1430,shaman,restoration,39,24,15
malganis,1429,shaman,restoration,60,34,26
sargeras,1427,shaman,restoration,36,15,21
frostmourne,1425,shaman,restoration,53,28,25
kelthuzad,1423,shaman,restoration,30,15,15
azralon,1423,shaman,restoration,94,42,52
ragnaros,1422,shaman,restoration,54,28,26
aggramar,1418,shaman,restoration,30,15,15
moon-guard,1417,shaman,restoration,60,32,28
quelthalas,1415,shaman,restoration,36,18,18
emerald-dream,1414,shaman,restoration,31,21,10
frostmourne,1414,shaman,restoration,30,15,15
icecrown,1414,shaman,restoration,36,15,21
barthilas,1412,shaman,restoration,48,26,22
eonar,1409,shaman,restoration,30,15,15
emerald-dream,1408,shaman,restoration,84,40,44
tichondrius,1406,shaman,restoration,26,16,10
barthilas,1404,shaman,restoration,42,19,23
tichondrius,1403,shaman,restoration,71,35,36
zuljin,1402,shaman,restoration,54,29,25
stormrage,1399,shaman,restoration,65,26,39
moknathal,1397,shaman,restoration,47,18,29
stormrage,1395,shaman,restoration,34,16,18
malganis,1389,shaman,restoration,42,33,9
sargeras,1389,shaman,restoration,42,24,18
tichondrius,1389,shaman,restoration,36,17,19
nemesis,1389,shaman,restoration,51,22,29
tichondrius,1387,shaman,restoration,60,23,37
illidan,1386,shaman,restoration,44,19,25
firetree,1384,shaman,restoration,42,23,19
tichondrius,1383,shaman,restoration,37,16,21
illidan,1382,shaman,restoration,70,31,39
tichondrius,1381,shaman,restoration,90,48,42
moon-guard,1379,shaman,restoration,54,31,23
quelthalas,1376,shaman,restoration,70,37,33
tichondrius,1370,shaman,restoration,58,22,36
icecrown,1369,shaman,restoration,54,27,27
mannoroth,1359,shaman,restoration,271,134,137
thrall,1355,shaman,restoration,24,17,7
barthilas,1347,shaman,restoration,29,17,12
veknilash,1347,shaman,restoration,88,42,46
blackrock,1346,shaman,restoration,23,15,8
tichondrius,1342,shaman,restoration,30,14,16
area-52,1341,shaman,restoration,47,26,21
bleeding-hollow,1339,shaman,restoration,35,20,15
quelthalas,1339,shaman,restoration,49,26,23
tichondrius,1336,shaman,restoration,36,14,22
darkspear,1336,shaman,restoration,36,14,22
barthilas,1335,shaman,restoration,36,21,15
drakkari,1334,shaman,restoration,60,28,32
ragnaros,1333,shaman,restoration,102,51,51
tichondrius,1331,shaman,restoration,24,14,10
malganis,1331,shaman,restoration,24,14,10
azralon,1330,shaman,restoration,36,23,13
ragnaros,1326,shaman,restoration,41,26,15
illidan,1322,shaman,restoration,60,35,25
crushridge,1320,shaman,restoration,30,18,12
frostmourne,1318,shaman,restoration,96,51,45
senjin,1310,shaman,restoration,30,16,14
tichondrius,1310,shaman,restoration,66,32,34
spirestone,1310,shaman,restoration,31,15,16
barthilas,1309,shaman,restoration,69,31,38
queldorei,1307,shaman,restoration,65,35,30
azshara,1305,shaman,restoration,76,39,37
dalaran,1303,shaman,restoration,42,14,28
tichondrius,1302,shaman,restoration,23,15,8
barthilas,1302,shaman,restoration,52,26,26
zuljin,1300,shaman,restoration,30,17,13
quelthalas,1298,shaman,restoration,132,69,63
tichondrius,1297,shaman,restoration,36,15,21
azralon,1295,shaman,restoration,48,23,25
laughing-skull,1292,shaman,restoration,30,14,16
durotan,1292,shaman,restoration,30,14,16
tichondrius,1291,shaman,restoration,66,36,30
quelthalas,1291,shaman,restoration,59,26,33
muradin,1288,shaman,restoration,36,19,17
area-52,1286,shaman,restoration,49,28,21
area-52,1284,shaman,restoration,54,28,26
korgath,1284,shaman,restoration,147,76,71
tichondrius,1279,shaman,restoration,102,45,57
tichondrius,1275,shaman,restoration,36,20,16
tichondrius,1272,shaman,restoration,30,17,13
stormrage,1269,shaman,restoration,30,16,14
ragnaros,1267,shaman,restoration,52,27,25
illidan,1266,shaman,restoration,63,30,33
stormrage,1265,shaman,restoration,41,16,25
tichondrius,1264,shaman,restoration,33,23,10
tichondrius,1262,shaman,restoration,122,68,54
kelthuzad,1261,shaman,restoration,84,38,46
moon-guard,1260,shaman,restoration,36,20,16
aegwynn,1260,shaman,restoration,54,24,30
zuljin,1259,shaman,restoration,48,15,33
ragnaros,1256,shaman,restoration,29,14,15
sargeras,1251,shaman,restoration,66,35,31
stormrage,1251,shaman,restoration,89,38,51
kiljaeden,1249,shaman,restoration,36,24,12
llane,1248,shaman,restoration,18,13,5
azralon,1248,shaman,restoration,29,16,13
zuluhed,1248,shaman,restoration,30,15,15
bleeding-hollow,1247,shaman,restoration,18,13,5
stormrage,1247,shaman,restoration,18,13,5
area-52,1247,shaman,restoration,24,13,11
malganis,1247,shaman,restoration,32,17,15
bleeding-hollow,1247,shaman,restoration,30,13,17
sargeras,1246,shaman,restoration,87,42,45
stormscale,1245,shaman,restoration,36,13,23
tichondrius,1244,shaman,restoration,24,13,11
tichondrius,1243,shaman,restoration,30,13,17
bleeding-hollow,1242,shaman,restoration,117,59,58
magtheridon,1241,shaman,restoration,32,15,17
ragnaros,1241,shaman,restoration,44,18,26
tichondrius,1237,shaman,restoration,18,13,5
aggramar,1237,shaman,restoration,24,13,11
tichondrius,1237,shaman,restoration,30,16,14
illidan,1234,shaman,restoration,24,13,11
dragonmaw,1232,shaman,restoration,30,13,17
zuljin,1232,shaman,restoration,36,13,23
malganis,1230,shaman,restoration,48,25,23
thrall,1227,shaman,restoration,24,13,11
barthilas,1227,shaman,restoration,60,19,41
illidan,1225,shaman,restoration,18,13,5
malganis,1225,shaman,restoration,24,14,10
dalaran,1221,shaman,restoration,82,39,43
black-dragonflight,1220,shaman,restoration,24,13,11
stormrage,1217,shaman,restoration,36,16,20
lightninghoof,1216,shaman,restoration,30,13,17
wyrmrest-accord,1215,shaman,restoration,88,44,44
tichondrius,1215,shaman,restoration,40,19,21
barthilas,1209,shaman,restoration,84,51,33
dark-iron,1209,shaman,restoration,39,15,24
area-52,1207,shaman,restoration,82,31,51
emerald-dream,1205,shaman,restoration,35,17,18
proudmoore,1204,shaman,restoration,34,17,17
frostmourne,1203,shaman,restoration,54,24,30
stormrage,1200,shaman,restoration,18,14,4
illidan,1197,shaman,restoration,29,13,16
tichondrius,1196,shaman,restoration,38,19,19
daggerspine,1190,shaman,restoration,34,16,18
zuljin,1186,shaman,restoration,83,47,36
quelthalas,1182,shaman,restoration,103,51,52
the-underbog,1181,shaman,restoration,28,14,14
frostmourne,1179,shaman,restoration,54,24,30
quelthalas,1178,shaman,restoration,25,15,10
thrall,1178,shaman,restoration,31,14,17
stormrage,1172,shaman,restoration,70,31,39
tichondrius,1170,shaman,restoration,49,14,35
frostmourne,1166,shaman,restoration,24,13,11
tichondrius,1153,shaman,restoration,41,19,22
tichondrius,1152,shaman,restoration,24,12,12
tichondrius,1152,shaman,restoration,24,12,12
tichondrius,1152,shaman,restoration,24,12,12
emerald-dream,1152,shaman,restoration,33,13,20
azralon,1151,shaman,restoration,70,39,31
tichondrius,1151,shaman,restoration,24,12,12
illidan,1151,shaman,restoration,30,12,18
area-52,1150,shaman,restoration,18,12,6
dalaran,1149,shaman,restoration,24,12,12
nagrand,1148,shaman,restoration,36,19,17
area-52,1148,shaman,restoration,24,12,12
azralon,1148,shaman,restoration,61,26,35
tichondrius,1147,shaman,restoration,30,18,12
tichondrius,1147,shaman,restoration,24,12,12
barthilas,1145,shaman,restoration,24,12,12
sargeras,1134,shaman,restoration,51,21,30
tichondrius,1131,shaman,restoration,41,27,14
area-52,1129,shaman,restoration,24,14,10
tichondrius,1120,shaman,restoration,36,12,24
bleeding-hollow,1118,shaman,restoration,18,12,6
lightbringer,1113,shaman,restoration,33,21,12
stormreaver,1103,shaman,restoration,50,23,27
kelthuzad,1102,shaman,restoration,21,13,8
tichondrius,1100,shaman,restoration,36,12,24
kelthuzad,1095,shaman,restoration,48,28,20
zuljin,1092,shaman,restoration,36,16,20
frostmourne,1086,shaman,restoration,17,12,5
blackhand,1083,shaman,restoration,42,13,29
frostmourne,1074,shaman,restoration,49,26,23
area-52,1071,shaman,restoration,31,13,18
daggerspine,1068,shaman,restoration,60,28,32
destromath,1064,shaman,restoration,36,13,23
kiljaeden,1061,shaman,restoration,60,28,32
thrall,1056,shaman,restoration,18,11,7
malganis,1056,shaman,restoration,18,11,7
tichondrius,1056,shaman,restoration,24,11,13
aerie-peak,1056,shaman,restoration,24,11,13
area-52,1055,shaman,restoration,18,11,7
doomhammer,1055,shaman,restoration,18,11,7
hyjal,1055,shaman,restoration,18,11,7
tichondrius,1055,shaman,restoration,18,11,7
sargeras,1055,shaman,restoration,24,11,13
bleeding-hollow,1055,shaman,restoration,30,11,19
ragnaros,1054,shaman,restoration,18,11,7
stormrage,1053,shaman,restoration,18,11,7
illidan,1052,shaman,restoration,18,11,7
kiljaeden,1052,shaman,restoration,30,11,19
frostmane,1050,shaman,restoration,18,11,7
proudmoore,1049,shaman,restoration,24,11,13
azralon,1048,shaman,restoration,35,21,14
thrall,1048,shaman,restoration,30,11,19
bleeding-hollow,1046,shaman,restoration,18,11,7
ragnaros,1046,shaman,restoration,30,11,19
caelestrasz,1045,shaman,restoration,45,13,32
nordrassil,1043,shaman,restoration,18,11,7
dalaran,1043,shaman,restoration,30,11,19
hakkar,1040,shaman,restoration,24,14,10
moon-guard,1040,shaman,restoration,84,33,51
barthilas,1039,shaman,restoration,24,11,13
tichondrius,1034,shaman,restoration,24,11,13
ragnaros,1033,shaman,restoration,36,11,25
norgannon,1031,shaman,restoration,30,15,15
sargeras,1030,shaman,restoration,24,12,12
stormrage,1023,shaman,restoration,34,11,23
warsong,1022,shaman,restoration,41,18,23
quelthalas,1021,shaman,restoration,28,12,16
illidan,1007,shaman,restoration,21,11,10
stormrage,1004,shaman,restoration,42,15,27
quelthalas,1003,shaman,restoration,51,18,33
kiljaeden,998,shaman,restoration,80,41,39
ragnaros,995,shaman,restoration,32,13,19
moon-guard,992,shaman,restoration,28,11,17
azralon,990,shaman,restoration,14,11,3
sargeras,990,shaman,restoration,18,13,5
stormrage,990,shaman,restoration,35,16,19
illidan,988,shaman,restoration,19,12,7
korgath,988,shaman,restoration,30,11,19
thrall,976,shaman,restoration,24,15,9
thrall,969,shaman,restoration,36,16,20
nemesis,961,shaman,restoration,19,11,8
tichondrius,960,shaman,restoration,12,10,2
barthilas,960,shaman,restoration,18,10,8
sargeras,960,shaman,restoration,18,10,8
frostmourne,960,shaman,restoration,24,10,14
tichondrius,959,shaman,restoration,12,10,2
frostmourne,959,shaman,restoration,12,10,2
wyrmrest-accord,959,shaman,restoration,18,10,8
bleeding-hollow,959,shaman,restoration,24,10,14
ghostlands,959,shaman,restoration,24,10,14
tichondrius,959,shaman,restoration,36,10,26
lightbringer,958,shaman,restoration,12,10,2
proudmoore,958,shaman,restoration,18,10,8
kalecgos,958,shaman,restoration,18,10,8
kelthuzad,958,shaman,restoration,30,10,20
korgath,957,shaman,restoration,12,10,2
malorne,957,shaman,restoration,59,31,28
ysera,956,shaman,restoration,30,10,20
aggramar,955,shaman,restoration,24,10,14
area-52,952,shaman,restoration,24,10,14
stormscale,951,shaman,restoration,18,10,8
tichondrius,951,shaman,restoration,24,10,14
lothar,937,shaman,restoration,24,10,14
thrall,933,shaman,restoration,18,10,8
tichondrius,928,shaman,restoration,16,11,5
illidan,927,shaman,restoration,23,10,13
bleeding-hollow,926,shaman,restoration,29,10,19
tichondrius,925,shaman,restoration,20,11,9
tichondrius,924,shaman,restoration,25,11,14
nazjatar,923,shaman,restoration,18,11,7
frostmourne,921,shaman,restoration,33,12,21
bleeding-hollow,917,shaman,restoration,20,11,9
trollbane,911,shaman,restoration,17,12,5
tichondrius,904,shaman,restoration,27,10,17
madoran,902,shaman,restoration,23,10,13
nemesis,899,shaman,restoration,28,12,16
tichondrius,895,shaman,restoration,17,10,7
area-52,883,shaman,restoration,22,10,12
gnomeregan,878,shaman,restoration,13,10,3
tichondrius,874,shaman,restoration,19,10,9
sargeras,872,shaman,restoration,25,14,11
barthilas,864,shaman,restoration,12,9,3
tichondrius,864,shaman,restoration,12,9,3
area-52,864,shaman,restoration,12,9,3
stormrage,864,shaman,restoration,12,9,3
illidan,864,shaman,restoration,12,9,3
emerald-dream,864,shaman,restoration,18,9,9
malfurion,864,shaman,restoration,18,9,9
malganis,864,shaman,restoration,18,9,9
emerald-dream,864,shaman,restoration,18,9,9
malganis,864,shaman,restoration,24,9,15
ragnaros,864,shaman,restoration,30,9,21
tichondrius,863,shaman,restoration,12,9,3
illidan,863,shaman,restoration,18,9,9
tichondrius,863,shaman,restoration,18,9,9
burning-blade,863,shaman,restoration,18,9,9
quelthalas,863,shaman,restoration,18,9,9
area-52,863,shaman,restoration,18,9,9
frostwolf,863,shaman,restoration,24,9,15
tichondrius,862,shaman,restoration,12,9,3
area-52,862,shaman,restoration,18,9,9
sargeras,862,shaman,restoration,18,9,9
frostmourne,862,shaman,restoration,18,9,9
wildhammer,862,shaman,restoration,18,9,9
frostmourne,862,shaman,restoration,27,11,16
tichondrius,860,shaman,restoration,18,9,9
barthilas,860,shaman,restoration,30,9,21
ragnaros,859,shaman,restoration,18,9,9
illidan,859,shaman,restoration,24,9,15
thunderlord,857,shaman,restoration,18,9,9
trollbane,854,shaman,restoration,12,9,3
eredar,852,shaman,restoration,18,9,9
tichondrius,850,shaman,restoration,18,9,9
illidan,847,shaman,restoration,44,19,25
darkspear,846,shaman,restoration,41,11,30
blackwing-lair,841,shaman,restoration,25,11,14
illidan,830,shaman,restoration,17,9,8
gilneas,827,shaman,restoration,35,17,18
tichondrius,815,shaman,restoration,15,10,5
tichondrius,810,shaman,restoration,29,11,18
hyjal,794,shaman,restoration,17,9,8
garrosh,792,shaman,restoration,20,9,11
zuljin,768,shaman,restoration,12,8,4
zuljin,768,shaman,restoration,12,8,4
kelthuzad,768,shaman,restoration,12,8,4
dark-iron,768,shaman,restoration,12,8,4
stormscale,768,shaman,restoration,12,8,4
khaz-modan,768,shaman,restoration,12,8,4
jubeithos,768,shaman,restoration,12,8,4
tichondrius,768,shaman,restoration,12,8,4
tichondrius,768,shaman,restoration,12,8,4
tichondrius,768,shaman,restoration,12,8,4
illidan,768,shaman,restoration,12,8,4
tichondrius,768,shaman,restoration,12,8,4
tichondrius,768,shaman,restoration,12,8,4
bleeding-hollow,768,shaman,restoration,12,8,4
tichondrius,768,shaman,restoration,12,8,4
tichondrius,768,shaman,restoration,18,8,10
frostmane,768,shaman,restoration,18,8,10
tichondrius,768,shaman,restoration,18,8,10
frostmourne,768,shaman,restoration,18,8,10
chogall,768,shaman,restoration,18,8,10
zuljin,768,shaman,restoration,18,8,10
emerald-dream,768,shaman,restoration,18,8,10
ragnaros,768,shaman,restoration,18,8,10
malganis,768,shaman,restoration,24,8,16
tichondrius,767,shaman,restoration,12,8,4
kelthuzad,767,shaman,restoration,12,8,4
warsong,767,shaman,restoration,12,8,4
boulderfist,767,shaman,restoration,12,8,4
illidan,767,shaman,restoration,18,8,10
ragnaros,767,shaman,restoration,18,8,10
area-52,767,shaman,restoration,18,8,10
tichondrius,767,shaman,restoration,24,8,16
azralon,766,shaman,restoration,18,8,10
darkspear,766,shaman,restoration,18,8,10
sargeras,766,shaman,restoration,24,8,16
barthilas,765,shaman,restoration,12,8,4
kiljaeden,765,shaman,restoration,12,8,4
altar-of-storms,762,shaman,restoration,12,8,4
area-52,757,shaman,restoration,18,8,10
thrall,751,shaman,restoration,17,8,9
thrall,747,shaman,restoration,12,8,4
bleeding-hollow,719,shaman,restoration,11,8,3
kelthuzad,719,shaman,restoration,17,8,9
tichondrius,719,shaman,restoration,17,8,9
tichondrius,714,shaman,restoration,23,11,12
tichondrius,714,shaman,restoration,23,9,14
tichondrius,714,shaman,restoration,25,9,16
tichondrius,703,shaman,restoration,11,8,3
guldan,703,shaman,restoration,11,8,3
burning-legion,703,shaman,restoration,14,8,6
bleeding-hollow,672,shaman,restoration,12,7,5
tichondrius,672,shaman,restoration,12,7,5
sargeras,672,shaman,restoration,12,7,5
spirestone,672,shaman,restoration,12,7,5
area-52,672,shaman,restoration,12,7,5
kelthuzad,672,shaman,restoration,12,7,5
nemesis,672,shaman,restoration,12,7,5
tichondrius,672,shaman,restoration,12,7,5
tichondrius,672,shaman,restoration,12,7,5
tichondrius,672,shaman,restoration,12,7,5
tichondrius,672,shaman,restoration,12,7,5
tichondrius,672,shaman,restoration,12,7,5
arathor,672,shaman,restoration,12,7,5
agamaggan,672,shaman,restoration,12,7,5
thunderhorn,672,shaman,restoration,12,7,5
tichondrius,672,shaman,restoration,12,7,5
stormrage,672,shaman,restoration,12,7,5
stormrage,672,shaman,restoration,12,7,5
bleeding-hollow,672,shaman,restoration,12,7,5
ragnaros,672,shaman,restoration,12,7,5
dragonmaw,672,shaman,restoration,18,7,11
sargeras,672,shaman,restoration,18,7,11
ragnaros,672,shaman,restoration,18,7,11
tichondrius,672,shaman,restoration,18,7,11
malganis,672,shaman,restoration,18,7,11
tichondrius,672,shaman,restoration,18,7,11
chogall,672,shaman,restoration,18,7,11
tichondrius,672,shaman,restoration,18,7,11
arygos,672,shaman,restoration,24,7,17
tichondrius,671,shaman,restoration,12,7,5
gorgonnash,671,shaman,restoration,12,7,5
sargeras,671,shaman,restoration,12,7,5
emerald-dream,671,shaman,restoration,18,7,11
shadowmoon,671,shaman,restoration,18,7,11
stormrage,671,shaman,restoration,18,7,11
azralon,671,shaman,restoration,18,7,11
thrall,671,shaman,restoration,18,7,11
senjin,670,shaman,restoration,12,7,5
crushridge,670,shaman,restoration,12,7,5
proudmoore,670,shaman,restoration,12,7,5
suramar,670,shaman,restoration,12,7,5
tichondrius,670,shaman,restoration,12,7,5
sargeras,670,shaman,restoration,12,7,5
stormscale,670,shaman,restoration,12,7,5
proudmoore,670,shaman,restoration,18,7,11
hakkar,670,shaman,restoration,30,7,23
illidan,669,shaman,restoration,18,7,11
frostmourne,666,shaman,restoration,12,7,5
moon-guard,665,shaman,restoration,11,9,2
moon-guard,665,shaman,restoration,12,7,5
shattered-hand,661,shaman,restoration,12,7,5
barthilas,657,shaman,restoration,23,10,13
thrall,639,shaman,restoration,11,7,4
hyjal,638,shaman,restoration,20,8,12
emerald-dream,623,shaman,restoration,11,7,4
area-52,618,shaman,restoration,14,8,6
sargeras,594,shaman,restoration,26,8,18
tichondrius,592,shaman,restoration,19,7,12
frostmourne,591,shaman,restoration,11,7,4
illidan,576,shaman,restoration,6,6,0
tichondrius,576,shaman,restoration,6,6,0
illidan,576,shaman,restoration,6,6,0
tichondrius,576,shaman,restoration,6,6,0
illidan,576,shaman,restoration,6,6,0
moon-guard,576,shaman,restoration,9,6,3
bleeding-hollow,576,shaman,restoration,12,6,6
tichondrius,576,shaman,restoration,12,6,6
tichondrius,576,shaman,restoration,12,6,6
sargeras,576,shaman,restoration,12,6,6
moon-guard,576,shaman,restoration,12,6,6
tichondrius,576,shaman,restoration,12,6,6
illidan,576,shaman,restoration,12,6,6
tichondrius,576,shaman,restoration,12,6,6
illidan,576,shaman,restoration,12,6,6
ragnaros,576,shaman,restoration,12,6,6
bleeding-hollow,576,shaman,restoration,12,6,6
stormrage,576,shaman,restoration,12,6,6
suramar,576,shaman,restoration,12,6,6
malganis,576,shaman,restoration,12,6,6
illidan,576,shaman,restoration,12,6,6
proudmoore,576,shaman,restoration,12,6,6
tichondrius,576,shaman,restoration,12,6,6
kelthuzad,576,shaman,restoration,12,6,6
black-dragonflight,576,shaman,restoration,12,6,6
sargeras,576,shaman,restoration,12,6,6
ragnaros,576,shaman,restoration,12,6,6
illidan,576,shaman,restoration,12,6,6
emerald-dream,576,shaman,restoration,12,6,6
dreadmaul,576,shaman,restoration,12,6,6
tichondrius,576,shaman,restoration,12,6,6
kiljaeden,576,shaman,restoration,12,6,6
azjolnerub,576,shaman,restoration,12,6,6
proudmoore,576,shaman,restoration,18,6,12
malganis,576,shaman,restoration,18,6,12
illidan,576,shaman,restoration,18,6,12
ragnaros,576,shaman,restoration,18,6,12
jaedenar,576,shaman,restoration,20,6,14
stormrage,576,shaman,restoration,24,6,18
tichondrius,575,shaman,restoration,12,6,6
malganis,575,shaman,restoration,12,6,6
tichondrius,575,shaman,restoration,12,6,6
tichondrius,575,shaman,restoration,12,6,6
illidan,575,shaman,restoration,12,6,6
proudmoore,575,shaman,restoration,12,6,6
dalaran,575,shaman,restoration,12,6,6
azralon,575,shaman,restoration,12,6,6
kelthuzad,575,shaman,restoration,15,7,8
frostmourne,575,shaman,restoration,14,6,8
draka,575,shaman,restoration,18,6,12
zuljin,574,shaman,restoration,12,6,6
laughing-skull,574,shaman,restoration,12,6,6
stormreaver,574,shaman,restoration,15,7,8
bleeding-hollow,574,shaman,restoration,15,6,9
emerald-dream,574,shaman,restoration,18,6,12
frostmourne,574,shaman,restoration,24,6,18
quelthalas,570,shaman,restoration,24,6,18
madoran,567,shaman,restoration,12,6,6
frostmourne,566,shaman,restoration,18,6,12
azshara,559,shaman,restoration,32,10,22
nagrand,547,shaman,restoration,18,9,9
stormrage,541,shaman,restoration,8,7,1
sargeras,528,shaman,restoration,15,6,9
tichondrius,522,shaman,restoration,22,8,14
sargeras,511,shaman,restoration,11,6,5
quelthalas,480,shaman,restoration,6,5,1
tichondrius,480,shaman,restoration,6,5,1
crushridge,480,shaman,restoration,6,5,1
zuljin,480,shaman,restoration,6,5,1
illidan,480,shaman,restoration,6,5,1
tichondrius,480,shaman,restoration,6,5,1
akama,480,shaman,restoration,6,5,1
thrall,480,shaman,restoration,6,5,1
aegwynn,480,shaman,restoration,6,5,1
tichondrius,480,shaman,restoration,6,5,1
tichondrius,480,shaman,restoration,6,5,1
illidan,480,shaman,restoration,6,5,1
area-52,480,shaman,restoration,6,5,1
tichondrius,480,shaman,restoration,6,5,1
bleeding-hollow,480,shaman,restoration,6,5,1
illidan,480,shaman,restoration,9,6,3
tichondrius,480,shaman,restoration,10,6,4
spirestone,480,shaman,restoration,12,5,7
tichondrius,480,shaman,restoration,12,5,7
quelthalas,480,shaman,restoration,12,5,7
tichondrius,480,shaman,restoration,12,5,7
stormreaver,480,shaman,restoration,12,5,7
drakkari,480,shaman,restoration,12,5,7
nemesis,480,shaman,restoration,12,5,7
tichondrius,480,shaman,restoration,12,5,7
barthilas,480,shaman,restoration,12,5,7
tichondrius,480,shaman,restoration,12,5,7
alexstrasza,480,shaman,restoration,12,5,7
moon-guard,480,shaman,restoration,12,5,7
senjin,480,shaman,restoration,12,5,7
tichondrius,480,shaman,restoration,12,5,7
frostmourne,480,shaman,restoration,12,5,7
frostmane,480,shaman,restoration,12,5,7
illidan,480,shaman,restoration,12,5,7
stormrage,480,shaman,restoration,12,5,7
tichondrius,480,shaman,restoration,12,5,7
tichondrius,480,shaman,restoration,12,5,7
tichondrius,480,shaman,restoration,12,5,7
blades-edge,480,shaman,restoration,12,5,7
moon-guard,480,shaman,restoration,12,5,7
tichondrius,480,shaman,restoration,12,5,7
illidan,480,shaman,restoration,12,5,7
emerald-dream,480,shaman,restoration,12,5,7
proudmoore,480,shaman,restoration,12,5,7
tichondrius,480,shaman,restoration,12,5,7
korialstrasz,480,shaman,restoration,12,5,7
azralon,480,shaman,restoration,12,5,7
tichondrius,480,shaman,restoration,12,5,7
caelestrasz,480,shaman,restoration,12,5,7
darkspear,480,shaman,restoration,12,5,7
kelthuzad,480,shaman,restoration,12,5,7
thunderlord,480,shaman,restoration,12,5,7
darkspear,480,shaman,restoration,12,5,7
kiljaeden,480,shaman,restoration,12,5,7
proudmoore,480,shaman,restoration,18,5,13
bleeding-hollow,480,shaman,restoration,18,5,13
tichondrius,480,shaman,restoration,18,5,13
illidan,480,shaman,restoration,18,5,13
illidan,480,shaman,restoration,24,5,19
zuljin,479,shaman,restoration,6,5,1
bonechewer,479,shaman,restoration,10,6,4
durotan,479,shaman,restoration,12,5,7
area-52,479,shaman,restoration,12,5,7
tichondrius,479,shaman,restoration,12,5,7
elune,479,shaman,restoration,12,5,7
malganis,479,shaman,restoration,12,5,7
sargeras,479,shaman,restoration,18,5,13
tichondrius,478,shaman,restoration,12,5,7
bleeding-hollow,478,shaman,restoration,15,6,9
sargeras,478,shaman,restoration,16,6,10
proudmoore,477,shaman,restoration,6,5,1
tichondrius,448,shaman,restoration,10,5,5
duskwood,445,shaman,restoration,14,6,8
wildhammer,431,shaman,restoration,11,5,6
azralon,425,shaman,restoration,8,8,0
ragnaros,416,shaman,restoration,16,5,11
barthilas,415,shaman,restoration,8,5,3
darkspear,400,shaman,restoration,19,5,14
tichondrius,384,shaman,restoration,6,4,2
zuljin,384,shaman,restoration,6,4,2
zuljin,384,shaman,restoration,6,4,2
tichondrius,384,shaman,restoration,6,4,2
sargeras,384,shaman,restoration,6,4,2
tichondrius,384,shaman,restoration,6,4,2
sargeras,384,shaman,restoration,6,4,2
tanaris,384,shaman,restoration,6,4,2
sargeras,384,shaman,restoration,6,4,2
burning-blade,384,shaman,restoration,6,4,2
tichondrius,384,shaman,restoration,6,4,2
frostmourne,384,shaman,restoration,6,4,2
illidan,384,shaman,restoration,6,4,2
emerald-dream,384,shaman,restoration,6,4,2
frostmourne,384,shaman,restoration,6,4,2
stormrage,384,shaman,restoration,6,4,2
tichondrius,384,shaman,restoration,6,4,2
tichondrius,384,shaman,restoration,6,4,2
destromath,384,shaman,restoration,6,4,2
tichondrius,384,shaman,restoration,6,4,2
dreadmaul,384,shaman,restoration,6,4,2
tichondrius,384,shaman,restoration,6,4,2
tichondrius,384,shaman,restoration,6,4,2
stormrage,384,shaman,restoration,6,4,2
nemesis,384,shaman,restoration,6,4,2
nerzhul,384,shaman,restoration,6,4,2
stormrage,384,shaman,restoration,6,4,2
kelthuzad,384,shaman,restoration,6,4,2
tichondrius,384,shaman,restoration,6,4,2
senjin,384,shaman,restoration,6,4,2
tichondrius,384,shaman,restoration,6,4,2
bleeding-hollow,384,shaman,restoration,6,4,2
area-52,384,shaman,restoration,6,4,2
tichondrius,384,shaman,restoration,6,4,2
frostmourne,384,shaman,restoration,6,4,2
sargeras,384,shaman,restoration,6,4,2
sargeras,384,shaman,restoration,12,4,8
azralon,384,shaman,restoration,12,4,8
frostmourne,384,shaman,restoration,12,4,8
frostmourne,384,shaman,restoration,12,4,8
illidan,384,shaman,restoration,12,4,8
sargeras,384,shaman,restoration,12,4,8
tichondrius,384,shaman,restoration,12,4,8
illidan,384,shaman,restoration,12,4,8
sargeras,384,shaman,restoration,12,4,8
tichondrius,384,shaman,restoration,12,4,8
tichondrius,384,shaman,restoration,12,4,8
tichondrius,384,shaman,restoration,12,4,8
sargeras,384,shaman,restoration,12,4,8
tichondrius,384,shaman,restoration,12,4,8
barthilas,384,shaman,restoration,12,4,8
maiev,384,shaman,restoration,12,4,8
arygos,384,shaman,restoration,12,4,8
tichondrius,384,shaman,restoration,12,4,8
bonechewer,384,shaman,restoration,12,4,8
whisperwind,384,shaman,restoration,12,4,8
ragnaros,384,shaman,restoration,13,4,9
malganis,384,shaman,restoration,18,4,14
sargeras,384,shaman,restoration,18,4,14
frostmourne,384,shaman,restoration,18,4,14
frostmourne,383,shaman,restoration,6,4,2
hyjal,383,shaman,restoration,6,4,2
wyrmrest-accord,383,shaman,restoration,12,4,8
sargeras,383,shaman,restoration,12,4,8
zuljin,382,shaman,restoration,12,4,8
tichondrius,382,shaman,restoration,12,4,8
hyjal,382,shaman,restoration,12,4,8
auchindoun,352,shaman,restoration,14,5,9
emerald-dream,351,shaman,restoration,8,5,3
frostmourne,351,shaman,restoration,8,5,3
illidan,351,shaman,restoration,11,4,7
tichondrius,336,shaman,restoration,9,4,5
frostmourne,335,shaman,restoration,11,4,7
malganis,331,shaman,restoration,15,4,11
emerald-dream,328,shaman,restoration,12,5,7
tichondrius,319,shaman,restoration,5,4,1
stormrage,304,shaman,restoration,7,4,3
ysondre,301,shaman,restoration,7,4,3
quelthalas,288,shaman,restoration,6,3,3
malganis,288,shaman,restoration,6,3,3
tichondrius,288,shaman,restoration,6,3,3
the-forgotten-coast,288,shaman,restoration,6,3,3
tichondrius,288,shaman,restoration,6,3,3
muradin,288,shaman,restoration,6,3,3
burning-legion,288,shaman,restoration,6,3,3
korgath,288,shaman,restoration,6,3,3
barthilas,288,shaman,restoration,6,3,3
area-52,288,shaman,restoration,6,3,3
moon-guard,288,shaman,restoration,6,3,3
malganis,288,shaman,restoration,6,3,3
dalaran,288,shaman,restoration,6,3,3
korgath,288,shaman,restoration,6,3,3
sargeras,288,shaman,restoration,6,3,3
sargeras,288,shaman,restoration,6,3,3
ravencrest,288,shaman,restoration,6,3,3
illidan,288,shaman,restoration,6,3,3
alleria,288,shaman,restoration,6,3,3
quelthalas,288,shaman,restoration,6,3,3
alterac-mountains,288,shaman,restoration,6,3,3
illidan,288,shaman,restoration,6,3,3
maelstrom,288,shaman,restoration,6,3,3
dathremar,288,shaman,restoration,6,3,3
malganis,288,shaman,restoration,6,3,3
thrall,288,shaman,restoration,6,3,3
kiljaeden,288,shaman,restoration,6,3,3
area-52,288,shaman,restoration,6,3,3
thrall,288,shaman,restoration,6,3,3
ursin,288,shaman,restoration,6,3,3
frostmourne,288,shaman,restoration,6,3,3
area-52,288,shaman,restoration,6,3,3
tichondrius,288,shaman,restoration,6,3,3
bonechewer,288,shaman,restoration,6,3,3
tichondrius,288,shaman,restoration,6,3,3
tichondrius,288,shaman,restoration,6,3,3
tichondrius,288,shaman,restoration,6,3,3
bleeding-hollow,288,shaman,restoration,6,3,3
tichondrius,288,shaman,restoration,6,3,3
kelthuzad,288,shaman,restoration,6,3,3
bleeding-hollow,288,shaman,restoration,6,3,3
sargeras,288,shaman,restoration,6,3,3
laughing-skull,288,shaman,restoration,6,3,3
silvermoon,288,shaman,restoration,6,3,3
arathor,288,shaman,restoration,6,3,3
tichondrius,288,shaman,restoration,6,3,3
malganis,288,shaman,restoration,6,3,3
tichondrius,288,shaman,restoration,6,3,3
tichondrius,288,shaman,restoration,6,3,3
kiljaeden,288,shaman,restoration,6,3,3
tichondrius,288,shaman,restoration,6,3,3
illidan,288,shaman,restoration,6,3,3
area-52,288,shaman,restoration,6,3,3
illidan,288,shaman,restoration,6,3,3
illidan,288,shaman,restoration,6,3,3
doomhammer,288,shaman,restoration,6,3,3
illidan,288,shaman,restoration,6,3,3
emerald-dream,288,shaman,restoration,6,3,3
tichondrius,288,shaman,restoration,6,3,3
frostmourne,288,shaman,restoration,6,3,3
illidan,288,shaman,restoration,6,3,3
emerald-dream,288,shaman,restoration,10,4,6
ragnaros,288,shaman,restoration,13,4,9
lothar,288,shaman,restoration,11,3,8
nerzhul,288,shaman,restoration,12,3,9
thaurissan,288,shaman,restoration,12,3,9
tichondrius,288,shaman,restoration,12,3,9
burning-blade,288,shaman,restoration,12,3,9
ragnaros,288,shaman,restoration,12,3,9
tichondrius,288,shaman,restoration,12,3,9
illidan,288,shaman,restoration,12,3,9
tichondrius,288,shaman,restoration,12,3,9
azralon,288,shaman,restoration,12,3,9
blackrock,288,shaman,restoration,12,3,9
wyrmrest-accord,288,shaman,restoration,12,3,9
lightbringer,288,shaman,restoration,13,3,10
shattered-hand,287,shaman,restoration,6,3,3
azralon,287,shaman,restoration,6,3,3
zuljin,287,shaman,restoration,12,3,9
malganis,282,shaman,restoration,10,6,4
malganis,281,shaman,restoration,15,6,9
hyjal,256,shaman,restoration,10,3,7
lightnings-blade,255,shaman,restoration,11,3,8
malganis,240,shaman,restoration,9,3,6
stormreaver,239,shaman,restoration,5,3,2
quelthalas,234,shaman,restoration,6,4,2
malganis,234,shaman,restoration,11,5,6
tichondrius,234,shaman,restoration,11,4,7
tichondrius,192,shaman,restoration,4,3,1
tichondrius,192,shaman,restoration,9,3,6
nerzhul,192,shaman,restoration,6,2,4
frostmourne,192,shaman,restoration,6,2,4
zuljin,192,shaman,restoration,6,2,4
emerald-dream,192,shaman,restoration,6,2,4
icecrown,192,shaman,restoration,6,2,4
tichondrius,192,shaman,restoration,6,2,4
frostmourne,192,shaman,restoration,6,2,4
tichondrius,192,shaman,restoration,6,2,4
tichondrius,192,shaman,restoration,6,2,4
zuljin,192,shaman,restoration,6,2,4
shattered-halls,192,shaman,restoration,6,2,4
moon-guard,192,shaman,restoration,6,2,4
frostmourne,192,shaman,restoration,6,2,4
illidan,192,shaman,restoration,6,2,4
tichondrius,192,shaman,restoration,6,2,4
frostmourne,192,shaman,restoration,6,2,4
spirestone,192,shaman,restoration,6,2,4
illidan,192,shaman,restoration,6,2,4
tichondrius,192,shaman,restoration,6,2,4
illidan,192,shaman,restoration,6,2,4
lightnings-blade,192,shaman,restoration,6,2,4
aerie-peak,192,shaman,restoration,6,2,4
illidan,192,shaman,restoration,6,2,4
thrall,192,shaman,restoration,6,2,4
thrall,192,shaman,restoration,6,2,4
tichondrius,192,shaman,restoration,6,2,4
blades-edge,192,shaman,restoration,6,2,4
tichondrius,192,shaman,restoration,6,2,4
mannoroth,192,shaman,restoration,6,2,4
tichondrius,192,shaman,restoration,6,2,4
nemesis,192,shaman,restoration,6,2,4
norgannon,192,shaman,restoration,6,2,4
stormrage,192,shaman,restoration,6,2,4
spirestone,192,shaman,restoration,6,2,4
tichondrius,192,shaman,restoration,6,2,4
tichondrius,192,shaman,restoration,6,2,4
icecrown,192,shaman,restoration,6,2,4
illidan,192,shaman,restoration,6,2,4
tichondrius,192,shaman,restoration,6,2,4
nerzhul,192,shaman,restoration,6,2,4
dalaran,192,shaman,restoration,6,2,4
tichondrius,192,shaman,restoration,6,2,4
malganis,192,shaman,restoration,6,2,4
the-forgotten-coast,192,shaman,restoration,6,2,4
tichondrius,192,shaman,restoration,6,2,4
area-52,192,shaman,restoration,6,2,4
stormrage,192,shaman,restoration,6,2,4
area-52,192,shaman,restoration,6,2,4
kelthuzad,192,shaman,restoration,6,2,4
anetheron,192,shaman,restoration,6,2,4
frostmourne,192,shaman,restoration,6,2,4
malganis,192,shaman,restoration,6,2,4
garrosh,192,shaman,restoration,6,2,4
malganis,192,shaman,restoration,6,2,4
hyjal,192,shaman,restoration,6,2,4
illidan,192,shaman,restoration,6,2,4
sargeras,192,shaman,restoration,6,2,4
azralon,192,shaman,restoration,6,2,4
sargeras,192,shaman,restoration,6,2,4
korialstrasz,192,shaman,restoration,6,2,4
sargeras,192,shaman,restoration,6,2,4
kiljaeden,192,shaman,restoration,12,2,10
bleeding-hollow,192,shaman,restoration,12,2,10
stormrage,192,shaman,restoration,12,2,10
frostmourne,192,shaman,restoration,12,2,10
black-dragonflight,192,shaman,restoration,12,2,10
area-52,192,shaman,restoration,13,2,11
stormscale,192,shaman,restoration,18,2,16
arthas,191,shaman,restoration,6,2,4
stormrage,191,shaman,restoration,6,2,4
malganis,191,shaman,restoration,6,2,4
sargeras,128,shaman,restoration,4,2,2
ragnaros,112,shaman,restoration,7,2,5
firetree,112,shaman,restoration,13,2,11
hyjal,96,shaman,restoration,3,2,1
area-52,96,shaman,restoration,6,1,5
area-52,96,shaman,restoration,6,1,5
scarlet-crusade,96,shaman,restoration,6,1,5
area-52,96,shaman,restoration,6,1,5
area-52,96,shaman,restoration,6,1,5
kelthuzad,96,shaman,restoration,6,1,5
blackrock,96,shaman,restoration,6,1,5
malganis,96,shaman,restoration,6,1,5
bonechewer,96,shaman,restoration,6,1,5
shadowmoon,96,shaman,restoration,6,1,5
ragnaros,96,shaman,restoration,6,1,5
drakkari,96,shaman,restoration,6,1,5
bleeding-hollow,96,shaman,restoration,6,1,5
tichondrius,96,shaman,restoration,6,1,5
thrall,96,shaman,restoration,6,1,5
tichondrius,96,shaman,restoration,6,1,5
frostwolf,96,shaman,restoration,6,1,5
moon-guard,96,shaman,restoration,6,1,5
area-52,96,shaman,restoration,6,1,5
zuljin,96,shaman,restoration,6,1,5
jubeithos,96,shaman,restoration,6,1,5
tichondrius,96,shaman,restoration,6,1,5
tichondrius,96,shaman,restoration,6,1,5
tichondrius,96,shaman,restoration,6,1,5
tichondrius,96,shaman,restoration,6,1,5
maelstrom,96,shaman,restoration,6,1,5
tichondrius,96,shaman,restoration,7,1,6
chogall,96,shaman,restoration,12,1,11
dalaran,96,shaman,restoration,12,1,11
khazgoroth,96,shaman,restoration,12,1,11
khadgar,96,shaman,restoration,12,1,11
area-52,96,shaman,restoration,12,1,11
firetree,96,shaman,restoration,12,1,11
tichondrius,95,shaman,restoration,18,1,17
mugthol,79,shaman,restoration,11,1,10
frostmourne,63,shaman,restoration,2,2,0
ysera,42,shaman,restoration,6,2,4
cenarion-circle,31,shaman,restoration,2,1,1
kiljaeden,2368,shaman,elemental,126,80,46
illidan,2168,shaman,elemental,59,36,23
tichondrius,2152,shaman,elemental,73,46,27
malganis,2135,shaman,elemental,84,43,41
dalaran,2134,shaman,elemental,106,64,42
malganis,2127,shaman,elemental,78,49,29
bleeding-hollow,2125,shaman,elemental,142,74,68
tichondrius,2090,shaman,elemental,59,36,23
drenden,2087,shaman,elemental,95,54,41
frostmourne,2070,shaman,elemental,108,61,47
malganis,2047,shaman,elemental,89,46,43
aggramar,2038,shaman,elemental,42,26,16
proudmoore,2038,shaman,elemental,65,37,28
sargeras,2009,shaman,elemental,112,59,53
tichondrius,2008,shaman,elemental,43,31,12
tichondrius,1947,shaman,elemental,92,48,44
tichondrius,1938,shaman,elemental,42,29,13
azralon,1931,shaman,elemental,78,35,43
deathwing,1890,shaman,elemental,143,74,69
tichondrius,1863,shaman,elemental,46,30,16
darkspear,1859,shaman,elemental,42,24,18
illidan,1853,shaman,elemental,51,31,20
korgath,1838,shaman,elemental,84,37,47
sargeras,1828,shaman,elemental,48,27,21
illidan,1821,shaman,elemental,104,47,57
burning-blade,1809,shaman,elemental,72,40,32
tichondrius,1807,shaman,elemental,42,19,23
sargeras,1806,shaman,elemental,36,22,14
tichondrius,1806,shaman,elemental,72,33,39
nesingwary,1803,shaman,elemental,44,27,17
frostmourne,1802,shaman,elemental,48,30,18
drakkari,1801,shaman,elemental,60,31,29
dathremar,1800,shaman,elemental,48,30,18
moon-guard,1800,shaman,elemental,102,56,46
area-52,1793,shaman,elemental,53,28,25
barthilas,1793,shaman,elemental,65,34,31
tichondrius,1792,shaman,elemental,36,21,15
boulderfist,1791,shaman,elemental,100,54,46
illidan,1770,shaman,elemental,35,19,16
tichondrius,1765,shaman,elemental,30,20,10
spirestone,1764,shaman,elemental,48,30,18
tichondrius,1760,shaman,elemental,48,33,15
tichondrius,1751,shaman,elemental,30,22,8
azralon,1740,shaman,elemental,42,27,15
tichondrius,1735,shaman,elemental,36,22,14
tichondrius,1731,shaman,elemental,34,26,8
tichondrius,1730,shaman,elemental,62,30,32
malganis,1728,shaman,elemental,30,21,9
tichondrius,1723,shaman,elemental,30,18,12
tichondrius,1719,shaman,elemental,42,24,18
tichondrius,1710,shaman,elemental,54,30,24
area-52,1703,shaman,elemental,48,34,14
lothar,1694,shaman,elemental,59,38,21
tichondrius,1691,shaman,elemental,51,24,27
sargeras,1689,shaman,elemental,36,18,18
tichondrius,1684,shaman,elemental,108,51,57
sargeras,1681,shaman,elemental,42,20,22
proudmoore,1659,shaman,elemental,94,52,42
tichondrius,1652,shaman,elemental,56,25,31
azgalor,1650,shaman,elemental,40,23,17
moon-guard,1645,shaman,elemental,47,23,24
sisters-of-elune,1644,shaman,elemental,52,23,29
crushridge,1642,shaman,elemental,61,32,29
stormrage,1633,shaman,elemental,36,18,18
bleeding-hollow,1631,shaman,elemental,42,22,20
bleeding-hollow,1630,shaman,elemental,30,17,13
frostmourne,1627,shaman,elemental,35,19,16
tichondrius,1624,shaman,elemental,36,17,19
bleeding-hollow,1618,shaman,elemental,48,30,18
gnomeregan,1617,shaman,elemental,104,54,50
kelthuzad,1616,shaman,elemental,58,29,29
frostmourne,1616,shaman,elemental,110,54,56
bleeding-hollow,1612,shaman,elemental,24,17,7
tichondrius,1612,shaman,elemental,30,17,13
tichondrius,1608,shaman,elemental,42,21,21
illidan,1603,shaman,elemental,36,19,17
sargeras,1602,shaman,elemental,66,44,22
tichondrius,1601,shaman,elemental,39,19,20
maiev,1599,shaman,elemental,27,22,5
proudmoore,1599,shaman,elemental,24,17,7
tichondrius,1595,shaman,elemental,30,17,13
stormrage,1595,shaman,elemental,41,18,23
tichondrius,1593,shaman,elemental,43,20,23
tichondrius,1579,shaman,elemental,84,38,46
blackrock,1577,shaman,elemental,35,17,18
illidan,1560,shaman,elemental,78,39,39
ragnaros,1557,shaman,elemental,60,34,26
senjin,1555,shaman,elemental,36,18,18
illidan,1550,shaman,elemental,30,17,13
dathremar,1545,shaman,elemental,50,41,9
tichondrius,1535,shaman,elemental,24,16,8
eonar,1535,shaman,elemental,24,16,8
frostmourne,1534,shaman,elemental,30,18,12
zuljin,1527,shaman,elemental,30,16,14
proudmoore,1524,shaman,elemental,30,16,14
frostwolf,1520,shaman,elemental,41,23,18
drakkari,1507,shaman,elemental,77,31,46
zuljin,1506,shaman,elemental,78,36,42
wyrmrest-accord,1504,shaman,elemental,30,16,14
proudmoore,1502,shaman,elemental,36,16,20
tichondrius,1499,shaman,elemental,42,19,23
illidan,1487,shaman,elemental,30,16,14
tichondrius,1483,shaman,elemental,58,35,23
ragnaros,1481,shaman,elemental,31,19,12
stormrage,1463,shaman,elemental,61,37,24
moon-guard,1449,shaman,elemental,35,22,13
frostmourne,1446,shaman,elemental,36,22,14
demon-soul,1445,shaman,elemental,42,24,18
stormrage,1438,shaman,elemental,24,15,9
kelthuzad,1434,shaman,elemental,57,32,25
kelthuzad,1430,shaman,elemental,30,15,15
tichondrius,1429,shaman,elemental,38,16,22
sargeras,1421,shaman,elemental,76,37,39
tichondrius,1417,shaman,elemental,30,15,15
ragnaros,1415,shaman,elemental,30,15,15
stormscale,1413,shaman,elemental,42,21,21
kelthuzad,1409,shaman,elemental,115,63,52
wyrmrest-accord,1392,shaman,elemental,68,29,39
illidan,1385,shaman,elemental,23,15,8
quelthalas,1383,shaman,elemental,23,15,8
kelthuzad,1381,shaman,elemental,66,34,32
proudmoore,1372,shaman,elemental,48,19,29
sargeras,1369,shaman,elemental,55,29,26
azralon,1362,shaman,elemental,42,23,19
darkspear,1361,shaman,elemental,35,15,20
dalaran,1357,shaman,elemental,36,15,21
tichondrius,1353,shaman,elemental,113,50,63
frostmourne,1351,shaman,elemental,30,15,15
kiljaeden,1349,shaman,elemental,32,18,14
tichondrius,1344,shaman,elemental,24,14,10
tichondrius,1343,shaman,elemental,33,16,17
quelthalas,1340,shaman,elemental,42,20,22
frostwolf,1340,shaman,elemental,30,14,16
destromath,1339,shaman,elemental,24,14,10
tichondrius,1333,shaman,elemental,31,14,17
burning-legion,1327,shaman,elemental,24,14,10
barthilas,1326,shaman,elemental,36,19,17
thaurissan,1325,shaman,elemental,49,21,28
tichondrius,1305,shaman,elemental,28,15,13
firetree,1295,shaman,elemental,24,14,10
illidan,1281,shaman,elemental,23,14,9
sargeras,1278,shaman,elemental,28,14,14
bleeding-hollow,1271,shaman,elemental,48,23,25
azralon,1260,shaman,elemental,30,16,14
tichondrius,1248,shaman,elemental,24,13,11
illidan,1248,shaman,elemental,24,13,11
dalaran,1245,shaman,elemental,18,13,5
quelthalas,1245,shaman,elemental,71,41,30
area-52,1242,shaman,elemental,21,14,7
sargeras,1242,shaman,elemental,24,13,11
quelthalas,1241,shaman,elemental,24,13,11
ragnaros,1238,shaman,elemental,40,20,20
stormrage,1234,shaman,elemental,24,13,11
area-52,1214,shaman,elemental,30,20,10
proudmoore,1214,shaman,elemental,30,15,15
illidan,1214,shaman,elemental,48,19,29
quelthalas,1210,shaman,elemental,42,16,26
haomarush,1196,shaman,elemental,36,14,22
stormrage,1195,shaman,elemental,36,17,19
warsong,1179,shaman,elemental,45,27,18
sargeras,1167,shaman,elemental,31,13,18
tichondrius,1163,shaman,elemental,45,24,21
sargeras,1152,shaman,elemental,24,12,12
tichondrius,1151,shaman,elemental,24,12,12
terenas,1150,shaman,elemental,18,12,6
sargeras,1150,shaman,elemental,24,12,12
quelthalas,1149,shaman,elemental,18,12,6
area-52,1147,shaman,elemental,24,12,12
vashj,1132,shaman,elemental,30,17,13
dunemaul,1125,shaman,elemental,47,18,29
area-52,1123,shaman,elemental,43,17,26
kelthuzad,1120,shaman,elemental,63,31,32
tichondrius,1119,shaman,elemental,28,12,16
barthilas,1111,shaman,elemental,23,12,11
daggerspine,1110,shaman,elemental,24,13,11
tichondrius,1099,shaman,elemental,17,12,5
tichondrius,1099,shaman,elemental,17,12,5
nathrezim,1085,shaman,elemental,20,12,8
tichondrius,1085,shaman,elemental,26,12,14
vashj,1083,shaman,elemental,17,12,5
zuluhed,1083,shaman,elemental,35,19,16
barthilas,1074,shaman,elemental,35,19,16
khazgoroth,1068,shaman,elemental,25,12,13
jubeithos,1061,shaman,elemental,48,15,33
illidan,1056,shaman,elemental,18,11,7
sargeras,1056,shaman,elemental,18,11,7
tichondrius,1056,shaman,elemental,24,11,13
tichondrius,1055,shaman,elemental,12,11,1
frostmourne,1055,shaman,elemental,18,11,7
tichondrius,1055,shaman,elemental,18,11,7
bloodscalp,1055,shaman,elemental,21,12,9
bleeding-hollow,1055,shaman,elemental,24,11,13
tichondrius,1054,shaman,elemental,18,11,7
bleeding-hollow,1054,shaman,elemental,18,11,7
sargeras,1054,shaman,elemental,42,22,20
gnomeregan,1052,shaman,elemental,66,34,32
ragnaros,1050,shaman,elemental,24,11,13
sargeras,1048,shaman,elemental,59,30,29
tichondrius,1045,shaman,elemental,63,29,34
illidan,1045,shaman,elemental,24,11,13
saurfang,1040,shaman,elemental,24,11,13
echo-isles,1033,shaman,elemental,24,12,12
bleeding-hollow,968,shaman,elemental,30,12,18
garithos,960,shaman,elemental,12,10,2
zuljin,960,shaman,elemental,12,10,2
malganis,960,shaman,elemental,18,10,8
kiljaeden,959,shaman,elemental,12,10,2
tichondrius,959,shaman,elemental,18,10,8
tichondrius,958,shaman,elemental,24,10,14
aegwynn,958,shaman,elemental,24,10,14
kelthuzad,957,shaman,elemental,12,10,2
tichondrius,957,shaman,elemental,12,10,2
kiljaeden,956,shaman,elemental,18,10,8
tichondrius,956,shaman,elemental,24,10,14
tichondrius,955,shaman,elemental,24,10,14
stormrage,953,shaman,elemental,18,10,8
tichondrius,953,shaman,elemental,24,10,14
bonechewer,941,shaman,elemental,24,10,14
frostwolf,929,shaman,elemental,24,10,14
frostmourne,909,shaman,elemental,17,10,7
malygos,899,shaman,elemental,32,16,16
lightbringer,893,shaman,elemental,23,10,13
azralon,890,shaman,elemental,22,10,12
bleeding-hollow,886,shaman,elemental,55,20,35
barthilas,880,shaman,elemental,19,10,9
tichondrius,864,shaman,elemental,12,9,3
lightbringer,864,shaman,elemental,12,9,3
tichondrius,864,shaman,elemental,12,9,3
tichondrius,864,shaman,elemental,18,9,9
tichondrius,864,shaman,elemental,18,9,9
dalaran,864,shaman,elemental,18,9,9
tichondrius,864,shaman,elemental,24,9,15
tichondrius,863,shaman,elemental,12,9,3
kiljaeden,863,shaman,elemental,18,9,9
ragnaros,863,shaman,elemental,18,9,9
tichondrius,863,shaman,elemental,18,9,9
proudmoore,863,shaman,elemental,24,9,15
blackrock,862,shaman,elemental,18,9,9
emerald-dream,862,shaman,elemental,18,9,9
ragnaros,862,shaman,elemental,24,9,15
zuljin,862,shaman,elemental,30,9,21
black-dragonflight,861,shaman,elemental,18,9,9
ragnaros,861,shaman,elemental,18,9,9
arthas,861,shaman,elemental,24,9,15
galakrond,860,shaman,elemental,12,9,3
illidan,860,shaman,elemental,18,9,9
shattered-hand,859,shaman,elemental,18,9,9
moon-guard,858,shaman,elemental,24,9,15
illidan,856,shaman,elemental,18,9,9
tichondrius,816,shaman,elemental,21,9,12
shandris,799,shaman,elemental,17,9,8
tichondrius,768,shaman,elemental,12,8,4
tichondrius,768,shaman,elemental,12,8,4
aegwynn,768,shaman,elemental,12,8,4
stormrage,768,shaman,elemental,12,8,4
tichondrius,768,shaman,elemental,12,8,4
bleeding-hollow,768,shaman,elemental,18,8,10
kelthuzad,768,shaman,elemental,18,8,10
tichondrius,768,shaman,elemental,18,8,10
malganis,767,shaman,elemental,12,8,4
mannoroth,767,shaman,elemental,18,8,10
alterac-mountains,767,shaman,elemental,24,8,16
illidan,764,shaman,elemental,12,8,4
tichondrius,751,shaman,elemental,18,8,10
dalaran,735,shaman,elemental,17,8,9
zuljin,734,shaman,elemental,17,8,9
hyjal,734,shaman,elemental,23,8,15
tichondrius,719,shaman,elemental,17,8,9
tichondrius,672,shaman,elemental,12,7,5
ragnaros,672,shaman,elemental,12,7,5
sargeras,672,shaman,elemental,12,7,5
barthilas,672,shaman,elemental,12,7,5
area-52,672,shaman,elemental,12,7,5
stormrage,672,shaman,elemental,12,7,5
tichondrius,672,shaman,elemental,12,7,5
bleeding-hollow,672,shaman,elemental,12,7,5
kelthuzad,672,shaman,elemental,12,7,5
thrall,672,shaman,elemental,12,7,5
kelthuzad,672,shaman,elemental,12,7,5
tichondrius,672,shaman,elemental,12,7,5
tortheldrin,672,shaman,elemental,18,7,11
azralon,672,shaman,elemental,18,7,11
proudmoore,672,shaman,elemental,18,7,11
tichondrius,672,shaman,elemental,18,7,11
malganis,671,shaman,elemental,12,7,5
moon-guard,671,shaman,elemental,12,7,5
drakkari,671,shaman,elemental,18,7,11
malganis,671,shaman,elemental,18,7,11
zuluhed,671,shaman,elemental,21,8,13
barthilas,671,shaman,elemental,26,7,19
borean-tundra,669,shaman,elemental,12,7,5
skullcrusher,669,shaman,elemental,18,7,11
dalaran,667,shaman,elemental,12,7,5
gallywix,666,shaman,elemental,18,7,11
area-52,664,shaman,elemental,24,7,17
arthas,651,shaman,elemental,22,7,15
moon-guard,639,shaman,elemental,14,8,6
area-52,623,shaman,elemental,11,7,4
stormrage,623,shaman,elemental,17,7,10
stormrage,600,shaman,elemental,21,10,11
frostmourne,591,shaman,elemental,11,7,4
stormrage,589,shaman,elemental,11,7,4
aggramar,576,shaman,elemental,6,6,0
tichondrius,576,shaman,elemental,6,6,0
tichondrius,576,shaman,elemental,6,6,0
quelthalas,576,shaman,elemental,12,6,6
sargeras,576,shaman,elemental,12,6,6
sargeras,576,shaman,elemental,12,6,6
sargeras,576,shaman,elemental,12,6,6
ragnaros,576,shaman,elemental,12,6,6
sargeras,576,shaman,elemental,12,6,6
kelthuzad,576,shaman,elemental,12,6,6
area-52,576,shaman,elemental,12,6,6
tichondrius,576,shaman,elemental,13,6,7
tichondrius,576,shaman,elemental,18,6,12
moon-guard,576,shaman,elemental,18,6,12
frostmourne,576,shaman,elemental,18,6,12
sargeras,575,shaman,elemental,12,6,6
magtheridon,575,shaman,elemental,12,6,6
zuljin,575,shaman,elemental,12,6,6
zuljin,575,shaman,elemental,12,6,6
zuljin,575,shaman,elemental,12,6,6
azralon,575,shaman,elemental,12,6,6
tichondrius,575,shaman,elemental,12,6,6
area-52,575,shaman,elemental,12,6,6
frostmourne,570,shaman,elemental,18,6,12
tichondrius,559,shaman,elemental,11,6,5
kelthuzad,543,shaman,elemental,15,7,8
the-scryers,541,shaman,elemental,16,6,10
drakkari,522,shaman,elemental,21,9,12
cenarion-circle,480,shaman,elemental,6,5,1
frostmourne,480,shaman,elemental,6,5,1
blades-edge,480,shaman,elemental,6,5,1
moon-guard,480,shaman,elemental,6,5,1
stormrage,480,shaman,elemental,6,5,1
illidan,480,shaman,elemental,6,5,1
azralon,480,shaman,elemental,6,5,1
moon-guard,480,shaman,elemental,6,5,1
illidan,480,shaman,elemental,6,5,1
magtheridon,480,shaman,elemental,6,5,1
quelthalas,480,shaman,elemental,12,5,7
ragnaros,480,shaman,elemental,12,5,7
tichondrius,480,shaman,elemental,12,5,7
barthilas,480,shaman,elemental,12,5,7
tichondrius,480,shaman,elemental,12,5,7
malganis,480,shaman,elemental,12,5,7
frostmourne,480,shaman,elemental,12,5,7
tichondrius,480,shaman,elemental,12,5,7
azralon,480,shaman,elemental,12,5,7
whisperwind,480,shaman,elemental,12,5,7
azralon,480,shaman,elemental,12,5,7
zuljin,480,shaman,elemental,12,5,7
silvermoon,480,shaman,elemental,12,5,7
sargeras,480,shaman,elemental,12,5,7
burning-legion,480,shaman,elemental,12,5,7
illidan,480,shaman,elemental,12,5,7
stormrage,480,shaman,elemental,15,6,9
nesingwary,480,shaman,elemental,15,6,9
area-52,480,shaman,elemental,18,5,13
drakkari,480,shaman,elemental,18,5,13
barthilas,479,shaman,elemental,6,5,1
stormrage,479,shaman,elemental,12,5,7
dalaran,478,shaman,elemental,12,5,7
nagrand,478,shaman,elemental,12,5,7
executus,447,shaman,elemental,11,5,6
dragonmaw,415,shaman,elemental,14,5,9
jubeithos,384,shaman,elemental,6,4,2
sargeras,384,shaman,elemental,6,4,2
proudmoore,384,shaman,elemental,6,4,2
tichondrius,384,shaman,elemental,6,4,2
stormreaver,384,shaman,elemental,6,4,2
sargeras,384,shaman,elemental,6,4,2
stonemaul,384,shaman,elemental,6,4,2
proudmoore,384,shaman,elemental,6,4,2
illidan,384,shaman,elemental,6,4,2
antonidas,384,shaman,elemental,6,4,2
korgath,384,shaman,elemental,6,4,2
illidan,384,shaman,elemental,6,4,2
tichondrius,384,shaman,elemental,6,4,2
tichondrius,384,shaman,elemental,6,4,2
azralon,384,shaman,elemental,6,4,2
tichondrius,384,shaman,elemental,6,4,2
area-52,384,shaman,elemental,6,4,2
thrall,384,shaman,elemental,6,4,2
arygos,384,shaman,elemental,6,4,2
stormrage,384,shaman,elemental,6,4,2
runetotem,384,shaman,elemental,6,4,2
tichondrius,384,shaman,elemental,6,4,2
madoran,384,shaman,elemental,6,4,2
frostwolf,384,shaman,elemental,6,4,2
arathor,384,shaman,elemental,6,4,2
ragnaros,384,shaman,elemental,6,4,2
tichondrius,384,shaman,elemental,6,4,2
kelthuzad,384,shaman,elemental,6,4,2
malganis,384,shaman,elemental,6,4,2
chogall,384,shaman,elemental,6,4,2
quelthalas,384,shaman,elemental,12,4,8
sargeras,384,shaman,elemental,12,4,8
suramar,384,shaman,elemental,12,4,8
area-52,384,shaman,elemental,12,4,8
area-52,384,shaman,elemental,12,4,8
tichondrius,384,shaman,elemental,12,4,8
area-52,384,shaman,elemental,12,4,8
chogall,384,shaman,elemental,12,4,8
tichondrius,384,shaman,elemental,18,4,14
frostmourne,384,shaman,elemental,18,4,14
ragnaros,384,shaman,elemental,24,4,20
ragnaros,383,shaman,elemental,6,4,2
stonemaul,383,shaman,elemental,6,4,2
sargeras,383,shaman,elemental,12,4,8
thunderlord,382,shaman,elemental,6,4,2
magtheridon,379,shaman,elemental,12,4,8
stormrage,351,shaman,elemental,8,5,3
turalyon,350,shaman,elemental,11,4,7
kelthuzad,336,shaman,elemental,9,4,5
garrosh,325,shaman,elemental,15,5,10
bleeding-hollow,304,shaman,elemental,7,4,3
moon-guard,302,shaman,elemental,9,4,5
hyjal,288,shaman,elemental,6,3,3
kelthuzad,288,shaman,elemental,6,3,3
illidan,288,shaman,elemental,6,3,3
quelthalas,288,shaman,elemental,6,3,3
ragnaros,288,shaman,elemental,6,3,3
area-52,288,shaman,elemental,6,3,3
ragnaros,288,shaman,elemental,6,3,3
laughing-skull,288,shaman,elemental,6,3,3
malganis,288,shaman,elemental,6,3,3
area-52,288,shaman,elemental,6,3,3
area-52,288,shaman,elemental,6,3,3
bleeding-hollow,288,shaman,elemental,6,3,3
frostmourne,288,shaman,elemental,6,3,3
elune,288,shaman,elemental,6,3,3
the-scryers,288,shaman,elemental,6,3,3
tichondrius,288,shaman,elemental,6,3,3
durotan,288,shaman,elemental,6,3,3
barthilas,288,shaman,elemental,6,3,3
malganis,288,shaman,elemental,6,3,3
bleeding-hollow,288,shaman,elemental,6,3,3
cenarius,288,shaman,elemental,6,3,3
area-52,288,shaman,elemental,6,3,3
sargeras,288,shaman,elemental,6,3,3
area-52,288,shaman,elemental,6,3,3
stormrage,288,shaman,elemental,6,3,3
bleeding-hollow,288,shaman,elemental,6,3,3
stormrage,288,shaman,elemental,6,3,3
zuljin,288,shaman,elemental,6,3,3
spirestone,288,shaman,elemental,6,3,3
kiljaeden,288,shaman,elemental,6,3,3
nerzhul,288,shaman,elemental,6,3,3
sargeras,288,shaman,elemental,6,3,3
tol-barad,288,shaman,elemental,6,3,3
stormrage,288,shaman,elemental,6,3,3
illidan,288,shaman,elemental,6,3,3
sargeras,288,shaman,elemental,6,3,3
sargeras,288,shaman,elemental,6,3,3
tichondrius,288,shaman,elemental,6,3,3
tichondrius,288,shaman,elemental,6,3,3
thrall,288,shaman,elemental,6,3,3
illidan,288,shaman,elemental,6,3,3
thrall,288,shaman,elemental,6,3,3
tichondrius,288,shaman,elemental,6,3,3
thrall,288,shaman,elemental,6,3,3
stormrage,288,shaman,elemental,6,3,3
darkspear,288,shaman,elemental,6,3,3
tichondrius,288,shaman,elemental,6,3,3
sargeras,288,shaman,elemental,6,3,3
illidan,288,shaman,elemental,6,3,3
tichondrius,288,shaman,elemental,6,3,3
sargeras,288,shaman,elemental,6,3,3
illidan,288,shaman,elemental,6,3,3
quelthalas,288,shaman,elemental,6,3,3
tichondrius,288,shaman,elemental,6,3,3
bronzebeard,288,shaman,elemental,6,3,3
sargeras,288,shaman,elemental,6,3,3
tichondrius,288,shaman,elemental,6,3,3
tichondrius,288,shaman,elemental,6,3,3
sargeras,288,shaman,elemental,6,3,3
malganis,288,shaman,elemental,6,3,3
sargeras,288,shaman,elemental,6,3,3
jaedenar,288,shaman,elemental,6,3,3
bleeding-hollow,288,shaman,elemental,11,3,8
bleeding-hollow,288,shaman,elemental,12,3,9
ragnaros,288,shaman,elemental,12,3,9
area-52,288,shaman,elemental,12,3,9
malganis,288,shaman,elemental,12,3,9
darkspear,287,shaman,elemental,6,3,3
frostmourne,287,shaman,elemental,6,3,3
burning-legion,287,shaman,elemental,12,3,9
sargeras,286,shaman,elemental,6,3,3
illidan,271,shaman,elemental,17,3,14
tichondrius,255,shaman,elemental,11,3,8
amanthul,240,shaman,elemental,9,3,6
wyrmrest-accord,239,shaman,elemental,5,3,2
frostmourne,239,shaman,elemental,5,3,2
frostmourne,234,shaman,elemental,17,8,9
exodar,224,shaman,elemental,10,3,7
emerald-dream,192,shaman,elemental,6,2,4
skywall,192,shaman,elemental,6,2,4
emerald-dream,192,shaman,elemental,6,2,4
area-52,192,shaman,elemental,6,2,4
stormrage,192,shaman,elemental,6,2,4
tichondrius,192,shaman,elemental,6,2,4
blackrock,192,shaman,elemental,6,2,4
emerald-dream,192,shaman,elemental,6,2,4
tichondrius,192,shaman,elemental,6,2,4
azgalor,192,shaman,elemental,6,2,4
jubeithos,192,shaman,elemental,6,2,4
illidan,192,shaman,elemental,6,2,4
chogall,192,shaman,elemental,6,2,4
sargeras,192,shaman,elemental,6,2,4
tichondrius,192,shaman,elemental,6,2,4
tichondrius,192,shaman,elemental,6,2,4
frostmourne,192,shaman,elemental,6,2,4
earthen-ring,192,shaman,elemental,6,2,4
illidan,192,shaman,elemental,6,2,4
tichondrius,192,shaman,elemental,6,2,4
sargeras,192,shaman,elemental,6,2,4
mugthol,192,shaman,elemental,6,2,4
frostmourne,192,shaman,elemental,6,2,4
illidan,192,shaman,elemental,6,2,4
sargeras,192,shaman,elemental,6,2,4
malganis,192,shaman,elemental,6,2,4
moon-guard,192,shaman,elemental,6,2,4
ragnaros,192,shaman,elemental,6,2,4
ragnaros,192,shaman,elemental,6,2,4
illidan,192,shaman,elemental,6,2,4
frostmourne,192,shaman,elemental,6,2,4
proudmoore,192,shaman,elemental,6,2,4
proudmoore,192,shaman,elemental,6,2,4
ragnaros,192,shaman,elemental,6,2,4
ragnaros,192,shaman,elemental,6,2,4
thrall,192,shaman,elemental,6,2,4
malganis,192,shaman,elemental,6,2,4
moon-guard,192,shaman,elemental,6,2,4
ragnaros,192,shaman,elemental,6,2,4
malganis,192,shaman,elemental,6,2,4
frostwolf,192,shaman,elemental,6,2,4
area-52,192,shaman,elemental,6,2,4
area-52,192,shaman,elemental,6,2,4
kiljaeden,192,shaman,elemental,7,2,5
smolderthorn,192,shaman,elemental,12,2,10
moon-guard,192,shaman,elemental,12,2,10
malygos,192,shaman,elemental,12,2,10
tichondrius,192,shaman,elemental,12,2,10
cenarion-circle,192,shaman,elemental,12,2,10
tichondrius,191,shaman,elemental,6,2,4
illidan,159,shaman,elemental,5,2,3
illidan,159,shaman,elemental,17,2,15
kiljaeden,138,shaman,elemental,10,3,7
zuljin,128,shaman,elemental,4,2,2
sargeras,127,shaman,elemental,8,2,6
azralon,96,shaman,elemental,6,1,5
silvermoon,96,shaman,elemental,6,1,5
thrall,96,shaman,elemental,6,1,5
silvermoon,96,shaman,elemental,6,1,5
illidan,96,shaman,elemental,6,1,5
ragnaros,96,shaman,elemental,6,1,5
frostmourne,96,shaman,elemental,6,1,5
ragnaros,96,shaman,elemental,6,1,5
area-52,96,shaman,elemental,6,1,5
ragnaros,96,shaman,elemental,6,1,5
stormrage,96,shaman,elemental,6,1,5
stormrage,96,shaman,elemental,6,1,5
thrall,96,shaman,elemental,6,1,5
fizzcrank,96,shaman,elemental,6,1,5
eldrethalas,96,shaman,elemental,6,1,5
emerald-dream,96,shaman,elemental,6,1,5
tichondrius,96,shaman,elemental,6,1,5
illidan,96,shaman,elemental,6,1,5
elune,96,shaman,elemental,6,1,5
darkspear,96,shaman,elemental,6,1,5
blood-furnace,96,shaman,elemental,6,1,5
tichondrius,96,shaman,elemental,6,1,5
azshara,96,shaman,elemental,6,1,5
tichondrius,96,shaman,elemental,6,1,5
tichondrius,96,shaman,elemental,18,1,17
tichondrius,79,shaman,elemental,5,1,4
khadgar,64,shaman,elemental,4,1,3
malganis,63,shaman,elemental,2,2,0
frostwolf,48,shaman,elemental,3,1,2
kiljaeden,48,shaman,elemental,3,1,2
illidan,31,shaman,elemental,2,1,1
emerald-dream,2194,shaman,enhancement,150,79,71
tichondrius,2156,shaman,enhancement,88,45,43
tichondrius,2145,shaman,enhancement,159,81,78
tichondrius,2138,shaman,enhancement,79,43,36
stormrage,2133,shaman,enhancement,132,76,56
sargeras,2130,shaman,enhancement,84,54,30
illidan,2129,shaman,enhancement,59,41,18
tichondrius,2121,shaman,enhancement,70,36,34
area-52,2116,shaman,enhancement,112,59,53
azralon,2049,shaman,enhancement,96,49,47
tichondrius,2027,shaman,enhancement,66,44,22
illidan,1996,shaman,enhancement,71,42,29
tichondrius,1994,shaman,enhancement,120,57,63
quelthalas,1987,shaman,enhancement,87,49,38
tichondrius,1978,shaman,enhancement,65,40,25
tichondrius,1969,shaman,enhancement,42,29,13
tichondrius,1963,shaman,enhancement,123,69,54
area-52,1959,shaman,enhancement,60,36,24
tichondrius,1957,shaman,enhancement,48,26,22
tichondrius,1952,shaman,enhancement,54,26,28
sargeras,1942,shaman,enhancement,115,62,53
tichondrius,1934,shaman,enhancement,263,139,124
tichondrius,1922,shaman,enhancement,80,42,38
area-52,1918,shaman,enhancement,90,67,23
tichondrius,1917,shaman,enhancement,89,45,44
area-52,1916,shaman,enhancement,47,28,19
dalaran,1915,shaman,enhancement,60,32,28
emerald-dream,1902,shaman,enhancement,46,23,23
proudmoore,1902,shaman,enhancement,120,58,62
stormrage,1897,shaman,enhancement,71,37,34
barthilas,1894,shaman,enhancement,159,85,74
tichondrius,1887,shaman,enhancement,42,24,18
frostmourne,1875,shaman,enhancement,126,84,42
tichondrius,1864,shaman,enhancement,102,54,48
illidan,1854,shaman,enhancement,42,29,13
emerald-dream,1844,shaman,enhancement,42,30,12
moon-guard,1840,shaman,enhancement,62,44,18
illidan,1839,shaman,enhancement,56,32,24
moon-guard,1835,shaman,enhancement,127,71,56
thrall,1832,shaman,enhancement,54,34,20
thaurissan,1828,shaman,enhancement,74,41,33
emerald-dream,1826,shaman,enhancement,75,47,28
tichondrius,1825,shaman,enhancement,47,29,18
tichondrius,1821,shaman,enhancement,57,35,22
moon-guard,1821,shaman,enhancement,72,40,32
azralon,1821,shaman,enhancement,54,30,24
stormrage,1820,shaman,enhancement,150,85,65
tichondrius,1819,shaman,enhancement,77,48,29
tichondrius,1818,shaman,enhancement,57,35,22
area-52,1818,shaman,enhancement,42,24,18
zuljin,1817,shaman,enhancement,54,29,25
bleeding-hollow,1812,shaman,enhancement,48,28,20
area-52,1811,shaman,enhancement,42,27,15
bleeding-hollow,1811,shaman,enhancement,30,19,11
sargeras,1811,shaman,enhancement,35,21,14
altar-of-storms,1809,shaman,enhancement,60,32,28
barthilas,1808,shaman,enhancement,92,47,45
tichondrius,1806,shaman,enhancement,30,19,11
illidan,1805,shaman,enhancement,84,39,45
zuljin,1803,shaman,enhancement,60,31,29
kelthuzad,1797,shaman,enhancement,48,27,21
illidan,1796,shaman,enhancement,132,76,56
area-52,1795,shaman,enhancement,52,32,20
emerald-dream,1778,shaman,enhancement,87,45,42
stormrage,1767,shaman,enhancement,36,26,10
frostmourne,1756,shaman,enhancement,52,26,26
khaz-modan,1751,shaman,enhancement,24,19,5
stormrage,1749,shaman,enhancement,30,22,8
tichondrius,1749,shaman,enhancement,76,42,34
wyrmrest-accord,1747,shaman,enhancement,54,29,25
stormrage,1743,shaman,enhancement,48,30,18
tichondrius,1741,shaman,enhancement,48,22,26
illidan,1734,shaman,enhancement,36,25,11
tichondrius,1734,shaman,enhancement,42,19,23
stormrage,1727,shaman,enhancement,78,48,30
tichondrius,1723,shaman,enhancement,42,23,19
sargeras,1715,shaman,enhancement,45,25,20
thrall,1713,shaman,enhancement,48,30,18
frostmourne,1713,shaman,enhancement,42,26,16
sargeras,1712,shaman,enhancement,90,52,38
steamwheedle-cartel,1711,shaman,enhancement,36,20,16
tichondrius,1702,shaman,enhancement,48,26,22
emerald-dream,1702,shaman,enhancement,60,32,28
illidan,1702,shaman,enhancement,50,24,26
tichondrius,1699,shaman,enhancement,89,56,33
blackrock,1699,shaman,enhancement,41,24,17
frostmourne,1698,shaman,enhancement,48,28,20
sargeras,1697,shaman,enhancement,30,21,9
malganis,1694,shaman,enhancement,42,27,15
tichondrius,1694,shaman,enhancement,42,23,19
proudmoore,1693,shaman,enhancement,72,38,34
stormrage,1691,shaman,enhancement,36,24,12
stormrage,1691,shaman,enhancement,76,36,40
tichondrius,1691,shaman,enhancement,67,27,40
stormreaver,1689,shaman,enhancement,47,22,25
thrall,1688,shaman,enhancement,42,20,22
sargeras,1687,shaman,enhancement,45,30,15
moon-guard,1685,shaman,enhancement,42,29,13
earthen-ring,1680,shaman,enhancement,80,49,31
chogall,1678,shaman,enhancement,42,23,19
area-52,1674,shaman,enhancement,33,20,13
dalaran,1666,shaman,enhancement,36,22,14
dalaran,1664,shaman,enhancement,50,31,19
tichondrius,1659,shaman,enhancement,36,22,14
emerald-dream,1656,shaman,enhancement,68,34,34
hyjal,1655,shaman,enhancement,36,20,16
dalaran,1653,shaman,enhancement,30,21,9
area-52,1653,shaman,enhancement,48,27,21
malganis,1646,shaman,enhancement,248,121,127
barthilas,1641,shaman,enhancement,42,25,17
sargeras,1635,shaman,enhancement,42,25,17
azralon,1630,shaman,enhancement,31,19,12
quelthalas,1626,shaman,enhancement,108,61,47
stormrage,1626,shaman,enhancement,36,17,19
shattered-halls,1626,shaman,enhancement,54,22,32
destromath,1621,shaman,enhancement,41,19,22
tichondrius,1619,shaman,enhancement,30,21,9
illidan,1617,shaman,enhancement,36,20,16
illidan,1612,shaman,enhancement,156,79,77
tichondrius,1607,shaman,enhancement,24,18,6
barthilas,1607,shaman,enhancement,30,17,13
ragnaros,1606,shaman,enhancement,36,20,16
sargeras,1606,shaman,enhancement,56,23,33
tichondrius,1605,shaman,enhancement,42,27,15
illidan,1602,shaman,enhancement,36,19,17
frostmourne,1601,shaman,enhancement,30,20,10
barthilas,1596,shaman,enhancement,52,27,25
fenris,1596,shaman,enhancement,76,38,38
stormrage,1592,shaman,enhancement,36,22,14
tichondrius,1590,shaman,enhancement,72,34,38
tichondrius,1581,shaman,enhancement,35,20,15
spirestone,1580,shaman,enhancement,46,24,22
kelthuzad,1572,shaman,enhancement,30,19,11
terokkar,1566,shaman,enhancement,36,22,14
drakkari,1564,shaman,enhancement,30,18,12
sargeras,1563,shaman,enhancement,42,19,23
kiljaeden,1562,shaman,enhancement,84,51,33
hyjal,1555,shaman,enhancement,35,17,18
kelthuzad,1553,shaman,enhancement,60,30,30
stormrage,1544,shaman,enhancement,66,28,38
tichondrius,1540,shaman,enhancement,166,93,73
alleria,1538,shaman,enhancement,60,32,28
area-52,1535,shaman,enhancement,18,17,1
tichondrius,1529,shaman,enhancement,85,51,34
frostmourne,1527,shaman,enhancement,30,21,9
tichondrius,1524,shaman,enhancement,41,27,14
nagrand,1520,shaman,enhancement,26,18,8
tichondrius,1518,shaman,enhancement,41,20,21
area-52,1516,shaman,enhancement,66,30,36
barthilas,1511,shaman,enhancement,67,38,29
kelthuzad,1508,shaman,enhancement,36,23,13
illidan,1507,shaman,enhancement,59,24,35
ragnaros,1506,shaman,enhancement,24,16,8
malganis,1501,shaman,enhancement,30,16,14
azshara,1493,shaman,enhancement,78,35,43
emerald-dream,1491,shaman,enhancement,33,20,13
silver-hand,1478,shaman,enhancement,48,27,21
stormrage,1478,shaman,enhancement,84,41,43
thrall,1471,shaman,enhancement,42,20,22
stormrage,1468,shaman,enhancement,30,18,12
azshara,1452,shaman,enhancement,45,25,20
bleeding-hollow,1451,shaman,enhancement,23,16,7
illidan,1445,shaman,enhancement,72,27,45
nemesis,1444,shaman,enhancement,47,27,20
tichondrius,1443,shaman,enhancement,48,20,28
area-52,1439,shaman,enhancement,24,15,9
gorefiend,1438,shaman,enhancement,24,15,9
muradin,1437,shaman,enhancement,30,15,15
chogall,1437,shaman,enhancement,30,15,15
tichondrius,1435,shaman,enhancement,30,21,9
stormrage,1435,shaman,enhancement,98,54,44
tichondrius,1435,shaman,enhancement,30,15,15
blackrock,1428,shaman,enhancement,18,15,3
magtheridon,1428,shaman,enhancement,41,21,20
tichondrius,1427,shaman,enhancement,30,15,15
area-52,1426,shaman,enhancement,36,15,21
hyjal,1422,shaman,enhancement,85,43,42
stormrage,1421,shaman,enhancement,24,15,9
frostmourne,1421,shaman,enhancement,39,24,15
bleeding-hollow,1420,shaman,enhancement,24,17,7
tichondrius,1419,shaman,enhancement,55,26,29
dalaran,1418,shaman,enhancement,47,18,29
moon-guard,1414,shaman,enhancement,30,21,9
area-52,1410,shaman,enhancement,63,35,28
proudmoore,1408,shaman,enhancement,64,35,29
ragnaros,1404,shaman,enhancement,54,30,24
emerald-dream,1398,shaman,enhancement,54,35,19
hakkar,1398,shaman,enhancement,36,22,14
moon-guard,1398,shaman,enhancement,60,31,29
darkspear,1394,shaman,enhancement,27,17,10
tichondrius,1389,shaman,enhancement,36,15,21
warsong,1385,shaman,enhancement,31,17,14
crushridge,1380,shaman,enhancement,36,18,18
frostmourne,1373,shaman,enhancement,30,17,13
skullcrusher,1370,shaman,enhancement,47,28,19
illidan,1367,shaman,enhancement,20,15,5
illidan,1363,shaman,enhancement,36,22,14
barthilas,1360,shaman,enhancement,90,52,38
frostmourne,1355,shaman,enhancement,46,28,18
tichondrius,1346,shaman,enhancement,39,22,17
zuljin,1346,shaman,enhancement,82,42,40
illidan,1343,shaman,enhancement,24,14,10
tichondrius,1342,shaman,enhancement,18,14,4
barthilas,1342,shaman,enhancement,48,22,26
moon-guard,1341,shaman,enhancement,18,14,4
illidan,1340,shaman,enhancement,48,20,28
area-52,1339,shaman,enhancement,35,32,3
illidan,1339,shaman,enhancement,24,16,8
moon-guard,1337,shaman,enhancement,24,14,10
daggerspine,1336,shaman,enhancement,30,14,16
blackwing-lair,1333,shaman,enhancement,30,17,13
black-dragonflight,1331,shaman,enhancement,18,14,4
wyrmrest-accord,1329,shaman,enhancement,24,14,10
tichondrius,1328,shaman,enhancement,24,14,10
barthilas,1324,shaman,enhancement,36,20,16
sargeras,1320,shaman,enhancement,82,41,41
ragnaros,1311,shaman,enhancement,77,41,36
malganis,1310,shaman,enhancement,18,14,4
sargeras,1305,shaman,enhancement,24,14,10
illidan,1303,shaman,enhancement,49,25,24
dalaran,1297,shaman,enhancement,70,37,33
illidan,1295,shaman,enhancement,36,23,13
sargeras,1292,shaman,enhancement,58,37,21
malganis,1291,shaman,enhancement,50,22,28
wyrmrest-accord,1284,shaman,enhancement,58,28,30
emerald-dream,1278,shaman,enhancement,26,14,12
proudmoore,1273,shaman,enhancement,54,33,21
thrall,1270,shaman,enhancement,75,39,36
feathermoon,1259,shaman,enhancement,42,23,19
hyjal,1249,shaman,enhancement,24,15,9
tichondrius,1247,shaman,enhancement,18,13,5
kelthuzad,1246,shaman,enhancement,18,13,5
kiljaeden,1239,shaman,enhancement,24,13,11
eonar,1238,shaman,enhancement,24,13,11
agamaggan,1238,shaman,enhancement,24,13,11
area-52,1238,shaman,enhancement,83,42,41
malganis,1236,shaman,enhancement,30,14,16
proudmoore,1235,shaman,enhancement,26,13,13
quelthalas,1234,shaman,enhancement,24,13,11
icecrown,1230,shaman,enhancement,23,13,10
saurfang,1229,shaman,enhancement,24,13,11
thrall,1228,shaman,enhancement,42,19,23
blackhand,1228,shaman,enhancement,35,15,20
nemesis,1227,shaman,enhancement,18,13,5
barthilas,1222,shaman,enhancement,72,30,42
azralon,1220,shaman,enhancement,48,29,19
moon-guard,1218,shaman,enhancement,21,13,8
area-52,1216,shaman,enhancement,83,37,46
frostmourne,1203,shaman,enhancement,71,36,35
thunderhorn,1186,shaman,enhancement,36,18,18
proudmoore,1182,shaman,enhancement,48,26,22
vashj,1166,shaman,enhancement,34,15,19
tichondrius,1162,shaman,enhancement,54,29,25
blackrock,1161,shaman,enhancement,45,16,29
stormrage,1155,shaman,enhancement,38,13,25
shadowmoon,1152,shaman,enhancement,18,12,6
tichondrius,1152,shaman,enhancement,24,12,12
tichondrius,1152,shaman,enhancement,24,12,12
illidan,1151,shaman,enhancement,21,12,9
bladefist,1151,shaman,enhancement,24,12,12
dragonmaw,1151,shaman,enhancement,35,14,21
sargeras,1146,shaman,enhancement,30,12,18
sargeras,1144,shaman,enhancement,30,12,18
quelthalas,1142,shaman,enhancement,24,15,9
ragnaros,1142,shaman,enhancement,24,12,12
gundrak,1141,shaman,enhancement,37,19,18
frostmourne,1137,shaman,enhancement,18,12,6
sargeras,1133,shaman,enhancement,24,12,12
dark-iron,1128,shaman,enhancement,18,12,6
altar-of-storms,1125,shaman,enhancement,33,16,17
emerald-dream,1123,shaman,enhancement,24,12,12
illidan,1113,shaman,enhancement,29,12,17
draka,1110,shaman,enhancement,23,12,11
illidan,1110,shaman,enhancement,30,12,18
thrall,1108,shaman,enhancement,124,47,77
tichondrius,1108,shaman,enhancement,60,22,38
stormrage,1086,shaman,enhancement,26,14,12
frostmourne,1056,shaman,enhancement,18,11,7
area-52,1055,shaman,enhancement,18,11,7
wyrmrest-accord,1055,shaman,enhancement,18,11,7
kelthuzad,1055,shaman,enhancement,24,11,13
kargath,1055,shaman,enhancement,24,11,13
tichondrius,1054,shaman,enhancement,12,11,1
sargeras,1054,shaman,enhancement,24,11,13
tichondrius,1052,shaman,enhancement,24,11,13
ravenholdt,1051,shaman,enhancement,18,11,7
kelthuzad,1051,shaman,enhancement,24,11,13
tichondrius,1050,shaman,enhancement,24,11,13
stormscale,1050,shaman,enhancement,24,11,13
skullcrusher,1044,shaman,enhancement,18,11,7
sargeras,1043,shaman,enhancement,18,11,7
tichondrius,1043,shaman,enhancement,24,11,13
trollbane,1042,shaman,enhancement,24,11,13
korgath,1039,shaman,enhancement,18,11,7
blackrock,1038,shaman,enhancement,30,11,19
tichondrius,1019,shaman,enhancement,20,12,8
azjolnerub,1011,shaman,enhancement,30,16,14
anvilmar,1010,shaman,enhancement,39,20,19
emerald-dream,1001,shaman,enhancement,18,12,6
tichondrius,1000,shaman,enhancement,21,11,10
tichondrius,1000,shaman,enhancement,27,12,15
coilfang,995,shaman,enhancement,22,13,9
azralon,988,shaman,enhancement,17,11,6
thunderhorn,964,shaman,enhancement,23,11,12
sargeras,960,shaman,enhancement,18,10,8
barthilas,960,shaman,enhancement,18,10,8
frostwolf,960,shaman,enhancement,24,11,13
elune,959,shaman,enhancement,12,10,2
area-52,959,shaman,enhancement,18,10,8
tichondrius,958,shaman,enhancement,12,10,2
gorefiend,958,shaman,enhancement,18,10,8
azralon,958,shaman,enhancement,21,11,10
dalaran,957,shaman,enhancement,30,10,20
sargeras,955,shaman,enhancement,18,10,8
frostmourne,954,shaman,enhancement,18,10,8
emerald-dream,954,shaman,enhancement,18,10,8
daggerspine,954,shaman,enhancement,18,10,8
moon-guard,935,shaman,enhancement,23,10,13
korialstrasz,924,shaman,enhancement,20,11,9
malganis,920,shaman,enhancement,29,15,14
thrall,912,shaman,enhancement,36,18,18
hyjal,912,shaman,enhancement,42,14,28
skullcrusher,910,shaman,enhancement,32,12,20
illidan,905,shaman,enhancement,20,11,9
bonechewer,897,shaman,enhancement,30,12,18
ysera,895,shaman,enhancement,14,10,4
tichondrius,864,shaman,enhancement,12,9,3
lightbringer,864,shaman,enhancement,12,9,3
stormreaver,863,shaman,enhancement,12,9,3
icecrown,863,shaman,enhancement,18,9,9
malganis,863,shaman,enhancement,18,9,9
firetree,863,shaman,enhancement,18,9,9
cenarius,863,shaman,enhancement,19,9,10
wyrmrest-accord,859,shaman,enhancement,18,9,9
tichondrius,859,shaman,enhancement,18,9,9
proudmoore,858,shaman,enhancement,24,9,15
sargeras,851,shaman,enhancement,30,9,21
ragnaros,849,shaman,enhancement,19,12,7
barthilas,831,shaman,enhancement,17,9,8
stormrage,825,shaman,enhancement,24,10,14
area-52,800,shaman,enhancement,22,9,13
malganis,782,shaman,enhancement,13,9,4
tichondrius,781,shaman,enhancement,13,9,4
area-52,768,shaman,enhancement,12,8,4
tichondrius,768,shaman,enhancement,12,8,4
bleeding-hollow,768,shaman,enhancement,12,8,4
bleeding-hollow,768,shaman,enhancement,12,8,4
skywall,768,shaman,enhancement,12,8,4
tichondrius,768,shaman,enhancement,12,8,4
tichondrius,768,shaman,enhancement,12,8,4
barthilas,768,shaman,enhancement,12,8,4
black-dragonflight,768,shaman,enhancement,12,8,4
ragnaros,768,shaman,enhancement,12,8,4
wyrmrest-accord,768,shaman,enhancement,18,8,10
vashj,768,shaman,enhancement,18,8,10
bleeding-hollow,768,shaman,enhancement,24,8,16
blackrock,767,shaman,enhancement,12,8,4
stormrage,767,shaman,enhancement,12,8,4
sargeras,767,shaman,enhancement,12,8,4
madoran,767,shaman,enhancement,12,8,4
khadgar,767,shaman,enhancement,12,8,4
ragnaros,767,shaman,enhancement,12,8,4
bleeding-hollow,767,shaman,enhancement,18,8,10
kelthuzad,767,shaman,enhancement,18,8,10
area-52,767,shaman,enhancement,18,8,10
stormrage,766,shaman,enhancement,12,8,4
bleeding-hollow,766,shaman,enhancement,24,8,16
destromath,756,shaman,enhancement,18,8,10
dalaran,754,shaman,enhancement,12,8,4
stormscale,735,shaman,enhancement,11,8,3
sargeras,735,shaman,enhancement,14,9,5
kelthuzad,735,shaman,enhancement,17,8,9
wyrmrest-accord,719,shaman,enhancement,23,8,15
aegwynn,704,shaman,enhancement,10,8,2
area-52,704,shaman,enhancement,16,8,8
stormrage,702,shaman,enhancement,14,8,6
nazjatar,700,shaman,enhancement,14,8,6
korgath,672,shaman,enhancement,12,7,5
tichondrius,672,shaman,enhancement,12,7,5
shadowsong,672,shaman,enhancement,12,7,5
illidan,672,shaman,enhancement,12,7,5
nazjatar,672,shaman,enhancement,12,7,5
kiljaeden,672,shaman,enhancement,12,7,5
tichondrius,672,shaman,enhancement,12,7,5
sargeras,672,shaman,enhancement,12,7,5
illidan,672,shaman,enhancement,12,7,5
tichondrius,672,shaman,enhancement,12,7,5
illidan,672,shaman,enhancement,12,7,5
tichondrius,672,shaman,enhancement,12,7,5
frostwolf,672,shaman,enhancement,17,8,9
proudmoore,672,shaman,enhancement,18,7,11
area-52,672,shaman,enhancement,18,7,11
durotan,671,shaman,enhancement,12,7,5
barthilas,671,shaman,enhancement,12,7,5
emerald-dream,671,shaman,enhancement,12,7,5
shattered-halls,671,shaman,enhancement,18,7,11
azralon,671,shaman,enhancement,18,7,11
malganis,671,shaman,enhancement,18,7,11
moon-guard,671,shaman,enhancement,21,8,13
zuljin,670,shaman,enhancement,12,7,5
scilla,670,shaman,enhancement,12,7,5
kiljaeden,670,shaman,enhancement,21,8,13
hyjal,669,shaman,enhancement,12,7,5
illidan,669,shaman,enhancement,21,8,13
lightnings-blade,668,shaman,enhancement,12,7,5
thrall,665,shaman,enhancement,12,7,5
bleeding-hollow,664,shaman,enhancement,12,7,5
sargeras,657,shaman,enhancement,12,7,5
nemesis,656,shaman,enhancement,24,7,17
tichondrius,639,shaman,enhancement,17,7,10
quelthalas,637,shaman,enhancement,10,8,2
stormrage,623,shaman,enhancement,17,7,10
quelthalas,607,shaman,enhancement,20,7,13
stormrage,603,shaman,enhancement,26,8,18
moon-guard,592,shaman,enhancement,19,7,12
vashj,576,shaman,enhancement,6,6,0
malganis,576,shaman,enhancement,6,6,0
nazjatar,576,shaman,enhancement,6,6,0
zuljin,576,shaman,enhancement,6,6,0
frostmourne,576,shaman,enhancement,6,6,0
frostmourne,576,shaman,enhancement,12,6,6
quelthalas,576,shaman,enhancement,12,6,6
tichondrius,576,shaman,enhancement,12,6,6
tichondrius,576,shaman,enhancement,12,6,6
spirestone,576,shaman,enhancement,12,6,6
moon-guard,576,shaman,enhancement,12,6,6
tichondrius,576,shaman,enhancement,12,6,6
illidan,576,shaman,enhancement,12,6,6
barthilas,576,shaman,enhancement,12,6,6
frostmourne,576,shaman,enhancement,12,6,6
bleeding-hollow,576,shaman,enhancement,12,6,6
ragnaros,576,shaman,enhancement,12,6,6
tichondrius,576,shaman,enhancement,12,6,6
stormrage,576,shaman,enhancement,12,6,6
thrall,576,shaman,enhancement,14,6,8
illidan,576,shaman,enhancement,18,6,12
tichondrius,576,shaman,enhancement,18,6,12
stormrage,576,shaman,enhancement,24,6,18
ragnaros,575,shaman,enhancement,12,6,6
sargeras,575,shaman,enhancement,12,6,6
illidan,575,shaman,enhancement,16,7,9
spirestone,575,shaman,enhancement,18,6,12
area-52,575,shaman,enhancement,18,6,12
nemesis,574,shaman,enhancement,12,6,6
burning-legion,574,shaman,enhancement,12,6,6
nemesis,571,shaman,enhancement,12,6,6
moon-guard,571,shaman,enhancement,12,6,6
area-52,569,shaman,enhancement,12,6,6
moon-guard,526,shaman,enhancement,15,6,9
area-52,525,shaman,enhancement,11,6,5
arthas,522,shaman,enhancement,15,7,8
area-52,496,shaman,enhancement,19,6,13
drakkari,493,shaman,enhancement,19,6,13
akama,480,shaman,enhancement,6,5,1
deathwing,480,shaman,enhancement,6,5,1
kelthuzad,480,shaman,enhancement,6,5,1
kelthuzad,480,shaman,enhancement,6,5,1
gnomeregan,480,shaman,enhancement,6,5,1
dalaran,480,shaman,enhancement,6,5,1
tichondrius,480,shaman,enhancement,6,5,1
blades-edge,480,shaman,enhancement,6,5,1
area-52,480,shaman,enhancement,6,5,1
zuljin,480,shaman,enhancement,6,5,1
sargeras,480,shaman,enhancement,6,5,1
draktharon,480,shaman,enhancement,6,5,1
crushridge,480,shaman,enhancement,6,5,1
dragonmaw,480,shaman,enhancement,6,5,1
bleeding-hollow,480,shaman,enhancement,6,5,1
dalaran,480,shaman,enhancement,12,5,7
antonidas,480,shaman,enhancement,12,5,7
tichondrius,480,shaman,enhancement,12,5,7
tichondrius,480,shaman,enhancement,12,5,7
quelthalas,480,shaman,enhancement,12,5,7
sargeras,480,shaman,enhancement,12,5,7
madoran,480,shaman,enhancement,12,5,7
emerald-dream,480,shaman,enhancement,12,5,7
skywall,480,shaman,enhancement,12,5,7
tichondrius,480,shaman,enhancement,12,5,7
ragnaros,480,shaman,enhancement,12,5,7
area-52,480,shaman,enhancement,12,5,7
area-52,480,shaman,enhancement,12,5,7
tichondrius,480,shaman,enhancement,14,5,9
stormrage,480,shaman,enhancement,18,5,13
nagrand,479,shaman,enhancement,12,5,7
icecrown,479,shaman,enhancement,12,5,7
hellscream,479,shaman,enhancement,12,5,7
ragnaros,479,shaman,enhancement,12,5,7
warsong,478,shaman,enhancement,6,5,1
aerie-peak,478,shaman,enhancement,12,5,7
ragnaros,477,shaman,enhancement,12,5,7
aegwynn,448,shaman,enhancement,10,5,5
kiljaeden,447,shaman,enhancement,14,6,8
dragonmaw,384,shaman,enhancement,6,4,2
tichondrius,384,shaman,enhancement,6,4,2
sargeras,384,shaman,enhancement,6,4,2
kiljaeden,384,shaman,enhancement,6,4,2
ragnaros,384,shaman,enhancement,6,4,2
whisperwind,384,shaman,enhancement,6,4,2
thrall,384,shaman,enhancement,6,4,2
tichondrius,384,shaman,enhancement,6,4,2
malganis,384,shaman,enhancement,6,4,2
guldan,384,shaman,enhancement,6,4,2
magtheridon,384,shaman,enhancement,6,4,2
area-52,384,shaman,enhancement,6,4,2
korgath,384,shaman,enhancement,6,4,2
tichondrius,384,shaman,enhancement,6,4,2
barthilas,384,shaman,enhancement,6,4,2
frostmourne,384,shaman,enhancement,6,4,2
thrall,384,shaman,enhancement,6,4,2
stonemaul,384,shaman,enhancement,6,4,2
tichondrius,384,shaman,enhancement,6,4,2
area-52,384,shaman,enhancement,6,4,2
area-52,384,shaman,enhancement,6,4,2
thunderlord,384,shaman,enhancement,6,4,2
tichondrius,384,shaman,enhancement,6,4,2
frostmourne,384,shaman,enhancement,6,4,2
moon-guard,384,shaman,enhancement,6,4,2
area-52,384,shaman,enhancement,6,4,2
tichondrius,384,shaman,enhancement,6,4,2
nemesis,384,shaman,enhancement,12,4,8
dalaran,384,shaman,enhancement,12,4,8
proudmoore,384,shaman,enhancement,12,4,8
dawnbringer,384,shaman,enhancement,12,4,8
zuljin,384,shaman,enhancement,12,4,8
emerald-dream,384,shaman,enhancement,12,4,8
tichondrius,384,shaman,enhancement,12,4,8
malganis,384,shaman,enhancement,12,4,8
bleeding-hollow,383,shaman,enhancement,6,4,2
maiev,383,shaman,enhancement,12,4,8
tichondrius,382,shaman,enhancement,12,4,8
ragnaros,381,shaman,enhancement,12,4,8
vashj,351,shaman,enhancement,17,4,13
bleeding-hollow,335,shaman,enhancement,11,4,7
darkspear,330,shaman,enhancement,14,5,9
borean-tundra,319,shaman,enhancement,5,4,1
tichondrius,319,shaman,enhancement,8,4,4
tichondrius,304,shaman,enhancement,7,4,3
proudmoore,288,shaman,enhancement,6,3,3
area-52,288,shaman,enhancement,6,3,3
illidan,288,shaman,enhancement,6,3,3
illidan,288,shaman,enhancement,6,3,3
stonemaul,288,shaman,enhancement,6,3,3
stormrage,288,shaman,enhancement,6,3,3
azshara,288,shaman,enhancement,6,3,3
stormrage,288,shaman,enhancement,6,3,3
stormrage,288,shaman,enhancement,6,3,3
blackrock,288,shaman,enhancement,6,3,3
thrall,288,shaman,enhancement,6,3,3
bonechewer,288,shaman,enhancement,6,3,3
kaelthas,288,shaman,enhancement,6,3,3
zuljin,288,shaman,enhancement,6,3,3
area-52,288,shaman,enhancement,6,3,3
blood-furnace,288,shaman,enhancement,6,3,3
azralon,288,shaman,enhancement,6,3,3
garithos,288,shaman,enhancement,6,3,3
ragnaros,288,shaman,enhancement,6,3,3
tichondrius,288,shaman,enhancement,6,3,3
tichondrius,288,shaman,enhancement,6,3,3
turalyon,288,shaman,enhancement,6,3,3
illidan,288,shaman,enhancement,6,3,3
steamwheedle-cartel,288,shaman,enhancement,6,3,3
magtheridon,288,shaman,enhancement,6,3,3
laughing-skull,288,shaman,enhancement,6,3,3
emerald-dream,288,shaman,enhancement,6,3,3
malganis,288,shaman,enhancement,6,3,3
barthilas,288,shaman,enhancement,6,3,3
tichondrius,288,shaman,enhancement,6,3,3
elune,288,shaman,enhancement,6,3,3
darkspear,288,shaman,enhancement,6,3,3
madoran,288,shaman,enhancement,6,3,3
thrall,288,shaman,enhancement,6,3,3
area-52,288,shaman,enhancement,6,3,3
kelthuzad,288,shaman,enhancement,6,3,3
thrall,288,shaman,enhancement,6,3,3
malganis,288,shaman,enhancement,6,3,3
emerald-dream,288,shaman,enhancement,6,3,3
tichondrius,288,shaman,enhancement,6,3,3
saurfang,288,shaman,enhancement,6,3,3
frostmourne,288,shaman,enhancement,6,3,3
frostmourne,288,shaman,enhancement,6,3,3
quelthalas,288,shaman,enhancement,6,3,3
drakkari,288,shaman,enhancement,6,3,3
dreadmaul,288,shaman,enhancement,6,3,3
kelthuzad,288,shaman,enhancement,6,3,3
tichondrius,288,shaman,enhancement,6,3,3
thrall,288,shaman,enhancement,6,3,3
sargeras,288,shaman,enhancement,6,3,3
malganis,288,shaman,enhancement,6,3,3
moon-guard,288,shaman,enhancement,6,3,3
malorne,288,shaman,enhancement,6,3,3
frostmourne,288,shaman,enhancement,6,3,3
illidan,288,shaman,enhancement,12,3,9
tichondrius,288,shaman,enhancement,12,3,9
area-52,288,shaman,enhancement,12,3,9
stormrage,288,shaman,enhancement,12,3,9
darkspear,288,shaman,enhancement,12,3,9
tichondrius,288,shaman,enhancement,12,3,9
tichondrius,288,shaman,enhancement,12,3,9
rivendare,288,shaman,enhancement,12,3,9
moon-guard,288,shaman,enhancement,12,3,9
tichondrius,288,shaman,enhancement,12,3,9
moon-guard,288,shaman,enhancement,12,3,9
tichondrius,288,shaman,enhancement,12,3,9
saurfang,287,shaman,enhancement,6,3,3
the-scryers,287,shaman,enhancement,8,3,5
kelthuzad,255,shaman,enhancement,11,4,7
amanthul,239,shaman,enhancement,5,3,2
azralon,239,shaman,enhancement,5,3,2
ursin,239,shaman,enhancement,11,3,8
bloodscalp,234,shaman,enhancement,19,5,14
dalaran,192,shaman,enhancement,6,2,4
azralon,192,shaman,enhancement,6,2,4
nathrezim,192,shaman,enhancement,6,2,4
azralon,192,shaman,enhancement,6,2,4
garona,192,shaman,enhancement,6,2,4
tichondrius,192,shaman,enhancement,6,2,4
emerald-dream,192,shaman,enhancement,6,2,4
tichondrius,192,shaman,enhancement,6,2,4
tichondrius,192,shaman,enhancement,6,2,4
bleeding-hollow,192,shaman,enhancement,6,2,4
stormrage,192,shaman,enhancement,6,2,4
emerald-dream,192,shaman,enhancement,6,2,4
tichondrius,192,shaman,enhancement,6,2,4
frostmourne,192,shaman,enhancement,6,2,4
illidan,192,shaman,enhancement,6,2,4
frostmourne,192,shaman,enhancement,6,2,4
frostmourne,192,shaman,enhancement,6,2,4
area-52,192,shaman,enhancement,6,2,4
magtheridon,192,shaman,enhancement,6,2,4
emerald-dream,192,shaman,enhancement,6,2,4
azralon,192,shaman,enhancement,6,2,4
frostmourne,192,shaman,enhancement,6,2,4
area-52,192,shaman,enhancement,6,2,4
auchindoun,192,shaman,enhancement,6,2,4
illidan,192,shaman,enhancement,6,2,4
kelthuzad,192,shaman,enhancement,6,2,4
tichondrius,192,shaman,enhancement,6,2,4
kelthuzad,192,shaman,enhancement,6,2,4
destromath,192,shaman,enhancement,6,2,4
area-52,192,shaman,enhancement,6,2,4
nemesis,192,shaman,enhancement,6,2,4
darkspear,192,shaman,enhancement,6,2,4
tichondrius,192,shaman,enhancement,6,2,4
dark-iron,192,shaman,enhancement,6,2,4
tichondrius,192,shaman,enhancement,6,2,4
zuljin,192,shaman,enhancement,6,2,4
frostwolf,192,shaman,enhancement,6,2,4
malganis,192,shaman,enhancement,6,2,4
tichondrius,192,shaman,enhancement,6,2,4
agamaggan,192,shaman,enhancement,6,2,4
thunderhorn,192,shaman,enhancement,6,2,4
illidan,192,shaman,enhancement,6,2,4
darkspear,192,shaman,enhancement,6,2,4
tichondrius,192,shaman,enhancement,6,2,4
the-forgotten-coast,192,shaman,enhancement,6,2,4
sargeras,192,shaman,enhancement,6,2,4
eonar,192,shaman,enhancement,6,2,4
illidan,192,shaman,enhancement,6,2,4
illidan,192,shaman,enhancement,6,2,4
arthas,192,shaman,enhancement,6,2,4
nemesis,192,shaman,enhancement,6,2,4
tichondrius,192,shaman,enhancement,6,2,4
bleeding-hollow,192,shaman,enhancement,6,2,4
sargeras,192,shaman,enhancement,6,2,4
veknilash,192,shaman,enhancement,6,2,4
sargeras,192,shaman,enhancement,6,2,4
sargeras,192,shaman,enhancement,6,2,4
illidan,192,shaman,enhancement,6,2,4
sargeras,192,shaman,enhancement,6,2,4
arthas,192,shaman,enhancement,6,2,4
firetree,192,shaman,enhancement,6,2,4
quelthalas,192,shaman,enhancement,6,2,4
sargeras,192,shaman,enhancement,6,2,4
illidan,192,shaman,enhancement,12,2,10
daggerspine,191,shaman,enhancement,6,2,4
spirestone,159,shaman,enhancement,5,2,3
tichondrius,159,shaman,enhancement,5,2,3
area-52,128,shaman,enhancement,4,2,2
moon-guard,128,shaman,enhancement,4,2,2
stormrage,112,shaman,enhancement,7,2,5
kiljaeden,96,shaman,enhancement,3,2,1
sargeras,96,shaman,enhancement,6,1,5
jubeithos,96,shaman,enhancement,6,1,5
sargeras,96,shaman,enhancement,6,1,5
moon-guard,96,shaman,enhancement,6,1,5
frostmourne,96,shaman,enhancement,6,1,5
dragonmaw,96,shaman,enhancement,6,1,5
moon-guard,96,shaman,enhancement,6,1,5
area-52,96,shaman,enhancement,6,1,5
darkspear,96,shaman,enhancement,6,1,5
area-52,96,shaman,enhancement,6,1,5
stormrage,96,shaman,enhancement,6,1,5
korgath,96,shaman,enhancement,6,1,5
stormrage,96,shaman,enhancement,6,1,5
dalaran,96,shaman,enhancement,6,1,5
proudmoore,96,shaman,enhancement,6,1,5
lothar,96,shaman,enhancement,6,1,5
illidan,96,shaman,enhancement,6,1,5
gallywix,96,shaman,enhancement,6,1,5
illidan,96,shaman,enhancement,6,1,5
mugthol,96,shaman,enhancement,6,1,5
illidan,96,shaman,enhancement,6,1,5
tichondrius,96,shaman,enhancement,7,1,6
bleeding-hollow,96,shaman,enhancement,8,1,7
bonechewer,96,shaman,enhancement,12,1,11
khazgoroth,95,shaman,enhancement,6,1,5
sargeras,79,shaman,enhancement,5,1,4
illidan,42,shaman,enhancement,10,2,8
proudmoore,2345,warlock,demonology,113,66,47
aerie-peak,2190,warlock,demonology,78,45,33
tichondrius,2156,warlock,demonology,85,45,40
tichondrius,2149,warlock,demonology,99,53,46
tichondrius,2143,warlock,demonology,66,37,29
tichondrius,2128,warlock,demonology,89,47,42
tichondrius,2114,warlock,demonology,96,50,46
azralon,2111,warlock,demonology,140,78,62
azshara,2110,warlock,demonology,66,38,28
illidan,2110,warlock,demonology,112,58,54
area-52,2050,warlock,demonology,129,70,59
tichondrius,2041,warlock,demonology,72,40,32
stormrage,2037,warlock,demonology,105,61,44
tichondrius,2015,warlock,demonology,80,42,38
tichondrius,2012,warlock,demonology,55,33,22
sargeras,2008,warlock,demonology,71,37,34
emerald-dream,2008,warlock,demonology,66,34,32
anetheron,2004,warlock,demonology,79,39,40
sargeras,1992,warlock,demonology,109,54,55
blackwing-lair,1978,warlock,demonology,78,53,25
nerzhul,1968,warlock,demonology,107,54,53
azralon,1949,warlock,demonology,72,35,37
tichondrius,1947,warlock,demonology,29,21,8
dalaran,1947,warlock,demonology,66,47,19
maiev,1935,warlock,demonology,90,45,45
tichondrius,1934,warlock,demonology,38,25,13
sargeras,1933,warlock,demonology,59,31,28
korgath,1922,warlock,demonology,36,29,7
tichondrius,1909,warlock,demonology,36,20,16
malganis,1900,warlock,demonology,47,27,20
darkspear,1900,warlock,demonology,53,27,26
malganis,1899,warlock,demonology,42,26,16
stormscale,1899,warlock,demonology,81,41,40
tichondrius,1896,warlock,demonology,30,20,10
warsong,1895,warlock,demonology,57,30,27
chogall,1893,warlock,demonology,59,28,31
tichondrius,1876,warlock,demonology,48,28,20
tichondrius,1871,warlock,demonology,35,22,13
ragnaros,1849,warlock,demonology,53,30,23
ragnaros,1848,warlock,demonology,46,25,21
area-52,1846,warlock,demonology,60,33,27
ragnaros,1833,warlock,demonology,135,72,63
illidan,1829,warlock,demonology,48,29,19
tichondrius,1829,warlock,demonology,48,26,22
lightnings-blade,1829,warlock,demonology,58,31,27
tichondrius,1827,warlock,demonology,72,36,36
moon-guard,1827,warlock,demonology,60,29,31
sargeras,1826,warlock,demonology,58,31,27
moon-guard,1826,warlock,demonology,142,71,71
barthilas,1825,warlock,demonology,48,27,21
stormreaver,1825,warlock,demonology,82,41,41
moon-guard,1817,warlock,demonology,75,34,41
tichondrius,1815,warlock,demonology,36,22,14
moon-guard,1811,warlock,demonology,30,22,8
alleria,1811,warlock,demonology,30,19,11
sargeras,1811,warlock,demonology,32,20,12
tichondrius,1811,warlock,demonology,36,22,14
the-venture-co,1810,warlock,demonology,54,33,21
area-52,1810,warlock,demonology,60,30,30
malganis,1807,warlock,demonology,40,25,15
ragnaros,1804,warlock,demonology,80,47,33
tichondrius,1803,warlock,demonology,30,19,11
malganis,1803,warlock,demonology,54,29,25
malganis,1802,warlock,demonology,48,25,23
azralon,1801,warlock,demonology,60,28,32
tichondrius,1795,warlock,demonology,30,19,11
tichondrius,1793,warlock,demonology,48,28,20
ragnaros,1791,warlock,demonology,36,19,17
emerald-dream,1766,warlock,demonology,126,68,58
tichondrius,1764,warlock,demonology,46,26,20
area-52,1763,warlock,demonology,87,57,30
tichondrius,1760,warlock,demonology,35,21,14
kelthuzad,1760,warlock,demonology,60,34,26
whisperwind,1747,warlock,demonology,42,23,19
illidan,1740,warlock,demonology,48,26,22
tichondrius,1737,warlock,demonology,35,20,15
malganis,1737,warlock,demonology,78,39,39
dalaran,1729,warlock,demonology,40,25,15
tichondrius,1727,warlock,demonology,106,52,54
destromath,1726,warlock,demonology,24,18,6
sentinels,1725,warlock,demonology,46,26,20
area-52,1724,warlock,demonology,30,18,12
cairne,1724,warlock,demonology,30,18,12
area-52,1721,warlock,demonology,30,18,12
bleeding-hollow,1719,warlock,demonology,48,24,24
area-52,1717,warlock,demonology,30,18,12
area-52,1716,warlock,demonology,42,32,10
tichondrius,1715,warlock,demonology,42,25,17
tichondrius,1700,warlock,demonology,54,24,30
sargeras,1698,warlock,demonology,36,20,16
stormrage,1696,warlock,demonology,30,20,10
tichondrius,1695,warlock,demonology,40,24,16
tichondrius,1692,warlock,demonology,36,20,16
zuljin,1690,warlock,demonology,30,18,12
area-52,1690,warlock,demonology,60,34,26
tichondrius,1689,warlock,demonology,24,18,6
area-52,1688,warlock,demonology,30,18,12
tichondrius,1687,warlock,demonology,48,23,25
moon-guard,1686,warlock,demonology,41,24,17
zuljin,1685,warlock,demonology,30,19,11
stormrage,1685,warlock,demonology,53,21,32
tichondrius,1682,warlock,demonology,128,78,50
stormrage,1680,warlock,demonology,60,29,31
zuljin,1679,warlock,demonology,73,35,38
tichondrius,1677,warlock,demonology,30,19,11
chromaggus,1673,warlock,demonology,130,67,63
tichondrius,1673,warlock,demonology,35,18,17
moon-guard,1671,warlock,demonology,33,20,13
tichondrius,1668,warlock,demonology,35,19,16
aggramar,1665,warlock,demonology,78,38,40
tichondrius,1663,warlock,demonology,35,22,13
bonechewer,1658,warlock,demonology,30,18,12
lightbringer,1656,warlock,demonology,78,43,35
ragnaros,1655,warlock,demonology,41,22,19
ursin,1655,warlock,demonology,42,22,20
tichondrius,1650,warlock,demonology,30,20,10
quelthalas,1649,warlock,demonology,36,20,16
stormrage,1646,warlock,demonology,48,25,23
illidan,1645,warlock,demonology,42,28,14
frostmourne,1644,warlock,demonology,48,29,19
wyrmrest-accord,1644,warlock,demonology,52,25,27
darrowmere,1638,warlock,demonology,89,49,40
tichondrius,1637,warlock,demonology,42,24,18
thunderhorn,1633,warlock,demonology,101,47,54
azralon,1630,warlock,demonology,75,47,28
illidan,1630,warlock,demonology,70,37,33
sargeras,1627,warlock,demonology,36,21,15
ragnaros,1626,warlock,demonology,30,21,9
nerzhul,1624,warlock,demonology,36,21,15
illidan,1621,warlock,demonology,36,20,16
nesingwary,1619,warlock,demonology,30,17,13
moon-guard,1619,warlock,demonology,41,20,21
lightninghoof,1618,warlock,demonology,30,20,10
tichondrius,1618,warlock,demonology,83,39,44
ursin,1615,warlock,demonology,33,21,12
zuljin,1615,warlock,demonology,42,20,22
ragnaros,1615,warlock,demonology,36,17,19
kelthuzad,1614,warlock,demonology,30,17,13
ragnaros,1613,warlock,demonology,115,66,49
thrall,1613,warlock,demonology,36,17,19
tichondrius,1610,warlock,demonology,39,21,18
bonechewer,1609,warlock,demonology,31,18,13
quelthalas,1607,warlock,demonology,36,24,12
azralon,1607,warlock,demonology,42,20,22
tichondrius,1605,warlock,demonology,30,20,10
malganis,1594,warlock,demonology,36,19,17
draenor,1592,warlock,demonology,30,19,11
tichondrius,1591,warlock,demonology,67,36,31
zuljin,1588,warlock,demonology,48,30,18
stormrage,1582,warlock,demonology,30,18,12
bleeding-hollow,1576,warlock,demonology,35,24,11
moon-guard,1560,warlock,demonology,87,43,44
bleeding-hollow,1549,warlock,demonology,56,27,29
daggerspine,1546,warlock,demonology,54,32,22
area-52,1541,warlock,demonology,36,21,15
nordrassil,1534,warlock,demonology,42,23,19
barthilas,1534,warlock,demonology,30,16,14
tichondrius,1534,warlock,demonology,30,16,14
tichondrius,1531,warlock,demonology,18,16,2
tichondrius,1523,warlock,demonology,30,16,14
dark-iron,1520,warlock,demonology,52,25,27
drakkari,1515,warlock,demonology,24,16,8
frostmourne,1514,warlock,demonology,38,19,19
stormrage,1512,warlock,demonology,62,29,33
aggramar,1510,warlock,demonology,30,16,14
bleeding-hollow,1509,warlock,demonology,30,18,12
tichondrius,1505,warlock,demonology,30,18,12
tichondrius,1502,warlock,demonology,112,56,56
tichondrius,1501,warlock,demonology,24,16,8
area-52,1500,warlock,demonology,35,16,19
illidan,1496,warlock,demonology,133,66,67
dalaran,1491,warlock,demonology,90,48,42
illidan,1489,warlock,demonology,48,24,24
sargeras,1452,warlock,demonology,34,24,10
dalaran,1451,warlock,demonology,25,16,9
frostmourne,1439,warlock,demonology,24,15,9
illidan,1439,warlock,demonology,24,15,9
dawnbringer,1438,warlock,demonology,70,33,37
mugthol,1437,warlock,demonology,24,15,9
stormrage,1437,warlock,demonology,30,15,15
tichondrius,1436,warlock,demonology,30,15,15
moon-guard,1432,warlock,demonology,36,22,14
tichondrius,1431,warlock,demonology,55,27,28
moon-guard,1430,warlock,demonology,80,36,44
tichondrius,1425,warlock,demonology,24,15,9
akama,1422,warlock,demonology,42,26,16
tichondrius,1414,warlock,demonology,19,15,4
moon-guard,1405,warlock,demonology,30,16,14
crushridge,1403,warlock,demonology,59,31,28
tichondrius,1392,warlock,demonology,24,15,9
tichondrius,1371,warlock,demonology,70,42,28
area-52,1344,warlock,demonology,24,14,10
tichondrius,1343,warlock,demonology,18,14,4
tichondrius,1343,warlock,demonology,24,14,10
tichondrius,1343,warlock,demonology,24,14,10
moon-guard,1343,warlock,demonology,24,14,10
tichondrius,1343,warlock,demonology,24,14,10
stormscale,1343,warlock,demonology,27,15,12
tichondrius,1343,warlock,demonology,30,14,16
tichondrius,1341,warlock,demonology,36,14,22
tichondrius,1340,warlock,demonology,30,14,16
malganis,1339,warlock,demonology,18,14,4
thrall,1336,warlock,demonology,36,15,21
zuljin,1335,warlock,demonology,57,31,26
chogall,1328,warlock,demonology,36,18,18
kelthuzad,1325,warlock,demonology,27,15,12
area-52,1323,warlock,demonology,28,15,13
tichondrius,1310,warlock,demonology,23,14,9
frostmourne,1306,warlock,demonology,29,15,14
sargeras,1302,warlock,demonology,68,26,42
skullcrusher,1299,warlock,demonology,85,45,40
illidan,1281,warlock,demonology,70,39,31
illidan,1279,warlock,demonology,50,29,21
illidan,1279,warlock,demonology,30,14,16
sargeras,1279,warlock,demonology,53,24,29
sargeras,1248,warlock,demonology,18,13,5
illidan,1248,warlock,demonology,18,13,5
tichondrius,1248,warlock,demonology,18,13,5
tichondrius,1248,warlock,demonology,24,13,11
tichondrius,1248,warlock,demonology,24,13,11
zuljin,1248,warlock,demonology,24,13,11
arthas,1243,warlock,demonology,24,13,11
kiljaeden,1241,warlock,demonology,30,13,17
malganis,1210,warlock,demonology,18,13,5
jubeithos,1203,warlock,demonology,24,13,11
area-52,1180,warlock,demonology,17,13,4
nordrassil,1174,warlock,demonology,30,20,10
tichondrius,1152,warlock,demonology,24,12,12
malganis,1150,warlock,demonology,18,12,6
chogall,1150,warlock,demonology,18,12,6
tichondrius,1150,warlock,demonology,18,12,6
zuljin,1150,warlock,demonology,18,12,6
wyrmrest-accord,1150,warlock,demonology,24,13,11
tichondrius,1149,warlock,demonology,18,12,6
mannoroth,1149,warlock,demonology,24,12,12
thrall,1148,warlock,demonology,18,12,6
illidan,1148,warlock,demonology,24,12,12
windrunner,1146,warlock,demonology,25,13,12
proudmoore,1146,warlock,demonology,24,12,12
area-52,1144,warlock,demonology,18,12,6
area-52,1144,warlock,demonology,30,12,18
illidan,1141,warlock,demonology,24,12,12
sargeras,1117,warlock,demonology,36,16,20
sargeras,1101,warlock,demonology,60,25,35
malganis,1093,warlock,demonology,36,15,21
lightnings-blade,1084,warlock,demonology,23,12,11
demon-soul,1068,warlock,demonology,13,12,1
tichondrius,1056,warlock,demonology,12,11,1
tichondrius,1056,warlock,demonology,18,11,7
zuljin,1056,warlock,demonology,18,11,7
tichondrius,1056,warlock,demonology,24,11,13
area-52,1056,warlock,demonology,24,11,13
illidan,1056,warlock,demonology,27,12,15
tichondrius,1055,warlock,demonology,24,11,13
kelthuzad,1055,warlock,demonology,24,11,13
sargeras,1055,warlock,demonology,24,11,13
tichondrius,1055,warlock,demonology,24,11,13
proudmoore,1054,warlock,demonology,12,11,1
tanaris,1050,warlock,demonology,18,11,7
arthas,1050,warlock,demonology,24,11,13
quelthalas,1049,warlock,demonology,22,12,10
moon-guard,1049,warlock,demonology,54,25,29
ragnaros,1037,warlock,demonology,30,11,19
frostmourne,1006,warlock,demonology,23,11,12
tichondrius,960,warlock,demonology,12,10,2
sargeras,960,warlock,demonology,18,10,8
stormrage,960,warlock,demonology,18,10,8
tichondrius,960,warlock,demonology,18,10,8
jubeithos,960,warlock,demonology,18,10,8
tichondrius,960,warlock,demonology,18,10,8
tichondrius,960,warlock,demonology,18,10,8
emerald-dream,960,warlock,demonology,24,10,14
ragnaros,959,warlock,demonology,12,10,2
gallywix,958,warlock,demonology,12,10,2
moon-guard,957,warlock,demonology,18,10,8
illidan,955,warlock,demonology,24,10,14
azralon,954,warlock,demonology,18,10,8
emerald-dream,953,warlock,demonology,24,10,14
ravencrest,894,warlock,demonology,17,10,7
area-52,864,warlock,demonology,12,9,3
illidan,864,warlock,demonology,12,9,3
zuljin,864,warlock,demonology,12,9,3
tichondrius,864,warlock,demonology,12,9,3
proudmoore,864,warlock,demonology,18,9,9
zuljin,864,warlock,demonology,18,9,9
ragnaros,864,warlock,demonology,19,9,10
tichondrius,864,warlock,demonology,23,9,14
ragnaros,863,warlock,demonology,12,9,3
agamaggan,863,warlock,demonology,12,9,3
tichondrius,863,warlock,demonology,12,9,3
arthas,863,warlock,demonology,18,9,9
area-52,863,warlock,demonology,18,9,9
proudmoore,863,warlock,demonology,18,9,9
stormrage,863,warlock,demonology,18,9,9
tichondrius,862,warlock,demonology,12,9,3
sargeras,862,warlock,demonology,12,9,3
bleeding-hollow,862,warlock,demonology,12,9,3
azralon,862,warlock,demonology,24,9,15
mugthol,859,warlock,demonology,18,9,9
kiljaeden,816,warlock,demonology,21,9,12
stormrage,815,warlock,demonology,11,9,2
arthas,797,warlock,demonology,17,9,8
illidan,794,warlock,demonology,19,10,9
kelthuzad,783,warlock,demonology,11,9,2
sargeras,781,warlock,demonology,19,9,10
earthen-ring,768,warlock,demonology,12,8,4
tichondrius,768,warlock,demonology,12,8,4
kelthuzad,768,warlock,demonology,12,8,4
sargeras,768,warlock,demonology,12,8,4
chogall,768,warlock,demonology,12,8,4
tichondrius,768,warlock,demonology,12,8,4
zuljin,768,warlock,demonology,12,8,4
blades-edge,768,warlock,demonology,12,8,4
tichondrius,768,warlock,demonology,12,8,4
tichondrius,768,warlock,demonology,12,8,4
illidan,768,warlock,demonology,12,8,4
shadowmoon,768,warlock,demonology,12,8,4
skywall,768,warlock,demonology,12,8,4
area-52,768,warlock,demonology,12,8,4
draktharon,768,warlock,demonology,18,8,10
queldorei,768,warlock,demonology,18,8,10
mannoroth,768,warlock,demonology,18,8,10
tichondrius,768,warlock,demonology,18,8,10
trollbane,768,warlock,demonology,18,8,10
dalaran,768,warlock,demonology,30,8,22
tichondrius,767,warlock,demonology,12,8,4
stormrage,767,warlock,demonology,12,8,4
tichondrius,767,warlock,demonology,12,8,4
thrall,767,warlock,demonology,12,8,4
azjolnerub,767,warlock,demonology,18,8,10
kelthuzad,764,warlock,demonology,18,8,10
quelthalas,764,warlock,demonology,24,8,16
area-52,735,warlock,demonology,17,8,9
kelthuzad,714,warlock,demonology,20,9,11
frostmourne,703,warlock,demonology,14,8,6
mannoroth,703,warlock,demonology,17,8,9
boulderfist,702,warlock,demonology,11,8,3
tichondrius,672,warlock,demonology,12,7,5
zuljin,672,warlock,demonology,12,7,5
stormrage,672,warlock,demonology,12,7,5
quelthalas,672,warlock,demonology,12,7,5
barthilas,672,warlock,demonology,12,7,5
kelthuzad,672,warlock,demonology,12,7,5
agamaggan,672,warlock,demonology,12,7,5
barthilas,672,warlock,demonology,12,7,5
nemesis,672,warlock,demonology,12,7,5
azralon,672,warlock,demonology,12,7,5
tichondrius,672,warlock,demonology,12,7,5
blackhand,672,warlock,demonology,12,7,5
tichondrius,672,warlock,demonology,12,7,5
ursin,672,warlock,demonology,12,7,5
tichondrius,672,warlock,demonology,12,7,5
nemesis,672,warlock,demonology,12,7,5
proudmoore,672,warlock,demonology,18,7,11
dalaran,672,warlock,demonology,18,7,11
gorefiend,672,warlock,demonology,18,7,11
spirestone,671,warlock,demonology,12,7,5
kiljaeden,671,warlock,demonology,12,7,5
stormrage,671,warlock,demonology,12,7,5
malganis,671,warlock,demonology,12,7,5
area-52,671,warlock,demonology,12,7,5
crushridge,671,warlock,demonology,18,7,11
amanthul,671,warlock,demonology,18,7,11
sargeras,670,warlock,demonology,12,7,5
tichondrius,654,warlock,demonology,17,7,10
tichondrius,618,warlock,demonology,14,8,6
malganis,616,warlock,demonology,22,9,13
nordrassil,576,warlock,demonology,6,6,0
sargeras,576,warlock,demonology,6,6,0
stormrage,576,warlock,demonology,6,6,0
quelthalas,576,warlock,demonology,6,6,0
tichondrius,576,warlock,demonology,12,6,6
illidan,576,warlock,demonology,12,6,6
gallywix,576,warlock,demonology,12,6,6
ragnaros,576,warlock,demonology,12,6,6
azralon,576,warlock,demonology,12,6,6
fizzcrank,576,warlock,demonology,12,6,6
kelthuzad,576,warlock,demonology,12,6,6
nathrezim,576,warlock,demonology,12,6,6
tichondrius,576,warlock,demonology,12,6,6
proudmoore,576,warlock,demonology,12,6,6
malygos,576,warlock,demonology,12,6,6
malganis,576,warlock,demonology,12,6,6
nemesis,576,warlock,demonology,12,6,6
illidan,576,warlock,demonology,12,6,6
stormrage,576,warlock,demonology,12,6,6
quelthalas,576,warlock,demonology,15,7,8
tichondrius,576,warlock,demonology,15,7,8
frostmourne,576,warlock,demonology,18,6,12
emerald-dream,575,warlock,demonology,12,6,6
detheroc,575,warlock,demonology,12,6,6
moon-guard,575,warlock,demonology,12,6,6
stormrage,575,warlock,demonology,12,6,6
anvilmar,575,warlock,demonology,12,6,6
frostmourne,574,warlock,demonology,24,6,18
sargeras,543,warlock,demonology,11,6,5
stormrage,543,warlock,demonology,12,6,6
bleeding-hollow,528,warlock,demonology,9,7,2
stormrage,528,warlock,demonology,15,6,9
tichondrius,480,warlock,demonology,6,5,1
tichondrius,480,warlock,demonology,6,5,1
altar-of-storms,480,warlock,demonology,6,5,1
area-52,480,warlock,demonology,6,5,1
thrall,480,warlock,demonology,6,5,1
frostmourne,480,warlock,demonology,6,5,1
illidan,480,warlock,demonology,6,5,1
tichondrius,480,warlock,demonology,6,5,1
ragnaros,480,warlock,demonology,6,5,1
mannoroth,480,warlock,demonology,6,5,1
thrall,480,warlock,demonology,6,5,1
tichondrius,480,warlock,demonology,6,5,1
sargeras,480,warlock,demonology,7,5,2
ragnaros,480,warlock,demonology,12,5,7
tichondrius,480,warlock,demonology,12,5,7
tichondrius,480,warlock,demonology,12,5,7
ragnaros,480,warlock,demonology,12,5,7
silvermoon,480,warlock,demonology,12,5,7
kelthuzad,480,warlock,demonology,12,5,7
tichondrius,480,warlock,demonology,12,5,7
akama,480,warlock,demonology,12,5,7
barthilas,480,warlock,demonology,12,5,7
sargeras,480,warlock,demonology,12,5,7
azralon,480,warlock,demonology,12,5,7
dalaran,480,warlock,demonology,12,5,7
veknilash,480,warlock,demonology,12,5,7
emerald-dream,480,warlock,demonology,12,5,7
tichondrius,480,warlock,demonology,12,5,7
moon-guard,480,warlock,demonology,12,5,7
tichondrius,480,warlock,demonology,19,5,14
illidan,479,warlock,demonology,12,5,7
azuremyst,479,warlock,demonology,12,5,7
quelthalas,479,warlock,demonology,18,5,13
spirestone,448,warlock,demonology,10,6,4
zuljin,426,warlock,demonology,17,6,11
tichondrius,400,warlock,demonology,13,5,8
stormrage,398,warlock,demonology,10,5,5
tichondrius,384,warlock,demonology,6,4,2
azralon,384,warlock,demonology,6,4,2
tichondrius,384,warlock,demonology,6,4,2
zuljin,384,warlock,demonology,6,4,2
azralon,384,warlock,demonology,6,4,2
ragnaros,384,warlock,demonology,6,4,2
aegwynn,384,warlock,demonology,6,4,2
area-52,384,warlock,demonology,6,4,2
sargeras,384,warlock,demonology,6,4,2
azralon,384,warlock,demonology,6,4,2
tichondrius,384,warlock,demonology,6,4,2
jubeithos,384,warlock,demonology,6,4,2
blackrock,384,warlock,demonology,6,4,2
kelthuzad,384,warlock,demonology,6,4,2
nemesis,384,warlock,demonology,6,4,2
sargeras,384,warlock,demonology,6,4,2
emerald-dream,384,warlock,demonology,6,4,2
illidan,384,warlock,demonology,6,4,2
frostmourne,384,warlock,demonology,6,4,2
tichondrius,384,warlock,demonology,6,4,2
malganis,384,warlock,demonology,6,4,2
cenarion-circle,384,warlock,demonology,6,4,2
malganis,384,warlock,demonology,6,4,2
tichondrius,384,warlock,demonology,6,4,2
stormrage,384,warlock,demonology,6,4,2
madoran,384,warlock,demonology,6,4,2
quelthalas,384,warlock,demonology,6,4,2
barthilas,384,warlock,demonology,6,4,2
stormrage,384,warlock,demonology,6,4,2
tichondrius,384,warlock,demonology,6,4,2
barthilas,384,warlock,demonology,6,4,2
zuljin,384,warlock,demonology,6,4,2
sargeras,384,warlock,demonology,7,4,3
area-52,384,warlock,demonology,9,5,4
ragnaros,384,warlock,demonology,9,5,4
quelthalas,384,warlock,demonology,12,4,8
moon-guard,384,warlock,demonology,12,4,8
tichondrius,384,warlock,demonology,12,4,8
barthilas,384,warlock,demonology,12,4,8
blackrock,384,warlock,demonology,12,4,8
dalaran,384,warlock,demonology,12,4,8
jubeithos,384,warlock,demonology,12,4,8
dalaran,384,warlock,demonology,12,4,8
sargeras,384,warlock,demonology,12,4,8
shadowsong,384,warlock,demonology,12,4,8
stormrage,384,warlock,demonology,12,4,8
tichondrius,384,warlock,demonology,12,4,8
tichondrius,384,warlock,demonology,12,4,8
laughing-skull,384,warlock,demonology,14,4,10
tichondrius,384,warlock,demonology,18,4,14
korgath,384,warlock,demonology,24,4,20
azuremyst,363,warlock,demonology,11,4,7
barthilas,351,warlock,demonology,11,4,7
frostmourne,319,warlock,demonology,5,4,1
blood-furnace,288,warlock,demonology,6,3,3
illidan,288,warlock,demonology,6,3,3
area-52,288,warlock,demonology,6,3,3
stormrage,288,warlock,demonology,6,3,3
quelthalas,288,warlock,demonology,6,3,3
illidan,288,warlock,demonology,6,3,3
mannoroth,288,warlock,demonology,6,3,3
bleeding-hollow,288,warlock,demonology,6,3,3
malganis,288,warlock,demonology,6,3,3
malganis,288,warlock,demonology,6,3,3
malganis,288,warlock,demonology,6,3,3
kelthuzad,288,warlock,demonology,6,3,3
area-52,288,warlock,demonology,6,3,3
area-52,288,warlock,demonology,6,3,3
aerie-peak,288,warlock,demonology,6,3,3
tichondrius,288,warlock,demonology,6,3,3
blackrock,288,warlock,demonology,6,3,3
proudmoore,288,warlock,demonology,6,3,3
bleeding-hollow,288,warlock,demonology,6,3,3
malorne,288,warlock,demonology,6,3,3
malorne,288,warlock,demonology,6,3,3
sargeras,288,warlock,demonology,6,3,3
gilneas,288,warlock,demonology,6,3,3
azralon,288,warlock,demonology,6,3,3
frostmourne,288,warlock,demonology,6,3,3
hyjal,288,warlock,demonology,6,3,3
frostmourne,288,warlock,demonology,6,3,3
sargeras,288,warlock,demonology,6,3,3
hyjal,288,warlock,demonology,6,3,3
arthas,288,warlock,demonology,6,3,3
tichondrius,288,warlock,demonology,6,3,3
sargeras,288,warlock,demonology,6,3,3
bonechewer,288,warlock,demonology,6,3,3
tichondrius,288,warlock,demonology,6,3,3
wyrmrest-accord,288,warlock,demonology,6,3,3
kiljaeden,288,warlock,demonology,6,3,3
tichondrius,288,warlock,demonology,6,3,3
frostwolf,288,warlock,demonology,6,3,3
deathwing,288,warlock,demonology,6,3,3
tichondrius,288,warlock,demonology,6,3,3
sargeras,288,warlock,demonology,6,3,3
tichondrius,288,warlock,demonology,6,3,3
tichondrius,288,warlock,demonology,6,3,3
tichondrius,288,warlock,demonology,6,3,3
wyrmrest-accord,288,warlock,demonology,10,4,6
moon-guard,288,warlock,demonology,8,3,5
azuremyst,288,warlock,demonology,12,3,9
shuhalo,288,warlock,demonology,12,3,9
kelthuzad,288,warlock,demonology,12,3,9
frostmourne,288,warlock,demonology,12,3,9
drakthul,288,warlock,demonology,12,3,9
sargeras,287,warlock,demonology,12,3,9
area-52,255,warlock,demonology,11,3,8
bleeding-hollow,239,warlock,demonology,5,3,2
rivendare,239,warlock,demonology,5,3,2
sargeras,239,warlock,demonology,5,3,2
tichondrius,239,warlock,demonology,5,3,2
emerald-dream,192,warlock,demonology,9,3,6
mannoroth,192,warlock,demonology,6,2,4
exodar,192,warlock,demonology,6,2,4
tichondrius,192,warlock,demonology,6,2,4
emerald-dream,192,warlock,demonology,6,2,4
tichondrius,192,warlock,demonology,6,2,4
emerald-dream,192,warlock,demonology,6,2,4
onyxia,192,warlock,demonology,6,2,4
stormrage,192,warlock,demonology,6,2,4
stormrage,192,warlock,demonology,6,2,4
emerald-dream,192,warlock,demonology,6,2,4
tichondrius,192,warlock,demonology,6,2,4
earthen-ring,192,warlock,demonology,6,2,4
tichondrius,192,warlock,demonology,6,2,4
illidan,192,warlock,demonology,6,2,4
area-52,192,warlock,demonology,6,2,4
spirestone,192,warlock,demonology,6,2,4
burning-legion,192,warlock,demonology,6,2,4
area-52,192,warlock,demonology,6,2,4
stormrage,192,warlock,demonology,6,2,4
tichondrius,192,warlock,demonology,6,2,4
frostmourne,192,warlock,demonology,6,2,4
proudmoore,192,warlock,demonology,6,2,4
kelthuzad,192,warlock,demonology,6,2,4
frostmourne,192,warlock,demonology,6,2,4
illidan,192,warlock,demonology,6,2,4
tichondrius,192,warlock,demonology,6,2,4
area-52,192,warlock,demonology,6,2,4
illidan,192,warlock,demonology,6,2,4
tichondrius,192,warlock,demonology,6,2,4
sargeras,192,warlock,demonology,6,2,4
sargeras,192,warlock,demonology,6,2,4
crushridge,192,warlock,demonology,6,2,4
firetree,192,warlock,demonology,6,2,4
area-52,192,warlock,demonology,6,2,4
nagrand,192,warlock,demonology,6,2,4
sargeras,192,warlock,demonology,6,2,4
bleeding-hollow,192,warlock,demonology,6,2,4
stormrage,192,warlock,demonology,6,2,4
runetotem,192,warlock,demonology,6,2,4
tichondrius,192,warlock,demonology,6,2,4
malganis,192,warlock,demonology,6,2,4
drakkari,192,warlock,demonology,12,2,10
coilfang,159,warlock,demonology,5,2,3
daggerspine,158,warlock,demonology,14,3,11
magtheridon,128,warlock,demonology,4,2,2
blackrock,128,warlock,demonology,10,2,8
malganis,96,warlock,demonology,6,1,5
sargeras,96,warlock,demonology,6,1,5
frostmane,96,warlock,demonology,6,1,5
kargath,96,warlock,demonology,6,1,5
ragnaros,96,warlock,demonology,6,1,5
barthilas,96,warlock,demonology,6,1,5
shattered-hand,96,warlock,demonology,6,1,5
kiljaeden,96,warlock,demonology,6,1,5
darkspear,96,warlock,demonology,6,1,5
stormrage,96,warlock,demonology,6,1,5
kelthuzad,96,warlock,demonology,6,1,5
moon-guard,96,warlock,demonology,6,1,5
illidan,96,warlock,demonology,6,1,5
tichondrius,96,warlock,demonology,6,1,5
frostmourne,96,warlock,demonology,6,1,5
moon-guard,96,warlock,demonology,6,1,5
moon-guard,96,warlock,demonology,6,1,5
bleeding-hollow,96,warlock,demonology,6,1,5
frostmourne,96,warlock,demonology,6,1,5
illidan,96,warlock,demonology,6,1,5
khazgoroth,96,warlock,demonology,6,1,5
stormscale,96,warlock,demonology,6,1,5
bleeding-hollow,96,warlock,demonology,6,1,5
bleeding-hollow,96,warlock,demonology,6,1,5
azralon,96,warlock,demonology,6,1,5
illidan,96,warlock,demonology,6,1,5
ragnaros,96,warlock,demonology,6,1,5
azralon,96,warlock,demonology,7,1,6
azralon,96,warlock,demonology,15,1,14
zuljin,48,warlock,demonology,3,1,2
tichondrius,2283,warlock,destruction,101,64,37
bleeding-hollow,2161,warlock,destruction,66,42,24
whisperwind,2156,warlock,destruction,114,59,55
tichondrius,2154,warlock,destruction,66,41,25
area-52,2154,warlock,destruction,78,45,33
nemesis,2142,warlock,destruction,78,51,27
bleeding-hollow,2142,warlock,destruction,60,39,21
thrall,2136,warlock,destruction,84,44,40
tichondrius,2132,warlock,destruction,91,49,42
illidan,2130,warlock,destruction,65,42,23
tichondrius,2129,warlock,destruction,54,31,23
guldan,2125,warlock,destruction,90,51,39
tichondrius,2123,warlock,destruction,91,47,44
tichondrius,2121,warlock,destruction,73,43,30
malganis,2120,warlock,destruction,59,37,22
tichondrius,2116,warlock,destruction,66,44,22
bleeding-hollow,2114,warlock,destruction,79,50,29
stormrage,2113,warlock,destruction,81,47,34
tichondrius,2107,warlock,destruction,66,41,25
azralon,2106,warlock,destruction,61,38,23
tichondrius,2106,warlock,destruction,72,41,31
illidan,2106,warlock,destruction,85,42,43
hyjal,2104,warlock,destruction,59,41,18
tichondrius,2103,warlock,destruction,112,62,50
tichondrius,2103,warlock,destruction,72,39,33
thrall,2102,warlock,destruction,69,45,24
tichondrius,2101,warlock,destruction,36,29,7
tichondrius,2101,warlock,destruction,142,73,69
bleeding-hollow,2080,warlock,destruction,66,37,29
burning-legion,2073,warlock,destruction,53,36,17
demon-soul,2071,warlock,destruction,54,37,17
sargeras,2067,warlock,destruction,81,42,39
frostmourne,2064,warlock,destruction,60,36,24
amanthul,2054,warlock,destruction,118,66,52
frostmourne,2051,warlock,destruction,54,28,26
tichondrius,2049,warlock,destruction,72,42,30
malganis,2044,warlock,destruction,72,42,30
tichondrius,2043,warlock,destruction,48,33,15
darkspear,2041,warlock,destruction,58,36,22
wyrmrest-accord,2038,warlock,destruction,53,35,18
tichondrius,2036,warlock,destruction,66,36,30
tichondrius,2034,warlock,destruction,42,32,10
stormrage,2031,warlock,destruction,116,73,43
tichondrius,2028,warlock,destruction,71,42,29
ragnaros,2026,warlock,destruction,90,47,43
illidan,2026,warlock,destruction,66,34,32
illidan,2021,warlock,destruction,54,32,22
tichondrius,2016,warlock,destruction,66,38,28
suramar,2015,warlock,destruction,65,36,29
tichondrius,2014,warlock,destruction,89,50,39
stormrage,2013,warlock,destruction,110,56,54
magtheridon,2010,warlock,destruction,117,68,49
tichondrius,2006,warlock,destruction,84,55,29
kelthuzad,2001,warlock,destruction,59,37,22
stormrage,1998,warlock,destruction,84,52,32
proudmoore,1993,warlock,destruction,41,24,17
blackrock,1992,warlock,destruction,77,45,32
tichondrius,1990,warlock,destruction,83,45,38
tichondrius,1986,warlock,destruction,36,30,6
tichondrius,1981,warlock,destruction,60,40,20
tichondrius,1980,warlock,destruction,61,40,21
kirin-tor,1978,warlock,destruction,54,33,21
tichondrius,1975,warlock,destruction,36,29,7
zuljin,1973,warlock,destruction,67,35,32
illidan,1972,warlock,destruction,95,51,44
sargeras,1972,warlock,destruction,109,55,54
khaz-modan,1970,warlock,destruction,66,39,27
bleeding-hollow,1965,warlock,destruction,54,31,23
moon-guard,1965,warlock,destruction,65,31,34
illidan,1961,warlock,destruction,54,36,18
illidan,1961,warlock,destruction,96,52,44
tichondrius,1959,warlock,destruction,86,46,40
gallywix,1942,warlock,destruction,92,46,46
illidan,1935,warlock,destruction,94,56,38
azralon,1934,warlock,destruction,60,30,30
alleria,1931,warlock,destruction,59,33,26
lightnings-blade,1930,warlock,destruction,53,32,21
frostmourne,1930,warlock,destruction,77,46,31
shadowsong,1929,warlock,destruction,72,44,28
rivendare,1927,warlock,destruction,78,39,39
area-52,1926,warlock,destruction,54,33,21
malganis,1926,warlock,destruction,96,50,46
illidan,1926,warlock,destruction,42,21,21
frostmourne,1919,warlock,destruction,48,28,20
stormrage,1916,warlock,destruction,54,31,23
sargeras,1907,warlock,destruction,55,37,18
sargeras,1905,warlock,destruction,48,27,21
malganis,1903,warlock,destruction,48,29,19
korgath,1903,warlock,destruction,58,30,28
spirestone,1900,warlock,destruction,36,20,16
kelthuzad,1894,warlock,destruction,31,21,10
kelthuzad,1894,warlock,destruction,91,46,45
illidan,1894,warlock,destruction,72,32,40
tichondrius,1892,warlock,destruction,36,25,11
ragnaros,1886,warlock,destruction,42,27,15
darkspear,1875,warlock,destruction,78,40,38
stormrage,1874,warlock,destruction,41,28,13
duskwood,1869,warlock,destruction,66,33,33
tichondrius,1868,warlock,destruction,36,26,10
frostmourne,1866,warlock,destruction,68,47,21
area-52,1865,warlock,destruction,74,45,29
demon-soul,1860,warlock,destruction,36,21,15
bleeding-hollow,1859,warlock,destruction,54,32,22
tichondrius,1854,warlock,destruction,42,27,15
kaelthas,1853,warlock,destruction,84,46,38
sargeras,1851,warlock,destruction,99,65,34
stormrage,1849,warlock,destruction,48,30,18
blood-furnace,1849,warlock,destruction,42,24,18
stormrage,1849,warlock,destruction,49,26,23
stormrage,1848,warlock,destruction,72,53,19
tichondrius,1847,warlock,destruction,54,24,30
illidan,1846,warlock,destruction,59,28,31
ragnaros,1845,warlock,destruction,63,43,20
frostmourne,1845,warlock,destruction,54,34,20
bleeding-hollow,1844,warlock,destruction,83,44,39
grizzly-hills,1843,warlock,destruction,54,30,24
wyrmrest-accord,1842,warlock,destruction,36,27,9
kelthuzad,1840,warlock,destruction,66,44,22
illidan,1840,warlock,destruction,54,32,22
tichondrius,1840,warlock,destruction,60,31,29
saurfang,1838,warlock,destruction,36,24,12
bleeding-hollow,1836,warlock,destruction,60,31,29
malganis,1835,warlock,destruction,30,20,10
bleeding-hollow,1835,warlock,destruction,42,26,16
tichondrius,1835,warlock,destruction,51,30,21
tichondrius,1835,warlock,destruction,48,28,20
sargeras,1835,warlock,destruction,84,43,41
area-52,1835,warlock,destruction,72,35,37
area-52,1834,warlock,destruction,24,20,4
barthilas,1834,warlock,destruction,54,37,17
mannoroth,1833,warlock,destruction,71,32,39
nesingwary,1832,warlock,destruction,48,31,17
greymane,1830,warlock,destruction,42,23,19
bladefist,1830,warlock,destruction,71,32,39
malganis,1829,warlock,destruction,54,29,25
moon-guard,1829,warlock,destruction,92,45,47
stormrage,1825,warlock,destruction,48,37,11
mugthol,1825,warlock,destruction,48,30,18
zuljin,1825,warlock,destruction,49,30,19
tichondrius,1822,warlock,destruction,24,19,5
lightnings-blade,1820,warlock,destruction,42,26,16
illidan,1819,warlock,destruction,30,22,8
malganis,1817,warlock,destruction,66,42,24
tichondrius,1817,warlock,destruction,48,27,21
chogall,1816,warlock,destruction,51,32,19
frostmourne,1816,warlock,destruction,42,23,19
dalaran,1815,warlock,destruction,36,22,14
moon-guard,1815,warlock,destruction,36,19,17
stormrage,1814,warlock,destruction,36,24,12
hellscream,1813,warlock,destruction,44,33,11
drakkari,1813,warlock,destruction,45,27,18
magtheridon,1812,warlock,destruction,44,29,15
tichondrius,1812,warlock,destruction,54,31,23
tichondrius,1812,warlock,destruction,36,19,17
barthilas,1812,warlock,destruction,60,30,30
malygos,1811,warlock,destruction,38,21,17
veknilash,1811,warlock,destruction,61,30,31
stormrage,1810,warlock,destruction,39,26,13
tichondrius,1810,warlock,destruction,42,26,16
tichondrius,1810,warlock,destruction,65,38,27
stormrage,1810,warlock,destruction,72,42,30
tichondrius,1810,warlock,destruction,54,29,25
dalaran,1809,warlock,destruction,30,22,8
stormrage,1807,warlock,destruction,36,27,9
malganis,1807,warlock,destruction,47,29,18
tichondrius,1807,warlock,destruction,60,32,28
bleeding-hollow,1806,warlock,destruction,42,32,10
nemesis,1806,warlock,destruction,173,91,82
tichondrius,1805,warlock,destruction,48,28,20
kelthuzad,1805,warlock,destruction,47,23,24
velen,1804,warlock,destruction,46,32,14
stormreaver,1803,warlock,destruction,42,26,16
zuljin,1802,warlock,destruction,30,20,10
thrall,1802,warlock,destruction,40,22,18
aerie-peak,1801,warlock,destruction,75,46,29
stormrage,1801,warlock,destruction,42,25,17
frostmourne,1800,warlock,destruction,54,33,21
nemesis,1800,warlock,destruction,36,22,14
moon-guard,1798,warlock,destruction,48,27,21
duskwood,1798,warlock,destruction,54,28,26
stormrage,1797,warlock,destruction,30,19,11
stormscale,1794,warlock,destruction,73,34,39
chogall,1786,warlock,destruction,24,19,5
frostwolf,1781,warlock,destruction,60,38,22
tichondrius,1777,warlock,destruction,40,26,14
ragnaros,1776,warlock,destruction,78,42,36
tichondrius,1775,warlock,destruction,42,28,14
kiljaeden,1772,warlock,destruction,48,24,24
tichondrius,1772,warlock,destruction,54,25,29
area-52,1768,warlock,destruction,68,36,32
tichondrius,1764,warlock,destruction,48,26,22
stormrage,1760,warlock,destruction,36,25,11
arthas,1758,warlock,destruction,115,61,54
llane,1757,warlock,destruction,36,23,13
area-52,1756,warlock,destruction,66,36,30
frostmourne,1755,warlock,destruction,203,96,107
nerzhul,1749,warlock,destruction,42,26,16
sargeras,1747,warlock,destruction,46,25,21
emerald-dream,1746,warlock,destruction,124,66,58
wyrmrest-accord,1744,warlock,destruction,41,23,18
malganis,1743,warlock,destruction,83,49,34
kelthuzad,1734,warlock,destruction,29,19,10
emerald-dream,1733,warlock,destruction,42,25,17
firetree,1731,warlock,destruction,96,51,45
dalaran,1730,warlock,destruction,48,28,20
bleeding-hollow,1729,warlock,destruction,119,62,57
bleeding-hollow,1727,warlock,destruction,58,43,15
sargeras,1723,warlock,destruction,27,19,8
stormrage,1722,warlock,destruction,36,18,18
tichondrius,1721,warlock,destruction,47,28,19
tichondrius,1721,warlock,destruction,36,18,18
sargeras,1719,warlock,destruction,72,33,39
sargeras,1717,warlock,destruction,48,27,21
khadgar,1716,warlock,destruction,36,24,12
wyrmrest-accord,1713,warlock,destruction,41,20,21
bleeding-hollow,1711,warlock,destruction,24,18,6
tichondrius,1711,warlock,destruction,40,25,15
azralon,1710,warlock,destruction,54,29,25
bleeding-hollow,1709,warlock,destruction,30,18,12
area-52,1709,warlock,destruction,49,26,23
tichondrius,1708,warlock,destruction,23,18,5
bleeding-hollow,1708,warlock,destruction,38,26,12
tichondrius,1708,warlock,destruction,30,18,12
malganis,1707,warlock,destruction,31,18,13
tichondrius,1707,warlock,destruction,41,22,19
laughing-skull,1706,warlock,destruction,24,18,6
malganis,1705,warlock,destruction,30,19,11
dalaran,1705,warlock,destruction,36,22,14
tichondrius,1703,warlock,destruction,40,23,17
stormrage,1703,warlock,destruction,71,38,33
tichondrius,1702,warlock,destruction,36,21,15
sargeras,1701,warlock,destruction,54,27,27
tichondrius,1699,warlock,destruction,24,18,6
tichondrius,1699,warlock,destruction,30,20,10
tichondrius,1698,warlock,destruction,36,24,12
black-dragonflight,1698,warlock,destruction,44,28,16
quelthalas,1698,warlock,destruction,90,48,42
tichondrius,1697,warlock,destruction,44,24,20
illidan,1697,warlock,destruction,101,43,58
azralon,1696,warlock,destruction,36,30,6
sargeras,1696,warlock,destruction,48,29,19
illidan,1694,warlock,destruction,49,30,19
tichondrius,1694,warlock,destruction,60,30,30
azralon,1691,warlock,destruction,24,18,6
azralon,1691,warlock,destruction,96,56,40
bleeding-hollow,1691,warlock,destruction,57,33,24
kelthuzad,1690,warlock,destruction,36,28,8
korgath,1690,warlock,destruction,62,36,26
bleeding-hollow,1689,warlock,destruction,41,24,17
moon-guard,1689,warlock,destruction,44,25,19
barthilas,1688,warlock,destruction,30,29,1
destromath,1688,warlock,destruction,47,26,21
dalaran,1688,warlock,destruction,78,40,38
proudmoore,1687,warlock,destruction,51,25,26
frostmourne,1686,warlock,destruction,48,29,19
zuljin,1685,warlock,destruction,90,45,45
bonechewer,1683,warlock,destruction,36,23,13
madoran,1682,warlock,destruction,53,34,19
area-52,1678,warlock,destruction,36,25,11
aegwynn,1678,warlock,destruction,48,27,21
stormrage,1676,warlock,destruction,30,22,8
tichondrius,1676,warlock,destruction,35,23,12
malganis,1676,warlock,destruction,54,31,23
tichondrius,1675,warlock,destruction,121,68,53
tichondrius,1674,warlock,destruction,36,21,15
tichondrius,1674,warlock,destruction,35,20,15
sargeras,1673,warlock,destruction,42,27,15
ragnaros,1668,warlock,destruction,69,43,26
jubeithos,1667,warlock,destruction,37,23,14
proudmoore,1667,warlock,destruction,60,30,30
frostmourne,1666,warlock,destruction,42,23,19
malganis,1664,warlock,destruction,48,28,20
frostmourne,1664,warlock,destruction,48,22,26
tortheldrin,1663,warlock,destruction,53,30,23
stormrage,1661,warlock,destruction,42,26,16
bleeding-hollow,1660,warlock,destruction,118,62,56
kelthuzad,1658,warlock,destruction,95,53,42
emerald-dream,1658,warlock,destruction,126,68,58
gurubashi,1658,warlock,destruction,60,31,29
area-52,1654,warlock,destruction,59,37,22
tichondrius,1652,warlock,destruction,36,22,14
ragnaros,1650,warlock,destruction,28,20,8
sargeras,1647,warlock,destruction,24,18,6
tichondrius,1646,warlock,destruction,36,21,15
sargeras,1646,warlock,destruction,50,28,22
illidan,1644,warlock,destruction,35,25,10
darkspear,1643,warlock,destruction,109,57,52
stormrage,1643,warlock,destruction,40,18,22
area-52,1642,warlock,destruction,30,22,8
tichondrius,1642,warlock,destruction,42,22,20
stormrage,1638,warlock,destruction,42,29,13
sargeras,1637,warlock,destruction,39,24,15
tichondrius,1635,warlock,destruction,43,25,18
proudmoore,1634,warlock,destruction,48,30,18
zuljin,1632,warlock,destruction,70,45,25
thunderlord,1632,warlock,destruction,68,41,27
greymane,1631,warlock,destruction,24,17,7
tichondrius,1631,warlock,destruction,30,21,9
ghostlands,1631,warlock,destruction,48,27,21
tichondrius,1631,warlock,destruction,48,26,22
tichondrius,1630,warlock,destruction,30,17,13
bleeding-hollow,1629,warlock,destruction,48,29,19
tichondrius,1629,warlock,destruction,30,17,13
kelthuzad,1629,warlock,destruction,30,17,13
zuljin,1629,warlock,destruction,30,17,13
ragnaros,1629,warlock,destruction,53,30,23
tichondrius,1629,warlock,destruction,47,24,23
tichondrius,1626,warlock,destruction,30,17,13
akama,1625,warlock,destruction,24,17,7
zuljin,1624,warlock,destruction,27,18,9
kelthuzad,1623,warlock,destruction,30,20,10
ragnaros,1623,warlock,destruction,30,17,13
stormrage,1622,warlock,destruction,24,18,6
illidan,1622,warlock,destruction,42,20,22
thrall,1620,warlock,destruction,37,27,10
sargeras,1619,warlock,destruction,30,17,13
stormrage,1618,warlock,destruction,36,20,16
moon-guard,1617,warlock,destruction,101,59,42
azralon,1617,warlock,destruction,54,31,23
destromath,1617,warlock,destruction,60,34,26
wildhammer,1616,warlock,destruction,30,17,13
nemesis,1616,warlock,destruction,36,17,19
area-52,1615,warlock,destruction,40,26,14
moon-guard,1614,warlock,destruction,71,42,29
area-52,1612,warlock,destruction,93,56,37
tichondrius,1612,warlock,destruction,46,22,24
thunderhorn,1610,warlock,destruction,24,17,7
nemesis,1610,warlock,destruction,95,51,44
malfurion,1609,warlock,destruction,71,35,36
area-52,1608,warlock,destruction,24,17,7
tichondrius,1607,warlock,destruction,39,24,15
area-52,1607,warlock,destruction,36,21,15
zuljin,1604,warlock,destruction,99,56,43
stormrage,1603,warlock,destruction,48,34,14
illidan,1603,warlock,destruction,47,27,20
arthas,1602,warlock,destruction,26,20,6
bronzebeard,1602,warlock,destruction,24,17,7
nemesis,1602,warlock,destruction,42,27,15
malorne,1600,warlock,destruction,36,26,10
tichondrius,1600,warlock,destruction,33,20,13
hyjal,1599,warlock,destruction,30,20,10
sargeras,1599,warlock,destruction,30,19,11
moon-guard,1596,warlock,destruction,24,20,4
tichondrius,1594,warlock,destruction,30,17,13
stormrage,1592,warlock,destruction,36,24,12
illidan,1592,warlock,destruction,36,19,17
kelthuzad,1591,warlock,destruction,48,19,29
senjin,1587,warlock,destruction,48,26,22
moon-guard,1586,warlock,destruction,56,36,20
sargeras,1585,warlock,destruction,35,22,13
zuljin,1585,warlock,destruction,36,19,17
veknilash,1585,warlock,destruction,36,19,17
quelthalas,1584,warlock,destruction,82,49,33
drakkari,1583,warlock,destruction,42,26,16
moon-guard,1581,warlock,destruction,42,22,20
thrall,1579,warlock,destruction,29,19,10
malganis,1578,warlock,destruction,54,36,18
stormrage,1578,warlock,destruction,30,18,12
area-52,1577,warlock,destruction,48,27,21
tichondrius,1574,warlock,destruction,66,40,26
area-52,1569,warlock,destruction,30,20,10
dalaran,1567,warlock,destruction,30,18,12
moon-guard,1567,warlock,destruction,118,60,58
area-52,1566,warlock,destruction,33,19,14
stormrage,1564,warlock,destruction,42,20,22
drenden,1561,warlock,destruction,24,17,7
frostmourne,1561,warlock,destruction,42,21,21
azralon,1561,warlock,destruction,38,18,20
frostmourne,1558,warlock,destruction,72,42,30
area-52,1558,warlock,destruction,57,29,28
azralon,1557,warlock,destruction,30,23,7
moon-guard,1551,warlock,destruction,42,27,15
area-52,1550,warlock,destruction,30,21,9
tichondrius,1549,warlock,destruction,51,25,26
saurfang,1548,warlock,destruction,49,30,19
zuljin,1546,warlock,destruction,92,52,40
sargeras,1546,warlock,destruction,61,34,27
tichondrius,1545,warlock,destruction,27,20,7
illidan,1545,warlock,destruction,36,19,17
malganis,1544,warlock,destruction,135,70,65
kiljaeden,1540,warlock,destruction,30,17,13
quelthalas,1540,warlock,destruction,35,18,17
kalecgos,1538,warlock,destruction,32,20,12
stormrage,1537,warlock,destruction,29,17,12
tichondrius,1536,warlock,destruction,90,45,45
tichondrius,1535,warlock,destruction,24,16,8
area-52,1535,warlock,destruction,72,34,38
malganis,1534,warlock,destruction,18,16,2
area-52,1534,warlock,destruction,57,35,22
boulderfist,1534,warlock,destruction,59,35,24
tichondrius,1534,warlock,destruction,30,16,14
tichondrius,1533,warlock,destruction,36,16,20
malganis,1532,warlock,destruction,65,35,30
kirin-tor,1532,warlock,destruction,30,16,14
frostmourne,1532,warlock,destruction,42,21,21
moon-guard,1530,warlock,destruction,18,16,2
hydraxis,1528,warlock,destruction,24,16,8
proudmoore,1528,warlock,destruction,24,16,8
illidan,1528,warlock,destruction,30,16,14
tichondrius,1527,warlock,destruction,77,31,46
tichondrius,1526,warlock,destruction,18,16,2
illidan,1526,warlock,destruction,18,16,2
tichondrius,1525,warlock,destruction,36,18,18
zuljin,1524,warlock,destruction,54,35,19
tichondrius,1520,warlock,destruction,84,37,47
moon-guard,1516,warlock,destruction,31,17,14
malganis,1513,warlock,destruction,64,40,24
bleeding-hollow,1512,warlock,destruction,30,16,14
draktharon,1509,warlock,destruction,66,35,31
tichondrius,1509,warlock,destruction,56,29,27
akama,1508,warlock,destruction,153,80,73
silvermoon,1508,warlock,destruction,64,26,38
boulderfist,1507,warlock,destruction,85,41,44
khadgar,1505,warlock,destruction,54,28,26
malganis,1503,warlock,destruction,24,16,8
area-52,1503,warlock,destruction,87,37,50
burning-legion,1502,warlock,destruction,48,25,23
illidan,1498,warlock,destruction,30,16,14
zuljin,1498,warlock,destruction,34,16,18
tichondrius,1497,warlock,destruction,29,16,13
steamwheedle-cartel,1495,warlock,destruction,55,34,21
sargeras,1489,warlock,destruction,78,46,32
sargeras,1488,warlock,destruction,30,19,11
wyrmrest-accord,1483,warlock,destruction,25,17,8
malganis,1482,warlock,destruction,31,22,9
korgath,1480,warlock,destruction,30,18,12
tichondrius,1479,warlock,destruction,35,16,19
tichondrius,1475,warlock,destruction,50,23,27
sargeras,1474,warlock,destruction,36,22,14
area-52,1474,warlock,destruction,38,19,19
deathwing,1467,warlock,destruction,30,21,9
turalyon,1465,warlock,destruction,48,25,23
nagrand,1462,warlock,destruction,60,36,24
sargeras,1459,warlock,destruction,35,17,18
tichondrius,1457,warlock,destruction,28,16,12
frostmourne,1451,warlock,destruction,50,30,20
sargeras,1449,warlock,destruction,93,38,55
nemesis,1448,warlock,destruction,58,35,23
azgalor,1445,warlock,destruction,72,46,26
tichondrius,1445,warlock,destruction,32,17,15
deathwing,1444,warlock,destruction,48,35,13
tichondrius,1444,warlock,destruction,36,23,13
arthas,1442,warlock,destruction,29,21,8
frostmourne,1439,warlock,destruction,24,15,9
spirestone,1439,warlock,destruction,30,15,15
laughing-skull,1438,warlock,destruction,18,15,3
bleeding-hollow,1438,warlock,destruction,18,15,3
firetree,1438,warlock,destruction,24,15,9
tichondrius,1437,warlock,destruction,18,15,3
drakthul,1437,warlock,destruction,18,15,3
illidan,1437,warlock,destruction,24,15,9
tichondrius,1437,warlock,destruction,84,52,32
blackrock,1437,warlock,destruction,30,15,15
tichondrius,1436,warlock,destruction,60,25,35
deathwing,1435,warlock,destruction,30,15,15
sargeras,1435,warlock,destruction,36,15,21
chogall,1434,warlock,destruction,30,15,15
stormrage,1432,warlock,destruction,30,19,11
tichondrius,1427,warlock,destruction,30,15,15
earthen-ring,1426,warlock,destruction,18,15,3
moknathal,1426,warlock,destruction,36,17,19
sargeras,1424,warlock,destruction,47,19,28
mannoroth,1423,warlock,destruction,42,29,13
tichondrius,1422,warlock,destruction,94,49,45
illidan,1422,warlock,destruction,54,22,32
muradin,1421,warlock,destruction,42,26,16
moon-guard,1421,warlock,destruction,54,31,23
kargath,1419,warlock,destruction,44,26,18
drakkari,1418,warlock,destruction,24,15,9
barthilas,1417,warlock,destruction,64,32,32
stormrage,1415,warlock,destruction,24,15,9
tichondrius,1415,warlock,destruction,24,15,9
stormrage,1415,warlock,destruction,57,35,22
area-52,1413,warlock,destruction,69,36,33
tichondrius,1413,warlock,destruction,78,39,39
illidan,1413,warlock,destruction,30,15,15
azralon,1413,warlock,destruction,93,41,52
azgalor,1412,warlock,destruction,25,20,5
ragnaros,1412,warlock,destruction,88,47,41
alexstrasza,1412,warlock,destruction,30,15,15
ragnaros,1411,warlock,destruction,24,15,9
darkspear,1411,warlock,destruction,36,18,18
tichondrius,1410,warlock,destruction,30,15,15
tichondrius,1410,warlock,destruction,42,19,23
frostmourne,1409,warlock,destruction,24,15,9
shadowmoon,1409,warlock,destruction,30,15,15
arthas,1404,warlock,destruction,24,17,7
altar-of-storms,1402,warlock,destruction,42,20,22
azralon,1401,warlock,destruction,55,25,30
thunderlord,1400,warlock,destruction,36,16,20
sargeras,1397,warlock,destruction,23,15,8
nesingwary,1395,warlock,destruction,36,21,15
emerald-dream,1395,warlock,destruction,59,30,29
area-52,1392,warlock,destruction,34,24,10
stormreaver,1390,warlock,destruction,24,15,9
illidan,1390,warlock,destruction,101,56,45
tichondrius,1384,warlock,destruction,129,70,59
stormrage,1383,warlock,destruction,24,16,8
trollbane,1383,warlock,destruction,24,16,8
illidan,1382,warlock,destruction,57,32,25
azralon,1379,warlock,destruction,48,23,25
proudmoore,1378,warlock,destruction,43,20,23
tichondrius,1377,warlock,destruction,42,23,19
borean-tundra,1371,warlock,destruction,35,18,17
moon-guard,1370,warlock,destruction,43,18,25
azralon,1367,warlock,destruction,38,16,22
arthas,1364,warlock,destruction,24,15,9
tichondrius,1363,warlock,destruction,30,18,12
misha,1362,warlock,destruction,36,18,18
quelthalas,1357,warlock,destruction,69,32,37
frostmourne,1352,warlock,destruction,26,15,11
area-52,1351,warlock,destruction,28,19,9
emerald-dream,1348,warlock,destruction,24,16,8
frostmourne,1346,warlock,destruction,38,19,19
tichondrius,1344,warlock,destruction,24,14,10
thrall,1344,warlock,destruction,42,18,24
sargeras,1343,warlock,destruction,24,14,10
tichondrius,1343,warlock,destruction,24,14,10
stormrage,1340,warlock,destruction,18,14,4
jubeithos,1338,warlock,destruction,42,25,17
agamaggan,1338,warlock,destruction,24,14,10
tichondrius,1337,warlock,destruction,18,14,4
tichondrius,1337,warlock,destruction,18,14,4
jubeithos,1337,warlock,destruction,18,14,4
azralon,1336,warlock,destruction,38,25,13
area-52,1334,warlock,destruction,24,14,10
tichondrius,1328,warlock,destruction,133,60,73
doomhammer,1323,warlock,destruction,26,15,11
antonidas,1316,warlock,destruction,36,16,20
stormrage,1312,warlock,destruction,24,15,9
azralon,1310,warlock,destruction,29,17,12
frostmane,1309,warlock,destruction,30,16,14
mannoroth,1309,warlock,destruction,48,22,26
malganis,1307,warlock,destruction,23,14,9
azralon,1307,warlock,destruction,38,20,18
malganis,1302,warlock,destruction,36,23,13
korgath,1300,warlock,destruction,18,14,4
frostmourne,1298,warlock,destruction,23,14,9
sargeras,1298,warlock,destruction,34,16,18
lightbringer,1290,warlock,destruction,23,14,9
barthilas,1286,warlock,destruction,33,14,19
mannoroth,1286,warlock,destruction,35,14,21
tichondrius,1278,warlock,destruction,37,14,23
proudmoore,1276,warlock,destruction,31,14,17
area-52,1275,warlock,destruction,23,14,9
area-52,1275,warlock,destruction,28,14,14
tichondrius,1267,warlock,destruction,56,24,32
stormrage,1261,warlock,destruction,24,14,10
quelthalas,1258,warlock,destruction,30,14,16
emerald-dream,1253,warlock,destruction,38,20,18
malganis,1253,warlock,destruction,32,14,18
illidan,1248,warlock,destruction,18,13,5
illidan,1248,warlock,destruction,18,13,5
ravencrest,1248,warlock,destruction,18,13,5
area-52,1248,warlock,destruction,18,13,5
sargeras,1247,warlock,destruction,18,13,5
illidan,1247,warlock,destruction,18,13,5
illidan,1247,warlock,destruction,27,17,10
bloodhoof,1247,warlock,destruction,24,13,11
zuljin,1247,warlock,destruction,24,13,11
chogall,1246,warlock,destruction,18,13,5
tichondrius,1246,warlock,destruction,22,14,8
hyjal,1246,warlock,destruction,30,13,17
barthilas,1245,warlock,destruction,24,15,9
illidan,1245,warlock,destruction,30,13,17
proudmoore,1243,warlock,destruction,30,13,17
tichondrius,1242,warlock,destruction,24,13,11
tichondrius,1242,warlock,destruction,24,13,11
tichondrius,1238,warlock,destruction,24,13,11
azralon,1237,warlock,destruction,18,13,5
sargeras,1237,warlock,destruction,18,13,5
bleeding-hollow,1237,warlock,destruction,24,13,11
draka,1236,warlock,destruction,18,13,5
frostmourne,1233,warlock,destruction,18,13,5
spirestone,1233,warlock,destruction,24,13,11
zuljin,1231,warlock,destruction,24,13,11
daggerspine,1228,warlock,destruction,59,37,22
zuljin,1226,warlock,destruction,18,13,5
sargeras,1226,warlock,destruction,18,13,5
tichondrius,1226,warlock,destruction,24,13,11
tichondrius,1225,warlock,destruction,24,13,11
azralon,1225,warlock,destruction,24,13,11
icecrown,1224,warlock,destruction,36,16,20
bleeding-hollow,1215,warlock,destruction,29,14,15
area-52,1214,warlock,destruction,133,56,77
crushridge,1209,warlock,destruction,28,17,11
stormrage,1200,warlock,destruction,30,13,17
stormrage,1196,warlock,destruction,24,15,9
azralon,1195,warlock,destruction,30,13,17
illidan,1193,warlock,destruction,22,16,6
proudmoore,1185,warlock,destruction,20,15,5
zuljin,1183,warlock,destruction,22,13,9
sargeras,1177,warlock,destruction,77,33,44
aegwynn,1168,warlock,destruction,42,26,16
stormrage,1165,warlock,destruction,89,46,43
proudmoore,1158,warlock,destruction,39,21,18
tichondrius,1152,warlock,destruction,12,12,0
illidan,1152,warlock,destruction,18,12,6
zuljin,1152,warlock,destruction,19,12,7
area-52,1151,warlock,destruction,18,12,6
mannoroth,1151,warlock,destruction,18,12,6
kelthuzad,1151,warlock,destruction,18,12,6
tichondrius,1151,warlock,destruction,24,12,12
emerald-dream,1151,warlock,destruction,24,12,12
firetree,1151,warlock,destruction,28,13,15
frostmourne,1150,warlock,destruction,24,12,12
stormrage,1150,warlock,destruction,33,13,20
illidan,1149,warlock,destruction,18,12,6
sargeras,1149,warlock,destruction,24,12,12
shuhalo,1148,warlock,destruction,18,12,6
kelthuzad,1147,warlock,destruction,18,12,6
tichondrius,1146,warlock,destruction,36,12,24
aerie-peak,1141,warlock,destruction,36,13,23
tichondrius,1140,warlock,destruction,24,12,12
dalaran,1138,warlock,destruction,24,12,12
moon-guard,1136,warlock,destruction,42,28,14
hyjal,1121,warlock,destruction,54,32,22
tichondrius,1119,warlock,destruction,22,12,10
frostmourne,1113,warlock,destruction,29,12,17
demon-soul,1106,warlock,destruction,24,12,12
nemesis,1106,warlock,destruction,151,66,85
tichondrius,1104,warlock,destruction,36,14,22
illidan,1103,warlock,destruction,15,13,2
area-52,1103,warlock,destruction,15,13,2
stormscale,1098,warlock,destruction,27,13,14
stormrage,1094,warlock,destruction,36,22,14
sargeras,1092,warlock,destruction,23,12,11
hyjal,1076,warlock,destruction,27,14,13
tichondrius,1072,warlock,destruction,19,12,7
earthen-ring,1071,warlock,destruction,30,20,10
stormrage,1070,warlock,destruction,36,18,18
daggerspine,1069,warlock,destruction,19,12,7
azralon,1056,warlock,destruction,12,11,1
zuljin,1056,warlock,destruction,12,11,1
tichondrius,1056,warlock,destruction,16,12,4
saurfang,1056,warlock,destruction,18,11,7
bleeding-hollow,1056,warlock,destruction,18,11,7
tichondrius,1056,warlock,destruction,18,11,7
sargeras,1056,warlock,destruction,18,11,7
tichondrius,1056,warlock,destruction,18,11,7
sargeras,1055,warlock,destruction,12,11,1
malfurion,1055,warlock,destruction,12,11,1
azralon,1055,warlock,destruction,18,11,7
nemesis,1055,warlock,destruction,18,11,7
illidan,1055,warlock,destruction,18,11,7
stormrage,1055,warlock,destruction,18,11,7
tichondrius,1055,warlock,destruction,18,11,7
tichondrius,1055,warlock,destruction,18,11,7
area-52,1055,warlock,destruction,24,11,13
area-52,1055,warlock,destruction,24,11,13
stormrage,1054,warlock,destruction,18,11,7
illidan,1054,warlock,destruction,18,11,7
tichondrius,1054,warlock,destruction,18,11,7
zuljin,1053,warlock,destruction,18,11,7
tichondrius,1052,warlock,destruction,12,11,1
darkspear,1052,warlock,destruction,18,11,7
illidan,1052,warlock,destruction,18,11,7
jubeithos,1050,warlock,destruction,18,11,7
blackrock,1049,warlock,destruction,18,11,7
illidan,1048,warlock,destruction,24,11,13
hydraxis,1046,warlock,destruction,18,11,7
frostmourne,1046,warlock,destruction,18,11,7
moon-guard,1044,warlock,destruction,18,11,7
tichondrius,1043,warlock,destruction,50,29,21
drakkari,1041,warlock,destruction,36,17,19
windrunner,1038,warlock,destruction,18,11,7
quelthalas,1038,warlock,destruction,30,11,19
tichondrius,1030,warlock,destruction,18,11,7
barthilas,1029,warlock,destruction,30,11,19
illidan,1025,warlock,destruction,24,13,11
ragnaros,1023,warlock,destruction,17,11,6
hellscream,1023,warlock,destruction,17,11,6
proudmoore,1022,warlock,destruction,23,11,12
sargeras,1006,warlock,destruction,26,11,15
malganis,1005,warlock,destruction,23,11,12
sargeras,1003,warlock,destruction,17,11,6
tichondrius,1002,warlock,destruction,23,11,12
azralon,992,warlock,destruction,27,12,15
area-52,986,warlock,destruction,23,11,12
tichondrius,975,warlock,destruction,11,11,0
tichondrius,966,warlock,destruction,31,11,20
sargeras,960,warlock,destruction,12,10,2
blackrock,960,warlock,destruction,12,10,2
tichondrius,960,warlock,destruction,12,10,2
bleeding-hollow,960,warlock,destruction,12,10,2
malganis,960,warlock,destruction,12,10,2
tichondrius,960,warlock,destruction,12,10,2
barthilas,960,warlock,destruction,12,10,2
kelthuzad,960,warlock,destruction,12,10,2
sargeras,960,warlock,destruction,12,10,2
tichondrius,960,warlock,destruction,12,10,2
sargeras,960,warlock,destruction,12,10,2
alleria,960,warlock,destruction,18,10,8
bleeding-hollow,960,warlock,destruction,18,10,8
sargeras,960,warlock,destruction,18,10,8
tichondrius,960,warlock,destruction,18,10,8
tichondrius,960,warlock,destruction,18,10,8
tichondrius,960,warlock,destruction,24,10,14
proudmoore,959,warlock,destruction,12,10,2
stormrage,959,warlock,destruction,12,10,2
illidan,959,warlock,destruction,12,10,2
emerald-dream,959,warlock,destruction,18,10,8
kiljaeden,959,warlock,destruction,18,10,8
kelthuzad,959,warlock,destruction,18,10,8
illidan,959,warlock,destruction,18,10,8
frostmourne,959,warlock,destruction,18,10,8
llane,959,warlock,destruction,18,10,8
sargeras,959,warlock,destruction,18,10,8
emerald-dream,959,warlock,destruction,18,10,8
kelthuzad,959,warlock,destruction,18,10,8
tichondrius,959,warlock,destruction,18,10,8
antonidas,959,warlock,destruction,18,10,8
barthilas,959,warlock,destruction,24,10,14
ragnaros,959,warlock,destruction,24,10,14
moon-guard,958,warlock,destruction,12,10,2
bleeding-hollow,958,warlock,destruction,12,10,2
sargeras,958,warlock,destruction,18,10,8
illidan,958,warlock,destruction,18,10,8
zuljin,957,warlock,destruction,24,10,14
moon-guard,956,warlock,destruction,12,10,2
aegwynn,956,warlock,destruction,18,10,8
dalaran,956,warlock,destruction,18,10,8
area-52,956,warlock,destruction,24,10,14
frostmourne,955,warlock,destruction,18,10,8
area-52,955,warlock,destruction,18,10,8
feathermoon,955,warlock,destruction,18,10,8
zuluhed,955,warlock,destruction,24,10,14
frostmourne,954,warlock,destruction,15,11,4
lightnings-blade,954,warlock,destruction,18,10,8
ravenholdt,953,warlock,destruction,18,10,8
sargeras,952,warlock,destruction,12,10,2
jubeithos,952,warlock,destruction,18,10,8
kaelthas,950,warlock,destruction,12,10,2
sargeras,950,warlock,destruction,18,10,8
ragnaros,950,warlock,destruction,36,10,26
lightnings-blade,946,warlock,destruction,12,10,2
azralon,946,warlock,destruction,24,10,14
illidan,946,warlock,destruction,24,10,14
twisting-nether,934,warlock,destruction,18,10,8
malganis,927,warlock,destruction,20,11,9
zuljin,926,warlock,destruction,26,11,15
burning-legion,925,warlock,destruction,27,11,16
illidan,921,warlock,destruction,28,13,15
stormrage,920,warlock,destruction,26,11,15
wyrmrest-accord,910,warlock,destruction,23,10,13
lightbringer,896,warlock,destruction,16,10,6
tichondrius,896,warlock,destruction,22,10,12
caelestrasz,895,warlock,destruction,16,10,6
dalaran,894,warlock,destruction,17,10,7
moon-guard,894,warlock,destruction,17,10,7
kiljaeden,893,warlock,destruction,17,10,7
destromath,892,warlock,destruction,42,22,20
tichondrius,879,warlock,destruction,19,10,9
quelthalas,875,warlock,destruction,19,10,9
azralon,865,warlock,destruction,18,10,8
ragnaros,864,warlock,destruction,12,9,3
tichondrius,864,warlock,destruction,12,9,3
illidan,864,warlock,destruction,12,9,3
stormrage,864,warlock,destruction,12,9,3
azralon,864,warlock,destruction,12,9,3
frostmourne,864,warlock,destruction,12,9,3
moon-guard,864,warlock,destruction,12,9,3
agamaggan,864,warlock,destruction,12,9,3
bleeding-hollow,864,warlock,destruction,12,9,3
ragnaros,864,warlock,destruction,12,9,3
illidan,864,warlock,destruction,12,9,3
illidan,864,warlock,destruction,18,9,9
malganis,864,warlock,destruction,18,9,9
area-52,864,warlock,destruction,18,9,9
azralon,864,warlock,destruction,18,9,9
illidan,864,warlock,destruction,18,9,9
illidan,864,warlock,destruction,18,9,9
illidan,864,warlock,destruction,18,9,9
tichondrius,864,warlock,destruction,18,9,9
illidan,863,warlock,destruction,12,9,3
frostmourne,863,warlock,destruction,12,9,3
frostwolf,863,warlock,destruction,12,9,3
stormrage,863,warlock,destruction,12,9,3
area-52,863,warlock,destruction,12,9,3
illidan,863,warlock,destruction,12,9,3
ragnaros,863,warlock,destruction,12,9,3
laughing-skull,863,warlock,destruction,12,9,3
garrosh,863,warlock,destruction,12,9,3
azralon,863,warlock,destruction,13,9,4
stormscale,863,warlock,destruction,15,10,5
barthilas,863,warlock,destruction,18,9,9
the-venture-co,863,warlock,destruction,18,9,9
tichondrius,863,warlock,destruction,18,9,9
tichondrius,863,warlock,destruction,18,9,9
nagrand,863,warlock,destruction,18,9,9
illidan,863,warlock,destruction,19,9,10
tichondrius,863,warlock,destruction,22,10,12
malganis,863,warlock,destruction,24,9,15
nathrezim,863,warlock,destruction,24,9,15
doomhammer,863,warlock,destruction,24,9,15
area-52,863,warlock,destruction,24,9,15
aerie-peak,862,warlock,destruction,12,9,3
earthen-ring,862,warlock,destruction,12,9,3
wyrmrest-accord,862,warlock,destruction,12,9,3
stormrage,862,warlock,destruction,12,9,3
proudmoore,862,warlock,destruction,18,9,9
sargeras,862,warlock,destruction,18,9,9
stormrage,862,warlock,destruction,18,9,9
azralon,862,warlock,destruction,18,9,9
tichondrius,862,warlock,destruction,24,9,15
tichondrius,862,warlock,destruction,24,9,15
antonidas,862,warlock,destruction,24,9,15
moon-guard,861,warlock,destruction,12,9,3
thrall,861,warlock,destruction,18,9,9
smolderthorn,861,warlock,destruction,27,10,17
tichondrius,860,warlock,destruction,18,9,9
tichondrius,860,warlock,destruction,18,9,9
akama,858,warlock,destruction,12,9,3
frostmourne,858,warlock,destruction,15,10,5
arathor,858,warlock,destruction,18,9,9
barthilas,856,warlock,destruction,18,9,9
lightnings-blade,855,warlock,destruction,12,9,3
nordrassil,855,warlock,destruction,12,9,3
ragnaros,853,warlock,destruction,18,9,9
wyrmrest-accord,852,warlock,destruction,18,9,9
tichondrius,850,warlock,destruction,18,9,9
amanthul,832,warlock,destruction,16,9,7
blades-edge,831,warlock,destruction,41,15,26
tichondrius,806,warlock,destruction,17,9,8
proudmoore,803,warlock,destruction,15,9,6
frostmourne,799,warlock,destruction,17,9,8
emerald-dream,798,warlock,destruction,17,9,8
tichondrius,784,warlock,destruction,13,9,4
barthilas,775,warlock,destruction,19,10,9
nemesis,768,warlock,destruction,12,8,4
darkspear,768,warlock,destruction,12,8,4
nemesis,768,warlock,destruction,12,8,4
tichondrius,768,warlock,destruction,12,8,4
sargeras,768,warlock,destruction,12,8,4
drakthul,768,warlock,destruction,12,8,4
area-52,768,warlock,destruction,12,8,4
tichondrius,768,warlock,destruction,12,8,4
frostmourne,768,warlock,destruction,12,8,4
tichondrius,768,warlock,destruction,12,8,4
tichondrius,768,warlock,destruction,12,8,4
malganis,768,warlock,destruction,12,8,4
dragonmaw,768,warlock,destruction,12,8,4
zuljin,768,warlock,destruction,12,8,4
illidan,768,warlock,destruction,12,8,4
tichondrius,768,warlock,destruction,12,8,4
stormrage,768,warlock,destruction,12,8,4
tichondrius,768,warlock,destruction,12,8,4
kelthuzad,768,warlock,destruction,12,8,4
sargeras,768,warlock,destruction,12,8,4
drakkari,768,warlock,destruction,12,8,4
area-52,768,warlock,destruction,12,8,4
dalaran,768,warlock,destruction,12,8,4
bleeding-hollow,768,warlock,destruction,12,8,4
archimonde,768,warlock,destruction,12,8,4
bleeding-hollow,768,warlock,destruction,12,8,4
bleeding-hollow,768,warlock,destruction,13,8,5
ragnaros,768,warlock,destruction,14,8,6
jaedenar,768,warlock,destruction,18,8,10
emerald-dream,768,warlock,destruction,18,8,10
sargeras,768,warlock,destruction,18,8,10
frostmourne,768,warlock,destruction,18,8,10
frostmourne,767,warlock,destruction,12,8,4
gorefiend,767,warlock,destruction,12,8,4
area-52,767,warlock,destruction,12,8,4
illidan,767,warlock,destruction,12,8,4
tichondrius,767,warlock,destruction,12,8,4
tichondrius,767,warlock,destruction,12,8,4
tichondrius,767,warlock,destruction,12,8,4
frostmourne,767,warlock,destruction,12,8,4
thrall,767,warlock,destruction,12,8,4
shadowsong,767,warlock,destruction,12,8,4
sargeras,767,warlock,destruction,12,8,4
mugthol,767,warlock,destruction,18,8,10
thrall,767,warlock,destruction,18,8,10
drakkari,767,warlock,destruction,18,8,10
lightnings-blade,767,warlock,destruction,18,8,10
dalvengyr,767,warlock,destruction,18,8,10
tichondrius,766,warlock,destruction,12,8,4
amanthul,766,warlock,destruction,12,8,4
frostmourne,766,warlock,destruction,12,8,4
nazgrel,766,warlock,destruction,18,8,10
hyjal,765,warlock,destruction,12,8,4
khazgoroth,765,warlock,destruction,12,8,4
sargeras,765,warlock,destruction,12,8,4
aggramar,765,warlock,destruction,24,8,16
kul-tiras,763,warlock,destruction,12,8,4
sargeras,763,warlock,destruction,18,8,10
dalaran,763,warlock,destruction,18,8,10
tichondrius,762,warlock,destruction,18,8,10
hellscream,762,warlock,destruction,18,8,10
gurubashi,760,warlock,destruction,12,8,4
trollbane,758,warlock,destruction,12,8,4
azgalor,753,warlock,destruction,12,8,4
bleeding-hollow,719,warlock,destruction,11,8,3
tichondrius,719,warlock,destruction,11,8,3
bleeding-hollow,719,warlock,destruction,11,8,3
barthilas,703,warlock,destruction,11,8,3
sargeras,703,warlock,destruction,11,8,3
jubeithos,702,warlock,destruction,11,8,3
illidan,699,warlock,destruction,11,8,3
emerald-dream,672,warlock,destruction,10,8,2
sargeras,672,warlock,destruction,12,7,5
illidan,672,warlock,destruction,12,7,5
malganis,672,warlock,destruction,12,7,5
tichondrius,672,warlock,destruction,12,7,5
bleeding-hollow,672,warlock,destruction,12,7,5
illidan,672,warlock,destruction,12,7,5
silver-hand,672,warlock,destruction,12,7,5
malganis,672,warlock,destruction,12,7,5
the-forgotten-coast,672,warlock,destruction,12,7,5
tichondrius,672,warlock,destruction,12,7,5
nagrand,672,warlock,destruction,12,7,5
tichondrius,672,warlock,destruction,12,7,5
crushridge,672,warlock,destruction,12,7,5
boulderfist,672,warlock,destruction,12,7,5
zuljin,672,warlock,destruction,12,7,5
goldrinn,672,warlock,destruction,12,7,5
tichondrius,672,warlock,destruction,12,7,5
tichondrius,672,warlock,destruction,12,7,5
mannoroth,672,warlock,destruction,12,7,5
frostmourne,672,warlock,destruction,12,7,5
arthas,672,warlock,destruction,12,7,5
illidan,672,warlock,destruction,12,7,5
thrall,672,warlock,destruction,12,7,5
gorefiend,672,warlock,destruction,12,7,5
tichondrius,672,warlock,destruction,12,7,5
tichondrius,672,warlock,destruction,12,7,5
ragnaros,672,warlock,destruction,12,7,5
malygos,672,warlock,destruction,12,7,5
tichondrius,672,warlock,destruction,12,7,5
tichondrius,672,warlock,destruction,12,7,5
wildhammer,672,warlock,destruction,12,7,5
frostmourne,672,warlock,destruction,12,7,5
sargeras,672,warlock,destruction,12,7,5
tichondrius,672,warlock,destruction,12,7,5
nemesis,672,warlock,destruction,12,7,5
malfurion,672,warlock,destruction,12,7,5
tichondrius,672,warlock,destruction,12,7,5
area-52,672,warlock,destruction,16,8,8
tichondrius,672,warlock,destruction,18,7,11
tichondrius,672,warlock,destruction,18,7,11
silver-hand,671,warlock,destruction,12,7,5
sargeras,671,warlock,destruction,12,7,5
ragnaros,671,warlock,destruction,12,7,5
darkspear,671,warlock,destruction,12,7,5
tichondrius,671,warlock,destruction,12,7,5
stormrage,671,warlock,destruction,12,7,5
dark-iron,671,warlock,destruction,18,7,11
thunderlord,671,warlock,destruction,24,7,17
aerie-peak,670,warlock,destruction,12,7,5
malygos,670,warlock,destruction,12,7,5
duskwood,669,warlock,destruction,18,7,11
borean-tundra,668,warlock,destruction,18,7,11
dalaran,668,warlock,destruction,19,7,12
tichondrius,639,warlock,destruction,11,7,4
bleeding-hollow,638,warlock,destruction,14,8,6
tichondrius,607,warlock,destruction,8,7,1
ragnaros,607,warlock,destruction,14,7,7
tichondrius,607,warlock,destruction,16,7,9
azralon,592,warlock,destruction,13,7,6
goldrinn,591,warlock,destruction,13,7,6
kelthuzad,576,warlock,destruction,6,6,0
azralon,576,warlock,destruction,6,6,0
illidan,576,warlock,destruction,6,6,0
tichondrius,576,warlock,destruction,6,6,0
tichondrius,576,warlock,destruction,6,6,0
quelthalas,576,warlock,destruction,6,6,0
thrall,576,warlock,destruction,6,6,0
tichondrius,576,warlock,destruction,6,6,0
velen,576,warlock,destruction,6,6,0
tichondrius,576,warlock,destruction,6,6,0
sargeras,576,warlock,destruction,6,6,0
nemesis,576,warlock,destruction,6,6,0
sargeras,576,warlock,destruction,6,6,0
tichondrius,576,warlock,destruction,6,6,0
tichondrius,576,warlock,destruction,6,6,0
tichondrius,576,warlock,destruction,6,6,0
darkspear,576,warlock,destruction,6,6,0
frostmourne,576,warlock,destruction,6,6,0
frostmourne,576,warlock,destruction,6,6,0
tichondrius,576,warlock,destruction,9,7,2
alterac-mountains,576,warlock,destruction,10,7,3
tichondrius,576,warlock,destruction,13,7,6
nerzhul,576,warlock,destruction,12,6,6
dalaran,576,warlock,destruction,12,6,6
barthilas,576,warlock,destruction,12,6,6
proudmoore,576,warlock,destruction,12,6,6
kelthuzad,576,warlock,destruction,12,6,6
emerald-dream,576,warlock,destruction,12,6,6
darkspear,576,warlock,destruction,12,6,6
kiljaeden,576,warlock,destruction,12,6,6
area-52,576,warlock,destruction,12,6,6
quelthalas,576,warlock,destruction,12,6,6
zuljin,576,warlock,destruction,12,6,6
aerie-peak,576,warlock,destruction,12,6,6
moon-guard,576,warlock,destruction,12,6,6
tichondrius,576,warlock,destruction,12,6,6
quelthalas,576,warlock,destruction,12,6,6
frostmourne,576,warlock,destruction,12,6,6
zuljin,576,warlock,destruction,12,6,6
illidan,576,warlock,destruction,12,6,6
illidan,576,warlock,destruction,12,6,6
tichondrius,576,warlock,destruction,12,6,6
azralon,576,warlock,destruction,12,6,6
thrall,576,warlock,destruction,12,6,6
azralon,576,warlock,destruction,12,6,6
bleeding-hollow,576,warlock,destruction,12,6,6
moon-guard,576,warlock,destruction,12,6,6
bleeding-hollow,576,warlock,destruction,12,6,6
area-52,576,warlock,destruction,12,6,6
area-52,576,warlock,destruction,12,6,6
tichondrius,576,warlock,destruction,12,6,6
drakkari,576,warlock,destruction,12,6,6
dreadmaul,576,warlock,destruction,12,6,6
area-52,576,warlock,destruction,16,7,9
hyjal,576,warlock,destruction,18,6,12
kelthuzad,576,warlock,destruction,18,6,12
malganis,576,warlock,destruction,18,6,12
kirin-tor,576,warlock,destruction,18,6,12
kaelthas,575,warlock,destruction,12,6,6
bleeding-hollow,575,warlock,destruction,12,6,6
kiljaeden,575,warlock,destruction,12,6,6
firetree,575,warlock,destruction,12,6,6
nordrassil,575,warlock,destruction,12,6,6
kelthuzad,575,warlock,destruction,12,6,6
area-52,575,warlock,destruction,12,6,6
andorhal,575,warlock,destruction,18,6,12
illidan,574,warlock,destruction,6,6,0
barthilas,574,warlock,destruction,12,6,6
bleeding-hollow,572,warlock,destruction,18,6,12
illidan,557,warlock,destruction,11,6,5
kelthuzad,544,warlock,destruction,16,6,10
tichondrius,543,warlock,destruction,8,7,1
tichondrius,528,warlock,destruction,15,6,9
dalaran,527,warlock,destruction,11,6,5
destromath,527,warlock,destruction,11,6,5
frostmourne,527,warlock,destruction,11,6,5
barthilas,527,warlock,destruction,17,6,11
wyrmrest-accord,511,warlock,destruction,8,6,2
tichondrius,511,warlock,destruction,11,6,5
frostmourne,511,warlock,destruction,14,6,8
tichondrius,480,warlock,destruction,6,5,1
altar-of-storms,480,warlock,destruction,6,5,1
area-52,480,warlock,destruction,6,5,1
area-52,480,warlock,destruction,6,5,1
kelthuzad,480,warlock,destruction,6,5,1
malganis,480,warlock,destruction,6,5,1
mannoroth,480,warlock,destruction,6,5,1
ragnaros,480,warlock,destruction,6,5,1
tichondrius,480,warlock,destruction,6,5,1
tichondrius,480,warlock,destruction,6,5,1
stormrage,480,warlock,destruction,6,5,1
stormrage,480,warlock,destruction,6,5,1
zuljin,480,warlock,destruction,6,5,1
tichondrius,480,warlock,destruction,6,5,1
tichondrius,480,warlock,destruction,6,5,1
tichondrius,480,warlock,destruction,6,5,1
tichondrius,480,warlock,destruction,6,5,1
tichondrius,480,warlock,destruction,6,5,1
stormrage,480,warlock,destruction,6,5,1
tichondrius,480,warlock,destruction,6,5,1
vashj,480,warlock,destruction,6,5,1
tichondrius,480,warlock,destruction,6,5,1
drenden,480,warlock,destruction,6,5,1
hyjal,480,warlock,destruction,6,5,1
korgath,480,warlock,destruction,6,5,1
tichondrius,480,warlock,destruction,6,5,1
darkspear,480,warlock,destruction,6,5,1
area-52,480,warlock,destruction,6,5,1
emerald-dream,480,warlock,destruction,6,5,1
emerald-dream,480,warlock,destruction,6,5,1
illidan,480,warlock,destruction,6,5,1
illidan,480,warlock,destruction,6,5,1
amanthul,480,warlock,destruction,6,5,1
dalaran,480,warlock,destruction,6,5,1
illidan,480,warlock,destruction,6,5,1
thrall,480,warlock,destruction,6,5,1
azralon,480,warlock,destruction,6,5,1
dalaran,480,warlock,destruction,6,5,1
frostmourne,480,warlock,destruction,6,5,1
frostmourne,480,warlock,destruction,6,5,1
sargeras,480,warlock,destruction,12,5,7
moon-guard,480,warlock,destruction,12,5,7
blackrock,480,warlock,destruction,12,5,7
stormreaver,480,warlock,destruction,12,5,7
garrosh,480,warlock,destruction,12,5,7
tichondrius,480,warlock,destruction,12,5,7
darkspear,480,warlock,destruction,12,5,7
frostmourne,480,warlock,destruction,12,5,7
frostmourne,480,warlock,destruction,12,5,7
tichondrius,480,warlock,destruction,12,5,7
illidan,480,warlock,destruction,12,5,7
kelthuzad,480,warlock,destruction,12,5,7
area-52,480,warlock,destruction,12,5,7
emerald-dream,480,warlock,destruction,12,5,7
malganis,480,warlock,destruction,12,5,7
shadowmoon,480,warlock,destruction,12,5,7
area-52,480,warlock,destruction,12,5,7
tichondrius,480,warlock,destruction,12,5,7
malfurion,480,warlock,destruction,12,5,7
skullcrusher,480,warlock,destruction,12,5,7
frostmourne,480,warlock,destruction,12,5,7
bleeding-hollow,480,warlock,destruction,12,5,7
mannoroth,480,warlock,destruction,12,5,7
laughing-skull,480,warlock,destruction,12,5,7
azralon,480,warlock,destruction,12,5,7
kelthuzad,480,warlock,destruction,12,5,7
blackrock,480,warlock,destruction,18,5,13
tichondrius,479,warlock,destruction,9,6,3
amanthul,479,warlock,destruction,12,5,7
laughing-skull,479,warlock,destruction,12,5,7
hyjal,479,warlock,destruction,12,5,7
area-52,477,warlock,destruction,9,6,3
stormrage,477,warlock,destruction,18,5,13
darkspear,476,warlock,destruction,12,5,7
malganis,468,warlock,destruction,38,8,30
azralon,462,warlock,destruction,11,5,6
moknathal,447,warlock,destruction,11,5,6
stormrage,447,warlock,destruction,11,5,6
korgath,447,warlock,destruction,16,5,11
illidan,432,warlock,destruction,13,7,6
tichondrius,431,warlock,destruction,11,5,6
moon-guard,431,warlock,destruction,11,5,6
tichondrius,425,warlock,destruction,15,7,8
garrosh,416,warlock,destruction,10,5,5
silvermoon,384,warlock,destruction,6,4,2
nemesis,384,warlock,destruction,6,4,2
stormrage,384,warlock,destruction,6,4,2
stormrage,384,warlock,destruction,6,4,2
stormrage,384,warlock,destruction,6,4,2
ravencrest,384,warlock,destruction,6,4,2
magtheridon,384,warlock,destruction,6,4,2
eredar,384,warlock,destruction,6,4,2
sargeras,384,warlock,destruction,6,4,2
thrall,384,warlock,destruction,6,4,2
stormreaver,384,warlock,destruction,6,4,2
tichondrius,384,warlock,destruction,6,4,2
zuljin,384,warlock,destruction,6,4,2
zuljin,384,warlock,destruction,6,4,2
sargeras,384,warlock,destruction,6,4,2
wildhammer,384,warlock,destruction,6,4,2
stormrage,384,warlock,destruction,6,4,2
zuljin,384,warlock,destruction,6,4,2
moon-guard,384,warlock,destruction,6,4,2
blackhand,384,warlock,destruction,6,4,2
sargeras,384,warlock,destruction,6,4,2
area-52,384,warlock,destruction,6,4,2
tichondrius,384,warlock,destruction,6,4,2
tichondrius,384,warlock,destruction,6,4,2
sargeras,384,warlock,destruction,6,4,2
quelthalas,384,warlock,destruction,6,4,2
sargeras,384,warlock,destruction,6,4,2
tichondrius,384,warlock,destruction,6,4,2
bleeding-hollow,384,warlock,destruction,6,4,2
quelthalas,384,warlock,destruction,6,4,2
tichondrius,384,warlock,destruction,6,4,2
tichondrius,384,warlock,destruction,6,4,2
illidan,384,warlock,destruction,6,4,2
azjolnerub,384,warlock,destruction,6,4,2
bleeding-hollow,384,warlock,destruction,6,4,2
moon-guard,384,warlock,destruction,6,4,2
tichondrius,384,warlock,destruction,6,4,2
illidan,384,warlock,destruction,6,4,2
bleeding-hollow,384,warlock,destruction,6,4,2
tichondrius,384,warlock,destruction,6,4,2
tichondrius,384,warlock,destruction,6,4,2
tichondrius,384,warlock,destruction,6,4,2
chogall,384,warlock,destruction,6,4,2
frostmourne,384,warlock,destruction,6,4,2
tichondrius,384,warlock,destruction,6,4,2
tichondrius,384,warlock,destruction,6,4,2
blackwing-lair,384,warlock,destruction,6,4,2
tichondrius,384,warlock,destruction,6,4,2
tichondrius,384,warlock,destruction,6,4,2
azralon,384,warlock,destruction,6,4,2
tichondrius,384,warlock,destruction,6,4,2
quelthalas,384,warlock,destruction,6,4,2
area-52,384,warlock,destruction,6,4,2
magtheridon,384,warlock,destruction,6,4,2
tichondrius,384,warlock,destruction,6,4,2
scarlet-crusade,384,warlock,destruction,6,4,2
the-scryers,384,warlock,destruction,6,4,2
sargeras,384,warlock,destruction,6,4,2
illidan,384,warlock,destruction,6,4,2
quelthalas,384,warlock,destruction,6,4,2
shuhalo,384,warlock,destruction,6,4,2
frostmourne,384,warlock,destruction,6,4,2
tichondrius,384,warlock,destruction,6,4,2
tichondrius,384,warlock,destruction,6,4,2
sargeras,384,warlock,destruction,6,4,2
area-52,384,warlock,destruction,6,4,2
quelthalas,384,warlock,destruction,6,4,2
illidan,384,warlock,destruction,6,4,2
tichondrius,384,warlock,destruction,6,4,2
sargeras,384,warlock,destruction,6,4,2
illidan,384,warlock,destruction,6,4,2
burning-blade,384,warlock,destruction,6,4,2
area-52,384,warlock,destruction,6,4,2
hyjal,384,warlock,destruction,6,4,2
burning-blade,384,warlock,destruction,6,4,2
emerald-dream,384,warlock,destruction,6,4,2
illidan,384,warlock,destruction,6,4,2
maiev,384,warlock,destruction,6,4,2
emerald-dream,384,warlock,destruction,6,4,2
aegwynn,384,warlock,destruction,6,4,2
moon-guard,384,warlock,destruction,6,4,2
moon-guard,384,warlock,destruction,6,4,2
winterhoof,384,warlock,destruction,6,4,2
tichondrius,384,warlock,destruction,6,4,2
winterhoof,384,warlock,destruction,6,4,2
tichondrius,384,warlock,destruction,6,4,2
deathwing,384,warlock,destruction,6,4,2
illidan,384,warlock,destruction,6,4,2
malganis,384,warlock,destruction,6,4,2
malganis,384,warlock,destruction,6,4,2
emerald-dream,384,warlock,destruction,6,4,2
tichondrius,384,warlock,destruction,6,4,2
area-52,384,warlock,destruction,6,4,2
malganis,384,warlock,destruction,6,4,2
darkspear,384,warlock,destruction,6,4,2
azralon,384,warlock,destruction,6,4,2
kiljaeden,384,warlock,destruction,6,4,2
eonar,384,warlock,destruction,6,4,2
zuluhed,384,warlock,destruction,6,4,2
malganis,384,warlock,destruction,6,4,2
proudmoore,384,warlock,destruction,6,4,2
tichondrius,384,warlock,destruction,6,4,2
the-venture-co,384,warlock,destruction,6,4,2
kelthuzad,384,warlock,destruction,6,4,2
dalaran,384,warlock,destruction,6,4,2
dalaran,384,warlock,destruction,6,4,2
tichondrius,384,warlock,destruction,6,4,2
darkspear,384,warlock,destruction,6,4,2
kelthuzad,384,warlock,destruction,6,4,2
mugthol,384,warlock,destruction,6,4,2
amanthul,384,warlock,destruction,6,4,2
stormrage,384,warlock,destruction,9,5,4
stormrage,384,warlock,destruction,12,4,8
fizzcrank,384,warlock,destruction,12,4,8
agamaggan,384,warlock,destruction,12,4,8
azralon,384,warlock,destruction,12,4,8
frostwolf,384,warlock,destruction,12,4,8
khaz-modan,384,warlock,destruction,12,4,8
illidan,384,warlock,destruction,12,4,8
frostwolf,384,warlock,destruction,12,4,8
illidan,384,warlock,destruction,12,4,8
moon-guard,384,warlock,destruction,12,4,8
zuljin,384,warlock,destruction,12,4,8
magtheridon,384,warlock,destruction,12,4,8
frostmourne,384,warlock,destruction,12,4,8
sargeras,384,warlock,destruction,12,4,8
frostwolf,384,warlock,destruction,12,4,8
kiljaeden,384,warlock,destruction,12,4,8
area-52,384,warlock,destruction,12,4,8
hyjal,384,warlock,destruction,12,4,8
area-52,384,warlock,destruction,12,4,8
stormrage,384,warlock,destruction,12,4,8
quelthalas,384,warlock,destruction,12,4,8
tichondrius,384,warlock,destruction,12,4,8
malganis,384,warlock,destruction,12,4,8
malganis,384,warlock,destruction,12,4,8
ragnaros,384,warlock,destruction,12,4,8
gorefiend,384,warlock,destruction,12,4,8
malganis,384,warlock,destruction,18,4,14
shattered-hand,384,warlock,destruction,18,4,14
dalaran,384,warlock,destruction,18,4,14
tichondrius,383,warlock,destruction,6,4,2
frostmourne,383,warlock,destruction,6,4,2
nathrezim,383,warlock,destruction,6,4,2
drakkari,383,warlock,destruction,12,4,8
tichondrius,383,warlock,destruction,12,4,8
stormrage,383,warlock,destruction,12,4,8
uldum,382,warlock,destruction,6,4,2
thrall,382,warlock,destruction,18,4,14
khadgar,367,warlock,destruction,9,5,4
frostmourne,367,warlock,destruction,11,4,7
ragnaros,351,warlock,destruction,11,4,7
proudmoore,351,warlock,destruction,11,4,7
moknathal,349,warlock,destruction,13,5,8
dalaran,330,warlock,destruction,9,7,2
darkspear,330,warlock,destruction,7,5,2
malganis,330,warlock,destruction,11,6,5
quelthalas,330,warlock,destruction,11,6,5
sargeras,320,warlock,destruction,10,4,6
area-52,319,warlock,destruction,5,4,1
bleeding-hollow,319,warlock,destruction,5,4,1
cenarius,304,warlock,destruction,7,4,3
gorefiend,288,warlock,destruction,6,3,3
ragnaros,288,warlock,destruction,6,3,3
quelthalas,288,warlock,destruction,6,3,3
sargeras,288,warlock,destruction,6,3,3
nagrand,288,warlock,destruction,6,3,3
ghostlands,288,warlock,destruction,6,3,3
ragnaros,288,warlock,destruction,6,3,3
destromath,288,warlock,destruction,6,3,3
ragnaros,288,warlock,destruction,6,3,3
malganis,288,warlock,destruction,6,3,3
the-forgotten-coast,288,warlock,destruction,6,3,3
trollbane,288,warlock,destruction,6,3,3
malganis,288,warlock,destruction,6,3,3
malganis,288,warlock,destruction,6,3,3
illidan,288,warlock,destruction,6,3,3
kelthuzad,288,warlock,destruction,6,3,3
illidan,288,warlock,destruction,6,3,3
aerie-peak,288,warlock,destruction,6,3,3
warsong,288,warlock,destruction,6,3,3
kelthuzad,288,warlock,destruction,6,3,3
anvilmar,288,warlock,destruction,6,3,3
vashj,288,warlock,destruction,6,3,3
malygos,288,warlock,destruction,6,3,3
frostmourne,288,warlock,destruction,6,3,3
skullcrusher,288,warlock,destruction,6,3,3
kelthuzad,288,warlock,destruction,6,3,3
thrall,288,warlock,destruction,6,3,3
area-52,288,warlock,destruction,6,3,3
illidan,288,warlock,destruction,6,3,3
wyrmrest-accord,288,warlock,destruction,6,3,3
barthilas,288,warlock,destruction,6,3,3
darkspear,288,warlock,destruction,6,3,3
stormscale,288,warlock,destruction,6,3,3
tichondrius,288,warlock,destruction,6,3,3
illidan,288,warlock,destruction,6,3,3
frostmourne,288,warlock,destruction,6,3,3
bleeding-hollow,288,warlock,destruction,6,3,3
tichondrius,288,warlock,destruction,6,3,3
tichondrius,288,warlock,destruction,6,3,3
tichondrius,288,warlock,destruction,6,3,3
blackwater-raiders,288,warlock,destruction,6,3,3
area-52,288,warlock,destruction,6,3,3
illidan,288,warlock,destruction,6,3,3
thrall,288,warlock,destruction,6,3,3
tichondrius,288,warlock,destruction,6,3,3
area-52,288,warlock,destruction,6,3,3
area-52,288,warlock,destruction,6,3,3
frostmourne,288,warlock,destruction,6,3,3
ysera,288,warlock,destruction,6,3,3
arthas,288,warlock,destruction,6,3,3
illidan,288,warlock,destruction,6,3,3
stormrage,288,warlock,destruction,6,3,3
medivh,288,warlock,destruction,6,3,3
darkspear,288,warlock,destruction,6,3,3
bleeding-hollow,288,warlock,destruction,6,3,3
bleeding-hollow,288,warlock,destruction,6,3,3
nemesis,288,warlock,destruction,6,3,3
illidan,288,warlock,destruction,6,3,3
vashj,288,warlock,destruction,6,3,3
illidan,288,warlock,destruction,6,3,3
bleeding-hollow,288,warlock,destruction,6,3,3
frostmourne,288,warlock,destruction,6,3,3
area-52,288,warlock,destruction,6,3,3
tichondrius,288,warlock,destruction,6,3,3
bleeding-hollow,288,warlock,destruction,6,3,3
illidan,288,warlock,destruction,6,3,3
bleeding-hollow,288,warlock,destruction,6,3,3
bleeding-hollow,288,warlock,destruction,6,3,3
tichondrius,288,warlock,destruction,6,3,3
tichondrius,288,warlock,destruction,6,3,3
goldrinn,288,warlock,destruction,6,3,3
frostmourne,288,warlock,destruction,6,3,3
frostmourne,288,warlock,destruction,6,3,3
proudmoore,288,warlock,destruction,6,3,3
tichondrius,288,warlock,destruction,6,3,3
tichondrius,288,warlock,destruction,6,3,3
tichondrius,288,warlock,destruction,6,3,3
blackhand,288,warlock,destruction,6,3,3
tichondrius,288,warlock,destruction,6,3,3
tichondrius,288,warlock,destruction,6,3,3
tichondrius,288,warlock,destruction,6,3,3
azuremyst,288,warlock,destruction,6,3,3
tichondrius,288,warlock,destruction,6,3,3
stormreaver,288,warlock,destruction,6,3,3
staghelm,288,warlock,destruction,6,3,3
moon-guard,288,warlock,destruction,6,3,3
kalecgos,288,warlock,destruction,6,3,3
queldorei,288,warlock,destruction,6,3,3
terokkar,288,warlock,destruction,6,3,3
tichondrius,288,warlock,destruction,6,3,3
sargeras,288,warlock,destruction,6,3,3
stormrage,288,warlock,destruction,6,3,3
galakrond,288,warlock,destruction,6,3,3
malganis,288,warlock,destruction,6,3,3
proudmoore,288,warlock,destruction,6,3,3
emerald-dream,288,warlock,destruction,6,3,3
moon-guard,288,warlock,destruction,6,3,3
sargeras,288,warlock,destruction,6,3,3
tichondrius,288,warlock,destruction,6,3,3
tichondrius,288,warlock,destruction,6,3,3
moon-guard,288,warlock,destruction,6,3,3
darkspear,288,warlock,destruction,6,3,3
kiljaeden,288,warlock,destruction,6,3,3
tichondrius,288,warlock,destruction,6,3,3
stormrage,288,warlock,destruction,6,3,3
tichondrius,288,warlock,destruction,6,3,3
kiljaeden,288,warlock,destruction,6,3,3
kiljaeden,288,warlock,destruction,6,3,3
stormrage,288,warlock,destruction,6,3,3
sargeras,288,warlock,destruction,6,3,3
tichondrius,288,warlock,destruction,6,3,3
thrall,288,warlock,destruction,16,4,12
bonechewer,288,warlock,destruction,12,3,9
kiljaeden,288,warlock,destruction,12,3,9
dreadmaul,288,warlock,destruction,12,3,9
sargeras,288,warlock,destruction,12,3,9
zuljin,288,warlock,destruction,12,3,9
malganis,288,warlock,destruction,12,3,9
auchindoun,288,warlock,destruction,12,3,9
tichondrius,288,warlock,destruction,12,3,9
misha,287,warlock,destruction,6,3,3
frostmane,287,warlock,destruction,6,3,3
sargeras,287,warlock,destruction,6,3,3
frostmourne,287,warlock,destruction,6,3,3
sargeras,287,warlock,destruction,6,3,3
jubeithos,287,warlock,destruction,12,5,7
tichondrius,287,warlock,destruction,12,3,9
gorefiend,287,warlock,destruction,18,3,15
area-52,286,warlock,destruction,6,3,3
tichondrius,271,warlock,destruction,11,3,8
tichondrius,255,warlock,destruction,11,3,8
moon-guard,250,warlock,destruction,7,5,2
aegwynn,239,warlock,destruction,5,3,2
thrall,224,warlock,destruction,10,3,7
proudmoore,192,warlock,destruction,4,3,1
lightbringer,192,warlock,destruction,4,3,1
altar-of-storms,192,warlock,destruction,4,3,1
proudmoore,192,warlock,destruction,6,2,4
malganis,192,warlock,destruction,6,2,4
malganis,192,warlock,destruction,6,2,4
stormrage,192,warlock,destruction,6,2,4
tichondrius,192,warlock,destruction,6,2,4
tichondrius,192,warlock,destruction,6,2,4
dark-iron,192,warlock,destruction,6,2,4
moon-guard,192,warlock,destruction,6,2,4
proudmoore,192,warlock,destruction,6,2,4
quelthalas,192,warlock,destruction,6,2,4
illidan,192,warlock,destruction,6,2,4
tichondrius,192,warlock,destruction,6,2,4
malganis,192,warlock,destruction,6,2,4
ravenholdt,192,warlock,destruction,6,2,4
kelthuzad,192,warlock,destruction,6,2,4
quelthalas,192,warlock,destruction,6,2,4
azralon,192,warlock,destruction,6,2,4
azralon,192,warlock,destruction,6,2,4
sargeras,192,warlock,destruction,6,2,4
aggramar,192,warlock,destruction,6,2,4
tichondrius,192,warlock,destruction,6,2,4
moon-guard,192,warlock,destruction,6,2,4
nemesis,192,warlock,destruction,6,2,4
korialstrasz,192,warlock,destruction,6,2,4
burning-blade,192,warlock,destruction,6,2,4
tichondrius,192,warlock,destruction,6,2,4
arygos,192,warlock,destruction,6,2,4
emerald-dream,192,warlock,destruction,6,2,4
sargeras,192,warlock,destruction,6,2,4
tichondrius,192,warlock,destruction,6,2,4
illidan,192,warlock,destruction,6,2,4
zuljin,192,warlock,destruction,6,2,4
malganis,192,warlock,destruction,6,2,4
whisperwind,192,warlock,destruction,6,2,4
daggerspine,192,warlock,destruction,6,2,4
area-52,192,warlock,destruction,6,2,4
tichondrius,192,warlock,destruction,6,2,4
stormrage,192,warlock,destruction,6,2,4
frostmourne,192,warlock,destruction,6,2,4
arathor,192,warlock,destruction,6,2,4
tichondrius,192,warlock,destruction,6,2,4
anubarak,192,warlock,destruction,6,2,4
tichondrius,192,warlock,destruction,6,2,4
zuljin,192,warlock,destruction,6,2,4
tichondrius,192,warlock,destruction,6,2,4
stormrage,192,warlock,destruction,6,2,4
area-52,192,warlock,destruction,6,2,4
hyjal,192,warlock,destruction,6,2,4
the-underbog,192,warlock,destruction,6,2,4
illidan,192,warlock,destruction,6,2,4
illidan,192,warlock,destruction,6,2,4
tichondrius,192,warlock,destruction,6,2,4
tichondrius,192,warlock,destruction,6,2,4
uldaman,192,warlock,destruction,6,2,4
tichondrius,192,warlock,destruction,6,2,4
thrall,192,warlock,destruction,6,2,4
illidan,192,warlock,destruction,6,2,4
tichondrius,192,warlock,destruction,6,2,4
spirestone,192,warlock,destruction,6,2,4
frostmourne,192,warlock,destruction,6,2,4
korgath,192,warlock,destruction,6,2,4
bleeding-hollow,192,warlock,destruction,6,2,4
nemesis,192,warlock,destruction,6,2,4
azjolnerub,192,warlock,destruction,6,2,4
frostmourne,192,warlock,destruction,6,2,4
sargeras,192,warlock,destruction,6,2,4
bleeding-hollow,192,warlock,destruction,6,2,4
tichondrius,192,warlock,destruction,6,2,4
sargeras,192,warlock,destruction,6,2,4
moon-guard,192,warlock,destruction,6,2,4
wyrmrest-accord,192,warlock,destruction,6,2,4
moon-guard,192,warlock,destruction,6,2,4
malganis,192,warlock,destruction,6,2,4
nagrand,192,warlock,destruction,6,2,4
azralon,192,warlock,destruction,6,2,4
turalyon,192,warlock,destruction,6,2,4
wyrmrest-accord,192,warlock,destruction,6,2,4
silvermoon,192,warlock,destruction,6,2,4
sargeras,192,warlock,destruction,6,2,4
sargeras,192,warlock,destruction,6,2,4
sargeras,192,warlock,destruction,6,2,4
darkspear,192,warlock,destruction,6,2,4
thrall,192,warlock,destruction,9,2,7
lothar,192,warlock,destruction,12,2,10
nemesis,192,warlock,destruction,12,2,10
arthas,192,warlock,destruction,12,2,10
illidan,192,warlock,destruction,12,2,10
tichondrius,192,warlock,destruction,12,2,10
aerie-peak,191,warlock,destruction,6,2,4
spirestone,191,warlock,destruction,6,2,4
tichondrius,159,warlock,destruction,5,2,3
illidan,159,warlock,destruction,5,2,3
stormrage,159,warlock,destruction,5,2,3
nagrand,159,warlock,destruction,5,2,3
hyjal,159,warlock,destruction,5,2,3
sargeras,138,warlock,destruction,9,3,6
tichondrius,128,warlock,destruction,4,2,2
zuljin,96,warlock,destruction,3,2,1
zuljin,96,warlock,destruction,3,2,1
quelthalas,96,warlock,destruction,3,2,1
tichondrius,96,warlock,destruction,3,2,1
stormscale,96,warlock,destruction,3,2,1
terenas,96,warlock,destruction,6,1,5
ragnaros,96,warlock,destruction,6,1,5
moon-guard,96,warlock,destruction,6,1,5
sargeras,96,warlock,destruction,6,1,5
wyrmrest-accord,96,warlock,destruction,6,1,5
hakkar,96,warlock,destruction,6,1,5
silver-hand,96,warlock,destruction,6,1,5
kiljaeden,96,warlock,destruction,6,1,5
sargeras,96,warlock,destruction,6,1,5
thunderhorn,96,warlock,destruction,6,1,5
moon-guard,96,warlock,destruction,6,1,5
quelthalas,96,warlock,destruction,6,1,5
proudmoore,96,warlock,destruction,6,1,5
eldrethalas,96,warlock,destruction,6,1,5
tichondrius,96,warlock,destruction,6,1,5
emerald-dream,96,warlock,destruction,6,1,5
tichondrius,96,warlock,destruction,6,1,5
lethon,96,warlock,destruction,6,1,5
tichondrius,96,warlock,destruction,6,1,5
tichondrius,96,warlock,destruction,6,1,5
tichondrius,96,warlock,destruction,6,1,5
tichondrius,96,warlock,destruction,6,1,5
frostmourne,96,warlock,destruction,6,1,5
tichondrius,96,warlock,destruction,6,1,5
stormscale,96,warlock,destruction,6,1,5
whisperwind,96,warlock,destruction,6,1,5
blackhand,96,warlock,destruction,6,1,5
frostmourne,96,warlock,destruction,6,1,5
earthen-ring,96,warlock,destruction,6,1,5
stormrage,96,warlock,destruction,6,1,5
mannoroth,96,warlock,destruction,6,1,5
stormrage,96,warlock,destruction,6,1,5
stormrage,96,warlock,destruction,6,1,5
nagrand,96,warlock,destruction,6,1,5
stormrage,96,warlock,destruction,6,1,5
malganis,96,warlock,destruction,6,1,5
kelthuzad,96,warlock,destruction,6,1,5
dragonmaw,96,warlock,destruction,6,1,5
area-52,96,warlock,destruction,6,1,5
area-52,96,warlock,destruction,6,1,5
bleeding-hollow,96,warlock,destruction,6,1,5
illidan,96,warlock,destruction,6,1,5
area-52,96,warlock,destruction,6,1,5
zuljin,96,warlock,destruction,6,1,5
illidan,96,warlock,destruction,6,1,5
anetheron,96,warlock,destruction,6,1,5
bleeding-hollow,96,warlock,destruction,6,1,5
ragnaros,96,warlock,destruction,6,1,5
bleeding-hollow,96,warlock,destruction,6,1,5
drakkari,96,warlock,destruction,6,1,5
area-52,96,warlock,destruction,7,1,6
cenarius,96,warlock,destruction,8,1,7
vashj,79,warlock,destruction,5,1,4
proudmoore,79,warlock,destruction,11,1,10
azjolnerub,64,warlock,destruction,4,1,3
tichondrius,48,warlock,destruction,3,1,2
zuljin,48,warlock,destruction,3,1,2
spirestone,42,warlock,destruction,9,2,7
frostmourne,31,warlock,destruction,2,1,1
stormrage,31,warlock,destruction,2,1,1
burning-legion,16,warlock,destruction,1,1,0
tichondrius,2121,warrior,fury,77,41,36
frostmane,2114,warrior,fury,72,43,29
stormrage,2105,warrior,fury,92,53,39
moon-guard,2011,warrior,fury,133,70,63
wyrmrest-accord,1996,warrior,fury,72,33,39
ragnaros,1967,warrior,fury,57,41,16
bleeding-hollow,1959,warrior,fury,68,35,33
tichondrius,1904,warrior,fury,150,79,71
drakkari,1886,warrior,fury,89,40,49
goldrinn,1874,warrior,fury,72,40,32
kelthuzad,1851,warrior,fury,59,32,27
area-52,1846,warrior,fury,54,27,27
tichondrius,1839,warrior,fury,48,28,20
proudmoore,1834,warrior,fury,83,52,31
sargeras,1830,warrior,fury,67,37,30
tichondrius,1828,warrior,fury,66,37,29
frostmourne,1825,warrior,fury,116,74,42
tichondrius,1824,warrior,fury,54,35,19
stormrage,1824,warrior,fury,63,31,32
tichondrius,1820,warrior,fury,53,28,25
quelthalas,1820,warrior,fury,42,22,20
tichondrius,1820,warrior,fury,78,40,38
moon-guard,1818,warrior,fury,110,64,46
sargeras,1816,warrior,fury,30,20,10
frostmourne,1815,warrior,fury,66,37,29
proudmoore,1813,warrior,fury,54,30,24
azralon,1810,warrior,fury,46,28,18
barthilas,1810,warrior,fury,102,60,42
sargeras,1807,warrior,fury,42,23,19
illidan,1805,warrior,fury,51,32,19
wyrmrest-accord,1805,warrior,fury,76,43,33
area-52,1803,warrior,fury,58,31,27
tichondrius,1802,warrior,fury,90,59,31
malganis,1802,warrior,fury,75,40,35
bleeding-hollow,1797,warrior,fury,84,48,36
area-52,1783,warrior,fury,49,25,24
illidan,1781,warrior,fury,60,28,32
tichondrius,1779,warrior,fury,53,29,24
malganis,1775,warrior,fury,39,23,16
kul-tiras,1766,warrior,fury,59,31,28
area-52,1763,warrior,fury,36,24,12
frostmourne,1763,warrior,fury,85,50,35
proudmoore,1761,warrior,fury,36,24,12
moon-guard,1753,warrior,fury,66,39,27
moon-guard,1728,warrior,fury,25,19,6
wyrmrest-accord,1725,warrior,fury,69,30,39
thrall,1718,warrior,fury,42,22,20
bleeding-hollow,1717,warrior,fury,40,25,15
sargeras,1705,warrior,fury,96,51,45
tichondrius,1698,warrior,fury,30,20,10
sargeras,1696,warrior,fury,51,32,19
moon-guard,1696,warrior,fury,97,49,48
azshara,1693,warrior,fury,42,24,18
area-52,1692,warrior,fury,36,21,15
tichondrius,1691,warrior,fury,54,23,31
agamaggan,1683,warrior,fury,81,49,32
stormrage,1682,warrior,fury,101,51,50
area-52,1680,warrior,fury,55,24,31
moon-guard,1675,warrior,fury,102,56,46
ragnaros,1673,warrior,fury,55,25,30
quelthalas,1667,warrior,fury,67,36,31
stormrage,1665,warrior,fury,66,40,26
sargeras,1651,warrior,fury,43,23,20
wyrmrest-accord,1649,warrior,fury,156,80,76
moon-guard,1644,warrior,fury,72,46,26
ragnaros,1641,warrior,fury,156,82,74
scarlet-crusade,1640,warrior,fury,42,24,18
stormrage,1640,warrior,fury,58,31,27
moon-guard,1634,warrior,fury,93,44,49
dragonmaw,1631,warrior,fury,49,31,18
tichondrius,1623,warrior,fury,64,32,32
elune,1619,warrior,fury,71,42,29
bleeding-hollow,1613,warrior,fury,44,24,20
moon-guard,1608,warrior,fury,48,25,23
tichondrius,1606,warrior,fury,36,20,16
emerald-dream,1605,warrior,fury,60,35,25
sargeras,1604,warrior,fury,42,28,14
stormrage,1603,warrior,fury,45,23,22
stonemaul,1602,warrior,fury,36,20,16
moon-guard,1601,warrior,fury,42,21,21
quelthalas,1596,warrior,fury,41,21,20
sargeras,1594,warrior,fury,91,49,42
tichondrius,1592,warrior,fury,59,30,29
malganis,1585,warrior,fury,36,20,16
bleeding-hollow,1585,warrior,fury,46,25,21
sargeras,1581,warrior,fury,40,23,17
thunderhorn,1580,warrior,fury,42,20,22
dalaran,1579,warrior,fury,30,19,11
drakkari,1574,warrior,fury,36,21,15
frostmourne,1570,warrior,fury,60,30,30
sargeras,1569,warrior,fury,40,22,18
thaurissan,1569,warrior,fury,42,21,21
trollbane,1559,warrior,fury,67,37,30
proudmoore,1552,warrior,fury,30,17,13
anetheron,1551,warrior,fury,35,17,18
sargeras,1548,warrior,fury,83,48,35
sargeras,1546,warrior,fury,116,64,52
ragnaros,1544,warrior,fury,87,40,47
illidan,1528,warrior,fury,24,16,8
moon-guard,1522,warrior,fury,30,16,14
mannoroth,1520,warrior,fury,132,75,57
drakkari,1520,warrior,fury,135,71,64
garrosh,1520,warrior,fury,36,17,19
wildhammer,1518,warrior,fury,72,32,40
moon-guard,1517,warrior,fury,59,34,25
tichondrius,1514,warrior,fury,30,17,13
area-52,1514,warrior,fury,83,37,46
area-52,1512,warrior,fury,24,16,8
sargeras,1511,warrior,fury,30,18,12
frostwolf,1503,warrior,fury,51,27,24
moon-guard,1499,warrior,fury,59,29,30
zuljin,1499,warrior,fury,36,16,20
moon-guard,1495,warrior,fury,64,34,30
madoran,1489,warrior,fury,78,43,35
azralon,1488,warrior,fury,74,37,37
spirestone,1485,warrior,fury,24,16,8
saurfang,1480,warrior,fury,81,44,37
velen,1474,warrior,fury,58,31,27
kelthuzad,1473,warrior,fury,36,20,16
stormrage,1472,warrior,fury,36,21,15
stormrage,1455,warrior,fury,42,26,16
stormrage,1454,warrior,fury,29,19,10
tichondrius,1449,warrior,fury,32,19,13
haomarush,1436,warrior,fury,36,20,16
azralon,1433,warrior,fury,36,17,19
eitrigg,1428,warrior,fury,42,27,15
amanthul,1428,warrior,fury,39,19,20
wyrmrest-accord,1428,warrior,fury,94,42,52
moon-guard,1425,warrior,fury,48,25,23
stormrage,1425,warrior,fury,60,25,35
anetheron,1423,warrior,fury,27,17,10
thunderhorn,1421,warrior,fury,24,15,9
illidan,1418,warrior,fury,47,27,20
skullcrusher,1415,warrior,fury,60,32,28
tichondrius,1409,warrior,fury,72,35,37
area-52,1404,warrior,fury,60,25,35
zuljin,1400,warrior,fury,30,15,15
illidan,1395,warrior,fury,62,26,36
wyrmrest-accord,1394,warrior,fury,18,15,3
blades-edge,1392,warrior,fury,65,33,32
azralon,1391,warrior,fury,54,27,27
tichondrius,1390,warrior,fury,66,35,31
vashj,1383,warrior,fury,35,16,19
sargeras,1382,warrior,fury,35,17,18
moon-guard,1380,warrior,fury,33,19,14
ysondre,1377,warrior,fury,36,17,19
stormrage,1375,warrior,fury,46,29,17
tichondrius,1369,warrior,fury,24,15,9
area-52,1369,warrior,fury,36,21,15
ragnaros,1365,warrior,fury,78,39,39
bleeding-hollow,1360,warrior,fury,24,16,8
malygos,1360,warrior,fury,141,74,67
tichondrius,1357,warrior,fury,68,39,29
area-52,1354,warrior,fury,45,22,23
jubeithos,1347,warrior,fury,56,24,32
stormrage,1325,warrior,fury,83,38,45
azralon,1324,warrior,fury,47,23,24
ragnaros,1321,warrior,fury,66,32,34
bonechewer,1319,warrior,fury,65,32,33
kelthuzad,1318,warrior,fury,36,16,20
tichondrius,1307,warrior,fury,23,14,9
whisperwind,1298,warrior,fury,30,14,16
ragnaros,1296,warrior,fury,34,20,14
kelthuzad,1296,warrior,fury,76,40,36
kelthuzad,1295,warrior,fury,42,23,19
khazgoroth,1295,warrior,fury,91,44,47
illidan,1292,warrior,fury,24,15,9
earthen-ring,1287,warrior,fury,36,21,15
frostmourne,1285,warrior,fury,30,16,14
stormrage,1285,warrior,fury,36,19,17
proudmoore,1284,warrior,fury,30,17,13
lightbringer,1280,warrior,fury,91,47,44
silvermoon,1271,warrior,fury,42,21,21
lightbringer,1269,warrior,fury,60,31,29
tichondrius,1267,warrior,fury,26,14,12
stormrage,1255,warrior,fury,98,43,55
moon-guard,1250,warrior,fury,30,18,12
aerie-peak,1249,warrior,fury,48,29,19
tichondrius,1247,warrior,fury,18,13,5
turalyon,1244,warrior,fury,24,16,8
bleeding-hollow,1243,warrior,fury,24,13,11
kirin-tor,1237,warrior,fury,24,13,11
quelthalas,1223,warrior,fury,30,19,11
area-52,1223,warrior,fury,30,16,14
moon-guard,1221,warrior,fury,32,14,18
khazgoroth,1221,warrior,fury,46,18,28
zuljin,1216,warrior,fury,24,13,11
illidan,1215,warrior,fury,36,17,19
stormrage,1213,warrior,fury,42,19,23
ragnaros,1205,warrior,fury,51,26,25
hyjal,1198,warrior,fury,54,21,33
tichondrius,1174,warrior,fury,47,19,28
skywall,1161,warrior,fury,24,18,6
kelthuzad,1151,warrior,fury,24,12,12
tichondrius,1150,warrior,fury,18,12,6
tichondrius,1150,warrior,fury,24,12,12
tichondrius,1150,warrior,fury,24,12,12
azralon,1148,warrior,fury,18,12,6
quelthalas,1147,warrior,fury,24,12,12
frostmourne,1146,warrior,fury,30,12,18
sargeras,1145,warrior,fury,22,13,9
ragnaros,1143,warrior,fury,28,13,15
proudmoore,1140,warrior,fury,24,12,12
shattered-hand,1139,warrior,fury,24,12,12
tichondrius,1138,warrior,fury,24,12,12
stormrage,1138,warrior,fury,30,12,18
quelthalas,1135,warrior,fury,18,12,6
bleeding-hollow,1134,warrior,fury,18,14,4
ragnaros,1132,warrior,fury,24,12,12
shadowsong,1125,warrior,fury,18,12,6
hellscream,1117,warrior,fury,62,31,31
ragnaros,1111,warrior,fury,25,15,10
thrall,1107,warrior,fury,36,19,17
frostmourne,1107,warrior,fury,24,12,12
kiljaeden,1103,warrior,fury,39,24,15
kelthuzad,1097,warrior,fury,24,14,10
tichondrius,1078,warrior,fury,59,29,30
kaelthas,1075,warrior,fury,17,12,5
emerald-dream,1055,warrior,fury,18,11,7
alterac-mountains,1055,warrior,fury,18,11,7
nesingwary,1055,warrior,fury,18,11,7
emerald-dream,1055,warrior,fury,18,11,7
quelthalas,1054,warrior,fury,18,11,7
ragnaros,1053,warrior,fury,18,11,7
kelthuzad,1053,warrior,fury,18,11,7
gallywix,1053,warrior,fury,64,34,30
quelthalas,1047,warrior,fury,18,11,7
nemesis,1041,warrior,fury,42,16,26
draktharon,1015,warrior,fury,65,26,39
tichondrius,1010,warrior,fury,24,13,11
moon-guard,1008,warrior,fury,78,37,41
nemesis,1005,warrior,fury,17,11,6
thaurissan,1001,warrior,fury,29,12,17
tichondrius,990,warrior,fury,20,11,9
dark-iron,987,warrior,fury,26,11,15
sargeras,976,warrior,fury,19,11,8
moon-guard,960,warrior,fury,12,10,2
tichondrius,960,warrior,fury,18,10,8
anubarak,960,warrior,fury,90,45,45
khazgoroth,958,warrior,fury,18,10,8
azralon,958,warrior,fury,24,10,14
zangarmarsh,957,warrior,fury,18,10,8
area-52,957,warrior,fury,18,10,8
ragnaros,957,warrior,fury,18,10,8
dalaran,957,warrior,fury,21,10,11
azralon,926,warrior,fury,24,12,12
malygos,925,warrior,fury,20,11,9
turalyon,918,warrior,fury,72,25,47
ragnaros,910,warrior,fury,17,10,7
skullcrusher,910,warrior,fury,89,43,46
aerie-peak,908,warrior,fury,17,10,7
kilrogg,898,warrior,fury,33,10,23
illidan,896,warrior,fury,22,10,12
nemesis,894,warrior,fury,17,10,7
zuljin,892,warrior,fury,18,11,7
zuljin,864,warrior,fury,12,9,3
illidan,864,warrior,fury,18,9,9
quelthalas,864,warrior,fury,18,9,9
lightbringer,863,warrior,fury,12,9,3
kaelthas,863,warrior,fury,12,9,3
sargeras,863,warrior,fury,18,9,9
stormrage,863,warrior,fury,18,9,9
dalaran,863,warrior,fury,18,9,9
queldorei,863,warrior,fury,24,9,15
thrall,862,warrior,fury,18,9,9
area-52,862,warrior,fury,18,9,9
illidan,862,warrior,fury,24,9,15
ragnaros,862,warrior,fury,24,9,15
trollbane,860,warrior,fury,12,9,3
tichondrius,860,warrior,fury,18,9,9
burning-blade,860,warrior,fury,18,9,9
shattered-hand,859,warrior,fury,24,9,15
proudmoore,858,warrior,fury,18,9,9
tichondrius,854,warrior,fury,22,9,13
bleeding-hollow,845,warrior,fury,23,9,14
boulderfist,836,warrior,fury,19,10,9
illidan,830,warrior,fury,17,9,8
zuljin,825,warrior,fury,24,9,15
kelthuzad,816,warrior,fury,15,10,5
nemesis,770,warrior,fury,24,9,15
sargeras,768,warrior,fury,12,8,4
frostmourne,768,warrior,fury,12,8,4
moon-guard,768,warrior,fury,12,8,4
dethecus,768,warrior,fury,12,8,4
tichondrius,768,warrior,fury,18,8,10
bonechewer,768,warrior,fury,18,8,10
sargeras,768,warrior,fury,18,8,10
shattered-hand,768,warrior,fury,18,8,10
frostmourne,768,warrior,fury,24,8,16
tichondrius,767,warrior,fury,12,8,4
emerald-dream,767,warrior,fury,12,8,4
malganis,767,warrior,fury,12,8,4
frostmourne,767,warrior,fury,19,10,9
proudmoore,767,warrior,fury,18,8,10
illidan,767,warrior,fury,18,8,10
drakkari,767,warrior,fury,18,8,10
frostmourne,766,warrior,fury,12,8,4
frostmourne,766,warrior,fury,24,8,16
area-52,763,warrior,fury,18,8,10
stormrage,763,warrior,fury,24,8,16
garrosh,762,warrior,fury,12,8,4
dreadmaul,761,warrior,fury,18,8,10
icecrown,760,warrior,fury,18,10,8
moonrunner,757,warrior,fury,18,8,10
malganis,735,warrior,fury,17,8,9
ragnaros,713,warrior,fury,18,11,7
zuljin,713,warrior,fury,19,10,9
draka,704,warrior,fury,16,8,8
tichondrius,703,warrior,fury,11,8,3
illidan,672,warrior,fury,12,7,5
illidan,672,warrior,fury,12,7,5
malganis,672,warrior,fury,12,7,5
chogall,672,warrior,fury,12,7,5
thrall,672,warrior,fury,12,7,5
arthas,672,warrior,fury,12,7,5
llane,672,warrior,fury,12,7,5
quelthalas,672,warrior,fury,12,7,5
tichondrius,672,warrior,fury,12,7,5
tichondrius,672,warrior,fury,12,7,5
burning-blade,672,warrior,fury,12,7,5
garona,672,warrior,fury,12,7,5
stormrage,672,warrior,fury,12,7,5
lightbringer,672,warrior,fury,12,7,5
emerald-dream,672,warrior,fury,12,7,5
queldorei,672,warrior,fury,12,7,5
frostmourne,672,warrior,fury,18,7,11
korgath,672,warrior,fury,18,7,11
frostmourne,672,warrior,fury,18,7,11
borean-tundra,671,warrior,fury,12,7,5
queldorei,671,warrior,fury,12,7,5
dragonblight,671,warrior,fury,12,7,5
bloodscalp,671,warrior,fury,12,7,5
ragnaros,671,warrior,fury,12,7,5
arthas,671,warrior,fury,12,7,5
kelthuzad,671,warrior,fury,15,8,7
kelthuzad,671,warrior,fury,18,7,11
tichondrius,671,warrior,fury,18,7,11
malganis,671,warrior,fury,18,7,11
draktharon,671,warrior,fury,18,7,11
kiljaeden,670,warrior,fury,12,7,5
garrosh,670,warrior,fury,12,7,5
sargeras,670,warrior,fury,12,7,5
stormrage,665,warrior,fury,21,9,12
malganis,639,warrior,fury,14,8,6
illidan,639,warrior,fury,17,7,10
dreadmaul,638,warrior,fury,14,8,6
skullcrusher,637,warrior,fury,20,8,12
malganis,623,warrior,fury,15,7,8
frostmourne,608,warrior,fury,22,7,15
korgath,607,warrior,fury,14,7,7
haomarush,591,warrior,fury,11,7,4
moon-guard,576,warrior,fury,6,6,0
spirestone,576,warrior,fury,12,6,6
moon-guard,576,warrior,fury,12,6,6
sargeras,576,warrior,fury,12,6,6
moon-guard,576,warrior,fury,12,6,6
tichondrius,576,warrior,fury,12,6,6
drenden,576,warrior,fury,12,6,6
exodar,576,warrior,fury,12,6,6
jaedenar,576,warrior,fury,12,6,6
ragnaros,576,warrior,fury,12,6,6
emerald-dream,576,warrior,fury,12,6,6
destromath,576,warrior,fury,12,6,6
tichondrius,576,warrior,fury,12,6,6
thrall,576,warrior,fury,12,6,6
tichondrius,576,warrior,fury,12,6,6
azgalor,576,warrior,fury,12,6,6
tichondrius,576,warrior,fury,12,6,6
tichondrius,576,warrior,fury,12,6,6
thrall,576,warrior,fury,12,6,6
moon-guard,576,warrior,fury,12,6,6
proudmoore,576,warrior,fury,12,6,6
stormscale,576,warrior,fury,12,6,6
bleeding-hollow,576,warrior,fury,12,6,6
tichondrius,576,warrior,fury,12,6,6
illidan,576,warrior,fury,12,6,6
frostmourne,576,warrior,fury,18,6,12
sargeras,576,warrior,fury,18,6,12
thunderlord,575,warrior,fury,12,6,6
nesingwary,575,warrior,fury,12,6,6
nordrassil,575,warrior,fury,12,6,6
malganis,575,warrior,fury,12,6,6
ragnaros,575,warrior,fury,12,6,6
moon-guard,575,warrior,fury,12,6,6
ragnaros,575,warrior,fury,12,6,6
shattered-halls,575,warrior,fury,12,6,6
zuljin,575,warrior,fury,12,6,6
bleeding-hollow,575,warrior,fury,12,6,6
tichondrius,575,warrior,fury,12,6,6
bleeding-hollow,575,warrior,fury,18,6,12
gilneas,574,warrior,fury,12,6,6
tichondrius,574,warrior,fury,18,6,12
area-52,573,warrior,fury,18,6,12
quelthalas,570,warrior,fury,12,6,6
antonidas,559,warrior,fury,17,6,11
azralon,558,warrior,fury,17,6,11
sargeras,549,warrior,fury,15,7,8
ragnaros,543,warrior,fury,16,6,10
windrunner,541,warrior,fury,17,6,11
sargeras,527,warrior,fury,11,6,5
misha,519,warrior,fury,11,6,5
thunderlord,511,warrior,fury,11,6,5
windrunner,480,warrior,fury,6,5,1
area-52,480,warrior,fury,6,5,1
tichondrius,480,warrior,fury,6,5,1
tichondrius,480,warrior,fury,6,5,1
malganis,480,warrior,fury,6,5,1
quelthalas,480,warrior,fury,6,5,1
illidan,480,warrior,fury,6,5,1
tichondrius,480,warrior,fury,6,5,1
stormreaver,480,warrior,fury,6,5,1
illidan,480,warrior,fury,6,5,1
illidan,480,warrior,fury,6,5,1
bleeding-hollow,480,warrior,fury,12,5,7
moon-guard,480,warrior,fury,12,5,7
illidan,480,warrior,fury,12,5,7
darkspear,480,warrior,fury,12,5,7
illidan,480,warrior,fury,12,5,7
kelthuzad,480,warrior,fury,12,5,7
khadgar,480,warrior,fury,12,5,7
tichondrius,480,warrior,fury,12,5,7
illidan,480,warrior,fury,12,5,7
ragnaros,480,warrior,fury,12,5,7
tichondrius,480,warrior,fury,12,5,7
azralon,480,warrior,fury,12,5,7
stormrage,480,warrior,fury,12,5,7
tichondrius,480,warrior,fury,12,5,7
sargeras,480,warrior,fury,12,5,7
quelthalas,480,warrior,fury,12,5,7
tichondrius,480,warrior,fury,12,5,7
area-52,480,warrior,fury,12,5,7
hyjal,480,warrior,fury,12,5,7
tichondrius,480,warrior,fury,12,5,7
tanaris,480,warrior,fury,18,5,13
proudmoore,479,warrior,fury,6,5,1
laughing-skull,479,warrior,fury,12,5,7
moonrunner,479,warrior,fury,12,5,7
tichondrius,479,warrior,fury,12,5,7
sargeras,479,warrior,fury,18,5,13
frostmourne,478,warrior,fury,6,5,1
stormrage,476,warrior,fury,12,5,7
nemesis,476,warrior,fury,12,5,7
quelthalas,469,warrior,fury,18,5,13
malganis,432,warrior,fury,9,5,4
ragnaros,432,warrior,fury,15,5,10
thaurissan,432,warrior,fury,15,5,10
zuljin,431,warrior,fury,15,5,10
azralon,426,warrior,fury,16,7,9
azralon,416,warrior,fury,10,5,5
malganis,414,warrior,fury,14,5,9
illidan,399,warrior,fury,5,5,0
nazjatar,384,warrior,fury,6,4,2
wyrmrest-accord,384,warrior,fury,6,4,2
area-52,384,warrior,fury,6,4,2
drakkari,384,warrior,fury,6,4,2
sargeras,384,warrior,fury,6,4,2
frostmourne,384,warrior,fury,6,4,2
aerie-peak,384,warrior,fury,6,4,2
tichondrius,384,warrior,fury,6,4,2
moon-guard,384,warrior,fury,6,4,2
area-52,384,warrior,fury,6,4,2
area-52,384,warrior,fury,6,4,2
tichondrius,384,warrior,fury,6,4,2
kelthuzad,384,warrior,fury,6,4,2
ragnaros,384,warrior,fury,6,4,2
moon-guard,384,warrior,fury,6,4,2
tichondrius,384,warrior,fury,6,4,2
moon-guard,384,warrior,fury,6,4,2
hellscream,384,warrior,fury,6,4,2
senjin,384,warrior,fury,6,4,2
garrosh,384,warrior,fury,6,4,2
dalaran,384,warrior,fury,6,4,2
illidan,384,warrior,fury,6,4,2
malganis,384,warrior,fury,6,4,2
kiljaeden,384,warrior,fury,6,4,2
aegwynn,384,warrior,fury,6,4,2
sargeras,384,warrior,fury,6,4,2
ragnaros,384,warrior,fury,6,4,2
barthilas,384,warrior,fury,6,4,2
kelthuzad,384,warrior,fury,6,4,2
stormrage,384,warrior,fury,6,4,2
khazgoroth,384,warrior,fury,6,4,2
stormrage,384,warrior,fury,6,4,2
stormrage,384,warrior,fury,6,4,2
malganis,384,warrior,fury,6,4,2
stormrage,384,warrior,fury,6,4,2
sargeras,384,warrior,fury,11,4,7
sargeras,384,warrior,fury,11,4,7
stormrage,384,warrior,fury,12,4,8
greymane,384,warrior,fury,12,4,8
area-52,384,warrior,fury,12,4,8
illidan,384,warrior,fury,12,4,8
wyrmrest-accord,384,warrior,fury,12,4,8
stormrage,384,warrior,fury,12,4,8
sargeras,384,warrior,fury,12,4,8
wyrmrest-accord,384,warrior,fury,12,4,8
tichondrius,384,warrior,fury,12,4,8
tichondrius,384,warrior,fury,12,4,8
tichondrius,384,warrior,fury,12,4,8
tichondrius,384,warrior,fury,12,4,8
hyjal,384,warrior,fury,12,4,8
dalaran,384,warrior,fury,12,4,8
malganis,384,warrior,fury,12,4,8
bleeding-hollow,384,warrior,fury,12,4,8
illidan,384,warrior,fury,12,4,8
dalaran,384,warrior,fury,12,4,8
tichondrius,384,warrior,fury,18,4,14
azralon,383,warrior,fury,6,4,2
malygos,383,warrior,fury,12,4,8
moon-guard,383,warrior,fury,12,4,8
stormrage,383,warrior,fury,12,4,8
bonechewer,383,warrior,fury,12,4,8
zuljin,383,warrior,fury,24,4,20
tichondrius,381,warrior,fury,24,4,20
arthas,367,warrior,fury,11,4,7
area-52,351,warrior,fury,8,5,3
tichondrius,330,warrior,fury,14,5,9
stormrage,288,warrior,fury,6,3,3
kelthuzad,288,warrior,fury,6,3,3
quelthalas,288,warrior,fury,6,3,3
stonemaul,288,warrior,fury,6,3,3
quelthalas,288,warrior,fury,6,3,3
proudmoore,288,warrior,fury,6,3,3
stormrage,288,warrior,fury,6,3,3
moonrunner,288,warrior,fury,6,3,3
kelthuzad,288,warrior,fury,6,3,3
area-52,288,warrior,fury,6,3,3
azralon,288,warrior,fury,6,3,3
malganis,288,warrior,fury,6,3,3
tichondrius,288,warrior,fury,6,3,3
tichondrius,288,warrior,fury,6,3,3
area-52,288,warrior,fury,6,3,3
kiljaeden,288,warrior,fury,6,3,3
elune,288,warrior,fury,6,3,3
bleeding-hollow,288,warrior,fury,6,3,3
winterhoof,288,warrior,fury,6,3,3
tichondrius,288,warrior,fury,6,3,3
area-52,288,warrior,fury,6,3,3
stormrage,288,warrior,fury,6,3,3
stormrage,288,warrior,fury,6,3,3
duskwood,288,warrior,fury,6,3,3
magtheridon,288,warrior,fury,6,3,3
quelthalas,288,warrior,fury,6,3,3
moon-guard,288,warrior,fury,6,3,3
tichondrius,288,warrior,fury,6,3,3
frostmourne,288,warrior,fury,6,3,3
sargeras,288,warrior,fury,6,3,3
moon-guard,288,warrior,fury,6,3,3
the-underbog,288,warrior,fury,6,3,3
silvermoon,288,warrior,fury,6,3,3
dark-iron,288,warrior,fury,6,3,3
wyrmrest-accord,288,warrior,fury,6,3,3
daggerspine,288,warrior,fury,6,3,3
wyrmrest-accord,288,warrior,fury,6,3,3
nordrassil,288,warrior,fury,6,3,3
wyrmrest-accord,288,warrior,fury,6,3,3
hyjal,288,warrior,fury,6,3,3
proudmoore,288,warrior,fury,12,3,9
nemesis,288,warrior,fury,12,3,9
tichondrius,288,warrior,fury,12,3,9
moon-guard,288,warrior,fury,12,3,9
frostmourne,288,warrior,fury,12,3,9
frostmourne,288,warrior,fury,12,3,9
moon-guard,288,warrior,fury,12,3,9
moon-guard,288,warrior,fury,12,3,9
bleeding-hollow,288,warrior,fury,12,3,9
tichondrius,288,warrior,fury,12,3,9
sargeras,288,warrior,fury,12,3,9
trollbane,288,warrior,fury,12,3,9
hyjal,288,warrior,fury,12,3,9
illidan,288,warrior,fury,12,3,9
tichondrius,287,warrior,fury,6,3,3
aegwynn,287,warrior,fury,6,3,3
jubeithos,287,warrior,fury,6,3,3
tichondrius,287,warrior,fury,12,3,9
the-forgotten-coast,286,warrior,fury,6,3,3
bleeding-hollow,255,warrior,fury,11,3,8
mannoroth,254,warrior,fury,11,3,8
emerald-dream,240,warrior,fury,13,4,9
moon-guard,239,warrior,fury,5,3,2
tichondrius,239,warrior,fury,5,3,2
tichondrius,239,warrior,fury,5,3,2
illidan,239,warrior,fury,5,3,2
malganis,234,warrior,fury,9,4,5
stormrage,234,warrior,fury,10,4,6
laughing-skull,223,warrior,fury,8,3,5
area-52,192,warrior,fury,4,3,1
azralon,192,warrior,fury,9,3,6
stormrage,192,warrior,fury,6,2,4
zuljin,192,warrior,fury,6,2,4
frostmourne,192,warrior,fury,6,2,4
tichondrius,192,warrior,fury,6,2,4
tichondrius,192,warrior,fury,6,2,4
tichondrius,192,warrior,fury,6,2,4
zuljin,192,warrior,fury,6,2,4
stormrage,192,warrior,fury,6,2,4
frostmourne,192,warrior,fury,6,2,4
nazjatar,192,warrior,fury,6,2,4
mannoroth,192,warrior,fury,6,2,4
barthilas,192,warrior,fury,6,2,4
zuljin,192,warrior,fury,6,2,4
shuhalo,192,warrior,fury,6,2,4
tichondrius,192,warrior,fury,6,2,4
frostmourne,192,warrior,fury,6,2,4
stormrage,192,warrior,fury,6,2,4
tichondrius,192,warrior,fury,6,2,4
tichondrius,192,warrior,fury,6,2,4
tichondrius,192,warrior,fury,6,2,4
hyjal,192,warrior,fury,6,2,4
stormrage,192,warrior,fury,6,2,4
bleeding-hollow,192,warrior,fury,6,2,4
tichondrius,192,warrior,fury,6,2,4
tichondrius,192,warrior,fury,6,2,4
tichondrius,192,warrior,fury,6,2,4
arthas,192,warrior,fury,6,2,4
tichondrius,192,warrior,fury,6,2,4
area-52,192,warrior,fury,6,2,4
lightbringer,192,warrior,fury,6,2,4
illidan,192,warrior,fury,6,2,4
area-52,192,warrior,fury,6,2,4
drakkari,192,warrior,fury,6,2,4
ragnaros,192,warrior,fury,6,2,4
moknathal,192,warrior,fury,6,2,4
thrall,192,warrior,fury,6,2,4
queldorei,192,warrior,fury,6,2,4
proudmoore,192,warrior,fury,6,2,4
ragnaros,192,warrior,fury,6,2,4
amanthul,192,warrior,fury,6,2,4
garona,192,warrior,fury,6,2,4
kelthuzad,192,warrior,fury,6,2,4
quelthalas,192,warrior,fury,6,2,4
sargeras,192,warrior,fury,6,2,4
illidan,192,warrior,fury,6,2,4
malganis,192,warrior,fury,6,2,4
quelthalas,192,warrior,fury,6,2,4
illidan,192,warrior,fury,6,2,4
frostmourne,192,warrior,fury,6,2,4
stormreaver,192,warrior,fury,6,2,4
moon-guard,192,warrior,fury,6,2,4
azralon,192,warrior,fury,6,2,4
moon-guard,192,warrior,fury,6,2,4
sargeras,192,warrior,fury,6,2,4
sargeras,192,warrior,fury,6,2,4
sargeras,192,warrior,fury,6,2,4
sargeras,192,warrior,fury,6,2,4
aggramar,192,warrior,fury,8,2,6
ursin,192,warrior,fury,11,2,9
ragnaros,192,warrior,fury,12,2,10
the-underbog,192,warrior,fury,12,2,10
darkspear,192,warrior,fury,12,2,10
kul-tiras,191,warrior,fury,6,2,4
ragnaros,191,warrior,fury,6,2,4
aggramar,190,warrior,fury,4,3,1
stormrage,159,warrior,fury,5,2,3
tichondrius,128,warrior,fury,4,2,2
ysera,128,warrior,fury,4,2,2
daggerspine,96,warrior,fury,6,1,5
frostmourne,96,warrior,fury,6,1,5
moon-guard,96,warrior,fury,6,1,5
barthilas,96,warrior,fury,6,1,5
illidan,96,warrior,fury,6,1,5
zuljin,96,warrior,fury,6,1,5
kiljaeden,96,warrior,fury,6,1,5
moon-guard,96,warrior,fury,6,1,5
bleeding-hollow,96,warrior,fury,6,1,5
magtheridon,96,warrior,fury,6,1,5
shadowsong,96,warrior,fury,6,1,5
frostmourne,96,warrior,fury,6,1,5
tichondrius,96,warrior,fury,6,1,5
spirestone,96,warrior,fury,6,1,5
area-52,96,warrior,fury,6,1,5
tichondrius,96,warrior,fury,6,1,5
moon-guard,96,warrior,fury,6,1,5
azralon,96,warrior,fury,6,1,5
area-52,96,warrior,fury,6,1,5
mugthol,96,warrior,fury,6,1,5
ragnaros,96,warrior,fury,6,1,5
ragnaros,96,warrior,fury,6,1,5
area-52,96,warrior,fury,6,1,5
korialstrasz,96,warrior,fury,6,1,5
azralon,96,warrior,fury,6,1,5
quelthalas,96,warrior,fury,6,1,5
barthilas,96,warrior,fury,6,1,5
terenas,96,warrior,fury,6,1,5
darkspear,96,warrior,fury,12,1,11
dalaran,95,warrior,fury,6,1,5
azralon,64,warrior,fury,4,1,3
gnomeregan,16,warrior,fury,1,1,0
area-52,2209,warrior,arms,128,66,62
tichondrius,2162,warrior,arms,111,62,49
azralon,2158,warrior,arms,78,42,36
area-52,2133,warrior,arms,81,46,35
area-52,2133,warrior,arms,106,54,52
tichondrius,2114,warrior,arms,117,64,53
sargeras,2113,warrior,arms,66,37,29
sargeras,2112,warrior,arms,56,32,24
moon-guard,2111,warrior,arms,137,69,68
sargeras,2103,warrior,arms,87,48,39
moon-guard,2100,warrior,arms,90,46,44
sargeras,2048,warrior,arms,143,78,65
area-52,2026,warrior,arms,71,40,31
area-52,2022,warrior,arms,98,48,50
tichondrius,1995,warrior,arms,65,32,33
tichondrius,1981,warrior,arms,138,76,62
sargeras,1979,warrior,arms,87,41,46
bleeding-hollow,1969,warrior,arms,60,32,28
feathermoon,1964,warrior,arms,56,34,22
illidan,1964,warrior,arms,72,37,35
area-52,1962,warrior,arms,88,50,38
ragnaros,1960,warrior,arms,143,69,74
sargeras,1957,warrior,arms,66,35,31
tichondrius,1941,warrior,arms,60,37,23
tichondrius,1941,warrior,arms,54,30,24
agamaggan,1940,warrior,arms,87,41,46
tichondrius,1929,warrior,arms,42,30,12
korgath,1925,warrior,arms,66,32,34
tichondrius,1920,warrior,arms,56,29,27
sargeras,1918,warrior,arms,36,25,11
stormrage,1916,warrior,arms,65,32,33
area-52,1914,warrior,arms,84,49,35
tichondrius,1908,warrior,arms,88,51,37
tichondrius,1905,warrior,arms,80,41,39
tichondrius,1902,warrior,arms,72,34,38
shattered-hand,1900,warrior,arms,41,25,16
tichondrius,1899,warrior,arms,126,64,62
azralon,1893,warrior,arms,83,50,33
tichondrius,1893,warrior,arms,60,26,34
sargeras,1889,warrior,arms,74,43,31
gurubashi,1888,warrior,arms,42,30,12
azralon,1881,warrior,arms,118,60,58
quelthalas,1880,warrior,arms,120,61,59
kaelthas,1876,warrior,arms,44,24,20
frostmourne,1875,warrior,arms,112,56,56
proudmoore,1872,warrior,arms,54,27,27
tichondrius,1868,warrior,arms,119,59,60
area-52,1866,warrior,arms,84,40,44
illidan,1864,warrior,arms,66,32,34
thrall,1863,warrior,arms,47,29,18
skullcrusher,1860,warrior,arms,63,34,29
stormrage,1860,warrior,arms,54,28,26
emerald-dream,1859,warrior,arms,59,34,25
frostmourne,1859,warrior,arms,108,53,55
illidan,1855,warrior,arms,60,29,31
illidan,1853,warrior,arms,39,29,10
tichondrius,1853,warrior,arms,65,31,34
tichondrius,1846,warrior,arms,46,35,11
illidan,1846,warrior,arms,60,30,30
tichondrius,1845,warrior,arms,54,32,22
tichondrius,1845,warrior,arms,48,28,20
kiljaeden,1844,warrior,arms,54,27,27
area-52,1844,warrior,arms,72,33,39
draka,1842,warrior,arms,60,33,27
azralon,1840,warrior,arms,41,26,15
tichondrius,1840,warrior,arms,96,53,43
stormrage,1838,warrior,arms,60,34,26
darkspear,1836,warrior,arms,70,36,34
malganis,1834,warrior,arms,90,45,45
suramar,1832,warrior,arms,60,30,30
moon-guard,1831,warrior,arms,41,23,18
zuljin,1828,warrior,arms,60,28,32
moon-guard,1827,warrior,arms,39,25,14
thrall,1827,warrior,arms,137,68,69
tichondrius,1827,warrior,arms,66,30,36
ragnaros,1826,warrior,arms,44,24,20
sargeras,1826,warrior,arms,77,41,36
sargeras,1825,warrior,arms,72,39,33
tichondrius,1825,warrior,arms,85,45,40
tichondrius,1825,warrior,arms,66,31,35
hyjal,1824,warrior,arms,105,56,49
frostmourne,1824,warrior,arms,100,43,57
malganis,1823,warrior,arms,36,27,9
wildhammer,1823,warrior,arms,65,36,29
kiljaeden,1821,warrior,arms,51,27,24
tichondrius,1820,warrior,arms,48,24,24
ragnaros,1820,warrior,arms,72,34,38
area-52,1816,warrior,arms,59,23,36
kelthuzad,1815,warrior,arms,107,57,50
quelthalas,1814,warrior,arms,67,32,35
tichondrius,1814,warrior,arms,126,60,66
tichondrius,1813,warrior,arms,55,35,20
moon-guard,1813,warrior,arms,59,31,28
ragnaros,1813,warrior,arms,108,54,54
ragnaros,1812,warrior,arms,57,31,26
tichondrius,1811,warrior,arms,64,33,31
kiljaeden,1811,warrior,arms,60,30,30
moon-guard,1810,warrior,arms,48,30,18
kelthuzad,1810,warrior,arms,54,31,23
hyjal,1810,warrior,arms,78,39,39
tichondrius,1809,warrior,arms,42,25,17
illidan,1809,warrior,arms,90,52,38
emerald-dream,1808,warrior,arms,64,34,30
tichondrius,1807,warrior,arms,48,29,19
azralon,1806,warrior,arms,54,25,29
kiljaeden,1805,warrior,arms,49,28,21
sargeras,1805,warrior,arms,36,19,17
tichondrius,1805,warrior,arms,52,27,25
tichondrius,1804,warrior,arms,42,19,23
tichondrius,1803,warrior,arms,66,36,30
tichondrius,1801,warrior,arms,54,28,26
tichondrius,1800,warrior,arms,42,23,19
staghelm,1800,warrior,arms,68,35,33
thrall,1800,warrior,arms,115,59,56
tichondrius,1800,warrior,arms,66,33,33
tichondrius,1798,warrior,arms,83,50,33
argent-dawn,1792,warrior,arms,59,26,33
illidan,1791,warrior,arms,42,19,23
tichondrius,1787,warrior,arms,84,44,40
malganis,1778,warrior,arms,44,23,21
tichondrius,1778,warrior,arms,66,28,38
tichondrius,1776,warrior,arms,66,40,26
ragnaros,1772,warrior,arms,114,65,49
tichondrius,1770,warrior,arms,61,27,34
tichondrius,1768,warrior,arms,78,35,43
tichondrius,1766,warrior,arms,101,49,52
tichondrius,1766,warrior,arms,54,25,29
tichondrius,1764,warrior,arms,96,49,47
hyjal,1764,warrior,arms,53,24,29
illidan,1762,warrior,arms,34,22,12
tichondrius,1759,warrior,arms,65,39,26
thrall,1759,warrior,arms,41,24,17
tichondrius,1755,warrior,arms,36,27,9
ragnaros,1754,warrior,arms,208,125,83
nerzhul,1754,warrior,arms,51,27,24
jubeithos,1753,warrior,arms,42,25,17
tichondrius,1753,warrior,arms,84,40,44
azralon,1747,warrior,arms,59,31,28
stormrage,1746,warrior,arms,144,64,80
wyrmrest-accord,1743,warrior,arms,66,32,34
draktharon,1742,warrior,arms,47,27,20
sargeras,1740,warrior,arms,144,69,75
proudmoore,1737,warrior,arms,72,37,35
ragnaros,1735,warrior,arms,42,22,20
illidan,1733,warrior,arms,62,26,36
tichondrius,1733,warrior,arms,65,26,39
stormrage,1732,warrior,arms,68,31,37
thrall,1731,warrior,arms,47,24,23
tichondrius,1726,warrior,arms,62,36,26
sargeras,1726,warrior,arms,72,34,38
tichondrius,1725,warrior,arms,30,18,12
proudmoore,1723,warrior,arms,60,26,34
khadgar,1722,warrior,arms,90,53,37
moon-guard,1722,warrior,arms,94,43,51
tichondrius,1721,warrior,arms,42,21,21
moon-guard,1719,warrior,arms,53,23,30
moon-guard,1718,warrior,arms,201,93,108
drakkari,1717,warrior,arms,30,18,12
bleeding-hollow,1714,warrior,arms,30,21,9
bonechewer,1714,warrior,arms,119,53,66
sargeras,1714,warrior,arms,48,21,27
azralon,1714,warrior,arms,66,27,39
frostmourne,1713,warrior,arms,78,42,36
illidan,1712,warrior,arms,36,21,15
suramar,1711,warrior,arms,84,37,47
ragnaros,1711,warrior,arms,54,22,32
illidan,1710,warrior,arms,74,44,30
nemesis,1710,warrior,arms,65,35,30
tichondrius,1709,warrior,arms,97,55,42
stormrage,1708,warrior,arms,78,43,35
kelthuzad,1708,warrior,arms,47,24,23
area-52,1706,warrior,arms,30,18,12
ragnaros,1706,warrior,arms,45,25,20
frostmourne,1702,warrior,arms,112,57,55
garrosh,1699,warrior,arms,71,37,34
lightbringer,1699,warrior,arms,119,61,58
illidan,1698,warrior,arms,54,24,30
sargeras,1696,warrior,arms,46,25,21
llane,1695,warrior,arms,66,41,25
moon-guard,1690,warrior,arms,82,43,39
area-52,1688,warrior,arms,162,86,76
tichondrius,1686,warrior,arms,36,31,5
alleria,1686,warrior,arms,93,50,43
zangarmarsh,1686,warrior,arms,48,24,24
proudmoore,1686,warrior,arms,72,24,48
tichondrius,1684,warrior,arms,62,33,29
chogall,1684,warrior,arms,87,44,43
kelthuzad,1684,warrior,arms,81,39,42
area-52,1683,warrior,arms,41,23,18
aggramar,1683,warrior,arms,75,42,33
tichondrius,1683,warrior,arms,46,20,26
tichondrius,1682,warrior,arms,41,29,12
kargath,1681,warrior,arms,42,26,16
tichondrius,1680,warrior,arms,95,52,43
illidan,1679,warrior,arms,48,31,17
proudmoore,1678,warrior,arms,42,21,21
proudmoore,1678,warrior,arms,48,22,26
aggramar,1677,warrior,arms,124,64,60
tichondrius,1677,warrior,arms,122,62,60
dragonmaw,1671,warrior,arms,36,22,14
illidan,1670,warrior,arms,60,26,34
frostmourne,1666,warrior,arms,30,19,11
tichondrius,1666,warrior,arms,41,20,21
sargeras,1665,warrior,arms,66,29,37
tichondrius,1665,warrior,arms,66,29,37
zuljin,1663,warrior,arms,54,29,25
nemesis,1663,warrior,arms,53,25,28
tichondrius,1662,warrior,arms,42,25,17
ragnaros,1661,warrior,arms,54,30,24
azralon,1660,warrior,arms,30,20,10
tichondrius,1660,warrior,arms,165,92,73
frostmourne,1658,warrior,arms,60,35,25
tichondrius,1657,warrior,arms,106,57,49
illidan,1653,warrior,arms,30,18,12
wyrmrest-accord,1653,warrior,arms,36,21,15
ragnaros,1651,warrior,arms,42,20,22
malganis,1650,warrior,arms,47,21,26
garrosh,1650,warrior,arms,54,24,30
kelthuzad,1647,warrior,arms,53,25,28
drakkari,1646,warrior,arms,38,21,17
moon-guard,1644,warrior,arms,42,22,20
blackrock,1644,warrior,arms,97,50,47
sargeras,1642,warrior,arms,102,51,51
illidan,1642,warrior,arms,78,36,42
stormrage,1640,warrior,arms,47,26,21
illidan,1639,warrior,arms,51,34,17
sargeras,1637,warrior,arms,48,25,23
eldrethalas,1636,warrior,arms,53,26,27
kelthuzad,1633,warrior,arms,30,19,11
frostmourne,1629,warrior,arms,48,26,22
area-52,1629,warrior,arms,60,25,35
tichondrius,1628,warrior,arms,36,20,16
cenarius,1626,warrior,arms,60,28,32
moon-guard,1625,warrior,arms,36,18,18
bleeding-hollow,1624,warrior,arms,30,17,13
sargeras,1624,warrior,arms,30,17,13
azralon,1624,warrior,arms,42,18,24
frostmourne,1624,warrior,arms,60,24,36
tichondrius,1623,warrior,arms,54,30,24
moon-guard,1623,warrior,arms,76,38,38
tichondrius,1623,warrior,arms,54,24,30
area-52,1622,warrior,arms,48,19,29
tichondrius,1621,warrior,arms,75,44,31
bleeding-hollow,1617,warrior,arms,72,42,30
drakkari,1617,warrior,arms,30,17,13
sargeras,1617,warrior,arms,127,66,61
moon-guard,1615,warrior,arms,78,43,35
tichondrius,1615,warrior,arms,47,23,24
ragnaros,1614,warrior,arms,30,17,13
tichondrius,1614,warrior,arms,49,17,32
drakkari,1610,warrior,arms,36,17,19
tichondrius,1609,warrior,arms,42,23,19
area-52,1609,warrior,arms,57,31,26
illidan,1609,warrior,arms,71,33,38
tichondrius,1607,warrior,arms,42,21,21
tichondrius,1606,warrior,arms,48,21,27
bleeding-hollow,1605,warrior,arms,42,22,20
barthilas,1605,warrior,arms,120,59,61
azshara,1605,warrior,arms,53,23,30
nagrand,1603,warrior,arms,36,22,14
bleeding-hollow,1603,warrior,arms,51,30,21
tichondrius,1602,warrior,arms,48,28,20
stormrage,1599,warrior,arms,69,38,31
tichondrius,1599,warrior,arms,59,32,27
sargeras,1598,warrior,arms,36,19,17
frostmourne,1598,warrior,arms,46,24,22
frostmourne,1597,warrior,arms,66,36,30
illidan,1597,warrior,arms,42,20,22
tichondrius,1589,warrior,arms,36,19,17
quelthalas,1589,warrior,arms,44,19,25
frostwolf,1588,warrior,arms,71,38,33
darkspear,1586,warrior,arms,60,29,31
sargeras,1586,warrior,arms,48,23,25
frostmourne,1586,warrior,arms,51,22,29
tichondrius,1585,warrior,arms,48,23,25
ragnaros,1585,warrior,arms,36,17,19
hyjal,1582,warrior,arms,42,24,18
bleeding-hollow,1581,warrior,arms,79,45,34
area-52,1581,warrior,arms,108,54,54
tichondrius,1581,warrior,arms,48,20,28
illidan,1579,warrior,arms,25,19,6
hyjal,1577,warrior,arms,80,39,41
stormrage,1576,warrior,arms,30,20,10
quelthalas,1573,warrior,arms,36,20,16
hyjal,1572,warrior,arms,42,20,22
malganis,1571,warrior,arms,84,38,46
azralon,1571,warrior,arms,71,32,39
tichondrius,1570,warrior,arms,60,36,24
boulderfist,1570,warrior,arms,150,78,72
thunderlord,1570,warrior,arms,80,35,45
drakkari,1569,warrior,arms,36,18,18
tichondrius,1569,warrior,arms,87,37,50
korgath,1567,warrior,arms,55,35,20
frostmourne,1566,warrior,arms,42,18,24
emerald-dream,1565,warrior,arms,72,41,31
nagrand,1564,warrior,arms,36,18,18
illidan,1564,warrior,arms,45,19,26
proudmoore,1562,warrior,arms,64,34,30
ragnaros,1558,warrior,arms,78,43,35
illidan,1557,warrior,arms,54,27,27
proudmoore,1556,warrior,arms,78,40,38
ragnaros,1555,warrior,arms,72,35,37
lightbringer,1551,warrior,arms,106,47,59
alleria,1550,warrior,arms,53,37,16
stormrage,1550,warrior,arms,35,20,15
azralon,1548,warrior,arms,41,24,17
frostmourne,1548,warrior,arms,90,43,47
kelthuzad,1547,warrior,arms,55,33,22
illidan,1547,warrior,arms,59,34,25
tichondrius,1547,warrior,arms,55,24,31
uldaman,1546,warrior,arms,26,18,8
sargeras,1545,warrior,arms,62,35,27
tichondrius,1544,warrior,arms,58,32,26
sargeras,1543,warrior,arms,38,26,12
anetheron,1542,warrior,arms,98,45,53
azralon,1540,warrior,arms,120,65,55
tichondrius,1540,warrior,arms,56,29,27
azralon,1539,warrior,arms,30,18,12
saurfang,1539,warrior,arms,38,21,17
tichondrius,1537,warrior,arms,66,34,32
moon-guard,1536,warrior,arms,83,50,33
area-52,1534,warrior,arms,28,17,11
stormrage,1532,warrior,arms,55,29,26
ragnaros,1532,warrior,arms,58,30,28
tichondrius,1532,warrior,arms,36,16,20
kelthuzad,1531,warrior,arms,24,16,8
tichondrius,1531,warrior,arms,56,29,27
hyjal,1529,warrior,arms,36,16,20
frostmourne,1526,warrior,arms,44,20,24
frostmourne,1526,warrior,arms,41,18,23
azralon,1524,warrior,arms,127,62,65
tichondrius,1523,warrior,arms,30,16,14
tichondrius,1522,warrior,arms,37,21,16
area-52,1522,warrior,arms,54,28,26
nemesis,1522,warrior,arms,60,30,30
illidan,1522,warrior,arms,82,37,45
bleeding-hollow,1522,warrior,arms,42,16,26
stormscale,1520,warrior,arms,50,30,20
zuljin,1519,warrior,arms,24,16,8
windrunner,1519,warrior,arms,42,24,18
stormrage,1519,warrior,arms,146,77,69
gundrak,1519,warrior,arms,51,25,26
malganis,1514,warrior,arms,137,69,68
malganis,1514,warrior,arms,84,39,45
tichondrius,1514,warrior,arms,36,16,20
tichondrius,1512,warrior,arms,30,17,13
tichondrius,1511,warrior,arms,36,17,19
frostmourne,1509,warrior,arms,66,33,33
bloodhoof,1509,warrior,arms,126,61,65
frostmourne,1508,warrior,arms,42,19,23
akama,1508,warrior,arms,47,21,26
nemesis,1507,warrior,arms,76,40,36
area-52,1507,warrior,arms,36,16,20
tichondrius,1502,warrior,arms,44,19,25
area-52,1500,warrior,arms,132,74,58
tichondrius,1500,warrior,arms,129,59,70
duskwood,1499,warrior,arms,67,34,33
azralon,1498,warrior,arms,89,46,43
malganis,1497,warrior,arms,24,16,8
area-52,1497,warrior,arms,24,16,8
spirestone,1497,warrior,arms,36,23,13
tichondrius,1496,warrior,arms,42,24,18
emerald-dream,1496,warrior,arms,29,16,13
nemesis,1496,warrior,arms,30,16,14
frostmourne,1496,warrior,arms,54,25,29
moon-guard,1495,warrior,arms,42,27,15
moon-guard,1494,warrior,arms,135,65,70
frostmourne,1491,warrior,arms,60,29,31
nagrand,1491,warrior,arms,45,21,24
azralon,1491,warrior,arms,47,21,26
wyrmrest-accord,1490,warrior,arms,54,23,31
tichondrius,1489,warrior,arms,100,41,59
ragnaros,1489,warrior,arms,74,27,47
sargeras,1488,warrior,arms,42,20,22
barthilas,1486,warrior,arms,112,54,58
tichondrius,1485,warrior,arms,30,16,14
thrall,1485,warrior,arms,41,16,25
crushridge,1484,warrior,arms,36,17,19
illidan,1484,warrior,arms,48,22,26
ravenholdt,1483,warrior,arms,54,20,34
emerald-dream,1481,warrior,arms,58,33,25
boulderfist,1480,warrior,arms,84,46,38
bloodhoof,1479,warrior,arms,75,34,41
illidan,1479,warrior,arms,62,27,35
stormrage,1476,warrior,arms,36,16,20
quelthalas,1475,warrior,arms,111,57,54
proudmoore,1474,warrior,arms,29,16,13
kelthuzad,1473,warrior,arms,35,16,19
darkspear,1472,warrior,arms,42,20,22
dalaran,1471,warrior,arms,54,35,19
zuljin,1470,warrior,arms,64,42,22
stormrage,1470,warrior,arms,54,33,21
tichondrius,1470,warrior,arms,49,23,26
stormrage,1469,warrior,arms,66,32,34
caelestrasz,1468,warrior,arms,74,43,31
frostmourne,1468,warrior,arms,36,17,19
tichondrius,1468,warrior,arms,90,42,48
zuljin,1465,warrior,arms,117,54,63
emerald-dream,1465,warrior,arms,47,17,30
hyjal,1464,warrior,arms,55,29,26
proudmoore,1462,warrior,arms,71,30,41
barthilas,1460,warrior,arms,35,17,18
korgath,1458,warrior,arms,58,26,32
illidan,1457,warrior,arms,36,26,10
wyrmrest-accord,1457,warrior,arms,24,17,7
malganis,1457,warrior,arms,68,31,37
sargeras,1457,warrior,arms,36,16,20
zuljin,1455,warrior,arms,36,18,18
tichondrius,1455,warrior,arms,42,19,23
tichondrius,1454,warrior,arms,42,21,21
bleeding-hollow,1452,warrior,arms,60,32,28
sargeras,1450,warrior,arms,118,58,60
sargeras,1446,warrior,arms,80,35,45
quelthalas,1446,warrior,arms,38,16,22
proudmoore,1445,warrior,arms,54,29,25
gundrak,1440,warrior,arms,72,36,36
barthilas,1439,warrior,arms,48,30,18
tichondrius,1439,warrior,arms,30,15,15
zuluhed,1439,warrior,arms,96,41,55
area-52,1438,warrior,arms,28,16,12
bleeding-hollow,1435,warrior,arms,30,15,15
azralon,1434,warrior,arms,29,16,13
alleria,1434,warrior,arms,66,29,37
stormrage,1433,warrior,arms,24,15,9
tichondrius,1433,warrior,arms,24,15,9
tichondrius,1432,warrior,arms,30,15,15
illidan,1431,warrior,arms,36,15,21
zuljin,1428,warrior,arms,34,15,19
frostmourne,1427,warrior,arms,50,27,23
zuluhed,1427,warrior,arms,96,46,50
tichondrius,1425,warrior,arms,137,67,70
malganis,1425,warrior,arms,72,29,43
thrall,1424,warrior,arms,30,15,15
illidan,1423,warrior,arms,51,23,28
barthilas,1422,warrior,arms,101,49,52
kelthuzad,1421,warrior,arms,49,24,25
quelthalas,1420,warrior,arms,41,19,22
tichondrius,1419,warrior,arms,24,17,7
tichondrius,1419,warrior,arms,30,15,15
tichondrius,1419,warrior,arms,44,16,28
gorgonnash,1416,warrior,arms,24,15,9
tichondrius,1416,warrior,arms,78,35,43
nordrassil,1415,warrior,arms,47,26,21
kelthuzad,1415,warrior,arms,70,34,36
sargeras,1415,warrior,arms,36,17,19
area-52,1414,warrior,arms,83,45,38
tichondrius,1414,warrior,arms,30,15,15
malganis,1413,warrior,arms,48,23,25
tichondrius,1413,warrior,arms,67,32,35
tichondrius,1410,warrior,arms,35,16,19
tichondrius,1409,warrior,arms,36,22,14
sargeras,1408,warrior,arms,58,23,35
frostmourne,1405,warrior,arms,36,16,20
stormreaver,1404,warrior,arms,36,16,20
ragnaros,1403,warrior,arms,66,30,36
nemesis,1402,warrior,arms,78,42,36
area-52,1402,warrior,arms,30,16,14
tichondrius,1401,warrior,arms,24,16,8
tichondrius,1400,warrior,arms,141,66,75
terenas,1399,warrior,arms,31,17,14
malganis,1399,warrior,arms,48,18,30
hellscream,1398,warrior,arms,35,18,17
stormrage,1397,warrior,arms,78,30,48
zuljin,1395,warrior,arms,52,26,26
sargeras,1392,warrior,arms,58,28,30
dunemaul,1392,warrior,arms,44,21,23
ragnaros,1392,warrior,arms,57,23,34
sargeras,1391,warrior,arms,69,36,33
malganis,1390,warrior,arms,72,40,32
tichondrius,1390,warrior,arms,53,22,31
bleeding-hollow,1389,warrior,arms,42,24,18
ragnaros,1389,warrior,arms,30,15,15
black-dragonflight,1388,warrior,arms,100,50,50
lightnings-blade,1388,warrior,arms,48,24,24
nemesis,1388,warrior,arms,42,15,27
dalaran,1387,warrior,arms,30,16,14
khadgar,1385,warrior,arms,50,19,31
tichondrius,1384,warrior,arms,59,26,33
proudmoore,1382,warrior,arms,60,26,34
tichondrius,1381,warrior,arms,39,21,18
area-52,1381,warrior,arms,42,20,22
thrall,1381,warrior,arms,36,17,19
stormrage,1378,warrior,arms,33,17,16
draktharon,1375,warrior,arms,42,23,19
frostmourne,1372,warrior,arms,42,23,19
tichondrius,1372,warrior,arms,62,32,30
frostmourne,1371,warrior,arms,47,25,22
tichondrius,1367,warrior,arms,33,15,18
barthilas,1365,warrior,arms,87,47,40
thrall,1365,warrior,arms,30,15,15
spinebreaker,1363,warrior,arms,46,26,20
area-52,1362,warrior,arms,75,33,42
tichondrius,1361,warrior,arms,81,34,47
aegwynn,1360,warrior,arms,48,29,19
frostmourne,1357,warrior,arms,68,32,36
tichondrius,1356,warrior,arms,48,19,29
tichondrius,1355,warrior,arms,41,26,15
emerald-dream,1355,warrior,arms,41,23,18
wyrmrest-accord,1355,warrior,arms,97,52,45
azralon,1354,warrior,arms,54,29,25
moon-guard,1352,warrior,arms,72,31,41
thrall,1349,warrior,arms,30,16,14
dreadmaul,1348,warrior,arms,67,29,38
malorne,1347,warrior,arms,57,31,26
nemesis,1347,warrior,arms,42,16,26
moon-guard,1346,warrior,arms,43,20,23
ragnaros,1345,warrior,arms,30,17,13
gurubashi,1345,warrior,arms,64,26,38
stormrage,1344,warrior,arms,94,47,47
frostmourne,1344,warrior,arms,59,29,30
stormrage,1344,warrior,arms,36,17,19
tichondrius,1342,warrior,arms,36,14,22
proudmoore,1341,warrior,arms,30,14,16
tichondrius,1340,warrior,arms,28,15,13
illidan,1340,warrior,arms,36,14,22
illidan,1339,warrior,arms,30,14,16
tichondrius,1338,warrior,arms,24,14,10
kaelthas,1338,warrior,arms,42,22,20
ragnaros,1338,warrior,arms,126,57,69
tichondrius,1337,warrior,arms,29,19,10
lightbringer,1337,warrior,arms,30,15,15
frostmourne,1337,warrior,arms,60,29,31
nemesis,1337,warrior,arms,45,19,26
whisperwind,1336,warrior,arms,24,14,10
azralon,1336,warrior,arms,30,16,14
zuljin,1336,warrior,arms,30,14,16
tichondrius,1336,warrior,arms,44,19,25
illidan,1333,warrior,arms,63,39,24
bonechewer,1333,warrior,arms,30,15,15
boulderfist,1331,warrior,arms,36,14,22
ragnaros,1330,warrior,arms,24,14,10
tichondrius,1330,warrior,arms,48,21,27
frostmourne,1328,warrior,arms,30,14,16
moon-guard,1326,warrior,arms,30,14,16
illidan,1326,warrior,arms,36,14,22
tichondrius,1324,warrior,arms,31,16,15
illidan,1324,warrior,arms,42,16,26
tichondrius,1320,warrior,arms,30,14,16
malganis,1320,warrior,arms,60,27,33
tichondrius,1319,warrior,arms,42,33,9
tichondrius,1318,warrior,arms,70,39,31
ragnaros,1317,warrior,arms,29,16,13
zuljin,1317,warrior,arms,52,28,24
ursin,1315,warrior,arms,41,27,14
tichondrius,1314,warrior,arms,63,31,32
tichondrius,1314,warrior,arms,42,14,28
thunderhorn,1312,warrior,arms,46,18,28
quelthalas,1311,warrior,arms,42,20,22
goldrinn,1305,warrior,arms,42,20,22
tichondrius,1304,warrior,arms,62,31,31
tichondrius,1303,warrior,arms,61,32,29
uther,1301,warrior,arms,30,14,16
kelthuzad,1299,warrior,arms,60,28,32
aerie-peak,1297,warrior,arms,64,30,34
malganis,1296,warrior,arms,55,21,34
dragonmaw,1295,warrior,arms,17,14,3
sargeras,1295,warrior,arms,23,14,9
tichondrius,1295,warrior,arms,33,14,19
rivendare,1294,warrior,arms,54,27,27
proudmoore,1293,warrior,arms,42,24,18
illidan,1293,warrior,arms,49,24,25
tichondrius,1292,warrior,arms,29,14,15
illidan,1290,warrior,arms,24,15,9
tichondrius,1289,warrior,arms,57,24,33
quelthalas,1288,warrior,arms,49,21,28
tichondrius,1286,warrior,arms,24,15,9
stormrage,1284,warrior,arms,48,22,26
daggerspine,1280,warrior,arms,20,15,5
tichondrius,1279,warrior,arms,60,21,39
nemesis,1278,warrior,arms,60,32,28
tichondrius,1277,warrior,arms,34,14,20
tichondrius,1275,warrior,arms,23,14,9
chogall,1274,warrior,arms,30,18,12
frostmourne,1273,warrior,arms,84,42,42
icecrown,1268,warrior,arms,30,14,16
stormreaver,1265,warrior,arms,30,15,15
sargeras,1263,warrior,arms,36,14,22
quelthalas,1262,warrior,arms,95,50,45
hyjal,1262,warrior,arms,48,22,26
ragnaros,1255,warrior,arms,60,33,27
darkspear,1255,warrior,arms,29,15,14
velen,1250,warrior,arms,77,35,42
azralon,1249,warrior,arms,72,31,41
akama,1248,warrior,arms,18,13,5
area-52,1248,warrior,arms,24,13,11
moon-guard,1247,warrior,arms,24,13,11
sargeras,1247,warrior,arms,24,13,11
tichondrius,1247,warrior,arms,24,13,11
stormscale,1247,warrior,arms,25,13,12
azralon,1247,warrior,arms,60,30,30
moon-guard,1247,warrior,arms,30,13,17
eredar,1247,warrior,arms,30,13,17
ragnaros,1247,warrior,arms,36,13,23
bleeding-hollow,1246,warrior,arms,20,13,7
tichondrius,1246,warrior,arms,24,13,11
malganis,1246,warrior,arms,30,13,17
ragnaros,1245,warrior,arms,36,13,23
zuljin,1244,warrior,arms,36,18,18
ragnaros,1243,warrior,arms,39,14,25
tichondrius,1242,warrior,arms,24,13,11
moon-guard,1240,warrior,arms,24,13,11
illidan,1240,warrior,arms,36,13,23
akama,1240,warrior,arms,36,13,23
illidan,1239,warrior,arms,24,13,11
hyjal,1239,warrior,arms,34,15,19
barthilas,1239,warrior,arms,72,31,41
azralon,1239,warrior,arms,33,14,19
stormrage,1238,warrior,arms,39,17,22
ragnaros,1238,warrior,arms,30,13,17
dalaran,1238,warrior,arms,30,13,17
bleeding-hollow,1237,warrior,arms,30,13,17
silvermoon,1236,warrior,arms,30,13,17
tichondrius,1235,warrior,arms,54,25,29
illidan,1235,warrior,arms,30,13,17
tichondrius,1234,warrior,arms,54,24,30
illidan,1233,warrior,arms,30,13,17
stormrage,1232,warrior,arms,24,13,11
area-52,1232,warrior,arms,30,13,17
moon-guard,1232,warrior,arms,36,13,23
tichondrius,1231,warrior,arms,42,13,29
gundrak,1230,warrior,arms,69,33,36
malorne,1230,warrior,arms,199,84,115
akama,1226,warrior,arms,24,13,11
moon-guard,1226,warrior,arms,28,14,14
thrall,1225,warrior,arms,32,23,9
runetotem,1224,warrior,arms,90,47,43
destromath,1224,warrior,arms,31,13,18
hakkar,1223,warrior,arms,24,13,11
stormrage,1223,warrior,arms,24,13,11
tichondrius,1223,warrior,arms,32,14,18
ragnaros,1222,warrior,arms,41,14,27
wyrmrest-accord,1221,warrior,arms,18,13,5
moknathal,1221,warrior,arms,61,33,28
nazjatar,1220,warrior,arms,54,27,27
sargeras,1217,warrior,arms,18,13,5
trollbane,1217,warrior,arms,36,20,16
nemesis,1217,warrior,arms,36,13,23
area-52,1213,warrior,arms,47,26,21
area-52,1212,warrior,arms,24,15,9
nemesis,1211,warrior,arms,48,24,24
quelthalas,1211,warrior,arms,30,14,16
ragnaros,1208,warrior,arms,30,14,16
kiljaeden,1203,warrior,arms,36,15,21
nagrand,1197,warrior,arms,65,34,31
area-52,1197,warrior,arms,52,26,26
korgath,1192,warrior,arms,28,14,14
area-52,1191,warrior,arms,59,27,32
ravencrest,1190,warrior,arms,17,13,4
azralon,1189,warrior,arms,56,30,26
kelthuzad,1189,warrior,arms,48,23,25
ragnaros,1185,warrior,arms,42,19,23
tichondrius,1184,warrior,arms,90,39,51
ysondre,1182,warrior,arms,22,13,9
area-52,1182,warrior,arms,36,20,16
frostmourne,1181,warrior,arms,26,14,12
wyrmrest-accord,1179,warrior,arms,108,51,57
stormscale,1177,warrior,arms,28,18,10
ragnaros,1176,warrior,arms,26,13,13
emerald-dream,1174,warrior,arms,26,14,12
malfurion,1174,warrior,arms,35,14,21
proudmoore,1174,warrior,arms,35,14,21
emerald-dream,1171,warrior,arms,22,13,9
perenolde,1167,warrior,arms,63,28,35
area-52,1166,warrior,arms,22,13,9
proudmoore,1166,warrior,arms,33,15,18
stormrage,1165,warrior,arms,32,14,18
wyrmrest-accord,1162,warrior,arms,48,26,22
kiljaeden,1159,warrior,arms,60,29,31
emerald-dream,1152,warrior,arms,18,12,6
tichondrius,1151,warrior,arms,18,12,6
twisting-nether,1151,warrior,arms,18,12,6
frostwolf,1151,warrior,arms,24,12,12
area-52,1151,warrior,arms,30,12,18
illidan,1150,warrior,arms,18,12,6
tichondrius,1150,warrior,arms,19,12,7
thunderhorn,1150,warrior,arms,24,12,12
korgath,1150,warrior,arms,24,12,12
bleeding-hollow,1150,warrior,arms,30,12,18
azralon,1149,warrior,arms,18,12,6
tichondrius,1149,warrior,arms,24,12,12
drakkari,1148,warrior,arms,24,12,12
deathwing,1148,warrior,arms,24,12,12
thrall,1148,warrior,arms,30,12,18
stormrage,1148,warrior,arms,30,12,18
nerzhul,1147,warrior,arms,24,15,9
dalaran,1147,warrior,arms,24,12,12
sargeras,1147,warrior,arms,24,12,12
darkspear,1145,warrior,arms,24,12,12
illidan,1145,warrior,arms,25,12,13
tichondrius,1144,warrior,arms,18,12,6
bleeding-hollow,1144,warrior,arms,24,12,12
tichondrius,1144,warrior,arms,78,27,51
stormrage,1143,warrior,arms,18,12,6
tichondrius,1143,warrior,arms,24,12,12
tichondrius,1143,warrior,arms,30,12,18
barthilas,1141,warrior,arms,24,12,12
azralon,1141,warrior,arms,24,12,12
barthilas,1140,warrior,arms,24,12,12
illidan,1139,warrior,arms,47,24,23
tichondrius,1139,warrior,arms,24,12,12
moon-guard,1138,warrior,arms,24,12,12
quelthalas,1138,warrior,arms,36,12,24
nemesis,1138,warrior,arms,36,12,24
aggramar,1134,warrior,arms,24,12,12
mugthol,1132,warrior,arms,18,12,6
kelthuzad,1132,warrior,arms,41,22,19
tichondrius,1131,warrior,arms,42,26,16
illidan,1129,warrior,arms,24,18,6
zuljin,1129,warrior,arms,24,12,12
kelthuzad,1128,warrior,arms,18,12,6
sargeras,1128,warrior,arms,24,12,12
nemesis,1128,warrior,arms,29,13,16
borean-tundra,1127,warrior,arms,24,12,12
andorhal,1126,warrior,arms,30,12,18
dalaran,1125,warrior,arms,30,13,17
ragnaros,1118,warrior,arms,30,18,12
tichondrius,1118,warrior,arms,24,12,12
stormscale,1114,warrior,arms,24,12,12
saurfang,1114,warrior,arms,30,12,18
moon-guard,1113,warrior,arms,47,23,24
azgalor,1111,warrior,arms,23,12,11
jubeithos,1111,warrior,arms,44,19,25
ragnaros,1111,warrior,arms,30,12,18
tichondrius,1108,warrior,arms,24,15,9
tichondrius,1105,warrior,arms,28,12,16
whisperwind,1103,warrior,arms,75,33,42
area-52,1101,warrior,arms,36,19,17
perenolde,1100,warrior,arms,21,12,9
malganis,1098,warrior,arms,52,25,27
alexstrasza,1097,warrior,arms,34,19,15
ragnaros,1097,warrior,arms,45,17,28
blackrock,1094,warrior,arms,21,13,8
sargeras,1094,warrior,arms,30,12,18
emerald-dream,1092,warrior,arms,84,41,43
stormrage,1090,warrior,arms,23,12,11
quelthalas,1085,warrior,arms,34,15,19
malganis,1080,warrior,arms,20,12,8
stormrage,1079,warrior,arms,24,13,11
quelthalas,1078,warrior,arms,32,13,19
thrall,1074,warrior,arms,72,31,41
sargeras,1071,warrior,arms,75,37,38
nemesis,1070,warrior,arms,82,43,39
burning-blade,1070,warrior,arms,28,12,16
tichondrius,1067,warrior,arms,30,12,18
moonrunner,1063,warrior,arms,63,28,35
senjin,1058,warrior,arms,60,21,39
area-52,1056,warrior,arms,18,11,7
zuljin,1056,warrior,arms,24,11,13
area-52,1056,warrior,arms,24,11,13
tichondrius,1056,warrior,arms,24,11,13
tichondrius,1055,warrior,arms,12,11,1
tichondrius,1055,warrior,arms,12,11,1
tichondrius,1055,warrior,arms,18,11,7
azshara,1055,warrior,arms,18,11,7
kiljaeden,1055,warrior,arms,18,11,7
tichondrius,1055,warrior,arms,24,11,13
area-52,1055,warrior,arms,24,11,13
drakkari,1055,warrior,arms,24,11,13
area-52,1055,warrior,arms,24,11,13
tichondrius,1055,warrior,arms,24,11,13
tichondrius,1055,warrior,arms,30,11,19
tichondrius,1055,warrior,arms,30,11,19
tichondrius,1054,warrior,arms,18,11,7
tichondrius,1054,warrior,arms,24,11,13
frostmourne,1054,warrior,arms,30,11,19
bleeding-hollow,1054,warrior,arms,30,11,19
wyrmrest-accord,1053,warrior,arms,24,11,13
illidan,1053,warrior,arms,24,11,13
frostmourne,1051,warrior,arms,30,11,19
wyrmrest-accord,1051,warrior,arms,30,11,19
azralon,1050,warrior,arms,24,11,13
eldrethalas,1050,warrior,arms,24,11,13
burning-blade,1050,warrior,arms,30,11,19
frostmourne,1049,warrior,arms,18,11,7
moon-guard,1049,warrior,arms,24,11,13
malganis,1048,warrior,arms,22,12,10
quelthalas,1048,warrior,arms,32,11,21
tichondrius,1047,warrior,arms,28,12,16
gorgonnash,1046,warrior,arms,30,16,14
proudmoore,1044,warrior,arms,59,30,29
moon-guard,1044,warrior,arms,36,11,25
perenolde,1041,warrior,arms,20,13,7
dalaran,1041,warrior,arms,24,11,13
dragonmaw,1040,warrior,arms,24,11,13
wyrmrest-accord,1039,warrior,arms,36,11,25
tichondrius,1038,warrior,arms,25,12,13
kelthuzad,1038,warrior,arms,30,11,19
amanthul,1037,warrior,arms,18,11,7
tichondrius,1037,warrior,arms,27,13,14
frostmourne,1037,warrior,arms,24,11,13
tichondrius,1032,warrior,arms,24,11,13
illidan,1031,warrior,arms,24,11,13
quelthalas,1029,warrior,arms,24,11,13
deathwing,1028,warrior,arms,45,13,32
steamwheedle-cartel,1027,warrior,arms,36,16,20
malygos,1014,warrior,arms,18,11,7
skullcrusher,1010,warrior,arms,43,20,23
dark-iron,1009,warrior,arms,26,12,14
nemesis,1009,warrior,arms,60,25,35
quelthalas,1009,warrior,arms,39,16,23
illidan,1006,warrior,arms,21,13,8
tichondrius,1006,warrior,arms,35,18,17
aerie-peak,1004,warrior,arms,32,11,21
farstriders,1001,warrior,arms,23,11,12
ragnaros,1000,warrior,arms,24,13,11
tichondrius,995,warrior,arms,42,16,26
azralon,994,warrior,arms,35,18,17
sargeras,994,warrior,arms,39,19,20
tichondrius,993,warrior,arms,23,11,12
thrall,992,warrior,arms,36,12,24
tichondrius,991,warrior,arms,17,11,6
ragnaros,991,warrior,arms,17,11,6
quelthalas,990,warrior,arms,36,11,25
azjolnerub,988,warrior,arms,23,11,12
frostwolf,984,warrior,arms,22,11,11
area-52,977,warrior,arms,36,16,20
tichondrius,974,warrior,arms,19,11,8
malganis,973,warrior,arms,25,11,14
zuljin,960,warrior,arms,12,10,2
anvilmar,960,warrior,arms,18,10,8
malganis,960,warrior,arms,18,10,8
tichondrius,960,warrior,arms,18,10,8
tichondrius,960,warrior,arms,18,10,8
malganis,960,warrior,arms,18,10,8
tichondrius,960,warrior,arms,18,10,8
sargeras,960,warrior,arms,24,10,14
tichondrius,960,warrior,arms,24,10,14
bleeding-hollow,960,warrior,arms,24,10,14
stormrage,960,warrior,arms,24,10,14
azralon,960,warrior,arms,30,10,20
sargeras,959,warrior,arms,12,10,2
steamwheedle-cartel,959,warrior,arms,18,10,8
tichondrius,959,warrior,arms,18,10,8
shadowsong,959,warrior,arms,18,10,8
stormrage,959,warrior,arms,18,10,8
sargeras,959,warrior,arms,18,10,8
tichondrius,959,warrior,arms,18,10,8
tichondrius,959,warrior,arms,24,10,14
tichondrius,959,warrior,arms,24,10,14
dragonmaw,958,warrior,arms,18,10,8
sargeras,958,warrior,arms,18,10,8
tichondrius,958,warrior,arms,18,10,8
tichondrius,958,warrior,arms,18,10,8
proudmoore,958,warrior,arms,18,10,8
aegwynn,958,warrior,arms,24,10,14
dreadmaul,958,warrior,arms,24,10,14
tichondrius,957,warrior,arms,16,11,5
draenor,957,warrior,arms,68,37,31
zuljin,957,warrior,arms,24,10,14
zuljin,956,warrior,arms,12,10,2
moon-guard,956,warrior,arms,26,11,15
drakkari,955,warrior,arms,12,10,2
malganis,955,warrior,arms,18,10,8
tichondrius,955,warrior,arms,18,10,8
blackwater-raiders,955,warrior,arms,66,32,34
shandris,954,warrior,arms,18,10,8
eldrethalas,954,warrior,arms,36,10,26
wyrmrest-accord,953,warrior,arms,18,10,8
malganis,952,warrior,arms,18,10,8
dalaran,952,warrior,arms,24,10,14
sargeras,952,warrior,arms,24,10,14
barthilas,951,warrior,arms,18,10,8
tichondrius,951,warrior,arms,24,10,14
arathor,950,warrior,arms,18,10,8
nemesis,950,warrior,arms,24,10,14
emerald-dream,949,warrior,arms,18,10,8
blood-furnace,949,warrior,arms,18,10,8
tichondrius,946,warrior,arms,24,10,14
frostmourne,945,warrior,arms,18,10,8
stormrage,942,warrior,arms,19,12,7
frostmane,941,warrior,arms,26,11,15
ragnaros,925,warrior,arms,20,11,9
hyjal,921,warrior,arms,17,10,7
drakkari,918,warrior,arms,28,12,16
frostmane,914,warrior,arms,23,10,13
tichondrius,911,warrior,arms,27,10,17
thrall,911,warrior,arms,29,10,19
stormrage,910,warrior,arms,23,10,13
stormrage,909,warrior,arms,18,10,8
amanthul,905,warrior,arms,20,11,9
frostmourne,904,warrior,arms,21,10,11
ragnaros,896,warrior,arms,16,10,6
illidan,894,warrior,arms,23,10,13
illidan,888,warrior,arms,16,10,6
sargeras,887,warrior,arms,20,10,10
garrosh,875,warrior,arms,19,10,9
dreadmaul,869,warrior,arms,18,10,8
frostmourne,864,warrior,arms,12,9,3
darkspear,864,warrior,arms,12,9,3
malganis,864,warrior,arms,12,9,3
illidan,864,warrior,arms,12,9,3
korgath,864,warrior,arms,12,9,3
blood-furnace,864,warrior,arms,18,9,9
quelthalas,864,warrior,arms,18,9,9
tichondrius,864,warrior,arms,18,9,9
fizzcrank,864,warrior,arms,18,9,9
stormrage,864,warrior,arms,18,9,9
malganis,864,warrior,arms,18,9,9
moon-guard,864,warrior,arms,18,9,9
stormrage,864,warrior,arms,18,9,9
tichondrius,864,warrior,arms,18,9,9
stormrage,864,warrior,arms,18,9,9
mugthol,864,warrior,arms,18,9,9
malygos,864,warrior,arms,18,9,9
tichondrius,864,warrior,arms,18,9,9
tichondrius,864,warrior,arms,24,9,15
sargeras,864,warrior,arms,24,9,15
sargeras,864,warrior,arms,24,9,15
moon-guard,864,warrior,arms,24,9,15
wyrmrest-accord,863,warrior,arms,12,9,3
sargeras,863,warrior,arms,12,9,3
lightnings-blade,863,warrior,arms,18,9,9
ragnaros,863,warrior,arms,18,9,9
kelthuzad,863,warrior,arms,18,9,9
tichondrius,863,warrior,arms,18,9,9
illidan,863,warrior,arms,18,9,9
sargeras,863,warrior,arms,18,9,9
tichondrius,863,warrior,arms,18,9,9
malganis,863,warrior,arms,18,9,9
moon-guard,863,warrior,arms,21,10,11
ragnaros,863,warrior,arms,22,10,12
tichondrius,863,warrior,arms,21,9,12
tichondrius,863,warrior,arms,24,9,15
thunderhorn,863,warrior,arms,24,9,15
bleeding-hollow,862,warrior,arms,18,9,9
goldrinn,862,warrior,arms,18,9,9
bleeding-hollow,862,warrior,arms,24,9,15
azralon,862,warrior,arms,24,9,15
gorefiend,861,warrior,arms,30,9,21
tichondrius,860,warrior,arms,12,9,3
fizzcrank,860,warrior,arms,18,9,9
ragnaros,860,warrior,arms,18,9,9
sargeras,860,warrior,arms,18,9,9
illidan,860,warrior,arms,19,9,10
illidan,860,warrior,arms,24,9,15
mannoroth,860,warrior,arms,24,9,15
moon-guard,860,warrior,arms,24,9,15
lightbringer,859,warrior,arms,18,9,9
malganis,859,warrior,arms,18,9,9
quelthalas,859,warrior,arms,18,9,9
mannoroth,859,warrior,arms,18,9,9
quelthalas,859,warrior,arms,24,9,15
stormreaver,859,warrior,arms,27,10,17
quelthalas,858,warrior,arms,18,9,9
skullcrusher,858,warrior,arms,24,11,13
bleeding-hollow,858,warrior,arms,24,9,15
azgalor,857,warrior,arms,26,10,16
stormrage,857,warrior,arms,24,9,15
sargeras,854,warrior,arms,12,9,3
thrall,853,warrior,arms,12,9,3
sargeras,852,warrior,arms,18,9,9
borean-tundra,851,warrior,arms,12,9,3
goldrinn,846,warrior,arms,18,9,9
malganis,845,warrior,arms,23,9,14
stormrage,845,warrior,arms,24,9,15
barthilas,834,warrior,arms,18,9,9
kelthuzad,831,warrior,arms,17,9,8
quelthalas,831,warrior,arms,22,9,13
tichondrius,830,warrior,arms,19,10,9
frostmourne,830,warrior,arms,26,10,16
tichondrius,827,warrior,arms,17,9,8
area-52,826,warrior,arms,17,9,8
hyjal,823,warrior,arms,23,9,14
tichondrius,816,warrior,arms,15,9,6
kelthuzad,816,warrior,arms,21,9,12
stormrage,814,warrior,arms,21,9,12
gorgonnash,806,warrior,arms,34,10,24
stormrage,799,warrior,arms,20,9,11
tichondrius,798,warrior,arms,22,9,13
moon-guard,798,warrior,arms,34,9,25
sargeras,797,warrior,arms,20,9,11
sargeras,788,warrior,arms,20,10,10
emerald-dream,783,warrior,arms,13,9,4
quelthalas,768,warrior,arms,12,8,4
hyjal,768,warrior,arms,12,8,4
tichondrius,768,warrior,arms,12,8,4
tichondrius,768,warrior,arms,12,8,4
illidan,768,warrior,arms,12,8,4
black-dragonflight,768,warrior,arms,12,8,4
emerald-dream,768,warrior,arms,12,8,4
quelthalas,768,warrior,arms,12,8,4
stormrage,768,warrior,arms,12,8,4
wyrmrest-accord,768,warrior,arms,12,8,4
tichondrius,768,warrior,arms,12,8,4
sargeras,768,warrior,arms,12,8,4
tichondrius,768,warrior,arms,12,8,4
frostwolf,768,warrior,arms,12,8,4
tichondrius,768,warrior,arms,18,8,10
tichondrius,768,warrior,arms,18,8,10
bleeding-hollow,768,warrior,arms,18,8,10
khadgar,768,warrior,arms,18,8,10
moon-guard,768,warrior,arms,18,8,10
zuljin,768,warrior,arms,18,8,10
tichondrius,768,warrior,arms,18,8,10
darkspear,768,warrior,arms,18,8,10
emerald-dream,768,warrior,arms,18,8,10
area-52,768,warrior,arms,18,8,10
tichondrius,768,warrior,arms,24,8,16
tichondrius,768,warrior,arms,24,8,16
darkspear,768,warrior,arms,24,8,16
tichondrius,768,warrior,arms,24,8,16
bleeding-hollow,768,warrior,arms,24,8,16
tichondrius,768,warrior,arms,24,8,16
tichondrius,767,warrior,arms,12,8,4
sargeras,767,warrior,arms,12,8,4
terokkar,767,warrior,arms,12,8,4
aerie-peak,767,warrior,arms,12,8,4
illidan,767,warrior,arms,12,8,4
azralon,767,warrior,arms,12,8,4
illidan,767,warrior,arms,12,8,4
area-52,767,warrior,arms,12,8,4
drakkari,767,warrior,arms,12,8,4
illidan,767,warrior,arms,12,8,4
moon-guard,767,warrior,arms,12,8,4
tichondrius,767,warrior,arms,12,8,4
frostmourne,767,warrior,arms,12,8,4
moon-guard,767,warrior,arms,12,8,4
shadow-council,767,warrior,arms,12,8,4
deathwing,767,warrior,arms,16,9,7
zuljin,767,warrior,arms,18,8,10
azralon,767,warrior,arms,18,8,10
area-52,767,warrior,arms,18,8,10
mannoroth,767,warrior,arms,18,8,10
aegwynn,767,warrior,arms,18,8,10
quelthalas,767,warrior,arms,18,8,10
stormrage,767,warrior,arms,20,8,12
azralon,767,warrior,arms,24,8,16
drakkari,767,warrior,arms,24,8,16
quelthalas,767,warrior,arms,24,8,16
wildhammer,767,warrior,arms,24,8,16
aerie-peak,767,warrior,arms,24,8,16
sargeras,767,warrior,arms,24,8,16
barthilas,767,warrior,arms,30,8,22
kelthuzad,766,warrior,arms,12,8,4
jubeithos,766,warrior,arms,12,8,4
tichondrius,766,warrior,arms,12,8,4
ragnaros,766,warrior,arms,18,8,10
tichondrius,766,warrior,arms,18,8,10
ragnaros,766,warrior,arms,18,8,10
sargeras,766,warrior,arms,22,8,14
mugthol,765,warrior,arms,24,8,16
illidan,765,warrior,arms,24,8,16
frostmourne,764,warrior,arms,18,8,10
chogall,764,warrior,arms,18,8,10
azjolnerub,763,warrior,arms,18,8,10
gorgonnash,763,warrior,arms,18,8,10
tichondrius,762,warrior,arms,16,9,7
greymane,761,warrior,arms,12,8,4
illidan,761,warrior,arms,25,10,15
ragnaros,759,warrior,arms,18,8,10
hyjal,757,warrior,arms,21,9,12
malganis,755,warrior,arms,12,8,4
nazjatar,735,warrior,arms,11,8,3
drakkari,734,warrior,arms,17,8,9
tichondrius,734,warrior,arms,17,8,9
blood-furnace,723,warrior,arms,24,8,16
area-52,719,warrior,arms,17,8,9
sargeras,718,warrior,arms,11,8,3
silver-hand,718,warrior,arms,11,8,3
azralon,718,warrior,arms,17,8,9
area-52,718,warrior,arms,17,8,9
tichondrius,714,warrior,arms,33,9,24
illidan,703,warrior,arms,16,8,8
kiljaeden,703,warrior,arms,17,8,9
tichondrius,701,warrior,arms,16,8,8
frostmourne,688,warrior,arms,13,8,5
proudmoore,687,warrior,arms,13,8,5
area-52,680,warrior,arms,20,10,10
tichondrius,672,warrior,arms,12,7,5
tichondrius,672,warrior,arms,12,7,5
frostmourne,672,warrior,arms,12,7,5
sargeras,672,warrior,arms,12,7,5
thunderlord,672,warrior,arms,12,7,5
wyrmrest-accord,672,warrior,arms,12,7,5
tichondrius,672,warrior,arms,12,7,5
tichondrius,672,warrior,arms,12,7,5
frostmourne,672,warrior,arms,12,7,5
zuljin,672,warrior,arms,12,7,5
barthilas,672,warrior,arms,12,7,5
zuljin,672,warrior,arms,12,7,5
azralon,672,warrior,arms,12,7,5
zangarmarsh,672,warrior,arms,12,7,5
aegwynn,672,warrior,arms,12,7,5
azralon,672,warrior,arms,12,7,5
malganis,672,warrior,arms,12,7,5
malganis,672,warrior,arms,12,7,5
sargeras,672,warrior,arms,12,7,5
mugthol,672,warrior,arms,12,7,5
malganis,672,warrior,arms,12,7,5
tichondrius,672,warrior,arms,12,7,5
korgath,672,warrior,arms,12,7,5
whisperwind,672,warrior,arms,12,7,5
dalaran,672,warrior,arms,12,7,5
sargeras,672,warrior,arms,12,7,5
kelthuzad,672,warrior,arms,12,7,5
frostmourne,672,warrior,arms,12,7,5
illidan,672,warrior,arms,12,7,5
moon-guard,672,warrior,arms,12,7,5
proudmoore,672,warrior,arms,12,7,5
area-52,672,warrior,arms,12,7,5
illidan,672,warrior,arms,12,7,5
drakkari,672,warrior,arms,12,7,5
sargeras,672,warrior,arms,12,7,5
malygos,672,warrior,arms,12,7,5
emerald-dream,672,warrior,arms,12,7,5
stormrage,672,warrior,arms,12,7,5
kiljaeden,672,warrior,arms,12,7,5
stormrage,672,warrior,arms,12,7,5
moon-guard,672,warrior,arms,12,7,5
stormrage,672,warrior,arms,12,7,5
chogall,672,warrior,arms,16,8,8
nordrassil,672,warrior,arms,18,7,11
stormrage,672,warrior,arms,18,7,11
ragnaros,672,warrior,arms,18,7,11
emerald-dream,672,warrior,arms,18,7,11
doomhammer,672,warrior,arms,18,7,11
tichondrius,672,warrior,arms,18,7,11
bleeding-hollow,672,warrior,arms,18,7,11
frostmane,672,warrior,arms,18,7,11
stormrage,672,warrior,arms,18,7,11
malganis,672,warrior,arms,18,7,11
area-52,672,warrior,arms,18,7,11
sargeras,672,warrior,arms,18,7,11
mugthol,672,warrior,arms,18,7,11
illidan,672,warrior,arms,18,7,11
duskwood,672,warrior,arms,18,7,11
barthilas,672,warrior,arms,18,7,11
wyrmrest-accord,672,warrior,arms,24,7,17
tichondrius,672,warrior,arms,24,7,17
hakkar,671,warrior,arms,12,7,5
stormrage,671,warrior,arms,12,7,5
area-52,671,warrior,arms,12,7,5
area-52,671,warrior,arms,12,7,5
kelthuzad,671,warrior,arms,12,7,5
akama,671,warrior,arms,12,7,5
frostmourne,671,warrior,arms,12,7,5
quelthalas,671,warrior,arms,12,7,5
malganis,671,warrior,arms,12,7,5
dalaran,671,warrior,arms,12,7,5
frostmourne,671,warrior,arms,12,7,5
blackhand,671,warrior,arms,12,7,5
ragnaros,671,warrior,arms,12,7,5
malfurion,671,warrior,arms,12,7,5
kiljaeden,671,warrior,arms,12,7,5
ghostlands,671,warrior,arms,12,7,5
tichondrius,671,warrior,arms,12,7,5
bleeding-hollow,671,warrior,arms,12,7,5
tichondrius,671,warrior,arms,12,7,5
quelthalas,671,warrior,arms,12,7,5
malganis,671,warrior,arms,12,7,5
tichondrius,671,warrior,arms,18,7,11
illidan,671,warrior,arms,18,7,11
tichondrius,671,warrior,arms,18,7,11
stormrage,671,warrior,arms,18,7,11
icecrown,671,warrior,arms,18,7,11
ysera,671,warrior,arms,18,7,11
illidan,670,warrior,arms,12,7,5
wyrmrest-accord,670,warrior,arms,12,7,5
tichondrius,670,warrior,arms,12,7,5
kiljaeden,670,warrior,arms,18,7,11
malganis,670,warrior,arms,18,7,11
hyjal,670,warrior,arms,18,7,11
drakkari,670,warrior,arms,18,7,11
ragnaros,670,warrior,arms,24,7,17
zuljin,670,warrior,arms,24,7,17
dragonmaw,669,warrior,arms,12,7,5
garrosh,669,warrior,arms,18,7,11
amanthul,668,warrior,arms,12,7,5
tichondrius,668,warrior,arms,18,7,11
azralon,668,warrior,arms,18,7,11
tichondrius,667,warrior,arms,18,7,11
sargeras,667,warrior,arms,24,7,17
area-52,666,warrior,arms,12,7,5
ragnaros,666,warrior,arms,18,7,11
stormrage,665,warrior,arms,18,7,11
dalaran,663,warrior,arms,12,7,5
doomhammer,663,warrior,arms,18,7,11
gnomeregan,659,warrior,arms,13,7,6
hydraxis,639,warrior,arms,16,7,9
azralon,639,warrior,arms,20,8,12
sargeras,638,warrior,arms,16,7,9
frostmourne,638,warrior,arms,22,7,15
thrall,637,warrior,arms,17,7,10
malfurion,637,warrior,arms,17,7,10
kelthuzad,624,warrior,arms,9,8,1
quelthalas,623,warrior,arms,11,7,4
burning-blade,623,warrior,arms,17,7,10
malganis,621,warrior,arms,11,7,4
kelthuzad,617,warrior,arms,26,8,18
zuljin,606,warrior,arms,14,7,7
tichondrius,605,warrior,arms,16,7,9
dentarg,592,warrior,arms,13,7,6
gilneas,576,warrior,arms,6,6,0
ragnaros,576,warrior,arms,6,6,0
thrall,576,warrior,arms,6,6,0
tichondrius,576,warrior,arms,6,6,0
malfurion,576,warrior,arms,6,6,0
senjin,576,warrior,arms,6,6,0
proudmoore,576,warrior,arms,12,6,6
area-52,576,warrior,arms,12,6,6
tichondrius,576,warrior,arms,12,6,6
tichondrius,576,warrior,arms,12,6,6
area-52,576,warrior,arms,12,6,6
area-52,576,warrior,arms,12,6,6
sargeras,576,warrior,arms,12,6,6
emerald-dream,576,warrior,arms,12,6,6
magtheridon,576,warrior,arms,12,6,6
dragonmaw,576,warrior,arms,12,6,6
emerald-dream,576,warrior,arms,12,6,6
nemesis,576,warrior,arms,12,6,6
ragnaros,576,warrior,arms,12,6,6
nerzhul,576,warrior,arms,12,6,6
sargeras,576,warrior,arms,12,6,6
undermine,576,warrior,arms,12,6,6
ragnaros,576,warrior,arms,12,6,6
thunderhorn,576,warrior,arms,12,6,6
barthilas,576,warrior,arms,12,6,6
quelthalas,576,warrior,arms,12,6,6
tichondrius,576,warrior,arms,12,6,6
barthilas,576,warrior,arms,12,6,6
dunemaul,576,warrior,arms,12,6,6
moon-guard,576,warrior,arms,12,6,6
barthilas,576,warrior,arms,12,6,6
boulderfist,576,warrior,arms,12,6,6
thrall,576,warrior,arms,12,6,6
emerald-dream,576,warrior,arms,12,6,6
sargeras,576,warrior,arms,12,6,6
sargeras,576,warrior,arms,12,6,6
bleeding-hollow,576,warrior,arms,12,6,6
eonar,576,warrior,arms,12,6,6
sargeras,576,warrior,arms,12,6,6
thrall,576,warrior,arms,12,6,6
moon-guard,576,warrior,arms,12,6,6
tichondrius,576,warrior,arms,12,6,6
moon-guard,576,warrior,arms,12,6,6
tichondrius,576,warrior,arms,12,6,6
icecrown,576,warrior,arms,12,6,6
azralon,576,warrior,arms,12,6,6
tichondrius,576,warrior,arms,12,6,6
tichondrius,576,warrior,arms,12,6,6
frostmourne,576,warrior,arms,12,6,6
illidan,576,warrior,arms,12,6,6
quelthalas,576,warrior,arms,12,6,6
illidan,576,warrior,arms,12,6,6
proudmoore,576,warrior,arms,12,6,6
zuljin,576,warrior,arms,12,6,6
malganis,576,warrior,arms,12,6,6
ragnaros,576,warrior,arms,12,6,6
area-52,576,warrior,arms,12,6,6
korgath,576,warrior,arms,12,6,6
sargeras,576,warrior,arms,12,6,6
tichondrius,576,warrior,arms,12,6,6
ragnaros,576,warrior,arms,12,6,6
stormrage,576,warrior,arms,12,6,6
blackhand,576,warrior,arms,12,6,6
illidan,576,warrior,arms,12,6,6
sargeras,576,warrior,arms,12,6,6
ragnaros,576,warrior,arms,12,6,6
malganis,576,warrior,arms,12,6,6
tichondrius,576,warrior,arms,12,6,6
illidan,576,warrior,arms,12,6,6
tichondrius,576,warrior,arms,13,6,7
quelthalas,576,warrior,arms,18,6,12
kelthuzad,576,warrior,arms,18,6,12
area-52,576,warrior,arms,18,6,12
frostmourne,576,warrior,arms,18,6,12
tichondrius,576,warrior,arms,18,6,12
shuhalo,576,warrior,arms,18,6,12
area-52,576,warrior,arms,18,6,12
emerald-dream,576,warrior,arms,18,6,12
malganis,576,warrior,arms,18,6,12
dawnbringer,576,warrior,arms,18,6,12
illidan,576,warrior,arms,18,6,12
azralon,576,warrior,arms,18,6,12
tichondrius,576,warrior,arms,18,6,12
tichondrius,576,warrior,arms,18,6,12
sargeras,576,warrior,arms,18,6,12
quelthalas,576,warrior,arms,24,6,18
moon-guard,576,warrior,arms,24,6,18
tichondrius,576,warrior,arms,24,6,18
ragnaros,575,warrior,arms,6,6,0
ragnaros,575,warrior,arms,6,6,0
tichondrius,575,warrior,arms,12,6,6
ragnaros,575,warrior,arms,12,6,6
ragnaros,575,warrior,arms,12,6,6
quelthalas,575,warrior,arms,12,6,6
dentarg,575,warrior,arms,12,6,6
stormrage,575,warrior,arms,12,6,6
stormrage,575,warrior,arms,12,6,6
archimonde,575,warrior,arms,12,6,6
azralon,575,warrior,arms,12,6,6
sargeras,575,warrior,arms,12,6,6
proudmoore,575,warrior,arms,12,6,6
shadowsong,575,warrior,arms,12,6,6
tichondrius,575,warrior,arms,12,6,6
kiljaeden,575,warrior,arms,12,6,6
drakkari,575,warrior,arms,12,6,6
barthilas,575,warrior,arms,12,6,6
blackrock,575,warrior,arms,12,6,6
quelthalas,575,warrior,arms,15,7,8
darkspear,575,warrior,arms,13,6,7
stormrage,575,warrior,arms,18,6,12
draktharon,575,warrior,arms,18,6,12
nazjatar,575,warrior,arms,18,6,12
proudmoore,575,warrior,arms,18,6,12
nemesis,574,warrior,arms,6,6,0
illidan,574,warrior,arms,12,6,6
quelthalas,574,warrior,arms,12,6,6
drakkari,573,warrior,arms,12,6,6
borean-tundra,573,warrior,arms,18,6,12
zuljin,572,warrior,arms,18,6,12
ragnaros,571,warrior,arms,12,6,6
tichondrius,543,warrior,arms,8,7,1
moon-guard,543,warrior,arms,8,7,1
stormrage,543,warrior,arms,11,6,5
illidan,543,warrior,arms,11,6,5
barthilas,543,warrior,arms,14,7,7
tichondrius,542,warrior,arms,11,6,5
moon-guard,542,warrior,arms,14,7,7
illidan,541,warrior,arms,10,6,4
wyrmrest-accord,527,warrior,arms,11,6,5
alleria,524,warrior,arms,11,6,5
bleeding-hollow,522,warrior,arms,17,9,8
kiljaeden,522,warrior,arms,19,8,11
kiljaeden,519,warrior,arms,21,9,12
tichondrius,512,warrior,arms,16,6,10
lethon,511,warrior,arms,8,6,2
tichondrius,511,warrior,arms,14,6,8
frostwolf,511,warrior,arms,14,6,8
wyrmrest-accord,511,warrior,arms,14,6,8
area-52,511,warrior,arms,16,6,10
ysera,511,warrior,arms,17,6,11
bonechewer,510,warrior,arms,14,6,8
emerald-dream,510,warrior,arms,14,6,8
malganis,507,warrior,arms,8,6,2
shadowsong,495,warrior,arms,13,7,6
tichondrius,480,warrior,arms,6,5,1
illidan,480,warrior,arms,6,5,1
khaz-modan,480,warrior,arms,6,5,1
illidan,480,warrior,arms,6,5,1
sargeras,480,warrior,arms,6,5,1
frostmourne,480,warrior,arms,6,5,1
khaz-modan,480,warrior,arms,6,5,1
amanthul,480,warrior,arms,6,5,1
kelthuzad,480,warrior,arms,6,5,1
kelthuzad,480,warrior,arms,6,5,1
tichondrius,480,warrior,arms,6,5,1
tichondrius,480,warrior,arms,6,5,1
tichondrius,480,warrior,arms,6,5,1
darkspear,480,warrior,arms,6,5,1
kelthuzad,480,warrior,arms,6,5,1
area-52,480,warrior,arms,6,5,1
nesingwary,480,warrior,arms,6,5,1
khadgar,480,warrior,arms,6,5,1
nemesis,480,warrior,arms,6,5,1
tichondrius,480,warrior,arms,6,5,1
korgath,480,warrior,arms,6,5,1
tichondrius,480,warrior,arms,6,5,1
emerald-dream,480,warrior,arms,6,5,1
dragonmaw,480,warrior,arms,6,5,1
tichondrius,480,warrior,arms,6,5,1
tichondrius,480,warrior,arms,6,5,1
magtheridon,480,warrior,arms,6,5,1
korgath,480,warrior,arms,6,5,1
tichondrius,480,warrior,arms,6,5,1
nemesis,480,warrior,arms,6,5,1
stormrage,480,warrior,arms,6,5,1
sargeras,480,warrior,arms,6,5,1
thrall,480,warrior,arms,12,5,7
khadgar,480,warrior,arms,12,5,7
exodar,480,warrior,arms,12,5,7
tichondrius,480,warrior,arms,12,5,7
tichondrius,480,warrior,arms,12,5,7
quelthalas,480,warrior,arms,12,5,7
tichondrius,480,warrior,arms,12,5,7
tichondrius,480,warrior,arms,12,5,7
moon-guard,480,warrior,arms,12,5,7
tichondrius,480,warrior,arms,12,5,7
ragnaros,480,warrior,arms,12,5,7
tichondrius,480,warrior,arms,12,5,7
cairne,480,warrior,arms,12,5,7
tichondrius,480,warrior,arms,12,5,7
korgath,480,warrior,arms,12,5,7
nemesis,480,warrior,arms,12,5,7
moon-guard,480,warrior,arms,12,5,7
tichondrius,480,warrior,arms,12,5,7
tichondrius,480,warrior,arms,12,5,7
lightbringer,480,warrior,arms,12,5,7
tichondrius,480,warrior,arms,12,5,7
tichondrius,480,warrior,arms,12,5,7
frostwolf,480,warrior,arms,12,5,7
tichondrius,480,warrior,arms,12,5,7
malganis,480,warrior,arms,12,5,7
drenden,480,warrior,arms,12,5,7
spirestone,480,warrior,arms,12,5,7
tichondrius,480,warrior,arms,12,5,7
aegwynn,480,warrior,arms,12,5,7
turalyon,480,warrior,arms,12,5,7
tichondrius,480,warrior,arms,12,5,7
turalyon,480,warrior,arms,12,5,7
kiljaeden,480,warrior,arms,12,5,7
kiljaeden,480,warrior,arms,12,5,7
area-52,480,warrior,arms,12,5,7
moon-guard,480,warrior,arms,12,5,7
proudmoore,480,warrior,arms,12,5,7
area-52,480,warrior,arms,12,5,7
proudmoore,480,warrior,arms,12,5,7
proudmoore,480,warrior,arms,12,5,7
kelthuzad,480,warrior,arms,12,5,7
sargeras,480,warrior,arms,12,5,7
gilneas,480,warrior,arms,12,5,7
mannoroth,480,warrior,arms,12,5,7
bleeding-hollow,480,warrior,arms,12,5,7
azralon,480,warrior,arms,12,5,7
bleeding-hollow,480,warrior,arms,12,5,7
zuljin,480,warrior,arms,12,5,7
zuljin,480,warrior,arms,12,5,7
sargeras,480,warrior,arms,12,5,7
sargeras,480,warrior,arms,12,5,7
sargeras,480,warrior,arms,12,5,7
zuljin,480,warrior,arms,12,5,7
alterac-mountains,480,warrior,arms,12,5,7
malfurion,480,warrior,arms,12,5,7
azshara,480,warrior,arms,12,5,7
greymane,480,warrior,arms,12,5,7
illidan,480,warrior,arms,12,5,7
stormrage,480,warrior,arms,12,5,7
illidan,480,warrior,arms,12,5,7
barthilas,480,warrior,arms,12,5,7
barthilas,480,warrior,arms,12,5,7
stormrage,480,warrior,arms,12,5,7
illidan,480,warrior,arms,12,5,7
illidan,480,warrior,arms,12,5,7
frostmourne,480,warrior,arms,12,5,7
nagrand,480,warrior,arms,12,5,7
frostmourne,480,warrior,arms,12,5,7
veknilash,480,warrior,arms,15,6,9
burning-legion,480,warrior,arms,13,5,8
bleeding-hollow,480,warrior,arms,14,5,9
tichondrius,480,warrior,arms,16,5,11
ragnaros,480,warrior,arms,26,8,18
tichondrius,480,warrior,arms,18,5,13
dalaran,480,warrior,arms,18,5,13
azralon,480,warrior,arms,18,5,13
drakkari,480,warrior,arms,18,5,13
hakkar,480,warrior,arms,18,5,13
frostmane,480,warrior,arms,18,5,13
stormrage,480,warrior,arms,18,5,13
aerie-peak,480,warrior,arms,18,5,13
ragnaros,480,warrior,arms,18,5,13
moon-guard,480,warrior,arms,18,5,13
tichondrius,480,warrior,arms,18,5,13
emerald-dream,480,warrior,arms,18,5,13
quelthalas,480,warrior,arms,18,5,13
proudmoore,479,warrior,arms,6,5,1
korgath,479,warrior,arms,6,5,1
ragnaros,479,warrior,arms,6,5,1
proudmoore,479,warrior,arms,10,6,4
bleeding-hollow,479,warrior,arms,12,5,7
zuluhed,479,warrior,arms,12,5,7
zuljin,479,warrior,arms,12,5,7
frostmourne,479,warrior,arms,12,5,7
tichondrius,479,warrior,arms,12,5,7
drakkari,479,warrior,arms,12,5,7
tichondrius,479,warrior,arms,12,5,7
frostmourne,479,warrior,arms,12,5,7
moon-guard,479,warrior,arms,12,5,7
ragnaros,479,warrior,arms,12,5,7
tanaris,479,warrior,arms,12,5,7
ragnaros,479,warrior,arms,12,5,7
hyjal,479,warrior,arms,18,5,13
quelthalas,479,warrior,arms,18,5,13
moon-guard,479,warrior,arms,22,5,17
stormrage,478,warrior,arms,6,5,1
proudmoore,478,warrior,arms,12,5,7
tichondrius,477,warrior,arms,6,5,1
ragnaros,477,warrior,arms,6,5,1
nagrand,477,warrior,arms,18,5,13
nemesis,476,warrior,arms,13,5,8
azralon,474,warrior,arms,18,5,13
azralon,448,warrior,arms,10,6,4
area-52,448,warrior,arms,10,6,4
tichondrius,447,warrior,arms,11,5,6
zuljin,447,warrior,arms,17,5,12
frostmourne,447,warrior,arms,17,5,12
nemesis,432,warrior,arms,9,6,3
dalaran,432,warrior,arms,15,5,10
shuhalo,426,warrior,arms,15,6,9
kiljaeden,415,warrior,arms,10,5,5
frostmourne,415,warrior,arms,14,5,9
tichondrius,399,warrior,arms,13,5,8
thrall,384,warrior,arms,6,4,2
illidan,384,warrior,arms,6,4,2
illidan,384,warrior,arms,6,4,2
nemesis,384,warrior,arms,6,4,2
nemesis,384,warrior,arms,6,4,2
illidan,384,warrior,arms,6,4,2
illidan,384,warrior,arms,6,4,2
illidan,384,warrior,arms,6,4,2
barthilas,384,warrior,arms,6,4,2
proudmoore,384,warrior,arms,6,4,2
ragnaros,384,warrior,arms,6,4,2
shadow-council,384,warrior,arms,6,4,2
tichondrius,384,warrior,arms,6,4,2
tichondrius,384,warrior,arms,6,4,2
kelthuzad,384,warrior,arms,6,4,2
madoran,384,warrior,arms,6,4,2
stormrage,384,warrior,arms,6,4,2
azralon,384,warrior,arms,6,4,2
wyrmrest-accord,384,warrior,arms,6,4,2
area-52,384,warrior,arms,6,4,2
ragnaros,384,warrior,arms,6,4,2
dragonmaw,384,warrior,arms,6,4,2
frostmourne,384,warrior,arms,6,4,2
ragnaros,384,warrior,arms,6,4,2
stormrage,384,warrior,arms,6,4,2
arygos,384,warrior,arms,6,4,2
tichondrius,384,warrior,arms,6,4,2
sargeras,384,warrior,arms,6,4,2
ragnaros,384,warrior,arms,6,4,2
area-52,384,warrior,arms,6,4,2
stormrage,384,warrior,arms,6,4,2
quelthalas,384,warrior,arms,6,4,2
wyrmrest-accord,384,warrior,arms,6,4,2
agamaggan,384,warrior,arms,6,4,2
bloodscalp,384,warrior,arms,6,4,2
sargeras,384,warrior,arms,6,4,2
tichondrius,384,warrior,arms,6,4,2
moon-guard,384,warrior,arms,6,4,2
moon-guard,384,warrior,arms,6,4,2
moon-guard,384,warrior,arms,6,4,2
blood-furnace,384,warrior,arms,6,4,2
tichondrius,384,warrior,arms,6,4,2
azralon,384,warrior,arms,6,4,2
mannoroth,384,warrior,arms,6,4,2
arthas,384,warrior,arms,6,4,2
area-52,384,warrior,arms,6,4,2
tichondrius,384,warrior,arms,6,4,2
moon-guard,384,warrior,arms,6,4,2
moknathal,384,warrior,arms,6,4,2
dathremar,384,warrior,arms,6,4,2
lethon,384,warrior,arms,6,4,2
laughing-skull,384,warrior,arms,6,4,2
frostmourne,384,warrior,arms,6,4,2
darkspear,384,warrior,arms,6,4,2
wyrmrest-accord,384,warrior,arms,6,4,2
sargeras,384,warrior,arms,6,4,2
quelthalas,384,warrior,arms,6,4,2
area-52,384,warrior,arms,6,4,2
kiljaeden,384,warrior,arms,6,4,2
tichondrius,384,warrior,arms,6,4,2
hyjal,384,warrior,arms,6,4,2
tichondrius,384,warrior,arms,6,4,2
quelthalas,384,warrior,arms,6,4,2
kelthuzad,384,warrior,arms,6,4,2
frostmourne,384,warrior,arms,6,4,2
shadowmoon,384,warrior,arms,6,4,2
hakkar,384,warrior,arms,6,4,2
shadowmoon,384,warrior,arms,6,4,2
aegwynn,384,warrior,arms,6,4,2
malganis,384,warrior,arms,6,4,2
lightninghoof,384,warrior,arms,6,4,2
bleeding-hollow,384,warrior,arms,6,4,2
frostmourne,384,warrior,arms,6,4,2
area-52,384,warrior,arms,6,4,2
quelthalas,384,warrior,arms,6,4,2
bleeding-hollow,384,warrior,arms,6,4,2
nerzhul,384,warrior,arms,6,4,2
tichondrius,384,warrior,arms,6,4,2
drenden,384,warrior,arms,6,4,2
sargeras,384,warrior,arms,6,4,2
hyjal,384,warrior,arms,6,4,2
sargeras,384,warrior,arms,6,4,2
quelthalas,384,warrior,arms,6,4,2
tichondrius,384,warrior,arms,6,4,2
zuluhed,384,warrior,arms,6,4,2
hyjal,384,warrior,arms,9,5,4
stormrage,384,warrior,arms,9,5,4
illidan,384,warrior,arms,9,5,4
area-52,384,warrior,arms,8,4,4
ragnaros,384,warrior,arms,9,4,5
azralon,384,warrior,arms,12,4,8
illidan,384,warrior,arms,12,4,8
illidan,384,warrior,arms,12,4,8
illidan,384,warrior,arms,12,4,8
illidan,384,warrior,arms,12,4,8
area-52,384,warrior,arms,12,4,8
wyrmrest-accord,384,warrior,arms,12,4,8
dalaran,384,warrior,arms,12,4,8
hyjal,384,warrior,arms,12,4,8
silver-hand,384,warrior,arms,12,4,8
sargeras,384,warrior,arms,12,4,8
kiljaeden,384,warrior,arms,12,4,8
stormreaver,384,warrior,arms,12,4,8
fenris,384,warrior,arms,12,4,8
duskwood,384,warrior,arms,12,4,8
azralon,384,warrior,arms,12,4,8
illidan,384,warrior,arms,12,4,8
bleeding-hollow,384,warrior,arms,12,4,8
area-52,384,warrior,arms,12,4,8
vashj,384,warrior,arms,12,4,8
proudmoore,384,warrior,arms,12,4,8
blackrock,384,warrior,arms,12,4,8
wyrmrest-accord,384,warrior,arms,12,4,8
proudmoore,384,warrior,arms,12,4,8
zuljin,384,warrior,arms,12,4,8
trollbane,384,warrior,arms,12,4,8
thaurissan,384,warrior,arms,12,4,8
ragnaros,384,warrior,arms,12,4,8
fizzcrank,384,warrior,arms,12,4,8
tichondrius,384,warrior,arms,12,4,8
grizzly-hills,384,warrior,arms,12,4,8
deathwing,384,warrior,arms,12,4,8
zuljin,384,warrior,arms,12,4,8
malfurion,384,warrior,arms,12,4,8
dalaran,384,warrior,arms,12,4,8
tichondrius,384,warrior,arms,12,4,8
stormrage,384,warrior,arms,12,4,8
tichondrius,384,warrior,arms,12,4,8
tichondrius,384,warrior,arms,12,4,8
tichondrius,384,warrior,arms,12,4,8
stormrage,384,warrior,arms,12,4,8
tichondrius,384,warrior,arms,12,4,8
illidan,384,warrior,arms,12,4,8
tichondrius,384,warrior,arms,12,4,8
tichondrius,384,warrior,arms,12,4,8
ragnaros,384,warrior,arms,12,4,8
tichondrius,384,warrior,arms,12,4,8
the-forgotten-coast,384,warrior,arms,12,4,8
queldorei,384,warrior,arms,12,4,8
thrall,384,warrior,arms,12,4,8
mannoroth,384,warrior,arms,12,4,8
tichondrius,384,warrior,arms,12,4,8
barthilas,384,warrior,arms,12,4,8
goldrinn,384,warrior,arms,12,4,8
tichondrius,384,warrior,arms,12,4,8
illidan,384,warrior,arms,12,4,8
khadgar,384,warrior,arms,12,4,8
saurfang,384,warrior,arms,12,4,8
tichondrius,384,warrior,arms,12,4,8
illidan,384,warrior,arms,12,4,8
ragnaros,384,warrior,arms,12,4,8
barthilas,384,warrior,arms,12,4,8
emerald-dream,384,warrior,arms,13,4,9
quelthalas,384,warrior,arms,17,4,13
boulderfist,384,warrior,arms,18,4,14
zuljin,384,warrior,arms,18,4,14
tichondrius,384,warrior,arms,18,4,14
azralon,384,warrior,arms,18,4,14
illidan,384,warrior,arms,18,4,14
tichondrius,384,warrior,arms,18,4,14
eredar,383,warrior,arms,6,4,2
azralon,383,warrior,arms,6,4,2
kelthuzad,383,warrior,arms,6,4,2
tichondrius,383,warrior,arms,6,4,2
tichondrius,383,warrior,arms,6,4,2
haomarush,383,warrior,arms,9,5,4
kargath,383,warrior,arms,12,4,8
the-venture-co,383,warrior,arms,12,4,8
scilla,383,warrior,arms,12,4,8
dalaran,383,warrior,arms,18,4,14
azjolnerub,382,warrior,arms,6,4,2
bonechewer,367,warrior,arms,17,4,13
proudmoore,352,warrior,arms,10,4,6
moon-guard,351,warrior,arms,11,4,7
area-52,351,warrior,arms,11,4,7
boulderfist,349,warrior,arms,10,4,6
rivendare,336,warrior,arms,9,4,5
bladefist,335,warrior,arms,11,4,7
zuljin,330,warrior,arms,18,5,13
stormrage,324,warrior,arms,16,7,9
emerald-dream,320,warrior,arms,10,4,6
illidan,320,warrior,arms,19,5,14
proudmoore,319,warrior,arms,5,4,1
darrowmere,319,warrior,arms,5,4,1
alterac-mountains,319,warrior,arms,8,4,4
tichondrius,319,warrior,arms,14,4,10
bleeding-hollow,304,warrior,arms,7,4,3
korgath,304,warrior,arms,13,4,9
thrall,302,warrior,arms,7,5,2
malfurion,288,warrior,arms,6,3,3
laughing-skull,288,warrior,arms,6,3,3
illidan,288,warrior,arms,6,3,3
bleeding-hollow,288,warrior,arms,6,3,3
bleeding-hollow,288,warrior,arms,6,3,3
area-52,288,warrior,arms,6,3,3
quelthalas,288,warrior,arms,6,3,3
quelthalas,288,warrior,arms,6,3,3
arthas,288,warrior,arms,6,3,3
thunderlord,288,warrior,arms,6,3,3
zuluhed,288,warrior,arms,6,3,3
warsong,288,warrior,arms,6,3,3
quelthalas,288,warrior,arms,6,3,3
illidan,288,warrior,arms,6,3,3
arthas,288,warrior,arms,6,3,3
thunderlord,288,warrior,arms,6,3,3
quelthalas,288,warrior,arms,6,3,3
kirin-tor,288,warrior,arms,6,3,3
lightnings-blade,288,warrior,arms,6,3,3
area-52,288,warrior,arms,6,3,3
malganis,288,warrior,arms,6,3,3
illidan,288,warrior,arms,6,3,3
malganis,288,warrior,arms,6,3,3
duskwood,288,warrior,arms,6,3,3
ragnaros,288,warrior,arms,6,3,3
stormrage,288,warrior,arms,6,3,3
malganis,288,warrior,arms,6,3,3
stormrage,288,warrior,arms,6,3,3
zuljin,288,warrior,arms,6,3,3
malganis,288,warrior,arms,6,3,3
eredar,288,warrior,arms,6,3,3
stormrage,288,warrior,arms,6,3,3
stormrage,288,warrior,arms,6,3,3
thunderlord,288,warrior,arms,6,3,3
dentarg,288,warrior,arms,6,3,3
kelthuzad,288,warrior,arms,6,3,3
kelthuzad,288,warrior,arms,6,3,3
dalaran,288,warrior,arms,6,3,3
dalaran,288,warrior,arms,6,3,3
alexstrasza,288,warrior,arms,6,3,3
illidan,288,warrior,arms,6,3,3
blackhand,288,warrior,arms,6,3,3
kelthuzad,288,warrior,arms,6,3,3
bleeding-hollow,288,warrior,arms,6,3,3
kelthuzad,288,warrior,arms,6,3,3
ragnaros,288,warrior,arms,6,3,3
stormrage,288,warrior,arms,6,3,3
kelthuzad,288,warrior,arms,6,3,3
zuljin,288,warrior,arms,6,3,3
zuljin,288,warrior,arms,6,3,3
tichondrius,288,warrior,arms,6,3,3
ragnaros,288,warrior,arms,6,3,3
sargeras,288,warrior,arms,6,3,3
suramar,288,warrior,arms,6,3,3
anubarak,288,warrior,arms,6,3,3
area-52,288,warrior,arms,6,3,3
illidan,288,warrior,arms,6,3,3
burning-legion,288,warrior,arms,6,3,3
illidan,288,warrior,arms,6,3,3
nemesis,288,warrior,arms,6,3,3
area-52,288,warrior,arms,6,3,3
tichondrius,288,warrior,arms,6,3,3
frostmourne,288,warrior,arms,6,3,3
uldum,288,warrior,arms,6,3,3
uldum,288,warrior,arms,6,3,3
illidan,288,warrior,arms,6,3,3
mugthol,288,warrior,arms,6,3,3
ragnaros,288,warrior,arms,6,3,3
stormrage,288,warrior,arms,6,3,3
malorne,288,warrior,arms,6,3,3
azralon,288,warrior,arms,6,3,3
stormrage,288,warrior,arms,6,3,3
moon-guard,288,warrior,arms,6,3,3
moon-guard,288,warrior,arms,6,3,3
moon-guard,288,warrior,arms,6,3,3
moon-guard,288,warrior,arms,6,3,3
stormrage,288,warrior,arms,6,3,3
azralon,288,warrior,arms,6,3,3
stormrage,288,warrior,arms,6,3,3
illidan,288,warrior,arms,6,3,3
stormrage,288,warrior,arms,6,3,3
moon-guard,288,warrior,arms,6,3,3
drakkari,288,warrior,arms,6,3,3
stormrage,288,warrior,arms,6,3,3
stormrage,288,warrior,arms,6,3,3
moon-guard,288,warrior,arms,6,3,3
illidan,288,warrior,arms,6,3,3
sargeras,288,warrior,arms,6,3,3
llane,288,warrior,arms,6,3,3
moon-guard,288,warrior,arms,6,3,3
moon-guard,288,warrior,arms,6,3,3
moon-guard,288,warrior,arms,6,3,3
terenas,288,warrior,arms,6,3,3
tichondrius,288,warrior,arms,6,3,3
illidan,288,warrior,arms,6,3,3
bronzebeard,288,warrior,arms,6,3,3
wyrmrest-accord,288,warrior,arms,6,3,3
wyrmrest-accord,288,warrior,arms,6,3,3
illidan,288,warrior,arms,6,3,3
sargeras,288,warrior,arms,6,3,3
sargeras,288,warrior,arms,6,3,3
sargeras,288,warrior,arms,6,3,3
illidan,288,warrior,arms,6,3,3
frostmourne,288,warrior,arms,6,3,3
illidan,288,warrior,arms,6,3,3
sargeras,288,warrior,arms,6,3,3
sargeras,288,warrior,arms,6,3,3
tichondrius,288,warrior,arms,6,3,3
illidan,288,warrior,arms,6,3,3
tichondrius,288,warrior,arms,6,3,3
blackhand,288,warrior,arms,6,3,3
kargath,288,warrior,arms,6,3,3
kiljaeden,288,warrior,arms,6,3,3
illidan,288,warrior,arms,6,3,3
thaurissan,288,warrior,arms,6,3,3
tichondrius,288,warrior,arms,6,3,3
tichondrius,288,warrior,arms,6,3,3
madoran,288,warrior,arms,6,3,3
dawnbringer,288,warrior,arms,6,3,3
tichondrius,288,warrior,arms,6,3,3
emerald-dream,288,warrior,arms,6,3,3
proudmoore,288,warrior,arms,6,3,3
proudmoore,288,warrior,arms,6,3,3
tichondrius,288,warrior,arms,6,3,3
proudmoore,288,warrior,arms,6,3,3
illidan,288,warrior,arms,6,3,3
thrall,288,warrior,arms,6,3,3
dunemaul,288,warrior,arms,6,3,3
illidan,288,warrior,arms,6,3,3
tichondrius,288,warrior,arms,6,3,3
tichondrius,288,warrior,arms,6,3,3
jubeithos,288,warrior,arms,6,3,3
tichondrius,288,warrior,arms,6,3,3
frostmourne,288,warrior,arms,6,3,3
tichondrius,288,warrior,arms,6,3,3
tichondrius,288,warrior,arms,6,3,3
tichondrius,288,warrior,arms,6,3,3
tichondrius,288,warrior,arms,6,3,3
frostmourne,288,warrior,arms,6,3,3
frostmourne,288,warrior,arms,6,3,3
tichondrius,288,warrior,arms,6,3,3
tichondrius,288,warrior,arms,6,3,3
tichondrius,288,warrior,arms,6,3,3
tichondrius,288,warrior,arms,6,3,3
tichondrius,288,warrior,arms,6,3,3
tichondrius,288,warrior,arms,6,3,3
tichondrius,288,warrior,arms,6,3,3
tichondrius,288,warrior,arms,6,3,3
tichondrius,288,warrior,arms,6,3,3
frostmourne,288,warrior,arms,6,3,3
illidan,288,warrior,arms,6,3,3
tichondrius,288,warrior,arms,6,3,3
frostmourne,288,warrior,arms,6,3,3
dathremar,288,warrior,arms,9,4,5
dark-iron,288,warrior,arms,8,3,5
ragnaros,288,warrior,arms,9,3,6
illidan,288,warrior,arms,11,3,8
ragnaros,288,warrior,arms,11,3,8
tichondrius,288,warrior,arms,12,3,9
barthilas,288,warrior,arms,12,3,9
tichondrius,288,warrior,arms,12,3,9
ragnaros,288,warrior,arms,12,3,9
ragnaros,288,warrior,arms,12,3,9
emerald-dream,288,warrior,arms,12,3,9
kiljaeden,288,warrior,arms,12,3,9
queldorei,288,warrior,arms,12,3,9
malganis,288,warrior,arms,12,3,9
mugthol,288,warrior,arms,12,3,9
gundrak,288,warrior,arms,12,3,9
spirestone,288,warrior,arms,12,3,9
emerald-dream,288,warrior,arms,12,3,9
quelthalas,288,warrior,arms,12,3,9
tanaris,288,warrior,arms,12,3,9
tichondrius,288,warrior,arms,12,3,9
bleeding-hollow,288,warrior,arms,12,3,9
wyrmrest-accord,288,warrior,arms,12,3,9
malganis,288,warrior,arms,12,3,9
suramar,288,warrior,arms,12,3,9
terenas,288,warrior,arms,12,3,9
smolderthorn,288,warrior,arms,12,3,9
frostmourne,288,warrior,arms,12,3,9
dalaran,288,warrior,arms,12,3,9
twisting-nether,288,warrior,arms,12,3,9
burning-legion,288,warrior,arms,14,3,11
area-52,288,warrior,arms,18,3,15
illidan,288,warrior,arms,18,3,15
moon-guard,287,warrior,arms,6,3,3
bloodscalp,287,warrior,arms,6,3,3
korgath,287,warrior,arms,6,3,3
barthilas,287,warrior,arms,6,3,3
barthilas,287,warrior,arms,6,3,3
blackrock,287,warrior,arms,6,3,3
thorium-brotherhood,287,warrior,arms,6,3,3
drakthul,287,warrior,arms,12,3,9
wyrmrest-accord,287,warrior,arms,18,3,15
moon-guard,286,warrior,arms,6,3,3
dalaran,286,warrior,arms,6,3,3
tol-barad,286,warrior,arms,12,3,9
moon-guard,271,warrior,arms,11,3,8
gilneas,256,warrior,arms,4,4,0
sargeras,256,warrior,arms,8,4,4
tichondrius,255,warrior,arms,11,3,8
stormrage,240,warrior,arms,9,3,6
thrall,239,warrior,arms,5,3,2
tichondrius,239,warrior,arms,5,3,2
tichondrius,239,warrior,arms,5,3,2
tichondrius,239,warrior,arms,5,3,2
area-52,234,warrior,arms,8,5,3
tichondrius,223,warrior,arms,8,3,5
tichondrius,223,warrior,arms,14,3,11
area-52,207,warrior,arms,8,3,5
tichondrius,192,warrior,arms,4,3,1
tichondrius,192,warrior,arms,9,3,6
bleeding-hollow,192,warrior,arms,9,3,6
frostmourne,192,warrior,arms,6,2,4
nagrand,192,warrior,arms,6,2,4
quelthalas,192,warrior,arms,6,2,4
frostmourne,192,warrior,arms,6,2,4
quelthalas,192,warrior,arms,6,2,4
kirin-tor,192,warrior,arms,6,2,4
tichondrius,192,warrior,arms,6,2,4
ragnaros,192,warrior,arms,6,2,4
tichondrius,192,warrior,arms,6,2,4
destromath,192,warrior,arms,6,2,4
thrall,192,warrior,arms,6,2,4
tichondrius,192,warrior,arms,6,2,4
trollbane,192,warrior,arms,6,2,4
tichondrius,192,warrior,arms,6,2,4
quelthalas,192,warrior,arms,6,2,4
tichondrius,192,warrior,arms,6,2,4
illidan,192,warrior,arms,6,2,4
nagrand,192,warrior,arms,6,2,4
tichondrius,192,warrior,arms,6,2,4
frostmourne,192,warrior,arms,6,2,4
tichondrius,192,warrior,arms,6,2,4
quelthalas,192,warrior,arms,6,2,4
quelthalas,192,warrior,arms,6,2,4
alterac-mountains,192,warrior,arms,6,2,4
tichondrius,192,warrior,arms,6,2,4
tichondrius,192,warrior,arms,6,2,4
tichondrius,192,warrior,arms,6,2,4
tichondrius,192,warrior,arms,6,2,4
ragnaros,192,warrior,arms,6,2,4
tichondrius,192,warrior,arms,6,2,4
tichondrius,192,warrior,arms,6,2,4
quelthalas,192,warrior,arms,6,2,4
tichondrius,192,warrior,arms,6,2,4
thrall,192,warrior,arms,6,2,4
tichondrius,192,warrior,arms,6,2,4
tichondrius,192,warrior,arms,6,2,4
tichondrius,192,warrior,arms,6,2,4
tichondrius,192,warrior,arms,6,2,4
tichondrius,192,warrior,arms,6,2,4
malganis,192,warrior,arms,6,2,4
tichondrius,192,warrior,arms,6,2,4
tichondrius,192,warrior,arms,6,2,4
ragnaros,192,warrior,arms,6,2,4
tichondrius,192,warrior,arms,6,2,4
khazgoroth,192,warrior,arms,6,2,4
area-52,192,warrior,arms,6,2,4
frostmourne,192,warrior,arms,6,2,4
whisperwind,192,warrior,arms,6,2,4
dalaran,192,warrior,arms,6,2,4
thrall,192,warrior,arms,6,2,4
stormrage,192,warrior,arms,6,2,4
kelthuzad,192,warrior,arms,6,2,4
azralon,192,warrior,arms,6,2,4
malganis,192,warrior,arms,6,2,4
malganis,192,warrior,arms,6,2,4
zuljin,192,warrior,arms,6,2,4
tichondrius,192,warrior,arms,6,2,4
ragnaros,192,warrior,arms,6,2,4
whisperwind,192,warrior,arms,6,2,4
tichondrius,192,warrior,arms,6,2,4
malfurion,192,warrior,arms,6,2,4
ragnaros,192,warrior,arms,6,2,4
ragnaros,192,warrior,arms,6,2,4
nemesis,192,warrior,arms,6,2,4
malorne,192,warrior,arms,6,2,4
stonemaul,192,warrior,arms,6,2,4
malganis,192,warrior,arms,6,2,4
frostwolf,192,warrior,arms,6,2,4
moon-guard,192,warrior,arms,6,2,4
blackhand,192,warrior,arms,6,2,4
stonemaul,192,warrior,arms,6,2,4
queldorei,192,warrior,arms,6,2,4
sargeras,192,warrior,arms,6,2,4
area-52,192,warrior,arms,6,2,4
zuljin,192,warrior,arms,6,2,4
illidan,192,warrior,arms,6,2,4
kelthuzad,192,warrior,arms,6,2,4
area-52,192,warrior,arms,6,2,4
firetree,192,warrior,arms,6,2,4
stormreaver,192,warrior,arms,6,2,4
moon-guard,192,warrior,arms,6,2,4
dalaran,192,warrior,arms,6,2,4
tichondrius,192,warrior,arms,6,2,4
stormscale,192,warrior,arms,6,2,4
quelthalas,192,warrior,arms,6,2,4
kelthuzad,192,warrior,arms,6,2,4
barthilas,192,warrior,arms,6,2,4
moon-guard,192,warrior,arms,6,2,4
area-52,192,warrior,arms,6,2,4
moon-guard,192,warrior,arms,6,2,4
stormrage,192,warrior,arms,6,2,4
illidan,192,warrior,arms,6,2,4
proudmoore,192,warrior,arms,6,2,4
kelthuzad,192,warrior,arms,6,2,4
proudmoore,192,warrior,arms,6,2,4
durotan,192,warrior,arms,6,2,4
moon-guard,192,warrior,arms,6,2,4
illidan,192,warrior,arms,6,2,4
zuljin,192,warrior,arms,6,2,4
illidan,192,warrior,arms,6,2,4
illidan,192,warrior,arms,6,2,4
proudmoore,192,warrior,arms,6,2,4
illidan,192,warrior,arms,6,2,4
aggramar,192,warrior,arms,6,2,4
moon-guard,192,warrior,arms,6,2,4
kiljaeden,192,warrior,arms,6,2,4
nemesis,192,warrior,arms,6,2,4
stormrage,192,warrior,arms,6,2,4
moon-guard,192,warrior,arms,6,2,4
kelthuzad,192,warrior,arms,6,2,4
ragnaros,192,warrior,arms,6,2,4
stormrage,192,warrior,arms,6,2,4
kiljaeden,192,warrior,arms,6,2,4
illidan,192,warrior,arms,6,2,4
area-52,192,warrior,arms,6,2,4
antonidas,192,warrior,arms,6,2,4
area-52,192,warrior,arms,6,2,4
ragnaros,192,warrior,arms,6,2,4
blades-edge,192,warrior,arms,6,2,4
stormrage,192,warrior,arms,6,2,4
black-dragonflight,192,warrior,arms,6,2,4
emerald-dream,192,warrior,arms,6,2,4
tichondrius,192,warrior,arms,6,2,4
bleeding-hollow,192,warrior,arms,6,2,4
bleeding-hollow,192,warrior,arms,6,2,4
kelthuzad,192,warrior,arms,6,2,4
nemesis,192,warrior,arms,6,2,4
sargeras,192,warrior,arms,6,2,4
sargeras,192,warrior,arms,6,2,4
azralon,192,warrior,arms,6,2,4
illidan,192,warrior,arms,6,2,4
ragnaros,192,warrior,arms,6,2,4
stormrage,192,warrior,arms,6,2,4
barthilas,192,warrior,arms,6,2,4
tichondrius,192,warrior,arms,6,2,4
stormrage,192,warrior,arms,6,2,4
sargeras,192,warrior,arms,6,2,4
aegwynn,192,warrior,arms,6,2,4
guldan,192,warrior,arms,6,2,4
area-52,192,warrior,arms,6,2,4
ragnaros,192,warrior,arms,6,2,4
tichondrius,192,warrior,arms,6,2,4
darkspear,192,warrior,arms,6,2,4
chromaggus,192,warrior,arms,6,2,4
area-52,192,warrior,arms,6,2,4
area-52,192,warrior,arms,6,2,4
sargeras,192,warrior,arms,6,2,4
bleeding-hollow,192,warrior,arms,6,2,4
area-52,192,warrior,arms,6,2,4
hyjal,192,warrior,arms,6,2,4
bleeding-hollow,192,warrior,arms,6,2,4
illidan,192,warrior,arms,6,2,4
stormrage,192,warrior,arms,6,2,4
black-dragonflight,192,warrior,arms,6,2,4
wyrmrest-accord,192,warrior,arms,6,2,4
area-52,192,warrior,arms,6,2,4
hyjal,192,warrior,arms,6,2,4
sargeras,192,warrior,arms,6,2,4
hyjal,192,warrior,arms,6,2,4
tichondrius,192,warrior,arms,6,2,4
area-52,192,warrior,arms,6,2,4
bleeding-hollow,192,warrior,arms,6,2,4
bleeding-hollow,192,warrior,arms,10,3,7
laughing-skull,192,warrior,arms,11,2,9
jubeithos,192,warrior,arms,12,2,10
crushridge,192,warrior,arms,12,2,10
proudmoore,192,warrior,arms,12,2,10
tichondrius,192,warrior,arms,12,2,10
tichondrius,192,warrior,arms,12,2,10
malganis,192,warrior,arms,12,2,10
ragnaros,192,warrior,arms,12,2,10
sargeras,192,warrior,arms,12,2,10
nerzhul,192,warrior,arms,12,2,10
tichondrius,192,warrior,arms,12,2,10
echo-isles,192,warrior,arms,12,2,10
azgalor,192,warrior,arms,12,2,10
barthilas,191,warrior,arms,6,2,4
bleeding-hollow,191,warrior,arms,6,2,4
zuljin,191,warrior,arms,6,2,4
gundrak,191,warrior,arms,6,2,4
farstriders,191,warrior,arms,6,2,4
dragonmaw,191,warrior,arms,6,2,4
kelthuzad,160,warrior,arms,10,2,8
frostmourne,159,warrior,arms,5,2,3
ragnaros,159,warrior,arms,5,2,3
illidan,159,warrior,arms,5,2,3
moon-guard,159,warrior,arms,5,2,3
hellscream,159,warrior,arms,5,2,3
hyjal,159,warrior,arms,5,2,3
barthilas,159,warrior,arms,11,2,9
tichondrius,144,warrior,arms,9,2,7
tichondrius,138,warrior,arms,11,6,5
tichondrius,138,warrior,arms,12,3,9
ragnaros,112,warrior,arms,7,2,5
sargeras,96,warrior,arms,3,2,1
illidan,96,warrior,arms,3,2,1
bonechewer,96,warrior,arms,3,2,1
emerald-dream,96,warrior,arms,3,2,1
area-52,96,warrior,arms,3,2,1
illidan,96,warrior,arms,3,2,1
destromath,96,warrior,arms,6,1,5
quelthalas,96,warrior,arms,6,1,5
bleeding-hollow,96,warrior,arms,6,1,5
ragnaros,96,warrior,arms,6,1,5
ragnaros,96,warrior,arms,6,1,5
tichondrius,96,warrior,arms,6,1,5
scarlet-crusade,96,warrior,arms,6,1,5
mannoroth,96,warrior,arms,6,1,5
bleeding-hollow,96,warrior,arms,6,1,5
shadowsong,96,warrior,arms,6,1,5
stormrage,96,warrior,arms,6,1,5
area-52,96,warrior,arms,6,1,5
quelthalas,96,warrior,arms,6,1,5
sargeras,96,warrior,arms,6,1,5
aegwynn,96,warrior,arms,6,1,5
kul-tiras,96,warrior,arms,6,1,5
bonechewer,96,warrior,arms,6,1,5
mannoroth,96,warrior,arms,6,1,5
icecrown,96,warrior,arms,6,1,5
stormrage,96,warrior,arms,6,1,5
sentinels,96,warrior,arms,6,1,5
sargeras,96,warrior,arms,6,1,5
hyjal,96,warrior,arms,6,1,5
bleeding-hollow,96,warrior,arms,6,1,5
barthilas,96,warrior,arms,6,1,5
quelthalas,96,warrior,arms,6,1,5
skullcrusher,96,warrior,arms,6,1,5
stormrage,96,warrior,arms,6,1,5
amanthul,96,warrior,arms,6,1,5
ragnaros,96,warrior,arms,6,1,5
frostmourne,96,warrior,arms,6,1,5
azralon,96,warrior,arms,6,1,5
arthas,96,warrior,arms,6,1,5
drakkari,96,warrior,arms,6,1,5
illidan,96,warrior,arms,6,1,5
stormrage,96,warrior,arms,6,1,5
malganis,96,warrior,arms,6,1,5
tichondrius,96,warrior,arms,6,1,5
barthilas,96,warrior,arms,6,1,5
zuljin,96,warrior,arms,6,1,5
aerie-peak,96,warrior,arms,6,1,5
frostmourne,96,warrior,arms,6,1,5
aggramar,96,warrior,arms,6,1,5
barthilas,96,warrior,arms,6,1,5
tichondrius,96,warrior,arms,6,1,5
tichondrius,96,warrior,arms,6,1,5
proudmoore,96,warrior,arms,6,1,5
moon-guard,96,warrior,arms,6,1,5
emerald-dream,96,warrior,arms,6,1,5
illidan,96,warrior,arms,6,1,5
moon-guard,96,warrior,arms,6,1,5
kelthuzad,96,warrior,arms,6,1,5
rexxar,96,warrior,arms,6,1,5
khaz-modan,96,warrior,arms,6,1,5
kelthuzad,96,warrior,arms,6,1,5
ragnaros,96,warrior,arms,6,1,5
azshara,96,warrior,arms,6,1,5
frostwolf,96,warrior,arms,6,1,5
proudmoore,96,warrior,arms,6,1,5
malganis,96,warrior,arms,6,1,5
kiljaeden,96,warrior,arms,6,1,5
dentarg,96,warrior,arms,6,1,5
area-52,96,warrior,arms,6,1,5
spirestone,96,warrior,arms,6,1,5
proudmoore,96,warrior,arms,6,1,5
thrall,96,warrior,arms,6,1,5
illidan,96,warrior,arms,6,1,5
emerald-dream,96,warrior,arms,6,1,5
exodar,96,warrior,arms,6,1,5
turalyon,96,warrior,arms,6,1,5
tichondrius,96,warrior,arms,6,1,5
moon-guard,96,warrior,arms,6,1,5
frostmourne,96,warrior,arms,6,1,5
area-52,96,warrior,arms,6,1,5
tichondrius,96,warrior,arms,6,1,5
ragnaros,96,warrior,arms,6,1,5
stormrage,96,warrior,arms,6,1,5
stonemaul,96,warrior,arms,6,1,5
haomarush,96,warrior,arms,6,1,5
azralon,96,warrior,arms,6,1,5
moon-guard,96,warrior,arms,6,1,5
bonechewer,96,warrior,arms,6,1,5
malganis,96,warrior,arms,6,1,5
ragnaros,96,warrior,arms,6,1,5
akama,96,warrior,arms,6,1,5
tichondrius,96,warrior,arms,6,1,5
vashj,96,warrior,arms,12,1,11
emerald-dream,96,warrior,arms,12,1,11
stormrage,96,warrior,arms,12,1,11
amanthul,96,warrior,arms,12,1,11
blackrock,96,warrior,arms,12,1,11
zuljin,96,warrior,arms,12,1,11
quelthalas,79,warrior,arms,5,1,4
frostmane,79,warrior,arms,5,1,4
hellscream,79,warrior,arms,5,1,4
illidan,79,warrior,arms,5,1,4
illidan,79,warrior,arms,5,1,4
thunderhorn,64,warrior,arms,4,1,3
ghostlands,48,warrior,arms,3,1,2
tichondrius,48,warrior,arms,3,1,2
draktharon,42,warrior,arms,6,2,4
doomhammer,42,warrior,arms,9,2,7
area-52,31,warrior,arms,2,1,1
stormrage,16,warrior,arms,1,1,0
stormrage,16,warrior,arms,1,1,0
gurubashi,16,warrior,arms,1,1,0
area-52,16,warrior,arms,7,1,6
moon-guard,1455,warrior,protection,62,34,28
tichondrius,1192,warrior,protection,47,22,25
hyjal,855,warrior,protection,30,12,18
whisperwind,845,warrior,protection,27,10,17
twisting-nether,564,warrior,protection,14,6,8
kelthuzad,479,warrior,protection,18,5,13
bloodscalp,469,warrior,protection,18,5,13
dawnbringer,384,warrior,protection,6,4,2
barthilas,384,warrior,protection,6,4,2
moon-guard,384,warrior,protection,12,4,8
frostmourne,288,warrior,protection,6,3,3
destromath,284,warrior,protection,12,3,9
madoran,192,warrior,protection,6,2,4
terokkar,192,warrior,protection,12,2,10
boulderfist,95,warrior,protection,6,1,5
