name,realm,rating,cls,spec,play,win,lose
Rahbekius,kazzak,1529,deathknight,blood,84,32,52
Эваер,blackscar,1506,deathknight,blood,60,29,31
Nîghtmáre,ravencrest,462,deathknight,blood,11,5,6
Horrorda,defias-brotherhood,446,deathknight,blood,9,6,3
Schiva,eredar,252,deathknight,blood,11,3,8
Хайвейтухэлл,soulflayer,2098,deathknight,unholy,96,48,48
Conqueròr,tarren-mill,2083,deathknight,unholy,94,46,48
Bóby,ravencrest,2050,deathknight,unholy,156,76,80
Кромгона,soulflayer,2036,deathknight,unholy,83,57,26
Leónid,kazzak,1962,deathknight,unholy,72,36,36
Дайтоолгоун,gordunni,1961,deathknight,unholy,77,39,38
Ipanic,argent-dawn,1957,deathknight,unholy,102,60,42
Bedstemoor,ravencrest,1955,deathknight,unholy,90,47,43
Enzy,drakthul,1948,deathknight,unholy,42,26,16
Shadowdeathj,kazzak,1913,deathknight,unholy,54,27,27
Murky,kazzak,1901,deathknight,unholy,108,51,57
Валькейн,blackscar,1883,deathknight,unholy,60,32,28
Akaliz,die-aldor,1876,deathknight,unholy,66,35,31
Vakü,burning-legion,1873,deathknight,unholy,156,73,83
Narali,argent-dawn,1859,deathknight,unholy,72,34,38
Fxckingmad,ravencrest,1856,deathknight,unholy,60,30,30
Vallenhal,twisting-nether,1850,deathknight,unholy,48,23,25
Azüla,ysondre,1848,deathknight,unholy,66,30,36
Worlviuz,argent-dawn,1847,deathknight,unholy,123,59,64
Øtherànóther,stormscale,1843,deathknight,unholy,54,30,24
Ezlyy,ravencrest,1843,deathknight,unholy,114,60,54
Amnésyx,ysondre,1842,deathknight,unholy,64,32,32
Nómòre,ravencrest,1839,deathknight,unholy,60,30,30
Mockingbirdo,sanguino,1836,deathknight,unholy,36,24,12
Leomordf,doomhammer,1832,deathknight,unholy,130,76,54
Lilshiet,stormreaver,1831,deathknight,unholy,66,30,36
Namzera,draenor,1827,deathknight,unholy,114,70,44
Неондк,eversong,1821,deathknight,unholy,104,53,51
Cealdris,blackmoore,1819,deathknight,unholy,30,20,10
Обледенение,gordunni,1819,deathknight,unholy,36,19,17
Mávé,tarren-mill,1819,deathknight,unholy,59,31,28
Rankor,grim-batol,1816,deathknight,unholy,66,36,30
Necrofear,grim-batol,1816,deathknight,unholy,126,62,64
Argonat,silvermoon,1814,deathknight,unholy,99,57,42
Аоепупс,gordunni,1809,deathknight,unholy,57,28,29
Лордэскорт,gordunni,1805,deathknight,unholy,78,37,41
Annabolik,ravencrest,1804,deathknight,unholy,36,19,17
Нишимба,soulflayer,1802,deathknight,unholy,54,28,26
Jesûsx,ravencrest,1799,deathknight,unholy,48,29,19
Oscman,silvermoon,1778,deathknight,unholy,78,42,36
Darkknights,archimonde,1774,deathknight,unholy,56,35,21
Шайбовёрт,gordunni,1773,deathknight,unholy,54,29,25
Дайтоолгоун,deathguard,1769,deathknight,unholy,51,31,20
Butthurtx,stormscale,1766,deathknight,unholy,40,23,17
Фростинг,gordunni,1757,deathknight,unholy,42,23,19
Oj,darkspear,1745,deathknight,unholy,66,37,29
Inflex,silvermoon,1741,deathknight,unholy,96,46,50
Shanariel,khaz-modan,1733,deathknight,unholy,102,58,44
Køley,draenor,1732,deathknight,unholy,41,23,18
Fennro,ysondre,1731,deathknight,unholy,90,37,53
Skulm,twisting-nether,1722,deathknight,unholy,48,20,28
Koranderx,argent-dawn,1713,deathknight,unholy,30,18,12
Itreachesout,ravencrest,1708,deathknight,unholy,58,27,31
Wôrgenator,kazzak,1704,deathknight,unholy,48,18,30
Kickbot,outland,1702,deathknight,unholy,106,54,52
Эриданс,gordunni,1699,deathknight,unholy,124,69,55
Kwc,ravencrest,1696,deathknight,unholy,87,43,44
Змейняша,soulflayer,1691,deathknight,unholy,60,27,33
Verminosis,stormscale,1689,deathknight,unholy,54,21,33
Unhóly,tarren-mill,1687,deathknight,unholy,84,47,37
Icegrin,silvermoon,1687,deathknight,unholy,60,32,28
Кулькулегал,ashenvale,1685,deathknight,unholy,54,27,27
Sanlex,twisting-nether,1684,deathknight,unholy,115,51,64
Grepetta,argent-dawn,1683,deathknight,unholy,231,111,120
ßankoedno,stormscale,1681,deathknight,unholy,120,62,58
Lovroo,silvermoon,1679,deathknight,unholy,75,34,41
Zokko,blackrock,1675,deathknight,unholy,47,23,24
Faznik,twisting-nether,1675,deathknight,unholy,42,20,22
Сантамо,soulflayer,1669,deathknight,unholy,50,27,23
Олинф,deathguard,1664,deathknight,unholy,56,23,33
Blazeberg,blackrock,1662,deathknight,unholy,58,33,25
Andreàs,silvermoon,1662,deathknight,unholy,42,22,20
Yandeäth,chants-éternels,1657,deathknight,unholy,42,25,17
Feministi,stormreaver,1652,deathknight,unholy,48,24,24
Reann,argent-dawn,1649,deathknight,unholy,55,31,24
Aryash,silvermoon,1649,deathknight,unholy,54,22,32
Nèrfx,ragnaros,1641,deathknight,unholy,66,30,36
Leanâdle,hyjal,1640,deathknight,unholy,80,39,41
Exoflake,kazzak,1639,deathknight,unholy,46,24,22
Hotcherryx,dun-modr,1638,deathknight,unholy,42,18,24
Äyrenn,draenor,1637,deathknight,unholy,45,27,18
Garrinchá,stormscale,1636,deathknight,unholy,48,21,27
Vainajala,die-aldor,1633,deathknight,unholy,71,41,30
Crenshawx,twisting-nether,1633,deathknight,unholy,77,33,44
Sølîta,archimonde,1632,deathknight,unholy,71,39,32
Вирко,eversong,1631,deathknight,unholy,58,29,29
Аронас,blackscar,1629,deathknight,unholy,42,21,21
Меланндрис,gordunni,1625,deathknight,unholy,36,25,11
Castlevanía,ravencrest,1624,deathknight,unholy,61,31,30
Sangíus,blackmoore,1624,deathknight,unholy,208,97,111
Кидер,blackscar,1622,deathknight,unholy,35,20,15
Quetza,twisting-nether,1621,deathknight,unholy,36,17,19
Аркёт,howling-fjord,1618,deathknight,unholy,42,19,23
Wombo,dentarg,1613,deathknight,unholy,39,21,18
Pellizquitas,sanguino,1612,deathknight,unholy,30,17,13
Lockhead,stormscale,1612,deathknight,unholy,84,47,37
Inâste,thrall,1612,deathknight,unholy,36,20,16
Darkertimes,ragnaros,1612,deathknight,unholy,84,37,47
Quizon,tarren-mill,1610,deathknight,unholy,42,20,22
Notsyndra,nemesis,1603,deathknight,unholy,42,23,19
Jiodythyy,archimonde,1602,deathknight,unholy,54,23,31
Økah,outland,1598,deathknight,unholy,48,21,27
Çruél,silvermoon,1596,deathknight,unholy,42,19,23
Körthazz,hyjal,1595,deathknight,unholy,49,25,24
Synthwave,tarren-mill,1594,deathknight,unholy,41,19,22
Hellguy,draenor,1589,deathknight,unholy,120,53,67
Lichbørn,ragnaros,1585,deathknight,unholy,48,22,26
Necrølyte,sylvanas,1581,deathknight,unholy,36,19,17
Ктунец,blackscar,1570,deathknight,unholy,36,19,17
Aeneriah,tarren-mill,1569,deathknight,unholy,49,27,22
Söttguetsi,blackrock,1566,deathknight,unholy,41,23,18
Motvinden,stormscale,1566,deathknight,unholy,46,22,24
Fraeya,sunstrider,1565,deathknight,unholy,42,20,22
Хорссэ,soulflayer,1563,deathknight,unholy,34,21,13
Вурдулакх,gordunni,1561,deathknight,unholy,96,48,48
Сванхильда,grom,1558,deathknight,unholy,66,33,33
Bokrak,norgannon,1551,deathknight,unholy,64,41,23
Anaralien,ravencrest,1551,deathknight,unholy,83,40,43
Gargalon,drakthul,1547,deathknight,unholy,54,28,26
Zoree,draenor,1541,deathknight,unholy,90,48,42
Хассандра,galakrond,1537,deathknight,unholy,62,30,32
Smörj,aggramar,1534,deathknight,unholy,42,17,25
Nommad,archimonde,1530,deathknight,unholy,53,22,31
Dörfl,antonidas,1524,deathknight,unholy,75,36,39
Babsyknight,wildhammer,1523,deathknight,unholy,54,23,31
Yusehz,kazzak,1523,deathknight,unholy,41,17,24
Бургер,soulflayer,1523,deathknight,unholy,42,16,26
Oweiowei,blackrock,1520,deathknight,unholy,24,16,8
Woddey,blackrock,1520,deathknight,unholy,72,39,33
Мёрдерфэйсх,soulflayer,1517,deathknight,unholy,78,41,37
Blízna,kazzak,1517,deathknight,unholy,72,35,37
Ghaloob,draenor,1515,deathknight,unholy,30,16,14
Greymarker,kirin-tor,1513,deathknight,unholy,66,37,29
Megdeath,silvermoon,1511,deathknight,unholy,61,28,33
Ardros,eredar,1507,deathknight,unholy,48,23,25
Нарилуне,blackscar,1504,deathknight,unholy,157,79,78
Nazgül,drakthul,1503,deathknight,unholy,74,36,38
Sîck,bladefist,1503,deathknight,unholy,60,22,38
Numnuts,alakir,1502,deathknight,unholy,36,21,15
Тыпидо,howling-fjord,1502,deathknight,unholy,30,17,13
Devilknight,dentarg,1500,deathknight,unholy,136,68,68
Jäätynyt,zenedar,1500,deathknight,unholy,71,28,43
Pavkata,outland,1497,deathknight,unholy,112,57,55
Алсидис,gordunni,1497,deathknight,unholy,60,22,38
Aleejha,draenor,1496,deathknight,unholy,40,22,18
Rizzlerdk,blackhand,1487,deathknight,unholy,66,25,41
Arxelas,sylvanas,1482,deathknight,unholy,60,33,27
Teljujad,sanguino,1482,deathknight,unholy,62,31,31
Bloodbane,burning-blade,1481,deathknight,unholy,36,18,18
Derfitt,sanguino,1478,deathknight,unholy,42,18,24
Deathcam,emerald-dream,1472,deathknight,unholy,71,32,39
Sorostew,twisting-nether,1467,deathknight,unholy,42,23,19
Qtxi,nozdormu,1465,deathknight,unholy,66,34,32
Сенкрул,gordunni,1464,deathknight,unholy,60,43,17
Utyr,ragnaros,1463,deathknight,unholy,30,16,14
Торедх,howling-fjord,1461,deathknight,unholy,42,16,26
Шифычдк,howling-fjord,1460,deathknight,unholy,60,27,33
Deusmort,ravencrest,1457,deathknight,unholy,66,26,40
Борнтудай,borean-tundra,1445,deathknight,unholy,48,17,31
Unholy,ragnaros,1444,deathknight,unholy,38,20,18
Лекъса,gordunni,1442,deathknight,unholy,81,40,41
Смердонос,grom,1432,deathknight,unholy,68,38,30
Спавни,blackscar,1432,deathknight,unholy,135,62,73
Ghostreign,tarren-mill,1428,deathknight,unholy,38,15,23
Turboface,kazzak,1427,deathknight,unholy,30,16,14
Десхоб,soulflayer,1426,deathknight,unholy,102,36,66
Кокосоус,gordunni,1425,deathknight,unholy,30,15,15
Анихиме,howling-fjord,1424,deathknight,unholy,75,37,38
Deathlog,silvermoon,1424,deathknight,unholy,36,17,19
Vatø,tarren-mill,1423,deathknight,unholy,36,15,21
Xado,frostwolf,1421,deathknight,unholy,66,37,29
Skøurge,silvermoon,1421,deathknight,unholy,126,64,62
Ampdk,ravencrest,1421,deathknight,unholy,30,15,15
Mìa,kragjin,1415,deathknight,unholy,73,33,40
Элекна,deepholm,1412,deathknight,unholy,36,16,20
Ceranto,frostwolf,1409,deathknight,unholy,47,29,18
Terren,ravencrest,1409,deathknight,unholy,52,29,23
Xirra,tarren-mill,1409,deathknight,unholy,67,33,34
Frostmommy,argent-dawn,1398,deathknight,unholy,48,18,30
Facèpalm,ravencrest,1396,deathknight,unholy,33,18,15
Lorvetis,malorne,1395,deathknight,unholy,42,19,23
Dkbladet,ravencrest,1391,deathknight,unholy,56,29,27
Hordak,stormscale,1384,deathknight,unholy,39,15,24
Necrotic,blackrock,1383,deathknight,unholy,23,15,8
Blorin,sylvanas,1372,deathknight,unholy,58,24,34
Gødofredo,dun-modr,1370,deathknight,unholy,60,30,30
Tyvra,blackhand,1369,deathknight,unholy,47,17,30
Fizzdk,pozzo-delleternità,1359,deathknight,unholy,30,15,15
Pawcio,argent-dawn,1352,deathknight,unholy,36,18,18
Gaurk,aggra-português,1350,deathknight,unholy,24,15,9
Draforce,quelthalas,1349,deathknight,unholy,23,15,8
Prænklý,blackrock,1348,deathknight,unholy,30,15,15
Quantumshift,ravencrest,1347,deathknight,unholy,24,15,9
Sathmayla,silvermoon,1343,deathknight,unholy,23,15,8
Zeghor,ragnaros,1343,deathknight,unholy,42,15,27
Segrim,drakthul,1342,deathknight,unholy,26,15,11
Roaredrick,draenor,1342,deathknight,unholy,87,40,47
Yagoora,silvermoon,1339,deathknight,unholy,33,15,18
Alessia,alonsus,1335,deathknight,unholy,24,14,10
Ðiesel,stormscale,1334,deathknight,unholy,46,15,31
Ullefuz,silvermoon,1330,deathknight,unholy,18,14,4
Akelæ,draenor,1330,deathknight,unholy,36,19,17
Evelys,kazzak,1329,deathknight,unholy,34,17,17
Ахелекус,blackscar,1327,deathknight,unholy,24,14,10
Moko,defias-brotherhood,1320,deathknight,unholy,30,14,16
Sictir,stormscale,1316,deathknight,unholy,133,63,70
Detrah,argent-dawn,1315,deathknight,unholy,52,27,25
Nilodk,nemesis,1314,deathknight,unholy,64,34,30
Ithis,zuljin,1312,deathknight,unholy,48,17,31
Metalmanethé,tarren-mill,1310,deathknight,unholy,97,40,57
Negzul,blackmoore,1308,deathknight,unholy,42,20,22
Sveinnhran,kazzak,1302,deathknight,unholy,46,19,27
Mojodango,outland,1299,deathknight,unholy,26,15,11
Jihm,silvermoon,1298,deathknight,unholy,67,35,32
Крикед,soulflayer,1297,deathknight,unholy,102,55,47
Züg,draenor,1287,deathknight,unholy,30,14,16
Гронташ,howling-fjord,1286,deathknight,unholy,29,14,15
Бреч,gordunni,1285,deathknight,unholy,42,14,28
Pjthedk,lightbringer,1284,deathknight,unholy,30,16,14
Zelbørk,medivh,1276,deathknight,unholy,30,17,13
Jöndas,drakthul,1272,deathknight,unholy,42,20,22
Necrozy,aggra-português,1269,deathknight,unholy,84,43,41
Morinosei,twisting-nether,1269,deathknight,unholy,59,30,29
Necrocancerr,twisting-nether,1269,deathknight,unholy,104,49,55
Роземайер,ashenvale,1266,deathknight,unholy,42,19,23
Kaletorn,ragnaros,1265,deathknight,unholy,84,41,43
Drenodur,amanthul,1261,deathknight,unholy,24,14,10
Superere,hyjal,1261,deathknight,unholy,36,17,19
Tyranus,quelthalas,1260,deathknight,unholy,91,38,53
Gûuts,archimonde,1257,deathknight,unholy,144,72,72
Storhøf,sanguino,1246,deathknight,unholy,24,13,11
Arizon,drakthul,1245,deathknight,unholy,36,13,23
Fentanil,elune,1244,deathknight,unholy,58,27,31
Allmawt,argent-dawn,1242,deathknight,unholy,24,13,11
Raust,xavius,1242,deathknight,unholy,26,13,13
Baltersa,blackhand,1240,deathknight,unholy,36,13,23
Hawkthuglife,dun-modr,1239,deathknight,unholy,30,13,17
Shabiri,twisting-nether,1238,deathknight,unholy,29,14,15
Lobotomia,burning-blade,1237,deathknight,unholy,30,15,15
Кристер,lich-king,1234,deathknight,unholy,30,13,17
Jalapeñofan,tarren-mill,1229,deathknight,unholy,24,13,11
Bärdk,forscherliga,1229,deathknight,unholy,30,13,17
Diatriss,argent-dawn,1199,deathknight,unholy,48,23,25
Zracul,nordrassil,1199,deathknight,unholy,36,14,22
Dunkàn,silvermoon,1190,deathknight,unholy,24,16,8
Abnormus,tarren-mill,1175,deathknight,unholy,45,19,26
Ridire,saurfang,1159,deathknight,unholy,31,15,16
Gladiadk,ysondre,1151,deathknight,unholy,30,12,18
Zerachy,blackmoore,1150,deathknight,unholy,18,12,6
Рыжаяпедаль,soulflayer,1150,deathknight,unholy,18,12,6
Happsor,eredar,1150,deathknight,unholy,30,12,18
Dklol,dun-morogh,1150,deathknight,unholy,36,14,22
Numnutz,alakir,1149,deathknight,unholy,25,13,12
Frege,tarren-mill,1149,deathknight,unholy,30,12,18
Nødder,ragnaros,1145,deathknight,unholy,18,12,6
Sevatar,zuljin,1137,deathknight,unholy,18,12,6
Fineral,argent-dawn,1134,deathknight,unholy,24,12,12
Razzvy,darkspear,1131,deathknight,unholy,24,12,12
Qmy,outland,1131,deathknight,unholy,24,12,12
Dêku,aegwynn,1130,deathknight,unholy,79,44,35
Asakurai,grim-batol,1126,deathknight,unholy,42,22,20
Ashlëy,kaelthas,1121,deathknight,unholy,82,42,40
Ârtjom,aegwynn,1106,deathknight,unholy,28,12,16
Saromón,ravencrest,1101,deathknight,unholy,30,18,12
Darkhallow,thrall,1100,deathknight,unholy,50,23,27
Roykoopa,hyjal,1099,deathknight,unholy,30,13,17
Охъламон,soulflayer,1077,deathknight,unholy,36,13,23
Джайвана,soulflayer,1057,deathknight,unholy,76,36,40
Pandahapci,ragnaros,1055,deathknight,unholy,18,11,7
Вовчан,howling-fjord,1055,deathknight,unholy,24,11,13
Doozz,draenor,1055,deathknight,unholy,30,11,19
Fýhr,silvermoon,1052,deathknight,unholy,18,11,7
Trialist,dun-modr,1052,deathknight,unholy,18,11,7
Maradk,drakthul,1048,deathknight,unholy,24,11,13
Dunklerlord,malfurion,1045,deathknight,unholy,24,11,13
Ezreo,neptulon,1029,deathknight,unholy,25,11,14
Мокраявода,soulflayer,1026,deathknight,unholy,94,49,45
Pamplemouse,burning-blade,1014,deathknight,unholy,55,24,31
Takåtry,archimonde,1004,deathknight,unholy,30,14,16
Арцевус,gordunni,1002,deathknight,unholy,24,11,13
Tyrannus,earthen-ring,1000,deathknight,unholy,23,13,10
Gowther,blackmoore,999,deathknight,unholy,30,16,14
Gathalion,the-maelstrom,980,deathknight,unholy,48,28,20
Fpsrvg,minahonda,980,deathknight,unholy,47,21,26
Kaliro,sylvanas,960,deathknight,unholy,18,10,8
Сгеатог,gordunni,960,deathknight,unholy,18,10,8
Кромгондк,soulflayer,960,deathknight,unholy,24,10,14
Gripbroblem,nemesis,960,deathknight,unholy,30,10,20
Слендер,howling-fjord,959,deathknight,unholy,18,10,8
Nasxsy,blackmoore,959,deathknight,unholy,18,10,8
Manovar,archimonde,959,deathknight,unholy,18,10,8
Discochoppa,blackmoore,959,deathknight,unholy,24,10,14
Ronsôn,terrordar,959,deathknight,unholy,24,10,14
Скизм,howling-fjord,959,deathknight,unholy,24,10,14
Exanex,ragnaros,957,deathknight,unholy,18,10,8
Logoz,dun-modr,956,deathknight,unholy,18,10,8
Endlesspain,burning-legion,955,deathknight,unholy,24,10,14
Eltorro,ravencrest,952,deathknight,unholy,30,10,20
Híruzen,blackrock,942,deathknight,unholy,18,10,8
Recoil,blackrock,925,deathknight,unholy,20,11,9
Sang,deathwing,912,deathknight,unholy,15,11,4
Asakim,tarren-mill,911,deathknight,unholy,17,10,7
Kaldhan,nemesis,910,deathknight,unholy,24,10,14
Karalun,nagrand,875,deathknight,unholy,24,10,14
Orcborg,zuljin,868,deathknight,unholy,25,10,15
Khalifamia,alonsus,864,deathknight,unholy,18,9,9
Usbdock,stormscale,864,deathknight,unholy,18,9,9
Rottenpete,grim-batol,864,deathknight,unholy,18,9,9
Panorboy,tarren-mill,864,deathknight,unholy,18,9,9
Catloaf,silvermoon,864,deathknight,unholy,24,9,15
Bephomet,onyxia,864,deathknight,unholy,33,9,24
Bertonilo,burning-legion,863,deathknight,unholy,18,9,9
Funds,kazzak,863,deathknight,unholy,18,9,9
Reapocalypse,blackhand,862,deathknight,unholy,24,9,15
Unholycard,argent-dawn,860,deathknight,unholy,18,9,9
Тзинч,soulflayer,859,deathknight,unholy,18,9,9
Reportmeplz,ragnaros,857,deathknight,unholy,24,9,15
Tarfu,kazzak,856,deathknight,unholy,18,9,9
Marcianorock,dalaran,850,deathknight,unholy,18,9,9
Deathcleave,burning-legion,845,deathknight,unholy,23,9,14
Évìl,stormscale,815,deathknight,unholy,17,9,8
Zot,twisting-nether,814,deathknight,unholy,18,10,8
Hêalz,ungoro,813,deathknight,unholy,17,9,8
Nauser,kazzak,813,deathknight,unholy,23,9,14
Trigárdon,antonidas,812,deathknight,unholy,18,9,9
Arthursq,stormscale,806,deathknight,unholy,24,10,14
Некронн,grom,795,deathknight,unholy,17,9,8
Oldu,haomarush,794,deathknight,unholy,39,15,24
Deathvid,ravencrest,768,deathknight,unholy,12,8,4
Nysaia,blackmoore,768,deathknight,unholy,12,8,4
Wórzzag,arygos,768,deathknight,unholy,12,8,4
Femilista,dun-modr,768,deathknight,unholy,12,8,4
Radan,stormscale,768,deathknight,unholy,12,8,4
Preddktwo,twisting-nether,768,deathknight,unholy,12,8,4
Frostplague,aegwynn,768,deathknight,unholy,18,8,10
Apacstanya,ragnaros,768,deathknight,unholy,18,8,10
Кромгак,soulflayer,768,deathknight,unholy,18,8,10
Sanuky,blackrock,768,deathknight,unholy,18,8,10
Silvergreed,kazzak,768,deathknight,unholy,18,8,10
Apolyio,outland,768,deathknight,unholy,21,9,12
Zatrina,blackrock,768,deathknight,unholy,24,8,16
Senkingodx,ravencrest,768,deathknight,unholy,24,8,16
Sélyne,dalaran,768,deathknight,unholy,24,8,16
Клиссанг,razuvious,768,deathknight,unholy,30,8,22
Amelia,ambossar,767,deathknight,unholy,12,8,4
Zff,hyjal,767,deathknight,unholy,12,8,4
Промештейн,gordunni,767,deathknight,unholy,18,8,10
Arthrex,twisting-nether,766,deathknight,unholy,12,8,4
Krinoe,dalaran,766,deathknight,unholy,18,8,10
Tanenoss,kazzak,766,deathknight,unholy,18,8,10
Zombienatíon,silvermoon,766,deathknight,unholy,24,8,16
Persefal,nemesis,765,deathknight,unholy,30,8,22
Mãshi,hyjal,764,deathknight,unholy,18,8,10
Деркхаус,soulflayer,762,deathknight,unholy,12,8,4
Badbrian,draenor,760,deathknight,unholy,12,8,4
Rognvald,les-sentinelles,755,deathknight,unholy,17,11,6
Ilovegouàng,khaz-modan,754,deathknight,unholy,24,8,16
Nickolass,skullcrusher,747,deathknight,unholy,18,8,10
Aldramil,gorgonnash,726,deathknight,unholy,24,9,15
Moonpoxdk,nerathor,672,deathknight,unholy,12,7,5
Gareath,ragnaros,672,deathknight,unholy,12,7,5
Зибак,soulflayer,672,deathknight,unholy,12,7,5
Dklékata,archimonde,672,deathknight,unholy,12,7,5
Unholykebab,defias-brotherhood,672,deathknight,unholy,12,7,5
Èvíl,stormscale,672,deathknight,unholy,12,7,5
Smallbaboon,stormreaver,672,deathknight,unholy,18,7,11
Gadres,aegwynn,672,deathknight,unholy,18,7,11
Никнейм,gordunni,672,deathknight,unholy,18,7,11
Soulchaos,ravencrest,672,deathknight,unholy,18,7,11
Fearléss,outland,672,deathknight,unholy,18,7,11
Ahilus,bladefist,672,deathknight,unholy,18,7,11
Geraltbg,twisting-nether,672,deathknight,unholy,18,7,11
Дэдушка,gordunni,671,deathknight,unholy,12,7,5
Mcrune,ravencrest,671,deathknight,unholy,18,7,11
Ráisy,outland,671,deathknight,unholy,24,7,17
Erodevil,kazzak,671,deathknight,unholy,24,7,17
Amencore,kazzak,670,deathknight,unholy,14,7,7
Restodrowd,tarren-mill,663,deathknight,unholy,12,7,5
Unzul,twisting-nether,660,deathknight,unholy,12,7,5
Maxto,outland,576,deathknight,unholy,12,6,6
Swordkill,drakthul,576,deathknight,unholy,12,6,6
Акамахи,ashenvale,576,deathknight,unholy,12,6,6
Feelmyfuri,mazrigos,576,deathknight,unholy,12,6,6
Duriel,stormscale,576,deathknight,unholy,12,6,6
Nephalêm,thrall,576,deathknight,unholy,12,6,6
Mefhesto,tarren-mill,576,deathknight,unholy,12,6,6
Critgødx,draenor,576,deathknight,unholy,13,6,7
Анзорини,gordunni,576,deathknight,unholy,18,6,12
Bloodkatana,drakthul,576,deathknight,unholy,18,6,12
Undtot,azshara,575,deathknight,unholy,12,6,6
Kalantii,draenor,575,deathknight,unholy,12,6,6
Havi,thunderhorn,575,deathknight,unholy,12,6,6
Feugen,hyjal,575,deathknight,unholy,12,6,6
Fishtruction,tarren-mill,575,deathknight,unholy,12,6,6
Oldiseas,grim-batol,575,deathknight,unholy,12,6,6
Mosscraciun,kazzak,575,deathknight,unholy,12,6,6
Zegaan,kazzak,575,deathknight,unholy,18,6,12
Reidemorte,minahonda,575,deathknight,unholy,18,6,12
Ennigmá,stormscale,572,deathknight,unholy,12,6,6
Jowân,blackmoore,572,deathknight,unholy,12,6,6
Малп,gordunni,569,deathknight,unholy,12,6,6
Kixx,bloodfeather,557,deathknight,unholy,23,6,17
Deadpòól,twisting-nether,521,deathknight,unholy,33,7,26
Jess,blackhand,520,deathknight,unholy,11,6,5
Таможникс,soulflayer,511,deathknight,unholy,11,6,5
Branchë,stormscale,511,deathknight,unholy,14,6,8
Барагган,thermaplugg,480,deathknight,unholy,6,5,1
Critycal,draenor,480,deathknight,unholy,6,5,1
Theamine,silvermoon,480,deathknight,unholy,6,5,1
Judin,kazzak,480,deathknight,unholy,6,5,1
Izanagii,exodar,480,deathknight,unholy,6,5,1
Náthrakh,argent-dawn,480,deathknight,unholy,6,5,1
Scotty,ravencrest,480,deathknight,unholy,6,5,1
Aceléss,drakthul,480,deathknight,unholy,6,5,1
Zhugzug,ragnaros,480,deathknight,unholy,12,5,7
Kaeyz,blackmoore,480,deathknight,unholy,12,5,7
Cbalife,ragnaros,480,deathknight,unholy,12,5,7
Dêeath,madmortem,480,deathknight,unholy,12,5,7
Frostich,ragnaros,480,deathknight,unholy,12,5,7
Luciferon,zenedar,480,deathknight,unholy,12,5,7
Миракл,howling-fjord,480,deathknight,unholy,12,5,7
Rêxaks,dun-modr,480,deathknight,unholy,12,5,7
Шэйп,fordragon,480,deathknight,unholy,12,5,7
Deathmonsta,auchindoun,480,deathknight,unholy,12,5,7
Deathkanta,antonidas,480,deathknight,unholy,12,5,7
Goreshovel,stormscale,480,deathknight,unholy,12,5,7
Крус,blackscar,480,deathknight,unholy,12,5,7
Prekliatylad,burning-blade,480,deathknight,unholy,12,5,7
Gethunts,drakthul,480,deathknight,unholy,12,5,7
Shewoman,stormreaver,480,deathknight,unholy,12,5,7
Azrìal,agamaggan,480,deathknight,unholy,12,5,7
Itokawa,tarren-mill,480,deathknight,unholy,12,5,7
Sipsip,tarren-mill,480,deathknight,unholy,12,5,7
Дядьдим,soulflayer,480,deathknight,unholy,12,5,7
Аирфрост,howling-fjord,480,deathknight,unholy,12,5,7
Dräpârn,sylvanas,480,deathknight,unholy,12,5,7
Morgianà,argent-dawn,480,deathknight,unholy,12,5,7
Rammsteïn,ravencrest,480,deathknight,unholy,15,6,9
Shining,blackrock,480,deathknight,unholy,21,6,15
Lurkkiss,ravencrest,480,deathknight,unholy,18,5,13
Xad,blackrock,480,deathknight,unholy,18,5,13
Maxïmus,argent-dawn,480,deathknight,unholy,24,5,19
Âlîce,culte-de-la-rive-noire,479,deathknight,unholy,12,5,7
Kazay,madmortem,479,deathknight,unholy,12,5,7
Hacknorris,aegwynn,478,deathknight,unholy,12,5,7
Mailasse,dalaran,476,deathknight,unholy,10,6,4
Kailara,draenor,463,deathknight,unholy,11,5,6
Grubbins,kul-tiras,447,deathknight,unholy,11,5,6
Gravetitan,shattrath,445,deathknight,unholy,23,5,18
Ezlar,silvermoon,400,deathknight,unholy,7,5,2
Arkaris,blackmoore,399,deathknight,unholy,5,5,0
Cheethdoom,ragnaros,384,deathknight,unholy,6,4,2
Wttdmg,kazzak,384,deathknight,unholy,6,4,2
Styxdk,blackhand,384,deathknight,unholy,6,4,2
Helmich,frostmane,384,deathknight,unholy,6,4,2
Deathcaller,zuljin,384,deathknight,unholy,6,4,2
Redduck,silvermoon,384,deathknight,unholy,6,4,2
Lichkunt,stormscale,384,deathknight,unholy,6,4,2
Капустас,gordunni,384,deathknight,unholy,6,4,2
Copium,hyjal,384,deathknight,unholy,6,4,2
Xênôrr,archimonde,384,deathknight,unholy,6,4,2
Psychopathz,tarren-mill,384,deathknight,unholy,6,4,2
Neph,sanguino,384,deathknight,unholy,6,4,2
Stepknìght,draenor,384,deathknight,unholy,6,4,2
Krisigaped,blackhand,384,deathknight,unholy,6,4,2
Dreadmind,blackrock,384,deathknight,unholy,12,4,8
Sekkah,tarren-mill,384,deathknight,unholy,12,4,8
Колхозник,howling-fjord,384,deathknight,unholy,12,4,8
Demrior,hellfire,384,deathknight,unholy,12,4,8
Epoch,azjolnerub,384,deathknight,unholy,12,4,8
Aifam,twisting-nether,384,deathknight,unholy,12,4,8
Кромгон,soulflayer,384,deathknight,unholy,12,4,8
Mustakäsi,ravencrest,384,deathknight,unholy,12,4,8
Darkarthás,aegwynn,384,deathknight,unholy,12,4,8
Derimathras,stormscale,384,deathknight,unholy,12,4,8
Протосеня,soulflayer,384,deathknight,unholy,12,4,8
Pängei,frostwolf,384,deathknight,unholy,12,4,8
Razdig,dun-modr,384,deathknight,unholy,12,4,8
Mawdrym,twisting-nether,384,deathknight,unholy,12,4,8
Szayestra,draenor,384,deathknight,unholy,12,4,8
Сивкабурка,fordragon,384,deathknight,unholy,12,4,8
Ecormcpz,eredar,384,deathknight,unholy,12,4,8
Sugarcakedk,blackrock,384,deathknight,unholy,18,4,14
Raizhen,ragnaros,384,deathknight,unholy,18,4,14
Dizin,ravencrest,384,deathknight,unholy,19,4,15
Zoombie,draenor,383,deathknight,unholy,6,4,2
Flippmo,argent-dawn,383,deathknight,unholy,9,5,4
Gothenburger,darksorrow,383,deathknight,unholy,12,4,8
Хворной,howling-fjord,383,deathknight,unholy,12,4,8
Lastdragon,dun-modr,381,deathknight,unholy,12,4,8
Варрлнишнс,soulflayer,367,deathknight,unholy,11,4,7
Ogomegee,ravencrest,352,deathknight,unholy,10,4,6
Millknight,norgannon,341,deathknight,unholy,15,6,9
Лордэнергон,gordunni,319,deathknight,unholy,10,4,6
Saryn,burning-steppes,304,deathknight,unholy,13,4,9
Randomdkxd,ravencrest,304,deathknight,unholy,13,4,9
Mocca,aegwynn,288,deathknight,unholy,6,3,3
Kelebglin,silvermoon,288,deathknight,unholy,6,3,3
Zathron,blackmoore,288,deathknight,unholy,6,3,3
Râke,teldrassil,288,deathknight,unholy,6,3,3
Galgalí,blackmoore,288,deathknight,unholy,6,3,3
Gigadk,ragnaros,288,deathknight,unholy,6,3,3
Квашонка,howling-fjord,288,deathknight,unholy,6,3,3
Yousaindk,blackrock,288,deathknight,unholy,6,3,3
Metalist,ravencrest,288,deathknight,unholy,6,3,3
Моровой,blackscar,288,deathknight,unholy,6,3,3
Løz,kazzak,288,deathknight,unholy,6,3,3
Axram,ravencrest,288,deathknight,unholy,6,3,3
Manego,eredar,288,deathknight,unholy,6,3,3
Riceeater,kazzak,288,deathknight,unholy,6,3,3
Эвессом,goldrinn,288,deathknight,unholy,6,3,3
Synchronic,stormscale,288,deathknight,unholy,6,3,3
Cyphîllyth,auchindoun,288,deathknight,unholy,6,3,3
Empiu,blackhand,288,deathknight,unholy,6,3,3
Myeltior,kazzak,288,deathknight,unholy,6,3,3
Vip,argent-dawn,288,deathknight,unholy,6,3,3
Jénga,ghostlands,288,deathknight,unholy,6,3,3
Альдафьод,howling-fjord,288,deathknight,unholy,6,3,3
Fatøumatata,archimonde,288,deathknight,unholy,6,3,3
Joyt,argent-dawn,288,deathknight,unholy,6,3,3
Clérora,argent-dawn,288,deathknight,unholy,6,3,3
Krookidk,archimonde,288,deathknight,unholy,6,3,3
Тряпьё,galakrond,288,deathknight,unholy,6,3,3
Еххел,soulflayer,288,deathknight,unholy,6,3,3
Gbdk,xavius,288,deathknight,unholy,6,3,3
Calina,frostwolf,288,deathknight,unholy,6,3,3
Mamanica,sanguino,288,deathknight,unholy,6,3,3
Дкшрёдингера,gordunni,288,deathknight,unholy,6,3,3
Zêlëph,archimonde,288,deathknight,unholy,6,3,3
Fyrkadk,aegwynn,288,deathknight,unholy,6,3,3
Crudelias,aegwynn,288,deathknight,unholy,6,3,3
Dakyforfun,ravencrest,288,deathknight,unholy,6,3,3
Plaguebones,ravencrest,288,deathknight,unholy,12,3,9
Дерайв,gordunni,288,deathknight,unholy,12,3,9
Ràiven,blackmoore,288,deathknight,unholy,12,3,9
Valanaari,argent-dawn,288,deathknight,unholy,12,3,9
Helixsdk,outland,288,deathknight,unholy,12,3,9
Dimania,the-maelstrom,288,deathknight,unholy,12,3,9
Chains,sanguino,288,deathknight,unholy,12,3,9
Nuadar,outland,288,deathknight,unholy,12,3,9
Cleverb,silvermoon,288,deathknight,unholy,12,3,9
Tyranuse,kazzak,288,deathknight,unholy,12,3,9
Lair,shendralar,288,deathknight,unholy,12,3,9
Garasu,eredar,288,deathknight,unholy,18,3,15
Dekayo,blackrock,256,deathknight,unholy,10,3,7
Narrua,die-aldor,255,deathknight,unholy,11,3,8
Hateem,sylvanas,255,deathknight,unholy,11,3,8
Xawias,ulduar,234,deathknight,unholy,8,4,4
Nexium,outland,192,deathknight,unholy,4,3,1
Alti,blackmoore,192,deathknight,unholy,4,3,1
Clipe,sanguino,192,deathknight,unholy,6,2,4
Ketnissq,blackrock,192,deathknight,unholy,6,2,4
Kacpèr,burning-legion,192,deathknight,unholy,6,2,4
Njor,twisting-nether,192,deathknight,unholy,6,2,4
Шинратенсеи,howling-fjord,192,deathknight,unholy,6,2,4
Kromas,silvermoon,192,deathknight,unholy,6,2,4
Vrez,argent-dawn,192,deathknight,unholy,6,2,4
Аэрит,howling-fjord,192,deathknight,unholy,6,2,4
Elendren,blackrock,192,deathknight,unholy,6,2,4
Rimda,twisting-nether,192,deathknight,unholy,6,2,4
Scareanger,argent-dawn,192,deathknight,unholy,6,2,4
Worldwiynd,ravencrest,192,deathknight,unholy,6,2,4
Thryndiel,ravencrest,192,deathknight,unholy,6,2,4
Engelinä,ysondre,192,deathknight,unholy,6,2,4
Urukaye,silvermoon,192,deathknight,unholy,6,2,4
Dk,earthen-ring,192,deathknight,unholy,6,2,4
Haeydez,draenor,192,deathknight,unholy,6,2,4
Letudra,outland,192,deathknight,unholy,6,2,4
Bigblackgrip,hyjal,192,deathknight,unholy,6,2,4
Fdkgotbuffed,tarren-mill,192,deathknight,unholy,6,2,4
Alameda,nathrezim,192,deathknight,unholy,6,2,4
Aesthaetik,draenor,192,deathknight,unholy,6,2,4
Homelándér,blackmoore,192,deathknight,unholy,6,2,4
Unholyysteel,silvermoon,192,deathknight,unholy,6,2,4
Eyyoo,blackmoore,192,deathknight,unholy,6,2,4
Norux,alonsus,192,deathknight,unholy,6,2,4
Буризан,blackscar,192,deathknight,unholy,6,2,4
Кадавров,gordunni,192,deathknight,unholy,6,2,4
Eigrin,argent-dawn,192,deathknight,unholy,6,2,4
Zugzugdecay,kazzak,192,deathknight,unholy,6,2,4
Exult,twisting-nether,192,deathknight,unholy,6,2,4
Nihilistyx,blackrock,192,deathknight,unholy,6,2,4
Mustapha,kazzak,192,deathknight,unholy,6,2,4
Линфео,galakrond,192,deathknight,unholy,6,2,4
Postura,kazzak,192,deathknight,unholy,6,2,4
Даркслэш,howling-fjord,192,deathknight,unholy,6,2,4
Морталес,azuregos,192,deathknight,unholy,6,2,4
Thoir,ahnqiraj,192,deathknight,unholy,6,2,4
Lithics,blades-edge,192,deathknight,unholy,6,2,4
Amyntasz,twisting-nether,192,deathknight,unholy,6,2,4
Kraken,aerie-peak,192,deathknight,unholy,6,2,4
Cyliandra,silvermoon,192,deathknight,unholy,12,2,10
Nestia,emerald-dream,192,deathknight,unholy,12,2,10
Гадиния,soulflayer,191,deathknight,unholy,4,3,1
Abyad,dalaran,191,deathknight,unholy,6,2,4
Àragørn,blackrock,191,deathknight,unholy,6,2,4
Джагат,gordunni,191,deathknight,unholy,12,2,10
Civilredevil,ravencrest,159,deathknight,unholy,5,2,3
Calhoun,teldrassil,159,deathknight,unholy,5,2,3
Táli,tarren-mill,144,deathknight,unholy,9,2,7
Dødsmanna,twisting-nether,144,deathknight,unholy,9,2,7
Cayliadk,tarren-mill,138,deathknight,unholy,14,4,10
Flinsen,blackmoore,106,deathknight,unholy,12,3,9
Inmau,sanguino,96,deathknight,unholy,3,2,1
Jarhèad,grim-batol,96,deathknight,unholy,10,3,7
Seal,lightnings-blade,96,deathknight,unholy,15,4,11
Vîrus,kazzak,96,deathknight,unholy,6,1,5
Grimgôr,kazzak,96,deathknight,unholy,6,1,5
Eívór,garrosh,96,deathknight,unholy,6,1,5
Gdubet,kazzak,96,deathknight,unholy,6,1,5
Wavemaker,kazzak,96,deathknight,unholy,6,1,5
Kirkster,terokkar,96,deathknight,unholy,6,1,5
Sìrmooalot,twisting-nether,96,deathknight,unholy,6,1,5
Cameltôe,frostwolf,96,deathknight,unholy,6,1,5
Bøby,kul-tiras,96,deathknight,unholy,6,1,5
Fixmybones,frostmane,96,deathknight,unholy,6,1,5
Orrengo,blackrock,96,deathknight,unholy,6,1,5
Mjölnir,sanguino,96,deathknight,unholy,6,1,5
Skrati,das-syndikat,96,deathknight,unholy,6,1,5
Antexdk,drakthul,96,deathknight,unholy,6,1,5
Dextèr,stormreaver,96,deathknight,unholy,6,1,5
Dumbclass,wildhammer,96,deathknight,unholy,6,1,5
Инфлюминс,soulflayer,96,deathknight,unholy,6,1,5
Madsgrip,tarren-mill,96,deathknight,unholy,6,1,5
Peiie,ravencrest,96,deathknight,unholy,6,1,5
Lieven,tarren-mill,96,deathknight,unholy,6,1,5
Brasith,outland,96,deathknight,unholy,12,1,11
Buzknight,twisting-nether,96,deathknight,unholy,12,1,11
Форнителли,howling-fjord,96,deathknight,unholy,12,1,11
Icyplague,ravencrest,63,deathknight,unholy,2,2,0
Charai,blackhand,42,deathknight,unholy,8,2,6
Никнейм,gordunni,2096,deathknight,frost,90,48,42
Garrinchá,stormscale,2040,deathknight,frost,60,36,24
Anotherdkx,ravencrest,1997,deathknight,frost,60,36,24
Имерсий,gordunni,1929,deathknight,frost,42,26,16
Igetmount,draenor,1895,deathknight,frost,36,20,16
Fdkgotbuffed,tarren-mill,1865,deathknight,frost,48,25,23
Jeanice,blackhand,1833,deathknight,frost,42,23,19
Murbastic,draenor,1823,deathknight,frost,102,47,55
Viuff,kazzak,1814,deathknight,frost,36,19,17
Gorobijec,drakthul,1680,deathknight,frost,42,21,21
Дарргг,ashenvale,1664,deathknight,frost,60,27,33
Frostlux,archimonde,1654,deathknight,frost,250,118,132
Brawlerbabe,stormscale,1646,deathknight,frost,54,26,28
Arxelas,sylvanas,1643,deathknight,frost,118,64,54
Rêxaks,dun-modr,1630,deathknight,frost,42,19,23
Geunieve,ysondre,1621,deathknight,frost,60,23,37
Duriel,stormscale,1619,deathknight,frost,36,22,14
Banishabomb,ragnaros,1615,deathknight,frost,78,39,39
Vidofnir,argent-dawn,1611,deathknight,frost,56,31,25
Xolaani,outland,1596,deathknight,frost,36,20,16
Kailara,draenor,1556,deathknight,frost,48,26,22
Raylenx,uldaman,1543,deathknight,frost,63,31,32
Regniér,frostwolf,1540,deathknight,frost,51,23,28
Deucalyqt,nemesis,1538,deathknight,frost,66,31,35
Dripgrip,ravencrest,1529,deathknight,frost,77,36,41
Винкис,gordunni,1509,deathknight,frost,36,19,17
Dktroll,blackmoore,1489,deathknight,frost,139,63,76
Leónid,kazzak,1486,deathknight,frost,33,17,16
Cayliadk,tarren-mill,1456,deathknight,frost,117,55,62
Fallenjaina,kazzak,1435,deathknight,frost,66,30,36
Stevensdk,darkspear,1427,deathknight,frost,36,17,19
Кулькулегал,ashenvale,1424,deathknight,frost,24,15,9
Маклайкнайт,gordunni,1417,deathknight,frost,78,36,42
Skorice,dalaran,1415,deathknight,frost,42,17,25
Düksito,dun-modr,1392,deathknight,frost,63,32,31
Фростмаран,soulflayer,1373,deathknight,frost,96,45,51
Frostmommy,argent-dawn,1371,deathknight,frost,39,16,23
Ðeucaly,nemesis,1357,deathknight,frost,66,30,36
Mocca,aegwynn,1357,deathknight,frost,52,21,31
Døuffy,hyjal,1319,deathknight,frost,48,24,24
Ihatelife,frostwolf,1304,deathknight,frost,42,19,23
Superere,hyjal,1300,deathknight,frost,78,43,35
Devilknight,dentarg,1282,deathknight,frost,60,31,29
Кроуфрост,gordunni,1245,deathknight,frost,42,19,23
Düks,dun-modr,1238,deathknight,frost,87,39,48
Comehere,norgannon,1214,deathknight,frost,18,13,5
Arthasuk,dun-modr,1207,deathknight,frost,68,36,32
Twardobaba,burning-legion,1203,deathknight,frost,38,17,21
Morgouse,kazzak,1203,deathknight,frost,41,16,25
Krasny,hyjal,1179,deathknight,frost,78,42,36
Abnormus,tarren-mill,1179,deathknight,frost,72,38,34
Espatula,ravencrest,1150,deathknight,frost,18,12,6
Tenzøftw,archimonde,1148,deathknight,frost,24,12,12
Nôsferatú,amanthul,1145,deathknight,frost,78,39,39
Darkchas,silvermoon,1144,deathknight,frost,24,12,12
Геннош,howling-fjord,1143,deathknight,frost,24,12,12
Zerodude,silvermoon,1142,deathknight,frost,60,30,30
Mattesøs,drakthul,1130,deathknight,frost,36,13,23
Âlîce,culte-de-la-rive-noire,1123,deathknight,frost,26,12,14
Dkruffos,draenor,1114,deathknight,frost,60,24,36
Woddey,blackrock,1073,deathknight,frost,48,22,26
Вафельнаяфея,blackscar,1073,deathknight,frost,43,17,26
Azrador,frostwolf,1071,deathknight,frost,36,12,24
Alastoras,nemesis,1011,deathknight,frost,24,11,13
Quantumshift,ravencrest,1004,deathknight,frost,17,11,6
Mikagoddess,argent-dawn,959,deathknight,frost,18,10,8
Ubiystvo,kazzak,955,deathknight,frost,18,10,8
Dursall,thrall,934,deathknight,frost,104,49,55
Fareast,nerathor,914,deathknight,frost,66,32,34
Нифер,deathguard,894,deathknight,frost,20,10,10
Kixx,bloodfeather,873,deathknight,frost,53,13,40
ßambøøzle,draenor,864,deathknight,frost,18,9,9
Wrathlich,tyrande,863,deathknight,frost,18,9,9
Neorteriona,argent-dawn,860,deathknight,frost,18,9,9
Vîrus,kazzak,859,deathknight,frost,18,9,9
Peachvajz,turalyon,855,deathknight,frost,24,11,13
Khelthalas,teldrassil,841,deathknight,frost,13,10,3
Guillemet,turalyon,830,deathknight,frost,16,10,6
Elbaqwan,the-shatar,827,deathknight,frost,30,13,17
Craftmaker,eonar,816,deathknight,frost,44,19,25
Ниффер,deathguard,800,deathknight,frost,22,9,13
Ivik,the-maelstrom,771,deathknight,frost,20,10,10
Afadk,kazzak,769,deathknight,frost,36,13,23
Селес,ashenvale,768,deathknight,frost,12,8,4
Elendren,blackrock,768,deathknight,frost,12,8,4
Diogenisis,arthas,768,deathknight,frost,24,8,16
Kooklynn,aggra-português,767,deathknight,frost,12,8,4
Jollíe,tarren-mill,767,deathknight,frost,24,8,16
Orcborg,zuljin,764,deathknight,frost,18,8,10
Gageth,shadowsong,763,deathknight,frost,33,9,24
Fullbusterr,hyjal,761,deathknight,frost,12,8,4
Lichfils,chogall,745,deathknight,frost,27,8,19
Gorefiend,kazzak,672,deathknight,frost,12,7,5
Asphyxias,alleria,672,deathknight,frost,12,7,5
Selena,blackmoore,672,deathknight,frost,12,7,5
Малтель,howling-fjord,672,deathknight,frost,12,7,5
Chakko,ravencrest,672,deathknight,frost,18,7,11
Flúrrý,kazzak,672,deathknight,frost,18,7,11
Halohuntress,outland,671,deathknight,frost,18,7,11
Меланндрис,gordunni,669,deathknight,frost,15,8,7
Gravehammer,sylvanas,663,deathknight,frost,12,7,5
Aczheron,argent-dawn,660,deathknight,frost,24,7,17
Narali,argent-dawn,576,deathknight,frost,12,6,6
Планус,booty-bay,576,deathknight,frost,12,6,6
Orangatang,dalaran,576,deathknight,frost,12,6,6
Sionya,outland,576,deathknight,frost,12,6,6
Rubbann,ravencrest,576,deathknight,frost,12,6,6
Deucàlyqt,nemesis,576,deathknight,frost,16,7,9
Izanagii,exodar,572,deathknight,frost,12,6,6
Tyranuse,kazzak,527,deathknight,frost,17,6,11
Exodiuss,dalaran,510,deathknight,frost,16,6,10
Асаала,soulflayer,480,deathknight,frost,6,5,1
Worlviuz,argent-dawn,480,deathknight,frost,12,5,7
Ûñhølýðéåthj,tarren-mill,480,deathknight,frost,12,5,7
Deucalygodx,nemesis,480,deathknight,frost,12,5,7
Feelmyfuri,mazrigos,480,deathknight,frost,12,5,7
Moosbirne,blackhand,479,deathknight,frost,12,5,7
Xtream,blackmoore,479,deathknight,frost,12,5,7
Deadpòól,twisting-nether,479,deathknight,frost,18,5,13
Copium,hyjal,477,deathknight,frost,12,5,7
Predatormkdd,ravencrest,429,deathknight,frost,11,5,6
Nymfo,tirion,384,deathknight,frost,6,4,2
Ostridz,grim-batol,384,deathknight,frost,6,4,2
Namzera,draenor,384,deathknight,frost,6,4,2
Gozuryu,kazzak,384,deathknight,frost,6,4,2
Êbøla,sanguino,384,deathknight,frost,6,4,2
Indrette,archimonde,384,deathknight,frost,6,4,2
Reann,argent-dawn,384,deathknight,frost,6,4,2
Oldiseas,grim-batol,384,deathknight,frost,6,4,2
Collinná,aegwynn,384,deathknight,frost,6,4,2
Dakyforfun,ravencrest,384,deathknight,frost,6,4,2
Neitoperho,frostmane,384,deathknight,frost,12,4,8
Æew,kazzak,384,deathknight,frost,12,4,8
Belía,blackmoore,384,deathknight,frost,12,4,8
Sipsip,tarren-mill,384,deathknight,frost,12,4,8
Кокосоус,gordunni,384,deathknight,frost,17,4,13
Beherith,sunstrider,383,deathknight,frost,6,4,2
Tÿnak,der-mithrilorden,383,deathknight,frost,9,4,5
Breeze,xavius,383,deathknight,frost,12,4,8
Kivo,marécage-de-zangar,383,deathknight,frost,12,4,8
Бранс,gordunni,383,deathknight,frost,12,4,8
Eckodk,aggra-português,383,deathknight,frost,12,4,8
Гадиния,soulflayer,383,deathknight,frost,12,4,8
Дневнои,howling-fjord,382,deathknight,frost,12,4,8
Apraxia,ravencrest,288,deathknight,frost,6,3,3
Nazgül,drakthul,288,deathknight,frost,6,3,3
Modelo,twisting-nether,288,deathknight,frost,6,3,3
Джайвана,soulflayer,288,deathknight,frost,6,3,3
Руин,blackscar,288,deathknight,frost,6,3,3
Endlesspain,burning-legion,288,deathknight,frost,6,3,3
Xanthic,ravencrest,288,deathknight,frost,6,3,3
Шэйп,fordragon,288,deathknight,frost,6,3,3
Whippy,ravencrest,288,deathknight,frost,6,3,3
Cyphîllyth,auchindoun,288,deathknight,frost,6,3,3
Vaanor,draenor,288,deathknight,frost,6,3,3
Veneera,emeriss,288,deathknight,frost,6,3,3
Moko,defias-brotherhood,288,deathknight,frost,6,3,3
Ogomegee,ravencrest,288,deathknight,frost,6,3,3
Keridíin,twisting-nether,288,deathknight,frost,6,3,3
Jjayker,kazzak,288,deathknight,frost,6,3,3
Necrozy,aggra-português,288,deathknight,frost,6,3,3
Persefal,nemesis,288,deathknight,frost,6,3,3
Raihor,outland,288,deathknight,frost,8,3,5
Eynoway,blackmoore,288,deathknight,frost,12,3,9
Thilior,silvermoon,288,deathknight,frost,12,3,9
Тенелла,gordunni,288,deathknight,frost,12,3,9
Prekliatylad,burning-blade,288,deathknight,frost,12,3,9
Zuggandk,tarren-mill,288,deathknight,frost,12,3,9
Iaccidens,stormscale,288,deathknight,frost,12,3,9
Tzunâ,blackmoore,288,deathknight,frost,18,3,15
Fishtruction,tarren-mill,287,deathknight,frost,6,3,3
Antîlâ,antonidas,286,deathknight,frost,6,3,3
Venthyrgwa,kazzak,284,deathknight,frost,7,5,2
Leonis,arthas,192,deathknight,frost,6,2,4
Doozz,draenor,192,deathknight,frost,6,2,4
Notstacy,dragonblight,192,deathknight,frost,6,2,4
Pandahapci,ragnaros,192,deathknight,frost,6,2,4
Ilovegouàng,khaz-modan,192,deathknight,frost,6,2,4
Mennal,the-maelstrom,192,deathknight,frost,6,2,4
Deathcardos,die-aldor,192,deathknight,frost,6,2,4
Toffy,anetheron,192,deathknight,frost,6,2,4
Sindó,blackrock,192,deathknight,frost,6,2,4
Abadonn,archimonde,192,deathknight,frost,6,2,4
Hordak,stormscale,192,deathknight,frost,6,2,4
Royalcrown,stormscale,192,deathknight,frost,6,2,4
Vaffe,tarren-mill,192,deathknight,frost,6,2,4
Køley,draenor,192,deathknight,frost,6,2,4
Ullefuz,silvermoon,192,deathknight,frost,6,2,4
Ilaenu,ravencrest,192,deathknight,frost,6,2,4
Tyró,ravencrest,192,deathknight,frost,6,2,4
Deathknight,spinebreaker,192,deathknight,frost,6,2,4
Dreadmind,blackrock,192,deathknight,frost,6,2,4
Narrua,die-aldor,192,deathknight,frost,12,2,10
Zioan,jaedenar,191,deathknight,frost,6,2,4
Nîghtmáre,ravencrest,159,deathknight,frost,5,2,3
Dïkcite,archimonde,96,deathknight,frost,6,1,5
Thínkk,ysondre,96,deathknight,frost,6,1,5
Arrèsted,aegwynn,96,deathknight,frost,6,1,5
Slimez,magtheridon,96,deathknight,frost,6,1,5
Hydross,archimonde,96,deathknight,frost,6,1,5
Бахлыщ,soulflayer,96,deathknight,frost,6,1,5
Буризан,blackscar,96,deathknight,frost,6,1,5
Discochoppa,blackmoore,96,deathknight,frost,6,1,5
Kaeyz,blackmoore,96,deathknight,frost,6,1,5
Veçh,turalyon,96,deathknight,frost,6,1,5
Pestilerous,draenor,96,deathknight,frost,6,1,5
Feddk,stormscale,96,deathknight,frost,6,1,5
Cleverb,silvermoon,96,deathknight,frost,6,1,5
Anasûrimbor,tarren-mill,96,deathknight,frost,6,1,5
Thryndiel,ravencrest,96,deathknight,frost,6,1,5
Ezlar,silvermoon,96,deathknight,frost,6,1,5
Urukaye,silvermoon,96,deathknight,frost,6,1,5
Arthursq,stormscale,95,deathknight,frost,6,1,5
Assølid,arathor,42,deathknight,frost,11,2,9
Zslebaans,dun-modr,2204,demonhunter,havoc,104,55,49
Itsdampbaby,kazzak,2187,demonhunter,havoc,79,44,35
Norgàn,die-aldor,2178,demonhunter,havoc,81,44,37
Ðesz,sanguino,2153,demonhunter,havoc,95,52,43
Enysia,twisting-nether,2127,demonhunter,havoc,122,62,60
Melan,sanguino,2116,demonhunter,havoc,108,54,54
Лфгхиро,soulflayer,2101,demonhunter,havoc,65,37,28
Razzagall,elune,2101,demonhunter,havoc,54,30,24
Heatx,ysondre,2094,demonhunter,havoc,138,79,59
Veon,ravencrest,2075,demonhunter,havoc,269,133,136
Évø,silvermoon,2064,demonhunter,havoc,90,44,46
Ohseri,defias-brotherhood,2045,demonhunter,havoc,114,57,57
Battlebruh,ghostlands,2032,demonhunter,havoc,83,39,44
Elswavé,kazzak,2026,demonhunter,havoc,66,39,27
Læsy,antonidas,2025,demonhunter,havoc,101,53,48
Истребитель,blackscar,2016,demonhunter,havoc,114,74,40
Boostbydh,archimonde,2006,demonhunter,havoc,140,72,68
Anabbele,kazzak,1968,demonhunter,havoc,96,52,44
Betterevoker,outland,1953,demonhunter,havoc,66,41,25
Мортрэд,gordunni,1950,demonhunter,havoc,66,39,27
Battlebruuh,ghostlands,1935,demonhunter,havoc,66,27,39
Ïîï,archimonde,1934,demonhunter,havoc,79,37,42
Damatche,outland,1933,demonhunter,havoc,120,61,59
Scubaman,tarren-mill,1932,demonhunter,havoc,54,31,23
Illislan,darksorrow,1928,demonhunter,havoc,155,81,74
Pipeandy,kazzak,1918,demonhunter,havoc,83,45,38
Fiveyearques,sylvanas,1914,demonhunter,havoc,90,45,45
Boxssabanned,archimonde,1903,demonhunter,havoc,89,44,45
Cuddlypeanut,argent-dawn,1898,demonhunter,havoc,76,36,40
Belvé,draenor,1897,demonhunter,havoc,84,43,41
Màuul,ravencrest,1886,demonhunter,havoc,134,68,66
Cydh,auchindoun,1883,demonhunter,havoc,60,32,28
Walkmyshoes,twisting-nether,1877,demonhunter,havoc,102,51,51
Brawndow,draenor,1877,demonhunter,havoc,84,42,42
Tyssra,argent-dawn,1870,demonhunter,havoc,96,42,54
Donkeydh,tarren-mill,1868,demonhunter,havoc,54,36,18
Perna,ghostlands,1867,demonhunter,havoc,60,29,31
Oldforwow,outland,1863,demonhunter,havoc,102,55,47
Çøððøøððøøðð,blackmoore,1863,demonhunter,havoc,60,32,28
Demonalpha,stormscale,1862,demonhunter,havoc,43,23,20
Brolafsen,ravencrest,1859,demonhunter,havoc,66,32,34
Kindablind,aggramar,1858,demonhunter,havoc,71,36,35
Apfelbaum,die-aldor,1857,demonhunter,havoc,60,40,20
Mädchen,blackhand,1854,demonhunter,havoc,48,23,25
Dasein,tarren-mill,1852,demonhunter,havoc,54,29,25
Gilletteabdi,argent-dawn,1847,demonhunter,havoc,72,34,38
Elipireli,doomhammer,1846,demonhunter,havoc,42,20,22
Gíftig,ravencrest,1843,demonhunter,havoc,47,24,23
Клопобойка,gordunni,1842,demonhunter,havoc,69,37,32
Bloodwatcher,twisting-nether,1842,demonhunter,havoc,54,27,27
Fotmdehatwo,blackrock,1837,demonhunter,havoc,61,32,29
Nøbodyx,tarren-mill,1837,demonhunter,havoc,66,33,33
Ðoksy,archimonde,1835,demonhunter,havoc,60,31,29
Donipwnz,blackrock,1833,demonhunter,havoc,60,29,31
Zeroques,frostmane,1831,demonhunter,havoc,66,33,33
Сасун,galakrond,1831,demonhunter,havoc,69,32,37
Supay,rexxar,1830,demonhunter,havoc,58,31,27
Yamehd,stormreaver,1827,demonhunter,havoc,42,26,16
Рейз,howling-fjord,1827,demonhunter,havoc,102,53,49
Chxpo,twisting-nether,1826,demonhunter,havoc,89,47,42
Сибу,soulflayer,1825,demonhunter,havoc,48,21,27
Badtimes,malganis,1824,demonhunter,havoc,213,106,107
Элизар,howling-fjord,1821,demonhunter,havoc,120,61,59
Iryut,onyxia,1820,demonhunter,havoc,60,32,28
Malignantx,ragnaros,1819,demonhunter,havoc,54,30,24
Mongoose,drakthul,1818,demonhunter,havoc,66,35,31
Airelidari,tyrande,1818,demonhunter,havoc,125,64,61
Maytherel,blackhand,1818,demonhunter,havoc,84,38,46
Dreamslash,tarren-mill,1817,demonhunter,havoc,52,29,23
Flyingwhale,terokkar,1815,demonhunter,havoc,33,21,12
Unseenshadow,ragnaros,1813,demonhunter,havoc,60,25,35
Tórstenstøck,ravencrest,1811,demonhunter,havoc,47,31,16
Elsynn,dalaran,1811,demonhunter,havoc,54,29,25
Paschli,tarren-mill,1810,demonhunter,havoc,54,26,28
Zerinitý,outland,1809,demonhunter,havoc,48,29,19
Glìmpsêgøðx,twisting-nether,1809,demonhunter,havoc,42,22,20
Хменчик,soulflayer,1809,demonhunter,havoc,97,47,50
Yúki,blackrock,1809,demonhunter,havoc,48,23,25
Ææçëñ,ravencrest,1808,demonhunter,havoc,36,23,13
Xarôth,eredar,1805,demonhunter,havoc,48,22,26
Cláw,ravencrest,1804,demonhunter,havoc,84,42,42
Batik,blackmoore,1802,demonhunter,havoc,78,40,38
Barbarinjo,silvermoon,1800,demonhunter,havoc,36,22,14
Миелион,gordunni,1800,demonhunter,havoc,65,29,36
Funkiller,stormscale,1788,demonhunter,havoc,46,24,22
Mazöku,ravencrest,1787,demonhunter,havoc,72,41,31
Sofun,stormscale,1780,demonhunter,havoc,50,22,28
Zuklio,ysondre,1778,demonhunter,havoc,59,29,30
Автокикер,soulflayer,1771,demonhunter,havoc,54,31,23
Possomhd,kazzak,1770,demonhunter,havoc,90,55,35
Pulsefuzzy,burning-legion,1770,demonhunter,havoc,48,28,20
Netherim,twisting-nether,1768,demonhunter,havoc,60,27,33
Lelaniae,blackhand,1759,demonhunter,havoc,48,20,28
Nuxzhell,tarren-mill,1753,demonhunter,havoc,126,64,62
Primolover,outland,1747,demonhunter,havoc,54,27,27
Gøat,nemesis,1745,demonhunter,havoc,54,32,22
Onof,hyjal,1742,demonhunter,havoc,54,26,28
Wojtall,silvermoon,1735,demonhunter,havoc,113,63,50
Cuirnoir,ravencrest,1734,demonhunter,havoc,36,20,16
Dadøw,dun-modr,1732,demonhunter,havoc,48,21,27
Weez,kilrogg,1731,demonhunter,havoc,72,35,37
Razex,kazzak,1730,demonhunter,havoc,87,44,43
Khétí,tarren-mill,1728,demonhunter,havoc,65,32,33
Djratatouill,kazzak,1727,demonhunter,havoc,30,20,10
Stazó,drakthul,1726,demonhunter,havoc,91,48,43
Aiean,ravencrest,1726,demonhunter,havoc,54,26,28
Kinstak,sanguino,1725,demonhunter,havoc,54,27,27
Finwe,outland,1723,demonhunter,havoc,45,27,18
Balberith,twisting-nether,1723,demonhunter,havoc,66,37,29
Haldin,kazzak,1719,demonhunter,havoc,35,19,16
Çôæ,twisting-nether,1719,demonhunter,havoc,52,28,24
Wibergdh,kazzak,1718,demonhunter,havoc,24,18,6
Maevê,frostmourne,1712,demonhunter,havoc,37,19,18
Mavorz,blackhand,1709,demonhunter,havoc,30,18,12
Depure,blackrock,1707,demonhunter,havoc,48,24,24
Hunee,kazzak,1706,demonhunter,havoc,54,32,22
Íllìðåñgøðx,twisting-nether,1705,demonhunter,havoc,46,22,24
Mentalìst,blackmoore,1703,demonhunter,havoc,57,35,22
Felen,zuljin,1703,demonhunter,havoc,47,21,26
Авилолз,gordunni,1702,demonhunter,havoc,48,25,23
Ryänåir,ravencrest,1701,demonhunter,havoc,54,34,20
Indral,argent-dawn,1699,demonhunter,havoc,42,25,17
Merelini,twisting-nether,1699,demonhunter,havoc,34,19,15
Киттигоплей,soulflayer,1699,demonhunter,havoc,48,25,23
Belákor,twisting-nether,1698,demonhunter,havoc,187,95,92
Vexanic,chamber-of-aspects,1697,demonhunter,havoc,42,22,20
Tanjero,stormscale,1696,demonhunter,havoc,53,36,17
Xekaul,tarren-mill,1694,demonhunter,havoc,96,45,51
Rvnx,archimonde,1691,demonhunter,havoc,81,47,34
Âspen,archimonde,1690,demonhunter,havoc,66,42,24
Bxdh,outland,1688,demonhunter,havoc,45,21,24
Demonichanta,azjolnerub,1684,demonhunter,havoc,120,63,57
Enfy,twisting-nether,1683,demonhunter,havoc,59,28,31
Emurid,les-sentinelles,1682,demonhunter,havoc,54,26,28
Carboen,tarren-mill,1682,demonhunter,havoc,72,34,38
Spheria,outland,1680,demonhunter,havoc,89,43,46
Íllìðåñgøðx,antonidas,1675,demonhunter,havoc,48,24,24
Ranked,drakthul,1675,demonhunter,havoc,63,24,39
Шахдан,howling-fjord,1673,demonhunter,havoc,76,43,33
Геммула,howling-fjord,1671,demonhunter,havoc,114,58,56
Imslapping,draenor,1669,demonhunter,havoc,66,37,29
Nisirae,argent-dawn,1662,demonhunter,havoc,81,51,30
Xetalar,burning-legion,1661,demonhunter,havoc,114,70,44
Camtoe,ravencrest,1656,demonhunter,havoc,58,36,22
Bojestvena,twisting-nether,1654,demonhunter,havoc,42,22,20
Thorair,ravenholdt,1653,demonhunter,havoc,60,31,29
Velysaría,guldan,1650,demonhunter,havoc,46,25,21
Slutkitten,ravencrest,1650,demonhunter,havoc,42,19,23
Ïfï,archimonde,1646,demonhunter,havoc,62,31,31
Nolitara,exodar,1640,demonhunter,havoc,54,29,25
Aofaye,aegwynn,1638,demonhunter,havoc,53,21,32
Simshady,stormscale,1637,demonhunter,havoc,42,25,17
Picpouc,archimonde,1637,demonhunter,havoc,54,24,30
Riptos,blackhand,1635,demonhunter,havoc,46,22,24
ßerdína,tarren-mill,1634,demonhunter,havoc,75,38,37
Akkita,ravencrest,1631,demonhunter,havoc,68,38,30
Temac,magtheridon,1630,demonhunter,havoc,42,22,20
Billyhassan,kazzak,1628,demonhunter,havoc,30,18,12
Reckqt,eredar,1628,demonhunter,havoc,30,17,13
Uldren,defias-brotherhood,1628,demonhunter,havoc,110,50,60
Azraethx,ravencrest,1627,demonhunter,havoc,36,24,12
Eurobeat,dun-modr,1627,demonhunter,havoc,36,21,15
Юзлескласс,gordunni,1627,demonhunter,havoc,36,20,16
Omegapump,ravencrest,1626,demonhunter,havoc,36,19,17
Nillrogthedh,stormscale,1625,demonhunter,havoc,90,59,31
Unkqt,dalaran,1625,demonhunter,havoc,36,20,16
Jumboo,tarren-mill,1625,demonhunter,havoc,53,29,24
Drmanaburn,ravencrest,1624,demonhunter,havoc,30,17,13
Dominik,the-maelstrom,1623,demonhunter,havoc,126,73,53
Jolyh,nemesis,1622,demonhunter,havoc,36,24,12
Lanadelbae,teldrassil,1622,demonhunter,havoc,91,46,45
Zkrdh,kazzak,1622,demonhunter,havoc,47,21,26
Susanoø,eredar,1619,demonhunter,havoc,147,78,69
Камуи,gordunni,1617,demonhunter,havoc,48,19,29
Demonkata,twisting-nether,1616,demonhunter,havoc,50,29,21
Пибзянка,howling-fjord,1616,demonhunter,havoc,36,20,16
Garoteromani,draenor,1612,demonhunter,havoc,54,35,19
Lindzor,frostmane,1611,demonhunter,havoc,41,29,12
Lilfly,twisting-nether,1611,demonhunter,havoc,30,17,13
Gündüzgezen,silvermoon,1611,demonhunter,havoc,44,23,21
Турбосвинья,gordunni,1610,demonhunter,havoc,36,20,16
Ted,frostwolf,1610,demonhunter,havoc,36,17,19
Przemson,mazrigos,1607,demonhunter,havoc,42,22,20
Neralith,ravencrest,1607,demonhunter,havoc,42,20,22
Майкелелекек,gordunni,1606,demonhunter,havoc,36,17,19
Havocer,burning-legion,1605,demonhunter,havoc,60,33,27
Èstefany,stormscale,1604,demonhunter,havoc,90,49,41
Zevsa,ravencrest,1604,demonhunter,havoc,48,25,23
Zayláh,ravencrest,1604,demonhunter,havoc,87,42,45
Фэсс,soulflayer,1603,demonhunter,havoc,60,32,28
Cheetòs,blackmoore,1602,demonhunter,havoc,24,17,7
Roaf,twisting-nether,1600,demonhunter,havoc,39,21,18
Kikitank,hyjal,1600,demonhunter,havoc,141,74,67
Крикадский,howling-fjord,1598,demonhunter,havoc,84,50,34
Великаямыша,blackscar,1598,demonhunter,havoc,44,26,18
Sepdy,draenor,1596,demonhunter,havoc,36,21,15
Demoncyka,twisting-nether,1595,demonhunter,havoc,54,17,37
Майотх,gordunni,1594,demonhunter,havoc,78,31,47
Xalgalor,silvermoon,1592,demonhunter,havoc,42,24,18
Sebyk,doomhammer,1591,demonhunter,havoc,54,32,22
Трукейт,gordunni,1582,demonhunter,havoc,56,33,23
Felski,outland,1572,demonhunter,havoc,40,18,22
Râindra,twisting-nether,1570,demonhunter,havoc,126,64,62
Shadyblady,nemesis,1568,demonhunter,havoc,46,24,22
Нэйтиси,soulflayer,1568,demonhunter,havoc,41,19,22
Quazr,outland,1567,demonhunter,havoc,93,58,35
Dhqoo,blackrock,1565,demonhunter,havoc,42,18,24
Demonmancer,ravencrest,1564,demonhunter,havoc,90,47,43
Dhzor,twisting-nether,1562,demonhunter,havoc,36,19,17
Lghdtv,ravencrest,1560,demonhunter,havoc,72,36,36
Мужичок,soulflayer,1559,demonhunter,havoc,66,37,29
Incanator,tarren-mill,1556,demonhunter,havoc,60,30,30
Yousaindh,blackrock,1553,demonhunter,havoc,48,18,30
Evil,uldum,1548,demonhunter,havoc,48,25,23
Сосочков,soulflayer,1548,demonhunter,havoc,70,30,40
Däshgødx,stormscale,1543,demonhunter,havoc,54,31,23
Dyamo,sylvanas,1543,demonhunter,havoc,195,97,98
Rezer,stormscale,1542,demonhunter,havoc,36,17,19
Azaleia,archimonde,1540,demonhunter,havoc,107,53,54
Shtahuntna,tarren-mill,1539,demonhunter,havoc,48,31,17
Чанпэн,soulflayer,1539,demonhunter,havoc,128,68,60
Duffin,doomhammer,1539,demonhunter,havoc,90,45,45
Misli,stormscale,1537,demonhunter,havoc,30,19,11
Boozlike,tarren-mill,1537,demonhunter,havoc,54,28,26
Nixzon,thrall,1537,demonhunter,havoc,54,18,36
Winxclub,ravencrest,1534,demonhunter,havoc,53,32,21
Ambudh,kazzak,1533,demonhunter,havoc,30,16,14
Neverdance,ravencrest,1533,demonhunter,havoc,36,16,20
Shylea,ravencrest,1531,demonhunter,havoc,90,48,42
Albunico,draenor,1527,demonhunter,havoc,105,59,46
Kostiq,kazzak,1527,demonhunter,havoc,30,16,14
Despèradø,archimonde,1527,demonhunter,havoc,60,30,30
Alcóhon,ravencrest,1526,demonhunter,havoc,35,17,18
Zintu,draenor,1526,demonhunter,havoc,66,30,36
Dinastye,archimonde,1525,demonhunter,havoc,47,25,22
Stellarvore,nemesis,1525,demonhunter,havoc,42,21,21
Yeedhlol,blackmoore,1523,demonhunter,havoc,30,16,14
Vênedri,eredar,1522,demonhunter,havoc,36,22,14
Amnésysx,ysondre,1521,demonhunter,havoc,36,16,20
Akaria,blackrock,1518,demonhunter,havoc,58,39,19
Guccibaby,silvermoon,1517,demonhunter,havoc,54,27,27
Ferihokurva,outland,1515,demonhunter,havoc,30,16,14
Speedførce,antonidas,1513,demonhunter,havoc,36,16,20
Дантеллиан,gordunni,1511,demonhunter,havoc,75,36,39
Slaanaesh,kazzak,1511,demonhunter,havoc,45,17,28
Telarris,twisting-nether,1509,demonhunter,havoc,141,82,59
Цэрри,soulflayer,1509,demonhunter,havoc,48,24,24
Zitx,ravencrest,1507,demonhunter,havoc,47,26,21
Tenawees,blackmoore,1505,demonhunter,havoc,36,22,14
Tamtheone,silvermoon,1503,demonhunter,havoc,54,26,28
Sweetpety,tarren-mill,1500,demonhunter,havoc,48,24,24
Krm,dun-modr,1498,demonhunter,havoc,26,17,9
Nuitrayer,hyjal,1497,demonhunter,havoc,50,33,17
Edh,dalaran,1497,demonhunter,havoc,42,17,25
Hauntedseoul,grim-batol,1496,demonhunter,havoc,90,54,36
Nøvillain,blackrock,1494,demonhunter,havoc,36,20,16
Цезарий,gordunni,1493,demonhunter,havoc,72,35,37
Koomaliha,outland,1492,demonhunter,havoc,61,25,36
Échô,tarren-mill,1489,demonhunter,havoc,40,18,22
Métakagoule,ysondre,1488,demonhunter,havoc,45,22,23
Snitchezz,blackmoore,1486,demonhunter,havoc,72,39,33
Thingawoop,tarren-mill,1483,demonhunter,havoc,32,17,15
Oonn,outland,1482,demonhunter,havoc,45,21,24
Oggidanbuu,tarren-mill,1479,demonhunter,havoc,36,17,19
Kayzel,argent-dawn,1477,demonhunter,havoc,72,33,39
Frevee,outland,1475,demonhunter,havoc,95,54,41
Vorbis,twisting-nether,1472,demonhunter,havoc,42,17,25
Myztiko,hellscream,1471,demonhunter,havoc,122,63,59
Malakbel,nemesis,1470,demonhunter,havoc,75,37,38
Ilovelilith,zuljin,1466,demonhunter,havoc,47,22,25
Фумиан,soulflayer,1465,demonhunter,havoc,52,22,30
Lasaka,stormscale,1460,demonhunter,havoc,30,19,11
Împd,ravencrest,1456,demonhunter,havoc,90,43,47
Ülquiorrä,kazzak,1450,demonhunter,havoc,53,34,19
Кирсена,gordunni,1450,demonhunter,havoc,35,17,18
Shadoss,ravencrest,1447,demonhunter,havoc,54,22,32
Flaybalbooll,ragnaros,1437,demonhunter,havoc,72,38,34
Kebabidin,kazzak,1436,demonhunter,havoc,30,15,15
Wibez,twisting-nether,1433,demonhunter,havoc,24,15,9
Satånist,outland,1433,demonhunter,havoc,24,15,9
Soizis,drakthul,1431,demonhunter,havoc,24,15,9
Ifeeldirty,draenor,1431,demonhunter,havoc,31,16,15
Felom,garona,1427,demonhunter,havoc,24,15,9
Деструкцыя,howling-fjord,1426,demonhunter,havoc,33,19,14
Thugrøse,blackrock,1426,demonhunter,havoc,60,31,29
Hialdoo,sylvanas,1426,demonhunter,havoc,36,15,21
Tkr,zuljin,1424,demonhunter,havoc,42,24,18
Méruème,hyjal,1424,demonhunter,havoc,31,16,15
Culywurly,silvermoon,1423,demonhunter,havoc,60,28,32
Imlegalblind,ragnaros,1422,demonhunter,havoc,38,17,21
Ilidrax,hyjal,1421,demonhunter,havoc,30,15,15
Molntuss,ravencrest,1418,demonhunter,havoc,38,15,23
Crappyftw,ravencrest,1416,demonhunter,havoc,120,61,59
Toddsnuggles,thrall,1414,demonhunter,havoc,30,20,10
Valarauk,ravencrest,1410,demonhunter,havoc,69,41,28
Аянамирейко,blackscar,1407,demonhunter,havoc,42,26,16
Checakore,argent-dawn,1406,demonhunter,havoc,48,27,21
Luzifer,ambossar,1406,demonhunter,havoc,129,68,61
Arnokia,kazzak,1405,demonhunter,havoc,48,19,29
Luckertwo,tarren-mill,1403,demonhunter,havoc,54,30,24
Malabala,grim-batol,1398,demonhunter,havoc,23,15,8
Shaihulud,sanguino,1398,demonhunter,havoc,77,39,38
Darrkdemon,kazzak,1398,demonhunter,havoc,77,34,43
Razziyel,ragnaros,1396,demonhunter,havoc,41,21,20
Дартарин,gordunni,1395,demonhunter,havoc,62,34,28
Cptxo,tarren-mill,1382,demonhunter,havoc,35,16,19
Кельдарк,soulflayer,1381,demonhunter,havoc,82,35,47
Øbsessiøn,kazzak,1379,demonhunter,havoc,54,24,30
Keanujeeves,dentarg,1376,demonhunter,havoc,60,33,27
Pówèr,ravencrest,1375,demonhunter,havoc,42,23,19
Anstict,kazzak,1371,demonhunter,havoc,48,22,26
Seyran,silvermoon,1367,demonhunter,havoc,30,15,15
Iaml,ravencrest,1366,demonhunter,havoc,49,24,25
Ziltush,archimonde,1366,demonhunter,havoc,81,38,43
Khalestya,shendralar,1366,demonhunter,havoc,42,18,24
Monkeypox,twisting-nether,1366,demonhunter,havoc,46,19,27
Покахонта,soulflayer,1364,demonhunter,havoc,70,35,35
Imsickleavme,draenor,1363,demonhunter,havoc,64,32,32
Phudi,tarren-mill,1361,demonhunter,havoc,83,36,47
Ларэгар,azuregos,1361,demonhunter,havoc,60,24,36
Súrinox,blackrock,1355,demonhunter,havoc,77,44,33
Агрочика,borean-tundra,1349,demonhunter,havoc,36,16,20
Мицлейн,gordunni,1348,demonhunter,havoc,39,16,23
Adalya,stormrage,1348,demonhunter,havoc,52,19,33
Ibeem,dentarg,1346,demonhunter,havoc,33,23,10
Obey,exodar,1346,demonhunter,havoc,41,20,21
Thalamis,kazzak,1345,demonhunter,havoc,75,33,42
Mandariâ,blackmoore,1341,demonhunter,havoc,24,14,10
Ragnirok,deathwing,1341,demonhunter,havoc,72,34,38
Wrakdh,archimonde,1340,demonhunter,havoc,50,31,19
Illídana,azjolnerub,1340,demonhunter,havoc,62,32,30
Alithy,kazzak,1339,demonhunter,havoc,65,36,29
Stickidan,malganis,1339,demonhunter,havoc,30,14,16
Nepthýs,blackhand,1338,demonhunter,havoc,33,15,18
Demonmatheo,stormscale,1337,demonhunter,havoc,24,14,10
Faytundh,kult-der-verdammten,1336,demonhunter,havoc,30,14,16
Tayo,dun-modr,1335,demonhunter,havoc,30,16,14
Hawoc,chamber-of-aspects,1334,demonhunter,havoc,42,26,16
Azzïnoth,sargeras,1334,demonhunter,havoc,24,14,10
Felwinter,ravencrest,1332,demonhunter,havoc,36,14,22
Treehunter,ravencrest,1331,demonhunter,havoc,24,14,10
Kïng,frostmane,1330,demonhunter,havoc,18,14,4
Øctågøñ,blackrock,1328,demonhunter,havoc,46,18,28
Ämi,blackmoore,1327,demonhunter,havoc,36,15,21
Louloulou,aegwynn,1326,demonhunter,havoc,93,52,41
Геннитиро,deathguard,1321,demonhunter,havoc,24,14,10
Itheos,kazzak,1321,demonhunter,havoc,77,36,41
Kâtsulol,ysondre,1321,demonhunter,havoc,30,14,16
Ðraudræm,ravencrest,1314,demonhunter,havoc,56,24,32
Yvrig,eredar,1313,demonhunter,havoc,24,14,10
Коньх,goldrinn,1313,demonhunter,havoc,36,14,22
Délyria,blackhand,1311,demonhunter,havoc,54,32,22
Jayhan,chamber-of-aspects,1311,demonhunter,havoc,68,37,31
Bestdemon,tarren-mill,1311,demonhunter,havoc,39,20,19
Írony,draenor,1310,demonhunter,havoc,26,15,11
Lozakum,draenor,1309,demonhunter,havoc,24,14,10
Slowcuzclick,stormscale,1307,demonhunter,havoc,85,44,41
Breezzdh,twisting-nether,1305,demonhunter,havoc,29,14,15
Enthia,antonidas,1303,demonhunter,havoc,35,15,20
Trashcarlitô,eredar,1302,demonhunter,havoc,26,15,11
Каралас,soulflayer,1301,demonhunter,havoc,36,21,15
Nezruslfive,dun-modr,1301,demonhunter,havoc,30,15,15
Chapzi,ragnaros,1300,demonhunter,havoc,42,23,19
Brisingamen,outland,1297,demonhunter,havoc,30,14,16
Icelucard,argent-dawn,1297,demonhunter,havoc,35,16,19
Сумърак,grom,1296,demonhunter,havoc,29,15,14
Skywålker,stormscale,1292,demonhunter,havoc,33,14,19
Тарапынька,gordunni,1291,demonhunter,havoc,76,42,34
Coltender,drakthul,1290,demonhunter,havoc,61,28,33
Bläckdëvïl,uldum,1284,demonhunter,havoc,34,22,12
Billidan,eredar,1282,demonhunter,havoc,54,25,29
Jahannam,ysondre,1281,demonhunter,havoc,36,17,19
Máédhros,ravencrest,1278,demonhunter,havoc,28,14,14
Soca,ysondre,1275,demonhunter,havoc,35,15,20
Symbul,blackrock,1269,demonhunter,havoc,36,16,20
Даргсайд,gordunni,1269,demonhunter,havoc,36,16,20
Thëos,argent-dawn,1268,demonhunter,havoc,42,20,22
Varedisa,kazzak,1264,demonhunter,havoc,29,14,15
Norac,silvermoon,1248,demonhunter,havoc,41,16,25
Дэн,blackscar,1246,demonhunter,havoc,24,13,11
Eyasluna,twisting-nether,1246,demonhunter,havoc,30,13,17
Nèvér,silvermoon,1246,demonhunter,havoc,30,13,17
Мэйзиквин,howling-fjord,1245,demonhunter,havoc,24,13,11
Burchulica,sylvanas,1245,demonhunter,havoc,24,13,11
Faufilé,garona,1243,demonhunter,havoc,30,13,17
Thorno,argent-dawn,1243,demonhunter,havoc,36,13,23
Anubias,ravencrest,1243,demonhunter,havoc,36,13,23
Kezumå,tarren-mill,1241,demonhunter,havoc,30,13,17
Illiada,spinebreaker,1240,demonhunter,havoc,24,13,11
Demonligos,draenor,1239,demonhunter,havoc,66,35,31
Easywaay,kazzak,1236,demonhunter,havoc,18,13,5
Gïzmó,tarren-mill,1236,demonhunter,havoc,30,13,17
Claere,blackhand,1234,demonhunter,havoc,75,41,34
Хингарский,deathguard,1234,demonhunter,havoc,24,13,11
Bøøgý,silvermoon,1234,demonhunter,havoc,42,19,23
Titanslayyer,azjolnerub,1233,demonhunter,havoc,30,13,17
Эндимэн,soulflayer,1230,demonhunter,havoc,38,23,15
Djaris,ghostlands,1228,demonhunter,havoc,18,13,5
Thegamesucks,ravencrest,1228,demonhunter,havoc,163,79,84
Hirbs,silvermoon,1222,demonhunter,havoc,61,25,36
Ashrena,ysondre,1218,demonhunter,havoc,18,13,5
Adapterinput,auchindoun,1218,demonhunter,havoc,25,14,11
Kanabiz,outland,1216,demonhunter,havoc,36,15,21
Notcrashy,eredar,1215,demonhunter,havoc,18,13,5
Betråyêr,draenor,1213,demonhunter,havoc,38,15,23
Davidastt,drakthul,1207,demonhunter,havoc,35,13,22
Tharysan,sanguino,1203,demonhunter,havoc,18,13,5
Philona,die-aldor,1202,demonhunter,havoc,75,34,41
Blisdon,argent-dawn,1197,demonhunter,havoc,24,15,9
Лизарин,gordunni,1197,demonhunter,havoc,29,13,16
Vozol,stormscale,1195,demonhunter,havoc,30,20,10
Аркантт,soulflayer,1193,demonhunter,havoc,30,14,16
Nanocsika,twisting-nether,1187,demonhunter,havoc,51,24,27
Fikyx,draenor,1177,demonhunter,havoc,32,14,18
Scarebearz,outland,1171,demonhunter,havoc,54,31,23
Kiriall,blackmoore,1169,demonhunter,havoc,42,18,24
Сильверган,soulflayer,1167,demonhunter,havoc,66,31,35
Oxydh,ravencrest,1165,demonhunter,havoc,28,13,15
Lagordin,aggramar,1161,demonhunter,havoc,18,14,4
Demobob,tarren-mill,1152,demonhunter,havoc,24,12,12
Brainlessdmg,ragnaros,1151,demonhunter,havoc,18,12,6
Lassudan,stormreaver,1151,demonhunter,havoc,24,12,12
Çrymemøre,dun-modr,1151,demonhunter,havoc,24,12,12
Dhgoddess,kazzak,1151,demonhunter,havoc,24,12,12
Hagana,tirion,1151,demonhunter,havoc,24,12,12
Wyna,aggra-português,1151,demonhunter,havoc,24,12,12
Illidrax,outland,1151,demonhunter,havoc,30,12,18
Testôdh,blackrock,1151,demonhunter,havoc,30,12,18
Alundil,ravencrest,1150,demonhunter,havoc,18,12,6
Найтбладия,gordunni,1150,demonhunter,havoc,18,12,6
Уполномочен,howling-fjord,1150,demonhunter,havoc,24,12,12
Seleverkauft,antonidas,1149,demonhunter,havoc,18,12,6
Doomcake,emeriss,1149,demonhunter,havoc,18,12,6
Bigboychaos,twisting-nether,1149,demonhunter,havoc,36,19,17
Sturmovik,ravencrest,1147,demonhunter,havoc,18,12,6
Åelita,burning-legion,1147,demonhunter,havoc,18,12,6
Exceltor,sanguino,1147,demonhunter,havoc,36,12,24
Zahadius,silvermoon,1146,demonhunter,havoc,18,12,6
Rylqt,blackmoore,1146,demonhunter,havoc,30,12,18
Razrsolo,tarren-mill,1145,demonhunter,havoc,24,12,12
Fullsënd,ragnaros,1145,demonhunter,havoc,36,12,24
Мужна,grom,1144,demonhunter,havoc,18,12,6
Джигурдинец,gordunni,1144,demonhunter,havoc,30,17,13
Kaizzy,twisting-nether,1142,demonhunter,havoc,48,21,27
Iphanaa,frostmane,1142,demonhunter,havoc,28,12,16
Poutanaola,twisting-nether,1140,demonhunter,havoc,24,12,12
Hornyhexy,stormscale,1139,demonhunter,havoc,30,12,18
Gullveîg,archimonde,1136,demonhunter,havoc,24,12,12
Даблкорк,soulflayer,1133,demonhunter,havoc,29,16,13
Afuwarrior,doomhammer,1133,demonhunter,havoc,24,12,12
Бичерезх,soulflayer,1127,demonhunter,havoc,24,12,12
Sarissa,dun-modr,1120,demonhunter,havoc,26,14,12
Munja,hyjal,1119,demonhunter,havoc,42,21,21
Gabquist,argent-dawn,1118,demonhunter,havoc,41,24,17
Bessus,aggra-português,1115,demonhunter,havoc,24,12,12
Schonevrouw,aszune,1109,demonhunter,havoc,24,13,11
Zengor,twilights-hammer,1109,demonhunter,havoc,28,14,14
Dreggath,doomhammer,1104,demonhunter,havoc,36,16,20
Lögan,uldum,1103,demonhunter,havoc,30,14,16
Hawek,madmortem,1096,demonhunter,havoc,30,16,14
Demonronin,the-maelstrom,1095,demonhunter,havoc,18,12,6
Kebiz,ragnaros,1090,demonhunter,havoc,23,12,11
Venøøm,eldrethalas,1084,demonhunter,havoc,90,40,50
Azazelkw,ragnaros,1082,demonhunter,havoc,42,22,20
Byah,kazzak,1076,demonhunter,havoc,49,20,29
Егордемон,soulflayer,1074,demonhunter,havoc,30,12,18
Айвэнгос,thermaplugg,1072,demonhunter,havoc,45,25,20
Bicskas,ragnaros,1070,demonhunter,havoc,32,13,19
Metadel,outland,1069,demonhunter,havoc,83,44,39
Kladius,skullcrusher,1067,demonhunter,havoc,21,12,9
Guanzho,silvermoon,1066,demonhunter,havoc,33,13,20
Itsukix,stormscale,1063,demonhunter,havoc,24,13,11
Ascanius,nemesis,1062,demonhunter,havoc,30,18,12
Аллилания,fordragon,1061,demonhunter,havoc,38,25,13
Dantert,zuljin,1056,demonhunter,havoc,18,11,7
Mittÿ,tarren-mill,1056,demonhunter,havoc,24,11,13
Stonebanker,turalyon,1055,demonhunter,havoc,17,12,5
Dhlee,ravencrest,1055,demonhunter,havoc,18,11,7
Tdh,sanguino,1055,demonhunter,havoc,18,11,7
Врежимеэтти,soulflayer,1055,demonhunter,havoc,24,11,13
Jawohunt,rexxar,1055,demonhunter,havoc,30,11,19
Cappaowx,ravencrest,1054,demonhunter,havoc,18,11,7
Draxie,turalyon,1053,demonhunter,havoc,22,12,10
Фирулия,goldrinn,1052,demonhunter,havoc,32,20,12
Squan,blackmoore,1050,demonhunter,havoc,20,12,8
Dibo,blackmoore,1050,demonhunter,havoc,24,11,13
Aphulucky,kazzak,1050,demonhunter,havoc,30,11,19
Balsza,burning-legion,1049,demonhunter,havoc,18,11,7
Shadowkick,archimonde,1047,demonhunter,havoc,156,76,80
Flowen,stormreaver,1047,demonhunter,havoc,24,11,13
Demonk,nemesis,1040,demonhunter,havoc,18,11,7
Kaitlyyn,norgannon,1038,demonhunter,havoc,30,11,19
Demonhyan,chants-éternels,1035,demonhunter,havoc,49,25,24
Aamonath,tarren-mill,1030,demonhunter,havoc,30,16,14
Увиден,eversong,1021,demonhunter,havoc,47,22,25
Milkeyes,ravencrest,1013,demonhunter,havoc,54,26,28
Demontripo,silvermoon,1005,demonhunter,havoc,81,43,38
Delfee,twisting-nether,1005,demonhunter,havoc,54,25,29
Шмальнуть,gordunni,997,demonhunter,havoc,32,12,20
Viridisignis,silvermoon,993,demonhunter,havoc,36,16,20
Hunterston,twisting-nether,992,demonhunter,havoc,68,38,30
Гарнаш,howling-fjord,992,demonhunter,havoc,36,18,18
Twistyy,drakthul,991,demonhunter,havoc,48,25,23
Dxæn,archimonde,990,demonhunter,havoc,17,11,6
Sintoraz,amanthul,975,demonhunter,havoc,36,21,15
Deadskill,alexstrasza,975,demonhunter,havoc,42,19,23
Флеркенкот,galakrond,972,demonhunter,havoc,55,28,27
Нохелет,deepholm,966,demonhunter,havoc,63,31,32
Хэллшок,eversong,960,demonhunter,havoc,12,10,2
Анхардх,gordunni,960,demonhunter,havoc,18,10,8
Sekørm,ragnaros,960,demonhunter,havoc,18,10,8
Reckqqt,eredar,960,demonhunter,havoc,18,10,8
Yerla,burning-legion,960,demonhunter,havoc,24,10,14
Rehagen,ysondre,960,demonhunter,havoc,24,10,14
Chïbrøne,archimonde,960,demonhunter,havoc,30,10,20
Íamprepared,tarren-mill,960,demonhunter,havoc,30,10,20
Gigasloth,outland,959,demonhunter,havoc,12,10,2
Tylleröwittu,grim-batol,959,demonhunter,havoc,18,10,8
Völkswagen,dun-modr,959,demonhunter,havoc,18,10,8
Zamassu,kazzak,959,demonhunter,havoc,18,10,8
Kéftëmé,ravencrest,959,demonhunter,havoc,18,10,8
Катякрылышки,gordunni,959,demonhunter,havoc,18,10,8
Përry,archimonde,959,demonhunter,havoc,18,10,8
Theaisbae,twisting-nether,959,demonhunter,havoc,18,10,8
Broglaive,sylvanas,959,demonhunter,havoc,18,10,8
Khray,archimonde,959,demonhunter,havoc,18,10,8
Ðemøñsåy,blackrock,959,demonhunter,havoc,24,10,14
Darnke,silvermoon,959,demonhunter,havoc,30,10,20
Phesxdh,sylvanas,958,demonhunter,havoc,12,10,2
Аитерия,gordunni,958,demonhunter,havoc,12,10,2
Critlerman,blackmoore,957,demonhunter,havoc,16,11,5
Blizdliksk,outland,957,demonhunter,havoc,18,10,8
Orochimaruu,kargath,956,demonhunter,havoc,30,10,20
Древиал,gordunni,955,demonhunter,havoc,18,10,8
Pvpabuser,ravencrest,955,demonhunter,havoc,18,10,8
Экселия,howling-fjord,954,demonhunter,havoc,18,10,8
Argnils,tarren-mill,953,demonhunter,havoc,12,10,2
Pleskdh,malganis,953,demonhunter,havoc,24,10,14
Momochi,silvermoon,952,demonhunter,havoc,18,10,8
Lùcîfer,hellfire,943,demonhunter,havoc,24,10,14
Jemoer,twisting-nether,942,demonhunter,havoc,15,12,3
Sinthetyx,quelthalas,940,demonhunter,havoc,24,14,10
Shishiro,alakir,937,demonhunter,havoc,24,10,14
Самфор,soulflayer,935,demonhunter,havoc,24,10,14
Zermut,culte-de-la-rive-noire,925,demonhunter,havoc,17,10,7
Solarae,silvermoon,924,demonhunter,havoc,23,10,13
Taliaa,drakthul,911,demonhunter,havoc,21,10,11
Иллиферрат,blackscar,907,demonhunter,havoc,17,10,7
Skylinex,dentarg,901,demonhunter,havoc,48,24,24
Kroepoeks,mazrigos,894,demonhunter,havoc,24,13,11
Nuriia,arthas,886,demonhunter,havoc,30,15,15
Никельдон,howling-fjord,883,demonhunter,havoc,18,11,7
Mønkeyx,kazzak,864,demonhunter,havoc,12,9,3
Zy,ahnqiraj,864,demonhunter,havoc,12,9,3
Folygale,outland,864,demonhunter,havoc,12,9,3
Zireáel,stormscale,864,demonhunter,havoc,15,10,5
Jórúnn,twisting-nether,864,demonhunter,havoc,18,9,9
Raïley,archimonde,864,demonhunter,havoc,18,9,9
Эридари,blackscar,864,demonhunter,havoc,18,9,9
Bignugs,ravencrest,864,demonhunter,havoc,18,9,9
Sghemon,pozzo-delleternità,864,demonhunter,havoc,18,9,9
Смутсайбот,howling-fjord,864,demonhunter,havoc,18,9,9
Oniramqt,aegwynn,864,demonhunter,havoc,18,9,9
Saene,ravencrest,864,demonhunter,havoc,18,9,9
Eréthrus,ravencrest,864,demonhunter,havoc,18,9,9
Draqula,ravencrest,864,demonhunter,havoc,18,9,9
Toschadh,blackmoore,864,demonhunter,havoc,18,9,9
Mürh,nordrassil,864,demonhunter,havoc,18,9,9
Míàkhãlîfâýð,stormscale,864,demonhunter,havoc,24,9,15
Anerana,malganis,864,demonhunter,havoc,24,9,15
Sunestaa,kazzak,863,demonhunter,havoc,12,9,3
Aethinos,sylvanas,863,demonhunter,havoc,12,9,3
Kenzaii,aegwynn,863,demonhunter,havoc,18,9,9
Дайкиаомине,soulflayer,863,demonhunter,havoc,18,9,9
Sadzari,burning-legion,863,demonhunter,havoc,18,9,9
Mephîsto,sylvanas,863,demonhunter,havoc,18,9,9
Ììîîííììîîíí,tarren-mill,863,demonhunter,havoc,18,9,9
Darktérror,silvermoon,863,demonhunter,havoc,24,9,15
Nvampire,draenor,862,demonhunter,havoc,12,9,3
Beerseewälk,ragnaros,862,demonhunter,havoc,18,9,9
Zappikdh,silvermoon,862,demonhunter,havoc,18,9,9
Jesana,argent-dawn,862,demonhunter,havoc,18,9,9
Finstergraf,blackmoore,862,demonhunter,havoc,30,14,16
Illidián,chamber-of-aspects,862,demonhunter,havoc,24,9,15
Pichkachu,sylvanas,859,demonhunter,havoc,18,9,9
Никкэс,gordunni,859,demonhunter,havoc,18,9,9
Doobregeesy,burning-legion,859,demonhunter,havoc,21,10,11
Tokoloshë,ragnaros,854,demonhunter,havoc,18,9,9
Fckmlf,outland,839,demonhunter,havoc,21,12,9
Zulthealbino,tarren-mill,830,demonhunter,havoc,14,10,4
Бельторо,soulflayer,798,demonhunter,havoc,22,9,13
Felleaf,ragnaros,797,demonhunter,havoc,22,9,13
Deadhuntor,daggerspine,795,demonhunter,havoc,17,9,8
Kundans,aegwynn,787,demonhunter,havoc,17,9,8
Garretos,senjin,780,demonhunter,havoc,13,9,4
Eyecandy,scarshield-legion,768,demonhunter,havoc,12,8,4
Fruchtzwerg,tarren-mill,768,demonhunter,havoc,12,8,4
Enjøybrah,nemesis,768,demonhunter,havoc,12,8,4
Dedemøn,ysondre,768,demonhunter,havoc,12,8,4
Chotzbrocke,blackhand,768,demonhunter,havoc,12,8,4
Traumadh,tarren-mill,768,demonhunter,havoc,12,8,4
Nthday,draenor,768,demonhunter,havoc,18,8,10
Vayshi,turalyon,768,demonhunter,havoc,18,8,10
Saleny,blackrock,768,demonhunter,havoc,18,8,10
Stinkymonkey,pozzo-delleternità,768,demonhunter,havoc,18,8,10
Daemonax,ragnaros,768,demonhunter,havoc,18,8,10
Shõ,twisting-nether,768,demonhunter,havoc,24,8,16
Bichmicher,earthen-ring,768,demonhunter,havoc,24,8,16
Itadora,antonidas,768,demonhunter,havoc,24,8,16
Эска,razuvious,767,demonhunter,havoc,12,8,4
Grimberg,tarren-mill,767,demonhunter,havoc,12,8,4
Tursal,dun-morogh,767,demonhunter,havoc,12,8,4
Ninetzqp,tarren-mill,767,demonhunter,havoc,12,8,4
Morphiyy,tarren-mill,767,demonhunter,havoc,12,8,4
Baddxd,ragnaros,767,demonhunter,havoc,14,9,5
Ноубрейндыха,gordunni,767,demonhunter,havoc,18,8,10
Danedemlia,magtheridon,766,demonhunter,havoc,12,8,4
Skrelarent,argent-dawn,766,demonhunter,havoc,12,8,4
Mêgumi,kirin-tor,766,demonhunter,havoc,21,9,12
Demonjay,stormscale,766,demonhunter,havoc,22,9,13
Natazia,eredar,765,demonhunter,havoc,18,8,10
Попкасиська,eversong,763,demonhunter,havoc,47,19,28
Covidian,kilrogg,762,demonhunter,havoc,12,8,4
Maltok,ysondre,762,demonhunter,havoc,18,8,10
Yuka,earthen-ring,761,demonhunter,havoc,18,8,10
Subelsiu,alakir,760,demonhunter,havoc,27,10,17
Maryjane,nordrassil,756,demonhunter,havoc,18,8,10
Кусьзакиску,soulflayer,753,demonhunter,havoc,12,8,4
Lorcanmar,draenor,740,demonhunter,havoc,24,8,16
Gushìñgwøuñð,blackmoore,719,demonhunter,havoc,11,8,3
Ozeey,draenor,719,demonhunter,havoc,17,8,9
Silan,kiljaeden,711,demonhunter,havoc,17,8,9
Найтшифт,blackscar,704,demonhunter,havoc,10,8,2
Jco,kazzak,703,demonhunter,havoc,20,8,12
Níghtwing,wildhammer,702,demonhunter,havoc,17,8,9
Стрепа,grom,693,demonhunter,havoc,17,8,9
Maddificator,silvermoon,686,demonhunter,havoc,14,8,6
Bizl,arygos,672,demonhunter,havoc,12,7,5
Шалдарон,howling-fjord,672,demonhunter,havoc,12,7,5
Yorxdh,eredar,672,demonhunter,havoc,12,7,5
Lirigizel,hellscream,672,demonhunter,havoc,12,7,5
Onecho,ragnaros,672,demonhunter,havoc,12,7,5
Stonedaf,ravencrest,672,demonhunter,havoc,12,7,5
Ozu,blackrock,672,demonhunter,havoc,12,7,5
Hextechz,stormscale,672,demonhunter,havoc,12,7,5
Enhtailo,draenor,672,demonhunter,havoc,12,7,5
Wintalker,nemesis,672,demonhunter,havoc,12,7,5
Alied,burning-blade,672,demonhunter,havoc,12,7,5
Caronte,los-errantes,672,demonhunter,havoc,12,7,5
Sidekiq,silvermoon,672,demonhunter,havoc,12,7,5
Skarvy,bronze-dragonflight,672,demonhunter,havoc,12,7,5
Äzräël,dun-modr,672,demonhunter,havoc,12,7,5
Pepenger,kazzak,672,demonhunter,havoc,12,7,5
Actuallytrol,argent-dawn,672,demonhunter,havoc,12,7,5
Esadeáth,ravencrest,672,demonhunter,havoc,12,7,5
Lagseven,ravencrest,672,demonhunter,havoc,12,7,5
Kekburagól,kazzak,672,demonhunter,havoc,15,8,7
Shanaplow,hyjal,672,demonhunter,havoc,18,7,11
Gnarpump,emeriss,672,demonhunter,havoc,18,7,11
Rõb,magtheridon,672,demonhunter,havoc,18,7,11
Yukiz,ravencrest,672,demonhunter,havoc,18,7,11
Ignasei,archimonde,672,demonhunter,havoc,18,7,11
Thedudex,dunemaul,672,demonhunter,havoc,18,7,11
Demondulle,kazzak,672,demonhunter,havoc,18,7,11
Келидаррия,soulflayer,672,demonhunter,havoc,18,7,11
Onizukadh,archimonde,672,demonhunter,havoc,18,7,11
Satti,sargeras,672,demonhunter,havoc,18,7,11
Calcïum,archimonde,672,demonhunter,havoc,24,7,17
Meji,ravencrest,671,demonhunter,havoc,12,7,5
Ddvh,drakthul,671,demonhunter,havoc,12,7,5
Nerfy,silvermoon,671,demonhunter,havoc,12,7,5
Nxmpys,sanguino,671,demonhunter,havoc,12,7,5
Хорбелий,deathguard,671,demonhunter,havoc,18,7,11
Alandrisz,argent-dawn,671,demonhunter,havoc,24,7,17
Милинайт,eversong,670,demonhunter,havoc,12,7,5
Adraelia,archimonde,670,demonhunter,havoc,12,7,5
Тушино,lich-king,670,demonhunter,havoc,12,7,5
Trekxx,ragnaros,670,demonhunter,havoc,12,7,5
Hannipham,silvermoon,669,demonhunter,havoc,15,8,7
Necrotyle,twisting-nether,669,demonhunter,havoc,21,8,13
Teoma,hyjal,666,demonhunter,havoc,12,7,5
Nelairia,tarren-mill,666,demonhunter,havoc,12,7,5
Judderzz,bronze-dragonflight,658,demonhunter,havoc,12,7,5
Blutox,antonidas,653,demonhunter,havoc,19,8,11
Legionek,burning-blade,629,demonhunter,havoc,14,8,6
Makhabunda,terokkar,618,demonhunter,havoc,28,8,20
Mèlfurion,hyjal,607,demonhunter,havoc,13,8,5
Prouser,turalyon,588,demonhunter,havoc,21,8,13
Smydi,blackmoore,576,demonhunter,havoc,6,6,0
Alasune,twisting-nether,576,demonhunter,havoc,6,6,0
Kiirtach,dun-modr,576,demonhunter,havoc,9,7,2
Lòsêr,ravencrest,576,demonhunter,havoc,12,6,6
Noovedh,ravencrest,576,demonhunter,havoc,12,6,6
Кейтпрнстарс,howling-fjord,576,demonhunter,havoc,12,6,6
Shivarræ,stormreaver,576,demonhunter,havoc,12,6,6
Lanaël,kaelthas,576,demonhunter,havoc,12,6,6
Ruíko,dun-morogh,576,demonhunter,havoc,12,6,6
Zyasea,blackmoore,576,demonhunter,havoc,12,6,6
Størmrage,sanguino,576,demonhunter,havoc,12,6,6
Муими,soulflayer,576,demonhunter,havoc,12,6,6
Hcsgötze,dalaran,576,demonhunter,havoc,12,6,6
Mollamaija,defias-brotherhood,576,demonhunter,havoc,12,6,6
Rhinozerg,kazzak,576,demonhunter,havoc,12,6,6
Cptncucumber,blackmoore,576,demonhunter,havoc,12,6,6
Lezzo,tarren-mill,576,demonhunter,havoc,12,6,6
Kyuzo,sanguino,576,demonhunter,havoc,12,6,6
Aeshalla,blackmoore,576,demonhunter,havoc,12,6,6
Tëvnic,kazzak,576,demonhunter,havoc,12,6,6
Paindemon,outland,576,demonhunter,havoc,12,6,6
Demonzøku,ravencrest,576,demonhunter,havoc,12,6,6
Notapistol,outland,576,demonhunter,havoc,12,6,6
Viced,kazzak,576,demonhunter,havoc,12,6,6
Xyrs,draenor,576,demonhunter,havoc,12,6,6
Bamßi,ragnaros,576,demonhunter,havoc,12,6,6
Ботология,gordunni,576,demonhunter,havoc,12,6,6
Lawus,blackhand,576,demonhunter,havoc,12,6,6
Lurtéx,kazzak,576,demonhunter,havoc,12,6,6
Õmen,ravencrest,576,demonhunter,havoc,12,6,6
Zmasteez,ahnqiraj,576,demonhunter,havoc,12,6,6
Soulmortal,draenor,576,demonhunter,havoc,12,6,6
Peacedopice,drakthul,576,demonhunter,havoc,12,6,6
Véin,stormscale,576,demonhunter,havoc,18,6,12
Nøøßønline,hyjal,576,demonhunter,havoc,18,6,12
Dèsdemøna,nemesis,576,demonhunter,havoc,18,6,12
Sailen,blackmoore,576,demonhunter,havoc,18,6,12
Pinx,archimonde,576,demonhunter,havoc,18,6,12
Zaÿn,antonidas,576,demonhunter,havoc,18,6,12
Shyoxdh,twisting-nether,576,demonhunter,havoc,18,6,12
Ilyerias,twisting-nether,576,demonhunter,havoc,18,6,12
Shizuuli,outland,576,demonhunter,havoc,30,6,24
Instinctivee,sylvanas,575,demonhunter,havoc,12,6,6
Кайриель,gordunni,575,demonhunter,havoc,12,6,6
Saftad,outland,575,demonhunter,havoc,12,6,6
Daweeo,the-maelstrom,575,demonhunter,havoc,12,6,6
Овецловец,deathguard,575,demonhunter,havoc,12,6,6
Shizá,burning-legion,575,demonhunter,havoc,12,6,6
Antidevil,kazzak,575,demonhunter,havoc,16,7,9
Candylicks,kazzak,575,demonhunter,havoc,18,6,12
Sangita,tarren-mill,574,demonhunter,havoc,12,6,6
Ôlowain,blackmoore,574,demonhunter,havoc,18,6,12
Klave,argent-dawn,573,demonhunter,havoc,18,6,12
Tatsukiyuzu,hyjal,572,demonhunter,havoc,6,6,0
Bahmut,argent-dawn,569,demonhunter,havoc,12,6,6
Дантавул,gordunni,568,demonhunter,havoc,18,6,12
Olddemon,ravencrest,542,demonhunter,havoc,11,6,5
Подкрадунзай,soulflayer,527,demonhunter,havoc,9,7,2
Fruttidimare,frostwolf,527,demonhunter,havoc,11,6,5
Makiu,archimonde,527,demonhunter,havoc,15,6,9
Иланари,gordunni,526,demonhunter,havoc,11,6,5
Gnjurac,outland,511,demonhunter,havoc,14,6,8
Amionisiken,amanthul,496,demonhunter,havoc,13,6,7
Убийца,soulflayer,480,demonhunter,havoc,6,5,1
Kimberleh,doomhammer,480,demonhunter,havoc,6,5,1
Morrion,blackmoore,480,demonhunter,havoc,6,5,1
Smâshêd,stormscale,480,demonhunter,havoc,6,5,1
Giboo,emerald-dream,480,demonhunter,havoc,6,5,1
Muharaar,ravencrest,480,demonhunter,havoc,6,5,1
Jugøbænned,blackrock,480,demonhunter,havoc,6,5,1
Muyoni,eredar,480,demonhunter,havoc,6,5,1
Kanéki,sylvanas,480,demonhunter,havoc,6,5,1
Monion,defias-brotherhood,480,demonhunter,havoc,6,5,1
Nekkëtsu,archimonde,480,demonhunter,havoc,6,5,1
Ayyo,agamaggan,480,demonhunter,havoc,12,5,7
Backflipgødx,uldaman,480,demonhunter,havoc,12,5,7
Spitface,aegwynn,480,demonhunter,havoc,12,5,7
Topg,bladefist,480,demonhunter,havoc,12,5,7
Abigorien,blackmoore,480,demonhunter,havoc,12,5,7
Solrosfrön,stormscale,480,demonhunter,havoc,12,5,7
Mojothejojo,ravencrest,480,demonhunter,havoc,12,5,7
Veryfunhaha,ravencrest,480,demonhunter,havoc,12,5,7
Varthag,antonidas,480,demonhunter,havoc,12,5,7
Revérse,stormscale,480,demonhunter,havoc,12,5,7
Moojdh,malganis,480,demonhunter,havoc,12,5,7
Dhaosh,nemesis,480,demonhunter,havoc,12,5,7
Brodor,alakir,480,demonhunter,havoc,12,5,7
Nstea,cthun,480,demonhunter,havoc,12,5,7
Wrathia,rexxar,480,demonhunter,havoc,12,5,7
Onlyfangodx,antonidas,480,demonhunter,havoc,12,5,7
Jotaros,ravencrest,480,demonhunter,havoc,12,5,7
Kithan,zuljin,480,demonhunter,havoc,12,5,7
Tomkis,ravencrest,480,demonhunter,havoc,12,5,7
Chosabreka,zuljin,480,demonhunter,havoc,12,5,7
Alandiel,twisting-nether,480,demonhunter,havoc,12,5,7
Glímpse,ravencrest,480,demonhunter,havoc,12,5,7
Такетомии,gordunni,480,demonhunter,havoc,12,5,7
Superchocowo,sanguino,480,demonhunter,havoc,12,5,7
Tastyblades,blackmoore,480,demonhunter,havoc,12,5,7
Irenzy,twisting-nether,480,demonhunter,havoc,12,5,7
Giftìg,ravencrest,480,demonhunter,havoc,12,5,7
Филеровщик,deathguard,480,demonhunter,havoc,12,5,7
Daemonai,neptulon,480,demonhunter,havoc,12,5,7
Нереалочка,blackscar,480,demonhunter,havoc,12,5,7
Rabæ,blackhand,480,demonhunter,havoc,12,5,7
Ðémón,outland,480,demonhunter,havoc,12,5,7
Shyynedh,grim-batol,480,demonhunter,havoc,15,6,9
Calendith,arathor,480,demonhunter,havoc,15,6,9
Баттлрэп,soulflayer,480,demonhunter,havoc,18,5,13
Slizer,draenor,480,demonhunter,havoc,18,5,13
Aelina,area-52,480,demonhunter,havoc,18,5,13
Кайренсс,howling-fjord,480,demonhunter,havoc,18,5,13
Natarásh,blackmoore,480,demonhunter,havoc,18,5,13
Lòsâng,sanguino,480,demonhunter,havoc,18,5,13
Sholon,kiljaeden,479,demonhunter,havoc,6,5,1
Sephiris,argent-dawn,479,demonhunter,havoc,6,5,1
Demontevz,outland,479,demonhunter,havoc,12,5,7
Marsterkush,malygos,479,demonhunter,havoc,12,5,7
Gryphory,ravencrest,479,demonhunter,havoc,12,5,7
Sua,outland,479,demonhunter,havoc,12,5,7
Эридали,gordunni,479,demonhunter,havoc,12,5,7
Merilidan,blackrock,479,demonhunter,havoc,12,5,7
Карнавалыч,gordunni,479,demonhunter,havoc,24,5,19
Скудайвер,gordunni,478,demonhunter,havoc,12,5,7
Kairidemon,eredar,477,demonhunter,havoc,12,5,7
Winnztlol,chamber-of-aspects,477,demonhunter,havoc,15,5,10
Vincbengt,tarren-mill,476,demonhunter,havoc,12,5,7
Anandria,blutkessel,475,demonhunter,havoc,12,5,7
Illikan,stormscale,474,demonhunter,havoc,12,5,7
Butcherr,ulduar,474,demonhunter,havoc,18,5,13
Etraidor,turalyon,473,demonhunter,havoc,12,5,7
Anishara,die-nachtwache,463,demonhunter,havoc,13,6,7
Shaundead,drakthul,447,demonhunter,havoc,11,5,6
Akäly,hyjal,447,demonhunter,havoc,11,5,6
Дисофи,soulflayer,431,demonhunter,havoc,11,5,6
Opmuch,eonar,416,demonhunter,havoc,10,5,5
Niellarsc,ravencrest,384,demonhunter,havoc,6,4,2
Styxdh,blackhand,384,demonhunter,havoc,6,4,2
Elfmonger,ravencrest,384,demonhunter,havoc,6,4,2
Varonx,drakthul,384,demonhunter,havoc,6,4,2
Vìdhar,tarren-mill,384,demonhunter,havoc,6,4,2
Аоешный,howling-fjord,384,demonhunter,havoc,6,4,2
Drilloz,ravencrest,384,demonhunter,havoc,6,4,2
Lemondehunta,twisting-nether,384,demonhunter,havoc,6,4,2
Thkingragnar,sanguino,384,demonhunter,havoc,6,4,2
Иллианэль,howling-fjord,384,demonhunter,havoc,6,4,2
Anklàr,blackrock,384,demonhunter,havoc,6,4,2
Glevenuschii,blackmoore,384,demonhunter,havoc,6,4,2
Ikari,neptulon,384,demonhunter,havoc,6,4,2
Талисзора,gordunni,384,demonhunter,havoc,6,4,2
Zophý,ragnaros,384,demonhunter,havoc,6,4,2
Isila,alakir,384,demonhunter,havoc,6,4,2
Yugsiturath,drakthul,384,demonhunter,havoc,6,4,2
Bokajr,ragnaros,384,demonhunter,havoc,6,4,2
Люцифэйль,gordunni,384,demonhunter,havoc,6,4,2
Véspé,naxxramas,384,demonhunter,havoc,6,4,2
Twopumpchump,twisting-nether,384,demonhunter,havoc,6,4,2
Mýg,ravencrest,384,demonhunter,havoc,6,4,2
Iken,ragnaros,384,demonhunter,havoc,6,4,2
Itsfinee,outland,384,demonhunter,havoc,6,4,2
Atrikagodx,kazzak,384,demonhunter,havoc,6,4,2
Beraxulus,aegwynn,384,demonhunter,havoc,6,4,2
Cielis,outland,384,demonhunter,havoc,6,4,2
Freakerzoid,kazzak,384,demonhunter,havoc,11,4,7
Exodlia,silvermoon,384,demonhunter,havoc,12,4,8
Shabalda,dun-morogh,384,demonhunter,havoc,12,4,8
Mareen,pozzo-delleternità,384,demonhunter,havoc,12,4,8
Maeltus,hyjal,384,demonhunter,havoc,12,4,8
Бистлайк,soulflayer,384,demonhunter,havoc,12,4,8
Хокану,gordunni,384,demonhunter,havoc,12,4,8
Deadrawdh,aegwynn,384,demonhunter,havoc,12,4,8
Chàk,marécage-de-zangar,384,demonhunter,havoc,12,4,8
Innocuouss,twisting-nether,384,demonhunter,havoc,12,4,8
Reachfight,lothar,384,demonhunter,havoc,12,4,8
Leylas,nagrand,384,demonhunter,havoc,12,4,8
Rebelion,dun-modr,384,demonhunter,havoc,12,4,8
Floridaboy,ravencrest,384,demonhunter,havoc,12,4,8
Pijvijie,shattrath,384,demonhunter,havoc,12,4,8
Лупидолх,soulflayer,384,demonhunter,havoc,12,4,8
Blüëräin,draenor,384,demonhunter,havoc,12,4,8
Djdhh,draenor,384,demonhunter,havoc,12,4,8
Moonbeàm,kazzak,384,demonhunter,havoc,12,4,8
Одзангейра,blackscar,384,demonhunter,havoc,12,4,8
Stormshred,stormscale,384,demonhunter,havoc,12,4,8
Frostidh,ysondre,384,demonhunter,havoc,12,4,8
Mempaan,magtheridon,384,demonhunter,havoc,12,4,8
Alleyezønme,outland,384,demonhunter,havoc,12,4,8
Luunz,argent-dawn,384,demonhunter,havoc,18,4,14
Redgi,tarren-mill,384,demonhunter,havoc,18,4,14
Pèpsì,kazzak,384,demonhunter,havoc,18,4,14
Noctilucent,executus,383,demonhunter,havoc,6,4,2
Rouzi,defias-brotherhood,383,demonhunter,havoc,6,4,2
Némesîs,cthun,383,demonhunter,havoc,6,4,2
Thorskinius,ravencrest,383,demonhunter,havoc,12,4,8
Шоеррей,gordunni,383,demonhunter,havoc,12,4,8
Danshokudino,kazzak,383,demonhunter,havoc,12,4,8
Elenastar,kazzak,383,demonhunter,havoc,12,4,8
Vengatoria,cthun,383,demonhunter,havoc,12,4,8
Besnik,stormscale,383,demonhunter,havoc,12,4,8
Liondam,pozzo-delleternità,382,demonhunter,havoc,6,4,2
Flamme,amanthul,382,demonhunter,havoc,6,4,2
Ёмайл,soulflayer,381,demonhunter,havoc,12,4,8
Летучий,howling-fjord,351,demonhunter,havoc,8,5,3
Lexxdh,blackmoore,351,demonhunter,havoc,8,5,3
Блэйденрифтс,soulflayer,351,demonhunter,havoc,11,4,7
Nyxxeria,drakthul,336,demonhunter,havoc,15,4,11
Nyalah,eredar,330,demonhunter,havoc,6,5,1
Hyperflex,blackrock,320,demonhunter,havoc,10,4,6
Asperity,antonidas,320,demonhunter,havoc,12,4,8
Mortyb,kazzak,288,demonhunter,havoc,6,3,3
Ашерис,deathguard,288,demonhunter,havoc,6,3,3
Hyonzyyesh,silvermoon,288,demonhunter,havoc,6,3,3
Imvnrcvr,dalaran,288,demonhunter,havoc,6,3,3
Länika,drakthul,288,demonhunter,havoc,6,3,3
Fantabolous,ragnaros,288,demonhunter,havoc,6,3,3
Kätarïnas,confrérie-du-thorium,288,demonhunter,havoc,6,3,3
Дэйнни,blackscar,288,demonhunter,havoc,6,3,3
Xellidan,dun-modr,288,demonhunter,havoc,6,3,3
Deschacke,eredar,288,demonhunter,havoc,6,3,3
Илнари,soulflayer,288,demonhunter,havoc,6,3,3
Abrahêll,dun-modr,288,demonhunter,havoc,6,3,3
Nightwalk,blackmoore,288,demonhunter,havoc,6,3,3
Natzú,ravencrest,288,demonhunter,havoc,6,3,3
Shaadraz,stormscale,288,demonhunter,havoc,6,3,3
Valø,malganis,288,demonhunter,havoc,6,3,3
Sayee,drakthul,288,demonhunter,havoc,6,3,3
Èfiie,culte-de-la-rive-noire,288,demonhunter,havoc,6,3,3
Андрюхадх,soulflayer,288,demonhunter,havoc,6,3,3
Zsídakabra,ragnaros,288,demonhunter,havoc,6,3,3
Âstræa,antonidas,288,demonhunter,havoc,6,3,3
Goatcorpse,blackmoore,288,demonhunter,havoc,6,3,3
Naargof,outland,288,demonhunter,havoc,6,3,3
Иллидал,greymane,288,demonhunter,havoc,6,3,3
Trashclass,draenor,288,demonhunter,havoc,6,3,3
Kolrex,ragnaros,288,demonhunter,havoc,6,3,3
Wrathill,draenor,288,demonhunter,havoc,6,3,3
Zedxx,kazzak,288,demonhunter,havoc,6,3,3
Dadagodx,kazzak,288,demonhunter,havoc,6,3,3
Hellboi,dun-modr,288,demonhunter,havoc,6,3,3
Резако,soulflayer,288,demonhunter,havoc,6,3,3
Albdh,kazzak,288,demonhunter,havoc,6,3,3
Extitan,twisting-nether,288,demonhunter,havoc,6,3,3
Норилайнн,gordunni,288,demonhunter,havoc,6,3,3
Aedilles,ravencrest,288,demonhunter,havoc,6,3,3
Кейсимег,soulflayer,288,demonhunter,havoc,6,3,3
Keýrañe,ragnaros,288,demonhunter,havoc,6,3,3
Ittas,archimonde,288,demonhunter,havoc,6,3,3
Alfaa,outland,288,demonhunter,havoc,6,3,3
Даудаев,gordunni,288,demonhunter,havoc,6,3,3
Lonedh,sylvanas,288,demonhunter,havoc,6,3,3
Illyriel,antonidas,288,demonhunter,havoc,6,3,3
Cindras,turalyon,288,demonhunter,havoc,6,3,3
Shinnu,antonidas,288,demonhunter,havoc,6,3,3
Неффкодх,howling-fjord,288,demonhunter,havoc,6,3,3
Sayph,hyjal,288,demonhunter,havoc,6,3,3
Batx,ravencrest,288,demonhunter,havoc,6,3,3
Alury,blackrock,288,demonhunter,havoc,6,3,3
Nerudas,blackhand,288,demonhunter,havoc,6,3,3
Aaryaa,archimonde,288,demonhunter,havoc,6,3,3
Kerog,blackmoore,288,demonhunter,havoc,6,3,3
Neony,blackmoore,288,demonhunter,havoc,6,3,3
Demonsushi,tarren-mill,288,demonhunter,havoc,6,3,3
Schwitte,tichondrius,288,demonhunter,havoc,6,3,3
Cirino,defias-brotherhood,288,demonhunter,havoc,6,3,3
Брилаброви,soulflayer,288,demonhunter,havoc,6,3,3
Annaboliik,ravencrest,288,demonhunter,havoc,6,3,3
Nameerr,ragnaros,288,demonhunter,havoc,6,3,3
Cnbâckbb,archimonde,288,demonhunter,havoc,6,3,3
Dzikalocha,burning-legion,288,demonhunter,havoc,6,3,3
Naturalis,die-todeskrallen,288,demonhunter,havoc,6,3,3
Vaterdenke,defias-brotherhood,288,demonhunter,havoc,6,3,3
Xénôns,archimonde,288,demonhunter,havoc,6,3,3
Slaanesh,xavius,288,demonhunter,havoc,6,3,3
Sandem,blackrock,288,demonhunter,havoc,6,3,3
Ðêmønìnsìðê,blackmoore,288,demonhunter,havoc,6,3,3
Cánoo,blackhand,288,demonhunter,havoc,6,3,3
Meleidar,kazzak,288,demonhunter,havoc,6,3,3
Hopéless,aggra-português,288,demonhunter,havoc,6,3,3
Myuøu,hyjal,288,demonhunter,havoc,6,3,3
Зедю,howling-fjord,288,demonhunter,havoc,6,3,3
Анавеллка,howling-fjord,288,demonhunter,havoc,6,3,3
Сангвиннус,howling-fjord,288,demonhunter,havoc,6,3,3
Bhaz,tichondrius,288,demonhunter,havoc,6,3,3
Wauway,ragnaros,288,demonhunter,havoc,8,3,5
Obitum,burning-legion,288,demonhunter,havoc,12,3,9
Metaman,archimonde,288,demonhunter,havoc,12,3,9
Artwar,stormscale,288,demonhunter,havoc,12,3,9
Skajlan,burning-legion,288,demonhunter,havoc,12,3,9
Gurthalak,alakir,288,demonhunter,havoc,12,3,9
Tuffêli,turalyon,288,demonhunter,havoc,12,3,9
Vandazza,argent-dawn,288,demonhunter,havoc,12,3,9
Âkazza,archimonde,288,demonhunter,havoc,12,3,9
Lovesong,the-shatar,288,demonhunter,havoc,12,3,9
Шавермье,gordunni,288,demonhunter,havoc,12,3,9
Ïvø,sargeras,288,demonhunter,havoc,12,3,9
Firebringer,silvermoon,288,demonhunter,havoc,12,3,9
Asporos,pozzo-delleternità,288,demonhunter,havoc,12,3,9
Cptgmiasbria,eredar,288,demonhunter,havoc,12,3,9
Bengleng,draenor,288,demonhunter,havoc,12,3,9
Феяужаса,soulflayer,288,demonhunter,havoc,12,3,9
Laurana,argent-dawn,288,demonhunter,havoc,12,3,9
Lamello,nemesis,288,demonhunter,havoc,12,3,9
Rúpél,thrall,288,demonhunter,havoc,12,3,9
Rurt,sanguino,288,demonhunter,havoc,12,3,9
Дитяхаоса,howling-fjord,288,demonhunter,havoc,12,3,9
Kruthor,taerar,288,demonhunter,havoc,12,3,9
Tenaebris,silvermoon,288,demonhunter,havoc,12,3,9
Lasthija,dun-modr,288,demonhunter,havoc,18,3,15
Гачирабыня,lich-king,288,demonhunter,havoc,18,3,15
Jimdh,quelthalas,288,demonhunter,havoc,18,3,15
Devildust,ravencrest,288,demonhunter,havoc,18,3,15
Saturnein,stormscale,287,demonhunter,havoc,6,3,3
Glaiverush,alakir,287,demonhunter,havoc,6,3,3
Menutzdh,tarren-mill,287,demonhunter,havoc,6,3,3
Allalina,draenor,287,demonhunter,havoc,6,3,3
Amaterasù,alleria,287,demonhunter,havoc,12,3,9
Dàrkinette,archimonde,286,demonhunter,havoc,6,3,3
Nithraim,kazzak,240,demonhunter,havoc,9,3,6
Ponn,blackmoore,239,demonhunter,havoc,5,3,2
Itskarmax,outland,239,demonhunter,havoc,5,3,2
Kalr,silvermoon,239,demonhunter,havoc,5,3,2
Xaro,quelthalas,239,demonhunter,havoc,5,3,2
Jamule,dun-morogh,231,demonhunter,havoc,12,4,8
Demoqt,ragnaros,192,demonhunter,havoc,4,3,1
Kâsúxôxô,ravencrest,192,demonhunter,havoc,4,3,1
Erenyeagerr,kazzak,192,demonhunter,havoc,4,3,1
Martøsdh,uldum,192,demonhunter,havoc,6,2,4
Nanana,doomhammer,192,demonhunter,havoc,6,2,4
Malkyor,ysondre,192,demonhunter,havoc,6,2,4
Demontoolz,outland,192,demonhunter,havoc,6,2,4
Disconecting,outland,192,demonhunter,havoc,6,2,4
Gandzsä,ragnaros,192,demonhunter,havoc,6,2,4
Illidaia,ravencrest,192,demonhunter,havoc,6,2,4
Мэлифсб,blackscar,192,demonhunter,havoc,6,2,4
Grimjow,arthas,192,demonhunter,havoc,6,2,4
Папичгодх,borean-tundra,192,demonhunter,havoc,6,2,4
Juicyglaives,ragnaros,192,demonhunter,havoc,6,2,4
Téthis,uldaman,192,demonhunter,havoc,6,2,4
Zxcjklcasdlk,sylvanas,192,demonhunter,havoc,6,2,4
Takad,twisting-nether,192,demonhunter,havoc,6,2,4
Rybn,eredar,192,demonhunter,havoc,6,2,4
Ànavar,twisting-nether,192,demonhunter,havoc,6,2,4
Cutforshred,zenedar,192,demonhunter,havoc,6,2,4
Usaïnbolts,archimonde,192,demonhunter,havoc,6,2,4
Lucziane,blackmoore,192,demonhunter,havoc,6,2,4
Karpandero,stormreaver,192,demonhunter,havoc,6,2,4
Тэнсу,borean-tundra,192,demonhunter,havoc,6,2,4
Dmgchris,sylvanas,192,demonhunter,havoc,6,2,4
Mcsmackface,hellfire,192,demonhunter,havoc,6,2,4
Sazzox,blackrock,192,demonhunter,havoc,6,2,4
Wolfex,hellfire,192,demonhunter,havoc,6,2,4
Malzehar,tarren-mill,192,demonhunter,havoc,6,2,4
Аллидариан,howling-fjord,192,demonhunter,havoc,6,2,4
Bämbøué,hyjal,192,demonhunter,havoc,6,2,4
Hamssterek,magtheridon,192,demonhunter,havoc,6,2,4
Demonpegasus,draenor,192,demonhunter,havoc,6,2,4
Rúllio,rexxar,192,demonhunter,havoc,6,2,4
Сязекть,goldrinn,192,demonhunter,havoc,6,2,4
Hicke,burning-legion,192,demonhunter,havoc,6,2,4
Linkôs,aegwynn,192,demonhunter,havoc,6,2,4
Williamgrant,alonsus,192,demonhunter,havoc,6,2,4
Alcadejas,pozzo-delleternità,192,demonhunter,havoc,6,2,4
Donstyle,anachronos,192,demonhunter,havoc,6,2,4
Datejust,archimonde,192,demonhunter,havoc,6,2,4
Badess,malfurion,192,demonhunter,havoc,6,2,4
Roxxis,mazrigos,192,demonhunter,havoc,6,2,4
Ragnarak,amanthul,192,demonhunter,havoc,6,2,4
Беатриз,soulflayer,192,demonhunter,havoc,6,2,4
Bogren,sylvanas,192,demonhunter,havoc,6,2,4
Kakovicz,gorgonnash,192,demonhunter,havoc,6,2,4
Sakumi,azshara,192,demonhunter,havoc,6,2,4
Hupon,drakthul,192,demonhunter,havoc,6,2,4
Деорру,gordunni,192,demonhunter,havoc,6,2,4
Tôx,dalaran,192,demonhunter,havoc,6,2,4
Palaurx,kazzak,192,demonhunter,havoc,6,2,4
Vulcaan,ravencrest,192,demonhunter,havoc,6,2,4
Tacodhx,ravencrest,192,demonhunter,havoc,6,2,4
Zlett,draenor,192,demonhunter,havoc,6,2,4
Sweåfy,outland,192,demonhunter,havoc,6,2,4
Riveén,blackhand,192,demonhunter,havoc,6,2,4
Cøldlean,ravencrest,192,demonhunter,havoc,6,2,4
Крикетх,soulflayer,192,demonhunter,havoc,6,2,4
Saphira,laughing-skull,192,demonhunter,havoc,6,2,4
Arkta,kazzak,192,demonhunter,havoc,6,2,4
Nairra,blackmoore,192,demonhunter,havoc,6,2,4
Bratti,kazzak,192,demonhunter,havoc,6,2,4
Xenits,kazzak,192,demonhunter,havoc,6,2,4
Mettdaemon,ravencrest,192,demonhunter,havoc,12,2,10
Deehoh,twisting-nether,192,demonhunter,havoc,12,2,10
Drâparn,sylvanas,192,demonhunter,havoc,12,2,10
Enygamy,frostmane,192,demonhunter,havoc,12,2,10
Gouteça,la-croisade-écarlate,192,demonhunter,havoc,12,2,10
Парагони,gordunni,192,demonhunter,havoc,12,2,10
Zynês,draenor,192,demonhunter,havoc,12,2,10
Gagfordaddy,ravencrest,192,demonhunter,havoc,12,2,10
Spideymon,ragnaros,192,demonhunter,havoc,12,2,10
Zaydra,the-maelstrom,192,demonhunter,havoc,12,2,10
Bobdh,twisting-nether,192,demonhunter,havoc,17,2,15
Hellforce,nemesis,191,demonhunter,havoc,6,2,4
Deathniresa,argent-dawn,191,demonhunter,havoc,6,2,4
Lilarii,argent-dawn,191,demonhunter,havoc,12,2,10
Noorrd,hyjal,191,demonhunter,havoc,12,2,10
Manjirosano,blackmoore,191,demonhunter,havoc,12,2,10
Zealdancer,veknilash,159,demonhunter,havoc,5,2,3
Snelle,outland,144,demonhunter,havoc,9,2,7
Zakaji,blackmoore,127,demonhunter,havoc,8,2,6
Felsbane,argent-dawn,96,demonhunter,havoc,3,2,1
Подэхилла,galakrond,96,demonhunter,havoc,4,2,2
Мишаметапамп,grom,96,demonhunter,havoc,6,1,5
Stormma,kazzak,96,demonhunter,havoc,6,1,5
Läderjoel,ravencrest,96,demonhunter,havoc,6,1,5
Jiínx,kazzak,96,demonhunter,havoc,6,1,5
Andij,frostwolf,96,demonhunter,havoc,6,1,5
Спокоивич,soulflayer,96,demonhunter,havoc,6,1,5
Ripgodx,bronzebeard,96,demonhunter,havoc,6,1,5
Annee,eredar,96,demonhunter,havoc,6,1,5
Rxor,eredar,96,demonhunter,havoc,6,1,5
Зарах,gordunni,96,demonhunter,havoc,6,1,5
Daekon,ahnqiraj,96,demonhunter,havoc,6,1,5
Ilovesabrina,dun-modr,96,demonhunter,havoc,6,1,5
Stàmàzza,nemesis,96,demonhunter,havoc,6,1,5
Cruptiq,kazzak,96,demonhunter,havoc,6,1,5
Bitex,archimonde,96,demonhunter,havoc,6,1,5
Nagh,archimonde,96,demonhunter,havoc,6,1,5
Pkdaemon,draenor,96,demonhunter,havoc,6,1,5
Jyzu,festung-der-stürme,96,demonhunter,havoc,6,1,5
Zarafel,hyjal,96,demonhunter,havoc,6,1,5
Maikko,los-errantes,96,demonhunter,havoc,6,1,5
Nairu,doomhammer,96,demonhunter,havoc,6,1,5
Ghetzlel,draenor,96,demonhunter,havoc,6,1,5
Mlecznygolem,silvermoon,96,demonhunter,havoc,6,1,5
Соларт,howling-fjord,96,demonhunter,havoc,6,1,5
Dýlän,argent-dawn,96,demonhunter,havoc,6,1,5
Teimotevey,silvermoon,96,demonhunter,havoc,6,1,5
Ryuhayabusa,stormscale,96,demonhunter,havoc,6,1,5
Аззазэль,howling-fjord,96,demonhunter,havoc,6,1,5
Максимлолпро,howling-fjord,96,demonhunter,havoc,6,1,5
Ганстапутин,howling-fjord,96,demonhunter,havoc,6,1,5
Найлинель,fordragon,96,demonhunter,havoc,6,1,5
Askari,lothar,96,demonhunter,havoc,6,1,5
Giace,drakthul,96,demonhunter,havoc,6,1,5
Kiô,drakthul,96,demonhunter,havoc,6,1,5
Trinchensdh,blackhand,96,demonhunter,havoc,6,1,5
Burritodh,tarren-mill,96,demonhunter,havoc,6,1,5
Shylaría,blackhand,96,demonhunter,havoc,6,1,5
Ellare,burning-blade,96,demonhunter,havoc,6,1,5
Jásírá,shattrath,96,demonhunter,havoc,12,1,11
Babyyéah,sunstrider,96,demonhunter,havoc,12,1,11
Ecthelionn,outland,96,demonhunter,havoc,12,1,11
Shinarei,silvermoon,95,demonhunter,havoc,6,1,5
Elldarion,blackhand,79,demonhunter,havoc,5,1,4
Deamo,stormscale,79,demonhunter,havoc,5,1,4
Caluxe,blackmoore,79,demonhunter,havoc,5,1,4
Гадх,gordunni,42,demonhunter,havoc,8,2,6
Greyfel,blackhand,31,demonhunter,havoc,2,1,1
Ìllídán,ravencrest,31,demonhunter,havoc,2,1,1
Felwaifu,tarren-mill,31,demonhunter,havoc,2,1,1
Sinjinzoo,blackrock,31,demonhunter,havoc,2,1,1
Brawngodx,draenor,16,demonhunter,havoc,1,1,0
Herzbann,madmortem,16,demonhunter,havoc,1,1,0
Vengeancezin,frostwhisper,1932,demonhunter,vengeance,96,50,46
Jedidiah,aggra-português,1667,demonhunter,vengeance,39,19,20
Zarín,outland,1333,demonhunter,vengeance,54,27,27
Kekburagól,kazzak,575,demonhunter,vengeance,12,6,6
Demonlucy,colinas-pardas,287,demonhunter,vengeance,12,3,9
Askari,lothar,192,demonhunter,vengeance,6,2,4
Сумърак,grom,192,demonhunter,vengeance,12,2,10
Arussil,pozzo-delleternità,96,demonhunter,vengeance,6,1,5
Zarafel,hyjal,95,demonhunter,vengeance,12,1,11
Hibibi,kazzak,2257,druid,restoration,113,66,47
Pegasu,kelthuzad,2206,druid,restoration,96,57,39
Iloveher,ravencrest,2180,druid,restoration,160,89,71
Årt,ravencrest,2153,druid,restoration,120,65,55
Kev,elune,2133,druid,restoration,143,76,67
Trèes,outland,2107,druid,restoration,95,59,36
Nesedondon,stormscale,2101,druid,restoration,60,44,16
Unohanâ,archimonde,2045,druid,restoration,84,50,34
Dendariottvx,sunstrider,2042,druid,restoration,73,44,29
Thotz,kazzak,2006,druid,restoration,96,50,46
Vanostboom,kazzak,1996,druid,restoration,58,34,24
Yoogy,ravencrest,1995,druid,restoration,60,37,23
Lunamimi,argent-dawn,1990,druid,restoration,218,117,101
Rives,sylvanas,1978,druid,restoration,78,46,32
Tjxaxa,ravencrest,1966,druid,restoration,78,38,40
Skrrlock,ravencrest,1952,druid,restoration,96,48,48
Angrykejton,silvermoon,1949,druid,restoration,180,92,88
Sheippi,stormreaver,1945,druid,restoration,54,31,23
Afky,stormreaver,1933,druid,restoration,66,37,29
Mentallyill,ravencrest,1914,druid,restoration,120,65,55
Syví,outland,1912,druid,restoration,59,29,30
Hånukkah,outland,1911,druid,restoration,58,29,29
Miouzy,archimonde,1908,druid,restoration,36,20,16
Thysabtw,archimonde,1894,druid,restoration,53,33,20
Nastycat,magtheridon,1887,druid,restoration,155,77,78
Clone,aegwynn,1878,druid,restoration,72,44,28
Maxpojke,ravencrest,1876,druid,restoration,142,88,54
Niksidruid,grim-batol,1868,druid,restoration,28,21,7
Ralaa,guldan,1865,druid,restoration,54,29,25
Arthéas,archimonde,1865,druid,restoration,174,89,85
Køngx,blackhand,1864,druid,restoration,119,63,56
Promethezine,tarren-mill,1863,druid,restoration,111,62,49
Naffelle,ysondre,1862,druid,restoration,71,34,37
Druidrak,eredar,1855,druid,restoration,66,32,34
Lalalime,arthas,1851,druid,restoration,64,31,33
Thebiggest,ravencrest,1836,druid,restoration,42,25,17
Andr,voljin,1835,druid,restoration,60,26,34
Jmdr,silvermoon,1830,druid,restoration,71,31,40
Spamclone,draenor,1828,druid,restoration,57,30,27
Kanyevotèrx,ravencrest,1828,druid,restoration,54,25,29
Bambambimbim,draenor,1826,druid,restoration,54,24,30
Gummysnake,aszune,1823,druid,restoration,42,25,17
Zydrux,outland,1822,druid,restoration,48,36,12
Doodlez,blackrock,1820,druid,restoration,60,27,33
Metagrass,stormscale,1818,druid,restoration,129,59,70
Shinöbü,sanguino,1816,druid,restoration,36,27,9
Skadooshee,kazzak,1816,druid,restoration,36,19,17
Sorryblya,ravencrest,1809,druid,restoration,60,26,34
Qjkuug,twisting-nether,1807,druid,restoration,106,69,37
Theatrex,ravencrest,1803,druid,restoration,111,66,45
Wraithshape,stormscale,1800,druid,restoration,60,32,28
Threesixnìne,dun-morogh,1795,druid,restoration,48,27,21
Jìnró,ravencrest,1782,druid,restoration,129,63,66
Дикаякиара,blackscar,1775,druid,restoration,83,38,45
Heçtôr,silvermoon,1767,druid,restoration,60,27,33
Dokixo,kazzak,1766,druid,restoration,35,19,16
Wéédmâñ,ravencrest,1756,druid,restoration,45,30,15
Chacopic,archimonde,1744,druid,restoration,96,48,48
Matteps,outland,1742,druid,restoration,41,19,22
Улдрэйн,deathguard,1739,druid,restoration,66,38,28
Lifelover,outland,1734,druid,restoration,48,23,25
Tedel,kazzak,1728,druid,restoration,47,28,19
Gaeldeth,silvermoon,1726,druid,restoration,93,53,40
Филавтия,gordunni,1724,druid,restoration,60,32,28
Druidella,stormscale,1716,druid,restoration,30,18,12
Galadronìa,aegwynn,1715,druid,restoration,41,25,16
Alolexx,archimonde,1711,druid,restoration,30,18,12
Wraithmoon,stormscale,1705,druid,restoration,36,18,18
Moonbee,burning-blade,1704,druid,restoration,42,28,14
Riplilpeep,grim-batol,1694,druid,restoration,48,23,25
Moondra,outland,1688,druid,restoration,95,39,56
Luhmanish,thunderhorn,1684,druid,restoration,102,52,50
Eviscreator,stormscale,1683,druid,restoration,42,27,15
Nasduck,ravencrest,1680,druid,restoration,40,27,13
Erika,vashj,1676,druid,restoration,48,26,22
Gøðførm,silvermoon,1673,druid,restoration,102,51,51
Drjmy,silvermoon,1669,druid,restoration,30,24,6
Buffbloom,auchindoun,1668,druid,restoration,126,67,59
Asaj,argent-dawn,1666,druid,restoration,95,54,41
Funnyjoker,outland,1665,druid,restoration,36,18,18
Hizzy,burning-legion,1662,druid,restoration,196,93,103
Demerit,aegwynn,1657,druid,restoration,32,18,14
Bâneth,destromath,1656,druid,restoration,60,33,27
Praetorian,sylvanas,1653,druid,restoration,60,25,35
Slayced,blackrock,1643,druid,restoration,29,18,11
Treliuz,twilights-hammer,1643,druid,restoration,66,39,27
Pogoth,turalyon,1641,druid,restoration,72,38,34
Diolives,stormscale,1640,druid,restoration,71,40,31
Drøødis,archimonde,1636,druid,restoration,42,24,18
Чухх,howling-fjord,1636,druid,restoration,52,29,23
Trèes,draenor,1636,druid,restoration,46,22,24
Pardus,ambossar,1635,druid,restoration,50,27,23
Eedaza,argent-dawn,1632,druid,restoration,42,20,22
Mafiasnipe,ravencrest,1630,druid,restoration,24,17,7
Friedbrocolí,tarren-mill,1629,druid,restoration,30,17,13
Asga,stormscale,1628,druid,restoration,30,17,13
Olaphy,elune,1628,druid,restoration,137,67,70
Frances,auchindoun,1622,druid,restoration,51,30,21
Миледистайпи,gordunni,1619,druid,restoration,32,18,14
Haszard,outland,1618,druid,restoration,54,26,28
Floka,archimonde,1617,druid,restoration,48,30,18
Goldrax,outland,1615,druid,restoration,24,17,7
Slaugh,zuljin,1608,druid,restoration,48,20,28
Опапенелопа,blackscar,1607,druid,restoration,39,27,12
Bîrke,blackrock,1604,druid,restoration,36,17,19
Naraia,aegwynn,1602,druid,restoration,30,17,13
Ðarckness,kazzak,1600,druid,restoration,24,17,7
Swifte,argent-dawn,1600,druid,restoration,48,27,21
Akmón,tarren-mill,1600,druid,restoration,58,20,38
Hyggefinger,ravencrest,1596,druid,restoration,42,19,23
Sélia,sylvanas,1591,druid,restoration,89,41,48
Xoriauz,archimonde,1582,druid,restoration,72,33,39
Брэвно,gordunni,1575,druid,restoration,155,86,69
Builtdiffy,kazzak,1569,druid,restoration,167,83,84
Jcpenney,xavius,1557,druid,restoration,97,47,50
Crïn,ravencrest,1553,druid,restoration,36,17,19
Bearform,blackhand,1548,druid,restoration,48,23,25
Sintiq,silvermoon,1547,druid,restoration,29,17,12
Khunahype,thrall,1546,druid,restoration,88,48,40
Warami,eredar,1539,druid,restoration,36,19,17
Mortalnight,sinstralis,1534,druid,restoration,170,83,87
Skrood,kazzak,1532,druid,restoration,30,16,14
Orayin,ravencrest,1530,druid,restoration,30,23,7
Kundz,dalaran,1530,druid,restoration,148,81,67
Hasselhoof,eredar,1526,druid,restoration,63,26,37
Bjoernbrudn,ravencrest,1524,druid,restoration,30,16,14
Skillfall,ravencrest,1524,druid,restoration,42,16,26
Dwaokut,ravencrest,1514,druid,restoration,47,24,23
Arogane,outland,1512,druid,restoration,51,26,25
Велаине,soulflayer,1509,druid,restoration,57,35,22
Feelstreeman,twisting-nether,1504,druid,restoration,77,42,35
Ittei,korgall,1501,druid,restoration,90,45,45
Setztes,tarren-mill,1494,druid,restoration,49,28,21
Kicki,outland,1494,druid,restoration,66,34,32
Маккаланн,soulflayer,1493,druid,restoration,48,30,18
Друлёнышь,eversong,1488,druid,restoration,89,51,38
Atôtheex,kazzak,1488,druid,restoration,43,21,22
Vashiko,tarren-mill,1483,druid,restoration,77,40,37
Pureballs,twisting-nether,1477,druid,restoration,165,93,72
Zaerox,ambossar,1474,druid,restoration,48,23,25
Deluron,malganis,1472,druid,restoration,101,50,51
Атмос,deathguard,1467,druid,restoration,65,40,25
Shufflê,blackmoore,1467,druid,restoration,107,51,56
Lukass,drakthul,1464,druid,restoration,72,40,32
Plàntz,tarren-mill,1464,druid,restoration,54,29,25
Drbse,silvermoon,1461,druid,restoration,56,28,28
Spliçe,draenor,1458,druid,restoration,42,21,21
Scorlok,eredar,1455,druid,restoration,44,25,19
Tamburoo,tarren-mill,1449,druid,restoration,119,52,67
Tôrmêñtêd,outland,1442,druid,restoration,69,42,27
Фапдрим,howling-fjord,1442,druid,restoration,42,22,20
Flum,darksorrow,1441,druid,restoration,148,77,71
Xyruden,kazzak,1441,druid,restoration,171,69,102
Guccicken,garona,1439,druid,restoration,76,42,34
Ына,gordunni,1438,druid,restoration,81,39,42
Síggíe,eredar,1436,druid,restoration,30,17,13
Shredzz,ravencrest,1436,druid,restoration,36,15,21
Блумха,howling-fjord,1435,druid,restoration,66,34,32
Andromedda,twisting-nether,1435,druid,restoration,66,31,35
Hadok,azjolnerub,1435,druid,restoration,36,15,21
Wenciorek,kazzak,1434,druid,restoration,48,25,23
Aesha,los-errantes,1434,druid,restoration,30,15,15
Ёу,soulflayer,1432,druid,restoration,41,16,25
Evílz,kazzak,1431,druid,restoration,24,15,9
Bëstwôrld,archimonde,1428,druid,restoration,30,15,15
Tunling,ravencrest,1423,druid,restoration,30,20,10
Kittý,terokkar,1414,druid,restoration,135,65,70
Bammedrudu,archimonde,1401,druid,restoration,24,15,9
Dûdûrînâ,blackrock,1400,druid,restoration,24,15,9
Bloomies,tarren-mill,1396,druid,restoration,64,36,28
Clovér,outland,1394,druid,restoration,30,15,15
Styleexd,ragnaros,1391,druid,restoration,51,27,24
Sandirion,silvermoon,1390,druid,restoration,336,163,173
Cörelly,ravencrest,1382,druid,restoration,145,88,57
Thanom,auchindoun,1372,druid,restoration,71,36,35
Ивантяй,gordunni,1369,druid,restoration,65,32,33
Balanc,ragnaros,1366,druid,restoration,30,16,14
Zwierzyniec,jaedenar,1357,druid,restoration,60,27,33
Ghaara,outland,1348,druid,restoration,34,19,15
Zaeli,archimonde,1344,druid,restoration,24,14,10
Mchots,ragnaros,1337,druid,restoration,89,42,47
Legyna,ravencrest,1334,druid,restoration,23,15,8
Shifthappénz,draenor,1334,druid,restoration,60,28,32
Вакидзами,gordunni,1331,druid,restoration,48,28,20
Fabsl,archimonde,1330,druid,restoration,30,14,16
Làhen,ravencrest,1330,druid,restoration,36,15,21
Ilyethea,earthen-ring,1328,druid,restoration,179,98,81
Scaleo,stormreaver,1326,druid,restoration,36,23,13
Рамзес,gordunni,1326,druid,restoration,24,14,10
Analmonstret,shattered-hand,1323,druid,restoration,24,14,10
Knzm,dun-modr,1323,druid,restoration,120,62,58
Koemarkt,sunstrider,1319,druid,restoration,46,29,17
Yenwe,kazzak,1317,druid,restoration,124,65,59
Крайсонг,soulflayer,1316,druid,restoration,36,18,18
Chinoiserie,aszune,1315,druid,restoration,102,58,44
Idect,silvermoon,1314,druid,restoration,106,55,51
Halyconwings,outland,1314,druid,restoration,33,17,16
Hellofresh,silvermoon,1312,druid,restoration,30,14,16
Nayokô,grim-batol,1310,druid,restoration,30,15,15
Mangy,xavius,1309,druid,restoration,78,39,39
Рефикс,gordunni,1307,druid,restoration,79,52,27
Bigßoi,stormscale,1300,druid,restoration,54,26,28
Ekologiskxx,outland,1296,druid,restoration,85,40,45
Callìa,sylvanas,1294,druid,restoration,36,18,18
Shelby,tirion,1291,druid,restoration,69,36,33
Delmond,sylvanas,1288,druid,restoration,159,80,79
Asanaria,ravencrest,1286,druid,restoration,38,15,23
Feinberg,stormscale,1286,druid,restoration,42,14,28
Хуссипусси,galakrond,1285,druid,restoration,29,14,15
Lyvuni,blackmoore,1285,druid,restoration,30,14,16
Seikoo,defias-brotherhood,1284,druid,restoration,91,41,50
Paawz,stormscale,1281,druid,restoration,65,33,32
Kaamirach,blackmoore,1280,druid,restoration,23,16,7
Lalon,blackrock,1280,druid,restoration,36,18,18
Bägira,sylvanas,1280,druid,restoration,59,29,30
Cubalitis,tarren-mill,1271,druid,restoration,36,22,14
Leliaen,sylvanas,1269,druid,restoration,45,24,21
Walexx,kazzak,1266,druid,restoration,44,25,19
Nalreaa,kazzak,1265,druid,restoration,48,27,21
Обейрин,gordunni,1261,druid,restoration,78,40,38
Cuxorb,rexxar,1259,druid,restoration,48,21,27
Delarion,nemesis,1258,druid,restoration,36,21,15
Irondruid,silvermoon,1250,druid,restoration,64,38,26
Chas,ravencrest,1247,druid,restoration,24,13,11
Deltsur,stormscale,1247,druid,restoration,35,17,18
Киберужас,gordunni,1246,druid,restoration,105,50,55
Lamatoes,ravencrest,1246,druid,restoration,30,13,17
Kooglaash,kazzak,1242,druid,restoration,79,39,40
Bellhooks,blackrock,1239,druid,restoration,24,13,11
ßløøm,outland,1236,druid,restoration,24,16,8
Zaratras,arathor,1230,druid,restoration,50,23,27
Zelíx,bronzebeard,1229,druid,restoration,42,28,14
Корнерит,gordunni,1229,druid,restoration,82,43,39
Weregoon,blackmoore,1225,druid,restoration,191,91,100
Sgtdrood,archimonde,1223,druid,restoration,30,13,17
Fettpumpad,karazhan,1221,druid,restoration,103,59,44
Nyxxz,shattered-hand,1221,druid,restoration,30,13,17
Khalec,silvermoon,1220,druid,restoration,18,13,5
Jiujiteiro,tarren-mill,1220,druid,restoration,23,16,7
Kukisanban,stormscale,1219,druid,restoration,60,33,27
Dreaddot,archimonde,1210,druid,restoration,24,13,11
Autoritär,gilneas,1209,druid,restoration,49,26,23
Räysa,archimonde,1207,druid,restoration,115,62,53
Дилайт,blackscar,1201,druid,restoration,30,13,17
Namenloser,azshara,1200,druid,restoration,72,39,33
Plsbuffdruid,ravencrest,1189,druid,restoration,28,14,14
Amakary,blackrock,1178,druid,restoration,36,16,20
Hílarío,sanguino,1174,druid,restoration,38,13,25
Mitnik,stormscale,1173,druid,restoration,65,39,26
Walenok,thrall,1158,druid,restoration,125,61,64
Mochiløxz,tarren-mill,1155,druid,restoration,24,13,11
Cäsïo,khaz-modan,1154,druid,restoration,54,32,22
Åä,ravencrest,1152,druid,restoration,18,12,6
Håbibi,kazzak,1152,druid,restoration,24,12,12
Lfsecondreju,ravencrest,1151,druid,restoration,18,12,6
Myndrá,varimathras,1151,druid,restoration,24,12,12
Dreathqt,twisting-nether,1150,druid,restoration,24,12,12
Rozt,ravencrest,1150,druid,restoration,24,12,12
Diriculous,kazzak,1150,druid,restoration,36,12,24
Rozi,draenor,1148,druid,restoration,18,12,6
Olympïee,archimonde,1147,druid,restoration,24,12,12
Rougetreize,khaz-modan,1146,druid,restoration,24,12,12
Elmáestró,aegwynn,1146,druid,restoration,24,12,12
Røsary,stormscale,1145,druid,restoration,51,28,23
Dobbmaster,aegwynn,1143,druid,restoration,191,93,98
Trànsformer,nemesis,1142,druid,restoration,30,12,18
Катяблум,gordunni,1139,druid,restoration,30,12,18
Кнесис,howling-fjord,1138,druid,restoration,19,13,6
Halleyz,hyjal,1138,druid,restoration,103,53,50
Arfedan,kazzak,1136,druid,restoration,42,24,18
Liquis,outland,1135,druid,restoration,91,42,49
Inkeyes,outland,1134,druid,restoration,53,19,34
Chable,hyjal,1131,druid,restoration,18,12,6
Eko,auchindoun,1131,druid,restoration,48,18,30
Dadud,twisting-nether,1126,druid,restoration,30,18,12
Maryjuanita,silvermoon,1122,druid,restoration,104,43,61
Raysa,archimonde,1119,druid,restoration,69,35,34
Ndnd,drakthul,1112,druid,restoration,82,42,40
Bynxx,antonidas,1112,druid,restoration,100,46,54
Crep,krasus,1111,druid,restoration,18,12,6
Сваткумбрат,eversong,1110,druid,restoration,78,26,52
Zirkuszwei,aegwynn,1102,druid,restoration,29,14,15
Bioházard,blackrock,1101,druid,restoration,18,12,6
Snowrk,hyjal,1101,druid,restoration,30,19,11
Hólo,blackrock,1097,druid,restoration,29,14,15
Relache,twisting-nether,1086,druid,restoration,42,23,19
Vurgyl,hyjal,1079,druid,restoration,54,33,21
Farodiin,blackmoore,1079,druid,restoration,24,13,11
Cazzette,grim-batol,1073,druid,restoration,24,13,11
Омгдру,gordunni,1073,druid,restoration,99,46,53
Ankhenature,outland,1068,druid,restoration,65,36,29
Betelgues,kazzak,1067,druid,restoration,54,31,23
Spidete,sanguino,1067,druid,restoration,66,36,30
Ironveins,ravencrest,1066,druid,restoration,18,12,6
Elanrya,argent-dawn,1066,druid,restoration,53,15,38
Урька,blackscar,1065,druid,restoration,35,13,22
Midnightstry,alakir,1064,druid,restoration,84,42,42
Hypnosoad,outland,1062,druid,restoration,76,31,45
Kobrá,ravencrest,1056,druid,restoration,18,11,7
Niknoom,azjolnerub,1056,druid,restoration,54,32,22
Хлайси,gordunni,1056,druid,restoration,24,11,13
Wømbat,ravencrest,1056,druid,restoration,24,11,13
Sprøut,drakthul,1056,druid,restoration,24,11,13
Kyomã,burning-legion,1056,druid,restoration,24,11,13
Weisslogia,aegwynn,1055,druid,restoration,18,11,7
Nasgra,malganis,1055,druid,restoration,24,11,13
Oschlandor,blackmoore,1054,druid,restoration,12,11,1
Вексиус,gordunni,1053,druid,restoration,18,11,7
Тчаёк,gordunni,1052,druid,restoration,21,13,8
Xenva,blackmoore,1052,druid,restoration,30,13,17
Dafapa,twilights-hammer,1049,druid,restoration,24,11,13
Luarbak,kazzak,1041,druid,restoration,18,11,7
Vícvega,ravencrest,1038,druid,restoration,18,11,7
Hashtagone,ysondre,1036,druid,restoration,23,11,12
Mirana,drakthul,1032,druid,restoration,24,13,11
Maethar,stormrage,1031,druid,restoration,27,12,15
Storpboom,drakthul,1028,druid,restoration,31,13,18
Алунар,lich-king,1023,druid,restoration,54,22,32
Raysien,doomhammer,1021,druid,restoration,24,13,11
Shanikya,argent-dawn,1021,druid,restoration,44,20,24
Bearinator,aggramar,1021,druid,restoration,33,15,18
Tângo,eredar,1019,druid,restoration,25,12,13
Cárnagè,stormscale,1017,druid,restoration,48,17,31
Sertris,kazzak,1015,druid,restoration,31,11,20
Hopê,burning-legion,1014,druid,restoration,30,21,9
Wazam,kazzak,1013,druid,restoration,24,11,13
Ninadobrev,ragnaros,1007,druid,restoration,21,12,9
Feedbark,stormscale,1002,druid,restoration,23,13,10
Saimdude,blackrock,1001,druid,restoration,24,11,13
Mutato,draenor,999,druid,restoration,68,34,34
Ellismera,argent-dawn,978,druid,restoration,36,17,19
Davincidru,tarren-mill,978,druid,restoration,56,24,32
Feanthur,drakthul,977,druid,restoration,88,48,40
Robutt,runetotem,976,druid,restoration,22,12,10
Naruhot,archimonde,975,druid,restoration,19,11,8
Spoco,defias-brotherhood,972,druid,restoration,78,40,38
Эмканегодяйк,galakrond,972,druid,restoration,30,15,15
Collîî,aegwynn,970,druid,restoration,21,12,9
Nachtelf,lightbringer,969,druid,restoration,48,15,33
Nimèl,argent-dawn,966,druid,restoration,36,16,20
Wegian,sylvanas,962,druid,restoration,63,36,27
Джелони,soulflayer,960,druid,restoration,18,10,8
Amaré,burning-legion,960,druid,restoration,24,10,14
Snedden,silvermoon,959,druid,restoration,30,15,15
Siuo,ravencrest,959,druid,restoration,24,10,14
Çãm,magtheridon,957,druid,restoration,18,10,8
Маминапуська,soulflayer,955,druid,restoration,18,10,8
Inspiredrood,archimonde,954,druid,restoration,30,18,12
Moonfetamine,silvermoon,954,druid,restoration,30,10,20
Rabacki,blackmoore,953,druid,restoration,26,10,16
Hót,ravencrest,952,druid,restoration,30,10,20
Ubbeleg,kazzak,950,druid,restoration,18,10,8
Друидсимба,howling-fjord,949,druid,restoration,18,10,8
Thieane,blackhand,948,druid,restoration,18,10,8
Merakir,dun-modr,948,druid,restoration,30,11,19
Johndru,kazzak,948,druid,restoration,71,26,45
Zarlaac,ravencrest,947,druid,restoration,18,10,8
Weiden,twisting-nether,945,druid,restoration,18,10,8
Thélon,antonidas,945,druid,restoration,69,35,34
Corias,blackmoore,944,druid,restoration,36,10,26
Cigamt,kazzak,943,druid,restoration,12,10,2
Buffspencer,ragnaros,932,druid,restoration,24,13,11
Mendozä,stormscale,930,druid,restoration,37,18,19
Krollix,dun-morogh,929,druid,restoration,47,25,22
Maldrýn,stormscale,927,druid,restoration,17,10,7
Macanbre,tarren-mill,925,druid,restoration,24,13,11
Missfar,doomhammer,923,druid,restoration,36,13,23
Shokazu,blackmoore,917,druid,restoration,64,29,35
Yespapa,kazzak,913,druid,restoration,60,28,32
Уэсериктх,blackscar,911,druid,restoration,15,10,5
Chainbrake,sylvanas,911,druid,restoration,17,10,7
Бехеровка,grom,910,druid,restoration,58,24,34
Kárél,drakthul,906,druid,restoration,24,12,12
Akifumi,archimonde,903,druid,restoration,35,11,24
Jambonmaster,archimonde,899,druid,restoration,24,12,12
Didi,frostwhisper,899,druid,restoration,30,11,19
Celéry,silvermoon,896,druid,restoration,16,10,6
Фэйблуд,blackscar,894,druid,restoration,60,27,33
Mw,dun-modr,893,druid,restoration,23,10,13
Simouch,archimonde,871,druid,restoration,84,37,47
Uñsullied,kazzak,864,druid,restoration,12,9,3
Viggez,outland,864,druid,restoration,18,9,9
Acxaryl,ravencrest,864,druid,restoration,18,9,9
Tjann,darksorrow,864,druid,restoration,18,9,9
Лабирон,soulflayer,864,druid,restoration,24,9,15
Ööh,outland,863,druid,restoration,12,9,3
Stonesight,argent-dawn,863,druid,restoration,12,9,3
Shiftway,stormscale,863,druid,restoration,18,9,9
Jikuni,ravencrest,862,druid,restoration,18,9,9
Thardruid,stormscale,860,druid,restoration,18,9,9
Sinthorasia,blackrock,858,druid,restoration,18,9,9
Nutzlos,azshara,856,druid,restoration,53,15,38
Relxc,outland,854,druid,restoration,12,9,3
Happyhoter,blackrock,854,druid,restoration,24,9,15
Ceapamatii,sylvanas,852,druid,restoration,18,9,9
Lunatrixs,dun-modr,852,druid,restoration,18,9,9
Chujogrzmot,kazzak,843,druid,restoration,23,9,14
Jagu,blackrock,839,druid,restoration,18,9,9
Diastra,silvermoon,837,druid,restoration,19,10,9
Triplej,twisting-nether,836,druid,restoration,18,9,9
Robeala,twisting-nether,832,druid,restoration,42,17,25
Найтед,gordunni,828,druid,restoration,16,10,6
Ruap,blackmoore,822,druid,restoration,20,10,10
Metaboss,ravencrest,817,druid,restoration,71,24,47
Trollisha,mannoroth,815,druid,restoration,23,9,14
Zillo,stormscale,815,druid,restoration,26,10,16
Spiralout,nemesis,805,druid,restoration,24,10,14
Nube,alonsus,805,druid,restoration,48,16,32
Ratskrone,alleria,796,druid,restoration,42,16,26
Lyndruid,sylvanas,789,druid,restoration,48,17,31
Bidodici,nemesis,783,druid,restoration,135,57,78
Houwalia,archimonde,781,druid,restoration,30,11,19
Buufu,kazzak,780,druid,restoration,19,9,10
Skilloxus,gilneas,772,druid,restoration,51,17,34
Ecological,outland,768,druid,restoration,12,8,4
Bellatrx,darksorrow,768,druid,restoration,12,8,4
Hotlotta,aegwynn,768,druid,restoration,12,8,4
Rînaa,ravencrest,768,druid,restoration,12,8,4
Dablol,draenor,768,druid,restoration,12,8,4
Zmira,outland,768,druid,restoration,18,8,10
Acondris,kazzak,768,druid,restoration,24,8,16
Muraebbasta,pozzo-delleternità,768,druid,restoration,24,8,16
Kajiun,silvermoon,767,druid,restoration,12,8,4
Elu,eredar,767,druid,restoration,12,8,4
Alexialol,silvermoon,767,druid,restoration,12,8,4
Brindefolie,archimonde,767,druid,restoration,18,8,10
Wooshy,kazzak,767,druid,restoration,18,8,10
Exilia,kragjin,767,druid,restoration,18,8,10
Noxlunaire,ravencrest,766,druid,restoration,18,8,10
Jehtrotull,nemesis,765,druid,restoration,14,8,6
Crydotcom,aegwynn,765,druid,restoration,18,8,10
Aolynk,twisting-nether,765,druid,restoration,18,8,10
Memento,kazzak,765,druid,restoration,18,8,10
Tsuteymanga,veknilash,763,druid,restoration,18,8,10
Mandy,spinebreaker,755,druid,restoration,18,8,10
Jimmorris,eredar,754,druid,restoration,18,8,10
Hootymactoot,magtheridon,752,druid,restoration,12,8,4
Frostfox,ghostlands,741,druid,restoration,22,9,13
Fubarmeep,outland,740,druid,restoration,18,8,10
Лордсенка,eversong,721,druid,restoration,18,8,10
Магараганага,azuregos,675,druid,restoration,25,8,17
Monatamis,kazzak,672,druid,restoration,12,7,5
Dïsä,ravencrest,672,druid,restoration,12,7,5
Maiverdr,ravencrest,672,druid,restoration,12,7,5
Jakeffsake,stormscale,672,druid,restoration,12,7,5
Dortalon,outland,672,druid,restoration,12,7,5
Plúx,antonidas,672,druid,restoration,12,7,5
Luuxiå,archimonde,672,druid,restoration,12,7,5
Asklepion,twisting-nether,672,druid,restoration,18,7,11
Buzzlîghtyea,outland,672,druid,restoration,18,7,11
Nozome,draenor,672,druid,restoration,18,7,11
Стомпбр,gordunni,672,druid,restoration,24,7,17
Badballance,outland,671,druid,restoration,12,7,5
Dablolo,ravencrest,671,druid,restoration,12,7,5
Delviri,stormreaver,671,druid,restoration,12,7,5
Pomdöner,echsenkessel,671,druid,restoration,12,7,5
Darktigrou,archimonde,671,druid,restoration,12,7,5
Mindru,sylvanas,671,druid,restoration,12,7,5
Zkasnoname,archimonde,671,druid,restoration,18,7,11
Basajáun,dun-modr,671,druid,restoration,18,7,11
Шеданна,gordunni,671,druid,restoration,24,7,17
Euskal,chogall,671,druid,restoration,24,7,17
Ninø,gorgonnash,670,druid,restoration,12,7,5
Soný,aegwynn,670,druid,restoration,18,7,11
Thaeldres,argent-dawn,667,druid,restoration,18,7,11
Nøkki,draenor,667,druid,restoration,18,7,11
Doovex,ragnaros,667,druid,restoration,24,7,17
Gribix,kazzak,666,druid,restoration,12,7,5
Shenandoah,hyjal,666,druid,restoration,12,7,5
Kaod,outland,666,druid,restoration,12,7,5
Кишкинахир,razuvious,665,druid,restoration,12,7,5
Dirtyhacks,blackmoore,664,druid,restoration,12,7,5
Shaorma,ravencrest,661,druid,restoration,12,7,5
Bazilika,argent-dawn,661,druid,restoration,12,7,5
Сутулоерыгло,howling-fjord,658,druid,restoration,20,7,13
Борзойрог,soulflayer,656,druid,restoration,18,7,11
Deretus,blackmoore,640,druid,restoration,22,7,15
Foaqi,aegwynn,639,druid,restoration,16,7,9
Lutzmiller,eredar,637,druid,restoration,39,14,25
Allod,stormscale,631,druid,restoration,23,9,14
Kùrámágødx,ravencrest,624,druid,restoration,17,7,10
Zerschmatzen,aegwynn,610,druid,restoration,28,9,19
Heavysmoker,emeriss,607,druid,restoration,11,7,4
Lorucka,die-nachtwache,607,druid,restoration,14,7,7
Метафрея,gordunni,605,druid,restoration,11,7,4
Medreas,argent-dawn,594,druid,restoration,16,7,9
Justforgames,ravencrest,576,druid,restoration,6,6,0
Draxedin,kazzak,576,druid,restoration,6,6,0
Fknmad,burning-blade,576,druid,restoration,6,6,0
Bakicadr,sylvanas,576,druid,restoration,6,6,0
Jin,the-venture-co,576,druid,restoration,12,6,6
Cplazi,kazzak,576,druid,restoration,12,6,6
Zhosy,shattrath,576,druid,restoration,12,6,6
Cyriaan,eredar,576,druid,restoration,12,6,6
Sálty,aegwynn,576,druid,restoration,12,6,6
Дуггизавр,howling-fjord,576,druid,restoration,12,6,6
Muraglia,pozzo-delleternità,576,druid,restoration,12,6,6
Jhiun,ragnaros,576,druid,restoration,12,6,6
Felisin,ravencrest,576,druid,restoration,12,6,6
Афклалка,gordunni,576,druid,restoration,12,6,6
Bloomitize,ravencrest,576,druid,restoration,12,6,6
Yandris,argent-dawn,576,druid,restoration,12,6,6
Doodougie,silvermoon,576,druid,restoration,12,6,6
Zaelithree,archimonde,576,druid,restoration,12,6,6
Foxyfeet,outland,576,druid,restoration,12,6,6
Сладуляя,gordunni,576,druid,restoration,12,6,6
Rhonir,twisting-nether,576,druid,restoration,12,6,6
Влажныйдру,soulflayer,576,druid,restoration,12,6,6
Neverpanic,stormscale,576,druid,restoration,18,6,12
Tjillevippen,tarren-mill,576,druid,restoration,18,6,12
Pölkky,argent-dawn,576,druid,restoration,18,6,12
Eluñeãdore,silvermoon,575,druid,restoration,6,6,0
Lucidor,frostmane,575,druid,restoration,12,6,6
Scarrymonsta,outland,575,druid,restoration,12,6,6
Geeorge,stormscale,575,druid,restoration,12,6,6
Ekaterina,dun-morogh,575,druid,restoration,12,6,6
Afret,kazzak,575,druid,restoration,12,6,6
Shylanna,ragnaros,575,druid,restoration,12,6,6
Jinxaran,culte-de-la-rive-noire,575,druid,restoration,12,6,6
Storfjåset,stormscale,575,druid,restoration,18,6,12
Telaroxx,die-nachtwache,575,druid,restoration,18,6,12
Avilary,tarren-mill,575,druid,restoration,18,6,12
Mascraxx,earthen-ring,575,druid,restoration,18,6,12
Indann,kazzak,575,druid,restoration,18,6,12
Pouletqt,archimonde,575,druid,restoration,18,6,12
Digestivebis,defias-brotherhood,574,druid,restoration,6,6,0
Semiflora,silvermoon,574,druid,restoration,12,6,6
Ruberg,kazzak,574,druid,restoration,12,6,6
Tsihsel,ravencrest,574,druid,restoration,12,6,6
Mcneil,wrathbringer,574,druid,restoration,12,6,6
Spritzer,tarren-mill,574,druid,restoration,12,6,6
Ковамедведь,borean-tundra,574,druid,restoration,24,6,18
Зервес,gordunni,574,druid,restoration,24,6,18
Лаегмерил,gordunni,573,druid,restoration,10,7,3
Menolao,dun-morogh,573,druid,restoration,12,6,6
Dfjguidfg,baelgun,573,druid,restoration,18,6,12
Ragdru,twisting-nether,573,druid,restoration,24,6,18
Druiddamage,the-maelstrom,571,druid,restoration,12,6,6
Vertymbras,hyjal,571,druid,restoration,12,6,6
Nøboorst,ravencrest,571,druid,restoration,12,6,6
Malandrin,khazgoroth,568,druid,restoration,18,6,12
Walkao,tarren-mill,566,druid,restoration,12,6,6
Vlookup,tarren-mill,543,druid,restoration,17,6,11
Siahra,khaz-modan,534,druid,restoration,48,6,42
Mykk,ravencrest,480,druid,restoration,6,5,1
Utopiah,ravencrest,480,druid,restoration,6,5,1
Мегабамбук,soulflayer,480,druid,restoration,6,5,1
Мафио,blackscar,480,druid,restoration,12,5,7
Watchmebear,stormscale,480,druid,restoration,12,5,7
Nightmoon,hellscream,480,druid,restoration,12,5,7
Holybarkz,aegwynn,480,druid,restoration,12,5,7
Greengolly,argent-dawn,480,druid,restoration,12,5,7
Epicskin,kazzak,480,druid,restoration,12,5,7
Napsta,sylvanas,480,druid,restoration,12,5,7
Druidicchi,stormscale,480,druid,restoration,12,5,7
Jenovas,argent-dawn,480,druid,restoration,12,5,7
Marmotini,the-maelstrom,480,druid,restoration,12,5,7
Místergreen,ravencrest,480,druid,restoration,12,5,7
Asude,outland,480,druid,restoration,12,5,7
Kvalitet,outland,480,druid,restoration,12,5,7
Loleh,ragnaros,480,druid,restoration,12,5,7
Smightydr,silvermoon,480,druid,restoration,12,5,7
Helløkittyßß,dun-modr,480,druid,restoration,12,5,7
Elviiradruid,tarren-mill,480,druid,restoration,12,5,7
Yseraheal,drakthul,480,druid,restoration,18,5,13
Ванечка,razuvious,480,druid,restoration,18,5,13
Kætachy,archimonde,480,druid,restoration,18,5,13
Vranz,draenor,479,druid,restoration,6,5,1
Kezbaniye,silvermoon,479,druid,restoration,6,5,1
Epidruid,stormrage,479,druid,restoration,12,5,7
Nissemand,ravencrest,479,druid,restoration,12,5,7
Delphina,dun-modr,479,druid,restoration,12,5,7
Reiss,tarren-mill,479,druid,restoration,12,5,7
Adiycrazy,outland,479,druid,restoration,12,5,7
Bhorumir,colinas-pardas,479,druid,restoration,12,5,7
Ballosh,hyjal,479,druid,restoration,12,5,7
Tanariel,ravencrest,479,druid,restoration,12,5,7
Quiksx,blackrock,479,druid,restoration,13,5,8
Whiskers,emerald-dream,479,druid,restoration,16,6,10
Jemyd,aegwynn,479,druid,restoration,24,5,19
Hubek,silvermoon,478,druid,restoration,6,5,1
Herbiko,turalyon,478,druid,restoration,12,5,7
Kroshka,sylvanas,478,druid,restoration,12,5,7
Droodfist,khaz-modan,477,druid,restoration,6,5,1
Benjosef,blackmoore,476,druid,restoration,26,12,14
Sýrês,malganis,475,druid,restoration,12,5,7
Caturday,terrordar,474,druid,restoration,12,5,7
Prowlinger,silvermoon,473,druid,restoration,12,5,7
Druidicmorr,sylvanas,447,druid,restoration,10,5,5
Joksica,draenor,447,druid,restoration,11,5,6
Исмалат,howling-fjord,429,druid,restoration,11,5,6
Domsz,dalaran,428,druid,restoration,15,5,10
Ráw,dun-modr,400,druid,restoration,13,5,8
Bartoluca,twisting-nether,393,druid,restoration,28,6,22
Zonsy,twisting-nether,384,druid,restoration,6,4,2
Mistgone,hyjal,384,druid,restoration,6,4,2
Xandersito,sanguino,384,druid,restoration,6,4,2
Vioboomie,blackrock,384,druid,restoration,6,4,2
Марголав,gordunni,384,druid,restoration,6,4,2
Мамамышь,gordunni,384,druid,restoration,6,4,2
Zagrem,antonidas,384,druid,restoration,6,4,2
Thatzdmg,blackmoore,384,druid,restoration,6,4,2
Yazari,nathrezim,384,druid,restoration,6,4,2
Kyssope,chants-éternels,384,druid,restoration,6,4,2
Sensisdruid,blackmoore,384,druid,restoration,6,4,2
Adjaara,ravencrest,384,druid,restoration,6,4,2
Bntyx,dun-modr,384,druid,restoration,6,4,2
Bigborst,ravencrest,384,druid,restoration,6,4,2
Icecöld,silvermoon,384,druid,restoration,6,4,2
Jellyxdd,silvermoon,384,druid,restoration,6,4,2
Lindémann,blackhand,384,druid,restoration,6,4,2
Eyvimel,ravencrest,384,druid,restoration,6,4,2
Koala,temple-noir,384,druid,restoration,6,4,2
Zeroclones,the-maelstrom,384,druid,restoration,6,4,2
Izhusky,ravencrest,384,druid,restoration,6,4,2
Greenberry,eonar,384,druid,restoration,6,4,2
Stinka,ravencrest,384,druid,restoration,6,4,2
Leyô,archimonde,384,druid,restoration,6,4,2
Нагетсмяу,howling-fjord,384,druid,restoration,6,4,2
Darkyblood,archimonde,384,druid,restoration,6,4,2
Yunalaa,blackmoore,384,druid,restoration,6,4,2
Béccàbtw,draenor,384,druid,restoration,6,4,2
Naphé,ysondre,384,druid,restoration,6,4,2
Nancey,auchindoun,384,druid,restoration,12,6,6
Lucael,blackmoore,384,druid,restoration,12,4,8
Wagoneis,grim-batol,384,druid,restoration,12,4,8
Найадра,gordunni,384,druid,restoration,12,4,8
Eaglefox,aszune,384,druid,restoration,12,4,8
Biglet,tarren-mill,384,druid,restoration,12,4,8
Davorian,frostmane,384,druid,restoration,12,4,8
Neverfall,aegwynn,384,druid,restoration,12,4,8
Holybarkzqt,aegwynn,384,druid,restoration,12,4,8
Crìmz,aszune,384,druid,restoration,12,4,8
Celtimi,antonidas,384,druid,restoration,12,4,8
Josedudu,twisting-nether,384,druid,restoration,12,4,8
Ravenfel,argent-dawn,384,druid,restoration,12,4,8
Irrlycht,blackrock,384,druid,restoration,12,4,8
Kobra,twilights-hammer,384,druid,restoration,12,4,8
Murlwywy,blackmoore,384,druid,restoration,12,4,8
Plantpuzzl,silvermoon,384,druid,restoration,12,4,8
Àlec,silvermoon,384,druid,restoration,12,4,8
Litany,drakthul,384,druid,restoration,13,4,9
Hrz,kazzak,384,druid,restoration,18,4,14
Jabbah,defias-brotherhood,383,druid,restoration,6,4,2
Boomayé,archimonde,383,druid,restoration,6,4,2
Wyngx,blackrock,383,druid,restoration,6,4,2
Nargaí,kargath,383,druid,restoration,6,4,2
Прожималодру,deathguard,383,druid,restoration,12,4,8
Bepanten,azshara,383,druid,restoration,12,4,8
Opla,nethersturm,383,druid,restoration,12,4,8
Mimisiek,burning-legion,383,druid,restoration,12,4,8
Шикалат,howling-fjord,383,druid,restoration,24,4,20
Nali,arthas,382,druid,restoration,6,4,2
Loumpa,hyjal,382,druid,restoration,6,4,2
Karochi,kazzak,382,druid,restoration,6,4,2
Muju,stormscale,382,druid,restoration,12,4,8
Roséa,ravencrest,382,druid,restoration,12,4,8
Pega,nazjatar,382,druid,restoration,12,4,8
Voodoodrood,draenor,382,druid,restoration,24,4,20
Djclonex,archimonde,381,druid,restoration,12,4,8
Amalou,ravencrest,381,druid,restoration,12,4,8
Pudseytree,doomhammer,379,druid,restoration,12,4,8
Tranquillo,outland,379,druid,restoration,12,4,8
Blolzz,silvermoon,377,druid,restoration,18,4,14
Biegel,ysera,351,druid,restoration,11,4,7
Nøbødy,silvermoon,351,druid,restoration,11,4,7
Demerit,defias-brotherhood,351,druid,restoration,11,4,7
Lyvaley,dun-modr,350,druid,restoration,16,4,12
Orgazmo,archimonde,335,druid,restoration,11,4,7
Scra,anubarak,297,druid,restoration,14,6,8
Moonbloom,defias-brotherhood,288,druid,restoration,6,3,3
Surfingbirdx,ragnaros,288,druid,restoration,6,3,3
Lèafy,silvermoon,288,druid,restoration,6,3,3
Néøu,archimonde,288,druid,restoration,6,3,3
Inspira,teldrassil,288,druid,restoration,6,3,3
Zaethul,draenor,288,druid,restoration,6,3,3
Restaidpvs,wildhammer,288,druid,restoration,6,3,3
Shyni,outland,288,druid,restoration,6,3,3
Folzenqt,archimonde,288,druid,restoration,6,3,3
Noobr,ravencrest,288,druid,restoration,6,3,3
Тое,soulflayer,288,druid,restoration,6,3,3
Faustîno,dun-modr,288,druid,restoration,6,3,3
Thugzie,kazzak,288,druid,restoration,6,3,3
Ipsdray,ysondre,288,druid,restoration,6,3,3
Friyiee,stormscale,288,druid,restoration,6,3,3
Qwopeiqpwoid,kazzak,288,druid,restoration,6,3,3
Brosephiné,stormscale,288,druid,restoration,6,3,3
Göli,argent-dawn,288,druid,restoration,6,3,3
Madmanul,draenor,288,druid,restoration,6,3,3
Hanibalector,silvermoon,288,druid,restoration,6,3,3
Semenisback,archimonde,288,druid,restoration,6,3,3
Microw,ghostlands,288,druid,restoration,6,3,3
Derie,nazjatar,288,druid,restoration,6,3,3
Танганэку,howling-fjord,288,druid,restoration,6,3,3
Owldschool,blackmoore,288,druid,restoration,6,3,3
Solutionx,aegwynn,288,druid,restoration,6,3,3
Jebaitor,tarren-mill,288,druid,restoration,6,3,3
Фонш,soulflayer,288,druid,restoration,6,3,3
Wurzeldor,ravencrest,288,druid,restoration,6,3,3
Sygko,kazzak,288,druid,restoration,6,3,3
Ravnac,aegwynn,288,druid,restoration,6,3,3
Tarshish,outland,288,druid,restoration,6,3,3
Juhato,outland,288,druid,restoration,6,3,3
Kokanine,ravencrest,288,druid,restoration,6,3,3
Norkenis,neptulon,288,druid,restoration,6,3,3
Clownrad,tarren-mill,288,druid,restoration,6,3,3
Milknosugar,tarren-mill,288,druid,restoration,6,3,3
Vaacku,stormreaver,288,druid,restoration,6,3,3
Amstaffio,blackhand,288,druid,restoration,6,3,3
Miyá,sylvanas,288,druid,restoration,6,3,3
Martinesämst,outland,288,druid,restoration,6,3,3
Drozzie,twisting-nether,288,druid,restoration,6,3,3
Magiskeforme,draenor,288,druid,restoration,6,3,3
ßïgßúll,twisting-nether,288,druid,restoration,6,3,3
Druni,blackrock,288,druid,restoration,6,3,3
Julss,archimonde,288,druid,restoration,6,3,3
Stevedru,ravencrest,288,druid,restoration,6,3,3
Skuhlxz,thrall,288,druid,restoration,6,3,3
Nohos,blackrock,288,druid,restoration,6,3,3
Mnine,twisting-nether,288,druid,restoration,6,3,3
Rumbus,sanguino,288,druid,restoration,7,3,4
Piñaclonada,archimonde,288,druid,restoration,9,3,6
Draawun,burning-legion,288,druid,restoration,11,3,8
Nostigon,azshara,288,druid,restoration,12,3,9
Areidhel,pozzo-delleternità,288,druid,restoration,12,3,9
Coínlíp,drakthul,288,druid,restoration,12,3,9
Restodruidx,ravencrest,288,druid,restoration,12,3,9
Ahuevshiy,wildhammer,288,druid,restoration,12,3,9
Shiotake,hyjal,288,druid,restoration,12,3,9
Храмульчик,blackscar,288,druid,restoration,12,3,9
Teah,darkmoon-faire,288,druid,restoration,12,3,9
Rawillinen,kazzak,288,druid,restoration,12,3,9
Bigbones,frostwolf,288,druid,restoration,12,3,9
Yøungreidzz,blackrock,288,druid,restoration,18,3,15
Do,alakir,287,druid,restoration,6,3,3
Boompjeh,chamber-of-aspects,287,druid,restoration,6,3,3
Krizak,eredar,287,druid,restoration,6,3,3
Taskingoman,twisting-nether,287,druid,restoration,6,3,3
Xulian,exodar,287,druid,restoration,12,3,9
Papalegba,kilrogg,287,druid,restoration,12,3,9
Wildblu,nemesis,287,druid,restoration,12,3,9
Seabath,kirin-tor,287,druid,restoration,12,3,9
Paniel,amanthul,286,druid,restoration,6,3,3
Elônea,antonidas,285,druid,restoration,12,3,9
Gladyon,ravencrest,285,druid,restoration,12,3,9
Lexopewpew,ravencrest,256,druid,restoration,16,3,13
Bunga,quelthalas,255,druid,restoration,11,3,8
Duduque,twisting-nether,255,druid,restoration,11,3,8
Quorn,pozzo-delleternità,240,druid,restoration,7,4,3
Mayte,ragnaros,239,druid,restoration,5,3,2
Потнаякиса,grom,239,druid,restoration,5,3,2
Thornat,chamber-of-aspects,239,druid,restoration,5,3,2
Amélor,ragnaros,239,druid,restoration,5,3,2
Beerplusbeer,kazzak,234,druid,restoration,23,6,17
Jnzymiau,blackrock,192,druid,restoration,4,3,1
Шокоокулист,gordunni,192,druid,restoration,6,2,4
Traffix,outland,192,druid,restoration,6,2,4
Wannabanhere,outland,192,druid,restoration,6,2,4
Homek,eredar,192,druid,restoration,6,2,4
Drukae,stormscale,192,druid,restoration,6,2,4
Champaa,aggra-português,192,druid,restoration,6,2,4
Xidenn,quelthalas,192,druid,restoration,6,2,4
Skraks,ysondre,192,druid,restoration,6,2,4
Vinniehacker,archimonde,192,druid,restoration,6,2,4
Layzz,archimonde,192,druid,restoration,6,2,4
Restoboi,stormscale,192,druid,restoration,6,2,4
Huebbi,blackmoore,192,druid,restoration,6,2,4
Yesco,malganis,192,druid,restoration,6,2,4
Mchøt,ravencrest,192,druid,restoration,6,2,4
Sartipus,draenor,192,druid,restoration,6,2,4
Catman,eredar,192,druid,restoration,6,2,4
Kheazar,blackmoore,192,druid,restoration,6,2,4
Димитруа,howling-fjord,192,druid,restoration,6,2,4
Shaggí,draenor,192,druid,restoration,6,2,4
Nooz,thrall,192,druid,restoration,6,2,4
Moodee,kazzak,192,druid,restoration,6,2,4
Kkona,silvermoon,192,druid,restoration,6,2,4
Атитока,goldrinn,192,druid,restoration,6,2,4
Pinkpanda,arthas,192,druid,restoration,6,2,4
Jaytiz,ravencrest,192,druid,restoration,6,2,4
Solern,ravencrest,192,druid,restoration,6,2,4
Fanso,burning-legion,192,druid,restoration,6,2,4
Lyricx,kazzak,192,druid,restoration,6,2,4
Conn,ravencrest,192,druid,restoration,6,2,4
Milkmepls,balnazzar,192,druid,restoration,6,2,4
Príimé,kazzak,192,druid,restoration,6,2,4
Benjiee,kazzak,192,druid,restoration,6,2,4
Chrisdruid,argent-dawn,192,druid,restoration,6,2,4
Drâcâ,antonidas,192,druid,restoration,12,2,10
Nakkikastike,magtheridon,192,druid,restoration,12,2,10
Элеарсия,gordunni,192,druid,restoration,12,2,10
Spaartaa,blackhand,192,druid,restoration,12,2,10
Lisovamavka,draenor,192,druid,restoration,12,2,10
Vertabrain,twilights-hammer,192,druid,restoration,12,2,10
Салона,deathguard,192,druid,restoration,12,2,10
Maceyx,ravencrest,192,druid,restoration,12,2,10
Imperador,tyrande,192,druid,restoration,12,2,10
Охломон,gordunni,192,druid,restoration,24,2,22
Siyoo,thrall,191,druid,restoration,6,2,4
Дела,eversong,191,druid,restoration,6,2,4
Watchmymoon,blackrock,138,druid,restoration,10,3,7
Ihatewhales,ravencrest,128,druid,restoration,4,2,2
Xneji,sylvanas,111,druid,restoration,13,2,11
Qdrood,quelthalas,96,druid,restoration,6,1,5
Hotundwech,blackrock,96,druid,restoration,6,1,5
Druvian,argent-dawn,96,druid,restoration,6,1,5
Taicoo,outland,96,druid,restoration,6,1,5
Haginator,twisting-nether,96,druid,restoration,6,1,5
Winstonka,doomhammer,96,druid,restoration,6,1,5
Мунпраид,gordunni,96,druid,restoration,6,1,5
Secô,sylvanas,96,druid,restoration,6,1,5
Rakuy,thrall,96,druid,restoration,6,1,5
Nuwell,arathor,96,druid,restoration,6,1,5
Tshungubuäch,eredar,96,druid,restoration,6,1,5
Meisterd,aegwynn,96,druid,restoration,6,1,5
Uuni,sylvanas,96,druid,restoration,6,1,5
Nermax,kazzak,96,druid,restoration,6,1,5
Blanoz,ravencrest,96,druid,restoration,6,1,5
Xadidruîd,blackrock,96,druid,restoration,6,1,5
Tranduiil,drakthul,96,druid,restoration,6,1,5
Kisyqt,aegwynn,96,druid,restoration,6,1,5
Тианна,razuvious,96,druid,restoration,6,1,5
Sylindra,argent-dawn,96,druid,restoration,6,1,5
Elo,dun-morogh,96,druid,restoration,6,1,5
Søfiaa,argent-dawn,96,druid,restoration,6,1,5
Druidguden,tarren-mill,96,druid,restoration,6,1,5
Baawz,blackmoore,96,druid,restoration,6,1,5
Marynlord,dalaran,96,druid,restoration,6,1,5
Nuggetspøwa,dalaran,96,druid,restoration,6,1,5
Cowárd,blackmoore,96,druid,restoration,6,1,5
Lyj,dalaran,96,druid,restoration,6,1,5
Naturaven,sylvanas,96,druid,restoration,6,1,5
Gintoni,dun-modr,96,druid,restoration,6,1,5
Sozu,magtheridon,96,druid,restoration,6,1,5
Effi,aggramar,96,druid,restoration,6,1,5
Kerydwen,silvermoon,96,druid,restoration,6,1,5
Ka,the-maelstrom,96,druid,restoration,6,1,5
Seekíng,blackmoore,96,druid,restoration,6,1,5
Tilikum,stormscale,96,druid,restoration,6,1,5
Thaïs,blackmoore,96,druid,restoration,6,1,5
Nediena,twisting-nether,96,druid,restoration,6,1,5
Teengirl,blackmoore,96,druid,restoration,6,1,5
Linkin,azshara,96,druid,restoration,6,1,5
Fotmrerollér,darksorrow,96,druid,restoration,6,1,5
Goatmeal,draenor,96,druid,restoration,12,1,11
Püpply,antonidas,96,druid,restoration,12,1,11
Xilmai,darksorrow,96,druid,restoration,12,1,11
Athenex,azshara,96,druid,restoration,12,1,11
Dreäms,ravencrest,95,druid,restoration,6,1,5
Pobrica,stormscale,79,druid,restoration,5,1,4
Driiptoohard,turalyon,64,druid,restoration,4,1,3
Сугрик,deathweaver,64,druid,restoration,10,1,9
Oyoyo,kaelthas,63,druid,restoration,2,2,0
Rasserdruid,runetotem,63,druid,restoration,2,2,0
Quizdarude,draenor,42,druid,restoration,10,3,7
Acidbrate,aegwynn,42,druid,restoration,9,2,7
Eceria,the-maelstrom,42,druid,restoration,9,2,7
Noxann,archimonde,42,druid,restoration,10,2,8
Onacor,stormrage,42,druid,restoration,10,2,8
Uniquz,sylvanas,42,druid,restoration,11,2,9
Essya,earthen-ring,16,druid,restoration,1,1,0
Djemdruid,argent-dawn,1585,druid,guardian,42,18,24
Bulleyo,ysondre,1508,druid,guardian,41,22,19
Windythemilf,stormscale,1271,druid,guardian,104,54,50
Rbgbear,blackhand,1182,druid,guardian,30,14,16
Rapatera,argent-dawn,1115,druid,guardian,24,12,12
Микайо,goldrinn,986,druid,guardian,41,17,24
Lioky,dun-modr,670,druid,guardian,12,7,5
Critter,kargath,572,druid,guardian,18,6,12
Bigdomas,sylvanas,532,druid,guardian,16,6,10
Crazydudu,tarren-mill,456,druid,guardian,21,7,14
Tigerbear,argent-dawn,384,druid,guardian,12,4,8
Avisa,blackhand,378,druid,guardian,12,4,8
Horizonline,terokkar,350,druid,guardian,11,4,7
Zinister,hyjal,192,druid,guardian,6,2,4
Astralcore,stormscale,192,druid,guardian,6,2,4
Kárrde,balnazzar,192,druid,guardian,6,2,4
Fynvola,anubarak,192,druid,guardian,12,2,10
Avior,eonar,192,druid,guardian,13,2,11
Pure,kul-tiras,190,druid,guardian,15,3,12
Twinklex,ravencrest,2211,druid,feral,94,48,46
Xercas,outland,2166,druid,feral,65,39,26
Desenlace,ravencrest,2127,druid,feral,149,82,67
Cataferal,ravencrest,2088,druid,feral,78,43,35
Zøte,ravencrest,2083,druid,feral,84,43,41
Jakamx,ravencrest,2072,druid,feral,150,79,71
Ktx,aegwynn,2067,druid,feral,66,40,26
Iminz,ravencrest,2032,druid,feral,161,78,83
Rapatera,argent-dawn,2019,druid,feral,54,30,24
Crøwnd,twisting-nether,2016,druid,feral,42,28,14
Lxve,tarren-mill,1999,druid,feral,60,31,29
Trøüpäx,outland,1994,druid,feral,84,43,41
Dashfull,ravencrest,1966,druid,feral,113,63,50
Tomyn,burning-legion,1928,druid,feral,60,36,24
Cløwnferalx,argent-dawn,1921,druid,feral,54,25,29
Råñkønêbëår,ravencrest,1897,druid,feral,54,32,22
Taladruide,archimonde,1897,druid,feral,60,30,30
Bloodyredlyx,ysera,1885,druid,feral,54,32,22
Норланда,gordunni,1884,druid,feral,60,32,28
Brutaldamage,ravencrest,1873,druid,feral,54,28,26
Purgatxry,ravencrest,1873,druid,feral,239,118,121
Symbiosa,silvermoon,1870,druid,feral,30,20,10
Nîîght,ravencrest,1852,druid,feral,48,23,25
Minaervea,antonidas,1846,druid,feral,72,33,39
Kattenvoer,stormscale,1842,druid,feral,36,27,9
Skatch,sylvanas,1836,druid,feral,54,28,26
Houmrx,ravencrest,1830,druid,feral,36,23,13
Февти,gordunni,1828,druid,feral,59,34,25
Drbeef,sanguino,1823,druid,feral,45,28,17
Zelaron,twisting-nether,1823,druid,feral,42,22,20
Фейкхехе,gordunni,1822,druid,feral,48,27,21
Kroñm,dun-modr,1818,druid,feral,60,25,35
Nøfåmïly,silvermoon,1814,druid,feral,160,83,77
Mortality,proudmoore,1812,druid,feral,65,31,34
Nfxdruid,argent-dawn,1810,druid,feral,90,54,36
Jhiun,ragnaros,1806,druid,feral,72,40,32
Cåssidy,archimonde,1805,druid,feral,60,26,34
Bigangrycatx,ravencrest,1803,druid,feral,62,26,36
Ratsimulator,tarren-mill,1802,druid,feral,54,32,22
Skytek,silvermoon,1802,druid,feral,84,41,43
Мелталиора,soulflayer,1800,druid,feral,59,30,29
Djmeowxd,blackrock,1784,druid,feral,66,30,36
Annksunamún,ysondre,1782,druid,feral,124,73,51
Jarethy,dun-modr,1779,druid,feral,66,30,36
Catkovic,kult-der-verdammten,1777,druid,feral,47,24,23
Tilikum,stormscale,1758,druid,feral,215,106,109
Pilaf,emerald-dream,1758,druid,feral,97,46,51
Mykk,ravencrest,1755,druid,feral,39,27,12
Mabkferal,ravencrest,1750,druid,feral,44,25,19
Mmlprox,burning-legion,1747,druid,feral,49,27,22
Kikihoux,ravencrest,1747,druid,feral,41,22,19
Опакот,howling-fjord,1741,druid,feral,44,22,22
Moldrokk,ravencrest,1739,druid,feral,52,31,21
Goodtrip,archimonde,1739,druid,feral,56,30,26
Apuasaatana,stormreaver,1731,druid,feral,36,20,16
Jukeboks,silvermoon,1726,druid,feral,55,25,30
Ромкабикстар,gordunni,1721,druid,feral,36,18,18
Mutaattori,sylvanas,1720,druid,feral,37,18,19
Yesbody,tarren-mill,1718,druid,feral,36,18,18
Adabsurdum,kazzak,1712,druid,feral,107,48,59
Trauller,outland,1712,druid,feral,48,21,27
Nouin,twisting-nether,1705,druid,feral,60,29,31
Djgírlßøssqt,argent-dawn,1702,druid,feral,42,18,24
Yone,blackmoore,1700,druid,feral,42,21,21
Elîas,kazzak,1699,druid,feral,36,23,13
Блюгилли,ashenvale,1687,druid,feral,56,21,35
Трэвисдог,gordunni,1673,druid,feral,35,18,17
Freyanah,argent-dawn,1673,druid,feral,90,38,52
Desenlace,silvermoon,1670,druid,feral,42,19,23
Ðrüid,ravencrest,1668,druid,feral,72,34,38
Phenova,sargeras,1667,druid,feral,59,23,36
Jgltrainer,archimonde,1666,druid,feral,53,31,22
Silksharp,ravencrest,1663,druid,feral,60,31,29
Bernfried,silvermoon,1661,druid,feral,58,25,33
Triluxa,blackmoore,1659,druid,feral,48,25,23
ßgøðx,argent-dawn,1656,druid,feral,45,27,18
Unoseeme,outland,1655,druid,feral,66,29,37
Opresse,archimonde,1655,druid,feral,54,23,31
Uebiwe,silvermoon,1654,druid,feral,42,22,20
Yongala,archimonde,1650,druid,feral,48,29,19
Mysticalmoon,ravencrest,1639,druid,feral,48,21,27
Bulan,ghostlands,1638,druid,feral,66,41,25
Shiftydruid,thunderhorn,1632,druid,feral,122,54,68
Dzandel,silvermoon,1631,druid,feral,234,112,122
Ñøpe,ravencrest,1630,druid,feral,30,17,13
Fyrkax,aegwynn,1626,druid,feral,30,17,13
Boostedbear,ragnaros,1622,druid,feral,36,17,19
Rollozuu,blackrock,1620,druid,feral,78,42,36
Skypinho,blackhand,1616,druid,feral,48,22,26
Khunahype,thrall,1610,druid,feral,24,17,7
Narunis,tarren-mill,1610,druid,feral,54,25,29
Zaibastus,doomhammer,1610,druid,feral,54,21,33
Elfsu,ravencrest,1609,druid,feral,36,21,15
Banzeye,nordrassil,1607,druid,feral,68,35,33
Simdruid,stormscale,1606,druid,feral,30,17,13
Bigpapad,ravencrest,1605,druid,feral,36,19,17
Evilshade,ravencrest,1604,druid,feral,115,47,68
Asçdruid,kazzak,1602,druid,feral,50,22,28
Акиша,deepholm,1597,druid,feral,42,20,22
Jabbari,outland,1592,druid,feral,72,35,37
Rbgbot,ragnaros,1583,druid,feral,30,17,13
Jellytardx,outland,1583,druid,feral,54,27,27
Natakis,blades-edge,1582,druid,feral,36,19,17
Vëgâñgøðx,ragnaros,1581,druid,feral,36,22,14
Màz,blackmoore,1570,druid,feral,92,43,49
Reward,ragnaros,1562,druid,feral,34,17,17
Риама,blackscar,1558,druid,feral,72,35,37
Зонкс,gordunni,1557,druid,feral,82,44,38
Drylle,argent-dawn,1555,druid,feral,87,47,40
Degmond,silvermoon,1533,druid,feral,30,16,14
Maccín,draenor,1530,druid,feral,52,18,34
Stopwatching,outland,1524,druid,feral,36,16,20
Оудин,blackscar,1521,druid,feral,47,23,24
Муумуумуу,howling-fjord,1512,druid,feral,108,49,59
Rami,sylvanas,1512,druid,feral,60,25,35
Fückøff,ravencrest,1510,druid,feral,30,16,14
Jerrybeans,ravencrest,1504,druid,feral,120,57,63
Sabertoon,argent-dawn,1491,druid,feral,77,32,45
Oleander,zuljin,1479,druid,feral,113,56,57
Lukeyferalxo,argent-dawn,1477,druid,feral,84,42,42
Мунпраид,gordunni,1470,druid,feral,55,26,29
Clipsy,twilights-hammer,1469,druid,feral,125,60,65
Arlina,magtheridon,1454,druid,feral,57,26,31
Margueriti,the-maelstrom,1452,druid,feral,43,17,26
Tazdino,destromath,1427,druid,feral,36,15,21
Arilíaxo,amanthul,1426,druid,feral,18,15,3
Phesxd,sylvanas,1425,druid,feral,42,21,21
Sÿlph,sylvanas,1422,druid,feral,72,38,34
Panthéra,ravencrest,1422,druid,feral,66,29,37
Vancis,ravencrest,1421,druid,feral,51,29,22
Mervend,tarren-mill,1420,druid,feral,41,15,26
Doopdroo,tarren-mill,1419,druid,feral,42,15,27
Avanah,silvermoon,1412,druid,feral,36,15,21
Elitarian,argent-dawn,1408,druid,feral,42,21,21
Boomzter,frostmane,1405,druid,feral,57,26,31
Pipima,kazzak,1405,druid,feral,42,18,24
Eranor,archimonde,1404,druid,feral,99,46,53
Chiwsy,outland,1400,druid,feral,30,15,15
Арбузег,gordunni,1398,druid,feral,35,16,19
Legitx,dentarg,1385,druid,feral,43,17,26
Ripgødx,outland,1377,druid,feral,100,53,47
Ferøsse,hyjal,1374,druid,feral,42,21,21
Cörelly,ravencrest,1370,druid,feral,78,39,39
Bigdaddytate,kazzak,1364,druid,feral,29,17,12
Эскоф,gordunni,1359,druid,feral,31,17,14
Manoestouro,draenor,1353,druid,feral,48,19,29
Беконайзер,howling-fjord,1349,druid,feral,34,16,18
Zechey,stormreaver,1343,druid,feral,24,14,10
Shinshìva,twisting-nether,1337,druid,feral,126,67,59
Degentiuso,alakir,1336,druid,feral,53,29,24
Raznos,ravencrest,1333,druid,feral,18,14,4
Biffsteak,blackhand,1328,druid,feral,48,21,27
Vanhelsíng,dun-modr,1322,druid,feral,22,15,7
Балаклаваа,soulflayer,1316,druid,feral,29,18,11
Majokz,ravencrest,1307,druid,feral,44,23,21
Regelè,sylvanas,1305,druid,feral,86,45,41
Epicplays,sylvanas,1300,druid,feral,24,14,10
Texoria,twisting-nether,1298,druid,feral,36,14,22
Druidicmorr,sylvanas,1288,druid,feral,38,15,23
Nalaa,festung-der-stürme,1277,druid,feral,83,35,48
Extracssion,ysondre,1270,druid,feral,32,14,18
Jxst,tarren-mill,1270,druid,feral,48,19,29
ßußßo,ravencrest,1264,druid,feral,18,15,3
Лякокля,soulflayer,1260,druid,feral,36,19,17
Кеорл,gordunni,1256,druid,feral,54,19,35
Pepeja,doomhammer,1253,druid,feral,24,15,9
Yaddas,draenor,1248,druid,feral,18,13,5
Kaldorei,nemesis,1246,druid,feral,24,13,11
Blvckðvitchz,ravencrest,1246,druid,feral,24,13,11
Goldrax,outland,1246,druid,feral,24,13,11
Tangela,stormreaver,1243,druid,feral,18,13,5
Cheddar,tyrande,1237,druid,feral,29,14,15
Cleandc,blackhand,1234,druid,feral,34,20,14
Twyty,khaz-modan,1234,druid,feral,70,33,37
Тётявискас,howling-fjord,1233,druid,feral,24,13,11
Deviantdruid,tarren-mill,1231,druid,feral,39,20,19
Bâbusch,blackmoore,1230,druid,feral,24,13,11
Катяблум,gordunni,1230,druid,feral,30,13,17
Kimpine,kirin-tor,1229,druid,feral,33,15,18
Shaggery,stormscale,1227,druid,feral,69,27,42
Whísperclaw,ravencrest,1226,druid,feral,41,21,20
Dougi,argent-dawn,1224,druid,feral,42,18,24
Soléda,thrall,1219,druid,feral,24,13,11
Thaelyy,drakthul,1218,druid,feral,42,13,29
Vlcák,drakthul,1215,druid,feral,30,13,17
Azmerloth,antonidas,1214,druid,feral,36,13,23
Shymä,hyjal,1206,druid,feral,73,30,43
Millenia,darkmoon-faire,1204,druid,feral,55,28,27
Stelthee,silvermoon,1198,druid,feral,45,17,28
Tussenfryd,draenor,1189,druid,feral,64,25,39
Грязныекогти,gordunni,1186,druid,feral,23,13,10
Mônchô,sanguino,1182,druid,feral,51,28,23
Kouda,draenor,1181,druid,feral,28,13,15
Dadzeus,khaz-modan,1170,druid,feral,23,13,10
Kynji,twisting-nether,1169,druid,feral,60,27,33
Lorcàn,argent-dawn,1164,druid,feral,40,16,24
Blazor,eredar,1161,druid,feral,40,23,17
Hottad,tarren-mill,1153,druid,feral,42,21,21
Cocaqt,nemesis,1151,druid,feral,18,12,6
Howtonio,archimonde,1151,druid,feral,18,12,6
Kàraba,archimonde,1151,druid,feral,22,13,9
Lenyl,dun-modr,1151,druid,feral,24,12,12
Zbear,kazzak,1151,druid,feral,36,16,20
Shyngodx,archimonde,1150,druid,feral,18,12,6
Webla,blackmoore,1149,druid,feral,23,13,10
Dirtyfantasy,alakir,1142,druid,feral,42,22,20
Kyoshî,blackmoore,1142,druid,feral,82,42,40
Jinxaran,culte-de-la-rive-noire,1135,druid,feral,36,12,24
Battleray,twisting-nether,1133,druid,feral,27,15,12
Koffee,archimonde,1129,druid,feral,24,12,12
Кыцко,soulflayer,1124,druid,feral,24,12,12
Vidlna,outland,1121,druid,feral,36,15,21
Devonshira,ravencrest,1114,druid,feral,30,12,18
Crtx,blackhand,1113,druid,feral,24,13,11
Malvakten,kazzak,1112,druid,feral,25,13,12
Feraligator,sanguino,1103,druid,feral,74,32,42
Tibozx,stormscale,1102,druid,feral,30,17,13
Cubswansón,outland,1095,druid,feral,26,13,13
Zivertgodx,argent-dawn,1093,druid,feral,42,20,22
Owling,antonidas,1088,druid,feral,36,19,17
Tsajj,stormreaver,1083,druid,feral,39,23,16
Hönör,ysondre,1083,druid,feral,60,28,32
Smittly,bloodhoof,1080,druid,feral,34,15,19
Eternas,elune,1074,druid,feral,70,33,37
Swagmode,draenor,1059,druid,feral,43,25,18
Kermit,die-aldor,1059,druid,feral,51,18,33
Indann,kazzak,1056,druid,feral,30,11,19
Nìm,outland,1056,druid,feral,30,11,19
Derzis,eonar,1055,druid,feral,54,25,29
Liya,ravencrest,1054,druid,feral,30,11,19
Одряя,soulflayer,1050,druid,feral,18,11,7
Chirnaruk,ravencrest,1049,druid,feral,24,11,13
Тёмныйзверь,borean-tundra,1048,druid,feral,30,11,19
Weedum,kazzak,1046,druid,feral,24,11,13
Amoonaa,kazzak,1045,druid,feral,24,14,10
Zokix,doomhammer,1040,druid,feral,30,12,18
Kageioshi,kazzak,1026,druid,feral,24,12,12
Liionheart,khaz-modan,1026,druid,feral,24,11,13
Phanterus,chamber-of-aspects,1012,druid,feral,24,11,13
Tatabomba,archimonde,1008,druid,feral,60,30,30
Брэмблс,soulflayer,1008,druid,feral,35,15,20
Yøløswag,naxxramas,990,druid,feral,47,23,24
Tsopúnisher,twisting-nether,990,druid,feral,28,13,15
Janjalism,silvermoon,973,druid,feral,63,34,29
Descendance,ysondre,967,druid,feral,30,14,16
Pänthërä,ravencrest,960,druid,feral,18,10,8
Ålleyézoffme,ravencrest,959,druid,feral,18,10,8
Mcvøvà,kazzak,959,druid,feral,18,10,8
Beerista,tarren-mill,959,druid,feral,24,11,13
Cyph,shadowsong,958,druid,feral,18,10,8
Nîchtsnutz,blackmoore,958,druid,feral,18,10,8
Donoz,ravencrest,956,druid,feral,12,10,2
Corrupthz,outland,955,druid,feral,24,10,14
Hushorde,twisting-nether,955,druid,feral,24,10,14
Snøwden,twisting-nether,952,druid,feral,18,10,8
Arnwaald,kaelthas,947,druid,feral,18,10,8
Реептилоид,soulflayer,942,druid,feral,24,10,14
Calaftayou,ravencrest,937,druid,feral,30,14,16
Mpounia,twilights-hammer,927,druid,feral,54,25,29
Zulazain,bladefist,921,druid,feral,42,13,29
Teddîursa,kazzak,915,druid,feral,34,10,24
Salseo,uldum,908,druid,feral,21,10,11
Wex,darksorrow,864,druid,feral,12,9,3
Urfi,tyrande,864,druid,feral,12,9,3
Quikahn,outland,864,druid,feral,12,9,3
Cocomojo,outland,864,druid,feral,18,9,9
Paramore,outland,864,druid,feral,18,9,9
Sixmonthbann,ravencrest,864,druid,feral,18,9,9
Aleatório,grim-batol,864,druid,feral,18,9,9
Furrykruger,the-maelstrom,864,druid,feral,18,9,9
Cjparker,archimonde,863,druid,feral,18,9,9
Беркамп,howling-fjord,863,druid,feral,18,9,9
Котосапенс,howling-fjord,863,druid,feral,18,9,9
Rbg,dun-modr,863,druid,feral,22,10,12
Пиггипоп,soulflayer,863,druid,feral,24,9,15
Олежасутра,howling-fjord,863,druid,feral,30,9,21
Мунфайр,galakrond,862,druid,feral,18,9,9
Larryburns,nathrezim,862,druid,feral,18,9,9
Nalreaa,kazzak,859,druid,feral,18,9,9
Snapeshifter,blackhand,859,druid,feral,18,9,9
Hadespool,sanguino,859,druid,feral,18,9,9
Caèlas,outland,859,druid,feral,18,9,9
Carakal,outland,858,druid,feral,24,9,15
Collnaris,ravencrest,857,druid,feral,12,9,3
Liqoú,tarren-mill,857,druid,feral,18,9,9
Mudpie,stormscale,856,druid,feral,24,9,15
Trusten,nemesis,854,druid,feral,18,9,9
Noyake,ragnaros,854,druid,feral,24,9,15
Реалаг,howling-fjord,847,druid,feral,23,9,14
Klatro,terokkar,844,druid,feral,12,9,3
Progodd,kazzak,833,druid,feral,24,9,15
Hadesx,blackhand,832,druid,feral,18,9,9
Kîñg,tarren-mill,817,druid,feral,46,20,26
Snupy,outland,815,druid,feral,17,9,8
Йванныч,gordunni,793,druid,feral,26,9,17
Sartipus,draenor,768,druid,feral,12,8,4
Moonkniight,ravencrest,768,druid,feral,12,8,4
Bleêds,dun-modr,768,druid,feral,12,8,4
Muckì,alleria,768,druid,feral,18,8,10
Апвель,gordunni,768,druid,feral,18,8,10
Feralwilder,turalyon,768,druid,feral,30,8,22
Kørnuto,nemesis,767,druid,feral,12,8,4
Mimir,la-croisade-écarlate,767,druid,feral,12,8,4
Стэлларпауэр,gordunni,767,druid,feral,18,8,10
Lugtedyr,draenor,767,druid,feral,18,8,10
Seysso,silvermoon,767,druid,feral,18,8,10
Pneuma,xavius,767,druid,feral,24,8,16
Acéré,archimonde,767,druid,feral,24,8,16
Laek,chogall,767,druid,feral,24,8,16
Thielyy,blackmoore,766,druid,feral,18,8,10
Crow,saurfang,766,druid,feral,20,8,12
Krvopito,tarren-mill,765,druid,feral,12,8,4
Plankface,ravencrest,765,druid,feral,18,8,10
Dudeimgodly,ravencrest,765,druid,feral,30,8,22
Bâlou,nathrezim,764,druid,feral,18,8,10
Плагиат,grom,749,druid,feral,30,8,22
Cyriaan,eredar,719,druid,feral,17,8,9
Lolhaha,ravencrest,672,druid,feral,12,7,5
Fíja,blackmoore,672,druid,feral,12,7,5
Nøkki,draenor,672,druid,feral,12,7,5
Диздру,howling-fjord,672,druid,feral,12,7,5
Бобасик,fordragon,672,druid,feral,12,7,5
Фекаллис,soulflayer,672,druid,feral,12,7,5
Итильтириэль,gordunni,672,druid,feral,12,7,5
Togara,kazzak,672,druid,feral,12,7,5
Bomoth,kazzak,672,druid,feral,12,7,5
Runeclaws,twisting-nether,672,druid,feral,12,7,5
Dureka,tarren-mill,672,druid,feral,12,7,5
Goodtrip,hyjal,672,druid,feral,12,7,5
Coldkíng,twisting-nether,672,druid,feral,18,7,11
Luveena,kazzak,672,druid,feral,18,7,11
Oni,kelthuzad,672,druid,feral,18,7,11
Ðevilwhite,nemesis,672,druid,feral,18,7,11
Mooncarnatio,burning-legion,672,druid,feral,18,7,11
Liptonbite,blackhand,672,druid,feral,24,7,17
Криашин,goldrinn,671,druid,feral,12,7,5
Déme,twisting-nether,671,druid,feral,12,7,5
Sôalôgel,blackrock,671,druid,feral,12,7,5
Henessi,ragnaros,671,druid,feral,18,7,11
Bærbell,blackrock,671,druid,feral,18,7,11
Lazerbinks,blackmoore,671,druid,feral,24,7,17
Grimgoor,burning-legion,670,druid,feral,12,7,5
Biorythm,draenor,670,druid,feral,12,7,5
Noobbiiee,silvermoon,670,druid,feral,12,7,5
Cøcøpøpsmøke,archimonde,670,druid,feral,18,7,11
Toredorxy,blackrock,669,druid,feral,12,7,5
Salviaf,silvermoon,669,druid,feral,12,7,5
Radime,khaz-modan,669,druid,feral,12,7,5
Терамин,howling-fjord,669,druid,feral,18,7,11
Nicos,elune,668,druid,feral,18,7,11
Фаллендэл,gordunni,663,druid,feral,12,7,5
Mordpaw,stormscale,639,druid,feral,14,8,6
Sìa,frostmane,639,druid,feral,23,7,16
Bagheera,archimonde,623,druid,feral,11,7,4
Àyóorts,archimonde,607,druid,feral,14,7,7
Théó,grim-batol,605,druid,feral,17,7,10
Snkyexpress,aegwynn,576,druid,feral,12,6,6
Arlandia,drakthul,576,druid,feral,12,6,6
Hugepepega,ravencrest,576,druid,feral,12,6,6
Baccthana,auchindoun,576,druid,feral,12,6,6
Amandial,silvermoon,576,druid,feral,12,6,6
Nédith,archimonde,576,druid,feral,12,6,6
Alessathrina,argent-dawn,576,druid,feral,12,6,6
Vulko,lightbringer,576,druid,feral,12,6,6
Tonycatmeow,ravencrest,576,druid,feral,12,6,6
Flawkin,kazzak,576,druid,feral,12,6,6
Сиэн,ashenvale,576,druid,feral,12,6,6
Radauronny,malganis,576,druid,feral,18,6,12
Belsebub,ravencrest,576,druid,feral,18,6,12
Хокан,deepholm,576,druid,feral,18,6,12
Chunkeykill,alonsus,575,druid,feral,12,6,6
Xurta,kazzak,575,druid,feral,12,6,6
Drudonja,silvermoon,575,druid,feral,12,6,6
Скайтибрайдх,gordunni,575,druid,feral,18,6,12
Tyldormeow,tarren-mill,575,druid,feral,18,6,12
Zeyne,ravencrest,574,druid,feral,12,6,6
Tricklou,tarren-mill,574,druid,feral,12,6,6
Hetalia,culte-de-la-rive-noire,571,druid,feral,12,6,6
Друлевой,greymane,570,druid,feral,12,6,6
Spangle,stormscale,554,druid,feral,21,7,14
Tyranderawr,ravencrest,522,druid,feral,15,7,8
Блиденг,gordunni,522,druid,feral,21,8,13
Nuashoa,argent-dawn,521,druid,feral,16,7,9
Ytzù,archimonde,480,druid,feral,6,5,1
Thørkang,dun-modr,480,druid,feral,6,5,1
Fürfur,ravencrest,480,druid,feral,6,5,1
Retzerbil,ravencrest,480,druid,feral,10,6,4
Nspirit,ravencrest,480,druid,feral,12,5,7
Wucherwurzel,eredar,480,druid,feral,12,5,7
Шэйпшифт,fordragon,480,druid,feral,12,5,7
Nå,outland,480,druid,feral,12,5,7
Eltroncazo,sanguino,480,druid,feral,12,5,7
Nainket,ravencrest,480,druid,feral,12,5,7
Nîghtz,ravencrest,480,druid,feral,12,5,7
Turkus,draenor,480,druid,feral,12,5,7
Flum,darksorrow,480,druid,feral,12,5,7
Rímeru,blackmoore,480,druid,feral,12,5,7
Hrabioid,burning-legion,480,druid,feral,12,5,7
Sketz,stormscale,480,druid,feral,12,5,7
Einsfünfkcat,madmortem,480,druid,feral,12,5,7
Zurllyn,ravencrest,480,druid,feral,12,5,7
Bloomly,tarren-mill,480,druid,feral,12,5,7
Arfgtdispo,hyjal,480,druid,feral,12,5,7
Shylovez,aegwynn,480,druid,feral,12,5,7
Toron,dalaran,480,druid,feral,12,5,7
Chepochem,stormscale,480,druid,feral,12,5,7
Saabeq,hyjal,480,druid,feral,12,5,7
Erenalby,draenor,480,druid,feral,12,5,7
Kardashìan,ravencrest,480,druid,feral,13,5,8
Mérias,archimonde,480,druid,feral,18,5,13
Blintschiki,echsenkessel,480,druid,feral,18,5,13
Outtanowhere,drakthul,480,druid,feral,18,5,13
Yiradur,stormscale,480,druid,feral,18,5,13
Cdsxr,outland,480,druid,feral,24,5,19
Селфика,gordunni,480,druid,feral,24,5,19
Mgelolaf,doomhammer,479,druid,feral,6,5,1
Poskehh,outland,479,druid,feral,12,5,7
Mambalol,sanguino,479,druid,feral,12,5,7
Holditorsken,grim-batol,479,druid,feral,12,5,7
Kodobursto,stormscale,479,druid,feral,12,5,7
Менстряк,howling-fjord,479,druid,feral,18,5,13
Cattastrophe,bronzebeard,477,druid,feral,12,5,7
Mitomen,ragnaros,476,druid,feral,12,5,7
Skylarr,alexstrasza,475,druid,feral,12,5,7
Zynmeow,lordaeron,416,druid,feral,19,6,13
Euskal,chogall,415,druid,feral,8,5,3
Nipply,ravencrest,415,druid,feral,15,6,9
Migajde,ravencrest,399,druid,feral,11,5,6
Takamizy,ysondre,384,druid,feral,6,4,2
Aslanah,hyjal,384,druid,feral,6,4,2
Seekx,silvermoon,384,druid,feral,6,4,2
Dystaleon,blackrock,384,druid,feral,6,4,2
Fzx,aegwynn,384,druid,feral,6,4,2
Diktus,outland,384,druid,feral,6,4,2
Noxxzar,stormscale,384,druid,feral,6,4,2
Kgn,blackmoore,384,druid,feral,6,4,2
Faveyo,die-nachtwache,384,druid,feral,6,4,2
Taigarus,aerie-peak,384,druid,feral,6,4,2
Minaye,hyjal,384,druid,feral,6,4,2
Ryáanz,ravencrest,384,druid,feral,6,4,2
Knatch,outland,384,druid,feral,6,4,2
Psixx,blackhand,384,druid,feral,6,4,2
Tróllinger,blackrock,384,druid,feral,6,4,2
Ábomínatíon,draenor,384,druid,feral,6,4,2
Ghettoven,kazzak,384,druid,feral,12,4,8
Турбокалясик,gordunni,384,druid,feral,12,4,8
Carridwyn,argent-dawn,384,druid,feral,12,4,8
Goatmeal,draenor,384,druid,feral,12,4,8
Ялория,azuregos,384,druid,feral,12,4,8
Sethread,ragnaros,384,druid,feral,12,4,8
Shiotake,hyjal,384,druid,feral,12,4,8
Notsad,dun-modr,384,druid,feral,12,4,8
Sekunden,ravencrest,384,druid,feral,12,4,8
Gediminas,argent-dawn,384,druid,feral,18,4,14
Plandros,draenor,384,druid,feral,18,4,14
Bearshift,aggra-português,383,druid,feral,6,4,2
Shuffey,frostmane,383,druid,feral,6,4,2
Tombenuit,tarren-mill,383,druid,feral,6,4,2
Tsukuyómi,ragnaros,383,druid,feral,6,4,2
Itzferal,durotan,383,druid,feral,9,4,5
Lutis,magtheridon,383,druid,feral,12,4,8
Malfyurion,ragnaros,383,druid,feral,12,4,8
Altramuz,uldum,382,druid,feral,6,4,2
Viølin,silvermoon,381,druid,feral,12,4,8
Verbat,cthun,379,druid,feral,12,4,8
Phandris,argent-dawn,379,druid,feral,12,4,8
Эвгедент,deathguard,379,druid,feral,24,4,20
Erelae,twisting-nether,352,druid,feral,10,4,6
Rakuy,thrall,352,druid,feral,10,4,6
Âltashamane,elune,351,druid,feral,11,4,7
Krekigaadzre,draenor,335,druid,feral,9,4,5
Wolfly,ravencrest,329,druid,feral,17,6,11
Броодяга,razuvious,319,druid,feral,5,4,1
Kärmä,eldrethalas,288,druid,feral,6,3,3
Nzmdruid,burning-legion,288,druid,feral,6,3,3
Biggestnick,ravencrest,288,druid,feral,6,3,3
Sylvy,dun-modr,288,druid,feral,6,3,3
Mooqt,alexstrasza,288,druid,feral,6,3,3
Apetino,dun-modr,288,druid,feral,6,3,3
Мивинчик,ashenvale,288,druid,feral,6,3,3
Shifthappens,dun-modr,288,druid,feral,6,3,3
Lunanikuya,ravencrest,288,druid,feral,6,3,3
Hipølita,zuljin,288,druid,feral,6,3,3
Shingeki,alonsus,288,druid,feral,6,3,3
Nefertiti,baelgun,288,druid,feral,6,3,3
Fallken,burning-blade,288,druid,feral,6,3,3
Kúùsh,frostwolf,288,druid,feral,6,3,3
Loafy,the-maelstrom,288,druid,feral,6,3,3
Fuzzylol,haomarush,288,druid,feral,6,3,3
Druiidou,dalaran,288,druid,feral,6,3,3
Fluffygoon,azjolnerub,288,druid,feral,6,3,3
Vãrima,ravencrest,288,druid,feral,6,3,3
Lyrasanna,argent-dawn,288,druid,feral,6,3,3
Madgazfanboi,ravencrest,288,druid,feral,6,3,3
Kovlian,argent-dawn,288,druid,feral,6,3,3
Zjukov,ragnaros,288,druid,feral,6,3,3
Ferpylul,ragnaros,288,druid,feral,6,3,3
Svass,ragnaros,288,druid,feral,6,3,3
Leidbulle,blackrock,288,druid,feral,6,3,3
Fearthecat,defias-brotherhood,288,druid,feral,6,3,3
Yepnesse,khaz-modan,288,druid,feral,6,3,3
Wildthing,blackmoore,288,druid,feral,6,3,3
Druidou,kaelthas,288,druid,feral,6,3,3
Telpha,onyxia,288,druid,feral,6,3,3
Carlitto,blackmoore,288,druid,feral,6,3,3
Veryfast,blackhand,288,druid,feral,6,3,3
Nightdruidcz,turalyon,288,druid,feral,6,3,3
Reservebär,blackhand,288,druid,feral,6,3,3
Moskaros,turalyon,288,druid,feral,6,3,3
Druidicchi,stormscale,288,druid,feral,6,3,3
Dianabigby,silvermoon,288,druid,feral,6,3,3
Moonpuff,kazzak,288,druid,feral,6,3,3
Feytique,aegwynn,288,druid,feral,6,3,3
Xercàs,outland,288,druid,feral,6,3,3
Aedui,tarren-mill,288,druid,feral,9,4,5
Zantill,chamber-of-aspects,288,druid,feral,7,3,4
Docmedlove,aegwynn,288,druid,feral,12,3,9
Lupa,drakthul,288,druid,feral,12,3,9
Лорья,azuregos,288,druid,feral,12,3,9
Ziovris,silvermoon,288,druid,feral,12,3,9
Kittyclâw,perenolde,288,druid,feral,12,3,9
Enylasi,hyjal,288,druid,feral,12,3,9
Trikill,hyjal,288,druid,feral,13,3,10
Klaerke,tarren-mill,288,druid,feral,18,3,15
Frincessa,burning-legion,288,druid,feral,18,3,15
Denadu,turalyon,288,druid,feral,18,3,15
Tallbutshort,stormscale,288,druid,feral,18,3,15
Jupter,burning-blade,287,druid,feral,6,3,3
Zaltaruk,sanguino,287,druid,feral,12,3,9
Kyth,forscherliga,287,druid,feral,12,3,9
Mistic,twisting-nether,287,druid,feral,12,3,9
Poxu,eredar,287,druid,feral,18,3,15
Bakar,ghostlands,286,druid,feral,6,3,3
Zhabka,silvermoon,286,druid,feral,6,3,3
Zottelmahne,blackrock,286,druid,feral,6,3,3
Wurnas,silvermoon,271,druid,feral,11,3,8
Диджейкошка,howling-fjord,239,druid,feral,5,3,2
Xarxius,sanguino,223,druid,feral,14,3,11
Metamø,blackrock,192,druid,feral,6,2,4
Кецян,gordunni,192,druid,feral,6,2,4
Shifts,the-maelstrom,192,druid,feral,6,2,4
Druiddamage,the-maelstrom,192,druid,feral,6,2,4
Pitchou,karazhan,192,druid,feral,6,2,4
Chikiz,ghostlands,192,druid,feral,6,2,4
Feralzeus,sylvanas,192,druid,feral,6,2,4
Mcservietsky,chogall,192,druid,feral,6,2,4
Спэкк,gordunni,192,druid,feral,6,2,4
Котфилин,gordunni,192,druid,feral,6,2,4
Kiizal,twisting-nether,192,druid,feral,6,2,4
Feralsaber,ghostlands,192,druid,feral,6,2,4
Вендьета,blackscar,192,druid,feral,6,2,4
Вохако,howling-fjord,192,druid,feral,6,2,4
Медверх,gordunni,192,druid,feral,6,2,4
Astlanes,ysondre,192,druid,feral,6,2,4
Wuzzington,outland,192,druid,feral,6,2,4
Nightfáll,tarren-mill,192,druid,feral,6,2,4
Treepoloski,stormscale,192,druid,feral,6,2,4
Glyn,earthen-ring,192,druid,feral,6,2,4
Kisskossa,stormscale,192,druid,feral,6,2,4
Glenn,alakir,192,druid,feral,6,2,4
Käissi,blackmoore,192,druid,feral,6,2,4
Aryitu,blackrock,192,druid,feral,6,2,4
Sandirion,silvermoon,192,druid,feral,6,2,4
Ephixa,burning-legion,192,druid,feral,6,2,4
Rabatout,eitrigg,192,druid,feral,6,2,4
Nidra,silvermoon,192,druid,feral,6,2,4
Voyerka,drakthul,192,druid,feral,6,2,4
Äcajou,hyjal,192,druid,feral,6,2,4
Ckelf,ravencrest,192,druid,feral,6,2,4
Savagehèals,ravencrest,192,druid,feral,6,2,4
Nelfboyuk,tarren-mill,192,druid,feral,6,2,4
Verbxp,kazzak,192,druid,feral,6,2,4
Melcow,eredar,192,druid,feral,6,2,4
Jåkeferalta,outland,192,druid,feral,6,2,4
Catwild,blackmoore,192,druid,feral,6,2,4
Coineagan,frostmourne,192,druid,feral,6,2,4
Citrus,sargeras,192,druid,feral,6,2,4
Sheiheda,kazzak,192,druid,feral,6,2,4
Bartax,culte-de-la-rive-noire,192,druid,feral,6,2,4
Docdruid,outland,192,druid,feral,6,2,4
Bóssít,doomhammer,192,druid,feral,6,2,4
Rabacki,blackmoore,192,druid,feral,6,2,4
Jimmyxdd,kazzak,192,druid,feral,6,2,4
Rottweiler,doomhammer,192,druid,feral,6,2,4
Speegle,kazzak,192,druid,feral,12,2,10
Affines,the-maelstrom,192,druid,feral,12,2,10
Älênkâ,drakthul,192,druid,feral,12,2,10
Amoveo,argent-dawn,192,druid,feral,12,2,10
Erelieva,silvermoon,192,druid,feral,12,2,10
Nkoyi,argent-dawn,192,druid,feral,12,2,10
Jompemanfish,stormscale,191,druid,feral,6,2,4
Ôpium,eldrethalas,191,druid,feral,6,2,4
Anyône,dun-morogh,191,druid,feral,6,2,4
Kittasek,drakthul,191,druid,feral,6,2,4
Loriann,twisting-nether,191,druid,feral,18,2,16
Meuhtéki,hyjal,190,druid,feral,7,3,4
Shadøwdruid,silvermoon,190,druid,feral,18,2,16
Ilyethea,earthen-ring,175,druid,feral,11,2,9
Carldroid,sylvanas,160,druid,feral,10,2,8
Korkskruven,draenor,159,druid,feral,5,2,3
Muryo,der-rat-von-dalaran,159,druid,feral,5,2,3
Azaría,aegwynn,128,druid,feral,4,2,2
Lionquokk,azjolnerub,128,druid,feral,4,2,2
Moderntalkin,aegwynn,96,druid,feral,17,4,13
Nicotex,draenor,96,druid,feral,6,1,5
Awán,aegwynn,96,druid,feral,6,1,5
Théodên,dalaran,96,druid,feral,6,1,5
Plàntz,tarren-mill,96,druid,feral,6,1,5
Tael,argent-dawn,96,druid,feral,6,1,5
Kuw,archimonde,96,druid,feral,6,1,5
Ãnimal,argent-dawn,96,druid,feral,6,1,5
Sabresheep,twisting-nether,96,druid,feral,6,1,5
Gurudru,tarren-mill,96,druid,feral,6,1,5
Мурталор,soulflayer,96,druid,feral,6,1,5
Bénjî,khazgoroth,96,druid,feral,6,1,5
Teám,tarren-mill,96,druid,feral,6,1,5
Terror,agamaggan,96,druid,feral,6,1,5
Nidrien,doomhammer,96,druid,feral,6,1,5
Haragmancs,arathor,96,druid,feral,6,1,5
Dash,the-maelstrom,96,druid,feral,6,1,5
Catgirlx,ravencrest,96,druid,feral,6,1,5
Ethryl,ravencrest,96,druid,feral,6,1,5
Saliencias,kazzak,96,druid,feral,6,1,5
Venomjr,bloodhoof,96,druid,feral,6,1,5
Heav,kiljaeden,96,druid,feral,6,1,5
Горртек,howling-fjord,96,druid,feral,6,1,5
Strand,ragnaros,96,druid,feral,6,1,5
Бабакошка,gordunni,96,druid,feral,6,1,5
Zinister,hyjal,96,druid,feral,6,1,5
Отхода,gordunni,96,druid,feral,6,1,5
Fabulous,genjuros,96,druid,feral,6,1,5
Ефомитстерша,gordunni,96,druid,feral,6,1,5
Хэрес,gordunni,96,druid,feral,6,1,5
Ragnai,emerald-dream,96,druid,feral,6,1,5
Greenfingerz,azjolnerub,96,druid,feral,6,1,5
Majesty,nagrand,96,druid,feral,6,1,5
Jamera,stormscale,96,druid,feral,6,1,5
Yarrp,stormscale,96,druid,feral,6,1,5
Zðe,la-croisade-écarlate,96,druid,feral,6,1,5
Thaneo,blackmoore,96,druid,feral,6,1,5
Markuslanz,blackrock,96,druid,feral,6,1,5
Maräanhatähr,silvermoon,96,druid,feral,6,1,5
Микайо,goldrinn,96,druid,feral,7,1,6
Farnae,kirin-tor,96,druid,feral,12,1,11
Taco,eredar,96,druid,feral,12,1,11
Veyronn,burning-legion,96,druid,feral,12,1,11
Mäywen,ravencrest,96,druid,feral,12,1,11
Bidodici,nemesis,95,druid,feral,6,1,5
Allîyâ,archimonde,79,druid,feral,5,1,4
Forigiver,draenor,64,druid,feral,4,1,3
Dubakoo,outland,64,druid,feral,4,1,3
Wadles,draenor,48,druid,feral,3,1,2
Aendy,tarren-mill,48,druid,feral,3,1,2
Merceý,ravencrest,2288,druid,balance,87,59,28
Fuséton,tarren-mill,2259,druid,balance,167,99,68
Bd,stormscale,2225,druid,balance,83,49,34
Immuz,kazzak,2215,druid,balance,101,55,46
Broccoliboy,sylvanas,2199,druid,balance,78,46,32
Eviscreator,stormscale,2148,druid,balance,114,76,38
Wriong,ravencrest,2147,druid,balance,112,68,44
Tmeister,kazzak,2145,druid,balance,84,50,34
Sleepyhallow,blackmoore,2142,druid,balance,100,58,42
Ackiz,ravencrest,2121,druid,balance,69,42,27
Thelire,silvermoon,2121,druid,balance,96,56,40
Skivesnulle,kazzak,2119,druid,balance,113,57,56
Deép,nazjatar,2106,druid,balance,84,45,39
Ôwlnur,kult-der-verdammten,2080,druid,balance,85,50,35
Mephîs,ravencrest,2078,druid,balance,76,49,27
Maroxd,stormscale,2069,druid,balance,42,34,8
Dincks,draenor,2068,druid,balance,71,47,24
Handsoff,stormscale,2065,druid,balance,120,65,55
Antahka,archimonde,2057,druid,balance,60,34,26
Shivany,twisting-nether,2045,druid,balance,106,53,53
Nutsnack,tarren-mill,2039,druid,balance,78,38,40
Batboomie,zuljin,2037,druid,balance,167,95,72
Jwrld,stormscale,2025,druid,balance,54,29,25
Méáckós,aegwynn,2025,druid,balance,104,52,52
Isatá,ravencrest,2024,druid,balance,54,36,18
Flanagân,hyjal,2020,druid,balance,42,26,16
Winkler,kazzak,2017,druid,balance,38,32,6
Howgh,destromath,2012,druid,balance,132,76,56
Oskol,tarren-mill,2004,druid,balance,52,29,23
Klimakleber,ravencrest,1997,druid,balance,135,67,68
Catchmê,archimonde,1993,druid,balance,62,36,26
Wizzlafa,ravencrest,1988,druid,balance,58,37,21
Владисзади,gordunni,1979,druid,balance,89,47,42
Karvajyrä,stormreaver,1972,druid,balance,162,96,66
Gurru,xavius,1967,druid,balance,78,45,33
Aggroasian,tarren-mill,1966,druid,balance,171,99,72
ßa,blackmoore,1960,druid,balance,59,38,21
Muufasa,blackmoore,1959,druid,balance,128,69,59
Vabore,twisting-nether,1956,druid,balance,60,35,25
Sunshinex,silvermoon,1956,druid,balance,78,43,35
Flæppy,blackmoore,1952,druid,balance,109,57,52
Turtleform,blackrock,1952,druid,balance,60,29,31
Knùbz,ravencrest,1950,druid,balance,47,27,20
Neirdá,hyjal,1949,druid,balance,131,79,52
Néllÿ,elune,1943,druid,balance,78,39,39
Shayia,aegwynn,1938,druid,balance,66,36,30
Positivîty,stormscale,1937,druid,balance,78,49,29
Transmangodx,tarren-mill,1923,druid,balance,60,38,22
Mooskie,draenor,1921,druid,balance,54,37,17
Fredhqt,tarren-mill,1918,druid,balance,59,37,22
Norgand,die-aldor,1915,druid,balance,24,20,4
Даирлин,gordunni,1913,druid,balance,106,52,54
Laserchicken,malganis,1912,druid,balance,95,47,48
Shåmss,kazzak,1910,druid,balance,36,23,13
Kruwkamilka,burning-legion,1906,druid,balance,64,38,26
Рейзакх,howling-fjord,1905,druid,balance,78,40,38
Secrägodx,ragnaros,1902,druid,balance,48,29,19
Zendda,hyjal,1896,druid,balance,61,30,31
Trntydr,senjin,1895,druid,balance,29,24,5
Malex,auchindoun,1895,druid,balance,54,32,22
Agagagagagag,ravencrest,1893,druid,balance,52,31,21
Votionex,tarren-mill,1891,druid,balance,64,38,26
Hppsr,eredar,1889,druid,balance,66,35,31
Fiskmåsn,twisting-nether,1887,druid,balance,102,63,39
Kankstery,stormscale,1882,druid,balance,65,44,21
Blopstar,stormscale,1879,druid,balance,54,34,20
Qtkitty,outland,1877,druid,balance,123,74,49
Sentería,sylvanas,1876,druid,balance,60,30,30
Crnkie,sylvanas,1873,druid,balance,24,20,4
Punxybear,ravencrest,1866,druid,balance,114,60,54
Zødzin,kazzak,1863,druid,balance,42,25,17
Ezeke,eredar,1863,druid,balance,54,28,26
Peaches,aerie-peak,1856,druid,balance,53,38,15
Starbro,grim-batol,1856,druid,balance,48,27,21
Afret,kazzak,1856,druid,balance,78,43,35
Newaccount,kazzak,1851,druid,balance,42,29,13
Ventrìx,alleria,1843,druid,balance,72,39,33
Арадия,gordunni,1843,druid,balance,66,35,31
Gipi,ravencrest,1843,druid,balance,60,31,29
Hrz,kazzak,1839,druid,balance,79,50,29
Starfallkey,dun-modr,1839,druid,balance,99,61,38
Pluginbaby,stormscale,1838,druid,balance,64,41,23
Tjillevippen,tarren-mill,1836,druid,balance,36,23,13
Небесныйхант,soulflayer,1834,druid,balance,71,37,34
Zuterlø,ragnaros,1834,druid,balance,54,28,26
Nuvemone,stormscale,1831,druid,balance,84,48,36
Mopboomkin,twisting-nether,1828,druid,balance,48,29,19
Bearpawzz,kazzak,1823,druid,balance,48,29,19
Mirynn,elune,1823,druid,balance,121,63,58
Nyndrà,archimonde,1823,druid,balance,99,48,51
Faxotium,argent-dawn,1822,druid,balance,30,21,9
Moonhusky,blackrock,1817,druid,balance,54,34,20
Captaïn,twisting-nether,1816,druid,balance,36,27,9
Lunahu,argent-dawn,1816,druid,balance,72,42,30
Astrobazooka,stormreaver,1815,druid,balance,77,48,29
Wrathgodx,aegwynn,1814,druid,balance,36,24,12
Didiee,kazzak,1814,druid,balance,54,31,23
Bákhar,ravencrest,1813,druid,balance,42,23,19
Hyac,the-maelstrom,1811,druid,balance,36,26,10
Juicypus,ragnaros,1809,druid,balance,48,29,19
Win,hellscream,1809,druid,balance,48,25,23
Ferawri,draenor,1808,druid,balance,42,24,18
Ghostpaws,ravencrest,1807,druid,balance,48,26,22
Slaugh,zuljin,1807,druid,balance,66,32,34
Icek,outland,1806,druid,balance,54,33,21
Hunkex,frostmane,1806,druid,balance,45,24,21
Cøntrol,argent-dawn,1804,druid,balance,60,34,26
Ruetinjeri,blackmoore,1804,druid,balance,73,38,35
Greenful,drakthul,1801,druid,balance,24,19,5
Disvikz,outland,1801,druid,balance,48,29,19
Geîl,blackrock,1801,druid,balance,42,24,18
Abyssaldepth,ravencrest,1800,druid,balance,54,44,10
Trekkertt,zuljin,1784,druid,balance,53,28,25
Травкер,howling-fjord,1784,druid,balance,107,51,56
Jenovas,argent-dawn,1778,druid,balance,45,25,20
Mesmerizing,ravencrest,1776,druid,balance,36,23,13
Darktigrou,archimonde,1775,druid,balance,30,21,9
Rexonadudu,kazzak,1775,druid,balance,81,46,35
Dyroxs,twisting-nether,1774,druid,balance,77,38,39
Meowcry,outland,1771,druid,balance,54,32,22
Kirexz,blackrock,1767,druid,balance,36,27,9
Shiftowl,tarren-mill,1766,druid,balance,36,25,11
Сосисосочка,gordunni,1763,druid,balance,42,20,22
Ganqb,ravencrest,1761,druid,balance,234,132,102
Maijs,ravencrest,1758,druid,balance,54,26,28
Babynaty,ravencrest,1756,druid,balance,158,77,81
Xyzy,burning-legion,1753,druid,balance,48,28,20
Dudukid,nemesis,1753,druid,balance,60,28,32
Izhusky,ravencrest,1751,druid,balance,29,21,8
Pyaw,kazzak,1750,druid,balance,36,26,10
Calê,blackrock,1747,druid,balance,57,39,18
Ånaðeårmas,outland,1746,druid,balance,77,47,30
Limme,ravencrest,1741,druid,balance,46,32,14
Meowmf,silvermoon,1739,druid,balance,60,39,21
Laker,stormscale,1737,druid,balance,41,21,20
Сибирячечка,greymane,1736,druid,balance,60,36,24
Emmdru,silvermoon,1734,druid,balance,59,37,22
Tobid,blackrock,1732,druid,balance,36,26,10
Atrosity,ravencrest,1732,druid,balance,48,29,19
Credenz,frostmane,1732,druid,balance,72,39,33
Трэйкотик,blackscar,1728,druid,balance,53,32,21
Gulmi,outland,1728,druid,balance,47,28,19
Pouletqt,archimonde,1723,druid,balance,42,21,21
Hugeragê,stormreaver,1720,druid,balance,47,22,25
Kalgarm,burning-legion,1719,druid,balance,66,29,37
Qtrly,ravencrest,1718,druid,balance,38,19,19
Quadpulse,ravencrest,1718,druid,balance,36,18,18
Pwnylol,teldrassil,1716,druid,balance,64,43,21
Mendorin,stormrage,1714,druid,balance,42,26,16
Jamzydruid,kazzak,1713,druid,balance,54,30,24
Владибой,gordunni,1712,druid,balance,36,18,18
Bastodonte,skullcrusher,1711,druid,balance,79,42,37
Dizay,xavius,1709,druid,balance,42,27,15
Grisdrood,draenor,1706,druid,balance,125,66,59
Thardruid,stormscale,1699,druid,balance,72,42,30
Htxo,kazzak,1698,druid,balance,30,18,12
Néxct,stormscale,1688,druid,balance,36,22,14
Solariah,garona,1688,druid,balance,125,71,54
Kenzia,stormrage,1687,druid,balance,30,18,12
Elissian,silvermoon,1686,druid,balance,125,68,57
Rngmåchinéx,ravencrest,1685,druid,balance,85,57,28
Gallokiriko,zuljin,1684,druid,balance,48,23,25
Zkrd,kazzak,1678,druid,balance,48,25,23
Highonfire,grim-batol,1676,druid,balance,60,41,19
Øncê,durotan,1670,druid,balance,36,19,17
Мэдикейт,soulflayer,1668,druid,balance,54,33,21
Drcaøs,sanguino,1668,druid,balance,84,47,37
Akinimod,ravencrest,1664,druid,balance,38,23,15
Рябчиик,blackscar,1663,druid,balance,36,22,14
Даена,razuvious,1662,druid,balance,24,19,5
Större,twisting-nether,1662,druid,balance,36,27,9
Yuhor,outland,1661,druid,balance,59,34,25
Narq,sylvanas,1660,druid,balance,36,21,15
Shapeshift,sanguino,1659,druid,balance,62,34,28
Møømøø,tarren-mill,1658,druid,balance,30,18,12
Shaakm,nerathor,1656,druid,balance,54,32,22
Xora,kazzak,1656,druid,balance,53,28,25
Jaycutler,archimonde,1655,druid,balance,60,31,29
Metamoo,tarren-mill,1651,druid,balance,29,24,5
Justyo,archimonde,1648,druid,balance,29,22,7
Mochiløxz,tarren-mill,1644,druid,balance,38,26,12
Hyunâ,dalaran,1644,druid,balance,42,27,15
Øffroadz,blackmoore,1643,druid,balance,30,20,10
Saufeb,stormscale,1643,druid,balance,41,23,18
Pradasurge,ravencrest,1642,druid,balance,149,81,68
Rek,sanguino,1641,druid,balance,39,20,19
Yarinai,blackmoore,1637,druid,balance,54,29,25
Derfaï,kaelthas,1636,druid,balance,41,21,20
Deví,twilights-hammer,1634,druid,balance,48,30,18
Naturalbeef,argent-dawn,1634,druid,balance,40,22,18
Settembre,ragnaros,1633,druid,balance,33,22,11
Rekked,alleria,1631,druid,balance,42,23,19
Masakrelol,sanguino,1631,druid,balance,36,18,18
Squirtdogx,drakthul,1630,druid,balance,30,17,13
Миртлэкшн,gordunni,1628,druid,balance,43,22,21
Èøèøèøèøè,stormscale,1627,druid,balance,18,17,1
Scaleo,stormreaver,1627,druid,balance,42,19,23
Bulla,culte-de-la-rive-noire,1626,druid,balance,38,22,16
Bigtouch,draenor,1625,druid,balance,48,29,19
Mäismz,hyjal,1624,druid,balance,42,29,13
Лсдспайсы,soulflayer,1623,druid,balance,36,21,15
Moonzysunzy,sylvanas,1620,druid,balance,30,17,13
Landesverrat,kazzak,1619,druid,balance,24,21,3
Nastyclones,kazzak,1619,druid,balance,24,17,7
Whisker,outland,1618,druid,balance,24,17,7
Zapx,hyjal,1618,druid,balance,42,25,17
Linkin,azshara,1618,druid,balance,60,29,31
Dràkàn,dethecus,1613,druid,balance,30,17,13
Exilara,twisting-nether,1612,druid,balance,61,38,23
Carnivals,twisting-nether,1612,druid,balance,30,17,13
Pëchy,aggra-português,1611,druid,balance,48,30,18
Xenuss,kazzak,1611,druid,balance,36,22,14
Онличикен,gordunni,1611,druid,balance,72,32,40
Trinket,frostmane,1610,druid,balance,30,23,7
Аласторвов,deathweaver,1610,druid,balance,60,28,32
Deadmeøw,outland,1609,druid,balance,34,21,13
Píøøx,tarren-mill,1607,druid,balance,48,31,17
Rode,magtheridon,1607,druid,balance,93,57,36
Ryng,nagrand,1606,druid,balance,60,41,19
Porzi,eredar,1605,druid,balance,54,35,19
Угощаюх,howling-fjord,1604,druid,balance,24,17,7
Xä,bloodscalp,1604,druid,balance,136,75,61
Gudñ,tarren-mill,1603,druid,balance,35,19,16
Kkona,silvermoon,1603,druid,balance,59,31,28
Goom,rexxar,1602,druid,balance,168,101,67
Hotlife,ravencrest,1601,druid,balance,32,19,13
Güccïmane,twisting-nether,1599,druid,balance,54,41,13
Rá,outland,1599,druid,balance,28,21,7
Esrín,the-maelstrom,1599,druid,balance,54,28,26
Milkywáys,draenor,1599,druid,balance,54,28,26
Eärendir,ravencrest,1595,druid,balance,84,47,37
Naturez,sylvanas,1594,druid,balance,36,17,19
Malfurien,magtheridon,1593,druid,balance,30,17,13
Saltymoo,tarren-mill,1589,druid,balance,41,24,17
Ôp,aegwynn,1589,druid,balance,65,31,34
Veyronn,burning-legion,1586,druid,balance,48,25,23
Cyriaan,eredar,1585,druid,balance,39,22,17
Kokslina,sylvanas,1580,druid,balance,35,17,18
Bøøstèdtréè,ravencrest,1576,druid,balance,30,18,12
Isylia,twisting-nether,1576,druid,balance,66,32,34
Døttore,garona,1575,druid,balance,62,31,31
Damigjat,sylvanas,1574,druid,balance,89,58,31
Merawr,ravencrest,1573,druid,balance,129,66,63
Pneuma,xavius,1571,druid,balance,57,31,26
Imperiusx,ravencrest,1570,druid,balance,30,17,13
Stinkyicky,sylvanas,1569,druid,balance,36,25,11
Obsessíon,kazzak,1566,druid,balance,30,17,13
Ícekiss,hyjal,1563,druid,balance,24,20,4
Balanc,ragnaros,1563,druid,balance,53,28,25
Oommis,outland,1562,druid,balance,30,18,12
Shreedex,blackmoore,1561,druid,balance,24,18,6
Elodìa,antonidas,1561,druid,balance,30,21,9
Starcrash,amanthul,1559,druid,balance,60,28,32
Ittei,korgall,1558,druid,balance,30,19,11
Bashmac,mugthol,1557,druid,balance,36,22,14
Каралесер,gordunni,1555,druid,balance,53,29,24
Däkk,draenor,1551,druid,balance,48,24,24
Баттнэйкед,gordunni,1551,druid,balance,83,41,42
Cantdonothig,ravencrest,1550,druid,balance,90,50,40
Зетзул,grom,1550,druid,balance,119,59,60
Wildmistake,argent-dawn,1550,druid,balance,35,17,18
Algír,argent-dawn,1545,druid,balance,71,35,36
Frikolina,outland,1542,druid,balance,48,24,24
Malvakten,kazzak,1539,druid,balance,104,47,57
Iamobito,blackmoore,1535,druid,balance,24,16,8
Izzi,arathor,1534,druid,balance,42,24,18
Druidflight,ravencrest,1534,druid,balance,48,24,24
Majokz,ravencrest,1532,druid,balance,58,28,30
Hashishi,grim-batol,1531,druid,balance,30,18,12
Starcowx,ragnaros,1530,druid,balance,30,18,12
Slahnesh,aegwynn,1526,druid,balance,24,16,8
Tárzáñ,ravencrest,1525,druid,balance,24,16,8
Lisbethqt,nemesis,1523,druid,balance,24,16,8
Rbgkári,draenor,1519,druid,balance,24,16,8
Chansnax,thrall,1519,druid,balance,52,29,23
Exca,stormscale,1519,druid,balance,54,28,26
Brainjuice,blackrock,1517,druid,balance,30,16,14
Ðelix,ysera,1516,druid,balance,44,27,17
Quorn,pozzo-delleternità,1515,druid,balance,52,25,27
Bobcup,tarren-mill,1514,druid,balance,36,20,16
Ahuevshiy,wildhammer,1512,druid,balance,24,16,8
Cowgurl,stormscale,1511,druid,balance,30,16,14
Мунстрайк,borean-tundra,1505,druid,balance,23,16,7
Gurudru,tarren-mill,1505,druid,balance,96,41,55
Dreathqt,twisting-nether,1501,druid,balance,42,16,26
Kabuul,dun-modr,1498,druid,balance,37,25,12
Trylune,blackmoore,1498,druid,balance,30,17,13
Thcpositiv,aegwynn,1496,druid,balance,42,16,26
Horadruid,silvermoon,1495,druid,balance,120,68,52
Гнетея,howling-fjord,1494,druid,balance,47,27,20
Бамболони,gordunni,1488,druid,balance,45,30,15
Kåmen,ravenholdt,1488,druid,balance,55,30,25
Dematos,forscherliga,1487,druid,balance,78,46,32
Муниня,gordunni,1485,druid,balance,42,23,19
Arkatt,outland,1482,druid,balance,36,24,12
Mahist,archimonde,1478,druid,balance,36,23,13
Aègon,ravencrest,1478,druid,balance,61,35,26
Demonbalance,silvermoon,1477,druid,balance,52,33,19
Tonutc,sanguino,1470,druid,balance,30,17,13
Kolt,rajaxx,1467,druid,balance,45,23,22
Strinx,ragnaros,1461,druid,balance,48,35,13
Мантоя,gordunni,1461,druid,balance,35,22,13
Meatwallet,defias-brotherhood,1460,druid,balance,41,24,17
Drøøkîé,antonidas,1453,druid,balance,48,31,17
Moffwastaken,kazzak,1453,druid,balance,42,17,25
Asterism,stormscale,1452,druid,balance,57,35,22
Carismatic,blackmoore,1452,druid,balance,54,28,26
Séxycàt,ravencrest,1451,druid,balance,63,33,30
Brandyballix,twisting-nether,1450,druid,balance,47,21,26
Viverion,ravencrest,1445,druid,balance,36,19,17
Æøøm,blackmoore,1444,druid,balance,29,16,13
Tawaraki,outland,1444,druid,balance,156,84,72
Pø,blackrock,1443,druid,balance,53,26,27
Duridlol,nemesis,1439,druid,balance,18,15,3
Ðiàblos,nemesis,1439,druid,balance,42,29,13
Lappe,stormreaver,1439,druid,balance,30,15,15
Wwboomy,kazzak,1439,druid,balance,30,15,15
Bîjaqt,blackmoore,1437,druid,balance,24,15,9
Shakso,stormscale,1434,druid,balance,24,15,9
Uglyrasputin,blackmoore,1434,druid,balance,95,49,46
Øhmygød,stormscale,1433,druid,balance,30,15,15
Sodapop,aszune,1431,druid,balance,36,23,13
Ibnform,archimonde,1429,druid,balance,18,15,3
Cmfg,blackrock,1429,druid,balance,21,16,5
Magiskeforme,draenor,1429,druid,balance,24,17,7
Kaïnak,dalaran,1427,druid,balance,24,15,9
Ziele,the-maelstrom,1427,druid,balance,28,17,11
Подпивасникх,gordunni,1424,druid,balance,24,15,9
Rilak,nordrassil,1424,druid,balance,30,18,12
Anabola,frostwhisper,1423,druid,balance,24,15,9
Inghlo,blackmoore,1423,druid,balance,47,26,21
Petiteorange,archimonde,1420,druid,balance,24,16,8
Guthíx,silvermoon,1420,druid,balance,36,16,20
Kanataka,stormscale,1418,druid,balance,42,26,16
Aik,gorgonnash,1417,druid,balance,48,23,25
Suevlaki,ragnaros,1416,druid,balance,31,21,10
Møønhorn,nemesis,1416,druid,balance,62,29,33
Ххансолл,gordunni,1411,druid,balance,54,35,19
Mogi,pozzo-delleternità,1411,druid,balance,69,32,37
Sefinana,malganis,1411,druid,balance,81,33,48
Primdâhl,ravencrest,1407,druid,balance,30,16,14
Insølitø,sanguino,1406,druid,balance,51,27,24
Leqt,ravencrest,1406,druid,balance,30,15,15
Fruitdealer,antonidas,1404,druid,balance,36,20,16
Bløødax,hyjal,1404,druid,balance,124,61,63
Cupoftea,drakthul,1403,druid,balance,33,19,14
Boomalot,auchindoun,1399,druid,balance,48,25,23
Chrevarraige,saurfang,1394,druid,balance,54,31,23
Blackfür,sylvanas,1387,druid,balance,44,17,27
Rédbull,outland,1379,druid,balance,70,36,34
Neova,dun-modr,1375,druid,balance,33,18,15
Матумбо,razuvious,1369,druid,balance,142,68,74
Darksbear,draenor,1368,druid,balance,24,16,8
Pøpp,archimonde,1367,druid,balance,23,15,8
Hammd,kazzak,1366,druid,balance,26,15,11
Niul,aegwynn,1366,druid,balance,62,32,30
Heanra,frostmane,1363,druid,balance,35,22,13
Джоннчек,gordunni,1355,druid,balance,28,19,9
Yiradur,stormscale,1355,druid,balance,38,18,20
Andreud,dunemaul,1354,druid,balance,35,15,20
Кекичшрекич,soulflayer,1349,druid,balance,42,20,22
Bum,ravencrest,1344,druid,balance,18,14,4
Divref,tarren-mill,1343,druid,balance,18,14,4
Lilpumpz,outland,1343,druid,balance,24,14,10
Broxisqt,blackrock,1343,druid,balance,24,14,10
Bittebads,stormscale,1342,druid,balance,18,14,4
Rosskemp,tarren-mill,1342,druid,balance,18,14,4
Ccoco,aegwynn,1342,druid,balance,18,14,4
Escaa,stormscale,1342,druid,balance,24,14,10
Kabôôm,stormscale,1342,druid,balance,24,14,10
Kjøttberit,moonglade,1340,druid,balance,18,14,4
Альмазар,lich-king,1339,druid,balance,42,22,20
Fhi,antonidas,1338,druid,balance,30,19,11
Tanduriel,ravencrest,1337,druid,balance,35,21,14
Zerozerosex,archimonde,1336,druid,balance,30,14,16
Krtt,tarren-mill,1336,druid,balance,58,23,35
Gehrkehotter,silvermoon,1332,druid,balance,18,14,4
Soward,la-croisade-écarlate,1331,druid,balance,38,17,21
Irishdemón,ravencrest,1329,druid,balance,48,25,23
Hisoca,tarren-mill,1328,druid,balance,49,28,21
Бонони,booty-bay,1328,druid,balance,30,14,16
Wazam,kazzak,1325,druid,balance,26,19,7
Редмун,soulflayer,1325,druid,balance,42,19,23
Wildthing,blackmoore,1316,druid,balance,44,25,19
Czarnykocur,burning-legion,1310,druid,balance,54,28,26
Hypam,archimonde,1310,druid,balance,30,14,16
Santoniq,dun-morogh,1310,druid,balance,54,24,30
Klappskaft,outland,1309,druid,balance,23,14,9
Haginator,twisting-nether,1306,druid,balance,90,43,47
Solarian,ravencrest,1304,druid,balance,42,26,16
Asinistar,ravencrest,1303,druid,balance,26,15,11
Madhatterr,kazzak,1302,druid,balance,24,14,10
Hardí,tarren-mill,1295,druid,balance,54,26,28
Callmev,hyjal,1294,druid,balance,18,14,4
Quiksx,blackrock,1286,druid,balance,43,20,23
Xclonedotcom,aegwynn,1283,druid,balance,24,16,8
Droodfarm,hyjal,1274,druid,balance,18,14,4
Convokeboost,archimonde,1273,druid,balance,47,32,15
Meezy,ragnaros,1273,druid,balance,30,15,15
Druidere,outland,1262,druid,balance,54,23,31
Zeifana,khaz-modan,1260,druid,balance,24,15,9
Vrill,kazzak,1257,druid,balance,57,30,27
Medreas,argent-dawn,1253,druid,balance,65,43,22
Superchïcken,archimonde,1247,druid,balance,24,13,11
Legitx,dentarg,1246,druid,balance,18,13,5
Taylorshîft,burning-legion,1244,druid,balance,30,13,17
Kroaxs,draenor,1243,druid,balance,30,16,14
Smittly,bloodhoof,1243,druid,balance,36,17,19
Kittyboomy,burning-blade,1242,druid,balance,63,30,33
Kubzii,archimonde,1239,druid,balance,24,13,11
Euphørie,twisting-nether,1238,druid,balance,18,13,5
Mayhh,ragnaros,1236,druid,balance,49,28,21
Cptsponksa,tarren-mill,1235,druid,balance,24,13,11
Halouest,archimonde,1234,druid,balance,24,13,11
Мунмунмун,gordunni,1229,druid,balance,43,19,24
Chillerin,draenor,1228,druid,balance,24,13,11
Psycloniac,ravencrest,1228,druid,balance,24,13,11
Limmiited,ravencrest,1228,druid,balance,30,16,14
Oxox,defias-brotherhood,1227,druid,balance,24,14,10
Druiddamage,the-maelstrom,1227,druid,balance,114,57,57
Slurmms,sylvanas,1220,druid,balance,102,62,40
Слоич,howling-fjord,1220,druid,balance,33,15,18
Seudoz,silvermoon,1217,druid,balance,24,13,11
Àlec,silvermoon,1217,druid,balance,114,61,53
Ðrpressure,blackrock,1209,druid,balance,18,13,5
Шадарлогот,gordunni,1209,druid,balance,72,40,32
Cagaboliches,sanguino,1208,druid,balance,30,14,16
Eliaster,ysondre,1204,druid,balance,30,18,12
Pultsarí,tarren-mill,1199,druid,balance,21,13,8
Jeesman,sylvanas,1198,druid,balance,36,19,17
Shåmssz,kazzak,1194,druid,balance,20,15,5
Lazerbinks,blackmoore,1188,druid,balance,23,13,10
Itadorikun,silvermoon,1186,druid,balance,24,13,11
Киллиманжаро,howling-fjord,1186,druid,balance,74,32,42
Chulainn,sylvanas,1181,druid,balance,24,18,6
Avior,eonar,1178,druid,balance,47,14,33
Farodiin,blackmoore,1177,druid,balance,48,18,30
Rullader,draenor,1176,druid,balance,24,15,9
Fantaclause,tarren-mill,1176,druid,balance,69,31,38
Forestrun,sylvanas,1174,druid,balance,30,17,13
Maelinou,archimonde,1168,druid,balance,36,19,17
Bearcosby,burning-legion,1160,druid,balance,23,13,10
Rexiehunty,aszune,1155,druid,balance,35,13,22
Gnotten,thunderhorn,1154,druid,balance,23,13,10
Ferraridudux,ravencrest,1152,druid,balance,12,12,0
Feelstreeman,twisting-nether,1152,druid,balance,18,12,6
Minado,outland,1151,druid,balance,12,12,0
Âlhajillo,dun-modr,1151,druid,balance,24,12,12
Bigbaddream,stormscale,1150,druid,balance,18,12,6
Potatodru,ragnaros,1150,druid,balance,18,12,6
Pvekek,stormscale,1150,druid,balance,18,12,6
Owenwilson,twisting-nether,1149,druid,balance,18,12,6
Nujus,kazzak,1146,druid,balance,24,12,12
Ashär,kirin-tor,1146,druid,balance,75,33,42
Lillevän,tarren-mill,1145,druid,balance,24,12,12
Ðoxi,draenor,1145,druid,balance,84,37,47
Лёхалепеха,gordunni,1144,druid,balance,24,12,12
Requinymph,ravencrest,1141,druid,balance,24,12,12
Loriann,twisting-nether,1141,druid,balance,75,36,39
Pavesino,nemesis,1140,druid,balance,18,12,6
Shiotake,hyjal,1139,druid,balance,24,12,12
Mascraxx,earthen-ring,1137,druid,balance,43,19,24
Tankis,dalaran,1128,druid,balance,36,23,13
Deblin,ragnaros,1119,druid,balance,29,16,13
Melyo,blackmoore,1119,druid,balance,24,13,11
Braokhull,stormscale,1111,druid,balance,30,14,16
Morlas,kazzak,1111,druid,balance,50,22,28
Hightotem,hakkar,1104,druid,balance,29,16,13
Durkdriven,kazzak,1100,druid,balance,27,12,15
Vaacku,stormreaver,1082,druid,balance,22,12,10
Søfiaa,argent-dawn,1074,druid,balance,59,34,25
Buckshee,doomhammer,1066,druid,balance,47,25,22
Whiskers,emerald-dream,1066,druid,balance,25,12,13
Cubir,turalyon,1065,druid,balance,23,12,11
Exiztenz,deathwing,1062,druid,balance,36,18,18
Tjoepert,azjolnerub,1061,druid,balance,60,20,40
Sheâ,nemesis,1060,druid,balance,30,12,18
Øwlkin,ravencrest,1056,druid,balance,18,11,7
Jazzme,aegwynn,1056,druid,balance,18,11,7
Drmoe,blackmoore,1055,druid,balance,15,12,3
Huxleyys,draenor,1055,druid,balance,18,11,7
Cptnclone,blackmoore,1055,druid,balance,18,11,7
Rootzxx,ravencrest,1055,druid,balance,18,11,7
Stb,outland,1055,druid,balance,18,11,7
Tuttu,kazzak,1055,druid,balance,18,11,7
Buckmysallz,archimonde,1055,druid,balance,18,11,7
Çhîñêséðrüîð,kazzak,1055,druid,balance,18,11,7
Neverpanic,stormscale,1054,druid,balance,18,11,7
Amoveo,argent-dawn,1053,druid,balance,18,11,7
Druidka,grim-batol,1053,druid,balance,18,11,7
Teaser,dun-modr,1053,druid,balance,24,11,13
Diggear,doomhammer,1052,druid,balance,18,11,7
Drutiful,outland,1052,druid,balance,24,11,13
Egirlqtxoxo,stormscale,1051,druid,balance,18,11,7
Bashfui,draenor,1050,druid,balance,18,11,7
Aimwaré,ravencrest,1050,druid,balance,24,11,13
Couleaf,stormscale,1049,druid,balance,13,11,2
Soguu,thrall,1049,druid,balance,18,11,7
Skyphi,silvermoon,1048,druid,balance,18,11,7
Pfandmalle,blackrock,1046,druid,balance,18,11,7
Rorugo,sanguino,1044,druid,balance,18,11,7
Rektjin,stormscale,1043,druid,balance,24,11,13
Hárty,tarren-mill,1035,druid,balance,24,11,13
Anerol,arthas,1031,druid,balance,36,19,17
Diepauline,aegwynn,1030,druid,balance,42,22,20
Ronî,arthas,1028,druid,balance,30,11,19
Exactt,blackrock,1028,druid,balance,30,11,19
Darisom,alexstrasza,1016,druid,balance,105,58,47
Bullmarkets,kazzak,1013,druid,balance,24,12,12
Медведяра,howling-fjord,1009,druid,balance,33,15,18
Kotomer,defias-brotherhood,997,druid,balance,96,35,61
Smexim,dalaran,996,druid,balance,41,21,20
Ледруд,gordunni,991,druid,balance,26,11,15
Skvll,silvermoon,987,druid,balance,26,11,15
Wildanomaly,argent-dawn,986,druid,balance,22,11,11
Bulvai,medivh,979,druid,balance,14,11,3
Воому,soulflayer,960,druid,balance,12,10,2
Ymagyne,frostmane,960,druid,balance,18,10,8
Rozi,draenor,960,druid,balance,18,10,8
Starsy,frostmane,960,druid,balance,18,10,8
Björnskift,tarren-mill,960,druid,balance,18,10,8
Boomky,blackmoore,960,druid,balance,18,10,8
Feralisser,ravencrest,959,druid,balance,12,10,2
Drooshy,ravencrest,959,druid,balance,15,11,4
Tiktokstar,blackrock,959,druid,balance,18,10,8
Fantomasik,drakthul,959,druid,balance,24,10,14
Сансплэш,lich-king,958,druid,balance,12,10,2
Thepuma,dun-modr,958,druid,balance,12,10,2
Élán,sylvanas,958,druid,balance,18,10,8
Tâliah,silvermoon,958,druid,balance,18,10,8
Monkeynight,ambossar,958,druid,balance,20,10,10
Verenai,bloodfeather,957,druid,balance,12,10,2
Buhuu,blackmoore,957,druid,balance,18,10,8
Brokul,kazzak,957,druid,balance,24,10,14
Restouz,twisting-nether,956,druid,balance,24,10,14
Nøny,gorgonnash,955,druid,balance,18,10,8
Sajlol,doomhammer,955,druid,balance,18,10,8
Seysso,silvermoon,955,druid,balance,24,10,14
Velnens,shattered-halls,953,druid,balance,18,10,8
Gluqt,outland,953,druid,balance,18,10,8
Ilovedruid,forscherliga,953,druid,balance,22,11,11
Bolskigg,stormreaver,953,druid,balance,24,10,14
Оудин,blackscar,952,druid,balance,18,10,8
Hypnosoad,outland,951,druid,balance,24,10,14
Cöyote,hyjal,948,druid,balance,42,23,19
Yepnesse,khaz-modan,946,druid,balance,18,10,8
Resthunor,draenor,935,druid,balance,18,10,8
Calistane,silvermoon,935,druid,balance,36,11,25
Лякокля,soulflayer,933,druid,balance,24,10,14
Naone,silvermoon,929,druid,balance,24,10,14
Mööñ,hyjal,917,druid,balance,16,11,5
Ryuzu,aegwynn,910,druid,balance,17,10,7
Théodên,dalaran,910,druid,balance,80,36,44
Суггуторр,howling-fjord,909,druid,balance,87,42,45
Kakaiy,shadowsong,908,druid,balance,18,11,7
Melyssea,argent-dawn,905,druid,balance,21,11,10
Troc,karazhan,864,druid,balance,12,9,3
Bakkú,ravencrest,864,druid,balance,12,9,3
Ravneskrig,ravencrest,864,druid,balance,12,9,3
Juvencus,twisting-nether,864,druid,balance,12,9,3
Друлякич,gordunni,864,druid,balance,18,9,9
Stepgødx,twisting-nether,864,druid,balance,18,9,9
Jøkèr,outland,864,druid,balance,18,9,9
Blanoz,ravencrest,864,druid,balance,24,9,15
Kénshin,blackhand,863,druid,balance,12,9,3
Aolynk,twisting-nether,863,druid,balance,12,9,3
Merq,ravencrest,863,druid,balance,12,9,3
Pezuñera,sanguino,863,druid,balance,12,9,3
Dantet,the-maelstrom,863,druid,balance,18,9,9
Croquetoro,sanguino,863,druid,balance,18,9,9
Empi,sanguino,863,druid,balance,18,9,9
Bxxmkin,draenor,862,druid,balance,12,9,3
Metaboss,ravencrest,862,druid,balance,18,9,9
Angharradh,arthas,862,druid,balance,18,9,9
Mindruid,kazzak,862,druid,balance,18,9,9
Gstahr,taerar,862,druid,balance,18,9,9
Амахасла,deathweaver,861,druid,balance,12,9,3
Fruntimmern,sylvanas,861,druid,balance,18,9,9
Астраджет,gordunni,860,druid,balance,18,9,9
Corias,blackmoore,859,druid,balance,24,9,15
Megaball,sylvanas,857,druid,balance,12,9,3
Lunably,silvermoon,855,druid,balance,18,9,9
Rockymarci,dalaran,840,druid,balance,12,9,3
Pretender,arathi,829,druid,balance,22,9,13
Corrupthz,outland,814,druid,balance,11,9,2
Dotclass,outland,799,druid,balance,14,9,5
Kribie,aegwynn,768,druid,balance,12,8,4
Djfukface,ravencrest,768,druid,balance,12,8,4
Aleza,tarren-mill,768,druid,balance,12,8,4
Jometatile,hyjal,768,druid,balance,12,8,4
Клыкояр,goldrinn,768,druid,balance,12,8,4
Àspro,hyjal,768,druid,balance,12,8,4
Celtimi,antonidas,768,druid,balance,12,8,4
Rifthy,nemesis,768,druid,balance,12,8,4
Ylmh,archimonde,768,druid,balance,12,8,4
Kissaey,emeriss,768,druid,balance,12,8,4
Elgatos,kazzak,768,druid,balance,12,8,4
Boompjeh,chamber-of-aspects,768,druid,balance,18,8,10
Restromide,ravencrest,768,druid,balance,18,8,10
Shroomdoom,ravencrest,768,druid,balance,18,8,10
Sylvy,dun-modr,768,druid,balance,18,8,10
Ljóskan,kazzak,768,druid,balance,24,8,16
Sagezza,draenor,767,druid,balance,12,8,4
Numberonebs,silvermoon,767,druid,balance,12,8,4
Goüsta,archimonde,767,druid,balance,12,8,4
Insanexp,antonidas,767,druid,balance,12,8,4
Кортанус,gordunni,767,druid,balance,12,8,4
Scamlafsen,ragnaros,767,druid,balance,18,8,10
Ilovehannah,laughing-skull,767,druid,balance,18,8,10
Àsúnâ,eredar,767,druid,balance,18,8,10
Zoxen,nefarian,767,druid,balance,18,8,10
Loswochos,blackmoore,767,druid,balance,18,8,10
Sylindra,argent-dawn,767,druid,balance,18,8,10
Winarchikxxl,tarren-mill,767,druid,balance,18,8,10
Farmerone,tarren-mill,765,druid,balance,12,8,4
When,kirin-tor,765,druid,balance,18,8,10
Machie,argent-dawn,765,druid,balance,18,8,10
Fillet,aggra-português,764,druid,balance,12,8,4
Сейтил,deathguard,764,druid,balance,18,8,10
Nømat,defias-brotherhood,763,druid,balance,12,8,4
Druice,tyrande,763,druid,balance,12,8,4
Кулунхе,soulflayer,763,druid,balance,12,8,4
Orchard,silvermoon,762,druid,balance,12,8,4
Laiquaril,ravencrest,762,druid,balance,25,8,17
Sároman,ravencrest,761,druid,balance,24,8,16
Fakers,the-maelstrom,747,druid,balance,12,8,4
Aggibääm,blackhand,724,druid,balance,18,8,10
Rønièl,tarren-mill,702,druid,balance,11,8,3
Mazalot,kazzak,687,druid,balance,13,8,5
Surlax,defias-brotherhood,672,druid,balance,12,7,5
Trønchetto,nemesis,672,druid,balance,12,7,5
Daÿdream,ravencrest,672,druid,balance,12,7,5
Yungtrappy,stormscale,672,druid,balance,12,7,5
Mommymìlkers,archimonde,672,druid,balance,12,7,5
Shapees,sylvanas,672,druid,balance,12,7,5
Longhornjohn,ragnaros,672,druid,balance,12,7,5
Delarion,nemesis,672,druid,balance,12,7,5
Glúingél,tarren-mill,672,druid,balance,12,7,5
Twerkdabooty,azjolnerub,672,druid,balance,12,7,5
Lilim,culte-de-la-rive-noire,672,druid,balance,12,7,5
Hajlol,sylvanas,672,druid,balance,12,7,5
Tease,blackrock,672,druid,balance,12,7,5
Epicplays,sylvanas,672,druid,balance,12,7,5
Obrys,tarren-mill,672,druid,balance,12,7,5
Svend,kazzak,672,druid,balance,12,7,5
Thornat,chamber-of-aspects,672,druid,balance,12,7,5
Hilom,grim-batol,672,druid,balance,12,7,5
Sweedrood,hyjal,672,druid,balance,12,7,5
Mythiaran,argent-dawn,672,druid,balance,12,7,5
Qyoon,argent-dawn,672,druid,balance,12,7,5
Hïrøshïmå,malganis,672,druid,balance,12,7,5
Okøë,marécage-de-zangar,672,druid,balance,12,7,5
Youngdinozzo,dalaran,672,druid,balance,12,7,5
Redyogurt,outland,672,druid,balance,18,7,11
Tronchetto,nemesis,672,druid,balance,18,7,11
Ravenfang,dun-modr,672,druid,balance,18,7,11
Núri,lordaeron,672,druid,balance,18,7,11
Rivella,blackrock,672,druid,balance,18,7,11
Schebäb,blackhand,672,druid,balance,18,7,11
Грандал,howling-fjord,672,druid,balance,18,7,11
Calambius,blackhand,672,druid,balance,18,7,11
Экстазиус,borean-tundra,672,druid,balance,24,7,17
Rikayn,tarren-mill,671,druid,balance,12,7,5
Mnqn,ravencrest,671,druid,balance,12,7,5
Hauntie,kazzak,671,druid,balance,12,7,5
Spoco,defias-brotherhood,671,druid,balance,12,7,5
Taylorshift,argent-dawn,671,druid,balance,12,7,5
Fesenjon,blackhand,671,druid,balance,18,7,11
Muhz,nathrezim,671,druid,balance,18,7,11
Fleq,antonidas,671,druid,balance,18,7,11
Elrroir,dun-modr,671,druid,balance,18,7,11
Shìrò,kelthuzad,671,druid,balance,18,7,11
Fréki,ravenholdt,670,druid,balance,12,7,5
Balzàc,ravencrest,670,druid,balance,12,7,5
Wolfhealer,blackmoore,669,druid,balance,12,7,5
Challi,nordrassil,669,druid,balance,18,7,11
Sabresheep,twisting-nether,669,druid,balance,24,7,17
Мяурицао,howling-fjord,668,druid,balance,12,7,5
Conn,ravencrest,667,druid,balance,12,7,5
ßalmain,nethersturm,666,druid,balance,18,7,11
Tommyruin,the-venture-co,640,druid,balance,16,7,9
Nille,tarren-mill,617,druid,balance,14,8,6
Sadgeconvoke,draenor,607,druid,balance,11,7,4
Fuzzylol,haomarush,607,druid,balance,11,7,4
Bubidiblumdr,twisting-nether,605,druid,balance,16,7,9
Rtfz,ravencrest,591,druid,balance,13,7,6
Ухухуня,gordunni,576,druid,balance,6,6,0
Qpoof,sylvanas,576,druid,balance,6,6,0
Grafíx,blackrock,576,druid,balance,6,6,0
Ноунэймбич,blackscar,576,druid,balance,6,6,0
Mønrøe,ravencrest,576,druid,balance,9,7,2
Kamenká,aegwynn,576,druid,balance,12,6,6
Layle,argent-dawn,576,druid,balance,12,6,6
Thefudge,silvermoon,576,druid,balance,12,6,6
Boomzter,frostmane,576,druid,balance,12,6,6
Nuggetspøwa,dalaran,576,druid,balance,12,6,6
Inbml,silvermoon,576,druid,balance,12,6,6
Dyuuna,hyjal,576,druid,balance,12,6,6
Knozylg,kazzak,576,druid,balance,12,6,6
Mentaldead,tarren-mill,576,druid,balance,12,6,6
Vulkayn,ysondre,576,druid,balance,12,6,6
Зулкхаку,soulflayer,576,druid,balance,12,6,6
Mikhaili,stormreaver,576,druid,balance,12,6,6
Saabeq,hyjal,576,druid,balance,12,6,6
Pórts,kazzak,576,druid,balance,12,6,6
Shoca,die-ewige-wacht,576,druid,balance,12,6,6
Diolives,stormscale,576,druid,balance,12,6,6
Мунпраид,gordunni,576,druid,balance,12,6,6
Elunælle,les-sentinelles,576,druid,balance,12,6,6
Kalthazar,twisting-nether,576,druid,balance,12,6,6
Zaoow,stormscale,576,druid,balance,12,6,6
Quinten,ulduar,576,druid,balance,12,6,6
Nancey,auchindoun,576,druid,balance,12,6,6
Littlecok,blackmoore,576,druid,balance,12,6,6
Teryx,blackmoore,576,druid,balance,12,6,6
Quoting,ravencrest,576,druid,balance,12,6,6
Smedoge,outland,576,druid,balance,18,6,12
Altix,blackmoore,575,druid,balance,6,6,0
Ketama,sylvanas,575,druid,balance,12,6,6
Òniz,hyjal,575,druid,balance,12,6,6
Raxona,blackmoore,575,druid,balance,12,6,6
Zaratras,arathor,575,druid,balance,12,6,6
Orazien,ravencrest,575,druid,balance,12,6,6
Lèafy,silvermoon,575,druid,balance,13,6,7
Momaa,neptulon,574,druid,balance,12,6,6
Стампид,blackscar,574,druid,balance,17,6,11
Жекакотик,eversong,574,druid,balance,24,6,18
Tchoubouléru,throkferoth,573,druid,balance,18,6,12
Tombenuit,tarren-mill,572,druid,balance,12,6,6
Kittasek,drakthul,572,druid,balance,12,6,6
Tarantinonon,kazzak,572,druid,balance,18,6,12
Arecsne,turalyon,543,druid,balance,14,7,7
Ancientix,burning-legion,543,druid,balance,17,6,11
Ruberg,kazzak,528,druid,balance,9,6,3
Xyiz,ravencrest,528,druid,balance,15,6,9
Кашаган,howling-fjord,527,druid,balance,15,6,9
Fransman,sylvanas,522,druid,balance,13,7,6
Humizon,silvermoon,522,druid,balance,15,7,8
Ábomínatíon,draenor,480,druid,balance,6,5,1
Harrydòtter,eredar,480,druid,balance,6,5,1
Хлайси,gordunni,480,druid,balance,6,5,1
Pinkpanda,arthas,480,druid,balance,6,5,1
Храш,gordunni,480,druid,balance,6,5,1
Neufcinqq,archimonde,480,druid,balance,6,5,1
Illebra,defias-brotherhood,480,druid,balance,6,5,1
Corkiy,tarren-mill,480,druid,balance,6,5,1
Entas,kazzak,480,druid,balance,6,5,1
Xoap,kazzak,480,druid,balance,6,5,1
Everdreamx,arathor,480,druid,balance,6,5,1
Smøkyyd,eredar,480,druid,balance,6,5,1
Hashtagone,ysondre,480,druid,balance,6,5,1
Опущеныйкелх,gordunni,480,druid,balance,6,5,1
Skywíng,stormscale,480,druid,balance,6,5,1
Fabuboomy,blackrock,480,druid,balance,6,5,1
Füllxtrap,hyjal,480,druid,balance,6,5,1
Jöggel,perenolde,480,druid,balance,6,5,1
Yshára,darkmoon-faire,480,druid,balance,6,5,1
Sebikboomie,ravencrest,480,druid,balance,6,5,1
Ploho,blackmoore,480,druid,balance,12,5,7
Elrandir,tarren-mill,480,druid,balance,12,5,7
Pròtodrù,twisting-nether,480,druid,balance,12,5,7
Zomgcow,twisting-nether,480,druid,balance,12,5,7
Karodoom,twisting-nether,480,druid,balance,12,5,7
Jabbah,defias-brotherhood,480,druid,balance,12,5,7
Skadruid,blackmoore,480,druid,balance,12,5,7
Pewpewdruid,blackmoore,480,druid,balance,12,5,7
Bearhúg,kazzak,480,druid,balance,12,5,7
Kørn,drakthul,480,druid,balance,12,5,7
Deadmorph,ysondre,480,druid,balance,12,5,7
Rwq,outland,480,druid,balance,12,5,7
Усыильвиры,soulflayer,480,druid,balance,12,5,7
Pèps,dalaran,480,druid,balance,12,5,7
Yabbah,blackrock,480,druid,balance,12,5,7
Lifecycle,nemesis,480,druid,balance,12,5,7
Hackamore,archimonde,480,druid,balance,12,5,7
Doup,alakir,480,druid,balance,12,5,7
Slâkkxz,kazzak,480,druid,balance,12,5,7
Naturina,shattered-hand,480,druid,balance,12,5,7
Goated,stormscale,480,druid,balance,12,5,7
Yadon,the-maelstrom,480,druid,balance,12,5,7
Angrykejton,silvermoon,480,druid,balance,12,5,7
Hirmo,ragnaros,480,druid,balance,12,5,7
Superpoulet,archimonde,480,druid,balance,12,5,7
Qïx,outland,480,druid,balance,15,6,9
Pansarbamse,outland,480,druid,balance,13,5,8
Kunya,tarren-mill,480,druid,balance,18,5,13
Mariss,chogall,479,druid,balance,6,5,1
Certton,arakarahm,479,druid,balance,12,5,7
Elfsu,ravencrest,479,druid,balance,12,5,7
Forigiver,draenor,479,druid,balance,12,5,7
Betol,das-konsortium,479,druid,balance,12,5,7
Hengst,laughing-skull,479,druid,balance,18,5,13
Músclébéach,silvermoon,479,druid,balance,18,5,13
Lysende,arathor,478,druid,balance,12,5,7
Барли,grom,478,druid,balance,16,6,10
Zenkay,naxxramas,476,druid,balance,16,6,10
Iskaarjx,archimonde,463,druid,balance,11,5,6
Chouan,marécage-de-zangar,457,druid,balance,21,7,14
Twitchmoney,archimonde,447,druid,balance,8,6,2
Adizero,blackrock,447,druid,balance,13,6,7
Eloahdruid,blackhand,432,druid,balance,9,5,4
Foxîo,frostmane,415,druid,balance,8,5,3
Kørra,dun-modr,415,druid,balance,11,5,6
Moonsama,twisting-nether,384,druid,balance,6,4,2
Sunisan,stormscale,384,druid,balance,6,4,2
ßoomin,tarren-mill,384,druid,balance,6,4,2
Vertabrain,twilights-hammer,384,druid,balance,6,4,2
Drutro,hellfire,384,druid,balance,6,4,2
Хастла,galakrond,384,druid,balance,6,4,2
Msb,the-maelstrom,384,druid,balance,6,4,2
Leafsandstuf,ragnaros,384,druid,balance,6,4,2
Blazek,sylvanas,384,druid,balance,6,4,2
Doovex,ragnaros,384,druid,balance,6,4,2
Chúcky,twisting-nether,384,druid,balance,6,4,2
Амераки,blackscar,384,druid,balance,6,4,2
Bearygrylls,sylvanas,384,druid,balance,6,4,2
Daluria,malganis,384,druid,balance,6,4,2
Айрокси,blackscar,384,druid,balance,6,4,2
Opla,nethersturm,384,druid,balance,6,4,2
Bafere,twisting-nether,384,druid,balance,6,4,2
Фигарофигаро,gordunni,384,druid,balance,6,4,2
Shiftmeow,tarren-mill,384,druid,balance,6,4,2
Hornykarenn,bladefist,384,druid,balance,6,4,2
Borticow,sanguino,384,druid,balance,6,4,2
Seasexsune,antonidas,384,druid,balance,6,4,2
Fatfingerx,blackrock,384,druid,balance,6,4,2
Fordragos,ravencrest,384,druid,balance,6,4,2
Boomjutzu,kazzak,384,druid,balance,6,4,2
Ekologiskxx,outland,384,druid,balance,6,4,2
Shiffe,argent-dawn,384,druid,balance,6,4,2
Citróne,blackrock,384,druid,balance,6,4,2
Duskdawn,xavius,384,druid,balance,6,4,2
Freshpussyz,ravencrest,384,druid,balance,6,4,2
Xvmon,draenor,384,druid,balance,6,4,2
Cpt,xavius,384,druid,balance,6,4,2
Benzinoid,silvermoon,384,druid,balance,6,4,2
Rhaf,argent-dawn,384,druid,balance,6,4,2
Hotdóts,outland,384,druid,balance,6,4,2
Malolepszy,burning-legion,384,druid,balance,6,4,2
Jeaylqt,archimonde,384,druid,balance,6,4,2
Lakersinfive,argent-dawn,384,druid,balance,6,4,2
Macron,terokkar,384,druid,balance,6,4,2
Dermegon,outland,384,druid,balance,6,4,2
Yinx,darksorrow,384,druid,balance,6,4,2
Dremdra,draenor,384,druid,balance,6,4,2
Smøuler,sanguino,384,druid,balance,6,4,2
Emochicken,silvermoon,384,druid,balance,9,5,4
Фамай,howling-fjord,384,druid,balance,8,4,4
Knuffle,eredar,384,druid,balance,8,4,4
Stìck,archimonde,384,druid,balance,11,5,6
Ohndankalan,kazzak,384,druid,balance,12,4,8
Rasgath,kazzak,384,druid,balance,12,4,8
Sixtyinches,burning-blade,384,druid,balance,12,4,8
Вбг,soulflayer,384,druid,balance,12,4,8
Achre,thunderhorn,384,druid,balance,12,4,8
Tmhaikyu,blackhand,384,druid,balance,12,4,8
Màlàkaii,hyjal,384,druid,balance,12,4,8
Drazefin,twisting-nether,384,druid,balance,12,4,8
Феразинария,gordunni,384,druid,balance,12,4,8
Alanpapi,sanguino,384,druid,balance,12,4,8
Yee,twisting-nether,384,druid,balance,12,4,8
Vasilona,sanguino,384,druid,balance,12,4,8
Tønychopper,sanguino,384,druid,balance,12,4,8
Ibroninad,ragnaros,384,druid,balance,12,4,8
Bôoze,nathrezim,384,druid,balance,12,4,8
Weisslogia,aegwynn,384,druid,balance,12,4,8
Ööh,outland,384,druid,balance,12,4,8
Commonsense,kazzak,384,druid,balance,12,4,8
Astralbody,auchindoun,384,druid,balance,12,4,8
Губкобоб,galakrond,384,druid,balance,16,4,12
Храмульчик,blackscar,383,druid,balance,6,4,2
Mongwau,blackrock,383,druid,balance,6,4,2
Grizzlyhills,silvermoon,383,druid,balance,6,4,2
Mlyzioz,ahnqiraj,383,druid,balance,6,4,2
Wartôn,blackhand,383,druid,balance,12,4,8
Moonpouk,archimonde,383,druid,balance,12,4,8
Blablábla,silvermoon,383,druid,balance,12,4,8
Druvian,argent-dawn,383,druid,balance,18,4,14
Katharo,kult-der-verdammten,383,druid,balance,24,4,20
Suranaelle,argent-dawn,369,druid,balance,20,8,12
Ráw,dun-modr,367,druid,balance,11,4,7
Blakemonster,khaz-modan,351,druid,balance,8,5,3
Ратататата,blackscar,351,druid,balance,8,5,3
Pawel,defias-brotherhood,351,druid,balance,8,5,3
Нэйроуз,howling-fjord,351,druid,balance,11,4,7
Nightshaðe,argent-dawn,351,druid,balance,11,4,7
Zybri,ragnaros,351,druid,balance,11,4,7
Sketit,grim-batol,335,druid,balance,11,4,7
Martinesämst,outland,320,druid,balance,10,4,6
Ohpfo,outland,319,druid,balance,5,4,1
Pikamoo,kazzak,319,druid,balance,5,4,1
Imaginarý,ravencrest,319,druid,balance,5,4,1
Eclipße,silvermoon,319,druid,balance,5,4,1
Holyconvoke,stormscale,319,druid,balance,5,4,1
Papalegba,kilrogg,319,druid,balance,8,4,4
Suitti,ravencrest,288,druid,balance,6,3,3
Humanoidpt,aggra-português,288,druid,balance,6,3,3
Покусаютебя,gordunni,288,druid,balance,6,3,3
Friidaf,lightbringer,288,druid,balance,6,3,3
Rbg,dun-modr,288,druid,balance,6,3,3
Flower,aggramar,288,druid,balance,6,3,3
Barbulloup,hyjal,288,druid,balance,6,3,3
Crackfat,stormscale,288,druid,balance,6,3,3
Jirenthegrey,antonidas,288,druid,balance,6,3,3
Зонкс,gordunni,288,druid,balance,6,3,3
Auches,argent-dawn,288,druid,balance,6,3,3
Néøu,archimonde,288,druid,balance,6,3,3
Siuo,ravencrest,288,druid,balance,6,3,3
Cryspie,hyjal,288,druid,balance,6,3,3
Блиденг,gordunni,288,druid,balance,6,3,3
Дарзамат,blackscar,288,druid,balance,6,3,3
Хрофт,blackscar,288,druid,balance,6,3,3
Катяблум,gordunni,288,druid,balance,6,3,3
Buboss,ravencrest,288,druid,balance,6,3,3
Srkameltouss,sanguino,288,druid,balance,6,3,3
Flanagàn,hyjal,288,druid,balance,6,3,3
Quinteness,silvermoon,288,druid,balance,6,3,3
Illmíndofboo,twisting-nether,288,druid,balance,6,3,3
Orangeterror,stormscale,288,druid,balance,6,3,3
Cörelly,ravencrest,288,druid,balance,6,3,3
Coogee,malganis,288,druid,balance,6,3,3
Ciwone,blackrock,288,druid,balance,6,3,3
Aryitu,blackrock,288,druid,balance,6,3,3
Applestrudle,blackrock,288,druid,balance,6,3,3
Seey,thrall,288,druid,balance,6,3,3
Rumjin,burning-blade,288,druid,balance,6,3,3
Meretrizx,kazzak,288,druid,balance,6,3,3
Lærken,the-maelstrom,288,druid,balance,6,3,3
Чепенкос,gordunni,288,druid,balance,6,3,3
Вооми,gordunni,288,druid,balance,6,3,3
Mdrgtwo,ravencrest,288,druid,balance,6,3,3
Happysw,thrall,288,druid,balance,6,3,3
Gorthunx,kazzak,288,druid,balance,6,3,3
Ullainho,stormscale,288,druid,balance,6,3,3
Biologie,onyxia,288,druid,balance,6,3,3
Hordepwnr,sylvanas,288,druid,balance,6,3,3
Islandbôy,blackrock,288,druid,balance,6,3,3
Sweetner,outland,288,druid,balance,6,3,3
Derie,nazjatar,288,druid,balance,6,3,3
Revølter,kazzak,288,druid,balance,6,3,3
Kamatea,eredar,288,druid,balance,6,3,3
Bámbí,sylvanas,288,druid,balance,6,3,3
Detü,blackrock,288,druid,balance,6,3,3
Hushorde,twisting-nether,288,druid,balance,6,3,3
Neincat,sylvanas,288,druid,balance,6,3,3
Fishe,twisting-nether,288,druid,balance,6,3,3
Zhroomx,blackmoore,288,druid,balance,6,3,3
Ilus,outland,288,druid,balance,6,3,3
Thaneo,blackmoore,288,druid,balance,12,3,9
Elatadru,silvermoon,288,druid,balance,12,3,9
Colibrix,ravencrest,288,druid,balance,12,3,9
Chavinelf,twisting-nether,288,druid,balance,12,3,9
Loverace,dun-modr,288,druid,balance,12,3,9
Ishaqu,bladefist,288,druid,balance,12,3,9
Crywingz,antonidas,288,druid,balance,12,3,9
Likwidator,stormscale,288,druid,balance,12,3,9
Zhof,ravencrest,288,druid,balance,12,3,9
Lúthiëñ,silvermoon,288,druid,balance,12,3,9
Kidow,wrathbringer,288,druid,balance,12,3,9
Azurai,blackmoore,288,druid,balance,12,3,9
Bigcappa,ahnqiraj,287,druid,balance,6,3,3
Lindémann,blackhand,287,druid,balance,6,3,3
Whythis,archimonde,282,druid,balance,17,6,11
Eikthyrson,nozdormu,256,druid,balance,4,4,0
Jhiun,ragnaros,256,druid,balance,4,4,0
Lxz,blackhand,256,druid,balance,10,3,7
Пушистаялапа,blackscar,255,druid,balance,4,4,0
Жибка,howling-fjord,255,druid,balance,8,4,4
Hotsincee,stormscale,255,druid,balance,11,3,8
Bóssít,doomhammer,255,druid,balance,11,3,8
Ddggss,ragnaros,255,druid,balance,11,3,8
Maw,hellfire,239,druid,balance,5,3,2
Dudukush,eredar,232,druid,balance,19,4,15
Beamgødx,thrall,192,druid,balance,4,3,1
Zømßie,outland,192,druid,balance,9,3,6
Druidbox,ravencrest,192,druid,balance,6,2,4
Akiíra,twisting-nether,192,druid,balance,6,2,4
Chäz,sanguino,192,druid,balance,6,2,4
Noou,aegwynn,192,druid,balance,6,2,4
Taskingoman,twisting-nether,192,druid,balance,6,2,4
Луноэльф,gordunni,192,druid,balance,6,2,4
Emidrem,ravencrest,192,druid,balance,6,2,4
Tallbutshort,stormscale,192,druid,balance,6,2,4
Dresten,burning-blade,192,druid,balance,6,2,4
Dingeren,stormscale,192,druid,balance,6,2,4
Halfaway,ravencrest,192,druid,balance,6,2,4
Kasiopee,hyjal,192,druid,balance,6,2,4
Canezmvp,blackrock,192,druid,balance,6,2,4
Telbo,ravencrest,192,druid,balance,6,2,4
Tranduiil,drakthul,192,druid,balance,6,2,4
Маалир,gordunni,192,druid,balance,6,2,4
Uglydruid,drakthul,192,druid,balance,6,2,4
Athenã,blackmoore,192,druid,balance,6,2,4
Chzycow,twisting-nether,192,druid,balance,6,2,4
Tamburoo,tarren-mill,192,druid,balance,6,2,4
Lóvebeam,ravencrest,192,druid,balance,6,2,4
Коктявзер,deathweaver,192,druid,balance,6,2,4
Снэйк,borean-tundra,192,druid,balance,6,2,4
Filderah,doomhammer,192,druid,balance,6,2,4
Spidete,sanguino,192,druid,balance,6,2,4
Kaamirach,blackmoore,192,druid,balance,6,2,4
Jaffacakeqt,draenor,192,druid,balance,6,2,4
Bigsmoké,die-aldor,192,druid,balance,6,2,4
Rootbeamftw,ravencrest,192,druid,balance,6,2,4
Segundø,archimonde,192,druid,balance,6,2,4
Laødinay,hyjal,192,druid,balance,6,2,4
Hâyâbusa,antonidas,192,druid,balance,6,2,4
Sanaponic,burning-legion,192,druid,balance,6,2,4
Héryse,hyjal,192,druid,balance,6,2,4
Kwenden,arygos,192,druid,balance,6,2,4
Rústy,baelgun,192,druid,balance,6,2,4
Fishanchips,archimonde,192,druid,balance,6,2,4
Zolduran,archimonde,192,druid,balance,6,2,4
Avimoo,tarren-mill,192,druid,balance,6,2,4
Dabudi,kazzak,192,druid,balance,6,2,4
Hotributionx,ravencrest,192,druid,balance,6,2,4
Robinchwän,archimonde,192,druid,balance,6,2,4
Kivimon,dun-modr,192,druid,balance,6,2,4
Jimmyxdd,kazzak,192,druid,balance,6,2,4
Baccon,ravencrest,192,druid,balance,6,2,4
Tadoson,blackmoore,192,druid,balance,6,2,4
Шубаиздуба,howling-fjord,192,druid,balance,6,2,4
Sorkoxd,silvermoon,192,druid,balance,6,2,4
Saliencias,kazzak,192,druid,balance,6,2,4
Kotkacy,silvermoon,192,druid,balance,6,2,4
Kylaaz,die-ewige-wacht,192,druid,balance,6,2,4
Gurranq,argent-dawn,192,druid,balance,11,3,8
Leekroom,forscherliga,192,druid,balance,12,2,10
Broasted,stormscale,192,druid,balance,12,2,10
Fallingmoon,ravencrest,192,druid,balance,12,2,10
Catbear,kazzak,191,druid,balance,6,2,4
Millworgen,norgannon,191,druid,balance,6,2,4
Arrock,malfurion,191,druid,balance,12,2,10
Silvacustos,teldrassil,191,druid,balance,12,2,10
Drix,frostwolf,175,druid,balance,11,2,9
Tekilaz,sanguino,128,druid,balance,4,2,2
Spaceshift,magtheridon,96,druid,balance,3,2,1
Two,silvermoon,96,druid,balance,6,1,5
Tbga,outland,96,druid,balance,6,1,5
Tigerbalm,ravenholdt,96,druid,balance,6,1,5
Nermax,kazzak,96,druid,balance,6,1,5
Cattdamon,outland,96,druid,balance,6,1,5
Nayemi,blackmoore,96,druid,balance,6,1,5
Siahra,khaz-modan,96,druid,balance,6,1,5
Ayven,kazzak,96,druid,balance,6,1,5
Druidja,sylvanas,96,druid,balance,6,1,5
Garudax,blackrock,96,druid,balance,6,1,5
Hotseîdank,blackrock,96,druid,balance,6,1,5
Whelpss,archimonde,96,druid,balance,6,1,5
Druidlaba,drakthul,96,druid,balance,6,1,5
Batmòn,stormscale,96,druid,balance,6,1,5
Ösdru,tarren-mill,96,druid,balance,6,1,5
Xwerzz,stormscale,96,druid,balance,6,1,5
Herekitykity,frostmane,96,druid,balance,6,1,5
Маминапуська,soulflayer,96,druid,balance,6,1,5
Lifeseed,ravencrest,96,druid,balance,6,1,5
Eredhion,stormscale,96,druid,balance,6,1,5
Ghostdoggie,stormscale,96,druid,balance,6,1,5
Samuelito,ravencrest,96,druid,balance,6,1,5
Ipsdray,ysondre,96,druid,balance,6,1,5
Arún,nazjatar,96,druid,balance,6,1,5
Ãnimal,argent-dawn,96,druid,balance,6,1,5
Yosimoo,draenor,96,druid,balance,6,1,5
Plankface,ravencrest,96,druid,balance,13,2,11
Mondino,blackrock,96,druid,balance,12,1,11
Negríno,cthun,95,druid,balance,3,2,1
Revoidý,blackmoore,79,druid,balance,5,1,4
Kodobursto,stormscale,79,druid,balance,6,1,5
Исмалат,howling-fjord,48,druid,balance,3,1,2
Nalreaa,kazzak,31,druid,balance,8,1,7
Báttlx,blackrock,16,druid,balance,7,1,6
Néthy,argent-dawn,2189,evoker,preservation,84,50,34
Bodytypezero,terenas,2169,evoker,preservation,110,62,48
Гачитварь,galakrond,2169,evoker,preservation,215,110,105
Zychodrac,draenor,2145,evoker,preservation,148,74,74
Бедныйгрузин,howling-fjord,2125,evoker,preservation,66,39,27
Sukkmymadnes,draenor,2120,evoker,preservation,79,39,40
Dn,shattered-hand,2111,evoker,preservation,89,46,43
Nesedon,stormscale,2053,evoker,preservation,185,95,90
Dragonsweat,hyjal,2022,evoker,preservation,66,38,28
Theories,blackhand,1978,evoker,preservation,68,36,32
Puzikloh,ravencrest,1973,evoker,preservation,42,23,19
Drogon,shendralar,1970,evoker,preservation,66,38,28
Amadeusx,ravencrest,1960,evoker,preservation,84,45,39
Шафлэнжоер,fordragon,1958,evoker,preservation,30,22,8
Dizablise,burning-legion,1954,evoker,preservation,59,33,26
Ripgódx,bronzebeard,1952,evoker,preservation,126,74,52
Haxyia,outland,1928,evoker,preservation,60,31,29
Phnx,blackrock,1918,evoker,preservation,222,114,108
Rvrsl,outland,1916,evoker,preservation,96,48,48
Waifuwu,blackhand,1900,evoker,preservation,175,85,90
Lazey,stormscale,1891,evoker,preservation,54,30,24
Huxleysroar,draenor,1888,evoker,preservation,54,26,28
Healevoker,aegwynn,1882,evoker,preservation,111,55,56
Matrixslave,tarren-mill,1875,evoker,preservation,81,46,35
Vokedrak,eredar,1875,evoker,preservation,66,32,34
Sinéstrà,antonidas,1874,evoker,preservation,108,52,56
Ноубадиаттак,soulflayer,1867,evoker,preservation,90,39,51
Xays,ravencrest,1864,evoker,preservation,70,34,36
Ipho,twisting-nether,1856,evoker,preservation,100,45,55
Bodytypefour,stormscale,1854,evoker,preservation,66,28,38
Myshagini,ravencrest,1846,evoker,preservation,45,27,18
Podonok,ravencrest,1845,evoker,preservation,48,25,23
Æzorahai,area-52,1845,evoker,preservation,72,33,39
Kankethyr,korgall,1834,evoker,preservation,47,26,21
Zimbello,nemesis,1826,evoker,preservation,36,26,10
Onelastdance,ravencrest,1821,evoker,preservation,59,50,9
Jakelóng,ravencrest,1818,evoker,preservation,52,25,27
Gardennewt,ravencrest,1817,evoker,preservation,60,29,31
Mixn,argent-dawn,1812,evoker,preservation,93,41,52
Infidus,ravencrest,1810,evoker,preservation,145,82,63
Smellybreath,ravencrest,1810,evoker,preservation,36,19,17
Dragonmeta,kazzak,1808,evoker,preservation,36,19,17
Wakûwakû,kazzak,1805,evoker,preservation,135,72,63
Cptdrakon,twisting-nether,1802,evoker,preservation,77,43,34
Lerrastrasza,zirkel-des-cenarius,1802,evoker,preservation,48,24,24
Talim,terrordar,1800,evoker,preservation,78,37,41
Swainsupp,archimonde,1776,evoker,preservation,42,19,23
Themasktw,kazzak,1772,evoker,preservation,36,19,17
Seafolk,stormscale,1763,evoker,preservation,116,64,52
Devidra,defias-brotherhood,1763,evoker,preservation,54,23,31
Yulinex,argent-dawn,1759,evoker,preservation,60,39,21
Dragondaddy,eredar,1748,evoker,preservation,42,19,23
Антошадф,gordunni,1736,evoker,preservation,48,25,23
Gneltharion,draenor,1723,evoker,preservation,56,25,31
Camdaddy,magtheridon,1715,evoker,preservation,117,60,57
Bümber,stormscale,1714,evoker,preservation,48,21,27
Трейш,soulflayer,1714,evoker,preservation,72,29,43
Baiyuekui,blackmoore,1709,evoker,preservation,237,114,123
Ранкондракон,lich-king,1695,evoker,preservation,89,38,51
Ðåñîq,kazzak,1691,evoker,preservation,48,23,25
Nakavoker,arygos,1676,evoker,preservation,46,18,28
Bònéz,blackmoore,1675,evoker,preservation,95,47,48
Ezinice,hyjal,1672,evoker,preservation,46,20,26
Kalevra,eredar,1667,evoker,preservation,65,33,32
Даэдра,gordunni,1655,evoker,preservation,84,42,42
Lytër,sanguino,1652,evoker,preservation,105,61,44
Valkroth,argent-dawn,1645,evoker,preservation,54,25,29
Аскми,blackscar,1642,evoker,preservation,84,35,49
Âspên,archimonde,1639,evoker,preservation,51,24,27
Дарконикс,gordunni,1632,evoker,preservation,60,31,29
Shroudflight,draenor,1632,evoker,preservation,54,23,31
Rüllatorsven,stormscale,1631,evoker,preservation,36,21,15
Тирэсплюс,soulflayer,1630,evoker,preservation,30,17,13
Kackaloch,tarren-mill,1625,evoker,preservation,69,37,32
Akaos,silvermoon,1613,evoker,preservation,38,20,18
Bugdul,twisting-nether,1603,evoker,preservation,44,26,18
Hjucen,twisting-nether,1603,evoker,preservation,90,49,41
Ramfurry,kazzak,1576,evoker,preservation,43,18,25
Kaipha,ravencrest,1565,evoker,preservation,42,19,23
Fearawr,malganis,1552,evoker,preservation,63,22,41
Obbwoke,ravencrest,1550,evoker,preservation,60,25,35
Нежныйболт,howling-fjord,1536,evoker,preservation,128,65,63
Setraxia,argent-dawn,1525,evoker,preservation,24,18,6
Malboroasted,archimonde,1524,evoker,preservation,36,18,18
Nahkiainen,darksorrow,1514,evoker,preservation,36,16,20
Scarydragôn,draenor,1510,evoker,preservation,75,44,31
Luderx,outland,1506,evoker,preservation,48,29,19
Ацидракон,blackscar,1502,evoker,preservation,66,27,39
Odensbest,silvermoon,1496,evoker,preservation,55,32,23
Bigaluga,blackmoore,1492,evoker,preservation,42,18,24
Tenibris,die-nachtwache,1486,evoker,preservation,113,52,61
Sakade,archimonde,1480,evoker,preservation,40,18,22
Бадикабаер,thermaplugg,1465,evoker,preservation,95,49,46
Oldwhiteman,guldan,1465,evoker,preservation,52,25,27
Didii,frostwhisper,1458,evoker,preservation,93,40,53
Madelynxoxo,draenor,1450,evoker,preservation,30,25,5
Dragoncya,archimonde,1447,evoker,preservation,72,33,39
Condrage,grim-batol,1445,evoker,preservation,42,22,20
Kronata,sanguino,1439,evoker,preservation,30,15,15
Loveheart,die-aldor,1432,evoker,preservation,64,30,34
Wernøker,archimonde,1431,evoker,preservation,36,15,21
Sedricae,twisting-nether,1429,evoker,preservation,131,67,64
Dazaar,kazzak,1428,evoker,preservation,18,16,2
Spiragon,ysondre,1428,evoker,preservation,42,22,20
Liliwood,ravencrest,1427,evoker,preservation,64,30,34
Béatér,aegwynn,1426,evoker,preservation,30,15,15
Saga,aegwynn,1418,evoker,preservation,53,30,23
Nanthira,darksorrow,1410,evoker,preservation,74,33,41
Evizard,nagrand,1407,evoker,preservation,53,30,23
Draxaer,outland,1390,evoker,preservation,90,52,38
Nadoney,hyjal,1389,evoker,preservation,67,42,25
Ammendorn,blackrock,1384,evoker,preservation,46,27,19
Azorgaron,outland,1383,evoker,preservation,60,26,34
Mortlalune,conseil-des-ombres,1381,evoker,preservation,88,51,37
Dragnthsnuts,sylvanas,1380,evoker,preservation,32,16,16
Ятромантис,gordunni,1377,evoker,preservation,165,81,84
Nexxà,archimonde,1373,evoker,preservation,39,28,11
Evokazoran,dentarg,1368,evoker,preservation,66,22,44
Sorextrazy,twisting-nether,1364,evoker,preservation,58,26,32
Scalie,ravencrest,1356,evoker,preservation,36,22,14
Шкуроносец,gordunni,1352,evoker,preservation,30,15,15
Sinistrea,conseil-des-ombres,1348,evoker,preservation,51,25,26
Cinquanteuro,hyjal,1347,evoker,preservation,101,45,56
Штеци,howling-fjord,1347,evoker,preservation,193,81,112
Rescuegirl,blackrock,1345,evoker,preservation,99,50,49
Maxthecar,draenor,1342,evoker,preservation,30,18,12
Adriia,draenor,1341,evoker,preservation,18,14,4
Drarent,hyjal,1340,evoker,preservation,54,24,30
Cenca,blackmoore,1338,evoker,preservation,91,44,47
Profdrake,zuluhed,1337,evoker,preservation,24,14,10
Whitelizzard,tarren-mill,1336,evoker,preservation,24,16,8
Phyrrax,silvermoon,1336,evoker,preservation,24,14,10
Choubalo,archimonde,1318,evoker,preservation,52,27,25
Methamfetami,kazzak,1317,evoker,preservation,30,14,16
Uroegevoker,twisting-nether,1316,evoker,preservation,68,36,32
Xerragon,ravencrest,1306,evoker,preservation,60,20,40
Geckonen,stormreaver,1292,evoker,preservation,109,59,50
Scalo,kazzak,1292,evoker,preservation,90,41,49
Malfø,exodar,1282,evoker,preservation,115,58,57
Asinitaris,ravencrest,1279,evoker,preservation,47,26,21
Superflyy,kazzak,1278,evoker,preservation,110,42,68
Asraestrasz,silvermoon,1277,evoker,preservation,23,15,8
Lynastrasza,silvermoon,1274,evoker,preservation,147,78,69
Discodidling,silvermoon,1273,evoker,preservation,51,25,26
Drackheal,kaelthas,1269,evoker,preservation,35,21,14
Ludracy,antonidas,1267,evoker,preservation,66,34,32
Sibvoker,kazzak,1267,evoker,preservation,41,16,25
Dinotron,uldaman,1249,evoker,preservation,54,27,27
Jkdrage,stormscale,1247,evoker,preservation,24,13,11
Najikí,tarren-mill,1247,evoker,preservation,24,13,11
Froststraza,chamber-of-aspects,1247,evoker,preservation,30,13,17
Nagoli,silvermoon,1246,evoker,preservation,45,20,25
Эндемический,soulflayer,1242,evoker,preservation,30,13,17
Kymura,archimonde,1239,evoker,preservation,30,13,17
Fredgobrr,tarren-mill,1232,evoker,preservation,66,40,26
Matysniak,burning-legion,1232,evoker,preservation,24,13,11
Beenus,doomhammer,1228,evoker,preservation,36,24,12
Патриотика,howling-fjord,1225,evoker,preservation,59,26,33
Breall,tarren-mill,1225,evoker,preservation,116,45,71
Th,stormscale,1223,evoker,preservation,18,13,5
Erhvoker,veknilash,1221,evoker,preservation,63,24,39
Lojinevo,twisting-nether,1215,evoker,preservation,95,43,52
Anso,sanguino,1212,evoker,preservation,24,14,10
Amaterãsu,kazzak,1206,evoker,preservation,42,21,21
Драконсила,gordunni,1198,evoker,preservation,23,13,10
Wingzy,chogall,1197,evoker,preservation,128,61,67
Howtodragon,twisting-nether,1189,evoker,preservation,36,17,19
Ohcaralho,outland,1188,evoker,preservation,39,16,23
Dragonna,argent-dawn,1171,evoker,preservation,42,20,22
Zethreus,silvermoon,1170,evoker,preservation,58,30,28
Tennin,thrall,1157,evoker,preservation,45,27,18
Navilism,kazzak,1154,evoker,preservation,177,91,86
Eagleflow,aszune,1154,evoker,preservation,31,13,18
Âbs,archimonde,1154,evoker,preservation,41,14,27
Jmy,bloodhoof,1152,evoker,preservation,18,12,6
Dârys,kazzak,1152,evoker,preservation,24,12,12
Hehehihihaha,ravencrest,1151,evoker,preservation,24,12,12
Puffthemagic,archimonde,1151,evoker,preservation,24,12,12
Dwagonzuv,the-maelstrom,1148,evoker,preservation,18,12,6
Dragawn,grim-batol,1147,evoker,preservation,73,41,32
Nekrosdrake,tarren-mill,1146,evoker,preservation,24,12,12
Sinusiitiis,destromath,1142,evoker,preservation,18,12,6
Nazalath,eonar,1130,evoker,preservation,24,12,12
Jimmytrivet,archimonde,1126,evoker,preservation,33,13,20
Adnoc,tarren-mill,1124,evoker,preservation,19,13,6
Алифсе,howling-fjord,1123,evoker,preservation,60,18,42
Nonolildrake,ysondre,1119,evoker,preservation,30,13,17
Drachenglas,antonidas,1112,evoker,preservation,30,13,17
Uztfuzt,blackmoore,1103,evoker,preservation,24,15,9
Predatax,drakthul,1101,evoker,preservation,73,39,34
Алекстраса,blackscar,1097,evoker,preservation,30,16,14
Saphirá,hyjal,1094,evoker,preservation,28,13,15
Singe,nemesis,1081,evoker,preservation,48,12,36
Blackli,kazzak,1074,evoker,preservation,33,14,19
Retyss,twisting-nether,1068,evoker,preservation,253,126,127
Lizardofoz,argent-dawn,1058,evoker,preservation,24,15,9
Tombeelee,kazzak,1055,evoker,preservation,18,11,7
Samidr,ravencrest,1054,evoker,preservation,30,11,19
Dragonsimp,archimonde,1047,evoker,preservation,18,11,7
Sarapakara,burning-blade,1047,evoker,preservation,24,11,13
Rafale,the-maelstrom,1029,evoker,preservation,35,16,19
Thymian,ambossar,1026,evoker,preservation,68,33,35
Zathîel,argent-dawn,1026,evoker,preservation,149,64,85
Spirow,archimonde,1012,evoker,preservation,18,11,7
Draklorn,moonglade,1012,evoker,preservation,24,13,11
Шадофдрагон,deathweaver,1004,evoker,preservation,30,20,10
Morlie,argent-dawn,1004,evoker,preservation,47,21,26
Tf,doomhammer,988,evoker,preservation,40,15,25
Palindre,argent-dawn,987,evoker,preservation,29,14,15
Dayandnight,quelthalas,984,evoker,preservation,30,11,19
Varaug,veklor,973,evoker,preservation,23,14,9
Slashlowe,archimonde,972,evoker,preservation,36,17,19
Reddeaddrago,silvermoon,966,evoker,preservation,44,24,20
Ecovoker,outland,960,evoker,preservation,18,10,8
Salamanderx,stormscale,959,evoker,preservation,12,10,2
Indragon,blackmoore,958,evoker,preservation,21,11,10
Винтер,azuregos,935,evoker,preservation,19,11,8
Vozzat,stormscale,934,evoker,preservation,24,11,13
Morsan,tichondrius,931,evoker,preservation,36,19,17
Jurrassic,defias-brotherhood,929,evoker,preservation,18,10,8
Pigioto,silvermoon,929,evoker,preservation,89,41,48
Drachi,ambossar,927,evoker,preservation,60,27,33
Vores,norgannon,908,evoker,preservation,59,26,33
Drakars,kazzak,905,evoker,preservation,24,11,13
Cárried,twilights-hammer,902,evoker,preservation,33,11,22
Canitabravar,cthun,898,evoker,preservation,60,30,30
Marasz,silvermoon,893,evoker,preservation,42,22,20
Eosin,blackrock,890,evoker,preservation,23,10,13
Hool,silvermoon,885,evoker,preservation,72,31,41
Gardenewt,ravencrest,864,evoker,preservation,12,9,3
Drakela,frostwhisper,864,evoker,preservation,12,9,3
Dracum,kazzak,864,evoker,preservation,18,9,9
Smâûg,silvermoon,864,evoker,preservation,18,9,9
Moondraka,outland,864,evoker,preservation,18,9,9
Drgigapump,blackmoore,864,evoker,preservation,18,9,9
Crocodeal,ysondre,863,evoker,preservation,12,9,3
Мишанячешуя,gordunni,863,evoker,preservation,12,9,3
Alusiedrake,ravencrest,863,evoker,preservation,12,9,3
Valtion,stormscale,863,evoker,preservation,18,9,9
Cupcâke,dalaran,863,evoker,preservation,18,9,9
Etier,aegwynn,862,evoker,preservation,18,9,9
Sissilisko,sylvanas,861,evoker,preservation,12,9,3
Blazeros,sylvanas,861,evoker,preservation,36,15,21
Mistvoke,kazzak,860,evoker,preservation,18,9,9
Lithnxv,bladefist,859,evoker,preservation,18,9,9
Dracanus,bronze-dragonflight,859,evoker,preservation,24,9,15
Jamiewing,ravencrest,858,evoker,preservation,18,9,9
Evok,deathwing,858,evoker,preservation,24,10,14
Gilgakek,darksorrow,852,evoker,preservation,24,9,15
Javåscript,outland,849,evoker,preservation,18,9,9
Viseriðn,archimonde,827,evoker,preservation,24,9,15
Nyghtx,sanguino,810,evoker,preservation,22,10,12
Мэриджэин,soulflayer,809,evoker,preservation,21,9,12
Jhoanna,grim-batol,804,evoker,preservation,18,9,9
Yadormi,sylvanas,795,evoker,preservation,42,16,26
Верметор,soulflayer,790,evoker,preservation,60,15,45
Тирдде,deathweaver,784,evoker,preservation,30,11,19
Miumyuki,drakthul,783,evoker,preservation,24,9,15
Zendaë,archimonde,768,evoker,preservation,12,8,4
Nst,zuljin,768,evoker,preservation,12,8,4
Humòngóus,kazzak,768,evoker,preservation,12,8,4
Roth,stormreaver,768,evoker,preservation,12,8,4
Zemar,dalaran,768,evoker,preservation,12,8,4
Ringil,tarren-mill,768,evoker,preservation,18,8,10
Crottedezen,archimonde,768,evoker,preservation,18,8,10
Jaje,nerathor,768,evoker,preservation,18,8,10
Baszz,aegwynn,767,evoker,preservation,18,8,10
Thundermifln,nemesis,765,evoker,preservation,12,8,4
Уполнамоченн,soulflayer,764,evoker,preservation,12,8,4
Nagimurr,kazzak,763,evoker,preservation,12,8,4
Donns,frostmane,763,evoker,preservation,16,9,7
Kurger,twisting-nether,762,evoker,preservation,24,8,16
Viseron,zuljin,761,evoker,preservation,21,9,12
Dragonrocker,silvermoon,757,evoker,preservation,24,8,16
Дрэгтир,lich-king,755,evoker,preservation,14,8,6
Nahfr,terenas,736,evoker,preservation,22,8,14
Apaçi,ravencrest,719,evoker,preservation,21,8,13
Dratheon,dun-modr,704,evoker,preservation,20,9,11
Vyron,amanthul,702,evoker,preservation,16,8,8
Sunfyres,frostmane,679,evoker,preservation,28,8,20
Berlyvoke,stormscale,672,evoker,preservation,12,7,5
Malowux,outland,672,evoker,preservation,12,7,5
Kremost,sylvanas,672,evoker,preservation,12,7,5
Stormnn,kazzak,672,evoker,preservation,12,7,5
Kharduk,outland,672,evoker,preservation,15,8,7
Thèrèse,hyjal,672,evoker,preservation,18,7,11
Spacebreath,ravencrest,672,evoker,preservation,18,7,11
Sulführer,sanguino,672,evoker,preservation,18,7,11
Ruinastrasza,silvermoon,671,evoker,preservation,12,7,5
Draaxy,twisting-nether,671,evoker,preservation,15,8,7
Fusanabide,kazzak,671,evoker,preservation,14,7,7
Karristrasza,silvermoon,671,evoker,preservation,18,7,11
Esalisko,kazzak,670,evoker,preservation,12,7,5
Nedflanderss,silvermoon,670,evoker,preservation,12,7,5
Coaxoch,thunderhorn,670,evoker,preservation,12,7,5
Leblon,stormreaver,670,evoker,preservation,12,7,5
Smokitor,kazzak,670,evoker,preservation,12,7,5
Drakthur,terenas,669,evoker,preservation,18,7,11
Эбиб,gordunni,664,evoker,preservation,18,7,11
Awfultrash,archimonde,655,evoker,preservation,23,7,16
Branados,argent-dawn,639,evoker,preservation,12,7,5
Mistrßroducr,stormreaver,576,evoker,preservation,12,6,6
Jacko,nemesis,576,evoker,preservation,12,6,6
Snipy,burning-legion,576,evoker,preservation,12,6,6
Mesarin,eredar,576,evoker,preservation,12,6,6
Talynn,sylvanas,576,evoker,preservation,12,6,6
Sindragonk,ravencrest,576,evoker,preservation,12,6,6
Вексалис,gordunni,576,evoker,preservation,12,6,6
Skypov,sylvanas,576,evoker,preservation,12,6,6
Dedx,sylvanas,576,evoker,preservation,12,6,6
Sính,ravencrest,576,evoker,preservation,12,6,6
Bluesaphir,ravencrest,576,evoker,preservation,12,6,6
Потныйдракон,soulflayer,576,evoker,preservation,12,6,6
Krayvoker,tarren-mill,576,evoker,preservation,12,6,6
Myntara,tarren-mill,576,evoker,preservation,18,6,12
Zeigrem,antonidas,575,evoker,preservation,6,6,0
Pasqvoker,ravencrest,575,evoker,preservation,12,6,6
Tarystrasza,blackrock,574,evoker,preservation,12,6,6
Schenlong,kelthuzad,574,evoker,preservation,12,6,6
Groovyy,hyjal,574,evoker,preservation,12,6,6
Drakpojke,stormscale,574,evoker,preservation,12,6,6
Dreamiee,kazzak,574,evoker,preservation,18,6,12
Dracarysfire,kazzak,573,evoker,preservation,12,6,6
Steeken,haomarush,572,evoker,preservation,18,6,12
Scaleyfurry,azshara,570,evoker,preservation,12,6,6
ßëkûsåùrús,ragnaros,559,evoker,preservation,17,6,11
Rasalhague,uldum,522,evoker,preservation,15,6,9
Dracarysx,grim-batol,520,evoker,preservation,15,7,8
Omac,sylvanas,480,evoker,preservation,6,5,1
Sürion,grim-batol,480,evoker,preservation,6,5,1
Holyvoker,aegwynn,480,evoker,preservation,6,5,1
Thellon,frostwolf,480,evoker,preservation,6,5,1
Nemrák,blackmoore,480,evoker,preservation,12,5,7
Polzeig,dentarg,480,evoker,preservation,12,5,7
Evoris,frostmane,480,evoker,preservation,12,5,7
Deathwingx,sylvanas,480,evoker,preservation,12,5,7
Chasxstrasza,ravencrest,480,evoker,preservation,12,5,7
Reptak,stormscale,480,evoker,preservation,12,5,7
Alamostrasza,doomhammer,480,evoker,preservation,12,5,7
Evokoloko,outland,480,evoker,preservation,12,5,7
Óceiros,silvermoon,480,evoker,preservation,12,5,7
Tobbebakar,silvermoon,480,evoker,preservation,12,5,7
Dragonsito,cthun,480,evoker,preservation,12,5,7
Iwaavoker,archimonde,480,evoker,preservation,12,5,7
Draelaynex,eredar,480,evoker,preservation,18,5,13
Lìssàndra,argent-dawn,480,evoker,preservation,18,5,13
Verithian,kazzak,479,evoker,preservation,12,5,7
Scaleflux,argent-dawn,479,evoker,preservation,12,5,7
Sudrac,antonidas,479,evoker,preservation,12,5,7
Puffdaddyxd,twisting-nether,479,evoker,preservation,12,5,7
Luftwaffel,blackmoore,479,evoker,preservation,12,5,7
Widow,chromaggus,478,evoker,preservation,12,5,7
Kärlethos,dun-modr,478,evoker,preservation,12,5,7
Fodom,medivh,477,evoker,preservation,12,5,7
Dragorasi,frostwolf,476,evoker,preservation,24,5,19
Fricandela,sanguino,472,evoker,preservation,12,5,7
Avizz,tarren-mill,462,evoker,preservation,17,8,9
Эфирид,blackscar,443,evoker,preservation,11,5,6
Grajade,dun-modr,422,evoker,preservation,15,6,9
Пидрактир,soulflayer,384,evoker,preservation,6,4,2
Zaffira,kazzak,384,evoker,preservation,6,4,2
Bindrasz,ahnqiraj,384,evoker,preservation,6,4,2
Aymoreth,argent-dawn,384,evoker,preservation,6,4,2
Darigo,ravencrest,384,evoker,preservation,6,4,2
Soupmah,silvermoon,384,evoker,preservation,6,4,2
Blyatcuka,kazzak,384,evoker,preservation,6,4,2
Dreamwalk,archimonde,384,evoker,preservation,6,4,2
Luuxiå8F57BC,archimonde,384,evoker,preservation,6,4,2
Drakeish,kazzak,384,evoker,preservation,6,4,2
Vizdraken,tarren-mill,384,evoker,preservation,6,4,2
Nhoru,stormscale,384,evoker,preservation,6,4,2
Evokker,antonidas,384,evoker,preservation,12,4,8
Sondosa,twisting-nether,384,evoker,preservation,12,4,8
Chronowalker,ragnaros,384,evoker,preservation,12,4,8
Toílet,blackmoore,384,evoker,preservation,12,4,8
Killafoolz,kazzak,384,evoker,preservation,12,4,8
Mirajhti,blackrock,384,evoker,preservation,12,4,8
Eidachsal,antonidas,384,evoker,preservation,18,4,14
Fogwing,ravencrest,384,evoker,preservation,18,4,14
Entombevoker,twisting-nether,383,evoker,preservation,6,4,2
Bombrush,ragnaros,383,evoker,preservation,6,4,2
Кефтыме,soulflayer,383,evoker,preservation,6,4,2
Deadfyre,dun-modr,383,evoker,preservation,6,4,2
Flawxy,blackmoore,383,evoker,preservation,12,4,8
Yaldthion,dun-modr,383,evoker,preservation,18,4,14
Steadyop,doomhammer,382,evoker,preservation,6,4,2
Мизурион,gordunni,379,evoker,preservation,12,4,8
Sinastral,sanguino,350,evoker,preservation,11,4,7
Colacorta,zuljin,288,evoker,preservation,6,3,3
Primepewpew,ragnaros,288,evoker,preservation,6,3,3
Viseriøn,kazzak,288,evoker,preservation,6,3,3
Saphiraa,lightnings-blade,288,evoker,preservation,6,3,3
Сулистраза,blackscar,288,evoker,preservation,6,3,3
Meezyevo,ragnaros,288,evoker,preservation,6,3,3
Asrwea,draenor,288,evoker,preservation,6,3,3
Eurydíke,blackhand,288,evoker,preservation,6,3,3
Konstraz,kazzak,288,evoker,preservation,6,3,3
Pruttburk,draenor,288,evoker,preservation,6,3,3
Nezruslfarm,cthun,288,evoker,preservation,6,3,3
Jackarlys,outland,288,evoker,preservation,6,3,3
Tactician,stormreaver,288,evoker,preservation,6,3,3
Моралдракон,soulflayer,288,evoker,preservation,6,3,3
Escaaboy,stormscale,288,evoker,preservation,6,3,3
Haawwt,eredar,288,evoker,preservation,6,3,3
Raegos,ravencrest,288,evoker,preservation,6,3,3
Alanikus,silvermoon,288,evoker,preservation,6,3,3
Keizal,twisting-nether,288,evoker,preservation,6,3,3
Jmyzard,tarren-mill,288,evoker,preservation,6,3,3
Vyore,silvermoon,288,evoker,preservation,6,3,3
Cragheart,ravencrest,288,evoker,preservation,6,3,3
Botomforgold,ravencrest,288,evoker,preservation,6,3,3
Ivokerz,tarren-mill,288,evoker,preservation,6,3,3
Dangai,draenor,288,evoker,preservation,6,3,3
Evokimag,grim-batol,288,evoker,preservation,6,3,3
Raøug,blackmoore,288,evoker,preservation,6,3,3
Rippo,tarren-mill,288,evoker,preservation,6,3,3
Renalia,blackrock,288,evoker,preservation,6,3,3
Kirivoker,dun-modr,288,evoker,preservation,6,3,3
Distinkd,draenor,288,evoker,preservation,6,3,3
Jmý,tarren-mill,288,evoker,preservation,6,3,3
Dokkàmxk,archimonde,288,evoker,preservation,12,3,9
Mfdragon,grim-batol,288,evoker,preservation,12,3,9
Bemil,twisting-nether,288,evoker,preservation,12,3,9
Cadwalader,blades-edge,288,evoker,preservation,12,3,9
Monftroglou,archimonde,288,evoker,preservation,12,3,9
Reelona,silvermoon,288,evoker,preservation,12,3,9
Detdragetid,zenedar,288,evoker,preservation,12,3,9
Horiz,kazzak,288,evoker,preservation,12,3,9
Smrdimipytel,drakthul,288,evoker,preservation,16,3,13
Mikevoker,aegwynn,287,evoker,preservation,6,3,3
Милеис,soulflayer,287,evoker,preservation,6,3,3
Anlong,alakir,287,evoker,preservation,11,3,8
Elexatra,hyjal,287,evoker,preservation,12,3,9
Smoochbumble,argent-dawn,240,evoker,preservation,9,3,6
Agnî,sanguino,240,evoker,preservation,9,3,6
Mugeki,burning-legion,234,evoker,preservation,7,4,3
Baranzion,twisting-nether,207,evoker,preservation,8,3,5
Lînkôs,aegwynn,192,evoker,preservation,6,2,4
Eryot,aggra-português,192,evoker,preservation,6,2,4
Mistime,twisting-nether,192,evoker,preservation,6,2,4
Arbîter,eredar,192,evoker,preservation,6,2,4
Sheràqt,blackrock,192,evoker,preservation,6,2,4
Flipflapflop,twisting-nether,192,evoker,preservation,6,2,4
Høt,nemesis,192,evoker,preservation,6,2,4
Puzzles,ravencrest,192,evoker,preservation,6,2,4
Parodize,thrall,192,evoker,preservation,6,2,4
Crazylucifer,kazzak,192,evoker,preservation,6,2,4
Pureshot,archimonde,192,evoker,preservation,6,2,4
Jamesdéan,twisting-nether,192,evoker,preservation,6,2,4
Arniye,ravencrest,192,evoker,preservation,6,2,4
Dno,archimonde,192,evoker,preservation,6,2,4
Freesckretx,archimonde,192,evoker,preservation,6,2,4
Glurak,stormscale,192,evoker,preservation,6,2,4
Nickydragonx,stormscale,192,evoker,preservation,6,2,4
Youzfull,blackrock,192,evoker,preservation,6,2,4
Myndragosa,varimathras,192,evoker,preservation,6,2,4
Azurog,blackmoore,192,evoker,preservation,6,2,4
Dragonzo,arathor,192,evoker,preservation,6,2,4
Dägon,drakthul,192,evoker,preservation,6,2,4
Nordomu,silvermoon,192,evoker,preservation,6,2,4
Голденджо,gordunni,192,evoker,preservation,11,2,9
Margouillax,archimonde,192,evoker,preservation,12,2,10
Тектрис,howling-fjord,192,evoker,preservation,12,2,10
Pico,madmortem,192,evoker,preservation,12,2,10
Touge,varimathras,191,evoker,preservation,6,2,4
Yuyux,sanguino,191,evoker,preservation,6,2,4
Гарил,grom,191,evoker,preservation,6,2,4
Azza,uldum,191,evoker,preservation,12,2,10
Zerario,blackhand,159,evoker,preservation,5,2,3
Eldrax,emerald-dream,159,evoker,preservation,5,2,3
Kuubski,ravencrest,144,evoker,preservation,3,3,0
Stinka,blackmoore,138,evoker,preservation,9,5,4
Zzaazaa,argent-dawn,137,evoker,preservation,10,3,7
Tyuz,antonidas,127,evoker,preservation,8,2,6
Odiin,dun-modr,96,evoker,preservation,3,2,1
Reska,archimonde,96,evoker,preservation,6,1,5
Hakuzah,terokkar,96,evoker,preservation,6,1,5
Смехокрыл,deathguard,96,evoker,preservation,6,1,5
Галактиг,thermaplugg,96,evoker,preservation,6,1,5
Dragarius,tarren-mill,96,evoker,preservation,6,1,5
Hizzo,burning-legion,96,evoker,preservation,6,1,5
Brystrasza,quelthalas,96,evoker,preservation,6,1,5
Ch,ghostlands,96,evoker,preservation,6,1,5
Kuramir,twisting-nether,96,evoker,preservation,6,1,5
Targzæ,hyjal,96,evoker,preservation,6,1,5
Mulqahdiiv,archimonde,96,evoker,preservation,6,1,5
Awienz,kazzak,96,evoker,preservation,6,1,5
Kaezmasterx,blackrock,96,evoker,preservation,6,1,5
Drogøn,khaz-modan,96,evoker,preservation,6,1,5
Kitoed,aegwynn,96,evoker,preservation,6,1,5
Lapaneri,sylvanas,96,evoker,preservation,6,1,5
Iblvicanfly,stormscale,96,evoker,preservation,6,1,5
Stjáuni,ravencrest,96,evoker,preservation,16,2,14
Vullgred,sylvanas,96,evoker,preservation,12,1,11
Sopollina,draenor,96,evoker,preservation,12,1,11
Valystrá,die-aldor,96,evoker,preservation,12,1,11
Dragonban,tarren-mill,96,evoker,preservation,12,1,11
Kamings,outland,95,evoker,preservation,8,1,7
Fluffykoi,silvermoon,95,evoker,preservation,12,1,11
Imend,stormscale,79,evoker,preservation,5,1,4
Sentos,blackmoore,64,evoker,preservation,10,1,9
Drakenyasha,tarren-mill,2136,evoker,devastation,93,48,45
Rexzstrasza,eredar,2046,evoker,devastation,72,44,28
Sârmikas,blackhand,2031,evoker,devastation,78,43,35
Babodrake,blackhand,2019,evoker,devastation,55,27,28
Claxy,ragnaros,2010,evoker,devastation,66,37,29
Kàido,ravencrest,1996,evoker,devastation,258,130,128
Нерфсрочно,gordunni,1927,evoker,devastation,96,46,50
Brokz,twisting-nether,1921,evoker,devastation,47,27,20
Xzvoker,kazzak,1909,evoker,devastation,110,57,53
Eldunaries,argent-dawn,1896,evoker,devastation,78,43,35
Wexvoker,darksorrow,1892,evoker,devastation,68,37,31
Darkssoul,outland,1875,evoker,devastation,72,38,34
Nigesaurus,burning-legion,1862,evoker,devastation,39,21,18
Frozendragon,twisting-nether,1849,evoker,devastation,45,32,13
Korvi,ravencrest,1830,evoker,devastation,44,25,19
Lizardbøi,blackhand,1827,evoker,devastation,66,33,33
Ízma,ravencrest,1826,evoker,devastation,138,70,68
Драгонтьма,gordunni,1823,evoker,devastation,65,33,32
Jamzyevoker,emerald-dream,1816,evoker,devastation,49,26,23
Amadeusx,ravencrest,1810,evoker,devastation,55,30,25
Animenorgam,alakir,1806,evoker,devastation,54,40,14
Jamiewing,ravencrest,1793,evoker,devastation,101,56,45
Bigmacfrite,ysondre,1792,evoker,devastation,64,32,32
Avë,kazzak,1790,evoker,devastation,77,39,38
Hollowbreath,sanguino,1787,evoker,devastation,126,63,63
Diznutz,kazzak,1781,evoker,devastation,36,21,15
Дреадди,soulflayer,1769,evoker,devastation,39,25,14
Dracohfeu,archimonde,1767,evoker,devastation,42,25,17
Valdrakon,doomhammer,1766,evoker,devastation,48,29,19
Twodeep,blackrock,1764,evoker,devastation,48,27,21
Oontäälihis,ravencrest,1763,evoker,devastation,66,34,32
Yuhabahha,kazzak,1740,evoker,devastation,124,69,55
Mizamiza,blackrock,1739,evoker,devastation,106,54,52
Meust,blackrock,1738,evoker,devastation,30,22,8
Hëroinhenry,tarren-mill,1738,evoker,devastation,42,28,14
Atoll,scarshield-legion,1732,evoker,devastation,43,20,23
Lesgrossman,ravencrest,1716,evoker,devastation,30,18,12
Kymaíra,hyjal,1716,evoker,devastation,48,22,26
Edvoker,twisting-nether,1706,evoker,devastation,48,25,23
Irvethius,argent-dawn,1702,evoker,devastation,107,51,56
Hanoostrasz,tarren-mill,1692,evoker,devastation,55,34,21
Хетсв,gordunni,1691,evoker,devastation,96,55,41
Famouszorc,sanguino,1682,evoker,devastation,131,77,54
Merkels,blackmoore,1662,evoker,devastation,63,33,30
Papayoyo,draenor,1660,evoker,devastation,144,70,74
Ruinastrasza,silvermoon,1651,evoker,devastation,129,64,65
Dispelgodx,eredar,1647,evoker,devastation,42,20,22
Sawk,archimonde,1645,evoker,devastation,60,38,22
Дарратель,gordunni,1643,evoker,devastation,97,51,46
Sürion,grim-batol,1642,evoker,devastation,60,33,27
Serulyon,draenor,1640,evoker,devastation,60,31,29
Krothus,outland,1635,evoker,devastation,106,60,46
Piyuli,silvermoon,1632,evoker,devastation,41,24,17
Саммеракс,gordunni,1619,evoker,devastation,54,22,32
Rahzk,twisting-nether,1616,evoker,devastation,30,17,13
Balthinar,argent-dawn,1612,evoker,devastation,42,17,25
Draxxys,blackmoore,1607,evoker,devastation,48,23,25
Ocanada,draenor,1606,evoker,devastation,36,23,13
Ludwoker,tarren-mill,1605,evoker,devastation,67,44,23
Мнякуня,howling-fjord,1600,evoker,devastation,46,24,22
Fyndassil,blackrock,1599,evoker,devastation,48,17,31
Pêengei,blackrock,1596,evoker,devastation,66,36,30
Denegos,sylvanas,1594,evoker,devastation,60,36,24
Tezkaz,blackmoore,1591,evoker,devastation,99,50,49
Shimmerscale,blackhand,1590,evoker,devastation,105,59,46
Dracoli,eredar,1590,evoker,devastation,59,30,29
Ðø,antonidas,1589,evoker,devastation,35,18,17
Фиамниэль,gordunni,1574,evoker,devastation,36,18,18
Ghiscar,dentarg,1568,evoker,devastation,66,34,32
Lilpooper,bloodhoof,1565,evoker,devastation,39,22,17
Спайрок,gordunni,1562,evoker,devastation,77,36,41
Ryujíin,kazzak,1561,evoker,devastation,30,17,13
Snoby,onyxia,1552,evoker,devastation,51,25,26
Ch,ghostlands,1551,evoker,devastation,41,20,21
Cûddles,hyjal,1548,evoker,devastation,132,68,64
Archdragon,argent-dawn,1547,evoker,devastation,30,18,12
Tetsú,tarren-mill,1541,evoker,devastation,36,20,16
Kayly,twisting-nether,1540,evoker,devastation,42,29,13
Batsquatch,argent-dawn,1539,evoker,devastation,30,18,12
Drazam,blackrock,1524,evoker,devastation,76,43,33
Hyperflexx,blackrock,1521,evoker,devastation,30,16,14
Agnî,sanguino,1520,evoker,devastation,70,35,35
Tibimbo,blackrock,1506,evoker,devastation,68,39,29
Лабриса,galakrond,1498,evoker,devastation,41,19,22
Mommystrasza,dentarg,1493,evoker,devastation,86,43,43
Drákon,dalaran,1490,evoker,devastation,42,19,23
Инсейнмэн,soulflayer,1489,evoker,devastation,62,31,31
Kaynyxia,argent-dawn,1487,evoker,devastation,45,25,20
Dracyan,taerar,1479,evoker,devastation,42,24,18
Ironwing,sanguino,1476,evoker,devastation,276,143,133
Baroqs,antonidas,1456,evoker,devastation,24,18,6
Nazalath,eonar,1454,evoker,devastation,65,35,30
Malfoyer,arathor,1452,evoker,devastation,54,30,24
Emmagosa,argent-dawn,1451,evoker,devastation,30,17,13
Drakea,sanguino,1445,evoker,devastation,35,18,17
Ларенил,gordunni,1436,evoker,devastation,30,15,15
Sakade,archimonde,1431,evoker,devastation,60,22,38
Homeoffice,zenedar,1430,evoker,devastation,24,15,9
Pippomale,nemesis,1430,evoker,devastation,42,22,20
Caliss,archimonde,1427,evoker,devastation,71,38,33
Drakshoff,khaz-modan,1425,evoker,devastation,59,31,28
Jeannedebruj,ravencrest,1416,evoker,devastation,45,16,29
Dowaa,tarren-mill,1414,evoker,devastation,30,15,15
Ipanicsoar,tarren-mill,1401,evoker,devastation,35,15,20
Darktempest,onyxia,1387,evoker,devastation,36,20,16
Паунфаунд,eversong,1382,evoker,devastation,72,32,40
Arbylegion,outland,1380,evoker,devastation,66,34,32
Drunkino,aegwynn,1377,evoker,devastation,48,23,25
Nathraakhza,argent-dawn,1375,evoker,devastation,42,23,19
Potéto,rashgarroth,1375,evoker,devastation,54,23,31
Sintharion,ravencrest,1372,evoker,devastation,39,17,22
Ксдз,soulflayer,1368,evoker,devastation,42,20,22
Øseria,khaz-modan,1363,evoker,devastation,42,25,17
Ken,la-croisade-écarlate,1350,evoker,devastation,84,40,44
Rowzy,sylvanas,1350,evoker,devastation,59,28,31
Ryuu,mazrigos,1343,evoker,devastation,24,14,10
Yoshinora,archimonde,1337,evoker,devastation,30,15,15
Углекислот,howling-fjord,1327,evoker,devastation,36,14,22
Favill,blackhand,1318,evoker,devastation,45,18,27
Xtdrakaris,uldum,1309,evoker,devastation,179,85,94
Flügelnix,blackmoore,1304,evoker,devastation,30,14,16
Draxone,malfurion,1297,evoker,devastation,54,33,21
Yála,anetheron,1286,evoker,devastation,149,75,74
Steeken,haomarush,1282,evoker,devastation,42,17,25
Airbourne,sanguino,1280,evoker,devastation,38,18,20
Кунидракон,gordunni,1276,evoker,devastation,29,14,15
Shmog,stormscale,1272,evoker,devastation,41,15,26
Gharløk,outland,1262,evoker,devastation,50,27,23
Llael,blackhand,1259,evoker,devastation,86,36,50
Коляомон,gordunni,1255,evoker,devastation,42,24,18
Magmarôs,argent-dawn,1252,evoker,devastation,31,16,15
Parisinka,silvermoon,1251,evoker,devastation,119,57,62
Dragoncloak,blackrock,1249,evoker,devastation,72,44,28
Swapxyevo,ravencrest,1246,evoker,devastation,24,13,11
Lagerstrasza,stormreaver,1234,evoker,devastation,30,13,17
Stefanosxios,bloodfeather,1224,evoker,devastation,36,13,23
Tokzestra,hyjal,1222,evoker,devastation,62,28,34
Dragonaked,silvermoon,1220,evoker,devastation,42,18,24
Heõ,twisting-nether,1215,evoker,devastation,33,14,19
Душнот,fordragon,1214,evoker,devastation,30,15,15
Yaldthion,dun-modr,1212,evoker,devastation,36,14,22
Isizzu,draenor,1205,evoker,devastation,73,37,36
Blasto,tarren-mill,1205,evoker,devastation,42,16,26
Димадракон,gordunni,1195,evoker,devastation,34,21,13
Dragomakry,blackmoore,1176,evoker,devastation,18,14,4
Flaminghot,stormreaver,1172,evoker,devastation,152,84,68
Ahiresegyfej,ragnaros,1170,evoker,devastation,42,25,17
Evodraxx,hyjal,1152,evoker,devastation,24,12,12
Duvahkahr,ragnaros,1149,evoker,devastation,30,12,18
Nuvese,tarren-mill,1147,evoker,devastation,24,12,12
Zaralek,stormscale,1145,evoker,devastation,18,12,6
Karnâks,silvermoon,1131,evoker,devastation,24,12,12
Sleepnot,argent-dawn,1121,evoker,devastation,18,12,6
Theredpepper,outland,1104,evoker,devastation,30,12,18
Childofdawn,blackmoore,1091,evoker,devastation,24,12,12
Thebigsmoke,lightbringer,1079,evoker,devastation,48,20,28
Padrepì,nemesis,1078,evoker,devastation,18,13,5
Iolite,dun-modr,1061,evoker,devastation,66,31,35
Canitabravar,cthun,1058,evoker,devastation,36,18,18
Evojøa,tarren-mill,1056,evoker,devastation,18,11,7
Zmej,twisting-nether,1056,evoker,devastation,24,11,13
Shenronblue,bloodscalp,1054,evoker,devastation,18,11,7
Pêrcevâl,archimonde,1053,evoker,devastation,24,11,13
Tenshà,nemesis,1048,evoker,devastation,18,11,7
Tályn,twisting-nether,1047,evoker,devastation,18,11,7
Cinnannoe,tarren-mill,1047,evoker,devastation,24,11,13
Akúda,blackhand,1032,evoker,devastation,30,13,17
Рептилойдина,howling-fjord,1030,evoker,devastation,24,11,13
Voldermort,ravencrest,1018,evoker,devastation,23,11,12
Алыйкиви,howling-fjord,1016,evoker,devastation,21,12,9
Ekko,nethersturm,998,evoker,devastation,24,12,12
Lùñe,hyjal,959,evoker,devastation,12,10,2
Terradòr,die-aldor,959,evoker,devastation,18,10,8
Hömeöffice,sylvanas,958,evoker,devastation,18,10,8
Draghad,blackmoore,958,evoker,devastation,18,10,8
Evokimag,grim-batol,958,evoker,devastation,24,10,14
Nagoli,silvermoon,957,evoker,devastation,18,10,8
Maccen,twisting-nether,955,evoker,devastation,18,10,8
Enzospatalo,nemesis,955,evoker,devastation,18,10,8
Grajade,dun-modr,954,evoker,devastation,18,10,8
Cuufizix,silvermoon,952,evoker,devastation,18,10,8
Leskano,aegwynn,948,evoker,devastation,24,12,12
Sleipnyr,garrosh,941,evoker,devastation,48,23,25
Scalo,kazzak,935,evoker,devastation,17,10,7
Donairian,doomhammer,911,evoker,devastation,54,27,27
Stormydude,doomhammer,903,evoker,devastation,18,10,8
Быковскии,howling-fjord,885,evoker,devastation,42,23,19
Shaze,zuljin,879,evoker,devastation,17,10,7
Гневиан,eversong,864,evoker,devastation,12,9,3
Orazur,hyjal,864,evoker,devastation,12,9,3
Yimvoker,blackrock,864,evoker,devastation,18,9,9
Yol,bladefist,864,evoker,devastation,18,9,9
Kmzi,twisting-nether,864,evoker,devastation,18,9,9
Рогатыйдебик,gordunni,863,evoker,devastation,18,9,9
Аймбадикабтв,howling-fjord,863,evoker,devastation,18,9,9
Sagrax,silvermoon,863,evoker,devastation,18,9,9
Туймаада,soulflayer,862,evoker,devastation,12,9,3
Saragoza,kirin-tor,862,evoker,devastation,18,9,9
Dschíses,malganis,858,evoker,devastation,18,9,9
Crygon,outland,857,evoker,devastation,18,9,9
Флардикас,gordunni,842,evoker,devastation,24,9,15
Dragonhero,arygos,830,evoker,devastation,36,16,20
Dragotar,malygos,814,evoker,devastation,28,11,17
Tsunamì,ysondre,768,evoker,devastation,12,8,4
Azorgaron,outland,768,evoker,devastation,12,8,4
Mazakqt,draenor,768,evoker,devastation,12,8,4
Пивнаябошка,soulflayer,768,evoker,devastation,12,8,4
Nekrosdrake,tarren-mill,768,evoker,devastation,18,8,10
Zp,kazzak,768,evoker,devastation,18,8,10
Dragonlia,blackrock,767,evoker,devastation,12,8,4
Dragonide,draenor,767,evoker,devastation,18,8,10
Deathwingx,sylvanas,767,evoker,devastation,18,8,10
Flawxy,blackmoore,766,evoker,devastation,18,8,10
Sharaxis,blackmoore,764,evoker,devastation,18,8,10
Ayders,khaz-modan,764,evoker,devastation,24,8,16
Evosker,zuljin,764,evoker,devastation,24,8,16
Keeqo,silvermoon,762,evoker,devastation,18,8,10
Ольменго,fordragon,735,evoker,devastation,17,8,9
Rîncêwind,uldum,726,evoker,devastation,18,8,10
Эбиб,gordunni,672,evoker,devastation,12,7,5
Crueh,outland,672,evoker,devastation,12,7,5
Varagon,rexxar,672,evoker,devastation,12,7,5
Aegón,uldum,672,evoker,devastation,18,7,11
Evoslaps,norgannon,671,evoker,devastation,12,7,5
Stalkhyr,elune,671,evoker,devastation,18,7,11
Enemi,twisting-nether,669,evoker,devastation,14,9,5
Fruhans,tarren-mill,667,evoker,devastation,12,7,5
Vucashi,blackhand,665,evoker,devastation,18,7,11
Scalash,drakthul,658,evoker,devastation,12,7,5
Zharas,nemesis,623,evoker,devastation,11,7,4
Fogwing,ravencrest,622,evoker,devastation,17,7,10
Morsan,tichondrius,619,evoker,devastation,11,7,4
Dovakin,arathi,601,evoker,devastation,14,7,7
Lago,gorgonnash,588,evoker,devastation,13,7,6
Zpartadraga,ragnaros,584,evoker,devastation,9,8,1
Henmon,defias-brotherhood,576,evoker,devastation,6,6,0
Øxyom,archimonde,576,evoker,devastation,10,7,3
Khimari,xavius,576,evoker,devastation,12,6,6
Scathethrel,draenor,576,evoker,devastation,12,6,6
Krazuntus,argent-dawn,576,evoker,devastation,12,6,6
Glurakk,aegwynn,576,evoker,devastation,12,6,6
Bodytypechad,ravencrest,576,evoker,devastation,12,6,6
Solandor,kazzak,576,evoker,devastation,12,6,6
Tremmérz,outland,576,evoker,devastation,12,6,6
Terrorclaw,ragnaros,576,evoker,devastation,12,6,6
Mattyastrasz,hyjal,576,evoker,devastation,12,6,6
Amnevoker,dalaran,576,evoker,devastation,12,6,6
Haltorr,ravencrest,576,evoker,devastation,18,6,12
Lifestrasza,drakthul,575,evoker,devastation,6,6,0
Xfckd,ragnaros,575,evoker,devastation,12,6,6
Chunlooi,baelgun,575,evoker,devastation,12,6,6
Dratheon,dun-modr,575,evoker,devastation,12,6,6
Firaxis,kazzak,573,evoker,devastation,12,6,6
Xatures,twisting-nether,572,evoker,devastation,6,6,0
Ryújín,blackhand,527,evoker,devastation,17,6,11
Avizz,tarren-mill,480,evoker,devastation,6,5,1
Juicyjeffe,blackrock,480,evoker,devastation,6,5,1
Deny,frostmane,480,evoker,devastation,6,5,1
Fayral,blackmoore,480,evoker,devastation,6,5,1
Дракшотик,soulflayer,480,evoker,devastation,6,5,1
Jinthyr,anachronos,480,evoker,devastation,6,5,1
Loveheart,die-aldor,480,evoker,devastation,12,5,7
Dracnass,silvermoon,480,evoker,devastation,12,5,7
Raagnar,kazzak,480,evoker,devastation,12,5,7
Pandagos,archimonde,480,evoker,devastation,12,5,7
Hehehihihaha,ravencrest,480,evoker,devastation,12,5,7
Burnrate,draenor,480,evoker,devastation,12,5,7
Pavelito,ysondre,480,evoker,devastation,12,5,7
Bindrasz,ahnqiraj,480,evoker,devastation,12,5,7
Sloeez,kazzak,480,evoker,devastation,18,5,13
Dakir,blackmoore,479,evoker,devastation,8,5,3
Vermithors,ravencrest,479,evoker,devastation,12,5,7
Dragônslayer,amanthul,478,evoker,devastation,6,5,1
Vanima,forscherliga,477,evoker,devastation,6,5,1
Lugarius,gilneas,477,evoker,devastation,16,6,10
Syraxis,shadowsong,415,evoker,devastation,10,5,5
Elitedraach,tarren-mill,384,evoker,devastation,6,4,2
Dragorus,stormscale,384,evoker,devastation,6,4,2
Zyevoker,silvermoon,384,evoker,devastation,6,4,2
Deathdream,stormscale,384,evoker,devastation,6,4,2
Saintly,kult-der-verdammten,384,evoker,devastation,6,4,2
Nurilla,twisting-nether,384,evoker,devastation,6,4,2
Scalewind,twisting-nether,384,evoker,devastation,6,4,2
Nochance,dentarg,384,evoker,devastation,6,4,2
Pinacóladaqt,stormscale,384,evoker,devastation,6,4,2
Melodio,outland,384,evoker,devastation,6,4,2
Iblvicanfly,stormscale,384,evoker,devastation,6,4,2
Skiora,argent-dawn,384,evoker,devastation,6,4,2
Штеци,howling-fjord,384,evoker,devastation,6,4,2
Wurm,shadowsong,384,evoker,devastation,6,4,2
Advancedboy,archimonde,384,evoker,devastation,6,4,2
Nynnaydoth,drakthul,384,evoker,devastation,12,4,8
Croker,ravencrest,384,evoker,devastation,12,4,8
Лавеон,gordunni,384,evoker,devastation,12,4,8
Grillkylling,outland,384,evoker,devastation,12,4,8
Skywitch,ragnaros,384,evoker,devastation,18,4,14
Hekatonshire,hyjal,383,evoker,devastation,6,4,2
Мизурион,gordunni,382,evoker,devastation,6,4,2
Sheego,anetheron,382,evoker,devastation,6,4,2
Kayizer,archimonde,382,evoker,devastation,6,4,2
Davioncz,thunderhorn,382,evoker,devastation,6,4,2
Dracsamdi,tarren-mill,367,evoker,devastation,11,4,7
Somntersu,argent-dawn,319,evoker,devastation,5,4,1
Драккалис,eversong,288,evoker,devastation,6,3,3
Puffdaddyxd,twisting-nether,288,evoker,devastation,6,3,3
Apacstrasza,ragnaros,288,evoker,devastation,6,3,3
Lajra,ragnaros,288,evoker,devastation,6,3,3
Hateroll,ravencrest,288,evoker,devastation,6,3,3
Ðragøn,argent-dawn,288,evoker,devastation,6,3,3
Dracofion,ravencrest,288,evoker,devastation,6,3,3
Feldrac,ravencrest,288,evoker,devastation,6,3,3
Whaazzdragon,tarren-mill,288,evoker,devastation,6,3,3
Mollÿ,sanguino,288,evoker,devastation,6,3,3
Geckonen,stormreaver,288,evoker,devastation,6,3,3
Predictrash,archimonde,288,evoker,devastation,6,3,3
Dracofeuxd,archimonde,288,evoker,devastation,6,3,3
Feinerkerl,blackmoore,288,evoker,devastation,6,3,3
Lektar,eredar,288,evoker,devastation,6,3,3
Azustraza,ysondre,288,evoker,devastation,6,3,3
Bombrush,ragnaros,288,evoker,devastation,6,3,3
Paizz,tarren-mill,288,evoker,devastation,6,3,3
Nerfmeplze,outland,288,evoker,devastation,6,3,3
Zettaflare,nazjatar,288,evoker,devastation,6,3,3
Jaykvoker,kazzak,288,evoker,devastation,6,3,3
Zapaflap,silvermoon,288,evoker,devastation,6,3,3
Fivebeers,silvermoon,288,evoker,devastation,6,3,3
Drachenwut,aegwynn,288,evoker,devastation,6,3,3
Dalsath,silvermoon,288,evoker,devastation,6,3,3
Azurog,blackmoore,288,evoker,devastation,6,3,3
Ughvoker,kazzak,288,evoker,devastation,6,3,3
Tiganj,silvermoon,288,evoker,devastation,6,3,3
Malowux,outland,288,evoker,devastation,6,3,3
Ripgódx,bronzebeard,288,evoker,devastation,6,3,3
Mazzg,blackmoore,288,evoker,devastation,9,4,5
Шотнутый,soulflayer,288,evoker,devastation,9,4,5
Veo,aggra-português,288,evoker,devastation,12,3,9
Valdrakken,anubarak,288,evoker,devastation,12,3,9
Kirien,blackhand,288,evoker,devastation,12,3,9
Hästdrake,the-maelstrom,288,evoker,devastation,12,3,9
Belianf,silvermoon,287,evoker,devastation,6,3,3
Sivaas,arathi,286,evoker,devastation,6,3,3
Филлид,gordunni,255,evoker,devastation,8,4,4
Azzul,teldrassil,233,evoker,devastation,6,4,2
Chürbis,blackmoore,192,evoker,devastation,6,2,4
Draaxy,twisting-nether,192,evoker,devastation,6,2,4
Niluslangbal,stormscale,192,evoker,devastation,6,2,4
Reddeaddrago,silvermoon,192,evoker,devastation,6,2,4
Xendragon,kazzak,192,evoker,devastation,6,2,4
Ppiaxx,dalaran,192,evoker,devastation,6,2,4
Exitelolx,blackrock,192,evoker,devastation,6,2,4
Spicylizard,stormscale,192,evoker,devastation,6,2,4
Kda,die-nachtwache,192,evoker,devastation,6,2,4
Otr,draenor,192,evoker,devastation,6,2,4
Adamâs,archimonde,192,evoker,devastation,6,2,4
Abehethan,archimonde,192,evoker,devastation,6,2,4
Twokgbananas,blackhand,192,evoker,devastation,6,2,4
Митокада,soulflayer,192,evoker,devastation,6,2,4
Norskairline,kazzak,192,evoker,devastation,6,2,4
Vynestria,argent-dawn,192,evoker,devastation,6,2,4
Wuiflyta,dun-modr,192,evoker,devastation,6,2,4
Bal,arakarahm,192,evoker,devastation,6,2,4
Bæxo,blackrock,192,evoker,devastation,6,2,4
Rokki,blackrock,192,evoker,devastation,6,2,4
Ellphi,illidan,192,evoker,devastation,6,2,4
Kroqmoo,drekthar,192,evoker,devastation,7,2,5
Jacra,twisting-nether,192,evoker,devastation,12,2,10
Дракомант,eversong,192,evoker,devastation,12,2,10
Andragosa,confrérie-du-thorium,192,evoker,devastation,12,2,10
Tenkenfutsu,elune,192,evoker,devastation,18,2,16
Kraakraa,turalyon,191,evoker,devastation,6,2,4
Drakridarn,kazzak,159,evoker,devastation,5,2,3
Gypsydrake,tarren-mill,159,evoker,devastation,8,3,5
Йормунгандка,soulflayer,144,evoker,devastation,9,3,6
Tneen,stormscale,96,evoker,devastation,3,2,1
Czerwonooki,turalyon,96,evoker,devastation,6,1,5
Dracarysfire,kazzak,96,evoker,devastation,6,1,5
Asharys,argent-dawn,96,evoker,devastation,6,1,5
Мельхиор,booty-bay,96,evoker,devastation,6,1,5
Zørix,hyjal,96,evoker,devastation,6,1,5
Кеннокс,soulflayer,96,evoker,devastation,6,1,5
Алексатэтсуя,ashenvale,96,evoker,devastation,6,1,5
Oeos,dragonblight,96,evoker,devastation,6,1,5
Oldlizard,blackrock,96,evoker,devastation,6,1,5
Evøkergøðx,outland,96,evoker,devastation,6,1,5
Devanthar,argent-dawn,96,evoker,devastation,6,1,5
Släshés,ravencrest,96,evoker,devastation,6,1,5
Terrorwings,twisting-nether,96,evoker,devastation,6,1,5
Xidalulz,sylvanas,63,evoker,devastation,2,2,0
Bulydracguir,kazzak,42,evoker,devastation,7,2,5
Âspên,archimonde,31,evoker,devastation,2,1,1
Pjållistani,ravencrest,2014,hunter,marksmanship,113,64,49
Matasso,burning-legion,2003,hunter,marksmanship,83,44,39
Nennimi,ravencrest,1978,hunter,marksmanship,87,44,43
Stavfel,kazzak,1952,hunter,marksmanship,71,37,34
Huprah,ravencrest,1901,hunter,marksmanship,126,63,63
Душнила,razuvious,1898,hunter,marksmanship,83,44,39
Мартидэн,howling-fjord,1889,hunter,marksmanship,119,56,63
Alêx,outland,1888,hunter,marksmanship,102,49,53
Yasuohasagi,archimonde,1828,hunter,marksmanship,42,23,19
Evacuatur,argent-dawn,1826,hunter,marksmanship,66,33,33
Wildheárt,aegwynn,1824,hunter,marksmanship,66,35,31
Techpoint,silvermoon,1816,hunter,marksmanship,42,27,15
Crôwley,twisting-nether,1816,hunter,marksmanship,54,30,24
Xanter,blackrock,1806,hunter,marksmanship,36,20,16
Áñmy,ravencrest,1804,hunter,marksmanship,53,28,25
Mogwai,stormscale,1801,hunter,marksmanship,59,29,30
Ancalarion,tarren-mill,1782,hunter,marksmanship,48,24,24
Wruck,echsenkessel,1779,hunter,marksmanship,42,29,13
Myice,twisting-nether,1771,hunter,marksmanship,66,36,30
Hallé,frostmane,1769,hunter,marksmanship,66,39,27
Murtagh,khaz-modan,1767,hunter,marksmanship,66,35,31
Ceitronox,argent-dawn,1765,hunter,marksmanship,42,23,19
Bestregards,ravencrest,1742,hunter,marksmanship,60,25,35
Onlystuns,sylvanas,1720,hunter,marksmanship,47,22,25
Strikke,archimonde,1709,hunter,marksmanship,42,18,24
Johnreapèr,sylvanas,1698,hunter,marksmanship,65,29,36
Scheixanter,drakthul,1684,hunter,marksmanship,77,37,40
Skilachi,stormscale,1684,hunter,marksmanship,48,21,27
Lowcaskor,turalyon,1678,hunter,marksmanship,47,26,21
Jabela,eredar,1668,hunter,marksmanship,78,35,43
Bearmane,tarren-mill,1663,hunter,marksmanship,70,35,35
Hï,eitrigg,1662,hunter,marksmanship,48,21,27
Eldrekou,kazzak,1657,hunter,marksmanship,48,22,26
Buffrøgues,ravencrest,1651,hunter,marksmanship,48,23,25
Speedhack,argent-dawn,1650,hunter,marksmanship,63,35,28
Травок,gordunni,1648,hunter,marksmanship,58,32,26
Dexter,ravencrest,1644,hunter,marksmanship,53,22,31
Ремонтлицаа,gordunni,1642,hunter,marksmanship,85,49,36
Velrox,blackmoore,1641,hunter,marksmanship,48,23,25
Evengance,dragonblight,1638,hunter,marksmanship,42,32,10
Naid,lordaeron,1632,hunter,marksmanship,36,20,16
Huntrag,tarren-mill,1632,hunter,marksmanship,95,44,51
Куфачка,soulflayer,1627,hunter,marksmanship,36,17,19
Адвентурер,howling-fjord,1624,hunter,marksmanship,84,46,38
Ледо,deathguard,1621,hunter,marksmanship,42,19,23
Trashcarlito,eredar,1619,hunter,marksmanship,24,17,7
Khregan,aerie-peak,1612,hunter,marksmanship,36,17,19
Дарктеххно,howling-fjord,1611,hunter,marksmanship,30,17,13
Lenooby,blades-edge,1600,hunter,marksmanship,36,20,16
Dragnial,kazzak,1592,hunter,marksmanship,41,18,23
Gugenot,tarren-mill,1589,hunter,marksmanship,56,33,23
Desudi,tarren-mill,1588,hunter,marksmanship,59,30,29
Recrent,kazzak,1582,hunter,marksmanship,96,53,43
Inayah,outland,1579,hunter,marksmanship,73,41,32
Длинноемоджо,soulflayer,1576,hunter,marksmanship,96,47,49
Лисатия,gordunni,1562,hunter,marksmanship,48,22,26
Мизэрица,soulflayer,1556,hunter,marksmanship,60,29,31
Natchell,ysondre,1555,hunter,marksmanship,36,18,18
Mantinell,hellfire,1553,hunter,marksmanship,36,20,16
Minisay,magtheridon,1547,hunter,marksmanship,178,88,90
Килофвратх,gordunni,1545,hunter,marksmanship,36,18,18
Lebalaffré,arathi,1537,hunter,marksmanship,71,37,34
Nidaliyae,archimonde,1532,hunter,marksmanship,36,16,20
Vangeroth,kazzak,1530,hunter,marksmanship,120,64,56
Doncar,stormscale,1527,hunter,marksmanship,57,28,29
Vavabxl,ysondre,1524,hunter,marksmanship,42,22,20
Mînérvá,blackhand,1521,hunter,marksmanship,48,31,17
Elja,laughing-skull,1521,hunter,marksmanship,30,19,11
Миссклик,soulflayer,1515,hunter,marksmanship,30,20,10
Chaussons,kazzak,1506,hunter,marksmanship,66,33,33
Eferos,quelthalas,1502,hunter,marksmanship,36,16,20
Rattentäter,alexstrasza,1498,hunter,marksmanship,54,28,26
Yarnvid,twisting-nether,1493,hunter,marksmanship,75,38,37
Summa,silvermoon,1482,hunter,marksmanship,54,26,28
Nanns,silvermoon,1470,hunter,marksmanship,30,16,14
Tntabsotrap,silvermoon,1456,hunter,marksmanship,40,23,17
Rex,chamber-of-aspects,1454,hunter,marksmanship,39,23,16
Autoturret,eredar,1454,hunter,marksmanship,48,24,24
Хальвеген,gordunni,1452,hunter,marksmanship,76,36,40
Meinkoenig,frostwolf,1448,hunter,marksmanship,48,30,18
Hunsed,sanguino,1445,hunter,marksmanship,36,23,13
Asthorio,stormscale,1442,hunter,marksmanship,83,36,47
Balamut,aegwynn,1440,hunter,marksmanship,71,39,32
Джоуе,ashenvale,1437,hunter,marksmanship,30,15,15
Yezzu,sylvanas,1437,hunter,marksmanship,33,16,17
Kariss,khaz-modan,1437,hunter,marksmanship,84,38,46
Luuszapfae,aegwynn,1436,hunter,marksmanship,29,16,13
Nagu,antonidas,1435,hunter,marksmanship,30,15,15
Skillzone,silvermoon,1432,hunter,marksmanship,36,15,21
Triggaz,stormscale,1421,hunter,marksmanship,40,16,24
Kalima,malfurion,1416,hunter,marksmanship,72,28,44
Firescorpion,onyxia,1414,hunter,marksmanship,30,19,11
Шимэйла,gordunni,1414,hunter,marksmanship,43,22,21
Darts,outland,1414,hunter,marksmanship,30,15,15
Elonyr,sanguino,1411,hunter,marksmanship,196,90,106
Meskette,ravencrest,1396,hunter,marksmanship,24,15,9
Miladinorc,azjolnerub,1395,hunter,marksmanship,24,15,9
Àfpro,hyjal,1394,hunter,marksmanship,30,15,15
Podroto,tyrande,1387,hunter,marksmanship,35,15,20
Boomkillshot,zuljin,1386,hunter,marksmanship,30,21,9
Carpante,nemesis,1383,hunter,marksmanship,42,17,25
Lincolne,ravencrest,1375,hunter,marksmanship,41,17,24
Stingarrow,stormscale,1374,hunter,marksmanship,42,24,18
Дисконнэктор,soulflayer,1374,hunter,marksmanship,48,17,31
Bøøgy,silvermoon,1366,hunter,marksmanship,36,21,15
Mindgap,pozzo-delleternità,1365,hunter,marksmanship,42,17,25
Iòvól,azuremyst,1364,hunter,marksmanship,60,33,27
Slmao,tarren-mill,1357,hunter,marksmanship,60,27,33
Szybky,defias-brotherhood,1354,hunter,marksmanship,60,25,35
Оленнька,howling-fjord,1349,hunter,marksmanship,36,21,15
Selaesa,chamber-of-aspects,1345,hunter,marksmanship,36,18,18
Будкусломаю,grom,1345,hunter,marksmanship,41,16,25
Cenaa,ragnaros,1343,hunter,marksmanship,19,14,5
Rzeezznik,burning-legion,1333,hunter,marksmanship,24,14,10
Amphi,stormscale,1333,hunter,marksmanship,54,30,24
Aimnfire,anachronos,1333,hunter,marksmanship,36,18,18
Røxxilia,blackmoore,1333,hunter,marksmanship,54,23,31
Glad,argent-dawn,1333,hunter,marksmanship,55,21,34
Mizumo,burning-legion,1332,hunter,marksmanship,59,34,25
Pickaboo,defias-brotherhood,1330,hunter,marksmanship,108,48,60
Deadfire,hyjal,1325,hunter,marksmanship,42,20,22
Diapositiv,draenor,1325,hunter,marksmanship,30,14,16
Zirgoo,outland,1320,hunter,marksmanship,66,28,38
Encore,sylvanas,1319,hunter,marksmanship,36,17,19
Narøs,blackhand,1314,hunter,marksmanship,54,24,30
Narawinger,silvermoon,1310,hunter,marksmanship,36,21,15
Arrowdoxx,silvermoon,1310,hunter,marksmanship,117,51,66
Høward,aegwynn,1300,hunter,marksmanship,36,20,16
Samhunt,blackrock,1299,hunter,marksmanship,29,14,15
Bigfoot,argent-dawn,1291,hunter,marksmanship,72,31,41
Touscahunter,kazzak,1290,hunter,marksmanship,120,64,56
Yoúmad,draenor,1288,hunter,marksmanship,28,14,14
Smitheye,argent-dawn,1287,hunter,marksmanship,84,40,44
Kyudo,ravencrest,1286,hunter,marksmanship,35,15,20
Rabiate,blackrock,1284,hunter,marksmanship,34,16,18
Prodanhunts,frostmane,1275,hunter,marksmanship,54,24,30
Хантвкроксах,gordunni,1257,hunter,marksmanship,22,14,8
Booms,eonar,1254,hunter,marksmanship,65,31,34
Одисенс,eversong,1250,hunter,marksmanship,57,30,27
Iilac,argent-dawn,1242,hunter,marksmanship,184,104,80
Barnabaz,skullcrusher,1238,hunter,marksmanship,24,13,11
Shedzargo,twisting-nether,1234,hunter,marksmanship,24,13,11
Fränko,ravencrest,1234,hunter,marksmanship,30,13,17
Doomhorg,quelthalas,1232,hunter,marksmanship,42,19,23
Mmaaee,ravencrest,1228,hunter,marksmanship,28,14,14
Babclaar,culte-de-la-rive-noire,1227,hunter,marksmanship,18,13,5
Watty,chogall,1227,hunter,marksmanship,76,40,36
Mönster,ravenholdt,1223,hunter,marksmanship,24,13,11
Travels,tarren-mill,1222,hunter,marksmanship,30,13,17
Redneckjoe,draenor,1219,hunter,marksmanship,41,18,23
Elyxa,ysondre,1211,hunter,marksmanship,48,27,21
Bollo,malganis,1211,hunter,marksmanship,29,13,16
Blackas,dun-modr,1208,hunter,marksmanship,42,19,23
Arize,quelthalas,1204,hunter,marksmanship,67,32,35
Jeston,amanthul,1202,hunter,marksmanship,31,14,17
Skohal,draenor,1200,hunter,marksmanship,78,36,42
Poatan,outland,1167,hunter,marksmanship,87,44,43
Blowplac,moonglade,1157,hunter,marksmanship,34,14,20
Sâetha,dun-modr,1157,hunter,marksmanship,36,14,22
Jodd,ragnaros,1152,hunter,marksmanship,24,12,12
Olyleskotch,ravencrest,1152,hunter,marksmanship,24,12,12
Amistat,kazzak,1149,hunter,marksmanship,30,12,18
Farmerjoee,alakir,1147,hunter,marksmanship,24,13,11
Kendow,blackrock,1146,hunter,marksmanship,55,24,31
Роктджана,deathguard,1143,hunter,marksmanship,24,12,12
Smekminbåge,tarren-mill,1142,hunter,marksmanship,30,12,18
Lillynahh,argent-dawn,1142,hunter,marksmanship,54,21,33
Jup,elune,1141,hunter,marksmanship,43,12,31
Swïtchz,hyjal,1140,hunter,marksmanship,27,13,14
Gilgharsh,rajaxx,1138,hunter,marksmanship,24,12,12
Хапмьюзик,howling-fjord,1138,hunter,marksmanship,42,13,29
Tinlop,ragnaros,1137,hunter,marksmanship,42,17,25
Naven,minahonda,1130,hunter,marksmanship,30,13,17
Cooroona,stormrage,1119,hunter,marksmanship,24,12,12
Serihu,cthun,1119,hunter,marksmanship,36,12,24
Xesih,twisting-nether,1116,hunter,marksmanship,35,13,22
Overhït,hyjal,1106,hunter,marksmanship,47,19,28
Voitelka,terokkar,1104,hunter,marksmanship,36,18,18
Souljâh,ravencrest,1093,hunter,marksmanship,23,12,11
Анхантэй,lich-king,1092,hunter,marksmanship,136,69,67
Сандабар,borean-tundra,1083,hunter,marksmanship,35,18,17
Thelasiel,aerie-peak,1079,hunter,marksmanship,67,33,34
Gromaya,elune,1072,hunter,marksmanship,23,12,11
Opsi,area-52,1066,hunter,marksmanship,32,12,20
Sisilianno,khaz-modan,1063,hunter,marksmanship,43,15,28
Epheso,daggerspine,1055,hunter,marksmanship,18,11,7
Iceyx,stormscale,1055,hunter,marksmanship,30,11,19
Dentaar,draenor,1054,hunter,marksmanship,83,40,43
Darm,sunstrider,1054,hunter,marksmanship,24,11,13
Murkek,drakthul,1053,hunter,marksmanship,18,11,7
Афигеннски,ashenvale,1051,hunter,marksmanship,24,11,13
Короткиствол,gordunni,1051,hunter,marksmanship,30,11,19
Rmnsbm,blackmoore,1050,hunter,marksmanship,18,11,7
Artémíss,kazzak,1050,hunter,marksmanship,24,11,13
Kbesagrillo,sanguino,1050,hunter,marksmanship,24,11,13
Слезыотлука,howling-fjord,1048,hunter,marksmanship,18,11,7
Swáy,twisting-nether,1041,hunter,marksmanship,196,89,107
Винтаж,deepholm,1041,hunter,marksmanship,59,26,33
Cêdric,alleria,1041,hunter,marksmanship,28,12,16
Maroxy,ragnaros,1039,hunter,marksmanship,29,11,18
Fetts,silvermoon,1023,hunter,marksmanship,24,11,13
Lonewolfe,ravencrest,1021,hunter,marksmanship,78,33,45
Slicer,arthas,1019,hunter,marksmanship,41,15,26
Noobatala,tarren-mill,1018,hunter,marksmanship,36,17,19
Laara,khaz-modan,1009,hunter,marksmanship,77,37,40
Bendit,eredar,1009,hunter,marksmanship,30,11,19
Tungusta,defias-brotherhood,1006,hunter,marksmanship,42,19,23
Nutzz,ragnaros,1006,hunter,marksmanship,41,15,26
Zendar,blackmoore,992,hunter,marksmanship,27,11,16
Azsräel,dalaran,991,hunter,marksmanship,27,13,14
Bonquiesha,tarren-mill,991,hunter,marksmanship,25,11,14
Jaýlah,draenor,991,hunter,marksmanship,48,21,27
Lookmyezzy,ravencrest,990,hunter,marksmanship,20,11,9
Ártemide,pozzo-delleternità,975,hunter,marksmanship,33,15,18
Oatmeal,dun-morogh,974,hunter,marksmanship,44,19,25
Квит,blackscar,960,hunter,marksmanship,24,10,14
Velites,aggra-português,959,hunter,marksmanship,18,10,8
Tiidus,burning-legion,955,hunter,marksmanship,18,10,8
Фузег,deathguard,953,hunter,marksmanship,18,10,8
Taveon,turalyon,953,hunter,marksmanship,18,10,8
Ensomnia,silvermoon,952,hunter,marksmanship,12,10,2
Azaella,tarren-mill,948,hunter,marksmanship,18,10,8
Aaryel,outland,948,hunter,marksmanship,18,10,8
Aliyah,blackmoore,946,hunter,marksmanship,42,24,18
Freezyshinkn,blackrock,945,hunter,marksmanship,18,11,7
Tomtus,aggramar,944,hunter,marksmanship,31,14,17
Ispo,frostwolf,935,hunter,marksmanship,46,17,29
Celtya,archimonde,934,hunter,marksmanship,18,10,8
Madida,ravencrest,925,hunter,marksmanship,12,10,2
Эвилтар,soulflayer,925,hunter,marksmanship,20,11,9
Амобарбиталх,gordunni,901,hunter,marksmanship,33,11,22
Ekz,twisting-nether,894,hunter,marksmanship,22,10,12
Adventures,darkmoon-faire,881,hunter,marksmanship,18,10,8
Luckyshooter,nethersturm,877,hunter,marksmanship,71,32,39
Aszasi,azjolnerub,871,hunter,marksmanship,25,10,15
Grafhunter,antonidas,865,hunter,marksmanship,44,21,23
Feelmyfurý,tarren-mill,864,hunter,marksmanship,12,9,3
Aimywinehaus,drakthul,864,hunter,marksmanship,18,9,9
Rizlay,the-maelstrom,864,hunter,marksmanship,24,9,15
Аккулэйд,blackscar,864,hunter,marksmanship,24,9,15
Jayri,ravencrest,863,hunter,marksmanship,18,9,9
Hiðe,archimonde,862,hunter,marksmanship,12,9,3
Ронингуд,gordunni,862,hunter,marksmanship,18,9,9
Theuzikat,ragnaros,861,hunter,marksmanship,24,9,15
Загзигзаг,soulflayer,860,hunter,marksmanship,18,9,9
Gorá,dethecus,858,hunter,marksmanship,12,9,3
Gintønic,blackmoore,857,hunter,marksmanship,36,9,27
Neosmoke,shadowsong,856,hunter,marksmanship,24,9,15
Qmbonboni,ravencrest,855,hunter,marksmanship,24,9,15
Sivoh,silvermoon,854,hunter,marksmanship,24,9,15
Baldazr,shadowsong,853,hunter,marksmanship,24,9,15
Eldrilaon,arthas,852,hunter,marksmanship,39,18,21
Фридор,deathguard,850,hunter,marksmanship,24,10,14
Heavenlyx,area-52,835,hunter,marksmanship,36,9,27
Куфа,blackscar,831,hunter,marksmanship,20,10,10
Wìndrunner,malfurion,826,hunter,marksmanship,59,25,34
Rollei,uldum,816,hunter,marksmanship,18,9,9
Zicko,argent-dawn,799,hunter,marksmanship,23,9,14
Väärä,stormscale,780,hunter,marksmanship,22,9,13
Nyxìa,shattered-halls,768,hunter,marksmanship,12,8,4
Åíøñs,kazzak,768,hunter,marksmanship,12,8,4
Zlejkadlec,burning-blade,768,hunter,marksmanship,18,8,10
Jamzyhunter,emerald-dream,768,hunter,marksmanship,18,8,10
Carre,twilights-hammer,768,hunter,marksmanship,18,8,10
Xqzmytrapz,blackrock,768,hunter,marksmanship,18,8,10
Рбг,blackscar,768,hunter,marksmanship,18,8,10
Celesticx,chamber-of-aspects,768,hunter,marksmanship,18,8,10
Mareyn,argent-dawn,767,hunter,marksmanship,12,8,4
Sylverain,silvermoon,767,hunter,marksmanship,12,8,4
Raegal,sanguino,767,hunter,marksmanship,18,8,10
Dasimir,blackrock,767,hunter,marksmanship,18,8,10
Иоссифсталин,soulflayer,767,hunter,marksmanship,24,8,16
Setis,uldaman,767,hunter,marksmanship,30,8,22
Ëluna,burning-legion,766,hunter,marksmanship,12,8,4
Shoót,blackmoore,766,hunter,marksmanship,18,8,10
Mainblu,nemesis,765,hunter,marksmanship,18,8,10
Ixôn,tarren-mill,765,hunter,marksmanship,24,8,16
Pappous,kul-tiras,764,hunter,marksmanship,18,8,10
Madtony,aegwynn,763,hunter,marksmanship,18,8,10
Sinsé,conseil-des-ombres,762,hunter,marksmanship,12,8,4
Shibai,outland,762,hunter,marksmanship,18,8,10
Серргио,soulflayer,761,hunter,marksmanship,12,8,4
Wetto,ravencrest,759,hunter,marksmanship,18,8,10
Fèhn,krasus,757,hunter,marksmanship,12,8,4
Erestor,hellfire,747,hunter,marksmanship,12,8,4
Calea,zirkel-des-cenarius,743,hunter,marksmanship,24,9,15
Tupalax,outland,734,hunter,marksmanship,22,9,13
Йошумитсу,howling-fjord,727,hunter,marksmanship,14,9,5
Deathøfrats,ravencrest,719,hunter,marksmanship,11,8,3
Greel,saurfang,718,hunter,marksmanship,42,15,27
Talcaliste,archimonde,701,hunter,marksmanship,32,11,21
Costner,darksorrow,672,hunter,marksmanship,12,7,5
Bigbowyahurd,draenor,672,hunter,marksmanship,12,7,5
Avaren,archimonde,672,hunter,marksmanship,12,7,5
Chindala,zuljin,672,hunter,marksmanship,12,7,5
Killershadow,twisting-nether,672,hunter,marksmanship,12,7,5
Weilerz,drakthul,672,hunter,marksmanship,12,7,5
Гусецап,gordunni,672,hunter,marksmanship,12,7,5
Eenel,twisting-nether,672,hunter,marksmanship,12,7,5
Агелетка,gordunni,672,hunter,marksmanship,12,7,5
Merquryh,ravencrest,672,hunter,marksmanship,12,7,5
Vanstro,ragnaros,672,hunter,marksmanship,12,7,5
Dtq,silvermoon,672,hunter,marksmanship,12,7,5
Хвоостт,gordunni,672,hunter,marksmanship,12,7,5
Suchskill,stormreaver,672,hunter,marksmanship,12,7,5
Кисяныч,gordunni,672,hunter,marksmanship,12,7,5
Corrupth,outland,672,hunter,marksmanship,15,8,7
Землепух,howling-fjord,672,hunter,marksmanship,18,7,11
Трольболь,eversong,672,hunter,marksmanship,18,7,11
Birgitta,jaedenar,672,hunter,marksmanship,18,7,11
Джарвиз,soulflayer,672,hunter,marksmanship,18,7,11
Påtrîckbátém,ravencrest,672,hunter,marksmanship,18,7,11
Griffithstew,blackmoore,672,hunter,marksmanship,24,7,17
Онкьяр,gordunni,672,hunter,marksmanship,24,7,17
Drxta,blackrock,672,hunter,marksmanship,24,7,17
Vruh,antonidas,671,hunter,marksmanship,12,7,5
Ôrïøn,archimonde,671,hunter,marksmanship,12,7,5
Maknamara,tarren-mill,671,hunter,marksmanship,12,7,5
Adariana,archimonde,671,hunter,marksmanship,12,7,5
Халикер,soulflayer,671,hunter,marksmanship,12,7,5
Ashrak,frostmourne,671,hunter,marksmanship,18,7,11
Rediction,ravencrest,671,hunter,marksmanship,18,7,11
Ямакасси,thermaplugg,671,hunter,marksmanship,36,7,29
Deathtrapper,bronzebeard,670,hunter,marksmanship,12,7,5
Pewpewshotz,stormscale,670,hunter,marksmanship,12,7,5
Yip,twisting-nether,670,hunter,marksmanship,18,7,11
Baraduh,sylvanas,669,hunter,marksmanship,12,7,5
Каизик,soulflayer,669,hunter,marksmanship,18,7,11
Wishmeweed,kazzak,668,hunter,marksmanship,18,7,11
Survivr,frostmane,667,hunter,marksmanship,12,7,5
Arkman,malganis,660,hunter,marksmanship,30,7,23
Shokre,silvermoon,657,hunter,marksmanship,12,7,5
Breezhunt,twisting-nether,655,hunter,marksmanship,17,7,10
Hardscoped,tarren-mill,655,hunter,marksmanship,23,7,16
Krøsh,blackmoore,646,hunter,marksmanship,18,7,11
Sogoru,dun-modr,637,hunter,marksmanship,15,8,7
Miezuu,ravencrest,620,hunter,marksmanship,15,7,8
Crétin,archimonde,617,hunter,marksmanship,20,8,12
Iniduhr,dalaran,617,hunter,marksmanship,21,8,13
Ofortuna,silvermoon,576,hunter,marksmanship,6,6,0
Absolutnoob,blackrock,576,hunter,marksmanship,9,7,2
Shína,argent-dawn,576,hunter,marksmanship,12,6,6
Huntazt,draenor,576,hunter,marksmanship,12,6,6
Nätzz,dun-modr,576,hunter,marksmanship,12,6,6
Nirn,ravencrest,576,hunter,marksmanship,12,6,6
Инкризшот,gordunni,576,hunter,marksmanship,12,6,6
Aenina,kazzak,576,hunter,marksmanship,12,6,6
Watchouttah,the-maelstrom,576,hunter,marksmanship,12,6,6
Daela,elune,576,hunter,marksmanship,12,6,6
Migro,sylvanas,576,hunter,marksmanship,12,6,6
Манаррия,soulflayer,576,hunter,marksmanship,18,6,12
Луврен,deepholm,576,hunter,marksmanship,18,6,12
Такувами,gordunni,576,hunter,marksmanship,18,6,12
Kilölek,ragnaros,575,hunter,marksmanship,12,6,6
Арийская,gordunni,575,hunter,marksmanship,12,6,6
Tolkienn,archimonde,575,hunter,marksmanship,12,6,6
Gwalëndil,hyjal,575,hunter,marksmanship,12,6,6
Helioshin,pozzo-delleternità,575,hunter,marksmanship,12,6,6
Honzu,silvermoon,575,hunter,marksmanship,12,6,6
Shootingbob,blackrock,575,hunter,marksmanship,12,6,6
Elladiel,blackmoore,575,hunter,marksmanship,12,6,6
Pøca,kaelthas,575,hunter,marksmanship,12,6,6
Vïcødïnë,sinstralis,575,hunter,marksmanship,12,6,6
Chizuna,dun-morogh,575,hunter,marksmanship,12,6,6
Ксидре,eversong,575,hunter,marksmanship,12,6,6
Ina,tarren-mill,575,hunter,marksmanship,12,6,6
Loca,twilights-hammer,575,hunter,marksmanship,12,6,6
Lightarròw,nordrassil,575,hunter,marksmanship,18,6,12
Yanger,burning-legion,575,hunter,marksmanship,18,6,12
Egy,the-maelstrom,574,hunter,marksmanship,12,6,6
Феорика,grom,574,hunter,marksmanship,18,6,12
Omixloua,ragnaros,572,hunter,marksmanship,18,6,12
Kartouche,culte-de-la-rive-noire,565,hunter,marksmanship,12,6,6
Sauer,stormreaver,564,hunter,marksmanship,18,6,12
Rockymarciaa,dalaran,527,hunter,marksmanship,21,6,15
Hoody,culte-de-la-rive-noire,517,hunter,marksmanship,13,7,6
Фэйсконтроль,azuregos,506,hunter,marksmanship,20,6,14
Сальверди,gordunni,480,hunter,marksmanship,6,5,1
Toptìérgoðx,drakthul,480,hunter,marksmanship,6,5,1
Nyjal,archimonde,480,hunter,marksmanship,6,5,1
Antiork,doomhammer,480,hunter,marksmanship,6,5,1
Elyar,eredar,480,hunter,marksmanship,6,5,1
Huntardös,outland,480,hunter,marksmanship,12,5,7
Jomerin,thrall,480,hunter,marksmanship,12,5,7
Крой,howling-fjord,480,hunter,marksmanship,12,5,7
Kravên,anubarak,480,hunter,marksmanship,12,5,7
Tavira,zuljin,480,hunter,marksmanship,12,5,7
Кайсго,gordunni,480,hunter,marksmanship,12,5,7
Imfiné,outland,480,hunter,marksmanship,12,5,7
Øßlíck,ysondre,480,hunter,marksmanship,12,5,7
Nothrokh,auchindoun,480,hunter,marksmanship,12,5,7
Agbaba,twisting-nether,480,hunter,marksmanship,12,5,7
Huntsmart,kazzak,480,hunter,marksmanship,12,5,7
Sashobg,aerie-peak,480,hunter,marksmanship,12,5,7
Огнеборик,howling-fjord,480,hunter,marksmanship,12,5,7
Littlerat,kult-der-verdammten,480,hunter,marksmanship,12,5,7
Carrilynn,blackrock,480,hunter,marksmanship,12,5,7
Galou,ghostlands,480,hunter,marksmanship,12,5,7
Deathmarks,blackrock,480,hunter,marksmanship,12,5,7
Scartet,blackmoore,480,hunter,marksmanship,12,5,7
Lennylynx,garrosh,480,hunter,marksmanship,12,5,7
Ðõt,ravencrest,480,hunter,marksmanship,12,5,7
Dramin,defias-brotherhood,480,hunter,marksmanship,18,5,13
Xoarqt,aegwynn,480,hunter,marksmanship,18,5,13
Aureboby,hyjal,480,hunter,marksmanship,18,5,13
Тэуреэль,gordunni,480,hunter,marksmanship,18,5,13
Tetiscaza,sanguino,480,hunter,marksmanship,24,5,19
Bluetiger,azshara,479,hunter,marksmanship,6,5,1
Jaggatee,senjin,479,hunter,marksmanship,6,5,1
Jozsiur,ragnaros,479,hunter,marksmanship,6,5,1
Zäyk,zuljin,479,hunter,marksmanship,12,5,7
Aourön,archimonde,479,hunter,marksmanship,12,5,7
Nìsalle,argent-dawn,479,hunter,marksmanship,12,5,7
Whereismypet,azjolnerub,479,hunter,marksmanship,12,5,7
Vèreesa,azjolnerub,479,hunter,marksmanship,12,5,7
Bazrzokh,elune,479,hunter,marksmanship,12,5,7
Zerkarok,draenor,479,hunter,marksmanship,18,5,13
Nightarrows,ravencrest,478,hunter,marksmanship,6,5,1
Thebalrog,korgall,478,hunter,marksmanship,12,5,7
Tiph,argent-dawn,478,hunter,marksmanship,12,5,7
Robìnhood,nemesis,477,hunter,marksmanship,12,5,7
Bloodshot,nethersturm,477,hunter,marksmanship,12,5,7
Robros,dentarg,475,hunter,marksmanship,12,5,7
Klittcrit,bloodhoof,475,hunter,marksmanship,12,5,7
Sixty,rajaxx,474,hunter,marksmanship,18,5,13
Karmios,drakthul,473,hunter,marksmanship,12,5,7
Aadarshh,turalyon,473,hunter,marksmanship,12,5,7
Snaped,malganis,447,hunter,marksmanship,11,5,6
Haleth,uldum,447,hunter,marksmanship,17,5,12
Jocitwitch,ragnaros,432,hunter,marksmanship,9,6,3
Zaragattas,aggra-português,426,hunter,marksmanship,17,7,10
Quinty,durotan,414,hunter,marksmanship,8,5,3
Jurá,perenolde,384,hunter,marksmanship,6,4,2
Burninghunt,ravencrest,384,hunter,marksmanship,6,4,2
Dariusmm,silvermoon,384,hunter,marksmanship,6,4,2
Comegetme,auchindoun,384,hunter,marksmanship,6,4,2
Sùnzí,alakir,384,hunter,marksmanship,6,4,2
Hntudwn,azshara,384,hunter,marksmanship,6,4,2
Metak,auchindoun,384,hunter,marksmanship,6,4,2
Sjufemman,ravencrest,384,hunter,marksmanship,6,4,2
Snipinx,draenor,384,hunter,marksmanship,6,4,2
Wîldhunt,burning-legion,384,hunter,marksmanship,6,4,2
Myoui,silvermoon,384,hunter,marksmanship,6,4,2
Nßatrapper,outland,384,hunter,marksmanship,6,4,2
Хантероо,gordunni,384,hunter,marksmanship,6,4,2
Doloresman,tarren-mill,384,hunter,marksmanship,6,4,2
Сацыви,gordunni,384,hunter,marksmanship,6,4,2
Jägarenen,kazzak,384,hunter,marksmanship,6,4,2
Denkstah,tarren-mill,384,hunter,marksmanship,6,4,2
Earlyspring,ragnaros,384,hunter,marksmanship,6,4,2
Silvyina,todeswache,384,hunter,marksmanship,6,4,2
Slo,sylvanas,384,hunter,marksmanship,6,4,2
Сынсема,blackscar,384,hunter,marksmanship,6,4,2
Lrr,grim-batol,384,hunter,marksmanship,6,4,2
Ixxmhunt,blackrock,384,hunter,marksmanship,6,4,2
Sandchaton,ragnaros,384,hunter,marksmanship,6,4,2
Dirtydolores,thrall,384,hunter,marksmanship,6,4,2
Ðøper,hyjal,384,hunter,marksmanship,6,4,2
Nêzz,tarren-mill,384,hunter,marksmanship,6,4,2
Aidsmacka,shattered-hand,384,hunter,marksmanship,6,4,2
Silvyn,pozzo-delleternità,384,hunter,marksmanship,6,4,2
Джеймсфранко,blackscar,384,hunter,marksmanship,6,4,2
Zulthat,thrall,384,hunter,marksmanship,6,4,2
Darllene,kazzak,384,hunter,marksmanship,6,4,2
Kragán,silvermoon,384,hunter,marksmanship,6,4,2
Kanlina,ravencrest,384,hunter,marksmanship,12,4,8
Абунай,soulflayer,384,hunter,marksmanship,12,4,8
Rupeebtw,stormscale,384,hunter,marksmanship,12,4,8
Spêctrâ,sylvanas,384,hunter,marksmanship,12,4,8
Vallêria,malganis,384,hunter,marksmanship,12,4,8
Hashaya,hyjal,384,hunter,marksmanship,12,4,8
Noobhuntress,norgannon,384,hunter,marksmanship,12,4,8
Свадебная,gordunni,384,hunter,marksmanship,12,4,8
Zurzok,blackrock,384,hunter,marksmanship,12,4,8
Bulseye,kilrogg,384,hunter,marksmanship,12,4,8
Deeparrow,stormscale,384,hunter,marksmanship,12,4,8
Йинги,gordunni,384,hunter,marksmanship,12,4,8
Дайпострелят,gordunni,384,hunter,marksmanship,12,4,8
Peonfarmer,argent-dawn,384,hunter,marksmanship,12,4,8
Dangerousfoe,argent-dawn,384,hunter,marksmanship,12,4,8
Ruppig,nozdormu,384,hunter,marksmanship,12,4,8
Bugspitz,outland,384,hunter,marksmanship,12,4,8
Tartaupommes,hyjal,384,hunter,marksmanship,12,4,8
Makaxx,stormscale,384,hunter,marksmanship,12,4,8
Blacksyo,elune,384,hunter,marksmanship,15,4,11
Kêêpsmile,blackmoore,384,hunter,marksmanship,18,4,14
Agarez,blackrock,383,hunter,marksmanship,6,4,2
Конар,soulflayer,383,hunter,marksmanship,6,4,2
Лорбан,gordunni,383,hunter,marksmanship,12,4,8
Kyéra,kirin-tor,383,hunter,marksmanship,12,4,8
Zirriath,mazrigos,383,hunter,marksmanship,12,4,8
Penelopé,darkmoon-faire,383,hunter,marksmanship,12,4,8
Breier,argent-dawn,383,hunter,marksmanship,12,4,8
Hanzolo,uldum,383,hunter,marksmanship,12,4,8
Tenkai,cthun,382,hunter,marksmanship,6,4,2
Bélier,hyjal,382,hunter,marksmanship,12,4,8
Бурбоньчик,soulflayer,382,hunter,marksmanship,12,4,8
Euphellius,darkmoon-faire,380,hunter,marksmanship,15,5,10
Lumidii,burning-legion,379,hunter,marksmanship,12,4,8
Boehelientje,defias-brotherhood,351,hunter,marksmanship,11,4,7
Shadoox,argent-dawn,335,hunter,marksmanship,11,4,7
Arwenna,argent-dawn,328,hunter,marksmanship,11,6,5
Weridia,der-rat-von-dalaran,319,hunter,marksmanship,5,4,1
Lithell,kazzak,288,hunter,marksmanship,6,3,3
Zajaczek,burning-legion,288,hunter,marksmanship,6,3,3
Bapt,blackrock,288,hunter,marksmanship,6,3,3
Eliune,silvermoon,288,hunter,marksmanship,6,3,3
Lioness,ahnqiraj,288,hunter,marksmanship,6,3,3
Shieryu,archimonde,288,hunter,marksmanship,6,3,3
Hÿyrøk,ysondre,288,hunter,marksmanship,6,3,3
Littlenugget,ravencrest,288,hunter,marksmanship,6,3,3
Phinecone,stormscale,288,hunter,marksmanship,6,3,3
Djøgi,archimonde,288,hunter,marksmanship,6,3,3
Spirys,drakthul,288,hunter,marksmanship,6,3,3
Jðsi,dalaran,288,hunter,marksmanship,6,3,3
Hunlin,kazzak,288,hunter,marksmanship,6,3,3
Celebor,sanguino,288,hunter,marksmanship,6,3,3
Sissnik,thrall,288,hunter,marksmanship,6,3,3
Rapid,sylvanas,288,hunter,marksmanship,6,3,3
Egodennis,frostwolf,288,hunter,marksmanship,6,3,3
Kundra,ravencrest,288,hunter,marksmanship,6,3,3
Neescafe,sylvanas,288,hunter,marksmanship,6,3,3
Samasukë,grim-batol,288,hunter,marksmanship,6,3,3
Noxxen,burning-legion,288,hunter,marksmanship,6,3,3
Éddiémórphín,kazzak,288,hunter,marksmanship,6,3,3
Djidawn,ysondre,288,hunter,marksmanship,6,3,3
Pläpp,stormscale,288,hunter,marksmanship,6,3,3
Barbrady,nethersturm,288,hunter,marksmanship,6,3,3
Deadluck,kazzak,288,hunter,marksmanship,6,3,3
Nerdhark,hyjal,288,hunter,marksmanship,6,3,3
Xeragon,frostwolf,288,hunter,marksmanship,6,3,3
Vorsia,tarren-mill,288,hunter,marksmanship,6,3,3
ßæro,hyjal,288,hunter,marksmanship,6,3,3
Комомура,soulflayer,288,hunter,marksmanship,6,3,3
Atranex,ravencrest,288,hunter,marksmanship,6,3,3
Zøk,stormscale,288,hunter,marksmanship,6,3,3
Dreemshoot,stormscale,288,hunter,marksmanship,6,3,3
Osie,kazzak,288,hunter,marksmanship,6,3,3
Seariko,draenor,288,hunter,marksmanship,6,3,3
Muddí,ravencrest,288,hunter,marksmanship,6,3,3
Fize,blackmoore,288,hunter,marksmanship,6,3,3
Хакаар,grom,288,hunter,marksmanship,6,3,3
Bocek,silvermoon,288,hunter,marksmanship,6,3,3
Medgical,outland,288,hunter,marksmanship,6,3,3
Fylealaes,ravencrest,288,hunter,marksmanship,6,3,3
Люблюлюбовь,gordunni,288,hunter,marksmanship,6,3,3
Threeguns,blackrock,288,hunter,marksmanship,6,3,3
Anguerande,khaz-modan,288,hunter,marksmanship,6,3,3
Techpøint,silvermoon,288,hunter,marksmanship,6,3,3
Яроняютрапу,gordunni,288,hunter,marksmanship,6,3,3
Lilsnuss,outland,288,hunter,marksmanship,6,3,3
Fugass,ragnaros,288,hunter,marksmanship,6,3,3
Velne,ravencrest,288,hunter,marksmanship,6,3,3
Feyoonxx,blackrock,288,hunter,marksmanship,6,3,3
Джинксан,blackscar,288,hunter,marksmanship,6,3,3
Nightarrowq,tarren-mill,288,hunter,marksmanship,9,4,5
Amdéa,boulderfist,288,hunter,marksmanship,10,4,6
Arrown,outland,288,hunter,marksmanship,11,4,7
Secrety,doomhammer,288,hunter,marksmanship,11,3,8
Бубунн,howling-fjord,288,hunter,marksmanship,12,3,9
Oduross,minahonda,288,hunter,marksmanship,12,3,9
Lùchiean,kazzak,288,hunter,marksmanship,12,3,9
Ричардн,howling-fjord,288,hunter,marksmanship,12,3,9
Naaztko,stormscale,288,hunter,marksmanship,12,3,9
Deahtviper,blackmoore,288,hunter,marksmanship,12,3,9
Koreic,silvermoon,288,hunter,marksmanship,12,3,9
Jakis,silvermoon,288,hunter,marksmanship,12,3,9
Triggery,ravencrest,288,hunter,marksmanship,12,3,9
Fatfrumos,twisting-nether,288,hunter,marksmanship,12,3,9
Zubro,kazzak,288,hunter,marksmanship,12,3,9
Deneja,kilrogg,288,hunter,marksmanship,12,3,9
Spakster,blackrock,288,hunter,marksmanship,12,3,9
Incompetence,argent-dawn,288,hunter,marksmanship,12,3,9
Deify,grim-batol,288,hunter,marksmanship,12,3,9
Andtamed,thunderhorn,288,hunter,marksmanship,12,3,9
Chassuu,khaz-modan,288,hunter,marksmanship,12,3,9
Marcher,aggra-português,288,hunter,marksmanship,18,3,15
Оркос,deathweaver,287,hunter,marksmanship,6,3,3
Crní,tarren-mill,287,hunter,marksmanship,6,3,3
Saccä,ysondre,287,hunter,marksmanship,6,3,3
Pylos,azshara,287,hunter,marksmanship,6,3,3
Ayshæ,tarren-mill,287,hunter,marksmanship,6,3,3
Мокку,howling-fjord,287,hunter,marksmanship,6,3,3
Dwoas,darkspear,287,hunter,marksmanship,12,3,9
Jomoguin,stormscale,286,hunter,marksmanship,6,3,3
Thedanchodak,stormrage,286,hunter,marksmanship,6,3,3
Лордввт,howling-fjord,286,hunter,marksmanship,6,3,3
Krippie,dun-modr,286,hunter,marksmanship,6,3,3
Millhunter,norgannon,284,hunter,marksmanship,12,3,9
Urith,les-clairvoyants,255,hunter,marksmanship,8,4,4
Twinshot,anetheron,234,hunter,marksmanship,10,4,6
Cais,drakthul,234,hunter,marksmanship,12,4,8
Darkshàdow,archimonde,192,hunter,marksmanship,6,2,4
Nezekielle,drekthar,192,hunter,marksmanship,6,2,4
Kerrveros,ravencrest,192,hunter,marksmanship,6,2,4
Bellecoq,arathi,192,hunter,marksmanship,6,2,4
Sjins,draenor,192,hunter,marksmanship,6,2,4
Doknak,gilneas,192,hunter,marksmanship,6,2,4
Sharpeyezz,ravencrest,192,hunter,marksmanship,6,2,4
Zirilan,nemesis,192,hunter,marksmanship,6,2,4
Mobshot,twisting-nether,192,hunter,marksmanship,6,2,4
Хисдед,howling-fjord,192,hunter,marksmanship,6,2,4
Tytoyz,khaz-modan,192,hunter,marksmanship,6,2,4
Bóssit,skullcrusher,192,hunter,marksmanship,6,2,4
Huntbeard,ragnaros,192,hunter,marksmanship,6,2,4
Beletor,medivh,192,hunter,marksmanship,6,2,4
Brizza,talnivarr,192,hunter,marksmanship,6,2,4
Querro,azshara,192,hunter,marksmanship,6,2,4
Galintzor,area-52,192,hunter,marksmanship,6,2,4
Anoroxx,arthas,192,hunter,marksmanship,6,2,4
Denaik,ravencrest,192,hunter,marksmanship,6,2,4
Domsín,ravencrest,192,hunter,marksmanship,6,2,4
Majuli,stormrage,192,hunter,marksmanship,6,2,4
Notikâ,aegwynn,192,hunter,marksmanship,6,2,4
Vâleriaa,blackrock,192,hunter,marksmanship,6,2,4
Rafaela,genjuros,192,hunter,marksmanship,6,2,4
Bobleearrow,darkspear,192,hunter,marksmanship,6,2,4
Nelf,shattered-hand,192,hunter,marksmanship,6,2,4
Garrash,teldrassil,192,hunter,marksmanship,6,2,4
Bláckheart,doomhammer,192,hunter,marksmanship,6,2,4
Banglor,shattered-hand,192,hunter,marksmanship,6,2,4
Draknik,nemesis,192,hunter,marksmanship,6,2,4
Bowner,frostmane,192,hunter,marksmanship,6,2,4
Охотуначал,soulflayer,192,hunter,marksmanship,6,2,4
Фетсол,soulflayer,192,hunter,marksmanship,6,2,4
Deadyeyez,doomhammer,192,hunter,marksmanship,6,2,4
Sayn,la-croisade-écarlate,192,hunter,marksmanship,6,2,4
Realme,blackrock,192,hunter,marksmanship,6,2,4
Olrik,dentarg,192,hunter,marksmanship,6,2,4
Miracleh,tarren-mill,192,hunter,marksmanship,6,2,4
Мафчик,razuvious,192,hunter,marksmanship,6,2,4
Carioca,blackhand,192,hunter,marksmanship,6,2,4
Axran,ravencrest,192,hunter,marksmanship,6,2,4
Guerrilla,stormscale,192,hunter,marksmanship,6,2,4
Jamais02AEE6,stormscale,192,hunter,marksmanship,6,2,4
Meetyour,stormscale,192,hunter,marksmanship,6,2,4
Greenstar,twisting-nether,192,hunter,marksmanship,6,2,4
Merveilleux,hyjal,192,hunter,marksmanship,6,2,4
Foxmis,kazzak,192,hunter,marksmanship,6,2,4
Silenta,outland,192,hunter,marksmanship,6,2,4
Othellö,kazzak,192,hunter,marksmanship,6,2,4
Leílah,kazzak,192,hunter,marksmanship,6,2,4
Velvett,blackmoore,192,hunter,marksmanship,6,2,4
Monnee,outland,192,hunter,marksmanship,6,2,4
Zulldek,sanguino,192,hunter,marksmanship,6,2,4
Slayman,kazzak,192,hunter,marksmanship,6,2,4
Amiosi,sanguino,192,hunter,marksmanship,6,2,4
Wowkulaka,kazzak,192,hunter,marksmanship,6,2,4
Lilsnipè,outland,192,hunter,marksmanship,6,2,4
Bobshmurda,defias-brotherhood,192,hunter,marksmanship,6,2,4
Sarblade,bronze-dragonflight,192,hunter,marksmanship,6,2,4
Ghostriders,archimonde,192,hunter,marksmanship,11,2,9
Friskì,draenor,192,hunter,marksmanship,12,2,10
Explicits,stormscale,192,hunter,marksmanship,12,2,10
Muckel,area-52,192,hunter,marksmanship,12,2,10
Showdope,drakthul,192,hunter,marksmanship,12,2,10
Weedonyhunt,hyjal,192,hunter,marksmanship,12,2,10
Shademd,ahnqiraj,192,hunter,marksmanship,12,2,10
Сашатетива,gordunni,192,hunter,marksmanship,12,2,10
Isarnexx,dun-modr,191,hunter,marksmanship,6,2,4
Selini,bloodfeather,191,hunter,marksmanship,6,2,4
Stormhoofd,bloodhoof,191,hunter,marksmanship,6,2,4
Kure,blackrock,191,hunter,marksmanship,12,2,10
Jaguàr,kazzak,159,hunter,marksmanship,5,2,3
Buttsnipe,sylvanas,159,hunter,marksmanship,5,2,3
Neremyn,sylvanas,138,hunter,marksmanship,9,3,6
Пушкабомби,soulflayer,126,hunter,marksmanship,8,2,6
Chrishyh,blackrock,112,hunter,marksmanship,7,2,5
Tryx,darksorrow,96,hunter,marksmanship,3,2,1
Akahr,thrall,96,hunter,marksmanship,3,2,1
Tyrone,saurfang,96,hunter,marksmanship,9,2,7
Камсшотт,gordunni,96,hunter,marksmanship,6,1,5
Faccacamoale,twisting-nether,96,hunter,marksmanship,6,1,5
Jimbow,blackrock,96,hunter,marksmanship,6,1,5
Wolfmcquade,draenor,96,hunter,marksmanship,6,1,5
Matarmeya,los-errantes,96,hunter,marksmanship,6,1,5
Наладдчик,howling-fjord,96,hunter,marksmanship,6,1,5
Killzo,sylvanas,96,hunter,marksmanship,6,1,5
Arung,ravencrest,96,hunter,marksmanship,6,1,5
Metalbaci,sylvanas,96,hunter,marksmanship,6,1,5
Фаффурион,gordunni,96,hunter,marksmanship,6,1,5
Горгонт,blackscar,96,hunter,marksmanship,6,1,5
Tillhunt,kargath,96,hunter,marksmanship,6,1,5
Cléò,kazzak,96,hunter,marksmanship,6,1,5
Grimazg,chogall,96,hunter,marksmanship,6,1,5
Avizi,anachronos,96,hunter,marksmanship,6,1,5
Castbuny,drakthul,96,hunter,marksmanship,6,1,5
Darilli,wildhammer,96,hunter,marksmanship,6,1,5
Drolarin,zuljin,96,hunter,marksmanship,6,1,5
Cxc,dun-modr,96,hunter,marksmanship,6,1,5
Superfacial,twisting-nether,96,hunter,marksmanship,6,1,5
Eowale,outland,96,hunter,marksmanship,6,1,5
Cítyzens,drakthul,96,hunter,marksmanship,6,1,5
Ренектон,soulflayer,96,hunter,marksmanship,6,1,5
Feedbackloop,silvermoon,96,hunter,marksmanship,6,1,5
Statik,deathwing,96,hunter,marksmanship,6,1,5
Deadlymayhem,dragonblight,96,hunter,marksmanship,6,1,5
Eilaa,ravencrest,96,hunter,marksmanship,6,1,5
Nezuqo,archimonde,96,hunter,marksmanship,6,1,5
Thalanel,arthas,96,hunter,marksmanship,6,1,5
Nalys,argent-dawn,96,hunter,marksmanship,6,1,5
Desow,blackrock,96,hunter,marksmanship,6,1,5
Nethria,antonidas,96,hunter,marksmanship,6,1,5
Akaname,ravencrest,96,hunter,marksmanship,6,1,5
Xaraimz,ravencrest,96,hunter,marksmanship,6,1,5
Fayenia,ravencrest,96,hunter,marksmanship,6,1,5
Chantalia,ravencrest,96,hunter,marksmanship,6,1,5
Wèdra,hyjal,96,hunter,marksmanship,6,1,5
Donáldtrúmp,tarren-mill,96,hunter,marksmanship,12,1,11
Denixxia,bronzebeard,95,hunter,marksmanship,3,2,1
Есселин,thermaplugg,95,hunter,marksmanship,6,1,5
Magahra,thrall,95,hunter,marksmanship,6,1,5
Ранбоу,howling-fjord,79,hunter,marksmanship,5,1,4
Амореселф,gordunni,79,hunter,marksmanship,5,1,4
Gettóbuxa,arathor,79,hunter,marksmanship,5,1,4
Dréws,kazzak,64,hunter,marksmanship,4,1,3
Rdevill,outland,64,hunter,marksmanship,4,1,3
Imortaltroll,kazzak,16,hunter,marksmanship,1,1,0
Elgango,blackrock,16,hunter,marksmanship,1,1,0
Corossity,blackmoore,2141,hunter,survival,89,63,26
Pridz,archimonde,2137,hunter,survival,150,76,74
Bonquiesha,tarren-mill,2091,hunter,survival,114,63,51
Fíng,tarren-mill,2089,hunter,survival,132,67,65
Pokefangirlx,grim-batol,2034,hunter,survival,132,80,52
Sneakyshøt,nemesis,2022,hunter,survival,155,87,68
Belaux,archimonde,2012,hunter,survival,84,40,44
Harrianlar,ravenholdt,2012,hunter,survival,112,53,59
Mestar,outland,2001,hunter,survival,199,100,99
Huntity,kazzak,1994,hunter,survival,95,51,44
Booxun,sylvanas,1982,hunter,survival,133,68,65
Macrolaim,outland,1978,hunter,survival,114,53,61
Mspt,archimonde,1967,hunter,survival,60,31,29
Горгонт,blackscar,1966,hunter,survival,108,61,47
Yeezu,sylvanas,1965,hunter,survival,60,33,27
Razoorine,blackrock,1963,hunter,survival,138,73,65
Ryomen,garona,1955,hunter,survival,165,90,75
Earfalass,twisting-nether,1932,hunter,survival,92,56,36
Stormblãze,ravencrest,1915,hunter,survival,96,41,55
Momohenní,archimonde,1901,hunter,survival,120,69,51
Kagrot,silvermoon,1876,hunter,survival,66,32,34
Lágåta,outland,1864,hunter,survival,53,27,26
Øvade,argent-dawn,1861,hunter,survival,67,41,26
Ravebae,silvermoon,1850,hunter,survival,120,61,59
Лесбиянюсь,gordunni,1841,hunter,survival,42,24,18
Квит,blackscar,1832,hunter,survival,30,20,10
Josethepimpo,stormscale,1832,hunter,survival,66,32,34
Vunter,malganis,1828,hunter,survival,48,26,22
Zhulk,los-errantes,1827,hunter,survival,60,28,32
Götdelen,kult-der-verdammten,1822,hunter,survival,60,30,30
Polaqu,burning-legion,1809,hunter,survival,60,37,23
Djshibalxd,argent-dawn,1807,hunter,survival,48,27,21
Yemistar,archimonde,1802,hunter,survival,48,24,24
Zpf,silvermoon,1801,hunter,survival,56,30,26
Jackjager,ravencrest,1800,hunter,survival,33,21,12
Nikzeubii,archimonde,1798,hunter,survival,42,19,23
Fatbushpig,stormscale,1786,hunter,survival,30,19,11
Frog,crushridge,1783,hunter,survival,72,42,30
Glosendra,ravencrest,1769,hunter,survival,27,20,7
Clifton,archimonde,1763,hunter,survival,36,25,11
Rynex,festung-der-stürme,1763,hunter,survival,48,26,22
Easyclass,hyjal,1762,hunter,survival,42,27,15
Разплюханка,howling-fjord,1755,hunter,survival,102,55,47
Djheartstrng,argent-dawn,1754,hunter,survival,46,27,19
Exquisitor,draenor,1748,hunter,survival,67,33,34
Dreämhäck,ravencrest,1742,hunter,survival,36,25,11
Hunjo,quelthalas,1739,hunter,survival,90,40,50
Âkane,argent-dawn,1737,hunter,survival,48,27,21
Onlylfg,drakthul,1734,hunter,survival,36,20,16
Летмимейт,howling-fjord,1724,hunter,survival,78,43,35
Avizi,anachronos,1724,hunter,survival,78,41,37
Yosia,draenor,1723,hunter,survival,60,31,29
Alexdi,kazzak,1722,hunter,survival,42,19,23
Sarrow,ravencrest,1719,hunter,survival,48,26,22
Mmkekw,guldan,1716,hunter,survival,30,22,8
Minibicmex,aegwynn,1709,hunter,survival,30,18,12
Zäroury,ravencrest,1702,hunter,survival,53,29,24
Zeer,sylvanas,1699,hunter,survival,57,27,30
Оскорбление,howling-fjord,1697,hunter,survival,66,34,32
Yazqua,deathwing,1696,hunter,survival,70,42,28
Closeenought,ravencrest,1689,hunter,survival,54,29,25
Zerberas,blackrock,1688,hunter,survival,42,21,21
Madzynette,archimonde,1684,hunter,survival,37,25,12
Akronis,outland,1684,hunter,survival,60,24,36
Burbutsuluki,silvermoon,1683,hunter,survival,30,20,10
Thugzilla,auchindoun,1683,hunter,survival,35,20,15
Sorozo,aegwynn,1675,hunter,survival,47,25,22
Чууч,blackscar,1673,hunter,survival,57,26,31
Knokkelmann,outland,1668,hunter,survival,36,24,12
Gedept,blackrock,1663,hunter,survival,56,30,26
Monkeytrapz,norgannon,1655,hunter,survival,42,23,19
Lxoh,turalyon,1655,hunter,survival,155,78,77
Kurkelx,ravencrest,1642,hunter,survival,36,24,12
Zulldek,sanguino,1638,hunter,survival,78,42,36
Calyssae,shattered-halls,1631,hunter,survival,40,28,12
Pwon,ravencrest,1631,hunter,survival,130,66,64
Renathir,argent-dawn,1628,hunter,survival,50,28,22
Кулерквест,soulflayer,1627,hunter,survival,79,43,36
Xiumiune,antonidas,1626,hunter,survival,54,32,22
Dyndns,blackmoore,1625,hunter,survival,30,17,13
Yemmeth,argent-dawn,1625,hunter,survival,135,69,66
Kajtarn,outland,1621,hunter,survival,60,27,33
Dabeszt,draenor,1617,hunter,survival,36,21,15
Ntwoõ,ravencrest,1615,hunter,survival,65,37,28
Nienel,archimonde,1615,hunter,survival,53,21,32
Pizzafanatic,blackrock,1614,hunter,survival,49,25,24
Ruxhunter,sanguino,1607,hunter,survival,90,50,40
Rizlay,the-maelstrom,1607,hunter,survival,48,24,24
Стингергодх,gordunni,1606,hunter,survival,36,18,18
Tillhunt,kargath,1600,hunter,survival,57,36,21
Сабакаа,borean-tundra,1599,hunter,survival,66,38,28
Darllene,kazzak,1599,hunter,survival,89,40,49
Dariusmm,silvermoon,1598,hunter,survival,58,32,26
Losiané,thrall,1592,hunter,survival,58,29,29
Wikariusz,kazzak,1592,hunter,survival,60,26,34
Зеленыйиисус,gordunni,1590,hunter,survival,30,20,10
Танчибосс,soulflayer,1590,hunter,survival,72,37,35
Fablet,draenor,1589,hunter,survival,36,21,15
Kalani,la-croisade-écarlate,1580,hunter,survival,72,38,34
Scypher,ragnaros,1578,hunter,survival,27,19,8
Свадебная,gordunni,1572,hunter,survival,148,78,70
Marryme,blackhand,1568,hunter,survival,42,26,16
Ódelagga,sylvanas,1568,hunter,survival,72,40,32
Subha,quelthalas,1563,hunter,survival,30,19,11
Turdy,executus,1559,hunter,survival,40,23,17
Ðarrk,tarren-mill,1557,hunter,survival,54,29,25
Жэш,howling-fjord,1551,hunter,survival,30,18,12
Mewithoutyou,ragnaros,1549,hunter,survival,114,52,62
Âmalphy,ravencrest,1549,hunter,survival,42,17,25
Lukez,ravencrest,1548,hunter,survival,30,18,12
Riema,ragnaros,1541,hunter,survival,58,27,31
Psychotik,stormreaver,1540,hunter,survival,94,50,44
Sphexya,ravencrest,1528,hunter,survival,30,16,14
Rewgodxq,ravencrest,1526,hunter,survival,42,16,26
Ищименявтени,gordunni,1525,hunter,survival,47,24,23
Фломидзе,gordunni,1515,hunter,survival,30,21,9
Huntiika,silvermoon,1512,hunter,survival,49,24,25
Horxxa,kul-tiras,1511,hunter,survival,48,32,16
Sznxøxo,ravencrest,1498,hunter,survival,24,16,8
Suxino,doomhammer,1459,hunter,survival,46,23,23
Unsáinted,ravencrest,1459,hunter,survival,60,29,31
Næ,kazzak,1449,hunter,survival,38,21,17
Arykes,drakthul,1440,hunter,survival,53,25,28
Sipsomewater,ravencrest,1439,hunter,survival,24,15,9
Olk,stormscale,1439,hunter,survival,24,15,9
Nwnw,tarren-mill,1437,hunter,survival,24,15,9
Ðoñko,hyjal,1434,hunter,survival,117,57,60
Clicker,runetotem,1425,hunter,survival,36,16,20
Robzyhunter,kazzak,1415,hunter,survival,24,15,9
Shoty,zuluhed,1411,hunter,survival,94,44,50
Zacxx,ravencrest,1398,hunter,survival,23,16,7
Andjelaa,kazzak,1398,hunter,survival,30,15,15
Crème,blackrock,1395,hunter,survival,65,26,39
Raztreadör,dun-modr,1390,hunter,survival,46,22,24
Kyosoku,silvermoon,1388,hunter,survival,33,15,18
Nalys,argent-dawn,1387,hunter,survival,46,25,21
Slagatronic,ragnaros,1380,hunter,survival,66,38,28
Глаззалмаз,howling-fjord,1373,hunter,survival,28,16,12
Сильвиина,eversong,1372,hunter,survival,36,17,19
Ðrãke,blackmoore,1370,hunter,survival,30,15,15
Vengefull,draenor,1369,hunter,survival,36,19,17
Zwerghauer,arthas,1358,hunter,survival,30,17,13
Китас,soulflayer,1346,hunter,survival,50,31,19
Icetrapped,eredar,1341,hunter,survival,30,14,16
Xaone,blackrock,1340,hunter,survival,18,14,4
Cjezka,blackmoore,1339,hunter,survival,30,14,16
Копия,azuregos,1338,hunter,survival,30,14,16
Avaren,archimonde,1337,hunter,survival,30,14,16
Субоота,gordunni,1335,hunter,survival,24,14,10
Zaphody,doomhammer,1334,hunter,survival,45,23,22
Мандалорецц,soulflayer,1329,hunter,survival,50,22,28
Taurïel,stormscale,1326,hunter,survival,36,19,17
Jamalinho,silvermoon,1322,hunter,survival,60,38,22
Santiägø,archimonde,1322,hunter,survival,42,23,19
Карвинн,soulflayer,1321,hunter,survival,30,14,16
Westcøãst,archimonde,1316,hunter,survival,24,14,10
Zehned,ysondre,1316,hunter,survival,57,25,32
Albumx,hyjal,1315,hunter,survival,140,63,77
Malgorn,burning-legion,1314,hunter,survival,34,23,11
Littlhuntard,tarren-mill,1306,hunter,survival,24,14,10
Tortillia,madmortem,1305,hunter,survival,30,14,16
Karabeg,twisting-nether,1301,hunter,survival,53,22,31
Kazzaak,kazzak,1300,hunter,survival,48,18,30
Prodanhunts,frostmane,1296,hunter,survival,30,14,16
Feignindeath,twisting-nether,1291,hunter,survival,32,17,15
Nvukaze,argent-dawn,1262,hunter,survival,33,22,11
Uglybaboon,draenor,1248,hunter,survival,24,13,11
Ajko,blackmoore,1247,hunter,survival,30,15,15
Jumong,ragnaros,1246,hunter,survival,24,13,11
Guanchin,silvermoon,1245,hunter,survival,42,16,26
Daweí,draenor,1244,hunter,survival,30,13,17
Paxiwtf,eredar,1242,hunter,survival,22,14,8
Ashablack,argent-dawn,1239,hunter,survival,65,32,33
Микихаса,galakrond,1238,hunter,survival,30,13,17
Sayn,la-croisade-écarlate,1227,hunter,survival,24,13,11
Rayadz,nethersturm,1199,hunter,survival,23,13,10
Sainttcc,thrall,1195,hunter,survival,54,25,29
Майен,thermaplugg,1152,hunter,survival,24,12,12
Ähäkutti,kazzak,1151,hunter,survival,30,12,18
Grulog,kazzak,1150,hunter,survival,30,12,18
Тэмплест,howling-fjord,1146,hunter,survival,18,12,6
Rettoo,aszune,1146,hunter,survival,19,12,7
Saejku,archimonde,1146,hunter,survival,24,12,12
Zøk,stormscale,1145,hunter,survival,18,12,6
Hakkoti,argent-dawn,1142,hunter,survival,24,12,12
Kobayashi,arathor,1140,hunter,survival,36,12,24
Gilzog,exodar,1138,hunter,survival,30,12,18
Cabaim,eredar,1137,hunter,survival,18,12,6
Notikâ,aegwynn,1135,hunter,survival,30,12,18
Cämper,aegwynn,1124,hunter,survival,24,12,12
Huntoruu,outland,1122,hunter,survival,67,30,37
Jakis,silvermoon,1101,hunter,survival,23,12,11
Lutza,sanguino,1056,hunter,survival,24,11,13
Djtrápálót,dragonmaw,1055,hunter,survival,18,11,7
Mogumogu,blackhand,1055,hunter,survival,18,11,7
Sunyjuyono,ravencrest,1055,hunter,survival,24,11,13
Juniorm,kazzak,1054,hunter,survival,18,11,7
Bicepspump,dun-morogh,1054,hunter,survival,24,11,13
Cataleýà,outland,1052,hunter,survival,18,11,7
Skzu,archimonde,1050,hunter,survival,18,11,7
Стивстифлер,razuvious,1043,hunter,survival,18,11,7
Шадак,soulflayer,1038,hunter,survival,30,11,19
Spakker,the-shatar,1025,hunter,survival,22,12,10
Doru,silvermoon,1025,hunter,survival,24,11,13
Melissax,silvermoon,1001,hunter,survival,28,12,16
Giobi,draenor,996,hunter,survival,24,13,11
Reviam,ravencrest,960,hunter,survival,12,10,2
Kukenisluken,stormscale,960,hunter,survival,18,10,8
Obbnfriends,ravencrest,960,hunter,survival,18,10,8
Хансбург,howling-fjord,960,hunter,survival,18,10,8
Stuckstepbro,silvermoon,960,hunter,survival,24,10,14
Neddly,draenor,960,hunter,survival,24,10,14
Islide,ravencrest,960,hunter,survival,24,10,14
Cadier,argent-dawn,959,hunter,survival,24,10,14
Менстряк,deathguard,958,hunter,survival,18,10,8
Галятрицепс,eversong,957,hunter,survival,24,10,14
Mcgloebels,archimonde,956,hunter,survival,21,11,10
Binhoker,argent-dawn,953,hunter,survival,12,10,2
Memli,uldaman,950,hunter,survival,18,10,8
Zipzâp,blackrock,936,hunter,survival,18,10,8
Neilime,marécage-de-zangar,890,hunter,survival,54,21,33
Ирртой,grom,885,hunter,survival,24,10,14
Åíøñs,kazzak,864,hunter,survival,12,9,3
Lìmpy,stormreaver,864,hunter,survival,12,9,3
Куджикс,soulflayer,864,hunter,survival,12,9,3
Ketaminösa,zuljin,864,hunter,survival,12,9,3
Bicmex,ravencrest,864,hunter,survival,12,9,3
Nttcoopzz,silvermoon,864,hunter,survival,12,9,3
Urrane,archimonde,864,hunter,survival,12,9,3
Svinrbglol,arygos,864,hunter,survival,18,9,9
Eunte,archimonde,864,hunter,survival,18,9,9
Mileysaures,stormscale,863,hunter,survival,12,9,3
Murkek,drakthul,863,hunter,survival,12,9,3
Миаур,gordunni,863,hunter,survival,18,9,9
Amilienne,nozdormu,863,hunter,survival,21,10,11
Hoffen,dentarg,861,hunter,survival,12,9,3
Rollin,khaz-modan,861,hunter,survival,12,9,3
Вилдфлекс,gordunni,861,hunter,survival,12,9,3
Foxyfoxo,guldan,860,hunter,survival,24,9,15
Getsniffarn,sylvanas,858,hunter,survival,18,9,9
Voltár,antonidas,854,hunter,survival,24,9,15
Aszasi,azjolnerub,814,hunter,survival,17,9,8
Норапина,eversong,797,hunter,survival,18,9,9
Drolig,blackmoore,793,hunter,survival,17,9,8
Крысюкпифпаф,blackscar,783,hunter,survival,13,9,4
Nemámponetí,drakthul,768,hunter,survival,12,8,4
Poggersdaddy,kazzak,768,hunter,survival,12,8,4
Véncsótány,ragnaros,768,hunter,survival,12,8,4
Calesthas,tarren-mill,768,hunter,survival,12,8,4
Djfortnite,ravencrest,768,hunter,survival,12,8,4
Maiver,ravencrest,768,hunter,survival,12,8,4
Qwèrts,stormscale,768,hunter,survival,12,8,4
Velen,pozzo-delleternità,768,hunter,survival,12,8,4
Wonkeedx,ravencrest,768,hunter,survival,12,8,4
Vargar,arygos,768,hunter,survival,12,8,4
Maiverx,ravencrest,768,hunter,survival,12,8,4
Фираналь,blackscar,768,hunter,survival,18,8,10
Epicsurvive,kazzak,768,hunter,survival,24,8,16
Dorota,auchindoun,767,hunter,survival,12,8,4
Onefatalshot,the-maelstrom,767,hunter,survival,12,8,4
Хантероо,gordunni,756,hunter,survival,18,8,10
Betarayjinx,kazzak,720,hunter,survival,15,8,7
Гудхантер,blackscar,672,hunter,survival,12,7,5
Robinbuds,stormscale,672,hunter,survival,12,7,5
Gíggí,malganis,672,hunter,survival,12,7,5
Wórldz,dun-modr,672,hunter,survival,12,7,5
Burninghunt,ravencrest,672,hunter,survival,12,7,5
Глефард,fordragon,672,hunter,survival,12,7,5
Ilovemax,archimonde,672,hunter,survival,12,7,5
Lugnåls,hyjal,672,hunter,survival,12,7,5
Xelsera,antonidas,672,hunter,survival,12,7,5
Иснсейшн,soulflayer,672,hunter,survival,12,7,5
Avashah,ravencrest,672,hunter,survival,16,7,9
Saliressa,ravencrest,672,hunter,survival,18,7,11
Terrorduni,tarren-mill,672,hunter,survival,18,7,11
Fyoni,silvermoon,671,hunter,survival,12,7,5
Herubin,doomhammer,671,hunter,survival,12,7,5
Floris,outland,671,hunter,survival,12,7,5
Kasperle,frostwolf,671,hunter,survival,12,7,5
Dragonflayer,sylvanas,666,hunter,survival,12,7,5
Szybky,defias-brotherhood,666,hunter,survival,12,7,5
Skyh,outland,655,hunter,survival,26,7,19
Skyythe,dun-morogh,649,hunter,survival,18,7,11
Bugspitz,outland,622,hunter,survival,11,7,4
Ilovejwrld,dun-modr,618,hunter,survival,16,8,8
Animàl,argent-dawn,607,hunter,survival,16,7,9
Gitanìlla,dun-modr,576,hunter,survival,6,6,0
Ðévi,ravencrest,576,hunter,survival,6,6,0
Rubydacherrý,argent-dawn,576,hunter,survival,6,6,0
Løvebombing,ravencrest,576,hunter,survival,6,6,0
Jamoneame,sanguino,576,hunter,survival,12,6,6
Snoude,silvermoon,576,hunter,survival,12,6,6
Steezowl,kazzak,576,hunter,survival,12,6,6
Nunziatellà,nemesis,576,hunter,survival,12,6,6
Nkl,archimonde,576,hunter,survival,12,6,6
Doubleright,ravencrest,576,hunter,survival,12,6,6
Morkahs,dalaran,576,hunter,survival,12,6,6
Nirn,ravencrest,576,hunter,survival,12,6,6
Torelk,dalaran,576,hunter,survival,12,6,6
Хитвейн,gordunni,576,hunter,survival,12,6,6
Mouganstine,archimonde,576,hunter,survival,12,6,6
Shiceloch,blackmoore,576,hunter,survival,12,6,6
Ashendan,silvermoon,576,hunter,survival,18,6,12
Grimazg,chogall,575,hunter,survival,12,6,6
Makeawish,antonidas,575,hunter,survival,12,6,6
Pãstèque,ravencrest,575,hunter,survival,12,6,6
Hevl,silvermoon,575,hunter,survival,12,6,6
Gakco,twisting-nether,575,hunter,survival,12,6,6
Йинги,gordunni,575,hunter,survival,12,6,6
Sekkeh,ragnaros,575,hunter,survival,18,6,12
Amjamh,hyjal,575,hunter,survival,18,6,12
Milandra,the-maelstrom,573,hunter,survival,12,6,6
Yake,kazzak,564,hunter,survival,28,9,19
Mâjôô,blackhand,544,hunter,survival,10,6,4
Reðrighthånð,throkferoth,528,hunter,survival,9,6,3
Pechvogel,blackmoore,527,hunter,survival,11,6,5
Jaggy,hyjal,480,hunter,survival,6,5,1
Frapt,dalaran,480,hunter,survival,6,5,1
Nooksem,blackrock,480,hunter,survival,6,5,1
Deek,ysera,480,hunter,survival,6,5,1
Mòzetónq,ravencrest,480,hunter,survival,6,5,1
Glama,archimonde,480,hunter,survival,6,5,1
Musen,draenor,480,hunter,survival,6,5,1
Röwene,argent-dawn,480,hunter,survival,6,5,1
Пьёт,gordunni,480,hunter,survival,6,5,1
Vilopez,arthas,480,hunter,survival,6,5,1
Айхана,gordunni,480,hunter,survival,6,5,1
Ватмано,gordunni,480,hunter,survival,6,5,1
Wicmex,archimonde,480,hunter,survival,6,5,1
Grusijohn,executus,480,hunter,survival,12,5,7
Agnêas,silvermoon,480,hunter,survival,12,5,7
Moscowmule,tarren-mill,480,hunter,survival,12,5,7
Skydraz,ysondre,480,hunter,survival,12,5,7
Kirax,ravencrest,480,hunter,survival,12,5,7
Boggy,outland,480,hunter,survival,12,5,7
Hunterado,burning-legion,480,hunter,survival,12,5,7
Løwg,drekthar,480,hunter,survival,12,5,7
Abeba,grim-batol,480,hunter,survival,12,5,7
Дондонандон,gordunni,480,hunter,survival,12,5,7
Doloresman,tarren-mill,480,hunter,survival,12,5,7
Ballistix,elune,480,hunter,survival,12,5,7
Wôôdsy,blackrock,480,hunter,survival,12,5,7
Querro,azshara,480,hunter,survival,18,5,13
Aequitaz,blackhand,480,hunter,survival,18,5,13
Badboyxoxo,stormscale,479,hunter,survival,6,5,1
Daltyr,ravencrest,479,hunter,survival,12,5,7
Bloodxx,ragnaros,479,hunter,survival,12,5,7
Absolutnoob,blackrock,478,hunter,survival,12,5,7
Pôîson,kazzak,478,hunter,survival,24,5,19
Mahemi,mazrigos,478,hunter,survival,24,5,19
Jabela,eredar,447,hunter,survival,11,5,6
Оверман,azuregos,447,hunter,survival,20,6,14
Azuren,twisting-nether,430,hunter,survival,11,5,6
Änubïs,culte-de-la-rive-noire,400,hunter,survival,10,6,4
Oldlynx,ravencrest,384,hunter,survival,6,4,2
Jamboss,twisting-nether,384,hunter,survival,6,4,2
Raelaf,zuljin,384,hunter,survival,6,4,2
Nomorex,frostwhisper,384,hunter,survival,6,4,2
Trapandstun,aszune,384,hunter,survival,6,4,2
Capullospawn,dun-morogh,384,hunter,survival,6,4,2
Пятницкий,soulflayer,384,hunter,survival,6,4,2
Аминотоксид,blackscar,384,hunter,survival,6,4,2
Xxø,ravencrest,384,hunter,survival,6,4,2
Snippy,sanguino,384,hunter,survival,6,4,2
Ледо,deathguard,384,hunter,survival,6,4,2
Tôm,ravencrest,384,hunter,survival,6,4,2
Fmatzen,the-maelstrom,384,hunter,survival,6,4,2
Куфа,blackscar,384,hunter,survival,6,4,2
Flamehand,kazzak,384,hunter,survival,6,4,2
Gharzok,blackrock,384,hunter,survival,6,4,2
Vâleriaa,blackrock,384,hunter,survival,6,4,2
Virzion,silvermoon,384,hunter,survival,6,4,2
Renegansnipe,silvermoon,384,hunter,survival,6,4,2
Luftikuss,arthas,384,hunter,survival,6,4,2
Djøgi,archimonde,384,hunter,survival,6,4,2
Gogolehunt,archimonde,384,hunter,survival,6,4,2
Abgeherjoe,antonidas,384,hunter,survival,12,4,8
Фурболгов,gordunni,384,hunter,survival,12,4,8
Ниалла,thermaplugg,384,hunter,survival,12,4,8
Ázurâ,blackhand,384,hunter,survival,12,4,8
Voldagor,hyjal,384,hunter,survival,12,4,8
Skumrask,outland,384,hunter,survival,12,4,8
Nurki,the-maelstrom,384,hunter,survival,12,4,8
Wärft,arathi,384,hunter,survival,12,4,8
Eâgleêyê,frostwolf,384,hunter,survival,12,4,8
Vorsord,zuljin,384,hunter,survival,12,4,8
Beaststeaks,thrall,384,hunter,survival,12,4,8
Bâng,zuljin,383,hunter,survival,12,4,8
Одисенс,eversong,383,hunter,survival,12,4,8
Platza,ragnaros,383,hunter,survival,12,4,8
Hanibale,burning-blade,382,hunter,survival,18,4,14
Ghob,kazzak,330,hunter,survival,8,5,3
Killdembro,sunstrider,320,hunter,survival,16,4,12
Sùnzí,alakir,319,hunter,survival,6,4,2
Prinzz,blackmoore,288,hunter,survival,6,3,3
Himatoumi,elune,288,hunter,survival,6,3,3
Eazzyy,auchindoun,288,hunter,survival,6,3,3
Lightxyz,ravencrest,288,hunter,survival,6,3,3
Hræsvëlg,archimonde,288,hunter,survival,6,3,3
Simppeli,sylvanas,288,hunter,survival,6,3,3
Helvetiya,sylvanas,288,hunter,survival,6,3,3
Dettas,silvermoon,288,hunter,survival,6,3,3
Барабаша,deathguard,288,hunter,survival,6,3,3
Natchell,ysondre,288,hunter,survival,6,3,3
Nektard,ravencrest,288,hunter,survival,6,3,3
Atalnta,ravencrest,288,hunter,survival,6,3,3
Oneeyedjoe,the-maelstrom,288,hunter,survival,6,3,3
Schwabbels,silvermoon,288,hunter,survival,6,3,3
Паркх,soulflayer,288,hunter,survival,6,3,3
Ремонтлицаа,gordunni,288,hunter,survival,6,3,3
Sworra,silvermoon,288,hunter,survival,6,3,3
Natheldir,silvermoon,288,hunter,survival,6,3,3
Spakster,blackrock,288,hunter,survival,6,3,3
Assaultrifle,frostmane,288,hunter,survival,6,3,3
Crucfixion,kazzak,288,hunter,survival,6,3,3
Rákthar,blackmoore,288,hunter,survival,6,3,3
Rdwlf,draenor,288,hunter,survival,6,3,3
Engetsu,drakthul,288,hunter,survival,6,3,3
Faccacamoale,twisting-nether,288,hunter,survival,6,3,3
Крэин,howling-fjord,288,hunter,survival,6,3,3
Aidsmacka,shattered-hand,288,hunter,survival,6,3,3
Hühneknubbel,blackmoore,288,hunter,survival,6,3,3
Hreo,twisting-nether,288,hunter,survival,6,3,3
Deskö,shendralar,288,hunter,survival,6,3,3
Cásper,tarren-mill,288,hunter,survival,12,3,9
Jäinenool,outland,288,hunter,survival,12,3,9
Nestór,todeswache,288,hunter,survival,12,3,9
Сногивкабину,soulflayer,288,hunter,survival,12,3,9
Aspergun,ragnaros,288,hunter,survival,12,3,9
Charlet,archimonde,287,hunter,survival,6,3,3
Lezigoulleur,marécage-de-zangar,287,hunter,survival,6,3,3
Санясурв,gordunni,239,hunter,survival,10,6,4
Axiøs,thrall,239,hunter,survival,5,3,2
Xamisch,eredar,192,hunter,survival,4,3,1
Flexifys,tarren-mill,192,hunter,survival,6,2,4
Gynax,hyjal,192,hunter,survival,6,2,4
Marluxiâ,archimonde,192,hunter,survival,6,2,4
Гаррельд,blackscar,192,hunter,survival,6,2,4
Tdapills,sanguino,192,hunter,survival,6,2,4
Неужто,deathguard,192,hunter,survival,6,2,4
Regale,archimonde,192,hunter,survival,6,2,4
Jarekk,auchindoun,192,hunter,survival,6,2,4
Gerzyy,drakthul,192,hunter,survival,6,2,4
Штынь,gordunni,192,hunter,survival,6,2,4
Babûsch,blackmoore,192,hunter,survival,6,2,4
Roscke,drakthul,192,hunter,survival,6,2,4
Éddiémórphín,kazzak,192,hunter,survival,6,2,4
Yakayoshi,kazzak,192,hunter,survival,6,2,4
Brindefolìe,archimonde,192,hunter,survival,6,2,4
Abeji,malygos,192,hunter,survival,6,2,4
Aggrobatics,blackmoore,192,hunter,survival,6,2,4
Eromoar,outland,192,hunter,survival,6,2,4
Aboleon,ragnaros,192,hunter,survival,6,2,4
Vasco,chogall,192,hunter,survival,6,2,4
Evazeonhunt,antonidas,192,hunter,survival,6,2,4
Robosexual,ravencrest,192,hunter,survival,6,2,4
Steffxd,twisting-nether,192,hunter,survival,6,2,4
Ammò,kazzak,192,hunter,survival,6,2,4
Epicsurvive,ravencrest,192,hunter,survival,6,2,4
Maddoqx,frostwolf,192,hunter,survival,6,2,4
Наладдчик,howling-fjord,192,hunter,survival,6,2,4
Lithell,kazzak,192,hunter,survival,6,2,4
Bùddhíst,ravencrest,192,hunter,survival,6,2,4
Zøøkëëper,silvermoon,192,hunter,survival,6,2,4
Sakaryali,silvermoon,192,hunter,survival,6,2,4
Raenard,ragnaros,192,hunter,survival,6,2,4
Adram,burning-legion,192,hunter,survival,6,2,4
Coromant,blackrock,192,hunter,survival,8,2,6
Бомбетта,grom,192,hunter,survival,12,2,10
Haskeer,shattrath,192,hunter,survival,12,2,10
Yinn,kilrogg,192,hunter,survival,12,2,10
Skewdar,hyjal,192,hunter,survival,12,2,10
Ecthelione,the-venture-co,192,hunter,survival,12,2,10
Bowkeeper,kazzak,191,hunter,survival,6,2,4
Комомура,soulflayer,169,hunter,survival,17,4,13
Horku,kazzak,96,hunter,survival,6,1,5
Katzchen,burning-legion,96,hunter,survival,6,1,5
Vuloshi,twisting-nether,96,hunter,survival,6,1,5
Panzershot,hyjal,96,hunter,survival,6,1,5
Эвилтар,soulflayer,96,hunter,survival,6,1,5
Supcuz,stormscale,96,hunter,survival,6,1,5
Cryts,dun-modr,96,hunter,survival,6,1,5
Ryztik,garona,96,hunter,survival,6,1,5
Zuggi,defias-brotherhood,96,hunter,survival,6,1,5
Aimywinehaus,drakthul,96,hunter,survival,6,1,5
Grollar,ragnaros,96,hunter,survival,6,1,5
Amadia,defias-brotherhood,96,hunter,survival,6,1,5
Clicktrap,runetotem,96,hunter,survival,6,1,5
Escaflôwn,aegwynn,96,hunter,survival,6,1,5
Zynga,sylvanas,96,hunter,survival,6,1,5
Fantus,sylvanas,96,hunter,survival,6,1,5
Куоль,gordunni,96,hunter,survival,6,1,5
Рангмар,howling-fjord,79,hunter,survival,5,1,4
Twinkhunter,pozzo-delleternità,64,hunter,survival,4,1,3
Skyyw,tarren-mill,64,hunter,survival,5,1,4
Jacobszy,outland,63,hunter,survival,2,2,0
Velrhegal,tarren-mill,16,hunter,survival,7,1,6
Mariabanks,aegwynn,2264,hunter,beastmastery,216,114,102
Brokeasalwys,ravencrest,2164,hunter,beastmastery,84,46,38
Hypse,kazzak,2133,hunter,beastmastery,130,65,65
Берх,gordunni,2043,hunter,beastmastery,90,45,45
Esperion,ragnaros,2042,hunter,beastmastery,96,46,50
Plugonbaby,hyjal,2035,hunter,beastmastery,77,37,40
Libanais,archimonde,2017,hunter,beastmastery,221,108,113
Cbã,ravencrest,1995,hunter,beastmastery,42,21,21
Wîldhunt,burning-legion,1982,hunter,beastmastery,107,56,51
Gernoqz,frostwolf,1973,hunter,beastmastery,107,51,56
Eldrekou,kazzak,1968,hunter,beastmastery,72,41,31
Zyphx,der-rat-von-dalaran,1936,hunter,beastmastery,102,46,56
Куфа,blackscar,1909,hunter,beastmastery,36,20,16
Thing,kazzak,1900,hunter,beastmastery,36,21,15
Тружка,soulflayer,1899,hunter,beastmastery,78,35,43
Trapgoddxx,archimonde,1894,hunter,beastmastery,65,44,21
Биско,gordunni,1890,hunter,beastmastery,80,40,40
Manj,blackhand,1888,hunter,beastmastery,54,29,25
Wilfyre,twisting-nether,1885,hunter,beastmastery,63,32,31
Baltímore,stormscale,1877,hunter,beastmastery,41,22,19
Blackszpak,jaedenar,1876,hunter,beastmastery,42,23,19
Дианнесса,howling-fjord,1876,hunter,beastmastery,71,35,36
Phesx,sylvanas,1865,hunter,beastmastery,54,27,27
Ígrågøßñø,silvermoon,1864,hunter,beastmastery,44,30,14
Aimshots,twisting-nether,1864,hunter,beastmastery,60,33,27
Fãdê,ravencrest,1858,hunter,beastmastery,42,30,12
Krampack,dun-modr,1858,hunter,beastmastery,54,31,23
Gaeln,outland,1856,hunter,beastmastery,90,44,46
Doghxnter,ravencrest,1853,hunter,beastmastery,42,21,21
Sipsomewater,ravencrest,1852,hunter,beastmastery,57,30,27
Draxil,archimonde,1852,hunter,beastmastery,42,22,20
Feevah,frostmane,1843,hunter,beastmastery,219,107,112
Nyzuri,die-aldor,1843,hunter,beastmastery,54,26,28
Luzivarus,malganis,1842,hunter,beastmastery,59,29,30
Miløø,silvermoon,1835,hunter,beastmastery,48,26,22
Breezme,twisting-nether,1833,hunter,beastmastery,66,31,35
Rákthar,blackmoore,1832,hunter,beastmastery,66,32,34
Odeôn,twisting-nether,1826,hunter,beastmastery,48,20,28
Bilbohunter,draenor,1825,hunter,beastmastery,48,27,21
Burninghunt,ravencrest,1822,hunter,beastmastery,60,32,28
Wêskêr,tarren-mill,1821,hunter,beastmastery,66,31,35
Ooh,doomhammer,1816,hunter,beastmastery,96,44,52
Jabela,eredar,1814,hunter,beastmastery,53,39,14
Dogetrainer,silvermoon,1814,hunter,beastmastery,54,29,25
Горгонт,blackscar,1813,hunter,beastmastery,42,24,18
Рагнарианх,gordunni,1813,hunter,beastmastery,60,25,35
Rndhunt,shattrath,1811,hunter,beastmastery,60,30,30
Марчик,blackscar,1810,hunter,beastmastery,42,19,23
Hiddenx,blackmoore,1808,hunter,beastmastery,42,21,21
Trend,silvermoon,1808,hunter,beastmastery,48,23,25
Huntchonk,kazzak,1806,hunter,beastmastery,53,27,26
Truejkee,silvermoon,1805,hunter,beastmastery,54,29,25
Crippa,tarren-mill,1803,hunter,beastmastery,54,28,26
Safnirx,tarren-mill,1803,hunter,beastmastery,60,24,36
Ynv,argent-dawn,1802,hunter,beastmastery,60,30,30
Tagz,ravencrest,1795,hunter,beastmastery,54,23,31
Thogel,hyjal,1794,hunter,beastmastery,66,30,36
Orcji,blackhand,1788,hunter,beastmastery,59,29,30
Wodhunterxdd,outland,1788,hunter,beastmastery,53,25,28
Triggaz,stormscale,1785,hunter,beastmastery,160,85,75
Mtrider,twisting-nether,1785,hunter,beastmastery,65,33,32
Nystaleoss,grim-batol,1776,hunter,beastmastery,88,42,46
Jamesyy,ravencrest,1776,hunter,beastmastery,60,28,32
Онкьяр,gordunni,1773,hunter,beastmastery,39,23,16
Erethrus,ravencrest,1769,hunter,beastmastery,48,19,29
Amyndôr,ravencrest,1767,hunter,beastmastery,48,27,21
Izmad,archimonde,1766,hunter,beastmastery,239,134,105
Klausmanne,blackrock,1765,hunter,beastmastery,81,37,44
Âmalphy,ravencrest,1764,hunter,beastmastery,35,19,16
Séyena,outland,1764,hunter,beastmastery,42,19,23
Fullxtrap,hyjal,1763,hunter,beastmastery,41,19,22
Nimhunt,dentarg,1759,hunter,beastmastery,65,29,36
Ilovemax,archimonde,1750,hunter,beastmastery,46,20,26
Fluphy,thrall,1744,hunter,beastmastery,53,31,22
Treaz,sanguino,1739,hunter,beastmastery,66,33,33
Nèxz,blackrock,1738,hunter,beastmastery,72,31,41
Saggymilkies,outland,1735,hunter,beastmastery,54,23,31
Carioca,blackhand,1731,hunter,beastmastery,42,20,22
Вождь,howling-fjord,1730,hunter,beastmastery,42,21,21
Шергала,soulflayer,1727,hunter,beastmastery,71,31,40
Duppdupp,eredar,1726,hunter,beastmastery,84,38,46
Лесбиянюсь,gordunni,1723,hunter,beastmastery,30,24,6
Father,auchindoun,1721,hunter,beastmastery,65,34,31
Babýrage,twisting-nether,1716,hunter,beastmastery,30,18,12
Дашатрирубля,soulflayer,1715,hunter,beastmastery,42,21,21
Noversia,aegwynn,1714,hunter,beastmastery,71,33,38
Twineyes,ravencrest,1712,hunter,beastmastery,48,25,23
Fize,blackmoore,1712,hunter,beastmastery,41,20,21
Moscowmule,tarren-mill,1711,hunter,beastmastery,48,21,27
Alpharaven,ravencrest,1709,hunter,beastmastery,48,25,23
Mogwai,stormscale,1709,hunter,beastmastery,42,18,24
Omegakek,madmortem,1707,hunter,beastmastery,46,23,23
Easyclass,hyjal,1705,hunter,beastmastery,96,55,41
Elamondria,outland,1699,hunter,beastmastery,72,42,30
Sznxøxo,ravencrest,1699,hunter,beastmastery,48,26,22
Irefutabilâ,outland,1696,hunter,beastmastery,96,43,53
Eazzyy,auchindoun,1695,hunter,beastmastery,36,21,15
Пивопьюня,ashenvale,1695,hunter,beastmastery,41,20,21
Priceqtxd,ravencrest,1694,hunter,beastmastery,61,40,21
Krix,ragnaros,1691,hunter,beastmastery,54,34,20
Пихпахах,gordunni,1691,hunter,beastmastery,82,43,39
Paimen,darksorrow,1690,hunter,beastmastery,96,54,42
Играсломана,howling-fjord,1685,hunter,beastmastery,24,18,6
Letsrock,outland,1682,hunter,beastmastery,33,20,13
Скадхи,blackscar,1681,hunter,beastmastery,46,23,23
Nestór,todeswache,1678,hunter,beastmastery,47,28,19
Отерон,gordunni,1677,hunter,beastmastery,90,55,35
Appirc,tarren-mill,1675,hunter,beastmastery,36,19,17
Порошокк,gordunni,1675,hunter,beastmastery,57,21,36
Åsynåmvp,twisting-nether,1671,hunter,beastmastery,35,18,17
Kachaxa,kazzak,1667,hunter,beastmastery,52,23,29
Dréws,kazzak,1665,hunter,beastmastery,40,18,22
Pérnix,tarren-mill,1657,hunter,beastmastery,30,18,12
Cnby,stormscale,1652,hunter,beastmastery,43,26,17
Índigo,kazzak,1650,hunter,beastmastery,44,25,19
Røzy,twisting-nether,1647,hunter,beastmastery,48,35,13
Зоотян,gordunni,1645,hunter,beastmastery,99,51,48
Nîøssx,blackrock,1644,hunter,beastmastery,53,28,25
Ericspet,stormscale,1641,hunter,beastmastery,36,24,12
Hacz,bronzebeard,1641,hunter,beastmastery,48,20,28
Drøøðqt,blackrock,1637,hunter,beastmastery,60,31,29
Lowfet,neptulon,1634,hunter,beastmastery,46,31,15
Экономист,fordragon,1633,hunter,beastmastery,36,21,15
Xiioo,ravencrest,1631,hunter,beastmastery,65,29,36
Imcuteandfun,ravencrest,1630,hunter,beastmastery,60,24,36
Lofiel,blackrock,1628,hunter,beastmastery,53,27,26
Roarmantic,blackrock,1627,hunter,beastmastery,36,17,19
Порошокк,howling-fjord,1625,hunter,beastmastery,30,17,13
Дэнвин,deathweaver,1625,hunter,beastmastery,42,22,20
Gibiswag,outland,1625,hunter,beastmastery,36,17,19
Uglybaboon,draenor,1625,hunter,beastmastery,42,17,25
Akaris,archimonde,1624,hunter,beastmastery,48,23,25
Jägarnmt,twisting-nether,1623,hunter,beastmastery,42,20,22
Merquryh,ravencrest,1619,hunter,beastmastery,36,20,16
Vezeka,ravencrest,1618,hunter,beastmastery,42,26,16
Sïmc,archimonde,1617,hunter,beastmastery,84,44,40
Búddhá,stormscale,1617,hunter,beastmastery,132,63,69
Impxgodx,outland,1617,hunter,beastmastery,39,18,21
Nexztwo,blackrock,1616,hunter,beastmastery,39,18,21
Ганидони,soulflayer,1616,hunter,beastmastery,59,23,36
Ðéadsøulz,stormscale,1613,hunter,beastmastery,72,38,34
Missmytraps,ravencrest,1613,hunter,beastmastery,39,20,19
Erilis,twisting-nether,1612,hunter,beastmastery,31,18,13
Aroeris,ravencrest,1611,hunter,beastmastery,57,32,25
Qtìp,aegwynn,1611,hunter,beastmastery,36,17,19
Трапгодикс,eversong,1606,hunter,beastmastery,78,40,38
Tyranski,ravencrest,1606,hunter,beastmastery,45,21,24
Chasseurcool,argent-dawn,1604,hunter,beastmastery,32,19,13
Taoshii,die-aldor,1604,hunter,beastmastery,66,36,30
Céah,blackrock,1604,hunter,beastmastery,54,28,26
Brisbya,khaz-modan,1600,hunter,beastmastery,29,21,8
Stickey,antonidas,1600,hunter,beastmastery,66,34,32
Hultasy,outland,1600,hunter,beastmastery,84,40,44
Bànsundara,hyjal,1596,hunter,beastmastery,42,25,17
Moistmán,kazzak,1594,hunter,beastmastery,44,22,22
Poupoune,uldum,1593,hunter,beastmastery,36,17,19
Nottberozz,silvermoon,1589,hunter,beastmastery,122,59,63
Eaglexx,twisting-nether,1586,hunter,beastmastery,48,23,25
Tayaa,draenor,1585,hunter,beastmastery,79,43,36
Janko,ravencrest,1584,hunter,beastmastery,108,55,53
Xxiioo,ravencrest,1583,hunter,beastmastery,79,46,33
Parhainkoira,argent-dawn,1581,hunter,beastmastery,36,20,16
Jeeso,baelgun,1581,hunter,beastmastery,72,33,39
Тиблэк,soulflayer,1579,hunter,beastmastery,101,51,50
Ryuwen,dun-modr,1579,hunter,beastmastery,36,18,18
Grusijohn,executus,1573,hunter,beastmastery,66,33,33
Мунлэс,lich-king,1569,hunter,beastmastery,69,30,39
Комомура,soulflayer,1568,hunter,beastmastery,53,24,29
Sagethunt,blackrock,1565,hunter,beastmastery,41,17,24
Mânhunt,blackhand,1563,hunter,beastmastery,174,80,94
Coldmonster,tarren-mill,1561,hunter,beastmastery,90,55,35
Pluttbug,xavius,1560,hunter,beastmastery,26,17,9
Kamar,archimonde,1560,hunter,beastmastery,36,23,13
Мэлвиса,borean-tundra,1558,hunter,beastmastery,30,18,12
Жокра,greymane,1557,hunter,beastmastery,42,19,23
Søuïlløn,archimonde,1553,hunter,beastmastery,36,24,12
Vaelyste,doomhammer,1552,hunter,beastmastery,36,20,16
Gunde,kazzak,1551,hunter,beastmastery,102,52,50
Zuxz,blackmoore,1546,hunter,beastmastery,42,18,24
Пулявзубах,gordunni,1544,hunter,beastmastery,92,49,43
Draugrinnh,tarren-mill,1544,hunter,beastmastery,60,27,33
Кразайс,ashenvale,1542,hunter,beastmastery,44,18,26
Oldcocknbals,silvermoon,1539,hunter,beastmastery,58,28,30
Антисерт,ashenvale,1538,hunter,beastmastery,70,33,37
Badkirves,kazzak,1530,hunter,beastmastery,36,17,19
Palaur,kazzak,1528,hunter,beastmastery,71,38,33
Nkdchef,outland,1526,hunter,beastmastery,36,17,19
Каоссхант,howling-fjord,1523,hunter,beastmastery,24,16,8
Sarrow,ravencrest,1523,hunter,beastmastery,77,41,36
Idtrapthat,nagrand,1522,hunter,beastmastery,30,16,14
Nallepuuoh,outland,1515,hunter,beastmastery,57,28,29
Haltrâdar,archimonde,1511,hunter,beastmastery,33,17,16
Kafkules,outland,1507,hunter,beastmastery,53,29,24
Eagletalon,twisting-nether,1506,hunter,beastmastery,30,16,14
Icetrapped,eredar,1502,hunter,beastmastery,41,25,16
Leriath,shadowsong,1502,hunter,beastmastery,89,52,37
Rdom,stormreaver,1497,hunter,beastmastery,46,24,22
Slmao,tarren-mill,1497,hunter,beastmastery,36,16,20
Gumm,gorgonnash,1496,hunter,beastmastery,30,17,13
Ázurâ,blackhand,1486,hunter,beastmastery,63,34,29
Забзаб,soulflayer,1484,hunter,beastmastery,29,16,13
Аллони,booty-bay,1483,hunter,beastmastery,90,41,49
Mytown,hyjal,1475,hunter,beastmastery,72,37,35
Mariehunt,blackmoore,1472,hunter,beastmastery,78,38,40
Snipertjuh,silvermoon,1472,hunter,beastmastery,37,17,20
Wingclip,ravencrest,1472,hunter,beastmastery,40,17,23
Bastianapa,twisting-nether,1471,hunter,beastmastery,66,31,35
Aenina,kazzak,1466,hunter,beastmastery,30,19,11
Råhl,zuljin,1466,hunter,beastmastery,41,17,24
Куоль,gordunni,1463,hunter,beastmastery,47,21,26
Афигеннски,ashenvale,1459,hunter,beastmastery,48,25,23
Boulaax,ysondre,1457,hunter,beastmastery,100,60,40
Gnouminøu,archimonde,1455,hunter,beastmastery,69,36,33
Metalmaison,archimonde,1453,hunter,beastmastery,70,31,39
Anca,aegwynn,1445,hunter,beastmastery,36,17,19
Леао,howling-fjord,1442,hunter,beastmastery,24,16,8
Bíllybobbs,argent-dawn,1439,hunter,beastmastery,30,15,15
Straybullet,kazzak,1438,hunter,beastmastery,66,32,34
Sicktrapbtw,hyjal,1438,hunter,beastmastery,36,15,21
Pfizershotx,khaz-modan,1436,hunter,beastmastery,30,15,15
Mágaz,draenor,1435,hunter,beastmastery,48,26,22
Orcoro,ysondre,1432,hunter,beastmastery,115,51,64
Tukene,kazzak,1432,hunter,beastmastery,45,17,28
Shoranon,stormscale,1431,hunter,beastmastery,30,15,15
Jomerin,thrall,1429,hunter,beastmastery,36,15,21
Nordafrøst,antonidas,1428,hunter,beastmastery,42,15,27
Anjeschka,nemesis,1427,hunter,beastmastery,40,24,16
Gondoo,tarren-mill,1427,hunter,beastmastery,30,15,15
Meskette,ravencrest,1423,hunter,beastmastery,49,23,26
Xystîco,thrall,1421,hunter,beastmastery,36,18,18
Rhee,the-maelstrom,1421,hunter,beastmastery,90,39,51
Horhyndan,ragnaros,1420,hunter,beastmastery,33,16,17
Waalth,ragnaros,1420,hunter,beastmastery,72,34,38
Diapositiv,draenor,1416,hunter,beastmastery,24,15,9
Гигапупсх,howling-fjord,1415,hunter,beastmastery,36,19,17
Маунтдроп,gordunni,1415,hunter,beastmastery,61,32,29
Яроняютрапу,gordunni,1413,hunter,beastmastery,24,17,7
Feralhound,exodar,1412,hunter,beastmastery,30,15,15
Velocity,nagrand,1411,hunter,beastmastery,41,19,22
Reptile,outland,1410,hunter,beastmastery,24,15,9
Neíth,the-maelstrom,1405,hunter,beastmastery,42,17,25
Hammertime,sanguino,1404,hunter,beastmastery,35,18,17
Traktorr,stormscale,1403,hunter,beastmastery,33,17,16
Váal,dun-modr,1401,hunter,beastmastery,63,36,27
Phinecone,stormscale,1399,hunter,beastmastery,42,18,24
Pammycakes,bronze-dragonflight,1394,hunter,beastmastery,66,34,32
Ayyubi,blackrock,1389,hunter,beastmastery,59,28,31
Jägarntwo,stormscale,1389,hunter,beastmastery,39,15,24
Elsasehunter,zuljin,1387,hunter,beastmastery,72,29,43
Acmé,kazzak,1385,hunter,beastmastery,36,15,21
Bambamgalke,antonidas,1378,hunter,beastmastery,72,34,38
Loógosh,blackmoore,1376,hunter,beastmastery,54,26,28
Чапуршилов,lich-king,1376,hunter,beastmastery,88,42,46
Esgar,blackrock,1374,hunter,beastmastery,74,34,40
Sonìc,kazzak,1373,hunter,beastmastery,32,16,16
Честнный,howling-fjord,1373,hunter,beastmastery,113,51,62
Шэйдуокер,gordunni,1373,hunter,beastmastery,69,30,39
Стреладемона,gordunni,1368,hunter,beastmastery,51,30,21
Shroomynuts,kazzak,1368,hunter,beastmastery,42,16,26
Drestan,drakthul,1363,hunter,beastmastery,36,16,20
Qmbonboni,ravencrest,1362,hunter,beastmastery,35,22,13
Kalt,twisting-nether,1357,hunter,beastmastery,42,22,20
Unrealy,grim-batol,1355,hunter,beastmastery,30,18,12
Nycrom,ravencrest,1354,hunter,beastmastery,32,15,17
Киборка,howling-fjord,1352,hunter,beastmastery,30,15,15
Laoriane,hyjal,1351,hunter,beastmastery,30,15,15
Shawnrai,drakthul,1348,hunter,beastmastery,32,16,16
Pryse,hyjal,1342,hunter,beastmastery,30,14,16
Baileé,onyxia,1340,hunter,beastmastery,32,17,15
Фираналь,blackscar,1339,hunter,beastmastery,27,15,12
Joshalama,quelthalas,1339,hunter,beastmastery,35,19,16
Ashjen,aszune,1338,hunter,beastmastery,24,14,10
Saromán,ravencrest,1336,hunter,beastmastery,36,19,17
Notikâ,aegwynn,1336,hunter,beastmastery,48,20,28
Bortian,argent-dawn,1334,hunter,beastmastery,25,15,10
Сатарр,gordunni,1334,hunter,beastmastery,54,24,30
Asousa,stormscale,1333,hunter,beastmastery,42,22,20
Жмыххунтер,howling-fjord,1331,hunter,beastmastery,30,14,16
Ägris,die-todeskrallen,1330,hunter,beastmastery,63,32,31
Ixix,blackhand,1330,hunter,beastmastery,30,14,16
Trapwann,argent-dawn,1329,hunter,beastmastery,24,14,10
Huntma,kazzak,1324,hunter,beastmastery,24,14,10
Cubro,sanguino,1322,hunter,beastmastery,30,14,16
Hantro,argent-dawn,1321,hunter,beastmastery,30,18,12
Tåxi,silvermoon,1320,hunter,beastmastery,24,14,10
Hogar,frostwolf,1317,hunter,beastmastery,24,14,10
Salvia,chromaggus,1315,hunter,beastmastery,84,46,38
Meredo,burning-legion,1313,hunter,beastmastery,58,30,28
Muspigen,tarren-mill,1313,hunter,beastmastery,81,37,44
Jarekk,auchindoun,1312,hunter,beastmastery,24,14,10
Felorya,kazzak,1311,hunter,beastmastery,24,14,10
Люблюлюбовь,gordunni,1310,hunter,beastmastery,42,27,15
Bravestarr,blades-edge,1307,hunter,beastmastery,30,16,14
Афонадзе,gordunni,1298,hunter,beastmastery,48,24,24
Чизано,deathguard,1295,hunter,beastmastery,30,14,16
Maknamara,tarren-mill,1293,hunter,beastmastery,24,14,10
Flunkytim,blackmoore,1290,hunter,beastmastery,42,21,21
Greathorn,arthas,1288,hunter,beastmastery,22,15,7
Cobra,magtheridon,1282,hunter,beastmastery,71,30,41
Travels,tarren-mill,1280,hunter,beastmastery,43,20,23
Tháyn,tarren-mill,1268,hunter,beastmastery,23,14,9
Kiingsane,archimonde,1268,hunter,beastmastery,33,15,18
Snipingdog,stormscale,1267,hunter,beastmastery,30,17,13
Linchpin,dentarg,1261,hunter,beastmastery,45,20,25
Шионо,howling-fjord,1250,hunter,beastmastery,26,14,12
Bufosh,twisting-nether,1250,hunter,beastmastery,36,19,17
Arcø,dun-modr,1248,hunter,beastmastery,24,13,11
Ðowz,ysondre,1248,hunter,beastmastery,24,13,11
Гринмех,gordunni,1247,hunter,beastmastery,24,13,11
Pagman,thrall,1247,hunter,beastmastery,30,13,17
Símpíng,tarren-mill,1245,hunter,beastmastery,18,13,5
Futureman,blackrock,1243,hunter,beastmastery,24,13,11
Ariabeast,archimonde,1240,hunter,beastmastery,30,13,17
Neescafe,sylvanas,1236,hunter,beastmastery,27,14,13
Dzikapumpa,burning-legion,1232,hunter,beastmastery,30,13,17
Sparcùs,stormreaver,1231,hunter,beastmastery,30,13,17
Yoggys,outland,1229,hunter,beastmastery,30,13,17
Xüscha,ysera,1226,hunter,beastmastery,36,13,23
Туруханец,gordunni,1225,hunter,beastmastery,48,24,24
Davíncí,tarren-mill,1224,hunter,beastmastery,77,41,36
Desow,blackrock,1222,hunter,beastmastery,18,13,5
Vexhh,outland,1221,hunter,beastmastery,24,13,11
Stogie,auchindoun,1217,hunter,beastmastery,24,13,11
Belorgrim,kirin-tor,1216,hunter,beastmastery,24,13,11
Sixty,rajaxx,1207,hunter,beastmastery,24,13,11
Heylie,senjin,1206,hunter,beastmastery,47,16,31
Diac,dalaran,1201,hunter,beastmastery,18,13,5
Slojork,thrall,1190,hunter,beastmastery,92,40,52
Eddy,the-maelstrom,1187,hunter,beastmastery,36,20,16
Cinan,twisting-nether,1182,hunter,beastmastery,40,21,19
Мориартис,ashenvale,1181,hunter,beastmastery,23,13,10
Jaky,illidan,1176,hunter,beastmastery,89,52,37
Skullstah,ravencrest,1169,hunter,beastmastery,24,13,11
Балласкиндер,gordunni,1164,hunter,beastmastery,60,31,29
Olamay,blackmoore,1159,hunter,beastmastery,36,19,17
Oròme,pozzo-delleternità,1157,hunter,beastmastery,54,28,26
Druckwelle,frostwolf,1151,hunter,beastmastery,18,12,6
Diktatos,kazzak,1151,hunter,beastmastery,24,12,12
Brawnshunt,stormscale,1151,hunter,beastmastery,24,12,12
Sentriks,tarren-mill,1151,hunter,beastmastery,24,12,12
Digimørtal,kazzak,1150,hunter,beastmastery,18,12,6
Bebar,kazzak,1150,hunter,beastmastery,18,12,6
Raythe,argent-dawn,1150,hunter,beastmastery,24,12,12
Galileo,sanguino,1150,hunter,beastmastery,26,12,14
Misstrap,nemesis,1150,hunter,beastmastery,30,12,18
Mâjôô,blackhand,1149,hunter,beastmastery,22,13,9
Ingvi,antonidas,1149,hunter,beastmastery,30,12,18
Freebïrd,shattered-hand,1147,hunter,beastmastery,18,12,6
Zubro,kazzak,1146,hunter,beastmastery,30,12,18
Ловихимеру,soulflayer,1145,hunter,beastmastery,18,12,6
Fiftyóne,festung-der-stürme,1144,hunter,beastmastery,30,12,18
Artemisas,draenor,1144,hunter,beastmastery,36,12,24
Tempestes,tarren-mill,1143,hunter,beastmastery,39,20,19
Chagaure,hyjal,1141,hunter,beastmastery,24,12,12
Dramin,defias-brotherhood,1140,hunter,beastmastery,119,57,62
Abovival,ragnaros,1134,hunter,beastmastery,24,12,12
Джантига,howling-fjord,1128,hunter,beastmastery,24,12,12
Ezelina,lightnings-blade,1124,hunter,beastmastery,24,14,10
Каосси,gordunni,1119,hunter,beastmastery,33,13,20
Schnezzler,nerathor,1116,hunter,beastmastery,74,38,36
Karstarkk,sanguino,1115,hunter,beastmastery,41,17,24
Tsoutsoukoss,silvermoon,1114,hunter,beastmastery,55,26,29
Juha,the-maelstrom,1111,hunter,beastmastery,26,13,13
Nieki,eitrigg,1109,hunter,beastmastery,44,15,29
Savori,kazzak,1096,hunter,beastmastery,31,18,13
Goonii,bronzebeard,1094,hunter,beastmastery,24,12,12
Cruelsummer,kul-tiras,1091,hunter,beastmastery,30,12,18
Ertestuing,tarren-mill,1090,hunter,beastmastery,30,14,16
Luckyhunty,dalaran,1086,hunter,beastmastery,36,15,21
Brometheus,sylvanas,1083,hunter,beastmastery,41,15,26
Ládysháyà,blackrock,1074,hunter,beastmastery,24,13,11
Spiritshot,baelgun,1066,hunter,beastmastery,34,14,20
Corossity,blackmoore,1056,hunter,beastmastery,18,11,7
Deblaze,aegwynn,1056,hunter,beastmastery,18,11,7
Techpøint,silvermoon,1056,hunter,beastmastery,24,11,13
Smhx,stormscale,1055,hunter,beastmastery,18,11,7
Eggcowmeow,azjolnerub,1055,hunter,beastmastery,18,11,7
Хастла,greymane,1055,hunter,beastmastery,18,11,7
Pawzz,kazzak,1055,hunter,beastmastery,24,11,13
Fåded,ravencrest,1054,hunter,beastmastery,25,12,13
Daveq,drakthul,1054,hunter,beastmastery,24,11,13
Hîldegard,todeswache,1054,hunter,beastmastery,24,11,13
Фетсол,soulflayer,1053,hunter,beastmastery,12,11,1
Almogrote,sanguino,1051,hunter,beastmastery,24,11,13
Kethos,draenor,1050,hunter,beastmastery,18,11,7
Pilogbueferd,silvermoon,1050,hunter,beastmastery,18,11,7
Askaway,sylvanas,1049,hunter,beastmastery,18,11,7
Коблазнх,howling-fjord,1048,hunter,beastmastery,24,11,13
Pekaxôxô,sanguino,1045,hunter,beastmastery,18,11,7
Amitar,tarren-mill,1044,hunter,beastmastery,18,11,7
Feignindeath,twisting-nether,1039,hunter,beastmastery,18,11,7
Venkox,archimonde,1039,hunter,beastmastery,49,25,24
Pumukle,madmortem,1035,hunter,beastmastery,34,15,19
Айлиси,soulflayer,1031,hunter,beastmastery,43,11,32
Румлис,gordunni,1029,hunter,beastmastery,29,14,15
Mykris,aegwynn,1024,hunter,beastmastery,35,13,22
Dioxis,silvermoon,1021,hunter,beastmastery,60,27,33
Ветиринарша,gordunni,1020,hunter,beastmastery,30,11,19
Grollar,ragnaros,1014,hunter,beastmastery,80,42,38
Nerfjuice,silvermoon,1006,hunter,beastmastery,27,13,14
Винченцо,blackscar,1003,hunter,beastmastery,21,11,10
Shpider,burning-blade,1000,hunter,beastmastery,52,22,30
Sinux,lordaeron,995,hunter,beastmastery,17,11,6
Feigur,sanguino,993,hunter,beastmastery,42,21,21
Loyalman,blackmoore,985,hunter,beastmastery,16,11,5
Missmytrap,archimonde,960,hunter,beastmastery,12,10,2
Kásúxøxø,ravencrest,960,hunter,beastmastery,16,11,5
Akhtabot,twisting-nether,960,hunter,beastmastery,18,10,8
Dìgítal,twisting-nether,960,hunter,beastmastery,18,10,8
Brokenpetman,defias-brotherhood,960,hunter,beastmastery,18,10,8
Jêsslíne,ravencrest,960,hunter,beastmastery,18,10,8
Lajnus,frostmane,960,hunter,beastmastery,18,10,8
Dafhel,hyjal,960,hunter,beastmastery,24,10,14
Zeanort,nordrassil,960,hunter,beastmastery,24,10,14
Astari,outland,960,hunter,beastmastery,24,10,14
Jägarn,stormscale,960,hunter,beastmastery,24,10,14
Ahlgood,stormscale,959,hunter,beastmastery,18,10,8
Thinkerer,silvermoon,959,hunter,beastmastery,18,10,8
Spider,zuljin,959,hunter,beastmastery,18,10,8
Spidak,stormscale,959,hunter,beastmastery,18,10,8
Gorgorm,ravencrest,959,hunter,beastmastery,18,10,8
Lëgølåslõrdx,blackrock,959,hunter,beastmastery,18,10,8
Gedzer,silvermoon,959,hunter,beastmastery,22,11,11
Djøgi,archimonde,959,hunter,beastmastery,24,10,14
Grabbin,silvermoon,959,hunter,beastmastery,24,10,14
Sylariel,die-aldor,958,hunter,beastmastery,18,10,8
Зуланария,howling-fjord,958,hunter,beastmastery,18,10,8
Corrupth,outland,958,hunter,beastmastery,18,10,8
Arrechus,khaz-modan,958,hunter,beastmastery,42,14,28
Choukzt,archimonde,957,hunter,beastmastery,18,10,8
Arnatti,tyrande,957,hunter,beastmastery,18,10,8
Ххун,gordunni,957,hunter,beastmastery,18,10,8
Rxr,kazzak,957,hunter,beastmastery,24,10,14
Толяарканшот,razuvious,956,hunter,beastmastery,18,10,8
Herpray,blackmoore,953,hunter,beastmastery,18,10,8
Magarosh,eredar,953,hunter,beastmastery,24,10,14
Darkdexou,defias-brotherhood,951,hunter,beastmastery,18,10,8
Ecalter,dun-modr,951,hunter,beastmastery,18,10,8
Lioness,ahnqiraj,951,hunter,beastmastery,24,10,14
Nidromel,stormscale,943,hunter,beastmastery,66,24,42
Lemeric,blackmoore,942,hunter,beastmastery,19,10,9
Безос,soulflayer,942,hunter,beastmastery,24,10,14
Deadlysnîpe,antonidas,941,hunter,beastmastery,16,11,5
Kure,blackrock,929,hunter,beastmastery,40,15,25
Trenesta,tarren-mill,927,hunter,beastmastery,22,10,12
Enanorabioso,minahonda,927,hunter,beastmastery,24,10,14
Paînfull,kazzak,926,hunter,beastmastery,23,10,13
Goliathoz,blackmoore,917,hunter,beastmastery,35,19,16
Stjordal,chamber-of-aspects,917,hunter,beastmastery,63,30,33
Kronzucker,eredar,914,hunter,beastmastery,36,16,20
Kënshiro,kazzak,893,hunter,beastmastery,20,10,10
Kapowz,kazzak,864,hunter,beastmastery,12,9,3
Sukzess,antonidas,864,hunter,beastmastery,12,9,3
Lilpancake,kazzak,864,hunter,beastmastery,12,9,3
Hispanøxd,sanguino,864,hunter,beastmastery,12,9,3
Eenel,twisting-nether,864,hunter,beastmastery,12,9,3
Mekerosh,burning-legion,864,hunter,beastmastery,18,9,9
Leza,kult-der-verdammten,864,hunter,beastmastery,18,9,9
Цитрукс,gordunni,864,hunter,beastmastery,18,9,9
Иоссифсталин,soulflayer,864,hunter,beastmastery,18,9,9
Scrubbi,destromath,864,hunter,beastmastery,18,9,9
Painaldeepz,stormscale,864,hunter,beastmastery,18,9,9
Kfcmanagerx,silvermoon,864,hunter,beastmastery,18,9,9
Downey,azshara,864,hunter,beastmastery,24,9,15
Denkstah,tarren-mill,864,hunter,beastmastery,24,9,15
Lysanhunt,zuljin,864,hunter,beastmastery,24,9,15
Fléxyz,sylvanas,863,hunter,beastmastery,18,9,9
Porch,dragonmaw,863,hunter,beastmastery,18,9,9
Darllene,kazzak,863,hunter,beastmastery,24,9,15
Lokiis,hyjal,862,hunter,beastmastery,12,9,3
Синглшот,blackscar,862,hunter,beastmastery,18,9,9
Mordhunterx,draenor,861,hunter,beastmastery,18,9,9
Shaznak,argent-dawn,858,hunter,beastmastery,18,9,9
Бруксиан,fordragon,857,hunter,beastmastery,19,9,10
Zúzú,hyjal,854,hunter,beastmastery,18,9,9
Arakton,drakthul,854,hunter,beastmastery,24,11,13
Greenstar,twisting-nether,846,hunter,beastmastery,27,10,17
Grokis,blackhand,834,hunter,beastmastery,55,25,30
Гримнар,borean-tundra,831,hunter,beastmastery,17,9,8
Enty,blackrock,830,hunter,beastmastery,14,10,4
Deathmarks,blackrock,830,hunter,beastmastery,29,9,20
Lissudarlin,stormreaver,829,hunter,beastmastery,48,22,26
Võnbødefeld,frostmourne,827,hunter,beastmastery,17,9,8
Happyrme,thrall,825,hunter,beastmastery,18,9,9
Пушкабомби,soulflayer,823,hunter,beastmastery,46,19,27
Anoroxx,arthas,815,hunter,beastmastery,17,9,8
Шаурмэ,gordunni,815,hunter,beastmastery,21,9,12
Vystrelil,drakthul,806,hunter,beastmastery,36,15,21
Colth,hyjal,799,hunter,beastmastery,29,9,20
Teacee,twisting-nether,773,hunter,beastmastery,20,9,11
Irükandji,chants-éternels,768,hunter,beastmastery,12,8,4
Ebobuss,tarren-mill,768,hunter,beastmastery,12,8,4
Трапча,soulflayer,768,hunter,beastmastery,12,8,4
Negz,eredar,768,hunter,beastmastery,12,8,4
Мираклдримз,gordunni,768,hunter,beastmastery,12,8,4
Weoneshot,ravencrest,768,hunter,beastmastery,12,8,4
Suffrebobbs,ravencrest,768,hunter,beastmastery,12,8,4
Mufdii,sylvanas,768,hunter,beastmastery,18,8,10
Pewpewstuff,draenor,768,hunter,beastmastery,18,8,10
Dispairge,antonidas,768,hunter,beastmastery,18,8,10
Pussirotta,stormreaver,768,hunter,beastmastery,18,8,10
Lambo,laughing-skull,768,hunter,beastmastery,18,8,10
Grynu,kazzak,768,hunter,beastmastery,24,8,16
Nelida,ragnaros,768,hunter,beastmastery,24,8,16
Lobo,kazzak,768,hunter,beastmastery,24,8,16
Oliene,twisting-nether,767,hunter,beastmastery,12,8,4
Хлопс,howling-fjord,767,hunter,beastmastery,12,8,4
Huntyadaun,blackrock,767,hunter,beastmastery,12,8,4
Kuljaa,ravencrest,767,hunter,beastmastery,12,8,4
Awoe,blackrock,767,hunter,beastmastery,12,8,4
Strélka,blackrock,767,hunter,beastmastery,18,8,10
Earnzie,outland,767,hunter,beastmastery,18,8,10
Drigs,blackrock,767,hunter,beastmastery,18,8,10
Лсныйпамп,howling-fjord,767,hunter,beastmastery,18,8,10
Gbureczka,burning-legion,767,hunter,beastmastery,18,8,10
Prodanhunts,frostmane,767,hunter,beastmastery,24,8,16
Vassiliadis,bronze-dragonflight,767,hunter,beastmastery,24,8,16
Шурикцаревич,galakrond,767,hunter,beastmastery,24,8,16
Darilli,wildhammer,766,hunter,beastmastery,13,8,5
Miracleh,tarren-mill,766,hunter,beastmastery,18,8,10
Rickh,ravencrest,765,hunter,beastmastery,12,8,4
Benbutton,antonidas,764,hunter,beastmastery,18,8,10
Фаталлити,grom,763,hunter,beastmastery,12,8,4
Blastarrow,the-maelstrom,763,hunter,beastmastery,30,8,22
Plong,argent-dawn,761,hunter,beastmastery,12,8,4
Floppybobby,burning-blade,759,hunter,beastmastery,18,8,10
Sushimän,kaelthas,751,hunter,beastmastery,12,8,4
Ремонтлицаа,gordunni,735,hunter,beastmastery,17,8,9
Altimor,blackmoore,719,hunter,beastmastery,17,8,9
Catmother,grim-batol,717,hunter,beastmastery,14,9,5
Быщь,gordunni,717,hunter,beastmastery,17,8,9
Sélenaé,hyjal,703,hunter,beastmastery,16,8,8
Feyoonx,blackrock,703,hunter,beastmastery,23,9,14
Huntbeard,aegwynn,695,hunter,beastmastery,22,8,14
Beorind,frostwolf,672,hunter,beastmastery,12,7,5
Dragosvis,arathor,672,hunter,beastmastery,12,7,5
Ufecläimbe,eredar,672,hunter,beastmastery,12,7,5
Riflur,stormscale,672,hunter,beastmastery,12,7,5
Utoast,ravencrest,672,hunter,beastmastery,12,7,5
Ulfrîc,exodar,672,hunter,beastmastery,12,7,5
Ledrox,ravencrest,672,hunter,beastmastery,12,7,5
Bigramy,sanguino,672,hunter,beastmastery,12,7,5
Fôx,frostmane,672,hunter,beastmastery,12,7,5
Stamzer,drakthul,672,hunter,beastmastery,12,7,5
Karuso,ravencrest,672,hunter,beastmastery,12,7,5
Marcsman,blackrock,672,hunter,beastmastery,12,7,5
Knokkelmann,outland,672,hunter,beastmastery,12,7,5
Gitanìlla,dun-modr,672,hunter,beastmastery,18,7,11
Valhnir,sanguino,672,hunter,beastmastery,18,7,11
Düivell,grim-batol,672,hunter,beastmastery,18,7,11
Boybiron,silvermoon,672,hunter,beastmastery,18,7,11
Амореселф,gordunni,672,hunter,beastmastery,18,7,11
Svolatch,blackrock,672,hunter,beastmastery,18,7,11
Дьярэ,gordunni,672,hunter,beastmastery,18,7,11
Летмимейт,howling-fjord,672,hunter,beastmastery,26,7,19
Ashryqt,ravencrest,671,hunter,beastmastery,12,7,5
Mazekhin,khaz-modan,671,hunter,beastmastery,12,7,5
Waidø,blackhand,671,hunter,beastmastery,12,7,5
Кежма,howling-fjord,671,hunter,beastmastery,12,7,5
Бэталол,gordunni,671,hunter,beastmastery,12,7,5
Jaydogg,lightbringer,671,hunter,beastmastery,12,7,5
Кулинарк,howling-fjord,671,hunter,beastmastery,12,7,5
Strade,argent-dawn,671,hunter,beastmastery,12,7,5
Raymear,kazzak,671,hunter,beastmastery,12,7,5
Neeske,sylvanas,671,hunter,beastmastery,18,7,11
Halgen,medivh,671,hunter,beastmastery,18,7,11
Orian,argent-dawn,671,hunter,beastmastery,18,7,11
Castbuny,drakthul,671,hunter,beastmastery,18,7,11
Basìcs,nemesis,670,hunter,beastmastery,12,7,5
Harpin,azuremyst,670,hunter,beastmastery,12,7,5
Pigoen,sporeggar,670,hunter,beastmastery,18,7,11
Kyliun,frostmane,669,hunter,beastmastery,18,7,11
Blainehunts,arathor,669,hunter,beastmastery,18,7,11
Poatan,outland,667,hunter,beastmastery,18,7,11
Rollei,uldum,666,hunter,beastmastery,12,7,5
Bornum,khaz-modan,662,hunter,beastmastery,25,7,18
Llamp,draenor,657,hunter,beastmastery,18,7,11
Notchan,stormscale,639,hunter,beastmastery,11,7,4
Снюсинка,gordunni,639,hunter,beastmastery,17,7,10
Oife,auchindoun,637,hunter,beastmastery,17,7,10
Adram,burning-legion,623,hunter,beastmastery,11,7,4
Samanou,kazzak,623,hunter,beastmastery,17,7,10
Mehtäsika,xavius,622,hunter,beastmastery,15,7,8
Yukina,frostmourne,602,hunter,beastmastery,16,7,9
Michaelvm,ravencrest,576,hunter,beastmastery,6,6,0
Rdwlf,draenor,576,hunter,beastmastery,12,6,6
Ausgefuchst,forscherliga,576,hunter,beastmastery,12,6,6
Fogknows,ravencrest,576,hunter,beastmastery,12,6,6
Шмыгахант,gordunni,576,hunter,beastmastery,12,6,6
Ishotharambe,doomhammer,576,hunter,beastmastery,12,6,6
Homesz,blackmoore,576,hunter,beastmastery,12,6,6
Dorkos,sanguino,576,hunter,beastmastery,12,6,6
Wodlenprince,draenor,576,hunter,beastmastery,12,6,6
Rifle,dun-morogh,576,hunter,beastmastery,12,6,6
Petitsui,zuljin,576,hunter,beastmastery,12,6,6
Showdope,drakthul,576,hunter,beastmastery,12,6,6
Xéraphine,mannoroth,576,hunter,beastmastery,12,6,6
Зеленыйиисус,gordunni,576,hunter,beastmastery,12,6,6
Magicnanø,nemesis,576,hunter,beastmastery,12,6,6
Toptìérgoðx,drakthul,576,hunter,beastmastery,12,6,6
Chïefhunt,twisting-nether,576,hunter,beastmastery,12,6,6
Солевойй,gordunni,576,hunter,beastmastery,12,6,6
Sithrom,blackmoore,576,hunter,beastmastery,12,6,6
Sallya,kazzak,576,hunter,beastmastery,12,6,6
Burbutsuluki,silvermoon,576,hunter,beastmastery,12,6,6
Platzpatron,eredar,576,hunter,beastmastery,12,6,6
Raegal,sanguino,576,hunter,beastmastery,12,6,6
Trapgodxx,archimonde,576,hunter,beastmastery,12,6,6
Funkalation,ravencrest,576,hunter,beastmastery,12,6,6
Cítyzens,drakthul,576,hunter,beastmastery,12,6,6
Акройя,gordunni,576,hunter,beastmastery,12,6,6
Paraskámu,twisting-nether,576,hunter,beastmastery,12,6,6
Vu,shattered-hand,576,hunter,beastmastery,12,6,6
Razoorine,blackrock,576,hunter,beastmastery,12,6,6
Logales,dragonblight,576,hunter,beastmastery,12,6,6
Jackjager,ravencrest,576,hunter,beastmastery,12,6,6
Bigdog,eredar,576,hunter,beastmastery,12,6,6
Iuyiuy,dalaran,576,hunter,beastmastery,12,6,6
Dtq,silvermoon,576,hunter,beastmastery,12,6,6
Nagu,antonidas,576,hunter,beastmastery,12,6,6
Saymqt,blackrock,576,hunter,beastmastery,15,7,8
Azrhu,ravencrest,576,hunter,beastmastery,18,6,12
Такувами,gordunni,576,hunter,beastmastery,18,6,12
Chúx,twisting-nether,576,hunter,beastmastery,18,6,12
Wetto,ravencrest,576,hunter,beastmastery,18,6,12
Coltan,nemesis,576,hunter,beastmastery,18,6,12
Realme,blackrock,576,hunter,beastmastery,18,6,12
Disyö,kazzak,576,hunter,beastmastery,18,6,12
Колякилшот,gordunni,576,hunter,beastmastery,18,6,12
Свадебная,gordunni,576,hunter,beastmastery,18,6,12
Fridion,argent-dawn,576,hunter,beastmastery,18,6,12
Матанал,gordunni,576,hunter,beastmastery,18,6,12
Vhalín,magtheridon,576,hunter,beastmastery,18,6,12
Krasavcik,shattrath,575,hunter,beastmastery,12,6,6
Puska,gilneas,575,hunter,beastmastery,12,6,6
Бирмингем,ashenvale,575,hunter,beastmastery,12,6,6
Eufumo,sanguino,575,hunter,beastmastery,12,6,6
Truedetectiv,aggramar,575,hunter,beastmastery,12,6,6
Абунай,soulflayer,575,hunter,beastmastery,12,6,6
Zäyk,zuljin,575,hunter,beastmastery,18,6,12
Дипшот,deathguard,575,hunter,beastmastery,18,6,12
Täpy,arathor,575,hunter,beastmastery,18,6,12
Nerdhark,hyjal,575,hunter,beastmastery,18,6,12
Dravara,blackmoore,574,hunter,beastmastery,12,6,6
Kruk,blackhand,574,hunter,beastmastery,12,6,6
Ulyash,ysondre,574,hunter,beastmastery,12,6,6
Kannon,twisting-nether,574,hunter,beastmastery,18,6,12
Atraxi,aegwynn,574,hunter,beastmastery,18,6,12
Penelopé,darkmoon-faire,573,hunter,beastmastery,12,6,6
Nixxay,antonidas,565,hunter,beastmastery,12,6,6
Dreemshoot,stormscale,542,hunter,beastmastery,11,6,5
Braatski,stormscale,526,hunter,beastmastery,18,7,11
Mirmona,stormscale,512,hunter,beastmastery,16,6,10
Мунмейстер,blackscar,480,hunter,beastmastery,6,5,1
Dogliz,stormscale,480,hunter,beastmastery,6,5,1
Подлыйстарик,gordunni,480,hunter,beastmastery,6,5,1
Tigerups,burning-legion,480,hunter,beastmastery,6,5,1
Hidethegun,draenor,480,hunter,beastmastery,6,5,1
Bebiyo,sanguino,480,hunter,beastmastery,6,5,1
Dåo,doomhammer,480,hunter,beastmastery,6,5,1
Nillaxy,blackmoore,480,hunter,beastmastery,6,5,1
Wellocérapt,confrérie-du-thorium,480,hunter,beastmastery,6,5,1
Solò,eredar,480,hunter,beastmastery,6,5,1
Jinxbomber,draenor,480,hunter,beastmastery,6,5,1
Glizzygobblr,kazzak,480,hunter,beastmastery,6,5,1
Survabuse,silvermoon,480,hunter,beastmastery,9,6,3
Valkrys,die-aldor,480,hunter,beastmastery,12,5,7
Vimd,archimonde,480,hunter,beastmastery,12,5,7
Tiendat,kazzak,480,hunter,beastmastery,12,5,7
Silvos,blackrock,480,hunter,beastmastery,12,5,7
Lolez,dun-modr,480,hunter,beastmastery,12,5,7
Ataxyz,draenor,480,hunter,beastmastery,12,5,7
Shieryu,archimonde,480,hunter,beastmastery,12,5,7
Mindgap,pozzo-delleternità,480,hunter,beastmastery,12,5,7
Rushgarroth,ravencrest,480,hunter,beastmastery,12,5,7
Yamadorî,blackrock,480,hunter,beastmastery,12,5,7
Bubbahubba,ragnaros,480,hunter,beastmastery,12,5,7
Dyve,antonidas,480,hunter,beastmastery,12,5,7
Vargar,arygos,480,hunter,beastmastery,12,5,7
Квит,blackscar,480,hunter,beastmastery,12,5,7
Джеймсфранко,blackscar,480,hunter,beastmastery,12,5,7
Dràcula,tarren-mill,480,hunter,beastmastery,12,5,7
Géeked,ravencrest,480,hunter,beastmastery,12,5,7
Китас,soulflayer,480,hunter,beastmastery,12,5,7
Naposin,ragnaros,480,hunter,beastmastery,12,5,7
Pilpetra,tarren-mill,480,hunter,beastmastery,12,5,7
Tizzlbang,ragnaros,480,hunter,beastmastery,12,5,7
Hanuong,ragnaros,480,hunter,beastmastery,12,5,7
Lis,gorgonnash,480,hunter,beastmastery,12,5,7
Grrizzly,kazzak,480,hunter,beastmastery,12,5,7
Expiraa,twisting-nether,480,hunter,beastmastery,12,5,7
Келкузд,howling-fjord,480,hunter,beastmastery,12,5,7
Khort,twisting-nether,480,hunter,beastmastery,12,5,7
Halessia,ravencrest,480,hunter,beastmastery,12,5,7
Elvenian,twisting-nether,480,hunter,beastmastery,12,5,7
Câonimâ,twisting-nether,480,hunter,beastmastery,12,5,7
Jawox,antonidas,480,hunter,beastmastery,12,5,7
Рафлекс,eversong,480,hunter,beastmastery,12,5,7
Bubby,burning-legion,480,hunter,beastmastery,16,6,10
Latschodives,malorne,480,hunter,beastmastery,15,5,10
Bluefluclue,draenor,480,hunter,beastmastery,16,5,11
Setyouintrap,ravencrest,480,hunter,beastmastery,18,5,13
Chrishyh,blackrock,480,hunter,beastmastery,18,5,13
Laerya,les-clairvoyants,479,hunter,beastmastery,12,5,7
Boompuf,draenor,479,hunter,beastmastery,12,5,7
Droubidi,garona,479,hunter,beastmastery,12,5,7
Ivanrockstar,draenor,479,hunter,beastmastery,12,5,7
Killzo,sylvanas,479,hunter,beastmastery,12,5,7
Sàclak,ysondre,479,hunter,beastmastery,12,5,7
Бодрыйсэм,soulflayer,477,hunter,beastmastery,12,5,7
Marlaska,exodar,472,hunter,beastmastery,12,5,7
Momohenní,archimonde,448,hunter,beastmastery,10,5,5
Bellecoq,arathi,447,hunter,beastmastery,11,5,6
Såvëâmäzøñíà,stormscale,431,hunter,beastmastery,11,5,6
Remiss,sanguino,425,hunter,beastmastery,14,6,8
Topbow,talnivarr,415,hunter,beastmastery,10,5,5
Fizè,blackmoore,415,hunter,beastmastery,11,5,6
Srvol,dun-modr,384,hunter,beastmastery,6,4,2
Illaice,antonidas,384,hunter,beastmastery,6,4,2
Chindaliña,zuljin,384,hunter,beastmastery,6,4,2
Эвилтар,soulflayer,384,hunter,beastmastery,6,4,2
Zpy,blackmoore,384,hunter,beastmastery,6,4,2
Zanéy,ravencrest,384,hunter,beastmastery,6,4,2
Garratha,burning-legion,384,hunter,beastmastery,6,4,2
Arrowman,burning-legion,384,hunter,beastmastery,6,4,2
Kareltje,stormscale,384,hunter,beastmastery,6,4,2
Pufyrella,kilrogg,384,hunter,beastmastery,6,4,2
Sejkxi,malganis,384,hunter,beastmastery,6,4,2
Straikkeri,draenor,384,hunter,beastmastery,6,4,2
Flytomars,ravencrest,384,hunter,beastmastery,6,4,2
Патапум,deathguard,384,hunter,beastmastery,6,4,2
Nulldmgmaker,malganis,384,hunter,beastmastery,6,4,2
Nith,ungoro,384,hunter,beastmastery,6,4,2
Spergmeister,argent-dawn,384,hunter,beastmastery,6,4,2
Machinedream,sylvanas,384,hunter,beastmastery,6,4,2
Robbingyou,tarren-mill,384,hunter,beastmastery,6,4,2
Nocturr,ragnaros,384,hunter,beastmastery,6,4,2
Rïm,haomarush,384,hunter,beastmastery,6,4,2
Pareia,blackrock,384,hunter,beastmastery,6,4,2
Azzazeal,drakthul,384,hunter,beastmastery,6,4,2
Xndr,sanguino,384,hunter,beastmastery,6,4,2
Разплюханка,howling-fjord,384,hunter,beastmastery,6,4,2
Вуйчеч,howling-fjord,384,hunter,beastmastery,6,4,2
Нью,soulflayer,384,hunter,beastmastery,6,4,2
Liquidhunter,quelthalas,384,hunter,beastmastery,6,4,2
Thursty,twisting-nether,384,hunter,beastmastery,6,4,2
Khregan,aerie-peak,384,hunter,beastmastery,6,4,2
Drukan,hyjal,384,hunter,beastmastery,6,4,2
Nomorepain,outland,384,hunter,beastmastery,6,4,2
Hask,pozzo-delleternità,384,hunter,beastmastery,6,4,2
Ilovekatsu,archimonde,384,hunter,beastmastery,6,4,2
Dregor,nemesis,384,hunter,beastmastery,6,4,2
Кайсго,gordunni,384,hunter,beastmastery,6,4,2
Alexdi,kazzak,384,hunter,beastmastery,6,4,2
Lultrap,nemesis,384,hunter,beastmastery,6,4,2
Ahotnik,aegwynn,384,hunter,beastmastery,6,4,2
Bøwjøb,arthas,384,hunter,beastmastery,6,4,2
Jaxxoo,outland,384,hunter,beastmastery,6,4,2
Xiviora,archimonde,384,hunter,beastmastery,6,4,2
Mestar,outland,384,hunter,beastmastery,6,4,2
Bøøya,aegwynn,384,hunter,beastmastery,6,4,2
Berkobaggins,twisting-nether,384,hunter,beastmastery,12,4,8
Sharpeneye,ragnaros,384,hunter,beastmastery,12,4,8
Tøixøna,tyrande,384,hunter,beastmastery,12,4,8
Thérón,ravencrest,384,hunter,beastmastery,12,4,8
Kreiden,twisting-nether,384,hunter,beastmastery,12,4,8
Saiko,kazzak,384,hunter,beastmastery,12,4,8
Лузановка,gordunni,384,hunter,beastmastery,12,4,8
Øï,outland,384,hunter,beastmastery,12,4,8
Aléxy,sanguino,384,hunter,beastmastery,12,4,8
Horxxa,kul-tiras,384,hunter,beastmastery,12,4,8
Zippyzen,twisting-nether,384,hunter,beastmastery,12,4,8
Córelly,outland,384,hunter,beastmastery,12,4,8
Nßatrapper,outland,384,hunter,beastmastery,12,4,8
Hollyz,auchindoun,384,hunter,beastmastery,12,4,8
Catman,stormreaver,384,hunter,beastmastery,12,4,8
Pergola,spinebreaker,384,hunter,beastmastery,12,4,8
Nîco,nathrezim,384,hunter,beastmastery,12,4,8
Frencharena,the-venture-co,384,hunter,beastmastery,12,4,8
Neocb,ravencrest,384,hunter,beastmastery,12,4,8
Valomeere,tarren-mill,384,hunter,beastmastery,12,4,8
Вейзу,ashenvale,384,hunter,beastmastery,12,4,8
Блудитролль,soulflayer,384,hunter,beastmastery,12,4,8
Amigoss,argent-dawn,384,hunter,beastmastery,12,4,8
Cêleste,kaelthas,384,hunter,beastmastery,12,4,8
Талигар,razuvious,384,hunter,beastmastery,12,4,8
Tervueren,burning-blade,384,hunter,beastmastery,18,4,14
Amdonesia,ravencrest,384,hunter,beastmastery,18,4,14
Bemtistaru,draenor,384,hunter,beastmastery,18,4,14
Xscaper,twilights-hammer,383,hunter,beastmastery,6,4,2
Delazi,proudmoore,383,hunter,beastmastery,12,4,8
Towu,archimonde,382,hunter,beastmastery,12,4,8
Beerox,ysondre,382,hunter,beastmastery,12,4,8
Сяову,gordunni,381,hunter,beastmastery,18,4,14
Haleth,uldum,319,hunter,beastmastery,11,4,7
Enthur,sylvanas,288,hunter,beastmastery,6,3,3
Hallem,karazhan,288,hunter,beastmastery,6,3,3
Рофшор,gordunni,288,hunter,beastmastery,6,3,3
Midist,stormscale,288,hunter,beastmastery,6,3,3
Загзигзаг,soulflayer,288,hunter,beastmastery,6,3,3
Демела,gordunni,288,hunter,beastmastery,6,3,3
Kukenisluken,stormscale,288,hunter,beastmastery,6,3,3
Hattorisama,ghostlands,288,hunter,beastmastery,6,3,3
Taurïel,stormscale,288,hunter,beastmastery,6,3,3
Nosfuratu,stormscale,288,hunter,beastmastery,6,3,3
Оути,azuregos,288,hunter,beastmastery,6,3,3
Джэромо,gordunni,288,hunter,beastmastery,6,3,3
Oldrocker,sylvanas,288,hunter,beastmastery,6,3,3
Живучийорех,gordunni,288,hunter,beastmastery,6,3,3
Metalbaci,sylvanas,288,hunter,beastmastery,6,3,3
Lioneli,sylvanas,288,hunter,beastmastery,6,3,3
Doubleoseven,frostmane,288,hunter,beastmastery,6,3,3
Оркос,deathweaver,288,hunter,beastmastery,6,3,3
Микихаса,galakrond,288,hunter,beastmastery,6,3,3
Jins,illidan,288,hunter,beastmastery,6,3,3
Ekz,twisting-nether,288,hunter,beastmastery,6,3,3
Thekev,ravencrest,288,hunter,beastmastery,6,3,3
Sebikh,ravencrest,288,hunter,beastmastery,6,3,3
Zoophobiaqt,silvermoon,288,hunter,beastmastery,6,3,3
Колтрэйнборз,blackscar,288,hunter,beastmastery,6,3,3
Cor,ravencrest,288,hunter,beastmastery,6,3,3
Yssup,frostmane,288,hunter,beastmastery,6,3,3
Ozunâ,blackmoore,288,hunter,beastmastery,6,3,3
Fedya,kazzak,288,hunter,beastmastery,6,3,3
Дзэнмашина,booty-bay,288,hunter,beastmastery,6,3,3
Sakaryali,silvermoon,288,hunter,beastmastery,6,3,3
Axran,ravencrest,288,hunter,beastmastery,6,3,3
Будкусломаю,grom,288,hunter,beastmastery,6,3,3
Скукота,grom,288,hunter,beastmastery,6,3,3
Chasseeur,archimonde,288,hunter,beastmastery,6,3,3
Милфхантерхе,blackscar,288,hunter,beastmastery,6,3,3
Kondirox,twisting-nether,288,hunter,beastmastery,6,3,3
Kronkh,nemesis,288,hunter,beastmastery,6,3,3
Sauce,alonsus,288,hunter,beastmastery,6,3,3
Zantorious,ravencrest,288,hunter,beastmastery,6,3,3
Katzchen,burning-legion,288,hunter,beastmastery,6,3,3
Kragán,silvermoon,288,hunter,beastmastery,6,3,3
Djtrapyasis,blackmoore,288,hunter,beastmastery,6,3,3
Iliíilíiílíl,outland,288,hunter,beastmastery,6,3,3
Artze,outland,288,hunter,beastmastery,6,3,3
Bugspitz,outland,288,hunter,beastmastery,6,3,3
Niedzwiedzor,silvermoon,288,hunter,beastmastery,6,3,3
Anhur,blackmoore,288,hunter,beastmastery,6,3,3
Kxx,kazzak,288,hunter,beastmastery,6,3,3
Hunterstein,archimonde,288,hunter,beastmastery,6,3,3
Mobshot,twisting-nether,288,hunter,beastmastery,6,3,3
Shedzargo,twisting-nether,288,hunter,beastmastery,6,3,3
Vescar,argent-dawn,288,hunter,beastmastery,6,3,3
Ipad,cthun,288,hunter,beastmastery,6,3,3
Appollo,magtheridon,288,hunter,beastmastery,6,3,3
Abonah,khaz-modan,288,hunter,beastmastery,6,3,3
Thebigboom,outland,288,hunter,beastmastery,6,3,3
Blazeblue,hyjal,288,hunter,beastmastery,6,3,3
Beefchops,draenor,288,hunter,beastmastery,6,3,3
Sillychilly,frostwolf,288,hunter,beastmastery,6,3,3
Scräppÿ,kazzak,288,hunter,beastmastery,6,3,3
Blmlooter,stormreaver,288,hunter,beastmastery,6,3,3
Cryptomars,twisting-nether,288,hunter,beastmastery,6,3,3
Bòw,antonidas,288,hunter,beastmastery,6,3,3
Yümekø,khaz-modan,288,hunter,beastmastery,6,3,3
Traenuss,azuremyst,288,hunter,beastmastery,6,3,3
Lunaunii,argent-dawn,288,hunter,beastmastery,6,3,3
Доррети,howling-fjord,288,hunter,beastmastery,6,3,3
Tedohunter,ragnaros,288,hunter,beastmastery,6,3,3
Razuye,nerathor,288,hunter,beastmastery,6,3,3
Avatarofwoe,blackmoore,288,hunter,beastmastery,6,3,3
Beletor,medivh,288,hunter,beastmastery,6,3,3
Оксанчек,howling-fjord,288,hunter,beastmastery,6,3,3
Hunterlolz,tarren-mill,288,hunter,beastmastery,6,3,3
Flugsmälla,kazzak,288,hunter,beastmastery,6,3,3
Хантероо,gordunni,288,hunter,beastmastery,8,3,5
Riik,ragnaros,288,hunter,beastmastery,12,3,9
Drakess,daggerspine,288,hunter,beastmastery,12,3,9
Coôkie,ysondre,288,hunter,beastmastery,12,3,9
Дафирия,deathguard,288,hunter,beastmastery,12,3,9
Headhunterzz,dun-modr,288,hunter,beastmastery,12,3,9
Nerøz,ravencrest,288,hunter,beastmastery,12,3,9
Craná,blackrock,288,hunter,beastmastery,12,3,9
Stuckstepbro,silvermoon,288,hunter,beastmastery,12,3,9
Spakster,blackrock,288,hunter,beastmastery,12,3,9
Jamesbownd,ravencrest,288,hunter,beastmastery,12,3,9
Demónhunter,frostmane,288,hunter,beastmastery,12,3,9
Nelerias,defias-brotherhood,288,hunter,beastmastery,12,3,9
Akù,magtheridon,288,hunter,beastmastery,12,3,9
Orgasmatronn,stormscale,288,hunter,beastmastery,12,3,9
Mogumogu,blackhand,288,hunter,beastmastery,12,3,9
Хансбург,howling-fjord,288,hunter,beastmastery,12,3,9
Xoarqt,aegwynn,288,hunter,beastmastery,12,3,9
Cliff,kiljaeden,288,hunter,beastmastery,18,3,15
Neuwi,stormreaver,287,hunter,beastmastery,6,3,3
Vachekiki,archimonde,287,hunter,beastmastery,6,3,3
Asca,eldrethalas,287,hunter,beastmastery,12,3,9
Oatmeal,dun-morogh,287,hunter,beastmastery,12,3,9
Lightrandom,kazzak,269,hunter,beastmastery,11,3,8
Sarblade,bronze-dragonflight,255,hunter,beastmastery,11,3,8
Кулерквест,soulflayer,240,hunter,beastmastery,9,3,6
Barzti,thrall,239,hunter,beastmastery,5,3,2
Куфачка,soulflayer,239,hunter,beastmastery,5,3,2
Grufflin,bronzebeard,239,hunter,beastmastery,5,3,2
Bigbababotan,blackrock,234,hunter,beastmastery,9,4,5
Бей,gordunni,223,hunter,beastmastery,8,3,5
Musraah,zuljin,192,hunter,beastmastery,5,3,2
Lännennopein,outland,192,hunter,beastmastery,11,4,7
Lusifa,antonidas,192,hunter,beastmastery,6,2,4
Mârked,argent-dawn,192,hunter,beastmastery,6,2,4
Dentaar,draenor,192,hunter,beastmastery,6,2,4
Mdmalol,malganis,192,hunter,beastmastery,6,2,4
Comegetme,auchindoun,192,hunter,beastmastery,6,2,4
Lísy,hyjal,192,hunter,beastmastery,6,2,4
Privelle,argent-dawn,192,hunter,beastmastery,6,2,4
Whatifany,tarren-mill,192,hunter,beastmastery,6,2,4
Ecthelione,the-venture-co,192,hunter,beastmastery,6,2,4
Ridbàck,archimonde,192,hunter,beastmastery,6,2,4
Серцебиение,soulflayer,192,hunter,beastmastery,6,2,4
Травок,gordunni,192,hunter,beastmastery,6,2,4
Tillhunt,kargath,192,hunter,beastmastery,6,2,4
Therakal,culte-de-la-rive-noire,192,hunter,beastmastery,6,2,4
Jarran,karazhan,192,hunter,beastmastery,6,2,4
Holytrapqt,aegwynn,192,hunter,beastmastery,6,2,4
Jayyke,frostmane,192,hunter,beastmastery,6,2,4
Дэлмор,greymane,192,hunter,beastmastery,6,2,4
Gunmeister,bronzebeard,192,hunter,beastmastery,6,2,4
Bernhardoder,blackhand,192,hunter,beastmastery,6,2,4
Scatterinc,antonidas,192,hunter,beastmastery,6,2,4
Ренектон,soulflayer,192,hunter,beastmastery,6,2,4
Naid,lordaeron,192,hunter,beastmastery,6,2,4
Khatia,blackrock,192,hunter,beastmastery,6,2,4
Nikzeubii,archimonde,192,hunter,beastmastery,6,2,4
Luuszapfae,aegwynn,192,hunter,beastmastery,6,2,4
Ansâvage,ravencrest,192,hunter,beastmastery,6,2,4
Arykes,drakthul,192,hunter,beastmastery,6,2,4
Phyllobates,blackrock,192,hunter,beastmastery,6,2,4
Ðoxz,blackrock,192,hunter,beastmastery,6,2,4
Legolex,burning-blade,192,hunter,beastmastery,6,2,4
Nómarak,drakthul,192,hunter,beastmastery,6,2,4
Dragoki,blackmoore,192,hunter,beastmastery,6,2,4
Hitray,stormscale,192,hunter,beastmastery,6,2,4
Wodhunterjr,ravencrest,192,hunter,beastmastery,6,2,4
Marzenielas,silvermoon,192,hunter,beastmastery,6,2,4
Crasharrow,stormscale,192,hunter,beastmastery,6,2,4
Vilopez,arthas,192,hunter,beastmastery,6,2,4
Dahunter,blackmoore,192,hunter,beastmastery,6,2,4
Aughtism,turalyon,192,hunter,beastmastery,6,2,4
Willzz,ravencrest,192,hunter,beastmastery,6,2,4
Marryme,blackhand,192,hunter,beastmastery,6,2,4
Silencxz,aegwynn,192,hunter,beastmastery,6,2,4
Droz,blackmoore,192,hunter,beastmastery,6,2,4
Sarbacanes,hyjal,192,hunter,beastmastery,6,2,4
Инкризшот,gordunni,192,hunter,beastmastery,6,2,4
Zulldek,sanguino,192,hunter,beastmastery,6,2,4
Deskö,shendralar,192,hunter,beastmastery,6,2,4
Гернриета,gordunni,192,hunter,beastmastery,6,2,4
Soen,zuljin,192,hunter,beastmastery,6,2,4
Sourxete,silvermoon,192,hunter,beastmastery,6,2,4
Фэйсконтроль,azuregos,192,hunter,beastmastery,6,2,4
Zynga,sylvanas,192,hunter,beastmastery,6,2,4
Zappikhunter,silvermoon,192,hunter,beastmastery,6,2,4
Thecorruptor,skullcrusher,192,hunter,beastmastery,6,2,4
Bówyóurfácé,outland,192,hunter,beastmastery,6,2,4
Lurigalinda,twisting-nether,192,hunter,beastmastery,6,2,4
Тофуитер,howling-fjord,192,hunter,beastmastery,6,2,4
Samodiva,twisting-nether,192,hunter,beastmastery,6,2,4
Lascazador,dun-modr,192,hunter,beastmastery,6,2,4
Feedbackloop,silvermoon,192,hunter,beastmastery,6,2,4
As,kazzak,192,hunter,beastmastery,6,2,4
Raztreadör,dun-modr,192,hunter,beastmastery,6,2,4
Jambomambo,twisting-nether,192,hunter,beastmastery,6,2,4
Azahunt,kazzak,192,hunter,beastmastery,6,2,4
Doraxa,sanguino,192,hunter,beastmastery,6,2,4
Wildwingsebb,nazjatar,192,hunter,beastmastery,6,2,4
Dohter,kazzak,192,hunter,beastmastery,6,2,4
Siegbald,ragnaros,192,hunter,beastmastery,6,2,4
Ефрейя,gordunni,192,hunter,beastmastery,6,2,4
Tràpz,archimonde,192,hunter,beastmastery,8,2,6
Куджикс,soulflayer,192,hunter,beastmastery,19,4,15
Calesthas,tarren-mill,192,hunter,beastmastery,12,2,10
Talmïr,archimonde,192,hunter,beastmastery,12,2,10
Bláckheart,doomhammer,192,hunter,beastmastery,12,2,10
Кронн,howling-fjord,192,hunter,beastmastery,12,2,10
Biorson,silvermoon,192,hunter,beastmastery,12,2,10
Elja,laughing-skull,192,hunter,beastmastery,12,2,10
Örrn,ragnaros,192,hunter,beastmastery,12,2,10
Rheyl,dun-morogh,192,hunter,beastmastery,12,2,10
Slayman,kazzak,192,hunter,beastmastery,18,2,16
Traknard,confrérie-du-thorium,191,hunter,beastmastery,6,2,4
Charlet,archimonde,191,hunter,beastmastery,6,2,4
Spycke,dalaran,191,hunter,beastmastery,6,2,4
Bynen,tarren-mill,180,hunter,beastmastery,18,5,13
Rakmo,blackmoore,159,hunter,beastmastery,5,2,3
Phinox,sanguino,159,hunter,beastmastery,5,2,3
Allcollapse,outland,144,hunter,beastmastery,3,3,0
Åånei,twisting-nether,144,hunter,beastmastery,9,2,7
Elnazar,archimonde,128,hunter,beastmastery,4,2,2
Deathøfrats,ravencrest,128,hunter,beastmastery,4,2,2
Runescimmy,twisting-nether,96,hunter,beastmastery,6,1,5
Zogzøg,draenor,96,hunter,beastmastery,6,1,5
Sayn,la-croisade-écarlate,96,hunter,beastmastery,6,1,5
Сочнаятурель,howling-fjord,96,hunter,beastmastery,6,1,5
Anun,magtheridon,96,hunter,beastmastery,6,1,5
Huntarbeît,eredar,96,hunter,beastmastery,6,1,5
Jozsiur,ragnaros,96,hunter,beastmastery,6,1,5
Gramzy,blackmoore,96,hunter,beastmastery,6,1,5
Imahuntard,frostmane,96,hunter,beastmastery,6,1,5
Кертион,howling-fjord,96,hunter,beastmastery,6,1,5
Dasmusdrückn,antonidas,96,hunter,beastmastery,6,1,5
Bloodpanter,ragnaros,96,hunter,beastmastery,6,1,5
Beastmaster,ragnaros,96,hunter,beastmastery,6,1,5
Traplørdx,sylvanas,96,hunter,beastmastery,6,1,5
Chambiann,tarren-mill,96,hunter,beastmastery,6,1,5
Дочьпескова,gordunni,96,hunter,beastmastery,6,1,5
Duïvell,grim-batol,96,hunter,beastmastery,6,1,5
Bloodking,madmortem,96,hunter,beastmastery,6,1,5
Hõth,kazzak,96,hunter,beastmastery,6,1,5
Фитьфитий,howling-fjord,96,hunter,beastmastery,6,1,5
Trollohunt,twisting-nether,96,hunter,beastmastery,6,1,5
Zergst,nathrezim,96,hunter,beastmastery,6,1,5
Hashaya,hyjal,96,hunter,beastmastery,6,1,5
Jägerjokke,blackrock,96,hunter,beastmastery,6,1,5
Táráh,proudmoore,96,hunter,beastmastery,6,1,5
Betarayjinx,kazzak,96,hunter,beastmastery,6,1,5
Wórldz,dun-modr,96,hunter,beastmastery,6,1,5
Евилик,gordunni,96,hunter,beastmastery,6,1,5
Bobtroll,twisting-nether,96,hunter,beastmastery,6,1,5
Hntudwn,azshara,96,hunter,beastmastery,6,1,5
Ichbringbier,blackrock,96,hunter,beastmastery,6,1,5
ßèástymãç,ravencrest,96,hunter,beastmastery,6,1,5
Найстити,deathguard,96,hunter,beastmastery,6,1,5
Stingsz,chogall,96,hunter,beastmastery,6,1,5
Douglas,die-silberne-hand,96,hunter,beastmastery,6,1,5
Mævis,ravencrest,96,hunter,beastmastery,6,1,5
Weafster,outland,96,hunter,beastmastery,6,1,5
Raggeh,frostwhisper,96,hunter,beastmastery,6,1,5
Pjållistani,ravencrest,96,hunter,beastmastery,6,1,5
Nomorex,frostwhisper,96,hunter,beastmastery,6,1,5
Traptard,blackrock,96,hunter,beastmastery,6,1,5
Hairyplottér,kazzak,96,hunter,beastmastery,6,1,5
Achiles,die-todeskrallen,96,hunter,beastmastery,6,1,5
Darkray,dalaran,96,hunter,beastmastery,6,1,5
Grigur,dalaran,96,hunter,beastmastery,6,1,5
Zurzok,blackrock,96,hunter,beastmastery,6,1,5
Буреклык,gordunni,96,hunter,beastmastery,6,1,5
Schräubchen,antonidas,96,hunter,beastmastery,6,1,5
Tsyapka,tarren-mill,96,hunter,beastmastery,12,1,11
Thóorin,ravencrest,96,hunter,beastmastery,12,1,11
Críted,blackmoore,96,hunter,beastmastery,12,1,11
Shoothim,destromath,95,hunter,beastmastery,3,2,1
Yahamenistos,ysondre,64,hunter,beastmastery,4,1,3
Youngjinh,ravencrest,64,hunter,beastmastery,4,1,3
Voldtzeig,dentarg,42,hunter,beastmastery,13,4,9
Liscie,silvermoon,42,hunter,beastmastery,14,2,12
Tunhaa,arthas,16,hunter,beastmastery,1,1,0
Gwaan,outland,9,hunter,beastmastery,6,2,4
Aleç,ravencrest,1932,mage,arcane,60,31,29
Bebenm,archimonde,1881,mage,arcane,69,34,35
Choll,stormscale,1866,mage,arcane,30,20,10
Нефростмаг,gordunni,1843,mage,arcane,78,43,35
Wàneís,ravencrest,1840,mage,arcane,72,37,35
Obbjob,ravencrest,1748,mage,arcane,60,30,30
Raíku,ravencrest,1723,mage,arcane,30,18,12
Wracrz,argent-dawn,1718,mage,arcane,54,33,21
Непутевыймаг,gordunni,1715,mage,arcane,24,23,1
Mercem,stormscale,1711,mage,arcane,30,21,9
Castorcato,kazzak,1691,mage,arcane,36,24,12
Shirrunn,the-maelstrom,1687,mage,arcane,38,19,19
Sallesauruus,outland,1651,mage,arcane,54,26,28
Dardíe,ravencrest,1645,mage,arcane,30,19,11
Шттрвблнкт,soulflayer,1644,mage,arcane,83,41,42
Radagulf,outland,1631,mage,arcane,42,20,22
Sérc,ravencrest,1626,mage,arcane,30,17,13
Orkamor,sylvanas,1622,mage,arcane,42,17,25
Alustrasz,skullcrusher,1612,mage,arcane,66,37,29
Манкай,fordragon,1604,mage,arcane,105,61,44
Nakamura,outland,1575,mage,arcane,232,117,115
Ekron,sanguino,1557,mage,arcane,116,61,55
Persi,dentarg,1554,mage,arcane,42,18,24
Absie,tarren-mill,1516,mage,arcane,36,26,10
Раканчик,gordunni,1503,mage,arcane,56,30,26
Ogarcanefist,outland,1424,mage,arcane,69,35,34
Tnhigh,blackrock,1407,mage,arcane,39,24,15
Barspin,lightnings-blade,1396,mage,arcane,54,31,23
Lusionator,defias-brotherhood,1394,mage,arcane,54,31,23
Фоулли,howling-fjord,1390,mage,arcane,23,15,8
Lemaroxd,draenor,1370,mage,arcane,23,15,8
Jhawkwizard,draenor,1369,mage,arcane,97,51,46
Манаманна,gordunni,1362,mage,arcane,105,54,51
Ðøæø,twisting-nether,1346,mage,arcane,93,46,47
Diper,burning-legion,1328,mage,arcane,36,15,21
Nefrendel,kazzak,1299,mage,arcane,68,33,35
Akâri,silvermoon,1294,mage,arcane,30,18,12
Pradapimp,ravencrest,1286,mage,arcane,32,15,17
Валбериса,deepholm,1270,mage,arcane,54,35,19
Xiaomofashi,quelthalas,1252,mage,arcane,42,22,20
Meolchum,outland,1237,mage,arcane,45,22,23
Tokyodes,twisting-nether,1237,mage,arcane,59,25,34
Nécrømage,confrérie-du-thorium,1235,mage,arcane,18,13,5
Magikere,tarren-mill,1230,mage,arcane,36,23,13
Rezre,stormscale,1212,mage,arcane,54,28,26
Sszz,ravencrest,1201,mage,arcane,72,41,31
Ozdewish,hyjal,1198,mage,arcane,85,39,46
Канеллис,howling-fjord,1197,mage,arcane,37,14,23
Magijoana,silvermoon,1182,mage,arcane,20,13,7
Cubis,archimonde,1152,mage,arcane,24,12,12
Tiqma,sylvanas,1151,mage,arcane,24,12,12
Ecovation,tarren-mill,1146,mage,arcane,24,12,12
Demizboub,archimonde,1114,mage,arcane,157,78,79
Hardways,archimonde,1091,mage,arcane,114,47,67
Макотшельник,gordunni,1056,mage,arcane,12,11,1
Léa,rashgarroth,1042,mage,arcane,24,11,13
Aleteia,stormscale,960,mage,arcane,18,10,8
Проблембойх,gordunni,960,mage,arcane,18,10,8
Portal,scarshield-legion,956,mage,arcane,18,10,8
Иссэя,borean-tundra,954,mage,arcane,37,21,16
Вадимодесса,soulflayer,904,mage,arcane,37,17,20
Scaless,stormscale,891,mage,arcane,22,10,12
Fuhry,tarren-mill,864,mage,arcane,12,9,3
Puni,emerald-dream,864,mage,arcane,12,9,3
Dárdie,ravencrest,864,mage,arcane,18,9,9
Dohnnyjepp,gorgonnash,864,mage,arcane,23,10,13
Дырявка,galakrond,859,mage,arcane,24,9,15
Kobrass,spinebreaker,855,mage,arcane,30,9,21
Frostdeath,medivh,851,mage,arcane,18,9,9
Waterhagx,tarren-mill,799,mage,arcane,11,9,2
Bullegong,archimonde,768,mage,arcane,12,8,4
Zimbabweborc,burning-legion,768,mage,arcane,12,8,4
Nïo,ravencrest,767,mage,arcane,18,8,10
Zehnvonzehn,antonidas,767,mage,arcane,18,8,10
Aeghis,darkspear,765,mage,arcane,18,8,10
Elor,eredar,765,mage,arcane,21,9,12
Doryy,silvermoon,672,mage,arcane,12,7,5
Яшабурстх,blackscar,672,mage,arcane,12,7,5
Nötmârtònxø,ragnaros,671,mage,arcane,12,7,5
Димаскунфу,howling-fjord,640,mage,arcane,22,7,15
Mageé,argent-dawn,621,mage,arcane,17,7,10
Arkeus,turalyon,605,mage,arcane,11,7,4
Pyllymake,kazzak,576,mage,arcane,12,6,6
Thorstäin,ragnaros,575,mage,arcane,12,6,6
Spicymash,chogall,575,mage,arcane,12,6,6
Freshforces,ragnaros,512,mage,arcane,10,6,4
Banjó,twilights-hammer,480,mage,arcane,6,5,1
Tamtheone,frostwhisper,480,mage,arcane,6,5,1
Alarak,drakthul,480,mage,arcane,12,5,7
Soulraider,tarren-mill,480,mage,arcane,12,5,7
Barryscótt,stormscale,480,mage,arcane,12,5,7
Astrryy,burning-legion,480,mage,arcane,12,5,7
Pwntt,terenas,480,mage,arcane,12,5,7
Ледянойкекс,gordunni,480,mage,arcane,18,5,13
Mðj,kazzak,480,mage,arcane,18,5,13
Ewina,twisting-nether,479,mage,arcane,6,5,1
Mortlol,chamber-of-aspects,479,mage,arcane,12,5,7
Gorn,ravencrest,478,mage,arcane,12,5,7
Зухвала,howling-fjord,440,mage,arcane,11,5,6
Ímnotback,outland,431,mage,arcane,11,5,6
Hexmath,tarren-mill,384,mage,arcane,6,4,2
Jengele,argent-dawn,384,mage,arcane,6,4,2
Rizzlybear,outland,384,mage,arcane,6,4,2
Fadi,anachronos,384,mage,arcane,6,4,2
Apollohouse,ravencrest,384,mage,arcane,6,4,2
Yunox,stormscale,384,mage,arcane,6,4,2
Мглавечная,azuregos,384,mage,arcane,6,4,2
Uní,emerald-dream,384,mage,arcane,12,4,8
Нормалмап,soulflayer,384,mage,arcane,18,4,14
Fôôxy,aegwynn,383,mage,arcane,6,4,2
Дантрий,gordunni,382,mage,arcane,6,4,2
Ovrpwrdxd,kazzak,288,mage,arcane,6,3,3
Сизаам,howling-fjord,288,mage,arcane,6,3,3
Choise,stormscale,288,mage,arcane,6,3,3
Sukalamink,alonsus,288,mage,arcane,6,3,3
Gagaj,ravencrest,288,mage,arcane,6,3,3
Kyrn,zuljin,288,mage,arcane,6,3,3
Æskalatîøn,blackmoore,288,mage,arcane,6,3,3
Даанрен,galakrond,288,mage,arcane,6,3,3
Aristarco,outland,288,mage,arcane,6,3,3
Khoshgele,draenor,288,mage,arcane,6,3,3
Auchenax,argent-dawn,288,mage,arcane,6,3,3
Brokenlegman,defias-brotherhood,288,mage,arcane,6,3,3
Serctheone,ravencrest,288,mage,arcane,9,4,5
Samirra,stormscale,288,mage,arcane,12,3,9
Хблэйз,howling-fjord,288,mage,arcane,12,3,9
Kudakto,ravencrest,288,mage,arcane,12,3,9
Malshash,outland,287,mage,arcane,6,3,3
Кронни,razuvious,287,mage,arcane,6,3,3
Arcadua,sanguino,287,mage,arcane,6,3,3
Kasus,sporeggar,286,mage,arcane,6,3,3
Naween,hyjal,239,mage,arcane,5,3,2
Ãshs,archimonde,192,mage,arcane,6,2,4
Teeclis,twisting-nether,192,mage,arcane,6,2,4
Shiranize,aegwynn,192,mage,arcane,6,2,4
Phyzed,archimonde,192,mage,arcane,6,2,4
Kbd,outland,192,mage,arcane,6,2,4
Ryûblast,archimonde,192,mage,arcane,6,2,4
Zoot,ravencrest,192,mage,arcane,6,2,4
Schøkø,eredar,192,mage,arcane,6,2,4
Naomypayton,tarren-mill,192,mage,arcane,6,2,4
Nerzzhul,burning-legion,192,mage,arcane,6,2,4
Versachi,neptulon,192,mage,arcane,6,2,4
Superduck,ragnaros,192,mage,arcane,6,2,4
Линклер,fordragon,192,mage,arcane,6,2,4
Hruon,ravenholdt,192,mage,arcane,6,2,4
Kuhwar,echsenkessel,192,mage,arcane,6,2,4
Baravar,blackrock,192,mage,arcane,6,2,4
Noxkin,stormscale,192,mage,arcane,6,2,4
Леракобольд,gordunni,192,mage,arcane,6,2,4
Зерагуд,eversong,192,mage,arcane,6,2,4
Arimila,sylvanas,192,mage,arcane,6,2,4
Æones,kult-der-verdammten,192,mage,arcane,12,2,10
Magse,kirin-tor,191,mage,arcane,6,2,4
Icx,tarren-mill,191,mage,arcane,6,2,4
Hólmess,silvermoon,96,mage,arcane,6,1,5
Мерац,howling-fjord,96,mage,arcane,6,1,5
Sorrow,outland,96,mage,arcane,6,1,5
Angélique,ragnaros,96,mage,arcane,6,1,5
Moosemæn,stormscale,96,mage,arcane,6,1,5
Thelastmage,outland,96,mage,arcane,6,1,5
Sidildur,ravencrest,96,mage,arcane,6,1,5
Døomey,ravencrest,96,mage,arcane,6,1,5
Seraf,argent-dawn,96,mage,arcane,6,1,5
Старкскрим,gordunni,96,mage,arcane,6,1,5
Animaze,argent-dawn,96,mage,arcane,6,1,5
Nohbrain,blackmoore,96,mage,arcane,6,1,5
Манднесс,azuregos,79,mage,arcane,11,1,10
Thegoodoctor,kazzak,2117,mage,fire,63,36,27
Slôw,kazzak,2029,mage,fire,42,29,13
Håtemebaby,kazzak,2021,mage,fire,84,38,46
Яшабурстх,blackscar,1943,mage,fire,66,35,31
Tommy,laughing-skull,1928,mage,fire,60,34,26
Twizzkek,silvermoon,1928,mage,fire,57,30,27
Rizzlybear,outland,1918,mage,fire,75,35,40
Laynerz,kazzak,1917,mage,fire,27,21,6
Milkenjoyer,ravencrest,1906,mage,fire,47,30,17
Hatsu,kazzak,1884,mage,fire,60,32,28
Håtsu,ravencrest,1882,mage,fire,54,29,25
Uknowhowwedu,aegwynn,1879,mage,fire,36,20,16
Шипми,gordunni,1862,mage,fire,78,39,39
Uniquenoodle,alakir,1857,mage,fire,72,34,38
Cörnflekz,stormscale,1850,mage,fire,44,28,16
Dardie,ravencrest,1849,mage,fire,48,30,18
Hazewrld,ravencrest,1848,mage,fire,132,62,70
Spelltastíc,blackmoore,1844,mage,fire,54,34,20
Hólmess,silvermoon,1840,mage,fire,54,28,26
Wàneís,ravencrest,1831,mage,fire,40,25,15
Твейзи,blackscar,1823,mage,fire,40,24,16
Evohz,stormscale,1822,mage,fire,66,33,33
Hey,khazgoroth,1817,mage,fire,48,31,17
Elmaestró,aegwynn,1815,mage,fire,48,30,18
Bigkent,stormscale,1814,mage,fire,62,27,35
Nihilvm,dalaran,1812,mage,fire,46,26,20
Libre,stormscale,1807,mage,fire,82,51,31
Jirt,stormscale,1782,mage,fire,47,28,19
Reyown,archimonde,1777,mage,fire,54,40,14
Ókamí,ravencrest,1775,mage,fire,97,50,47
Isenhour,frostmane,1757,mage,fire,114,56,58
Dizzy,ahnqiraj,1751,mage,fire,78,35,43
Диссоциация,greymane,1746,mage,fire,42,26,16
Рофкастер,gordunni,1743,mage,fire,41,22,19
Ygø,hyjal,1740,mage,fire,65,29,36
Hardtimes,blackhand,1738,mage,fire,70,38,32
Авгурей,howling-fjord,1736,mage,fire,72,35,37
Гекомория,fordragon,1736,mage,fire,65,26,39
Asterixus,sylvanas,1728,mage,fire,72,44,28
Disnay,draenor,1724,mage,fire,114,67,47
Mágetráiner,ravencrest,1721,mage,fire,36,18,18
Dxdxdxdxdx,drakthul,1700,mage,fire,42,23,19
Gelußaßa,ravencrest,1696,mage,fire,35,22,13
Mssilvy,sylvanas,1681,mage,fire,66,36,30
Skrex,blackrock,1677,mage,fire,78,48,30
Spelltastìc,blackmoore,1675,mage,fire,36,18,18
Реордиан,gordunni,1667,mage,fire,47,18,29
Itrius,tarren-mill,1647,mage,fire,48,23,25
Magenerfed,archimonde,1637,mage,fire,42,21,21
Sheepmeepbip,ravencrest,1632,mage,fire,81,35,46
Obbjob,ravencrest,1631,mage,fire,72,36,36
Elldiamage,draenor,1608,mage,fire,35,21,14
Cienaños,outland,1606,mage,fire,66,34,32
Smlx,outland,1603,mage,fire,36,20,16
Айслэнц,howling-fjord,1602,mage,fire,42,21,21
Frozentwink,kul-tiras,1601,mage,fire,40,21,19
Whats,korgall,1585,mage,fire,70,39,31
Naps,argent-dawn,1574,mage,fire,42,26,16
Czd,outland,1574,mage,fire,53,21,32
Прауз,soulflayer,1573,mage,fire,33,17,16
Stoychav,outland,1573,mage,fire,72,36,36
Hexmath,tarren-mill,1572,mage,fire,41,26,15
Underscore,outland,1563,mage,fire,30,18,12
Råståfåri,uldum,1562,mage,fire,60,31,29
Camiina,shattered-hand,1545,mage,fire,48,29,19
Gagaj,ravencrest,1534,mage,fire,42,20,22
Petar,tarren-mill,1526,mage,fire,34,18,16
Ðevlqt,blackmoore,1522,mage,fire,24,16,8
Consquens,aszune,1509,mage,fire,24,16,8
Insanewizard,kazzak,1504,mage,fire,53,28,25
Evovar,silvermoon,1492,mage,fire,35,16,19
Экзорсус,goldrinn,1491,mage,fire,80,39,41
Macheat,kazzak,1485,mage,fire,30,16,14
Plætinum,ravencrest,1478,mage,fire,80,42,38
Gnomag,argent-dawn,1478,mage,fire,54,28,26
Dantiqa,ravencrest,1472,mage,fire,110,53,57
Htwhy,kazzak,1448,mage,fire,36,16,20
Skarxaa,sanguino,1443,mage,fire,36,19,17
Lilblinks,silvermoon,1441,mage,fire,34,18,16
Secretagent,aegwynn,1439,mage,fire,66,37,29
Shahnoza,thrall,1428,mage,fire,24,15,9
Fireblood,runetotem,1426,mage,fire,36,15,21
Triplesevenx,silvermoon,1422,mage,fire,53,26,27
Siérra,outland,1419,mage,fire,18,15,3
Rayniß,blackmoore,1417,mage,fire,54,25,29
Calientay,ragnaros,1414,mage,fire,30,15,15
Aikamie,draenor,1412,mage,fire,48,24,24
Razrkh,ragnaros,1409,mage,fire,36,19,17
Vzrmage,antonidas,1402,mage,fire,108,46,62
Колдрагос,gordunni,1398,mage,fire,42,17,25
Lokilus,dalaran,1393,mage,fire,24,15,9
Дрраго,greymane,1386,mage,fire,69,34,35
Ледянойкекс,gordunni,1384,mage,fire,48,24,24
Аваон,deathguard,1372,mage,fire,60,32,28
Рифтиг,howling-fjord,1365,mage,fire,61,27,34
Blitzo,madmortem,1361,mage,fire,42,25,17
Noviina,argent-dawn,1346,mage,fire,30,17,13
Kappotjeplif,ravencrest,1346,mage,fire,54,28,26
Cesi,silvermoon,1342,mage,fire,24,14,10
Magmarro,burning-legion,1342,mage,fire,36,19,17
Pisini,tarren-mill,1342,mage,fire,30,14,16
Ширм,blackscar,1340,mage,fire,30,14,16
Нереварин,soulflayer,1338,mage,fire,27,15,12
Ryzea,ravencrest,1338,mage,fire,41,21,20
Bloodycast,archimonde,1338,mage,fire,40,16,24
Аквамэрис,gordunni,1336,mage,fire,24,14,10
Zestrax,kazzak,1334,mage,fire,36,26,10
Darríck,argent-dawn,1323,mage,fire,41,16,25
Stylaaz,twisting-nether,1317,mage,fire,35,18,17
Mäalaka,archimonde,1316,mage,fire,24,14,10
Bonto,tarren-mill,1313,mage,fire,36,16,20
Neird,sinstralis,1312,mage,fire,30,15,15
Liendri,aegwynn,1305,mage,fire,30,14,16
Fiveboyjr,tarren-mill,1302,mage,fire,54,29,25
Вселениум,razuvious,1299,mage,fire,52,29,23
Magicalmig,draenor,1295,mage,fire,120,71,49
Manvo,bloodscalp,1294,mage,fire,30,16,14
Быкуня,gordunni,1276,mage,fire,30,17,13
Zéngã,kazzak,1263,mage,fire,31,15,16
Cinoox,blackrock,1261,mage,fire,54,29,25
Varenca,blackrock,1256,mage,fire,75,35,40
Prácticemàge,archimonde,1246,mage,fire,18,13,5
Fingolfin,amanthul,1246,mage,fire,237,111,126
Dóncójones,blackrock,1244,mage,fire,47,21,26
Zensheep,silvermoon,1235,mage,fire,24,13,11
Elcølgaø,sanguino,1233,mage,fire,30,13,17
Carinuz,blackmoore,1232,mage,fire,31,13,18
Tokerlol,stormscale,1231,mage,fire,27,13,14
Faunas,kazzak,1230,mage,fire,46,27,19
Warwizz,sanguino,1226,mage,fire,24,13,11
Ênizt,archimonde,1222,mage,fire,23,13,10
Nuvx,ravencrest,1212,mage,fire,72,39,33
Romethito,dun-modr,1203,mage,fire,24,17,7
Skylezy,blackrock,1198,mage,fire,23,13,10
Dobbite,archimonde,1178,mage,fire,30,21,9
Mëgu,silvermoon,1161,mage,fire,80,37,43
Nilitar,kazzak,1152,mage,fire,24,12,12
Фоулли,howling-fjord,1151,mage,fire,24,12,12
Azulêera,archimonde,1149,mage,fire,24,12,12
Rewq,twisting-nether,1147,mage,fire,18,12,6
Demensida,ravencrest,1145,mage,fire,28,13,15
Büyübaba,twisting-nether,1145,mage,fire,30,12,18
Doonii,ragnaros,1132,mage,fire,29,12,17
Eutkir,silvermoon,1121,mage,fire,27,13,14
Fritmckhaine,archimonde,1116,mage,fire,36,21,15
Gorleg,draenor,1072,mage,fire,47,17,30
Newtwo,ravencrest,1070,mage,fire,25,12,13
Wizmec,silvermoon,1068,mage,fire,36,12,24
Mowns,ravencrest,1056,mage,fire,24,11,13
Твейдей,blackscar,1056,mage,fire,24,11,13
Sleepingfate,stormscale,1055,mage,fire,18,11,7
Anisovsky,archimonde,1055,mage,fire,24,11,13
Fuego,sylvanas,1052,mage,fire,27,12,15
Мозифорест,gordunni,1047,mage,fire,30,11,19
Larah,les-clairvoyants,1038,mage,fire,18,11,7
Aimaniac,stormscale,1029,mage,fire,78,36,42
Pablø,blackrock,1014,mage,fire,31,15,16
Cyrîll,malygos,1004,mage,fire,73,36,37
Apócalyptic,tarren-mill,997,mage,fire,29,11,18
Freezandrun,tarren-mill,968,mage,fire,35,16,19
Dazz,ravencrest,960,mage,fire,18,10,8
Enandia,darksorrow,959,mage,fire,18,10,8
Âcryz,blackrock,959,mage,fire,24,10,14
Akâri,silvermoon,958,mage,fire,18,10,8
Texmexguden,tarren-mill,958,mage,fire,24,10,14
Mejtschazor,twisting-nether,957,mage,fire,18,10,8
Tiltedpapi,ravencrest,957,mage,fire,18,10,8
Charizard,emerald-dream,956,mage,fire,15,11,4
Atixx,aegwynn,952,mage,fire,27,11,16
Leontus,outland,951,mage,fire,12,10,2
Shealá,blackhand,951,mage,fire,24,10,14
Immortanjoe,thrall,946,mage,fire,24,10,14
Kuríbo,gorgonnash,944,mage,fire,21,11,10
Bobbasor,defias-brotherhood,934,mage,fire,34,14,20
Icx,tarren-mill,931,mage,fire,39,19,20
Sèrum,drakthul,927,mage,fire,23,10,13
Magicspark,madmortem,904,mage,fire,74,35,39
Santoz,blackrock,892,mage,fire,32,15,17
Nåzmyz,outland,891,mage,fire,17,10,7
Sagregas,silvermoon,876,mage,fire,65,28,37
Freezeballs,blackmoore,871,mage,fire,31,10,21
Auchenax,argent-dawn,864,mage,fire,12,9,3
Turbomedusa,draenor,864,mage,fire,12,9,3
Magerocks,ragnaros,864,mage,fire,12,9,3
Spacehoe,stormscale,864,mage,fire,18,9,9
Lotharie,aegwynn,864,mage,fire,18,9,9
Tagrine,kaelthas,863,mage,fire,12,9,3
Ghalanz,ravencrest,863,mage,fire,18,9,9
Estelliên,burning-legion,863,mage,fire,18,9,9
Деозар,eversong,862,mage,fire,18,9,9
Weedup,zuljin,862,mage,fire,18,9,9
Morphis,talnivarr,862,mage,fire,18,9,9
Firewitch,blackhand,860,mage,fire,18,9,9
Silatara,twisting-nether,860,mage,fire,18,9,9
Чоуза,gordunni,858,mage,fire,24,9,15
Athenå,dalaran,857,mage,fire,18,9,9
Nezousta,sinstralis,854,mage,fire,18,9,9
Løxyy,ysondre,852,mage,fire,26,11,15
Netherstorm,chogall,848,mage,fire,24,10,14
Töframaður,draenor,827,mage,fire,16,9,7
Firen,thrall,827,mage,fire,18,9,9
Gerdâ,confrérie-du-thorium,777,mage,fire,20,10,10
Mlodysimba,burning-legion,768,mage,fire,12,8,4
Yésdávé,stormscale,768,mage,fire,12,8,4
Nùts,archimonde,768,mage,fire,12,8,4
Apollohouse,ravencrest,768,mage,fire,12,8,4
Roxxis,kazzak,768,mage,fire,12,8,4
Fakeklepter,sylvanas,768,mage,fire,12,8,4
Zelimeth,outland,768,mage,fire,18,8,10
Mðj,kazzak,768,mage,fire,24,8,16
Imtrynasheep,kazzak,767,mage,fire,12,8,4
Bclaudiu,terokkar,767,mage,fire,16,9,7
Dauwen,silvermoon,767,mage,fire,18,8,10
Алаурс,howling-fjord,767,mage,fire,18,8,10
Aulny,kaelthas,767,mage,fire,18,8,10
Dynamica,ravencrest,767,mage,fire,18,8,10
Pluggis,the-maelstrom,767,mage,fire,18,8,10
Магмагистр,blackscar,767,mage,fire,24,8,16
Takiix,antonidas,766,mage,fire,12,8,4
Pandathis,frostwolf,766,mage,fire,12,8,4
Versachi,neptulon,766,mage,fire,18,8,10
Laetitiah,archimonde,766,mage,fire,18,8,10
Iamslow,sylvanas,762,mage,fire,12,8,4
Arcadua,sanguino,758,mage,fire,12,8,4
Kalyypso,arygos,735,mage,fire,16,9,7
Iconic,eredar,672,mage,fire,12,7,5
Вовзон,howling-fjord,672,mage,fire,12,7,5
Equálity,blackrock,672,mage,fire,12,7,5
Двинск,soulflayer,672,mage,fire,12,7,5
Anaxtra,guldan,672,mage,fire,18,7,11
Mangiafuoco,nemesis,672,mage,fire,18,7,11
Spellfaker,drakthul,671,mage,fire,12,7,5
Дмблдр,soulflayer,670,mage,fire,12,7,5
Ustafrr,argent-dawn,670,mage,fire,13,7,6
Caesarclown,silvermoon,667,mage,fire,12,7,5
Bigbazzabean,silvermoon,657,mage,fire,18,7,11
Magikere,tarren-mill,639,mage,fire,17,7,10
Vulcanx,stormscale,638,mage,fire,17,7,10
Bezelgeuse,pozzo-delleternità,623,mage,fire,17,7,10
Chrismage,argent-dawn,606,mage,fire,20,7,13
Whócárés,dragonmaw,576,mage,fire,6,6,0
Matsuratkø,nemesis,576,mage,fire,6,6,0
Arcticfury,ravencrest,576,mage,fire,6,6,0
Pradapimp,ravencrest,576,mage,fire,12,6,6
Octtmiss,twisting-nether,576,mage,fire,12,6,6
Codeincassie,blackhand,576,mage,fire,12,6,6
Yanir,die-arguswacht,576,mage,fire,12,6,6
Themagicguy,silvermoon,576,mage,fire,12,6,6
Macey,ravencrest,576,mage,fire,12,6,6
Çana,thrall,576,mage,fire,12,6,6
Zimbabweborc,burning-legion,576,mage,fire,12,6,6
Serctheone,ravencrest,576,mage,fire,12,6,6
Feath,ravencrest,576,mage,fire,12,6,6
Canceled,kazzak,576,mage,fire,12,6,6
Rhodghar,ravencrest,576,mage,fire,12,6,6
Steveishigh,tarren-mill,576,mage,fire,13,6,7
Relik,sylvanas,576,mage,fire,18,6,12
Arhi,silvermoon,575,mage,fire,12,6,6
Saturator,burning-legion,575,mage,fire,18,6,12
Explosìve,arthas,574,mage,fire,12,6,6
Durdi,silvermoon,574,mage,fire,12,6,6
Mauvé,blades-edge,520,mage,fire,13,7,6
Rambau,archimonde,480,mage,fire,6,5,1
Yoku,nethersturm,480,mage,fire,6,5,1
Cleancc,blackhand,480,mage,fire,6,5,1
Säroumäne,archimonde,480,mage,fire,6,5,1
Larmp,outland,480,mage,fire,6,5,1
Jél,stormscale,480,mage,fire,6,5,1
Jíncks,draenor,480,mage,fire,6,5,1
Bzzr,tarren-mill,480,mage,fire,6,5,1
Utarii,deathwing,480,mage,fire,6,5,1
Excuséme,ravencrest,480,mage,fire,6,5,1
Choll,stormscale,480,mage,fire,6,5,1
Momomagic,silvermoon,480,mage,fire,6,5,1
Teeclis,twisting-nether,480,mage,fire,12,5,7
Røysi,ravencrest,480,mage,fire,12,5,7
Проблембойх,gordunni,480,mage,fire,12,5,7
Mieria,argent-dawn,480,mage,fire,12,5,7
Magechonk,kazzak,480,mage,fire,12,5,7
Sheepwithmeh,blackrock,480,mage,fire,12,5,7
Schøkø,eredar,480,mage,fire,12,5,7
Backped,kazzak,480,mage,fire,18,5,13
Валбериса,deepholm,479,mage,fire,6,5,1
Wizarð,archimonde,479,mage,fire,12,5,7
Spispi,burning-legion,479,mage,fire,15,6,9
Nohbrain,blackmoore,479,mage,fire,18,5,13
Iceorb,azshara,479,mage,fire,24,5,19
Spader,argent-dawn,478,mage,fire,12,5,7
Skitsó,shadowsong,477,mage,fire,12,5,7
Exorifrigo,dun-modr,477,mage,fire,22,5,17
Eldiablo,dun-modr,476,mage,fire,12,5,7
Yshax,malganis,463,mage,fire,11,5,6
Buuszek,outland,430,mage,fire,11,5,6
Файрусх,deathguard,384,mage,fire,6,4,2
Zaci,argent-dawn,384,mage,fire,6,4,2
Doryy,silvermoon,384,mage,fire,6,4,2
Mitchmage,ravencrest,384,mage,fire,6,4,2
Saryotheone,silvermoon,384,mage,fire,6,4,2
Drè,daggerspine,384,mage,fire,6,4,2
Mnday,ravencrest,384,mage,fire,6,4,2
Ovrpwrdxd,kazzak,384,mage,fire,6,4,2
Kitchimage,ravencrest,384,mage,fire,6,4,2
Pavlé,draenor,384,mage,fire,6,4,2
Cardioexpert,ravencrest,384,mage,fire,6,4,2
Drewna,silvermoon,384,mage,fire,6,4,2
Gennésïs,darksorrow,384,mage,fire,6,4,2
Blinker,frostwhisper,384,mage,fire,6,4,2
Rotøk,burning-legion,384,mage,fire,6,4,2
Zyreanx,blackrock,384,mage,fire,6,4,2
Elesios,blackmoore,384,mage,fire,6,4,2
Gidsor,silvermoon,384,mage,fire,6,4,2
Нефростмаг,gordunni,384,mage,fire,6,4,2
Деорро,gordunni,384,mage,fire,12,4,8
Викликс,borean-tundra,384,mage,fire,12,4,8
Genviedgiclé,arathi,384,mage,fire,12,4,8
Anthrex,drakthul,384,mage,fire,12,4,8
Magicuze,argent-dawn,384,mage,fire,12,4,8
Camelshaver,tarren-mill,384,mage,fire,12,4,8
Aarcheon,kazzak,384,mage,fire,12,4,8
Zuckerzimt,ravencrest,384,mage,fire,12,4,8
Insaneex,aegwynn,384,mage,fire,12,4,8
Вельдрик,soulflayer,384,mage,fire,12,4,8
Rooven,aegwynn,384,mage,fire,12,4,8
Popbg,outland,384,mage,fire,12,4,8
Lusionator,defias-brotherhood,384,mage,fire,18,4,14
Rapidfrost,drakthul,383,mage,fire,6,4,2
Draenaya,forscherliga,381,mage,fire,18,4,14
Hidrax,outland,352,mage,fire,10,4,6
Lusifera,outland,336,mage,fire,9,4,5
Мэдраша,gordunni,335,mage,fire,17,4,13
Sonybonanza,kazzak,288,mage,fire,6,3,3
Alyraza,chamber-of-aspects,288,mage,fire,6,3,3
Salvadordalí,ravencrest,288,mage,fire,6,3,3
Тудысюдым,eversong,288,mage,fire,6,3,3
Ziscine,tarren-mill,288,mage,fire,6,3,3
Radiantfury,outland,288,mage,fire,6,3,3
Shermî,blackrock,288,mage,fire,6,3,3
Maveya,blackmoore,288,mage,fire,6,3,3
Namemage,stormscale,288,mage,fire,6,3,3
Незерёб,soulflayer,288,mage,fire,6,3,3
Driana,dragonmaw,288,mage,fire,6,3,3
Funkyfriday,twisting-nether,288,mage,fire,6,3,3
Capphaow,ravencrest,288,mage,fire,6,3,3
Росвенд,gordunni,288,mage,fire,6,3,3
Мэджу,gordunni,288,mage,fire,6,3,3
Trowbe,blackmoore,288,mage,fire,6,3,3
Lëyra,ysondre,288,mage,fire,6,3,3
Alterwhite,archimonde,288,mage,fire,6,3,3
Ørka,stormscale,288,mage,fire,6,3,3
Coachrmp,ravencrest,288,mage,fire,6,3,3
Revanov,outland,288,mage,fire,6,3,3
Zøe,aggra-português,288,mage,fire,6,3,3
Modrone,ragnaros,288,mage,fire,6,3,3
Колтрэйн,blackscar,288,mage,fire,9,3,6
Kyrn,zuljin,288,mage,fire,10,3,7
Oblív,ravencrest,288,mage,fire,12,3,9
Aylan,kazzak,288,mage,fire,12,3,9
Rasaku,argent-dawn,288,mage,fire,12,3,9
Trenpapi,twisting-nether,288,mage,fire,12,3,9
Frökenfrost,stormscale,288,mage,fire,12,3,9
Anshara,stormscale,287,mage,fire,6,3,3
Rasputina,blackrock,287,mage,fire,23,7,16
Ceanna,argent-dawn,287,mage,fire,12,3,9
Regenn,kazzak,286,mage,fire,6,3,3
Critr,sylvanas,239,mage,fire,5,3,2
Sokardes,the-maelstrom,192,mage,fire,4,3,1
Roberx,sanguino,192,mage,fire,6,2,4
Zeklo,frostmane,192,mage,fire,6,2,4
Atzin,sanguino,192,mage,fire,6,2,4
Malshash,outland,192,mage,fire,6,2,4
Transformo,draenor,192,mage,fire,6,2,4
Preí,archimonde,192,mage,fire,6,2,4
Elynaé,draenor,192,mage,fire,6,2,4
Watchmeclic,archimonde,192,mage,fire,6,2,4
Arcandor,tarren-mill,192,mage,fire,6,2,4
Vantimere,twisting-nether,192,mage,fire,6,2,4
Letitsnow,ravencrest,192,mage,fire,6,2,4
Kilféfroid,ysondre,192,mage,fire,6,2,4
Аквамелис,gordunni,192,mage,fire,6,2,4
Abêj,malygos,192,mage,fire,6,2,4
Hopewell,aszune,192,mage,fire,6,2,4
Alarak,drakthul,192,mage,fire,6,2,4
Milminmage,ravencrest,192,mage,fire,6,2,4
Dnt,twilights-hammer,192,mage,fire,6,2,4
Димаскунфу,howling-fjord,192,mage,fire,6,2,4
Szarbán,ragnaros,192,mage,fire,6,2,4
Zerobelow,silvermoon,192,mage,fire,6,2,4
Beardmorph,auchindoun,192,mage,fire,6,2,4
Magenox,blackrock,192,mage,fire,6,2,4
Firedeáth,kazzak,192,mage,fire,6,2,4
Majinbo,doomhammer,192,mage,fire,6,2,4
Lupuus,anubarak,192,mage,fire,6,2,4
Mesvef,archimonde,192,mage,fire,12,2,10
Magijoana,silvermoon,192,mage,fire,12,2,10
Kyani,mannoroth,192,mage,fire,12,2,10
Nötmârtònxø,ragnaros,192,mage,fire,12,2,10
Çatàclysmík,kazzak,192,mage,fire,12,2,10
Firelight,argent-dawn,192,mage,fire,12,2,10
Veveroiu,defias-brotherhood,191,mage,fire,6,2,4
Nabucor,culte-de-la-rive-noire,190,mage,fire,13,3,10
Хблэйз,howling-fjord,96,mage,fire,3,2,1
Пламяорды,soulflayer,96,mage,fire,6,1,5
Megancox,blackmoore,96,mage,fire,6,1,5
Mexxî,thrall,96,mage,fire,6,1,5
Варриморыч,soulflayer,96,mage,fire,6,1,5
Satheril,argent-dawn,96,mage,fire,6,1,5
Zoot,ravencrest,96,mage,fire,6,1,5
Nodnarb,dragonblight,96,mage,fire,6,1,5
Wîtchcurse,dentarg,96,mage,fire,6,1,5
Símple,sylvanas,96,mage,fire,6,1,5
Waan,sylvanas,96,mage,fire,6,1,5
Ckrax,sanguino,96,mage,fire,6,1,5
Kaki,stormscale,96,mage,fire,6,1,5
Phenoxi,sylvanas,96,mage,fire,6,1,5
Миднаит,gordunni,96,mage,fire,6,1,5
Polÿmorph,stormscale,96,mage,fire,6,1,5
Дизордерх,gordunni,96,mage,fire,6,1,5
Овеча,gordunni,96,mage,fire,6,1,5
Røvso,ragnaros,96,mage,fire,6,1,5
Slashlife,wrathbringer,96,mage,fire,6,1,5
Мэджиксул,grom,96,mage,fire,6,1,5
Moleester,twisting-nether,96,mage,fire,6,1,5
Radagulf,outland,96,mage,fire,6,1,5
Baxeraa,draenor,96,mage,fire,6,1,5
Tsungy,twisting-nether,96,mage,fire,6,1,5
Фантомланс,howling-fjord,96,mage,fire,6,1,5
Alaster,culte-de-la-rive-noire,96,mage,fire,6,1,5
Shâdozy,blackmoore,89,mage,fire,6,3,3
Озобочений,greymane,31,mage,fire,2,1,1
Worstwòrld,draenor,16,mage,fire,1,1,0
Ðøæø,twisting-nether,16,mage,fire,1,1,0
Partypower,twisting-nether,2252,mage,frost,129,68,61
Avizura,kazzak,2134,mage,frost,60,35,25
Dastion,ravencrest,2105,mage,frost,91,45,46
Oseri,defias-brotherhood,2103,mage,frost,101,53,48
Chikounet,archimonde,2094,mage,frost,120,60,60
Sóz,ravencrest,2060,mage,frost,91,43,48
Serctheone,ravencrest,2031,mage,frost,90,44,46
Fakér,ravencrest,2023,mage,frost,112,51,61
Sukmikok,twisting-nether,1942,mage,frost,90,46,44
Efes,dun-modr,1934,mage,frost,58,32,26
Shíróyama,ravencrest,1933,mage,frost,120,74,46
Nilitar,kazzak,1910,mage,frost,60,24,36
Watchmeclick,archimonde,1909,mage,frost,36,20,16
Auchenax,argent-dawn,1903,mage,frost,113,59,54
Søz,agamaggan,1899,mage,frost,65,31,34
Rekzaop,ravencrest,1886,mage,frost,72,34,38
Drfeeldgoodd,mazrigos,1880,mage,frost,60,29,31
Løwskìll,outland,1865,mage,frost,60,38,22
Aìnz,hyjal,1837,mage,frost,60,27,33
Rosady,ragnaros,1828,mage,frost,66,34,32
Exone,sylvanas,1828,mage,frost,66,32,34
Praison,defias-brotherhood,1826,mage,frost,48,30,18
Мэдвэйз,gordunni,1819,mage,frost,48,31,17
Gavno,ravencrest,1815,mage,frost,36,19,17
Zhodusqt,ragnaros,1808,mage,frost,48,24,24
Bombswag,bloodhoof,1807,mage,frost,59,31,28
Xmoo,blackrock,1805,mage,frost,48,24,24
Novaco,ravencrest,1805,mage,frost,59,29,30
Tellysia,blackmoore,1802,mage,frost,47,26,21
Símple,sylvanas,1802,mage,frost,60,27,33
Jaimey,blackhand,1801,mage,frost,114,56,58
Zøe,aggra-português,1800,mage,frost,54,34,20
Knometsj,ravencrest,1796,mage,frost,48,26,22
Ovrpwrdxd,kazzak,1763,mage,frost,24,20,4
Wmp,ravencrest,1763,mage,frost,42,23,19
Henqo,burning-legion,1762,mage,frost,58,25,33
Tfmchamp,ravencrest,1755,mage,frost,27,21,6
Girldalf,silvermoon,1754,mage,frost,119,65,54
Колинас,soulflayer,1748,mage,frost,101,50,51
Èverix,ravencrest,1748,mage,frost,71,28,43
Nightfee,eredar,1745,mage,frost,42,21,21
Setyouoncs,ravencrest,1729,mage,frost,42,25,17
Neymar,aszune,1725,mage,frost,35,24,11
Blackfirez,ravencrest,1725,mage,frost,30,18,12
Tánu,quelthalas,1717,mage,frost,66,32,34
Vilenciaga,kazzak,1716,mage,frost,60,34,26
Swizzy,arathor,1713,mage,frost,58,33,25
Ввнд,galakrond,1713,mage,frost,48,18,30
Lorothar,blackhand,1712,mage,frost,60,24,36
Mexxî,thrall,1707,mage,frost,54,28,26
Zimbabweborc,burning-legion,1706,mage,frost,48,30,18
Shakéx,outland,1700,mage,frost,45,22,23
Mlodysimba,burning-legion,1699,mage,frost,47,25,22
Sâkuya,blackrock,1697,mage,frost,80,37,43
Ёкай,soulflayer,1690,mage,frost,78,53,25
Tommy,laughing-skull,1690,mage,frost,35,18,17
Ãshs,archimonde,1690,mage,frost,48,20,28
Jirø,cthun,1688,mage,frost,40,23,17
Rambau,archimonde,1687,mage,frost,114,54,60
Алаурс,howling-fjord,1686,mage,frost,42,22,20
Jenggot,ravencrest,1681,mage,frost,35,18,17
Silverlining,ravencrest,1679,mage,frost,36,18,18
Вендайса,soulflayer,1678,mage,frost,168,107,61
Vilain,tarren-mill,1678,mage,frost,35,18,17
Raíner,eredar,1675,mage,frost,66,37,29
Magethings,kazzak,1675,mage,frost,48,25,23
Pryt,ragnaros,1669,mage,frost,78,43,35
Alearis,die-aldor,1667,mage,frost,36,20,16
Gossipgirlz,outland,1664,mage,frost,178,85,93
Гекомория,fordragon,1654,mage,frost,74,39,35
Oscarwizyo,ravencrest,1653,mage,frost,44,18,26
Naynn,archimonde,1651,mage,frost,34,21,13
Бингчилинг,howling-fjord,1648,mage,frost,43,24,19
Soloqtarget,archimonde,1648,mage,frost,74,34,40
Crylz,kazzak,1644,mage,frost,41,20,21
Afterimage,zuljin,1641,mage,frost,80,39,41
Nickg,ravencrest,1636,mage,frost,42,21,21
Magerocks,ragnaros,1635,mage,frost,36,20,16
Sondremage,outland,1635,mage,frost,134,60,74
Äntigood,outland,1633,mage,frost,53,27,26
Манахк,gordunni,1631,mage,frost,42,19,23
Asiman,eredar,1631,mage,frost,51,22,29
Buddi,burning-blade,1630,mage,frost,197,103,94
Thesiôu,ravencrest,1629,mage,frost,36,20,16
Glowie,stormreaver,1623,mage,frost,36,20,16
Xenant,ravencrest,1623,mage,frost,42,18,24
Frostgodxqt,ravencrest,1622,mage,frost,55,30,25
Blasty,guldan,1622,mage,frost,57,25,32
Thinamerican,defias-brotherhood,1620,mage,frost,24,18,6
Sykz,hyjal,1617,mage,frost,65,35,30
Bigkent,stormscale,1614,mage,frost,42,20,22
Bestial,alexstrasza,1613,mage,frost,40,19,21
Cleophe,burning-legion,1611,mage,frost,30,17,13
Xæll,silvermoon,1611,mage,frost,114,61,53
Fireblood,runetotem,1610,mage,frost,48,21,27
Bzzr,tarren-mill,1601,mage,frost,54,35,19
Левелнес,howling-fjord,1593,mage,frost,56,24,32
Ôbsury,hyjal,1588,mage,frost,42,24,18
Rihnou,blackmoore,1583,mage,frost,53,23,30
Ímnotback,outland,1578,mage,frost,78,45,33
Sunehx,blackrock,1578,mage,frost,36,19,17
Ceillech,blackrock,1578,mage,frost,71,36,35
Lo,kilrogg,1578,mage,frost,69,29,40
Райоми,fordragon,1575,mage,frost,61,30,31
Мибринк,soulflayer,1575,mage,frost,72,32,40
Beaun,tarren-mill,1570,mage,frost,54,31,23
Ингилейф,howling-fjord,1570,mage,frost,46,18,28
Демолюшн,soulflayer,1569,mage,frost,47,21,26
Вольняша,azuregos,1565,mage,frost,72,28,44
Iroya,festung-der-stürme,1561,mage,frost,96,47,49
Joulz,ravencrest,1561,mage,frost,80,34,46
Chareyla,argent-dawn,1558,mage,frost,83,42,41
Gaduz,kazzak,1556,mage,frost,72,31,41
Sheepthrillz,blackmoore,1536,mage,frost,30,18,12
Tiqma,sylvanas,1528,mage,frost,30,16,14
Сосулькина,gordunni,1520,mage,frost,77,42,35
Phélenia,sargeras,1516,mage,frost,48,24,24
Gêrky,drakthul,1507,mage,frost,84,44,40
Óuíja,outland,1504,mage,frost,33,19,14
Comodus,ragnaros,1500,mage,frost,78,37,41
Fullpolly,twisting-nether,1493,mage,frost,30,19,11
Únna,sanguino,1493,mage,frost,51,29,22
Itzlucky,twisting-nether,1493,mage,frost,93,44,49
Arimila,sylvanas,1492,mage,frost,88,39,49
Widmage,silvermoon,1484,mage,frost,60,23,37
Саваннхмаег,blackscar,1482,mage,frost,33,18,15
Тачмахал,soulflayer,1478,mage,frost,60,31,29
Qqpwn,ragnaros,1477,mage,frost,65,32,33
Магсимум,ashenvale,1476,mage,frost,30,18,12
Octtmiss,twisting-nether,1476,mage,frost,33,17,16
Dzikk,silvermoon,1474,mage,frost,48,24,24
Plætinum,ravencrest,1473,mage,frost,102,52,50
Ghalanz,ravencrest,1473,mage,frost,54,23,31
Maquiwizz,aggra-português,1472,mage,frost,42,22,20
Quinella,ravencrest,1470,mage,frost,48,21,27
Shainax,dun-modr,1466,mage,frost,88,45,43
Fïttan,stormscale,1464,mage,frost,44,20,24
Emoden,silvermoon,1455,mage,frost,119,56,63
Lesoleil,archimonde,1453,mage,frost,30,19,11
Khivax,twisting-nether,1448,mage,frost,66,27,39
Woorm,sylvanas,1446,mage,frost,76,44,32
Eldariel,ravencrest,1446,mage,frost,53,24,29
Laurents,silvermoon,1443,mage,frost,86,51,35
Iggilaus,blackhand,1436,mage,frost,167,87,80
Hayaka,sanguino,1435,mage,frost,59,30,29
Polÿmorph,stormscale,1434,mage,frost,24,15,9
Nimdáá,stormscale,1429,mage,frost,85,49,36
Alkhazzar,defias-brotherhood,1428,mage,frost,84,37,47
Caesarclown,silvermoon,1417,mage,frost,81,42,39
Absoluteswag,tarren-mill,1416,mage,frost,33,16,17
Гатмир,gordunni,1416,mage,frost,77,37,40
Синийлед,galakrond,1408,mage,frost,54,25,29
Elcølgaø,sanguino,1406,mage,frost,90,39,51
Shüri,kazzak,1404,mage,frost,60,35,25
Rexør,frostwolf,1404,mage,frost,36,19,17
Missl,draenor,1403,mage,frost,26,16,10
Shinzel,hyjal,1403,mage,frost,54,24,30
Datpolytho,twisting-nether,1402,mage,frost,18,15,3
Pluribusunum,outland,1398,mage,frost,38,17,21
Ymirë,khaz-modan,1391,mage,frost,45,20,25
Pipihu,silvermoon,1389,mage,frost,42,20,22
Demensida,ravencrest,1387,mage,frost,50,21,29
Cheerió,aggramar,1382,mage,frost,126,55,71
Tôke,kaelthas,1380,mage,frost,54,29,25
Mecharience,rexxar,1378,mage,frost,27,15,12
Icefix,dun-modr,1377,mage,frost,59,29,30
Цепнойпёс,goldrinn,1371,mage,frost,34,17,17
Immobilizer,eredar,1368,mage,frost,36,19,17
Smöked,tarren-mill,1350,mage,frost,252,128,124
Søphiâ,thrall,1347,mage,frost,45,25,20
Jíncks,anachronos,1344,mage,frost,24,14,10
Preí,archimonde,1344,mage,frost,37,15,22
Барсуктри,deathguard,1343,mage,frost,24,14,10
Макотшельник,gordunni,1342,mage,frost,18,14,4
Onnÿy,dun-modr,1342,mage,frost,24,14,10
Apócalyptic,tarren-mill,1340,mage,frost,64,36,28
Fractox,ysondre,1338,mage,frost,35,20,15
Spelltastíc,blackmoore,1333,mage,frost,24,14,10
Iulie,kazzak,1331,mage,frost,42,19,23
Sused,outland,1321,mage,frost,30,16,14
Alicánte,silvermoon,1320,mage,frost,48,18,30
Stillfrostin,blackrock,1319,mage,frost,42,25,17
Walian,burning-blade,1319,mage,frost,24,14,10
Гунмаказ,soulflayer,1318,mage,frost,22,16,6
Afklow,pozzo-delleternità,1318,mage,frost,27,14,13
Sekulicgoga,draenor,1317,mage,frost,105,59,46
Mdog,stormreaver,1317,mage,frost,68,35,33
Nups,ravencrest,1315,mage,frost,60,24,36
Ðeejkñ,archimonde,1310,mage,frost,20,15,5
Firehasse,draenor,1309,mage,frost,60,32,28
Excuses,chamber-of-aspects,1305,mage,frost,22,14,8
Iceterror,ravencrest,1300,mage,frost,24,15,9
Mxrrz,kazzak,1299,mage,frost,73,33,40
Psychosiss,kazzak,1298,mage,frost,49,27,22
Abolf,twisting-nether,1288,mage,frost,30,16,14
Кройзис,howling-fjord,1278,mage,frost,36,21,15
Дарнивил,gordunni,1277,mage,frost,66,31,35
Jedite,die-todeskrallen,1269,mage,frost,52,25,27
Leafløver,ravencrest,1267,mage,frost,29,14,15
Айсбоунт,eversong,1265,mage,frost,37,25,12
Braxxorz,chamber-of-aspects,1261,mage,frost,36,24,12
Seelengott,onyxia,1259,mage,frost,61,31,30
Homellander,silvermoon,1258,mage,frost,64,32,32
Animaze,argent-dawn,1250,mage,frost,83,49,34
Pwntt,terenas,1248,mage,frost,39,15,24
Nebbur,dun-modr,1243,mage,frost,30,13,17
Oiklo,eitrigg,1243,mage,frost,49,19,30
Xânârchy,minahonda,1242,mage,frost,72,33,39
Jackin,burning-legion,1241,mage,frost,42,18,24
Mgtowforlife,ravencrest,1241,mage,frost,36,13,23
Melíssa,silvermoon,1240,mage,frost,18,13,5
Fleurdelacur,ravencrest,1240,mage,frost,51,28,23
Дырявка,galakrond,1229,mage,frost,30,13,17
Kaaguraa,ravencrest,1228,mage,frost,42,22,20
Iceorb,azshara,1227,mage,frost,30,13,17
Alktraz,outland,1223,mage,frost,30,13,17
Laenadria,argent-dawn,1218,mage,frost,36,13,23
Suidas,auchindoun,1217,mage,frost,66,28,38
Pyroden,stormscale,1216,mage,frost,30,14,16
Лутиум,howling-fjord,1210,mage,frost,139,76,63
Silvariy,stormscale,1210,mage,frost,82,39,43
Scaless,stormscale,1209,mage,frost,58,28,30
Орижн,howling-fjord,1208,mage,frost,24,13,11
Хируэль,gordunni,1208,mage,frost,30,14,16
Rektd,blackhand,1200,mage,frost,51,20,31
Tradez,norgannon,1197,mage,frost,36,13,23
Сибиди,gordunni,1185,mage,frost,24,13,11
Latiny,destromath,1184,mage,frost,35,17,18
Teuboku,ysondre,1180,mage,frost,25,15,10
Akúmã,stormscale,1171,mage,frost,24,14,10
Bossgb,twisting-nether,1160,mage,frost,27,15,12
Katarapower,silvermoon,1158,mage,frost,96,41,55
Baravar,blackrock,1155,mage,frost,35,14,21
Gliffy,terokkar,1152,mage,frost,37,22,15
Noxkin,stormscale,1151,mage,frost,24,12,12
Koreanbbq,outland,1148,mage,frost,30,12,18
Kippercarry,outland,1144,mage,frost,24,12,12
Qulinx,kazzak,1142,mage,frost,29,13,16
Айсвеном,gordunni,1142,mage,frost,30,13,17
Oathkeepper,silvermoon,1134,mage,frost,70,33,37
Morphees,twisting-nether,1132,mage,frost,18,12,6
Iamslow,sylvanas,1130,mage,frost,18,12,6
Amicuta,ravencrest,1125,mage,frost,42,20,22
Медивера,gordunni,1119,mage,frost,26,13,13
Shalien,tarren-mill,1117,mage,frost,23,12,11
Stickiburn,malganis,1103,mage,frost,27,12,15
Snowrain,chogall,1099,mage,frost,29,16,13
Réd,earthen-ring,1098,mage,frost,35,12,23
Saphiregos,dalaran,1086,mage,frost,36,16,20
Zedsdeadbaby,argent-dawn,1083,mage,frost,27,15,12
Goeb,kazzak,1083,mage,frost,35,14,21
Lovësosa,hyjal,1081,mage,frost,34,15,19
Qtiepatootie,silvermoon,1077,mage,frost,85,48,37
Дедамаг,eversong,1064,mage,frost,36,18,18
Forestie,silvermoon,1061,mage,frost,44,21,23
Tacto,ravencrest,1061,mage,frost,94,44,50
Lifemagic,chamber-of-aspects,1058,mage,frost,72,36,36
Лемозяра,gordunni,1056,mage,frost,12,11,1
Emerlyn,ragnaros,1056,mage,frost,18,11,7
Soz,agamaggan,1056,mage,frost,18,11,7
Sìsia,ragnaros,1056,mage,frost,18,11,7
Jocelynn,aggramar,1056,mage,frost,24,11,13
Ironhood,nemesis,1055,mage,frost,18,11,7
Hazzá,ravencrest,1055,mage,frost,18,11,7
Rere,zenedar,1054,mage,frost,26,13,13
Викликс,borean-tundra,1052,mage,frost,22,13,9
Momotemp,emerald-dream,1046,mage,frost,56,23,33
Férécide,ysondre,1045,mage,frost,30,11,19
Khoshgele,draenor,1039,mage,frost,24,11,13
Corpusqq,eredar,1039,mage,frost,30,11,19
Вельдрик,soulflayer,1037,mage,frost,44,18,26
Schtenen,silvermoon,1028,mage,frost,80,34,46
Arkhaen,archimonde,1022,mage,frost,23,11,12
Илайла,booty-bay,1007,mage,frost,15,12,3
Broduy,draenor,1005,mage,frost,36,12,24
Haljina,kazzak,1001,mage,frost,72,27,45
Ramcoz,twisting-nether,1000,mage,frost,24,12,12
Erzà,todeswache,992,mage,frost,23,13,10
Slobbery,aggramar,990,mage,frost,20,11,9
Инкрионити,gordunni,989,mage,frost,17,11,6
Kumakara,archimonde,981,mage,frost,24,12,12
Clonefcf,sylvanas,976,mage,frost,43,23,20
Dnt,twilights-hammer,974,mage,frost,24,11,13
Мрперут,eversong,972,mage,frost,30,18,12
Niivel,ysondre,972,mage,frost,66,37,29
Ryzea,ravencrest,968,mage,frost,17,12,5
Roughfked,silvermoon,965,mage,frost,30,14,16
Acx,drakthul,960,mage,frost,18,10,8
Santriss,defias-brotherhood,960,mage,frost,24,10,14
Øscarwizyo,ravencrest,960,mage,frost,24,10,14
Гамаюнх,deathguard,959,mage,frost,18,10,8
Тортикток,soulflayer,959,mage,frost,18,10,8
Anaxtra,guldan,959,mage,frost,18,10,8
Borêta,blackrock,959,mage,frost,18,10,8
Discomorph,the-maelstrom,957,mage,frost,18,10,8
Zenó,blackrock,956,mage,frost,30,10,20
Stryee,ragnaros,954,mage,frost,18,10,8
Gacosane,chamber-of-aspects,952,mage,frost,24,10,14
Nightplays,sylvanas,951,mage,frost,18,10,8
Quincy,frostwolf,951,mage,frost,18,10,8
Этридемус,howling-fjord,947,mage,frost,30,10,20
Fashes,sunstrider,946,mage,frost,60,28,32
Evuryl,nemesis,944,mage,frost,18,10,8
Морозящий,howling-fjord,940,mage,frost,18,10,8
Килавый,eversong,938,mage,frost,12,10,2
Speedshatter,aegwynn,928,mage,frost,22,10,12
Блья,howling-fjord,918,mage,frost,18,11,7
Ghostgivree,archimonde,917,mage,frost,30,16,14
Ттэль,gordunni,900,mage,frost,16,11,5
Døliprane,garona,900,mage,frost,36,19,17
Margistikus,die-aldor,899,mage,frost,60,32,28
Юлианх,gordunni,891,mage,frost,202,92,110
Iceym,ravencrest,891,mage,frost,26,11,15
Amazona,veklor,889,mage,frost,32,16,16
Êmmá,blackmoore,885,mage,frost,54,22,32
Piego,turalyon,883,mage,frost,30,16,14
Xæl,ravencrest,866,mage,frost,57,27,30
Fakeklepter,sylvanas,864,mage,frost,12,9,3
Goneforever,draenor,864,mage,frost,12,9,3
Старкскрим,gordunni,864,mage,frost,12,9,3
Ney,drakthul,864,mage,frost,12,9,3
Manafuzz,outland,864,mage,frost,12,9,3
Baconlance,stormscale,864,mage,frost,18,9,9
Sorrow,outland,864,mage,frost,18,9,9
Medara,darkspear,864,mage,frost,18,9,9
Nozarashí,hyjal,864,mage,frost,22,10,12
Мэтаскрим,soulflayer,864,mage,frost,24,9,15
Abovè,outland,864,mage,frost,30,9,21
Surlancealot,outland,863,mage,frost,18,9,9
Trowbe,blackmoore,863,mage,frost,18,9,9
Muchmage,silvermoon,863,mage,frost,24,9,15
Манднесс,azuregos,861,mage,frost,18,9,9
Strychne,ragnaros,860,mage,frost,12,9,3
Frisstana,outland,859,mage,frost,18,9,9
Misscandy,doomhammer,858,mage,frost,18,9,9
Klésh,nemesis,858,mage,frost,18,9,9
Meydoum,archimonde,858,mage,frost,18,9,9
Naote,blackhand,858,mage,frost,18,9,9
Suikune,twisting-nether,857,mage,frost,12,9,3
Bolesnimage,draenor,857,mage,frost,18,9,9
Voralastor,doomhammer,855,mage,frost,12,9,3
Farrä,dun-modr,854,mage,frost,53,26,27
Zvuta,sanguino,853,mage,frost,12,9,3
Nazø,archimonde,853,mage,frost,24,9,15
Tàylerdarden,nemesis,845,mage,frost,23,9,14
Ezzekkiel,elune,835,mage,frost,18,9,9
Isolia,silvermoon,810,mage,frost,23,9,14
Lemonshelo,archimonde,806,mage,frost,27,9,18
Bengé,ragnaros,796,mage,frost,16,9,7
Akâri,silvermoon,784,mage,frost,25,9,16
Subzeraxo,archimonde,768,mage,frost,12,8,4
Séxmachiné,draenor,768,mage,frost,12,8,4
Xall,silvermoon,768,mage,frost,12,8,4
Serclulz,ravencrest,768,mage,frost,12,8,4
Laynerz,kazzak,768,mage,frost,13,8,5
Zoot,ravencrest,768,mage,frost,18,8,10
Mðj,kazzak,768,mage,frost,18,8,10
Track,blackhand,768,mage,frost,18,8,10
Lyndsey,dalaran,768,mage,frost,18,8,10
Väänik,draenor,768,mage,frost,18,8,10
Kurtkiels,draenor,768,mage,frost,18,8,10
Transformo,draenor,768,mage,frost,18,8,10
Zelimeth,outland,768,mage,frost,24,8,16
Нереварин,soulflayer,768,mage,frost,24,8,16
Tajos,drakthul,767,mage,frost,12,8,4
Gagaj,ravencrest,767,mage,frost,12,8,4
Necizbored,tarren-mill,767,mage,frost,12,8,4
Zili,draenor,767,mage,frost,12,8,4
Ewina,twisting-nether,767,mage,frost,12,8,4
Helminsterr,archimonde,767,mage,frost,18,8,10
Quilava,ghostlands,766,mage,frost,12,8,4
Ærrflôw,frostwolf,765,mage,frost,18,8,10
Celdra,blackrock,765,mage,frost,18,8,10
Xakiha,kazzak,764,mage,frost,18,8,10
Кельтузат,azuregos,762,mage,frost,12,8,4
Саназэр,soulflayer,762,mage,frost,18,8,10
Lêgólás,blackmoore,762,mage,frost,18,8,10
Frigus,khaz-modan,761,mage,frost,24,8,16
Леракобольд,gordunni,745,mage,frost,29,10,19
Lexalia,blackmoore,744,mage,frost,24,9,15
Kapueca,jaedenar,736,mage,frost,15,9,6
Amalou,stormscale,729,mage,frost,32,9,23
Cardioexpert,ravencrest,672,mage,frost,12,7,5
Skyblink,hyjal,672,mage,frost,12,7,5
Sangumage,silvermoon,672,mage,frost,12,7,5
Fîsheye,blackrock,672,mage,frost,12,7,5
Yobys,burning-legion,672,mage,frost,12,7,5
Lyès,uldaman,672,mage,frost,12,7,5
Evilmagíc,tarren-mill,672,mage,frost,12,7,5
Tills,kargath,672,mage,frost,12,7,5
Корадо,gordunni,672,mage,frost,12,7,5
Axhole,darksorrow,672,mage,frost,12,7,5
Qtpoof,sylvanas,672,mage,frost,12,7,5
Миднаит,gordunni,672,mage,frost,18,7,11
Чистокрут,gordunni,672,mage,frost,18,7,11
Mageyreid,quelthalas,672,mage,frost,18,7,11
Vinlimar,drakthul,672,mage,frost,18,7,11
Aterso,azshara,672,mage,frost,21,8,13
Layzzy,kazzak,672,mage,frost,24,7,17
Kaì,twisting-nether,671,mage,frost,12,7,5
Hernêise,silvermoon,671,mage,frost,12,7,5
Badphaz,frostmane,671,mage,frost,12,7,5
Geepie,twisting-nether,671,mage,frost,12,7,5
Ice,sargeras,671,mage,frost,18,7,11
Frostvirgin,twisting-nether,671,mage,frost,18,7,11
Daneliam,outland,670,mage,frost,18,7,11
Pruneau,hyjal,670,mage,frost,18,7,11
Bebarz,darksorrow,670,mage,frost,18,7,11
Irreversal,ravencrest,669,mage,frost,12,7,5
Titanshao,silvermoon,669,mage,frost,12,7,5
Aileean,burning-legion,669,mage,frost,18,7,11
Boredpeon,burning-legion,668,mage,frost,18,7,11
Lenycz,burning-blade,668,mage,frost,18,7,11
Jodiefroster,bronzebeard,667,mage,frost,12,7,5
Iceicebáby,draenor,667,mage,frost,18,7,11
Toxttr,drakthul,657,mage,frost,12,7,5
Helloimgone,blackmoore,655,mage,frost,17,7,10
Psika,kazzak,623,mage,frost,17,7,10
Skæde,ravencrest,618,mage,frost,17,11,6
Estonka,ravencrest,576,mage,frost,6,6,0
Escapematrix,ravencrest,576,mage,frost,6,6,0
Spellcast,ravencrest,576,mage,frost,12,6,6
Tromie,archimonde,576,mage,frost,12,6,6
Ecnaclappy,blackrock,576,mage,frost,12,6,6
Titarie,ravencrest,576,mage,frost,12,6,6
Sickofme,blackmoore,576,mage,frost,12,6,6
Джинетикс,deathguard,576,mage,frost,12,6,6
Нонекс,soulflayer,576,mage,frost,12,6,6
Frostjävel,grim-batol,576,mage,frost,12,6,6
Obbjob,ravencrest,576,mage,frost,12,6,6
Insømnium,stormscale,576,mage,frost,12,6,6
Bumbumdead,sylvanas,576,mage,frost,12,6,6
Nécrømage,confrérie-du-thorium,576,mage,frost,12,6,6
Iverson,kazzak,576,mage,frost,12,6,6
Skdroople,ravencrest,576,mage,frost,12,6,6
Watchmeclic,archimonde,576,mage,frost,12,6,6
Sainth,sanguino,576,mage,frost,12,6,6
Esscheppert,blackrock,576,mage,frost,18,6,12
Ephixis,ravencrest,576,mage,frost,18,6,12
Ury,hyjal,576,mage,frost,18,6,12
Articunoh,ravencrest,576,mage,frost,18,6,12
Yshax,malganis,576,mage,frost,24,6,18
Длинныеухи,blackscar,575,mage,frost,12,6,6
Pitbones,archimonde,575,mage,frost,12,6,6
Коласольдом,gordunni,575,mage,frost,12,6,6
Vathalis,zuluhed,575,mage,frost,18,6,12
Flakeh,outland,575,mage,frost,18,6,12
Saturator,burning-legion,575,mage,frost,18,6,12
Zzombi,sylvanas,574,mage,frost,16,7,9
Heavyfire,kazzak,573,mage,frost,12,6,6
Pinkis,darkmoon-faire,572,mage,frost,12,6,6
Aelire,die-aldor,527,mage,frost,15,6,9
Avb,twisting-nether,527,mage,frost,17,6,11
Kaeki,khaz-modan,520,mage,frost,14,8,6
Miihawkk,khaz-modan,510,mage,frost,20,6,14
Veemi,blackmoore,480,mage,frost,6,5,1
Azkarr,stormscale,480,mage,frost,6,5,1
Hérä,archimonde,480,mage,frost,6,5,1
Wortyvery,outland,480,mage,frost,6,5,1
Zehnvonzehn,antonidas,480,mage,frost,6,5,1
Insanewizard,kazzak,480,mage,frost,6,5,1
Arunx,magtheridon,480,mage,frost,6,5,1
Фоулли,howling-fjord,480,mage,frost,10,6,4
Magnopvp,sanguino,480,mage,frost,10,6,4
Moffmage,sylvanas,480,mage,frost,12,5,7
Crackheads,hyjal,480,mage,frost,12,5,7
Zionw,frostwolf,480,mage,frost,12,5,7
Gàtsby,outland,480,mage,frost,12,5,7
Marikisanx,blackmoore,480,mage,frost,12,5,7
Spell,blackmoore,480,mage,frost,12,5,7
Shnitz,stormscale,480,mage,frost,12,5,7
Okey,frostwhisper,480,mage,frost,12,5,7
Milkenjoyer,ravencrest,480,mage,frost,12,5,7
Charliezard,argent-dawn,480,mage,frost,12,5,7
Thelastmage,outland,480,mage,frost,12,5,7
Snowsánji,blackmoore,480,mage,frost,12,5,7
Betomage,blackmoore,480,mage,frost,12,5,7
Primodious,kazzak,480,mage,frost,12,5,7
Chrømy,twisting-nether,480,mage,frost,12,5,7
Lylla,cthun,480,mage,frost,12,5,7
Dyx,nemesis,480,mage,frost,12,5,7
Bamz,malganis,480,mage,frost,12,5,7
Krookéd,tarren-mill,480,mage,frost,18,5,13
Stîckî,malganis,480,mage,frost,18,5,13
Samath,conseil-des-ombres,480,mage,frost,18,5,13
Djdankzter,outland,480,mage,frost,24,5,19
Pinguíni,aegwynn,479,mage,frost,6,5,1
Fôôxy,aegwynn,479,mage,frost,12,5,7
Winterblues,frostmourne,479,mage,frost,12,5,7
Dabina,sanguino,479,mage,frost,12,5,7
Popixx,magtheridon,479,mage,frost,18,5,13
Deletron,ragnaros,479,mage,frost,18,5,13
Rifinouu,archimonde,476,mage,frost,12,5,7
Phibonaci,sylvanas,475,mage,frost,12,5,7
Blinkinggoat,ragnaros,448,mage,frost,16,5,11
Zaruna,arathor,432,mage,frost,9,6,3
Aerius,lightnings-blade,432,mage,frost,9,5,4
Swemagus,outland,432,mage,frost,9,5,4
Kelthuzed,twisting-nether,432,mage,frost,15,5,10
Xerathon,ravencrest,414,mage,frost,16,5,11
Leylus,blackmoore,399,mage,frost,5,5,0
Nightcàller,pozzo-delleternità,384,mage,frost,6,4,2
Pinkusbruh,aggra-português,384,mage,frost,6,4,2
Sneakii,the-maelstrom,384,mage,frost,6,4,2
Proudmøøre,argent-dawn,384,mage,frost,6,4,2
Pezi,outland,384,mage,frost,6,4,2
Хблэйз,howling-fjord,384,mage,frost,6,4,2
Tagrine,kaelthas,384,mage,frost,6,4,2
Kleini,die-aldor,384,mage,frost,6,4,2
Ðazzftw,archimonde,384,mage,frost,6,4,2
Пиньон,borean-tundra,384,mage,frost,6,4,2
Zionara,stormscale,384,mage,frost,6,4,2
Botanicula,the-maelstrom,384,mage,frost,6,4,2
Noviina,argent-dawn,384,mage,frost,6,4,2
Ón,burning-steppes,384,mage,frost,6,4,2
Crzyubrdrver,blackrock,384,mage,frost,6,4,2
Phenoxi,sylvanas,384,mage,frost,6,4,2
Nötmârtònxø,ragnaros,384,mage,frost,6,4,2
Nïo,ravencrest,384,mage,frost,6,4,2
Ahøllic,frostwolf,384,mage,frost,6,4,2
Fuhry,tarren-mill,384,mage,frost,6,4,2
Nutsa,silvermoon,384,mage,frost,6,4,2
Zerobelow,silvermoon,384,mage,frost,6,4,2
Leontus,outland,384,mage,frost,6,4,2
Arcitech,tarren-mill,384,mage,frost,6,4,2
Doryy,silvermoon,384,mage,frost,6,4,2
Meign,eredar,384,mage,frost,6,4,2
Chililol,dun-modr,384,mage,frost,6,4,2
Razzìatore,pozzo-delleternità,384,mage,frost,7,4,3
Zikyo,silvermoon,384,mage,frost,12,4,8
Stellarie,sylvanas,384,mage,frost,12,4,8
Däpper,ragnaros,384,mage,frost,12,4,8
Гаразлик,howling-fjord,384,mage,frost,12,4,8
Lambaa,thrall,384,mage,frost,12,4,8
Tærrëñshíll,tarren-mill,384,mage,frost,12,4,8
Пламяорды,soulflayer,384,mage,frost,12,4,8
Ioriyagami,dragonmaw,384,mage,frost,12,4,8
Faunas,kazzak,384,mage,frost,12,4,8
Muntiks,ravencrest,384,mage,frost,12,4,8
Ahdetärjag,silvermoon,384,mage,frost,12,4,8
Acclay,malganis,384,mage,frost,12,4,8
Юджегс,soulflayer,384,mage,frost,12,4,8
Facerollyo,tarren-mill,384,mage,frost,12,4,8
Newtwo,ravencrest,384,mage,frost,12,4,8
Shakeándbake,ravencrest,384,mage,frost,12,4,8
Whïm,ysondre,384,mage,frost,12,4,8
Roberx,sanguino,384,mage,frost,12,4,8
Unreadyx,archimonde,384,mage,frost,12,4,8
Cavadrex,arathor,384,mage,frost,18,4,14
Wuffwuffspik,grim-batol,383,mage,frost,6,4,2
Rafaeala,argent-dawn,383,mage,frost,6,4,2
Умелецмаг,gordunni,383,mage,frost,6,4,2
Brandonjames,ragnaros,383,mage,frost,12,4,8
Chogger,blackmoore,382,mage,frost,6,4,2
Лордбелиал,soulflayer,382,mage,frost,12,4,8
Nebby,argent-dawn,351,mage,frost,11,4,7
Escobar,frostmane,335,mage,frost,8,5,3
Sleîhg,sanguino,320,mage,frost,10,4,6
Magitron,wildhammer,319,mage,frost,5,4,1
Regenn,kazzak,318,mage,frost,5,4,1
Coldnight,uldum,301,mage,frost,13,4,9
Nevertøxic,ravencrest,288,mage,frost,6,3,3
Magekaoz,sylvanas,288,mage,frost,6,3,3
Justvik,eredar,288,mage,frost,6,3,3
Milminmage,ravencrest,288,mage,frost,6,3,3
Bóósh,alakir,288,mage,frost,6,3,3
Учительйода,ashenvale,288,mage,frost,6,3,3
Arandartis,kazzak,288,mage,frost,6,3,3
Microsmag,thrall,288,mage,frost,6,3,3
Фемна,soulflayer,288,mage,frost,6,3,3
Orelox,kazzak,288,mage,frost,6,3,3
Dominos,medivh,288,mage,frost,6,3,3
Broccosoup,kazzak,288,mage,frost,6,3,3
Tommyboy,dragonblight,288,mage,frost,6,3,3
Dragotus,dragonblight,288,mage,frost,6,3,3
Овеча,gordunni,288,mage,frost,6,3,3
Frökenfrost,stormscale,288,mage,frost,6,3,3
Fboltprocd,ragnaros,288,mage,frost,6,3,3
Kilstine,outland,288,mage,frost,6,3,3
Lidin,draenor,288,mage,frost,6,3,3
Snowberry,blackrock,288,mage,frost,6,3,3
Lyramage,draenor,288,mage,frost,6,3,3
Kurtcobain,draenor,288,mage,frost,6,3,3
Dumbledores,aegwynn,288,mage,frost,6,3,3
Johnnydeepp,archimonde,288,mage,frost,6,3,3
Bebenm,archimonde,288,mage,frost,6,3,3
Håtemebaby,kazzak,288,mage,frost,6,3,3
Ørixx,blackhand,288,mage,frost,6,3,3
Narcîsa,sanguino,288,mage,frost,6,3,3
Zyllu,argent-dawn,288,mage,frost,6,3,3
Codeincassie,blackhand,288,mage,frost,6,3,3
Anthrex,drakthul,288,mage,frost,6,3,3
Brunettdelux,archimonde,288,mage,frost,6,3,3
Luckydo,turalyon,288,mage,frost,6,3,3
Muuckie,blackrock,288,mage,frost,6,3,3
Onegaisenpai,ragnaros,288,mage,frost,6,3,3
Kleptomania,archimonde,288,mage,frost,6,3,3
Smashdown,blackrock,288,mage,frost,6,3,3
Siérra,outland,288,mage,frost,6,3,3
Haginatorr,twisting-nether,288,mage,frost,6,3,3
Vannq,silvermoon,288,mage,frost,6,3,3
Zoubaz,archimonde,288,mage,frost,6,3,3
Kadsy,tarren-mill,288,mage,frost,6,3,3
Find,archimonde,288,mage,frost,6,3,3
Rèkt,lightbringer,288,mage,frost,6,3,3
Gotone,tarren-mill,288,mage,frost,6,3,3
Tìnder,tarren-mill,288,mage,frost,6,3,3
Mimicassa,defias-brotherhood,288,mage,frost,9,4,5
Эммилиарда,gordunni,288,mage,frost,12,3,9
Потныйдпс,eversong,288,mage,frost,12,3,9
Fernandéz,ravencrest,288,mage,frost,12,3,9
Buffenhance,ravencrest,288,mage,frost,12,3,9
Sérc,ravencrest,288,mage,frost,12,3,9
Apeex,chamber-of-aspects,288,mage,frost,12,3,9
Ахиригиз,gordunni,288,mage,frost,12,3,9
Wambamm,ravencrest,288,mage,frost,12,3,9
Voraxma,draenor,288,mage,frost,12,3,9
Consquens,aszune,288,mage,frost,12,3,9
Distrophy,vashj,288,mage,frost,12,3,9
Деметрадон,gordunni,288,mage,frost,12,3,9
Tadaa,blackmoore,288,mage,frost,12,3,9
Blinkmehome,silvermoon,288,mage,frost,12,3,9
Naween,hyjal,288,mage,frost,12,3,9
Gogara,kazzak,288,mage,frost,12,3,9
Valtarisoo,amanthul,287,mage,frost,6,3,3
Wopi,sylvanas,287,mage,frost,6,3,3
Magó,eredar,287,mage,frost,6,3,3
Magjaw,twisting-nether,287,mage,frost,6,3,3
Sylênna,kazzak,287,mage,frost,9,4,5
Kasus,sporeggar,287,mage,frost,12,3,9
Rintoh,pozzo-delleternità,287,mage,frost,12,3,9
Freeto,blackmoore,286,mage,frost,6,3,3
Lìx,ravencrest,239,mage,frost,5,3,2
Rayniß,blackmoore,223,mage,frost,8,3,5
Магниффика,blackscar,192,mage,frost,6,2,4
Frostbringer,archimonde,192,mage,frost,6,2,4
Doidadetanga,aggra-português,192,mage,frost,6,2,4
Бд,blackscar,192,mage,frost,6,2,4
Nøxas,archimonde,192,mage,frost,6,2,4
Shealá,blackhand,192,mage,frost,6,2,4
Слизерин,gordunni,192,mage,frost,6,2,4
Фростидзе,gordunni,192,mage,frost,6,2,4
Ðøæø,twisting-nether,192,mage,frost,6,2,4
Ingibjorg,auchindoun,192,mage,frost,6,2,4
Maveya,blackmoore,192,mage,frost,6,2,4
Mezaiyh,blackmoore,192,mage,frost,6,2,4
Бальзамон,eversong,192,mage,frost,6,2,4
Незерёб,soulflayer,192,mage,frost,6,2,4
Озобочений,greymane,192,mage,frost,6,2,4
Laciee,silvermoon,192,mage,frost,6,2,4
Aern,sinstralis,192,mage,frost,6,2,4
Meteofrost,draenor,192,mage,frost,6,2,4
Elor,eredar,192,mage,frost,6,2,4
Rizzlybear,outland,192,mage,frost,6,2,4
Tomia,burning-legion,192,mage,frost,6,2,4
Balmak,doomhammer,192,mage,frost,6,2,4
Ehbehad,doomhammer,192,mage,frost,6,2,4
Alleii,kazzak,192,mage,frost,6,2,4
Xenodike,blackrock,192,mage,frost,6,2,4
Magenox,blackrock,192,mage,frost,6,2,4
Wracrz,argent-dawn,192,mage,frost,6,2,4
Labius,dun-modr,192,mage,frost,6,2,4
Frazztato,tarren-mill,192,mage,frost,6,2,4
Alieni,stormreaver,192,mage,frost,6,2,4
Welt,drakthul,192,mage,frost,6,2,4
Dxdxdxdxdx,drakthul,192,mage,frost,6,2,4
Blastus,ragnaros,192,mage,frost,6,2,4
Løxyy,ysondre,192,mage,frost,6,2,4
Sperow,marécage-de-zangar,192,mage,frost,6,2,4
Chíefsheep,thrall,192,mage,frost,6,2,4
Warwizz,sanguino,192,mage,frost,6,2,4
Pixlet,kazzak,192,mage,frost,6,2,4
Sebers,kazzak,192,mage,frost,6,2,4
Tygaone,tirion,192,mage,frost,6,2,4
Gameart,alexstrasza,192,mage,frost,6,2,4
Вайконд,howling-fjord,192,mage,frost,6,2,4
Estupen,sanguino,192,mage,frost,6,2,4
Etherìon,los-errantes,192,mage,frost,6,2,4
Chread,bronze-dragonflight,192,mage,frost,6,2,4
Smokedaddy,stormscale,192,mage,frost,6,2,4
Creak,blackhand,192,mage,frost,6,2,4
Lillelord,defias-brotherhood,192,mage,frost,6,2,4
Bloodymage,zenedar,192,mage,frost,6,2,4
Portnography,draenor,192,mage,frost,12,2,10
Rapidfrost,drakthul,192,mage,frost,12,2,10
Pogmage,blackrock,192,mage,frost,12,2,10
Wslyx,dun-morogh,192,mage,frost,12,2,10
Yojimbot,archimonde,192,mage,frost,12,2,10
Intêrnet,archimonde,192,mage,frost,12,2,10
Mariujana,ravencrest,192,mage,frost,12,2,10
Freezeballs,blackmoore,192,mage,frost,12,2,10
Mátraxx,silvermoon,191,mage,frost,12,2,10
Щавзорву,gordunni,159,mage,frost,5,2,3
Dødo,archimonde,159,mage,frost,5,2,3
Azadan,pozzo-delleternità,159,mage,frost,5,2,3
Kyan,burning-legion,159,mage,frost,5,2,3
Mínêrvâ,blackrock,144,mage,frost,3,3,0
Ehren,ravencrest,138,mage,frost,10,3,7
Skitsó,shadowsong,127,mage,frost,4,2,2
Dmmeforcam,archimonde,127,mage,frost,8,2,6
Markasaura,kazzak,127,mage,frost,8,2,6
Ntintsec,tarren-mill,96,mage,frost,3,2,1
Firestárter,ravencrest,96,mage,frost,3,2,1
Mutly,kazzak,96,mage,frost,3,2,1
Alphaburstqx,ragnaros,96,mage,frost,6,1,5
Xoouuboo,eredar,96,mage,frost,6,1,5
Nullso,zuljin,96,mage,frost,6,1,5
Familyfrost,thunderhorn,96,mage,frost,6,1,5
Aarcheon,kazzak,96,mage,frost,6,1,5
Squìshy,magtheridon,96,mage,frost,6,1,5
Деорро,gordunni,96,mage,frost,6,1,5
Boned,ravencrest,96,mage,frost,6,1,5
Devòna,silvermoon,96,mage,frost,6,1,5
Rilac,nordrassil,96,mage,frost,6,1,5
Rezre,stormscale,96,mage,frost,6,1,5
Dzomage,kazzak,96,mage,frost,6,1,5
Froostii,aegwynn,96,mage,frost,6,1,5
Xèrec,ysondre,96,mage,frost,6,1,5
Niladyel,hyjal,96,mage,frost,6,1,5
Teeclis,twisting-nether,96,mage,frost,6,1,5
Testoletku,twisting-nether,96,mage,frost,6,1,5
Nåzmyz,outland,96,mage,frost,6,1,5
Kaiyn,argent-dawn,96,mage,frost,6,1,5
Shizzy,onyxia,96,mage,frost,6,1,5
Fîrestorm,doomhammer,96,mage,frost,6,1,5
Karstnstenzl,blackrock,96,mage,frost,6,1,5
Elynaé,draenor,96,mage,frost,6,1,5
Larmp,outland,96,mage,frost,6,1,5
Reeroll,arthas,96,mage,frost,6,1,5
Paradigma,sylvanas,96,mage,frost,6,1,5
Колтрэйн,blackscar,96,mage,frost,6,1,5
Subtempo,silvermoon,96,mage,frost,6,1,5
Sheeptonreup,archimonde,96,mage,frost,6,1,5
Kpacey,guldan,96,mage,frost,6,1,5
Loskapaska,stormreaver,96,mage,frost,6,1,5
Nekroulis,agamaggan,96,mage,frost,6,1,5
Hruon,ravenholdt,96,mage,frost,9,1,8
Aurayaa,teldrassil,95,mage,frost,11,1,10
Milhoux,ysondre,79,mage,frost,5,1,4
Bceps,stormscale,64,mage,frost,4,1,3
Maege,ragnaros,63,mage,frost,2,2,0
Gocu,tarren-mill,63,mage,frost,2,2,0
Aeghis,darkspear,42,mage,frost,10,3,7
Yoxt,blackhand,31,mage,frost,2,1,1
Xaramael,colinas-pardas,8,mage,frost,9,3,6
Fisterino,zuljin,2304,monk,mistweaver,54,42,12
Nnsstt,zuljin,2277,monk,mistweaver,104,64,40
Bankmw,tarren-mill,2265,monk,mistweaver,77,52,25
Brickedup,twisting-nether,2246,monk,mistweaver,139,81,58
Montex,stormscale,2210,monk,mistweaver,96,53,43
Cocojones,tarren-mill,2194,monk,mistweaver,60,42,18
Ballademager,magtheridon,2173,monk,mistweaver,72,44,28
Онимэшнеца,gordunni,2170,monk,mistweaver,77,48,29
Ltmxy,ravencrest,2127,monk,mistweaver,66,40,26
Umadbrohuh,outland,2126,monk,mistweaver,66,39,27
Леолайт,borean-tundra,2124,monk,mistweaver,83,52,31
Фунтос,soulflayer,2124,monk,mistweaver,66,41,25
Çoomðragon,stormscale,2122,monk,mistweaver,42,29,13
Tryhârdx,stormscale,2122,monk,mistweaver,84,45,39
Beetlejuicé,stormscale,2118,monk,mistweaver,42,28,14
Akanetsu,kazzak,2112,monk,mistweaver,96,58,38
Joke,ragnaros,2111,monk,mistweaver,78,41,37
Teampro,ragnaros,2108,monk,mistweaver,211,120,91
Sinted,blackmoore,2103,monk,mistweaver,83,52,31
Lifelessons,blackrock,2103,monk,mistweaver,57,34,23
Mibe,alonsus,2103,monk,mistweaver,108,53,55
Flowy,uldum,2101,monk,mistweaver,60,31,29
Lylleri,darksorrow,2089,monk,mistweaver,68,40,28
Tímmz,blackrock,2088,monk,mistweaver,96,56,40
Øllen,stormscale,2062,monk,mistweaver,71,41,30
Monkeyi,silvermoon,2040,monk,mistweaver,108,57,51
Webhottie,twisting-nether,2032,monk,mistweaver,66,42,24
Pennyflame,stormscale,2026,monk,mistweaver,125,67,58
Quendiz,frostwolf,2025,monk,mistweaver,72,40,32
Bobthewild,draenor,2023,monk,mistweaver,239,120,119
Ðalvan,blackrock,2011,monk,mistweaver,78,39,39
Flandersmonk,archimonde,2008,monk,mistweaver,73,48,25
Stringg,zuljin,2005,monk,mistweaver,240,137,103
Monkeystar,archimonde,2004,monk,mistweaver,66,38,28
Beili,ravencrest,1997,monk,mistweaver,71,40,31
Кимлейн,blackscar,1995,monk,mistweaver,30,21,9
Inlakech,auchindoun,1992,monk,mistweaver,129,73,56
Mösêê,eredar,1992,monk,mistweaver,88,39,49
Brxndimonk,antonidas,1990,monk,mistweaver,63,35,28
Суммрачная,gordunni,1989,monk,mistweaver,126,79,47
Кулакх,blackscar,1982,monk,mistweaver,76,42,34
Seeyoulater,nemesis,1982,monk,mistweaver,156,79,77
Donitrivegas,blackrock,1971,monk,mistweaver,84,60,24
Skailzkrtwo,hyjal,1971,monk,mistweaver,54,33,21
Loiyh,dun-modr,1969,monk,mistweaver,72,35,37
Turricane,blackmoore,1967,monk,mistweaver,60,31,29
Shirkán,ragnaros,1961,monk,mistweaver,90,56,34
Cranex,terenas,1960,monk,mistweaver,71,43,28
Arenatwo,outland,1957,monk,mistweaver,75,48,27
Môûsè,ravencrest,1955,monk,mistweaver,36,28,8
Halùnkè,eredar,1949,monk,mistweaver,94,59,35
Commadore,draenor,1949,monk,mistweaver,60,29,31
Kêkburagol,kazzak,1938,monk,mistweaver,66,45,21
Couchfrmikea,twisting-nether,1937,monk,mistweaver,72,38,34
Pwner,daggerspine,1935,monk,mistweaver,135,75,60
Dmonkz,magtheridon,1932,monk,mistweaver,36,26,10
Voltzeig,dentarg,1930,monk,mistweaver,130,71,59
Pizzabud,ravencrest,1926,monk,mistweaver,46,31,15
Yuukiiqt,kult-der-verdammten,1925,monk,mistweaver,77,44,33
Subàru,draenor,1924,monk,mistweaver,87,58,29
Monkrah,blackmoore,1922,monk,mistweaver,48,26,22
Monkield,kazzak,1921,monk,mistweaver,99,68,31
Veganweaver,ravencrest,1917,monk,mistweaver,54,34,20
Kêkbûrâgól,kazzak,1917,monk,mistweaver,73,39,34
Шортмневноги,howling-fjord,1917,monk,mistweaver,71,37,34
Zaerin,eredar,1913,monk,mistweaver,43,24,19
Manjini,blackhand,1908,monk,mistweaver,47,27,20
Meemyo,blackmoore,1904,monk,mistweaver,83,34,49
Moariann,drakthul,1902,monk,mistweaver,120,64,56
Ouhmaikgød,dun-modr,1897,monk,mistweaver,54,30,24
Seventhirty,ravencrest,1896,monk,mistweaver,36,20,16
Muchobijca,defias-brotherhood,1891,monk,mistweaver,72,41,31
Effeots,blackrock,1878,monk,mistweaver,170,91,79
Dmonk,aegwynn,1873,monk,mistweaver,58,29,29
Bigbummer,blackmoore,1871,monk,mistweaver,90,48,42
Zeoverx,ragnaros,1869,monk,mistweaver,66,29,37
Blubberwurst,gorgonnash,1867,monk,mistweaver,64,32,32
Jiafei,tarren-mill,1862,monk,mistweaver,42,25,17
Hiryu,argent-dawn,1862,monk,mistweaver,53,31,22
Youkâi,blackrock,1859,monk,mistweaver,48,31,17
Zonsym,twisting-nether,1859,monk,mistweaver,60,32,28
Glooni,blackrock,1858,monk,mistweaver,57,33,24
Rullsimpa,ravencrest,1858,monk,mistweaver,77,34,43
Vanost,kazzak,1857,monk,mistweaver,42,24,18
Фейкнаут,soulflayer,1855,monk,mistweaver,108,57,51
Jades,emeriss,1855,monk,mistweaver,145,73,72
Zoida,azuremyst,1853,monk,mistweaver,60,33,27
Pyrìt,blackhand,1852,monk,mistweaver,36,29,7
Коконгкд,blackscar,1851,monk,mistweaver,78,43,35
Haìryplotter,kazzak,1847,monk,mistweaver,66,39,27
Alprox,moonglade,1841,monk,mistweaver,146,77,69
Musclemage,turalyon,1841,monk,mistweaver,60,31,29
Siignmonk,ravencrest,1840,monk,mistweaver,54,31,23
Neszesmonk,ragnaros,1840,monk,mistweaver,121,65,56
Tráïner,madmortem,1840,monk,mistweaver,95,51,44
Yungsooth,stormscale,1838,monk,mistweaver,53,37,16
Kratzl,blackrock,1838,monk,mistweaver,42,27,15
Pøhx,ragnaros,1837,monk,mistweaver,87,51,36
Homes,blackmoore,1837,monk,mistweaver,60,35,25
Motang,blackmoore,1833,monk,mistweaver,56,32,24
Toram,burning-legion,1833,monk,mistweaver,60,29,31
Døk,twisting-nether,1832,monk,mistweaver,30,22,8
Shonba9D659E,argent-dawn,1829,monk,mistweaver,48,30,18
Deepl,dun-modr,1829,monk,mistweaver,48,24,24
Нубстриимс,gordunni,1828,monk,mistweaver,62,33,29
Mistyfox,aszune,1828,monk,mistweaver,95,45,50
Véxyra,draenor,1827,monk,mistweaver,48,32,16
Мефодийкун,howling-fjord,1826,monk,mistweaver,108,63,45
Playbîrd,archimonde,1826,monk,mistweaver,100,54,46
Notachi,doomhammer,1825,monk,mistweaver,243,135,108
Ønlyfäns,kazzak,1824,monk,mistweaver,106,64,42
Элонхаск,gordunni,1824,monk,mistweaver,54,29,25
Swagmonk,silvermoon,1824,monk,mistweaver,56,30,26
Вульфхильда,soulflayer,1823,monk,mistweaver,150,83,67
Tigermw,twisting-nether,1821,monk,mistweaver,49,31,18
Luru,outland,1820,monk,mistweaver,53,33,20
Анстапоблх,grom,1820,monk,mistweaver,54,24,30
Perceptîon,thrall,1819,monk,mistweaver,41,23,18
Mistyhoe,twisting-nether,1818,monk,mistweaver,71,37,34
Supercoach,blackrock,1817,monk,mistweaver,87,52,35
Mugenzen,sanguino,1816,monk,mistweaver,36,19,17
Zulein,defias-brotherhood,1814,monk,mistweaver,36,21,15
Savagex,sanguino,1814,monk,mistweaver,60,32,28
Тамаз,gordunni,1814,monk,mistweaver,59,24,35
Manatoiled,draenor,1813,monk,mistweaver,36,24,12
Basilbrushxd,stormscale,1813,monk,mistweaver,48,27,21
Lünara,ambossar,1812,monk,mistweaver,72,44,28
Digzzy,draenor,1812,monk,mistweaver,57,32,25
Uwû,ravencrest,1811,monk,mistweaver,59,45,14
Onlyfist,stormscale,1811,monk,mistweaver,42,28,14
Sugermum,outland,1811,monk,mistweaver,54,31,23
Claudiå,kazzak,1811,monk,mistweaver,54,27,27
Bigbøøty,silvermoon,1810,monk,mistweaver,60,29,31
Karmasnitch,antonidas,1808,monk,mistweaver,66,38,28
Gronkr,draenor,1808,monk,mistweaver,53,27,26
Лиянь,soulflayer,1807,monk,mistweaver,96,56,40
Mobrac,twisting-nether,1807,monk,mistweaver,39,21,18
Kilograme,tarren-mill,1806,monk,mistweaver,66,36,30
Kîrânâ,eredar,1806,monk,mistweaver,54,29,25
Ранки,lich-king,1806,monk,mistweaver,60,27,33
Wwvwwvwwvwwv,ragnaros,1805,monk,mistweaver,42,19,23
Panson,twisting-nether,1804,monk,mistweaver,54,28,26
Lyashi,dalaran,1801,monk,mistweaver,54,28,26
Callysra,archimonde,1800,monk,mistweaver,42,30,12
Hurricaine,hyjal,1799,monk,mistweaver,30,19,11
Monkler,blackhand,1794,monk,mistweaver,72,34,38
Howtoown,burning-legion,1792,monk,mistweaver,36,22,14
Meliowo,ravencrest,1791,monk,mistweaver,48,28,20
Барлиос,soulflayer,1788,monk,mistweaver,162,90,72
Qwertyxo,draenor,1785,monk,mistweaver,33,23,10
Xoconut,kazzak,1785,monk,mistweaver,161,94,67
Rolxx,twisting-nether,1785,monk,mistweaver,62,31,31
Brysiqtx,aegwynn,1783,monk,mistweaver,45,26,19
Trashcarlita,eredar,1781,monk,mistweaver,36,21,15
Fùckaround,emeriss,1780,monk,mistweaver,54,33,21
Hurri,krasus,1779,monk,mistweaver,30,20,10
Shâng,blackhand,1775,monk,mistweaver,30,19,11
Stifmeister,tarren-mill,1772,monk,mistweaver,60,34,26
Milkhy,minahonda,1763,monk,mistweaver,46,26,20
Bicmex,archimonde,1763,monk,mistweaver,66,30,36
Monkdrak,eredar,1758,monk,mistweaver,33,20,13
Sniffn,ravencrest,1754,monk,mistweaver,54,35,19
Эрмилинда,gordunni,1749,monk,mistweaver,54,26,28
Porcman,archimonde,1749,monk,mistweaver,75,36,39
Trollroll,defias-brotherhood,1746,monk,mistweaver,102,56,46
Xámell,ravencrest,1746,monk,mistweaver,36,19,17
Mcscrub,ragnaros,1742,monk,mistweaver,35,24,11
Тащунаскилле,thermaplugg,1741,monk,mistweaver,50,28,22
Mwrbg,shadowsong,1740,monk,mistweaver,101,58,43
Hardi,chamber-of-aspects,1740,monk,mistweaver,67,38,29
Kóan,stormscale,1740,monk,mistweaver,60,31,29
Inuria,ravencrest,1739,monk,mistweaver,54,37,17
Vivie,destromath,1735,monk,mistweaver,36,20,16
Sinanger,dun-modr,1735,monk,mistweaver,168,92,76
Greentape,kiljaeden,1730,monk,mistweaver,42,27,15
Prototyp,burning-legion,1729,monk,mistweaver,36,23,13
Mønkeÿ,ravencrest,1723,monk,mistweaver,28,19,9
Séi,kazzak,1721,monk,mistweaver,36,18,18
Cåpybårå,outland,1718,monk,mistweaver,108,58,50
Аскмилол,deathweaver,1717,monk,mistweaver,60,35,25
Jacksa,bronze-dragonflight,1712,monk,mistweaver,84,42,42
Neisha,drakthul,1711,monk,mistweaver,42,26,16
Bammemw,archimonde,1710,monk,mistweaver,48,22,26
Tjann,stormscale,1706,monk,mistweaver,48,33,15
Babbub,tarren-mill,1704,monk,mistweaver,42,27,15
Djpunchable,blackrock,1701,monk,mistweaver,35,26,9
Pudgefeed,silvermoon,1701,monk,mistweaver,30,19,11
Donkeymønk,hyjal,1701,monk,mistweaver,129,73,56
Рендикаое,soulflayer,1701,monk,mistweaver,109,58,51
Brewnox,ragnaros,1700,monk,mistweaver,47,23,24
Æøwyn,ragnaros,1699,monk,mistweaver,36,27,9
Ziibaa,outland,1698,monk,mistweaver,42,28,14
Evad,kazzak,1698,monk,mistweaver,66,41,25
Rullefald,stormscale,1697,monk,mistweaver,84,47,37
Neash,silvermoon,1695,monk,mistweaver,42,24,18
Вакидзави,gordunni,1694,monk,mistweaver,48,31,17
Фучой,howling-fjord,1692,monk,mistweaver,57,34,23
Táuriéll,eredar,1692,monk,mistweaver,36,18,18
Fatdad,magtheridon,1687,monk,mistweaver,71,33,38
Astromune,draenor,1683,monk,mistweaver,41,24,17
Sadmw,archimonde,1679,monk,mistweaver,36,20,16
Papours,ysondre,1676,monk,mistweaver,30,22,8
Merína,ragnaros,1676,monk,mistweaver,173,90,83
Karsat,hyjal,1676,monk,mistweaver,171,88,83
Limbaskalol,dun-modr,1674,monk,mistweaver,127,59,68
Chanzey,silvermoon,1672,monk,mistweaver,108,60,48
Bullergøjen,ravencrest,1668,monk,mistweaver,78,52,26
Dearmw,silvermoon,1667,monk,mistweaver,54,31,23
Zorkev,dun-modr,1667,monk,mistweaver,95,53,42
Jingfeng,arthas,1667,monk,mistweaver,54,24,30
Shadezz,blackmoore,1665,monk,mistweaver,35,24,11
Rogvi,argent-dawn,1665,monk,mistweaver,78,34,44
Adis,nerathor,1662,monk,mistweaver,36,20,16
Encanthar,blackhand,1662,monk,mistweaver,150,82,68
Olympiiee,archimonde,1660,monk,mistweaver,203,110,93
Jabington,aegwynn,1657,monk,mistweaver,70,40,30
Репаблликуес,gordunni,1656,monk,mistweaver,34,20,14
Varyat,uldum,1656,monk,mistweaver,41,24,17
Sîono,antonidas,1655,monk,mistweaver,24,18,6
Эддрос,gordunni,1655,monk,mistweaver,66,35,31
Mangi,rexxar,1655,monk,mistweaver,72,37,35
Stramonk,nemesis,1655,monk,mistweaver,138,67,71
Meltfistqt,ravencrest,1654,monk,mistweaver,112,52,60
Birgitbuddha,gorgonnash,1652,monk,mistweaver,42,24,18
Боецкфц,soulflayer,1652,monk,mistweaver,40,21,19
Koguosa,outland,1651,monk,mistweaver,30,22,8
Skailzkrt,hyjal,1649,monk,mistweaver,43,19,24
Alë,argent-dawn,1644,monk,mistweaver,93,56,37
Imeon,dun-modr,1644,monk,mistweaver,30,18,12
Эрмонд,soulflayer,1644,monk,mistweaver,44,23,21
Unsanegodx,ravencrest,1643,monk,mistweaver,48,35,13
Áyell,archimonde,1643,monk,mistweaver,75,48,27
Нийтринно,howling-fjord,1643,monk,mistweaver,36,19,17
Wrv,kazzak,1643,monk,mistweaver,78,37,41
Pogimonkey,ragnaros,1642,monk,mistweaver,42,23,19
Hajlong,outland,1641,monk,mistweaver,42,21,21
Mer,outland,1640,monk,mistweaver,44,24,20
Fistify,destromath,1639,monk,mistweaver,24,20,4
Yoghurtz,frostmourne,1639,monk,mistweaver,36,22,14
Suliya,zuluhed,1639,monk,mistweaver,36,21,15
Timboqt,blackmoore,1638,monk,mistweaver,70,43,27
Apolskis,ravencrest,1636,monk,mistweaver,42,30,12
Extrimist,sylvanas,1635,monk,mistweaver,69,38,31
Bossmanfred,outland,1631,monk,mistweaver,48,31,17
Orcimon,draenor,1630,monk,mistweaver,30,17,13
Loobee,ravencrest,1630,monk,mistweaver,30,17,13
Onlyfunn,sanguino,1629,monk,mistweaver,36,20,16
Youssee,silvermoon,1629,monk,mistweaver,186,102,84
Seandyche,ravencrest,1628,monk,mistweaver,28,18,10
Pe,blackhand,1628,monk,mistweaver,60,34,26
Loofey,ragnaros,1627,monk,mistweaver,66,33,33
Problematic,blackmoore,1626,monk,mistweaver,30,17,13
Twistie,aegwynn,1626,monk,mistweaver,36,17,19
Chichigneux,hyjal,1625,monk,mistweaver,31,21,10
Йорита,soulflayer,1625,monk,mistweaver,30,17,13
Sâu,twisting-nether,1623,monk,mistweaver,30,17,13
Аци,blackscar,1622,monk,mistweaver,42,26,16
Ultdave,eredar,1622,monk,mistweaver,87,49,38
Swaghäuser,blackmoore,1622,monk,mistweaver,101,53,48
Kaezm,blackrock,1621,monk,mistweaver,30,20,10
Errowin,blackmoore,1621,monk,mistweaver,72,42,30
Shyheim,outland,1620,monk,mistweaver,24,20,4
Jetleê,eredar,1617,monk,mistweaver,138,71,67
Hamsster,ravencrest,1617,monk,mistweaver,60,30,30
Кулаквнос,gordunni,1616,monk,mistweaver,54,30,24
Fansolini,burning-legion,1616,monk,mistweaver,46,22,24
Kaizetsu,drakthul,1614,monk,mistweaver,36,27,9
Soulxq,blackrock,1613,monk,mistweaver,90,51,39
Magixc,drakthul,1613,monk,mistweaver,41,20,21
Твикса,soulflayer,1613,monk,mistweaver,36,17,19
Dokternelg,silvermoon,1612,monk,mistweaver,30,20,10
Sart,aerie-peak,1612,monk,mistweaver,42,22,20
Kåýðø,archimonde,1610,monk,mistweaver,72,42,30
Hokespokus,silvermoon,1605,monk,mistweaver,30,20,10
Räyh,outland,1602,monk,mistweaver,57,31,26
Chimara,kazzak,1602,monk,mistweaver,49,26,23
Zýru,ragnaros,1601,monk,mistweaver,65,38,27
Yörg,eredar,1600,monk,mistweaver,51,30,21
Nepho,twisting-nether,1596,monk,mistweaver,32,21,11
Jerymonk,tarren-mill,1595,monk,mistweaver,132,71,61
Soulring,kazzak,1595,monk,mistweaver,45,21,24
Brewstea,kazzak,1594,monk,mistweaver,66,29,37
Otemøøn,sanguino,1593,monk,mistweaver,39,22,17
Chàrràth,blackmoore,1593,monk,mistweaver,121,62,59
Elmonkodonko,draenor,1590,monk,mistweaver,30,17,13
Brüderlichke,elune,1590,monk,mistweaver,42,19,23
Бадика,howling-fjord,1589,monk,mistweaver,108,58,50
Pitrols,twisting-nether,1588,monk,mistweaver,48,28,20
Fungku,azjolnerub,1588,monk,mistweaver,61,34,27
Monkim,chogall,1585,monk,mistweaver,30,19,11
Вдыхайтуман,gordunni,1585,monk,mistweaver,90,51,39
Çz,tarren-mill,1585,monk,mistweaver,30,17,13
Слишкомхорош,thermaplugg,1580,monk,mistweaver,23,17,6
Binkote,zuljin,1577,monk,mistweaver,53,33,20
Snookzlol,aegwynn,1574,monk,mistweaver,53,31,22
Zenfir,sylvanas,1570,monk,mistweaver,50,33,17
Warsox,aegwynn,1570,monk,mistweaver,48,26,22
Orgasmix,tarren-mill,1569,monk,mistweaver,42,21,21
Nêøø,blackrock,1566,monk,mistweaver,97,68,29
Fatskeleton,stormreaver,1563,monk,mistweaver,415,196,219
Gronoz,drakthul,1562,monk,mistweaver,66,43,23
Ulns,blackrock,1559,monk,mistweaver,48,19,29
Pamtu,dun-modr,1558,monk,mistweaver,42,25,17
Òó,vashj,1558,monk,mistweaver,42,20,22
Bitbird,zirkel-des-cenarius,1557,monk,mistweaver,42,25,17
Sneeza02C0FD,ravencrest,1556,monk,mistweaver,144,82,62
Kitingbuddha,aegwynn,1556,monk,mistweaver,108,57,51
Vitnam,auchindoun,1554,monk,mistweaver,72,46,26
Sindresa,outland,1553,monk,mistweaver,48,25,23
Elvand,twisting-nether,1551,monk,mistweaver,30,17,13
Yäffa,archimonde,1550,monk,mistweaver,42,18,24
Chitea,argent-dawn,1549,monk,mistweaver,23,17,6
Macpunchy,defias-brotherhood,1545,monk,mistweaver,30,18,12
Dìó,tarren-mill,1543,monk,mistweaver,198,114,84
Endorrphine,ravencrest,1538,monk,mistweaver,80,35,45
Pembi,blades-edge,1534,monk,mistweaver,80,39,41
Wwception,blackrock,1533,monk,mistweaver,32,17,15
Smâsh,blackhand,1531,monk,mistweaver,46,32,14
Actionsusi,area-52,1531,monk,mistweaver,30,16,14
Marqinio,archimonde,1529,monk,mistweaver,30,16,14
Hôn,sanguino,1528,monk,mistweaver,23,17,6
Musashiden,twisting-nether,1525,monk,mistweaver,42,23,19
Malkaviano,kazzak,1523,monk,mistweaver,40,24,16
Plaguer,nordrassil,1519,monk,mistweaver,30,18,12
Freyas,outland,1519,monk,mistweaver,41,23,18
Dicedkiwi,quelthalas,1517,monk,mistweaver,71,43,28
Notfist,kazzak,1513,monk,mistweaver,54,35,19
Calmpalms,tarren-mill,1513,monk,mistweaver,42,23,19
Trollandroll,stormscale,1512,monk,mistweaver,30,16,14
Xiaokingqvq,silvermoon,1512,monk,mistweaver,78,41,37
Германика,soulflayer,1511,monk,mistweaver,86,43,43
Loddarita,ravencrest,1510,monk,mistweaver,36,28,8
Idrdob,kazzak,1510,monk,mistweaver,87,49,38
Melamonk,ravencrest,1508,monk,mistweaver,36,18,18
Misthera,burning-legion,1508,monk,mistweaver,60,25,35
Urbàs,blackmoore,1507,monk,mistweaver,36,25,11
Ticktak,archimonde,1506,monk,mistweaver,36,27,9
Crymonkya,aegwynn,1505,monk,mistweaver,41,27,14
Inthepoopa,outland,1505,monk,mistweaver,30,18,12
Gravityfist,aegwynn,1503,monk,mistweaver,36,18,18
Caniluvz,eredar,1501,monk,mistweaver,24,16,8
Dmonk,alakir,1501,monk,mistweaver,60,28,32
Bmane,archimonde,1499,monk,mistweaver,29,16,13
Diffenbachia,outland,1497,monk,mistweaver,33,24,9
Cykatea,dun-modr,1495,monk,mistweaver,175,94,81
Miînd,tarren-mill,1494,monk,mistweaver,48,29,19
Monkzdino,destromath,1494,monk,mistweaver,47,24,23
Eckø,rashgarroth,1487,monk,mistweaver,30,21,9
Moveietss,stormscale,1485,monk,mistweaver,18,16,2
Неэверида,deepholm,1475,monk,mistweaver,66,39,27
Rzi,amanthul,1475,monk,mistweaver,125,68,57
Grauwe,stormscale,1474,monk,mistweaver,27,17,10
Монккд,gordunni,1474,monk,mistweaver,105,58,47
Zinnout,twisting-nether,1467,monk,mistweaver,36,26,10
Hollymêdx,blackmoore,1465,monk,mistweaver,31,17,14
Njursten,twilights-hammer,1464,monk,mistweaver,153,74,79
Monkgd,sylvanas,1461,monk,mistweaver,108,64,44
Umagon,chogall,1459,monk,mistweaver,36,21,15
Pøwcow,blackrock,1459,monk,mistweaver,113,61,52
Noni,gorgonnash,1459,monk,mistweaver,65,31,34
ßojo,kazzak,1458,monk,mistweaver,39,24,15
Legsweep,blackhand,1458,monk,mistweaver,31,19,12
Kapitan,sanguino,1455,monk,mistweaver,45,27,18
Saitamä,archimonde,1453,monk,mistweaver,38,17,21
Ceeja,blackmoore,1451,monk,mistweaver,89,46,43
Watchmedamp,draenor,1450,monk,mistweaver,75,46,29
Genjosanso,kazzak,1449,monk,mistweaver,36,25,11
Heartless,sporeggar,1448,monk,mistweaver,36,28,8
Slugerpigen,stormscale,1446,monk,mistweaver,98,59,39
Civix,sanguino,1443,monk,mistweaver,98,57,41
Jemp,ravencrest,1442,monk,mistweaver,108,64,44
Vienuolè,silvermoon,1439,monk,mistweaver,24,15,9
Prettysus,silvermoon,1439,monk,mistweaver,36,21,15
Ashm,shattered-halls,1438,monk,mistweaver,30,15,15
Acidflexx,kazzak,1437,monk,mistweaver,24,16,8
Lanory,blackmoore,1433,monk,mistweaver,24,15,9
Yarie,blackmoore,1432,monk,mistweaver,66,33,33
Waramow,eredar,1431,monk,mistweaver,24,15,9
Nievah,argent-dawn,1430,monk,mistweaver,39,24,15
Setup,thrall,1430,monk,mistweaver,110,61,49
Yadokaí,darkmoon-faire,1425,monk,mistweaver,36,15,21
Cbmonk,sylvanas,1422,monk,mistweaver,24,17,7
Dudulinda,silvermoon,1422,monk,mistweaver,54,29,25
Medovic,blackmoore,1421,monk,mistweaver,114,64,50
Woushou,outland,1420,monk,mistweaver,48,31,17
Lacasyto,sanguino,1417,monk,mistweaver,18,15,3
Biftas,nagrand,1415,monk,mistweaver,27,16,11
Fistingfury,burning-blade,1415,monk,mistweaver,48,24,24
Mistsen,kazzak,1414,monk,mistweaver,81,47,34
Eugenn,alonsus,1412,monk,mistweaver,30,15,15
Kukn,twisting-nether,1412,monk,mistweaver,39,16,23
Chiuna,sylvanas,1411,monk,mistweaver,30,15,15
Thuz,kazzak,1411,monk,mistweaver,45,22,23
Самадайка,howling-fjord,1411,monk,mistweaver,50,24,26
Kroyus,antonidas,1410,monk,mistweaver,60,31,29
Амаззонния,soulflayer,1408,monk,mistweaver,54,21,33
Incapme,outland,1405,monk,mistweaver,67,39,28
Guthäxlul,khazgoroth,1405,monk,mistweaver,111,63,48
Mistïnguette,dalaran,1402,monk,mistweaver,36,24,12
Leôlulu,blackmoore,1400,monk,mistweaver,24,17,7
Orkiya,archimonde,1394,monk,mistweaver,198,102,96
Salsina,nemesis,1390,monk,mistweaver,98,54,44
Haxxo,die-nachtwache,1387,monk,mistweaver,32,22,10
Badcøwboy,archimonde,1387,monk,mistweaver,104,45,59
Pundok,blackrock,1383,monk,mistweaver,53,31,22
Okdontnerf,kazzak,1381,monk,mistweaver,30,15,15
Тевикс,gordunni,1381,monk,mistweaver,36,15,21
Allosthenos,ravencrest,1379,monk,mistweaver,27,18,9
Chikokon,silvermoon,1378,monk,mistweaver,24,17,7
Kruemelkeks,frostwolf,1378,monk,mistweaver,57,33,24
Onlyvegan,ravencrest,1375,monk,mistweaver,28,16,12
Beaglemo,blackrock,1366,monk,mistweaver,35,15,20
Krylin,antonidas,1361,monk,mistweaver,81,41,40
Ðëvx,argent-dawn,1360,monk,mistweaver,72,42,30
Ричфлекс,howling-fjord,1357,monk,mistweaver,102,59,43
Thayne,blades-edge,1354,monk,mistweaver,30,15,15
Romk,darkspear,1352,monk,mistweaver,36,25,11
Патаомальчик,blackscar,1352,monk,mistweaver,35,15,20
Demakis,stormscale,1350,monk,mistweaver,23,15,8
Gigilonis,korgall,1350,monk,mistweaver,91,47,44
Coollann,drakthul,1347,monk,mistweaver,30,15,15
Trifogeorge,archimonde,1342,monk,mistweaver,24,14,10
Zagar,emeriss,1342,monk,mistweaver,24,14,10
Xianxiaa,ravencrest,1342,monk,mistweaver,58,33,25
Vetocorleone,kazzak,1341,monk,mistweaver,101,55,46
Evelios,blackmoore,1340,monk,mistweaver,29,20,9
Tyzin,blackrock,1340,monk,mistweaver,30,17,13
Aseidith,tarren-mill,1337,monk,mistweaver,24,14,10
Kaàli,pozzo-delleternità,1337,monk,mistweaver,24,14,10
Rocknreroll,executus,1336,monk,mistweaver,30,14,16
Happymonktwo,ravencrest,1333,monk,mistweaver,24,14,10
Boomboôom,outland,1332,monk,mistweaver,24,14,10
Sajin,la-croisade-écarlate,1329,monk,mistweaver,36,15,21
Oikodomos,twisting-nether,1328,monk,mistweaver,30,14,16
Vooxis,drakthul,1323,monk,mistweaver,24,14,10
Popcornn,archimonde,1319,monk,mistweaver,36,17,19
Akalaja,alakir,1316,monk,mistweaver,34,19,15
Mistbringer,kazzak,1315,monk,mistweaver,78,37,41
Bluum,ravencrest,1315,monk,mistweaver,36,16,20
Thegrudge,dragonblight,1315,monk,mistweaver,42,16,26
Shreckmonk,burning-blade,1313,monk,mistweaver,30,14,16
Brewswíllis,tarren-mill,1312,monk,mistweaver,18,14,4
Kungfupandy,blackmoore,1312,monk,mistweaver,91,53,38
Quezatrix,ravencrest,1311,monk,mistweaver,30,15,15
Loreo,burning-legion,1310,monk,mistweaver,81,48,33
Marrave,chogall,1310,monk,mistweaver,51,19,32
Tokz,ravencrest,1309,monk,mistweaver,24,14,10
Waitaminute,outland,1308,monk,mistweaver,30,18,12
Vivir,stormreaver,1308,monk,mistweaver,43,23,20
Løsang,blackrock,1303,monk,mistweaver,68,46,22
Assfist,drakthul,1303,monk,mistweaver,63,40,23
Джоский,borean-tundra,1299,monk,mistweaver,60,23,37
Nesthorian,draenor,1297,monk,mistweaver,117,60,57
Камикадзэн,gordunni,1296,monk,mistweaver,24,15,9
Pandimaci,ragnaros,1295,monk,mistweaver,47,27,20
Ðurîmar,ravencrest,1294,monk,mistweaver,23,14,9
Zenmist,kazzak,1294,monk,mistweaver,23,14,9
Shiguru,dun-morogh,1289,monk,mistweaver,23,15,8
Mareki,nethersturm,1288,monk,mistweaver,36,18,18
Mestro,argent-dawn,1284,monk,mistweaver,80,50,30
Carnat,blackrock,1284,monk,mistweaver,30,17,13
Trivi,blackrock,1284,monk,mistweaver,39,21,18
Drboombay,kazzak,1283,monk,mistweaver,38,21,17
Nìkâ,blackmoore,1283,monk,mistweaver,51,28,23
Vladikus,tarren-mill,1283,monk,mistweaver,46,19,27
Scare,stormreaver,1280,monk,mistweaver,35,16,19
Toon,eredar,1277,monk,mistweaver,42,21,21
Ugras,auchindoun,1273,monk,mistweaver,36,14,22
Rymz,sanguino,1270,monk,mistweaver,28,17,11
Trnd,draenor,1269,monk,mistweaver,41,15,26
Mishax,draenor,1268,monk,mistweaver,78,38,40
Chainster,defias-brotherhood,1267,monk,mistweaver,64,34,30
Boredom,wildhammer,1266,monk,mistweaver,60,35,25
Szilvia,sylvanas,1263,monk,mistweaver,48,25,23
Macgyverr,outland,1258,monk,mistweaver,24,14,10
Chígoku,grim-batol,1257,monk,mistweaver,52,23,29
Трикленд,azuregos,1254,monk,mistweaver,30,15,15
Yahní,eredar,1253,monk,mistweaver,47,24,23
Supaverli,archimonde,1248,monk,mistweaver,18,13,5
Angeryw,kazzak,1248,monk,mistweaver,18,13,5
Zenzu,blackmoore,1248,monk,mistweaver,24,14,10
Bighealz,aggra-português,1248,monk,mistweaver,24,13,11
Sonydl,archimonde,1247,monk,mistweaver,22,14,8
Zevenblad,stormscale,1247,monk,mistweaver,24,13,11
Meldi,ravencrest,1247,monk,mistweaver,24,13,11
Yto,gorgonnash,1247,monk,mistweaver,24,13,11
Natsuø,nemesis,1246,monk,mistweaver,18,13,5
Egg,frostmane,1246,monk,mistweaver,24,13,11
Crñ,blackmoore,1246,monk,mistweaver,24,13,11
Йуппи,galakrond,1246,monk,mistweaver,24,13,11
Srdarr,kazzak,1246,monk,mistweaver,24,13,11
Эифорйя,howling-fjord,1246,monk,mistweaver,28,14,14
Timmzý,blackmoore,1245,monk,mistweaver,18,13,5
Taìka,archimonde,1245,monk,mistweaver,18,13,5
Uckkm,ragnaros,1244,monk,mistweaver,18,13,5
Амаранточка,howling-fjord,1244,monk,mistweaver,24,13,11
Кубермонкер,gordunni,1243,monk,mistweaver,24,13,11
Bigmckoy,kazzak,1242,monk,mistweaver,21,14,7
Mmrkick,kazzak,1241,monk,mistweaver,24,13,11
Chibuku,burning-legion,1240,monk,mistweaver,24,13,11
Факенщет,soulflayer,1239,monk,mistweaver,24,13,11
Jolude,nemesis,1239,monk,mistweaver,30,13,17
Kayen,frostwhisper,1238,monk,mistweaver,46,23,23
Baddany,sanguino,1238,monk,mistweaver,54,26,28
Yukimøn,hyjal,1232,monk,mistweaver,18,13,5
Psychocop,drakthul,1225,monk,mistweaver,30,13,17
Quendi,arthas,1224,monk,mistweaver,77,37,40
Vanquishlølz,archimonde,1222,monk,mistweaver,39,17,22
Xplosiv,twisting-nether,1220,monk,mistweaver,18,13,5
Wteg,emerald-dream,1220,monk,mistweaver,30,14,16
Mondrim,burning-legion,1218,monk,mistweaver,40,16,24
Fistus,dentarg,1214,monk,mistweaver,29,13,16
Bhasundara,turalyon,1212,monk,mistweaver,88,51,37
Monkehst,dun-modr,1210,monk,mistweaver,60,25,35
Freemann,archimonde,1204,monk,mistweaver,70,33,37
Ivi,neptulon,1197,monk,mistweaver,58,29,29
Farmander,silvermoon,1197,monk,mistweaver,42,21,21
Zenified,ragnaros,1192,monk,mistweaver,21,13,8
Larå,ravencrest,1185,monk,mistweaver,101,46,55
Jyll,malganis,1182,monk,mistweaver,23,13,10
Phrynè,silvermoon,1182,monk,mistweaver,31,16,15
Mîstxd,kazzak,1181,monk,mistweaver,17,13,4
Carloz,drakthul,1174,monk,mistweaver,30,16,14
Fistweavr,antonidas,1171,monk,mistweaver,36,14,22
Makïi,archimonde,1167,monk,mistweaver,30,16,14
Boozmoo,stormscale,1166,monk,mistweaver,22,16,6
Fulgrem,stormscale,1162,monk,mistweaver,19,13,6
Xwtdreamz,hyjal,1156,monk,mistweaver,36,14,22
Yuuhai,ravencrest,1152,monk,mistweaver,18,12,6
Подвижник,soulflayer,1151,monk,mistweaver,18,12,6
Residùe,kazzak,1151,monk,mistweaver,18,12,6
Shixen,ragnaros,1151,monk,mistweaver,24,12,12
Phyxone,twisting-nether,1151,monk,mistweaver,24,12,12
Zesha,zuljin,1151,monk,mistweaver,30,12,18
Xado,aegwynn,1150,monk,mistweaver,18,12,6
Нунтяк,gordunni,1150,monk,mistweaver,24,12,12
Гроксси,howling-fjord,1148,monk,mistweaver,22,13,9
Cubw,archimonde,1148,monk,mistweaver,24,12,12
Vanoarabidze,ravencrest,1148,monk,mistweaver,24,12,12
Aryphus,blackmoore,1148,monk,mistweaver,24,12,12
Koraxx,blackmoore,1146,monk,mistweaver,30,12,18
Namelessmist,drakthul,1145,monk,mistweaver,18,12,6
Tintatama,aszune,1143,monk,mistweaver,82,36,46
Shiftchenko,stormscale,1142,monk,mistweaver,42,24,18
Suggy,kilrogg,1139,monk,mistweaver,24,12,12
Cicera,kazzak,1138,monk,mistweaver,30,12,18
Nîcko,ravencrest,1137,monk,mistweaver,18,12,6
Riendy,silvermoon,1137,monk,mistweaver,18,12,6
Lubeï,kirin-tor,1131,monk,mistweaver,34,21,13
Graffy,eonar,1128,monk,mistweaver,18,13,5
Badonkamonk,twilights-hammer,1119,monk,mistweaver,18,12,6
Worf,haomarush,1116,monk,mistweaver,24,13,11
Tsouli,twilights-hammer,1116,monk,mistweaver,24,12,12
Milkabtw,kazzak,1100,monk,mistweaver,21,13,8
Ksll,silvermoon,1094,monk,mistweaver,24,14,10
Alphafist,argent-dawn,1093,monk,mistweaver,24,12,12
Mofisto,bladefist,1093,monk,mistweaver,36,13,23
Carcasce,la-croisade-écarlate,1089,monk,mistweaver,36,20,16
Tripitakâ,dun-modr,1085,monk,mistweaver,29,12,17
Cybert,blackmoore,1083,monk,mistweaver,23,12,11
Hvnm,ravencrest,1082,monk,mistweaver,42,22,20
Zeldrís,ragnaros,1079,monk,mistweaver,32,12,20
Adgoh,tarren-mill,1070,monk,mistweaver,17,14,3
Benzzy,ragnaros,1064,monk,mistweaver,19,12,7
Precocconx,stormreaver,1056,monk,mistweaver,18,11,7
Izuwumi,ragnaros,1056,monk,mistweaver,18,11,7
Öhlinmonk,outland,1056,monk,mistweaver,18,11,7
Фуфинус,gordunni,1056,monk,mistweaver,24,11,13
Ffxivrefugee,argent-dawn,1056,monk,mistweaver,24,11,13
Darlaa,ravencrest,1055,monk,mistweaver,18,11,7
Kakor,gorgonnash,1055,monk,mistweaver,18,11,7
Clemoine,archimonde,1055,monk,mistweaver,18,11,7
Xarêlla,aegwynn,1055,monk,mistweaver,24,11,13
Shiftkin,stormscale,1055,monk,mistweaver,24,11,13
Cochonhalall,archimonde,1055,monk,mistweaver,24,11,13
Jakethestake,twilights-hammer,1054,monk,mistweaver,12,11,1
Hærleyquin,ravencrest,1054,monk,mistweaver,18,11,7
Shàká,stormscale,1052,monk,mistweaver,12,11,1
Pepesmacks,kazzak,1052,monk,mistweaver,18,11,7
Mankee,kazzak,1052,monk,mistweaver,26,11,15
Basthek,blackhand,1052,monk,mistweaver,30,11,19
Lambofmonkz,stormscale,1052,monk,mistweaver,36,11,25
Eynodiggity,blackmoore,1050,monk,mistweaver,24,11,13
Puddinpop,auchindoun,1049,monk,mistweaver,24,11,13
Sydras,silvermoon,1049,monk,mistweaver,60,27,33
Fisticuffs,tarren-mill,1048,monk,mistweaver,24,11,13
Onlyfísts,stormscale,1047,monk,mistweaver,30,11,19
Brünó,kazzak,1046,monk,mistweaver,33,22,11
Maiver,stormscale,1046,monk,mistweaver,18,11,7
Mjaweaver,stormscale,1046,monk,mistweaver,62,23,39
Mcronald,blackhand,1041,monk,mistweaver,22,14,8
Monkypunch,tarren-mill,1039,monk,mistweaver,28,12,16
Фапдао,howling-fjord,1039,monk,mistweaver,33,12,21
Kungfubatti,stormscale,1034,monk,mistweaver,24,11,13
Drpajhiwo,burning-legion,1027,monk,mistweaver,18,11,7
Dèathpunch,doomhammer,1025,monk,mistweaver,54,26,28
Ugotcraned,tarren-mill,1019,monk,mistweaver,72,27,45
Birdymonk,boulderfist,1009,monk,mistweaver,36,22,14
Kurbanov,stormscale,1008,monk,mistweaver,21,11,10
Mwmkgodxz,archimonde,1007,monk,mistweaver,15,12,3
Апесиинка,gordunni,1002,monk,mistweaver,24,11,13
Zenchî,ysondre,1001,monk,mistweaver,22,13,9
Celestine,mugthol,998,monk,mistweaver,54,25,29
Kégman,silvermoon,992,monk,mistweaver,33,18,15
Lucebree,nozdormu,990,monk,mistweaver,42,15,27
Лалафест,soulflayer,987,monk,mistweaver,22,11,11
Heäléna,ragnaros,979,monk,mistweaver,21,15,6
Glaphan,the-maelstrom,960,monk,mistweaver,12,10,2
Ipmonk,outland,960,monk,mistweaver,12,10,2
Dihsa,ragnaros,960,monk,mistweaver,12,10,2
Ofwgkta,moonglade,960,monk,mistweaver,18,10,8
Ashenore,outland,960,monk,mistweaver,18,10,8
Darkmonkky,tarren-mill,960,monk,mistweaver,18,10,8
Ræïzò,dun-morogh,960,monk,mistweaver,18,10,8
Xoleck,aegwynn,960,monk,mistweaver,24,10,14
Jeññie,stormscale,959,monk,mistweaver,12,10,2
Mimimatrick,hyjal,959,monk,mistweaver,12,10,2
Citamonk,blackmoore,959,monk,mistweaver,12,10,2
Mâjô,blackhand,959,monk,mistweaver,18,10,8
Zlodey,laughing-skull,959,monk,mistweaver,18,10,8
Pikemi,dun-modr,959,monk,mistweaver,18,10,8
Brewmâster,kazzak,958,monk,mistweaver,18,10,8
Búns,draenor,958,monk,mistweaver,18,10,8
Yotke,ravencrest,958,monk,mistweaver,18,10,8
Bigballs,ysera,958,monk,mistweaver,24,10,14
Panicfist,stormscale,957,monk,mistweaver,18,10,8
Karoou,kelthuzad,957,monk,mistweaver,24,10,14
Rheinair,antonidas,956,monk,mistweaver,24,10,14
Gråce,nemesis,954,monk,mistweaver,12,10,2
Monkyd,stormscale,950,monk,mistweaver,18,10,8
Ariä,marécage-de-zangar,930,monk,mistweaver,24,13,11
Loctak,nathrezim,911,monk,mistweaver,18,12,6
Dícxi,ravencrest,910,monk,mistweaver,17,10,7
Keeba,kirin-tor,907,monk,mistweaver,125,58,67
Tierrax,cthun,906,monk,mistweaver,22,12,10
Behrens,defias-brotherhood,905,monk,mistweaver,21,11,10
Shimmichanga,blackrock,895,monk,mistweaver,17,10,7
Changzu,sanguino,894,monk,mistweaver,30,15,15
Kelechi,stormreaver,894,monk,mistweaver,20,10,10
Мишапяточка,howling-fjord,890,monk,mistweaver,12,11,1
Eclipsè,dragonmaw,889,monk,mistweaver,17,10,7
Влажныйтач,soulflayer,879,monk,mistweaver,13,10,3
Тиктокмонк,gordunni,877,monk,mistweaver,20,11,9
Iixil,sylvanas,864,monk,mistweaver,12,9,3
Remyhadley,dun-modr,864,monk,mistweaver,12,9,3
Roadrunnér,ravencrest,864,monk,mistweaver,12,9,3
Фунтих,soulflayer,864,monk,mistweaver,12,9,3
Belärus,outland,864,monk,mistweaver,18,9,9
Jiest,outland,864,monk,mistweaver,18,9,9
Pizelx,alakir,864,monk,mistweaver,18,9,9
Kebabrolle,blackrock,864,monk,mistweaver,18,9,9
Ultrasense,outland,864,monk,mistweaver,18,9,9
Polch,archimonde,864,monk,mistweaver,18,9,9
Pafia,ysondre,864,monk,mistweaver,18,9,9
Luvmollý,silvermoon,864,monk,mistweaver,24,9,15
Balia,blackrock,864,monk,mistweaver,24,9,15
Pô,sanguino,863,monk,mistweaver,12,9,3
Shabaz,draenor,863,monk,mistweaver,12,9,3
Simonex,ravencrest,863,monk,mistweaver,12,9,3
Schane,zuluhed,863,monk,mistweaver,12,9,3
Kattlåda,darkspear,863,monk,mistweaver,18,9,9
Kyleestrutt,stormscale,863,monk,mistweaver,18,9,9
Monkwithlove,blackhand,863,monk,mistweaver,18,9,9
Shokko,uldaman,863,monk,mistweaver,18,9,9
Nimander,burning-legion,863,monk,mistweaver,18,9,9
Nirexi,blackrock,863,monk,mistweaver,21,10,11
Konexzx,blackmoore,861,monk,mistweaver,12,9,3
Mwsama,stormscale,861,monk,mistweaver,12,9,3
Zukatan,tarren-mill,861,monk,mistweaver,18,9,9
Oddessa,ravenholdt,860,monk,mistweaver,12,9,3
Yèna,pozzo-delleternità,860,monk,mistweaver,24,9,15
Herdom,blackmoore,856,monk,mistweaver,12,9,3
Blackmonk,chromaggus,852,monk,mistweaver,18,9,9
Cudworth,silvermoon,850,monk,mistweaver,12,9,3
Bobbyknuckls,ravencrest,850,monk,mistweaver,30,9,21
ßæutiful,silvermoon,835,monk,mistweaver,30,13,17
Sheishot,kazzak,829,monk,mistweaver,20,10,10
Santoron,baelgun,816,monk,mistweaver,27,9,18
Melysà,antonidas,815,monk,mistweaver,17,9,8
Drugashe,archimonde,815,monk,mistweaver,23,9,14
Tèam,defias-brotherhood,810,monk,mistweaver,15,9,6
Extaszeh,turalyon,802,monk,mistweaver,17,11,6
Nyrkkiseski,outland,799,monk,mistweaver,11,9,2
Dipdop,blackhand,788,monk,mistweaver,33,10,23
Lmnsx,ravencrest,768,monk,mistweaver,12,8,4
Xadoqt,aegwynn,768,monk,mistweaver,12,8,4
Zødiac,quelthalas,768,monk,mistweaver,12,8,4
Jiuhjitsu,blackmoore,768,monk,mistweaver,12,8,4
Brutamonk,blackmoore,768,monk,mistweaver,12,8,4
Miamalkøva,nemesis,768,monk,mistweaver,12,8,4
Shyrea,nazjatar,768,monk,mistweaver,12,8,4
Mástermônkèy,tarren-mill,768,monk,mistweaver,12,8,4
Botweaver,tarren-mill,768,monk,mistweaver,12,8,4
Ikuyaa,ravencrest,768,monk,mistweaver,12,8,4
Fckisrael,archimonde,768,monk,mistweaver,12,8,4
Kirkeý,ravencrest,768,monk,mistweaver,12,8,4
Ryx,twisting-nether,768,monk,mistweaver,18,8,10
Adamlól,tarren-mill,768,monk,mistweaver,18,8,10
Ronkingkong,ravencrest,768,monk,mistweaver,18,8,10
Nsq,ravencrest,768,monk,mistweaver,18,8,10
Tøxicweaver,kazzak,768,monk,mistweaver,18,8,10
Moistweaver,hellfire,767,monk,mistweaver,12,8,4
Гачитварина,galakrond,767,monk,mistweaver,12,8,4
Tanyà,hyjal,767,monk,mistweaver,12,8,4
Lin,nathrezim,767,monk,mistweaver,12,8,4
Leblatt,blackhand,767,monk,mistweaver,12,8,4
Мистхоррор,gordunni,767,monk,mistweaver,12,8,4
Gízmö,tarren-mill,767,monk,mistweaver,18,8,10
Saduh,thrall,767,monk,mistweaver,18,8,10
Syyrø,silvermoon,767,monk,mistweaver,24,8,16
Qî,ravencrest,767,monk,mistweaver,24,8,16
Moohamood,argent-dawn,767,monk,mistweaver,24,8,16
Riip,ysondre,766,monk,mistweaver,12,8,4
Индоран,howling-fjord,766,monk,mistweaver,12,8,4
Nela,sanguino,766,monk,mistweaver,18,8,10
Hersmonk,drakthul,765,monk,mistweaver,12,8,4
Lûxz,ragnaros,765,monk,mistweaver,18,8,10
Gammelbruno,azshara,763,monk,mistweaver,12,8,4
Pekinn,sanguino,761,monk,mistweaver,18,8,10
Wangho,magtheridon,760,monk,mistweaver,24,8,16
Ляосинь,deepholm,758,monk,mistweaver,18,8,10
Hidekami,archimonde,702,monk,mistweaver,22,8,14
Mjoo,blackrock,672,monk,mistweaver,12,7,5
Xdhehehexd,twisting-nether,672,monk,mistweaver,12,7,5
Merçury,dun-morogh,672,monk,mistweaver,12,7,5
Dodomino,archimonde,672,monk,mistweaver,12,7,5
Shkorwi,drakthul,672,monk,mistweaver,12,7,5
Frajer,auchindoun,672,monk,mistweaver,12,7,5
Hessuzen,stormreaver,672,monk,mistweaver,12,7,5
Coularx,stormscale,672,monk,mistweaver,12,7,5
Kushvendorx,silvermoon,672,monk,mistweaver,12,7,5
Fugmonk,ravencrest,672,monk,mistweaver,12,7,5
Mêshuggâh,malganis,672,monk,mistweaver,12,7,5
Bekachu,ragnaros,672,monk,mistweaver,12,7,5
Dollyqt,ravencrest,672,monk,mistweaver,12,7,5
Йомо,borean-tundra,672,monk,mistweaver,12,7,5
Yulon,blackrock,672,monk,mistweaver,12,7,5
Bamiegoreng,aegwynn,672,monk,mistweaver,12,7,5
Monkel,frostwolf,672,monk,mistweaver,12,7,5
Quendi,frostwolf,672,monk,mistweaver,12,7,5
Prismaticx,ravencrest,672,monk,mistweaver,12,7,5
Flexify,outland,672,monk,mistweaver,12,7,5
Ana,eredar,672,monk,mistweaver,12,7,5
Tøwtc,outland,672,monk,mistweaver,12,7,5
Mommymonk,outland,672,monk,mistweaver,12,7,5
Numpys,sanguino,672,monk,mistweaver,12,7,5
Linshai,eredar,672,monk,mistweaver,12,7,5
Abdulhealer,stormscale,672,monk,mistweaver,18,7,11
Stdzym,tarren-mill,672,monk,mistweaver,18,7,11
Yumhai,dun-modr,672,monk,mistweaver,18,7,11
Scz,draenor,672,monk,mistweaver,18,7,11
Leïsha,ysondre,672,monk,mistweaver,18,7,11
Almonkdiga,sanguino,672,monk,mistweaver,18,7,11
Dumplings,earthen-ring,671,monk,mistweaver,12,7,5
Кисеч,soulflayer,671,monk,mistweaver,12,7,5
Anadia,blackrock,671,monk,mistweaver,12,7,5
Chigee,kazzak,671,monk,mistweaver,12,7,5
Lazuros,auchindoun,671,monk,mistweaver,18,7,11
Rebekko,pozzo-delleternità,671,monk,mistweaver,18,7,11
Uncleheal,tarren-mill,671,monk,mistweaver,18,7,11
Jarô,silvermoon,671,monk,mistweaver,24,7,17
Tokkz,eredar,670,monk,mistweaver,10,8,2
Zendyy,argent-dawn,670,monk,mistweaver,12,7,5
Bréwsléé,ragnaros,670,monk,mistweaver,12,7,5
Torqualis,kazzak,669,monk,mistweaver,18,7,11
Enceladion,burning-legion,662,monk,mistweaver,24,7,17
Fistarfrans,sylvanas,639,monk,mistweaver,8,8,0
Klischi,taerar,639,monk,mistweaver,17,7,10
Monknice,sylvanas,639,monk,mistweaver,17,7,10
Chucknorrís,kilrogg,624,monk,mistweaver,15,7,8
Akkadianx,ravencrest,623,monk,mistweaver,17,7,10
Chìless,shadowsong,576,monk,mistweaver,6,6,0
Redundänt,kazzak,576,monk,mistweaver,6,6,0
Fisterinos,blackrock,576,monk,mistweaver,6,6,0
Lilithrevan,frostmourne,576,monk,mistweaver,6,6,0
Кувырбек,howling-fjord,576,monk,mistweaver,6,6,0
Mørbradgryde,silvermoon,576,monk,mistweaver,12,6,6
Akuuji,silvermoon,576,monk,mistweaver,12,6,6
Vàlky,outland,576,monk,mistweaver,12,6,6
Visk,blackmoore,576,monk,mistweaver,12,6,6
Poohya,silvermoon,576,monk,mistweaver,12,6,6
Telder,sylvanas,576,monk,mistweaver,12,6,6
Bigkim,khadgar,576,monk,mistweaver,12,6,6
Iliketofist,ravencrest,576,monk,mistweaver,12,6,6
Potkuri,stormreaver,576,monk,mistweaver,12,6,6
Ygêrne,archimonde,576,monk,mistweaver,12,6,6
Mahøni,malganis,576,monk,mistweaver,12,6,6
Féfè,archimonde,576,monk,mistweaver,12,6,6
Aritisi,tarren-mill,576,monk,mistweaver,12,6,6
Mistur,blackrock,576,monk,mistweaver,12,6,6
Kæmará,blackrock,576,monk,mistweaver,12,6,6
Annoyingtwo,archimonde,576,monk,mistweaver,12,6,6
Musaya,chamber-of-aspects,576,monk,mistweaver,12,6,6
Vedak,stormreaver,576,monk,mistweaver,12,6,6
Cøcøøn,blackrock,576,monk,mistweaver,12,6,6
Goamix,ravencrest,576,monk,mistweaver,12,6,6
Maybeexm,ravencrest,576,monk,mistweaver,12,6,6
Pivomamrad,drakthul,576,monk,mistweaver,12,6,6
Oiorie,twisting-nether,576,monk,mistweaver,12,6,6
Aromipesäx,outland,576,monk,mistweaver,12,6,6
Mbynxtlife,draenor,576,monk,mistweaver,12,6,6
Коумана,gordunni,576,monk,mistweaver,15,7,8
Loiythree,dun-modr,576,monk,mistweaver,18,6,12
Itsthemonkky,tarren-mill,576,monk,mistweaver,24,6,18
Heyami,ravencrest,576,monk,mistweaver,24,6,18
Tojokirumi,dalaran,575,monk,mistweaver,6,6,0
Rakowo,arthas,575,monk,mistweaver,12,6,6
Mistréss,silvermoon,575,monk,mistweaver,12,6,6
Tily,stormreaver,575,monk,mistweaver,12,6,6
Zøubida,draenor,575,monk,mistweaver,12,6,6
Samie,ravencrest,575,monk,mistweaver,12,6,6
Drlyn,blackmoore,575,monk,mistweaver,12,6,6
Vexzen,tarren-mill,575,monk,mistweaver,12,6,6
Painswîft,blackhand,575,monk,mistweaver,18,6,12
Mulana,sanguino,575,monk,mistweaver,18,6,12
Yeetkunmeep,outland,575,monk,mistweaver,18,6,12
Othalain,silvermoon,574,monk,mistweaver,12,6,6
Gârdt,blackmoore,573,monk,mistweaver,6,6,0
Zedruu,tarren-mill,571,monk,mistweaver,12,6,6
Xalyà,archimonde,556,monk,mistweaver,14,8,6
Psychö,zuljin,538,monk,mistweaver,17,6,11
Trymax,blackmoore,522,monk,mistweaver,17,7,10
Maikez,stormreaver,512,monk,mistweaver,16,6,10
Ûnknöw,archimonde,511,monk,mistweaver,8,6,2
Tarzaki,hyjal,494,monk,mistweaver,13,6,7
Astolfochan,silvermoon,480,monk,mistweaver,6,5,1
Habmit,ravencrest,480,monk,mistweaver,6,5,1
Zappikmonk,silvermoon,480,monk,mistweaver,6,5,1
Sio,dentarg,480,monk,mistweaver,6,5,1
Kaowar,nerzhul,480,monk,mistweaver,6,5,1
Pafia,sargeras,480,monk,mistweaver,6,5,1
Uao,tarren-mill,480,monk,mistweaver,6,5,1
Blinkër,sanguino,480,monk,mistweaver,6,5,1
Хэйхати,gordunni,480,monk,mistweaver,6,5,1
Керизз,gordunni,480,monk,mistweaver,6,5,1
Holyrop,aegwynn,480,monk,mistweaver,6,5,1
Fistpunk,kazzak,480,monk,mistweaver,6,5,1
Niborc,doomhammer,480,monk,mistweaver,6,5,1
Cattleyah,ysondre,480,monk,mistweaver,6,5,1
Applestrûdel,blackrock,480,monk,mistweaver,6,5,1
Павнмонкх,gordunni,480,monk,mistweaver,6,5,1
Blamethegame,hyjal,480,monk,mistweaver,6,5,1
Sloopkogel,tarren-mill,480,monk,mistweaver,6,5,1
Lovange,silvermoon,480,monk,mistweaver,6,5,1
Stromon,silvermoon,480,monk,mistweaver,6,5,1
Djsnake,blackrock,480,monk,mistweaver,6,5,1
Такиера,gordunni,480,monk,mistweaver,6,5,1
Ohmegah,frostmane,480,monk,mistweaver,6,5,1
Dukhi,kazzak,480,monk,mistweaver,6,5,1
Jackål,silvermoon,480,monk,mistweaver,9,6,3
Tîptap,blackrock,480,monk,mistweaver,12,5,7
Brewzleè,ravencrest,480,monk,mistweaver,12,5,7
Folfimo,silvermoon,480,monk,mistweaver,12,5,7
Лолидевочка,soulflayer,480,monk,mistweaver,12,5,7
Bountyño,dun-modr,480,monk,mistweaver,12,5,7
Erapanzon,nemesis,480,monk,mistweaver,12,5,7
Minervaez,grim-batol,480,monk,mistweaver,12,5,7
Simòna,dun-modr,480,monk,mistweaver,12,5,7
Erandja,silvermoon,480,monk,mistweaver,12,5,7
Siezlebabo,blackrock,480,monk,mistweaver,12,5,7
Holyropx,aegwynn,480,monk,mistweaver,12,5,7
Kandislee,ravencrest,480,monk,mistweaver,12,5,7
Jacm,blackhand,480,monk,mistweaver,12,5,7
Gemil,argent-dawn,480,monk,mistweaver,12,5,7
Pandacus,silvermoon,480,monk,mistweaver,12,5,7
Zóma,ragnaros,480,monk,mistweaver,12,5,7
Diabolùs,blackmoore,480,monk,mistweaver,18,5,13
Whytoosxy,silvermoon,480,monk,mistweaver,18,5,13
Madraven,ravencrest,480,monk,mistweaver,18,5,13
Patiencebro,archimonde,480,monk,mistweaver,18,5,13
Sotqyy,stormscale,479,monk,mistweaver,12,5,7
Jackamonk,kazzak,479,monk,mistweaver,12,5,7
Jumper,xavius,479,monk,mistweaver,12,5,7
Bensó,stormscale,478,monk,mistweaver,6,5,1
Toaborsten,tarren-mill,478,monk,mistweaver,6,5,1
Mistyheals,nagrand,474,monk,mistweaver,12,5,7
Jsuispasheal,dalaran,473,monk,mistweaver,12,5,7
Filomenata,rexxar,469,monk,mistweaver,19,5,14
Pìmpìnelle,garona,432,monk,mistweaver,9,6,3
Dræk,twisting-nether,426,monk,mistweaver,19,6,13
Годъяр,gordunni,415,monk,mistweaver,8,5,3
Bhrag,die-aldor,384,monk,mistweaver,6,4,2
Якунка,soulflayer,384,monk,mistweaver,6,4,2
Zanizu,blackhand,384,monk,mistweaver,6,4,2
Эрумонк,gordunni,384,monk,mistweaver,6,4,2
Alomonk,archimonde,384,monk,mistweaver,6,4,2
Jemijedno,drakthul,384,monk,mistweaver,6,4,2
Monkersquad,doomhammer,384,monk,mistweaver,6,4,2
Nêrfmeta,kazzak,384,monk,mistweaver,6,4,2
Trancendent,silvermoon,384,monk,mistweaver,6,4,2
Ryac,defias-brotherhood,384,monk,mistweaver,6,4,2
Глитч,deepholm,384,monk,mistweaver,6,4,2
Camlen,draenor,384,monk,mistweaver,6,4,2
Katmunk,kazzak,384,monk,mistweaver,6,4,2
Naìsh,arygos,384,monk,mistweaver,6,4,2
Erannas,turalyon,384,monk,mistweaver,6,4,2
Valdaras,runetotem,384,monk,mistweaver,6,4,2
Latify,todeswache,384,monk,mistweaver,6,4,2
Bratana,dun-morogh,384,monk,mistweaver,6,4,2
Xurf,draenor,384,monk,mistweaver,6,4,2
Mushush,draenor,384,monk,mistweaver,6,4,2
Bigflex,conseil-des-ombres,384,monk,mistweaver,6,4,2
Highline,draenor,384,monk,mistweaver,6,4,2
Bréwmáster,silvermoon,384,monk,mistweaver,6,4,2
Yuyuni,laughing-skull,384,monk,mistweaver,6,4,2
Ennamoly,blackmoore,384,monk,mistweaver,6,4,2
Муррчалкин,howling-fjord,384,monk,mistweaver,6,4,2
Леобтв,soulflayer,384,monk,mistweaver,6,4,2
Nulojeu,archimonde,384,monk,mistweaver,6,4,2
Callim,blackrock,384,monk,mistweaver,6,4,2
Enveløp,stormscale,384,monk,mistweaver,6,4,2
Peaceweaver,ravencrest,384,monk,mistweaver,6,4,2
Barracüs,dun-modr,384,monk,mistweaver,6,4,2
Yoogychi,ravencrest,384,monk,mistweaver,6,4,2
Foaqer,aegwynn,384,monk,mistweaver,6,4,2
Sugra,frostwolf,384,monk,mistweaver,6,4,2
Lizardspock,hyjal,384,monk,mistweaver,6,4,2
Kickin,burning-legion,384,monk,mistweaver,6,4,2
Escopetin,los-errantes,384,monk,mistweaver,6,4,2
Brxmonki,antonidas,384,monk,mistweaver,6,4,2
Dath,outland,384,monk,mistweaver,6,4,2
Missislee,aegwynn,384,monk,mistweaver,6,4,2
Nillebpgodx,kazzak,384,monk,mistweaver,6,4,2
Gangichi,blackhand,384,monk,mistweaver,9,5,4
Irishdëmon,ravencrest,384,monk,mistweaver,10,4,6
Gakunie,blackhand,384,monk,mistweaver,12,4,8
Монкиннияя,gordunni,384,monk,mistweaver,12,4,8
Nebelwandler,blackhand,384,monk,mistweaver,12,4,8
Woofi,tarren-mill,384,monk,mistweaver,12,4,8
Dromarch,dun-modr,384,monk,mistweaver,12,4,8
Audaz,dun-modr,384,monk,mistweaver,12,4,8
Akùmawíns,archimonde,384,monk,mistweaver,12,4,8
Shiesel,draenor,384,monk,mistweaver,12,4,8
Invsionrush,crushridge,384,monk,mistweaver,12,4,8
Daitaro,ravencrest,384,monk,mistweaver,12,4,8
Eth,nagrand,384,monk,mistweaver,12,4,8
Тсайм,howling-fjord,384,monk,mistweaver,12,4,8
Сукавкимоно,soulflayer,383,monk,mistweaver,6,4,2
Xentimus,kazzak,383,monk,mistweaver,12,4,8
Senseithai,trollbane,383,monk,mistweaver,12,4,8
Fkflying,defias-brotherhood,381,monk,mistweaver,12,4,8
Geeberz,twisting-nether,380,monk,mistweaver,12,4,8
Matrim,arathor,351,monk,mistweaver,8,5,3
Chiá,tarren-mill,351,monk,mistweaver,11,4,7
Zaalleh,draenor,319,monk,mistweaver,5,4,1
Ilikeducks,ravencrest,319,monk,mistweaver,5,4,1
Strillen,twisting-nether,304,monk,mistweaver,7,4,3
Atommyran,frostmane,288,monk,mistweaver,6,3,3
Mistless,ragnaros,288,monk,mistweaver,6,3,3
Stolas,spinebreaker,288,monk,mistweaver,6,3,3
Chakuro,ravencrest,288,monk,mistweaver,6,3,3
Cheriedevile,drakthul,288,monk,mistweaver,6,3,3
Wisebeb,les-clairvoyants,288,monk,mistweaver,6,3,3
Domedagsdamp,draenor,288,monk,mistweaver,6,3,3
Xanderpowa,sanguino,288,monk,mistweaver,6,3,3
Leikô,grim-batol,288,monk,mistweaver,6,3,3
Shoskio,chamber-of-aspects,288,monk,mistweaver,6,3,3
Киликххл,deathguard,288,monk,mistweaver,6,3,3
Córporation,outland,288,monk,mistweaver,6,3,3
Relentlessly,blackrock,288,monk,mistweaver,6,3,3
Mecin,ragnaros,288,monk,mistweaver,6,3,3
Uggs,hyjal,288,monk,mistweaver,6,3,3
Rhatid,twisting-nether,288,monk,mistweaver,6,3,3
Bullbøx,chamber-of-aspects,288,monk,mistweaver,6,3,3
Räpeltäjä,stormreaver,288,monk,mistweaver,6,3,3
Koba,frostwolf,288,monk,mistweaver,6,3,3
Vingurd,terokkar,288,monk,mistweaver,6,3,3
Fairhand,emerald-dream,288,monk,mistweaver,6,3,3
Коррелир,howling-fjord,288,monk,mistweaver,6,3,3
Windspiritt,ragnaros,288,monk,mistweaver,6,3,3
Coalsack,outland,288,monk,mistweaver,6,3,3
Threesíxníne,dun-morogh,288,monk,mistweaver,6,3,3
Boomshaq,defias-brotherhood,288,monk,mistweaver,6,3,3
Saneshayne,ravencrest,288,monk,mistweaver,6,3,3
Lp,mugthol,288,monk,mistweaver,6,3,3
Loempia,outland,288,monk,mistweaver,6,3,3
Fistwave,malganis,288,monk,mistweaver,6,3,3
Chazu,outland,288,monk,mistweaver,6,3,3
Lassador,onyxia,288,monk,mistweaver,6,3,3
Píco,gorgonnash,288,monk,mistweaver,6,3,3
Heramonk,dun-modr,288,monk,mistweaver,6,3,3
Louiemon,outland,288,monk,mistweaver,6,3,3
Kylâas,die-ewige-wacht,288,monk,mistweaver,6,3,3
Moinalisaa,outland,288,monk,mistweaver,6,3,3
Lanuia,aegwynn,288,monk,mistweaver,6,3,3
Timmyßênz,kaelthas,288,monk,mistweaver,6,3,3
Kätelyys,dun-modr,288,monk,mistweaver,6,3,3
Mickeyworms,archimonde,288,monk,mistweaver,6,3,3
Fettakules,eredar,288,monk,mistweaver,6,3,3
Chisurgeon,outland,288,monk,mistweaver,6,3,3
Perikencito,dun-modr,288,monk,mistweaver,6,3,3
Kaizenthor,runetotem,288,monk,mistweaver,6,3,3
Dråf,ysondre,288,monk,mistweaver,6,3,3
Мирюзаки,gordunni,288,monk,mistweaver,6,3,3
Crommul,burning-legion,288,monk,mistweaver,6,3,3
Родо,blackscar,288,monk,mistweaver,6,3,3
Tiddor,burning-legion,288,monk,mistweaver,6,3,3
Totemlygodx,alakir,288,monk,mistweaver,6,3,3
Saáru,argent-dawn,288,monk,mistweaver,6,3,3
Zyrosmonk,blackmoore,288,monk,mistweaver,6,3,3
Rípple,alakir,288,monk,mistweaver,6,3,3
Baisi,blackhand,288,monk,mistweaver,6,3,3
Kbwser,silvermoon,288,monk,mistweaver,6,3,3
Bóber,kazzak,288,monk,mistweaver,6,3,3
Askmeout,ravencrest,288,monk,mistweaver,7,3,4
Brewdooms,laughing-skull,288,monk,mistweaver,12,3,9
Olîvê,ravencrest,288,monk,mistweaver,12,3,9
Tossen,ragnaros,288,monk,mistweaver,12,3,9
Jinora,theradras,288,monk,mistweaver,12,3,9
Løkî,culte-de-la-rive-noire,288,monk,mistweaver,12,3,9
Justfistyoux,archimonde,288,monk,mistweaver,12,3,9
Jetchi,twisting-nether,287,monk,mistweaver,6,3,3
Brizs,outland,287,monk,mistweaver,6,3,3
Ryanshazier,eredar,287,monk,mistweaver,6,3,3
Bo,malorne,287,monk,mistweaver,6,3,3
Hanumahn,kilrogg,287,monk,mistweaver,12,3,9
Papermakerx,blackrock,256,monk,mistweaver,4,4,0
Trlmøna,gorgonnash,240,monk,mistweaver,9,4,5
Pikajeww,kazzak,239,monk,mistweaver,5,3,2
Арнольдовна,blackscar,234,monk,mistweaver,17,4,13
Colita,kazzak,233,monk,mistweaver,16,5,11
Acbcz,draenor,192,monk,mistweaver,6,2,4
Sînge,archimonde,192,monk,mistweaver,6,2,4
Discoelysia,outland,192,monk,mistweaver,6,2,4
Тэсси,blackscar,192,monk,mistweaver,6,2,4
Fistmeg,grim-batol,192,monk,mistweaver,6,2,4
Zywoo,emerald-dream,192,monk,mistweaver,6,2,4
Siouxxsie,thunderhorn,192,monk,mistweaver,6,2,4
Exbuddhist,outland,192,monk,mistweaver,6,2,4
Зараз,gordunni,192,monk,mistweaver,6,2,4
Jetsweep,kazzak,192,monk,mistweaver,6,2,4
Dennismansix,sylvanas,192,monk,mistweaver,6,2,4
Dunkfjås,stormscale,192,monk,mistweaver,6,2,4
Espectrå,dun-modr,192,monk,mistweaver,6,2,4
Mouhous,hellscream,192,monk,mistweaver,6,2,4
Syy,medivh,192,monk,mistweaver,6,2,4
Kûngfu,tarren-mill,192,monk,mistweaver,6,2,4
Bakersdozen,tarren-mill,192,monk,mistweaver,6,2,4
Kapud,twisting-nether,192,monk,mistweaver,6,2,4
Merlyñ,blackmoore,192,monk,mistweaver,6,2,4
Fisterxd,blackrock,192,monk,mistweaver,6,2,4
Люсилью,howling-fjord,192,monk,mistweaver,6,2,4
Trippyv,ragnaros,192,monk,mistweaver,6,2,4
Scorpìon,blackrock,192,monk,mistweaver,6,2,4
Loveít,blackrock,192,monk,mistweaver,6,2,4
Saintmoon,drakthul,192,monk,mistweaver,6,2,4
Auaaua,ravencrest,192,monk,mistweaver,6,2,4
Tøngpø,argent-dawn,192,monk,mistweaver,6,2,4
Rgkekw,dun-modr,192,monk,mistweaver,6,2,4
Jadefain,argent-dawn,192,monk,mistweaver,6,2,4
Yinsho,stormscale,192,monk,mistweaver,6,2,4
Mystize,shattered-hand,192,monk,mistweaver,6,2,4
Dalaipyjama,quelthalas,192,monk,mistweaver,6,2,4
Kmorhin,antonidas,192,monk,mistweaver,6,2,4
Domingovivas,dun-modr,192,monk,mistweaver,6,2,4
Rbgmachine,burning-legion,192,monk,mistweaver,6,2,4
Tsifsakari,silvermoon,192,monk,mistweaver,12,2,10
Ascrem,ragnaros,192,monk,mistweaver,12,2,10
Konnîchîwa,kazzak,192,monk,mistweaver,12,2,10
Чвка,booty-bay,191,monk,mistweaver,6,2,4
Sargnorak,dalaran,191,monk,mistweaver,6,2,4
Pandasia,kargath,186,monk,mistweaver,16,4,12
Andrah,blackmoore,185,monk,mistweaver,14,4,10
Swiftmonky,azuremyst,159,monk,mistweaver,5,2,3
Quotes,darksorrow,138,monk,mistweaver,10,4,6
Monkeymain,tarren-mill,138,monk,mistweaver,11,4,7
Wraq,tarren-mill,128,monk,mistweaver,4,2,2
Cheechong,grim-batol,127,monk,mistweaver,8,2,6
Mynaira,tarren-mill,112,monk,mistweaver,19,2,17
Kegrøll,doomhammer,96,monk,mistweaver,6,1,5
Moorf,ravencrest,96,monk,mistweaver,6,1,5
Kano,burning-legion,96,monk,mistweaver,6,1,5
Àómìñêdâìkí,lightnings-blade,96,monk,mistweaver,6,1,5
Ytjin,draenor,96,monk,mistweaver,6,1,5
Brixelol,kazzak,96,monk,mistweaver,6,1,5
Botsmw,kazzak,96,monk,mistweaver,6,1,5
Chîca,ysondre,96,monk,mistweaver,6,1,5
Shîïna,ysondre,96,monk,mistweaver,6,1,5
Glivilalis,drekthar,96,monk,mistweaver,6,1,5
Jessiemonk,blackhand,96,monk,mistweaver,6,1,5
Lìlíy,taerar,96,monk,mistweaver,6,1,5
Bænkai,naxxramas,96,monk,mistweaver,6,1,5
Itxelita,zuljin,96,monk,mistweaver,6,1,5
Ðéliora,la-croisade-écarlate,96,monk,mistweaver,6,1,5
Mongretod,ravencrest,96,monk,mistweaver,6,1,5
Jusex,stormreaver,96,monk,mistweaver,6,1,5
Rostick,drakthul,96,monk,mistweaver,6,1,5
Brandy,kazzak,96,monk,mistweaver,6,1,5
Boîndíl,malfurion,96,monk,mistweaver,6,1,5
Whoszeus,archimonde,96,monk,mistweaver,6,1,5
Smlpp,kazzak,96,monk,mistweaver,6,1,5
Renegatt,twisting-nether,96,monk,mistweaver,6,1,5
Monkolben,blackmoore,96,monk,mistweaver,6,1,5
Legpunch,the-maelstrom,96,monk,mistweaver,6,1,5
Brewbunnyqt,thrall,96,monk,mistweaver,6,1,5
Антошамв,gordunni,96,monk,mistweaver,6,1,5
Pitit,outland,96,monk,mistweaver,6,1,5
Capos,wrathbringer,96,monk,mistweaver,11,1,10
Xiâomèi,dun-modr,96,monk,mistweaver,12,1,11
Upbringer,ragnaros,96,monk,mistweaver,12,1,11
Griffens,argent-dawn,79,monk,mistweaver,5,1,4
Moreløs,stormscale,42,monk,mistweaver,12,3,9
Monkeykung,defias-brotherhood,40,monk,mistweaver,16,3,13
Padawang,twisting-nether,767,monk,brewmaster,24,8,16
Tayoo,aegwynn,192,monk,brewmaster,6,2,4
Lubeï,kirin-tor,96,monk,brewmaster,6,1,5
Lòthbar,confrérie-du-thorium,63,monk,brewmaster,2,2,0
Fistyw,stormscale,2313,monk,windwalker,104,60,44
Sîxmonths,stormscale,2263,monk,windwalker,72,48,24
Queteapie,stormscale,2192,monk,windwalker,82,48,34
Plaww,dalaran,2172,monk,windwalker,120,75,45
Unpruneable,stormscale,2147,monk,windwalker,84,45,39
Hitsuwalker,archimonde,2142,monk,windwalker,78,50,28
Tabetai,tarren-mill,2125,monk,windwalker,90,46,44
Lilcatlife,tyrande,2123,monk,windwalker,66,36,30
Ewynamonk,silvermoon,2121,monk,windwalker,102,51,51
Snusochnocco,the-maelstrom,2120,monk,windwalker,78,39,39
Ilovehim,antonidas,2092,monk,windwalker,66,41,25
Brñ,twisting-nether,2073,monk,windwalker,66,36,30
Fistinguhuhu,outland,2067,monk,windwalker,84,45,39
Váinz,ravencrest,2046,monk,windwalker,66,37,29
Rivazsunkick,archimonde,2035,monk,windwalker,124,59,65
Hurricrane,kazzak,2019,monk,windwalker,118,63,55
Stepsyzz,stormscale,1996,monk,windwalker,77,37,40
Pichouhuahua,elune,1995,monk,windwalker,90,44,46
Pandamoniun,aggra-português,1987,monk,windwalker,84,44,40
Niamix,archimonde,1985,monk,windwalker,110,55,55
Мистмастер,soulflayer,1984,monk,windwalker,48,30,18
Jájsemshadow,drakthul,1971,monk,windwalker,66,36,30
Balia,blackrock,1971,monk,windwalker,60,29,31
Eth,nagrand,1968,monk,windwalker,72,37,35
Soulja,bloodfeather,1965,monk,windwalker,70,42,28
Rmtexter,ravencrest,1964,monk,windwalker,53,27,26
Troopmonk,ravencrest,1960,monk,windwalker,78,40,38
Щищ,gordunni,1958,monk,windwalker,78,46,32
Senretsu,shattered-halls,1956,monk,windwalker,60,32,28
Sørann,drekthar,1948,monk,windwalker,64,38,26
Riskcapcap,dentarg,1935,monk,windwalker,66,35,31
Zukatan,tarren-mill,1934,monk,windwalker,72,37,35
Yassøux,archimonde,1928,monk,windwalker,136,71,65
Нелегитимный,howling-fjord,1923,monk,windwalker,190,96,94
Melyda,ravencrest,1922,monk,windwalker,102,56,46
Bulluh,blackmoore,1919,monk,windwalker,47,27,20
Ellipirelli,doomhammer,1911,monk,windwalker,46,21,25
Muix,draenor,1906,monk,windwalker,30,20,10
Theoww,dragonblight,1903,monk,windwalker,60,29,31
Hastewalker,dun-morogh,1898,monk,windwalker,42,23,19
Monkmeta,frostwolf,1896,monk,windwalker,60,33,27
Gyto,archimonde,1893,monk,windwalker,54,33,21
Ztl,twisting-nether,1890,monk,windwalker,89,54,35
Муррчалкин,howling-fjord,1880,monk,windwalker,48,28,20
Daosh,nemesis,1878,monk,windwalker,67,32,35
Аррани,thermaplugg,1874,monk,windwalker,58,33,25
Domww,outland,1871,monk,windwalker,108,59,49
Projectasura,draenor,1864,monk,windwalker,102,55,47
Edenmonk,dun-morogh,1855,monk,windwalker,48,27,21
Яагрессивный,howling-fjord,1850,monk,windwalker,74,36,38
Flunkefar,defias-brotherhood,1845,monk,windwalker,90,42,48
Enerchi,ravencrest,1836,monk,windwalker,54,32,22
Santanax,ravencrest,1834,monk,windwalker,42,27,15
Linuxx,ravencrest,1832,monk,windwalker,90,45,45
Такюн,howling-fjord,1822,monk,windwalker,102,56,46
Shpunk,ravencrest,1821,monk,windwalker,54,27,27
Monkees,twisting-nether,1815,monk,windwalker,65,33,32
Ароба,blackscar,1814,monk,windwalker,78,38,40
Калестонз,howling-fjord,1811,monk,windwalker,54,31,23
Инрэйджинкап,soulflayer,1811,monk,windwalker,66,29,37
Lullerull,silvermoon,1810,monk,windwalker,51,31,20
Фодз,soulflayer,1809,monk,windwalker,58,26,32
Pàrádìsé,ravencrest,1807,monk,windwalker,72,38,34
Redundänt,kazzak,1806,monk,windwalker,42,25,17
Mebrin,ragnaros,1805,monk,windwalker,71,37,34
Sushiroll,stormrage,1805,monk,windwalker,99,49,50
Åbyssgòd,kazzak,1805,monk,windwalker,60,24,36
Notmelo,dun-modr,1801,monk,windwalker,48,25,23
Windwanker,eredar,1800,monk,windwalker,36,22,14
Teressah,argent-dawn,1800,monk,windwalker,42,22,20
Tommypistol,runetotem,1800,monk,windwalker,78,39,39
Gararasu,eredar,1798,monk,windwalker,36,19,17
Twinny,drakthul,1793,monk,windwalker,90,52,38
Санварион,eversong,1786,monk,windwalker,54,26,28
Mionoor,aegwynn,1781,monk,windwalker,142,72,70
Skailzkrt,hyjal,1779,monk,windwalker,42,22,20
Yiannischan,draenor,1774,monk,windwalker,84,47,37
Mikedcrybaby,tarren-mill,1774,monk,windwalker,119,63,56
Тихийпук,deathguard,1771,monk,windwalker,110,63,47
Fotmwalker,ragnaros,1761,monk,windwalker,66,32,34
Меняубило,howling-fjord,1757,monk,windwalker,60,32,28
Xiâomèi,dun-modr,1755,monk,windwalker,60,28,32
Sobadzlolz,alexstrasza,1751,monk,windwalker,64,39,25
Yukfou,tarren-mill,1749,monk,windwalker,53,26,27
Ackken,twisting-nether,1748,monk,windwalker,51,26,25
Sororicide,stormscale,1748,monk,windwalker,64,30,34
Niyka,silvermoon,1740,monk,windwalker,48,29,19
Dwdw,aerie-peak,1737,monk,windwalker,54,28,26
Klumpenx,draenor,1735,monk,windwalker,62,31,31
Rêshi,draenor,1731,monk,windwalker,48,34,14
Лазанья,grom,1731,monk,windwalker,60,27,33
Unangebracht,silvermoon,1730,monk,windwalker,179,94,85
Saltotriks,tarren-mill,1723,monk,windwalker,50,23,27
Kitcheneer,twisting-nether,1720,monk,windwalker,30,19,11
Трэйци,blackscar,1716,monk,windwalker,39,23,16
Виноипиво,soulflayer,1713,monk,windwalker,60,30,30
Elinalia,burning-legion,1712,monk,windwalker,42,21,21
Stillwater,thrall,1711,monk,windwalker,54,26,28
Dansaam,tarren-mill,1706,monk,windwalker,24,18,6
Reõ,argent-dawn,1702,monk,windwalker,72,42,30
Osalot,ravencrest,1695,monk,windwalker,60,30,30
Ashânti,eredar,1691,monk,windwalker,62,30,32
Димакарма,howling-fjord,1691,monk,windwalker,65,26,39
Pitball,ravencrest,1690,monk,windwalker,42,18,24
Miløøx,silvermoon,1683,monk,windwalker,59,33,26
Tisaki,blackhand,1680,monk,windwalker,41,25,16
Fistofrage,ravencrest,1677,monk,windwalker,36,22,14
Ratslayerz,dun-modr,1669,monk,windwalker,42,24,18
Гладастар,soulflayer,1665,monk,windwalker,66,33,33
Gonkun,outland,1662,monk,windwalker,49,26,23
Маруты,soulflayer,1661,monk,windwalker,53,22,31
Zéroneufsix,silvermoon,1658,monk,windwalker,50,19,31
Ninadobrév,stormscale,1657,monk,windwalker,44,25,19
Pwaff,kazzak,1654,monk,windwalker,48,24,24
Faxax,draenor,1651,monk,windwalker,42,21,21
Bîmbâmboom,blackmoore,1650,monk,windwalker,48,25,23
Thérez,les-sentinelles,1648,monk,windwalker,42,22,20
Sylicia,alleria,1648,monk,windwalker,97,47,50
Гуппер,howling-fjord,1646,monk,windwalker,54,23,31
Cheethfu,ragnaros,1645,monk,windwalker,30,21,9
Deretrox,twisting-nether,1645,monk,windwalker,36,21,15
Idiot,outland,1644,monk,windwalker,42,22,20
Mîsts,aszune,1624,monk,windwalker,35,18,17
Тринх,ashenvale,1613,monk,windwalker,54,31,23
Heyami,ravencrest,1613,monk,windwalker,36,17,19
Moistpocket,stormscale,1613,monk,windwalker,42,17,25
Zandoy,draenor,1611,monk,windwalker,52,26,26
Ocëane,sanguino,1609,monk,windwalker,36,19,17
Beernie,tarren-mill,1608,monk,windwalker,24,17,7
Vayarah,antonidas,1605,monk,windwalker,54,28,26
Pazü,ysondre,1605,monk,windwalker,41,20,21
Rivaz,archimonde,1603,monk,windwalker,36,19,17
Fistu,silvermoon,1602,monk,windwalker,31,18,13
Carbozø,archimonde,1600,monk,windwalker,24,17,7
Fistedx,twisting-nether,1598,monk,windwalker,36,17,19
Pelou,culte-de-la-rive-noire,1597,monk,windwalker,48,25,23
Heran,ravencrest,1596,monk,windwalker,44,19,25
Nigu,dun-modr,1592,monk,windwalker,61,34,27
Тэсти,blackscar,1590,monk,windwalker,34,19,15
Chaospilot,sylvanas,1574,monk,windwalker,42,19,23
Doktormonk,blackrock,1568,monk,windwalker,70,37,33
Эвэйжион,gordunni,1564,monk,windwalker,30,19,11
Erenaar,nemesis,1563,monk,windwalker,36,29,7
Ютуми,soulflayer,1557,monk,windwalker,36,17,19
Тшейши,howling-fjord,1556,monk,windwalker,42,23,19
Thyf,drakthul,1550,monk,windwalker,42,17,25
Steros,die-aldor,1546,monk,windwalker,36,17,19
Xullon,dragonblight,1542,monk,windwalker,60,27,33
Bastos,blackrock,1540,monk,windwalker,216,110,106
Хекмуги,borean-tundra,1535,monk,windwalker,91,44,47
Plsnerfmemor,hyjal,1532,monk,windwalker,58,31,27
Shaolinthug,stormscale,1531,monk,windwalker,36,16,20
Jeydi,ravencrest,1528,monk,windwalker,41,29,12
Mynokxu,blackmoore,1526,monk,windwalker,27,18,9
Scribzw,twisting-nether,1524,monk,windwalker,24,16,8
Акумах,blackscar,1523,monk,windwalker,78,35,43
Kixxus,blackmoore,1522,monk,windwalker,42,21,21
Naschitüte,blackrock,1517,monk,windwalker,78,39,39
Bèrïth,kazzak,1517,monk,windwalker,36,18,18
Анпапаяя,galakrond,1507,monk,windwalker,47,26,21
Jolbucheron,hyjal,1507,monk,windwalker,60,31,29
Дивипи,blackscar,1506,monk,windwalker,54,24,30
Senshí,stormscale,1500,monk,windwalker,30,17,13
Sòftx,stormscale,1491,monk,windwalker,28,19,9
Eonyzi,kazzak,1491,monk,windwalker,42,20,22
Домудароги,gordunni,1484,monk,windwalker,30,16,14
Keskonriz,ysondre,1481,monk,windwalker,50,23,27
Ravelbaby,blackrock,1464,monk,windwalker,34,16,18
Дуэльныйчел,howling-fjord,1462,monk,windwalker,38,17,21
Fungamelol,blackhand,1459,monk,windwalker,30,19,11
Sagewhisper,ravencrest,1458,monk,windwalker,57,27,30
Xuuan,argent-dawn,1440,monk,windwalker,65,38,27
Ladderfiend,stormscale,1439,monk,windwalker,30,15,15
Рэйвх,howling-fjord,1438,monk,windwalker,30,15,15
Dræk,twisting-nether,1437,monk,windwalker,29,17,12
Артемиоксх,blackscar,1437,monk,windwalker,37,15,22
Эльморо,goldrinn,1434,monk,windwalker,30,15,15
Spinntowin,blackmoore,1433,monk,windwalker,63,31,32
Freehelper,stormscale,1433,monk,windwalker,42,15,27
Oberháupt,blackrock,1432,monk,windwalker,30,15,15
Anhox,ragnaros,1425,monk,windwalker,30,15,15
Notsmol,quelthalas,1422,monk,windwalker,30,15,15
Darré,sylvanas,1413,monk,windwalker,72,30,42
Добраядушка,gordunni,1400,monk,windwalker,36,19,17
Ívó,ragnaros,1400,monk,windwalker,42,17,25
Lucaspires,sylvanas,1399,monk,windwalker,42,15,27
Pipatvs,drakthul,1398,monk,windwalker,31,21,10
Azato,hyjal,1398,monk,windwalker,48,23,25
Uffsmaul,blackhand,1395,monk,windwalker,49,27,22
Vixia,outland,1390,monk,windwalker,29,15,14
Kanõ,outland,1381,monk,windwalker,30,17,13
Wakmo,bladefist,1380,monk,windwalker,44,22,22
Kyraxs,silvermoon,1379,monk,windwalker,36,17,19
Кюзичка,gordunni,1379,monk,windwalker,83,38,45
Icecoldish,tarren-mill,1378,monk,windwalker,72,39,33
Swiftmonky,azuremyst,1376,monk,windwalker,48,27,21
Malutkie,defias-brotherhood,1363,monk,windwalker,66,33,33
Doobly,kazzak,1359,monk,windwalker,89,44,45
Îrønfist,blackmoore,1358,monk,windwalker,29,17,12
Bandiya,archimonde,1358,monk,windwalker,61,28,33
Bakash,ysondre,1353,monk,windwalker,128,57,71
Mirôku,onyxia,1352,monk,windwalker,42,22,20
Boutarzi,hyjal,1347,monk,windwalker,54,25,29
Exikûsh,frostwolf,1341,monk,windwalker,30,16,14
Yungdrippy,eredar,1340,monk,windwalker,24,14,10
Schmidti,kazzak,1340,monk,windwalker,30,14,16
Domiqx,blackhand,1339,monk,windwalker,30,14,16
Nicesky,ravencrest,1339,monk,windwalker,36,14,22
Vexíllum,sylvanas,1338,monk,windwalker,30,14,16
Saduh,thrall,1338,monk,windwalker,30,14,16
Undefinedid,ravencrest,1335,monk,windwalker,98,51,47
Bobbyknuckls,ravencrest,1335,monk,windwalker,78,34,44
Moonkeeye,stormscale,1332,monk,windwalker,60,36,24
Коркирас,howling-fjord,1322,monk,windwalker,84,47,37
Сандерстрайк,howling-fjord,1315,monk,windwalker,30,14,16
Kîngjungeîle,dalaran,1301,monk,windwalker,24,14,10
Монголгодх,howling-fjord,1296,monk,windwalker,30,17,13
Nodzomi,shadowsong,1295,monk,windwalker,33,17,16
Hampocket,ravencrest,1290,monk,windwalker,38,15,23
Mycki,dalaran,1289,monk,windwalker,29,15,14
Яшкациган,howling-fjord,1285,monk,windwalker,40,16,24
Lemmeportbk,ravencrest,1279,monk,windwalker,32,15,17
Miyaghï,dun-modr,1269,monk,windwalker,31,16,15
Mønkeydluffy,blackmoore,1269,monk,windwalker,66,33,33
Matlahon,kazzak,1269,monk,windwalker,29,14,15
Kungfumite,twisting-nether,1266,monk,windwalker,83,42,41
Djpunchable,blackrock,1247,monk,windwalker,24,13,11
Monkini,kazzak,1247,monk,windwalker,24,13,11
Yacum,blackrock,1246,monk,windwalker,30,13,17
Iceym,stormscale,1244,monk,windwalker,33,14,19
Кирокко,gordunni,1242,monk,windwalker,18,14,4
Brandy,kazzak,1242,monk,windwalker,30,13,17
Pandermann,antonidas,1238,monk,windwalker,30,16,14
Kouradoskylo,twisting-nether,1234,monk,windwalker,29,16,13
Meltfistqt,ravencrest,1234,monk,windwalker,30,13,17
Kegrøll,doomhammer,1231,monk,windwalker,42,21,21
Agitoyamissj,burning-legion,1231,monk,windwalker,33,14,19
Янасру,gordunni,1230,monk,windwalker,243,121,122
Yesman,quelthalas,1229,monk,windwalker,74,35,39
Vushao,blackmoore,1228,monk,windwalker,156,72,84
Nikchi,destromath,1221,monk,windwalker,36,13,23
Bruzuh,outland,1215,monk,windwalker,31,15,16
Akÿo,archimonde,1213,monk,windwalker,29,13,16
Imvengeance,stormscale,1204,monk,windwalker,28,14,14
Диванн,howling-fjord,1198,monk,windwalker,29,13,16
Yobo,archimonde,1196,monk,windwalker,23,13,10
Hunkfur,ravencrest,1177,monk,windwalker,26,13,13
Vercya,dun-morogh,1168,monk,windwalker,37,19,18
Bellarika,nemesis,1152,monk,windwalker,12,12,0
Sponkas,tarren-mill,1152,monk,windwalker,24,12,12
Милыйколян,soulflayer,1152,monk,windwalker,24,12,12
Дезмимонк,ashenvale,1152,monk,windwalker,28,13,15
Arsonists,argent-dawn,1151,monk,windwalker,18,12,6
Джэкичача,soulflayer,1151,monk,windwalker,24,12,12
Healbotzweik,frostwolf,1151,monk,windwalker,24,12,12
Çhina,twisting-nether,1151,monk,windwalker,24,12,12
Jinpachi,ravencrest,1151,monk,windwalker,30,12,18
Ksâin,ravencrest,1151,monk,windwalker,30,12,18
Shardonay,ravencrest,1149,monk,windwalker,18,12,6
Йетисан,gordunni,1149,monk,windwalker,18,12,6
Iastyn,kazzak,1148,monk,windwalker,24,12,12
Brorsantuck,frostmane,1147,monk,windwalker,18,12,6
Valduri,stormscale,1147,monk,windwalker,30,12,18
Sesi,drakthul,1147,monk,windwalker,42,12,30
Hosh,ysondre,1146,monk,windwalker,30,12,18
Gúerrilla,tarren-mill,1135,monk,windwalker,48,27,21
Yøøps,dalaran,1134,monk,windwalker,53,22,31
Elfisto,baelgun,1132,monk,windwalker,24,12,12
Hilzaxsub,archimonde,1083,monk,windwalker,23,12,11
Euronymesis,silvermoon,1065,monk,windwalker,23,12,11
Daybaobao,the-maelstrom,1062,monk,windwalker,22,12,10
Одиниз,gordunni,1057,monk,windwalker,36,25,11
Orkamonka,burning-legion,1056,monk,windwalker,18,11,7
Ðâvàizskÿ,ysondre,1056,monk,windwalker,18,11,7
Kokushibo,cthun,1056,monk,windwalker,24,11,13
Cirixx,outland,1055,monk,windwalker,18,11,7
Ехерех,blackscar,1055,monk,windwalker,30,17,13
Djshady,sylvanas,1054,monk,windwalker,18,11,7
Tiaqa,aegwynn,1053,monk,windwalker,12,11,1
Ryle,forscherliga,1051,monk,windwalker,24,11,13
Gatyz,archimonde,1051,monk,windwalker,27,11,16
Samantonah,nemesis,1050,monk,windwalker,16,12,4
Вамптолкер,howling-fjord,1049,monk,windwalker,18,11,7
Malarie,magtheridon,1035,monk,windwalker,66,34,32
Napqi,malganis,1023,monk,windwalker,17,11,6
Broner,dunemaul,1022,monk,windwalker,23,11,12
Trunks,turalyon,1014,monk,windwalker,24,11,13
Янакаблуках,howling-fjord,1013,monk,windwalker,20,12,8
Hefners,grim-batol,991,monk,windwalker,23,11,12
Marcianorock,archimonde,987,monk,windwalker,30,13,17
Stronkman,frostwhisper,979,monk,windwalker,18,11,7
Вагонюлеера,howling-fjord,974,monk,windwalker,22,11,11
Wolmachégodx,archimonde,960,monk,windwalker,12,10,2
Peaceweaver,ravencrest,960,monk,windwalker,12,10,2
Akuuji,silvermoon,960,monk,windwalker,18,10,8
Ðävàizskó,ysondre,960,monk,windwalker,18,10,8
Shînøbi,dalaran,960,monk,windwalker,18,10,8
Rismonk,twisting-nether,960,monk,windwalker,24,10,14
Атакцуки,gordunni,959,monk,windwalker,18,10,8
Nycea,blackrock,959,monk,windwalker,18,10,8
Vtx,blackrock,959,monk,windwalker,18,10,8
Rorkito,sanguino,959,monk,windwalker,30,10,20
Realiaze,tichondrius,958,monk,windwalker,24,10,14
Agress,sanguino,932,monk,windwalker,48,19,29
Dionee,twisting-nether,877,monk,windwalker,21,12,9
Venuki,blackrock,864,monk,windwalker,12,9,3
Thänkky,kazzak,864,monk,windwalker,12,9,3
Mcscrub,ragnaros,864,monk,windwalker,12,9,3
Weaverman,ragnaros,864,monk,windwalker,18,9,9
Lrizz,argent-dawn,864,monk,windwalker,18,9,9
Snookzlol,aegwynn,864,monk,windwalker,18,9,9
Цеска,howling-fjord,864,monk,windwalker,18,9,9
Otp,hyjal,863,monk,windwalker,18,9,9
Fisty,lightbringer,863,monk,windwalker,24,9,15
Monkgol,stormscale,861,monk,windwalker,18,9,9
Lin,nathrezim,861,monk,windwalker,18,9,9
Blumonk,argent-dawn,857,monk,windwalker,18,9,9
Чвка,booty-bay,853,monk,windwalker,21,10,11
Gidmonk,darkspear,836,monk,windwalker,18,9,9
Apprentice,ravencrest,815,monk,windwalker,17,9,8
Okilexsan,sanguino,797,monk,windwalker,11,9,2
Karatiy,doomhammer,795,monk,windwalker,99,33,66
Plånck,archimonde,768,monk,windwalker,12,8,4
Runefists,twisting-nether,768,monk,windwalker,12,8,4
Tðptier,drakthul,768,monk,windwalker,12,8,4
Wladqz,stormscale,768,monk,windwalker,12,8,4
Ðìør,kazzak,768,monk,windwalker,12,8,4
Jeppehmonk,stormscale,768,monk,windwalker,12,8,4
Slayh,archimonde,768,monk,windwalker,12,8,4
Karmaisabich,ragnaros,768,monk,windwalker,12,8,4
Toyless,ravencrest,768,monk,windwalker,12,8,4
Eggroll,archimonde,768,monk,windwalker,12,8,4
Лагвай,gordunni,768,monk,windwalker,12,8,4
Anteric,sylvanas,768,monk,windwalker,12,8,4
Karels,archimonde,768,monk,windwalker,12,8,4
Shoura,blackmoore,768,monk,windwalker,12,8,4
Monk,shattered-hand,768,monk,windwalker,18,8,10
Kåtsumi,sanguino,768,monk,windwalker,18,8,10
Wonkeed,hyjal,768,monk,windwalker,18,8,10
Gdkz,tarren-mill,768,monk,windwalker,18,8,10
Stÿvww,archimonde,768,monk,windwalker,24,8,16
ßibip,hyjal,767,monk,windwalker,14,10,4
Earendil,culte-de-la-rive-noire,767,monk,windwalker,12,8,4
Дыня,gordunni,767,monk,windwalker,12,8,4
Merilwyn,argent-dawn,767,monk,windwalker,12,8,4
Kneecapper,ravencrest,767,monk,windwalker,18,8,10
Pocaa,arakarahm,766,monk,windwalker,18,8,10
Nggz,archimonde,764,monk,windwalker,12,8,4
Czvibuh,drakthul,763,monk,windwalker,24,8,16
Томтью,gordunni,735,monk,windwalker,17,8,9
Gaehitmonlee,ravencrest,734,monk,windwalker,17,8,9
Sqoobie,tarren-mill,672,monk,windwalker,12,7,5
Saodiseng,outland,672,monk,windwalker,12,7,5
Имортарион,howling-fjord,672,monk,windwalker,12,7,5
Hôllowx,archimonde,672,monk,windwalker,12,7,5
Lesauceboss,kazzak,672,monk,windwalker,12,7,5
Njursten,twilights-hammer,672,monk,windwalker,12,7,5
Zenothar,ravencrest,672,monk,windwalker,12,7,5
Wuux,tarren-mill,672,monk,windwalker,12,7,5
Dopi,frostmane,672,monk,windwalker,12,7,5
Arthanaar,drakthul,672,monk,windwalker,12,7,5
Potsymist,twisting-nether,672,monk,windwalker,12,7,5
Gorskie,silvermoon,672,monk,windwalker,12,7,5
Blizò,tarren-mill,672,monk,windwalker,12,7,5
Pêterpump,blackrock,672,monk,windwalker,12,7,5
Kármo,thrall,672,monk,windwalker,12,7,5
Gankplank,nemesis,672,monk,windwalker,12,7,5
Uwuhehe,ravencrest,672,monk,windwalker,12,7,5
Chigre,hyjal,672,monk,windwalker,12,7,5
Flowér,auchindoun,672,monk,windwalker,18,7,11
Mefîsto,blackrock,672,monk,windwalker,18,7,11
Kåýðø,archimonde,672,monk,windwalker,18,7,11
Inkegomonk,draenor,672,monk,windwalker,24,7,17
Recklusa,stormscale,671,monk,windwalker,12,7,5
Bierdame,blackhand,671,monk,windwalker,12,7,5
Sonofelrond,twisting-nether,671,monk,windwalker,12,7,5
Ролитта,gordunni,671,monk,windwalker,12,7,5
Chæli,tarren-mill,671,monk,windwalker,12,7,5
Монахнехилит,howling-fjord,671,monk,windwalker,18,7,11
Discosean,frostmane,671,monk,windwalker,18,7,11
Duches,tarren-mill,671,monk,windwalker,18,7,11
Непорядочная,gordunni,669,monk,windwalker,18,7,11
Kirara,talnivarr,668,monk,windwalker,12,7,5
Bal,tyrande,667,monk,windwalker,15,8,7
Fusetonww,tarren-mill,623,monk,windwalker,11,7,4
Rezuz,draenor,576,monk,windwalker,6,6,0
Waaks,archimonde,576,monk,windwalker,12,6,6
Niyatî,draenor,576,monk,windwalker,12,6,6
Ijji,argent-dawn,576,monk,windwalker,12,6,6
Fln,blackrock,576,monk,windwalker,12,6,6
Turbofistsqt,kazzak,576,monk,windwalker,12,6,6
Nyrkkikylpy,ravencrest,576,monk,windwalker,12,6,6
Ferree,tarren-mill,576,monk,windwalker,12,6,6
Balance,laughing-skull,576,monk,windwalker,12,6,6
Xàrslòulolz,kazzak,576,monk,windwalker,12,6,6
Weezé,outland,576,monk,windwalker,12,6,6
Kryzu,ragnaros,576,monk,windwalker,12,6,6
Dokuziq,twisting-nether,576,monk,windwalker,12,6,6
Мэрджик,soulflayer,576,monk,windwalker,12,6,6
Lycké,silvermoon,576,monk,windwalker,12,6,6
Miridius,silvermoon,576,monk,windwalker,12,6,6
Форгетх,soulflayer,576,monk,windwalker,12,6,6
Coollann,drakthul,576,monk,windwalker,12,6,6
Testmonial,hyjal,576,monk,windwalker,12,6,6
Ampm,ravencrest,576,monk,windwalker,12,6,6
Däemon,twisting-nether,576,monk,windwalker,15,7,8
Fiststowin,blackrock,576,monk,windwalker,18,6,12
Möîne,arathi,576,monk,windwalker,18,6,12
Blickx,draenor,576,monk,windwalker,18,6,12
Norgamx,alakir,576,monk,windwalker,18,6,12
Galaxyfists,blackhand,576,monk,windwalker,18,6,12
Raychi,draenor,575,monk,windwalker,12,6,6
Waîzen,uldaman,575,monk,windwalker,12,6,6
Teetoor,argent-dawn,575,monk,windwalker,12,6,6
Doreese,moonglade,575,monk,windwalker,12,6,6
Iluvatareru,twisting-nether,575,monk,windwalker,12,6,6
Dummars,ragnaros,575,monk,windwalker,12,6,6
Chiroidz,kazzak,575,monk,windwalker,12,6,6
Mönchdog,blackmoore,573,monk,windwalker,12,6,6
Mullan,eonar,573,monk,windwalker,24,6,18
Cptfist,argent-dawn,543,monk,windwalker,17,6,11
Merjis,stormscale,527,monk,windwalker,11,6,5
Kungfuhkyou,tarren-mill,480,monk,windwalker,6,5,1
Emptyeyés,kazzak,480,monk,windwalker,6,5,1
Hàtéppl,ravencrest,480,monk,windwalker,6,5,1
Rayokhen,kazzak,480,monk,windwalker,6,5,1
Zmile,ragnaros,480,monk,windwalker,6,5,1
Madelnheaven,burning-legion,480,monk,windwalker,6,5,1
Alandriai,blackmoore,480,monk,windwalker,6,5,1
Larsowns,ragnaros,480,monk,windwalker,6,5,1
Wilywolxx,silvermoon,480,monk,windwalker,6,5,1
Fijiwater,draenor,480,monk,windwalker,6,5,1
Kapud,twisting-nether,480,monk,windwalker,6,5,1
Энвишь,soulflayer,480,monk,windwalker,6,5,1
Shapzxd,archimonde,480,monk,windwalker,6,5,1
Ноупэйн,soulflayer,480,monk,windwalker,6,5,1
Bbcmonkinc,aegwynn,480,monk,windwalker,10,6,4
Bimberta,argent-dawn,480,monk,windwalker,12,5,7
Blyatfast,draenor,480,monk,windwalker,12,5,7
Diagmonk,kazzak,480,monk,windwalker,12,5,7
Øbamakush,archimonde,480,monk,windwalker,12,5,7
Johnsôn,blackmoore,480,monk,windwalker,12,5,7
Babyfax,draenor,480,monk,windwalker,12,5,7
Greenshortea,aegwynn,480,monk,windwalker,12,5,7
Badcøwboy,archimonde,480,monk,windwalker,12,5,7
Mink,uldum,480,monk,windwalker,12,5,7
Kaelwind,burning-legion,480,monk,windwalker,12,5,7
Käsefäuste,azshara,480,monk,windwalker,12,5,7
Monk,dun-modr,480,monk,windwalker,12,5,7
Archnun,stormscale,480,monk,windwalker,12,5,7
Tubørg,ravencrest,480,monk,windwalker,12,5,7
Onlypressw,tarren-mill,480,monk,windwalker,12,5,7
Кунфумастер,gordunni,480,monk,windwalker,12,5,7
Xialongbao,khaz-modan,480,monk,windwalker,12,5,7
Tempestu,twisting-nether,480,monk,windwalker,12,5,7
Fistus,dentarg,480,monk,windwalker,12,5,7
Nerd,argent-dawn,480,monk,windwalker,12,5,7
Vivvy,argent-dawn,480,monk,windwalker,12,5,7
Omnibar,kazzak,480,monk,windwalker,12,5,7
Mayliene,stormscale,480,monk,windwalker,12,5,7
Fatlazypanda,argent-dawn,479,monk,windwalker,6,5,1
Sadwhi,turalyon,472,monk,windwalker,12,5,7
Sebbii,twisting-nether,447,monk,windwalker,11,5,6
Камагами,howling-fjord,400,monk,windwalker,7,5,2
Shagzy,ravencrest,399,monk,windwalker,5,5,0
Gøøgodx,tarren-mill,384,monk,windwalker,6,4,2
Monkflexi,draenor,384,monk,windwalker,6,4,2
Moultsou,hyjal,384,monk,windwalker,6,4,2
Hertel,boulderfist,384,monk,windwalker,6,4,2
Bossdog,mugthol,384,monk,windwalker,6,4,2
Dadrael,argent-dawn,384,monk,windwalker,6,4,2
Twinkletoe,twisting-nether,384,monk,windwalker,6,4,2
Yeol,ravencrest,384,monk,windwalker,6,4,2
Pandafuki,ravencrest,384,monk,windwalker,6,4,2
Blazeuu,drakthul,384,monk,windwalker,6,4,2
Diagmonk,arathi,384,monk,windwalker,6,4,2
Jollyzug,blackrock,384,monk,windwalker,6,4,2
Onn,outland,384,monk,windwalker,6,4,2
Windstormcro,ragnaros,384,monk,windwalker,6,4,2
Tàlo,anachronos,384,monk,windwalker,6,4,2
Palarîns,dalaran,384,monk,windwalker,6,4,2
Tysonwonka,thrall,384,monk,windwalker,6,4,2
Soulspar,ragnaros,384,monk,windwalker,6,4,2
Вэилэй,gordunni,384,monk,windwalker,6,4,2
Gramkin,ravencrest,384,monk,windwalker,6,4,2
Rugys,ravenholdt,384,monk,windwalker,6,4,2
Âdonis,twisting-nether,384,monk,windwalker,6,4,2
Clìtfister,silvermoon,384,monk,windwalker,6,4,2
Pili,aegwynn,384,monk,windwalker,6,4,2
Мионелолл,goldrinn,384,monk,windwalker,6,4,2
Rerowine,magtheridon,384,monk,windwalker,6,4,2
Mabkww,ravencrest,384,monk,windwalker,6,4,2
Orenichi,antonidas,384,monk,windwalker,6,4,2
Iminzww,ravencrest,384,monk,windwalker,6,4,2
Baisi,blackhand,384,monk,windwalker,6,4,2
Крэйзимедвед,howling-fjord,384,monk,windwalker,12,4,8
Salt,suramar,384,monk,windwalker,12,4,8
Blutáar,khazgoroth,384,monk,windwalker,12,4,8
Andrah,blackmoore,384,monk,windwalker,12,4,8
Scribzz,twisting-nether,384,monk,windwalker,12,4,8
Goremancey,draenor,384,monk,windwalker,12,4,8
Mwoinesamdi,hyjal,384,monk,windwalker,12,4,8
Risingspud,frostmane,384,monk,windwalker,12,4,8
Rollah,ravencrest,384,monk,windwalker,12,4,8
Пампич,borean-tundra,384,monk,windwalker,12,4,8
Räyh,outland,384,monk,windwalker,12,4,8
Desmî,ravencrest,384,monk,windwalker,12,4,8
Likethat,hyjal,384,monk,windwalker,12,4,8
Кианасоломид,gordunni,384,monk,windwalker,12,4,8
Panzeerotto,nemesis,384,monk,windwalker,18,4,14
Bbinzu,lothar,383,monk,windwalker,6,4,2
Lòthbar,confrérie-du-thorium,383,monk,windwalker,6,4,2
Югэн,azuregos,383,monk,windwalker,12,4,8
Benkkei,ysondre,336,monk,windwalker,15,4,11
Choje,blackmoore,319,monk,windwalker,5,4,1
Alë,argent-dawn,319,monk,windwalker,8,4,4
Realfighter,arathor,288,monk,windwalker,6,3,3
Aslêyia,antonidas,288,monk,windwalker,6,3,3
Piedliés,ravencrest,288,monk,windwalker,6,3,3
Arisua,blackhand,288,monk,windwalker,6,3,3
Iluvfistinjk,sylvanas,288,monk,windwalker,6,3,3
Sàlêxz,ysondre,288,monk,windwalker,6,3,3
Karmachi,ravencrest,288,monk,windwalker,6,3,3
Mezz,ahnqiraj,288,monk,windwalker,6,3,3
Jakfuki,ragnaros,288,monk,windwalker,6,3,3
Zenified,ragnaros,288,monk,windwalker,6,3,3
Ragobd,argent-dawn,288,monk,windwalker,6,3,3
Zunixxww,terrordar,288,monk,windwalker,6,3,3
Tinjihn,magtheridon,288,monk,windwalker,6,3,3
Dennismansix,sylvanas,288,monk,windwalker,6,3,3
Ðoom,sylvanas,288,monk,windwalker,6,3,3
Verfa,twisting-nether,288,monk,windwalker,6,3,3
Рендикаое,soulflayer,288,monk,windwalker,6,3,3
Hôllowx,throkferoth,288,monk,windwalker,6,3,3
Aaronm,tarren-mill,288,monk,windwalker,6,3,3
Sajin,la-croisade-écarlate,288,monk,windwalker,6,3,3
Sizok,blackmoore,288,monk,windwalker,6,3,3
Vajawalkerx,twisting-nether,288,monk,windwalker,6,3,3
Zelraqt,burning-steppes,288,monk,windwalker,6,3,3
Расселкроу,galakrond,288,monk,windwalker,6,3,3
Lørðbrøñkø,blackrock,288,monk,windwalker,6,3,3
Bigfistah,tarren-mill,288,monk,windwalker,6,3,3
Räpeltäjä,stormreaver,288,monk,windwalker,6,3,3
Nevertouch,blackrock,288,monk,windwalker,6,3,3
Pabu,emeriss,288,monk,windwalker,6,3,3
Zéná,gilneas,288,monk,windwalker,6,3,3
Monkacek,drakthul,288,monk,windwalker,6,3,3
Ratfacè,outland,288,monk,windwalker,6,3,3
Nightingalê,silvermoon,288,monk,windwalker,6,3,3
Droozy,silvermoon,288,monk,windwalker,6,3,3
Fistyfast,hyjal,288,monk,windwalker,6,3,3
Azangar,kazzak,288,monk,windwalker,6,3,3
Alkanphel,kazzak,288,monk,windwalker,6,3,3
Geliôs,kazzak,288,monk,windwalker,12,3,9
Халиосфа,gordunni,288,monk,windwalker,12,3,9
Mönchfatih,blackhand,288,monk,windwalker,12,3,9
Barylen,outland,288,monk,windwalker,12,3,9
Clamps,darkspear,288,monk,windwalker,12,3,9
Roxmonk,ravencrest,288,monk,windwalker,12,3,9
Ayyee,blackmoore,288,monk,windwalker,18,3,15
Brucilli,dalaran,287,monk,windwalker,6,3,3
Lewimoäne,khaz-modan,287,monk,windwalker,6,3,3
Syaóran,exodar,286,monk,windwalker,12,3,9
Iamzra,kazzak,239,monk,windwalker,11,3,8
Trolleurz,archimonde,224,monk,windwalker,16,3,13
Idointcare,ravencrest,192,monk,windwalker,4,3,1
Bignessb,draenor,192,monk,windwalker,4,3,1
Kano,burning-legion,192,monk,windwalker,9,3,6
Джийви,goldrinn,192,monk,windwalker,6,2,4
Dodoglad,hyjal,192,monk,windwalker,6,2,4
Nicetrybuddy,draenor,192,monk,windwalker,6,2,4
Monkiki,hyjal,192,monk,windwalker,6,2,4
Bobthewild,draenor,192,monk,windwalker,6,2,4
Andyww,doomhammer,192,monk,windwalker,6,2,4
Frajer,auchindoun,192,monk,windwalker,6,2,4
Cac,argent-dawn,192,monk,windwalker,6,2,4
Chireapz,blackrock,192,monk,windwalker,6,2,4
Geochi,tarren-mill,192,monk,windwalker,6,2,4
Купейчик,gordunni,192,monk,windwalker,6,2,4
Wazari,nemesis,192,monk,windwalker,6,2,4
Loriodas,tarren-mill,192,monk,windwalker,6,2,4
Tayoo,aegwynn,192,monk,windwalker,6,2,4
Joachi,outland,192,monk,windwalker,6,2,4
Mtmonk,tarren-mill,192,monk,windwalker,6,2,4
Fistingfury,burning-blade,192,monk,windwalker,6,2,4
Zýru,ragnaros,192,monk,windwalker,6,2,4
Devilmønk,thrall,192,monk,windwalker,6,2,4
Wwisalright,burning-legion,192,monk,windwalker,6,2,4
Майамибитч,howling-fjord,192,monk,windwalker,6,2,4
Tetetete,silvermoon,192,monk,windwalker,6,2,4
Miamausebär,blackmoore,192,monk,windwalker,6,2,4
Woalter,silvermoon,192,monk,windwalker,6,2,4
Orcword,ragnaros,192,monk,windwalker,6,2,4
Eynodiggity,blackmoore,192,monk,windwalker,6,2,4
Stenhård,azjolnerub,192,monk,windwalker,6,2,4
Belobe,stormscale,192,monk,windwalker,6,2,4
Kenjibsen,blackhand,192,monk,windwalker,6,2,4
Walterwayne,blackrock,192,monk,windwalker,6,2,4
Bloodychi,ravencrest,192,monk,windwalker,6,2,4
Legeend,dun-modr,192,monk,windwalker,6,2,4
Khirazim,ysondre,192,monk,windwalker,6,2,4
Mcflaïe,ysondre,192,monk,windwalker,6,2,4
Musclorww,ysondre,192,monk,windwalker,6,2,4
Dianly,ravencrest,192,monk,windwalker,6,2,4
Bensil,ravencrest,192,monk,windwalker,6,2,4
Savecdfornxt,blackmoore,192,monk,windwalker,6,2,4
Tongat,ravencrest,192,monk,windwalker,12,2,10
Galexuz,blackrock,192,monk,windwalker,12,2,10
Тифуя,gordunni,192,monk,windwalker,12,2,10
Mollytov,tarren-mill,192,monk,windwalker,18,2,16
Соловьюх,gordunni,191,monk,windwalker,6,2,4
Yianjih,blackmoore,191,monk,windwalker,6,2,4
Жекадобряк,howling-fjord,191,monk,windwalker,10,3,7
Ahlu,argent-dawn,144,monk,windwalker,9,2,7
Umbrâsyl,ravencrest,96,monk,windwalker,6,1,5
Zugzuwg,ahnqiraj,96,monk,windwalker,6,1,5
Бладмонки,soulflayer,96,monk,windwalker,6,1,5
Néroburnsred,eredar,96,monk,windwalker,6,1,5
Kaizenthor,runetotem,96,monk,windwalker,6,1,5
Mjaweaver,stormscale,96,monk,windwalker,6,1,5
Kinføu,hyjal,96,monk,windwalker,6,1,5
Синнэрли,soulflayer,96,monk,windwalker,6,1,5
Bâsarä,archimonde,96,monk,windwalker,6,1,5
Embodimonk,twisting-nether,96,monk,windwalker,6,1,5
Musaya,chamber-of-aspects,96,monk,windwalker,6,1,5
Mìcrøb,blackmoore,96,monk,windwalker,6,1,5
Konnîchîwa,kazzak,96,monk,windwalker,6,1,5
Cøbrakaï,archimonde,96,monk,windwalker,6,1,5
Мяяумяу,gordunni,96,monk,windwalker,6,1,5
Olgachocolat,blackmoore,96,monk,windwalker,6,1,5
Dolkenm,tarren-mill,96,monk,windwalker,6,1,5
Drlightorc,tarren-mill,96,monk,windwalker,6,1,5
Ilovecravmag,draenor,96,monk,windwalker,6,1,5
Olympeá,silvermoon,96,monk,windwalker,6,1,5
Djînns,blackmoore,96,monk,windwalker,6,1,5
Smâsh,blackhand,96,monk,windwalker,6,1,5
Dadeldo,blackrock,96,monk,windwalker,6,1,5
Linocence,draenor,95,monk,windwalker,6,1,5
Odanobunaga,ravencrest,79,monk,windwalker,5,1,4
Xtcc,kazzak,79,monk,windwalker,5,1,4
Огненныйкит,blackscar,48,monk,windwalker,3,1,2
Xámell,ravencrest,48,monk,windwalker,3,1,2
Shamarinator,kazzak,42,monk,windwalker,9,2,7
Åbx,argent-dawn,2191,paladin,holy,113,59,54
Crewxdlolz,frostmane,2123,paladin,holy,211,118,93
Likkik,ravencrest,2121,paladin,holy,86,42,44
Wiriday,draenor,2019,paladin,holy,150,74,76
Lickssi,outland,2001,paladin,holy,94,56,38
Goyimslayer,ravencrest,1926,paladin,holy,54,32,22
Vaîjin,aegwynn,1921,paladin,holy,71,37,34
Jìmjim,ysondre,1916,paladin,holy,114,53,61
Kyoma,burning-legion,1876,paladin,holy,63,28,35
Tipmax,ravencrest,1856,paladin,holy,61,37,24
Niwariel,silvermoon,1852,paladin,holy,60,37,23
Типмакс,howling-fjord,1851,paladin,holy,42,25,17
Welivewewin,defias-brotherhood,1845,paladin,holy,54,32,22
Wheelybin,argent-dawn,1843,paladin,holy,53,23,30
Måvé,tarren-mill,1840,paladin,holy,60,34,26
Алексендлер,howling-fjord,1824,paladin,holy,48,27,21
Aww,anachronos,1824,paladin,holy,60,29,31
Jeø,stormscale,1823,paladin,holy,54,28,26
Eldorín,blackmoore,1823,paladin,holy,54,20,34
Galaxys,blackhand,1818,paladin,holy,128,62,66
Neverlostx,ravencrest,1816,paladin,holy,48,31,17
Ránchìek,ravencrest,1812,paladin,holy,54,26,28
Pêacerainer,stormscale,1804,paladin,holy,72,29,43
Runtheshôw,tarren-mill,1790,paladin,holy,72,34,38
Jûliâ,archimonde,1777,paladin,holy,88,49,39
Optîmuslîme,veklor,1774,paladin,holy,30,19,11
Popecrusade,archimonde,1771,paladin,holy,48,35,13
Valia,argent-dawn,1754,paladin,holy,63,36,27
Holysacx,aegwynn,1745,paladin,holy,42,25,17
Powertilt,ravencrest,1743,paladin,holy,123,55,68
Everflame,blackmoore,1739,paladin,holy,84,50,34
Dbblou,draenor,1739,paladin,holy,42,20,22
Vindîcator,defias-brotherhood,1736,paladin,holy,191,91,100
Аришалисичка,blackscar,1727,paladin,holy,70,36,34
Svyata,twisting-nether,1721,paladin,holy,53,27,26
Holylightxz,runetotem,1717,paladin,holy,75,36,39
Faíren,mugthol,1697,paladin,holy,66,36,30
Holysac,aegwynn,1693,paladin,holy,36,21,15
Emloses,outland,1690,paladin,holy,90,48,42
Rettyfield,blackrock,1689,paladin,holy,30,18,12
Акунделар,gordunni,1685,paladin,holy,102,50,52
Thaderyl,auchindoun,1678,paladin,holy,66,31,35
Гигашмяк,howling-fjord,1677,paladin,holy,54,30,24
Voklane,tarren-mill,1676,paladin,holy,48,23,25
Andûrîl,tarren-mill,1668,paladin,holy,71,37,34
Wokyo,tarren-mill,1663,paladin,holy,77,48,29
Emlight,kazzak,1646,paladin,holy,41,24,17
Kakii,gorgonnash,1645,paladin,holy,59,24,35
Deodas,kazzak,1638,paladin,holy,48,26,22
Holychît,sanguino,1631,paladin,holy,105,50,55
Baazil,ragnaros,1631,paladin,holy,84,38,46
Insanevegan,ravencrest,1628,paladin,holy,66,33,33
Лайтпалочка,soulflayer,1628,paladin,holy,101,48,53
Arysur,defias-brotherhood,1619,paladin,holy,96,43,53
Сэлфхил,gordunni,1617,paladin,holy,83,36,47
Nezâ,thrall,1613,paladin,holy,52,23,29
Skyf,outland,1613,paladin,holy,95,41,54
Goodpeace,kazzak,1607,paladin,holy,43,20,23
Острит,gordunni,1605,paladin,holy,78,45,33
Lexó,ravencrest,1604,paladin,holy,42,20,22
Judgejuryexe,kazzak,1600,paladin,holy,92,44,48
Buntqt,kazzak,1594,paladin,holy,48,27,21
Тошанич,soulflayer,1587,paladin,holy,48,23,25
Xenyaa,arygos,1581,paladin,holy,103,53,50
Shabbyy,bronzebeard,1580,paladin,holy,66,36,30
Rùfus,tarren-mill,1574,paladin,holy,54,32,22
Грор,galakrond,1565,paladin,holy,34,21,13
Tuoppi,steamwheedle-cartel,1562,paladin,holy,29,17,12
Isøri,antonidas,1562,paladin,holy,96,45,51
Astollfo,hyjal,1559,paladin,holy,36,22,14
Itsjulie,sylvanas,1557,paladin,holy,34,18,16
Глиндес,gordunni,1551,paladin,holy,66,33,33
Skurly,ragnaros,1551,paladin,holy,42,19,23
Rëtnuhka,drakthul,1546,paladin,holy,47,24,23
Myssa,uldum,1545,paladin,holy,36,18,18
Strûgglebûs,outland,1543,paladin,holy,47,25,22
Алукартик,deathguard,1543,paladin,holy,59,29,30
Срувтапкизз,blackscar,1543,paladin,holy,83,29,54
Realpalla,ravenholdt,1542,paladin,holy,90,48,42
Rekieuna,archimonde,1538,paladin,holy,246,119,127
Gasilol,frostwolf,1537,paladin,holy,81,41,40
Scrimple,stormscale,1537,paladin,holy,36,18,18
Aíe,draenor,1536,paladin,holy,45,28,17
Потокденег,howling-fjord,1534,paladin,holy,86,36,50
Blessedpapi,draenor,1532,paladin,holy,36,19,17
Pooncy,ragnaros,1530,paladin,holy,60,27,33
Easypala,blackrock,1530,paladin,holy,78,29,49
Флэшкапро,soulflayer,1521,paladin,holy,190,95,95
Jambbo,twisting-nether,1513,paladin,holy,63,34,29
Smightypal,silvermoon,1513,paladin,holy,81,43,38
Dàrckness,ravencrest,1513,paladin,holy,144,76,68
Drdeus,kazzak,1512,paladin,holy,33,18,15
Jajmentx,kazzak,1509,paladin,holy,54,31,23
Aese,dun-modr,1509,paladin,holy,78,38,40
Sonil,les-sentinelles,1507,paladin,holy,57,24,33
Curtfizzle,kazzak,1505,paladin,holy,53,24,29
Narkal,archimonde,1504,paladin,holy,30,16,14
Dömötörp,ragnaros,1492,paladin,holy,42,20,22
Chocòbon,archimonde,1487,paladin,holy,36,21,15
Hirolde,zenedar,1487,paladin,holy,42,18,24
Бадбх,howling-fjord,1486,paladin,holy,60,22,38
Arenalena,sylvanas,1483,paladin,holy,83,39,44
Noliferx,ravencrest,1467,paladin,holy,68,39,29
Джонниджага,blackscar,1462,paladin,holy,40,17,23
Dathróhán,silvermoon,1458,paladin,holy,219,109,110
Lóde,silvermoon,1454,paladin,holy,84,42,42
Marygueguete,archimonde,1448,paladin,holy,48,21,27
Реколори,gordunni,1445,paladin,holy,141,80,61
Сашафистинг,gordunni,1442,paladin,holy,117,58,59
Mitsaklas,grim-batol,1440,paladin,holy,45,18,27
Паладинас,lich-king,1438,paladin,holy,52,17,35
Уретроград,soulflayer,1436,paladin,holy,72,36,36
Injection,khaz-modan,1435,paladin,holy,51,22,29
Devinèqt,tarren-mill,1430,paladin,holy,28,17,11
Kantfyrste,ravencrest,1426,paladin,holy,127,55,72
Taiso,alonsus,1422,paladin,holy,132,64,68
Fourshaw,ravencrest,1422,paladin,holy,77,35,42
Enemylosers,stormscale,1421,paladin,holy,42,20,22
Хегия,gordunni,1414,paladin,holy,30,15,15
Zycqo,silvermoon,1414,paladin,holy,168,82,86
Hazø,silvermoon,1413,paladin,holy,30,18,12
Blazeberg,tirion,1411,paladin,holy,36,20,16
Hotub,twisting-nether,1411,paladin,holy,69,37,32
Preyy,eredar,1409,paladin,holy,42,24,18
Ðenlox,destromath,1408,paladin,holy,104,53,51
Салфеточник,thermaplugg,1403,paladin,holy,60,23,37
Bécasszelium,varimathras,1395,paladin,holy,72,35,37
Xenaké,kazzak,1391,paladin,holy,74,26,48
Skengdaddy,ragnaros,1390,paladin,holy,36,18,18
Эсерпи,gordunni,1389,paladin,holy,88,45,43
Stinkepieet,blackmoore,1387,paladin,holy,42,17,25
Аяпал,blackscar,1383,paladin,holy,66,35,31
Cykadin,dun-modr,1382,paladin,holy,42,16,26
Satipal,sargeras,1368,paladin,holy,75,31,44
Locofatguy,drakthul,1366,paladin,holy,60,26,34
Mecah,hyjal,1365,paladin,holy,42,21,21
Lastaid,azshara,1365,paladin,holy,60,28,32
Zilu,kazzak,1364,paladin,holy,29,15,14
Зондарк,booty-bay,1364,paladin,holy,53,22,31
Shakalol,dun-modr,1355,paladin,holy,60,23,37
Pullheavy,silvermoon,1354,paladin,holy,59,23,36
Леонящер,gordunni,1351,paladin,holy,108,58,50
Heilgaharald,blackrock,1351,paladin,holy,110,51,59
Freaak,dethecus,1351,paladin,holy,36,15,21
Снупарь,blackscar,1351,paladin,holy,45,18,27
Arlette,moonglade,1345,paladin,holy,72,32,40
Keele,stormscale,1341,paladin,holy,69,32,37
Wollymolly,ravencrest,1338,paladin,holy,24,14,10
Кольт,borean-tundra,1335,paladin,holy,60,30,30
Steggeh,argent-dawn,1331,paladin,holy,120,48,72
Lightbrîng,hyjal,1327,paladin,holy,53,26,27
Sacbøt,stormscale,1324,paladin,holy,182,89,93
Эллиарэй,gordunni,1321,paladin,holy,30,14,16
Alldo,drakthul,1320,paladin,holy,54,22,32
Kayndornek,ravencrest,1316,paladin,holy,36,19,17
Hîfi,blackmoore,1309,paladin,holy,94,55,39
Bigfailure,blackmoore,1309,paladin,holy,65,21,44
Лимфома,goldrinn,1307,paladin,holy,53,18,35
Sangriul,outland,1306,paladin,holy,75,27,48
Wíw,kazzak,1304,paladin,holy,36,14,22
Valkhana,draenor,1301,paladin,holy,36,21,15
Nudzolini,tarren-mill,1300,paladin,holy,30,17,13
Maitrelampe,argent-dawn,1294,paladin,holy,54,22,32
Kerven,doomhammer,1293,paladin,holy,42,16,26
Макстипчик,howling-fjord,1291,paladin,holy,33,15,18
Amolan,drakthul,1290,paladin,holy,27,19,8
Daizen,blackrock,1289,paladin,holy,61,41,20
Polydeukis,stormscale,1288,paladin,holy,78,29,49
Ggiwastheret,kazzak,1277,paladin,holy,23,14,9
Alard,sanguino,1277,paladin,holy,60,22,38
Анбели,gordunni,1270,paladin,holy,36,15,21
Vivalabeef,stormscale,1270,paladin,holy,36,14,22
Делатор,gordunni,1267,paladin,holy,48,22,26
Tyktyk,draenor,1264,paladin,holy,30,17,13
Necrozi,stormscale,1263,paladin,holy,48,27,21
Tíep,blackmoore,1262,paladin,holy,71,36,35
Bloodsoldier,twisting-nether,1258,paladin,holy,88,45,43
Kaitlyne,tarren-mill,1252,paladin,holy,91,46,45
Ritiv,stormreaver,1252,paladin,holy,60,25,35
Farata,ravencrest,1249,paladin,holy,106,52,54
Demecir,twisting-nether,1247,paladin,holy,118,56,62
Pajtash,doomhammer,1245,paladin,holy,47,22,25
Phalphlingo,stormscale,1244,paladin,holy,36,13,23
Ромерл,gordunni,1241,paladin,holy,141,64,77
Demonskiller,alakir,1240,paladin,holy,83,44,39
Ostardo,blackhand,1237,paladin,holy,18,13,5
Nerdpallyx,tarren-mill,1234,paladin,holy,24,13,11
Crispydixx,draenor,1217,paladin,holy,41,22,19
Weserwehr,laughing-skull,1214,paladin,holy,54,27,27
Jarroshdin,stormscale,1210,paladin,holy,54,34,20
Stuzzyy,ravencrest,1209,paladin,holy,36,16,20
Strykar,aggra-português,1207,paladin,holy,30,17,13
Keryann,argent-dawn,1205,paladin,holy,102,51,51
Bovinequeef,twisting-nether,1202,paladin,holy,24,13,11
Xastur,rexxar,1201,paladin,holy,33,17,16
Boric,bloodhoof,1184,paladin,holy,29,16,13
Elohim,echsenkessel,1182,paladin,holy,100,46,54
Baubble,silvermoon,1181,paladin,holy,24,14,10
Wrathlol,ravencrest,1180,paladin,holy,101,43,58
Shiidori,aegwynn,1175,paladin,holy,57,23,34
Rhulana,blackrock,1171,paladin,holy,50,32,18
Zebramann,silvermoon,1167,paladin,holy,42,19,23
Pokébowl,outland,1166,paladin,holy,30,14,16
Echooes,ravencrest,1166,paladin,holy,72,30,42
Kambood,twisting-nether,1162,paladin,holy,117,52,65
Ragua,tarren-mill,1159,paladin,holy,54,20,34
Holymax,gorgonnash,1158,paladin,holy,24,15,9
Kaki,gorgonnash,1151,paladin,holy,18,12,6
Lrnz,tarren-mill,1151,paladin,holy,30,12,18
Haylø,archimonde,1150,paladin,holy,24,12,12
Алексендлерх,soulflayer,1149,paladin,holy,18,12,6
Chryme,thrall,1149,paladin,holy,18,12,6
Catali,sanguino,1149,paladin,holy,99,50,49
Мифариан,blackscar,1147,paladin,holy,24,12,12
Elsewhere,archimonde,1146,paladin,holy,30,12,18
Rookbeef,eredar,1145,paladin,holy,18,12,6
Quezkal,dun-modr,1144,paladin,holy,39,18,21
Leon,veknilash,1144,paladin,holy,93,39,54
Skolisse,kazzak,1142,paladin,holy,54,27,27
Коварное,borean-tundra,1141,paladin,holy,24,12,12
Gromezrael,elune,1141,paladin,holy,42,19,23
Archaegis,silvermoon,1141,paladin,holy,30,12,18
Talimañ,kazzak,1140,paladin,holy,18,12,6
Wedervärdig,twilights-hammer,1132,paladin,holy,36,14,22
Mikemyers,blackhand,1127,paladin,holy,30,12,18
Skailzpal,hyjal,1119,paladin,holy,24,13,11
Serim,dun-modr,1119,paladin,holy,54,23,31
Kanina,outland,1114,paladin,holy,58,23,35
Cmen,silvermoon,1111,paladin,holy,97,50,47
Tscheba,kazzak,1109,paladin,holy,82,42,40
Trístesse,tarren-mill,1109,paladin,holy,88,42,46
Unithral,durotan,1107,paladin,holy,24,12,12
Minui,onyxia,1100,paladin,holy,30,12,18
Nosn,ravencrest,1087,paladin,holy,66,34,32
Dabstar,antonidas,1086,paladin,holy,88,41,47
Jaezlin,tarren-mill,1077,paladin,holy,70,33,37
Palanolmal,dun-modr,1068,paladin,holy,33,16,17
Billkop,silvermoon,1063,paladin,holy,37,18,19
Darhuun,antonidas,1063,paladin,holy,30,12,18
Johnaggro,outland,1060,paladin,holy,31,13,18
Casmira,blackrock,1055,paladin,holy,18,11,7
Holeck,aegwynn,1054,paladin,holy,33,11,22
Andronar,blackmoore,1053,paladin,holy,24,11,13
Skinstructor,silvermoon,1051,paladin,holy,18,11,7
Emistesía,stormscale,1050,paladin,holy,30,11,19
Erao,the-maelstrom,1049,paladin,holy,30,11,19
Dawnforged,stormscale,1044,paladin,holy,36,12,24
Babybeater,outland,1043,paladin,holy,37,14,23
Grimbold,hellfire,1042,paladin,holy,18,11,7
Trisunonvaki,khazgoroth,1042,paladin,holy,84,37,47
Karnwield,kirin-tor,1039,paladin,holy,34,16,18
Kuhs,eredar,1038,paladin,holy,59,23,36
Neithi,twisting-nether,1033,paladin,holy,24,11,13
Guidone,sylvanas,1029,paladin,holy,24,11,13
Høpé,malganis,1028,paladin,holy,68,32,36
Zerfleddern,aegwynn,1026,paladin,holy,65,27,38
Palir,ysondre,1010,paladin,holy,24,11,13
Golldy,burning-legion,1008,paladin,holy,21,12,9
Paliester,stormscale,1007,paladin,holy,18,12,6
Satip,archimonde,993,paladin,holy,30,19,11
Poundcake,stormscale,990,paladin,holy,68,30,38
Buddy,conseil-des-ombres,988,paladin,holy,50,24,26
Legenda,grim-batol,979,paladin,holy,30,14,16
Clerik,eredar,972,paladin,holy,58,29,29
Byoß,ravencrest,960,paladin,holy,18,10,8
Seabrook,stormscale,960,paladin,holy,36,10,26
Drohim,aegwynn,959,paladin,holy,18,10,8
Umirinbruv,zenedar,959,paladin,holy,26,10,16
Pablok,minahonda,959,paladin,holy,30,10,20
Xelqt,draenor,958,paladin,holy,25,10,15
Whórainzóne,eredar,958,paladin,holy,36,10,26
Wingcomandêr,aegwynn,957,paladin,holy,24,10,14
Elians,outland,955,paladin,holy,24,10,14
Tömmÿ,draenor,954,paladin,holy,30,13,17
Crusadelight,alakir,953,paladin,holy,68,29,39
Roshï,tarren-mill,953,paladin,holy,30,10,20
Bcrp,ragnaros,950,paladin,holy,24,10,14
Skwáru,burning-legion,949,paladin,holy,24,10,14
Sweestance,minahonda,949,paladin,holy,30,10,20
Бэнкли,soulflayer,948,paladin,holy,18,10,8
Cmelacek,wildhammer,948,paladin,holy,18,10,8
Lightmamba,draenor,947,paladin,holy,30,10,20
Ударник,soulflayer,946,paladin,holy,18,11,7
Lightmachine,kirin-tor,945,paladin,holy,12,10,2
Uzuriel,chogall,942,paladin,holy,166,63,103
Kaktuszfüge,ragnaros,939,paladin,holy,40,22,18
Messîah,outland,939,paladin,holy,43,19,24
Badckes,sylvanas,937,paladin,holy,29,10,19
Çrúsader,frostmane,932,paladin,holy,18,10,8
Gabriev,twisting-nether,925,paladin,holy,14,11,3
Paladons,darksorrow,922,paladin,holy,30,16,14
Vintar,quelthalas,909,paladin,holy,30,12,18
Reeceboss,ravencrest,906,paladin,holy,29,12,17
Toradin,thunderhorn,905,paladin,holy,21,10,11
Öbedö,malganis,902,paladin,holy,27,10,17
Яполковник,gordunni,887,paladin,holy,53,30,23
Theisixtus,drakthul,883,paladin,holy,23,12,11
Veelris,kazzak,865,paladin,holy,60,28,32
Xsÿde,archimonde,864,paladin,holy,18,9,9
Pisr,draenor,864,paladin,holy,18,9,9
Мылонеуроних,deathguard,864,paladin,holy,18,9,9
Áfx,blackmoore,864,paladin,holy,37,14,23
Думгохан,howling-fjord,864,paladin,holy,24,9,15
Deathsfate,defias-brotherhood,863,paladin,holy,12,9,3
Erathoor,grim-batol,863,paladin,holy,18,9,9
Ashbrìnger,aegwynn,861,paladin,holy,18,9,9
Рэймета,soulflayer,861,paladin,holy,18,9,9
Expot,blackmoore,859,paladin,holy,18,9,9
Алекхей,gordunni,858,paladin,holy,24,9,15
Smirk,aggra-português,857,paladin,holy,12,9,3
Elganwar,hyjal,856,paladin,holy,18,9,9
Manole,ravencrest,855,paladin,holy,23,11,12
Kocovic,tarren-mill,855,paladin,holy,24,9,15
Faildin,arathor,853,paladin,holy,30,9,21
Burkaal,antonidas,852,paladin,holy,24,9,15
Fract,aggramar,838,paladin,holy,18,9,9
Kárlsberg,aegwynn,833,paladin,holy,30,12,18
Pupsihasi,kelthuzad,825,paladin,holy,17,9,8
Ridethelight,nemesis,823,paladin,holy,18,9,9
Salubrifie,archimonde,817,paladin,holy,18,9,9
Psycholas,ysondre,805,paladin,holy,17,9,8
Миллагрессия,soulflayer,797,paladin,holy,18,9,9
Derpe,hellscream,768,paladin,holy,18,8,10
Percocetx,tarren-mill,768,paladin,holy,24,8,16
Crucifiction,balnazzar,768,paladin,holy,24,8,16
Curufin,grim-batol,767,paladin,holy,12,8,4
Micrøsi,thrall,767,paladin,holy,18,8,10
Qpax,twisting-nether,767,paladin,holy,18,8,10
Emistesia,stormscale,767,paladin,holy,18,8,10
Claudîax,kazzak,767,paladin,holy,18,8,10
Konane,drekthar,767,paladin,holy,19,8,11
Asenae,draenor,767,paladin,holy,24,8,16
Dunutunicorn,argent-dawn,766,paladin,holy,12,8,4
Bezvakost,thunderhorn,766,paladin,holy,18,8,10
Bighammerx,ravencrest,765,paladin,holy,18,8,10
Rébél,argent-dawn,763,paladin,holy,24,8,16
Ikbenmani,tarren-mill,760,paladin,holy,18,8,10
Паландис,howling-fjord,757,paladin,holy,18,8,10
Yasmira,frostmourne,749,paladin,holy,12,8,4
Anemonaa,argent-dawn,722,paladin,holy,18,8,10
Churrucuca,minahonda,713,paladin,holy,15,9,6
Gegge,kazzak,701,paladin,holy,32,8,24
Haros,xavius,686,paladin,holy,13,8,5
Blazerlolz,kazzak,672,paladin,holy,12,7,5
Heartbroken,blackrock,672,paladin,holy,12,7,5
Ирестли,azuregos,672,paladin,holy,12,7,5
Ramos,aggra-português,672,paladin,holy,18,7,11
Papasito,tarren-mill,672,paladin,holy,24,7,17
Daddysiliam,ravencrest,671,paladin,holy,12,7,5
Tiffanyqt,frostwolf,671,paladin,holy,12,7,5
Skatiaringos,silvermoon,671,paladin,holy,18,7,11
Mohamedx,tarren-mill,671,paladin,holy,18,7,11
Skarn,pozzo-delleternità,670,paladin,holy,18,7,11
Lènnja,baelgun,670,paladin,holy,18,7,11
Seinz,talnivarr,668,paladin,holy,18,7,11
Luminix,ragnaros,667,paladin,holy,12,7,5
Edwín,tichondrius,667,paladin,holy,12,7,5
Juicemachine,silvermoon,663,paladin,holy,12,7,5
Langibo,malfurion,658,paladin,holy,12,7,5
Jüther,pozzo-delleternità,623,paladin,holy,17,7,10
Торсгард,howling-fjord,622,paladin,holy,15,8,7
Meive,sanguino,622,paladin,holy,17,7,10
Ubiquitous,kazzak,606,paladin,holy,17,7,10
Verlinya,archimonde,576,paladin,holy,12,6,6
Holyfuchsia,ravencrest,576,paladin,holy,12,6,6
Powerpufgirl,blackrock,576,paladin,holy,12,6,6
Ben,ghostlands,576,paladin,holy,12,6,6
Рустиктоп,gordunni,576,paladin,holy,12,6,6
Dogmatic,blackmoore,576,paladin,holy,12,6,6
Holypapa,argent-dawn,576,paladin,holy,12,6,6
Mðnsterz,archimonde,576,paladin,holy,12,6,6
Jinyssa,silvermoon,576,paladin,holy,12,6,6
Istani,twisting-nether,576,paladin,holy,12,6,6
Nádrüstál,kazzak,576,paladin,holy,12,6,6
Kiingen,ragnaros,576,paladin,holy,12,6,6
Bapêe,thrall,576,paladin,holy,12,6,6
Fannypoo,sylvanas,576,paladin,holy,18,6,12
Westranspal,ravencrest,576,paladin,holy,18,6,12
Neverbuble,archimonde,576,paladin,holy,18,6,12
Язвавгорле,soulflayer,576,paladin,holy,18,6,12
Elfaza,uldum,576,paladin,holy,24,6,18
Dragonwingz,kazzak,575,paladin,holy,12,6,6
Goodbit,dentarg,575,paladin,holy,12,6,6
Paliat,silvermoon,575,paladin,holy,13,6,7
Pussas,burning-legion,575,paladin,holy,18,6,12
Нинтендо,grom,575,paladin,holy,18,6,12
Fleshoflight,arathor,575,paladin,holy,24,6,18
Mestgone,dalaran,575,paladin,holy,24,6,18
Jeyløl,antonidas,574,paladin,holy,12,6,6
Cadila,silvermoon,574,paladin,holy,12,6,6
Elsirosel,dun-modr,574,paladin,holy,12,6,6
Pussdocta,ravencrest,574,paladin,holy,18,6,12
Kaleto,ragnaros,570,paladin,holy,12,6,6
Pigpiss,ravencrest,527,paladin,holy,11,6,5
Heavel,thrall,527,paladin,holy,17,6,11
Rotana,eredar,480,paladin,holy,6,5,1
Teksor,frostmourne,480,paladin,holy,6,5,1
Pepegasensei,ravencrest,480,paladin,holy,6,5,1
Ðelusion,sanguino,480,paladin,holy,6,5,1
Bossedin,aszune,480,paladin,holy,12,5,7
Itsgossiplol,twisting-nether,480,paladin,holy,12,5,7
Tibelious,ravencrest,480,paladin,holy,12,5,7
Fluentx,ravencrest,480,paladin,holy,12,5,7
Gayestpala,ravencrest,480,paladin,holy,12,5,7
Лайхтни,gordunni,480,paladin,holy,12,5,7
Holydeals,silvermoon,480,paladin,holy,12,5,7
Stepsislana,tarren-mill,480,paladin,holy,12,5,7
Présidential,grim-batol,480,paladin,holy,12,5,7
Аффикстинка,soulflayer,480,paladin,holy,12,5,7
Гола,gordunni,480,paladin,holy,18,5,13
Zymotíx,stormscale,480,paladin,holy,18,5,13
Holydhanas,outland,480,paladin,holy,18,5,13
Ðeswynd,hyjal,480,paladin,holy,24,5,19
Tarhal,guldan,479,paladin,holy,6,5,1
Brøadway,eredar,479,paladin,holy,12,5,7
Stinkytoes,draenor,479,paladin,holy,12,5,7
Лазуриса,deathguard,479,paladin,holy,12,5,7
Малимон,soulflayer,479,paladin,holy,12,5,7
Gavril,bloodfeather,479,paladin,holy,12,5,7
Puiçanpal,archimonde,479,paladin,holy,12,5,7
Liadry,sylvanas,479,paladin,holy,12,5,7
Truthbearer,darksorrow,479,paladin,holy,16,5,11
Bellamy,vashj,479,paladin,holy,18,5,13
Groove,colinas-pardas,478,paladin,holy,16,6,10
Bubblegum,dentarg,478,paladin,holy,18,5,13
Menagron,tarren-mill,476,paladin,holy,13,5,8
Styflor,dalaran,476,paladin,holy,18,5,13
Ázot,burning-legion,475,paladin,holy,18,5,13
Chantal,gilneas,474,paladin,holy,12,5,7
Jargot,antonidas,472,paladin,holy,12,5,7
Memewings,tarren-mill,426,paladin,holy,17,7,10
Тейдехан,gordunni,426,paladin,holy,21,6,15
Eastranspal,ravencrest,426,paladin,holy,24,6,18
Bloednicht,dentarg,384,paladin,holy,6,4,2
Shamoo,archimonde,384,paladin,holy,6,4,2
Lexolex,ravencrest,384,paladin,holy,6,4,2
Nemesisbot,dun-modr,384,paladin,holy,6,4,2
Wiffy,ravencrest,384,paladin,holy,6,4,2
Дезоиль,gordunni,384,paladin,holy,6,4,2
Elp,ysondre,384,paladin,holy,6,4,2
Dragg,kirin-tor,384,paladin,holy,6,4,2
Chewwaka,bloodhoof,384,paladin,holy,6,4,2
Holydawnx,kazzak,384,paladin,holy,6,4,2
Первыйпал,blackscar,384,paladin,holy,6,4,2
Ванябублгам,soulflayer,384,paladin,holy,6,4,2
Fluv,ravencrest,384,paladin,holy,6,4,2
Shívah,auchindoun,384,paladin,holy,12,4,8
Stratarxis,kazzak,384,paladin,holy,12,4,8
Vânwêêd,thrall,384,paladin,holy,12,4,8
Eline,zenedar,384,paladin,holy,12,4,8
Lianndrin,blackhand,384,paladin,holy,12,4,8
Дэнриэль,howling-fjord,384,paladin,holy,12,4,8
Imitrex,hyjal,384,paladin,holy,12,4,8
Hammarfall,ravencrest,384,paladin,holy,12,4,8
Cerseï,frostmane,384,paladin,holy,12,4,8
Norandel,turalyon,384,paladin,holy,12,4,8
Подлыйдим,fordragon,384,paladin,holy,12,4,8
Sebatrøz,ravencrest,384,paladin,holy,12,4,8
Tyrø,ravencrest,384,paladin,holy,12,4,8
Psikatchuu,hyjal,384,paladin,holy,12,4,8
Visersion,tarren-mill,384,paladin,holy,12,4,8
Талрэн,howling-fjord,384,paladin,holy,18,4,14
Dunka,twisting-nether,383,paladin,holy,6,4,2
Anfe,silvermoon,383,paladin,holy,12,4,8
Caumon,los-errantes,383,paladin,holy,12,4,8
Кэлви,blackscar,383,paladin,holy,12,4,8
Galadørn,elune,383,paladin,holy,12,4,8
Scissors,dun-morogh,383,paladin,holy,18,4,14
Santtox,dun-modr,383,paladin,holy,18,4,14
Superpaladin,draenor,383,paladin,holy,18,4,14
Avengilo,silvermoon,382,paladin,holy,12,4,8
Zetla,khaz-modan,382,paladin,holy,12,4,8
Lezoom,draenor,367,paladin,holy,11,4,7
Konpala,blackmoore,367,paladin,holy,11,4,7
Justyowx,archimonde,352,paladin,holy,16,5,11
Zeret,twisting-nether,329,paladin,holy,16,6,10
Ysnee,sanguino,320,paladin,holy,16,4,12
Veléxis,outland,288,paladin,holy,6,3,3
Grafes,sanguino,288,paladin,holy,6,3,3
Snoogléface,grim-batol,288,paladin,holy,6,3,3
Solumon,gorgonnash,288,paladin,holy,6,3,3
Matagladis,dun-modr,288,paladin,holy,6,3,3
Vôltuxx,outland,288,paladin,holy,6,3,3
Keltinne,ysondre,288,paladin,holy,6,3,3
Вивай,howling-fjord,288,paladin,holy,6,3,3
Bandrogina,shattered-hand,288,paladin,holy,6,3,3
Reeley,drakthul,288,paladin,holy,6,3,3
Preamx,blackrock,288,paladin,holy,6,3,3
Эвердрим,soulflayer,288,paladin,holy,6,3,3
Gtgpiscine,kirin-tor,288,paladin,holy,6,3,3
Tacodin,blackrock,288,paladin,holy,6,3,3
Rohanan,blackrock,288,paladin,holy,6,3,3
Бладиполи,soulflayer,288,paladin,holy,6,3,3
Breez,die-aldor,288,paladin,holy,6,3,3
Кейлол,soulflayer,288,paladin,holy,9,3,6
Zerohour,kilrogg,288,paladin,holy,12,3,9
Bigdamjudge,argent-dawn,288,paladin,holy,12,3,9
Heldarim,ysondre,288,paladin,holy,12,3,9
Arbuzno,draenor,288,paladin,holy,12,3,9
Linxo,argent-dawn,288,paladin,holy,12,3,9
Tyraïa,archimonde,288,paladin,holy,12,3,9
Brölin,sanguino,288,paladin,holy,12,3,9
Krayzier,nordrassil,288,paladin,holy,12,3,9
Telarii,die-nachtwache,288,paladin,holy,12,3,9
Jctp,ravencrest,288,paladin,holy,12,3,9
Kapsloch,twisting-nether,288,paladin,holy,12,3,9
Kelmarr,blackmoore,288,paladin,holy,12,3,9
Rezvaya,tarren-mill,288,paladin,holy,12,3,9
Kaelorian,silvermoon,288,paladin,holy,18,3,15
Averyholycow,the-maelstrom,287,paladin,holy,6,3,3
Макспал,lich-king,287,paladin,holy,6,3,3
Kcore,blackrock,287,paladin,holy,12,3,9
Purificatoru,draenor,287,paladin,holy,12,3,9
Toxií,argent-dawn,287,paladin,holy,12,3,9
Mozzie,archimonde,282,paladin,holy,23,5,18
Regis,dragonblight,275,paladin,holy,14,6,8
Европпа,soulflayer,271,paladin,holy,16,3,13
Gaskohle,blackmoore,255,paladin,holy,11,3,8
Xila,blackrock,234,paladin,holy,9,4,5
Mustardio,tarren-mill,234,paladin,holy,14,4,10
Dewastør,blackmoore,234,paladin,holy,15,4,11
Pátish,terenas,192,paladin,holy,6,2,4
Vadomar,emerald-dream,192,paladin,holy,6,2,4
Zeiserig,antonidas,192,paladin,holy,6,2,4
Edgï,confrérie-du-thorium,192,paladin,holy,6,2,4
Rdypaladin,ravencrest,192,paladin,holy,6,2,4
Jeromesavile,tarren-mill,192,paladin,holy,6,2,4
Realdeal,argent-dawn,192,paladin,holy,6,2,4
Nirvanä,drakthul,192,paladin,holy,6,2,4
Fleshgraft,drakthul,192,paladin,holy,6,2,4
Datz,nerathor,192,paladin,holy,6,2,4
Truko,frostwolf,192,paladin,holy,6,2,4
Teflonmagìc,ravencrest,192,paladin,holy,6,2,4
Zabrok,outland,192,paladin,holy,6,2,4
Pârabellum,the-maelstrom,192,paladin,holy,6,2,4
Bígmachine,draenor,192,paladin,holy,6,2,4
Rulîx,blackmoore,192,paladin,holy,6,2,4
Poonky,dun-modr,192,paladin,holy,6,2,4
Lafrogge,culte-de-la-rive-noire,192,paladin,holy,6,2,4
Lompe,karazhan,192,paladin,holy,6,2,4
Léinãd,kazzak,192,paladin,holy,6,2,4
Alisonquínn,defias-brotherhood,192,paladin,holy,6,2,4
Perpon,exodar,192,paladin,holy,6,2,4
Padraic,scarshield-legion,192,paladin,holy,6,2,4
Durnell,sylvanas,192,paladin,holy,6,2,4
Conker,malganis,192,paladin,holy,6,2,4
Pagadi,blackhand,192,paladin,holy,6,2,4
Дюве,blackscar,192,paladin,holy,6,2,4
Ришардебюр,soulflayer,192,paladin,holy,6,2,4
Galadrion,dun-modr,192,paladin,holy,6,2,4
Calipse,outland,192,paladin,holy,6,2,4
Прожектор,gordunni,192,paladin,holy,6,2,4
Faíren,blackrock,192,paladin,holy,6,2,4
Elrack,blackhand,192,paladin,holy,6,2,4
Envli,ragnaros,192,paladin,holy,6,2,4
Benedikt,stormscale,192,paladin,holy,6,2,4
Amôn,outland,192,paladin,holy,10,2,8
Essina,argent-dawn,192,paladin,holy,12,2,10
Croptol,dun-modr,192,paladin,holy,12,2,10
Холидугги,howling-fjord,192,paladin,holy,12,2,10
Àkí,blackmoore,191,paladin,holy,6,2,4
Tiboeufpéi,archimonde,191,paladin,holy,6,2,4
Zuplex,deathwing,191,paladin,holy,6,2,4
Pïñkñætðøðÿ,tarren-mill,138,paladin,holy,14,3,11
Fükdîscláss,ravencrest,96,paladin,holy,6,1,5
Holyfalls,blackmoore,96,paladin,holy,6,1,5
Acongojante,zuljin,96,paladin,holy,6,1,5
Aggressìon,twisting-nether,96,paladin,holy,6,1,5
Aienest,ragnaros,96,paladin,holy,6,1,5
Switchflip,frostmane,96,paladin,holy,6,1,5
Enriel,temple-noir,96,paladin,holy,6,1,5
Whiskeypal,draenor,96,paladin,holy,6,1,5
Maxôr,norgannon,96,paladin,holy,6,1,5
Bittersweex,stormscale,96,paladin,holy,6,1,5
Agorasieya,frostwolf,96,paladin,holy,6,1,5
Dedicatèd,draenor,96,paladin,holy,6,1,5
Xephiroxus,the-venture-co,96,paladin,holy,6,1,5
Flashhèart,draenor,96,paladin,holy,6,1,5
Mybadvibes,tarren-mill,96,paladin,holy,6,1,5
Înphy,cthun,96,paladin,holy,6,1,5
Lichbörnè,outland,96,paladin,holy,6,1,5
Penth,doomhammer,96,paladin,holy,6,1,5
Shanik,zuljin,96,paladin,holy,6,1,5
Rehtu,malganis,96,paladin,holy,6,1,5
Minirempart,khaz-modan,96,paladin,holy,6,1,5
Wingcomander,aegwynn,96,paladin,holy,6,1,5
Zerafic,sylvanas,96,paladin,holy,6,1,5
Colpadeltank,kazzak,96,paladin,holy,6,1,5
Dreamwatcher,outland,96,paladin,holy,6,1,5
Iamyellow,silvermoon,96,paladin,holy,6,1,5
Демига,ashenvale,96,paladin,holy,6,1,5
Andrøiz,dun-modr,96,paladin,holy,6,1,5
Bubbleheart,ahnqiraj,96,paladin,holy,6,1,5
Playprist,aegwynn,96,paladin,holy,6,1,5
Shiøn,zuljin,96,paladin,holy,6,1,5
Jasiv,draenor,96,paladin,holy,12,1,11
Лейфи,howling-fjord,96,paladin,holy,12,1,11
Lunaary,antonidas,96,paladin,holy,12,1,11
Callon,das-syndikat,95,paladin,holy,6,1,5
Hitaki,tarren-mill,64,paladin,holy,4,1,3
Yijania,argent-dawn,42,paladin,holy,9,2,7
Cosmicstâr,kazzak,2152,paladin,retribution,101,53,48
Steelsuit,argent-dawn,2132,paladin,retribution,176,98,78
Ðâny,elune,2128,paladin,retribution,135,68,67
Аеррис,gordunni,2106,paladin,retribution,113,57,56
Miilicium,archimonde,2091,paladin,retribution,83,41,42
Peiker,blackrock,2073,paladin,retribution,112,54,58
Mýstíc,ravencrest,2049,paladin,retribution,118,56,62
Ufø,magtheridon,2029,paladin,retribution,78,39,39
Miriokekw,archimonde,2020,paladin,retribution,96,45,51
Sacredwrath,burning-legion,2017,paladin,retribution,59,30,29
Nedith,pozzo-delleternità,2013,paladin,retribution,84,46,38
Аполодориан,gordunni,2012,paladin,retribution,102,56,46
Bernhoftxd,ravencrest,2003,paladin,retribution,110,51,59
Drkp,blackrock,1993,paladin,retribution,49,32,17
Retwar,ravencrest,1986,paladin,retribution,77,49,28
Sonne,tarren-mill,1985,paladin,retribution,72,36,36
Нейтхигерс,howling-fjord,1974,paladin,retribution,83,43,40
Xillindion,blackhand,1958,paladin,retribution,110,56,54
Jowanno,stormscale,1945,paladin,retribution,84,43,41
Ðeathron,blackmoore,1945,paladin,retribution,93,46,47
Günykoloke,blackrock,1939,paladin,retribution,54,33,21
Bersercute,sylvanas,1939,paladin,retribution,96,48,48
Kriszi,burning-legion,1938,paladin,retribution,90,39,51
Monkeytm,archimonde,1928,paladin,retribution,52,25,27
Durenai,aegwynn,1925,paladin,retribution,96,46,50
Nîhil,silvermoon,1920,paladin,retribution,76,34,42
Zerørespect,ravencrest,1917,paladin,retribution,77,35,42
Royki,the-maelstrom,1916,paladin,retribution,72,32,40
Bigspin,ravencrest,1906,paladin,retribution,54,29,25
Ricexoxo,blackhand,1904,paladin,retribution,56,25,31
Martoretard,archimonde,1903,paladin,retribution,142,71,71
Ctierpala,ravencrest,1903,paladin,retribution,60,30,30
Nastalia,elune,1896,paladin,retribution,24,20,4
Brassaren,stormscale,1890,paladin,retribution,67,36,31
Синодх,eversong,1888,paladin,retribution,76,34,42
Âlßêdø,ravencrest,1888,paladin,retribution,89,38,51
Толвард,gordunni,1881,paladin,retribution,25,21,4
Bakawolf,burning-legion,1879,paladin,retribution,66,32,34
Pancakee,the-maelstrom,1872,paladin,retribution,60,31,29
Vabz,blackrock,1867,paladin,retribution,47,23,24
Дэнискарз,gordunni,1866,paladin,retribution,48,26,22
Стьюпидбой,howling-fjord,1864,paladin,retribution,125,64,61
Swahadon,stormscale,1862,paladin,retribution,60,29,31
Mezor,dun-modr,1860,paladin,retribution,66,34,32
Djstompyamom,stormscale,1859,paladin,retribution,69,33,36
Antou,twisting-nether,1857,paladin,retribution,141,69,72
Dasar,twisting-nether,1851,paladin,retribution,72,31,41
Nein,blackhand,1848,paladin,retribution,102,47,55
Dibzi,argent-dawn,1845,paladin,retribution,54,27,27
Risingfi,kult-der-verdammten,1844,paladin,retribution,78,47,31
Astilia,sylvanas,1843,paladin,retribution,84,43,41
Hornyret,kazzak,1839,paladin,retribution,96,46,50
Малиновыйбох,gordunni,1835,paladin,retribution,78,48,30
Yuber,ravencrest,1833,paladin,retribution,78,34,44
Hódle,silvermoon,1831,paladin,retribution,42,29,13
Ilòvekris,draenor,1830,paladin,retribution,183,93,90
Phix,outland,1830,paladin,retribution,99,50,49
Декионзхц,howling-fjord,1830,paladin,retribution,78,29,49
Hojinson,blackrock,1828,paladin,retribution,48,34,14
Holzer,azshara,1826,paladin,retribution,47,26,21
Eimaqt,stormscale,1825,paladin,retribution,70,33,37
Denastys,nemesis,1824,paladin,retribution,60,28,32
Cqt,ravencrest,1823,paladin,retribution,66,30,36
Beautýbeast,ravencrest,1821,paladin,retribution,65,32,33
Дюрьвючыф,razuvious,1819,paladin,retribution,143,74,69
Âtlas,ragnaros,1819,paladin,retribution,48,24,24
Taurski,sylvanas,1817,paladin,retribution,48,35,13
Angryturk,ravencrest,1816,paladin,retribution,36,19,17
Фемдом,blackscar,1814,paladin,retribution,48,27,21
Morri,ravencrest,1814,paladin,retribution,171,83,88
Mayhemx,ravencrest,1814,paladin,retribution,112,52,60
Сотранокинг,soulflayer,1813,paladin,retribution,30,19,11
Ktk,ravencrest,1813,paladin,retribution,121,67,54
Granfort,argent-dawn,1813,paladin,retribution,114,55,59
Yungboihoj,twisting-nether,1813,paladin,retribution,131,63,68
Rankoneretri,arathor,1812,paladin,retribution,30,19,11
Doomsoom,kazzak,1810,paladin,retribution,34,26,8
Коварное,borean-tundra,1810,paladin,retribution,66,36,30
Syruplol,blackrock,1809,paladin,retribution,48,25,23
Делимнаноль,blackscar,1809,paladin,retribution,66,34,32
Zscrew,nemesis,1807,paladin,retribution,30,19,11
Ðaegos,blackmoore,1807,paladin,retribution,89,39,50
Matriarchxd,kazzak,1805,paladin,retribution,48,24,24
Vhardan,archimonde,1805,paladin,retribution,143,71,72
Bulkpwders,burning-legion,1803,paladin,retribution,30,19,11
Karadøc,archimonde,1802,paladin,retribution,90,41,49
Wingsteak,draenor,1801,paladin,retribution,51,25,26
Delgato,kazzak,1800,paladin,retribution,152,80,72
Icekissz,hyjal,1795,paladin,retribution,24,19,5
Vadya,ravencrest,1795,paladin,retribution,47,24,23
Pâsla,hyjal,1795,paladin,retribution,89,44,45
Elypsia,tarren-mill,1795,paladin,retribution,80,37,43
Paakz,stormscale,1794,paladin,retribution,90,52,38
Лиспорий,gordunni,1789,paladin,retribution,42,19,23
Simjon,defias-brotherhood,1788,paladin,retribution,159,91,68
Ниашес,howling-fjord,1788,paladin,retribution,65,29,36
Vylnoa,twisting-nether,1786,paladin,retribution,55,27,28
Kazuroo,blackmoore,1783,paladin,retribution,42,22,20
Tremelay,silvermoon,1782,paladin,retribution,210,105,105
Holysiah,kazzak,1782,paladin,retribution,42,19,23
Skyrose,ravencrest,1778,paladin,retribution,90,51,39
Zion,runetotem,1777,paladin,retribution,36,21,15
Halevia,kazzak,1776,paladin,retribution,41,24,17
Мрч,howling-fjord,1775,paladin,retribution,42,21,21
Lesterqt,thrall,1773,paladin,retribution,102,47,55
Vankwok,stormscale,1771,paladin,retribution,33,20,13
Sofhiya,silvermoon,1759,paladin,retribution,42,24,18
Блэканус,blackscar,1759,paladin,retribution,54,25,29
Опгоп,gordunni,1758,paladin,retribution,89,45,44
Kinvqt,tarren-mill,1756,paladin,retribution,52,26,26
Tanny,kazzak,1756,paladin,retribution,48,20,28
Игры,gordunni,1755,paladin,retribution,59,28,31
Yungboii,kazzak,1753,paladin,retribution,59,37,22
Bigdblaster,twisting-nether,1752,paladin,retribution,48,23,25
Охоху,gordunni,1751,paladin,retribution,83,47,36
Данхайк,gordunni,1750,paladin,retribution,114,68,46
Netharia,antonidas,1748,paladin,retribution,108,51,57
Мегопалл,blackscar,1738,paladin,retribution,90,38,52
Selina,burning-legion,1737,paladin,retribution,71,36,35
Legodudex,ravencrest,1736,paladin,retribution,48,25,23
Qarak,argent-dawn,1732,paladin,retribution,65,30,35
Пинкпуссибой,howling-fjord,1729,paladin,retribution,50,29,21
Mordar,ravencrest,1726,paladin,retribution,49,25,24
Tadashì,aegwynn,1726,paladin,retribution,60,25,35
Freshreroll,tarren-mill,1723,paladin,retribution,36,24,12
Bregowine,doomhammer,1723,paladin,retribution,131,78,53
Salti,magtheridon,1723,paladin,retribution,136,75,61
Xeaa,tarren-mill,1718,paladin,retribution,42,18,24
Trølled,aegwynn,1713,paladin,retribution,48,21,27
Nikkibenzqt,blackmoore,1713,paladin,retribution,60,25,35
Prex,dun-modr,1712,paladin,retribution,54,25,29
Dannyvye,outland,1712,paladin,retribution,48,21,27
Zazalamel,hyjal,1705,paladin,retribution,42,25,17
Чупаа,howling-fjord,1704,paladin,retribution,42,26,16
Foreskinx,draenor,1704,paladin,retribution,30,18,12
Pestomp,tarren-mill,1704,paladin,retribution,53,24,29
Модрит,soulflayer,1703,paladin,retribution,41,26,15
Nutqtgodx,archimonde,1702,paladin,retribution,36,21,15
Dudjaw,stormscale,1702,paladin,retribution,42,18,24
Rli,twisting-nether,1698,paladin,retribution,59,31,28
Tazken,tarren-mill,1697,paladin,retribution,54,25,29
Rullatôrsven,stormscale,1697,paladin,retribution,48,18,30
Warmâchiine,burning-legion,1692,paladin,retribution,48,29,19
Ruath,xavius,1691,paladin,retribution,84,42,42
Thedarksteel,ravencrest,1690,paladin,retribution,54,25,29
Eysn,blackrock,1689,paladin,retribution,42,20,22
Kêkbûrâgol,kazzak,1688,paladin,retribution,30,20,10
Réaxon,archimonde,1688,paladin,retribution,57,24,33
Bigbuffdaddy,draenor,1687,paladin,retribution,166,82,84
Зондарк,booty-bay,1687,paladin,retribution,59,24,35
Losër,ravencrest,1687,paladin,retribution,54,20,34
Tsorig,tarren-mill,1682,paladin,retribution,102,56,46
Dréamypie,silvermoon,1681,paladin,retribution,47,18,29
Анофарин,gordunni,1680,paladin,retribution,49,18,31
Аскеттх,gordunni,1678,paladin,retribution,48,27,21
Staticdeath,ravencrest,1676,paladin,retribution,78,42,36
Gùtz,xavius,1676,paladin,retribution,51,23,28
Spegepølse,silvermoon,1675,paladin,retribution,68,40,28
Кавайнекс,azuregos,1675,paladin,retribution,62,32,30
Misako,sanguino,1669,paladin,retribution,84,42,42
Littlelíght,silvermoon,1666,paladin,retribution,36,22,14
Singlemomdtf,argent-dawn,1665,paladin,retribution,54,24,30
Стимулин,howling-fjord,1662,paladin,retribution,42,22,20
Rekktadin,grim-batol,1661,paladin,retribution,71,31,40
Milkyavenger,sylvanas,1659,paladin,retribution,53,35,18
Smirk,aggra-português,1659,paladin,retribution,48,22,26
Ярослэйв,howling-fjord,1658,paladin,retribution,45,21,24
Vanthael,chamber-of-aspects,1654,paladin,retribution,138,76,62
Сводимиаое,soulflayer,1654,paladin,retribution,45,22,23
Сёмаигрок,soulflayer,1654,paladin,retribution,54,26,28
Pætter,aggra-português,1652,paladin,retribution,36,22,14
Íbossít,doomhammer,1652,paladin,retribution,66,36,30
Gaalarr,burning-legion,1650,paladin,retribution,36,20,16
Baxuz,draenor,1648,paladin,retribution,42,22,20
Ðenlox,destromath,1647,paladin,retribution,54,23,31
Wakke,outland,1646,paladin,retribution,32,23,9
Djcrusade,twisting-nether,1645,paladin,retribution,98,57,41
Xila,blackrock,1645,paladin,retribution,54,21,33
Bjornulfr,ravencrest,1643,paladin,retribution,101,42,59
Afhvahj,tichondrius,1634,paladin,retribution,40,23,17
Pruntadin,silvermoon,1634,paladin,retribution,60,26,34
Breakdøwñ,blackrock,1634,paladin,retribution,148,63,85
Ønlyfâns,dragonblight,1633,paladin,retribution,54,23,31
Draizor,twisting-nether,1631,paladin,retribution,89,42,47
Shmndr,kazzak,1630,paladin,retribution,30,18,12
Lightsaint,kazzak,1630,paladin,retribution,48,26,22
Sübôvîñ,ravencrest,1629,paladin,retribution,44,26,18
Bobiwan,ravencrest,1629,paladin,retribution,30,17,13
Krîstal,aegwynn,1629,paladin,retribution,41,20,21
Gilet,argent-dawn,1628,paladin,retribution,30,18,12
Биоразлагаем,gordunni,1628,paladin,retribution,66,37,29
Wyllian,grim-batol,1628,paladin,retribution,48,23,25
Фэйсрол,gordunni,1628,paladin,retribution,59,21,38
Отловщик,gordunni,1627,paladin,retribution,36,17,19
Msharix,kazzak,1625,paladin,retribution,30,17,13
Cauze,ravencrest,1624,paladin,retribution,66,38,28
Lisma,bloodfeather,1623,paladin,retribution,47,26,21
Wingsmode,kazzak,1623,paladin,retribution,48,17,31
Katanaclówn,eredar,1620,paladin,retribution,48,25,23
Nanisunda,thrall,1620,paladin,retribution,102,48,54
Charmxx,stormscale,1618,paladin,retribution,30,18,12
Lonesolo,sylvanas,1618,paladin,retribution,36,20,16
Liendry,antonidas,1618,paladin,retribution,41,19,22
Ças,quelthalas,1618,paladin,retribution,42,17,25
Hýox,malganis,1617,paladin,retribution,37,18,19
Azlaya,sargeras,1617,paladin,retribution,54,25,29
Утипутя,goldrinn,1616,paladin,retribution,30,17,13
Nizzlee,eredar,1616,paladin,retribution,36,20,16
Holyblast,archimonde,1615,paladin,retribution,42,22,20
Aqualisse,hyjal,1615,paladin,retribution,48,20,28
Leoxander,outland,1613,paladin,retribution,42,21,21
Valhella,stormscale,1611,paladin,retribution,111,57,54
Akrobatka,sanguino,1611,paladin,retribution,48,20,28
Discølove,blackmoore,1610,paladin,retribution,43,21,22
Batteldin,blackmoore,1609,paladin,retribution,89,56,33
Snødunkern,outland,1609,paladin,retribution,96,41,55
Biggboii,twisting-nether,1608,paladin,retribution,48,19,29
Akoumb,twisting-nether,1606,paladin,retribution,42,20,22
Fisslol,kazzak,1606,paladin,retribution,60,28,32
Мяумяухх,soulflayer,1603,paladin,retribution,51,32,19
Hargreeve,ravencrest,1602,paladin,retribution,48,24,24
Zubxp,ravencrest,1602,paladin,retribution,36,17,19
Stracciatell,archimonde,1601,paladin,retribution,18,17,1
Saabnaab,outland,1600,paladin,retribution,96,59,37
Skippadin,ravencrest,1600,paladin,retribution,59,30,29
Unschúld,blackrock,1596,paladin,retribution,55,34,21
Русэльф,howling-fjord,1593,paladin,retribution,59,32,27
Frankostyle,sanguino,1590,paladin,retribution,41,20,21
Телканапалке,blackscar,1587,paladin,retribution,30,21,9
Altundrdel,ravencrest,1587,paladin,retribution,48,25,23
Meìster,blackmoore,1586,paladin,retribution,48,20,28
Malthred,ravenholdt,1583,paladin,retribution,47,22,25
Glàdiator,outland,1583,paladin,retribution,41,18,23
Zarrex,blackrock,1582,paladin,retribution,36,18,18
Ämÿcüs,zuljin,1581,paladin,retribution,66,37,29
Sántouryu,ravencrest,1580,paladin,retribution,110,49,61
Кузькинамать,greymane,1580,paladin,retribution,54,20,34
Knigh,draenor,1578,paladin,retribution,66,35,31
Hammarfall,ravencrest,1578,paladin,retribution,63,31,32
Honorkill,silvermoon,1577,paladin,retribution,91,52,39
Uliko,twisting-nether,1577,paladin,retribution,48,26,22
Thyrec,thrall,1576,paladin,retribution,36,18,18
Emostylex,draenor,1575,paladin,retribution,77,27,50
Palwig,tarren-mill,1573,paladin,retribution,42,22,20
Karyouka,archimonde,1572,paladin,retribution,42,25,17
Kaitlyne,tarren-mill,1570,paladin,retribution,53,25,28
Kaileena,archimonde,1569,paladin,retribution,36,19,17
Deadholland,ravencrest,1568,paladin,retribution,34,18,16
Мистеравадон,gordunni,1568,paladin,retribution,48,19,29
Кронкс,howling-fjord,1566,paladin,retribution,129,66,63
Дезоиль,gordunni,1564,paladin,retribution,36,18,18
Магрейм,gordunni,1564,paladin,retribution,41,17,24
Kathí,kazzak,1563,paladin,retribution,24,18,6
Rugila,ragnaros,1562,paladin,retribution,51,33,18
Jiraaqi,silvermoon,1562,paladin,retribution,53,27,26
Opsyoudie,kazzak,1561,paladin,retribution,51,21,30
Wootschi,arthas,1560,paladin,retribution,29,17,12
Mhehø,hyjal,1560,paladin,retribution,66,23,43
Tyri,silvermoon,1559,paladin,retribution,54,25,29
Джамбит,howling-fjord,1556,paladin,retribution,36,18,18
Theodór,antonidas,1555,paladin,retribution,59,24,35
Kènpachî,blackrock,1554,paladin,retribution,36,19,17
Runhexi,silvermoon,1553,paladin,retribution,36,19,17
Taiso,alonsus,1552,paladin,retribution,59,30,29
Azûl,archimonde,1547,paladin,retribution,60,30,30
Surian,kazzak,1546,paladin,retribution,30,18,12
Gulinborsti,aegwynn,1544,paladin,retribution,42,29,13
Владыкасвета,borean-tundra,1544,paladin,retribution,36,20,16
Maybach,onyxia,1543,paladin,retribution,66,31,35
Starworkal,ragnaros,1541,paladin,retribution,30,17,13
Zeldalòl,outland,1541,paladin,retribution,59,25,34
Tóxicpaladín,kazzak,1537,paladin,retribution,39,20,19
Dabeefchief,outland,1535,paladin,retribution,22,17,5
Naneno,silvermoon,1535,paladin,retribution,40,18,22
Jorhall,antonidas,1531,paladin,retribution,97,51,46
Johannx,tarren-mill,1531,paladin,retribution,60,20,40
Palior,sylvanas,1530,paladin,retribution,30,16,14
Sitekx,burning-legion,1530,paladin,retribution,45,17,28
Ришардебюр,soulflayer,1528,paladin,retribution,71,34,37
Elrandil,kazzak,1528,paladin,retribution,72,33,39
Isora,twisting-nether,1527,paladin,retribution,36,16,20
Xawier,ghostlands,1524,paladin,retribution,54,28,26
Аилерия,howling-fjord,1522,paladin,retribution,78,44,34
Drakingsang,blackhand,1522,paladin,retribution,36,16,20
Tazkaz,archimonde,1520,paladin,retribution,30,17,13
Таптыгин,gordunni,1518,paladin,retribution,36,16,20
Rapwnzel,sylvanas,1515,paladin,retribution,60,30,30
Волатбай,gordunni,1513,paladin,retribution,48,29,19
Røck,aggra-português,1512,paladin,retribution,47,27,20
Mélli,eredar,1512,paladin,retribution,45,25,20
Snibsxpala,silvermoon,1512,paladin,retribution,36,19,17
Деленка,gordunni,1511,paladin,retribution,24,16,8
Бэйгреон,gordunni,1511,paladin,retribution,44,27,17
Impaross,shattrath,1509,paladin,retribution,159,87,72
Threathor,outland,1509,paladin,retribution,81,41,40
Саймум,blackscar,1509,paladin,retribution,45,19,26
Nergigante,drekthar,1503,paladin,retribution,36,16,20
Doomgape,alakir,1502,paladin,retribution,48,18,30
Батллграунт,soulflayer,1500,paladin,retribution,73,46,27
Powerpuffret,antonidas,1500,paladin,retribution,42,20,22
Wuzzle,azshara,1499,paladin,retribution,24,16,8
Jathx,silvermoon,1498,paladin,retribution,62,36,26
Arígato,argent-dawn,1498,paladin,retribution,83,39,44
Ralphias,twisting-nether,1498,paladin,retribution,72,32,40
Колсет,soulflayer,1496,paladin,retribution,37,17,20
Aethelwold,ragnaros,1494,paladin,retribution,84,29,55
Ben,ghostlands,1492,paladin,retribution,24,16,8
Hys,stormscale,1492,paladin,retribution,30,17,13
Tyrael,darksorrow,1490,paladin,retribution,104,46,58
Testør,ragnaros,1489,paladin,retribution,41,16,25
Sonarix,blackrock,1488,paladin,retribution,51,26,25
Paellysuir,blackmoore,1488,paladin,retribution,54,24,30
Менетиил,galakrond,1488,paladin,retribution,52,17,35
Baldivar,silvermoon,1484,paladin,retribution,60,35,25
Luhae,archimonde,1483,paladin,retribution,60,35,25
Catar,arathor,1482,paladin,retribution,157,87,70
Тюрр,lich-king,1480,paladin,retribution,43,21,22
Shockashy,stormscale,1480,paladin,retribution,38,18,20
Mystixd,talnivarr,1477,paladin,retribution,24,18,6
Ветрум,gordunni,1477,paladin,retribution,30,17,13
Ârev,antonidas,1477,paladin,retribution,35,19,16
Shröömïë,silvermoon,1477,paladin,retribution,111,56,55
Walladin,stormscale,1476,paladin,retribution,57,30,27
Shtaladin,sylvanas,1472,paladin,retribution,53,24,29
Jøøs,sargeras,1471,paladin,retribution,51,30,21
Io,frostwolf,1464,paladin,retribution,66,25,41
Ceccil,dun-modr,1462,paladin,retribution,30,19,11
Ulrhik,nemesis,1461,paladin,retribution,45,17,28
Йосяфлексер,howling-fjord,1459,paladin,retribution,42,22,20
Ysell,sargeras,1458,paladin,retribution,38,18,20
Lightbrîng,hyjal,1455,paladin,retribution,42,17,25
Gluttön,tarren-mill,1454,paladin,retribution,25,16,9
Elinmogz,kazzak,1454,paladin,retribution,26,16,10
Синфуледи,gordunni,1454,paladin,retribution,48,17,31
Valarians,nemesis,1443,paladin,retribution,30,16,14
Джибути,soulflayer,1442,paladin,retribution,54,27,27
Lawtõn,argent-dawn,1441,paladin,retribution,78,38,40
Nothonnest,archimonde,1440,paladin,retribution,34,23,11
Ibnkrook,archimonde,1439,paladin,retribution,30,15,15
Shinøaa,wrathbringer,1438,paladin,retribution,24,15,9
Youmistpew,antonidas,1438,paladin,retribution,36,15,21
Майлайт,gordunni,1437,paladin,retribution,42,24,18
Harridin,ravencrest,1437,paladin,retribution,36,15,21
Солошафл,howling-fjord,1436,paladin,retribution,24,15,9
Exceed,blackmoore,1436,paladin,retribution,30,15,15
Antimov,twisting-nether,1435,paladin,retribution,30,15,15
Hagën,minahonda,1434,paladin,retribution,41,24,17
Jac,nemesis,1434,paladin,retribution,72,33,39
Ironquist,doomhammer,1432,paladin,retribution,30,15,15
Merkury,sanguino,1432,paladin,retribution,36,15,21
Gymly,kazzak,1431,paladin,retribution,84,50,34
Duckiboy,ragnaros,1429,paladin,retribution,70,42,28
Xyzl,argent-dawn,1429,paladin,retribution,42,23,19
Сазар,gordunni,1426,paladin,retribution,51,21,30
Zanreti,outland,1425,paladin,retribution,48,25,23
Ðivine,stormscale,1424,paladin,retribution,48,26,22
Асканиэль,howling-fjord,1423,paladin,retribution,36,15,21
Mattiesko,kazzak,1422,paladin,retribution,107,53,54
Teryanna,ragnaros,1422,paladin,retribution,50,17,33
Uxxer,sanguino,1421,paladin,retribution,29,17,12
Flaweldin,ravencrest,1420,paladin,retribution,18,15,3
Jackub,draenor,1419,paladin,retribution,38,22,16
Modeladin,ragnaros,1418,paladin,retribution,36,15,21
Offa,draenor,1416,paladin,retribution,48,23,25
Атикинс,gordunni,1415,paladin,retribution,36,15,21
Carlash,draenor,1414,paladin,retribution,24,15,9
Tharizod,nagrand,1414,paladin,retribution,48,20,28
Àræs,archimonde,1414,paladin,retribution,36,15,21
Dvouklik,burning-blade,1413,paladin,retribution,41,24,17
Arfeniel,stormscale,1413,paladin,retribution,60,22,38
Blówout,tarren-mill,1412,paladin,retribution,24,15,9
Malemanlad,silvermoon,1412,paladin,retribution,51,26,25
Holyblast,shattered-hand,1407,paladin,retribution,30,23,7
Блейзерфайт,eversong,1407,paladin,retribution,36,17,19
Argentø,ravencrest,1405,paladin,retribution,30,15,15
Maltazar,arygos,1404,paladin,retribution,24,15,9
Sickbolt,eredar,1404,paladin,retribution,54,30,24
Crazzylight,kazzak,1403,paladin,retribution,74,35,39
Zélix,bronzebeard,1401,paladin,retribution,36,18,18
Hàsbulla,khaz-modan,1400,paladin,retribution,36,19,17
Astragore,archimonde,1400,paladin,retribution,41,15,26
Elganwar,hyjal,1396,paladin,retribution,30,16,14
Thazyru,frostmane,1395,paladin,retribution,24,16,8
Дракула,howling-fjord,1393,paladin,retribution,36,15,21
Dantrag,eredar,1391,paladin,retribution,42,15,27
Артреал,blackscar,1387,paladin,retribution,18,15,3
Рэгнволд,deathguard,1385,paladin,retribution,40,20,20
Термотравка,grom,1385,paladin,retribution,90,36,54
Izolated,aegwynn,1383,paladin,retribution,60,24,36
Günselsen,antonidas,1381,paladin,retribution,84,42,42
Vlodthar,uldum,1378,paladin,retribution,24,15,9
Vendikor,nemesis,1376,paladin,retribution,66,24,42
Morniarn,argent-dawn,1374,paladin,retribution,54,29,25
Telredor,rexxar,1372,paladin,retribution,42,15,27
Ahnaa,argent-dawn,1370,paladin,retribution,30,17,13
Teho,dragonblight,1370,paladin,retribution,63,33,30
Viiri,burning-legion,1368,paladin,retribution,53,33,20
Goldhand,vashj,1368,paladin,retribution,60,28,32
Násty,twisting-nether,1368,paladin,retribution,90,40,50
Svetijuju,kazzak,1367,paladin,retribution,60,29,31
Беймикс,gordunni,1364,paladin,retribution,54,29,25
Aegend,antonidas,1360,paladin,retribution,157,76,81
Эзарх,gordunni,1359,paladin,retribution,58,29,29
Гучив,howling-fjord,1354,paladin,retribution,48,27,21
Apolomaeuz,blackhand,1354,paladin,retribution,36,20,16
Kreyvin,argent-dawn,1353,paladin,retribution,35,16,19
Ashent,stormscale,1353,paladin,retribution,42,19,23
Борссалино,gordunni,1352,paladin,retribution,77,35,42
Taiiki,archimonde,1349,paladin,retribution,36,22,14
Илюшагодх,gordunni,1349,paladin,retribution,48,26,22
Zipoohun,arathor,1345,paladin,retribution,56,31,25
Vatix,trollbane,1344,paladin,retribution,24,14,10
Inkzen,silvermoon,1343,paladin,retribution,24,14,10
Мевар,gordunni,1343,paladin,retribution,30,14,16
Retdead,nordrassil,1342,paladin,retribution,30,14,16
Рикшак,howling-fjord,1342,paladin,retribution,30,14,16
Ослепителен,eversong,1342,paladin,retribution,36,14,22
Aasimar,twilights-hammer,1341,paladin,retribution,76,39,37
Chocbear,tarren-mill,1341,paladin,retribution,30,14,16
Geneundreitt,dethecus,1341,paladin,retribution,30,14,16
Blekadin,ragnaros,1340,paladin,retribution,32,15,17
Ertheus,argent-dawn,1340,paladin,retribution,30,14,16
Kaizêr,silvermoon,1339,paladin,retribution,42,20,22
Витурус,howling-fjord,1339,paladin,retribution,42,14,28
Dainan,blackmoore,1338,paladin,retribution,30,14,16
Mustach,aggra-português,1337,paladin,retribution,41,20,21
Aisnil,twilights-hammer,1337,paladin,retribution,47,21,26
Proletardk,draenor,1336,paladin,retribution,102,51,51
Xciepo,rexxar,1336,paladin,retribution,36,14,22
Варблэйз,gordunni,1335,paladin,retribution,24,14,10
Cowwithspell,stormscale,1335,paladin,retribution,30,14,16
Мэибибэиби,howling-fjord,1335,paladin,retribution,36,14,22
Angelisho,zuljin,1335,paladin,retribution,36,14,22
Holylimx,draenor,1334,paladin,retribution,90,46,44
Aikm,tarren-mill,1332,paladin,retribution,50,26,24
Âlßêdø,silvermoon,1332,paladin,retribution,42,21,21
Хилерскийхил,soulflayer,1332,paladin,retribution,32,14,18
Yrgin,ravencrest,1330,paladin,retribution,60,32,28
Гневнебес,howling-fjord,1330,paladin,retribution,36,14,22
Stelanâal,archimonde,1328,paladin,retribution,24,14,10
Кливерти,gordunni,1325,paladin,retribution,36,14,22
Хеллкик,howling-fjord,1325,paladin,retribution,37,14,23
Enriel,temple-noir,1324,paladin,retribution,30,16,14
Campo,tarren-mill,1324,paladin,retribution,36,14,22
Мизиола,galakrond,1322,paladin,retribution,48,24,24
Истенен,blackscar,1316,paladin,retribution,42,14,28
Джекадамс,gordunni,1316,paladin,retribution,121,40,81
Codindio,silvermoon,1315,paladin,retribution,30,14,16
Sparrda,dun-modr,1314,paladin,retribution,48,24,24
Foxare,burning-legion,1312,paladin,retribution,53,29,24
Rothmans,aggra-português,1311,paladin,retribution,30,17,13
Mendril,malorne,1302,paladin,retribution,24,17,7
Booyaahh,ravencrest,1301,paladin,retribution,36,17,19
Elení,thrall,1296,paladin,retribution,37,15,22
Ретриванлав,gordunni,1296,paladin,retribution,72,24,48
Rudî,sanguino,1295,paladin,retribution,22,16,6
Хиккудоджер,eversong,1294,paladin,retribution,48,25,23
Nardindindou,ysondre,1292,paladin,retribution,86,44,42
Orseis,anubarak,1291,paladin,retribution,29,15,14
Mantinel,hellfire,1290,paladin,retribution,32,20,12
Unohana,shattered-halls,1290,paladin,retribution,48,14,34
Deloréane,archimonde,1285,paladin,retribution,27,14,13
Vvaarok,blackmoore,1285,paladin,retribution,57,22,35
Angrykorean,blackmoore,1284,paladin,retribution,59,28,31
Faithsmemory,silvermoon,1284,paladin,retribution,41,15,26
Khrotos,draenor,1283,paladin,retribution,48,25,23
Darhuun,antonidas,1281,paladin,retribution,93,43,50
Vickdicator,stormscale,1281,paladin,retribution,34,15,19
Dieversity,stormscale,1280,paladin,retribution,41,16,25
Freyjä,turalyon,1279,paladin,retribution,30,15,15
Ljumá,kazzak,1278,paladin,retribution,33,15,18
Синерина,blackscar,1278,paladin,retribution,35,15,20
Ïdø,hyjal,1277,paladin,retribution,40,16,24
Hammexõr,sylvanas,1271,paladin,retribution,87,39,48
Кветирон,soulflayer,1271,paladin,retribution,42,14,28
Эльбабло,lich-king,1268,paladin,retribution,45,21,24
Перизкопец,gordunni,1267,paladin,retribution,30,16,14
Hydarr,twisting-nether,1262,paladin,retribution,35,18,17
Owiganowi,ulduar,1260,paladin,retribution,30,19,11
Блэквилл,howling-fjord,1256,paladin,retribution,60,26,34
Elitest,hyjal,1256,paladin,retribution,43,14,29
Edyk,silvermoon,1255,paladin,retribution,53,32,21
Tønyx,les-clairvoyants,1253,paladin,retribution,32,14,18
Hollylady,outland,1251,paladin,retribution,30,19,11
Lightppl,outland,1249,paladin,retribution,36,19,17
Leyawin,sanguino,1249,paladin,retribution,30,15,15
Lübu,archimonde,1248,paladin,retribution,30,13,17
Wickedret,kazzak,1247,paladin,retribution,18,13,5
Ревирант,gordunni,1247,paladin,retribution,24,13,11
Valkûn,rexxar,1247,paladin,retribution,30,13,17
Тардариус,gordunni,1247,paladin,retribution,30,13,17
Paladiodinos,hyjal,1247,paladin,retribution,42,16,26
Saintseiya,pozzo-delleternità,1246,paladin,retribution,18,13,5
Spacknas,blackmoore,1246,paladin,retribution,18,13,5
Korendil,frostmane,1246,paladin,retribution,24,13,11
Mistérion,archimonde,1246,paladin,retribution,30,13,17
Réfractio,die-aldor,1245,paladin,retribution,30,13,17
Bezúziusz,ragnaros,1244,paladin,retribution,36,16,20
Raoun,archimonde,1242,paladin,retribution,30,13,17
Ùthér,sylvanas,1241,paladin,retribution,24,13,11
Zaaen,burning-legion,1240,paladin,retribution,24,13,11
Kayøz,aegwynn,1238,paladin,retribution,30,13,17
Argonak,sanguino,1237,paladin,retribution,18,13,5
Æe,blackmoore,1236,paladin,retribution,37,22,15
Teliriyon,blackrock,1236,paladin,retribution,32,14,18
Lewp,tarren-mill,1234,paladin,retribution,18,13,5
Anatorka,drakthul,1234,paladin,retribution,78,39,39
Aurroraa,doomhammer,1233,paladin,retribution,27,14,13
Yaoiri,argent-dawn,1232,paladin,retribution,18,13,5
Æthëlflæd,ravencrest,1230,paladin,retribution,21,15,6
Наваляка,deathguard,1228,paladin,retribution,24,13,11
Enveador,garrosh,1227,paladin,retribution,25,13,12
Баблспула,soulflayer,1227,paladin,retribution,30,13,17
Вандиир,soulflayer,1226,paladin,retribution,24,13,11
Trisunonvaki,khazgoroth,1226,paladin,retribution,41,16,25
Velkar,frostmane,1221,paladin,retribution,50,26,24
Юлец,galakrond,1220,paladin,retribution,30,13,17
Ylvannka,blackmoore,1219,paladin,retribution,36,18,18
Nomurabeta,naxxramas,1219,paladin,retribution,30,13,17
Ragnarük,khaz-modan,1217,paladin,retribution,42,20,22
Xourens,twisting-nether,1215,paladin,retribution,32,14,18
Angelcore,tarren-mill,1215,paladin,retribution,30,13,17
Malianterø,ravencrest,1211,paladin,retribution,28,13,15
Hornox,ragnaros,1211,paladin,retribution,42,19,23
Keith,dragonmaw,1210,paladin,retribution,30,14,16
Хен,blackscar,1209,paladin,retribution,32,15,17
Ункаль,ashenvale,1209,paladin,retribution,60,27,33
Альфазеро,howling-fjord,1208,paladin,retribution,28,13,15
Kýrp,stormreaver,1207,paladin,retribution,43,16,27
Светлыйкит,blackscar,1204,paladin,retribution,48,25,23
Цвандр,gordunni,1201,paladin,retribution,46,20,26
Calaestra,twisting-nether,1193,paladin,retribution,21,15,6
Whiffy,silvermoon,1193,paladin,retribution,36,13,23
Helmed,tarren-mill,1190,paladin,retribution,39,21,18
Hïto,dun-modr,1189,paladin,retribution,24,14,10
Fredas,hyjal,1185,paladin,retribution,30,13,17
Perfectum,burning-legion,1182,paladin,retribution,28,13,15
Irinor,rashgarroth,1181,paladin,retribution,30,14,16
Runkpaladin,kazzak,1180,paladin,retribution,36,23,13
Raweo,kilrogg,1178,paladin,retribution,36,24,12
Mystíque,die-todeskrallen,1177,paladin,retribution,36,21,15
Truezero,draenor,1176,paladin,retribution,30,14,16
Dinøx,archimonde,1171,paladin,retribution,74,33,41
Palagray,blackmoore,1166,paladin,retribution,36,16,20
Vrgingamer,kazzak,1158,paladin,retribution,48,16,32
Джагадаптер,gordunni,1157,paladin,retribution,23,13,10
Rileys,turalyon,1156,paladin,retribution,36,15,21
Franclovis,hyjal,1152,paladin,retribution,29,12,17
Fullsendbro,ravencrest,1151,paladin,retribution,18,12,6
Sessian,bronze-dragonflight,1151,paladin,retribution,30,19,11
Zachäus,kirin-tor,1151,paladin,retribution,24,12,12
Lipsvirgin,kazzak,1151,paladin,retribution,24,12,12
Galenhad,kazzak,1151,paladin,retribution,30,12,18
Fordragon,twisting-nether,1151,paladin,retribution,30,12,18
Gigasack,ravencrest,1150,paladin,retribution,18,12,6
Оззмо,howling-fjord,1150,paladin,retribution,18,12,6
Cigyal,hyjal,1150,paladin,retribution,30,16,14
Hirako,nemesis,1150,paladin,retribution,24,12,12
Ruotollo,ravencrest,1150,paladin,retribution,24,12,12
Torvik,eredar,1150,paladin,retribution,24,12,12
Beastyblodne,sylvanas,1149,paladin,retribution,24,14,10
Dominikcro,sylvanas,1149,paladin,retribution,24,12,12
Прожектор,gordunni,1149,paladin,retribution,24,12,12
Muhnnin,archimonde,1149,paladin,retribution,30,12,18
Swàyz,archimonde,1149,paladin,retribution,36,12,24
Ædrenn,archimonde,1148,paladin,retribution,36,12,24
Холихит,gordunni,1147,paladin,retribution,30,12,18
Algoric,suramar,1146,paladin,retribution,24,12,12
Mâterîa,antonidas,1146,paladin,retribution,24,12,12
Daoht,ysondre,1146,paladin,retribution,24,12,12
Иродиада,gordunni,1146,paladin,retribution,24,12,12
Хельдотер,howling-fjord,1146,paladin,retribution,25,12,13
Kreselia,ravencrest,1146,paladin,retribution,30,12,18
Palitard,turalyon,1145,paladin,retribution,36,20,16
Sieghard,aegwynn,1145,paladin,retribution,24,12,12
Splasher,grim-batol,1144,paladin,retribution,24,12,12
Kollak,dun-modr,1144,paladin,retribution,42,18,24
Росиель,soulflayer,1144,paladin,retribution,30,12,18
Endar,drakthul,1139,paladin,retribution,30,12,18
Dijkie,boulderfist,1139,paladin,retribution,30,12,18
Zandorath,argent-dawn,1135,paladin,retribution,30,12,18
Holybubo,tarren-mill,1133,paladin,retribution,60,30,30
Диваин,gordunni,1133,paladin,retribution,24,12,12
Questos,burning-legion,1130,paladin,retribution,45,25,20
Cästiël,arathor,1130,paladin,retribution,29,13,16
Yunax,silvermoon,1127,paladin,retribution,18,12,6
Deathzinger,aszune,1126,paladin,retribution,24,12,12
Самерваль,borean-tundra,1122,paladin,retribution,18,12,6
Rayshield,tarren-mill,1122,paladin,retribution,41,19,22
Burstyléz,silvermoon,1121,paladin,retribution,24,12,12
Buckfizz,ysondre,1115,paladin,retribution,18,13,5
Judgement,quelthalas,1114,paladin,retribution,24,16,8
Nelasson,eredar,1114,paladin,retribution,24,12,12
Troj,ahnqiraj,1112,paladin,retribution,30,14,16
Lagaminë,dalaran,1111,paladin,retribution,51,19,32
Ghostfacê,khaz-modan,1105,paladin,retribution,36,17,19
Shädyss,hyjal,1105,paladin,retribution,76,34,42
Mataleo,archimonde,1104,paladin,retribution,22,14,8
Rilledread,stormscale,1103,paladin,retribution,48,20,28
Kaljir,archimonde,1098,paladin,retribution,21,13,8
Ajkulaa,kazzak,1085,paladin,retribution,26,12,14
Valgar,ragnaros,1081,paladin,retribution,17,12,5
Obé,argent-dawn,1080,paladin,retribution,78,40,38
Sandorr,area-52,1079,paladin,retribution,30,17,13
Vorthir,khaz-modan,1079,paladin,retribution,26,13,13
Böb,garona,1078,paladin,retribution,36,14,22
Миоцуки,gordunni,1077,paladin,retribution,28,12,16
Mosih,bloodfeather,1061,paladin,retribution,38,21,17
Lytza,frostwolf,1059,paladin,retribution,30,15,15
Soossi,silvermoon,1056,paladin,retribution,18,11,7
Jedzy,ragnaros,1056,paladin,retribution,18,11,7
Carlá,silvermoon,1056,paladin,retribution,25,13,12
Dalemiar,ravencrest,1056,paladin,retribution,24,11,13
Pia,twisting-nether,1056,paladin,retribution,24,11,13
Tauskiz,sylvanas,1056,paladin,retribution,24,11,13
Mcret,ravencrest,1056,paladin,retribution,30,11,19
Retaxx,outland,1055,paladin,retribution,18,11,7
Reito,eredar,1055,paladin,retribution,18,11,7
Stukker,silvermoon,1055,paladin,retribution,24,11,13
Melantus,eredar,1055,paladin,retribution,24,11,13
Kalimgor,theradras,1055,paladin,retribution,24,11,13
Okcså,ragnaros,1055,paladin,retribution,28,12,16
Relius,outland,1055,paladin,retribution,30,11,19
Zialo,ravencrest,1055,paladin,retribution,36,11,25
Ilikejudge,blackmoore,1055,paladin,retribution,36,11,25
Myridan,bloodhoof,1054,paladin,retribution,18,11,7
Addwyr,blackrock,1054,paladin,retribution,18,11,7
Báldür,silvermoon,1054,paladin,retribution,18,11,7
Sinthoràs,shattered-hand,1054,paladin,retribution,36,20,16
Blademàster,twisting-nether,1054,paladin,retribution,22,12,10
Pallidino,antonidas,1054,paladin,retribution,24,11,13
Раффаэло,borean-tundra,1054,paladin,retribution,24,11,13
Jout,tarren-mill,1054,paladin,retribution,24,11,13
Lyraestra,hyjal,1054,paladin,retribution,30,11,19
Phalex,outland,1054,paladin,retribution,30,11,19
Grimstark,argent-dawn,1053,paladin,retribution,18,11,7
Vleisboom,ravencrest,1053,paladin,retribution,18,11,7
Sunsaiy,doomhammer,1053,paladin,retribution,42,22,20
Deceneü,kazzak,1053,paladin,retribution,24,11,13
Alard,sanguino,1052,paladin,retribution,30,11,19
Ayàhuazka,ysondre,1051,paladin,retribution,24,11,13
Oldsqlmofu,blackrock,1051,paladin,retribution,24,11,13
Мистерху,gordunni,1051,paladin,retribution,61,26,35
Llaynn,argent-dawn,1051,paladin,retribution,36,11,25
Рипкарт,gordunni,1050,paladin,retribution,18,11,7
Lawlight,frostmane,1050,paladin,retribution,24,11,13
Sylazz,blackrock,1050,paladin,retribution,61,24,37
Auditõr,argent-dawn,1050,paladin,retribution,36,11,25
Windsor,argent-dawn,1049,paladin,retribution,24,11,13
Grobididi,malygos,1048,paladin,retribution,24,11,13
Vorsip,tarren-mill,1048,paladin,retribution,24,11,13
Nevermoore,doomhammer,1047,paladin,retribution,24,11,13
Kealen,nemesis,1046,paladin,retribution,54,20,34
Traqnbilkarq,stormscale,1044,paladin,retribution,24,12,12
Darnero,blackrock,1043,paladin,retribution,18,11,7
Fumaça,dun-modr,1043,paladin,retribution,18,11,7
Dildotbagins,argent-dawn,1041,paladin,retribution,47,29,18
Línke,sanguino,1040,paladin,retribution,25,12,13
Lightmonger,drakthul,1038,paladin,retribution,18,11,7
Хоулишит,blackscar,1037,paladin,retribution,18,11,7
Saró,ravencrest,1035,paladin,retribution,22,12,10
Fëanôr,tarren-mill,1033,paladin,retribution,182,91,91
Snottybrat,draenor,1032,paladin,retribution,18,11,7
Zemoss,kazzak,1030,paladin,retribution,18,11,7
Lliissaa,kazzak,1027,paladin,retribution,36,21,15
Hateless,tarren-mill,1024,paladin,retribution,28,11,17
Молотоборец,gordunni,1019,paladin,retribution,24,11,13
Krïstâlùlz,archimonde,1014,paladin,retribution,34,15,19
Quasimotto,turalyon,1014,paladin,retribution,36,13,23
Paladie,dalaran,1013,paladin,retribution,141,72,69
Unkillablee,stormscale,1011,paladin,retribution,22,11,11
Crynó,blackmoore,1010,paladin,retribution,30,13,17
Aégon,archimonde,1010,paladin,retribution,36,13,23
Renaseh,twisting-nether,1007,paladin,retribution,23,11,12
Kipperb,kazzak,1007,paladin,retribution,23,11,12
Zwergicus,alexstrasza,1005,paladin,retribution,29,11,18
Snaty,khaz-modan,1004,paladin,retribution,47,25,22
Ilovemylay,area-52,1004,paladin,retribution,21,11,10
Pytha,nozdormu,1004,paladin,retribution,25,13,12
Эксвайп,howling-fjord,997,paladin,retribution,23,11,12
Âchîle,garona,991,paladin,retribution,43,23,20
Nomeel,twisting-nether,984,paladin,retribution,73,39,34
Bloodaxjr,archimonde,984,paladin,retribution,26,11,15
Pyrogon,malorne,969,paladin,retribution,56,26,30
Killtauren,kazzak,966,paladin,retribution,54,23,31
Raerk,dalaran,962,paladin,retribution,25,11,14
Weekly,outland,960,paladin,retribution,18,10,8
Exolis,archimonde,960,paladin,retribution,18,10,8
ßlacklight,archimonde,960,paladin,retribution,24,10,14
Daveboss,dragonblight,960,paladin,retribution,24,10,14
Ганка,blackscar,960,paladin,retribution,30,10,20
Screâm,eredar,960,paladin,retribution,30,10,20
Pallyprinces,dentarg,960,paladin,retribution,30,10,20
Trenvendor,ravencrest,959,paladin,retribution,16,11,5
Lonesoul,tarren-mill,959,paladin,retribution,18,10,8
Gangb,ravencrest,959,paladin,retribution,18,10,8
Bunurata,silvermoon,959,paladin,retribution,18,10,8
Яправ,borean-tundra,959,paladin,retribution,18,10,8
Crusshqt,silvermoon,959,paladin,retribution,18,10,8
Makakí,twisting-nether,959,paladin,retribution,18,10,8
Plarbo,blackmoore,959,paladin,retribution,24,10,14
Рамзеса,soulflayer,959,paladin,retribution,24,10,14
Нижмубабл,soulflayer,959,paladin,retribution,27,11,16
Lightlogic,ravencrest,959,paladin,retribution,30,10,20
Béhèlit,sargeras,958,paladin,retribution,18,10,8
Arcardi,dun-morogh,958,paladin,retribution,18,10,8
Mashijudge,blackhand,957,paladin,retribution,12,10,2
Immortalkrux,archimonde,957,paladin,retribution,53,18,35
Syracx,blackhand,956,paladin,retribution,24,10,14
Moodý,ragnaros,956,paladin,retribution,24,10,14
Holypurger,shattered-hand,955,paladin,retribution,25,10,15
Zeyz,defias-brotherhood,954,paladin,retribution,18,10,8
Bloodsworn,stormrage,953,paladin,retribution,18,10,8
Белкоксю,booty-bay,951,paladin,retribution,30,10,20
Wumbo,sinstralis,950,paladin,retribution,18,10,8
Xemoth,kazzak,947,paladin,retribution,18,10,8
Gerannan,kirin-tor,946,paladin,retribution,24,11,13
Buddabob,antonidas,946,paladin,retribution,56,12,44
Ziggyz,kul-tiras,945,paladin,retribution,19,10,9
Valpen,veknilash,943,paladin,retribution,24,10,14
Shorella,malganis,941,paladin,retribution,18,10,8
Diøstemplar,dun-modr,941,paladin,retribution,18,10,8
Vexxus,blackrock,937,paladin,retribution,24,12,12
Plato,arthas,933,paladin,retribution,18,10,8
Justrhino,kazzak,927,paladin,retribution,23,10,13
Caladys,silvermoon,926,paladin,retribution,23,10,13
Patzi,die-todeskrallen,925,paladin,retribution,48,23,25
Eltruite,archimonde,920,paladin,retribution,54,20,34
Coelslaw,azjolnerub,915,paladin,retribution,29,10,19
Crazypits,silvermoon,913,paladin,retribution,30,10,20
Rulîx,blackmoore,904,paladin,retribution,39,11,28
Lumino,twilights-hammer,901,paladin,retribution,23,10,13
Vuzetevacabo,doomhammer,899,paladin,retribution,54,24,30
Rígel,silvermoon,896,paladin,retribution,16,10,6
Gurutze,ragnaros,896,paladin,retribution,16,10,6
Pârabellum,the-maelstrom,896,paladin,retribution,28,10,18
Tánk,twilights-hammer,888,paladin,retribution,48,22,26
Атмх,soulflayer,864,paladin,retribution,12,9,3
Terrozina,stormscale,864,paladin,retribution,12,9,3
Номос,soulflayer,864,paladin,retribution,12,9,3
Holysnickers,tarren-mill,864,paladin,retribution,12,9,3
Bloodyret,outland,864,paladin,retribution,12,9,3
Justivo,tarren-mill,864,paladin,retribution,18,9,9
Djandja,blackrock,864,paladin,retribution,18,9,9
Kilô,sylvanas,864,paladin,retribution,18,9,9
Screws,dun-modr,864,paladin,retribution,18,9,9
Pesterci,draenor,864,paladin,retribution,18,9,9
Мэднессх,howling-fjord,864,paladin,retribution,18,9,9
Loratheon,stormscale,864,paladin,retribution,18,9,9
Djcurry,archimonde,864,paladin,retribution,18,9,9
Hølypwnjk,forscherliga,864,paladin,retribution,18,9,9
Lecutus,sunstrider,864,paladin,retribution,22,10,12
Лакостик,howling-fjord,864,paladin,retribution,24,9,15
Elisabeth,kazzak,864,paladin,retribution,24,9,15
Holymerda,grim-batol,864,paladin,retribution,24,9,15
Kæycc,blackmoore,864,paladin,retribution,24,9,15
Kaleyra,argent-dawn,864,paladin,retribution,24,9,15
Umirinbruv,zenedar,864,paladin,retribution,30,9,21
Nillenkäse,antonidas,863,paladin,retribution,12,9,3
Nakedholy,draenor,863,paladin,retribution,12,9,3
Búbbles,nerathor,863,paladin,retribution,12,9,3
Nordkreuz,aegwynn,863,paladin,retribution,18,9,9
Fujszi,arathor,863,paladin,retribution,18,9,9
Vitacé,burning-legion,863,paladin,retribution,18,9,9
Инфернох,howling-fjord,863,paladin,retribution,18,9,9
Sildrit,draenor,863,paladin,retribution,18,9,9
Arayël,archimonde,863,paladin,retribution,18,9,9
Durnell,sylvanas,863,paladin,retribution,18,9,9
Deriøt,dun-modr,863,paladin,retribution,24,9,15
Baé,drakthul,863,paladin,retribution,24,9,15
Olivaresx,ravencrest,863,paladin,retribution,24,9,15
Каштоуны,soulflayer,863,paladin,retribution,24,9,15
Данбро,borean-tundra,863,paladin,retribution,24,9,15
Obsidyen,outland,863,paladin,retribution,26,9,17
Димасгачи,gordunni,862,paladin,retribution,12,9,3
Primle,thrall,862,paladin,retribution,12,9,3
Blatrix,kazzak,862,paladin,retribution,12,9,3
Lìmier,ysondre,862,paladin,retribution,18,9,9
Darkenorr,silvermoon,862,paladin,retribution,18,9,9
Роллита,gordunni,862,paladin,retribution,24,9,15
Маркант,gordunni,861,paladin,retribution,18,9,9
Portgas,hyjal,861,paladin,retribution,24,9,15
Uwelist,arathor,861,paladin,retribution,24,9,15
Vaníos,nazjatar,860,paladin,retribution,18,9,9
Radamanthes,ysondre,860,paladin,retribution,18,9,9
Thëone,exodar,858,paladin,retribution,16,10,6
Jagen,tyrande,858,paladin,retribution,18,9,9
Steakenstein,nathrezim,858,paladin,retribution,18,9,9
Forneus,nemesis,850,paladin,retribution,22,10,12
Teogrim,blackmoore,849,paladin,retribution,18,9,9
Injustice,chamber-of-aspects,847,paladin,retribution,19,9,10
Rafflesia,sanguino,847,paladin,retribution,29,9,20
Painshield,outland,847,paladin,retribution,29,9,20
Ocgynle,alonsus,844,paladin,retribution,18,9,9
Лусейд,howling-fjord,842,paladin,retribution,17,10,7
Dafe,zuluhed,836,paladin,retribution,24,11,13
Helvirya,defias-brotherhood,836,paladin,retribution,78,35,43
Dôrä,ysondre,830,paladin,retribution,23,9,14
Jebenatreba,sporeggar,827,paladin,retribution,23,9,14
Pàlàthor,khaz-modan,826,paladin,retribution,18,9,9
Монбиин,soulflayer,810,paladin,retribution,18,10,8
Ararion,tarren-mill,809,paladin,retribution,18,10,8
Qïkarï,antonidas,783,paladin,retribution,13,9,4
Fleshoflight,arathor,779,paladin,retribution,22,10,12
Mitsoû,archimonde,768,paladin,retribution,12,8,4
Eléndrên,blackrock,768,paladin,retribution,12,8,4
Sigmud,turalyon,768,paladin,retribution,12,8,4
Дохлаяженах,gordunni,768,paladin,retribution,12,8,4
Clessington,die-aldor,768,paladin,retribution,12,8,4
Vindicatê,stormscale,768,paladin,retribution,12,8,4
Pakór,blackrock,768,paladin,retribution,12,8,4
Erasdin,silvermoon,768,paladin,retribution,12,8,4
Hülä,antonidas,768,paladin,retribution,12,8,4
Siuras,blackmoore,768,paladin,retribution,12,8,4
Lazaraat,antonidas,768,paladin,retribution,12,8,4
Zeggayodax,nemesis,768,paladin,retribution,12,8,4
Хексали,soulflayer,768,paladin,retribution,15,9,6
Sukinsin,aegwynn,768,paladin,retribution,18,8,10
Мидэас,gordunni,768,paladin,retribution,18,8,10
Baxxster,blackhand,768,paladin,retribution,18,8,10
Iiwar,silvermoon,768,paladin,retribution,18,8,10
Thaddios,burning-blade,768,paladin,retribution,18,8,10
Retenki,silvermoon,768,paladin,retribution,18,8,10
Hislifelmao,kazzak,768,paladin,retribution,18,8,10
Tyristrum,kilrogg,768,paladin,retribution,18,8,10
Dankin,pozzo-delleternità,768,paladin,retribution,18,8,10
Roostersucka,stormreaver,768,paladin,retribution,18,8,10
Murkyxd,sanguino,768,paladin,retribution,18,8,10
Чемеряк,gordunni,768,paladin,retribution,18,8,10
Powerphally,outland,768,paladin,retribution,24,8,16
Chyve,tarren-mill,768,paladin,retribution,24,8,16
Nabbi,ravencrest,768,paladin,retribution,24,8,16
Tjabo,burning-blade,768,paladin,retribution,24,8,16
Toxií,argent-dawn,768,paladin,retribution,30,8,22
ßancu,ragnaros,768,paladin,retribution,30,8,22
Nfxx,argent-dawn,767,paladin,retribution,12,8,4
Dawnnslayer,kazzak,767,paladin,retribution,12,8,4
Spinzr,draenor,767,paladin,retribution,12,8,4
Seraphyonhd,blackmoore,767,paladin,retribution,12,8,4
Hutimeni,turalyon,767,paladin,retribution,12,8,4
Baxteria,dun-modr,767,paladin,retribution,18,8,10
Xersys,draenor,767,paladin,retribution,18,8,10
Mooses,stormscale,767,paladin,retribution,18,8,10
Hôrrible,ravencrest,767,paladin,retribution,18,8,10
Ruftadin,ragnaros,767,paladin,retribution,18,8,10
Eywinn,silvermoon,767,paladin,retribution,18,8,10
Aleixodolphi,argent-dawn,767,paladin,retribution,30,10,20
Puré,festung-der-stürme,767,paladin,retribution,24,8,16
Combinecka,chamber-of-aspects,767,paladin,retribution,36,8,28
Fremuduin,argent-dawn,766,paladin,retribution,12,8,4
Ryozupala,frostwolf,766,paladin,retribution,12,8,4
Krustenkaese,kelthuzad,766,paladin,retribution,12,8,4
Hogan,blackmoore,766,paladin,retribution,18,8,10
Evililz,kazzak,766,paladin,retribution,18,8,10
Террорх,blackscar,766,paladin,retribution,30,8,22
Raê,hyjal,765,paladin,retribution,18,8,10
Mikipaki,tarren-mill,765,paladin,retribution,18,8,10
Skénder,kazzak,765,paladin,retribution,30,8,22
Killa,stormrage,764,paladin,retribution,18,8,10
Andocay,das-syndikat,764,paladin,retribution,24,8,16
Torczy,frostwhisper,760,paladin,retribution,12,8,4
Tripani,twisting-nether,760,paladin,retribution,18,8,10
Goungokuhrbo,doomhammer,755,paladin,retribution,12,8,4
Thorold,earthen-ring,755,paladin,retribution,22,10,12
Ericafontës,kazzak,751,paladin,retribution,17,8,9
Nazaninez,tarren-mill,749,paladin,retribution,18,8,10
Klikas,twisting-nether,746,paladin,retribution,18,8,10
Grayparser,silvermoon,735,paladin,retribution,14,9,5
Lynaé,blackhand,735,paladin,retribution,13,8,5
Craaw,archimonde,735,paladin,retribution,23,8,15
Guckzu,malganis,733,paladin,retribution,19,8,11
Beyma,twisting-nether,719,paladin,retribution,11,8,3
Byths,blackmoore,714,paladin,retribution,26,9,17
Aelthir,kazzak,703,paladin,retribution,11,8,3
Анастэриан,thermaplugg,703,paladin,retribution,14,8,6
Gradepal,drakthul,687,paladin,retribution,19,8,11
Thebestpala,tarren-mill,686,paladin,retribution,19,8,11
Vircy,outland,672,paladin,retribution,12,7,5
Miriem,twisting-nether,672,paladin,retribution,12,7,5
Sunwalker,bronzebeard,672,paladin,retribution,12,7,5
Ilpreside,nemesis,672,paladin,retribution,12,7,5
Rb,twisting-nether,672,paladin,retribution,12,7,5
Миллиционер,razuvious,672,paladin,retribution,12,7,5
Лакоста,ashenvale,672,paladin,retribution,12,7,5
Gimly,anachronos,672,paladin,retribution,12,7,5
Pïkachû,ravencrest,672,paladin,retribution,12,7,5
Bigducc,draenor,672,paladin,retribution,12,7,5
Лиривель,howling-fjord,672,paladin,retribution,12,7,5
Hammertime,guldan,672,paladin,retribution,12,7,5
Neverdeath,stormscale,672,paladin,retribution,12,7,5
Shjami,rexxar,672,paladin,retribution,12,7,5
Шоринг,gordunni,672,paladin,retribution,12,7,5
Akaasix,stormscale,672,paladin,retribution,12,7,5
Даракар,deathguard,672,paladin,retribution,12,7,5
Anatollia,silvermoon,672,paladin,retribution,12,7,5
Ellünca,ravencrest,672,paladin,retribution,12,7,5
Fatherabdul,ravencrest,672,paladin,retribution,12,7,5
Archibäld,silvermoon,672,paladin,retribution,12,7,5
Sletlana,burning-blade,672,paladin,retribution,12,7,5
Vhalkur,dun-modr,672,paladin,retribution,12,7,5
Lazone,ysondre,672,paladin,retribution,12,7,5
Dideta,colinas-pardas,672,paladin,retribution,12,7,5
Dälaghetto,kilrogg,672,paladin,retribution,12,7,5
Promise,dun-modr,672,paladin,retribution,12,7,5
Bubblor,ravencrest,672,paladin,retribution,12,7,5
Arshiaa,ravencrest,672,paladin,retribution,15,8,7
Norganpala,die-aldor,672,paladin,retribution,18,7,11
Dinønuggets,ravencrest,672,paladin,retribution,18,7,11
Bubbledøtcøm,blackmoore,672,paladin,retribution,18,7,11
Nyxbane,kazzak,672,paladin,retribution,18,7,11
Galadrion,dun-modr,672,paladin,retribution,18,7,11
Shownómercy,stormscale,672,paladin,retribution,18,7,11
Ivarladin,draenor,672,paladin,retribution,18,7,11
Lílou,blackmoore,672,paladin,retribution,18,7,11
Tezmodian,antonidas,672,paladin,retribution,18,7,11
Créo,draenor,672,paladin,retribution,18,7,11
Lysander,antonidas,672,paladin,retribution,18,7,11
Auryel,nemesis,672,paladin,retribution,18,7,11
Arbuzno,draenor,672,paladin,retribution,18,7,11
Vodax,argent-dawn,672,paladin,retribution,18,7,11
Apocalypsé,twisting-nether,672,paladin,retribution,18,7,11
Мериатас,soulflayer,672,paladin,retribution,18,7,11
Jíyü,blackmoore,672,paladin,retribution,18,7,11
Ritaora,aggramar,672,paladin,retribution,18,7,11
Bíceron,sanguino,672,paladin,retribution,18,7,11
Scairtin,ravencrest,672,paladin,retribution,18,7,11
Wingsuit,eredar,672,paladin,retribution,20,7,13
Коссандра,greymane,672,paladin,retribution,23,7,16
Akelad,arathor,672,paladin,retribution,24,7,17
Crysania,twisting-nether,672,paladin,retribution,24,7,17
Ящеры,gordunni,672,paladin,retribution,24,7,17
Cianna,shattered-hand,672,paladin,retribution,28,7,21
Bajheeroth,kazzak,671,paladin,retribution,12,7,5
Retgaffeooku,conseil-des-ombres,671,paladin,retribution,12,7,5
Sakred,hellscream,671,paladin,retribution,12,7,5
Gbejr,xavius,671,paladin,retribution,12,7,5
Vâskt,dun-modr,671,paladin,retribution,12,7,5
Wolfpala,drakthul,671,paladin,retribution,12,7,5
Kyríé,tarren-mill,671,paladin,retribution,12,7,5
Demsi,ravencrest,671,paladin,retribution,12,7,5
Uraraka,burning-blade,671,paladin,retribution,12,7,5
Mazekiel,archimonde,671,paladin,retribution,12,7,5
Jooki,drakthul,671,paladin,retribution,12,7,5
Imreallybadx,blackrock,671,paladin,retribution,12,7,5
Bubblefett,ysera,671,paladin,retribution,12,7,5
Guccishock,twisting-nether,671,paladin,retribution,12,7,5
Samueel,blackmoore,671,paladin,retribution,12,7,5
Galevar,argent-dawn,671,paladin,retribution,18,7,11
Eken,hyjal,671,paladin,retribution,18,7,11
Alvíss,sanguino,671,paladin,retribution,18,7,11
Asorte,chants-éternels,671,paladin,retribution,18,7,11
Спидфрик,blackscar,671,paladin,retribution,18,7,11
Johnßlake,dun-modr,671,paladin,retribution,18,7,11
Laenira,nemesis,671,paladin,retribution,18,7,11
Öbedö,malganis,671,paladin,retribution,24,7,17
Atrexie,lightbringer,670,paladin,retribution,12,7,5
Kaelron,sanguino,670,paladin,retribution,12,7,5
Keol,sanguino,670,paladin,retribution,12,7,5
Aistor,burning-legion,670,paladin,retribution,18,7,11
Kawakii,outland,669,paladin,retribution,12,7,5
Starstríder,aszune,669,paladin,retribution,12,7,5
Ghallandre,khaz-modan,669,paladin,retribution,12,7,5
Палочка,howling-fjord,669,paladin,retribution,18,7,11
Rangorian,defias-brotherhood,669,paladin,retribution,24,7,17
Gxdéon,hyjal,667,paladin,retribution,12,7,5
Messîah,outland,666,paladin,retribution,12,7,5
Rocaviva,sanguino,666,paladin,retribution,12,7,5
Quoque,turalyon,664,paladin,retribution,15,8,7
Chikaz,archimonde,664,paladin,retribution,20,10,10
Halimox,terokkar,664,paladin,retribution,18,7,11
Wolya,blackrock,663,paladin,retribution,15,8,7
Mechoka,auchindoun,661,paladin,retribution,13,7,6
Belzed,draenor,660,paladin,retribution,15,8,7
Luxor,sporeggar,658,paladin,retribution,12,7,5
Bigdamjudgee,outland,655,paladin,retribution,17,7,10
Keele,stormscale,639,paladin,retribution,17,7,10
Boabux,draenor,638,paladin,retribution,17,7,10
Diamir,rajaxx,624,paladin,retribution,15,7,8
Denounce,defias-brotherhood,624,paladin,retribution,21,7,14
Samànta,nemesis,623,paladin,retribution,11,7,4
Rustig,talnivarr,623,paladin,retribution,11,7,4
Darkironpala,argent-dawn,623,paladin,retribution,15,7,8
Jaro,alleria,623,paladin,retribution,21,7,14
Fufenzee,stormscale,620,paladin,retribution,17,7,10
Goofyaf,ravencrest,618,paladin,retribution,16,9,7
Mariaremarc,silvermoon,617,paladin,retribution,25,8,17
Ressler,tichondrius,616,paladin,retribution,15,7,8
Nollieflip,tarren-mill,607,paladin,retribution,11,7,4
Crohnox,nemesis,607,paladin,retribution,14,7,7
Альмор,blackscar,607,paladin,retribution,20,7,13
Blagori,blackhand,576,paladin,retribution,6,6,0
Twomog,ravencrest,576,paladin,retribution,6,6,0
Lóyal,kazzak,576,paladin,retribution,6,6,0
Retgodx,eredar,576,paladin,retribution,12,6,6
Stève,ravencrest,576,paladin,retribution,12,6,6
Elendíl,azjolnerub,576,paladin,retribution,12,6,6
Shaylaru,tarren-mill,576,paladin,retribution,12,6,6
Ryaz,blackrock,576,paladin,retribution,12,6,6
Gigajudge,ravencrest,576,paladin,retribution,12,6,6
Cùpìdstunt,draenor,576,paladin,retribution,12,6,6
Кошкотяночка,ashenvale,576,paladin,retribution,12,6,6
Veejxo,silvermoon,576,paladin,retribution,12,6,6
Керантий,gordunni,576,paladin,retribution,12,6,6
Clamjam,sylvanas,576,paladin,retribution,12,6,6
Loscar,silvermoon,576,paladin,retribution,12,6,6
Романтик,deathweaver,576,paladin,retribution,12,6,6
Humphry,vashj,576,paladin,retribution,12,6,6
Ridethelight,nemesis,576,paladin,retribution,12,6,6
Cycodin,garrosh,576,paladin,retribution,12,6,6
Feelmylight,tarren-mill,576,paladin,retribution,12,6,6
Wingdude,ysera,576,paladin,retribution,12,6,6
Deresos,anetheron,576,paladin,retribution,12,6,6
Pallachyrk,kazzak,576,paladin,retribution,12,6,6
Rhyvar,outland,576,paladin,retribution,12,6,6
Válé,silvermoon,576,paladin,retribution,12,6,6
Sölaria,silvermoon,576,paladin,retribution,12,6,6
Paliax,outland,576,paladin,retribution,12,6,6
Mawrâ,twisting-nether,576,paladin,retribution,12,6,6
Bloodlord,twisting-nether,576,paladin,retribution,12,6,6
Exolie,archimonde,576,paladin,retribution,12,6,6
Exolia,archimonde,576,paladin,retribution,12,6,6
Melverti,kazzak,576,paladin,retribution,12,6,6
Bigdaddypump,ravencrest,576,paladin,retribution,12,6,6
Eldrial,argent-dawn,576,paladin,retribution,12,6,6
Ryxxii,ravencrest,576,paladin,retribution,12,6,6
Snowife,drakthul,576,paladin,retribution,12,6,6
Mekluba,twisting-nether,576,paladin,retribution,12,6,6
Mouncake,archimonde,576,paladin,retribution,12,6,6
Ibanez,lightnings-blade,576,paladin,retribution,12,6,6
Bloodbeard,twisting-nether,576,paladin,retribution,12,6,6
Søulréaper,stormscale,576,paladin,retribution,12,6,6
Smirky,silvermoon,576,paladin,retribution,12,6,6
Диджейнобабл,howling-fjord,576,paladin,retribution,12,6,6
Raceper,the-maelstrom,576,paladin,retribution,12,6,6
Croptol,dun-modr,576,paladin,retribution,12,6,6
Gabrîel,sanguino,576,paladin,retribution,12,6,6
Vysavo,draenor,576,paladin,retribution,12,6,6
Ruggero,stormscale,576,paladin,retribution,12,6,6
Exolix,archimonde,576,paladin,retribution,12,6,6
Askmy,stormscale,576,paladin,retribution,12,6,6
Neêsoldr,blackmoore,576,paladin,retribution,12,6,6
Скварлетх,howling-fjord,576,paladin,retribution,12,6,6
Elyrax,nemesis,576,paladin,retribution,12,6,6
Notnerb,outland,576,paladin,retribution,12,6,6
Xairo,twisting-nether,576,paladin,retribution,12,6,6
Czachadymii,defias-brotherhood,576,paladin,retribution,12,6,6
Palamauka,kazzak,576,paladin,retribution,12,6,6
Daybreak,kazzak,576,paladin,retribution,15,7,8
Racduck,dunemaul,576,paladin,retribution,18,6,12
Hydrath,ysondre,576,paladin,retribution,18,6,12
Curtwizz,silvermoon,576,paladin,retribution,18,6,12
Hermmes,alakir,576,paladin,retribution,18,6,12
Lusugo,alakir,576,paladin,retribution,18,6,12
Lolladin,blackmoore,576,paladin,retribution,18,6,12
Tosá,antonidas,576,paladin,retribution,18,6,12
Sîlversun,grim-batol,576,paladin,retribution,18,6,12
Кхабелех,howling-fjord,576,paladin,retribution,18,6,12
Nìcky,stormscale,576,paladin,retribution,18,6,12
Thoriz,elune,576,paladin,retribution,18,6,12
Mâêdhrøsx,ravencrest,576,paladin,retribution,18,6,12
Âtom,outland,576,paladin,retribution,18,6,12
Imaturtle,darksorrow,576,paladin,retribution,24,6,18
Actionjack,area-52,576,paladin,retribution,24,6,18
Sacredlol,blackmoore,576,paladin,retribution,24,6,18
Huevo,frostmane,576,paladin,retribution,24,6,18
Jêzus,blackrock,575,paladin,retribution,6,6,0
Kyrokonserve,blackmoore,575,paladin,retribution,14,7,7
Faventu,ragnaros,575,paladin,retribution,12,6,6
Phillipe,illidan,575,paladin,retribution,12,6,6
Тамплиир,gordunni,575,paladin,retribution,12,6,6
Vaako,blackrock,575,paladin,retribution,12,6,6
Iqso,argent-dawn,575,paladin,retribution,12,6,6
Antón,dun-modr,575,paladin,retribution,12,6,6
Pewpews,twisting-nether,575,paladin,retribution,12,6,6
Aeyalana,ragnaros,575,paladin,retribution,12,6,6
Trøllørd,shattrath,575,paladin,retribution,12,6,6
Hypothalamus,silvermoon,575,paladin,retribution,12,6,6
Orti,sanguino,575,paladin,retribution,18,6,12
Nykothpn,ghostlands,574,paladin,retribution,6,6,0
Mírato,blackhand,574,paladin,retribution,12,6,6
Vondarkmoor,magtheridon,574,paladin,retribution,12,6,6
Humaladi,draenor,574,paladin,retribution,18,6,12
Cpsuper,azuremyst,573,paladin,retribution,12,6,6
Cinderlight,aszune,573,paladin,retribution,12,6,6
Nhum,destromath,572,paladin,retribution,12,6,6
Exiztant,ravencrest,571,paladin,retribution,18,6,12
Boaka,outland,571,paladin,retribution,18,6,12
Liliong,draenor,568,paladin,retribution,12,6,6
Vibeer,ravencrest,568,paladin,retribution,12,6,6
Nicgr,nemesis,566,paladin,retribution,12,6,6
Raptasenda,archimonde,566,paladin,retribution,26,9,17
Benkenoah,ragnaros,566,paladin,retribution,24,6,18
Ràwx,twisting-nether,559,paladin,retribution,23,6,17
Knygnesys,silvermoon,558,paladin,retribution,9,8,1
Tavyy,sylvanas,551,paladin,retribution,15,9,6
Ryüü,uldaman,537,paladin,retribution,23,6,17
Ollebala,ravencrest,527,paladin,retribution,11,6,5
Pak,amanthul,527,paladin,retribution,15,7,8
Тошши,soulflayer,522,paladin,retribution,28,8,20
Råckamoo,emerald-dream,512,paladin,retribution,22,6,16
Babypic,ambossar,511,paladin,retribution,14,6,8
Vanyon,malganis,511,paladin,retribution,14,6,8
Блатш,greymane,496,paladin,retribution,19,6,13
Драгун,gordunni,481,paladin,retribution,19,6,13
Sabríel,ragnaros,480,paladin,retribution,6,5,1
Takálus,eredar,480,paladin,retribution,6,5,1
Yull,twisting-nether,480,paladin,retribution,6,5,1
Derian,antonidas,480,paladin,retribution,6,5,1
Тенькопыт,howling-fjord,480,paladin,retribution,6,5,1
Xoriun,norgannon,480,paladin,retribution,6,5,1
Percocetx,tarren-mill,480,paladin,retribution,6,5,1
Needel,argent-dawn,480,paladin,retribution,6,5,1
Voycetwo,frostwolf,480,paladin,retribution,6,5,1
Harlequina,argent-dawn,480,paladin,retribution,6,5,1
Легейнда,soulflayer,480,paladin,retribution,6,5,1
Jacadin,sunstrider,480,paladin,retribution,6,5,1
Abukasol,kazzak,480,paladin,retribution,6,5,1
Röland,sanguino,480,paladin,retribution,6,5,1
Dioxius,stormscale,480,paladin,retribution,6,5,1
Aisolôn,thrall,480,paladin,retribution,6,5,1
Kendomendo,ravencrest,480,paladin,retribution,6,5,1
Yezitzme,blackrock,480,paladin,retribution,6,5,1
Milojcica,kazzak,480,paladin,retribution,6,5,1
Фэнон,gordunni,480,paladin,retribution,6,5,1
Walorez,ragnaros,480,paladin,retribution,6,5,1
Rqd,blackrock,480,paladin,retribution,6,5,1
Bikkuz,kazzak,480,paladin,retribution,6,5,1
Архемор,ashenvale,480,paladin,retribution,6,5,1
Ryven,stormscale,480,paladin,retribution,6,5,1
Justyowx,archimonde,480,paladin,retribution,6,5,1
Пивняк,eversong,480,paladin,retribution,6,5,1
Briman,neptulon,480,paladin,retribution,6,5,1
Havefunzqt,archimonde,480,paladin,retribution,6,5,1
Highfivè,ravencrest,480,paladin,retribution,6,5,1
Mma,sylvanas,480,paladin,retribution,6,5,1
Xëlâ,archimonde,480,paladin,retribution,6,5,1
Melvòó,blackrock,480,paladin,retribution,9,6,3
Ênma,archimonde,480,paladin,retribution,12,5,7
Drylands,ravencrest,480,paladin,retribution,12,5,7
Mufuqa,ragnaros,480,paladin,retribution,12,5,7
Боремир,borean-tundra,480,paladin,retribution,12,5,7
Meriween,ravencrest,480,paladin,retribution,12,5,7
Ritoru,drekthar,480,paladin,retribution,12,5,7
Milenia,nemesis,480,paladin,retribution,12,5,7
Earendìl,blackmoore,480,paladin,retribution,12,5,7
Ophillan,draenor,480,paladin,retribution,12,5,7
Vaalé,aegwynn,480,paladin,retribution,12,5,7
Bornir,khaz-modan,480,paladin,retribution,12,5,7
Naexea,archimonde,480,paladin,retribution,12,5,7
Hugins,chamber-of-aspects,480,paladin,retribution,12,5,7
Qpala,quelthalas,480,paladin,retribution,12,5,7
Lighttitan,ravencrest,480,paladin,retribution,12,5,7
Thun,azjolnerub,480,paladin,retribution,12,5,7
Llighthand,ravencrest,480,paladin,retribution,12,5,7
Zayaka,ragnaros,480,paladin,retribution,12,5,7
Proxidus,blackmoore,480,paladin,retribution,12,5,7
Kylaz,die-ewige-wacht,480,paladin,retribution,12,5,7
Ретроградий,howling-fjord,480,paladin,retribution,12,5,7
Endavour,ravencrest,480,paladin,retribution,12,5,7
Zethhx,stormscale,480,paladin,retribution,12,5,7
Rînedaman,ysondre,480,paladin,retribution,12,5,7
Asgardietis,kazzak,480,paladin,retribution,12,5,7
Zuveron,the-maelstrom,480,paladin,retribution,12,5,7
Freedomwinds,kazzak,480,paladin,retribution,12,5,7
Wingzy,hyjal,480,paladin,retribution,12,5,7
Гниленький,razuvious,480,paladin,retribution,12,5,7
Наолина,gordunni,480,paladin,retribution,12,5,7
Angelynor,ysondre,480,paladin,retribution,12,5,7
Froxies,drakthul,480,paladin,retribution,12,5,7
Jkøø,sanguino,480,paladin,retribution,12,5,7
Mecah,hyjal,480,paladin,retribution,12,5,7
Cêa,blackrock,480,paladin,retribution,12,5,7
Jeriiret,khaz-modan,480,paladin,retribution,12,5,7
Kírin,drakthul,480,paladin,retribution,12,5,7
Serjudge,kazzak,480,paladin,retribution,12,5,7
Morggann,drakthul,480,paladin,retribution,12,5,7
Ноулайфир,eversong,480,paladin,retribution,12,5,7
Агинон,gordunni,480,paladin,retribution,12,5,7
Socx,outland,480,paladin,retribution,12,5,7
Bobilous,twisting-nether,480,paladin,retribution,12,5,7
Скадих,soulflayer,480,paladin,retribution,12,5,7
Ërzã,outland,480,paladin,retribution,12,5,7
Equityy,burning-legion,480,paladin,retribution,12,5,7
Mozaiczny,burning-legion,480,paladin,retribution,12,5,7
Retlikeme,ravencrest,480,paladin,retribution,12,5,7
Roflemente,bladefist,480,paladin,retribution,12,5,7
Bancu,outland,480,paladin,retribution,12,5,7
Onishu,blackhand,480,paladin,retribution,12,5,7
Torpala,burning-legion,480,paladin,retribution,12,5,7
Hydrolic,blackrock,480,paladin,retribution,12,5,7
Bascelik,outland,480,paladin,retribution,12,5,7
Корсаро,deepholm,480,paladin,retribution,12,5,7
Zaopink,blackhand,480,paladin,retribution,12,5,7
Dêstî,silvermoon,480,paladin,retribution,12,5,7
Babaluga,blackrock,480,paladin,retribution,12,5,7
Sytrexxer,frostwolf,480,paladin,retribution,12,5,7
Héphäistos,silvermoon,480,paladin,retribution,12,5,7
Razrpal,tarren-mill,480,paladin,retribution,12,5,7
Veckra,kazzak,480,paladin,retribution,12,5,7
Nalaea,arathor,480,paladin,retribution,12,5,7
Bugo,drakthul,480,paladin,retribution,12,5,7
Axone,ravencrest,480,paladin,retribution,18,5,13
Копранесса,soulflayer,480,paladin,retribution,18,5,13
Thoreas,perenolde,480,paladin,retribution,18,5,13
Posttal,aggra-português,480,paladin,retribution,18,5,13
Ramhal,stormscale,480,paladin,retribution,18,5,13
Strätholme,drakthul,480,paladin,retribution,18,5,13
Xiuya,dun-modr,480,paladin,retribution,18,5,13
Juicycheeks,frostwolf,480,paladin,retribution,18,5,13
Fleckige,nethersturm,480,paladin,retribution,18,5,13
Aranael,nemesis,480,paladin,retribution,18,5,13
Deidâra,blackhand,480,paladin,retribution,18,5,13
Pliscken,kazzak,480,paladin,retribution,18,5,13
Алепос,soulflayer,480,paladin,retribution,18,5,13
Вэндрик,azuregos,480,paladin,retribution,18,5,13
Exobyte,stormscale,480,paladin,retribution,24,5,19
Itsgossiplol,twisting-nether,480,paladin,retribution,24,5,19
Trainingdumy,aszune,479,paladin,retribution,6,5,1
Wingedguard,ragnaros,479,paladin,retribution,6,5,1
Zvirblis,chamber-of-aspects,479,paladin,retribution,9,6,3
Ðarkjøjø,hyjal,479,paladin,retribution,12,5,7
Сасмен,blackscar,479,paladin,retribution,12,5,7
Taffz,burning-legion,479,paladin,retribution,12,5,7
Эллессар,howling-fjord,479,paladin,retribution,12,5,7
Пропала,greymane,479,paladin,retribution,12,5,7
Edwards,sanguino,479,paladin,retribution,12,5,7
Майнстер,gordunni,479,paladin,retribution,12,5,7
Rettarded,draenor,479,paladin,retribution,12,5,7
Solyra,blackhand,479,paladin,retribution,12,5,7
Dykopala,doomhammer,479,paladin,retribution,12,5,7
Baymanda,tarren-mill,479,paladin,retribution,12,5,7
Takaret,hyjal,479,paladin,retribution,18,5,13
Лейфи,howling-fjord,479,paladin,retribution,18,5,13
Mysticlight,sylvanas,478,paladin,retribution,18,8,10
Mirelaw,drakthul,478,paladin,retribution,12,5,7
Ilacktoes,twisting-nether,478,paladin,retribution,12,5,7
Четкийчервь,soulflayer,478,paladin,retribution,18,5,13
Fardahr,ravencrest,476,paladin,retribution,12,5,7
Zantria,alleria,476,paladin,retribution,12,5,7
Morhgain,kazzak,476,paladin,retribution,18,5,13
Баблыч,borean-tundra,472,paladin,retribution,12,5,7
Legitpower,silvermoon,468,paladin,retribution,18,10,8
Mimsy,dalaran,447,paladin,retribution,11,5,6
Грайндсет,galakrond,447,paladin,retribution,11,5,6
Slayton,twisting-nether,447,paladin,retribution,11,5,6
Гкм,howling-fjord,447,paladin,retribution,11,5,6
Kevlar,frostmane,446,paladin,retribution,12,6,6
Æïs,blackrock,432,paladin,retribution,9,5,4
Sunnyboy,tarren-mill,431,paladin,retribution,11,5,6
Dragonwingz,kazzak,431,paladin,retribution,11,5,6
Îiî,archimonde,426,paladin,retribution,21,6,15
Alithyra,earthen-ring,416,paladin,retribution,10,5,5
Нероблр,gordunni,416,paladin,retribution,10,5,5
Qshadow,frostwhisper,416,paladin,retribution,16,5,11
Сильвернайт,soulflayer,400,paladin,retribution,13,5,8
Леаркус,blackscar,384,paladin,retribution,6,4,2
Bâbass,sargeras,384,paladin,retribution,6,4,2
Panicmaker,ravencrest,384,paladin,retribution,6,4,2
Atanasum,dun-modr,384,paladin,retribution,6,4,2
Shevøçk,ravencrest,384,paladin,retribution,6,4,2
Luckyman,aszune,384,paladin,retribution,6,4,2
Позабытый,deathweaver,384,paladin,retribution,6,4,2
Zeggayoda,nemesis,384,paladin,retribution,6,4,2
Skrýmir,marécage-de-zangar,384,paladin,retribution,6,4,2
Pelbo,ravencrest,384,paladin,retribution,6,4,2
Érléuchtas,kazzak,384,paladin,retribution,6,4,2
Nicolae,colinas-pardas,384,paladin,retribution,6,4,2
Stitchup,argent-dawn,384,paladin,retribution,6,4,2
Aylion,blackrock,384,paladin,retribution,6,4,2
Shakkur,varimathras,384,paladin,retribution,6,4,2
Spizz,dun-modr,384,paladin,retribution,6,4,2
Zeusp,archimonde,384,paladin,retribution,6,4,2
Бабичпал,soulflayer,384,paladin,retribution,6,4,2
Neverknõw,draenor,384,paladin,retribution,6,4,2
Marmotaxx,dun-modr,384,paladin,retribution,6,4,2
Lighteousnes,blackmoore,384,paladin,retribution,6,4,2
Velikor,dun-modr,384,paladin,retribution,6,4,2
Tillak,draenor,384,paladin,retribution,6,4,2
Драгмитухел,gordunni,384,paladin,retribution,6,4,2
Tdchopa,ravencrest,384,paladin,retribution,6,4,2
Arrious,frostmane,384,paladin,retribution,6,4,2
Иев,howling-fjord,384,paladin,retribution,6,4,2
Trefino,blackrock,384,paladin,retribution,6,4,2
Valin,frostmane,384,paladin,retribution,6,4,2
Petsadin,ravencrest,384,paladin,retribution,6,4,2
Franc,aggra-português,384,paladin,retribution,6,4,2
Ibuc,blackrock,384,paladin,retribution,6,4,2
Gashqx,hyjal,384,paladin,retribution,6,4,2
Судья,greymane,384,paladin,retribution,6,4,2
Dragongîrl,lothar,384,paladin,retribution,6,4,2
Светонносец,gordunni,384,paladin,retribution,6,4,2
Serenityxo,twisting-nether,384,paladin,retribution,6,4,2
Angeal,ysondre,384,paladin,retribution,6,4,2
Caleel,nemesis,384,paladin,retribution,6,4,2
Swânn,sanguino,384,paladin,retribution,6,4,2
Zhàø,ysondre,384,paladin,retribution,6,4,2
Apokalipsnik,drakthul,384,paladin,retribution,6,4,2
Volkai,zuljin,384,paladin,retribution,6,4,2
Tigurius,zuljin,384,paladin,retribution,6,4,2
Ямыч,ashenvale,384,paladin,retribution,6,4,2
Bcrp,ragnaros,384,paladin,retribution,6,4,2
Timoxas,kazzak,384,paladin,retribution,6,4,2
Refuse,blackrock,384,paladin,retribution,6,4,2
Holydhanas,outland,384,paladin,retribution,6,4,2
Лиадринель,howling-fjord,384,paladin,retribution,6,4,2
Veldora,zuljin,384,paladin,retribution,6,4,2
Dornu,tarren-mill,384,paladin,retribution,6,4,2
Pecar,stormscale,384,paladin,retribution,6,4,2
Dobbygotsock,kazzak,384,paladin,retribution,6,4,2
Arcillus,stormscale,384,paladin,retribution,6,4,2
Sabriaña,silvermoon,384,paladin,retribution,6,4,2
Òlymp,blackhand,384,paladin,retribution,6,4,2
Missmyhoj,archimonde,384,paladin,retribution,6,4,2
Rölfchen,frostwolf,384,paladin,retribution,6,4,2
Zeportpala,archimonde,384,paladin,retribution,6,4,2
Vuutnëx,twisting-nether,384,paladin,retribution,6,4,2
Pállis,ravencrest,384,paladin,retribution,6,4,2
Holyhi,silvermoon,384,paladin,retribution,6,4,2
Emloses,outland,384,paladin,retribution,6,4,2
Ðesolace,twisting-nether,384,paladin,retribution,6,4,2
Colpadeltank,kazzak,384,paladin,retribution,6,4,2
Skittlespala,twisting-nether,384,paladin,retribution,6,4,2
Clementine,spinebreaker,384,paladin,retribution,6,4,2
Pav,eredar,384,paladin,retribution,6,4,2
Wiither,argent-dawn,384,paladin,retribution,6,4,2
Соулерт,ashenvale,384,paladin,retribution,6,4,2
Pâlâpâm,blackmoore,384,paladin,retribution,6,4,2
Blader,darksorrow,384,paladin,retribution,6,4,2
Drownlord,eredar,384,paladin,retribution,6,4,2
Crussaden,stormscale,384,paladin,retribution,7,4,3
Olaghkan,dun-modr,384,paladin,retribution,8,4,4
Shoogle,alonsus,384,paladin,retribution,9,4,5
Хилвкд,blackscar,384,paladin,retribution,11,4,7
Athênâ,azjolnerub,384,paladin,retribution,15,5,10
Andrøiz,dun-modr,384,paladin,retribution,12,4,8
Kjobergen,tarren-mill,384,paladin,retribution,12,4,8
Батллграунд,soulflayer,384,paladin,retribution,12,4,8
Serim,dun-modr,384,paladin,retribution,12,4,8
Yakuron,blackhand,384,paladin,retribution,12,4,8
Celerius,trollbane,384,paladin,retribution,12,4,8
Hasart,tarren-mill,384,paladin,retribution,12,4,8
Palapaye,archimonde,384,paladin,retribution,12,4,8
Notpitball,kazzak,384,paladin,retribution,12,4,8
Artoriaz,ravencrest,384,paladin,retribution,12,4,8
Baldarlyset,tarren-mill,384,paladin,retribution,12,4,8
Kiriel,dun-modr,384,paladin,retribution,12,4,8
Trainors,chamber-of-aspects,384,paladin,retribution,12,4,8
Bonzai,blackrock,384,paladin,retribution,12,4,8
Nözderg,archimonde,384,paladin,retribution,12,4,8
Vazayo,ravencrest,384,paladin,retribution,12,4,8
Yasfy,stormscale,384,paladin,retribution,12,4,8
Lucretius,kilrogg,384,paladin,retribution,12,4,8
Freeloliipop,darksorrow,384,paladin,retribution,12,4,8
Moløk,ysondre,384,paladin,retribution,12,4,8
Холирайз,gordunni,384,paladin,retribution,12,4,8
Madeofsteel,silvermoon,384,paladin,retribution,12,4,8
Cyban,twisting-nether,384,paladin,retribution,12,4,8
Diaéna,kirin-tor,384,paladin,retribution,12,4,8
Inkuboss,nemesis,384,paladin,retribution,12,4,8
Зираэлис,gordunni,384,paladin,retribution,12,4,8
Ippex,silvermoon,384,paladin,retribution,12,4,8
Шэйкер,blackscar,384,paladin,retribution,12,4,8
Juozas,argent-dawn,384,paladin,retribution,12,4,8
Holyinstinct,bronze-dragonflight,384,paladin,retribution,12,4,8
Eîon,argent-dawn,384,paladin,retribution,12,4,8
Асшура,howling-fjord,384,paladin,retribution,12,4,8
Decain,twisting-nether,384,paladin,retribution,12,4,8
Arkkipiispa,outland,384,paladin,retribution,12,4,8
Pålegg,emerald-dream,384,paladin,retribution,12,4,8
Phazio,twisting-nether,384,paladin,retribution,12,4,8
Thiccdeeps,aegwynn,384,paladin,retribution,12,4,8
Benzimus,ragnaros,384,paladin,retribution,12,4,8
Perxx,stormscale,384,paladin,retribution,12,4,8
Dennyboy,sylvanas,384,paladin,retribution,12,4,8
Сандалар,gordunni,384,paladin,retribution,12,4,8
Minfa,argent-dawn,384,paladin,retribution,12,4,8
Генатрамбон,howling-fjord,384,paladin,retribution,12,4,8
Bundagains,silvermoon,384,paladin,retribution,12,4,8
Popelarr,burning-blade,384,paladin,retribution,12,4,8
Supergallows,shattered-hand,384,paladin,retribution,12,4,8
Hornybìlly,stormscale,384,paladin,retribution,12,4,8
Vilayesyo,ravencrest,384,paladin,retribution,12,4,8
Donttaskwhy,sylvanas,384,paladin,retribution,12,4,8
Crowdev,zuljin,384,paladin,retribution,12,4,8
Denlow,silvermoon,384,paladin,retribution,12,4,8
Xòtrios,argent-dawn,384,paladin,retribution,12,4,8
Kuhfleisch,eredar,384,paladin,retribution,12,4,8
Розовыйбабл,gordunni,384,paladin,retribution,12,4,8
Gladiator,die-aldor,384,paladin,retribution,12,4,8
Douglazz,tarren-mill,384,paladin,retribution,13,4,9
Лютыйчпок,fordragon,384,paladin,retribution,13,4,9
Руказакона,deathguard,384,paladin,retribution,18,4,14
Møøgødx,bronzebeard,384,paladin,retribution,18,4,14
Maitrelampe,argent-dawn,384,paladin,retribution,18,4,14
Forthy,drakthul,384,paladin,retribution,18,4,14
Алекхей,gordunni,384,paladin,retribution,18,4,14
Cadearas,antonidas,384,paladin,retribution,18,4,14
Anesthesiax,ravencrest,384,paladin,retribution,18,4,14
Orbia,draenor,384,paladin,retribution,18,4,14
Рукаф,soulflayer,383,paladin,retribution,6,4,2
Supersnubben,grim-batol,383,paladin,retribution,6,4,2
Fløki,blackrock,383,paladin,retribution,6,4,2
Bubblemama,aegwynn,383,paladin,retribution,6,4,2
Tank,uldum,383,paladin,retribution,6,4,2
Krögerelf,garrosh,383,paladin,retribution,6,4,2
Ренегадер,thermaplugg,383,paladin,retribution,6,4,2
Ahritea,blackrock,383,paladin,retribution,6,4,2
Tobebryant,eonar,383,paladin,retribution,6,4,2
Bärghest,sanguino,383,paladin,retribution,6,4,2
Buddy,conseil-des-ombres,383,paladin,retribution,9,5,4
Paladoon,ravencrest,383,paladin,retribution,12,4,8
Vonryan,defias-brotherhood,383,paladin,retribution,12,4,8
Käylä,silvermoon,383,paladin,retribution,12,4,8
Nenenita,cthun,383,paladin,retribution,12,4,8
Ратомир,howling-fjord,383,paladin,retribution,14,4,10
Anamary,ravencrest,383,paladin,retribution,15,4,11
Juliea,aegwynn,383,paladin,retribution,24,6,18
Ságé,thrall,383,paladin,retribution,16,4,12
Lavacalistar,turalyon,383,paladin,retribution,21,5,16
Fumatelo,tyrande,382,paladin,retribution,6,4,2
Shurikèn,khaz-modan,382,paladin,retribution,6,4,2
Rockymarcian,hyjal,382,paladin,retribution,12,4,8
Куоширо,goldrinn,381,paladin,retribution,12,4,8
Palastratos,turalyon,379,paladin,retribution,12,4,8
Bellight,sinstralis,376,paladin,retribution,19,4,15
Spóntaneous,ravencrest,351,paladin,retribution,8,5,3
Madzy,archimonde,351,paladin,retribution,11,4,7
Joeintkaa,ragnaros,351,paladin,retribution,11,4,7
Kantfyrste,ravencrest,351,paladin,retribution,11,4,7
Freemain,doomhammer,336,paladin,retribution,9,4,5
Sunsera,blackrock,330,paladin,retribution,8,5,3
Alanore,tarren-mill,330,paladin,retribution,13,6,7
Bafbaf,arathi,329,paladin,retribution,30,5,25
Reiwyn,archimonde,320,paladin,retribution,10,4,6
Kyazar,sylvanas,319,paladin,retribution,5,4,1
Vell,bronze-dragonflight,319,paladin,retribution,5,4,1
Strìke,ragnaros,319,paladin,retribution,8,4,4
Kýríl,antonidas,319,paladin,retribution,14,4,10
Адептустер,gordunni,319,paladin,retribution,14,4,10
Zerad,quelthalas,319,paladin,retribution,20,4,16
Palädörette,dalaran,318,paladin,retribution,5,4,1
Synthesis,uldum,288,paladin,retribution,6,3,3
Mcfëë,ysondre,288,paladin,retribution,6,3,3
Yaldly,dun-modr,288,paladin,retribution,6,3,3
Shaká,ravencrest,288,paladin,retribution,6,3,3
Lixîa,hyjal,288,paladin,retribution,6,3,3
Зеппели,gordunni,288,paladin,retribution,6,3,3
Xirac,antonidas,288,paladin,retribution,6,3,3
Ketherian,blutkessel,288,paladin,retribution,6,3,3
Лефша,soulflayer,288,paladin,retribution,6,3,3
Митахо,gordunni,288,paladin,retribution,6,3,3
Astralenigma,hyjal,288,paladin,retribution,6,3,3
Братстепина,gordunni,288,paladin,retribution,6,3,3
Lóde,silvermoon,288,paladin,retribution,6,3,3
Tîrana,ysondre,288,paladin,retribution,6,3,3
Sämaelia,ysondre,288,paladin,retribution,6,3,3
Harycon,thrall,288,paladin,retribution,6,3,3
Lyrïcs,ysondre,288,paladin,retribution,6,3,3
Бигтедо,gordunni,288,paladin,retribution,6,3,3
Jpally,ravencrest,288,paladin,retribution,6,3,3
Tonynox,hyjal,288,paladin,retribution,6,3,3
Seekêr,tarren-mill,288,paladin,retribution,6,3,3
Synexy,kazzak,288,paladin,retribution,6,3,3
Cloudlight,argent-dawn,288,paladin,retribution,6,3,3
Думклиф,gordunni,288,paladin,retribution,6,3,3
Løøktår,ysondre,288,paladin,retribution,6,3,3
Лайсен,gordunni,288,paladin,retribution,6,3,3
Eyebluee,tarren-mill,288,paladin,retribution,6,3,3
Qpalax,outland,288,paladin,retribution,6,3,3
Freakks,twisting-nether,288,paladin,retribution,6,3,3
Fahrèl,hyjal,288,paladin,retribution,6,3,3
Tyn,dragonmaw,288,paladin,retribution,6,3,3
Кс,greymane,288,paladin,retribution,6,3,3
Lbj,eredar,288,paladin,retribution,6,3,3
Ксинем,howling-fjord,288,paladin,retribution,6,3,3
Holythore,shadowsong,288,paladin,retribution,6,3,3
Muieiulica,twisting-nether,288,paladin,retribution,6,3,3
Holyshet,blackrock,288,paladin,retribution,6,3,3
Strangerx,blackrock,288,paladin,retribution,6,3,3
Мортлайт,soulflayer,288,paladin,retribution,6,3,3
Partur,stormreaver,288,paladin,retribution,6,3,3
Véngeance,twilights-hammer,288,paladin,retribution,6,3,3
Nympa,sylvanas,288,paladin,retribution,6,3,3
Cursedd,sanguino,288,paladin,retribution,6,3,3
Ksama,ysondre,288,paladin,retribution,6,3,3
Nînaninja,silvermoon,288,paladin,retribution,6,3,3
Belnadris,eredar,288,paladin,retribution,6,3,3
Retroxy,stormreaver,288,paladin,retribution,6,3,3
Alphaladin,stormscale,288,paladin,retribution,6,3,3
Темплеар,gordunni,288,paladin,retribution,6,3,3
Prâtox,blackmoore,288,paladin,retribution,6,3,3
Paidi,die-todeskrallen,288,paladin,retribution,6,3,3
Zehnya,grim-batol,288,paladin,retribution,6,3,3
Fogell,ravencrest,288,paladin,retribution,6,3,3
Блэкхарм,gordunni,288,paladin,retribution,6,3,3
Fumbz,alakir,288,paladin,retribution,6,3,3
Aklime,blackmoore,288,paladin,retribution,6,3,3
Boyard,silvermoon,288,paladin,retribution,6,3,3
Steínsgate,ravencrest,288,paladin,retribution,6,3,3
Lotheirid,antonidas,288,paladin,retribution,6,3,3
Талрэн,howling-fjord,288,paladin,retribution,6,3,3
Dwangl,silvermoon,288,paladin,retribution,6,3,3
Divineovic,ravencrest,288,paladin,retribution,6,3,3
Animegifx,ragnaros,288,paladin,retribution,6,3,3
Рамстафарай,gordunni,288,paladin,retribution,6,3,3
Moolurk,stormscale,288,paladin,retribution,6,3,3
Neithi,twisting-nether,288,paladin,retribution,6,3,3
Retisfine,silvermoon,288,paladin,retribution,6,3,3
Торсгард,howling-fjord,288,paladin,retribution,6,3,3
Minirempart,khaz-modan,288,paladin,retribution,6,3,3
Obackbarama,outland,288,paladin,retribution,6,3,3
Heallgodxx,ragnaros,288,paladin,retribution,6,3,3
Holyshêêt,draenor,288,paladin,retribution,6,3,3
Raketenreiko,blackrock,288,paladin,retribution,6,3,3
Cilodin,blackrock,288,paladin,retribution,6,3,3
Astralz,aegwynn,288,paladin,retribution,6,3,3
Sakulchan,antonidas,288,paladin,retribution,6,3,3
Малоко,thermaplugg,288,paladin,retribution,6,3,3
Gulyas,tarren-mill,288,paladin,retribution,6,3,3
Дджаб,booty-bay,288,paladin,retribution,6,3,3
Enmà,archimonde,288,paladin,retribution,6,3,3
Illmindofyou,twisting-nether,288,paladin,retribution,6,3,3
Рукибудды,soulflayer,288,paladin,retribution,6,3,3
Ozen,blackrock,288,paladin,retribution,6,3,3
Kielonpala,kazzak,288,paladin,retribution,6,3,3
Mayhem,area-52,288,paladin,retribution,6,3,3
Unforsakenx,silvermoon,288,paladin,retribution,6,3,3
Rômtone,dalaran,288,paladin,retribution,6,3,3
Rothus,bronze-dragonflight,288,paladin,retribution,6,3,3
Маразоточка,howling-fjord,288,paladin,retribution,6,3,3
Krýptø,ravencrest,288,paladin,retribution,6,3,3
Jessrabit,tarren-mill,288,paladin,retribution,6,3,3
Fabsy,frostwolf,288,paladin,retribution,6,3,3
Bämschi,blackrock,288,paladin,retribution,6,3,3
Êxood,archimonde,288,paladin,retribution,6,3,3
Tyranius,bronzebeard,288,paladin,retribution,6,3,3
Palapouffe,khaz-modan,288,paladin,retribution,6,3,3
Киэрсис,howling-fjord,288,paladin,retribution,6,3,3
Sarunan,ravencrest,288,paladin,retribution,6,3,3
Partysyster,defias-brotherhood,288,paladin,retribution,6,3,3
Tsunà,antonidas,288,paladin,retribution,6,3,3
Zeltose,uldaman,288,paladin,retribution,6,3,3
Hione,burning-legion,288,paladin,retribution,6,3,3
Elesmerias,dalaran,288,paladin,retribution,6,3,3
Eldivin,hyjal,288,paladin,retribution,6,3,3
Timal,eitrigg,288,paladin,retribution,6,3,3
Kelsumi,draenor,288,paladin,retribution,6,3,3
Hèmera,archimonde,288,paladin,retribution,6,3,3
Ïrönhämmër,argent-dawn,288,paladin,retribution,6,3,3
ßßæßßæßß,stormscale,288,paladin,retribution,6,3,3
Aoldur,ragnaros,288,paladin,retribution,6,3,3
Stárchy,terenas,288,paladin,retribution,6,3,3
Antidrasi,turalyon,288,paladin,retribution,6,3,3
Хаспадин,gordunni,288,paladin,retribution,6,3,3
Khadet,draenor,288,paladin,retribution,6,3,3
Reptoglad,archimonde,288,paladin,retribution,6,3,3
Névér,steamwheedle-cartel,288,paladin,retribution,6,3,3
Fufth,pozzo-delleternità,288,paladin,retribution,6,3,3
Sekztokio,blackmoore,288,paladin,retribution,6,3,3
Lolsurprise,twisting-nether,288,paladin,retribution,6,3,3
Akcope,thunderhorn,288,paladin,retribution,6,3,3
Golgel,turalyon,288,paladin,retribution,6,3,3
Kaarsius,defias-brotherhood,288,paladin,retribution,6,3,3
Uriel,scarshield-legion,288,paladin,retribution,6,3,3
Pigma,outland,288,paladin,retribution,9,4,5
Aenhel,zuljin,288,paladin,retribution,11,4,7
Parlma,naxxramas,288,paladin,retribution,13,4,9
Dragg,kirin-tor,288,paladin,retribution,10,3,7
Zerohour,kilrogg,288,paladin,retribution,12,3,9
Simsaii,stormscale,288,paladin,retribution,12,3,9
Mandingbull,stormscale,288,paladin,retribution,12,3,9
Smilé,sylvanas,288,paladin,retribution,12,3,9
Strikè,stormscale,288,paladin,retribution,12,3,9
Daddysiliam,ravencrest,288,paladin,retribution,12,3,9
Эеомли,blackscar,288,paladin,retribution,12,3,9
Бунча,gordunni,288,paladin,retribution,12,3,9
Масачусетсс,gordunni,288,paladin,retribution,12,3,9
Whórainzóne,eredar,288,paladin,retribution,12,3,9
Pikoman,hellfire,288,paladin,retribution,12,3,9
Найдэкер,gordunni,288,paladin,retribution,12,3,9
Cigoveth,sylvanas,288,paladin,retribution,12,3,9
Kraakz,sanguino,288,paladin,retribution,12,3,9
Wolluna,frostwolf,288,paladin,retribution,12,3,9
Claymore,ravenholdt,288,paladin,retribution,12,3,9
Gromzed,ravencrest,288,paladin,retribution,12,3,9
Miqee,burning-legion,288,paladin,retribution,12,3,9
Аладушок,gordunni,288,paladin,retribution,12,3,9
Ашилолпро,soulflayer,288,paladin,retribution,12,3,9
Таурмакус,howling-fjord,288,paladin,retribution,12,3,9
Загошслакер,howling-fjord,288,paladin,retribution,12,3,9
Tj,sanguino,288,paladin,retribution,12,3,9
Pascual,magtheridon,288,paladin,retribution,12,3,9
Annurra,quelthalas,288,paladin,retribution,12,3,9
Lättäkamerus,ravencrest,288,paladin,retribution,12,3,9
Quaterbâck,antonidas,288,paladin,retribution,12,3,9
Milisha,the-maelstrom,288,paladin,retribution,12,3,9
Ауё,blackscar,288,paladin,retribution,12,3,9
Lylennâ,argent-dawn,288,paladin,retribution,12,3,9
Dalaly,kazzak,288,paladin,retribution,12,3,9
Ragen,kazzak,288,paladin,retribution,12,3,9
Niou,alleria,288,paladin,retribution,12,3,9
Kypamop,argent-dawn,288,paladin,retribution,12,3,9
Blecheîmer,aegwynn,288,paladin,retribution,12,3,9
Dathea,aegwynn,288,paladin,retribution,12,3,9
Dufftroll,kazzak,288,paladin,retribution,12,3,9
Thoorval,silvermoon,288,paladin,retribution,12,3,9
Dmascus,blackrock,288,paladin,retribution,12,3,9
Ahreesh,blackrock,288,paladin,retribution,12,3,9
Lacrossé,kazzak,288,paladin,retribution,12,3,9
Trollpaladin,blackmoore,288,paladin,retribution,12,3,9
Diccari,stormreaver,288,paladin,retribution,12,3,9
Arthàs,blackmoore,288,paladin,retribution,12,3,9
Luridity,argent-dawn,288,paladin,retribution,12,3,9
Moriex,drakthul,288,paladin,retribution,12,3,9
Turbopal,burning-blade,288,paladin,retribution,12,3,9
Мува,soulflayer,288,paladin,retribution,14,3,11
Ulderoth,dun-modr,288,paladin,retribution,18,3,15
Cilise,bronzebeard,288,paladin,retribution,18,3,15
Ллосла,howling-fjord,288,paladin,retribution,18,3,15
Davoss,outland,288,paladin,retribution,18,3,15
Lééroÿ,sylvanas,287,paladin,retribution,8,4,4
Hrubo,drakthul,287,paladin,retribution,6,3,3
Taomeba,runetotem,287,paladin,retribution,6,3,3
Duragon,khaz-modan,287,paladin,retribution,6,3,3
Fortplus,pozzo-delleternità,287,paladin,retribution,6,3,3
Ïwâ,hyjal,287,paladin,retribution,6,3,3
Lewanor,tarren-mill,287,paladin,retribution,6,3,3
Themlstake,kazzak,287,paladin,retribution,6,3,3
Choyoki,blackmoore,287,paladin,retribution,7,3,4
Trevorion,argent-dawn,287,paladin,retribution,12,3,9
Bore,culte-de-la-rive-noire,287,paladin,retribution,12,3,9
Voraxpa,draenor,287,paladin,retribution,12,3,9
Cajikpal,drakthul,287,paladin,retribution,12,3,9
Rsanchez,frostwolf,286,paladin,retribution,6,3,3
Brictom,tarren-mill,271,paladin,retribution,11,3,8
Tofrus,kazzak,271,paladin,retribution,11,3,8
Рбгхил,howling-fjord,271,paladin,retribution,11,3,8
Loire,blackmoore,239,paladin,retribution,5,3,2
Erannor,kirin-tor,239,paladin,retribution,5,3,2
Pooncy,ragnaros,239,paladin,retribution,5,3,2
Tivv,blackhand,239,paladin,retribution,5,3,2
Tÿy,sylvanas,234,paladin,retribution,8,4,4
Dørvâp,culte-de-la-rive-noire,234,paladin,retribution,11,4,7
Tomkü,burning-legion,234,paladin,retribution,16,5,11
Rettalius,ravencrest,234,paladin,retribution,16,4,12
Pitux,dun-modr,192,paladin,retribution,4,3,1
Aimee,draenor,192,paladin,retribution,4,3,1
Тайела,gordunni,192,paladin,retribution,4,3,1
Toruk,burning-legion,192,paladin,retribution,4,3,1
Phaenre,pozzo-delleternità,192,paladin,retribution,6,2,4
Олегсудья,howling-fjord,192,paladin,retribution,6,2,4
Benø,malganis,192,paladin,retribution,6,2,4
Rdypaladin,ravencrest,192,paladin,retribution,6,2,4
Daviaa,silvermoon,192,paladin,retribution,6,2,4
Starr,confrérie-du-thorium,192,paladin,retribution,6,2,4
Slymm,archimonde,192,paladin,retribution,6,2,4
Stinkytoes,draenor,192,paladin,retribution,6,2,4
Hännó,malganis,192,paladin,retribution,6,2,4
Потрепал,blackscar,192,paladin,retribution,6,2,4
Maxximuss,drekthar,192,paladin,retribution,6,2,4
Bálerion,bronze-dragonflight,192,paladin,retribution,6,2,4
Greko,ysera,192,paladin,retribution,6,2,4
Alto,nordrassil,192,paladin,retribution,6,2,4
Vikingensven,silvermoon,192,paladin,retribution,6,2,4
Gornim,die-nachtwache,192,paladin,retribution,6,2,4
Alus,blackmoore,192,paladin,retribution,6,2,4
Скруддж,howling-fjord,192,paladin,retribution,6,2,4
Galaerøn,elune,192,paladin,retribution,6,2,4
Arator,terenas,192,paladin,retribution,6,2,4
Grìmmjøw,silvermoon,192,paladin,retribution,6,2,4
Ashariah,die-aldor,192,paladin,retribution,6,2,4
Wellick,ravencrest,192,paladin,retribution,6,2,4
Flashhèart,draenor,192,paladin,retribution,6,2,4
Swapxyr,aegwynn,192,paladin,retribution,6,2,4
Waks,dalaran,192,paladin,retribution,6,2,4
Lightwitcher,silvermoon,192,paladin,retribution,6,2,4
Azapala,kazzak,192,paladin,retribution,6,2,4
Shufflee,drakthul,192,paladin,retribution,6,2,4
Takezop,dun-modr,192,paladin,retribution,6,2,4
Ainnamash,twisting-nether,192,paladin,retribution,6,2,4
Níthag,ragnaros,192,paladin,retribution,6,2,4
Drident,die-nachtwache,192,paladin,retribution,6,2,4
Durwin,mazrigos,192,paladin,retribution,6,2,4
Oldsurehand,blackmoore,192,paladin,retribution,6,2,4
Fortination,dalaran,192,paladin,retribution,6,2,4
Vcd,kazzak,192,paladin,retribution,6,2,4
Drasir,nemesis,192,paladin,retribution,6,2,4
Jâybee,ravencrest,192,paladin,retribution,6,2,4
Legendaryxw,drakthul,192,paladin,retribution,6,2,4
Thrinea,blackrock,192,paladin,retribution,6,2,4
Пепескарлет,howling-fjord,192,paladin,retribution,6,2,4
Djstompyasis,blackmoore,192,paladin,retribution,6,2,4
Flawx,blackmoore,192,paladin,retribution,6,2,4
Llya,blackrock,192,paladin,retribution,6,2,4
Aguerx,alleria,192,paladin,retribution,6,2,4
Panomecon,magtheridon,192,paladin,retribution,6,2,4
Lorex,grim-batol,192,paladin,retribution,6,2,4
Palidos,blackrock,192,paladin,retribution,6,2,4
Ghéttørèt,das-konsortium,192,paladin,retribution,6,2,4
Myrmidan,magtheridon,192,paladin,retribution,6,2,4
Refléx,zirkel-des-cenarius,192,paladin,retribution,6,2,4
Lindrone,aggra-português,192,paladin,retribution,6,2,4
Cøygonne,archimonde,192,paladin,retribution,6,2,4
Stjusmussel,ragnaros,192,paladin,retribution,6,2,4
Jimrogier,argent-dawn,192,paladin,retribution,6,2,4
Дрейв,soulflayer,192,paladin,retribution,6,2,4
Valzyffs,twisting-nether,192,paladin,retribution,6,2,4
Фэрплэйн,gordunni,192,paladin,retribution,6,2,4
Memororo,stormscale,192,paladin,retribution,6,2,4
Dàk,grim-batol,192,paladin,retribution,6,2,4
Némesis,frostmane,192,paladin,retribution,6,2,4
Всеволорд,howling-fjord,192,paladin,retribution,6,2,4
Støøk,shendralar,192,paladin,retribution,6,2,4
Gaab,aggra-português,192,paladin,retribution,6,2,4
Quennten,grim-batol,192,paladin,retribution,6,2,4
Антитеррор,greymane,192,paladin,retribution,6,2,4
Saulencio,zuljin,192,paladin,retribution,6,2,4
Noxy,thrall,192,paladin,retribution,6,2,4
Meruem,blackrock,192,paladin,retribution,6,2,4
Paxillustral,twisting-nether,192,paladin,retribution,6,2,4
Palacheatlol,ysondre,192,paladin,retribution,6,2,4
Далходж,soulflayer,192,paladin,retribution,6,2,4
Holyape,argent-dawn,192,paladin,retribution,6,2,4
Bozznamaan,thrall,192,paladin,retribution,6,2,4
Zuldekk,sanguino,192,paladin,retribution,6,2,4
Yumhi,dun-modr,192,paladin,retribution,6,2,4
Ijego,silvermoon,192,paladin,retribution,6,2,4
Trainwréck,ravencrest,192,paladin,retribution,6,2,4
Бордюрчег,howling-fjord,192,paladin,retribution,6,2,4
Vallorum,ravencrest,192,paladin,retribution,6,2,4
Rinocerb,ravencrest,192,paladin,retribution,6,2,4
Roklim,blackhand,192,paladin,retribution,6,2,4
Bakasnoop,hyjal,192,paladin,retribution,6,2,4
Эйлара,howling-fjord,192,paladin,retribution,6,2,4
Mathrixo,silvermoon,192,paladin,retribution,6,2,4
Valanyr,kazzak,192,paladin,retribution,6,2,4
Ultrabenzo,ravencrest,192,paladin,retribution,6,2,4
Blazeê,blackrock,192,paladin,retribution,6,2,4
Холигор,deathguard,192,paladin,retribution,6,2,4
Tomforøl,aggramar,192,paladin,retribution,6,2,4
Maxunius,antonidas,192,paladin,retribution,6,2,4
Logmár,sanguino,192,paladin,retribution,6,2,4
Гачипаладинн,galakrond,192,paladin,retribution,6,2,4
Xavios,eredar,192,paladin,retribution,6,2,4
Fannypoo,sylvanas,192,paladin,retribution,6,2,4
Загадзуга,howling-fjord,192,paladin,retribution,6,2,4
Japsee,runetotem,192,paladin,retribution,6,2,4
Leroya,blackrock,192,paladin,retribution,6,2,4
Боевикс,ashenvale,192,paladin,retribution,6,2,4
Waramo,eredar,192,paladin,retribution,6,2,4
Donfilippo,burning-legion,192,paladin,retribution,6,2,4
Ðeswynd,hyjal,192,paladin,retribution,6,2,4
Altoangelo,outland,192,paladin,retribution,6,2,4
Легионор,galakrond,192,paladin,retribution,6,2,4
Víii,outland,192,paladin,retribution,6,2,4
Zbykmasta,burning-legion,192,paladin,retribution,6,2,4
Ustex,argent-dawn,192,paladin,retribution,6,2,4
Dollicia,outland,192,paladin,retribution,6,2,4
Rodakinos,outland,192,paladin,retribution,6,2,4
Blurengo,blackrock,192,paladin,retribution,6,2,4
Postî,eredar,192,paladin,retribution,6,2,4
Caribbean,outland,192,paladin,retribution,6,2,4
Serethor,blackrock,192,paladin,retribution,6,2,4
Zephale,sunstrider,192,paladin,retribution,6,2,4
Aal,eredar,192,paladin,retribution,6,2,4
Yømø,antonidas,192,paladin,retribution,6,2,4
Razarus,sylvanas,192,paladin,retribution,6,2,4
Heilgaharald,blackrock,192,paladin,retribution,6,2,4
Riares,darkspear,192,paladin,retribution,6,2,4
Pyronort,eredar,192,paladin,retribution,6,2,4
Apolytos,laughing-skull,192,paladin,retribution,6,2,4
Strøb,antonidas,192,paladin,retribution,6,2,4
Aelaris,dunemaul,192,paladin,retribution,6,2,4
Canihavesome,sylvanas,192,paladin,retribution,6,2,4
Døgpaladin,outland,192,paladin,retribution,6,2,4
Summuno,eredar,192,paladin,retribution,6,2,4
Knusern,dunemaul,192,paladin,retribution,6,2,4
Moraru,neptulon,192,paladin,retribution,6,2,4
Tinyandy,blackrock,192,paladin,retribution,6,2,4
Плат,gordunni,192,paladin,retribution,7,2,5
Kökslaktarn,sylvanas,192,paladin,retribution,15,3,12
Instaquez,stormscale,192,paladin,retribution,11,2,9
Samious,draenor,192,paladin,retribution,12,2,10
Remedios,archimonde,192,paladin,retribution,12,2,10
Mariuhûna,blackmoore,192,paladin,retribution,12,2,10
Мунрейм,gordunni,192,paladin,retribution,12,2,10
Limitles,nemesis,192,paladin,retribution,12,2,10
Pârâsite,hyjal,192,paladin,retribution,12,2,10
Babarush,nozdormu,192,paladin,retribution,12,2,10
Erathör,sanguino,192,paladin,retribution,12,2,10
Hito,sylvanas,192,paladin,retribution,12,2,10
Cunix,draenor,192,paladin,retribution,12,2,10
Muuclear,twisting-nether,192,paladin,retribution,12,2,10
Verix,thrall,192,paladin,retribution,12,2,10
Skemfar,sanguino,192,paladin,retribution,12,2,10
Galaadh,archimonde,192,paladin,retribution,12,2,10
Rhyua,eredar,192,paladin,retribution,12,2,10
Edathar,argent-dawn,192,paladin,retribution,12,2,10
Tressðr,dun-modr,192,paladin,retribution,12,2,10
Eniste,silvermoon,192,paladin,retribution,12,2,10
Reinwaltz,the-maelstrom,192,paladin,retribution,12,2,10
Лимфома,goldrinn,192,paladin,retribution,12,2,10
Wigbilly,tarren-mill,192,paladin,retribution,12,2,10
Leriell,ravencrest,192,paladin,retribution,12,2,10
Rîex,alleria,192,paladin,retribution,12,2,10
Vivike,silvermoon,192,paladin,retribution,12,2,10
Konardos,burning-legion,192,paladin,retribution,12,2,10
Stillgard,ghostlands,192,paladin,retribution,15,2,13
Cyxanacma,silvermoon,192,paladin,retribution,18,2,16
Milicos,sylvanas,191,paladin,retribution,6,2,4
Derbrècher,azshara,191,paladin,retribution,6,2,4
Ârthâstrâs,terrordar,191,paladin,retribution,6,2,4
Yeohinyiu,khaz-modan,191,paladin,retribution,6,2,4
Broziopath,blackrock,191,paladin,retribution,6,2,4
Duckula,ravenholdt,191,paladin,retribution,6,2,4
Supou,twisting-nether,191,paladin,retribution,6,2,4
Севенола,galakrond,191,paladin,retribution,6,2,4
Thelronis,kelthuzad,175,paladin,retribution,11,2,9
Geronimooh,vashj,159,paladin,retribution,5,2,3
Heiemdall,azuremyst,159,paladin,retribution,5,2,3
Aerathil,nethersturm,159,paladin,retribution,5,2,3
Trístesse,tarren-mill,159,paladin,retribution,11,2,9
Амнон,goldrinn,144,paladin,retribution,9,2,7
Еребор,howling-fjord,143,paladin,retribution,15,2,13
Braiinafk,thrall,138,paladin,retribution,6,3,3
Скелфер,soulflayer,138,paladin,retribution,8,3,5
Jesamine,blackmoore,138,paladin,retribution,9,3,6
Stonebeard,ahnqiraj,138,paladin,retribution,19,3,16
Danneris,sanguino,137,paladin,retribution,7,3,4
Paillasson,nerzhul,128,paladin,retribution,4,2,2
Lavawraith,argent-dawn,128,paladin,retribution,4,2,2
Tigerherz,antonidas,128,paladin,retribution,4,2,2
Qpax,twisting-nether,128,paladin,retribution,4,2,2
Aalyaah,zirkel-des-cenarius,96,paladin,retribution,3,2,1
Kelianna,drakthul,96,paladin,retribution,3,2,1
Маефис,gordunni,96,paladin,retribution,3,2,1
Моррзито,soulflayer,96,paladin,retribution,6,1,5
Hyggë,sanguino,96,paladin,retribution,6,1,5
Hipo,zuljin,96,paladin,retribution,6,1,5
Эльтарус,soulflayer,96,paladin,retribution,6,1,5
Nijówka,burning-legion,96,paladin,retribution,6,1,5
Møg,blackrock,96,paladin,retribution,6,1,5
Пашштет,gordunni,96,paladin,retribution,6,1,5
Pussas,burning-legion,96,paladin,retribution,6,1,5
Lowfi,argent-dawn,96,paladin,retribution,6,1,5
Shanilia,argent-dawn,96,paladin,retribution,6,1,5
Chelan,thrall,96,paladin,retribution,6,1,5
Akagami,ysondre,96,paladin,retribution,6,1,5
Блейзр,ashenvale,96,paladin,retribution,6,1,5
Graphpora,argent-dawn,96,paladin,retribution,6,1,5
Destya,eredar,96,paladin,retribution,6,1,5
Skarium,hyjal,96,paladin,retribution,6,1,5
Holyloa,laughing-skull,96,paladin,retribution,6,1,5
Lagrops,chants-éternels,96,paladin,retribution,6,1,5
Lezoom,draenor,96,paladin,retribution,6,1,5
Veshnu,blackrock,96,paladin,retribution,6,1,5
Valiscar,antonidas,96,paladin,retribution,6,1,5
Хилтонепта,gordunni,96,paladin,retribution,6,1,5
Stabilisator,blackrock,96,paladin,retribution,6,1,5
Kavíár,kazzak,96,paladin,retribution,6,1,5
Taraniah,argent-dawn,96,paladin,retribution,6,1,5
Tíríón,nethersturm,96,paladin,retribution,6,1,5
Scorebit,draenor,96,paladin,retribution,6,1,5
Винзерг,ashenvale,96,paladin,retribution,6,1,5
Kambood,twisting-nether,96,paladin,retribution,6,1,5
Lightian,twisting-nether,96,paladin,retribution,6,1,5
Sâfcon,eredar,96,paladin,retribution,6,1,5
Fatalism,draenor,96,paladin,retribution,6,1,5
Светиздырки,howling-fjord,96,paladin,retribution,6,1,5
Blazix,kazzak,96,paladin,retribution,6,1,5
Bubblebuttx,ghostlands,96,paladin,retribution,6,1,5
Amoxapine,hyjal,96,paladin,retribution,6,1,5
Gwynel,argent-dawn,96,paladin,retribution,6,1,5
Старыйграф,gordunni,96,paladin,retribution,6,1,5
Жмышенко,gordunni,96,paladin,retribution,6,1,5
Battlelord,terokkar,96,paladin,retribution,6,1,5
Пилоттыч,gordunni,96,paladin,retribution,6,1,5
Böserbube,tarren-mill,96,paladin,retribution,6,1,5
Ironstealman,shattered-hand,96,paladin,retribution,6,1,5
Bázer,antonidas,96,paladin,retribution,6,1,5
Ragie,twisting-nether,96,paladin,retribution,6,1,5
Paladzor,twisting-nether,96,paladin,retribution,6,1,5
Фатумм,howling-fjord,96,paladin,retribution,6,1,5
Pianiste,sinstralis,96,paladin,retribution,6,1,5
Thaderyl,auchindoun,96,paladin,retribution,6,1,5
Dananas,draenor,96,paladin,retribution,6,1,5
Atacan,twisting-nether,96,paladin,retribution,6,1,5
Steelrose,auchindoun,96,paladin,retribution,6,1,5
Azmocore,blackhand,96,paladin,retribution,6,1,5
Perrinaybull,magtheridon,96,paladin,retribution,6,1,5
Patsani,twilights-hammer,96,paladin,retribution,6,1,5
Cazzanova,draenor,96,paladin,retribution,6,1,5
Zlätän,outland,96,paladin,retribution,6,1,5
Friemelaar,silvermoon,96,paladin,retribution,6,1,5
Nîcolascage,stormscale,96,paladin,retribution,6,1,5
Serberen,ravencrest,96,paladin,retribution,6,1,5
Fintros,silvermoon,96,paladin,retribution,6,1,5
Diggs,draenor,96,paladin,retribution,6,1,5
Yséria,kirin-tor,96,paladin,retribution,6,1,5
Phlakorn,blackhand,96,paladin,retribution,6,1,5
Shuukz,blackmoore,96,paladin,retribution,6,1,5
Defuzes,twisting-nether,96,paladin,retribution,6,1,5
Nøvå,ravencrest,96,paladin,retribution,6,1,5
Karo,wildhammer,96,paladin,retribution,6,1,5
Vokesh,silvermoon,96,paladin,retribution,6,1,5
Rataxes,stormreaver,96,paladin,retribution,6,1,5
Aggressìon,twisting-nether,96,paladin,retribution,6,1,5
Blakethorn,silvermoon,96,paladin,retribution,6,1,5
Popolelo,dun-modr,96,paladin,retribution,6,1,5
Мэркес,fordragon,96,paladin,retribution,6,1,5
Hølyshøckz,blackmoore,96,paladin,retribution,6,1,5
Palamaister,stormscale,96,paladin,retribution,6,1,5
Tozzey,defias-brotherhood,96,paladin,retribution,6,1,5
Hordium,doomhammer,96,paladin,retribution,6,1,5
Évo,drakthul,96,paladin,retribution,6,1,5
Monmo,emerald-dream,96,paladin,retribution,6,1,5
Bobsing,silvermoon,96,paladin,retribution,6,1,5
Rekkt,ravenholdt,96,paladin,retribution,6,1,5
Dawnbringer,stormscale,96,paladin,retribution,6,1,5
Halldòr,ravencrest,96,paladin,retribution,6,1,5
Vindorus,archimonde,96,paladin,retribution,6,1,5
Édèn,les-sentinelles,96,paladin,retribution,6,1,5
Holyhannes,blackmoore,96,paladin,retribution,6,1,5
Dänie,silvermoon,96,paladin,retribution,6,1,5
Miawyn,blackmoore,96,paladin,retribution,6,1,5
Zerlat,twisting-nether,96,paladin,retribution,6,1,5
Omranator,stormscale,96,paladin,retribution,6,1,5
Bôomayé,archimonde,96,paladin,retribution,6,1,5
Saedrick,nemesis,96,paladin,retribution,6,1,5
Artplex,ravencrest,96,paladin,retribution,6,1,5
Flashyo,archimonde,96,paladin,retribution,6,1,5
Highlòrd,silvermoon,96,paladin,retribution,6,1,5
Quarrel,kul-tiras,96,paladin,retribution,6,1,5
Notingvar,doomhammer,96,paladin,retribution,6,1,5
Bigfatpig,ravencrest,96,paladin,retribution,6,1,5
Dildodin,ravencrest,96,paladin,retribution,6,1,5
Jûliâ,archimonde,96,paladin,retribution,6,1,5
Aion,chamber-of-aspects,96,paladin,retribution,6,1,5
Traxxces,ravencrest,96,paladin,retribution,6,1,5
Zandathor,chamber-of-aspects,96,paladin,retribution,6,1,5
Ansonia,ravencrest,96,paladin,retribution,6,1,5
Retrystyle,ragnaros,96,paladin,retribution,6,1,5
Kimozabie,ravencrest,96,paladin,retribution,6,1,5
Crawini,ragnaros,96,paladin,retribution,6,1,5
Bürd,rajaxx,96,paladin,retribution,6,1,5
Kefalas,ravencrest,96,paladin,retribution,6,1,5
Borons,silvermoon,96,paladin,retribution,9,1,8
Snakedubaby,blackrock,96,paladin,retribution,12,1,11
Kaelorian,silvermoon,96,paladin,retribution,12,1,11
Медверус,gordunni,96,paladin,retribution,12,1,11
Nauy,korgall,96,paladin,retribution,12,1,11
Fenik,dun-modr,96,paladin,retribution,12,1,11
Gazïel,kaelthas,96,paladin,retribution,12,1,11
Dragonous,darkmoon-faire,96,paladin,retribution,20,1,19
Charlybrown,archimonde,95,paladin,retribution,6,1,5
Uriziel,the-shatar,95,paladin,retribution,6,1,5
Rhauk,dun-modr,79,paladin,retribution,5,1,4
Pastaflwras,twisting-nether,64,paladin,retribution,4,1,3
Snobypala,onyxia,64,paladin,retribution,4,1,3
Emakk,darksorrow,63,paladin,retribution,2,2,0
Lafrogge,culte-de-la-rive-noire,48,paladin,retribution,3,1,2
Reliikt,blackrock,48,paladin,retribution,3,1,2
Doruk,stormscale,48,paladin,retribution,9,1,8
Plsdøntusemd,ravencrest,42,paladin,retribution,11,3,8
Окилан,gordunni,42,paladin,retribution,9,2,7
Ranish,aegwynn,42,paladin,retribution,9,2,7
Vengryn,turalyon,42,paladin,retribution,26,2,24
Кранштейн,gordunni,31,paladin,retribution,2,1,1
Irondawg,rajaxx,31,paladin,retribution,8,1,7
Davidas,drakthul,16,paladin,retribution,1,1,0
Pepsimaxpvp,blackmoore,16,paladin,retribution,1,1,0
Arbuzno,draenor,1955,paladin,protection,66,48,18
Leotheron,boulderfist,1763,paladin,protection,156,104,52
Collinnawin,aegwynn,1741,paladin,protection,90,45,45
Гниленький,razuvious,1712,paladin,protection,29,20,9
Sterben,aegwynn,1679,paladin,protection,66,29,37
Maximumtaste,ravencrest,1662,paladin,protection,30,22,8
Elitest,hyjal,1560,paladin,protection,195,75,120
Schrikii,archimonde,1556,paladin,protection,72,44,28
Phlakorn,blackhand,1514,paladin,protection,36,22,14
Силугор,soulflayer,1498,paladin,protection,48,26,22
Galevar,argent-dawn,1453,paladin,protection,128,63,65
Haringoth,argent-dawn,1448,paladin,protection,48,25,23
Gabubex,tarren-mill,1430,paladin,protection,99,59,40
Velkar,frostmane,1331,paladin,protection,82,42,40
Trufetteuh,hyjal,1311,paladin,protection,148,73,75
Ðivine,stormscale,1294,paladin,protection,42,15,27
Ichbin,sanguino,1262,paladin,protection,77,33,44
Augroni,antonidas,1247,paladin,protection,69,29,40
Lóu,hyjal,1224,paladin,protection,29,14,15
Âmba,blackrock,1150,paladin,protection,18,12,6
Sonnywalkman,twisting-nether,1055,paladin,protection,12,11,1
Justífiéd,kazzak,1055,paladin,protection,24,11,13
Flakkson,stormscale,1027,paladin,protection,42,12,30
Medium,frostwolf,958,paladin,protection,18,10,8
Проц,soulflayer,952,paladin,protection,18,10,8
Xrules,blackhand,855,paladin,protection,24,9,15
Fumbz,alakir,767,paladin,protection,12,8,4
Tíríón,nethersturm,763,paladin,protection,18,8,10
Yunalêsca,mugthol,760,paladin,protection,18,8,10
Statscowski,thrall,672,paladin,protection,12,7,5
Kraljevic,silvermoon,672,paladin,protection,12,7,5
Ванябублгам,soulflayer,672,paladin,protection,18,7,11
Tippressure,ravencrest,640,paladin,protection,10,7,3
Marihuána,ragnaros,576,paladin,protection,18,6,12
Leadfoot,argent-dawn,575,paladin,protection,12,6,6
Lägolas,thrall,511,paladin,protection,11,6,5
Supremerage,silvermoon,480,paladin,protection,12,5,7
Onefrostyboi,defias-brotherhood,479,paladin,protection,12,5,7
Elkka,azjolnerub,415,paladin,protection,11,5,6
Fleshoflight,arathor,384,paladin,protection,6,4,2
Galadrion,dun-modr,384,paladin,protection,6,4,2
Røse,argent-dawn,384,paladin,protection,12,4,8
Lotheriem,argent-dawn,383,paladin,protection,12,4,8
Figustyle,archimonde,318,paladin,protection,10,4,6
Swäagg,hyjal,288,paladin,protection,6,3,3
Craft,frostwolf,288,paladin,protection,6,3,3
Снайпик,azuregos,288,paladin,protection,6,3,3
Zuplex,deathwing,288,paladin,protection,6,3,3
Æero,blackhand,288,paladin,protection,6,3,3
Whiteraven,rexxar,288,paladin,protection,6,3,3
Ekenpala,kazzak,288,paladin,protection,6,3,3
Ðizzmo,bloodfeather,288,paladin,protection,12,3,9
Yourmomz,kazzak,239,paladin,protection,5,3,2
Emakk,darksorrow,192,paladin,protection,6,2,4
Helladin,haomarush,192,paladin,protection,6,2,4
Синерина,blackscar,192,paladin,protection,6,2,4
Derina,silvermoon,192,paladin,protection,6,2,4
Arkera,blackrock,192,paladin,protection,6,2,4
Quantox,frostwolf,192,paladin,protection,12,2,10
Exion,ravenholdt,159,paladin,protection,5,2,3
Thôrwald,les-sentinelles,96,paladin,protection,12,1,11
Bobilous,twisting-nether,79,paladin,protection,5,1,4
Candrä,archimonde,2164,priest,holy,90,47,43
Leadeur,kazzak,2148,priest,holy,80,42,38
Yötönyö,ravencrest,2043,priest,holy,60,32,28
Кальвейт,deathweaver,1968,priest,holy,69,34,35
Výra,der-rat-von-dalaran,1939,priest,holy,71,46,25
Ladá,stormscale,1939,priest,holy,138,73,65
Шотыказау,blackscar,1912,priest,holy,66,38,28
Lenyp,sanguino,1909,priest,holy,96,50,46
Лоаресс,gordunni,1868,priest,holy,72,33,39
Kunen,sanguino,1854,priest,holy,96,60,36
Weezing,ysondre,1849,priest,holy,72,36,36
Servêy,twisting-nether,1845,priest,holy,42,22,20
Dmnz,blackrock,1840,priest,holy,75,34,41
Grafius,stormscale,1826,priest,holy,42,23,19
Yateh,blackmoore,1824,priest,holy,62,32,30
Катккат,soulflayer,1823,priest,holy,48,27,21
Siign,ravencrest,1820,priest,holy,54,27,27
Sayne,arathor,1815,priest,holy,168,91,77
Maruh,malganis,1812,priest,holy,113,60,53
Eriónd,ravencrest,1811,priest,holy,66,34,32
Muchos,blackrock,1807,priest,holy,66,31,35
Køzukï,ravencrest,1805,priest,holy,66,28,38
Teatime,aegwynn,1800,priest,holy,84,42,42
Гоплзнекст,gordunni,1782,priest,holy,216,116,100
Imbitterx,stormscale,1777,priest,holy,30,21,9
Carlitastock,eredar,1777,priest,holy,41,22,19
Dolens,argent-dawn,1775,priest,holy,94,49,45
Psi,hakkar,1725,priest,holy,193,108,85
Wåtrux,alakir,1724,priest,holy,118,66,52
Kaalu,frostmane,1716,priest,holy,200,99,101
Jim,saurfang,1711,priest,holy,251,124,127
Tangent,ravencrest,1707,priest,holy,60,30,30
Kaiikoo,ravencrest,1701,priest,holy,42,24,18
Holyholy,stormscale,1697,priest,holy,56,20,36
Itsmeminglee,ravencrest,1694,priest,holy,42,20,22
Meanbabe,argent-dawn,1683,priest,holy,48,22,26
Smïlë,ravencrest,1679,priest,holy,155,79,76
Gladíator,blackhand,1677,priest,holy,102,58,44
Phobò,blackrock,1676,priest,holy,66,30,36
Kÿokó,ravencrest,1670,priest,holy,72,40,32
Weezïng,ysondre,1668,priest,holy,42,24,18
Alpháømegá,outland,1653,priest,holy,81,42,39
Beatrixz,twisting-nether,1650,priest,holy,127,62,65
Câlyr,ragnaros,1647,priest,holy,48,21,27
Løøney,kazzak,1635,priest,holy,36,25,11
Друмги,gordunni,1635,priest,holy,54,19,35
Calithria,kazzak,1631,priest,holy,95,53,42
Senkín,aegwynn,1621,priest,holy,54,30,24
Ilenna,dun-morogh,1618,priest,holy,54,32,22
Alchemïst,ravencrest,1617,priest,holy,46,21,25
Cosines,ravencrest,1614,priest,holy,36,17,19
Affro,drakthul,1613,priest,holy,54,27,27
Sïxsïxsïx,ravencrest,1613,priest,holy,43,21,22
Нубстрим,gordunni,1611,priest,holy,60,28,32
Stinkydog,kazzak,1607,priest,holy,71,32,39
Shanya,thrall,1605,priest,holy,221,109,112
Eox,kazzak,1602,priest,holy,36,20,16
Zxø,ravencrest,1601,priest,holy,160,88,72
Dranbor,argent-dawn,1592,priest,holy,76,39,37
Xianxia,twisting-nether,1589,priest,holy,30,17,13
Salvatíon,sanguino,1588,priest,holy,46,20,26
Phobò,antonidas,1583,priest,holy,84,36,48
Dény,ravencrest,1573,priest,holy,90,50,40
Highn,anetheron,1570,priest,holy,60,33,27
Anabananaa,ravencrest,1561,priest,holy,40,24,16
Elmaestrø,aegwynn,1558,priest,holy,48,25,23
Wilby,archimonde,1550,priest,holy,42,20,22
Womanwonderf,ravencrest,1542,priest,holy,48,23,25
Møhammed,wrathbringer,1537,priest,holy,138,65,73
Hyonra,kazzak,1536,priest,holy,66,34,32
Gnomemonk,stormscale,1533,priest,holy,120,55,65
Vregoa,twisting-nether,1532,priest,holy,36,17,19
Anníng,tarren-mill,1528,priest,holy,114,63,51
Jiffie,twisting-nether,1528,priest,holy,30,16,14
Sehlia,kazzak,1526,priest,holy,126,64,62
Evabae,the-maelstrom,1520,priest,holy,42,22,20
Divinetouch,ravencrest,1516,priest,holy,78,35,43
Dokkaebì,kazzak,1514,priest,holy,135,67,68
Joeasaurs,ragnaros,1510,priest,holy,60,24,36
Rines,thrall,1505,priest,holy,143,72,71
Zlejkadlec,drakthul,1504,priest,holy,52,27,25
Заволончик,blackscar,1494,priest,holy,102,48,54
Alphacub,ragnaros,1478,priest,holy,60,27,33
Mcdeady,tarren-mill,1477,priest,holy,36,17,19
Koíré,defias-brotherhood,1472,priest,holy,84,46,38
Maah,defias-brotherhood,1471,priest,holy,80,46,34
Hydraximus,garrosh,1471,priest,holy,310,155,155
Suxino,stormscale,1466,priest,holy,72,39,33
Symbolofhope,ravencrest,1460,priest,holy,117,62,55
Atiyesh,arthas,1448,priest,holy,111,61,50
Byzzi,draenor,1447,priest,holy,30,19,11
Cøvu,draenor,1439,priest,holy,58,26,32
Boonlai,ravencrest,1438,priest,holy,30,15,15
Fizzlesp,tarren-mill,1425,priest,holy,30,15,15
Phénylanine,khaz-modan,1420,priest,holy,51,27,24
Вакидзачи,gordunni,1419,priest,holy,54,27,27
Kbakå,kazzak,1419,priest,holy,78,37,41
Pigdestroyin,frostmane,1418,priest,holy,30,15,15
Nomakprst,sanguino,1417,priest,holy,42,24,18
Prëdz,stormscale,1416,priest,holy,36,20,16
Markianos,silvermoon,1412,priest,holy,114,58,56
Aykò,blackmoore,1412,priest,holy,36,15,21
Nastylex,magtheridon,1410,priest,holy,24,15,9
Мектран,gordunni,1408,priest,holy,54,27,27
Bifs,blackmoore,1405,priest,holy,50,32,18
Инзора,gordunni,1400,priest,holy,30,15,15
Mylini,silvermoon,1392,priest,holy,42,29,13
Madcole,blackhand,1371,priest,holy,85,43,42
Seladine,ravencrest,1367,priest,holy,125,64,61
Neoark,archimonde,1364,priest,holy,61,29,32
Orcid,chogall,1355,priest,holy,84,44,40
Alros,elune,1346,priest,holy,54,26,28
Tyrhaa,blackmoore,1345,priest,holy,102,52,50
Libetha,ysondre,1341,priest,holy,29,18,11
Мамкалол,soulflayer,1341,priest,holy,24,14,10
Alizeé,nazjatar,1341,priest,holy,48,24,24
Jaz,ysondre,1339,priest,holy,30,15,15
Shizzlol,silvermoon,1339,priest,holy,30,14,16
Angrk,kazzak,1338,priest,holy,42,26,16
Virginmaris,sanguino,1337,priest,holy,48,28,20
Rägà,archimonde,1337,priest,holy,49,27,22
Delphina,archimonde,1326,priest,holy,83,44,39
Ezechiel,twisting-nether,1325,priest,holy,35,22,13
Tëmärï,ravencrest,1317,priest,holy,54,36,18
Lasuora,nemesis,1315,priest,holy,60,26,34
Gloxina,argent-dawn,1305,priest,holy,66,34,32
Midycine,ysondre,1300,priest,holy,47,23,24
Catstretch,ravencrest,1300,priest,holy,89,38,51
Hmanco,burning-legion,1287,priest,holy,42,26,16
Asare,outland,1286,priest,holy,60,35,25
Draconux,terenas,1273,priest,holy,48,18,30
Nosgot,earthen-ring,1272,priest,holy,60,31,29
Wintercurse,twisting-nether,1272,priest,holy,52,24,28
Djdesha,tarren-mill,1272,priest,holy,35,16,19
Zakhun,stormrage,1271,priest,holy,82,42,40
Ethery,argent-dawn,1266,priest,holy,65,33,32
Lykarion,argent-dawn,1265,priest,holy,72,37,35
Возхд,soulflayer,1258,priest,holy,30,15,15
Soapie,defias-brotherhood,1249,priest,holy,24,14,10
Zên,argent-dawn,1248,priest,holy,21,14,7
Åluneth,kazzak,1247,priest,holy,75,34,41
Hiimgreen,blackhand,1241,priest,holy,24,13,11
Adare,sanguino,1241,priest,holy,30,13,17
Certe,twisting-nether,1240,priest,holy,72,29,43
Tudiiheals,frostwolf,1236,priest,holy,39,20,19
Ниеса,lich-king,1229,priest,holy,68,34,34
Lómesilme,dun-modr,1226,priest,holy,24,13,11
Nykah,antonidas,1224,priest,holy,55,19,36
Usw,outland,1224,priest,holy,51,14,37
Morrydin,stormreaver,1217,priest,holy,48,18,30
Maybelline,ravencrest,1215,priest,holy,36,16,20
Пингзеро,soulflayer,1215,priest,holy,56,23,33
Neenä,ravencrest,1214,priest,holy,50,25,25
Harlemsfnest,blackrock,1204,priest,holy,21,13,8
Скартэикс,howling-fjord,1200,priest,holy,42,20,22
Kbakå,stormscale,1193,priest,holy,65,27,38
Lhyria,baelgun,1189,priest,holy,48,21,27
Torcena,garrosh,1185,priest,holy,119,60,59
Nino,gorgonnash,1184,priest,holy,36,13,23
Dathlight,argent-dawn,1183,priest,holy,71,37,34
Иннерон,soulflayer,1171,priest,holy,70,33,37
Xzklolz,twisting-nether,1161,priest,holy,23,13,10
Lyla,frostwolf,1149,priest,holy,48,27,21
Преттисмайл,gordunni,1149,priest,holy,30,12,18
Dúréx,sanguino,1147,priest,holy,24,18,6
Alloktonos,ravencrest,1146,priest,holy,91,38,53
Pridepriest,twisting-nether,1137,priest,holy,24,12,12
Meatyshaft,doomhammer,1129,priest,holy,45,18,27
Fedorah,ragnaros,1127,priest,holy,36,17,19
Nou,aegwynn,1127,priest,holy,30,12,18
Sücre,dalaran,1125,priest,holy,30,16,14
Eazzyy,kazzak,1115,priest,holy,27,12,15
Brigied,turalyon,1110,priest,holy,30,12,18
Morphuz,tarren-mill,1102,priest,holy,102,44,58
Kæos,blackrock,1091,priest,holy,64,28,36
Anàriel,elune,1070,priest,holy,36,13,23
Lobogaust,kargath,1067,priest,holy,30,19,11
Copperplume,ravenholdt,1067,priest,holy,60,21,39
Ludriel,turalyon,1056,priest,holy,54,26,28
Zen,talnivarr,1056,priest,holy,24,11,13
Boomixed,twisting-nether,1055,priest,holy,18,11,7
Laewen,die-aldor,1054,priest,holy,45,22,23
Тевтонка,goldrinn,1054,priest,holy,48,22,26
Рейеан,soulflayer,1054,priest,holy,24,11,13
Uro,tirion,1053,priest,holy,30,11,19
Fjonnski,blackmoore,1050,priest,holy,18,11,7
Hoeneygodx,antonidas,1050,priest,holy,24,11,13
Gï,blackmoore,1048,priest,holy,18,11,7
Kímbérléy,argent-dawn,1042,priest,holy,36,19,17
Ломаюключики,gordunni,1042,priest,holy,39,16,23
Hipnotika,nemesis,1042,priest,holy,47,17,30
Türapea,draenor,1033,priest,holy,18,12,6
Deeforce,argent-dawn,1019,priest,holy,79,42,37
Orcü,tarren-mill,1017,priest,holy,42,18,24
Ankhepope,outland,1013,priest,holy,56,33,23
Siarai,pozzo-delleternità,1001,priest,holy,37,19,18
Melancholly,thunderhorn,998,priest,holy,23,13,10
Краббожий,greymane,987,priest,holy,29,11,18
Valtessian,medivh,961,priest,holy,57,27,30
Baabaak,frostmane,960,priest,holy,15,12,3
Xlhealscptn,arathor,959,priest,holy,60,19,41
Hara,elune,957,priest,holy,24,10,14
Kotipope,silvermoon,956,priest,holy,24,10,14
Rennic,stormscale,955,priest,holy,18,10,8
Sickheals,doomhammer,954,priest,holy,36,20,16
Speltmor,stormscale,953,priest,holy,24,10,14
Archangel,terokkar,942,priest,holy,42,22,20
Ripjuice,sylvanas,930,priest,holy,28,11,17
Kanki,haomarush,925,priest,holy,42,19,23
Discxqt,ysondre,924,priest,holy,14,11,3
Covidios,twisting-nether,888,priest,holy,45,21,24
Eurydike,blackrock,887,priest,holy,16,10,6
Jaisuu,ravencrest,864,priest,holy,12,9,3
Testdeath,ravencrest,864,priest,holy,18,9,9
Rhæveth,ravencrest,864,priest,holy,18,9,9
Âlolexx,archimonde,863,priest,holy,12,9,3
Ankî,aegwynn,863,priest,holy,18,9,9
Andreel,ravencrest,860,priest,holy,18,9,9
Sodatsu,cthun,859,priest,holy,18,9,9
Hyonzy,silvermoon,859,priest,holy,24,9,15
Omnissiiah,silvermoon,856,priest,holy,24,9,15
Leyea,kazzak,849,priest,holy,25,10,15
Infinitiy,sylvanas,827,priest,holy,18,9,9
Rahela,dun-modr,793,priest,holy,17,9,8
Dampfwalze,nozdormu,779,priest,holy,26,10,16
Evílz,tarren-mill,768,priest,holy,12,8,4
Ltmp,ravencrest,768,priest,holy,18,8,10
Budgetdp,archimonde,768,priest,holy,18,8,10
Ÿolo,nemesis,768,priest,holy,24,8,16
Sak,uldaman,767,priest,holy,18,8,10
Misscure,draenor,765,priest,holy,24,8,16
Mcmuffin,runetotem,761,priest,holy,12,8,4
Sohryø,drekthar,761,priest,holy,18,8,10
Iliridan,pozzo-delleternità,726,priest,holy,42,11,31
Moirgana,minahonda,718,priest,holy,17,8,9
Valentinus,dragonmaw,702,priest,holy,26,8,18
Mélínâ,blackmoore,691,priest,holy,28,9,19
Willzah,outland,672,priest,holy,12,7,5
Гшд,gordunni,672,priest,holy,12,7,5
Malkàv,hyjal,672,priest,holy,12,7,5
Ainadaxz,ravencrest,672,priest,holy,12,7,5
Darkoul,conseil-des-ombres,672,priest,holy,12,7,5
Cleoana,blackhand,672,priest,holy,12,7,5
Ksn,silvermoon,672,priest,holy,18,7,11
Penvon,ravencrest,672,priest,holy,24,7,17
Gintøníc,blackmoore,671,priest,holy,12,7,5
Veurjin,uldaman,671,priest,holy,12,7,5
Cartøøns,ravencrest,671,priest,holy,12,7,5
Yuhé,elune,671,priest,holy,12,7,5
Nemista,hyjal,671,priest,holy,18,7,11
Penitence,drekthar,671,priest,holy,18,7,11
Migam,kazzak,671,priest,holy,18,7,11
Holydolly,doomhammer,669,priest,holy,12,7,5
Zinary,silvermoon,667,priest,holy,18,7,11
Sâtânica,kelthuzad,610,priest,holy,27,8,19
Blâdes,gorgonnash,589,priest,holy,17,7,10
Darkoul,ravencrest,576,priest,holy,12,6,6
Zoophobîa,stormscale,576,priest,holy,12,6,6
Danina,outland,576,priest,holy,12,6,6
Bij,outland,576,priest,holy,12,6,6
Nancey,draenor,576,priest,holy,12,6,6
Yamai,thrall,576,priest,holy,12,6,6
Найтингеилл,gordunni,576,priest,holy,12,6,6
Englishheart,auchindoun,576,priest,holy,12,6,6
Мотд,gordunni,576,priest,holy,18,6,12
Nathamo,archimonde,575,priest,holy,12,6,6
Spàgno,nemesis,571,priest,holy,18,6,12
Dazé,ravencrest,563,priest,holy,19,9,10
Priestxx,twilights-hammer,543,priest,holy,11,6,5
Scartay,outland,543,priest,holy,11,6,5
Nálá,nethersturm,521,priest,holy,16,7,9
Ralek,hyjal,495,priest,holy,17,6,11
Secundis,silvermoon,480,priest,holy,6,5,1
Felaenna,argent-dawn,480,priest,holy,6,5,1
Quiwzx,blackrock,480,priest,holy,12,5,7
Mazeari,sylvanas,480,priest,holy,12,5,7
Åzjol,magtheridon,480,priest,holy,12,5,7
Sisko,stormscale,480,priest,holy,12,5,7
Árcadoom,quelthalas,479,priest,holy,12,5,7
Двакамня,soulflayer,479,priest,holy,12,5,7
Nicksiz,silvermoon,479,priest,holy,12,5,7
Alaeddin,kazzak,479,priest,holy,24,5,19
Shanny,kazzak,384,priest,holy,6,4,2
Experimentix,silvermoon,384,priest,holy,6,4,2
Tyene,voljin,384,priest,holy,6,4,2
Skíps,sylvanas,384,priest,holy,6,4,2
Karpiest,stormscale,384,priest,holy,6,4,2
Yredias,dalaran,384,priest,holy,6,4,2
Arithon,blackrock,384,priest,holy,6,4,2
Flurri,tarren-mill,384,priest,holy,12,4,8
Sayash,chamber-of-aspects,384,priest,holy,12,4,8
Zarez,stormscale,384,priest,holy,12,4,8
Bebwaz,kazzak,384,priest,holy,12,4,8
Ksn,argent-dawn,384,priest,holy,12,4,8
Blazekk,sylvanas,384,priest,holy,12,4,8
Disillusíon,tarren-mill,384,priest,holy,12,4,8
Gertie,blackhand,384,priest,holy,12,4,8
Badguymike,ragnaros,384,priest,holy,12,4,8
Skytheory,eredar,384,priest,holy,13,4,9
Ømegagødx,outland,384,priest,holy,18,4,14
Ðlcz,blackrock,384,priest,holy,18,4,14
Applecrumßle,ragnaros,383,priest,holy,6,4,2
Sîanah,archimonde,383,priest,holy,12,4,8
Ruebi,blackmoore,383,priest,holy,12,4,8
Sarafîsthole,ysondre,380,priest,holy,12,4,8
Nxtlvl,stormscale,352,priest,holy,10,5,5
Голнар,deathguard,351,priest,holy,14,5,9
Shyvi,ravencrest,319,priest,holy,5,4,1
Fratio,krasus,288,priest,holy,6,3,3
Hilerki,draenor,288,priest,holy,6,3,3
Goytka,tarren-mill,288,priest,holy,6,3,3
Ahilarry,tarren-mill,288,priest,holy,6,3,3
Bambus,shattered-hand,288,priest,holy,6,3,3
Holyheartx,argent-dawn,288,priest,holy,6,3,3
Миррен,gordunni,288,priest,holy,6,3,3
Shmoly,stormscale,288,priest,holy,6,3,3
ßestworld,draenor,288,priest,holy,6,3,3
Caz,cthun,288,priest,holy,6,3,3
Avelynn,ravencrest,288,priest,holy,6,3,3
Góli,argent-dawn,288,priest,holy,6,3,3
Missdemerè,nemesis,288,priest,holy,6,3,3
Arabpriest,draenor,288,priest,holy,6,3,3
Ariyia,argent-dawn,288,priest,holy,6,3,3
Jeboc,ravencrest,288,priest,holy,6,3,3
Bobitä,ravencrest,288,priest,holy,6,3,3
Blackwidow,chromaggus,288,priest,holy,6,3,3
Namsolo,kazzak,288,priest,holy,6,3,3
Nerfnerf,kazzak,288,priest,holy,6,3,3
Hotforus,silvermoon,288,priest,holy,6,3,3
Shâru,frostmourne,288,priest,holy,6,3,3
Novella,kult-der-verdammten,288,priest,holy,6,3,3
Drminduskâ,ysondre,288,priest,holy,12,3,9
Protegee,draenor,288,priest,holy,12,3,9
Fatherliam,emerald-dream,288,priest,holy,12,3,9
Lurri,tarren-mill,288,priest,holy,12,3,9
Dotreveal,ravencrest,288,priest,holy,12,3,9
Quami,dun-modr,288,priest,holy,12,3,9
Javvi,sylvanas,288,priest,holy,12,3,9
Eihran,stormscale,288,priest,holy,12,3,9
Farae,arathor,288,priest,holy,18,3,15
Bloodelfoula,draenor,286,priest,holy,12,3,9
Lr,aszune,240,priest,holy,9,3,6
Eyllise,ragnaros,192,priest,holy,6,2,4
Discobrill,silvermoon,192,priest,holy,6,2,4
Grøums,blackmoore,192,priest,holy,6,2,4
Korzec,dun-modr,192,priest,holy,6,2,4
Troedelsuppe,destromath,192,priest,holy,6,2,4
Ibunnyqt,aegwynn,192,priest,holy,6,2,4
Noukeé,blackrock,192,priest,holy,6,2,4
Prästpojken,frostwhisper,192,priest,holy,6,2,4
Vitae,gorgonnash,192,priest,holy,6,2,4
Krematorio,twisting-nether,192,priest,holy,6,2,4
Dangerfred,stormscale,192,priest,holy,6,2,4
Burnex,thrall,192,priest,holy,6,2,4
Nýkah,antonidas,192,priest,holy,6,2,4
Haxxøn,die-nachtwache,192,priest,holy,6,2,4
Ebolaidman,ravencrest,192,priest,holy,6,2,4
Dami,defias-brotherhood,192,priest,holy,6,2,4
Bamboleon,blackrock,192,priest,holy,6,2,4
Yukirito,drakthul,192,priest,holy,6,2,4
Bøij,pozzo-delleternità,192,priest,holy,8,2,6
Mayalolz,chogall,192,priest,holy,8,2,6
Бранлор,howling-fjord,192,priest,holy,8,2,6
Stanyú,tarren-mill,192,priest,holy,12,2,10
Hónòr,sylvanas,192,priest,holy,12,2,10
Gød,magtheridon,192,priest,holy,18,2,16
Meynola,ysondre,191,priest,holy,6,2,4
Benificent,argent-dawn,159,priest,holy,5,2,3
Spae,twisting-nether,138,priest,holy,11,4,7
Saheila,defias-brotherhood,96,priest,holy,6,1,5
Remkoja,blackrock,96,priest,holy,6,1,5
Ylenae,twisting-nether,96,priest,holy,6,1,5
Jaatjak,ravencrest,96,priest,holy,6,1,5
Tÿona,hyjal,96,priest,holy,6,1,5
Itstooney,doomhammer,96,priest,holy,6,1,5
Isendriel,outland,96,priest,holy,6,1,5
Bubbleup,defias-brotherhood,96,priest,holy,6,1,5
Pattie,ragnaros,96,priest,holy,6,1,5
Herwin,twisting-nether,96,priest,holy,6,1,5
Systerstål,twisting-nether,96,priest,holy,6,1,5
Zongiz,azjolnerub,96,priest,holy,6,1,5
Plaguestrike,darkspear,96,priest,holy,6,1,5
Батлджес,gordunni,96,priest,holy,6,1,5
Bowie,frostwhisper,96,priest,holy,6,1,5
Сакредлайв,gordunni,96,priest,holy,6,1,5
Laadyybirkee,blackhand,96,priest,holy,6,1,5
Syntara,twisting-nether,96,priest,holy,12,1,11
Åme,kirin-tor,96,priest,holy,12,1,11
Kæzm,blackrock,96,priest,holy,12,1,11
Felvytwo,stormscale,96,priest,holy,12,1,11
Mswagner,outland,79,priest,holy,5,1,4
Darkyos,azshara,42,priest,holy,6,2,4
Vanostsp,kazzak,2230,priest,discipline,102,56,46
Jayti,ravencrest,2205,priest,discipline,115,65,50
Dripcheck,draenor,2180,priest,discipline,133,73,60
Èfflux,ravencrest,2172,priest,discipline,86,54,32
Bedfirez,ravencrest,2161,priest,discipline,211,122,89
Holypoppa,ravencrest,2145,priest,discipline,115,64,51
Saentainen,kazzak,2133,priest,discipline,95,68,27
Cylizx,stormscale,2133,priest,discipline,114,62,52
Moonriver,archimonde,2132,priest,discipline,66,39,27
Artle,sanguino,2131,priest,discipline,83,44,39
Azrpr,ravencrest,2128,priest,discipline,82,45,37
Rébörn,tarren-mill,2123,priest,discipline,71,44,27
Twinkboyx,ragnaros,2121,priest,discipline,93,50,43
Jidammy,ravencrest,2120,priest,discipline,80,41,39
Rñd,ravencrest,2117,priest,discipline,78,40,38
Vengefulmaze,ravencrest,2101,priest,discipline,90,46,44
Klonyaryk,ravencrest,2100,priest,discipline,78,47,31
Sèco,sylvanas,2085,priest,discipline,84,44,40
Jackiqt,nemesis,2078,priest,discipline,101,64,37
Mentalboom,emerald-dream,2044,priest,discipline,125,64,61
Vajadisc,twisting-nether,2037,priest,discipline,106,47,59
Thelïght,ravencrest,2034,priest,discipline,111,54,57
Гопикзашквар,blackscar,2017,priest,discipline,104,47,57
Priestqtx,kelthuzad,2016,priest,discipline,60,34,26
Trialight,ravencrest,2009,priest,discipline,89,57,32
Crinji,blackmoore,2005,priest,discipline,139,68,71
Хомячпочка,gordunni,2003,priest,discipline,76,40,36
Shmoly,stormscale,2001,priest,discipline,91,47,44
Salvinia,kelthuzad,1999,priest,discipline,90,48,42
Stavfel,stormscale,1993,priest,discipline,93,51,42
Djsüssi,frostwolf,1989,priest,discipline,121,56,65
Unréål,ravencrest,1987,priest,discipline,108,49,59
Summerfinn,ravencrest,1982,priest,discipline,87,43,44
Underdogx,eredar,1980,priest,discipline,109,58,51
Kâiøxx,outland,1979,priest,discipline,48,31,17
Dpriesta,aegwynn,1979,priest,discipline,88,52,36
Acondisc,kazzak,1977,priest,discipline,76,43,33
Ekman,twisting-nether,1977,priest,discipline,128,67,61
Sinetrax,tarren-mill,1973,priest,discipline,96,57,39
Neverdome,ravencrest,1973,priest,discipline,128,75,53
Aeogon,kazzak,1972,priest,discipline,107,50,57
Mercilégion,sargeras,1971,priest,discipline,66,34,32
Ilumiinatrix,dun-modr,1966,priest,discipline,157,81,76
Charlotten,shattered-hand,1963,priest,discipline,84,42,42
Synxii,ravencrest,1961,priest,discipline,58,35,23
Spinebuster,frostwolf,1958,priest,discipline,78,38,40
Алинкалол,howling-fjord,1948,priest,discipline,162,96,66
Primayodbain,archimonde,1947,priest,discipline,58,33,25
Shøy,nemesis,1942,priest,discipline,66,34,32
Карпинчо,soulflayer,1941,priest,discipline,82,43,39
Ebuglatatrov,ravencrest,1941,priest,discipline,120,57,63
Mysterymucus,draenor,1938,priest,discipline,102,61,41
Porkhunt,stormscale,1938,priest,discipline,90,52,38
Kekkons,sylvanas,1938,priest,discipline,65,34,31
Хомяктьмы,gordunni,1938,priest,discipline,72,37,35
Senga,kazzak,1937,priest,discipline,78,38,40
Önnÿ,dun-modr,1933,priest,discipline,78,39,39
Syreet,silvermoon,1926,priest,discipline,231,120,111
Psyheea,stormscale,1926,priest,discipline,139,62,77
Akaria,kelthuzad,1922,priest,discipline,66,30,36
Фанпау,soulflayer,1919,priest,discipline,72,34,38
Kleot,ragnaros,1918,priest,discipline,90,46,44
Wetnpuffy,ravencrest,1916,priest,discipline,96,47,49
Dermaul,kazzak,1913,priest,discipline,42,24,18
Ävbmârsík,kazzak,1913,priest,discipline,89,50,39
Pheen,kazzak,1904,priest,discipline,108,55,53
Georgeshxx,ravencrest,1903,priest,discipline,95,50,45
Sfÿ,ysondre,1903,priest,discipline,60,28,32
Kangaroogodx,ravencrest,1901,priest,discipline,78,35,43
Dabalthazar,ravencrest,1900,priest,discipline,117,58,59
ßrb,sylvanas,1896,priest,discipline,126,75,51
Maxfly,archimonde,1894,priest,discipline,48,26,22
Sleepypriest,frostmane,1893,priest,discipline,30,20,10
Infamoussftw,drakthul,1892,priest,discipline,72,31,41
Rippertmepls,ravencrest,1891,priest,discipline,89,52,37
Ananous,hyjal,1891,priest,discipline,67,37,30
Разорлайтх,gordunni,1890,priest,discipline,29,21,8
Ronnyvandamm,destromath,1887,priest,discipline,88,58,30
Voxtwo,blackrock,1887,priest,discipline,42,26,16
Clapped,ravencrest,1887,priest,discipline,72,32,40
Nêxt,ravencrest,1884,priest,discipline,60,42,18
Asdfghqwezxc,twisting-nether,1884,priest,discipline,53,30,23
Spaanseslof,silvermoon,1884,priest,discipline,78,39,39
Norganp,die-aldor,1881,priest,discipline,50,31,19
Voideffsucks,stormscale,1881,priest,discipline,60,32,28
Mavisqt,draenor,1880,priest,discipline,42,24,18
Merylle,ragnaros,1880,priest,discipline,60,29,31
Ziknait,sargeras,1879,priest,discipline,48,29,19
Мамкалол,soulflayer,1873,priest,discipline,144,75,69
Elethia,blackmoore,1872,priest,discipline,38,21,17
Discishârd,ravencrest,1871,priest,discipline,99,50,49
Egî,azshara,1870,priest,discipline,42,20,22
Saniqt,kazzak,1865,priest,discipline,57,35,22
Mswagner,outland,1864,priest,discipline,36,20,16
Painchampion,draenor,1864,priest,discipline,54,23,31
Gerryqt,draenor,1863,priest,discipline,48,26,22
Asyncx,ravencrest,1862,priest,discipline,68,35,33
Flao,ravencrest,1860,priest,discipline,52,28,24
Thalanas,ravencrest,1859,priest,discipline,158,90,68
Sublab,kazzak,1859,priest,discipline,60,33,27
Citadelle,blackmoore,1858,priest,discipline,59,36,23
Мефодийприст,howling-fjord,1858,priest,discipline,102,62,40
Wernou,archimonde,1858,priest,discipline,48,29,19
Bigextendo,blackmoore,1857,priest,discipline,66,35,31
Unfaithful,twisting-nether,1854,priest,discipline,70,43,27
Rlyeh,argent-dawn,1854,priest,discipline,54,30,24
Dieterdose,tarren-mill,1852,priest,discipline,44,29,15
Lloreen,ravencrest,1852,priest,discipline,42,25,17
Swoptoplong,blackhand,1849,priest,discipline,302,167,135
Rynnegan,zuljin,1849,priest,discipline,72,31,41
Çhåosgòddess,kazzak,1848,priest,discipline,42,25,17
Oioiio,kazzak,1846,priest,discipline,72,33,39
Andrë,ragnaros,1845,priest,discipline,46,29,17
Asanti,die-aldor,1845,priest,discipline,54,33,21
Jagardoden,stormscale,1845,priest,discipline,59,33,26
Leahbtw,ravencrest,1844,priest,discipline,54,30,24
Soyloverjuan,auchindoun,1843,priest,discipline,52,27,25
Bæsts,ravencrest,1842,priest,discipline,47,35,12
Minilove,ravencrest,1842,priest,discipline,36,22,14
Ostrogami,silvermoon,1842,priest,discipline,232,112,120
Hamsicam,frostwolf,1842,priest,discipline,116,56,60
Kianprie,silvermoon,1842,priest,discipline,101,46,55
Concetto,nazjatar,1841,priest,discipline,36,21,15
Cdplz,archimonde,1841,priest,discipline,107,52,55
Mend,tarren-mill,1841,priest,discipline,77,34,43
Kàrèm,blutkessel,1839,priest,discipline,48,28,20
Shîn,zirkel-des-cenarius,1839,priest,discipline,72,32,40
Втильте,blackscar,1838,priest,discipline,138,77,61
Sheelah,ravencrest,1838,priest,discipline,66,32,34
Nasdaq,ravencrest,1837,priest,discipline,60,30,30
Azoran,dentarg,1836,priest,discipline,72,33,39
Nevercared,aegwynn,1835,priest,discipline,30,25,5
Shonsized,argent-dawn,1835,priest,discipline,142,82,60
Eliriya,thrall,1835,priest,discipline,126,64,62
Видзар,blackscar,1834,priest,discipline,42,27,15
Goldensp,sanguino,1834,priest,discipline,75,42,33
Azaciúx,sylvanas,1832,priest,discipline,48,29,19
Feeqamikka,ragnaros,1832,priest,discipline,61,32,29
Anheduanna,outland,1831,priest,discipline,225,118,107
Lyrvanax,ravencrest,1831,priest,discipline,163,73,90
Sazuki,sylvanas,1830,priest,discipline,119,71,48
Kaizza,burning-legion,1829,priest,discipline,48,30,18
Alusiepriest,ravencrest,1829,priest,discipline,164,102,62
Potatojuicer,argent-dawn,1829,priest,discipline,63,31,32
Mainputa,pozzo-delleternità,1829,priest,discipline,58,28,30
Akeno,sylvanas,1829,priest,discipline,70,31,39
Pradrak,eredar,1828,priest,discipline,54,31,23
Chivalryy,argent-dawn,1828,priest,discipline,119,64,55
Jconnelly,antonidas,1828,priest,discipline,62,32,30
Chasx,ravencrest,1828,priest,discipline,65,30,35
Ltmp,ravencrest,1827,priest,discipline,48,24,24
Nadøney,hyjal,1826,priest,discipline,172,87,85
Eau,quelthalas,1826,priest,discipline,64,30,34
Sinetrax,draenor,1825,priest,discipline,48,30,18
Sathie,ravencrest,1825,priest,discipline,60,29,31
Ayõu,ravencrest,1824,priest,discipline,60,36,24
Collinna,aegwynn,1824,priest,discipline,105,57,48
Sláin,outland,1824,priest,discipline,54,29,25
Lanata,blackrock,1823,priest,discipline,60,34,26
Мухаглот,soulflayer,1823,priest,discipline,71,37,34
Ihefyehvjrm,ravencrest,1823,priest,discipline,83,41,42
Mamaa,stormscale,1822,priest,discipline,72,40,32
Rickerstrike,stormscale,1822,priest,discipline,90,47,43
Tecc,draenor,1822,priest,discipline,130,65,65
Georgesheenx,ravencrest,1822,priest,discipline,124,58,66
Mèlindra,tarren-mill,1821,priest,discipline,35,28,7
Билет,borean-tundra,1821,priest,discipline,42,26,16
Aâraks,khaz-modan,1821,priest,discipline,134,82,52
Virulence,twisting-nether,1821,priest,discipline,193,108,85
Mommymilkrx,argent-dawn,1821,priest,discipline,239,124,115
Miklós,die-aldor,1821,priest,discipline,54,28,26
Racecar,executus,1821,priest,discipline,132,66,66
Прощайдуде,gordunni,1820,priest,discipline,47,26,21
Kripteksx,ravencrest,1819,priest,discipline,47,27,20
Дорогасмеха,howling-fjord,1819,priest,discipline,66,36,30
Vibéz,outland,1819,priest,discipline,54,27,27
Лёнятреппер,blackscar,1818,priest,discipline,93,53,40
Egi,lothar,1818,priest,discipline,51,27,24
Monsterzx,outland,1818,priest,discipline,90,44,46
Spiritina,darkmoon-faire,1817,priest,discipline,76,52,24
Свэпи,blackscar,1817,priest,discipline,47,27,20
Lakeworth,argent-dawn,1817,priest,discipline,104,48,56
Hanniri,archimonde,1816,priest,discipline,48,28,20
Aenon,argent-dawn,1816,priest,discipline,129,72,57
Thaeres,stormscale,1816,priest,discipline,65,31,34
Оченьнеочень,howling-fjord,1816,priest,discipline,72,33,39
Jowaba,ravencrest,1815,priest,discipline,60,38,22
Виллавелл,blackscar,1815,priest,discipline,48,24,24
Svakkanxd,kazzak,1815,priest,discipline,58,27,31
Zyzx,blackrock,1815,priest,discipline,66,29,37
Discusting,anachronos,1814,priest,discipline,66,34,32
Разрухаз,gordunni,1814,priest,discipline,59,30,29
Debeo,ragnaros,1812,priest,discipline,75,44,31
Elataqt,silvermoon,1812,priest,discipline,79,45,34
Eedazap,argent-dawn,1812,priest,discipline,58,32,26
ßlinkytwinky,outland,1812,priest,discipline,36,19,17
Discoqt,aegwynn,1812,priest,discipline,60,30,30
Isalvation,stormscale,1812,priest,discipline,78,38,40
Mïserygødx,nemesis,1811,priest,discipline,84,57,27
Maxmoto,blackrock,1811,priest,discipline,92,56,36
Yzïam,ravencrest,1811,priest,discipline,45,27,18
Cæsifer,blackrock,1811,priest,discipline,100,55,45
Leahuwu,ravencrest,1811,priest,discipline,72,37,35
Arthezz,ravencrest,1811,priest,discipline,80,40,40
Øxxgodx,blackrock,1810,priest,discipline,81,43,38
Wet,twisting-nether,1810,priest,discipline,66,29,37
Xrq,stormscale,1809,priest,discipline,36,27,9
Джагонх,soulflayer,1809,priest,discipline,60,31,29
Comedii,blackmoore,1809,priest,discipline,261,132,129
Kuxk,stormscale,1809,priest,discipline,48,24,24
Stola,archimonde,1809,priest,discipline,101,41,60
Xutira,silvermoon,1808,priest,discipline,195,109,86
Ohlinsqt,outland,1808,priest,discipline,66,36,30
Фастэксп,razuvious,1808,priest,discipline,60,31,29
Aprilfalls,blackmoore,1808,priest,discipline,54,25,29
Råcòøñ,ravencrest,1808,priest,discipline,42,19,23
Ÿolo,nemesis,1807,priest,discipline,80,47,33
Seasonf,tarren-mill,1807,priest,discipline,60,28,32
Izzý,antonidas,1806,priest,discipline,30,19,11
Zarahard,draenor,1806,priest,discipline,120,65,55
Zeruhphin,eredar,1806,priest,discipline,54,28,26
Brigittë,ravencrest,1806,priest,discipline,66,29,37
Mentalist,dun-modr,1806,priest,discipline,81,33,48
Светжрец,blackscar,1805,priest,discipline,36,26,10
Tattum,ragnaros,1805,priest,discipline,84,57,27
Pricemg,thrall,1805,priest,discipline,42,26,16
Поршкаенн,gordunni,1805,priest,discipline,60,32,28
Andaar,ravencrest,1805,priest,discipline,60,32,28
Шкурюклады,gordunni,1805,priest,discipline,60,27,33
Ïcön,ravencrest,1804,priest,discipline,60,43,17
Floyyd,kazzak,1804,priest,discipline,42,24,18
Chaxxpriest,blackrock,1804,priest,discipline,101,45,56
Gehrke,silvermoon,1803,priest,discipline,105,51,54
Галюхах,soulflayer,1802,priest,discipline,36,19,17
Bassepriest,tarren-mill,1802,priest,discipline,101,53,48
Cx,mazrigos,1801,priest,discipline,65,42,23
Shínx,illidan,1801,priest,discipline,90,52,38
Artístx,twisting-nether,1801,priest,discipline,53,29,24
Rngånxiety,ravencrest,1801,priest,discipline,60,28,32
Wardshield,ravencrest,1800,priest,discipline,29,20,9
Felwy,stormscale,1800,priest,discipline,48,31,17
Mautiya,blackrock,1800,priest,discipline,96,52,44
Соникида,gordunni,1800,priest,discipline,70,36,34
Lazyx,tarren-mill,1800,priest,discipline,59,29,30
Prsx,ravencrest,1798,priest,discipline,54,28,26
Remkoja,blackrock,1798,priest,discipline,84,43,41
Gaussqt,ravencrest,1797,priest,discipline,78,39,39
Nalakis,archimonde,1795,priest,discipline,103,58,45
Bigballer,stormscale,1795,priest,discipline,51,26,25
Legiondisc,blackmoore,1794,priest,discipline,151,69,82
Некронево,howling-fjord,1793,priest,discipline,45,27,18
Evpisces,archimonde,1792,priest,discipline,207,96,111
Tacochrist,kazzak,1789,priest,discipline,65,35,30
Hopesallgone,stormscale,1787,priest,discipline,96,58,38
Healseri,defias-brotherhood,1786,priest,discipline,102,50,52
Фенджидисплх,blackscar,1784,priest,discipline,66,30,36
Dreifearfünf,arygos,1778,priest,discipline,84,48,36
Scaryolol,blackmoore,1775,priest,discipline,71,36,35
Akzar,blackrock,1774,priest,discipline,255,138,117
Enteja,outland,1774,priest,discipline,281,143,138
Faderfarbror,tarren-mill,1773,priest,discipline,85,52,33
Scortie,blackrock,1771,priest,discipline,37,21,16
Roxeal,archimonde,1770,priest,discipline,174,100,74
Sekker,silvermoon,1770,priest,discipline,232,125,107
Src,ravencrest,1768,priest,discipline,48,29,19
Wóllo,stormscale,1767,priest,discipline,42,23,19
Sdn,twisting-nether,1766,priest,discipline,54,28,26
Magetrainer,tarren-mill,1765,priest,discipline,60,42,18
Neffty,aegwynn,1764,priest,discipline,96,46,50
Aruna,ravencrest,1761,priest,discipline,70,35,35
Fitu,drakthul,1760,priest,discipline,59,30,29
Нед,greymane,1759,priest,discipline,207,119,88
Ironqt,malfurion,1758,priest,discipline,112,48,64
Aòo,twisting-nether,1756,priest,discipline,60,29,31
Slimcharles,ravencrest,1755,priest,discipline,155,89,66
Gaalonikus,blackmoore,1754,priest,discipline,44,26,18
Merylle,outland,1751,priest,discipline,41,27,14
Kimspriest,ragnaros,1751,priest,discipline,36,19,17
Уровеньб,soulflayer,1750,priest,discipline,42,22,20
Nooxid,eredar,1746,priest,discipline,130,70,60
Devoura,sylvanas,1746,priest,discipline,48,23,25
Mystz,dun-modr,1744,priest,discipline,63,34,29
Wangewover,ravencrest,1744,priest,discipline,87,46,41
Artle,dun-modr,1741,priest,discipline,24,20,4
Alwaysøøm,kazzak,1741,priest,discipline,96,62,34
Maulerion,tarren-mill,1740,priest,discipline,66,36,30
Folelli,ysondre,1740,priest,discipline,96,50,46
Xeldrania,azshara,1739,priest,discipline,41,22,19
Justyø,archimonde,1738,priest,discipline,148,88,60
Xzep,archimonde,1736,priest,discipline,133,69,64
Фокусшвд,soulflayer,1735,priest,discipline,132,68,64
Kuusistöö,kazzak,1733,priest,discipline,54,28,26
Drillin,ravencrest,1731,priest,discipline,42,19,23
Doublefreak,draenor,1730,priest,discipline,48,31,17
Fandac,sylvanas,1730,priest,discipline,48,29,19
Смотривнебоь,soulflayer,1730,priest,discipline,63,32,31
Snuskong,kazzak,1730,priest,discipline,54,25,29
Emryth,blackhand,1729,priest,discipline,234,118,116
Denunciation,argent-dawn,1727,priest,discipline,191,101,90
Nocdsusage,draenor,1727,priest,discipline,138,71,67
Swdjack,blackrock,1727,priest,discipline,144,73,71
Prips,bladefist,1725,priest,discipline,213,108,105
Hoses,twisting-nether,1725,priest,discipline,70,35,35
Holymoly,talnivarr,1725,priest,discipline,84,37,47
Twinkerz,ravencrest,1724,priest,discipline,72,44,28
Простосори,gordunni,1723,priest,discipline,284,144,140
Justdänce,hyjal,1723,priest,discipline,46,23,23
Holyshiiet,stormscale,1722,priest,discipline,57,36,21
Файкахохо,soulflayer,1722,priest,discipline,53,23,30
Healêl,sanguino,1721,priest,discipline,54,26,28
Лизагодх,howling-fjord,1720,priest,discipline,54,30,24
Schlämpie,blackmoore,1720,priest,discipline,49,25,24
Smilézz,eredar,1720,priest,discipline,66,32,34
Kedrack,draenor,1719,priest,discipline,42,27,15
Leffie,outland,1719,priest,discipline,51,26,25
Eukmassus,archimonde,1719,priest,discipline,58,29,29
Mndvx,sylvanas,1718,priest,discipline,60,29,31
Kàalyx,archimonde,1718,priest,discipline,66,31,35
Deadandugly,eredar,1718,priest,discipline,48,19,29
Chèéks,kazzak,1717,priest,discipline,60,40,20
Psjk,blackrock,1717,priest,discipline,41,22,19
Smiteyoudown,blackrock,1716,priest,discipline,42,21,21
Cylantharia,eredar,1715,priest,discipline,96,54,42
Berseenreikä,the-venture-co,1715,priest,discipline,48,24,24
Артжрец,soulflayer,1713,priest,discipline,76,43,33
Mitha,tarren-mill,1713,priest,discipline,74,41,33
Ingelosi,eredar,1713,priest,discipline,106,56,50
Abudhabi,blackhand,1713,priest,discipline,264,136,128
Xghj,sylvanas,1711,priest,discipline,42,24,18
Abømination,hyjal,1709,priest,discipline,69,42,27
Анстахоуп,grom,1708,priest,discipline,120,80,40
Kijhun,uldaman,1707,priest,discipline,72,40,32
Mafakor,ravencrest,1707,priest,discipline,78,34,44
Yukasa,silvermoon,1705,priest,discipline,78,34,44
Ashenflexj,draenor,1704,priest,discipline,83,39,44
Ðês,ravencrest,1703,priest,discipline,30,18,12
Убикрофт,soulflayer,1703,priest,discipline,49,24,25
Grouptherpst,draenor,1703,priest,discipline,142,66,76
Touchmypink,ragnaros,1703,priest,discipline,66,27,39
Stazqt,conseil-des-ombres,1702,priest,discipline,112,55,57
Blazingad,kazzak,1702,priest,discipline,77,37,40
Scarletstory,ravencrest,1702,priest,discipline,90,41,49
Znàdix,silvermoon,1701,priest,discipline,170,89,81
Gurgaue,argent-dawn,1701,priest,discipline,53,24,29
Elsieexø,ravencrest,1700,priest,discipline,48,21,27
Lorimac,dun-modr,1699,priest,discipline,111,55,56
Ampara,thrall,1698,priest,discipline,72,35,37
Areyqt,ravencrest,1697,priest,discipline,36,22,14
Gòldfinger,norgannon,1697,priest,discipline,162,76,86
Døppëlápfèl,tarren-mill,1696,priest,discipline,30,20,10
Cptisus,draenor,1696,priest,discipline,72,31,41
Swdommeil,aegwynn,1695,priest,discipline,48,24,24
Alicewhydel,blackhand,1694,priest,discipline,36,18,18
Flào,draenor,1694,priest,discipline,42,20,22
Elsuzette,hyjal,1692,priest,discipline,34,21,13
Verweven,twisting-nether,1692,priest,discipline,47,26,21
Scurrp,aegwynn,1692,priest,discipline,60,31,29
Samaya,blackrock,1691,priest,discipline,92,41,51
Rhauru,tyrande,1690,priest,discipline,48,20,28
Шестьнадцать,gordunni,1689,priest,discipline,107,60,47
Афганский,gordunni,1688,priest,discipline,46,24,22
Ssjfoxyo,sylvanas,1688,priest,discipline,50,21,29
Hrtbrxkn,ravencrest,1687,priest,discipline,64,39,25
Wérrýxs,kazzak,1687,priest,discipline,142,80,62
Pinipom,kazzak,1686,priest,discipline,26,19,7
Vänskap,kazzak,1684,priest,discipline,42,23,19
Awcute,kazzak,1684,priest,discipline,143,70,73
Verti,outland,1684,priest,discipline,48,20,28
Verjin,kazzak,1684,priest,discipline,78,29,49
Aelisendi,draenor,1683,priest,discipline,47,25,22
Deathgodx,archimonde,1683,priest,discipline,74,39,35
Roshmanoff,stormscale,1683,priest,discipline,36,18,18
Barackomana,blackrock,1683,priest,discipline,114,53,61
Hwren,auchindoun,1682,priest,discipline,90,41,49
Kevinsorbo,destromath,1681,priest,discipline,36,20,16
Lizka,kazzak,1681,priest,discipline,54,26,28
Donipriest,ravencrest,1680,priest,discipline,66,39,27
Ljusmor,silvermoon,1680,priest,discipline,57,33,24
Apuessii,dun-modr,1680,priest,discipline,53,24,29
Tricavla,frostmane,1679,priest,discipline,72,38,34
Eliverax,outland,1679,priest,discipline,62,30,32
Healdeal,stormscale,1679,priest,discipline,142,65,77
Gothicpriest,blackrock,1678,priest,discipline,30,21,9
Mohammedx,tarren-mill,1678,priest,discipline,42,19,23
Sutenör,kazzak,1678,priest,discipline,108,43,65
Nihpolz,ragnaros,1677,priest,discipline,39,24,15
Savagex,dun-modr,1677,priest,discipline,72,40,32
Шайтсунг,soulflayer,1677,priest,discipline,56,30,26
Krystynal,archimonde,1676,priest,discipline,41,22,19
Clownspec,twisting-nether,1676,priest,discipline,54,26,28
Mindx,sylvanas,1676,priest,discipline,72,33,39
Диспайзх,gordunni,1674,priest,discipline,90,43,47
Scarified,aggramar,1673,priest,discipline,48,23,25
Ladderpolice,blackmoore,1672,priest,discipline,42,22,20
Свдпро,soulflayer,1672,priest,discipline,35,18,17
Horrðr,kazzak,1671,priest,discipline,42,28,14
Byef,kazzak,1671,priest,discipline,56,31,25
Utrd,kazzak,1671,priest,discipline,120,54,66
Zaak,kazzak,1670,priest,discipline,59,26,33
Walkmydome,twisting-nether,1669,priest,discipline,114,59,55
Lobbygriefer,ravencrest,1668,priest,discipline,143,76,67
Андерприст,soulflayer,1668,priest,discipline,83,40,43
Lindvorm,tarren-mill,1667,priest,discipline,120,61,59
Iwariel,blackmoore,1666,priest,discipline,42,23,19
Loví,twisting-nether,1666,priest,discipline,48,22,26
Yunusgødx,kazzak,1665,priest,discipline,48,32,16
Bambus,shattered-hand,1665,priest,discipline,36,23,13
Kèvin,das-syndikat,1665,priest,discipline,65,38,27
Worldgamer,blackrock,1664,priest,discipline,84,43,41
Duelistfied,blackrock,1664,priest,discipline,39,19,20
Gepeitschter,frostwolf,1662,priest,discipline,102,56,46
Sikaanyo,blackhand,1662,priest,discipline,66,35,31
Cätälin,twisting-nether,1662,priest,discipline,181,88,93
Kaksel,blackrock,1661,priest,discipline,72,38,34
Сонясоукьют,gordunni,1660,priest,discipline,36,20,16
Owrly,bladefist,1660,priest,discipline,119,53,66
Nzothapostle,baelgun,1659,priest,discipline,90,41,49
Аскеронх,howling-fjord,1659,priest,discipline,48,21,27
Mautijr,blackrock,1658,priest,discipline,172,99,73
Seranà,hyjal,1658,priest,discipline,96,51,45
Xangha,burning-legion,1658,priest,discipline,228,117,111
Dispelgodxx,eredar,1658,priest,discipline,54,25,29
Ew,shattered-halls,1658,priest,discipline,58,26,32
Salvatíon,sanguino,1658,priest,discipline,212,92,120
Trashedd,outland,1658,priest,discipline,54,22,32
Nyxoqtxd,ravencrest,1657,priest,discipline,76,43,33
Kaleycuoco,blackrock,1656,priest,discipline,78,36,42
Эвэргарден,eversong,1655,priest,discipline,54,20,34
Veltrag,sanguino,1654,priest,discipline,42,29,13
Yënâs,hyjal,1654,priest,discipline,91,57,34
Hellhammer,stormreaver,1654,priest,discipline,102,50,52
Èightsix,draenor,1653,priest,discipline,101,59,42
Йефа,gordunni,1653,priest,discipline,42,23,19
Efeslol,dun-modr,1653,priest,discipline,96,48,48
Mopriest,eredar,1652,priest,discipline,36,24,12
Illuminarexo,sylvanas,1651,priest,discipline,65,34,31
Qhub,sylvanas,1650,priest,discipline,90,47,43
Yugemilkers,kazzak,1650,priest,discipline,74,37,37
Dendegodx,kazzak,1650,priest,discipline,48,24,24
Arlekin,ravencrest,1649,priest,discipline,72,47,25
Mnu,blackrock,1649,priest,discipline,46,28,18
Zoophobîa,stormscale,1649,priest,discipline,42,22,20
Violentha,kazzak,1649,priest,discipline,96,50,46
Элишана,deathguard,1649,priest,discipline,111,54,57
Naphell,outland,1647,priest,discipline,72,34,38
Sills,twisting-nether,1647,priest,discipline,53,23,30
Géèk,alakir,1646,priest,discipline,46,27,19
Вашачесть,gordunni,1646,priest,discipline,60,30,30
Watchmedark,ravencrest,1646,priest,discipline,42,21,21
Cathocrasty,draenor,1644,priest,discipline,69,40,29
Rmt,darksorrow,1644,priest,discipline,42,23,19
Mønsterx,kazzak,1643,priest,discipline,58,35,23
Scodây,blackmoore,1643,priest,discipline,128,68,60
Репабликуес,gordunni,1641,priest,discipline,36,18,18
Duqes,stormreaver,1640,priest,discipline,24,19,5
Xtracheesy,ragnaros,1640,priest,discipline,72,45,27
Priewyn,ragnaros,1640,priest,discipline,114,61,53
Imsaltyxd,tarren-mill,1639,priest,discipline,36,22,14
Шаастраха,gordunni,1639,priest,discipline,50,22,28
Киллус,ashenvale,1639,priest,discipline,54,23,31
Mantra,blackmoore,1638,priest,discipline,42,23,19
Felaenna,argent-dawn,1638,priest,discipline,88,43,45
Deepsea,kazzak,1638,priest,discipline,173,82,91
Matwucss,outland,1637,priest,discipline,36,24,12
Vorynax,silvermoon,1637,priest,discipline,56,31,25
Miikkap,blackhand,1637,priest,discipline,48,26,22
Bercxu,ragnaros,1637,priest,discipline,69,37,32
Mentaldeadp,draenor,1636,priest,discipline,82,50,32
Marôs,antonidas,1636,priest,discipline,54,23,31
Devotedape,draenor,1635,priest,discipline,47,26,21
Yugata,archimonde,1635,priest,discipline,45,19,26
Amtoxic,stormscale,1634,priest,discipline,311,155,156
Wasnezov,blackhand,1634,priest,discipline,70,32,38
Аэтпио,soulflayer,1633,priest,discipline,54,23,31
Yameru,stormreaver,1633,priest,discipline,60,22,38
Misántropo,dun-modr,1632,priest,discipline,59,38,21
Keyfear,kazzak,1632,priest,discipline,63,36,27
Mythrixia,draenor,1632,priest,discipline,52,29,23
Sakulus,malganis,1632,priest,discipline,42,21,21
Ahpøual,archimonde,1632,priest,discipline,168,82,86
Kollis,twilights-hammer,1632,priest,discipline,87,42,45
Ankus,tarren-mill,1631,priest,discipline,48,23,25
Zloyvrach,ravencrest,1630,priest,discipline,54,25,29
Botstyleswdx,ravencrest,1630,priest,discipline,112,51,61
Fricia,zuljin,1629,priest,discipline,53,32,21
Inoru,stormreaver,1629,priest,discipline,78,41,37
Acidrops,hyjal,1629,priest,discipline,48,22,26
Ödriaell,the-venture-co,1629,priest,discipline,48,21,27
Såra,ravencrest,1628,priest,discipline,36,18,18
Leviakerman,blackrock,1628,priest,discipline,42,18,24
Sølvfox,stormscale,1627,priest,discipline,42,25,17
Aleluia,alonsus,1627,priest,discipline,99,43,56
Élsias,blackmoore,1626,priest,discipline,42,21,21
Spìrít,ghostlands,1626,priest,discipline,42,20,22
Eestpr,tarren-mill,1626,priest,discipline,45,20,25
Pestmorran,sylvanas,1626,priest,discipline,150,66,84
Discxqt,ysondre,1625,priest,discipline,83,51,32
Pepeflex,draenor,1625,priest,discipline,79,38,41
Bijaqt,blackmoore,1625,priest,discipline,42,17,25
Demora,ysondre,1624,priest,discipline,24,17,7
Krottus,antonidas,1624,priest,discipline,30,18,12
Garsdal,tarren-mill,1624,priest,discipline,78,43,35
Пристижнаяя,gordunni,1624,priest,discipline,50,25,25
Echonic,aegwynn,1624,priest,discipline,111,51,60
Rezzurrectum,doomhammer,1623,priest,discipline,36,20,16
Мплехибои,gordunni,1622,priest,discipline,54,30,24
Zinzor,archimonde,1621,priest,discipline,61,37,24
Líluqt,sanguino,1621,priest,discipline,30,17,13
Babybelle,arakarahm,1621,priest,discipline,61,33,28
Carnegi,burning-legion,1621,priest,discipline,54,28,26
Mindfiend,stormscale,1621,priest,discipline,81,37,44
Tÿona,hyjal,1620,priest,discipline,111,64,47
Bizqit,tarren-mill,1620,priest,discipline,107,57,50
Ðæððÿsgïrl,ravencrest,1620,priest,discipline,108,56,52
Outtloor,twisting-nether,1619,priest,discipline,39,25,14
Glyss,draenor,1619,priest,discipline,36,23,13
Aêalama,argent-dawn,1619,priest,discipline,36,17,19
Mobcal,twisting-nether,1618,priest,discipline,42,17,25
Edoran,ragnaros,1617,priest,discipline,66,39,27
Uivi,azjolnerub,1617,priest,discipline,30,17,13
Некрогуро,gordunni,1617,priest,discipline,36,17,19
Isweariheal,twisting-nether,1616,priest,discipline,58,37,21
Cinri,argent-dawn,1616,priest,discipline,175,87,88
Eagrh,ravencrest,1615,priest,discipline,84,56,28
Gehrketwo,silvermoon,1615,priest,discipline,36,21,15
Troedelsuppe,destromath,1615,priest,discipline,144,61,83
Assacine,aegwynn,1614,priest,discipline,42,23,19
Wonderdispel,ragnaros,1614,priest,discipline,48,21,27
Jeanprêtre,ysondre,1614,priest,discipline,48,20,28
Burningheatx,kazzak,1612,priest,discipline,65,44,21
Southyz,stormscale,1611,priest,discipline,75,44,31
Shadowboness,twisting-nether,1611,priest,discipline,58,31,27
Rezzdar,lightnings-blade,1611,priest,discipline,36,17,19
Blazekk,sylvanas,1611,priest,discipline,66,29,37
Lolylights,tarren-mill,1611,priest,discipline,48,20,28
Viu,eredar,1610,priest,discipline,51,22,29
Zychopriest,antonidas,1610,priest,discipline,42,17,25
Holyshiz,stormrage,1609,priest,discipline,42,24,18
Darkshdwbrst,malorne,1608,priest,discipline,63,39,24
Toba,hellscream,1608,priest,discipline,101,60,41
Beabanane,aegwynn,1608,priest,discipline,50,24,26
Fakecats,sargeras,1608,priest,discipline,51,22,29
Felvytwo,stormscale,1607,priest,discipline,36,17,19
Altruistx,ravencrest,1607,priest,discipline,36,17,19
Vigodis,alleria,1604,priest,discipline,73,44,29
Rabbai,twisting-nether,1604,priest,discipline,42,21,21
Kolinamenuss,dun-morogh,1604,priest,discipline,48,21,27
Tabaç,stormscale,1603,priest,discipline,36,21,15
Хилботгодикс,borean-tundra,1602,priest,discipline,42,32,10
Антошашвп,gordunni,1602,priest,discipline,36,19,17
Lahammy,kazzak,1601,priest,discipline,50,30,20
Мастди,ashenvale,1601,priest,discipline,41,20,21
Xîz,silvermoon,1601,priest,discipline,66,32,34
Enzysama,sanguino,1601,priest,discipline,48,21,27
Lgbtgodx,archimonde,1600,priest,discipline,61,45,16
Dêrbómbêr,guldan,1600,priest,discipline,54,30,24
Interrupted,kazzak,1600,priest,discipline,66,30,36
Noviriel,argent-dawn,1600,priest,discipline,47,19,28
Alexpriest,twisting-nether,1598,priest,discipline,139,72,67
Vregoa,twisting-nether,1596,priest,discipline,54,32,22
Sebikpri,ravencrest,1596,priest,discipline,60,34,26
Баблби,soulflayer,1596,priest,discipline,169,73,96
Aédeira,blackhand,1596,priest,discipline,47,20,27
Alèxy,tarren-mill,1596,priest,discipline,48,19,29
Badorange,kazzak,1592,priest,discipline,59,29,30
Senpumara,malganis,1590,priest,discipline,240,124,116
Effectx,stormscale,1590,priest,discipline,66,33,33
Parzivál,argent-dawn,1589,priest,discipline,71,30,41
Athelsta,alleria,1588,priest,discipline,63,33,30
Mcdced,archimonde,1587,priest,discipline,78,38,40
Cptatonement,draenor,1586,priest,discipline,36,21,15
Sosabgd,azjolnerub,1585,priest,discipline,30,17,13
Sahorie,archimonde,1584,priest,discipline,135,79,56
Copperpriest,draenor,1584,priest,discipline,68,35,33
Skynoxx,ragnaros,1584,priest,discipline,114,56,58
Vanillå,silvermoon,1584,priest,discipline,58,28,30
Enoriya,blackrock,1583,priest,discipline,212,119,93
Èzì,burning-legion,1583,priest,discipline,36,18,18
Gravebrain,draenor,1581,priest,discipline,130,62,68
Jhaazx,nemesis,1580,priest,discipline,143,76,67
Fuzzymerge,ravencrest,1579,priest,discipline,30,19,11
Averagenoob,ragnaros,1578,priest,discipline,54,25,29
Kaldhor,ysondre,1578,priest,discipline,41,17,24
Akemmì,sylvanas,1577,priest,discipline,42,25,17
Maccz,hyjal,1577,priest,discipline,68,32,36
Соулвардинг,soulflayer,1577,priest,discipline,42,18,24
Shadowfishey,grim-batol,1577,priest,discipline,42,17,25
Twosugars,sylvanas,1576,priest,discipline,84,44,40
Tuitio,blackmoore,1576,priest,discipline,65,34,31
Флафика,deathguard,1575,priest,discipline,72,42,30
Chamelthoe,the-maelstrom,1575,priest,discipline,96,47,49
Bennyjamin,kazzak,1574,priest,discipline,38,22,16
Xaey,ravencrest,1574,priest,discipline,30,17,13
Мэдсанван,howling-fjord,1573,priest,discipline,60,37,23
Надийя,gordunni,1573,priest,discipline,102,60,42
Aia,tyrande,1573,priest,discipline,82,38,44
Babywayn,onyxia,1572,priest,discipline,87,48,39
Ðarkan,kaelthas,1572,priest,discipline,102,55,47
Syntara,twisting-nether,1572,priest,discipline,163,87,76
Nyarlatothep,boulderfist,1572,priest,discipline,148,77,71
Fazzy,nagrand,1571,priest,discipline,64,33,31
Hèmera,tichondrius,1568,priest,discipline,55,41,14
Alicanx,twisting-nether,1568,priest,discipline,57,23,34
Chuckline,eredar,1566,priest,discipline,36,20,16
Аая,blackscar,1566,priest,discipline,66,31,35
Denyz,blackrock,1566,priest,discipline,54,21,33
Могулас,soulflayer,1565,priest,discipline,173,89,84
Yøløswagg,silvermoon,1564,priest,discipline,48,21,27
Rasha,kazzak,1563,priest,discipline,69,41,28
Unfaker,drakthul,1562,priest,discipline,36,23,13
Hamati,blackhand,1562,priest,discipline,84,47,37
Рвотка,gordunni,1559,priest,discipline,124,68,56
Gød,magtheridon,1559,priest,discipline,48,20,28
Нз,soulflayer,1558,priest,discipline,41,19,22
Raawri,blackmoore,1557,priest,discipline,54,24,30
Tansk,stormscale,1556,priest,discipline,96,57,39
Tamy,draenor,1556,priest,discipline,62,33,29
Lyrina,twisting-nether,1556,priest,discipline,268,142,126
Tritíana,blackrock,1555,priest,discipline,111,68,43
Wencis,kazzak,1555,priest,discipline,54,25,29
Vhim,hyjal,1555,priest,discipline,52,24,28
Holyasprin,sylvanas,1554,priest,discipline,42,21,21
Frednshield,tarren-mill,1554,priest,discipline,69,34,35
Khâléd,kazzak,1553,priest,discipline,36,17,19
Juggster,bloodhoof,1552,priest,discipline,168,88,80
Blackbox,burning-legion,1552,priest,discipline,113,54,59
Cresellia,twisting-nether,1552,priest,discipline,170,81,89
Люблюкофе,deathguard,1552,priest,discipline,47,22,25
Blindmymind,malganis,1551,priest,discipline,53,26,27
Strawhât,eredar,1550,priest,discipline,29,17,12
Korzec,dun-modr,1550,priest,discipline,108,57,51
Jandice,blackrock,1550,priest,discipline,36,18,18
Exoduz,stormscale,1550,priest,discipline,117,58,59
Acrio,die-ewige-wacht,1550,priest,discipline,54,26,28
Bandulskii,twisting-nether,1550,priest,discipline,163,75,88
Xaerah,blackmoore,1549,priest,discipline,78,41,37
Darkprofit,aegwynn,1549,priest,discipline,60,30,30
Yûnalescá,blackmoore,1549,priest,discipline,60,30,30
Arkkinunna,outland,1549,priest,discipline,124,59,65
Sonics,antonidas,1548,priest,discipline,66,31,35
Elämäntypy,stormscale,1547,priest,discipline,54,28,26
Bubbelchên,blackhand,1547,priest,discipline,66,28,38
Mtbalt,tarren-mill,1546,priest,discipline,96,59,37
Systerstål,twisting-nether,1546,priest,discipline,78,45,33
Thedisco,kazzak,1545,priest,discipline,24,17,7
Alphabreyf,tarren-mill,1545,priest,discipline,83,43,40
Holycrapx,chromaggus,1545,priest,discipline,62,32,30
Lishado,twisting-nether,1545,priest,discipline,90,45,45
Nevor,nemesis,1545,priest,discipline,70,30,40
Diszi,norgannon,1544,priest,discipline,58,28,30
Ipâ,hyjal,1544,priest,discipline,55,18,37
Uo,kilrogg,1543,priest,discipline,48,25,23
Skevitche,hyjal,1543,priest,discipline,102,48,54
Enimao,tarren-mill,1542,priest,discipline,37,20,17
Alz,rashgarroth,1542,priest,discipline,110,55,55
Alesthion,silvermoon,1540,priest,discipline,62,33,29
Whiskie,twisting-nether,1540,priest,discipline,60,30,30
Liviúss,draenor,1540,priest,discipline,42,20,22
Voidsnitch,antonidas,1540,priest,discipline,66,30,36
Cizer,kazzak,1540,priest,discipline,65,29,36
Tøxicboy,ravencrest,1539,priest,discipline,66,32,34
Grautesk,chogall,1539,priest,discipline,48,23,25
Fatishcribe,twisting-nether,1538,priest,discipline,84,48,36
Foobi,the-maelstrom,1538,priest,discipline,219,120,99
Gûardianwisp,ravencrest,1538,priest,discipline,64,33,31
Burnex,thrall,1537,priest,discipline,54,26,28
Hâlez,antonidas,1536,priest,discipline,290,148,142
Shalvy,aegwynn,1536,priest,discipline,98,50,48
Ёджих,blackscar,1535,priest,discipline,61,32,29
Goblex,hyjal,1535,priest,discipline,63,28,35
Jtî,ravencrest,1534,priest,discipline,24,16,8
Разрухаовнз,gordunni,1534,priest,discipline,24,16,8
Майндоф,howling-fjord,1534,priest,discipline,60,34,26
Lunatique,shadowsong,1534,priest,discipline,32,16,16
Ptsd,argent-dawn,1533,priest,discipline,60,26,34
Pshan,blackmoore,1532,priest,discipline,158,77,81
Nooway,kazzak,1532,priest,discipline,66,30,36
Фыбра,soulflayer,1531,priest,discipline,30,16,14
Wiildsy,tarren-mill,1531,priest,discipline,53,24,29
Амбракадабра,blackscar,1530,priest,discipline,36,26,10
Avengëd,nagrand,1530,priest,discipline,34,18,16
Remkojatwo,blackrock,1529,priest,discipline,30,16,14
Mêmphìs,twisting-nether,1529,priest,discipline,65,29,36
Gulch,blackmoore,1528,priest,discipline,54,26,28
Джелесана,gordunni,1528,priest,discipline,69,31,38
Limeslayerx,veklor,1527,priest,discipline,30,17,13
Verminous,ravencrest,1527,priest,discipline,38,20,18
Dêxter,hyjal,1527,priest,discipline,102,51,51
Valnor,pozzo-delleternità,1527,priest,discipline,54,25,29
Místerbiceps,outland,1527,priest,discipline,36,16,20
Пальтишко,howling-fjord,1527,priest,discipline,60,26,34
Фейкай,blackscar,1526,priest,discipline,48,28,20
Cnqz,archimonde,1526,priest,discipline,36,16,20
Deathchicka,draenor,1524,priest,discipline,40,30,10
Xoxogg,burning-blade,1524,priest,discipline,84,53,31
Whýççpèrx,ravencrest,1524,priest,discipline,30,16,14
Darudo,kazzak,1524,priest,discipline,66,31,35
Bockx,ragnaros,1524,priest,discipline,42,16,26
Виспх,eversong,1523,priest,discipline,269,120,149
Lythi,eredar,1522,priest,discipline,118,52,66
Drxz,twilights-hammer,1520,priest,discipline,46,24,22
Mamis,anetheron,1520,priest,discipline,48,22,26
Cbsad,madmortem,1518,priest,discipline,78,45,33
Poonies,silvermoon,1518,priest,discipline,82,38,44
Laxímink,sylvanas,1518,priest,discipline,65,26,39
Ssol,tarren-mill,1517,priest,discipline,49,29,20
Менестрели,gordunni,1516,priest,discipline,94,60,34
Влажныйшп,soulflayer,1516,priest,discipline,36,20,16
Shyria,argent-dawn,1515,priest,discipline,53,25,28
Aestina,silvermoon,1514,priest,discipline,102,49,53
Raesd,argent-dawn,1513,priest,discipline,58,30,28
Kuqezi,archimonde,1513,priest,discipline,42,21,21
Erupyks,archimonde,1512,priest,discipline,36,18,18
Enigam,alakir,1511,priest,discipline,48,29,19
Virdeo,aegwynn,1511,priest,discipline,30,16,14
Ohbenji,ravencrest,1510,priest,discipline,68,32,36
Prästpojken,frostwhisper,1509,priest,discipline,60,27,33
Milania,ravencrest,1508,priest,discipline,30,16,14
Tinpr,sanguino,1507,priest,discipline,105,48,57
Zealtron,darksorrow,1507,priest,discipline,47,19,28
Tylér,stormscale,1506,priest,discipline,30,17,13
Lïnkz,kazzak,1506,priest,discipline,48,26,22
Эйвиг,blackscar,1505,priest,discipline,54,26,28
Mortarz,ragnaros,1505,priest,discipline,71,31,40
Dench,azjolnerub,1505,priest,discipline,60,25,35
Shadowbread,tarren-mill,1504,priest,discipline,30,16,14
Chôrdi,aegwynn,1504,priest,discipline,42,19,23
Lethalhealz,outland,1503,priest,discipline,149,75,74
Huffinctus,tarren-mill,1502,priest,discipline,94,49,45
Rizzlerx,blackmoore,1501,priest,discipline,48,28,20
Cryksî,eredar,1501,priest,discipline,51,27,24
Shînnøk,silvermoon,1501,priest,discipline,84,42,42
Dreythan,stormrage,1501,priest,discipline,50,19,31
Japral,blackhand,1500,priest,discipline,24,16,8
Мьюсх,deathguard,1500,priest,discipline,77,42,35
Kyseki,ravencrest,1500,priest,discipline,286,147,139
Dreamhatcher,deathwing,1500,priest,discipline,42,18,24
Ceraghk,tichondrius,1499,priest,discipline,46,28,18
Ilovedisc,kazzak,1499,priest,discipline,33,19,14
Amysantiàgo,sylvanas,1497,priest,discipline,47,26,21
Holineß,burning-blade,1496,priest,discipline,54,33,21
Menda,eredar,1496,priest,discipline,112,63,49
Spoggle,kazzak,1496,priest,discipline,30,16,14
Kæyc,blackmoore,1496,priest,discipline,59,31,28
Dyliz,stormscale,1496,priest,discipline,81,40,41
Nurbanu,ravencrest,1495,priest,discipline,59,39,20
Sheshan,destromath,1494,priest,discipline,53,29,24
Hïstërïä,silvermoon,1494,priest,discipline,57,28,29
Olio,outland,1494,priest,discipline,76,35,41
Viagrà,outland,1493,priest,discipline,62,26,36
Grimdream,ragnaros,1491,priest,discipline,98,43,55
Themistia,kazzak,1491,priest,discipline,48,20,28
Minipõppy,ravencrest,1491,priest,discipline,60,21,39
Holysheett,magtheridon,1490,priest,discipline,48,28,20
Остроухх,howling-fjord,1490,priest,discipline,52,29,23
Holycrit,aszune,1490,priest,discipline,53,26,27
Targolina,argent-dawn,1490,priest,discipline,136,63,73
Nêlumar,aegwynn,1490,priest,discipline,48,21,27
Холишитс,gordunni,1489,priest,discipline,79,49,30
Ziv,grim-batol,1488,priest,discipline,74,46,28
Phreyst,draenor,1488,priest,discipline,56,34,22
Flaskandeux,tarren-mill,1488,priest,discipline,62,17,45
Orophar,antonidas,1487,priest,discipline,53,29,24
Pokahonta,silvermoon,1487,priest,discipline,183,90,93
Nomakprst,sanguino,1486,priest,discipline,130,63,67
Шатолюгран,soulflayer,1485,priest,discipline,46,32,14
Kåstå,archimonde,1485,priest,discipline,74,44,30
Lurri,tarren-mill,1485,priest,discipline,96,48,48
Feed,burning-legion,1484,priest,discipline,36,18,18
Klituriis,twisting-nether,1483,priest,discipline,77,41,36
Bindw,tarren-mill,1482,priest,discipline,35,16,19
Hannirï,archimonde,1481,priest,discipline,53,34,19
Jumperlawl,khaz-modan,1481,priest,discipline,48,26,22
Вилайф,galakrond,1479,priest,discipline,58,27,31
Aurosa,argent-dawn,1478,priest,discipline,73,34,39
Diddlefiddle,stormscale,1477,priest,discipline,58,35,23
Шарадин,gordunni,1477,priest,discipline,104,57,47
Saintpri,twisting-nether,1477,priest,discipline,66,35,31
Kdot,drakthul,1477,priest,discipline,48,23,25
Кошечка,deathguard,1477,priest,discipline,35,16,19
Kanî,eredar,1477,priest,discipline,60,27,33
Yonkerz,frostmane,1477,priest,discipline,72,27,45
Кэндимен,gordunni,1475,priest,discipline,70,42,28
Neoni,blackmoore,1475,priest,discipline,88,42,46
Chankilolx,dun-modr,1475,priest,discipline,163,76,87
Flurri,tarren-mill,1474,priest,discipline,108,59,49
Mzpriest,dalaran,1474,priest,discipline,76,41,35
Prezica,stormscale,1474,priest,discipline,137,72,65
Олегстразза,howling-fjord,1474,priest,discipline,93,44,49
Licktheheal,outland,1473,priest,discipline,30,17,13
Ðiscobiscuit,argent-dawn,1472,priest,discipline,92,50,42
Санггвиний,soulflayer,1472,priest,discipline,90,46,44
Aurunea,blackrock,1471,priest,discipline,36,24,12
Evõmax,sylvanas,1471,priest,discipline,107,57,50
Spirítbox,argent-dawn,1471,priest,discipline,84,44,40
Targoviste,archimonde,1470,priest,discipline,199,107,92
Шпангл,gordunni,1470,priest,discipline,54,25,29
Battra,argent-dawn,1468,priest,discipline,78,41,37
Трэй,deathguard,1467,priest,discipline,72,41,31
Brutapriestx,stormscale,1467,priest,discipline,35,16,19
Panoio,aggra-português,1466,priest,discipline,77,33,44
Yákizå,darksorrow,1466,priest,discipline,72,30,42
Krasawìtch,onyxia,1465,priest,discipline,66,28,38
Geierlol,blackrock,1464,priest,discipline,42,17,25
Ahmnesia,archimonde,1463,priest,discipline,111,57,54
Мненосина,goldrinn,1462,priest,discipline,46,21,25
Krayziest,tarren-mill,1461,priest,discipline,42,26,16
Lemontea,frostwolf,1461,priest,discipline,30,17,13
Scade,kazzak,1461,priest,discipline,92,44,48
Medipack,khaz-modan,1459,priest,discipline,30,20,10
Mewpew,azjolnerub,1459,priest,discipline,42,17,25
Daddyfinger,argent-dawn,1458,priest,discipline,97,56,41
Zedrus,azshara,1458,priest,discipline,87,42,45
Prost,aerie-peak,1457,priest,discipline,29,20,9
Dalylla,aggra-português,1457,priest,discipline,42,24,18
Avaichquirit,tarren-mill,1457,priest,discipline,36,17,19
Zoe,aegwynn,1456,priest,discipline,153,79,74
Dotdotggwp,stormscale,1456,priest,discipline,84,39,45
Anzil,dun-modr,1456,priest,discipline,60,27,33
Laonar,silvermoon,1454,priest,discipline,103,59,44
Dejica,kult-der-verdammten,1454,priest,discipline,72,33,39
Pàndoràh,nemesis,1453,priest,discipline,36,20,16
Cleancf,blackhand,1452,priest,discipline,42,17,25
Artì,kazzak,1449,priest,discipline,53,18,35
Kamiyasa,blackmoore,1448,priest,discipline,36,17,19
Vqny,archimonde,1446,priest,discipline,40,24,16
Gïanna,archimonde,1446,priest,discipline,54,30,24
Kâltak,aegwynn,1446,priest,discipline,48,24,24
Sáshagrey,arathor,1446,priest,discipline,49,24,25
Preachyjeg,ravencrest,1444,priest,discipline,78,30,48
Troublemaker,durotan,1443,priest,discipline,54,30,24
Sombralúz,sanguino,1442,priest,discipline,36,20,16
Shanny,kazzak,1442,priest,discipline,89,43,46
Laurent,sanguino,1441,priest,discipline,36,16,20
Хомие,soulflayer,1441,priest,discipline,54,22,32
Смегмачет,soulflayer,1440,priest,discipline,122,63,59
Sensor,kazzak,1440,priest,discipline,51,26,25
Sprutch,kazzak,1439,priest,discipline,50,28,22
Bedkara,ravencrest,1439,priest,discipline,30,15,15
Cáss,archimonde,1439,priest,discipline,30,15,15
Snutz,draenor,1437,priest,discipline,24,15,9
Mjamc,stormscale,1437,priest,discipline,78,33,45
Dzoo,kazzak,1436,priest,discipline,58,27,31
Makesnosense,kilrogg,1435,priest,discipline,48,22,26
Bubidiblumpr,twisting-nether,1433,priest,discipline,66,40,26
Selëne,blackrock,1433,priest,discipline,42,22,20
Tynsxd,silvermoon,1432,priest,discipline,54,30,24
Swera,twisting-nether,1431,priest,discipline,24,15,9
Jupiter,silvermoon,1431,priest,discipline,84,45,39
Littleheal,ghostlands,1430,priest,discipline,30,16,14
Karoopi,ysondre,1429,priest,discipline,77,38,39
Ivysaurus,ravencrest,1428,priest,discipline,54,31,23
Alinone,uldum,1428,priest,discipline,49,20,29
Hiereia,khadgar,1428,priest,discipline,42,17,25
Gbpjr,xavius,1427,priest,discipline,104,49,55
Discobrill,silvermoon,1427,priest,discipline,48,19,29
Amanojakü,ravencrest,1426,priest,discipline,48,34,14
Fatalx,grim-batol,1426,priest,discipline,34,16,18
Урголиафа,howling-fjord,1425,priest,discipline,54,25,29
Lukéy,silvermoon,1425,priest,discipline,42,17,25
Zymai,ravencrest,1424,priest,discipline,42,15,27
Nirsis,dun-modr,1423,priest,discipline,63,30,33
Zzbleh,stormscale,1422,priest,discipline,24,15,9
Nøheall,ysondre,1422,priest,discipline,42,17,25
Mixoo,throkferoth,1422,priest,discipline,48,15,33
Двелегитоп,howling-fjord,1421,priest,discipline,24,15,9
Vaewyn,ravencrest,1420,priest,discipline,42,26,16
Invexx,tarren-mill,1420,priest,discipline,84,34,50
Labadudala,aegwynn,1419,priest,discipline,18,15,3
Тэтэшник,ashenvale,1419,priest,discipline,42,21,21
Destinychild,norgannon,1419,priest,discipline,35,15,20
Cyberlunatic,antonidas,1419,priest,discipline,36,15,21
Подчинись,ashenvale,1418,priest,discipline,54,30,24
Нэстикус,gordunni,1418,priest,discipline,30,16,14
Мдзшка,gordunni,1418,priest,discipline,221,107,114
Гачибунта,blackscar,1417,priest,discipline,41,27,14
Soulreapper,blackhand,1417,priest,discipline,117,64,53
Блексебет,soulflayer,1417,priest,discipline,90,46,44
Légít,argent-dawn,1417,priest,discipline,42,15,27
Softie,zuljin,1416,priest,discipline,24,15,9
Øbz,sylvanas,1415,priest,discipline,42,15,27
Kaeldara,ysondre,1413,priest,discipline,24,15,9
Bolflo,khaz-modan,1413,priest,discipline,90,49,41
Convulsiveq,silvermoon,1413,priest,discipline,184,94,90
Oxborn,thrall,1413,priest,discipline,83,40,43
Ledania,aegwynn,1412,priest,discipline,24,15,9
Adev,drakthul,1412,priest,discipline,47,25,22
Eyllise,ragnaros,1411,priest,discipline,58,28,30
Joniop,stormreaver,1410,priest,discipline,60,29,31
Kaémon,twisting-nether,1410,priest,discipline,88,37,51
Getötet,blackrock,1409,priest,discipline,36,21,15
Dunderprälle,outland,1409,priest,discipline,30,15,15
Lévention,stormscale,1408,priest,discipline,36,20,16
Медиив,deepholm,1408,priest,discipline,60,29,31
Tarellia,argent-dawn,1407,priest,discipline,72,48,24
Gothixs,draenor,1406,priest,discipline,44,26,18
Garfriest,aggra-português,1406,priest,discipline,78,46,32
Marllen,twisting-nether,1406,priest,discipline,59,25,34
Putinkuilo,outland,1405,priest,discipline,42,21,21
Fantästic,kazzak,1404,priest,discipline,50,27,23
Dragovic,chogall,1404,priest,discipline,80,38,42
Naïlu,hyjal,1403,priest,discipline,54,33,21
Centaurio,nemesis,1403,priest,discipline,38,22,16
Benificent,argent-dawn,1403,priest,discipline,63,31,32
Carnacia,tarren-mill,1402,priest,discipline,42,27,15
Spiochpr,burning-legion,1402,priest,discipline,48,27,21
Kbakå,kazzak,1402,priest,discipline,32,15,17
Acidpills,hyjal,1402,priest,discipline,40,17,23
Virulent,nemesis,1402,priest,discipline,36,15,21
Dímension,ragnaros,1401,priest,discipline,62,37,25
Angelofdeàth,kazzak,1401,priest,discipline,72,40,32
Nerfnerf,kazzak,1400,priest,discipline,245,123,122
Вурти,howling-fjord,1400,priest,discipline,65,28,37
Overhealzz,blackmoore,1399,priest,discipline,60,30,30
Chibrausorus,archimonde,1399,priest,discipline,54,22,32
Laadyybirkee,blackhand,1398,priest,discipline,140,70,70
Алуриэлия,gordunni,1397,priest,discipline,71,31,40
Rahan,stormscale,1396,priest,discipline,93,46,47
Derylium,kazzak,1395,priest,discipline,47,29,18
Сашадвасм,gordunni,1394,priest,discipline,42,24,18
Alakkiria,ravencrest,1394,priest,discipline,77,38,39
Kroa,ragnaros,1393,priest,discipline,24,15,9
Rher,blackmoore,1392,priest,discipline,24,15,9
Phasmöphobia,zuljin,1392,priest,discipline,96,38,58
Zombîe,draenor,1390,priest,discipline,42,16,26
Discipleotl,stormscale,1388,priest,discipline,24,16,8
Praybro,blackmoore,1388,priest,discipline,24,16,8
Yoii,nemesis,1386,priest,discipline,22,16,6
Nakali,the-maelstrom,1386,priest,discipline,30,16,14
Дядяврач,howling-fjord,1386,priest,discipline,60,28,32
Pyropenance,twisting-nether,1386,priest,discipline,83,35,48
Brilho,frostmane,1386,priest,discipline,57,16,41
Arkkupiispa,stormreaver,1385,priest,discipline,94,43,51
Thrakoun,twilights-hammer,1383,priest,discipline,104,51,53
Alliora,dalaran,1382,priest,discipline,69,26,43
Animepfp,stormreaver,1381,priest,discipline,78,35,43
Onelovexx,thrall,1380,priest,discipline,36,15,21
Streety,nethersturm,1378,priest,discipline,90,43,47
Gangreana,kazzak,1377,priest,discipline,78,42,36
Verzeichnis,thrall,1376,priest,discipline,65,35,30
Dolifrius,dalaran,1375,priest,discipline,50,30,20
Annisa,kazzak,1374,priest,discipline,125,68,57
Psyfir,outland,1374,priest,discipline,224,117,107
Otheym,the-maelstrom,1374,priest,discipline,39,18,21
Arize,dun-modr,1373,priest,discipline,30,15,15
Blackheal,sanguino,1373,priest,discipline,68,29,39
Rabbît,stormscale,1372,priest,discipline,82,42,40
Geesuz,outland,1372,priest,discipline,39,16,23
Kutjeskopper,silvermoon,1371,priest,discipline,36,19,17
Drawun,burning-legion,1370,priest,discipline,42,25,17
Скизма,gordunni,1370,priest,discipline,42,25,17
Маимморта,howling-fjord,1368,priest,discipline,42,25,17
Pètunia,ravencrest,1368,priest,discipline,120,69,51
Elosen,darkspear,1368,priest,discipline,36,20,16
Salzgehalt,antonidas,1366,priest,discipline,58,38,20
Unholyfield,draenor,1365,priest,discipline,84,37,47
Jordí,darkspear,1364,priest,discipline,96,45,51
Valaç,turalyon,1362,priest,discipline,101,53,48
Sephìrøth,malganis,1361,priest,discipline,48,24,24
Aisha,rajaxx,1361,priest,discipline,69,32,37
Ræpriestx,ragnaros,1360,priest,discipline,75,36,39
Докторпэйн,howling-fjord,1360,priest,discipline,86,41,45
Sissi,blackmoore,1359,priest,discipline,52,29,23
Enduring,darksorrow,1359,priest,discipline,72,33,39
Kbakå,stormscale,1359,priest,discipline,60,22,38
Ahree,sargeras,1358,priest,discipline,76,36,40
Аквариусс,gordunni,1357,priest,discipline,36,22,14
Nestélle,drakthul,1357,priest,discipline,30,18,12
Priesless,sylvanas,1357,priest,discipline,34,20,14
Yvaini,xavius,1357,priest,discipline,30,16,14
Antainis,silvermoon,1357,priest,discipline,59,30,29
Лимоняшечка,soulflayer,1356,priest,discipline,92,48,44
Massbimba,tarren-mill,1356,priest,discipline,108,56,52
Hardcode,twisting-nether,1356,priest,discipline,32,16,16
Kratzîgel,blackmoore,1354,priest,discipline,90,47,43
Nésha,dun-modr,1354,priest,discipline,41,21,20
Íhðly,silvermoon,1353,priest,discipline,30,15,15
Byxoph,sanguino,1353,priest,discipline,66,32,34
Девственен,soulflayer,1353,priest,discipline,36,17,19
Solarïah,garona,1352,priest,discipline,32,19,13
Littlehelper,shendralar,1352,priest,discipline,39,16,23
Buszeekk,outland,1351,priest,discipline,28,18,10
Isore,culte-de-la-rive-noire,1351,priest,discipline,34,20,14
Feelmypainn,kazzak,1350,priest,discipline,42,23,19
Smilyface,sylvanas,1350,priest,discipline,47,20,27
Xypri,nordrassil,1350,priest,discipline,48,19,29
Devot,outland,1349,priest,discipline,52,31,21
Chowhone,archimonde,1349,priest,discipline,100,53,47
Инстенли,howling-fjord,1348,priest,discipline,36,17,19
Frekio,eitrigg,1348,priest,discipline,71,33,38
Dstars,archimonde,1348,priest,discipline,42,16,26
Maidie,stormscale,1347,priest,discipline,43,26,17
Nuklash,burning-legion,1347,priest,discipline,30,15,15
Greedyaf,stormscale,1347,priest,discipline,101,48,53
Maylà,aegwynn,1347,priest,discipline,48,18,30
Holyfussell,antonidas,1346,priest,discipline,54,25,29
Ciri,die-aldor,1345,priest,discipline,25,15,10
Pwjetlifelol,grim-batol,1345,priest,discipline,97,52,45
Sâtânica,kelthuzad,1345,priest,discipline,72,33,39
Noxr,ravencrest,1344,priest,discipline,50,18,32
Kenzah,ysondre,1343,priest,discipline,18,14,4
Fsnx,sylvanas,1343,priest,discipline,18,14,4
Outcast,korgall,1343,priest,discipline,42,24,18
Ецци,howling-fjord,1343,priest,discipline,38,18,20
Reflector,sunstrider,1343,priest,discipline,30,14,16
Kevokko,silvermoon,1342,priest,discipline,24,14,10
Омилая,gordunni,1342,priest,discipline,24,14,10
Rpriest,outland,1342,priest,discipline,24,14,10
Krematorio,twisting-nether,1342,priest,discipline,24,14,10
Поднялбабки,deathguard,1342,priest,discipline,36,14,22
Бенджаминлол,blackscar,1342,priest,discipline,36,14,22
Nolnilian,archimonde,1340,priest,discipline,24,14,10
Halastrâ,tarren-mill,1339,priest,discipline,20,15,5
Keryin,draenor,1339,priest,discipline,42,14,28
Árî,dun-modr,1338,priest,discipline,51,30,21
Kirtarah,aegwynn,1338,priest,discipline,30,14,16
Kahir,ravencrest,1337,priest,discipline,18,14,4
Luuña,ravencrest,1336,priest,discipline,88,41,47
Chealsey,thrall,1335,priest,discipline,45,30,15
Styrbjörn,shattered-hand,1335,priest,discipline,50,27,23
Kojee,blackrock,1335,priest,discipline,48,18,30
Biscuits,ravencrest,1335,priest,discipline,48,14,34
Гшд,gordunni,1334,priest,discipline,42,23,19
Jerzay,hyjal,1332,priest,discipline,40,16,24
Assiduous,stormreaver,1331,priest,discipline,28,17,11
Gajos,frostwolf,1331,priest,discipline,24,14,10
Aroghul,eredar,1331,priest,discipline,54,23,31
Waafa,kazzak,1331,priest,discipline,42,14,28
Мегаствол,howling-fjord,1330,priest,discipline,48,24,24
Кролс,gordunni,1330,priest,discipline,30,14,16
Snuifje,azjolnerub,1330,priest,discipline,81,33,48
Blackbertha,ravencrest,1330,priest,discipline,42,14,28
Winnever,dun-modr,1329,priest,discipline,111,58,53
Rose,darksorrow,1328,priest,discipline,37,21,16
Nou,aegwynn,1327,priest,discipline,36,14,22
Vedina,bronze-dragonflight,1326,priest,discipline,84,42,42
Èlysium,grim-batol,1326,priest,discipline,42,15,27
Seinaruki,emerald-dream,1325,priest,discipline,34,18,16
Skrnz,turalyon,1325,priest,discipline,59,26,33
Jodge,ravencrest,1324,priest,discipline,48,26,22
Hashoko,draenor,1323,priest,discipline,18,15,3
Jempi,argent-dawn,1323,priest,discipline,24,14,10
Бомжскадилом,gordunni,1323,priest,discipline,159,83,76
Kizzorde,ragnaros,1322,priest,discipline,30,22,8
Mungam,draenor,1322,priest,discipline,35,15,20
Kotipope,silvermoon,1321,priest,discipline,71,41,30
Niholie,sinstralis,1321,priest,discipline,36,14,22
Nirvánabang,sylvanas,1320,priest,discipline,42,21,21
Lãwh,hyjal,1319,priest,discipline,54,30,24
Fatherliam,emerald-dream,1319,priest,discipline,42,19,23
Eileengu,silvermoon,1318,priest,discipline,46,27,19
Chimara,eredar,1318,priest,discipline,66,32,34
Batsu,hyjal,1318,priest,discipline,82,36,46
Sabaxdxd,dun-modr,1317,priest,discipline,42,18,24
Meanazer,antonidas,1316,priest,discipline,30,14,16
Drwlad,archimonde,1316,priest,discipline,42,14,28
Ashérs,ravencrest,1315,priest,discipline,33,21,12
Shanya,thrall,1315,priest,discipline,24,14,10
Yugo,outland,1314,priest,discipline,41,15,26
Jakeow,auchindoun,1313,priest,discipline,27,15,12
Shilôz,hyjal,1313,priest,discipline,59,29,30
Ggsus,outland,1313,priest,discipline,48,20,28
Форсибучи,soulflayer,1312,priest,discipline,66,30,36
Tintapri,aszune,1311,priest,discipline,87,41,46
Youngfade,twisting-nether,1311,priest,discipline,34,15,19
Suzziee,silvermoon,1310,priest,discipline,48,25,23
Violentha,silvermoon,1310,priest,discipline,30,15,15
Pawriest,draenor,1309,priest,discipline,36,22,14
Elfarity,tarren-mill,1308,priest,discipline,24,14,10
Фурлена,blackscar,1308,priest,discipline,73,38,35
Dirtydoc,area-52,1307,priest,discipline,39,20,19
Patriamore,jaedenar,1306,priest,discipline,28,15,13
Lalgorithme,hyjal,1305,priest,discipline,24,14,10
Paine,pozzo-delleternità,1305,priest,discipline,31,18,13
Асади,gordunni,1305,priest,discipline,60,33,27
Ассарх,lich-king,1305,priest,discipline,48,24,24
Shadowmend,aegwynn,1305,priest,discipline,29,14,15
Prellish,draenor,1305,priest,discipline,48,19,29
Простойа,deathguard,1304,priest,discipline,30,16,14
Kïmbo,kazzak,1303,priest,discipline,41,17,24
Missdreavus,draenor,1301,priest,discipline,40,24,16
Ràthaløs,sanguino,1301,priest,discipline,41,24,17
Fullymetalz,defias-brotherhood,1300,priest,discipline,58,32,26
Mirelaw,stormscale,1298,priest,discipline,53,29,24
Agorasii,frostwolf,1298,priest,discipline,42,22,20
Шкуропльот,gordunni,1296,priest,discipline,88,46,42
Noobpriest,blackrock,1296,priest,discipline,36,14,22
Reticlel,kazzak,1293,priest,discipline,26,15,11
Pl,sunstrider,1293,priest,discipline,42,22,20
Kaktosz,ragnaros,1293,priest,discipline,54,21,33
Vès,stormscale,1292,priest,discipline,54,30,24
Bandgap,antonidas,1292,priest,discipline,98,44,54
Ixdeadxl,stormscale,1291,priest,discipline,30,16,14
Mustatomi,stormreaver,1291,priest,discipline,27,14,13
Тэвиель,gordunni,1291,priest,discipline,54,19,35
Тварьгосподя,gordunni,1290,priest,discipline,185,90,95
Yuuvi,ravencrest,1290,priest,discipline,48,20,28
Rodshun,dun-modr,1290,priest,discipline,52,21,31
Nukksch,antonidas,1289,priest,discipline,152,71,81
Brainwash,darksorrow,1289,priest,discipline,53,18,35
Hardloker,ravencrest,1288,priest,discipline,54,24,30
Sílvana,nordrassil,1284,priest,discipline,76,39,37
Pregrip,twisting-nether,1284,priest,discipline,236,116,120
Eßola,silvermoon,1283,priest,discipline,26,15,11
Olereo,blackhand,1282,priest,discipline,54,24,30
Mynameisebe,twisting-nether,1282,priest,discipline,42,18,24
Vannax,arygos,1282,priest,discipline,54,23,31
Superfelyn,ragnaros,1280,priest,discipline,51,27,24
Limerençe,ravencrest,1279,priest,discipline,20,14,6
Wortgottes,blackrock,1277,priest,discipline,28,16,12
Asuriyan,grim-batol,1276,priest,discipline,69,34,35
Хаварь,gordunni,1275,priest,discipline,75,38,37
Valeriana,stormreaver,1275,priest,discipline,36,18,18
Boulotpas,hyjal,1273,priest,discipline,55,38,17
Overshadowed,kazzak,1272,priest,discipline,175,80,95
Cring,kirin-tor,1271,priest,discipline,42,24,18
Jbte,silvermoon,1270,priest,discipline,66,38,28
Mishas,draenor,1270,priest,discipline,42,24,18
Даркфолс,soulflayer,1270,priest,discipline,53,28,25
Jeuwls,argent-dawn,1269,priest,discipline,67,40,27
Zùt,ysondre,1269,priest,discipline,48,28,20
Micobra,dalaran,1267,priest,discipline,24,14,10
Пофанчику,gordunni,1266,priest,discipline,58,27,31
Chrispriest,argent-dawn,1264,priest,discipline,32,14,18
Акктуальная,deepholm,1263,priest,discipline,48,25,23
Sacerfull,sanguino,1263,priest,discipline,48,23,25
Nìak,ysondre,1263,priest,discipline,94,38,56
Seum,ravencrest,1260,priest,discipline,44,25,19
Søînx,archimonde,1259,priest,discipline,27,17,10
Pocketissue,ravencrest,1258,priest,discipline,26,17,9
Alexnator,malganis,1258,priest,discipline,54,22,32
Añgêl,ravencrest,1257,priest,discipline,117,60,57
Ruderali,blackmoore,1257,priest,discipline,52,26,26
Velles,nazjatar,1256,priest,discipline,234,115,119
Brach,nazjatar,1255,priest,discipline,49,26,23
Littleabs,the-maelstrom,1249,priest,discipline,65,34,31
Buan,outland,1248,priest,discipline,18,13,5
Билетлолпро,borean-tundra,1248,priest,discipline,18,13,5
Mazikeen,stormscale,1248,priest,discipline,24,13,11
Suprenext,draenor,1248,priest,discipline,24,13,11
Удзумукец,howling-fjord,1248,priest,discipline,90,36,54
Miraña,kazzak,1247,priest,discipline,18,13,5
Dêmôn,stormscale,1247,priest,discipline,18,13,5
Zathada,twisting-nether,1247,priest,discipline,30,19,11
Swdömmel,aegwynn,1247,priest,discipline,24,13,11
Feedergodx,dun-modr,1247,priest,discipline,24,13,11
Flensu,stormscale,1246,priest,discipline,18,13,5
Judgementdaý,kazzak,1246,priest,discipline,18,13,5
Lekadolplusc,doomhammer,1246,priest,discipline,50,30,20
Psychoboris,outland,1246,priest,discipline,72,39,33
Xraid,blackmoore,1246,priest,discipline,24,13,11
Holycuddles,ysondre,1245,priest,discipline,24,13,11
Mcdodgens,auchindoun,1245,priest,discipline,36,13,23
Hotdog,kult-der-verdammten,1244,priest,discipline,30,17,13
Silvdarr,hyjal,1244,priest,discipline,68,34,34
Ùçù,dalaran,1244,priest,discipline,34,16,18
Jumby,outland,1244,priest,discipline,30,13,17
Шадоухоррор,gordunni,1244,priest,discipline,51,20,31
Takeoff,dun-morogh,1243,priest,discipline,30,20,10
Vokuheala,tarren-mill,1243,priest,discipline,29,16,13
Karanas,archimonde,1243,priest,discipline,24,13,11
Nintendó,sylvanas,1242,priest,discipline,24,13,11
Luziaa,outland,1242,priest,discipline,30,13,17
Pedopräst,stormscale,1241,priest,discipline,24,13,11
Lavendertown,tarren-mill,1241,priest,discipline,24,13,11
Pleistras,magtheridon,1240,priest,discipline,88,54,34
Cutename,burning-blade,1240,priest,discipline,30,14,16
Alaeddin,kazzak,1240,priest,discipline,171,77,94
Алуан,blackscar,1240,priest,discipline,42,13,29
Wandéline,arathi,1238,priest,discipline,35,15,20
Fulgus,sanguino,1237,priest,discipline,42,13,29
Miileys,arthas,1235,priest,discipline,18,13,5
Speltmor,stormscale,1235,priest,discipline,24,13,11
Disturbdtwo,archimonde,1235,priest,discipline,24,13,11
Flygar,outland,1235,priest,discipline,36,13,23
Holybunny,blackrock,1234,priest,discipline,54,27,27
Héternel,ysondre,1234,priest,discipline,56,27,29
Divaz,eredar,1234,priest,discipline,48,18,30
Deneye,thunderhorn,1233,priest,discipline,21,15,6
Nethenielle,malganis,1233,priest,discipline,30,17,13
Kätsulol,ysondre,1233,priest,discipline,24,13,11
Janinw,sylvanas,1232,priest,discipline,30,13,17
Samtig,malganis,1232,priest,discipline,57,23,34
Aladorius,la-croisade-écarlate,1231,priest,discipline,40,20,20
Lucianßk,sanguino,1230,priest,discipline,48,27,21
Deadpxlz,ravencrest,1230,priest,discipline,24,13,11
Veecna,the-maelstrom,1230,priest,discipline,36,19,17
Nikotyna,doomhammer,1230,priest,discipline,71,31,40
Cntrl,frostmane,1229,priest,discipline,60,30,30
Топчикс,gordunni,1229,priest,discipline,76,37,39
Avázàr,stormscale,1228,priest,discipline,30,13,17
Drsmort,blackrock,1227,priest,discipline,60,31,29
Verrottênd,frostwolf,1227,priest,discipline,58,25,33
Baglet,ravencrest,1224,priest,discipline,24,13,11
Therezzer,burning-legion,1224,priest,discipline,36,16,20
Nobbisnice,drakthul,1223,priest,discipline,52,28,24
Gobie,sunstrider,1223,priest,discipline,30,13,17
Mediumheals,tarren-mill,1221,priest,discipline,75,35,40
Blagovesta,ragnaros,1221,priest,discipline,36,13,23
Amphôra,archimonde,1220,priest,discipline,30,14,16
Discoprillan,twisting-nether,1219,priest,discipline,39,21,18
Howaya,la-croisade-écarlate,1219,priest,discipline,48,25,23
Xghazo,sylvanas,1218,priest,discipline,45,25,20
Лолиэль,soulflayer,1218,priest,discipline,57,31,26
Talonjean,conseil-des-ombres,1218,priest,discipline,24,13,11
Perdítá,thrall,1218,priest,discipline,106,51,55
Reìdood,stormscale,1217,priest,discipline,24,14,10
Pvpriestess,silvermoon,1217,priest,discipline,36,17,19
Капляболи,gordunni,1216,priest,discipline,51,28,23
Hêsêkiêl,eredar,1215,priest,discipline,24,13,11
Jimmyhoffa,stormscale,1213,priest,discipline,30,17,13
Nymrasus,ravencrest,1213,priest,discipline,24,13,11
Elderiel,turalyon,1212,priest,discipline,66,29,37
Myrmeen,silvermoon,1210,priest,discipline,78,39,39
Vempress,neptulon,1210,priest,discipline,48,24,24
Gertie,blackhand,1208,priest,discipline,46,29,17
Freezydot,silvermoon,1207,priest,discipline,63,37,26
Palitox,kazzak,1207,priest,discipline,24,13,11
Nostramo,kirin-tor,1206,priest,discipline,54,19,35
Selenar,neptulon,1205,priest,discipline,36,19,17
Voidvania,drakthul,1205,priest,discipline,29,14,15
Kyrédan,dalaran,1204,priest,discipline,62,35,27
Sykra,magtheridon,1204,priest,discipline,34,16,18
Simbaba,archimonde,1203,priest,discipline,36,19,17
Свежага,howling-fjord,1203,priest,discipline,76,33,43
Mamaoh,ravencrest,1203,priest,discipline,30,13,17
Beaglep,blackrock,1203,priest,discipline,53,13,40
Bekareth,archimonde,1201,priest,discipline,48,26,22
Flyingdutch,tarren-mill,1201,priest,discipline,209,97,112
Hetha,tarren-mill,1199,priest,discipline,44,31,13
Xieen,outland,1199,priest,discipline,66,27,39
Holyswift,dun-morogh,1198,priest,discipline,163,84,79
Notnøw,silvermoon,1197,priest,discipline,23,13,10
Canthms,twisting-nether,1194,priest,discipline,24,18,6
Türapea,draenor,1194,priest,discipline,53,27,26
Ráka,earthen-ring,1193,priest,discipline,24,13,11
Onicolla,terokkar,1193,priest,discipline,30,13,17
Дайбчик,gordunni,1191,priest,discipline,28,15,13
Whitepitch,doomhammer,1190,priest,discipline,35,14,21
Uro,tirion,1190,priest,discipline,41,14,27
Discovery,aggra-português,1189,priest,discipline,48,22,26
Triksas,sylvanas,1187,priest,discipline,24,19,5
Megalodön,draenor,1187,priest,discipline,45,17,28
Duem,kazzak,1186,priest,discipline,42,20,22
Lighter,dragonblight,1183,priest,discipline,58,35,23
Аэрэта,deathguard,1181,priest,discipline,24,15,9
Drioz,ysondre,1180,priest,discipline,36,22,14
Duaijhutari,outland,1179,priest,discipline,24,14,10
Phórkys,kazzak,1179,priest,discipline,42,23,19
Diçkhëad,ravencrest,1179,priest,discipline,31,15,16
Valnaya,draenor,1178,priest,discipline,55,31,24
Attenna,ravencrest,1178,priest,discipline,69,26,43
Nnaoy,ysondre,1177,priest,discipline,26,13,13
Парикнахер,soulflayer,1171,priest,discipline,36,23,13
Deeforce,argent-dawn,1171,priest,discipline,52,26,26
Captn,draenor,1171,priest,discipline,54,22,32
Dartheon,twisting-nether,1171,priest,discipline,58,19,39
Bomzhik,silvermoon,1170,priest,discipline,24,15,9
Cøøbrà,hyjal,1170,priest,discipline,70,38,32
Synoé,la-croisade-écarlate,1170,priest,discipline,35,15,20
Jerolol,sanguino,1169,priest,discipline,44,14,30
Aeo,twisting-nether,1166,priest,discipline,47,20,27
Aléhyl,la-croisade-écarlate,1164,priest,discipline,30,14,16
Dezriah,tarren-mill,1163,priest,discipline,28,18,10
Olîra,hyjal,1163,priest,discipline,30,14,16
Yojoyo,draenor,1163,priest,discipline,97,44,53
Eyecry,sylvanas,1162,priest,discipline,23,13,10
Klaura,blackmoore,1161,priest,discipline,30,15,15
Blàckângel,blackrock,1160,priest,discipline,306,153,153
Монесса,howling-fjord,1159,priest,discipline,36,16,20
Javvi,sylvanas,1158,priest,discipline,78,44,34
Brunestùd,pozzo-delleternità,1157,priest,discipline,62,30,32
Milessa,steamwheedle-cartel,1157,priest,discipline,42,17,25
Ноубадди,howling-fjord,1155,priest,discipline,43,19,24
Coldyxz,blackrock,1152,priest,discipline,18,12,6
Найтингеилл,gordunni,1152,priest,discipline,24,12,12
Donpedrila,kazzak,1152,priest,discipline,24,12,12
Djrussia,tarren-mill,1152,priest,discipline,30,12,18
Djokui,uldum,1152,priest,discipline,30,12,18
Yesdaddypls,draenor,1151,priest,discipline,25,13,12
Deadsloth,hyjal,1151,priest,discipline,24,12,12
Ксенонх,gordunni,1151,priest,discipline,24,12,12
Arythc,ahnqiraj,1151,priest,discipline,24,12,12
Listrix,frostmane,1151,priest,discipline,30,12,18
Cyabish,twisting-nether,1150,priest,discipline,18,12,6
Plsdontcry,blackrock,1150,priest,discipline,24,12,12
Olurin,rajaxx,1150,priest,discipline,30,12,18
Soloqbob,kazzak,1149,priest,discipline,30,12,18
Discmoo,kazzak,1148,priest,discipline,20,12,8
Neverlandx,bladefist,1147,priest,discipline,18,12,6
Sameec,drakthul,1147,priest,discipline,24,12,12
Tarîs,archimonde,1147,priest,discipline,24,12,12
Indicta,darksorrow,1147,priest,discipline,27,13,14
Péntagón,festung-der-stürme,1147,priest,discipline,30,12,18
Deicidex,blackrock,1147,priest,discipline,36,12,24
Sandaal,drakthul,1146,priest,discipline,47,21,26
Holyskull,magtheridon,1146,priest,discipline,63,26,37
Laërhia,archimonde,1146,priest,discipline,30,12,18
Toorree,stormscale,1145,priest,discipline,18,12,6
Ruly,ragnaros,1145,priest,discipline,18,12,6
Darkest,ysondre,1145,priest,discipline,24,12,12
Ticklebell,ravencrest,1144,priest,discipline,48,30,18
Dysko,alakir,1144,priest,discipline,24,12,12
Fluvnidi,ravencrest,1144,priest,discipline,24,12,12
Ðøð,dalaran,1143,priest,discipline,24,16,8
Dankopriest,drakthul,1143,priest,discipline,18,12,6
Eördög,ragnaros,1143,priest,discipline,24,12,12
Noskan,silvermoon,1141,priest,discipline,21,13,8
Karzin,aggra-português,1141,priest,discipline,66,32,34
Daesa,defias-brotherhood,1140,priest,discipline,24,14,10
Dotterin,draenor,1140,priest,discipline,24,12,12
Тодохил,gordunni,1140,priest,discipline,30,12,18
Werita,frostmane,1140,priest,discipline,74,29,45
Healy,blackrock,1140,priest,discipline,36,13,23
Ebolaidman,ravencrest,1139,priest,discipline,18,12,6
Mädmän,draenor,1139,priest,discipline,72,38,34
Vividots,draenor,1139,priest,discipline,24,12,12
Didinini,outland,1138,priest,discipline,36,21,15
Alfaböna,outland,1138,priest,discipline,116,62,54
Quinax,shattered-hand,1138,priest,discipline,24,12,12
Seneth,twisting-nether,1135,priest,discipline,24,12,12
Drissz,archimonde,1135,priest,discipline,24,12,12
Darkheall,sanguino,1135,priest,discipline,50,21,29
Seras,bloodfeather,1134,priest,discipline,84,37,47
Danucd,ragnaros,1133,priest,discipline,82,39,43
Taiyöshin,silvermoon,1132,priest,discipline,30,12,18
Frittê,anetheron,1130,priest,discipline,39,20,19
Арабет,galakrond,1129,priest,discipline,55,31,24
Miralou,ravencrest,1129,priest,discipline,120,63,57
Ожившийприст,soulflayer,1128,priest,discipline,42,21,21
Dotsin,kazzak,1128,priest,discipline,113,53,60
Jeez,twilights-hammer,1127,priest,discipline,36,12,24
Praystatîon,dragonblight,1125,priest,discipline,77,46,31
Zenoo,argent-dawn,1122,priest,discipline,18,12,6
Kurtse,archimonde,1121,priest,discipline,28,14,14
Biblebabe,tarren-mill,1121,priest,discipline,24,12,12
Марджелла,howling-fjord,1119,priest,discipline,28,13,15
Iømÿnudir,archimonde,1119,priest,discipline,30,13,17
Necromania,cthun,1118,priest,discipline,49,21,28
Limpopon,doomhammer,1118,priest,discipline,36,14,22
Angusbeêf,blackrock,1117,priest,discipline,36,19,17
Алеброн,gordunni,1117,priest,discipline,29,12,17
Sphard,ysondre,1113,priest,discipline,36,12,24
Залупский,gordunni,1111,priest,discipline,24,12,12
Пакетикдот,gordunni,1111,priest,discipline,42,19,23
Стаминабаф,gordunni,1108,priest,discipline,21,13,8
Glärë,burning-legion,1108,priest,discipline,29,16,13
Chega,malganis,1108,priest,discipline,36,13,23
Дракулесса,gordunni,1107,priest,discipline,23,12,11
Lanaineuwu,archimonde,1105,priest,discipline,20,13,7
Deckardkain,pozzo-delleternità,1105,priest,discipline,60,33,27
Valente,twisting-nether,1105,priest,discipline,60,22,38
Lydîâ,blackhand,1102,priest,discipline,23,12,11
Seherbazqt,twisting-nether,1101,priest,discipline,23,12,11
Möd,ragnaros,1100,priest,discipline,30,13,17
Rrpriest,silvermoon,1096,priest,discipline,50,19,31
Mjölkpelle,twisting-nether,1092,priest,discipline,18,14,4
Mønti,onyxia,1092,priest,discipline,33,17,16
Praywingsebb,nazjatar,1091,priest,discipline,24,13,11
Çiione,archimonde,1086,priest,discipline,29,12,17
Trashpriest,blackrock,1086,priest,discipline,35,12,23
Liliashet,sanguino,1085,priest,discipline,24,12,12
Saénna,burning-legion,1083,priest,discipline,26,12,14
Tristar,nethersturm,1081,priest,discipline,23,12,11
Drtickomaru,drakthul,1081,priest,discipline,26,13,13
Dinma,argent-dawn,1081,priest,discipline,47,20,27
Nellytaa,dalaran,1080,priest,discipline,33,17,16
Гомотряс,howling-fjord,1079,priest,discipline,102,54,48
Waxosc,silvermoon,1076,priest,discipline,62,25,37
Ghostroller,ravencrest,1075,priest,discipline,23,12,11
Enilion,draenor,1071,priest,discipline,32,13,19
Lunairess,silvermoon,1069,priest,discipline,60,16,44
Mournus,defias-brotherhood,1065,priest,discipline,17,12,5
Юкич,soulflayer,1065,priest,discipline,34,12,22
Trimégiste,hyjal,1061,priest,discipline,81,43,38
Yânùx,aegwynn,1056,priest,discipline,12,11,1
Asgà,stormscale,1056,priest,discipline,18,11,7
Bindww,tarren-mill,1056,priest,discipline,18,11,7
Schwypsvnr,garona,1056,priest,discipline,18,11,7
Prïstië,drakthul,1056,priest,discipline,54,26,28
Tazn,thrall,1056,priest,discipline,24,11,13
Bølzer,blackrock,1056,priest,discipline,24,11,13
Stormmyy,kazzak,1056,priest,discipline,24,11,13
Secø,sylvanas,1056,priest,discipline,24,11,13
Carpathîan,blackhand,1056,priest,discipline,72,25,47
Menarille,kazzak,1055,priest,discipline,12,11,1
Гоплзнекст,gordunni,1055,priest,discipline,18,11,7
Yungblessing,stormscale,1055,priest,discipline,24,11,13
Pureàngel,ravencrest,1055,priest,discipline,24,11,13
Ylenae,twisting-nether,1055,priest,discipline,30,11,19
Piperxp,ravencrest,1054,priest,discipline,18,11,7
Anzee,tarren-mill,1054,priest,discipline,24,11,13
Faintly,emeriss,1054,priest,discipline,24,11,13
Yuukii,kult-der-verdammten,1054,priest,discipline,24,11,13
Tryhàrdx,stormscale,1054,priest,discipline,30,11,19
Szycho,burning-legion,1054,priest,discipline,36,11,25
Азмоддан,azuregos,1054,priest,discipline,36,11,25
Zeatt,ysera,1053,priest,discipline,18,11,7
Lerión,ravencrest,1053,priest,discipline,18,11,7
Snusprällen,sylvanas,1053,priest,discipline,24,11,13
Immortalled,twisting-nether,1053,priest,discipline,30,11,19
Trénboloné,tarren-mill,1052,priest,discipline,24,11,13
Inaeries,argent-dawn,1051,priest,discipline,35,20,15
Ihaveibs,doomhammer,1051,priest,discipline,24,11,13
Nevermyndz,blackmoore,1051,priest,discipline,24,11,13
Cursedme,blackrock,1050,priest,discipline,18,11,7
Junglepriest,ravencrest,1050,priest,discipline,24,11,13
Angelic,ragnaros,1050,priest,discipline,30,11,19
Baloopriest,grim-batol,1050,priest,discipline,30,11,19
Icyc,outland,1049,priest,discipline,42,11,31
Grausami,zuluhed,1048,priest,discipline,18,11,7
Sanril,ragnaros,1048,priest,discipline,24,11,13
Neseig,blutkessel,1047,priest,discipline,18,11,7
Ilostmybible,runetotem,1047,priest,discipline,28,12,16
Мерседулька,howling-fjord,1046,priest,discipline,22,12,10
Ichpvpeuch,eredar,1046,priest,discipline,24,11,13
Eowins,blackmoore,1046,priest,discipline,28,12,16
Болътвоя,gordunni,1045,priest,discipline,18,11,7
Janclod,pozzo-delleternità,1045,priest,discipline,18,11,7
Jeanpipe,khaz-modan,1044,priest,discipline,12,11,1
Ginebra,archimonde,1044,priest,discipline,18,11,7
Needmana,hyjal,1044,priest,discipline,36,15,21
Kaos,anetheron,1043,priest,discipline,15,13,2
Mambanero,nemesis,1043,priest,discipline,42,15,27
Apeist,outland,1042,priest,discipline,24,11,13
Thörbjorn,confrérie-du-thorium,1039,priest,discipline,24,12,12
Джейнкелли,borean-tundra,1038,priest,discipline,18,15,3
Spoc,blackrock,1037,priest,discipline,18,11,7
Khai,tarren-mill,1037,priest,discipline,49,26,23
Whitemané,argent-dawn,1033,priest,discipline,50,25,25
Cheja,ravencrest,1033,priest,discipline,30,11,19
Loetharion,archimonde,1032,priest,discipline,18,11,7
Pandalulz,turalyon,1031,priest,discipline,22,14,8
Devîlcry,nordrassil,1030,priest,discipline,36,18,18
Pasalacabra,zuljin,1030,priest,discipline,24,11,13
Nupzie,stormscale,1029,priest,discipline,39,15,24
Rydzyk,laughing-skull,1028,priest,discipline,24,13,11
Sisdenna,doomhammer,1026,priest,discipline,48,23,25
Mocnymaco,burning-blade,1024,priest,discipline,115,59,56
Bakris,twisting-nether,1024,priest,discipline,24,11,13
Чилюнахиле,gordunni,1022,priest,discipline,35,12,23
Tori,marécage-de-zangar,1021,priest,discipline,20,12,8
Kæzm,blackrock,1020,priest,discipline,23,11,12
Ylvanna,arthas,1020,priest,discipline,28,11,17
Zerula,outland,1019,priest,discipline,54,21,33
Sòsò,archimonde,1018,priest,discipline,60,25,35
Deathspawn,hellscream,1016,priest,discipline,39,20,19
Gronni,argent-dawn,1014,priest,discipline,24,13,11
Xanndro,argent-dawn,1014,priest,discipline,34,13,21
Фрустрациия,soulflayer,1013,priest,discipline,20,12,8
Yøzø,blackhand,1009,priest,discipline,63,27,36
Zurlyne,ravencrest,1007,priest,discipline,21,12,9
Discoruzki,ravencrest,1007,priest,discipline,23,11,12
Howlscastie,stormscale,1007,priest,discipline,54,22,32
Prazefin,twisting-nether,1005,priest,discipline,16,12,4
Boomhilde,aegwynn,1003,priest,discipline,182,89,93
Sixeus,outland,1002,priest,discipline,26,12,14
Mijuuk,zuljin,1000,priest,discipline,36,23,13
Nunnis,kazzak,997,priest,discipline,90,48,42
Вальдемарс,howling-fjord,996,priest,discipline,29,11,18
Kenderke,ragnaros,994,priest,discipline,23,11,12
Hinkelstein,defias-brotherhood,993,priest,discipline,26,15,11
Îndura,drakthul,993,priest,discipline,61,30,31
Negativeapm,archimonde,991,priest,discipline,17,11,6
Therealopa,blackmoore,991,priest,discipline,98,45,53
Popegoat,ragnaros,983,priest,discipline,18,14,4
Huzlin,kazzak,983,priest,discipline,28,11,17
Lichtelaaie,quelthalas,980,priest,discipline,24,15,9
Satanspawn,neptulon,977,priest,discipline,64,23,41
Borrex,sanguino,971,priest,discipline,13,11,2
Shalacho,blackrock,970,priest,discipline,52,23,29
Эрьеро,gordunni,970,priest,discipline,36,11,25
Snoopqt,dalaran,965,priest,discipline,31,11,20
Аргла,soulflayer,964,priest,discipline,54,21,33
Presbyter,mazrigos,961,priest,discipline,21,11,10
Stargal,blackmoore,960,priest,discipline,12,10,2
Piccolamorte,ysondre,960,priest,discipline,12,10,2
Ghettonelf,sylvanas,960,priest,discipline,12,10,2
Rîeka,antonidas,960,priest,discipline,18,10,8
Фотосз,soulflayer,960,priest,discipline,18,10,8
Дъикиймвп,deepholm,960,priest,discipline,18,10,8
Bekznfiend,ragnaros,960,priest,discipline,18,10,8
Ринкуку,howling-fjord,960,priest,discipline,18,10,8
Jâde,bloodhoof,960,priest,discipline,18,10,8
Пухлаясвинка,fordragon,960,priest,discipline,18,10,8
Teradros,blackhand,960,priest,discipline,18,10,8
Hukkuvahirvi,ravencrest,960,priest,discipline,24,10,14
Sùzy,ravencrest,960,priest,discipline,30,10,20
Casic,blackhand,959,priest,discipline,12,10,2
Rngamer,silvermoon,959,priest,discipline,12,10,2
Talbyslegacý,blackmoore,959,priest,discipline,18,10,8
Yaoz,sanguino,959,priest,discipline,18,10,8
Waffur,twisting-nether,959,priest,discipline,18,10,8
Healbotmvp,ravencrest,959,priest,discipline,18,10,8
Ðaala,blackrock,959,priest,discipline,18,10,8
Moglimeister,blackrock,959,priest,discipline,18,10,8
Towelie,stormscale,959,priest,discipline,18,10,8
Рыжаякискис,soulflayer,959,priest,discipline,18,10,8
Joeasaurs,ragnaros,959,priest,discipline,21,11,10
Aurorä,burning-legion,959,priest,discipline,24,10,14
Loarderonx,stormscale,959,priest,discipline,24,10,14
Drwho,zuljin,959,priest,discipline,27,11,16
Loliheal,blackmoore,959,priest,discipline,28,11,17
Ykiotonegawa,twisting-nether,959,priest,discipline,30,10,20
Zarez,stormscale,959,priest,discipline,38,12,26
Mêduse,ravencrest,959,priest,discipline,39,11,28
Ezcobar,twilights-hammer,958,priest,discipline,18,10,8
Goldgot,tarren-mill,958,priest,discipline,18,10,8
Joeelz,blackmoore,958,priest,discipline,18,10,8
Vynivan,korgall,958,priest,discipline,18,10,8
Gingerflexay,archimonde,958,priest,discipline,18,10,8
Vo,dentarg,958,priest,discipline,18,10,8
Ømñyx,outland,958,priest,discipline,24,10,14
Kolinamenus,dun-morogh,958,priest,discipline,24,10,14
Manau,culte-de-la-rive-noire,958,priest,discipline,24,10,14
Dotreveal,ravencrest,958,priest,discipline,27,11,16
Hellsaya,ysondre,957,priest,discipline,12,10,2
Mackópriest,ragnaros,957,priest,discipline,30,10,20
Вейтарен,gordunni,957,priest,discipline,30,10,20
Nøwénna,ravencrest,957,priest,discipline,36,10,26
Cidrea,saurfang,956,priest,discipline,18,10,8
Nastynina,frostwhisper,956,priest,discipline,24,10,14
Golletz,twisting-nether,955,priest,discipline,18,10,8
Umbraya,blackhand,955,priest,discipline,30,10,20
Zyrexan,defias-brotherhood,955,priest,discipline,30,10,20
Linara,frostmane,954,priest,discipline,12,10,2
Chilltcaster,blackrock,954,priest,discipline,26,10,16
Syro,defias-brotherhood,953,priest,discipline,20,11,9
Calsote,sanguino,952,priest,discipline,30,10,20
Matsipri,sylvanas,951,priest,discipline,24,10,14
Salskagripme,ragnaros,950,priest,discipline,12,10,2
Desperion,ragnaros,949,priest,discipline,24,10,14
Priincess,ragnaros,947,priest,discipline,22,12,10
Заплетальщик,howling-fjord,942,priest,discipline,40,20,20
Felbs,defias-brotherhood,941,priest,discipline,51,16,35
Perlo,sanguino,940,priest,discipline,83,44,39
Moinmeister,frostmourne,939,priest,discipline,29,15,14
Sednâ,conseil-des-ombres,931,priest,discipline,23,10,13
Eleveno,ravencrest,928,priest,discipline,48,24,24
Лайбаси,howling-fjord,927,priest,discipline,24,11,13
Yante,ragnaros,926,priest,discipline,24,12,12
Pavyone,twisting-nether,926,priest,discipline,23,10,13
Taili,ysondre,925,priest,discipline,20,11,9
Meodor,antonidas,923,priest,discipline,24,14,10
Kalisy,ravencrest,922,priest,discipline,16,10,6
Kallsen,ravencrest,920,priest,discipline,27,15,12
Pulttipiispa,ravencrest,916,priest,discipline,23,10,13
Elba,defias-brotherhood,916,priest,discipline,24,10,14
Kashmirweed,ravencrest,916,priest,discipline,48,17,31
Titibolls,sanguino,908,priest,discipline,23,10,13
Ebashuvkashu,stormscale,906,priest,discipline,23,10,13
Steadyog,doomhammer,905,priest,discipline,18,11,7
Mércíless,ravencrest,905,priest,discipline,17,10,7
Vepa,blackrock,903,priest,discipline,34,15,19
Theunknown,stormscale,903,priest,discipline,29,11,18
Nosgot,earthen-ring,898,priest,discipline,24,12,12
Absinthamos,eredar,895,priest,discipline,16,10,6
Aliciakeys,twilights-hammer,892,priest,discipline,28,10,18
Wynkx,zuljin,891,priest,discipline,23,10,13
Unleet,sylvanas,885,priest,discipline,28,11,17
Shnookfour,agamaggan,882,priest,discipline,22,12,10
Blååb,draenor,879,priest,discipline,19,10,9
Priezeke,aggramar,878,priest,discipline,18,10,8
Chillx,blackmoore,878,priest,discipline,85,45,40
Amaretta,perenolde,872,priest,discipline,32,13,19
Borgír,burning-legion,871,priest,discipline,27,11,16
Toks,stormscale,871,priest,discipline,45,10,35
Elfiontko,burning-legion,870,priest,discipline,24,11,13
Pohja,veknilash,864,priest,discipline,12,9,3
Qpapi,quelthalas,864,priest,discipline,12,9,3
Priéstitude,kazzak,864,priest,discipline,12,9,3
Lexojam,ravencrest,864,priest,discipline,12,9,3
Slovak,stormscale,864,priest,discipline,12,9,3
Zyrean,bronzebeard,864,priest,discipline,18,9,9
Леддигага,gordunni,864,priest,discipline,18,9,9
Kavrack,dalaran,864,priest,discipline,18,9,9
Muant,twisting-nether,864,priest,discipline,18,9,9
Jmp,tarren-mill,864,priest,discipline,18,9,9
Djros,magtheridon,864,priest,discipline,18,9,9
Dexlolo,stormscale,864,priest,discipline,18,9,9
Myggsparv,stormscale,864,priest,discipline,18,9,9
Антошашвп,azuregos,864,priest,discipline,18,9,9
Undeathy,ravencrest,864,priest,discipline,18,9,9
Жентельмен,deathguard,864,priest,discipline,18,9,9
Sørcedote,dun-modr,864,priest,discipline,18,9,9
Frígídhealz,outland,864,priest,discipline,24,9,15
Падлез,howling-fjord,864,priest,discipline,24,9,15
Kêkwshádêzz,blackmoore,864,priest,discipline,24,9,15
Próxs,ravencrest,864,priest,discipline,24,9,15
Notnowelf,silvermoon,864,priest,discipline,24,9,15
Smitebone,tarren-mill,864,priest,discipline,24,9,15
Itsdiscobaby,auchindoun,864,priest,discipline,24,9,15
Chocomiette,archimonde,864,priest,discipline,25,9,16
Radiance,emeriss,864,priest,discipline,28,10,18
Sadgelands,outland,863,priest,discipline,12,9,3
Fearadelia,thrall,863,priest,discipline,12,9,3
Elinaa,die-aldor,863,priest,discipline,12,9,3
Giily,archimonde,863,priest,discipline,18,9,9
Sacreth,ragnaros,863,priest,discipline,18,9,9
Ectria,ravencrest,863,priest,discipline,18,9,9
Mïxa,eitrigg,863,priest,discipline,18,9,9
Ratingfeeder,tarren-mill,863,priest,discipline,18,9,9
Cajolîne,archimonde,863,priest,discipline,18,9,9
Markianos,silvermoon,863,priest,discipline,18,9,9
Grêy,dun-modr,863,priest,discipline,18,9,9
Naberus,ragnaros,863,priest,discipline,19,9,10
Mysticforces,silvermoon,863,priest,discipline,24,9,15
Xyliqa,aegwynn,863,priest,discipline,24,9,15
Sctheal,outland,863,priest,discipline,24,9,15
Холиблэк,blackscar,863,priest,discipline,24,9,15
Rixis,la-croisade-écarlate,863,priest,discipline,24,9,15
Kaydenkross,eredar,863,priest,discipline,30,9,21
Søkariss,elune,862,priest,discipline,12,9,3
Joeshmoex,blackrock,862,priest,discipline,12,9,3
Tiktokdancér,kazzak,862,priest,discipline,12,9,3
Vandansk,kazzak,862,priest,discipline,12,9,3
Gnomeeater,silvermoon,862,priest,discipline,12,9,3
Carlye,stormreaver,862,priest,discipline,18,9,9
Chaosxo,draenor,862,priest,discipline,18,9,9
Skyalpha,silvermoon,862,priest,discipline,18,9,9
Reäzx,archimonde,861,priest,discipline,18,9,9
Drüdkh,tarren-mill,861,priest,discipline,30,9,21
Brênos,blackmoore,860,priest,discipline,18,9,9
Juhduss,tarren-mill,859,priest,discipline,12,9,3
Fkup,twisting-nether,859,priest,discipline,18,9,9
Symeria,sylvanas,859,priest,discipline,18,9,9
Shadoomed,kazzak,859,priest,discipline,24,9,15
Nhajÿ,hyjal,859,priest,discipline,24,9,15
Priestige,spinebreaker,858,priest,discipline,18,9,9
Щявыхилим,howling-fjord,857,priest,discipline,13,9,4
Fatalyse,ysondre,857,priest,discipline,36,16,20
Plaguetale,archimonde,855,priest,discipline,12,9,3
Nilsatis,grim-batol,855,priest,discipline,59,25,34
Fingerblast,sanguino,853,priest,discipline,18,9,9
Reighl,drakthul,850,priest,discipline,18,9,9
Drynte,blackmoore,847,priest,discipline,23,9,14
Bálíé,blackmoore,846,priest,discipline,18,9,9
Evastemplar,turalyon,836,priest,discipline,24,9,15
Socratés,antonidas,832,priest,discipline,54,21,33
Spooka,ravencrest,831,priest,discipline,17,9,8
Mílérí,ravencrest,830,priest,discipline,23,9,14
Waikiki,ambossar,827,priest,discipline,16,10,6
Zthul,draenor,815,priest,discipline,21,10,11
Ladá,stormscale,815,priest,discipline,19,9,10
Squidlicker,twisting-nether,814,priest,discipline,17,9,8
Lauriinda,culte-de-la-rive-noire,809,priest,discipline,19,10,9
Zofa,sunstrider,809,priest,discipline,21,9,12
Solaní,antonidas,808,priest,discipline,26,11,15
Давалкасвета,gordunni,807,priest,discipline,27,10,17
Maerlene,nemesis,800,priest,discipline,22,9,13
Djleffe,stormscale,799,priest,discipline,11,9,2
Dhassy,sanguino,799,priest,discipline,11,9,2
Pillian,nordrassil,799,priest,discipline,16,9,7
Tremrfinger,dun-modr,798,priest,discipline,14,9,5
Gudrinieks,shattered-halls,797,priest,discipline,26,10,16
Протомуу,gordunni,783,priest,discipline,11,9,2
Homxcxde,ravencrest,777,priest,discipline,26,10,16
Gobblestick,draenor,768,priest,discipline,12,8,4
Csúforck,ragnaros,768,priest,discipline,12,8,4
Gnzysan,blackrock,768,priest,discipline,12,8,4
Xandrial,blackmoore,768,priest,discipline,12,8,4
Nyell,silvermoon,768,priest,discipline,12,8,4
Raeratwo,archimonde,768,priest,discipline,12,8,4
Oldnbad,archimonde,768,priest,discipline,12,8,4
Shdwxy,blackrock,768,priest,discipline,12,8,4
Lmnsqzy,ravencrest,768,priest,discipline,12,8,4
Voxqt,blackrock,768,priest,discipline,12,8,4
Joeblowx,blackrock,768,priest,discipline,12,8,4
Ltr,tarren-mill,768,priest,discipline,12,8,4
Anabølix,ravencrest,768,priest,discipline,12,8,4
Killafoolx,silvermoon,768,priest,discipline,12,8,4
Absôlutvôdka,twisting-nether,768,priest,discipline,12,8,4
Orkanwal,ravencrest,768,priest,discipline,12,8,4
Nazo,sylvanas,768,priest,discipline,19,9,10
Blerd,eredar,768,priest,discipline,18,8,10
Yânux,aegwynn,768,priest,discipline,18,8,10
Preme,blackhand,768,priest,discipline,18,8,10
Phyxiusx,stormscale,768,priest,discipline,18,8,10
Manäka,hyjal,768,priest,discipline,18,8,10
Pikaboom,the-maelstrom,768,priest,discipline,18,8,10
Двачх,soulflayer,768,priest,discipline,18,8,10
Ssjx,ravencrest,768,priest,discipline,18,8,10
Theblank,pozzo-delleternità,768,priest,discipline,18,8,10
Aelíth,archimonde,768,priest,discipline,18,8,10
Uanna,ravencrest,768,priest,discipline,18,8,10
Nstp,zuljin,768,priest,discipline,18,8,10
Louiepr,outland,768,priest,discipline,18,8,10
Azpr,ravencrest,768,priest,discipline,18,8,10
Raffá,blackhand,768,priest,discipline,18,8,10
Zuniqa,die-aldor,768,priest,discipline,24,8,16
Rmp,stormscale,768,priest,discipline,24,8,16
Kletroll,archimonde,767,priest,discipline,12,8,4
Ompala,shattered-hand,767,priest,discipline,12,8,4
Pumpkin,aggramar,767,priest,discipline,12,8,4
Ðelftware,tarren-mill,767,priest,discipline,12,8,4
Freaki,blackrock,767,priest,discipline,12,8,4
Cainactor,drakthul,767,priest,discipline,12,8,4
Rihx,ysondre,767,priest,discipline,12,8,4
Apøcalypso,antonidas,767,priest,discipline,12,8,4
Gumer,antonidas,767,priest,discipline,18,8,10
Durinko,thunderhorn,767,priest,discipline,18,8,10
Kitanai,silvermoon,767,priest,discipline,18,8,10
Амберис,gordunni,767,priest,discipline,18,8,10
Eluveitieq,kazzak,767,priest,discipline,18,8,10
Khaag,korgall,767,priest,discipline,18,8,10
Crazyname,outland,767,priest,discipline,18,8,10
Pìkachù,stormscale,767,priest,discipline,18,8,10
Prästbaazil,ragnaros,767,priest,discipline,18,8,10
Luminouzilla,tarren-mill,767,priest,discipline,18,8,10
Dathanosx,outland,767,priest,discipline,18,8,10
Døgfîsh,stormscale,767,priest,discipline,18,8,10
Smokäy,blackhand,767,priest,discipline,18,8,10
Diskogoblin,drakthul,767,priest,discipline,18,8,10
Arwén,zuljin,767,priest,discipline,18,8,10
Saskiaa,doomhammer,767,priest,discipline,24,9,15
Nahni,teldrassil,767,priest,discipline,24,8,16
Healenax,ravencrest,767,priest,discipline,24,8,16
Smålbenör,stormreaver,766,priest,discipline,12,8,4
Worstdisceu,draenor,766,priest,discipline,12,8,4
Aerosoll,drakthul,766,priest,discipline,12,8,4
Letmehêal,archimonde,766,priest,discipline,18,8,10
Chuntriest,shadowsong,766,priest,discipline,18,8,10
Lianny,sylvanas,766,priest,discipline,18,8,10
Pure,kazzak,765,priest,discipline,12,8,4
Baybe,ravencrest,765,priest,discipline,12,8,4
Amambo,chamber-of-aspects,765,priest,discipline,12,8,4
Pocketsimp,stormscale,765,priest,discipline,18,8,10
Uglypriest,grim-batol,764,priest,discipline,12,8,4
Irenedwen,silvermoon,764,priest,discipline,18,8,10
Sytawa,blackmoore,764,priest,discipline,18,8,10
Buttafly,archimonde,764,priest,discipline,18,8,10
Mefeon,draenor,763,priest,discipline,18,8,10
Togx,silvermoon,763,priest,discipline,18,8,10
Joebando,ravencrest,763,priest,discipline,18,8,10
Жрицазла,soulflayer,763,priest,discipline,18,8,10
Nightshådøw,silvermoon,762,priest,discipline,22,10,12
Xmassdispel,tarren-mill,762,priest,discipline,18,8,10
Rashyd,sylvanas,761,priest,discipline,12,8,4
Boyraz,argent-dawn,760,priest,discipline,18,8,10
Sîanah,archimonde,754,priest,discipline,12,8,4
Healheal,outland,753,priest,discipline,18,8,10
Omened,nemesis,751,priest,discipline,17,8,9
Swdswdswdswd,blackmoore,751,priest,discipline,23,8,15
Йуп,ashenvale,735,priest,discipline,16,9,7
Ислейн,howling-fjord,735,priest,discipline,29,8,21
Blorpan,tarren-mill,734,priest,discipline,26,9,17
Cthultist,dun-modr,728,priest,discipline,26,9,17
Abstauberin,blackrock,723,priest,discipline,22,8,14
Lyim,stormscale,719,priest,discipline,11,8,3
Bigwoopsie,stormscale,719,priest,discipline,19,9,10
Dtpe,kazzak,717,priest,discipline,15,9,6
Hidary,ysondre,717,priest,discipline,21,9,12
Chnechnechne,outland,714,priest,discipline,23,10,13
Greenlizard,stormreaver,704,priest,discipline,22,8,14
Mindcrackr,stormscale,702,priest,discipline,12,9,3
Sacerdotini,outland,702,priest,discipline,19,9,10
Disconsick,vashj,702,priest,discipline,32,8,24
Pristerline,antonidas,687,priest,discipline,13,8,5
Trixix,ragnaros,684,priest,discipline,14,8,6
Sinnestrike,tarren-mill,672,priest,discipline,12,7,5
Duckiethot,twisting-nether,672,priest,discipline,12,7,5
Binkx,tarren-mill,672,priest,discipline,12,7,5
Yarok,anubarak,672,priest,discipline,12,7,5
Plåster,dunemaul,672,priest,discipline,12,7,5
Morphics,silvermoon,672,priest,discipline,12,7,5
Mdmaster,stormreaver,672,priest,discipline,12,7,5
Sehek,sanguino,672,priest,discipline,12,7,5
Infandus,pozzo-delleternità,672,priest,discipline,12,7,5
Goodra,sylvanas,672,priest,discipline,12,7,5
Obbdasknob,ravencrest,672,priest,discipline,12,7,5
Klered,ragnaros,672,priest,discipline,12,7,5
Убивал,soulflayer,672,priest,discipline,12,7,5
Расспутана,howling-fjord,672,priest,discipline,12,7,5
Wurstpriest,silvermoon,672,priest,discipline,12,7,5
Pattie,ragnaros,672,priest,discipline,12,7,5
Choron,kult-der-verdammten,672,priest,discipline,12,7,5
Swd,dun-morogh,672,priest,discipline,12,7,5
Smiteweaver,drakthul,672,priest,discipline,12,7,5
Wyrofear,ragnaros,672,priest,discipline,12,7,5
Longheals,stormscale,672,priest,discipline,12,7,5
Bunnygxrl,ravencrest,672,priest,discipline,12,7,5
Nightsøul,ragnaros,672,priest,discipline,12,7,5
Lèss,ysondre,672,priest,discipline,12,7,5
Sydnex,blackmoore,672,priest,discipline,12,7,5
Healicious,teldrassil,672,priest,discipline,12,7,5
Durness,argent-dawn,672,priest,discipline,12,7,5
Fåtkidx,ravencrest,672,priest,discipline,12,7,5
Grzmocillaa,burning-legion,672,priest,discipline,12,7,5
Furtnajebany,tarren-mill,672,priest,discipline,12,7,5
Xians,alakir,672,priest,discipline,12,7,5
Striderz,outland,672,priest,discipline,12,7,5
Iloveilka,madmortem,672,priest,discipline,12,7,5
Bebydaniwey,eredar,672,priest,discipline,12,7,5
Anyndra,twisting-nether,672,priest,discipline,12,7,5
Dealtime,ysondre,672,priest,discipline,12,7,5
Rêstlêss,blackrock,672,priest,discipline,12,7,5
Fkitweball,argent-dawn,672,priest,discipline,12,7,5
Feniyxa,die-aldor,672,priest,discipline,12,7,5
Dombili,frostmane,672,priest,discipline,12,7,5
Magiclands,twisting-nether,672,priest,discipline,12,7,5
Arjak,stormscale,672,priest,discipline,12,7,5
Gudjon,dragonblight,672,priest,discipline,12,7,5
Vicwix,draenor,672,priest,discipline,12,7,5
Xourin,blackrock,672,priest,discipline,16,8,8
Soziy,silvermoon,672,priest,discipline,15,7,8
Ominoushell,twisting-nether,672,priest,discipline,15,7,8
Halysis,chamber-of-aspects,672,priest,discipline,16,7,9
Cház,sanguino,672,priest,discipline,18,7,11
Опрометчивый,soulflayer,672,priest,discipline,18,7,11
Kurt,blackrock,672,priest,discipline,18,7,11
Bij,outland,672,priest,discipline,18,7,11
Wifta,ravencrest,672,priest,discipline,18,7,11
Priszt,arathor,672,priest,discipline,18,7,11
Undeadpriest,aegwynn,672,priest,discipline,18,7,11
Bubblebuddy,draenor,672,priest,discipline,18,7,11
Nancey,draenor,672,priest,discipline,18,7,11
Nidetha,draenor,672,priest,discipline,18,7,11
Zërøx,ysondre,672,priest,discipline,18,7,11
Träskfarfar,tarren-mill,672,priest,discipline,18,7,11
Mythasz,archimonde,672,priest,discipline,18,7,11
Faithz,ragnaros,672,priest,discipline,18,7,11
Ðanilosp,dun-modr,672,priest,discipline,18,7,11
Skinandbones,sylvanas,672,priest,discipline,24,7,17
Ptrspriest,twisting-nether,672,priest,discipline,24,7,17
Exaneo,ragnaros,672,priest,discipline,24,7,17
Hónòr,sylvanas,672,priest,discipline,24,7,17
Сайларс,howling-fjord,671,priest,discipline,12,7,5
Balhlin,argent-dawn,671,priest,discipline,12,7,5
Ylivoima,stormscale,671,priest,discipline,12,7,5
Quecum,draenor,671,priest,discipline,12,7,5
Эски,howling-fjord,671,priest,discipline,12,7,5
Saltfeskball,tarren-mill,671,priest,discipline,12,7,5
Sokratina,ragnaros,671,priest,discipline,12,7,5
Xvpr,trollbane,671,priest,discipline,12,7,5
Chokmâh,sanguino,671,priest,discipline,12,7,5
Aiewn,elune,671,priest,discipline,12,7,5
Ezhealing,ravencrest,671,priest,discipline,12,7,5
Ballsbrawlz,sylvanas,671,priest,discipline,12,7,5
Fargall,eonar,671,priest,discipline,12,7,5
Bromine,twisting-nether,671,priest,discipline,12,7,5
Rines,thrall,671,priest,discipline,12,7,5
Aeritha,blackmoore,671,priest,discipline,12,7,5
Gagai,ravencrest,671,priest,discipline,12,7,5
Phoskitos,sanguino,671,priest,discipline,12,7,5
Helikipope,kazzak,671,priest,discipline,12,7,5
Diarolz,sanguino,671,priest,discipline,12,7,5
Xharyo,ravencrest,671,priest,discipline,16,7,9
Sebatröz,ravencrest,671,priest,discipline,18,7,11
Lezz,ragnaros,671,priest,discipline,18,7,11
Zïn,silvermoon,671,priest,discipline,18,7,11
Lillaego,ragnaros,671,priest,discipline,18,7,11
Рукатёмная,soulflayer,671,priest,discipline,18,7,11
Cúrt,sanguino,671,priest,discipline,18,7,11
Viì,ravencrest,671,priest,discipline,18,7,11
Elusivv,blackhand,671,priest,discipline,18,7,11
Ministry,tirion,671,priest,discipline,18,7,11
Zatón,dun-modr,671,priest,discipline,24,7,17
Fathermaxii,stormrage,670,priest,discipline,12,7,5
Clua,draenor,670,priest,discipline,12,7,5
Orqz,anetheron,670,priest,discipline,12,7,5
Хемех,soulflayer,670,priest,discipline,12,7,5
Arenarooky,eredar,670,priest,discipline,12,7,5
Asolan,drakthul,670,priest,discipline,18,7,11
Olikharma,archimonde,670,priest,discipline,18,7,11
Makkalisser,kazzak,670,priest,discipline,24,7,17
Johnnypleb,blackrock,669,priest,discipline,12,7,5
Prognosis,frostwhisper,669,priest,discipline,12,7,5
Belithia,argent-dawn,669,priest,discipline,12,7,5
Sytrix,frostwolf,669,priest,discipline,12,7,5
Enlîl,zuljin,669,priest,discipline,12,7,5
Sadira,malganis,669,priest,discipline,18,7,11
Rhåenyra,ravencrest,668,priest,discipline,12,7,5
Абсорберша,gordunni,668,priest,discipline,12,7,5
Mescaminator,blackmoore,668,priest,discipline,18,7,11
Lacaena,deathwing,668,priest,discipline,18,7,11
Míjagí,blackhand,668,priest,discipline,22,8,14
Crazyhemsire,twisting-nether,667,priest,discipline,12,7,5
Stigy,auchindoun,667,priest,discipline,18,7,11
Sadkitten,sylvanas,667,priest,discipline,18,7,11
Avor,hellfire,665,priest,discipline,12,7,5
Rhésùs,archimonde,664,priest,discipline,12,7,5
Buzzard,frostmourne,662,priest,discipline,12,7,5
Ãbømînåtîøn,blackrock,660,priest,discipline,12,7,5
Redøm,stormreaver,655,priest,discipline,18,8,10
Søb,silvermoon,655,priest,discipline,23,7,16
Dapope,drakthul,639,priest,discipline,17,7,10
Voidwaffel,blackmoore,638,priest,discipline,14,8,6
Rulz,zuluhed,636,priest,discipline,17,7,10
Sigor,hellfire,634,priest,discipline,11,7,4
Nomorelight,stormscale,634,priest,discipline,26,8,18
Ysteriagødx,twisting-nether,624,priest,discipline,15,8,7
Submexoxo,archimonde,624,priest,discipline,15,7,8
Darknun,aggra-português,623,priest,discipline,17,7,10
Luxumbra,quelthalas,623,priest,discipline,21,8,13
Darktattoo,twisting-nether,621,priest,discipline,21,8,13
Voilencia,kazzak,620,priest,discipline,21,7,14
Lacrum,ragnaros,613,priest,discipline,14,8,6
Dush,draenor,607,priest,discipline,11,7,4
Atibarát,hellfire,605,priest,discipline,16,7,9
Diccen,twilights-hammer,592,priest,discipline,13,7,6
Andhoras,dalaran,591,priest,discipline,11,7,4
Holytopp,aegwynn,576,priest,discipline,6,6,0
Vèrcs,silvermoon,576,priest,discipline,6,6,0
Pouffi,garona,576,priest,discipline,6,6,0
Táliss,arthas,576,priest,discipline,6,6,0
Vædan,drakthul,576,priest,discipline,6,6,0
Dotmaker,sanguino,576,priest,discipline,12,6,6
Ènma,archimonde,576,priest,discipline,12,6,6
Sensimiya,dalaran,576,priest,discipline,12,6,6
Supernal,twisting-nether,576,priest,discipline,12,6,6
Trickyteè,tarren-mill,576,priest,discipline,12,6,6
Rylpriest,blackmoore,576,priest,discipline,12,6,6
Angrypiex,stormscale,576,priest,discipline,12,6,6
Jämar,archimonde,576,priest,discipline,12,6,6
Velri,runetotem,576,priest,discipline,12,6,6
Tyrhaa,blackmoore,576,priest,discipline,12,6,6
Bebwaz,kazzak,576,priest,discipline,12,6,6
Saitani,stormscale,576,priest,discipline,12,6,6
Legitha,blackmoore,576,priest,discipline,12,6,6
Melcarth,blades-edge,576,priest,discipline,12,6,6
Tutoress,stormscale,576,priest,discipline,12,6,6
Popor,archimonde,576,priest,discipline,12,6,6
Hunfall,stormscale,576,priest,discipline,12,6,6
Mitasdi,stormscale,576,priest,discipline,12,6,6
Animalrescue,draenor,576,priest,discipline,12,6,6
Ðèvì,ravencrest,576,priest,discipline,12,6,6
Fléxéd,burning-legion,576,priest,discipline,12,6,6
Nyxara,outland,576,priest,discipline,12,6,6
Artist,outland,576,priest,discipline,12,6,6
Ballarr,burning-legion,576,priest,discipline,12,6,6
Intentoso,nemesis,576,priest,discipline,12,6,6
Randmbare,nemesis,576,priest,discipline,12,6,6
Shadowzrip,twilights-hammer,576,priest,discipline,12,6,6
Родохрозит,blackscar,576,priest,discipline,12,6,6
Йодтс,soulflayer,576,priest,discipline,12,6,6
Størmblaze,stormreaver,576,priest,discipline,12,6,6
Nelyø,destromath,576,priest,discipline,12,6,6
Swkunz,dun-modr,576,priest,discipline,12,6,6
Msbald,shattered-hand,576,priest,discipline,12,6,6
Boysa,earthen-ring,576,priest,discipline,12,6,6
Chalecø,dun-modr,576,priest,discipline,12,6,6
Velosp,defias-brotherhood,576,priest,discipline,12,6,6
Utsuro,stormscale,576,priest,discipline,12,6,6
Jacknapier,kazzak,576,priest,discipline,12,6,6
Ranagöl,ragnaros,576,priest,discipline,12,6,6
Krokkete,hyjal,576,priest,discipline,12,6,6
Lowery,argent-dawn,576,priest,discipline,12,6,6
Donvyto,blackmoore,576,priest,discipline,12,6,6
Vulreth,culte-de-la-rive-noire,576,priest,discipline,12,6,6
Далайна,galakrond,576,priest,discipline,12,6,6
Сосиска,deathguard,576,priest,discipline,12,6,6
Monataamis,kazzak,576,priest,discipline,12,6,6
Zyreenx,blackrock,576,priest,discipline,12,6,6
Дакимакурах,gordunni,576,priest,discipline,12,6,6
Kankstery,kazzak,576,priest,discipline,12,6,6
Äliénør,khaz-modan,576,priest,discipline,12,6,6
Fästrak,dalaran,576,priest,discipline,12,6,6
Sheeash,kazzak,576,priest,discipline,12,6,6
Lapinvicieux,archimonde,576,priest,discipline,12,6,6
Yroe,gorgonnash,576,priest,discipline,12,6,6
Dunkelseele,ahnqiraj,576,priest,discipline,12,6,6
Dõrà,ravencrest,576,priest,discipline,12,6,6
Papynou,garona,576,priest,discipline,12,6,6
Rmpriest,blackhand,576,priest,discipline,12,6,6
Yro,gorgonnash,576,priest,discipline,12,6,6
Artìst,ravencrest,576,priest,discipline,12,6,6
Stuhlgänger,blackhand,576,priest,discipline,12,6,6
Seemywatch,ungoro,576,priest,discipline,12,6,6
Rune,ravencrest,576,priest,discipline,12,6,6
Ryyne,ravencrest,576,priest,discipline,12,6,6
Stee,sylvanas,576,priest,discipline,12,6,6
Axewound,neptulon,576,priest,discipline,13,6,7
Mxcey,ravencrest,576,priest,discipline,18,6,12
Disillusíon,tarren-mill,576,priest,discipline,18,6,12
Noukeé,blackrock,576,priest,discipline,18,6,12
Ilovelily,antonidas,576,priest,discipline,18,6,12
Alros,elune,576,priest,discipline,18,6,12
Devastris,ravencrest,576,priest,discipline,18,6,12
Frida,blackrock,576,priest,discipline,18,6,12
Kîlo,sylvanas,576,priest,discipline,18,6,12
Gimeurgold,aegwynn,576,priest,discipline,18,6,12
Omnissiiah,silvermoon,576,priest,discipline,18,6,12
Bochonok,stormrage,576,priest,discipline,18,6,12
Eclaír,blackhand,576,priest,discipline,18,6,12
Yoloswaglørd,blackmoore,576,priest,discipline,18,6,12
Artymox,sylvanas,576,priest,discipline,18,6,12
Pierrebourne,blackmoore,576,priest,discipline,18,6,12
Cinjá,thrall,576,priest,discipline,19,6,13
Klugzy,silvermoon,576,priest,discipline,24,6,18
Sørney,aegwynn,575,priest,discipline,9,7,2
Юбич,soulflayer,575,priest,discipline,12,6,6
Elfdarkholme,stormscale,575,priest,discipline,12,6,6
Hâmmel,blackrock,575,priest,discipline,12,6,6
Handmännchen,kelthuzad,575,priest,discipline,12,6,6
Hensynsløs,draenor,575,priest,discipline,12,6,6
Фионыч,blackscar,575,priest,discipline,12,6,6
Lichtl,ysera,575,priest,discipline,12,6,6
Zaradana,tarren-mill,575,priest,discipline,12,6,6
Ðotgød,nemesis,575,priest,discipline,12,6,6
Ostberger,twisting-nether,575,priest,discipline,12,6,6
Insicompany,antonidas,575,priest,discipline,12,6,6
Zembowae,drakthul,575,priest,discipline,12,6,6
Priestvnr,hyjal,575,priest,discipline,12,6,6
Zák,sylvanas,575,priest,discipline,12,6,6
Darkweed,twilights-hammer,575,priest,discipline,12,6,6
Hmanco,burning-legion,575,priest,discipline,12,6,6
Makariotatos,xavius,575,priest,discipline,12,6,6
Hidr,nemesis,575,priest,discipline,12,6,6
Empí,sanguino,575,priest,discipline,12,6,6
Чикхоп,blackscar,575,priest,discipline,12,6,6
Bauscia,nemesis,575,priest,discipline,12,6,6
Lillthya,kazzak,575,priest,discipline,12,6,6
Hypnòz,archimonde,575,priest,discipline,12,6,6
Tira,darksorrow,575,priest,discipline,12,6,6
Flackiepi,tarren-mill,575,priest,discipline,12,6,6
Kipnuggetz,burning-legion,575,priest,discipline,12,6,6
Nimuëh,ragnaros,575,priest,discipline,16,7,9
Priestbiyy,sunstrider,575,priest,discipline,18,6,12
Juco,draenor,575,priest,discipline,18,6,12
Вэстервилли,howling-fjord,575,priest,discipline,24,6,18
Draenera,silvermoon,574,priest,discipline,12,6,6
Vebuya,blackmoore,574,priest,discipline,12,6,6
Leonard,nemesis,574,priest,discipline,12,6,6
Nygel,kazzak,574,priest,discipline,12,6,6
Tindoriel,bronzebeard,574,priest,discipline,12,6,6
Muftl,thrall,574,priest,discipline,18,6,12
Prigart,sylvanas,574,priest,discipline,18,6,12
Nerul,twisting-nether,574,priest,discipline,19,6,13
Kreem,frostmane,573,priest,discipline,12,6,6
Камшотхил,gordunni,573,priest,discipline,18,6,12
Timmemeep,outland,572,priest,discipline,12,6,6
Loriny,ragnaros,572,priest,discipline,14,6,8
Glutenhode,stormscale,571,priest,discipline,12,6,6
Äwësömë,aggra-português,571,priest,discipline,12,6,6
Германий,deathguard,558,priest,discipline,17,6,11
Ünholy,burning-legion,556,priest,discipline,17,6,11
Massdispell,silvermoon,543,priest,discipline,16,6,10
Lemowae,doomhammer,542,priest,discipline,22,6,16
Stormééz,bronzebeard,541,priest,discipline,26,7,19
Leahx,dalvengyr,527,priest,discipline,11,6,5
Gailiugà,kazzak,527,priest,discipline,11,6,5
Healsquad,draenor,524,priest,discipline,20,6,14
Triuna,sylvanas,522,priest,discipline,17,8,9
Demmi,dun-modr,522,priest,discipline,22,7,15
Полуниця,galakrond,522,priest,discipline,23,7,16
Xotz,thrall,521,priest,discipline,15,8,7
Gandzaa,silvermoon,521,priest,discipline,15,6,9
Cummask,silvermoon,512,priest,discipline,16,6,10
Tepevelf,dun-modr,512,priest,discipline,22,6,16
Никорете,soulflayer,511,priest,discipline,11,6,5
Thimble,blackhand,510,priest,discipline,14,6,8
Teyranamin,defias-brotherhood,496,priest,discipline,7,6,1
Sorchad,hyjal,480,priest,discipline,6,5,1
Trntypr,senjin,480,priest,discipline,6,5,1
Loldisc,arthas,480,priest,discipline,6,5,1
Docpower,twisting-nether,480,priest,discipline,6,5,1
Sethp,hyjal,480,priest,discipline,6,5,1
Ronnmoss,defias-brotherhood,480,priest,discipline,6,5,1
Svistis,ravencrest,480,priest,discipline,6,5,1
Lamp,terokkar,480,priest,discipline,6,5,1
Ounxx,blackrock,480,priest,discipline,6,5,1
Shieldyblaze,frostwolf,480,priest,discipline,6,5,1
Whopzi,blackmoore,480,priest,discipline,6,5,1
Paìnz,blackhand,480,priest,discipline,6,5,1
Trippinorbs,stormscale,480,priest,discipline,6,5,1
Sloee,kazzak,480,priest,discipline,6,5,1
Moonacky,bronze-dragonflight,480,priest,discipline,6,5,1
Noodlesoup,daggerspine,480,priest,discipline,6,5,1
Yungmazikeen,archimonde,480,priest,discipline,6,5,1
Boltygnome,blades-edge,480,priest,discipline,6,5,1
Pollution,ragnaros,480,priest,discipline,6,5,1
Nayballistic,tarren-mill,480,priest,discipline,6,5,1
Rixfoulah,ysondre,480,priest,discipline,6,5,1
Swep,ragnaros,480,priest,discipline,6,5,1
Nttyfromohio,ravencrest,480,priest,discipline,6,5,1
Нэриэлл,gordunni,480,priest,discipline,6,5,1
Hexybtw,stormscale,480,priest,discipline,6,5,1
Гачидварфич,gordunni,480,priest,discipline,6,5,1
Bec,ragnaros,480,priest,discipline,6,5,1
Eladri,silvermoon,480,priest,discipline,6,5,1
Katsikatsika,silvermoon,480,priest,discipline,12,5,7
Litera,silvermoon,480,priest,discipline,12,5,7
Уер,galakrond,480,priest,discipline,12,5,7
Kaiikoo,ravencrest,480,priest,discipline,12,5,7
Baptized,baelgun,480,priest,discipline,12,5,7
Magthalor,twisting-nether,480,priest,discipline,12,5,7
Roylian,ravencrest,480,priest,discipline,12,5,7
Medivs,blackmoore,480,priest,discipline,12,5,7
Donbas,tarren-mill,480,priest,discipline,12,5,7
Tarana,mannoroth,480,priest,discipline,12,5,7
Yukîna,blackrock,480,priest,discipline,12,5,7
Nyù,kazzak,480,priest,discipline,12,5,7
Вайтбласт,howling-fjord,480,priest,discipline,12,5,7
Саксесфул,howling-fjord,480,priest,discipline,12,5,7
Swiftdemise,sylvanas,480,priest,discipline,12,5,7
Nayballsp,tarren-mill,480,priest,discipline,12,5,7
Allaría,bronze-dragonflight,480,priest,discipline,12,5,7
Seankingkong,ravencrest,480,priest,discipline,12,5,7
Hyonra,kazzak,480,priest,discipline,12,5,7
Bejud,tarren-mill,480,priest,discipline,12,5,7
Chaapsbbq,archimonde,480,priest,discipline,12,5,7
Paterfisl,ragnaros,480,priest,discipline,12,5,7
Bibleenjoyer,blackmoore,480,priest,discipline,12,5,7
Sbj,bronze-dragonflight,480,priest,discipline,12,5,7
Doncamïllo,blackrock,480,priest,discipline,12,5,7
Shadew,stormscale,480,priest,discipline,12,5,7
Grozozo,tarren-mill,480,priest,discipline,12,5,7
Kaleshiry,kazzak,480,priest,discipline,12,5,7
Suaakypriest,tyrande,480,priest,discipline,12,5,7
Fabuliciøus,blackrock,480,priest,discipline,12,5,7
Holysjodin,tarren-mill,480,priest,discipline,12,5,7
Hollylicious,kazzak,480,priest,discipline,12,5,7
Porklifer,tarren-mill,480,priest,discipline,12,5,7
Azrella,ravencrest,480,priest,discipline,12,5,7
Seskipr,stormreaver,480,priest,discipline,12,5,7
Meheal,lothar,480,priest,discipline,12,5,7
Pwsx,draenor,480,priest,discipline,12,5,7
Madkes,ravencrest,480,priest,discipline,12,5,7
Coqa,blackrock,480,priest,discipline,12,5,7
Абсорбиболь,howling-fjord,480,priest,discipline,12,5,7
Borgamor,frostmane,480,priest,discipline,12,5,7
Døtzillah,kazzak,480,priest,discipline,12,5,7
Epa,zuljin,480,priest,discipline,12,5,7
Discgødx,thrall,480,priest,discipline,12,5,7
Mayday,silvermoon,480,priest,discipline,12,5,7
Navihato,silvermoon,480,priest,discipline,12,5,7
Тенсаи,howling-fjord,480,priest,discipline,12,5,7
Lunatrix,sanguino,480,priest,discipline,12,5,7
Fainttnt,stormscale,480,priest,discipline,12,5,7
Джахия,soulflayer,480,priest,discipline,12,5,7
Floorpovx,blackmoore,480,priest,discipline,12,5,7
Yö,stormscale,480,priest,discipline,12,5,7
Jeboc,ravencrest,480,priest,discipline,12,5,7
Bimbax,dun-modr,480,priest,discipline,12,5,7
Ameja,sylvanas,480,priest,discipline,13,5,8
Карбонит,fordragon,480,priest,discipline,18,5,13
Ча,thermaplugg,480,priest,discipline,18,5,13
Chekkó,blackrock,480,priest,discipline,18,5,13
Äkvä,ragnaros,480,priest,discipline,18,5,13
Taimani,burning-legion,480,priest,discipline,18,5,13
Володябигуди,howling-fjord,480,priest,discipline,18,5,13
Valirda,twisting-nether,480,priest,discipline,18,5,13
Góli,argent-dawn,480,priest,discipline,18,5,13
Faouzia,argent-dawn,480,priest,discipline,18,5,13
Clergy,nagrand,479,priest,discipline,6,5,1
Perxonx,twisting-nether,479,priest,discipline,6,5,1
Elpitiimigré,sinstralis,479,priest,discipline,6,5,1
Helming,magtheridon,479,priest,discipline,12,5,7
Piotrek,hyjal,479,priest,discipline,12,5,7
Shyvannas,antonidas,479,priest,discipline,12,5,7
Pluf,nefarian,479,priest,discipline,12,5,7
Дэйвора,ashenvale,479,priest,discipline,12,5,7
Texstil,blackmoore,479,priest,discipline,12,5,7
Velenthan,stormrage,479,priest,discipline,12,5,7
Cobrix,nemesis,479,priest,discipline,12,5,7
Bòóny,ravencrest,479,priest,discipline,12,5,7
Sewerperson,doomhammer,479,priest,discipline,12,5,7
Vecaya,blackrock,479,priest,discipline,12,5,7
Calenberhtil,burning-legion,479,priest,discipline,12,5,7
Konantenshi,doomhammer,479,priest,discipline,12,5,7
Slight,aggra-português,479,priest,discipline,12,5,7
Tumlaa,ravencrest,479,priest,discipline,12,5,7
Røläck,ragnaros,479,priest,discipline,12,5,7
Шпалкоклоб,soulflayer,479,priest,discipline,12,5,7
Velenthøs,argent-dawn,479,priest,discipline,12,5,7
Stmichael,silvermoon,479,priest,discipline,14,5,9
Quepimquepam,tarren-mill,479,priest,discipline,18,5,13
Aká,kazzak,479,priest,discipline,18,5,13
Antiexhile,kazzak,479,priest,discipline,18,5,13
Seehz,ysondre,479,priest,discipline,18,5,13
Sleeyz,blackmoore,479,priest,discipline,24,5,19
Ruebi,blackmoore,478,priest,discipline,12,5,7
Hotwheal,ysondre,478,priest,discipline,12,5,7
Oknelim,blackmoore,477,priest,discipline,12,5,7
Phosphorus,blackhand,476,priest,discipline,12,5,7
Feloriya,antonidas,476,priest,discipline,12,5,7
Lazzariah,ravencrest,475,priest,discipline,12,5,7
Rettsche,eredar,475,priest,discipline,12,5,7
Wipipi,draenor,474,priest,discipline,12,5,7
Spookyfive,blackhand,472,priest,discipline,26,8,18
Carcaz,blackmoore,463,priest,discipline,17,7,10
Приствалера,howling-fjord,463,priest,discipline,17,5,12
Drë,daggerspine,447,priest,discipline,11,5,6
Nioubèy,archimonde,447,priest,discipline,11,5,6
Dhed,turalyon,447,priest,discipline,14,6,8
Aykò,blackmoore,447,priest,discipline,14,6,8
Yazzyz,eredar,447,priest,discipline,17,5,12
Sandgambler,draenor,432,priest,discipline,9,5,4
Kak,gorgonnash,426,priest,discipline,19,6,13
Cestrial,sylvanas,415,priest,discipline,14,5,9
Holyheartx,argent-dawn,408,priest,discipline,22,6,16
Шруня,howling-fjord,400,priest,discipline,24,5,19
Кхарли,howling-fjord,384,priest,discipline,6,4,2
Ilovecala,ravencrest,384,priest,discipline,6,4,2
Mylox,blackrock,384,priest,discipline,6,4,2
Nesar,stormscale,384,priest,discipline,6,4,2
Reól,blackmoore,384,priest,discipline,6,4,2
Asýnc,ravencrest,384,priest,discipline,6,4,2
Luckystar,grim-batol,384,priest,discipline,6,4,2
Телоури,galakrond,384,priest,discipline,6,4,2
Daniweyy,eredar,384,priest,discipline,6,4,2
Бархомелфой,gordunni,384,priest,discipline,6,4,2
Dzyxx,ravencrest,384,priest,discipline,6,4,2
Papêrcut,kazzak,384,priest,discipline,6,4,2
Серью,booty-bay,384,priest,discipline,6,4,2
Hadk,blackrock,384,priest,discipline,6,4,2
Cheesegód,outland,384,priest,discipline,6,4,2
Pipperxp,ravencrest,384,priest,discipline,6,4,2
Healmebaby,kiljaeden,384,priest,discipline,6,4,2
Gimcho,magtheridon,384,priest,discipline,6,4,2
Frekko,outland,384,priest,discipline,6,4,2
Petitogré,silvermoon,384,priest,discipline,6,4,2
Buerak,tarren-mill,384,priest,discipline,6,4,2
Sebbi,ragnaros,384,priest,discipline,6,4,2
Priestutute,tarren-mill,384,priest,discipline,6,4,2
Petshopboi,sylvanas,384,priest,discipline,6,4,2
Thean,twilights-hammer,384,priest,discipline,6,4,2
Experimentix,silvermoon,384,priest,discipline,6,4,2
Nàlak,archimonde,384,priest,discipline,6,4,2
Büssi,blackrock,384,priest,discipline,6,4,2
Touchypunk,ravencrest,384,priest,discipline,6,4,2
Iirina,draenor,384,priest,discipline,6,4,2
Monstretpr,dragonblight,384,priest,discipline,6,4,2
Ghorfindel,kaelthas,384,priest,discipline,6,4,2
Смайтвайфу,howling-fjord,384,priest,discipline,6,4,2
Tâmshi,dun-modr,384,priest,discipline,6,4,2
Relaxmom,bloodhoof,384,priest,discipline,6,4,2
Above,hyjal,384,priest,discipline,6,4,2
Yukirito,drakthul,384,priest,discipline,6,4,2
Byzzi,draenor,384,priest,discipline,6,4,2
Badguymike,ragnaros,384,priest,discipline,6,4,2
Zumbae,tarren-mill,384,priest,discipline,6,4,2
Pínx,nerathor,384,priest,discipline,6,4,2
Rawelf,ravencrest,384,priest,discipline,6,4,2
Chilie,ravencrest,384,priest,discipline,6,4,2
Pankp,kazzak,384,priest,discipline,6,4,2
Ocastia,antonidas,384,priest,discipline,6,4,2
Zehakky,tarren-mill,384,priest,discipline,6,4,2
Шадия,ashenvale,384,priest,discipline,6,4,2
Neeti,kazzak,384,priest,discipline,6,4,2
Awön,stormscale,384,priest,discipline,6,4,2
Dødy,hyjal,384,priest,discipline,6,4,2
Babambaba,sylvanas,384,priest,discipline,6,4,2
Gorti,ravencrest,384,priest,discipline,6,4,2
Imaut,emerald-dream,384,priest,discipline,6,4,2
Piixld,aegwynn,384,priest,discipline,6,4,2
Sinîra,frostwolf,384,priest,discipline,6,4,2
Healinrbglol,blackmoore,384,priest,discipline,6,4,2
Schnîttchen,blackrock,384,priest,discipline,6,4,2
Woid,aegwynn,384,priest,discipline,6,4,2
Wixzyx,ravencrest,384,priest,discipline,10,4,6
Spezzato,nemesis,384,priest,discipline,12,4,8
Filtro,eredar,384,priest,discipline,12,4,8
Chigreru,uldum,384,priest,discipline,12,4,8
Rîîper,khaz-modan,384,priest,discipline,12,4,8
Jaywie,twisting-nether,384,priest,discipline,12,4,8
Lysium,sylvanas,384,priest,discipline,12,4,8
Сегуната,howling-fjord,384,priest,discipline,12,4,8
Stepsisstuck,ragnaros,384,priest,discipline,12,4,8
Deliâz,aegwynn,384,priest,discipline,12,4,8
Solerona,blackmoore,384,priest,discipline,12,4,8
Ankî,aegwynn,384,priest,discipline,12,4,8
Vicetøne,stormscale,384,priest,discipline,12,4,8
Melord,thunderhorn,384,priest,discipline,12,4,8
Absolution,stormscale,384,priest,discipline,12,4,8
Goatrocker,kazzak,384,priest,discipline,12,4,8
Шимату,howling-fjord,384,priest,discipline,12,4,8
Malíficent,draenor,384,priest,discipline,12,4,8
Luznywiesiek,burning-legion,384,priest,discipline,12,4,8
Sorrop,sanguino,384,priest,discipline,12,4,8
Touchmé,blackmoore,384,priest,discipline,12,4,8
Predpriest,twisting-nether,384,priest,discipline,12,4,8
Sweity,dun-modr,384,priest,discipline,12,4,8
Sabakk,archimonde,384,priest,discipline,12,4,8
Skyløl,dun-modr,384,priest,discipline,12,4,8
Euphorius,blackmoore,384,priest,discipline,12,4,8
Cadierna,argent-dawn,384,priest,discipline,12,4,8
Druzhok,sylvanas,384,priest,discipline,12,4,8
Mérce,kazzak,384,priest,discipline,12,4,8
Radiancekey,sanguino,384,priest,discipline,12,4,8
Lothbruke,twisting-nether,384,priest,discipline,12,4,8
Asdfsds,kazzak,384,priest,discipline,12,4,8
Fiilaaja,stormreaver,384,priest,discipline,12,4,8
Kimozabi,ravencrest,384,priest,discipline,12,4,8
Chocopríest,blackmoore,384,priest,discipline,12,4,8
Appox,amanthul,384,priest,discipline,12,4,8
Марина,howling-fjord,384,priest,discipline,12,4,8
Kalestharia,blackmoore,384,priest,discipline,12,4,8
Abrakahudder,tarren-mill,384,priest,discipline,12,4,8
Pnsl,dun-morogh,384,priest,discipline,12,4,8
Deathtrapx,draenor,384,priest,discipline,12,4,8
Toasttrii,outland,384,priest,discipline,12,4,8
Tsunadesaama,silvermoon,384,priest,discipline,12,4,8
Xaeroow,archimonde,384,priest,discipline,12,4,8
Bebsenpai,hyjal,384,priest,discipline,12,4,8
ßlowska,hyjal,384,priest,discipline,12,4,8
Bldnl,ragnaros,384,priest,discipline,12,4,8
Sweetxq,tarren-mill,384,priest,discipline,12,4,8
Пэйтен,deathguard,384,priest,discipline,12,4,8
Xayona,argent-dawn,384,priest,discipline,12,4,8
Asdfgfhtjy,stormscale,384,priest,discipline,12,4,8
Ревентонх,howling-fjord,384,priest,discipline,12,4,8
Mariio,blackmoore,384,priest,discipline,12,4,8
Заак,howling-fjord,384,priest,discipline,12,4,8
Сашашвд,howling-fjord,384,priest,discipline,12,4,8
Drdré,blackrock,384,priest,discipline,12,4,8
Сайлентхилл,howling-fjord,384,priest,discipline,12,4,8
Amèn,archimonde,384,priest,discipline,12,4,8
Celestias,sanguino,384,priest,discipline,15,4,11
Zeröone,silvermoon,384,priest,discipline,17,4,13
Blackwidow,chromaggus,384,priest,discipline,18,4,14
Dubai,silvermoon,384,priest,discipline,18,4,14
Sbubbi,ravencrest,384,priest,discipline,18,4,14
Пахад,blackscar,383,priest,discipline,6,4,2
Ravend,sylvanas,383,priest,discipline,6,4,2
Moonary,ravencrest,383,priest,discipline,6,4,2
Kinn,kaelthas,383,priest,discipline,6,4,2
Enchanttress,burning-legion,383,priest,discipline,6,4,2
Kelras,grim-batol,383,priest,discipline,6,4,2
Hðly,doomhammer,383,priest,discipline,6,4,2
Vishnoo,hyjal,383,priest,discipline,6,4,2
Miriàl,outland,383,priest,discipline,12,4,8
Patoroch,terokkar,383,priest,discipline,12,4,8
Jezlung,frostmane,383,priest,discipline,12,4,8
Søs,eldrethalas,383,priest,discipline,12,4,8
Bolíngbroke,argent-dawn,383,priest,discipline,18,4,14
Seiigops,ysondre,382,priest,discipline,6,4,2
Havanna,dethecus,382,priest,discipline,6,4,2
Camellight,stormscale,382,priest,discipline,12,4,8
Тэтсу,greymane,382,priest,discipline,12,4,8
Lierie,kazzak,382,priest,discipline,24,4,20
Grommyr,eredar,381,priest,discipline,12,4,8
Thanil,bloodfeather,367,priest,discipline,11,4,7
Tephutes,ravencrest,367,priest,discipline,11,4,7
Maskinjundre,bronzebeard,352,priest,discipline,10,4,6
Pjuww,outland,351,priest,discipline,11,4,7
Góldfinger,norgannon,351,priest,discipline,11,4,7
Doxxi,argent-dawn,336,priest,discipline,9,5,4
Salvatör,quelthalas,336,priest,discipline,15,5,10
Sneed,moonglade,335,priest,discipline,12,5,7
Vicønia,tarren-mill,335,priest,discipline,11,4,7
Runay,draenor,330,priest,discipline,13,5,8
Impmvp,kazzak,330,priest,discipline,17,6,11
Косн,razuvious,330,priest,discipline,16,5,11
Tyog,khazgoroth,320,priest,discipline,10,4,6
Кирюшасэмпай,gordunni,320,priest,discipline,10,4,6
Brainðead,aegwynn,319,priest,discipline,5,4,1
Enaches,twisting-nether,304,priest,discipline,7,4,3
Релакз,soulflayer,288,priest,discipline,6,3,3
Hængøver,blackmoore,288,priest,discipline,6,3,3
Rektom,archimonde,288,priest,discipline,6,3,3
Mahist,ravencrest,288,priest,discipline,6,3,3
Decimerad,kazzak,288,priest,discipline,6,3,3
Applepiez,ravencrest,288,priest,discipline,6,3,3
Indrades,blackmoore,288,priest,discipline,6,3,3
Neosix,sanguino,288,priest,discipline,6,3,3
Shyvi,ravencrest,288,priest,discipline,6,3,3
Zeuws,kazzak,288,priest,discipline,6,3,3
ßestworld,draenor,288,priest,discipline,6,3,3
Mindflayér,stormscale,288,priest,discipline,6,3,3
Spaghettoni,tarren-mill,288,priest,discipline,6,3,3
Acik,bladefist,288,priest,discipline,6,3,3
Sardine,ravencrest,288,priest,discipline,6,3,3
Psychout,ravencrest,288,priest,discipline,6,3,3
Henreita,darksorrow,288,priest,discipline,6,3,3
Krolox,blackhand,288,priest,discipline,6,3,3
Holytop,aegwynn,288,priest,discipline,6,3,3
Ribberull,darksorrow,288,priest,discipline,6,3,3
Elmaestrø,aegwynn,288,priest,discipline,6,3,3
Sapue,aegwynn,288,priest,discipline,6,3,3
Олдмэнсэйд,soulflayer,288,priest,discipline,6,3,3
Jazty,sanguino,288,priest,discipline,6,3,3
Микаса,howling-fjord,288,priest,discipline,6,3,3
Hampådenbååd,kazzak,288,priest,discipline,6,3,3
Hanagaki,ragnaros,288,priest,discipline,6,3,3
Эннхэтэуэй,soulflayer,288,priest,discipline,6,3,3
Fearxyz,aegwynn,288,priest,discipline,6,3,3
Чилюотферала,eversong,288,priest,discipline,6,3,3
Giatros,kazzak,288,priest,discipline,6,3,3
Confess,archimonde,288,priest,discipline,6,3,3
Felon,burning-legion,288,priest,discipline,6,3,3
Tzúú,ravencrest,288,priest,discipline,6,3,3
Argaar,burning-legion,288,priest,discipline,6,3,3
Fønss,sanguino,288,priest,discipline,6,3,3
Stahpit,twisting-nether,288,priest,discipline,6,3,3
Víd,dun-morogh,288,priest,discipline,6,3,3
Wontdispel,ravencrest,288,priest,discipline,6,3,3
Dezless,tarren-mill,288,priest,discipline,6,3,3
Ðopebwøy,burning-legion,288,priest,discipline,6,3,3
Sâmba,pozzo-delleternità,288,priest,discipline,6,3,3
Watchmepray,stormscale,288,priest,discipline,6,3,3
Palrins,dalaran,288,priest,discipline,6,3,3
Таравера,soulflayer,288,priest,discipline,6,3,3
Chayz,thrall,288,priest,discipline,6,3,3
Pristel,twisting-nether,288,priest,discipline,6,3,3
Deternity,stormscale,288,priest,discipline,6,3,3
Húlda,auchindoun,288,priest,discipline,6,3,3
Eyesønyou,nemesis,288,priest,discipline,6,3,3
Purpl,tarren-mill,288,priest,discipline,6,3,3
Bridélight,archimonde,288,priest,discipline,6,3,3
Haffination,frostmane,288,priest,discipline,6,3,3
Realdead,blackrock,288,priest,discipline,6,3,3
Makemyday,dun-modr,288,priest,discipline,6,3,3
Tyarande,tarren-mill,288,priest,discipline,6,3,3
Åtømîç,kazzak,288,priest,discipline,6,3,3
Eník,blackrock,288,priest,discipline,6,3,3
Noonex,hakkar,288,priest,discipline,6,3,3
ßøunty,dun-modr,288,priest,discipline,6,3,3
Santainphy,cthun,288,priest,discipline,6,3,3
Биркох,blackscar,288,priest,discipline,6,3,3
Nedex,thrall,288,priest,discipline,6,3,3
Ardeë,dun-modr,288,priest,discipline,6,3,3
Laradiel,dun-modr,288,priest,discipline,6,3,3
Cbbigbape,thrall,288,priest,discipline,6,3,3
Matiagmenh,stormscale,288,priest,discipline,6,3,3
Nexìan,ravencrest,288,priest,discipline,6,3,3
Àlucárd,blackhand,288,priest,discipline,6,3,3
Discobeb,les-clairvoyants,288,priest,discipline,6,3,3
Flet,emerald-dream,288,priest,discipline,6,3,3
Shadoxx,malganis,288,priest,discipline,6,3,3
Mallkie,ysondre,288,priest,discipline,6,3,3
Maikzky,stormreaver,288,priest,discipline,6,3,3
Hiimpinxî,ragnaros,288,priest,discipline,6,3,3
Gødisc,blackrock,288,priest,discipline,6,3,3
Психоз,gordunni,288,priest,discipline,6,3,3
Byshadow,silvermoon,288,priest,discipline,6,3,3
Moistmidget,frostmane,288,priest,discipline,6,3,3
Hôtseitdank,blackrock,288,priest,discipline,6,3,3
Iløvelena,ravencrest,288,priest,discipline,6,3,3
Hôllÿ,ysondre,288,priest,discipline,6,3,3
Куольхд,gordunni,288,priest,discipline,6,3,3
Deathspren,stormscale,288,priest,discipline,6,3,3
Milderyp,kazzak,288,priest,discipline,6,3,3
Ríeka,proudmoore,288,priest,discipline,6,3,3
Nefufangirl,ravencrest,288,priest,discipline,6,3,3
Semagdnim,aggra-português,288,priest,discipline,6,3,3
Kamiðßlesing,sanguino,288,priest,discipline,6,3,3
Батлджес,gordunni,288,priest,discipline,6,3,3
Vaurork,stormscale,288,priest,discipline,6,3,3
Аридел,ashenvale,288,priest,discipline,6,3,3
Aasgard,frostwolf,288,priest,discipline,6,3,3
Jaylove,frostwolf,288,priest,discipline,6,3,3
Löspajen,stormscale,288,priest,discipline,6,3,3
Саммерфинн,gordunni,288,priest,discipline,6,3,3
Jp,gorgonnash,288,priest,discipline,6,3,3
Фруктовыйса,gordunni,288,priest,discipline,6,3,3
Maiel,die-aldor,288,priest,discipline,6,3,3
Eros,illidan,288,priest,discipline,6,3,3
Mariahscarey,blackhand,288,priest,discipline,6,3,3
Нагп,gordunni,288,priest,discipline,6,3,3
Justjuice,hyjal,288,priest,discipline,6,3,3
Iyannà,blackrock,288,priest,discipline,6,3,3
Makrophage,mannoroth,288,priest,discipline,6,3,3
Ashuramaru,drakthul,288,priest,discipline,6,3,3
Шлёндрик,gordunni,288,priest,discipline,6,3,3
Paphahaha,ragnaros,288,priest,discipline,6,3,3
ßrûm,archimonde,288,priest,discipline,6,3,3
Rhàenyra,ravencrest,288,priest,discipline,6,3,3
Shììnx,hyjal,288,priest,discipline,6,3,3
Challengepro,burning-legion,288,priest,discipline,6,3,3
Eldrathir,burning-legion,288,priest,discipline,6,3,3
Imprøved,outland,288,priest,discipline,6,3,3
Qpops,twisting-nether,288,priest,discipline,6,3,3
Lolipopheal,blackmoore,288,priest,discipline,6,3,3
Xyfas,azshara,288,priest,discipline,6,3,3
Drennaria,draenor,288,priest,discipline,6,3,3
Ònasou,silvermoon,288,priest,discipline,6,3,3
Pietyberi,tichondrius,288,priest,discipline,6,3,3
Qzrx,draenor,288,priest,discipline,6,3,3
Immutable,twisting-nether,288,priest,discipline,6,3,3
Holycowheals,the-maelstrom,288,priest,discipline,6,3,3
Kapts,twisting-nether,288,priest,discipline,6,3,3
Delinsx,outland,288,priest,discipline,6,3,3
Velanrous,kazzak,288,priest,discipline,6,3,3
Windieqt,drakthul,288,priest,discipline,6,3,3
Preodek,kazzak,288,priest,discipline,6,3,3
Starships,kazzak,288,priest,discipline,6,3,3
Moppriest,twisting-nether,288,priest,discipline,6,3,3
Dumix,shadowsong,288,priest,discipline,6,3,3
Deppara,twisting-nether,288,priest,discipline,6,3,3
Ансор,lich-king,288,priest,discipline,6,3,3
Bigdamsmitex,draenor,288,priest,discipline,6,3,3
Mariahcarey,blackmoore,288,priest,discipline,6,3,3
Depleeky,blackmoore,288,priest,discipline,6,3,3
Nasirjones,outland,288,priest,discipline,6,3,3
Zikár,kazzak,288,priest,discipline,6,3,3
Disfinkacze,drakthul,288,priest,discipline,6,3,3
Azazzel,nathrezim,288,priest,discipline,6,3,3
Effot,twisting-nether,288,priest,discipline,6,3,3
Mamabeer,draenor,288,priest,discipline,9,4,5
Leyasu,eredar,288,priest,discipline,10,4,6
Barbiemeth,silvermoon,288,priest,discipline,16,5,11
Maybeexp,ravencrest,288,priest,discipline,12,3,9
Ælæx,alleria,288,priest,discipline,12,3,9
Shockpriest,grim-batol,288,priest,discipline,12,3,9
Tazting,stormscale,288,priest,discipline,12,3,9
Kilmin,ravencrest,288,priest,discipline,12,3,9
Yzina,archimonde,288,priest,discipline,12,3,9
Kalamh,marécage-de-zangar,288,priest,discipline,12,3,9
Djezà,archimonde,288,priest,discipline,12,3,9
Nyxém,blackmoore,288,priest,discipline,12,3,9
Sins,defias-brotherhood,288,priest,discipline,12,3,9
Malaboost,archimonde,288,priest,discipline,12,3,9
Anadyia,aegwynn,288,priest,discipline,12,3,9
Piitixd,burning-legion,288,priest,discipline,12,3,9
Honompa,darkmoon-faire,288,priest,discipline,12,3,9
Tsuser,blackrock,288,priest,discipline,12,3,9
Momomomomomo,aegwynn,288,priest,discipline,12,3,9
Nuriva,frostmane,288,priest,discipline,12,3,9
Tubercurass,hyjal,288,priest,discipline,12,3,9
Dooga,draenor,288,priest,discipline,12,3,9
Knobibobby,blackrock,288,priest,discipline,12,3,9
Dizzaer,terokkar,288,priest,discipline,12,3,9
Moth,kazzak,288,priest,discipline,12,3,9
Kitazu,draenor,288,priest,discipline,12,3,9
Âlígés,outland,288,priest,discipline,12,3,9
Blasfemo,nemesis,288,priest,discipline,12,3,9
Yaaoz,dun-modr,288,priest,discipline,12,3,9
Toratorap,burning-legion,288,priest,discipline,12,3,9
Biierlip,twisting-nether,288,priest,discipline,12,3,9
Senza,ysondre,288,priest,discipline,12,3,9
Raî,durotan,288,priest,discipline,12,3,9
Výra,der-rat-von-dalaran,288,priest,discipline,12,3,9
Chabih,ravencrest,288,priest,discipline,12,3,9
Crazyhealsqt,hellfire,288,priest,discipline,12,3,9
Choosunghoon,silvermoon,288,priest,discipline,12,3,9
Летиин,gordunni,288,priest,discipline,12,3,9
Èlvis,dun-morogh,288,priest,discipline,12,3,9
Ðènnis,argent-dawn,288,priest,discipline,12,3,9
Fluxyqt,ravencrest,288,priest,discipline,12,3,9
Венэма,azuregos,288,priest,discipline,12,3,9
Arathelle,chromaggus,288,priest,discipline,12,3,9
Sarinà,archimonde,288,priest,discipline,18,3,15
Попячебрило,gordunni,287,priest,discipline,6,3,3
Hulluh,tarren-mill,287,priest,discipline,6,3,3
Xkv,blackmoore,287,priest,discipline,6,3,3
Pontifex,baelgun,287,priest,discipline,6,3,3
Rhanira,aegwynn,287,priest,discipline,6,3,3
Sacabocaos,dun-modr,287,priest,discipline,12,3,9
Tíffanny,ragnaros,287,priest,discipline,12,3,9
Eritreea,stormscale,287,priest,discipline,12,3,9
Elraine,ravencrest,287,priest,discipline,12,3,9
Rotems,korgall,287,priest,discipline,12,3,9
Orioz,tarren-mill,287,priest,discipline,12,3,9
Willibad,executus,286,priest,discipline,6,3,3
Kårejonny,tarren-mill,275,priest,discipline,13,6,7
Alphakillerz,sanguino,255,priest,discipline,11,3,8
Czee,draenor,255,priest,discipline,11,3,8
Zlothax,blackrock,255,priest,discipline,11,3,8
Sánta,blackmoore,240,priest,discipline,9,3,6
Iloa,dun-morogh,239,priest,discipline,5,3,2
Tyeldine,ragnaros,239,priest,discipline,9,4,5
Паратузов,gordunni,239,priest,discipline,29,3,26
Zargoss,sylvanas,234,priest,discipline,8,4,4
Paandosa,outland,234,priest,discipline,9,4,5
Sologrifer,sylvanas,234,priest,discipline,9,4,5
Katwizro,hyjal,234,priest,discipline,16,6,10
Mineshadow,argent-dawn,234,priest,discipline,11,4,7
Jael,frostmane,234,priest,discipline,14,4,10
Krakjak,twisting-nether,234,priest,discipline,15,4,11
Holybøi,ragnaros,234,priest,discipline,23,5,18
Shadowpeste,aggra-português,233,priest,discipline,11,4,7
Хилогайка,howling-fjord,233,priest,discipline,16,4,12
Flexelzz,argent-dawn,227,priest,discipline,18,6,12
Cultaken,kazzak,192,priest,discipline,4,3,1
Кфень,soulflayer,192,priest,discipline,4,3,1
Kopfsache,blackmoore,192,priest,discipline,6,2,4
Várósh,blackmoore,192,priest,discipline,6,2,4
Shaomi,eldrethalas,192,priest,discipline,6,2,4
Clastro,outland,192,priest,discipline,6,2,4
Tmnewho,outland,192,priest,discipline,6,2,4
Unreal,nagrand,192,priest,discipline,6,2,4
Ponting,kazzak,192,priest,discipline,6,2,4
Rickermortis,defias-brotherhood,192,priest,discipline,6,2,4
Terstyana,hyjal,192,priest,discipline,6,2,4
Pøh,kilrogg,192,priest,discipline,6,2,4
Draconux,terenas,192,priest,discipline,6,2,4
Coldxzera,tarren-mill,192,priest,discipline,6,2,4
Amayko,kazzak,192,priest,discipline,6,2,4
Doombrew,blackmoore,192,priest,discipline,6,2,4
Diva,malfurion,192,priest,discipline,6,2,4
Insufrible,minahonda,192,priest,discipline,6,2,4
Thehealer,twisting-nether,192,priest,discipline,6,2,4
Idén,quelthalas,192,priest,discipline,6,2,4
Gladíator,blackhand,192,priest,discipline,6,2,4
Рэпру,galakrond,192,priest,discipline,6,2,4
Uncleben,grim-batol,192,priest,discipline,6,2,4
Maquivel,aggra-português,192,priest,discipline,6,2,4
Tota,frostmane,192,priest,discipline,6,2,4
Titiqr,naxxramas,192,priest,discipline,6,2,4
Prodan,frostmane,192,priest,discipline,6,2,4
Missright,ragnaros,192,priest,discipline,6,2,4
Servaas,silvermoon,192,priest,discipline,6,2,4
Bigpinkballs,tarren-mill,192,priest,discipline,6,2,4
Chankro,sanguino,192,priest,discipline,6,2,4
Piedl,aegwynn,192,priest,discipline,6,2,4
Toxicx,aegwynn,192,priest,discipline,6,2,4
Shalabox,twisting-nether,192,priest,discipline,6,2,4
Stanyú,tarren-mill,192,priest,discipline,6,2,4
Døtgdx,archimonde,192,priest,discipline,6,2,4
Cctw,archimonde,192,priest,discipline,6,2,4
Jupiminaj,tarren-mill,192,priest,discipline,6,2,4
Hormgal,blackmoore,192,priest,discipline,6,2,4
Thyrandis,dragonblight,192,priest,discipline,6,2,4
Chrònos,das-konsortium,192,priest,discipline,6,2,4
Dqt,ragnaros,192,priest,discipline,6,2,4
Taschigi,rexxar,192,priest,discipline,6,2,4
Calah,frostwhisper,192,priest,discipline,6,2,4
Kironm,kazzak,192,priest,discipline,6,2,4
Soupana,darksorrow,192,priest,discipline,6,2,4
Kaamiluus,burning-legion,192,priest,discipline,6,2,4
Mlii,the-maelstrom,192,priest,discipline,6,2,4
Xýz,tarren-mill,192,priest,discipline,6,2,4
Tigrok,burning-legion,192,priest,discipline,6,2,4
Groaxx,ragnaros,192,priest,discipline,6,2,4
Zéró,gorgonnash,192,priest,discipline,6,2,4
Mehhx,burning-legion,192,priest,discipline,6,2,4
Sipriest,silvermoon,192,priest,discipline,6,2,4
Quintanaro,thrall,192,priest,discipline,6,2,4
Артфуул,howling-fjord,192,priest,discipline,6,2,4
Ægirl,chamber-of-aspects,192,priest,discipline,6,2,4
Anvena,elune,192,priest,discipline,6,2,4
Мэдмод,gordunni,192,priest,discipline,6,2,4
Aidkit,burning-legion,192,priest,discipline,6,2,4
Забейка,howling-fjord,192,priest,discipline,6,2,4
Hombre,anetheron,192,priest,discipline,6,2,4
Каэден,blackscar,192,priest,discipline,6,2,4
Zxø,ravencrest,192,priest,discipline,6,2,4
Adägïo,dun-modr,192,priest,discipline,6,2,4
Sazo,drakthul,192,priest,discipline,6,2,4
Колдунская,soulflayer,192,priest,discipline,6,2,4
Wumtris,ragnaros,192,priest,discipline,6,2,4
Shadowlander,dun-modr,192,priest,discipline,6,2,4
Артэта,blackscar,192,priest,discipline,6,2,4
Побьюкадилом,gordunni,192,priest,discipline,6,2,4
Calling,nozdormu,192,priest,discipline,6,2,4
Tofsy,stormscale,192,priest,discipline,6,2,4
Vanadii,blackhand,192,priest,discipline,6,2,4
Vadhänder,the-maelstrom,192,priest,discipline,6,2,4
Nekros,agamaggan,192,priest,discipline,6,2,4
Prîëstìtütê,doomhammer,192,priest,discipline,6,2,4
Grduebel,tirion,192,priest,discipline,6,2,4
Efflúx,ravencrest,192,priest,discipline,6,2,4
Ethylene,ysondre,192,priest,discipline,6,2,4
Vebbysor,sylvanas,192,priest,discipline,6,2,4
Soreboners,stormscale,192,priest,discipline,6,2,4
Nitroze,stormscale,192,priest,discipline,6,2,4
Phantombride,silvermoon,192,priest,discipline,6,2,4
Derathon,eredar,192,priest,discipline,6,2,4
Tinúvielle,dalaran,192,priest,discipline,6,2,4
Dîablø,eredar,192,priest,discipline,6,2,4
Skytheory,eredar,192,priest,discipline,6,2,4
Spectriums,twisting-nether,192,priest,discipline,6,2,4
Leønix,malfurion,192,priest,discipline,6,2,4
Elëctra,vashj,192,priest,discipline,6,2,4
Nálá,nethersturm,192,priest,discipline,6,2,4
Lirrydoz,ravencrest,192,priest,discipline,6,2,4
Illüminaty,sylvanas,192,priest,discipline,6,2,4
Fadehojwnabe,the-shatar,192,priest,discipline,6,2,4
Arctoczax,ravencrest,192,priest,discipline,6,2,4
Perrín,blackrock,192,priest,discipline,6,2,4
Rallzken,stormscale,192,priest,discipline,6,2,4
Ascindra,ravencrest,192,priest,discipline,6,2,4
Тейдехан,howling-fjord,192,priest,discipline,6,2,4
Alexwinkwink,kazzak,192,priest,discipline,6,2,4
Jøjmenejøj,ravencrest,192,priest,discipline,6,2,4
Malapriest,dalaran,192,priest,discipline,6,2,4
Pidarkgogo,stormscale,192,priest,discipline,6,2,4
Qku,ravencrest,192,priest,discipline,6,2,4
Tiefergelegt,arthas,192,priest,discipline,6,2,4
Ølle,ravencrest,192,priest,discipline,6,2,4
Ilovedomo,stormscale,192,priest,discipline,6,2,4
Tacøgxd,ravencrest,192,priest,discipline,6,2,4
Øxx,blackrock,192,priest,discipline,6,2,4
Chópsuey,stormscale,192,priest,discipline,6,2,4
Methslinger,draenor,192,priest,discipline,6,2,4
Ичисанчик,howling-fjord,192,priest,discipline,6,2,4
Маджори,azuregos,192,priest,discipline,6,2,4
Chukapi,stormscale,192,priest,discipline,6,2,4
Mcx,stormscale,192,priest,discipline,6,2,4
Flayin,kazzak,192,priest,discipline,7,2,5
Uwuslayerx,stormscale,192,priest,discipline,7,2,5
Иванвай,soulflayer,192,priest,discipline,9,2,7
Волия,gordunni,192,priest,discipline,11,2,9
Sevinho,twisting-nether,192,priest,discipline,12,2,10
Neliica,silvermoon,192,priest,discipline,12,2,10
Adallon,blackmoore,192,priest,discipline,12,2,10
Norah,kirin-tor,192,priest,discipline,12,2,10
Ulfsarkaom,turalyon,192,priest,discipline,12,2,10
Miind,tarren-mill,192,priest,discipline,12,2,10
Chenandler,aggra-português,192,priest,discipline,12,2,10
Trickfulzqt,stormscale,192,priest,discipline,12,2,10
Shacoat,draenor,192,priest,discipline,12,2,10
Xlia,argent-dawn,192,priest,discipline,12,2,10
Aldebrand,dun-modr,192,priest,discipline,12,2,10
Balan,argent-dawn,192,priest,discipline,12,2,10
Chizu,alakir,192,priest,discipline,12,2,10
Petjouli,darksorrow,192,priest,discipline,12,2,10
Zêlða,ravencrest,192,priest,discipline,12,2,10
Aist,ragnaros,192,priest,discipline,12,2,10
Yhraeliaegh,defias-brotherhood,192,priest,discipline,18,2,16
Zinary,silvermoon,192,priest,discipline,18,2,16
Adolosh,thrall,191,priest,discipline,6,2,4
Cav,archimonde,175,priest,discipline,11,2,9
Jumpaxx,archimonde,159,priest,discipline,5,2,3
Bigfnatlund,silvermoon,159,priest,discipline,5,2,3
Munche,blackmoore,159,priest,discipline,5,2,3
Noserenity,outland,159,priest,discipline,5,2,3
Discopriestt,outland,144,priest,discipline,9,2,7
Sotanax,khazgoroth,144,priest,discipline,9,2,7
Magister,sanguino,138,priest,discipline,9,4,5
Xire,outland,138,priest,discipline,8,3,5
Ohhowpretty,ravencrest,138,priest,discipline,11,4,7
Majestíc,blackmoore,138,priest,discipline,9,3,6
Шорон,howling-fjord,138,priest,discipline,11,3,8
Telpriest,blackrock,138,priest,discipline,13,3,10
Rushax,ravencrest,137,priest,discipline,7,3,4
Xakala,cthun,137,priest,discipline,13,3,10
Darzul,conseil-des-ombres,127,priest,discipline,8,2,6
Lucerna,defias-brotherhood,112,priest,discipline,7,2,5
Midy,drakthul,96,priest,discipline,3,2,1
Sdw,kargath,96,priest,discipline,3,2,1
Wizzp,magtheridon,96,priest,discipline,9,2,7
Guiliman,chamber-of-aspects,96,priest,discipline,11,2,9
Leykop,ravencrest,96,priest,discipline,6,1,5
Sayala,dalaran,96,priest,discipline,6,1,5
Aprima,culte-de-la-rive-noire,96,priest,discipline,6,1,5
Cptncarrot,blackmoore,96,priest,discipline,6,1,5
Dami,defias-brotherhood,96,priest,discipline,6,1,5
Rennic,stormscale,96,priest,discipline,6,1,5
Iololololxd,eredar,96,priest,discipline,6,1,5
Dionegativ,draenor,96,priest,discipline,6,1,5
Sonyl,les-sentinelles,96,priest,discipline,6,1,5
Liendro,stormscale,96,priest,discipline,6,1,5
Yogastretch,ravencrest,96,priest,discipline,6,1,5
Немонте,gordunni,96,priest,discipline,6,1,5
Шишищ,gordunni,96,priest,discipline,6,1,5
Miraçlê,kazzak,96,priest,discipline,6,1,5
Arttos,antonidas,96,priest,discipline,6,1,5
Teri,taerar,96,priest,discipline,6,1,5
Madcole,blackhand,96,priest,discipline,6,1,5
Redblue,onyxia,96,priest,discipline,6,1,5
Jaimee,zirkel-des-cenarius,96,priest,discipline,6,1,5
Hiliom,ahnqiraj,96,priest,discipline,6,1,5
Alsalty,stormscale,96,priest,discipline,6,1,5
Xälis,ysondre,96,priest,discipline,6,1,5
Cysco,blackmoore,96,priest,discipline,6,1,5
Марриаза,blackscar,96,priest,discipline,6,1,5
Vampirito,ragnaros,96,priest,discipline,6,1,5
Жрецдуши,gordunni,96,priest,discipline,6,1,5
Хоббитсон,soulflayer,96,priest,discipline,6,1,5
Myxeh,ravencrest,96,priest,discipline,6,1,5
Listenlisten,archimonde,96,priest,discipline,6,1,5
Æsia,archimonde,96,priest,discipline,6,1,5
Yixi,blackmoore,96,priest,discipline,6,1,5
Erkay,kazzak,96,priest,discipline,6,1,5
Pristürk,burning-legion,96,priest,discipline,6,1,5
Prêtresacré,archimonde,96,priest,discipline,6,1,5
Namï,darksorrow,96,priest,discipline,6,1,5
Anethron,ragnaros,96,priest,discipline,6,1,5
Героиннарбг,soulflayer,96,priest,discipline,6,1,5
Missah,archimonde,96,priest,discipline,6,1,5
Йоййо,gordunni,96,priest,discipline,6,1,5
Ascendare,tarren-mill,96,priest,discipline,6,1,5
Holzí,frostmourne,96,priest,discipline,6,1,5
Shinesomnya,aegwynn,96,priest,discipline,6,1,5
Pellé,stormscale,96,priest,discipline,6,1,5
Joncartagena,sanguino,96,priest,discipline,6,1,5
Могвайи,soulflayer,96,priest,discipline,6,1,5
Filit,hyjal,96,priest,discipline,6,1,5
Sende,tarren-mill,96,priest,discipline,6,1,5
Оумега,gordunni,96,priest,discipline,6,1,5
Nondi,frostmane,96,priest,discipline,6,1,5
Миррен,gordunni,96,priest,discipline,6,1,5
Huhu,defias-brotherhood,96,priest,discipline,6,1,5
Récko,blackmoore,96,priest,discipline,6,1,5
Olqp,tarren-mill,96,priest,discipline,6,1,5
Скартэикс,howling-fjord,96,priest,discipline,6,1,5
Promiqt,drakthul,96,priest,discipline,6,1,5
Broncos,twisting-nether,96,priest,discipline,6,1,5
Menjo,silvermoon,96,priest,discipline,6,1,5
Lyssandre,stormreaver,96,priest,discipline,6,1,5
Epokalarm,ragnaros,96,priest,discipline,12,1,11
Alwiel,kazzak,96,priest,discipline,12,1,11
Sorprendente,cthun,96,priest,discipline,12,1,11
Kelarai,azjolnerub,96,priest,discipline,12,1,11
Ccatchme,sylvanas,96,priest,discipline,18,1,17
Priestin,dun-modr,79,priest,discipline,5,1,4
Elián,silvermoon,79,priest,discipline,5,1,4
Tiinia,hyjal,74,priest,discipline,13,3,10
Tronte,dun-modr,64,priest,discipline,4,1,3
Faithful,emerald-dream,64,priest,discipline,8,1,7
Jaimeê,der-rat-von-dalaran,63,priest,discipline,2,2,0
Bossku,kazzak,48,priest,discipline,3,1,2
Pushup,drakthul,48,priest,discipline,3,1,2
Piacolada,aegwynn,48,priest,discipline,3,1,2
Triip,argent-dawn,42,priest,discipline,7,2,5
Хаахаахаа,gordunni,42,priest,discipline,11,3,8
Ronk,outland,42,priest,discipline,9,2,7
Xxddxd,draenor,42,priest,discipline,17,3,14
Yggdra,ragnaros,2229,priest,shadow,66,44,22
Хедмэнмвп,gordunni,2203,priest,shadow,156,80,76
Dollyboo,tarren-mill,2152,priest,shadow,125,77,48
Ilovemycat,silvermoon,2152,priest,shadow,78,47,31
Hanic,kazzak,2151,priest,shadow,68,43,25
Permafeetup,aegwynn,2151,priest,shadow,78,45,33
Даняпампгодх,soulflayer,2151,priest,shadow,134,70,64
Sphero,earthen-ring,2147,priest,shadow,106,63,43
Cheesecake,defias-brotherhood,2143,priest,shadow,78,47,31
Blacktrain,burning-blade,2136,priest,shadow,118,60,58
Crainoo,ravencrest,2136,priest,shadow,152,77,75
Rzkp,eredar,2110,priest,shadow,93,50,43
Yuzuflex,hyjal,2110,priest,shadow,81,43,38
Standtall,blackrock,2103,priest,shadow,78,44,34
Syedi,drakthul,2077,priest,shadow,117,55,62
Èxtêrmìnätör,kazzak,2059,priest,shadow,66,41,25
Walterwhite,stormscale,2059,priest,shadow,66,36,30
Notsoholy,blackmoore,2056,priest,shadow,60,37,23
Finn,kult-der-verdammten,2056,priest,shadow,102,56,46
Purpl,tarren-mill,2045,priest,shadow,114,62,52
Bönfire,silvermoon,2040,priest,shadow,86,45,41
Pu,outland,2039,priest,shadow,90,43,47
Сделайсам,gordunni,2033,priest,shadow,65,37,28
Миладиель,gordunni,2033,priest,shadow,101,52,49
Pepeshadow,twisting-nether,2020,priest,shadow,93,48,45
Stjärtsten,tarren-mill,2008,priest,shadow,147,87,60
Rzktwo,eredar,1988,priest,shadow,59,33,26
Sethÿr,sanguino,1982,priest,shadow,126,66,60
Tremrfinger,dun-modr,1969,priest,shadow,62,42,20
Thanatae,kazzak,1969,priest,shadow,71,38,33
Zhadum,stormscale,1964,priest,shadow,84,45,39
Dbeezy,tarren-mill,1961,priest,shadow,58,33,25
Nousey,twisting-nether,1959,priest,shadow,54,32,22
Infuséd,aegwynn,1956,priest,shadow,54,30,24
Destinyhero,aegwynn,1955,priest,shadow,76,37,39
Moretti,ravencrest,1953,priest,shadow,54,32,22
Vaccineboost,silvermoon,1944,priest,shadow,84,40,44
Dhurza,shendralar,1938,priest,shadow,66,39,27
Justtpro,twisting-nether,1937,priest,shadow,99,64,35
Gorholm,argent-dawn,1933,priest,shadow,48,33,15
Бвонсаамди,soulflayer,1928,priest,shadow,107,58,49
Shåmssv,kazzak,1923,priest,shadow,54,28,26
Estragon,quelthalas,1912,priest,shadow,75,40,35
Dippy,blackrock,1910,priest,shadow,42,27,15
Hansmaul,thrall,1897,priest,shadow,36,20,16
Maryhugette,archimonde,1892,priest,shadow,84,43,41
Heal,hyjal,1889,priest,shadow,171,98,73
Shádówý,kazzak,1889,priest,shadow,36,20,16
Melábufeis,dun-modr,1887,priest,shadow,60,34,26
Rrj,ravencrest,1886,priest,shadow,46,29,17
Lâughing,ravencrest,1883,priest,shadow,55,32,23
Qoryn,ravencrest,1882,priest,shadow,42,25,17
Genjutzux,kazzak,1882,priest,shadow,54,32,22
Heffer,outland,1880,priest,shadow,93,58,35
Akibom,drakthul,1879,priest,shadow,47,31,16
Бхонсамди,blackscar,1872,priest,shadow,65,40,25
Xsß,dun-modr,1872,priest,shadow,60,32,28
Knútx,stormscale,1867,priest,shadow,60,30,30
Rãpidi,hyjal,1866,priest,shadow,77,48,29
Simôc,eredar,1864,priest,shadow,48,25,23
Weekfortyone,blackhand,1864,priest,shadow,56,27,29
Perché,silvermoon,1863,priest,shadow,54,39,15
Tentoumushi,ravencrest,1861,priest,shadow,42,27,15
Prøphetx,thrall,1861,priest,shadow,105,52,53
Léandrä,magtheridon,1860,priest,shadow,60,28,32
Milkysmite,twisting-nether,1856,priest,shadow,52,32,20
Ансор,lich-king,1856,priest,shadow,89,50,39
Iodjsaiojoij,kazzak,1856,priest,shadow,54,30,24
Buøbuarns,sanguino,1856,priest,shadow,51,23,28
Термидор,booty-bay,1851,priest,shadow,83,52,31
Physxd,blackrock,1848,priest,shadow,36,28,8
Deathlý,blackrock,1846,priest,shadow,54,30,24
Dingopriest,blackrock,1843,priest,shadow,48,31,17
Akolyte,blackmoore,1843,priest,shadow,36,22,14
Trisks,ravencrest,1843,priest,shadow,34,20,14
Arendt,blackhand,1837,priest,shadow,48,29,19
Zoodiacp,blackrock,1837,priest,shadow,58,28,30
Sadix,ravencrest,1835,priest,shadow,66,38,28
Безрассудица,howling-fjord,1834,priest,shadow,55,29,26
Either,kazzak,1833,priest,shadow,59,33,26
Ымц,gordunni,1832,priest,shadow,66,33,33
Schmetter,tarren-mill,1829,priest,shadow,65,29,36
Selëne,blackrock,1827,priest,shadow,72,43,29
Rockness,blackmoore,1825,priest,shadow,125,84,41
Rakamain,ravencrest,1825,priest,shadow,48,31,17
Anateoris,turalyon,1825,priest,shadow,76,43,33
Quezaris,stormscale,1825,priest,shadow,48,23,25
Cantsqell,silvermoon,1823,priest,shadow,48,34,14
Ûñträînablê,outland,1822,priest,shadow,48,34,14
Swdjkbad,kazzak,1822,priest,shadow,47,28,19
Староезло,gordunni,1821,priest,shadow,68,33,35
Raikup,ravencrest,1816,priest,shadow,41,19,22
Zodzín,ragnaros,1815,priest,shadow,36,19,17
Theunknown,thrall,1814,priest,shadow,42,30,12
Luvlyrah,draenor,1812,priest,shadow,81,52,29
Namsolo,kazzak,1811,priest,shadow,78,42,36
Skillmåsterx,ravencrest,1810,priest,shadow,54,29,25
Gymbró,kazzak,1809,priest,shadow,54,31,23
Salkerer,stormscale,1807,priest,shadow,30,19,11
Айсиоу,howling-fjord,1807,priest,shadow,30,19,11
Snarks,sylvanas,1806,priest,shadow,36,20,16
Galatea,les-sentinelles,1805,priest,shadow,78,44,34
Vajainap,outland,1804,priest,shadow,30,19,11
Mataî,kazzak,1803,priest,shadow,84,49,35
Margots,kazzak,1802,priest,shadow,42,22,20
Bidraget,ravencrest,1797,priest,shadow,36,23,13
Nyotux,blackrock,1795,priest,shadow,60,41,19
Becknarbritt,stormscale,1791,priest,shadow,142,87,55
Djops,outland,1789,priest,shadow,66,35,31
Sepharis,runetotem,1776,priest,shadow,167,100,67
Theoniss,draenor,1773,priest,shadow,48,32,16
Darthmantle,silvermoon,1758,priest,shadow,53,26,27
Garycash,outland,1754,priest,shadow,82,42,40
Ninjajane,sylvanas,1753,priest,shadow,53,32,21
Versio,dalvengyr,1739,priest,shadow,36,22,14
Klosso,anachronos,1732,priest,shadow,83,38,45
Ankî,aegwynn,1731,priest,shadow,78,42,36
Marbellexd,pozzo-delleternità,1730,priest,shadow,115,67,48
Mizulol,ravencrest,1727,priest,shadow,48,24,24
Goodsuck,tarren-mill,1723,priest,shadow,36,22,14
Johnnybanana,argent-dawn,1722,priest,shadow,30,21,9
Всезнайка,soulflayer,1715,priest,shadow,114,61,53
Игорянатакуе,eversong,1712,priest,shadow,106,58,48
Dümbledore,aggra-português,1704,priest,shadow,24,18,6
Zuhä,twisting-nether,1703,priest,shadow,42,22,20
Helín,hellfire,1702,priest,shadow,84,48,36
Ageyr,ragnaros,1701,priest,shadow,53,34,19
Atahalni,argent-dawn,1700,priest,shadow,36,18,18
Zhyn,turalyon,1699,priest,shadow,104,61,43
Хьёх,blackscar,1688,priest,shadow,36,23,13
Кломми,gordunni,1688,priest,shadow,66,35,31
Iessei,outland,1686,priest,shadow,30,18,12
Перекованный,soulflayer,1685,priest,shadow,87,47,40
Mojibien,burning-legion,1683,priest,shadow,92,54,38
Víppe,stormreaver,1682,priest,shadow,53,32,21
Geløpr,eredar,1681,priest,shadow,30,20,10
Devoura,sylvanas,1673,priest,shadow,30,19,11
Absolution,stormscale,1673,priest,shadow,83,52,31
Sheto,burning-legion,1670,priest,shadow,72,37,35
Dezerta,nozdormu,1667,priest,shadow,68,37,31
Дикаях,gordunni,1666,priest,shadow,94,46,48
Zeythz,ravencrest,1665,priest,shadow,88,51,37
Yêl,thrall,1662,priest,shadow,137,76,61
Tosem,antonidas,1661,priest,shadow,30,19,11
Buffholy,dun-modr,1657,priest,shadow,60,36,24
Bréézee,ravencrest,1654,priest,shadow,35,18,17
Финдовский,gordunni,1649,priest,shadow,102,54,48
Ruhe,silvermoon,1648,priest,shadow,48,27,21
Akroama,archimonde,1648,priest,shadow,41,20,21
Cdplz,archimonde,1647,priest,shadow,30,20,10
Киндзер,blackscar,1644,priest,shadow,36,23,13
Фиброз,blackscar,1642,priest,shadow,42,27,15
Empz,thrall,1641,priest,shadow,36,18,18
Weebi,silvermoon,1640,priest,shadow,65,39,26
Milo,argent-dawn,1640,priest,shadow,102,61,41
Mikizu,die-aldor,1638,priest,shadow,42,21,21
Undefined,chamber-of-aspects,1634,priest,shadow,40,28,12
Jaimë,ravencrest,1630,priest,shadow,30,17,13
Ðanilox,dun-modr,1629,priest,shadow,24,17,7
Mérce,kazzak,1629,priest,shadow,30,20,10
Билетлолпро,borean-tundra,1627,priest,shadow,24,17,7
Ксерф,soulflayer,1627,priest,shadow,84,40,44
Liptonolda,blackhand,1624,priest,shadow,30,17,13
Трубишоп,howling-fjord,1624,priest,shadow,76,38,38
Affex,tarren-mill,1622,priest,shadow,30,18,12
Tacøgxd,ravencrest,1621,priest,shadow,30,21,9
Angsty,blackrock,1620,priest,shadow,30,17,13
Toesxcker,stormscale,1616,priest,shadow,35,21,14
Priestazie,madmortem,1616,priest,shadow,96,57,39
Knoffp,blackhand,1614,priest,shadow,72,41,31
Mehtz,ravencrest,1613,priest,shadow,132,63,69
Rnkz,sanguino,1612,priest,shadow,36,20,16
Everdark,twisting-nether,1611,priest,shadow,90,52,38
Ревентонх,howling-fjord,1611,priest,shadow,130,72,58
Казуямисима,gordunni,1609,priest,shadow,48,28,20
Nabøøbies,blackmoore,1607,priest,shadow,32,18,14
Faminé,outland,1606,priest,shadow,47,22,25
Kujiua,ravencrest,1603,priest,shadow,55,28,27
Basicpr,ravencrest,1601,priest,shadow,39,27,12
Sudeki,blackmoore,1601,priest,shadow,42,20,22
Llothx,ravencrest,1597,priest,shadow,62,34,28
Dyshexia,bronze-dragonflight,1590,priest,shadow,48,27,21
Lindp,stormreaver,1588,priest,shadow,24,17,7
Erenndriel,twisting-nether,1588,priest,shadow,30,17,13
Pombär,ragnaros,1587,priest,shadow,54,36,18
Spamplague,stormscale,1583,priest,shadow,36,20,16
Spklooril,hyjal,1581,priest,shadow,139,71,68
Milamati,kazzak,1576,priest,shadow,60,28,32
Levitation,alakir,1575,priest,shadow,48,27,21
Ptxd,alakir,1569,priest,shadow,28,18,10
Momomomomomo,aegwynn,1568,priest,shadow,60,30,30
Эззи,soulflayer,1565,priest,shadow,48,29,19
Kightz,twisting-nether,1560,priest,shadow,51,27,24
Asterixsu,sylvanas,1556,priest,shadow,30,20,10
Seneth,twisting-nether,1553,priest,shadow,48,25,23
Xangha,burning-legion,1551,priest,shadow,72,41,31
Máv,tarren-mill,1549,priest,shadow,30,18,12
Skypray,burning-legion,1549,priest,shadow,36,20,16
Sháady,ravencrest,1549,priest,shadow,42,23,19
Pregrip,twisting-nether,1548,priest,shadow,37,21,16
Valirda,twisting-nether,1548,priest,shadow,45,23,22
Даняпампх,soulflayer,1547,priest,shadow,77,47,30
Thmas,outland,1545,priest,shadow,47,21,26
Синатро,deathguard,1544,priest,shadow,106,68,38
Coupdekaraté,sylvanas,1543,priest,shadow,36,18,18
Кхэрри,goldrinn,1540,priest,shadow,30,19,11
Амгар,galakrond,1540,priest,shadow,125,69,56
Ankhh,bloodscalp,1539,priest,shadow,42,19,23
Hâicu,antonidas,1535,priest,shadow,57,36,21
Саксесфул,howling-fjord,1535,priest,shadow,97,53,44
Bøts,ravencrest,1534,priest,shadow,55,27,28
Синфал,blackscar,1533,priest,shadow,30,16,14
Йоййо,gordunni,1532,priest,shadow,52,29,23
Zekonja,doomhammer,1532,priest,shadow,82,42,40
Holyshadów,azjolnerub,1525,priest,shadow,36,19,17
Kêrrýgold,blackrock,1523,priest,shadow,34,19,15
Psycos,kazzak,1523,priest,shadow,66,33,33
Деплитфофан,gordunni,1521,priest,shadow,53,35,18
Cnsnn,ysondre,1520,priest,shadow,49,33,16
Chrønös,hyjal,1520,priest,shadow,30,18,12
Framesxøxø,ravencrest,1518,priest,shadow,24,16,8
Umbralx,ragnaros,1513,priest,shadow,71,42,29
Hellscon,kazzak,1513,priest,shadow,30,16,14
Hemaplex,dun-modr,1508,priest,shadow,35,21,14
Cykdwojeczka,burning-legion,1499,priest,shadow,66,31,35
Imøteph,ragnaros,1497,priest,shadow,30,18,12
Babarøqa,blackmoore,1497,priest,shadow,80,40,40
Zászàsmaster,kazzak,1496,priest,shadow,48,30,18
Blasphemiia,outland,1492,priest,shadow,42,29,13
Anathemas,draenor,1490,priest,shadow,30,22,8
Kajifoxi,frostmane,1490,priest,shadow,60,38,22
Bercxu,ragnaros,1487,priest,shadow,60,34,26
Isusgaspodi,argent-dawn,1486,priest,shadow,66,42,24
Ecquidozx,ravencrest,1480,priest,shadow,29,16,13
Зонкк,thermaplugg,1477,priest,shadow,114,62,52
Vatikanet,ravencrest,1475,priest,shadow,63,36,27
Mightyfool,aegwynn,1475,priest,shadow,36,18,18
Massbimba,tarren-mill,1475,priest,shadow,41,19,22
Мишатемный,gordunni,1472,priest,shadow,30,17,13
Kellen,burning-blade,1466,priest,shadow,94,55,39
Nygel,kazzak,1459,priest,shadow,53,29,24
Fiftyfives,hyjal,1456,priest,shadow,39,18,21
Tyene,voljin,1455,priest,shadow,52,31,21
Ounxx,blackrock,1454,priest,shadow,23,16,7
Cinaedus,stormreaver,1449,priest,shadow,51,27,24
Sanebassoff,kazzak,1447,priest,shadow,94,55,39
Dotsin,kazzak,1445,priest,shadow,89,45,44
Kertith,argent-dawn,1444,priest,shadow,85,44,41
Tbs,sylvanas,1441,priest,shadow,33,17,16
Клаима,soulflayer,1441,priest,shadow,35,17,18
Ondskabsfuld,kazzak,1439,priest,shadow,30,15,15
Voidgodx,blackrock,1438,priest,shadow,30,15,15
Xayona,argent-dawn,1438,priest,shadow,30,15,15
Bubbleup,defias-brotherhood,1437,priest,shadow,24,16,8
Miruh,malganis,1433,priest,shadow,41,31,10
Adägïo,dun-modr,1431,priest,shadow,42,18,24
Пристатеист,howling-fjord,1431,priest,shadow,36,15,21
Yaoshih,draenor,1430,priest,shadow,53,28,25
Raspberrypíe,silvermoon,1428,priest,shadow,30,16,14
Офелла,howling-fjord,1426,priest,shadow,59,32,27
Nightshådøw,silvermoon,1426,priest,shadow,98,53,45
Jaimee,zirkel-des-cenarius,1425,priest,shadow,24,15,9
Vhayna,kazzak,1417,priest,shadow,53,32,21
Sebbepriest,twisting-nether,1416,priest,shadow,30,18,12
Unerfedsp,archimonde,1414,priest,shadow,63,27,36
Shopify,nagrand,1412,priest,shadow,30,15,15
Saintethérez,archimonde,1410,priest,shadow,45,30,15
Рэнфан,fordragon,1409,priest,shadow,26,17,9
Kamish,twisting-nether,1409,priest,shadow,48,19,29
Melanore,sylvanas,1407,priest,shadow,72,34,38
Xooxl,ragnaros,1406,priest,shadow,24,17,7
Dopey,kazzak,1406,priest,shadow,24,17,7
Maxhima,defias-brotherhood,1404,priest,shadow,66,34,32
Astangia,nemesis,1401,priest,shadow,111,62,49
Vedina,bronze-dragonflight,1399,priest,shadow,75,32,43
Priestfive,stormscale,1395,priest,shadow,30,15,15
Rogmisa,cthun,1394,priest,shadow,36,22,14
Genthus,kazzak,1393,priest,shadow,48,19,29
Êttân,ravencrest,1392,priest,shadow,38,21,17
Дэспира,howling-fjord,1391,priest,shadow,28,16,12
Багбери,eversong,1391,priest,shadow,76,43,33
Bubidiblumpr,twisting-nether,1388,priest,shadow,42,27,15
Meshen,ysondre,1386,priest,shadow,76,42,34
Inei,doomhammer,1384,priest,shadow,24,15,9
Hek,sylvanas,1384,priest,shadow,72,36,36
Palitox,kazzak,1383,priest,shadow,58,30,28
Damyo,eredar,1381,priest,shadow,54,29,25
Kendea,silvermoon,1378,priest,shadow,93,50,43
Shinígamí,frostmane,1377,priest,shadow,36,19,17
Ваккарий,gordunni,1368,priest,shadow,43,27,16
Apuessii,dun-modr,1366,priest,shadow,35,20,15
Shizo,blutkessel,1364,priest,shadow,29,20,9
Twøpac,hyjal,1362,priest,shadow,35,22,13
Erkay,kazzak,1362,priest,shadow,36,17,19
Míjagí,blackhand,1352,priest,shadow,47,25,22
Saviour,spinebreaker,1346,priest,shadow,30,19,11
Польскийбуль,gordunni,1343,priest,shadow,24,14,10
Voidlink,kazzak,1342,priest,shadow,24,14,10
Velenthøs,argent-dawn,1338,priest,shadow,41,23,18
Xxede,dun-modr,1338,priest,shadow,51,23,28
Hecaté,blackhand,1337,priest,shadow,55,31,24
Seni,gilneas,1336,priest,shadow,55,26,29
Settemsen,tarren-mill,1334,priest,shadow,18,14,4
Staljon,burning-legion,1334,priest,shadow,24,14,10
Megajuicy,blackmoore,1332,priest,shadow,66,30,36
Rasha,kazzak,1331,priest,shadow,24,14,10
Broncos,twisting-nether,1331,priest,shadow,58,33,25
Daltheria,daggerspine,1328,priest,shadow,59,34,25
Baptizer,nemesis,1324,priest,shadow,67,43,24
Mackings,the-maelstrom,1319,priest,shadow,32,14,18
Littlebugger,argent-dawn,1317,priest,shadow,63,28,35
Kåz,argent-dawn,1301,priest,shadow,35,21,14
Ammp,outland,1298,priest,shadow,92,51,41
Сариандра,gordunni,1295,priest,shadow,24,15,9
Kasyrra,sylvanas,1294,priest,shadow,30,17,13
Hexmon,tarren-mill,1292,priest,shadow,30,21,9
Ankus,tarren-mill,1287,priest,shadow,30,14,16
Babarøga,blackrock,1274,priest,shadow,23,14,9
Sodomix,tarren-mill,1274,priest,shadow,60,34,26
Odium,alakir,1264,priest,shadow,36,18,18
Hârlequin,draenor,1262,priest,shadow,132,71,61
Evilspel,ravencrest,1261,priest,shadow,33,18,15
Hëllokitty,sanguino,1253,priest,shadow,86,42,44
Cornflays,outland,1248,priest,shadow,18,13,5
Been,ravencrest,1247,priest,shadow,18,13,5
Cutepangolin,khaz-modan,1247,priest,shadow,18,13,5
Selaria,magtheridon,1245,priest,shadow,18,13,5
Caballococo,dun-modr,1245,priest,shadow,46,18,28
Greyford,blackhand,1240,priest,shadow,18,13,5
Peikkousva,twisting-nether,1240,priest,shadow,24,13,11
Putríd,sylvanas,1239,priest,shadow,18,13,5
Kylähullu,ravencrest,1239,priest,shadow,30,13,17
Morsy,alleria,1235,priest,shadow,27,14,13
Voidlord,hyjal,1232,priest,shadow,34,17,17
Farseerx,ravencrest,1224,priest,shadow,54,34,20
Prøfesor,nemesis,1224,priest,shadow,24,13,11
Secundis,silvermoon,1219,priest,shadow,24,13,11
Даркфолс,soulflayer,1219,priest,shadow,30,15,15
Tesz,perenolde,1217,priest,shadow,36,16,20
Lowisa,sylvanas,1212,priest,shadow,23,13,10
Eryxial,antonidas,1211,priest,shadow,29,13,16
Thergozar,stormscale,1208,priest,shadow,48,33,15
Cthulou,tarren-mill,1207,priest,shadow,87,47,40
Zedrus,azshara,1206,priest,shadow,29,13,16
Ggdoll,twisting-nether,1204,priest,shadow,60,28,32
Nagatary,blackmoore,1192,priest,shadow,48,23,25
Morteous,twisting-nether,1188,priest,shadow,205,101,104
Флэшх,soulflayer,1177,priest,shadow,22,13,9
Tiinia,hyjal,1165,priest,shadow,40,15,25
Scaryman,ravencrest,1157,priest,shadow,23,14,9
Медовыедотки,soulflayer,1152,priest,shadow,24,12,12
Pandacore,frostmane,1152,priest,shadow,24,12,12
Hotdog,kult-der-verdammten,1152,priest,shadow,42,20,22
Smxkÿÿ,eredar,1151,priest,shadow,18,12,6
Julîane,aegwynn,1151,priest,shadow,18,12,6
Voidshuffle,laughing-skull,1151,priest,shadow,18,12,6
Animesenpai,kazzak,1151,priest,shadow,18,12,6
Døubtful,kazzak,1151,priest,shadow,24,12,12
Facemeltina,kiljaeden,1151,priest,shadow,24,12,12
Jacep,kazzak,1150,priest,shadow,18,12,6
Mydianá,aegwynn,1149,priest,shadow,18,12,6
Onlyfansp,ravencrest,1149,priest,shadow,30,12,18
Fakecastguru,ravencrest,1148,priest,shadow,24,12,12
Cylantharia,eredar,1147,priest,shadow,24,12,12
Ølle,ravencrest,1147,priest,shadow,24,12,12
Энвиньяттар,howling-fjord,1144,priest,shadow,18,12,6
Cerbero,doomhammer,1128,priest,shadow,18,12,6
Chillx,blackmoore,1127,priest,shadow,30,19,11
Bimboxo,argent-dawn,1127,priest,shadow,47,24,23
Shiannâ,malganis,1118,priest,shadow,26,13,13
Inzàné,kazzak,1114,priest,shadow,18,12,6
Psycoscream,blackmoore,1112,priest,shadow,23,12,11
Bodeeney,hellfire,1111,priest,shadow,36,15,21
Nellytaa,dalaran,1103,priest,shadow,35,18,17
Yuhé,elune,1100,priest,shadow,24,16,8
Voodkaa,drakthul,1098,priest,shadow,21,13,8
Ðizzi,dun-modr,1096,priest,shadow,21,14,7
Ladouce,archimonde,1096,priest,shadow,27,13,14
Cabalist,silvermoon,1094,priest,shadow,60,30,30
Амфетаминная,howling-fjord,1069,priest,shadow,20,13,7
Equalìzer,ravencrest,1056,priest,shadow,12,11,1
Трейдарк,blackscar,1056,priest,shadow,24,11,13
Yoe,twisting-nether,1056,priest,shadow,24,11,13
Sÿrax,ysondre,1055,priest,shadow,18,11,7
Adub,tarren-mill,1055,priest,shadow,18,11,7
Actionjezuz,shattered-hand,1055,priest,shadow,18,11,7
Terrored,ravencrest,1055,priest,shadow,18,11,7
Raisedbyrap,blackrock,1055,priest,shadow,24,11,13
Abjure,silvermoon,1053,priest,shadow,18,11,7
Poposy,hyjal,1053,priest,shadow,18,11,7
Санятруу,blackscar,1053,priest,shadow,78,42,36
Блюмсик,blackscar,1052,priest,shadow,30,18,12
Gauge,frostmane,1048,priest,shadow,31,12,19
Angleka,argent-dawn,1046,priest,shadow,29,13,16
Baihoi,twilights-hammer,1041,priest,shadow,18,11,7
Holypowér,twisting-nether,1041,priest,shadow,24,11,13
Tsunadesaama,silvermoon,1037,priest,shadow,23,11,12
Flayin,kazzak,1035,priest,shadow,24,11,13
Тэтсу,greymane,1018,priest,shadow,18,12,6
Minabonxx,silvermoon,1002,priest,shadow,51,14,37
Hypnocat,blackrock,991,priest,shadow,22,11,11
Vavulya,blackhand,988,priest,shadow,16,11,5
Asdaprice,hellfire,986,priest,shadow,18,12,6
Mylox,blackrock,984,priest,shadow,17,11,6
Dayowe,antonidas,975,priest,shadow,28,13,15
Уртримас,gordunni,975,priest,shadow,30,11,19
Кинраналь,eversong,964,priest,shadow,24,12,12
Maedhrós,ravencrest,960,priest,shadow,12,10,2
Blindöts,tarren-mill,960,priest,shadow,18,10,8
Шадоупуз,soulflayer,960,priest,shadow,24,10,14
Billybay,argent-dawn,959,priest,shadow,12,10,2
Pórt,kazzak,959,priest,shadow,15,11,4
Dotreveal,ravencrest,959,priest,shadow,18,10,8
Snoopý,dun-modr,959,priest,shadow,18,10,8
Cathrix,kazzak,959,priest,shadow,18,10,8
Dreamhatcher,deathwing,959,priest,shadow,24,10,14
Goodison,outland,959,priest,shadow,24,10,14
Rakkha,ravencrest,959,priest,shadow,24,10,14
Supriest,alakir,959,priest,shadow,24,10,14
Miruvai,tarren-mill,958,priest,shadow,18,10,8
Strunkiin,defias-brotherhood,958,priest,shadow,18,10,8
Shadowsister,burning-blade,955,priest,shadow,18,10,8
Иннй,howling-fjord,947,priest,shadow,24,11,13
Lathas,bloodfeather,946,priest,shadow,18,10,8
Силабездны,deathguard,946,priest,shadow,38,20,18
Abrakahudder,tarren-mill,927,priest,shadow,17,10,7
Priestoll,draenor,911,priest,shadow,21,10,11
Æäõ,turalyon,864,priest,shadow,12,9,3
Lr,aszune,864,priest,shadow,12,9,3
Slimcharles,ravencrest,864,priest,shadow,12,9,3
Ekkfwiedrice,ragnaros,864,priest,shadow,12,9,3
Vibéz,outland,864,priest,shadow,18,9,9
Spyrono,kazzak,864,priest,shadow,18,9,9
Manyus,archimonde,864,priest,shadow,18,9,9
Insanious,skullcrusher,864,priest,shadow,18,9,9
Scade,kazzak,864,priest,shadow,18,9,9
Shucks,stormscale,864,priest,shadow,18,9,9
Schmatzy,blackmoore,864,priest,shadow,24,9,15
Festiz,tichondrius,863,priest,shadow,12,9,3
Lostcause,alakir,863,priest,shadow,12,9,3
Dazé,ravencrest,863,priest,shadow,17,10,7
Jadæ,ragnaros,863,priest,shadow,18,9,9
Nomorelight,stormscale,863,priest,shadow,18,9,9
Imaut,emerald-dream,863,priest,shadow,18,9,9
Zayden,ragnaros,863,priest,shadow,18,9,9
Jonig,blackmoore,863,priest,shadow,24,9,15
Healiea,outland,863,priest,shadow,30,9,21
Hörror,twisting-nether,862,priest,shadow,18,9,9
Элдерле,gordunni,862,priest,shadow,18,9,9
Experimentix,silvermoon,862,priest,shadow,18,9,9
Ilostmybible,runetotem,862,priest,shadow,24,9,15
Dívíne,ravenholdt,861,priest,shadow,12,9,3
Cringelørd,alakir,861,priest,shadow,12,9,3
Dutchstuff,karazhan,861,priest,shadow,18,9,9
Smiles,burning-steppes,861,priest,shadow,18,9,9
Kavie,ravencrest,861,priest,shadow,18,9,9
Adssdfhjgh,outland,860,priest,shadow,12,9,3
Maximandreic,kazzak,859,priest,shadow,24,9,15
Fordöbroo,ragnaros,858,priest,shadow,18,9,9
Дроус,borean-tundra,858,priest,shadow,30,12,18
Alfredosauce,ravencrest,831,priest,shadow,17,9,8
Noremorze,ravencrest,827,priest,shadow,14,10,4
Pipen,stormscale,820,priest,shadow,23,9,14
Csksablanca,sargeras,815,priest,shadow,11,9,2
Alicanx,silvermoon,798,priest,shadow,17,9,8
Sypnos,zuljin,797,priest,shadow,16,9,7
Sayash,chamber-of-aspects,782,priest,shadow,20,9,11
Прыст,howling-fjord,768,priest,shadow,12,8,4
Morseeii,baelgun,768,priest,shadow,12,8,4
Shyvi,ravencrest,768,priest,shadow,12,8,4
Syreet,silvermoon,768,priest,shadow,12,8,4
Rýzera,aegwynn,768,priest,shadow,12,8,4
Возрождающее,soulflayer,768,priest,shadow,18,8,10
Jaanny,defias-brotherhood,768,priest,shadow,18,8,10
Qiandra,argent-dawn,768,priest,shadow,18,8,10
Хелектро,deathweaver,768,priest,shadow,18,8,10
Холиспирт,deathguard,767,priest,shadow,12,8,4
Бомжскадилом,gordunni,767,priest,shadow,12,8,4
Jegred,draenor,767,priest,shadow,12,8,4
Äiri,blackmoore,767,priest,shadow,18,8,10
Aereza,darkspear,767,priest,shadow,18,8,10
Kwolinger,norgannon,767,priest,shadow,18,8,10
Flexzpriest,destromath,767,priest,shadow,18,8,10
Unreal,nagrand,767,priest,shadow,18,8,10
Lynseanna,ravencrest,767,priest,shadow,18,8,10
Lênax,arthas,767,priest,shadow,18,8,10
Maskinjundre,bronzebeard,767,priest,shadow,24,8,16
Priestlolx,aegwynn,767,priest,shadow,24,8,16
Søcrax,blackrock,766,priest,shadow,12,8,4
Ехереу,blackscar,766,priest,shadow,12,8,4
Powna,blackrock,765,priest,shadow,12,8,4
Géèk,alakir,765,priest,shadow,19,8,11
Holyface,twisting-nether,764,priest,shadow,12,8,4
Sucukpriest,blackrock,764,priest,shadow,18,8,10
Sammel,moonglade,763,priest,shadow,18,8,10
Omnissiiah,silvermoon,763,priest,shadow,24,8,16
Ixdeadxl,stormscale,761,priest,shadow,18,8,10
Семмэр,gordunni,759,priest,shadow,27,9,18
Shíàpríést,kazzak,734,priest,shadow,29,8,21
Onskansmoder,shattered-hand,733,priest,shadow,22,8,14
Aeo,twisting-nether,732,priest,shadow,17,8,9
Raetwo,stormscale,703,priest,shadow,14,8,6
Ниомана,gordunni,698,priest,shadow,12,9,3
Systerstål,twisting-nether,672,priest,shadow,12,7,5
Sadgepriest,draenor,672,priest,shadow,12,7,5
Spherics,ravencrest,672,priest,shadow,12,7,5
Laradiel,dun-modr,672,priest,shadow,12,7,5
Baldracca,shendralar,672,priest,shadow,12,7,5
Zevulós,ravencrest,672,priest,shadow,12,7,5
Gød,magtheridon,672,priest,shadow,12,7,5
Fueguchi,anubarak,672,priest,shadow,12,7,5
Donkyrobert,tarren-mill,672,priest,shadow,12,7,5
Bizzlebabe,lightbringer,672,priest,shadow,12,7,5
Râvyn,silvermoon,672,priest,shadow,12,7,5
Sundae,nemesis,672,priest,shadow,12,7,5
Марриаза,blackscar,672,priest,shadow,12,7,5
Енотхд,soulflayer,672,priest,shadow,12,7,5
Uria,moonglade,672,priest,shadow,12,7,5
Миррен,gordunni,672,priest,shadow,12,7,5
Говорун,grom,672,priest,shadow,12,7,5
Solítu9D6529,tarren-mill,672,priest,shadow,12,7,5
Neitter,zuljin,672,priest,shadow,12,7,5
Leggat,draenor,672,priest,shadow,15,8,7
Heygoogle,ravencrest,672,priest,shadow,18,7,11
Charmebolzen,blackrock,672,priest,shadow,18,7,11
Homxcxde,ravencrest,672,priest,shadow,18,7,11
Majinbuù,sargeras,672,priest,shadow,18,7,11
Irlfatguy,ravencrest,672,priest,shadow,20,7,13
Syam,dun-morogh,672,priest,shadow,24,7,17
Cryptoniite,kazzak,671,priest,shadow,12,7,5
Абсорб,gordunni,671,priest,shadow,12,7,5
Elarya,zenedar,671,priest,shadow,12,7,5
Badomens,draenor,671,priest,shadow,12,7,5
Beonin,tarren-mill,671,priest,shadow,13,7,6
Neggan,chamber-of-aspects,671,priest,shadow,18,7,11
Дикрия,eversong,671,priest,shadow,18,7,11
Jerolol,sanguino,671,priest,shadow,18,7,11
Gooflord,ravencrest,671,priest,shadow,18,7,11
Офинсия,deathguard,671,priest,shadow,24,7,17
Hiela,outland,670,priest,shadow,12,7,5
Calor,nemesis,670,priest,shadow,12,7,5
Morgoh,die-arguswacht,670,priest,shadow,12,7,5
Kitasia,tarren-mill,670,priest,shadow,12,7,5
Haxxøn,die-nachtwache,670,priest,shadow,12,7,5
Sáro,ravencrest,669,priest,shadow,12,7,5
Phasmofobia,ragnaros,666,priest,shadow,12,7,5
Bonbonici,sylvanas,666,priest,shadow,12,7,5
Hulluh,tarren-mill,665,priest,shadow,12,7,5
Redfield,frostmane,663,priest,shadow,24,7,17
Ruhoniy,ysondre,658,priest,shadow,12,7,5
Sadskîx,dun-modr,624,priest,shadow,9,8,1
Brainwash,darksorrow,608,priest,shadow,16,7,9
Sxynix,thrall,607,priest,shadow,11,7,4
Reeflix,blackmoore,607,priest,shadow,17,8,9
Kirrako,tarren-mill,576,priest,shadow,6,6,0
Uselessxasel,sanguino,576,priest,shadow,6,6,0
Xceliann,stormscale,576,priest,shadow,6,6,0
Шандресса,deepholm,576,priest,shadow,6,6,0
Stèálth,sylvanas,576,priest,shadow,6,6,0
Inavea,hyjal,576,priest,shadow,6,6,0
Shacoat,draenor,576,priest,shadow,6,6,0
Fåith,twilights-hammer,576,priest,shadow,6,6,0
Uzü,ysondre,576,priest,shadow,10,7,3
Бранлор,howling-fjord,576,priest,shadow,12,6,6
Prästjäväln,stormscale,576,priest,shadow,12,6,6
Yaboyboompie,blackrock,576,priest,shadow,12,6,6
Tùcøcø,archimonde,576,priest,shadow,12,6,6
Miraçlê,kazzak,576,priest,shadow,12,6,6
Fluffieh,ravencrest,576,priest,shadow,12,6,6
Gbc,emerald-dream,576,priest,shadow,12,6,6
Babydark,ravencrest,576,priest,shadow,12,6,6
Papie,kazzak,576,priest,shadow,12,6,6
Despéri,ysondre,576,priest,shadow,12,6,6
Ктулсотум,soulflayer,576,priest,shadow,12,6,6
Тарренмилл,gordunni,576,priest,shadow,12,6,6
Carmechanic,defias-brotherhood,576,priest,shadow,12,6,6
Skyfour,blackmoore,576,priest,shadow,12,6,6
Bromiaris,dun-morogh,576,priest,shadow,12,6,6
Shadoxx,malganis,576,priest,shadow,12,6,6
Saliâ,blackmoore,576,priest,shadow,12,6,6
Cultist,defias-brotherhood,576,priest,shadow,12,6,6
Varjomies,ragnaros,576,priest,shadow,12,6,6
Lilsayx,blackrock,576,priest,shadow,12,6,6
Omedo,stormscale,576,priest,shadow,18,6,12
Khäñ,ravencrest,576,priest,shadow,24,6,18
Нитровина,howling-fjord,575,priest,shadow,12,6,6
ßeastx,nethersturm,575,priest,shadow,12,6,6
Princéssà,aegwynn,575,priest,shadow,12,6,6
Wintercurse,twisting-nether,575,priest,shadow,18,6,12
Sacreth,ragnaros,574,priest,shadow,24,6,18
Reptika,tichondrius,573,priest,shadow,12,6,6
Trencharse,draenor,559,priest,shadow,17,6,11
Ottii,thrall,553,priest,shadow,11,8,3
Skeida,bloodhoof,543,priest,shadow,11,6,5
Blóódfart,kazzak,520,priest,shadow,29,9,20
Õðæßìùa,kazzak,511,priest,shadow,11,6,5
Lildiggy,outland,511,priest,shadow,14,6,8
Døtgdx,archimonde,480,priest,shadow,6,5,1
Øhlø,ysondre,480,priest,shadow,6,5,1
Raeratwo,archimonde,480,priest,shadow,6,5,1
Shyasianpr,area-52,480,priest,shadow,6,5,1
Rinkahands,silvermoon,480,priest,shadow,6,5,1
Attilerg,stormscale,480,priest,shadow,6,5,1
Drarianna,nemesis,480,priest,shadow,6,5,1
Tigrok,burning-legion,480,priest,shadow,6,5,1
Jingling,kazzak,480,priest,shadow,6,5,1
Huffle,argent-dawn,480,priest,shadow,6,5,1
Sharmidix,kazzak,480,priest,shadow,6,5,1
Darkqt,ravencrest,480,priest,shadow,6,5,1
Wérrýxs,kazzak,480,priest,shadow,6,5,1
Anabølixx,ravencrest,480,priest,shadow,6,5,1
Potati,defias-brotherhood,480,priest,shadow,6,5,1
Makethemstop,bronzebeard,480,priest,shadow,6,5,1
Debbski,tarren-mill,480,priest,shadow,6,5,1
Скизма,gordunni,480,priest,shadow,6,5,1
Zeto,blackmoore,480,priest,shadow,6,5,1
Cluelêss,blackrock,480,priest,shadow,6,5,1
Aleetheia,silvermoon,480,priest,shadow,6,5,1
Yoggies,tarren-mill,480,priest,shadow,9,6,3
Korzec,dun-modr,480,priest,shadow,12,5,7
Shadowful,drakthul,480,priest,shadow,12,5,7
Wewo,drakthul,480,priest,shadow,12,5,7
Qwertyuioasd,ravencrest,480,priest,shadow,12,5,7
Taikki,stormreaver,480,priest,shadow,12,5,7
Nairima,argent-dawn,480,priest,shadow,12,5,7
Ryik,ravencrest,480,priest,shadow,12,5,7
Svenskabarn,twisting-nether,480,priest,shadow,12,5,7
Skûggpräst,silvermoon,480,priest,shadow,12,5,7
Darrianna,outland,480,priest,shadow,12,5,7
Cmonbro,hyjal,480,priest,shadow,12,5,7
Rovensin,ravencrest,480,priest,shadow,12,5,7
Lyssandre,stormreaver,480,priest,shadow,12,5,7
Felaenna,argent-dawn,480,priest,shadow,12,5,7
Seenoend,neptulon,480,priest,shadow,12,5,7
Smâshëd,stormscale,480,priest,shadow,12,5,7
Дакимакурах,gordunni,480,priest,shadow,12,5,7
Môrtïciâ,tarren-mill,480,priest,shadow,12,5,7
Nanna,agamaggan,480,priest,shadow,12,5,7
Whocare,tarren-mill,480,priest,shadow,12,5,7
Jarkk,ysondre,480,priest,shadow,12,5,7
Rokil,ravencrest,480,priest,shadow,12,5,7
Lasdrael,dun-modr,479,priest,shadow,6,5,1
Kíssme,archimonde,479,priest,shadow,6,5,1
Вэйворс,blackscar,479,priest,shadow,10,6,4
Crishroc,stormreaver,479,priest,shadow,12,5,7
Sigor,hellfire,479,priest,shadow,12,5,7
Heinricht,ragnaros,479,priest,shadow,12,5,7
Sacher,shendralar,479,priest,shadow,12,5,7
Soulsuckerr,silvermoon,479,priest,shadow,18,5,13
Карбираторх,gordunni,447,priest,shadow,11,5,6
Lightform,twisting-nether,432,priest,shadow,9,6,3
Diha,argent-dawn,384,priest,shadow,6,4,2
Umayyaa,sylvanas,384,priest,shadow,6,4,2
Îzî,sanguino,384,priest,shadow,6,4,2
Mafiasnipers,ravencrest,384,priest,shadow,6,4,2
Priestgrade,darkspear,384,priest,shadow,6,4,2
Æåeåeåé,twisting-nether,384,priest,shadow,6,4,2
Drë,daggerspine,384,priest,shadow,6,4,2
Achára,ravencrest,384,priest,shadow,6,4,2
Claritycraft,twisting-nether,384,priest,shadow,6,4,2
Слышуфонк,howling-fjord,384,priest,shadow,6,4,2
Majestíc,blackmoore,384,priest,shadow,6,4,2
Looó,los-errantes,384,priest,shadow,6,4,2
Velence,ravencrest,384,priest,shadow,6,4,2
Ylenae,twisting-nether,384,priest,shadow,6,4,2
Фьюриреидж,soulflayer,384,priest,shadow,6,4,2
Lysium,sylvanas,384,priest,shadow,6,4,2
Kobiden,stormreaver,384,priest,shadow,6,4,2
Люблюкофе,deathguard,384,priest,shadow,6,4,2
Êlectron,ravencrest,384,priest,shadow,6,4,2
Jpxoxo,blackhand,384,priest,shadow,6,4,2
Наярда,howling-fjord,384,priest,shadow,6,4,2
Holineß,burning-blade,384,priest,shadow,6,4,2
Alusiepriest,ravencrest,384,priest,shadow,6,4,2
Вэстервилли,howling-fjord,384,priest,shadow,6,4,2
Alicanx,twisting-nether,384,priest,shadow,6,4,2
Shadowboness,twisting-nether,384,priest,shadow,6,4,2
Seehz,ysondre,384,priest,shadow,6,4,2
Шучунекошмар,soulflayer,384,priest,shadow,6,4,2
Hòllymèdx,blackmoore,384,priest,shadow,6,4,2
Temtem,ravencrest,384,priest,shadow,6,4,2
Spae,twisting-nether,384,priest,shadow,6,4,2
Tokkz,kelthuzad,384,priest,shadow,6,4,2
Valaç,turalyon,384,priest,shadow,6,4,2
Cyrená,ravencrest,384,priest,shadow,6,4,2
Controlled,tarren-mill,384,priest,shadow,6,4,2
Alinfinito,ravencrest,384,priest,shadow,6,4,2
Sandcastles,ravencrest,384,priest,shadow,6,4,2
Peprama,stormscale,384,priest,shadow,6,4,2
Evílshadows,tarren-mill,384,priest,shadow,6,4,2
Vantek,antonidas,384,priest,shadow,6,4,2
Zindrix,silvermoon,384,priest,shadow,6,4,2
Lumex,aegwynn,384,priest,shadow,6,4,2
Roastie,frostmane,384,priest,shadow,6,4,2
Torino,kazzak,384,priest,shadow,6,4,2
Atropin,silvermoon,384,priest,shadow,6,4,2
Dumámày,silvermoon,384,priest,shadow,6,4,2
Dogstav,kazzak,384,priest,shadow,6,4,2
Draryanna,nemesis,384,priest,shadow,6,4,2
Squîzz,archimonde,384,priest,shadow,6,4,2
Libstik,hyjal,384,priest,shadow,6,4,2
Raëkon,nemesis,384,priest,shadow,6,4,2
Necrofeel,silvermoon,384,priest,shadow,6,4,2
Ihaveibs,doomhammer,384,priest,shadow,13,5,8
Strvnge,stormreaver,384,priest,shadow,11,4,7
Nìak,ysondre,384,priest,shadow,15,5,10
Самоэль,gordunni,384,priest,shadow,12,4,8
Grayraven,azjolnerub,384,priest,shadow,12,4,8
Ларчшп,gordunni,384,priest,shadow,12,4,8
Отчепадре,gordunni,384,priest,shadow,12,4,8
Jellypie,blackrock,384,priest,shadow,12,4,8
Umbrazoid,sanguino,384,priest,shadow,12,4,8
Gerase,blackrock,384,priest,shadow,12,4,8
Swoptoplong,blackhand,384,priest,shadow,12,4,8
Psystorm,frostmane,384,priest,shadow,12,4,8
Bacovia,tarren-mill,384,priest,shadow,12,4,8
Dpriesta,aegwynn,384,priest,shadow,12,4,8
Lfgarcatraz,aegwynn,384,priest,shadow,12,4,8
Shadøwz,grim-batol,384,priest,shadow,12,4,8
Chlorohhkine,chogall,384,priest,shadow,13,4,9
Zultor,ragnaros,384,priest,shadow,13,4,9
Tobirama,stormscale,384,priest,shadow,17,4,13
Zerim,blackmoore,384,priest,shadow,18,4,14
Cederpriest,tarren-mill,384,priest,shadow,18,4,14
Bloodimand,terenas,383,priest,shadow,6,4,2
Brainmuscle,ravencrest,383,priest,shadow,6,4,2
Sphard,ysondre,383,priest,shadow,12,4,8
Stoffig,aggramar,382,priest,shadow,6,4,2
Намдандар,howling-fjord,382,priest,shadow,12,4,8
Perchédue,silvermoon,367,priest,shadow,11,4,7
Tweediertie,argent-dawn,335,priest,shadow,11,4,7
Solaní,antonidas,335,priest,shadow,11,4,7
Anabølix,ravencrest,288,priest,shadow,6,3,3
Vilayetko,ravencrest,288,priest,shadow,6,3,3
Dunkelseele,ahnqiraj,288,priest,shadow,6,3,3
Цитамин,deathguard,288,priest,shadow,6,3,3
Allanna,talnivarr,288,priest,shadow,6,3,3
Смегмачет,soulflayer,288,priest,shadow,6,3,3
Мариаглорум,gordunni,288,priest,shadow,6,3,3
Лиройгеморой,gordunni,288,priest,shadow,6,3,3
Skillmåster,ravencrest,288,priest,shadow,6,3,3
Kallsen,ravencrest,288,priest,shadow,6,3,3
Даняпимпгадх,soulflayer,288,priest,shadow,6,3,3
Chaddius,stormscale,288,priest,shadow,6,3,3
Shadowchunks,argent-dawn,288,priest,shadow,6,3,3
Barthólomew,doomhammer,288,priest,shadow,6,3,3
Maela,uldum,288,priest,shadow,6,3,3
Liliashet,sanguino,288,priest,shadow,6,3,3
Stinkycreep,executus,288,priest,shadow,6,3,3
Ahle,darkspear,288,priest,shadow,6,3,3
Laffy,saurfang,288,priest,shadow,6,3,3
Chandria,veknilash,288,priest,shadow,6,3,3
Sweedensp,hyjal,288,priest,shadow,6,3,3
Aliocha,dalaran,288,priest,shadow,6,3,3
Holybestie,eredar,288,priest,shadow,6,3,3
Dimorinny,silvermoon,288,priest,shadow,6,3,3
Montane,wrathbringer,288,priest,shadow,6,3,3
Nitza,silvermoon,288,priest,shadow,6,3,3
Fnúggí,kazzak,288,priest,shadow,6,3,3
Roxfer,ysondre,288,priest,shadow,6,3,3
Imadîa,dalaran,288,priest,shadow,6,3,3
Abyssonmind,dun-modr,288,priest,shadow,6,3,3
Arratør,ysondre,288,priest,shadow,6,3,3
Zøid,ysondre,288,priest,shadow,6,3,3
Xaviá,blackrock,288,priest,shadow,6,3,3
Pbwser,silvermoon,288,priest,shadow,6,3,3
Lethaa,twisting-nether,288,priest,shadow,6,3,3
Sàyaa,draenor,288,priest,shadow,6,3,3
Linara,frostmane,288,priest,shadow,6,3,3
Chaarronn,drakthul,288,priest,shadow,6,3,3
Grocx,kazzak,288,priest,shadow,6,3,3
Hilerki,draenor,288,priest,shadow,6,3,3
Ragwitch,draenor,288,priest,shadow,6,3,3
Skymning,tarren-mill,288,priest,shadow,6,3,3
Wkid,draenor,288,priest,shadow,6,3,3
Presbyter,mazrigos,288,priest,shadow,6,3,3
Nhajÿ,hyjal,288,priest,shadow,6,3,3
Stepsisstuck,ragnaros,288,priest,shadow,6,3,3
Xpy,kazzak,288,priest,shadow,6,3,3
Ggsus,outland,288,priest,shadow,6,3,3
Nukyo,blackmoore,288,priest,shadow,6,3,3
Freezydot,silvermoon,288,priest,shadow,6,3,3
Anexxia,outland,288,priest,shadow,6,3,3
Mindboorst,kazzak,288,priest,shadow,6,3,3
Notra,shattrath,288,priest,shadow,6,3,3
Dboi,tarren-mill,288,priest,shadow,6,3,3
Rippeep,emerald-dream,288,priest,shadow,6,3,3
Papynou,garona,288,priest,shadow,6,3,3
Dolens,argent-dawn,288,priest,shadow,6,3,3
Cðsima,blackmoore,288,priest,shadow,6,3,3
Balthe,defias-brotherhood,288,priest,shadow,6,3,3
Syntara,twisting-nether,288,priest,shadow,6,3,3
Jlox,stormscale,288,priest,shadow,9,4,5
Kopfsache,blackmoore,288,priest,shadow,7,3,4
Freshpope,ravencrest,288,priest,shadow,10,4,6
Петушшара,gordunni,288,priest,shadow,9,3,6
Cthultist,dun-modr,288,priest,shadow,12,3,9
Damnedangel,drakthul,288,priest,shadow,12,3,9
Nesar,stormscale,288,priest,shadow,12,3,9
Atelstan,drakthul,288,priest,shadow,12,3,9
Aaluvor,blackmoore,288,priest,shadow,12,3,9
Hâstur,ravencrest,288,priest,shadow,12,3,9
Shreedz,blackmoore,288,priest,shadow,12,3,9
Elumi,the-maelstrom,288,priest,shadow,12,3,9
Васпохилить,howling-fjord,288,priest,shadow,18,3,15
Kaenlin,the-maelstrom,288,priest,shadow,18,3,15
Мргорсан,eversong,287,priest,shadow,6,3,3
Mimox,kaelthas,287,priest,shadow,6,3,3
Jês,thrall,287,priest,shadow,6,3,3
Акциуми,howling-fjord,287,priest,shadow,6,3,3
Syfl,defias-brotherhood,287,priest,shadow,12,3,9
Endchor,eredar,286,priest,shadow,6,3,3
Irrtum,nozdormu,286,priest,shadow,6,3,3
Czikibriki,ravenholdt,256,priest,shadow,4,4,0
Guccimaane,twisting-nether,239,priest,shadow,5,3,2
Deeforce,argent-dawn,234,priest,shadow,6,4,2
Twisty,malganis,234,priest,shadow,11,7,4
Shadowflamè,outland,192,priest,shadow,4,3,1
Szycho,burning-legion,192,priest,shadow,9,3,6
Happychap,stormreaver,192,priest,shadow,6,2,4
Мсикатана,gordunni,192,priest,shadow,6,2,4
Nomarak,drakthul,192,priest,shadow,6,2,4
Elëctra,vashj,192,priest,shadow,6,2,4
Ràthaløs,sanguino,192,priest,shadow,6,2,4
Sotriggered,sylvanas,192,priest,shadow,6,2,4
Шарадин,gordunni,192,priest,shadow,6,2,4
Slimshadey,malganis,192,priest,shadow,6,2,4
Kidkuddo,blackmoore,192,priest,shadow,6,2,4
Clemexyo,stormscale,192,priest,shadow,6,2,4
Vregoa,twisting-nether,192,priest,shadow,6,2,4
Безмездная,gordunni,192,priest,shadow,6,2,4
Tankeløs,kazzak,192,priest,shadow,6,2,4
Rallzken,stormscale,192,priest,shadow,6,2,4
Tuljan,twisting-nether,192,priest,shadow,6,2,4
Velansera,argent-dawn,192,priest,shadow,6,2,4
Ичисанчик,howling-fjord,192,priest,shadow,6,2,4
Crzzy,dun-modr,192,priest,shadow,6,2,4
Wiglere,argent-dawn,192,priest,shadow,6,2,4
Сорвиголов,howling-fjord,192,priest,shadow,6,2,4
Alpharîus,argent-dawn,192,priest,shadow,6,2,4
Дашажмитучу,howling-fjord,192,priest,shadow,6,2,4
Oknelim,blackmoore,192,priest,shadow,6,2,4
Triinkett,doomhammer,192,priest,shadow,6,2,4
Zikár,kazzak,192,priest,shadow,6,2,4
Hadsup,stormscale,192,priest,shadow,6,2,4
Lythra,burning-legion,192,priest,shadow,6,2,4
Calïxløve,der-rat-von-dalaran,192,priest,shadow,6,2,4
Lugburzz,draenor,192,priest,shadow,6,2,4
Omejan,frostmane,192,priest,shadow,6,2,4
Phobò,blackrock,192,priest,shadow,6,2,4
Cto,gorgonnash,192,priest,shadow,6,2,4
Misántropo,dun-modr,192,priest,shadow,6,2,4
Bòóny,ravencrest,192,priest,shadow,6,2,4
Bandgap,antonidas,192,priest,shadow,6,2,4
Daven,ysondre,192,priest,shadow,6,2,4
Shinesomnya,aegwynn,192,priest,shadow,6,2,4
Arunp,magtheridon,192,priest,shadow,6,2,4
Xiä,archimonde,192,priest,shadow,6,2,4
Vengigodxx,ravencrest,192,priest,shadow,6,2,4
Otheym,the-maelstrom,192,priest,shadow,6,2,4
Низара,deathguard,192,priest,shadow,6,2,4
Kaleshiry,kazzak,192,priest,shadow,6,2,4
Notdespo,kazzak,192,priest,shadow,6,2,4
Aruna,ravencrest,192,priest,shadow,6,2,4
Xaeroow,archimonde,192,priest,shadow,6,2,4
Claudefrollo,the-maelstrom,192,priest,shadow,7,2,5
Önnÿ,dun-modr,192,priest,shadow,12,2,10
Karmapollys,silvermoon,191,priest,shadow,6,2,4
Shidoya,tarren-mill,159,priest,shadow,5,2,3
Edoran,ragnaros,159,priest,shadow,5,2,3
Girlidlion,twisting-nether,159,priest,shadow,5,2,3
Qku,ravencrest,144,priest,shadow,9,3,6
Пампгодх,howling-fjord,138,priest,shadow,10,4,6
Spideypap,ragnaros,138,priest,shadow,10,3,7
Alswynn,draenor,138,priest,shadow,13,3,10
Leckpriest,sanguino,128,priest,shadow,4,2,2
Yologrumples,tarren-mill,128,priest,shadow,4,2,2
Абсорбиболь,howling-fjord,96,priest,shadow,6,1,5
Maddøc,die-aldor,96,priest,shadow,6,1,5
Nerfnerf,kazzak,96,priest,shadow,6,1,5
Enduring,darksorrow,96,priest,shadow,6,1,5
Koíré,defias-brotherhood,96,priest,shadow,6,1,5
Gobie,sunstrider,96,priest,shadow,6,1,5
Jakepriest,twisting-nether,96,priest,shadow,6,1,5
Lapinvicieux,archimonde,96,priest,shadow,6,1,5
Skitcy,ghostlands,96,priest,shadow,6,1,5
Shifune,blackhand,96,priest,shadow,6,1,5
Мегаствол,howling-fjord,96,priest,shadow,6,1,5
Kristiflicka,kazzak,96,priest,shadow,6,1,5
Atheniss,drakthul,96,priest,shadow,6,1,5
Winstõn,sanguino,96,priest,shadow,6,1,5
Abudhabi,blackhand,96,priest,shadow,6,1,5
Zukatana,tarren-mill,96,priest,shadow,6,1,5
Kianprie,silvermoon,96,priest,shadow,6,1,5
Oniakusa,outland,96,priest,shadow,6,1,5
Príêstjklòl,stormscale,96,priest,shadow,6,1,5
Vès,stormscale,96,priest,shadow,6,1,5
Meatyshaft,doomhammer,96,priest,shadow,6,1,5
Rines,thrall,96,priest,shadow,6,1,5
Apèx,blackrock,96,priest,shadow,6,1,5
Baltrom,ravencrest,96,priest,shadow,6,1,5
Stola,archimonde,96,priest,shadow,6,1,5
Tryagain,ravencrest,96,priest,shadow,6,1,5
Deicidex,blackrock,96,priest,shadow,6,1,5
Tiras,argent-dawn,96,priest,shadow,12,1,11
Yonaka,amanthul,96,priest,shadow,12,1,11
Эсттелла,gordunni,96,priest,shadow,18,1,17
Gandals,shadowsong,64,priest,shadow,4,1,3
Xharyo,ravencrest,64,priest,shadow,4,1,3
Achesita,sylvanas,48,priest,shadow,3,1,2
Rãz,stormscale,2130,rogue,outlaw,66,36,30
Kekuriix,vashj,1877,rogue,outlaw,112,60,52
Дизелюжн,howling-fjord,1773,rogue,outlaw,72,35,37
Макевин,gordunni,1750,rogue,outlaw,52,24,28
Yessa,argent-dawn,1721,rogue,outlaw,36,18,18
Jalsket,tarren-mill,1666,rogue,outlaw,36,20,16
Syrn,ravencrest,1579,rogue,outlaw,48,22,26
Kreay,tarren-mill,1576,rogue,outlaw,40,29,11
Lidiaubaro,ravencrest,1556,rogue,outlaw,161,78,83
Bonelesschic,silvermoon,1516,rogue,outlaw,65,39,26
Deevoll,tarren-mill,1481,rogue,outlaw,102,45,57
Jasolo,silvermoon,1480,rogue,outlaw,153,91,62
Kreayx,ysondre,1438,rogue,outlaw,30,15,15
Nèwt,aggramar,1419,rogue,outlaw,84,40,44
Зувер,blackscar,1416,rogue,outlaw,88,45,43
Loubina,silvermoon,1408,rogue,outlaw,30,15,15
Sigleif,argent-dawn,1407,rogue,outlaw,54,25,29
Scotlander,argent-dawn,1401,rogue,outlaw,30,15,15
Cryneth,ravencrest,1373,rogue,outlaw,51,25,26
Kreay,ysondre,1343,rogue,outlaw,30,14,16
Koopa,argent-dawn,1336,rogue,outlaw,30,14,16
Murkyy,gilneas,1329,rogue,outlaw,32,16,16
Djeud,archimonde,1293,rogue,outlaw,52,27,25
Tidløs,dun-morogh,1270,rogue,outlaw,41,15,26
Carvyn,defias-brotherhood,1255,rogue,outlaw,33,15,18
Radiogodx,stormscale,1239,rogue,outlaw,36,13,23
Jinzou,blackmoore,1153,rogue,outlaw,39,19,20
Феинт,galakrond,1150,rogue,outlaw,36,12,24
Шторкаа,gordunni,1148,rogue,outlaw,25,14,11
Spiochrr,burning-legion,1064,rogue,outlaw,44,17,27
Lättja,hyjal,1059,rogue,outlaw,24,12,12
Svddendeath,ragnaros,1034,rogue,outlaw,24,11,13
Génn,silvermoon,1009,rogue,outlaw,38,17,21
Shredfngrz,garona,986,rogue,outlaw,26,11,15
Déjávu,ravencrest,959,rogue,outlaw,18,10,8
Melahl,kazzak,909,rogue,outlaw,18,11,7
Bxtchslayer,blackmoore,876,rogue,outlaw,18,10,8
Bannedfrigid,outland,864,rogue,outlaw,24,9,15
Ранконх,lich-king,863,rogue,outlaw,30,9,21
Lïke,frostwolf,768,rogue,outlaw,12,8,4
Bikrut,hyjal,768,rogue,outlaw,12,8,4
Gerzy,drakthul,768,rogue,outlaw,18,8,10
Джулт,soulflayer,767,rogue,outlaw,24,8,16
Blàckbèàrd,silvermoon,753,rogue,outlaw,36,13,23
Kidneyou,ragnaros,672,rogue,outlaw,18,7,11
Rogiko,twisting-nether,672,rogue,outlaw,18,7,11
Omgjkgtfo,ravencrest,671,rogue,outlaw,18,7,11
Åråmsëß,grim-batol,670,rogue,outlaw,12,7,5
Shichi,archimonde,655,rogue,outlaw,17,7,10
Pistolpete,grim-batol,576,rogue,outlaw,12,6,6
Vokhun,outland,576,rogue,outlaw,12,6,6
Badabôôm,wrathbringer,575,rogue,outlaw,12,6,6
Noodlegoose,tarren-mill,575,rogue,outlaw,12,6,6
Pidroseus,argent-dawn,575,rogue,outlaw,12,6,6
Кингксу,gordunni,575,rogue,outlaw,24,6,18
Тимареканец,eversong,572,rogue,outlaw,18,6,12
Omuspan,magtheridon,558,rogue,outlaw,18,6,12
Zômbiê,blackrock,491,rogue,outlaw,13,6,7
Eukaryot,aggra-português,480,rogue,outlaw,6,5,1
Faoil,defias-brotherhood,480,rogue,outlaw,12,5,7
Fivepoint,blackmoore,480,rogue,outlaw,12,5,7
Featfawkes,ragnaros,480,rogue,outlaw,12,5,7
Krixor,ravencrest,480,rogue,outlaw,18,5,13
Nocrath,blades-edge,479,rogue,outlaw,12,5,7
Chillo,ravencrest,384,rogue,outlaw,6,4,2
Delrøq,draenor,384,rogue,outlaw,6,4,2
Synexo,sylvanas,384,rogue,outlaw,12,4,8
Trímønâ,gorgonnash,351,rogue,outlaw,11,4,7
Masteez,ahnqiraj,318,rogue,outlaw,5,4,1
Shadxwstep,ravencrest,288,rogue,outlaw,6,3,3
Cigarette,emeriss,288,rogue,outlaw,6,3,3
Играючестно,howling-fjord,288,rogue,outlaw,6,3,3
Zyreanxy,blackrock,288,rogue,outlaw,6,3,3
Onlyluvhurt,dun-modr,288,rogue,outlaw,6,3,3
Finisher,sanguino,288,rogue,outlaw,12,3,9
Heulleise,die-ewige-wacht,288,rogue,outlaw,12,3,9
Mcgora,doomhammer,286,rogue,outlaw,6,3,3
Tipok,tarren-mill,286,rogue,outlaw,12,3,9
Soothinqq,emerald-dream,238,rogue,outlaw,5,3,2
Оргельна,gordunni,192,rogue,outlaw,6,2,4
Mawrat,mazrigos,192,rogue,outlaw,6,2,4
Sneakysteve,bloodfeather,192,rogue,outlaw,6,2,4
Szpachela,burning-legion,192,rogue,outlaw,6,2,4
Banaulikode,twisting-nether,192,rogue,outlaw,6,2,4
Zind,dalaran,192,rogue,outlaw,6,2,4
Nyxal,argent-dawn,192,rogue,outlaw,6,2,4
Alvoriace,hyjal,192,rogue,outlaw,12,2,10
Hânnäh,hyjal,191,rogue,outlaw,6,2,4
Rivso,auchindoun,159,rogue,outlaw,8,3,5
Matchfixer,moonglade,138,rogue,outlaw,10,3,7
Mallaurya,dalaran,96,rogue,outlaw,6,1,5
Dredge,kaelthas,96,rogue,outlaw,6,1,5
Yüm,burning-blade,96,rogue,outlaw,6,1,5
Vaze,ravencrest,96,rogue,outlaw,6,1,5
Ciaordel,sylvanas,96,rogue,outlaw,6,1,5
Nabatean,magtheridon,48,rogue,outlaw,3,1,2
Фофламидзе,gordunni,47,rogue,outlaw,3,1,2
Getbleeded,stormscale,31,rogue,outlaw,2,1,1
Cazzette,ravencrest,2204,rogue,subtlety,81,48,33
Лолелт,borean-tundra,2131,rogue,subtlety,104,53,51
Denjinx,culte-de-la-rive-noire,2107,rogue,subtlety,78,43,35
Pridå,thrall,2107,rogue,subtlety,78,41,37
Sunø,archimonde,2063,rogue,subtlety,100,48,52
Смертьвсмоке,gordunni,1977,rogue,subtlety,104,52,52
Nàsklolz,hyjal,1971,rogue,subtlety,60,31,29
Chatdisabled,drakthul,1913,rogue,subtlety,102,53,49
Asterisyup,silvermoon,1909,rogue,subtlety,89,55,34
Флексити,soulflayer,1907,rogue,subtlety,84,43,41
Clawdíte,blackrock,1895,rogue,subtlety,48,21,27
Makethemrog,archimonde,1887,rogue,subtlety,68,34,34
Пожилойпупь,gordunni,1869,rogue,subtlety,36,20,16
Sapécomejaja,archimonde,1866,rogue,subtlety,38,24,14
Asumah,ravencrest,1863,rogue,subtlety,36,22,14
Brensø,nemesis,1857,rogue,subtlety,99,60,39
Âkame,argent-dawn,1853,rogue,subtlety,59,32,27
Zuqzwang,outland,1840,rogue,subtlety,48,26,22
Shadezlöl,ravencrest,1838,rogue,subtlety,130,65,65
Illmatíc,ravencrest,1828,rogue,subtlety,56,29,27
Тохуо,lich-king,1822,rogue,subtlety,42,20,22
Radiogodx,stormscale,1817,rogue,subtlety,60,31,29
Sly,emerald-dream,1814,rogue,subtlety,36,22,14
Iqws,ravencrest,1811,rogue,subtlety,54,29,25
Renhri,burning-legion,1811,rogue,subtlety,191,102,89
Troxerboxer,tarren-mill,1806,rogue,subtlety,42,22,20
Xtoyo,zuljin,1804,rogue,subtlety,54,29,25
Røgger,ragnaros,1798,rogue,subtlety,107,52,55
Chatbann,blackrock,1774,rogue,subtlety,106,59,47
Naïmitsu,hyjal,1762,rogue,subtlety,60,34,26
Vulkos,lightbringer,1758,rogue,subtlety,42,20,22
Stonyhavana,ravencrest,1757,rogue,subtlety,60,36,24
Stråwberrý,archimonde,1753,rogue,subtlety,57,28,29
Lilaven,turalyon,1752,rogue,subtlety,54,28,26
Погибайдуде,gordunni,1749,rogue,subtlety,35,28,7
Lówskill,outland,1746,rogue,subtlety,66,32,34
Lfgenjoyer,tarren-mill,1743,rogue,subtlety,42,25,17
Инфера,lich-king,1741,rogue,subtlety,72,33,39
Îlîlîlîlîlî,azuremyst,1736,rogue,subtlety,98,55,43
Эмилилавс,galakrond,1732,rogue,subtlety,118,65,53
Shadowprank,ravencrest,1731,rogue,subtlety,48,27,21
Trîçk,aegwynn,1719,rogue,subtlety,36,23,13
Malasap,archimonde,1719,rogue,subtlety,128,69,59
Insomnla,silvermoon,1714,rogue,subtlety,90,46,44
Sábros,ravencrest,1714,rogue,subtlety,108,50,58
Yumiee,arygos,1697,rogue,subtlety,80,44,36
Бладстейн,blackscar,1684,rogue,subtlety,64,37,27
Китей,howling-fjord,1682,rogue,subtlety,36,18,18
Mâêl,blackmoore,1676,rogue,subtlety,89,47,42
Роземсти,gordunni,1676,rogue,subtlety,74,38,36
Rhayesh,silvermoon,1665,rogue,subtlety,100,47,53
Ccedolol,stormscale,1662,rogue,subtlety,59,32,27
Handuil,blackmoore,1652,rogue,subtlety,84,47,37
Sariena,sylvanas,1648,rogue,subtlety,54,27,27
Getschwîfty,ravencrest,1639,rogue,subtlety,27,18,9
Namelless,twisting-nether,1637,rogue,subtlety,60,29,31
Bleakhøuse,ravencrest,1635,rogue,subtlety,40,20,20
Dancex,kazzak,1634,rogue,subtlety,42,28,14
Lânnïster,kazzak,1626,rogue,subtlety,42,20,22
Ishízu,exodar,1625,rogue,subtlety,54,24,30
Asm,the-maelstrom,1622,rogue,subtlety,40,20,20
Tinylol,dun-morogh,1620,rogue,subtlety,48,29,19
Subsònik,tarren-mill,1617,rogue,subtlety,46,27,19
Baldoh,kazzak,1614,rogue,subtlety,30,22,8
Säxnthecrity,blackmoore,1613,rogue,subtlety,119,62,57
Tanssy,ragnaros,1610,rogue,subtlety,50,28,22
Ratirl,kult-der-verdammten,1603,rogue,subtlety,30,19,11
Ipresskidney,tarren-mill,1601,rogue,subtlety,99,58,41
Кишмякх,howling-fjord,1599,rogue,subtlety,72,24,48
Exanimu,ravencrest,1597,rogue,subtlety,72,30,42
Vensq,drakthul,1596,rogue,subtlety,36,19,17
Txm,argent-dawn,1590,rogue,subtlety,36,18,18
Морзо,howling-fjord,1582,rogue,subtlety,66,39,27
Oxyrog,ravencrest,1580,rogue,subtlety,42,22,20
Shyy,dun-modr,1568,rogue,subtlety,42,20,22
Сильфитт,gordunni,1565,rogue,subtlety,40,21,19
Liarø,archimonde,1546,rogue,subtlety,30,18,12
Evivalarte,burning-legion,1542,rogue,subtlety,36,20,16
Kidknee,outland,1537,rogue,subtlety,30,17,13
Sinist,twisting-nether,1531,rogue,subtlety,50,23,27
Sniiky,kazzak,1530,rogue,subtlety,66,39,27
Zilemjr,stormscale,1522,rogue,subtlety,30,19,11
Trapstar,stormscale,1520,rogue,subtlety,48,23,25
Ninjaassasin,aegwynn,1515,rogue,subtlety,58,32,26
Calestrian,tarren-mill,1512,rogue,subtlety,36,16,20
Chimp,darksorrow,1505,rogue,subtlety,35,21,14
Ramses,onyxia,1505,rogue,subtlety,42,18,24
Cøntrøl,stormreaver,1503,rogue,subtlety,72,39,33
Azirios,kazzak,1503,rogue,subtlety,30,16,14
Cheapshôt,archimonde,1502,rogue,subtlety,58,29,29
Shaeni,silvermoon,1501,rogue,subtlety,54,30,24
Абисиан,soulflayer,1500,rogue,subtlety,66,36,30
Meccura,silvermoon,1484,rogue,subtlety,39,22,17
Ibizå,ravencrest,1477,rogue,subtlety,36,18,18
Sashikorosu,archimonde,1471,rogue,subtlety,45,30,15
Yourexwifey,ravencrest,1470,rogue,subtlety,65,37,28
Grifika,outland,1469,rogue,subtlety,30,18,12
Ванэйти,gordunni,1468,rogue,subtlety,178,94,84
Aszaryn,magtheridon,1467,rogue,subtlety,42,21,21
Rogueas,stormscale,1466,rogue,subtlety,29,18,11
Шпилля,gordunni,1459,rogue,subtlety,71,34,37
Voki,dalaran,1458,rogue,subtlety,69,37,32
Шадовкилер,blackscar,1458,rogue,subtlety,66,34,32
Johnnyprep,ravencrest,1454,rogue,subtlety,54,29,25
Kire,daggerspine,1452,rogue,subtlety,35,17,18
Nightq,tarren-mill,1450,rogue,subtlety,57,34,23
Zømbië,kazzak,1445,rogue,subtlety,54,19,35
Inyria,outland,1438,rogue,subtlety,118,61,57
Dêlaral,blackhand,1437,rogue,subtlety,30,15,15
Jáyjay,antonidas,1437,rogue,subtlety,54,23,31
Tracersxrude,ravencrest,1437,rogue,subtlety,36,15,21
Skýfire,ravencrest,1435,rogue,subtlety,36,16,20
Morgan,argent-dawn,1431,rogue,subtlety,60,35,25
Зенофар,soulflayer,1431,rogue,subtlety,53,23,30
Deathcvlt,hyjal,1428,rogue,subtlety,72,35,37
Magepèt,tarren-mill,1426,rogue,subtlety,30,15,15
Gankbang,frostmane,1426,rogue,subtlety,60,28,32
Ñavy,archimonde,1425,rogue,subtlety,60,27,33
Дернирог,howling-fjord,1418,rogue,subtlety,30,17,13
Memphismp,drakthul,1404,rogue,subtlety,29,15,14
Grzech,burning-legion,1403,rogue,subtlety,42,19,23
Svddendeath,ragnaros,1401,rogue,subtlety,42,21,21
Sumsarx,ravencrest,1400,rogue,subtlety,77,38,39
Teba,cthun,1391,rogue,subtlety,28,16,12
Onlyluvhurt,dun-modr,1391,rogue,subtlety,70,36,34
Xblackhole,tarren-mill,1390,rogue,subtlety,41,20,21
Эренх,gordunni,1382,rogue,subtlety,74,37,37
Wraithh,minahonda,1380,rogue,subtlety,36,21,15
Billybang,outland,1372,rogue,subtlety,65,36,29
Tripx,ravencrest,1370,rogue,subtlety,85,47,38
Appatras,tarren-mill,1369,rogue,subtlety,23,15,8
Зорго,deathguard,1366,rogue,subtlety,30,15,15
Loopermann,silvermoon,1366,rogue,subtlety,34,16,18
Spr,malfurion,1362,rogue,subtlety,64,35,29
Huej,tarren-mill,1353,rogue,subtlety,48,32,16
Trimøná,gorgonnash,1351,rogue,subtlety,24,15,9
Эдкенуэй,gordunni,1351,rogue,subtlety,47,25,22
Dàwn,boulderfist,1349,rogue,subtlety,46,25,21
Smøkyyx,eredar,1342,rogue,subtlety,30,14,16
Лолелт,howling-fjord,1341,rogue,subtlety,24,14,10
Keophz,tarren-mill,1340,rogue,subtlety,30,19,11
Achterom,tarren-mill,1338,rogue,subtlety,68,26,42
Жабоклик,gordunni,1336,rogue,subtlety,50,23,27
Starfighter,pozzo-delleternità,1331,rogue,subtlety,30,14,16
Lilrookie,argent-dawn,1327,rogue,subtlety,50,30,20
Nexieane,ravencrest,1324,rogue,subtlety,72,39,33
Bleeds,thrall,1324,rogue,subtlety,47,24,23
Солевыегубки,gordunni,1322,rogue,subtlety,24,14,10
Рестинписер,soulflayer,1322,rogue,subtlety,72,38,34
Сабик,howling-fjord,1318,rogue,subtlety,18,14,4
Sénsorium,draenor,1306,rogue,subtlety,59,29,30
Mxx,stormscale,1300,rogue,subtlety,81,45,36
Luckeri,antonidas,1300,rogue,subtlety,66,32,34
Ракфорн,howling-fjord,1289,rogue,subtlety,48,21,27
Бэтх,soulflayer,1286,rogue,subtlety,30,17,13
Dölf,archimonde,1285,rogue,subtlety,38,20,18
Прошмандэ,gordunni,1282,rogue,subtlety,30,15,15
Xeggy,turalyon,1278,rogue,subtlety,70,43,27
Althieves,ravencrest,1272,rogue,subtlety,41,22,19
Guiltythief,stormscale,1272,rogue,subtlety,37,18,19
Старллесс,gordunni,1270,rogue,subtlety,89,44,45
Azovrouge,terokkar,1266,rogue,subtlety,60,31,29
Calpic,sanguino,1259,rogue,subtlety,36,17,19
Usainßreak,chogall,1258,rogue,subtlety,24,14,10
Subzy,burning-legion,1257,rogue,subtlety,30,18,12
Zourkan,archimonde,1250,rogue,subtlety,65,36,29
Tyrly,ravencrest,1250,rogue,subtlety,28,15,13
Swâggerino,kazzak,1250,rogue,subtlety,44,22,22
Denjastwo,archimonde,1248,rogue,subtlety,18,13,5
Shoxy,ravencrest,1248,rogue,subtlety,27,14,13
Sunå,archimonde,1247,rogue,subtlety,24,13,11
Путьказаха,gordunni,1245,rogue,subtlety,18,13,5
Binbág,draenor,1245,rogue,subtlety,36,22,14
Zanaken,stormscale,1245,rogue,subtlety,42,21,21
Тучёна,soulflayer,1243,rogue,subtlety,42,25,17
Pfourtwenty,eredar,1243,rogue,subtlety,24,13,11
Leepz,outland,1242,rogue,subtlety,24,14,10
Levíeus,blackrock,1241,rogue,subtlety,48,29,19
Wøølfgang,archimonde,1240,rogue,subtlety,54,25,29
Norlix,ravencrest,1239,rogue,subtlety,24,13,11
Ÿøßø,archimonde,1238,rogue,subtlety,24,13,11
Mishøna,kazzak,1237,rogue,subtlety,54,31,23
Ézzah,blackhand,1236,rogue,subtlety,69,27,42
Jugalos,ravencrest,1230,rogue,subtlety,35,13,22
Yakio,silvermoon,1229,rogue,subtlety,30,13,17
Adwl,archimonde,1226,rogue,subtlety,45,20,25
Daggerdashx,ravencrest,1222,rogue,subtlety,54,33,21
Monoxid,eredar,1222,rogue,subtlety,30,14,16
Ултра,gordunni,1216,rogue,subtlety,51,24,27
Grindz,ravencrest,1212,rogue,subtlety,42,19,23
Ксионас,gordunni,1212,rogue,subtlety,82,36,46
Sicariø,argent-dawn,1209,rogue,subtlety,36,15,21
Architeggt,eredar,1209,rogue,subtlety,38,14,24
Gansull,nemesis,1207,rogue,subtlety,30,13,17
Коффемолка,ashenvale,1204,rogue,subtlety,48,19,29
Ganker,antonidas,1202,rogue,subtlety,30,15,15
Сладкийперец,borean-tundra,1202,rogue,subtlety,46,22,24
Avøry,antonidas,1201,rogue,subtlety,30,13,17
Skillissuex,tarren-mill,1200,rogue,subtlety,54,31,23
ßøß,ysondre,1193,rogue,subtlety,32,17,15
Hashlund,stormscale,1181,rogue,subtlety,38,17,21
Cesârion,antonidas,1180,rogue,subtlety,69,26,43
Elfreyja,archimonde,1176,rogue,subtlety,33,14,19
Knoffchad,blackhand,1174,rogue,subtlety,32,13,19
Arrzhan,silvermoon,1167,rogue,subtlety,18,14,4
Kïdney,stormscale,1162,rogue,subtlety,24,13,11
Darkan,kaelthas,1159,rogue,subtlety,48,29,19
Howton,archimonde,1152,rogue,subtlety,18,12,6
Тира,grom,1151,rogue,subtlety,24,12,12
Darksilencee,blackmoore,1146,rogue,subtlety,24,12,12
Ryzem,archimonde,1145,rogue,subtlety,72,39,33
Kickcake,ravencrest,1144,rogue,subtlety,30,12,18
Хавиа,gordunni,1143,rogue,subtlety,24,12,12
Sâybyëbæ,dun-modr,1142,rogue,subtlety,30,12,18
Jaydeeñ,ravencrest,1142,rogue,subtlety,30,12,18
Veryscaryguý,twisting-nether,1140,rogue,subtlety,18,12,6
Zx,frostmane,1140,rogue,subtlety,24,12,12
Lechatbotté,tarren-mill,1137,rogue,subtlety,18,12,6
Faelylanea,argent-dawn,1122,rogue,subtlety,36,16,20
Попочке,soulflayer,1116,rogue,subtlety,18,13,5
Winwin,silvermoon,1113,rogue,subtlety,31,19,12
Coronababy,argent-dawn,1111,rogue,subtlety,24,13,11
Gamezcorex,aegwynn,1111,rogue,subtlety,40,15,25
Stin,blackrock,1105,rogue,subtlety,58,17,41
Unreallx,silvermoon,1102,rogue,subtlety,80,36,44
Stuxothug,silvermoon,1098,rogue,subtlety,31,18,13
Stâr,archimonde,1077,rogue,subtlety,28,13,15
Löka,amanthul,1071,rogue,subtlety,117,59,58
Псиихооз,eversong,1070,rogue,subtlety,25,13,12
Daekrun,argent-dawn,1068,rogue,subtlety,26,12,14
Скорпеон,deathguard,1059,rogue,subtlety,24,17,7
Çhimaev,ravencrest,1056,rogue,subtlety,16,12,4
Djswaghetti,stormscale,1056,rogue,subtlety,18,11,7
Ccedox,stormscale,1055,rogue,subtlety,18,11,7
Флеймсфорт,gordunni,1055,rogue,subtlety,35,16,19
Kleptomancy,sylvanas,1054,rogue,subtlety,18,11,7
Exiv,ragnaros,1053,rogue,subtlety,30,11,19
Tonaxstab,ragnaros,1049,rogue,subtlety,24,11,13
Blantek,defias-brotherhood,1048,rogue,subtlety,24,13,11
Maam,ravencrest,1046,rogue,subtlety,18,11,7
Cuckboy,chogall,1042,rogue,subtlety,37,24,13
Behindü,frostmane,1042,rogue,subtlety,24,11,13
Ithru,twisting-nether,1035,rogue,subtlety,102,51,51
Drakaess,archimonde,1032,rogue,subtlety,24,11,13
Зебол,howling-fjord,1024,rogue,subtlety,36,17,19
Yamoshí,sanguino,1024,rogue,subtlety,34,15,19
Thehand,eonar,1016,rogue,subtlety,18,11,7
Mercìles,kazzak,1004,rogue,subtlety,31,19,12
Сабанутый,howling-fjord,1002,rogue,subtlety,72,38,34
Thicck,twisting-nether,980,rogue,subtlety,48,13,35
Yüm,burning-blade,979,rogue,subtlety,39,13,26
Niinim,draenor,969,rogue,subtlety,75,39,36
Mannheim,kazzak,968,rogue,subtlety,42,23,19
Pochîta,blackrock,964,rogue,subtlety,35,13,22
Sákiqt,ravencrest,960,rogue,subtlety,18,10,8
Naláa,ravencrest,960,rogue,subtlety,18,10,8
Нойсеен,gordunni,960,rogue,subtlety,18,10,8
Noboorstsub,ravencrest,959,rogue,subtlety,12,10,2
Счастливое,howling-fjord,957,rogue,subtlety,18,10,8
Fugly,ragnaros,955,rogue,subtlety,26,10,16
Rêve,the-maelstrom,954,rogue,subtlety,18,10,8
Воруюнарынке,gordunni,953,rogue,subtlety,32,19,13
Káríc,draenor,953,rogue,subtlety,18,10,8
Sacrehptit,naxxramas,952,rogue,subtlety,18,10,8
Oazo,ysondre,951,rogue,subtlety,35,13,22
Qiiss,stormscale,949,rogue,subtlety,18,10,8
Callboy,turalyon,949,rogue,subtlety,24,10,14
Lovetospoon,ravencrest,937,rogue,subtlety,25,11,14
Kezaay,silvermoon,923,rogue,subtlety,24,13,11
Hemorhoid,outland,912,rogue,subtlety,48,25,23
Whaiipy,ravencrest,908,rogue,subtlety,44,23,21
Sentaria,argent-dawn,903,rogue,subtlety,36,18,18
Saroumani,eitrigg,891,rogue,subtlety,30,16,14
Katarïnä,khaz-modan,887,rogue,subtlety,24,11,13
Kouru,outland,871,rogue,subtlety,25,10,15
Aeønaxx,hyjal,865,rogue,subtlety,36,14,22
Rantie,eredar,864,rogue,subtlety,12,9,3
Randomidiot,ravencrest,864,rogue,subtlety,12,9,3
Фрозенденс,gordunni,864,rogue,subtlety,12,9,3
Whaazlysnipz,tarren-mill,864,rogue,subtlety,12,9,3
Иждолк,gordunni,864,rogue,subtlety,18,9,9
Slapshot,das-konsortium,864,rogue,subtlety,18,9,9
Пораменяться,gordunni,863,rogue,subtlety,12,9,3
Miiløx,silvermoon,863,rogue,subtlety,18,9,9
Cørek,blackhand,863,rogue,subtlety,18,9,9
Márto,archimonde,863,rogue,subtlety,24,9,15
Xãwé,kazzak,862,rogue,subtlety,18,9,9
Críppléz,ravencrest,862,rogue,subtlety,18,9,9
Crixor,blackrock,861,rogue,subtlety,12,9,3
Дакоока,soulflayer,861,rogue,subtlety,12,9,3
Jaqenhghar,pozzo-delleternità,859,rogue,subtlety,18,9,9
Eightball,frostmane,859,rogue,subtlety,18,9,9
Sequoja,blackrock,858,rogue,subtlety,24,9,15
Zergroidz,kazzak,856,rogue,subtlety,24,9,15
Vampor,sylvanas,852,rogue,subtlety,30,9,21
Хасилей,booty-bay,847,rogue,subtlety,17,9,8
Горланг,ashenvale,841,rogue,subtlety,18,9,9
Liquidgaba,ravencrest,828,rogue,subtlety,48,20,28
Anr,burning-legion,815,rogue,subtlety,17,9,8
Djdillá,kazzak,768,rogue,subtlety,12,8,4
Фрозенблейдс,gordunni,768,rogue,subtlety,12,8,4
Danori,grim-batol,768,rogue,subtlety,12,8,4
Devourswine,argent-dawn,768,rogue,subtlety,12,8,4
Whoton,archimonde,768,rogue,subtlety,16,9,7
Zygzäg,hyjal,768,rogue,subtlety,18,8,10
Ач,gordunni,768,rogue,subtlety,18,8,10
Amuini,magtheridon,768,rogue,subtlety,18,8,10
Mortnoïre,naxxramas,767,rogue,subtlety,12,8,4
Zëkke,sanguino,767,rogue,subtlety,12,8,4
Ferrãof,aggra-português,767,rogue,subtlety,12,8,4
Bamsejuicee,kazzak,767,rogue,subtlety,12,8,4
Aahz,tarren-mill,767,rogue,subtlety,18,8,10
Mdadx,stormreaver,767,rogue,subtlety,18,8,10
Madisonivyqt,blackmoore,767,rogue,subtlety,18,8,10
Akwaaba,ravencrest,767,rogue,subtlety,21,9,12
Vanéry,ravencrest,766,rogue,subtlety,12,8,4
Jkrx,draenor,766,rogue,subtlety,18,8,10
Poughkeepsie,outland,765,rogue,subtlety,18,8,10
Byonics,durotan,763,rogue,subtlety,12,8,4
Deprress,silvermoon,762,rogue,subtlety,12,8,4
Jomoama,norgannon,762,rogue,subtlety,24,8,16
Narar,stormscale,756,rogue,subtlety,12,8,4
Drakhez,sanguino,752,rogue,subtlety,12,8,4
Беточка,gordunni,752,rogue,subtlety,12,8,4
Faable,silvermoon,742,rogue,subtlety,47,16,31
Rmp,khaz-modan,720,rogue,subtlety,30,9,21
Petsakos,ravencrest,713,rogue,subtlety,21,9,12
Смекрус,soulflayer,687,rogue,subtlety,19,8,11
Abomïñatïøñ,ravencrest,684,rogue,subtlety,24,8,16
Лэйкиро,gordunni,672,rogue,subtlety,12,7,5
Änanké,outland,672,rogue,subtlety,12,7,5
Рэкрейвон,gordunni,672,rogue,subtlety,12,7,5
Ncrø,aszune,672,rogue,subtlety,13,7,6
Kenjí,silvermoon,672,rogue,subtlety,18,7,11
Социалистсс,gordunni,672,rogue,subtlety,18,7,11
Belwarx,darksorrow,672,rogue,subtlety,18,7,11
Azziinoth,ragnaros,672,rogue,subtlety,24,7,17
Drydamage,kazzak,672,rogue,subtlety,24,7,17
Hyake,zuljin,671,rogue,subtlety,12,7,5
Nairobii,tarren-mill,671,rogue,subtlety,12,7,5
Teralala,kazzak,671,rogue,subtlety,18,7,11
Ithilyien,blackmoore,671,rogue,subtlety,18,7,11
Maroshko,argent-dawn,671,rogue,subtlety,18,7,11
Cataleýa,outland,670,rogue,subtlety,12,7,5
Pepperbox,twisting-nether,667,rogue,subtlety,12,7,5
Рэйбэк,howling-fjord,667,rogue,subtlety,24,7,17
Cacucoxpahu,kazzak,666,rogue,subtlety,12,7,5
Пузэн,howling-fjord,658,rogue,subtlety,12,7,5
Fizgaroth,argent-dawn,657,rogue,subtlety,12,7,5
Frequenzalfa,silvermoon,640,rogue,subtlety,10,8,2
Nineball,frostmane,638,rogue,subtlety,17,7,10
Obsçuritý,ragnaros,630,rogue,subtlety,17,7,10
Actualcarry,dentarg,617,rogue,subtlety,12,8,4
Subzerõ,archimonde,608,rogue,subtlety,22,7,15
Naiikaii,antonidas,576,rogue,subtlety,6,6,0
Strangeboy,ravencrest,576,rogue,subtlety,6,6,0
Bizzarerogue,tarren-mill,576,rogue,subtlety,12,6,6
Ðelvin,dalaran,576,rogue,subtlety,12,6,6
Briggo,silvermoon,576,rogue,subtlety,12,6,6
Carvyn,defias-brotherhood,576,rogue,subtlety,12,6,6
Ibizà,ravencrest,576,rogue,subtlety,12,6,6
Geá,ravencrest,576,rogue,subtlety,12,6,6
Ладжо,gordunni,576,rogue,subtlety,12,6,6
Smílèy,ravencrest,576,rogue,subtlety,12,6,6
Àlleyezonme,ravencrest,576,rogue,subtlety,12,6,6
Rinj,antonidas,576,rogue,subtlety,12,6,6
Jqmie,ravencrest,576,rogue,subtlety,12,6,6
Jljr,twisting-nether,576,rogue,subtlety,12,6,6
Denjas,archimonde,576,rogue,subtlety,12,6,6
Feradelia,thrall,576,rogue,subtlety,12,6,6
Ðéstr,ravencrest,576,rogue,subtlety,12,6,6
Amén,sanguino,576,rogue,subtlety,18,6,12
Blihhubba,silvermoon,576,rogue,subtlety,18,6,12
Пусякиллерх,gordunni,575,rogue,subtlety,12,6,6
Чайрлайн,blackscar,575,rogue,subtlety,12,6,6
Stabymoose,draenor,575,rogue,subtlety,12,6,6
Jisz,doomhammer,574,rogue,subtlety,12,6,6
Hersuub,blackmoore,574,rogue,subtlety,12,6,6
Xaiko,baelgun,572,rogue,subtlety,9,7,2
Sassasine,amanthul,572,rogue,subtlety,12,6,6
Freddybst,twisting-nether,571,rogue,subtlety,12,6,6
Lêvî,sanguino,569,rogue,subtlety,12,6,6
Thiranor,cthun,569,rogue,subtlety,12,6,6
Geroge,sylvanas,566,rogue,subtlety,12,6,6
Grikra,argent-dawn,566,rogue,subtlety,12,6,6
Drspectres,tarren-mill,543,rogue,subtlety,30,6,24
Zobrak,twisting-nether,542,rogue,subtlety,14,7,7
Malignance,drakthul,511,rogue,subtlety,14,7,7
Cheapshotwin,nethersturm,480,rogue,subtlety,6,5,1
Silnce,outland,480,rogue,subtlety,6,5,1
Фэйкуои,gordunni,480,rogue,subtlety,6,5,1
Бонястелс,gordunni,480,rogue,subtlety,6,5,1
Draytonlove,nemesis,480,rogue,subtlety,6,5,1
Meshay,kazzak,480,rogue,subtlety,7,5,2
Decoyed,sylvanas,480,rogue,subtlety,12,5,7
Løre,blackrock,480,rogue,subtlety,12,5,7
Лайнэл,deathweaver,480,rogue,subtlety,12,5,7
Khepaso,sanguino,480,rogue,subtlety,12,5,7
Kleptomaniac,aggra-português,480,rogue,subtlety,12,5,7
Mzaa,ravencrest,480,rogue,subtlety,12,5,7
Киднитучер,fordragon,480,rogue,subtlety,12,5,7
Lurk,saurfang,480,rogue,subtlety,12,5,7
Akyô,archimonde,480,rogue,subtlety,12,5,7
Deevoll,tarren-mill,480,rogue,subtlety,12,5,7
Стеллакокс,howling-fjord,480,rogue,subtlety,12,5,7
Фрозеншедов,gordunni,480,rogue,subtlety,12,5,7
Анивиана,howling-fjord,480,rogue,subtlety,12,5,7
Loznah,outland,480,rogue,subtlety,12,5,7
Darkveil,xavius,480,rogue,subtlety,12,5,7
Slayered,burning-legion,480,rogue,subtlety,18,5,13
Ajwenx,ravencrest,480,rogue,subtlety,18,5,13
Zodracir,scarshield-legion,480,rogue,subtlety,18,5,13
Jailkaz,thrall,479,rogue,subtlety,12,5,7
Моямайя,eversong,479,rogue,subtlety,12,5,7
Houston,aegwynn,479,rogue,subtlety,12,5,7
Smorcoolio,stormscale,479,rogue,subtlety,12,5,7
Распяздяй,gordunni,479,rogue,subtlety,12,5,7
Ryxon,arathor,479,rogue,subtlety,12,5,7
Smoothiè,twisting-nether,479,rogue,subtlety,12,5,7
Mozenn,draenor,478,rogue,subtlety,19,5,14
Strikes,eredar,477,rogue,subtlety,6,5,1
Эльтаэрон,gordunni,477,rogue,subtlety,12,5,7
Nirvána,outland,477,rogue,subtlety,12,5,7
Mallaurya,dalaran,474,rogue,subtlety,12,5,7
Cortzy,stormscale,448,rogue,subtlety,16,5,11
Кумаме,howling-fjord,447,rogue,subtlety,11,5,6
Roguebot,draenor,447,rogue,subtlety,11,5,6
Maxtnulaujeu,archimonde,431,rogue,subtlety,11,5,6
Райан,fordragon,431,rogue,subtlety,11,5,6
Ålleyézonme,ravencrest,415,rogue,subtlety,11,5,6
Algopyrin,ragnaros,396,rogue,subtlety,13,5,8
Dainhek,gilneas,394,rogue,subtlety,13,5,8
Нунас,soulflayer,384,rogue,subtlety,6,4,2
Ënd,ravencrest,384,rogue,subtlety,6,4,2
Джеанит,gordunni,384,rogue,subtlety,6,4,2
Featfawkes,ragnaros,384,rogue,subtlety,6,4,2
Cucumber,laughing-skull,384,rogue,subtlety,6,4,2
Nâzaar,antonidas,384,rogue,subtlety,6,4,2
Qylu,argent-dawn,384,rogue,subtlety,6,4,2
Mol,defias-brotherhood,384,rogue,subtlety,6,4,2
Læffgøðx,stormscale,384,rogue,subtlety,6,4,2
Siele,twisting-nether,384,rogue,subtlety,6,4,2
Ocklol,archimonde,384,rogue,subtlety,6,4,2
Sebik,ravencrest,384,rogue,subtlety,6,4,2
Seeralex,anetheron,384,rogue,subtlety,6,4,2
Mega,nordrassil,384,rogue,subtlety,6,4,2
Pérplèxîty,thrall,384,rogue,subtlety,6,4,2
Marcel,blackrock,384,rogue,subtlety,6,4,2
Nxnja,silvermoon,384,rogue,subtlety,6,4,2
Ciosy,blackrock,384,rogue,subtlety,6,4,2
Grekén,bronze-dragonflight,384,rogue,subtlety,6,4,2
Zordochrog,kazzak,384,rogue,subtlety,12,4,8
Szabina,outland,384,rogue,subtlety,12,4,8
Whiteløtûs,dun-modr,384,rogue,subtlety,12,4,8
Ambushmike,gorgonnash,384,rogue,subtlety,12,4,8
Máuul,ravencrest,384,rogue,subtlety,12,4,8
Jenz,blackmoore,384,rogue,subtlety,12,4,8
Erenyeagerx,kazzak,384,rogue,subtlety,12,4,8
Snack,burning-legion,384,rogue,subtlety,12,4,8
Sxpped,stormscale,384,rogue,subtlety,12,4,8
Очч,blackscar,384,rogue,subtlety,18,4,14
Vanishdotcom,blackrock,383,rogue,subtlety,6,4,2
Anala,stormreaver,383,rogue,subtlety,6,4,2
Protolink,zuljin,383,rogue,subtlety,18,4,14
Lolblizard,gorgonnash,382,rogue,subtlety,6,4,2
Leylaris,argent-dawn,382,rogue,subtlety,12,4,8
Wurzelzepp,blackrock,335,rogue,subtlety,11,4,7
Cozu,stormrage,317,rogue,subtlety,10,4,6
Opiïum,ysondre,303,rogue,subtlety,7,4,3
Niapro,dun-morogh,288,rogue,subtlety,6,3,3
Sheldowws,tarren-mill,288,rogue,subtlety,6,3,3
Sneakysáp,ravencrest,288,rogue,subtlety,6,3,3
Izzyb,auchindoun,288,rogue,subtlety,6,3,3
Бейнс,howling-fjord,288,rogue,subtlety,6,3,3
Бэрнии,howling-fjord,288,rogue,subtlety,6,3,3
Nahj,ravencrest,288,rogue,subtlety,6,3,3
Baradiir,defias-brotherhood,288,rogue,subtlety,6,3,3
Kolto,argent-dawn,288,rogue,subtlety,6,3,3
Synthaetic,draenor,288,rogue,subtlety,6,3,3
Qira,burning-blade,288,rogue,subtlety,6,3,3
Aythusha,twisting-nether,288,rogue,subtlety,6,3,3
Валанбалас,soulflayer,288,rogue,subtlety,6,3,3
Элисандресса,gordunni,288,rogue,subtlety,6,3,3
Pulvèr,dalaran,288,rogue,subtlety,6,3,3
Sadgexd,draenor,288,rogue,subtlety,6,3,3
Mekóz,draenor,288,rogue,subtlety,6,3,3
Xhemil,tarren-mill,288,rogue,subtlety,6,3,3
Ezk,eredar,288,rogue,subtlety,6,3,3
Jabbz,blackhand,288,rogue,subtlety,6,3,3
Sicu,malganis,288,rogue,subtlety,6,3,3
Pretylo,marécage-de-zangar,288,rogue,subtlety,6,3,3
Shadxwstep,ravencrest,288,rogue,subtlety,6,3,3
Viiltäjäjack,stormscale,288,rogue,subtlety,6,3,3
Garou,blackhand,288,rogue,subtlety,6,3,3
Roguanal,hyjal,288,rogue,subtlety,6,3,3
Swiftyfan,silvermoon,288,rogue,subtlety,6,3,3
Vanisshh,hyjal,288,rogue,subtlety,6,3,3
Knifeparty,silvermoon,288,rogue,subtlety,6,3,3
Jawen,silvermoon,288,rogue,subtlety,6,3,3
Waakie,frostmane,288,rogue,subtlety,6,3,3
Kryptonite,nemesis,288,rogue,subtlety,6,3,3
Alexandra,kazzak,288,rogue,subtlety,6,3,3
Zayøn,outland,288,rogue,subtlety,6,3,3
Faptastíc,blackmoore,288,rogue,subtlety,6,3,3
Røguøross,archimonde,288,rogue,subtlety,6,3,3
Botnet,blackmoore,288,rogue,subtlety,6,3,3
Dimidimi,wildhammer,288,rogue,subtlety,6,3,3
Checkormate,aegwynn,288,rogue,subtlety,6,3,3
Lepreuchan,archimonde,288,rogue,subtlety,6,3,3
Uareincombat,drakthul,288,rogue,subtlety,11,3,8
Ристоврация,gordunni,288,rogue,subtlety,12,3,9
Bú,nemesis,288,rogue,subtlety,12,3,9
Daggoth,kiljaeden,288,rogue,subtlety,12,3,9
Zavebe,nathrezim,288,rogue,subtlety,12,3,9
Rufinol,twisting-nether,288,rogue,subtlety,12,3,9
Taniwa,archimonde,288,rogue,subtlety,12,3,9
Zoldyck,bloodhoof,288,rogue,subtlety,12,3,9
Vancleéf,sylvanas,288,rogue,subtlety,12,3,9
Skíll,sanguino,288,rogue,subtlety,12,3,9
Pestctrl,argent-dawn,288,rogue,subtlety,12,3,9
Abej,malygos,288,rogue,subtlety,12,3,9
Princip,drakthul,288,rogue,subtlety,12,3,9
Mns,drakthul,288,rogue,subtlety,12,3,9
Воробнальщик,soulflayer,288,rogue,subtlety,12,3,9
Helcof,emerald-dream,288,rogue,subtlety,12,3,9
Djinnx,malganis,288,rogue,subtlety,12,3,9
Xéshon,tarren-mill,288,rogue,subtlety,12,3,9
Кэйтлис,howling-fjord,288,rogue,subtlety,12,3,9
Plot,zenedar,288,rogue,subtlety,12,3,9
Kïbs,dalaran,288,rogue,subtlety,12,3,9
Ñú,ravencrest,288,rogue,subtlety,12,3,9
Koutzai,stormscale,288,rogue,subtlety,12,3,9
Kongnognog,ragnaros,288,rogue,subtlety,12,3,9
Xyúmopjoßblú,ravencrest,288,rogue,subtlety,12,3,9
Coolspot,archimonde,288,rogue,subtlety,12,3,9
Liirja,twisting-nether,288,rogue,subtlety,18,3,15
Fastspectre,ravencrest,287,rogue,subtlety,6,3,3
Gingahboy,doomhammer,287,rogue,subtlety,6,3,3
Styggvanas,tarren-mill,287,rogue,subtlety,15,4,11
Боузи,howling-fjord,287,rogue,subtlety,12,3,9
Cesar,blackhand,286,rogue,subtlety,6,3,3
Ratolí,dun-modr,286,rogue,subtlety,6,3,3
Jontor,deathwing,286,rogue,subtlety,12,3,9
Skene,sanguino,284,rogue,subtlety,12,3,9
Wìzléy,ravencrest,284,rogue,subtlety,12,3,9
Madlain,jaedenar,255,rogue,subtlety,8,4,4
Juuzou,outland,239,rogue,subtlety,5,3,2
Iwillberone,ravencrest,239,rogue,subtlety,11,3,8
Nakli,antonidas,234,rogue,subtlety,15,4,11
Bananashow,aegwynn,192,rogue,subtlety,6,2,4
Elnos,conseil-des-ombres,192,rogue,subtlety,6,2,4
Stormhardt,stormscale,192,rogue,subtlety,6,2,4
Stigh,twisting-nether,192,rogue,subtlety,6,2,4
Skaterboy,stormscale,192,rogue,subtlety,6,2,4
Røxxilly,blackmoore,192,rogue,subtlety,6,2,4
Ît,stormscale,192,rogue,subtlety,6,2,4
Голадриель,gordunni,192,rogue,subtlety,6,2,4
Selecta,bloodhoof,192,rogue,subtlety,6,2,4
Lenwe,blackmoore,192,rogue,subtlety,6,2,4
Dedka,hyjal,192,rogue,subtlety,6,2,4
Skeeto,blackmoore,192,rogue,subtlety,6,2,4
Knifeex,ravencrest,192,rogue,subtlety,6,2,4
Шмарамышь,soulflayer,192,rogue,subtlety,6,2,4
Рикимартини,gordunni,192,rogue,subtlety,6,2,4
Бллейз,gordunni,192,rogue,subtlety,6,2,4
Gosleep,stormscale,192,rogue,subtlety,6,2,4
Скиррона,gordunni,192,rogue,subtlety,6,2,4
Melfîce,blackhand,192,rogue,subtlety,6,2,4
Xiro,dalaran,192,rogue,subtlety,6,2,4
Wrathed,stormreaver,192,rogue,subtlety,6,2,4
Рогаупорога,howling-fjord,192,rogue,subtlety,6,2,4
Режупополам,howling-fjord,192,rogue,subtlety,6,2,4
Aikaza,blackmoore,192,rogue,subtlety,6,2,4
Stealthyist,darkmoon-faire,192,rogue,subtlety,6,2,4
Decrios,outland,192,rogue,subtlety,6,2,4
Ilyrya,azuremyst,192,rogue,subtlety,6,2,4
Deadchivalry,argent-dawn,192,rogue,subtlety,6,2,4
Haikyu,blackhand,192,rogue,subtlety,6,2,4
Igel,antonidas,192,rogue,subtlety,6,2,4
Sigleif,argent-dawn,192,rogue,subtlety,6,2,4
Mojojina,theradras,192,rogue,subtlety,6,2,4
Katara,antonidas,192,rogue,subtlety,6,2,4
Fatnutsac,eredar,192,rogue,subtlety,6,2,4
Botsrogue,kazzak,192,rogue,subtlety,6,2,4
Fatedancer,outland,192,rogue,subtlety,6,2,4
Inviscuz,draenor,192,rogue,subtlety,6,2,4
Xanders,draenor,192,rogue,subtlety,6,2,4
Feylia,terenas,192,rogue,subtlety,6,2,4
Giftknirps,silvermoon,192,rogue,subtlety,6,2,4
Cbrook,sylvanas,192,rogue,subtlety,6,2,4
Фордрэн,deathguard,192,rogue,subtlety,10,3,7
Greiskull,cthun,192,rogue,subtlety,15,3,12
Acheravar,antonidas,192,rogue,subtlety,12,2,10
Jackpot,sargeras,192,rogue,subtlety,12,2,10
Destrektor,kazzak,192,rogue,subtlety,12,2,10
Refundlands,kazzak,192,rogue,subtlety,12,2,10
Delenor,stormscale,192,rogue,subtlety,12,2,10
Cabalion,draenor,191,rogue,subtlety,6,2,4
Mamus,tarren-mill,191,rogue,subtlety,6,2,4
Ecray,burning-legion,191,rogue,subtlety,6,2,4
Энвитио,gordunni,191,rogue,subtlety,6,2,4
Singularität,silvermoon,191,rogue,subtlety,6,2,4
Lêgòlàs,blackmoore,191,rogue,subtlety,12,2,10
Feinted,kazzak,159,rogue,subtlety,11,2,9
Bandèra,ragnaros,138,rogue,subtlety,15,3,12
Idrîl,rashgarroth,137,rogue,subtlety,9,3,6
Эбиб,soulflayer,128,rogue,subtlety,4,2,2
Songoro,tirion,96,rogue,subtlety,3,2,1
Kunigunde,shattered-hand,96,rogue,subtlety,6,1,5
Гламурятина,gordunni,96,rogue,subtlety,6,1,5
Nerkmind,ragnaros,96,rogue,subtlety,6,1,5
Àrléngødx,kazzak,96,rogue,subtlety,6,1,5
Hyrule,onyxia,96,rogue,subtlety,6,1,5
Edaniel,draenor,96,rogue,subtlety,6,1,5
Kidneyou,ragnaros,96,rogue,subtlety,6,1,5
Twinkyzzö,archimonde,96,rogue,subtlety,6,1,5
Tàazz,archimonde,96,rogue,subtlety,6,1,5
Rímen,archimonde,96,rogue,subtlety,6,1,5
Neskagrall,aegwynn,96,rogue,subtlety,6,1,5
Bauwten,ravencrest,96,rogue,subtlety,6,1,5
Outride,outland,96,rogue,subtlety,6,1,5
Verk,twilights-hammer,96,rogue,subtlety,6,1,5
Chøsen,stormscale,96,rogue,subtlety,6,1,5
Fintex,ravencrest,96,rogue,subtlety,6,1,5
Стронг,soulflayer,96,rogue,subtlety,6,1,5
Элонли,gordunni,96,rogue,subtlety,6,1,5
Тварьебаная,howling-fjord,96,rogue,subtlety,6,1,5
Stealthi,stormscale,96,rogue,subtlety,6,1,5
Letheus,stormscale,96,rogue,subtlety,6,1,5
Tripleníne,silvermoon,96,rogue,subtlety,6,1,5
Imnotnice,terenas,96,rogue,subtlety,6,1,5
Nohks,blackmoore,96,rogue,subtlety,6,1,5
Takenòtes,nemesis,96,rogue,subtlety,6,1,5
Lëmönhäzë,dun-modr,96,rogue,subtlety,6,1,5
Könän,dalaran,96,rogue,subtlety,6,1,5
Альдинг,howling-fjord,96,rogue,subtlety,12,1,11
Calmrusgirl,ravenholdt,96,rogue,subtlety,12,1,11
Çåñçér,sylvanas,96,rogue,subtlety,12,1,11
Nesth,silvermoon,79,rogue,subtlety,5,1,4
Digmorre,drakthul,79,rogue,subtlety,5,1,4
Domiqs,blackhand,63,rogue,subtlety,2,2,0
Mâtâtâ,die-ewige-wacht,63,rogue,subtlety,2,2,0
Dendriodidit,kazzak,31,rogue,subtlety,2,1,1
Aæ,stormscale,2112,rogue,assassination,125,65,60
Rightplay,outland,2112,rogue,assassination,90,45,45
Fánsly,silvermoon,2102,rogue,assassination,78,40,38
Shadenox,ravencrest,2060,rogue,assassination,245,120,125
Chínerox,thunderhorn,2002,rogue,assassination,129,68,61
Heavý,argent-dawn,1954,rogue,assassination,96,46,50
Visuáls,antonidas,1950,rogue,assassination,81,38,43
Mentol,stormscale,1928,rogue,assassination,53,41,12
Naláa,ravencrest,1924,rogue,assassination,52,31,21
Ewyna,silvermoon,1916,rogue,assassination,63,32,31
Vayyel,silvermoon,1912,rogue,assassination,160,77,83
Vulrin,argent-dawn,1899,rogue,assassination,77,44,33
Buffassa,ravencrest,1888,rogue,assassination,77,48,29
Ohdaesu,aegwynn,1854,rogue,assassination,84,36,48
Asàd,draenor,1841,rogue,assassination,47,30,17
Sadgexd,draenor,1814,rogue,assassination,52,26,26
Shadeco,ravencrest,1811,rogue,assassination,60,29,31
Пожилойпуп,gordunni,1811,rogue,assassination,54,26,28
Lookåtme,ravencrest,1808,rogue,assassination,48,20,28
Eiscreme,blackmoore,1802,rogue,assassination,95,50,45
Prei,hyjal,1784,rogue,assassination,66,32,34
Ридлли,soulflayer,1783,rogue,assassination,59,29,30
Dáydreamín,draenor,1772,rogue,assassination,60,27,33
Warbell,ravencrest,1757,rogue,assassination,66,27,39
Watchmeyoe,ravencrest,1738,rogue,assassination,54,28,26
Варэль,borean-tundra,1727,rogue,assassination,150,78,72
Youcrymydear,outland,1711,rogue,assassination,66,31,35
Drenched,turalyon,1703,rogue,assassination,72,33,39
Awaaylol,stormscale,1702,rogue,assassination,105,48,57
Blindlol,emerald-dream,1700,rogue,assassination,48,24,24
Rinj,antonidas,1693,rogue,assassination,89,37,52
Войенх,gordunni,1692,rogue,assassination,168,82,86
Акиоми,gordunni,1691,rogue,assassination,102,57,45
Çhïñêsérøqüè,tarren-mill,1691,rogue,assassination,71,30,41
Sotro,dun-modr,1690,rogue,assassination,66,26,40
Shipshot,blackrock,1664,rogue,assassination,45,26,19
Monski,ravencrest,1631,rogue,assassination,54,21,33
Fíìp,drakthul,1626,rogue,assassination,48,18,30
Кэпс,blackscar,1625,rogue,assassination,66,39,27
Naiikaii,antonidas,1624,rogue,assassination,42,17,25
Мистеркрэпс,howling-fjord,1624,rogue,assassination,47,19,28
Shookyz,zuljin,1615,rogue,assassination,54,27,27
Nîllá,blackmoore,1600,rogue,assassination,42,18,24
Gøldzahn,antonidas,1599,rogue,assassination,70,25,45
Ockzy,archimonde,1592,rogue,assassination,75,39,36
Precious,sylvanas,1567,rogue,assassination,72,28,44
Keeke,outland,1544,rogue,assassination,42,19,23
Weakrat,kult-der-verdammten,1538,rogue,assassination,30,20,10
Kãlí,blackmoore,1537,rogue,assassination,90,44,46
Shikamouflé,archimonde,1537,rogue,assassination,136,65,71
Howfastiam,ravencrest,1515,rogue,assassination,24,16,8
Synergize,stormreaver,1508,rogue,assassination,115,54,61
Knutten,wildhammer,1500,rogue,assassination,96,43,53
Silesi,kazzak,1499,rogue,assassination,70,37,33
Nùgz,area-52,1498,rogue,assassination,119,65,54
Ванэйти,gordunni,1487,rogue,assassination,42,24,18
Hidinginash,twisting-nether,1486,rogue,assassination,56,31,25
ßênz,archimonde,1483,rogue,assassination,54,25,29
Волнорес,eversong,1481,rogue,assassination,76,39,37
Diazz,aegwynn,1470,rogue,assassination,114,53,61
Шмарамышь,soulflayer,1463,rogue,assassination,66,31,35
Argapu,stormscale,1455,rogue,assassination,42,16,26
Eizan,outland,1450,rogue,assassination,42,23,19
Grzech,burning-legion,1435,rogue,assassination,70,38,32
Axoic,ravencrest,1433,rogue,assassination,48,23,25
Vennomous,darkspear,1429,rogue,assassination,66,32,34
Synthaetic,draenor,1428,rogue,assassination,58,34,24
Shaokiz,sylvanas,1428,rogue,assassination,30,16,14
Nìghtwalker,ravencrest,1428,rogue,assassination,50,24,26
Søsaboy,nemesis,1425,rogue,assassination,48,21,27
Cander,kazzak,1425,rogue,assassination,36,15,21
Freemmr,draenor,1418,rogue,assassination,58,31,27
Belsazar,azshara,1418,rogue,assassination,138,67,71
Koreanrogue,archimonde,1406,rogue,assassination,24,15,9
Патайчик,soulflayer,1403,rogue,assassination,54,29,25
Arkblenderx,silvermoon,1401,rogue,assassination,82,41,41
Piñotxo,sanguino,1377,rogue,assassination,41,17,24
Teseiga,aegwynn,1364,rogue,assassination,96,37,59
Синигурай,soulflayer,1353,rogue,assassination,36,18,18
Cýphia,amanthul,1351,rogue,assassination,69,32,37
Dirtyz,dun-modr,1344,rogue,assassination,30,17,13
Пусякиллерх,gordunni,1343,rogue,assassination,43,17,26
Haikyu,blackhand,1334,rogue,assassination,54,21,33
Iwillcapyou,twisting-nether,1331,rogue,assassination,30,14,16
Ciaordel,sylvanas,1330,rogue,assassination,66,30,36
Batsu,alleria,1319,rogue,assassination,36,17,19
Peeon,drakthul,1314,rogue,assassination,55,17,38
Zaintsas,tarren-mill,1311,rogue,assassination,33,15,18
Sigleif,argent-dawn,1309,rogue,assassination,61,28,33
Mexxn,antonidas,1303,rogue,assassination,31,16,15
Gadûz,kazzak,1295,rogue,assassination,44,17,27
Flawlesser,kazzak,1294,rogue,assassination,39,19,20
Ppollito,hyjal,1284,rogue,assassination,42,17,25
Zizmo,deathwing,1284,rogue,assassination,60,20,40
Dime,silvermoon,1272,rogue,assassination,78,42,36
Raiyqyu,archimonde,1263,rogue,assassination,63,29,34
Djnelly,stormreaver,1253,rogue,assassination,42,25,17
Сайгакк,galakrond,1248,rogue,assassination,58,30,28
Candycc,burning-legion,1245,rogue,assassination,31,15,16
Zerocell,kazzak,1240,rogue,assassination,54,26,28
Veronkierto,stormreaver,1233,rogue,assassination,66,35,31
Sáinz,malganis,1233,rogue,assassination,35,15,20
Markø,twisting-nether,1229,rogue,assassination,30,13,17
Trollohlol,malganis,1220,rogue,assassination,36,17,19
Luftpumpe,blackrock,1214,rogue,assassination,24,13,11
Mazeken,kazzak,1212,rogue,assassination,35,13,22
Pitøu,outland,1205,rogue,assassination,36,17,19
Kariinthuul,aegwynn,1205,rogue,assassination,48,20,28
Bennyweth,argent-dawn,1205,rogue,assassination,42,16,26
Роземсти,gordunni,1202,rogue,assassination,30,15,15
Effectz,ragnaros,1188,rogue,assassination,34,15,19
Sùbzerø,archimonde,1186,rogue,assassination,23,13,10
Finanzamtlg,blackrock,1169,rogue,assassination,30,16,14
Lelíth,ravencrest,1167,rogue,assassination,29,13,16
Skali,tarren-mill,1148,rogue,assassination,24,12,12
Зоти,lich-king,1146,rogue,assassination,24,12,12
Bonejaw,tarren-mill,1137,rogue,assassination,30,14,16
Matchfixer,moonglade,1136,rogue,assassination,68,29,39
Цилана,gordunni,1122,rogue,assassination,24,14,10
Lastsight,burning-legion,1102,rogue,assassination,27,13,14
Oshä,dalaran,1102,rogue,assassination,30,13,17
Yvÿ,archimonde,1101,rogue,assassination,24,12,12
Elûnè,silvermoon,1097,rogue,assassination,30,14,16
Nevelon,chogall,1095,rogue,assassination,54,23,31
Krimos,archimonde,1090,rogue,assassination,30,17,13
Gravestam,sunstrider,1085,rogue,assassination,36,17,19
Yokze,ravencrest,1085,rogue,assassination,36,12,24
Nighteshift,silvermoon,1064,rogue,assassination,36,14,22
Azonaticus,hyjal,1059,rogue,assassination,28,13,15
Alltaïr,ravencrest,1056,rogue,assassination,73,39,34
Boskönigt,ragnaros,1056,rogue,assassination,36,17,19
Goshîmoshî,stormscale,1056,rogue,assassination,30,11,19
Fatnutsac,eredar,1055,rogue,assassination,24,11,13
Çhïñêsémøñkè,argent-dawn,1054,rogue,assassination,18,11,7
Кайдарра,eversong,1045,rogue,assassination,24,11,13
Petsakos,ravencrest,1045,rogue,assassination,30,11,19
Zélla,twisting-nether,1044,rogue,assassination,24,11,13
Pasarelo,dun-modr,1041,rogue,assassination,95,45,50
Subyo,eredar,1038,rogue,assassination,30,11,19
Sladen,ghostlands,1032,rogue,assassination,24,11,13
Dykumah,sanguino,1016,rogue,assassination,24,11,13
Maroshko,argent-dawn,1015,rogue,assassination,23,11,12
Swarge,silvermoon,1012,rogue,assassination,128,54,74
Lesale,turalyon,1011,rogue,assassination,36,16,20
Pinchoto,sanguino,1002,rogue,assassination,24,13,11
Moneylake,stormscale,959,rogue,assassination,18,10,8
Koopa,argent-dawn,959,rogue,assassination,42,10,32
Кайсити,gordunni,958,rogue,assassination,18,10,8
Лёнтролль,blackscar,958,rogue,assassination,18,10,8
Unshaken,dun-modr,958,rogue,assassination,24,10,14
Poughkeepsie,outland,956,rogue,assassination,18,10,8
Редфилд,blackscar,956,rogue,assassination,18,10,8
Nukubu,draenor,956,rogue,assassination,24,10,14
Stôrpîx,drakthul,955,rogue,assassination,20,10,10
Izze,thrall,955,rogue,assassination,24,10,14
Eightball,frostmane,954,rogue,assassination,18,10,8
Gârrík,blackhand,954,rogue,assassination,18,10,8
Noxxra,blackhand,954,rogue,assassination,24,10,14
Raetoc,turalyon,951,rogue,assassination,18,10,8
Джэкман,soulflayer,950,rogue,assassination,12,10,2
Макггара,soulflayer,947,rogue,assassination,113,51,62
Purplereign,frostmane,939,rogue,assassination,36,18,18
Unterweger,die-aldor,902,rogue,assassination,17,10,7
Dallrend,stormscale,902,rogue,assassination,48,17,31
Márto,archimonde,896,rogue,assassination,22,10,12
Jústina,die-aldor,894,rogue,assassination,48,19,29
Ороти,greymane,891,rogue,assassination,20,12,8
Løuvees,archimonde,881,rogue,assassination,64,29,35
Undîsputed,blackmoore,879,rogue,assassination,33,10,23
Прнхабочка,gordunni,865,rogue,assassination,24,11,13
Skýhigh,ravencrest,864,rogue,assassination,12,9,3
Sadìra,echsenkessel,864,rogue,assassination,18,9,9
Ålùnæh,azjolnerub,864,rogue,assassination,18,9,9
Angeldarky,silvermoon,864,rogue,assassination,24,9,15
Tyreall,drakthul,864,rogue,assassination,24,9,15
Npkx,outland,863,rogue,assassination,24,9,15
Erion,silvermoon,863,rogue,assassination,24,9,15
Artésia,archimonde,862,rogue,assassination,18,9,9
Alnaddafrog,outland,861,rogue,assassination,12,9,3
Negrim,dun-modr,860,rogue,assassination,30,9,21
Асиксх,blackscar,859,rogue,assassination,24,9,15
Norlix,ravencrest,856,rogue,assassination,18,9,9
Seleyese,draenor,849,rogue,assassination,18,9,9
Kuxion,zuljin,847,rogue,assassination,24,10,14
Паштетмашин,booty-bay,841,rogue,assassination,18,9,9
Reginlief,argent-dawn,835,rogue,assassination,44,22,22
Dmfd,darksorrow,832,rogue,assassination,69,27,42
Îlihad,zuljin,824,rogue,assassination,42,16,26
Gillette,guldan,821,rogue,assassination,54,21,33
Yuffi,ysondre,803,rogue,assassination,23,11,12
Sospiro,nemesis,779,rogue,assassination,22,9,13
Limítless,tarren-mill,768,rogue,assassination,12,8,4
Играючестно,howling-fjord,768,rogue,assassination,12,8,4
Botsrogue,kazzak,768,rogue,assassination,18,8,10
Onlyluvhurt,dun-modr,768,rogue,assassination,24,8,16
Sumiftw,drakthul,768,rogue,assassination,24,8,16
Obsçuritý,ragnaros,765,rogue,assassination,16,9,7
Zobrak,twisting-nether,765,rogue,assassination,18,8,10
Lixht,the-maelstrom,764,rogue,assassination,18,8,10
Parker,frostmane,758,rogue,assassination,24,8,16
Jupitor,argent-dawn,757,rogue,assassination,18,8,10
Куррвабобер,borean-tundra,756,rogue,assassination,18,8,10
Stabbinu,burning-legion,672,rogue,assassination,12,7,5
Eeros,kazzak,672,rogue,assassination,18,7,11
Zilemjr,stormscale,672,rogue,assassination,18,7,11
Köna,archimonde,672,rogue,assassination,18,7,11
Ámbush,sylvanas,672,rogue,assassination,24,7,17
Richï,outland,672,rogue,assassination,24,7,17
Загляденье,gordunni,672,rogue,assassination,24,7,17
Luketherogue,twisting-nether,672,rogue,assassination,24,7,17
Rikdy,kazzak,672,rogue,assassination,30,7,23
Givewallet,ravencrest,671,rogue,assassination,12,7,5
Kuzmin,die-aldor,671,rogue,assassination,18,7,11
Yassu,archimonde,671,rogue,assassination,18,7,11
Кэйлфрут,gordunni,670,rogue,assassination,12,7,5
Babysteps,the-maelstrom,670,rogue,assassination,12,7,5
Поздоровайся,howling-fjord,670,rogue,assassination,12,7,5
Скулипёс,howling-fjord,667,rogue,assassination,12,7,5
Rogunelf,stormreaver,666,rogue,assassination,12,7,5
Ashami,genjuros,666,rogue,assassination,18,7,11
Niapro,dun-morogh,653,rogue,assassination,17,7,10
Mozenn,draenor,622,rogue,assassination,15,7,8
Sachsun,outland,576,rogue,assassination,12,6,6
Ритор,deathguard,576,rogue,assassination,12,6,6
Voetdown,blackmoore,576,rogue,assassination,12,6,6
Diagnoze,silvermoon,576,rogue,assassination,12,6,6
Flopsy,archimonde,576,rogue,assassination,12,6,6
Attylaria,rexxar,576,rogue,assassination,12,6,6
Dîspatchx,defias-brotherhood,576,rogue,assassination,12,6,6
Sneakypeeki,sylvanas,576,rogue,assassination,12,6,6
Lildretch,dun-morogh,576,rogue,assassination,12,6,6
Lôre,blackrock,576,rogue,assassination,12,6,6
Mollyperph,ravencrest,576,rogue,assassination,12,6,6
Grøax,ragnaros,576,rogue,assassination,12,6,6
Blooddance,ragnaros,576,rogue,assassination,18,6,12
Røler,ravencrest,576,rogue,assassination,18,6,12
Слаадкий,gordunni,576,rogue,assassination,18,6,12
Mystykal,twisting-nether,575,rogue,assassination,12,6,6
Madlain,jaedenar,575,rogue,assassination,12,6,6
Peqpen,ravencrest,575,rogue,assassination,12,6,6
Rbgdowngrade,ravencrest,575,rogue,assassination,12,6,6
Cbrook,sylvanas,575,rogue,assassination,18,6,12
Röllz,ysondre,575,rogue,assassination,18,6,12
Chalkbag,blackrock,575,rogue,assassination,18,6,12
Fkuwu,dalaran,575,rogue,assassination,24,6,18
Kuttunga,ravencrest,574,rogue,assassination,12,6,6
Outofstuns,earthen-ring,574,rogue,assassination,18,7,11
Tubes,dun-morogh,573,rogue,assassination,6,6,0
Letheus,stormscale,573,rogue,assassination,18,6,12
Snakeshiv,ravenholdt,569,rogue,assassination,12,6,6
Симус,lich-king,568,rogue,assassination,12,6,6
Tc,doomhammer,568,rogue,assassination,12,6,6
Dezxxyox,dun-modr,568,rogue,assassination,18,6,12
Ûltraaxx,ysondre,528,rogue,assassination,15,6,9
Stonyhavana,ravencrest,527,rogue,assassination,11,6,5
Xeeana,ravencrest,480,rogue,assassination,6,5,1
Babouill,ysondre,480,rogue,assassination,6,5,1
Ðescartes,antonidas,480,rogue,assassination,6,5,1
Ghðst,stormscale,480,rogue,assassination,12,5,7
Кишмякх,howling-fjord,480,rogue,assassination,12,5,7
Gögel,draenor,480,rogue,assassination,12,5,7
Иллвилл,soulflayer,480,rogue,assassination,12,5,7
Morgan,argent-dawn,480,rogue,assassination,12,5,7
Patryk,silvermoon,480,rogue,assassination,12,5,7
Fixsap,aegwynn,480,rogue,assassination,12,5,7
Liraia,eredar,480,rogue,assassination,12,5,7
Venomblood,sanguino,480,rogue,assassination,12,5,7
Йоио,howling-fjord,480,rogue,assassination,12,5,7
Malatang,thrall,480,rogue,assassination,12,5,7
Рэкрейвон,gordunni,480,rogue,assassination,12,5,7
Uzrigu,tarren-mill,480,rogue,assassination,12,5,7
Aikaza,blackmoore,480,rogue,assassination,12,5,7
Stealthi,stormscale,480,rogue,assassination,18,5,13
Ambushgirl,ravencrest,480,rogue,assassination,18,5,13
Pheq,ravencrest,480,rogue,assassination,18,5,13
Republicano,cthun,480,rogue,assassination,18,5,13
Gankbang,frostmane,480,rogue,assassination,18,5,13
Wrathed,stormreaver,480,rogue,assassination,18,5,13
Exanimu,ravencrest,480,rogue,assassination,18,5,13
Траста,fordragon,480,rogue,assassination,24,5,19
Oggish,tarren-mill,480,rogue,assassination,24,5,19
Vizifyx,ravencrest,480,rogue,assassination,24,5,19
Хэресс,soulflayer,479,rogue,assassination,6,5,1
Nargun,archimonde,479,rogue,assassination,12,5,7
Leÿji,archimonde,479,rogue,assassination,12,5,7
Shadowfangs,ravencrest,479,rogue,assassination,12,5,7
Pathicus,stormreaver,479,rogue,assassination,12,5,7
Azovrouge,terokkar,478,rogue,assassination,12,5,7
Owlcat,argent-dawn,475,rogue,assassination,12,5,7
Deragur,antonidas,474,rogue,assassination,12,5,7
Наджийа,lich-king,473,rogue,assassination,12,5,7
Blackone,nemesis,473,rogue,assassination,18,5,13
Tranxéne,hyjal,472,rogue,assassination,12,5,7
Intecto,twisting-nether,448,rogue,assassination,10,5,5
Lorena,ravencrest,446,rogue,assassination,11,5,6
Refundlands,kazzak,426,rogue,assassination,15,6,9
Mâêl,blackmoore,426,rogue,assassination,16,6,10
Bluehell,sanguino,415,rogue,assassination,10,5,5
Bauwten,ravencrest,392,rogue,assassination,18,7,11
Dredge,kaelthas,391,rogue,assassination,25,8,17
Whosmanz,ragnaros,384,rogue,assassination,6,4,2
Ebayscammer,ravencrest,384,rogue,assassination,6,4,2
Kidneyou,ragnaros,384,rogue,assassination,6,4,2
Sîccarîus,ravencrest,384,rogue,assassination,6,4,2
Дикийминус,howling-fjord,384,rogue,assassination,6,4,2
Zerfex,eredar,384,rogue,assassination,6,4,2
Myk,ravencrest,384,rogue,assassination,6,4,2
Brñ,ravencrest,384,rogue,assassination,6,4,2
Sayianwho,ravencrest,384,rogue,assassination,6,4,2
Malvaxxs,tarren-mill,384,rogue,assassination,6,4,2
Бейнс,howling-fjord,384,rogue,assassination,6,4,2
Brunhityx,ravencrest,384,rogue,assassination,6,4,2
Tebzr,ravencrest,384,rogue,assassination,6,4,2
Parawietje,twilights-hammer,384,rogue,assassination,6,4,2
Jaxck,sylvanas,384,rogue,assassination,6,4,2
Awakeaf,outland,384,rogue,assassination,6,4,2
Doomdagger,chamber-of-aspects,384,rogue,assassination,6,4,2
Аязлаая,blackscar,384,rogue,assassination,6,4,2
Justkiddning,blackmoore,384,rogue,assassination,6,4,2
Йа,gordunni,384,rogue,assassination,6,4,2
Лиринэлла,soulflayer,384,rogue,assassination,6,4,2
Mouchess,hyjal,384,rogue,assassination,6,4,2
Имилиона,blackscar,384,rogue,assassination,6,4,2
Биокарлик,soulflayer,384,rogue,assassination,6,4,2
Únk,dalaran,384,rogue,assassination,9,5,4
Fálke,dun-modr,384,rogue,assassination,12,4,8
Crimatoria,rajaxx,384,rogue,assassination,12,4,8
Paidaki,kazzak,384,rogue,assassination,12,4,8
Röguetönerö,dun-modr,384,rogue,assassination,12,4,8
Stepkickgodx,blackmoore,384,rogue,assassination,12,4,8
Stepbrogue,tarren-mill,384,rogue,assassination,12,4,8
Darkchomeur,archimonde,384,rogue,assassination,12,4,8
Feucht,argent-dawn,384,rogue,assassination,12,4,8
Achterom,tarren-mill,384,rogue,assassination,12,4,8
Фуллблайнд,gordunni,384,rogue,assassination,12,4,8
Noxxy,archimonde,384,rogue,assassination,12,4,8
Meimei,sanguino,384,rogue,assassination,12,4,8
Гранетанцор,blackscar,384,rogue,assassination,12,4,8
Лайнэл,deathweaver,384,rogue,assassination,18,4,14
Ibizà,ravencrest,384,rogue,assassination,18,4,14
Gorgeousréd,aegwynn,384,rogue,assassination,18,4,14
Vexedancer,stormscale,383,rogue,assassination,6,4,2
Opiïum,ysondre,383,rogue,assassination,6,4,2
Килларан,howling-fjord,383,rogue,assassination,6,4,2
Whiz,alexstrasza,383,rogue,assassination,15,5,10
Obbexd,outland,383,rogue,assassination,12,4,8
Silksneak,kazzak,383,rogue,assassination,12,4,8
Töbïï,sylvanas,383,rogue,assassination,12,4,8
Satiiva,terokkar,383,rogue,assassination,18,4,14
Twinkyzzö,archimonde,382,rogue,assassination,12,4,8
Sessanali,silvermoon,382,rogue,assassination,18,4,14
Møkkagnom,darkspear,381,rogue,assassination,12,4,8
Ressputini,emeriss,366,rogue,assassination,11,4,7
Стронг,soulflayer,352,rogue,assassination,10,4,6
Stælf,argent-dawn,352,rogue,assassination,16,4,12
Lilbubblegum,emerald-dream,351,rogue,assassination,11,4,7
Deevoll,tarren-mill,351,rogue,assassination,14,5,9
Eljana,amanthul,335,rogue,assassination,11,4,7
Riskyx,draenor,304,rogue,assassination,7,4,3
Redcutter,silvermoon,288,rogue,assassination,6,3,3
Nuguri,blackrock,288,rogue,assassination,6,3,3
Anhduy,blackrock,288,rogue,assassination,6,3,3
Ракфорн,howling-fjord,288,rogue,assassination,6,3,3
Izzyb,auchindoun,288,rogue,assassination,6,3,3
Psg,argent-dawn,288,rogue,assassination,6,3,3
Hì,bronzebeard,288,rogue,assassination,6,3,3
Brazi,dalaran,288,rogue,assassination,6,3,3
Ingesa,blackhand,288,rogue,assassination,6,3,3
Lättja,hyjal,288,rogue,assassination,6,3,3
Котянкахд,howling-fjord,288,rogue,assassination,6,3,3
Luciferx,stormscale,288,rogue,assassination,6,3,3
Myxx,ravencrest,288,rogue,assassination,6,3,3
Lïhtêñßërg,ravencrest,288,rogue,assassination,6,3,3
Якунька,soulflayer,288,rogue,assassination,6,3,3
Stroògz,ysondre,288,rogue,assassination,6,3,3
Stealthyist,darkmoon-faire,288,rogue,assassination,6,3,3
Meldee,burning-legion,288,rogue,assassination,6,3,3
Shâdowfreeze,onyxia,288,rogue,assassination,6,3,3
Sâtýr,ravencrest,288,rogue,assassination,6,3,3
Smorcoolio,stormscale,288,rogue,assassination,6,3,3
Mordred,stormscale,288,rogue,assassination,6,3,3
Охотникведьм,soulflayer,288,rogue,assassination,6,3,3
Jupezii,stormreaver,288,rogue,assassination,6,3,3
Rîg,draenor,288,rogue,assassination,12,3,9
Hersuub,blackmoore,288,rogue,assassination,12,3,9
Bumaqt,silvermoon,288,rogue,assassination,12,3,9
Lacusdark,draenor,288,rogue,assassination,12,3,9
Persës,outland,288,rogue,assassination,12,3,9
Nezuko,gilneas,288,rogue,assassination,12,3,9
Milenia,thrall,288,rogue,assassination,12,3,9
Kyropth,eredar,288,rogue,assassination,12,3,9
Ryurfy,archimonde,288,rogue,assassination,12,3,9
Madisonivyqt,blackmoore,288,rogue,assassination,12,3,9
Курога,howling-fjord,288,rogue,assassination,12,3,9
Jáyjay,antonidas,288,rogue,assassination,18,3,15
Экичу,howling-fjord,287,rogue,assassination,6,3,3
Pumpy,blades-edge,287,rogue,assassination,6,3,3
Willin,kazzak,287,rogue,assassination,6,3,3
Гламурятина,gordunni,287,rogue,assassination,6,3,3
Nastyrogue,burning-legion,287,rogue,assassination,12,3,9
Fizzkhalifa,zuljin,284,rogue,assassination,12,3,9
Verbb,turalyon,284,rogue,assassination,12,3,9
Rahes,stormscale,255,rogue,assassination,23,3,20
Blckrogue,bloodfeather,240,rogue,assassination,9,3,6
Alpinestars,dun-modr,239,rogue,assassination,5,3,2
Starkad,archimonde,239,rogue,assassination,5,3,2
Rhâpsødýx,twisting-nether,234,rogue,assassination,8,4,4
Psybelette,khaz-modan,192,rogue,assassination,9,3,6
Zyphion,ragnaros,192,rogue,assassination,6,2,4
Саулите,deathguard,192,rogue,assassination,6,2,4
Rearmer,burning-legion,192,rogue,assassination,6,2,4
Kenjí,silvermoon,192,rogue,assassination,6,2,4
Eriksonn,drakthul,192,rogue,assassination,6,2,4
Gane,sanguino,192,rogue,assassination,6,2,4
Naí,zuljin,192,rogue,assassination,6,2,4
Fushimi,ravencrest,192,rogue,assassination,6,2,4
Xanyy,bloodfeather,192,rogue,assassination,6,2,4
Halucinogeno,silvermoon,192,rogue,assassination,6,2,4
Ichiegoichie,draenor,192,rogue,assassination,6,2,4
Kikitaklk,uldum,192,rogue,assassination,6,2,4
Saix,blackrock,192,rogue,assassination,6,2,4
Хулиганнчег,galakrond,192,rogue,assassination,6,2,4
Schníttchen,antonidas,192,rogue,assassination,6,2,4
Sokillu,silvermoon,192,rogue,assassination,6,2,4
Jeruna,veklor,192,rogue,assassination,6,2,4
Teldã,archimonde,192,rogue,assassination,6,2,4
Ач,gordunni,192,rogue,assassination,6,2,4
Zømbië,kazzak,192,rogue,assassination,6,2,4
Bangerstab,draenor,192,rogue,assassination,6,2,4
Nudelholz,blackrock,192,rogue,assassination,6,2,4
Yanlu,ysondre,192,rogue,assassination,6,2,4
Tinta,aszune,192,rogue,assassination,6,2,4
Snurry,tarren-mill,192,rogue,assassination,6,2,4
Сабстрайк,soulflayer,192,rogue,assassination,6,2,4
Tofix,tarren-mill,192,rogue,assassination,6,2,4
Bhabì,uldaman,192,rogue,assassination,6,2,4
Helcof,emerald-dream,192,rogue,assassination,6,2,4
Нойсеен,gordunni,192,rogue,assassination,6,2,4
Shúrae,blackmoore,192,rogue,assassination,6,2,4
Jonewrld,ravencrest,192,rogue,assassination,6,2,4
Althieves,ravencrest,192,rogue,assassination,6,2,4
Mallaurya,dalaran,192,rogue,assassination,6,2,4
Díddz,tarren-mill,192,rogue,assassination,6,2,4
Eazmode,outland,192,rogue,assassination,6,2,4
Horvathzu,ravencrest,192,rogue,assassination,6,2,4
Китей,howling-fjord,192,rogue,assassination,6,2,4
Bronxbomber,tarren-mill,192,rogue,assassination,6,2,4
Diliu,doomhammer,192,rogue,assassination,6,2,4
Xeggy,turalyon,192,rogue,assassination,6,2,4
Maxrizzx,ravencrest,192,rogue,assassination,6,2,4
Norpz,aggra-português,192,rogue,assassination,6,2,4
Missesinvis,blackmoore,192,rogue,assassination,6,2,4
Fälke,dun-modr,192,rogue,assassination,6,2,4
Katara,antonidas,192,rogue,assassination,6,2,4
Vanisha,outland,192,rogue,assassination,6,2,4
Synexo,sylvanas,192,rogue,assassination,6,2,4
Стеллакокс,howling-fjord,192,rogue,assassination,8,2,6
Sneakysloth,ravencrest,192,rogue,assassination,11,2,9
Stonecold,twilights-hammer,192,rogue,assassination,12,2,10
Cacucoxpahu,kazzak,192,rogue,assassination,12,2,10
Sneakzy,sylvanas,192,rogue,assassination,12,2,10
Romiel,ravencrest,192,rogue,assassination,12,2,10
Mingzhu,ravencrest,192,rogue,assassination,12,2,10
Vezinia,ravencrest,192,rogue,assassination,12,2,10
Azzmodia,aegwynn,192,rogue,assassination,12,2,10
Sheyrrà,aegwynn,192,rogue,assassination,12,2,10
Zerö,tarren-mill,192,rogue,assassination,12,2,10
Sythex,archimonde,192,rogue,assassination,12,2,10
Бонасера,blackscar,192,rogue,assassination,12,2,10
Лэйкиро,gordunni,192,rogue,assassination,12,2,10
Coopér,argent-dawn,192,rogue,assassination,18,2,16
Rêdbello,dun-morogh,191,rogue,assassination,6,2,4
Drexxo,drakthul,191,rogue,assassination,6,2,4
Nhot,kazzak,191,rogue,assassination,6,2,4
Easy,kult-der-verdammten,190,rogue,assassination,12,2,10
Icyicé,kazzak,175,rogue,assassination,11,2,9
Sanzoo,blackmoore,175,rogue,assassination,11,2,9
Ripgore,sylvanas,159,rogue,assassination,5,2,3
Voraq,blackhand,159,rogue,assassination,5,2,3
Knockyz,khaz-modan,135,rogue,assassination,13,3,10
Totentánz,silvermoon,96,rogue,assassination,9,2,7
Krymziàâ,hyjal,96,rogue,assassination,6,1,5
Vanisshh,hyjal,96,rogue,assassination,6,1,5
Kenko,aerie-peak,96,rogue,assassination,6,1,5
Ðiè,frostmane,96,rogue,assassination,6,1,5
Royalflüx,grim-batol,96,rogue,assassination,6,1,5
Ристоврация,gordunni,96,rogue,assassination,6,1,5
Matarocho,ravencrest,96,rogue,assassination,6,1,5
Mindset,eredar,96,rogue,assassination,6,1,5
Метаболикх,gordunni,96,rogue,assassination,6,1,5
Yörgs,eredar,96,rogue,assassination,6,1,5
Sly,emerald-dream,96,rogue,assassination,6,1,5
Ohmydotz,archimonde,96,rogue,assassination,6,1,5
Chøsen,stormscale,96,rogue,assassination,6,1,5
Azotix,archimonde,96,rogue,assassination,6,1,5
Ogc,draenor,96,rogue,assassination,6,1,5
Трисися,gordunni,96,rogue,assassination,6,1,5
Penetrantos,eredar,96,rogue,assassination,6,1,5
Aknana,vashj,96,rogue,assassination,6,1,5
Рестинписер,soulflayer,96,rogue,assassination,6,1,5
Msrogue,eredar,96,rogue,assassination,6,1,5
Wøølfgang,archimonde,96,rogue,assassination,6,1,5
Giftknirps,silvermoon,96,rogue,assassination,6,1,5
Myk,xavius,96,rogue,assassination,6,1,5
Sickko,stormscale,96,rogue,assassination,6,1,5
Mol,defias-brotherhood,96,rogue,assassination,6,1,5
Кейнилин,gordunni,96,rogue,assassination,6,1,5
Yamoshí,sanguino,96,rogue,assassination,6,1,5
Missàh,archimonde,96,rogue,assassination,6,1,5
Frequenzalfa,silvermoon,96,rogue,assassination,6,1,5
Miiløx,silvermoon,96,rogue,assassination,6,1,5
Jawen,silvermoon,96,rogue,assassination,12,1,11
Elvís,chamber-of-aspects,95,rogue,assassination,6,1,5
Trashcarlitâ,eredar,79,rogue,assassination,5,1,4
Layson,les-clairvoyants,79,rogue,assassination,5,1,4
Maelithas,archimonde,79,rogue,assassination,11,1,10
Kebabgodx,sanguino,31,rogue,assassination,2,1,1
Shadrak,eredar,2123,shaman,restoration,84,46,38
Crnine,pozzo-delleternità,2112,shaman,restoration,75,49,26
Дольчих,deathguard,2103,shaman,restoration,110,53,57
Josë,twisting-nether,2095,shaman,restoration,95,52,43
Ultrahound,twisting-nether,2057,shaman,restoration,48,39,9
Trashgame,kazzak,2050,shaman,restoration,66,36,30
Мефодийшаман,howling-fjord,2038,shaman,restoration,72,51,21
Джексобед,soulflayer,2026,shaman,restoration,126,66,60
Yararsiz,twisting-nether,2004,shaman,restoration,159,86,73
Bmbx,archimonde,1979,shaman,restoration,185,100,85
Драгенхз,gordunni,1970,shaman,restoration,304,154,150
Sentûn,blackrock,1960,shaman,restoration,103,56,47
Цукерок,soulflayer,1958,shaman,restoration,84,56,28
Epsylone,kazzak,1953,shaman,restoration,101,51,50
Linkx,stormscale,1948,shaman,restoration,40,22,18
Thunderrock,stormreaver,1942,shaman,restoration,122,61,61
Valko,hellfire,1931,shaman,restoration,42,27,15
Deepwithyou,blackhand,1931,shaman,restoration,99,55,44
Skreewu,outland,1908,shaman,restoration,78,37,41
Adroda,kazzak,1899,shaman,restoration,63,37,26
Carlpeant,drakthul,1896,shaman,restoration,84,42,42
Трс,razuvious,1892,shaman,restoration,122,69,53
Mininini,ravencrest,1880,shaman,restoration,60,29,31
Sèfìx,tarren-mill,1879,shaman,restoration,38,21,17
Owrly,stormscale,1878,shaman,restoration,106,51,55
Cylantarus,blackrock,1877,shaman,restoration,77,46,31
Timide,ravencrest,1870,shaman,restoration,48,28,20
Teldathree,archimonde,1866,shaman,restoration,95,51,44
Keenxd,burning-legion,1861,shaman,restoration,42,23,19
Louler,ragnaros,1860,shaman,restoration,124,69,55
Lahey,draenor,1858,shaman,restoration,92,55,37
Kïllard,archimonde,1858,shaman,restoration,68,33,35
Jackypink,ragnaros,1858,shaman,restoration,93,41,52
Bladeyx,ragnaros,1856,shaman,restoration,177,104,73
Tallyx,ravencrest,1855,shaman,restoration,72,34,38
Yachiru,sylvanas,1854,shaman,restoration,73,59,14
Swkx,dun-modr,1848,shaman,restoration,58,34,24
Sugarfreé,ragnaros,1848,shaman,restoration,48,26,22
Cæsífer,blackrock,1844,shaman,restoration,72,32,40
Helloiamdoni,ravencrest,1843,shaman,restoration,101,63,38
Sinzzu,ragnaros,1838,shaman,restoration,150,76,74
Zhull,ravencrest,1836,shaman,restoration,144,65,79
Centralc,twisting-nether,1833,shaman,restoration,41,26,15
Shiranoye,blackrock,1831,shaman,restoration,120,65,55
Jawje,tarren-mill,1831,shaman,restoration,102,49,53
Shamuunn,ravencrest,1830,shaman,restoration,54,28,26
Sethrøllins,hyjal,1829,shaman,restoration,102,47,55
Fitnessdavid,ravencrest,1826,shaman,restoration,53,29,24
Zergønk,ravencrest,1824,shaman,restoration,42,28,14
Rottulos,stormrage,1823,shaman,restoration,41,27,14
Lunarsloths,hyjal,1823,shaman,restoration,48,28,20
Shamrockx,outland,1816,shaman,restoration,83,42,41
Carpetmaster,ragnaros,1812,shaman,restoration,51,27,24
Нойзблок,gordunni,1811,shaman,restoration,36,19,17
Tidepog,ravencrest,1810,shaman,restoration,60,28,32
Fuzzynuts,ravencrest,1808,shaman,restoration,132,74,58
Онеоне,deathweaver,1807,shaman,restoration,53,31,22
Kreamcake,bladefist,1807,shaman,restoration,96,43,53
Nokster,twisting-nether,1806,shaman,restoration,84,60,24
Ggnore,kazzak,1806,shaman,restoration,54,37,17
Greggyb,twisting-nether,1805,shaman,restoration,36,22,14
Neou,archimonde,1803,shaman,restoration,54,27,27
Милфшама,blackscar,1802,shaman,restoration,239,123,116
Stensham,stormreaver,1801,shaman,restoration,48,28,20
Kiansham,silvermoon,1801,shaman,restoration,47,26,21
Kisshots,the-maelstrom,1794,shaman,restoration,48,23,25
Awcchampion,stormscale,1793,shaman,restoration,179,106,73
Wíllz,ravencrest,1787,shaman,restoration,48,25,23
Phaynozx,cthun,1786,shaman,restoration,60,29,31
Fufupartyxx,blackrock,1785,shaman,restoration,30,19,11
Hexe,kazzak,1783,shaman,restoration,75,32,43
Szellento,darksorrow,1770,shaman,restoration,60,30,30
Johncoltrane,archimonde,1765,shaman,restoration,84,57,27
Kraksham,ravencrest,1765,shaman,restoration,106,58,48
Shamolili,stormscale,1764,shaman,restoration,96,48,48
Midgetfizzle,kazzak,1764,shaman,restoration,82,40,42
Bstr,frostmane,1763,shaman,restoration,60,30,30
Windfúhrèr,tarren-mill,1759,shaman,restoration,60,26,34
Эоя,howling-fjord,1758,shaman,restoration,132,66,66
Harmony,outland,1746,shaman,restoration,30,22,8
Palfe,khaz-modan,1746,shaman,restoration,93,46,47
Karakoram,ysondre,1742,shaman,restoration,53,32,21
Purgeluxe,aegwynn,1740,shaman,restoration,59,32,27
Hugox,outland,1740,shaman,restoration,48,20,28
Donv,blackmoore,1739,shaman,restoration,42,26,16
Lavalavalava,blackrock,1734,shaman,restoration,201,109,92
Ixxmre,blackrock,1731,shaman,restoration,125,68,57
Агентхолинки,gordunni,1726,shaman,restoration,24,18,6
Luckymê,blackrock,1725,shaman,restoration,40,20,20
Arslos,twisting-nether,1723,shaman,restoration,30,24,6
Ihealbro,blackrock,1722,shaman,restoration,60,37,23
Wess,archimonde,1722,shaman,restoration,36,18,18
Totembaws,blackmoore,1708,shaman,restoration,54,26,28
Hexmeqt,frostwolf,1707,shaman,restoration,48,33,15
Ларкуш,howling-fjord,1707,shaman,restoration,82,44,38
Darnast,draenor,1706,shaman,restoration,52,25,27
Connecting,hyjal,1704,shaman,restoration,39,21,18
Мвнз,soulflayer,1700,shaman,restoration,54,22,32
Goeller,stormscale,1698,shaman,restoration,42,23,19
Wacomtablet,kazzak,1690,shaman,restoration,24,18,6
Frshprn,hyjal,1687,shaman,restoration,36,20,16
Вишняблэйз,soulflayer,1684,shaman,restoration,41,24,17
Machmacan,argent-dawn,1683,shaman,restoration,68,36,32
Чинанрук,howling-fjord,1680,shaman,restoration,77,38,39
Сорит,blackscar,1678,shaman,restoration,45,28,17
Learningsham,destromath,1676,shaman,restoration,30,21,9
Turboeddy,blackmoore,1675,shaman,restoration,49,32,17
Mbembe,blackhand,1674,shaman,restoration,48,26,22
Indeed,frostmourne,1672,shaman,restoration,36,23,13
Porkzzila,aggra-português,1671,shaman,restoration,60,34,26
Skrewu,stormscale,1671,shaman,restoration,79,39,40
Tùiðhânâ,ravencrest,1668,shaman,restoration,42,22,20
Waramors,eredar,1668,shaman,restoration,113,53,60
Reäz,archimonde,1665,shaman,restoration,42,21,21
Héxdóctór,ravencrest,1664,shaman,restoration,86,48,38
Atwâ,ravencrest,1663,shaman,restoration,51,31,20
Brandiløve,nemesis,1663,shaman,restoration,36,19,17
Crmx,blackrock,1657,shaman,restoration,51,23,28
Мвнзх,gordunni,1656,shaman,restoration,54,24,30
Hypéra,kazzak,1655,shaman,restoration,156,84,72
Shamandoino,wildhammer,1644,shaman,restoration,198,91,107
Phoenííx,twisting-nether,1643,shaman,restoration,42,20,22
Meöw,nemesis,1638,shaman,restoration,114,53,61
Kyogre,auchindoun,1636,shaman,restoration,42,22,20
Vajaele,twisting-nether,1636,shaman,restoration,47,23,24
Rxs,thunderhorn,1635,shaman,restoration,54,28,26
Pøwertoto,dalaran,1632,shaman,restoration,54,24,30
Bonshaman,ahnqiraj,1632,shaman,restoration,48,19,29
Izir,archimonde,1628,shaman,restoration,42,18,24
Hjod,outland,1627,shaman,restoration,83,45,38
Urshak,alleria,1624,shaman,restoration,30,20,10
Askagain,sylvanas,1624,shaman,restoration,28,18,10
Xhanon,kazzak,1624,shaman,restoration,36,20,16
Fersok,zuljin,1624,shaman,restoration,36,17,19
Chäväman,archimonde,1624,shaman,restoration,48,17,31
Thyroideus,argent-dawn,1622,shaman,restoration,90,56,34
Atomstrom,frostwolf,1621,shaman,restoration,62,34,28
Инкуль,howling-fjord,1621,shaman,restoration,42,20,22
Igly,antonidas,1620,shaman,restoration,30,17,13
Sûckmytotem,ragnaros,1619,shaman,restoration,30,17,13
Zwergmann,blackrock,1618,shaman,restoration,54,36,18
Seasick,frostmane,1618,shaman,restoration,66,34,32
Coldlean,haomarush,1617,shaman,restoration,90,46,44
Тафельшпиц,soulflayer,1617,shaman,restoration,40,18,22
Earthhulk,thrall,1615,shaman,restoration,89,52,37
Сладкийстас,soulflayer,1613,shaman,restoration,48,20,28
Yzeldan,hyjal,1611,shaman,restoration,124,79,45
Bullezno,kazzak,1611,shaman,restoration,87,50,37
Makkalisse,kazzak,1609,shaman,restoration,24,17,7
Upisi,burning-legion,1609,shaman,restoration,84,42,42
Blowlips,argent-dawn,1609,shaman,restoration,42,17,25
Koraél,dun-modr,1608,shaman,restoration,54,21,33
Rexatar,blackrock,1606,shaman,restoration,36,21,15
Sanamaxx,colinas-pardas,1605,shaman,restoration,44,24,20
Zanezu,stormscale,1605,shaman,restoration,90,42,48
Whiskiy,kazzak,1598,shaman,restoration,26,18,8
Lechii,stormscale,1598,shaman,restoration,95,51,44
Martuscielöl,drakthul,1598,shaman,restoration,88,32,56
Laskopivo,doomhammer,1593,shaman,restoration,60,37,23
Bîlunder,arygos,1593,shaman,restoration,41,19,22
Shockair,frostwolf,1591,shaman,restoration,69,32,37
Firenanajkm,dun-modr,1586,shaman,restoration,48,28,20
Variablelol,outland,1584,shaman,restoration,29,20,9
Vioception,blackrock,1584,shaman,restoration,48,19,29
Denastyo,nemesis,1581,shaman,restoration,36,21,15
Tupato,kazzak,1581,shaman,restoration,62,31,31
Ebøbøla,terokkar,1581,shaman,restoration,152,70,82
Mìcrøs,thrall,1571,shaman,restoration,47,27,20
Sixtyone,stormscale,1569,shaman,restoration,75,42,33
Zinjk,nemesis,1567,shaman,restoration,126,66,60
Beastmodex,eredar,1567,shaman,restoration,132,68,64
Шсаваннх,blackscar,1566,shaman,restoration,165,83,82
Uzze,drakthul,1564,shaman,restoration,60,26,34
Horokeu,blackrock,1560,shaman,restoration,30,17,13
Exolnard,twisting-nether,1557,shaman,restoration,60,28,32
Sebubu,twisting-nether,1556,shaman,restoration,38,23,15
Kuhnedy,blackrock,1553,shaman,restoration,82,43,39
Discoranger,ravencrest,1552,shaman,restoration,54,27,27
Thald,ragnaros,1550,shaman,restoration,42,28,14
Shuzman,emeriss,1550,shaman,restoration,48,23,25
Ezilol,blackhand,1547,shaman,restoration,65,38,27
Reilah,drakthul,1546,shaman,restoration,66,33,33
Linkedink,tarren-mill,1545,shaman,restoration,23,17,6
Bezixx,ravencrest,1544,shaman,restoration,60,31,29
Кичисанчик,howling-fjord,1541,shaman,restoration,126,57,69
Pädagogeig,antonidas,1536,shaman,restoration,54,30,24
Anöuchkâ,ysondre,1535,shaman,restoration,42,19,23
Mcktavish,silvermoon,1534,shaman,restoration,36,22,14
Blowxd,aegwynn,1534,shaman,restoration,116,63,53
Ugard,burning-legion,1533,shaman,restoration,37,18,19
Отчима,howling-fjord,1532,shaman,restoration,77,41,36
Mypakypa,outland,1532,shaman,restoration,48,20,28
Urzza,stormscale,1530,shaman,restoration,18,16,2
Collînna,aegwynn,1529,shaman,restoration,62,34,28
Nassîî,antonidas,1528,shaman,restoration,95,37,58
Bumblebeec,tarren-mill,1526,shaman,restoration,54,29,25
Reezex,silvermoon,1526,shaman,restoration,65,34,31
Bombasthicc,ravencrest,1523,shaman,restoration,30,16,14
Ilovejamie,sylvanas,1522,shaman,restoration,54,30,24
Кислаябуба,howling-fjord,1520,shaman,restoration,61,28,33
Schain,eredar,1518,shaman,restoration,36,24,12
Zorcs,silvermoon,1518,shaman,restoration,127,61,66
Incredibade,stormscale,1517,shaman,restoration,36,16,20
Remony,pozzo-delleternità,1512,shaman,restoration,39,27,12
Mydpsrbad,stormscale,1507,shaman,restoration,42,23,19
Enzopotenzo,blackrock,1506,shaman,restoration,42,22,20
Vaizii,silvermoon,1505,shaman,restoration,53,26,27
Krovogor,silvermoon,1501,shaman,restoration,54,31,23
Remkoo,blackrock,1498,shaman,restoration,24,17,7
Velkin,thrall,1494,shaman,restoration,109,55,54
Neovim,trollbane,1493,shaman,restoration,30,16,14
Apaorkaxyz,ragnaros,1493,shaman,restoration,60,27,33
Хэйзл,ashenvale,1492,shaman,restoration,74,32,42
Lexos,ravencrest,1490,shaman,restoration,30,16,14
Diix,archimonde,1489,shaman,restoration,66,27,39
Kalaris,stormscale,1488,shaman,restoration,36,20,16
Светшам,howling-fjord,1486,shaman,restoration,29,16,13
Чанголист,soulflayer,1486,shaman,restoration,47,19,28
Pacio,alakir,1481,shaman,restoration,78,40,38
Monstermunch,ravencrest,1481,shaman,restoration,93,43,50
Mamacitá,eredar,1481,shaman,restoration,144,53,91
Gützli,blackmoore,1474,shaman,restoration,93,35,58
Ünknownz,archimonde,1464,shaman,restoration,71,37,34
Biggiebig,ravencrest,1458,shaman,restoration,42,21,21
Stòrmbreakèr,nemesis,1458,shaman,restoration,37,18,19
Духсалата,grom,1454,shaman,restoration,30,16,14
Cuzzer,drakthul,1454,shaman,restoration,77,39,38
Hexoffender,alakir,1454,shaman,restoration,106,50,56
Zlingx,auchindoun,1454,shaman,restoration,48,22,26
Ironkraw,stormscale,1453,shaman,restoration,60,22,38
Djxyoloswag,silvermoon,1451,shaman,restoration,81,36,45
Redoms,stormreaver,1449,shaman,restoration,63,31,32
Gspót,twisting-nether,1447,shaman,restoration,98,47,51
Mjukiz,tarren-mill,1444,shaman,restoration,99,59,40
Sucøre,die-nachtwache,1444,shaman,restoration,52,27,25
Bonraptor,kirin-tor,1443,shaman,restoration,41,20,21
Zaiyoxgodx,thrall,1439,shaman,restoration,30,16,14
Helloitsmee,thrall,1439,shaman,restoration,40,20,20
Шиока,borean-tundra,1436,shaman,restoration,24,17,7
Roineé,draenor,1436,shaman,restoration,30,15,15
Okdar,stormscale,1435,shaman,restoration,54,34,20
Emochka,ravencrest,1435,shaman,restoration,130,60,70
Kataretic,kazzak,1433,shaman,restoration,24,17,7
Vioceptîon,blackrock,1432,shaman,restoration,24,19,5
Cobbel,argent-dawn,1429,shaman,restoration,60,32,28
Mcbloob,kazzak,1425,shaman,restoration,40,19,21
Shemanrolf,outland,1425,shaman,restoration,57,26,31
Vorkanyx,ysondre,1421,shaman,restoration,52,26,26
Prizærn,tarren-mill,1415,shaman,restoration,42,15,27
Diya,karazhan,1414,shaman,restoration,72,33,39
Mightgethexd,tarren-mill,1412,shaman,restoration,24,16,8
Wôdân,blackrock,1412,shaman,restoration,54,21,33
Zhulnaar,hyjal,1409,shaman,restoration,42,21,21
Bénathon,ravencrest,1407,shaman,restoration,33,21,12
Tèysh,ysondre,1407,shaman,restoration,66,35,31
Кразтор,howling-fjord,1405,shaman,restoration,35,18,17
Splashgodx,frostwolf,1401,shaman,restoration,29,15,14
Yomuchacha,dun-modr,1398,shaman,restoration,94,44,50
Дагод,booty-bay,1393,shaman,restoration,30,22,8
Yois,nemesis,1393,shaman,restoration,66,37,29
Damex,thunderhorn,1390,shaman,restoration,108,38,70
Johnblånn,stormscale,1389,shaman,restoration,51,30,21
Джонпсинаа,gordunni,1379,shaman,restoration,36,18,18
Warianis,ravencrest,1374,shaman,restoration,51,27,24
Elamentaly,draenor,1371,shaman,restoration,54,29,25
Phêbz,archimonde,1371,shaman,restoration,48,25,23
Jazzrod,stormscale,1369,shaman,restoration,168,81,87
Vuls,blackmoore,1367,shaman,restoration,24,18,6
Hulcky,grim-batol,1363,shaman,restoration,48,27,21
Nwäar,archimonde,1362,shaman,restoration,36,21,15
Murmaiderz,draenor,1362,shaman,restoration,66,32,34
Akrobata,silvermoon,1360,shaman,restoration,180,83,97
Lustmasterx,grim-batol,1357,shaman,restoration,54,26,28
Shago,archimonde,1356,shaman,restoration,95,43,52
Elombrion,destromath,1355,shaman,restoration,30,16,14
Ketzersend,alleria,1351,shaman,restoration,30,18,12
Asumix,illidan,1347,shaman,restoration,71,38,33
Rhakhatheckh,nemesis,1340,shaman,restoration,30,16,14
Nestre,kazzak,1339,shaman,restoration,30,14,16
Виелетта,gordunni,1338,shaman,restoration,24,14,10
Shapperdin,darksorrow,1336,shaman,restoration,24,14,10
Littledorf,ravencrest,1331,shaman,restoration,30,19,11
Ксмо,gordunni,1331,shaman,restoration,24,14,10
Kuis,sanguino,1331,shaman,restoration,30,14,16
Vodoochild,hyjal,1327,shaman,restoration,43,17,26
Jarvís,gilneas,1327,shaman,restoration,50,19,31
Sadfemecraft,aggramar,1326,shaman,restoration,105,45,60
Showman,archimonde,1325,shaman,restoration,146,72,74
Patuljak,outland,1317,shaman,restoration,59,29,30
Beyp,sylvanas,1315,shaman,restoration,41,22,19
Macchiavelli,blades-edge,1313,shaman,restoration,41,20,21
Antey,ravencrest,1313,shaman,restoration,72,35,37
Alisàn,teldrassil,1312,shaman,restoration,91,43,48
Шайнинлайт,soulflayer,1311,shaman,restoration,83,32,51
Navezi,twisting-nether,1310,shaman,restoration,72,41,31
Aceofraphy,thrall,1308,shaman,restoration,125,53,72
Gnackbretzn,eredar,1305,shaman,restoration,36,15,21
Durek,aerie-peak,1304,shaman,restoration,24,14,10
Teccatwo,outland,1302,shaman,restoration,76,40,36
Shôk,ravencrest,1302,shaman,restoration,68,35,33
Sugardad,khaz-modan,1301,shaman,restoration,70,34,36
Шаеман,soulflayer,1298,shaman,restoration,36,20,16
Murmelï,stormreaver,1297,shaman,restoration,51,26,25
Крэгнор,gordunni,1295,shaman,restoration,81,43,38
Shamanmode,twisting-nether,1292,shaman,restoration,42,17,25
Onlytides,doomhammer,1290,shaman,restoration,36,14,22
Thundersioux,ravencrest,1288,shaman,restoration,39,24,15
Samantouz,archimonde,1282,shaman,restoration,63,27,36
Sjamanisme,silvermoon,1279,shaman,restoration,42,20,22
Umbraverfaa,twisting-nether,1278,shaman,restoration,36,15,21
Сёмабро,ashenvale,1275,shaman,restoration,130,70,60
Ishkadar,twisting-nether,1270,shaman,restoration,33,15,18
Жижелье,howling-fjord,1263,shaman,restoration,52,28,24
Kbakasham,ravencrest,1262,shaman,restoration,32,15,17
Малекулакота,soulflayer,1261,shaman,restoration,35,14,21
Azifox,hyjal,1260,shaman,restoration,25,14,11
Bigrambo,draenor,1259,shaman,restoration,18,15,3
Panicsc,twisting-nether,1259,shaman,restoration,53,24,29
Fulminare,ravencrest,1250,shaman,restoration,36,20,16
Daboó,vashj,1250,shaman,restoration,73,38,35
Swineflowing,ysondre,1247,shaman,restoration,24,13,11
Karlurban,outland,1247,shaman,restoration,30,13,17
Reparagos,sanguino,1246,shaman,restoration,25,14,11
Squixi,tarren-mill,1246,shaman,restoration,24,13,11
Руикси,howling-fjord,1246,shaman,restoration,30,13,17
Shambulancex,tarren-mill,1243,shaman,restoration,24,13,11
Anlaki,silvermoon,1241,shaman,restoration,18,13,5
Eduorde,silvermoon,1241,shaman,restoration,26,15,11
Leunam,draenor,1241,shaman,restoration,52,26,26
Egí,azshara,1241,shaman,restoration,30,13,17
Sîggý,eredar,1237,shaman,restoration,24,13,11
Alexmiamosch,thrall,1226,shaman,restoration,78,48,30
Gaelic,frostmourne,1226,shaman,restoration,24,13,11
Moonbotico,blackrock,1220,shaman,restoration,36,18,18
Schnessert,silvermoon,1220,shaman,restoration,30,13,17
Sickbrain,silvermoon,1216,shaman,restoration,45,19,26
Yasharshammy,tarren-mill,1215,shaman,restoration,36,13,23
Перегной,ashenvale,1212,shaman,restoration,93,39,54
Deadwoodz,tarren-mill,1209,shaman,restoration,36,14,22
Morttes,burning-legion,1205,shaman,restoration,27,14,13
Nakenfeigy,stormreaver,1204,shaman,restoration,29,16,13
Baelee,sylvanas,1204,shaman,restoration,60,27,33
Semrix,blackhand,1202,shaman,restoration,30,13,17
Lechirurgien,elune,1201,shaman,restoration,78,39,39
Alakan,saurfang,1201,shaman,restoration,40,17,23
Blöödfist,drakthul,1200,shaman,restoration,35,14,21
Snobas,kazzak,1198,shaman,restoration,29,13,16
Lolafløres,dun-modr,1194,shaman,restoration,53,37,16
Jimmybuffett,kazzak,1193,shaman,restoration,55,26,29
Lerosh,twisting-nether,1193,shaman,restoration,30,14,16
Yuliy,arathor,1191,shaman,restoration,30,13,17
Братишкапинг,soulflayer,1190,shaman,restoration,98,50,48
Kickvando,blackmoore,1184,shaman,restoration,38,18,20
Oldrym,blackrock,1183,shaman,restoration,64,25,39
Fußpilzmann,blackmoore,1182,shaman,restoration,90,46,44
Watashij,outland,1179,shaman,restoration,45,22,23
Biztor,jaedenar,1178,shaman,restoration,48,26,22
Kvekkis,argent-dawn,1175,shaman,restoration,30,17,13
Arabesk,arygos,1174,shaman,restoration,102,49,53
Darnok,quelthalas,1173,shaman,restoration,60,29,31
Tegellera,ravencrest,1168,shaman,restoration,53,27,26
Thenasil,stormscale,1165,shaman,restoration,42,19,23
Drman,shattered-hand,1162,shaman,restoration,42,25,17
Bèx,twisting-nether,1159,shaman,restoration,30,13,17
Märthalouise,twisting-nether,1158,shaman,restoration,37,13,24
Linknvm,thrall,1156,shaman,restoration,18,13,5
Ðøminantx,stormscale,1155,shaman,restoration,30,14,16
Quòr,antonidas,1154,shaman,restoration,30,23,7
Alcam,twisting-nether,1154,shaman,restoration,77,33,44
Olînours,archimonde,1152,shaman,restoration,36,20,16
Snusy,stormscale,1152,shaman,restoration,24,12,12
Lexxthree,blackrock,1151,shaman,restoration,18,12,6
Dêblâzê,thrall,1151,shaman,restoration,24,12,12
Gargro,kazzak,1151,shaman,restoration,24,12,12
Teldarian,archimonde,1151,shaman,restoration,24,12,12
Suntpraf,kazzak,1151,shaman,restoration,29,14,15
Ripperdoc,stormreaver,1151,shaman,restoration,30,12,18
Souqixo,drakthul,1150,shaman,restoration,18,12,6
Lolalovexo,kazzak,1150,shaman,restoration,30,14,16
Dmgccbot,outland,1149,shaman,restoration,30,12,18
Putzè,blackrock,1148,shaman,restoration,18,12,6
Djosershamy,draenor,1148,shaman,restoration,24,12,12
Kaherad,antonidas,1148,shaman,restoration,72,33,39
Vaweñ,ravencrest,1147,shaman,restoration,30,12,18
Kärríegold,blackrock,1146,shaman,restoration,18,12,6
Schamazon,tarren-mill,1145,shaman,restoration,18,12,6
Nogag,kazzak,1145,shaman,restoration,24,12,12
Tartorno,antonidas,1144,shaman,restoration,36,12,24
Нитрочка,soulflayer,1143,shaman,restoration,24,12,12
Gehrké,silvermoon,1142,shaman,restoration,18,12,6
Elijaá,nordrassil,1141,shaman,restoration,54,30,24
Rêêza,blackhand,1140,shaman,restoration,36,19,17
Laïnàà,archimonde,1136,shaman,restoration,65,27,38
Сновидений,soulflayer,1135,shaman,restoration,24,12,12
Cloovster,magtheridon,1132,shaman,restoration,24,12,12
Bennycooch,silvermoon,1128,shaman,restoration,81,32,49
Holshammy,nemesis,1127,shaman,restoration,90,39,51
Jävlajävel,draenor,1126,shaman,restoration,33,20,13
Jimkopf,eredar,1123,shaman,restoration,24,14,10
Lemontea,burning-blade,1112,shaman,restoration,30,12,18
Woade,silvermoon,1108,shaman,restoration,30,12,18
Hazufel,kaelthas,1106,shaman,restoration,38,17,21
Sáltý,ravencrest,1103,shaman,restoration,21,12,9
Qjie,argent-dawn,1102,shaman,restoration,41,21,20
Ivaccineyou,blackmoore,1099,shaman,restoration,24,12,12
Thuknala,tarren-mill,1094,shaman,restoration,23,13,10
Pocahøntas,archimonde,1078,shaman,restoration,32,12,20
Nafay,lordaeron,1071,shaman,restoration,30,14,16
Smyke,magtheridon,1069,shaman,restoration,60,31,29
Shinui,twisting-nether,1069,shaman,restoration,24,12,12
Сорнинай,soulflayer,1068,shaman,restoration,36,15,21
Checkpoint,defias-brotherhood,1065,shaman,restoration,30,15,15
Кодитян,gordunni,1056,shaman,restoration,24,11,13
Nyzo,tarren-mill,1056,shaman,restoration,24,11,13
Invadé,stormscale,1056,shaman,restoration,24,11,13
Fotmherøqtx,ravencrest,1055,shaman,restoration,18,11,7
Garuga,dun-morogh,1055,shaman,restoration,24,11,13
Aioñ,kazzak,1055,shaman,restoration,27,11,16
Dmgaddict,kazzak,1054,shaman,restoration,18,11,7
Elshamino,ravencrest,1054,shaman,restoration,24,11,13
Tiddles,arathor,1053,shaman,restoration,18,11,7
Gronash,sunstrider,1051,shaman,restoration,18,11,7
Spartecøbra,dalaran,1051,shaman,restoration,30,13,17
Kíkjo,aegwynn,1050,shaman,restoration,18,11,7
Waterboi,blackmoore,1050,shaman,restoration,30,11,19
Оперочек,howling-fjord,1050,shaman,restoration,42,12,30
Flikus,aggra-português,1048,shaman,restoration,30,11,19
Cukkerberg,ragnaros,1047,shaman,restoration,36,15,21
Chokeonme,blackrock,1046,shaman,restoration,63,37,26
Mandoloriana,sylvanas,1041,shaman,restoration,24,11,13
Ephase,burning-blade,1041,shaman,restoration,45,11,34
Idkteam,stormscale,1037,shaman,restoration,24,11,13
Slutie,stormscale,1036,shaman,restoration,23,11,12
Haginathor,twisting-nether,1032,shaman,restoration,72,40,32
Dasce,sylvanas,1017,shaman,restoration,30,14,16
Mantoon,doomhammer,1013,shaman,restoration,30,12,18
Blainehammer,arathor,1006,shaman,restoration,30,12,18
Noulol,aegwynn,1005,shaman,restoration,23,12,11
Selrin,blackrock,1005,shaman,restoration,77,28,49
Subaki,die-aldor,1003,shaman,restoration,17,11,6
Венжии,soulflayer,1002,shaman,restoration,30,12,18
Valdraxx,ravencrest,1000,shaman,restoration,82,42,40
Wernøz,archimonde,991,shaman,restoration,20,11,9
Быковат,booty-bay,986,shaman,restoration,33,12,21
Teada,aegwynn,980,shaman,restoration,34,12,22
Knasta,malygos,978,shaman,restoration,30,11,19
Garifus,dun-modr,970,shaman,restoration,90,44,46
Mearu,bronze-dragonflight,961,shaman,restoration,30,18,12
Милжон,soulflayer,961,shaman,restoration,31,17,14
Qobq,ravencrest,960,shaman,restoration,12,10,2
Dremlok,burning-legion,959,shaman,restoration,12,10,2
Ðtxkeks,onyxia,959,shaman,restoration,13,10,3
Teldatwo,archimonde,959,shaman,restoration,18,10,8
Kacamaz,twisting-nether,959,shaman,restoration,18,10,8
Raketenrieke,blackrock,959,shaman,restoration,18,10,8
Monstacookie,stormreaver,959,shaman,restoration,18,10,8
Crysisx,sanguino,959,shaman,restoration,18,10,8
Hydrolîc,blackrock,959,shaman,restoration,18,10,8
Ugáa,malganis,959,shaman,restoration,24,10,14
Loay,blackrock,959,shaman,restoration,24,10,14
Drohx,ysondre,958,shaman,restoration,18,10,8
Fuzzywaagh,silvermoon,958,shaman,restoration,18,10,8
Paidactor,kazzak,958,shaman,restoration,18,10,8
Чаиро,howling-fjord,958,shaman,restoration,24,10,14
Neejtjak,ravencrest,958,shaman,restoration,24,10,14
Назульчике,razuvious,957,shaman,restoration,18,10,8
Zoolza,kirin-tor,957,shaman,restoration,36,10,26
Schaname,rajaxx,956,shaman,restoration,24,10,14
Bloodvaron,zuljin,942,shaman,restoration,29,10,19
Swedishmeat,kazzak,940,shaman,restoration,26,13,13
Nexolok,alleria,933,shaman,restoration,54,30,24
Bullvai,dun-morogh,929,shaman,restoration,62,28,34
Corbo,ysondre,917,shaman,restoration,39,19,20
Blumy,skullcrusher,912,shaman,restoration,72,34,38
Slowtem,draenor,906,shaman,restoration,23,10,13
Pilinham,aggra-português,864,shaman,restoration,12,9,3
Mysterqt,nemesis,864,shaman,restoration,12,9,3
Batmanmain,twisting-nether,864,shaman,restoration,16,10,6
Фатнир,soulflayer,864,shaman,restoration,18,9,9
Nothexy,stormscale,864,shaman,restoration,18,9,9
Shounx,hyjal,864,shaman,restoration,18,9,9
Котенокмур,soulflayer,864,shaman,restoration,24,9,15
Carlitosham,eredar,864,shaman,restoration,24,9,15
Shamantistik,ravencrest,863,shaman,restoration,12,9,3
Geminate,stormscale,863,shaman,restoration,12,9,3
Redomsh,stormreaver,863,shaman,restoration,18,9,9
Syreer,silvermoon,862,shaman,restoration,19,9,10
Tonifo,nemesis,861,shaman,restoration,12,9,3
Shamanopaf,tarren-mill,861,shaman,restoration,18,9,9
Freizeitler,antonidas,860,shaman,restoration,18,9,9
Amu,ravencrest,860,shaman,restoration,18,9,9
Orchal,defias-brotherhood,859,shaman,restoration,18,9,9
Sunsham,illidan,858,shaman,restoration,18,9,9
Düsterlotus,dalvengyr,857,shaman,restoration,12,9,3
Lanzatotems,dun-modr,852,shaman,restoration,18,9,9
Ambrosioss,kazzak,841,shaman,restoration,12,9,3
Yàra,throkferoth,837,shaman,restoration,24,10,14
Numdog,stormreaver,831,shaman,restoration,17,9,8
Shafallen,tarren-mill,829,shaman,restoration,14,10,4
Stkk,ravencrest,818,shaman,restoration,24,10,14
Hacyria,archimonde,815,shaman,restoration,18,9,9
Дрфэка,soulflayer,815,shaman,restoration,36,9,27
Crixuss,argent-dawn,809,shaman,restoration,17,9,8
Arshak,stormscale,800,shaman,restoration,16,9,7
Akwa,stormscale,799,shaman,restoration,20,9,11
Vërÿßåðxd,silvermoon,768,shaman,restoration,12,8,4
Squixi,ravencrest,768,shaman,restoration,12,8,4
Ivnashaman,drakthul,768,shaman,restoration,12,8,4
Enchancement,ragnaros,768,shaman,restoration,12,8,4
Lilcake,ravencrest,768,shaman,restoration,12,8,4
Zelent,thrall,768,shaman,restoration,12,8,4
Rostislav,ravencrest,768,shaman,restoration,12,8,4
Navajito,tarren-mill,768,shaman,restoration,12,8,4
Рамаксбосс,gordunni,768,shaman,restoration,12,8,4
Socialfailur,archimonde,768,shaman,restoration,12,8,4
Vivaldi,varimathras,768,shaman,restoration,14,8,6
Lorko,twisting-nether,768,shaman,restoration,18,8,10
Nøraa,ravencrest,768,shaman,restoration,18,8,10
Qoekke,uldum,768,shaman,restoration,18,8,10
Iloveléa,ravencrest,768,shaman,restoration,18,8,10
Sprühkot,aegwynn,768,shaman,restoration,18,8,10
Ripstorm,sylvanas,768,shaman,restoration,18,8,10
Ларисашерсть,blackscar,767,shaman,restoration,12,8,4
Berasham,dalaran,767,shaman,restoration,12,8,4
Lauree,terokkar,767,shaman,restoration,12,8,4
Eisei,stormscale,767,shaman,restoration,12,8,4
Magma,kazzak,767,shaman,restoration,12,8,4
Jänis,ragnaros,767,shaman,restoration,12,8,4
Torxii,antonidas,767,shaman,restoration,12,8,4
Iwaa,dalaran,767,shaman,restoration,18,8,10
Juyina,ravencrest,767,shaman,restoration,18,8,10
Aliatës,sanguino,767,shaman,restoration,18,8,10
Nexian,kazzak,767,shaman,restoration,24,8,16
Shamhingo,stormscale,767,shaman,restoration,30,8,22
Джоукх,howling-fjord,766,shaman,restoration,12,8,4
Aldron,tirion,766,shaman,restoration,12,8,4
Kryuxs,blackrock,766,shaman,restoration,12,8,4
Cleansing,nemesis,766,shaman,restoration,12,8,4
Eero,darksorrow,766,shaman,restoration,12,8,4
Санрэйн,soulflayer,765,shaman,restoration,12,8,4
Penetrierer,blackrock,765,shaman,restoration,12,8,4
Xamic,twisting-nether,765,shaman,restoration,18,8,10
Gundersen,stormscale,763,shaman,restoration,18,8,10
Saviothewise,aggra-português,761,shaman,restoration,12,8,4
Rórekk,aegwynn,761,shaman,restoration,18,8,10
Thunderberg,antonidas,746,shaman,restoration,24,8,16
Дарьюша,fordragon,744,shaman,restoration,12,8,4
Xogor,kazzak,720,shaman,restoration,21,8,13
Purgérkíng,silvermoon,713,shaman,restoration,15,9,6
Mltx,twilights-hammer,703,shaman,restoration,14,8,6
Thangog,ragnaros,703,shaman,restoration,16,8,8
Грейсаша,howling-fjord,695,shaman,restoration,22,8,14
Bullfox,aszune,672,shaman,restoration,12,7,5
Тубалкайн,soulflayer,672,shaman,restoration,12,7,5
Awumbahway,outland,672,shaman,restoration,12,7,5
Elmezz,aggra-português,672,shaman,restoration,12,7,5
Madytz,eredar,672,shaman,restoration,12,7,5
Alëxx,hyjal,672,shaman,restoration,12,7,5
Dôppel,archimonde,672,shaman,restoration,12,7,5
Pvegame,tarren-mill,672,shaman,restoration,12,7,5
Pogchampz,nemesis,672,shaman,restoration,12,7,5
Spiirit,tarren-mill,672,shaman,restoration,12,7,5
Arathoir,ravencrest,672,shaman,restoration,12,7,5
Gigawashed,archimonde,672,shaman,restoration,12,7,5
Raintlordx,twisting-nether,672,shaman,restoration,12,7,5
Voodoonerd,twisting-nether,672,shaman,restoration,12,7,5
Rôwdy,kazzak,672,shaman,restoration,12,7,5
Winshear,twisting-nether,672,shaman,restoration,12,7,5
Крэйвхх,howling-fjord,672,shaman,restoration,18,7,11
Jenkem,hyjal,672,shaman,restoration,18,7,11
Viinny,dun-modr,672,shaman,restoration,18,7,11
Barbebiendur,archimonde,672,shaman,restoration,18,7,11
Reticlol,kazzak,672,shaman,restoration,18,7,11
Daykên,kazzak,672,shaman,restoration,18,7,11
Çøynx,aegwynn,672,shaman,restoration,20,7,13
Багсбанних,soulflayer,672,shaman,restoration,24,7,17
Elshimano,ravencrest,671,shaman,restoration,12,7,5
Bufuxx,kazzak,671,shaman,restoration,12,7,5
Megumín,darksorrow,671,shaman,restoration,12,7,5
Oscar,khaz-modan,671,shaman,restoration,12,7,5
Zippidizap,ulduar,671,shaman,restoration,18,7,11
Sdkpwns,draenor,671,shaman,restoration,18,7,11
Shâdôwlîght,antonidas,671,shaman,restoration,18,7,11
Skullføck,argent-dawn,671,shaman,restoration,21,8,13
Shámpain,antonidas,670,shaman,restoration,12,7,5
Woew,tarren-mill,669,shaman,restoration,12,7,5
Лялори,gordunni,669,shaman,restoration,12,7,5
Shacharcaspi,blackmoore,669,shaman,restoration,24,7,17
Millacki,blackrock,667,shaman,restoration,18,7,11
Omeletteoeuf,silvermoon,666,shaman,restoration,12,7,5
Fivezax,tarren-mill,665,shaman,restoration,12,7,5
Bogmagnus,the-maelstrom,659,shaman,restoration,39,13,26
Ayesapik,dalaran,657,shaman,restoration,12,7,5
Nojiko,blackrock,638,shaman,restoration,17,7,10
Иоч,soulflayer,623,shaman,restoration,11,7,4
Disharmony,outland,618,shaman,restoration,12,8,4
Енотикусь,soulflayer,618,shaman,restoration,12,8,4
Hexewar,kazzak,618,shaman,restoration,17,8,9
Randomuwu,stormscale,616,shaman,restoration,22,8,14
Мке,howling-fjord,615,shaman,restoration,29,11,18
Imdarat,hyjal,576,shaman,restoration,6,6,0
Shamiinn,ravencrest,576,shaman,restoration,6,6,0
Oldveteran,eredar,576,shaman,restoration,6,6,0
Snickersx,blackrock,576,shaman,restoration,6,6,0
Tether,twisting-nether,576,shaman,restoration,12,6,6
Rckfeller,burning-legion,576,shaman,restoration,12,6,6
Канамаш,borean-tundra,576,shaman,restoration,12,6,6
Mêrowinger,blackhand,576,shaman,restoration,12,6,6
Sérx,sanguino,576,shaman,restoration,12,6,6
Bigdaddyxo,tarren-mill,576,shaman,restoration,12,6,6
Амальтейх,soulflayer,576,shaman,restoration,12,6,6
Erepmad,ravencrest,576,shaman,restoration,12,6,6
Jodel,tarren-mill,576,shaman,restoration,12,6,6
Ambuu,kazzak,576,shaman,restoration,12,6,6
Kaluna,outland,576,shaman,restoration,12,6,6
Embodiment,blackrock,576,shaman,restoration,12,6,6
Quizx,blackrock,576,shaman,restoration,12,6,6
Draredemolen,archimonde,576,shaman,restoration,12,6,6
Wintradezki,tarren-mill,576,shaman,restoration,12,6,6
Komodski,kazzak,576,shaman,restoration,12,6,6
Enoughh,the-maelstrom,576,shaman,restoration,12,6,6
Monamour,twisting-nether,576,shaman,restoration,12,6,6
Somethingnew,azuremyst,576,shaman,restoration,12,6,6
Runbrorun,hyjal,576,shaman,restoration,12,6,6
Blipster,tarren-mill,576,shaman,restoration,12,6,6
Purgecleave,dalvengyr,576,shaman,restoration,12,6,6
Gromaburst,stormscale,576,shaman,restoration,12,6,6
Гоэл,ashenvale,576,shaman,restoration,12,6,6
Katwio,hyjal,576,shaman,restoration,12,6,6
Goodevening,tarren-mill,576,shaman,restoration,12,6,6
Bordellgast,thrall,576,shaman,restoration,12,6,6
Lmnn,ravencrest,576,shaman,restoration,12,6,6
Khidon,silvermoon,576,shaman,restoration,12,6,6
Dimront,gorgonnash,576,shaman,restoration,12,6,6
Horcsog,ravencrest,576,shaman,restoration,12,6,6
Wibra,nagrand,576,shaman,restoration,12,6,6
Superthomas,archimonde,576,shaman,restoration,23,9,14
Muril,argent-dawn,576,shaman,restoration,18,6,12
Bresidendo,frostwhisper,576,shaman,restoration,18,6,12
Patsham,wildhammer,576,shaman,restoration,18,6,12
Floki,emerald-dream,576,shaman,restoration,18,6,12
Милыйдед,gordunni,576,shaman,restoration,24,6,18
Hyflex,alakir,576,shaman,restoration,24,6,18
Smørbar,kazzak,575,shaman,restoration,6,6,0
Whatsup,aggramar,575,shaman,restoration,12,6,6
Stortvloed,twisting-nether,575,shaman,restoration,12,6,6
Shamnox,blackrock,575,shaman,restoration,12,6,6
Sjearthen,defias-brotherhood,575,shaman,restoration,12,6,6
Crymere,chamber-of-aspects,575,shaman,restoration,12,6,6
Tidushears,thrall,574,shaman,restoration,12,6,6
Shammzy,mannoroth,573,shaman,restoration,18,6,12
Pituu,tarren-mill,573,shaman,restoration,18,6,12
Polystrath,silvermoon,573,shaman,restoration,18,6,12
Greenguard,argent-dawn,540,shaman,restoration,23,6,17
Totemglad,drakthul,528,shaman,restoration,9,7,2
Télapou,ragnaros,527,shaman,restoration,11,6,5
Манрото,soulflayer,526,shaman,restoration,9,6,3
Arigolds,twilights-hammer,511,shaman,restoration,11,6,5
Jakesmistake,stormscale,494,shaman,restoration,11,7,4
Эйвуа,gordunni,486,shaman,restoration,22,8,14
Doubleshamz,the-maelstrom,480,shaman,restoration,6,5,1
Pepegahex,blackmoore,480,shaman,restoration,6,5,1
Djschamihaar,blackrock,480,shaman,restoration,6,5,1
Costakislolz,twisting-nether,480,shaman,restoration,6,5,1
Терату,howling-fjord,480,shaman,restoration,6,5,1
Fernashaman,aggra-português,480,shaman,restoration,6,5,1
Shamsteaks,thrall,480,shaman,restoration,6,5,1
Kuubskii,ravencrest,480,shaman,restoration,6,5,1
Schamfxx,blackrock,480,shaman,restoration,6,5,1
Geneazytwo,silvermoon,480,shaman,restoration,6,5,1
Ub,garona,480,shaman,restoration,6,5,1
Kelvok,silvermoon,480,shaman,restoration,6,5,1
Antikahraman,blackrock,480,shaman,restoration,6,5,1
Holytidezx,aegwynn,480,shaman,restoration,10,6,4
Tooltip,tarren-mill,480,shaman,restoration,12,5,7
Uanl,stormscale,480,shaman,restoration,12,5,7
Eurocad,draenor,480,shaman,restoration,12,5,7
Evííl,tarren-mill,480,shaman,restoration,12,5,7
Maestralink,aegwynn,480,shaman,restoration,12,5,7
Libano,archimonde,480,shaman,restoration,12,5,7
Skrimisher,draenor,480,shaman,restoration,12,5,7
Volwerin,blackhand,480,shaman,restoration,12,5,7
Spaceboy,archimonde,480,shaman,restoration,12,5,7
Totemiclol,aegwynn,480,shaman,restoration,12,5,7
Burrowabuser,nemesis,480,shaman,restoration,12,5,7
Lumière,alonsus,480,shaman,restoration,12,5,7
Nøný,gorgonnash,480,shaman,restoration,12,5,7
Inspektør,kazzak,480,shaman,restoration,12,5,7
Markboymint,earthen-ring,480,shaman,restoration,12,5,7
Évileye,silvermoon,480,shaman,restoration,12,5,7
Lontarsdaddy,twisting-nether,480,shaman,restoration,12,5,7
Cheerz,ravencrest,480,shaman,restoration,12,5,7
Caliqueños,sanguino,480,shaman,restoration,12,5,7
Sørum,grim-batol,480,shaman,restoration,12,5,7
Flandersx,archimonde,480,shaman,restoration,12,5,7
Nevagonalink,archimonde,480,shaman,restoration,12,5,7
Leafplsx,blackrock,480,shaman,restoration,12,5,7
Bandyy,magtheridon,480,shaman,restoration,12,5,7
Bosskwtt,kazzak,480,shaman,restoration,12,5,7
Tigo,tarren-mill,480,shaman,restoration,12,5,7
Unleashme,sylvanas,480,shaman,restoration,12,5,7
Papskalla,ravencrest,480,shaman,restoration,12,5,7
Hakunax,twisting-nether,480,shaman,restoration,12,5,7
Селфлессх,soulflayer,480,shaman,restoration,18,5,13
Bruho,mazrigos,480,shaman,restoration,18,5,13
Nêgan,ravencrest,480,shaman,restoration,22,5,17
Jelincic,ravencrest,480,shaman,restoration,24,5,19
Banilikum,tarren-mill,480,shaman,restoration,24,5,19
Savan,darkspear,480,shaman,restoration,24,5,19
Rawtex,draenor,480,shaman,restoration,26,5,21
Iamnyka,blackrock,479,shaman,restoration,6,5,1
Wayoa,defias-brotherhood,479,shaman,restoration,6,5,1
Ominouslove,twisting-nether,479,shaman,restoration,12,5,7
Рёнтар,howling-fjord,478,shaman,restoration,12,5,7
Altesh,die-todeskrallen,446,shaman,restoration,10,5,5
Xerinas,eredar,432,shaman,restoration,15,6,9
Cømedian,ragnaros,431,shaman,restoration,9,6,3
Suculenta,zuljin,426,shaman,restoration,11,5,6
Shamakerr,tarren-mill,426,shaman,restoration,17,7,10
Äppelpaj,earthen-ring,426,shaman,restoration,15,6,9
Blixtlasse,magtheridon,400,shaman,restoration,13,5,8
Greatørc,tarren-mill,384,shaman,restoration,6,4,2
Pasjeop,ravencrest,384,shaman,restoration,6,4,2
Ruvxy,twisting-nether,384,shaman,restoration,6,4,2
Lingz,auchindoun,384,shaman,restoration,6,4,2
Oldandslow,sylvanas,384,shaman,restoration,6,4,2
Invade,darkspear,384,shaman,restoration,6,4,2
Viallinen,stormreaver,384,shaman,restoration,6,4,2
Kundt,dalaran,384,shaman,restoration,6,4,2
Роджермур,howling-fjord,384,shaman,restoration,6,4,2
Bountiti,dun-modr,384,shaman,restoration,6,4,2
Eras,ragnaros,384,shaman,restoration,6,4,2
Хотдевил,gordunni,384,shaman,restoration,6,4,2
Grimn,burning-legion,384,shaman,restoration,6,4,2
Puffeh,emeriss,384,shaman,restoration,6,4,2
Zhead,aggramar,384,shaman,restoration,6,4,2
Ærthgød,stormscale,384,shaman,restoration,6,4,2
Kekke,uldum,384,shaman,restoration,6,4,2
Stolen,skullcrusher,384,shaman,restoration,6,4,2
Axéron,blackhand,384,shaman,restoration,6,4,2
Prup,tarren-mill,384,shaman,restoration,6,4,2
Berly,stormscale,384,shaman,restoration,6,4,2
Bandulski,twisting-nether,384,shaman,restoration,6,4,2
Soffsittaren,kazzak,384,shaman,restoration,6,4,2
Totembeard,frostmourne,384,shaman,restoration,6,4,2
Pank,kazzak,384,shaman,restoration,6,4,2
Hamuksha,nerathor,384,shaman,restoration,6,4,2
Artîe,archimonde,384,shaman,restoration,6,4,2
Holytidez,aegwynn,384,shaman,restoration,6,4,2
Flùffy,nemesis,384,shaman,restoration,6,4,2
Yozgatlilan,aegwynn,384,shaman,restoration,6,4,2
Thriveqt,nemesis,384,shaman,restoration,6,4,2
Wagaluu,ravencrest,384,shaman,restoration,12,4,8
Энхай,azuregos,384,shaman,restoration,12,4,8
Fünkchn,zuluhed,384,shaman,restoration,12,4,8
Gharn,sanguino,384,shaman,restoration,12,4,8
Saksyl,zuljin,384,shaman,restoration,12,4,8
Bobaléh,ravencrest,384,shaman,restoration,12,4,8
Notwhoheals,executus,384,shaman,restoration,12,4,8
Archsha,burning-legion,384,shaman,restoration,12,4,8
Maluch,burning-legion,384,shaman,restoration,12,4,8
Keén,burning-legion,384,shaman,restoration,12,4,8
Omgodofwar,burning-blade,384,shaman,restoration,12,4,8
Ранняяпташка,soulflayer,384,shaman,restoration,12,4,8
Numbs,tarren-mill,384,shaman,restoration,12,4,8
Naphe,ysondre,384,shaman,restoration,12,4,8
Kerfo,ragnaros,384,shaman,restoration,12,4,8
Roverlos,blackrock,384,shaman,restoration,12,4,8
Lavababe,blackmoore,384,shaman,restoration,12,4,8
Daklickshamy,blackmoore,384,shaman,restoration,12,4,8
Zyphiz,twisting-nether,384,shaman,restoration,12,4,8
Shinds,archimonde,384,shaman,restoration,12,4,8
Kaffekask,stormscale,384,shaman,restoration,12,4,8
Vey,hyjal,384,shaman,restoration,12,4,8
Gards,sylvanas,384,shaman,restoration,18,4,14
Khattla,outland,383,shaman,restoration,6,4,2
Darthshox,outland,383,shaman,restoration,10,5,5
Sleyvarian,chamber-of-aspects,383,shaman,restoration,12,4,8
Fîmbo,defias-brotherhood,383,shaman,restoration,12,4,8
Killhorn,malganis,382,shaman,restoration,6,4,2
Protv,ravencrest,382,shaman,restoration,6,4,2
Slippyjim,azshara,382,shaman,restoration,12,4,8
Xpone,blackrock,380,shaman,restoration,12,4,8
Icytide,kazzak,378,shaman,restoration,18,7,11
Zboubii,archimonde,351,shaman,restoration,11,4,7
Gunhyld,hyjal,335,shaman,restoration,11,4,7
Mycameltotem,ravencrest,330,shaman,restoration,15,5,10
Xoxoxoxoa,twisting-nether,328,shaman,restoration,29,6,23
Zhangliyi,ravencrest,319,shaman,restoration,5,4,1
Murog,dalaran,319,shaman,restoration,8,4,4
Turbohulk,blackrock,304,shaman,restoration,7,4,3
Kilazz,twisting-nether,288,shaman,restoration,6,3,3
Stormfreg,quelthalas,288,shaman,restoration,6,3,3
Nizzarrathur,argent-dawn,288,shaman,restoration,6,3,3
Wealey,drakthul,288,shaman,restoration,6,3,3
Yarali,argent-dawn,288,shaman,restoration,6,3,3
Jilyu,blackmoore,288,shaman,restoration,6,3,3
Majinbeb,hyjal,288,shaman,restoration,6,3,3
Вэллкомм,gordunni,288,shaman,restoration,6,3,3
Prepegahex,blackmoore,288,shaman,restoration,6,3,3
Stibs,silvermoon,288,shaman,restoration,6,3,3
Pépón,dun-modr,288,shaman,restoration,6,3,3
Shànnón,kazzak,288,shaman,restoration,6,3,3
Octon,dun-modr,288,shaman,restoration,6,3,3
Votie,tarren-mill,288,shaman,restoration,6,3,3
Turbokrapka,tarren-mill,288,shaman,restoration,6,3,3
Ravenshock,bloodfeather,288,shaman,restoration,6,3,3
Muddy,argent-dawn,288,shaman,restoration,6,3,3
Horiq,kazzak,288,shaman,restoration,6,3,3
Soulsh,die-ewige-wacht,288,shaman,restoration,6,3,3
Brandbombe,frostwolf,288,shaman,restoration,6,3,3
Tarzh,dalaran,288,shaman,restoration,6,3,3
Shamoobob,archimonde,288,shaman,restoration,6,3,3
Chainbeef,blackmoore,288,shaman,restoration,6,3,3
Bananis,outland,288,shaman,restoration,6,3,3
Cristhor,nemesis,288,shaman,restoration,6,3,3
Ярусскийй,howling-fjord,288,shaman,restoration,6,3,3
Nêmônin,perenolde,288,shaman,restoration,6,3,3
Rndshaman,thrall,288,shaman,restoration,6,3,3
Shèshe,uldaman,288,shaman,restoration,6,3,3
Kataclysm,nemesis,288,shaman,restoration,6,3,3
Outerspace,silvermoon,288,shaman,restoration,6,3,3
Questionable,antonidas,288,shaman,restoration,6,3,3
Richtigfies,kazzak,288,shaman,restoration,6,3,3
Tenror,ragnaros,288,shaman,restoration,6,3,3
Кхуздуфар,blackscar,288,shaman,restoration,6,3,3
Totemboyuk,tarren-mill,288,shaman,restoration,6,3,3
Бриз,blackscar,288,shaman,restoration,6,3,3
Меготип,deathweaver,288,shaman,restoration,6,3,3
Jazzcore,twisting-nether,288,shaman,restoration,6,3,3
Shamamamin,argent-dawn,288,shaman,restoration,6,3,3
Гарантийный,lich-king,288,shaman,restoration,6,3,3
Onkens,ravencrest,288,shaman,restoration,6,3,3
Cøkka,hyjal,288,shaman,restoration,6,3,3
Aeknor,ravencrest,288,shaman,restoration,6,3,3
Abalenn,kazzak,288,shaman,restoration,6,3,3
Grosgourdin,la-croisade-écarlate,288,shaman,restoration,6,3,3
Mestgonee,draenor,288,shaman,restoration,6,3,3
Blboz,grim-batol,288,shaman,restoration,6,3,3
Ханикс,blackscar,288,shaman,restoration,6,3,3
Shamansh,draenor,288,shaman,restoration,6,3,3
Stinkyfînger,draenor,288,shaman,restoration,6,3,3
Henchtotem,draenor,288,shaman,restoration,6,3,3
Bingo,tarren-mill,288,shaman,restoration,6,3,3
Драмкул,soulflayer,288,shaman,restoration,6,3,3
Oldmanrena,stormscale,288,shaman,restoration,6,3,3
Madrävëngodx,ragnaros,288,shaman,restoration,12,3,9
Kandrox,blackmoore,288,shaman,restoration,12,3,9
Flameshock,area-52,288,shaman,restoration,12,3,9
Kuzsham,archimonde,288,shaman,restoration,12,3,9
Volstorm,ysondre,288,shaman,restoration,12,3,9
Aboveaverage,stormscale,288,shaman,restoration,12,3,9
Sorcerus,burning-legion,288,shaman,restoration,12,3,9
Charquanda,argent-dawn,288,shaman,restoration,12,3,9
Nixxy,magtheridon,288,shaman,restoration,12,3,9
Thísisrestø,sanguino,288,shaman,restoration,12,3,9
Feizhousa,outland,288,shaman,restoration,12,3,9
Wtbtoes,ravencrest,288,shaman,restoration,12,3,9
Sakoon,twisting-nether,287,shaman,restoration,6,3,3
Patites,twisting-nether,287,shaman,restoration,6,3,3
Deeblu,nemesis,287,shaman,restoration,12,3,9
Alïsyo,nemesis,287,shaman,restoration,12,3,9
Mwnci,anachronos,287,shaman,restoration,18,3,15
Mimsy,hyjal,285,shaman,restoration,12,3,9
Crazypurgeqt,arathor,255,shaman,restoration,11,3,8
Whibbler,ravencrest,240,shaman,restoration,9,4,5
Elliesham,kazzak,239,shaman,restoration,5,3,2
Tickly,blackhand,239,shaman,restoration,5,3,2
Brigantino,burning-legion,239,shaman,restoration,5,3,2
Yukîmøn,hyjal,234,shaman,restoration,11,4,7
Ikó,kazzak,234,shaman,restoration,22,6,16
Vukroth,argent-dawn,222,shaman,restoration,8,3,5
Khayac,ravencrest,192,shaman,restoration,6,2,4
Mcgrêgor,aegwynn,192,shaman,restoration,6,2,4
Fridafrog,malganis,192,shaman,restoration,6,2,4
Berascendz,argent-dawn,192,shaman,restoration,6,2,4
Kevox,malganis,192,shaman,restoration,6,2,4
Shupp,stormscale,192,shaman,restoration,6,2,4
Nassîî,blackhand,192,shaman,restoration,6,2,4
Wahya,stormscale,192,shaman,restoration,6,2,4
Wåe,outland,192,shaman,restoration,6,2,4
Vickeshaman,stormreaver,192,shaman,restoration,6,2,4
Rheax,tarren-mill,192,shaman,restoration,6,2,4
Jacquisham,archimonde,192,shaman,restoration,6,2,4
Domo,stormscale,192,shaman,restoration,6,2,4
Боргирх,soulflayer,192,shaman,restoration,6,2,4
Palarins,dalaran,192,shaman,restoration,6,2,4
Hímars,ragnaros,192,shaman,restoration,6,2,4
Урахарочка,soulflayer,192,shaman,restoration,6,2,4
Pebble,blackrock,192,shaman,restoration,6,2,4
Tobbey,tarren-mill,192,shaman,restoration,6,2,4
Schmamane,blutkessel,192,shaman,restoration,6,2,4
Renátosz,ragnaros,192,shaman,restoration,6,2,4
Baboss,blutkessel,192,shaman,restoration,6,2,4
Bumbummann,blackmoore,192,shaman,restoration,6,2,4
Thanasiss,kazzak,192,shaman,restoration,6,2,4
Oladoda,archimonde,192,shaman,restoration,6,2,4
Chêlëx,silvermoon,192,shaman,restoration,6,2,4
Lycburst,twisting-nether,192,shaman,restoration,6,2,4
Ðiezz,ysondre,192,shaman,restoration,6,2,4
Raincaller,archimonde,192,shaman,restoration,6,2,4
Lêss,ysondre,192,shaman,restoration,6,2,4
Coöld,archimonde,192,shaman,restoration,6,2,4
Sniipy,blackmoore,192,shaman,restoration,6,2,4
Shazefin,twisting-nether,192,shaman,restoration,6,2,4
Srøgg,archimonde,192,shaman,restoration,6,2,4
Cragouz,archimonde,192,shaman,restoration,6,2,4
Mosterx,stormscale,192,shaman,restoration,6,2,4
Kàji,ravencrest,192,shaman,restoration,6,2,4
Sablolix,ravencrest,192,shaman,restoration,6,2,4
Maybeyes,twisting-nether,192,shaman,restoration,6,2,4
Элементаликс,ashenvale,192,shaman,restoration,6,2,4
Pûrge,tarren-mill,192,shaman,restoration,6,2,4
Shàwyn,sylvanas,192,shaman,restoration,6,2,4
Vyrá,onyxia,192,shaman,restoration,6,2,4
Shamarco,nemesis,192,shaman,restoration,6,2,4
Pumanii,silvermoon,192,shaman,restoration,6,2,4
Liferqt,nemesis,192,shaman,restoration,6,2,4
Soger,mannoroth,192,shaman,restoration,6,2,4
Grende,sylvanas,192,shaman,restoration,6,2,4
Xentic,kazzak,192,shaman,restoration,6,2,4
Aciel,magtheridon,192,shaman,restoration,6,2,4
Vulkan,kirin-tor,192,shaman,restoration,6,2,4
Natasz,burning-legion,192,shaman,restoration,6,2,4
Lexus,nordrassil,192,shaman,restoration,6,2,4
Strikerz,aggra-português,192,shaman,restoration,7,2,5
Mostachin,dun-modr,192,shaman,restoration,10,2,8
Ozzlac,thrall,192,shaman,restoration,12,2,10
Ekxr,kazzak,192,shaman,restoration,12,2,10
Nêôô,blackrock,192,shaman,restoration,12,2,10
Shamanarama,sylvanas,192,shaman,restoration,12,2,10
Killatotem,kazzak,192,shaman,restoration,12,2,10
Cptnkirby,malganis,192,shaman,restoration,12,2,10
Muntark,thrall,192,shaman,restoration,12,2,10
Jøw,dun-modr,191,shaman,restoration,6,2,4
Zenzua,twisting-nether,159,shaman,restoration,5,2,3
Belldandý,archimonde,128,shaman,restoration,4,2,2
Shamaray,stormscale,127,shaman,restoration,8,2,6
Kelshaj,thrall,96,shaman,restoration,3,2,1
Gauss,agamaggan,96,shaman,restoration,6,1,5
Hotstorm,bronzebeard,96,shaman,restoration,6,1,5
Zimzalabling,kazzak,96,shaman,restoration,6,1,5
Таззикшок,soulflayer,96,shaman,restoration,6,1,5
Reflux,outland,96,shaman,restoration,6,1,5
Mystico,sanguino,96,shaman,restoration,6,1,5
Zethh,antonidas,96,shaman,restoration,6,1,5
Zeiger,minahonda,96,shaman,restoration,6,1,5
Kimpa,minahonda,96,shaman,restoration,6,1,5
Jaeslin,tarren-mill,96,shaman,restoration,6,1,5
Diabolous,drakthul,96,shaman,restoration,6,1,5
Magicflames,draenor,96,shaman,restoration,6,1,5
Dälon,thrall,96,shaman,restoration,6,1,5
Dvrg,antonidas,96,shaman,restoration,6,1,5
Greenbo,burning-blade,96,shaman,restoration,6,1,5
Lorthargol,chamber-of-aspects,96,shaman,restoration,6,1,5
Agrok,jaedenar,96,shaman,restoration,6,1,5
Samisu,blackmoore,96,shaman,restoration,6,1,5
Elchivo,blackrock,96,shaman,restoration,6,1,5
Shamgott,silvermoon,96,shaman,restoration,6,1,5
Amnéshaman,ysondre,96,shaman,restoration,6,1,5
Happyjuice,silvermoon,96,shaman,restoration,6,1,5
Rëazx,archimonde,96,shaman,restoration,6,1,5
Фистинктотем,soulflayer,96,shaman,restoration,6,1,5
Porke,moonglade,96,shaman,restoration,6,1,5
Ronell,argent-dawn,96,shaman,restoration,6,1,5
Garulf,twisting-nether,96,shaman,restoration,6,1,5
Picklechris,tarren-mill,96,shaman,restoration,6,1,5
Hikigane,marécage-de-zangar,96,shaman,restoration,6,1,5
Íss,cthun,96,shaman,restoration,12,1,11
Akuha,dun-modr,96,shaman,restoration,12,1,11
Porre,zuljin,96,shaman,restoration,12,1,11
Freeleys,silvermoon,96,shaman,restoration,12,1,11
Tiamât,culte-de-la-rive-noire,96,shaman,restoration,12,1,11
Ikeaboy,eredar,96,shaman,restoration,12,1,11
Goldhand,ravencrest,96,shaman,restoration,12,1,11
Chunkss,argent-dawn,96,shaman,restoration,12,1,11
Penumbrah,kazzak,96,shaman,restoration,20,1,19
Hairball,turalyon,95,shaman,restoration,6,2,4
Twotwozero,defias-brotherhood,95,shaman,restoration,6,1,5
Taiki,sylvanas,90,shaman,restoration,13,4,9
Realiz,ysondre,79,shaman,restoration,5,1,4
Icozy,stormscale,48,shaman,restoration,3,1,2
Bahane,frostwolf,48,shaman,restoration,3,1,2
Icanbreathe,ravencrest,42,shaman,restoration,9,2,7
Shammez,ravencrest,42,shaman,restoration,11,2,9
Gerlo,thrall,41,shaman,restoration,7,2,5
Rungõo,blackrock,2267,shaman,elemental,84,48,36
Proccit,blackrock,2226,shaman,elemental,90,50,40
Lexila,doomhammer,2191,shaman,elemental,173,100,73
Silden,thrall,2157,shaman,elemental,97,55,42
Shamanazor,twisting-nether,2153,shaman,elemental,66,41,25
Lavaole,blackrock,2144,shaman,elemental,72,39,33
Trickful,kazzak,2136,shaman,elemental,60,42,18
Theglue,kilrogg,2124,shaman,elemental,60,36,24
Reibanit,twisting-nether,2089,shaman,elemental,83,46,37
Lavayoshi,kazzak,2086,shaman,elemental,66,47,19
Space,stormscale,2084,shaman,elemental,120,61,59
Маигваза,soulflayer,2067,shaman,elemental,54,37,17
Wisplol,ravencrest,2017,shaman,elemental,65,36,29
Edshearen,stormscale,2004,shaman,elemental,57,34,23
Rngo,blackrock,1992,shaman,elemental,42,27,15
Båkka,ysondre,1966,shaman,elemental,36,26,10
Eyi,ambossar,1955,shaman,elemental,86,46,40
Drshock,blackmoore,1950,shaman,elemental,66,35,31
Satisfya,ambossar,1937,shaman,elemental,53,31,22
Onceinalife,ambossar,1932,shaman,elemental,59,34,25
Shiggenbasta,kazzak,1924,shaman,elemental,54,33,21
Tommybanger,kazzak,1921,shaman,elemental,57,33,24
Eupra,archimonde,1902,shaman,elemental,48,29,19
Punished,blackrock,1901,shaman,elemental,72,41,31
Smorchamp,sanguino,1898,shaman,elemental,60,32,28
Totemlié,ravencrest,1887,shaman,elemental,42,27,15
Baldcreep,blackrock,1885,shaman,elemental,36,22,14
Gungo,deathwing,1880,shaman,elemental,36,20,16
Teslashock,outland,1879,shaman,elemental,30,20,10
Obryss,tarren-mill,1876,shaman,elemental,36,20,16
Kärríegold,blackrock,1850,shaman,elemental,111,59,52
Pipousham,blackhand,1849,shaman,elemental,35,20,15
Crazyshaman,ravencrest,1829,shaman,elemental,53,26,27
Штормкрашер,howling-fjord,1810,shaman,elemental,48,30,18
Chamel,draenor,1808,shaman,elemental,30,19,11
Kailash,defias-brotherhood,1808,shaman,elemental,54,26,28
Thyeori,stormscale,1806,shaman,elemental,36,19,17
Fabslx,archimonde,1806,shaman,elemental,69,31,38
Burstraze,tarren-mill,1801,shaman,elemental,58,32,26
Spajry,drakthul,1800,shaman,elemental,48,32,16
Suldaro,aegwynn,1800,shaman,elemental,55,30,25
Anqe,twisting-nether,1800,shaman,elemental,66,34,32
Psÿkz,kazzak,1790,shaman,elemental,57,25,32
Naorgot,uldaman,1785,shaman,elemental,54,27,27
Volcanò,outland,1778,shaman,elemental,134,66,68
Naskezz,kazzak,1776,shaman,elemental,89,42,47
Novoz,ysondre,1775,shaman,elemental,36,19,17
Chênoya,blackrock,1774,shaman,elemental,55,27,28
Mjorè,twisting-nether,1765,shaman,elemental,55,28,27
Healyoa,blackmoore,1759,shaman,elemental,123,58,65
Eledelede,blackhand,1758,shaman,elemental,42,26,16
Nekhros,sargeras,1751,shaman,elemental,84,44,40
Mcmxcvi,ravencrest,1750,shaman,elemental,36,23,13
Zest,hyjal,1748,shaman,elemental,42,23,19
Blyatifulday,malganis,1736,shaman,elemental,42,22,20
Transcendent,malorne,1734,shaman,elemental,46,41,5
Paulbaniel,alonsus,1734,shaman,elemental,54,26,28
Ryysham,ravencrest,1729,shaman,elemental,57,27,30
Pitsamestari,frostmane,1728,shaman,elemental,80,45,35
Braíntas,norgannon,1727,shaman,elemental,66,31,35
Voydetesto,sanguino,1726,shaman,elemental,54,24,30
Doyah,eredar,1717,shaman,elemental,30,19,11
Starelement,draenor,1716,shaman,elemental,42,18,24
Djlavaburst,malganis,1713,shaman,elemental,143,69,74
Xorron,archimonde,1713,shaman,elemental,72,33,39
Чойсе,deathguard,1711,shaman,elemental,51,26,25
Xtremeshaman,blackmoore,1709,shaman,elemental,24,18,6
Crespó,alakir,1708,shaman,elemental,36,18,18
Kæzx,blackrock,1703,shaman,elemental,36,20,16
Шумноватт,howling-fjord,1700,shaman,elemental,42,19,23
Nalaadu,stormscale,1686,shaman,elemental,30,18,12
Sáàd,ravencrest,1681,shaman,elemental,42,20,22
Tasoro,sanguino,1678,shaman,elemental,41,18,23
Barbarra,stormscale,1673,shaman,elemental,42,22,20
Thorleíf,silvermoon,1668,shaman,elemental,42,24,18
Esal,blackrock,1665,shaman,elemental,31,21,10
Lavatherapy,grim-batol,1664,shaman,elemental,42,25,17
Elektron,malganis,1657,shaman,elemental,42,24,18
Malybou,ysondre,1651,shaman,elemental,36,18,18
Haasshaman,ravencrest,1650,shaman,elemental,43,21,22
Электро,thermaplugg,1648,shaman,elemental,47,24,23
Карбонатрикс,soulflayer,1641,shaman,elemental,30,19,11
Axahavregryn,kazzak,1640,shaman,elemental,66,40,26
Urshak,alleria,1639,shaman,elemental,36,24,12
Zaarok,voljin,1639,shaman,elemental,91,41,50
Dakyele,ravencrest,1636,shaman,elemental,35,20,15
Proccq,twisting-nether,1632,shaman,elemental,34,18,16
Rrtyui,twisting-nether,1628,shaman,elemental,30,17,13
Valgø,twisting-nether,1626,shaman,elemental,58,35,23
Ungabungha,stormscale,1625,shaman,elemental,72,42,30
Agrero,auchindoun,1624,shaman,elemental,30,17,13
Murdá,ravencrest,1624,shaman,elemental,42,20,22
Eppîx,lightnings-blade,1622,shaman,elemental,34,18,16
Suirz,dun-modr,1620,shaman,elemental,36,24,12
Mcbloob,kazzak,1620,shaman,elemental,46,25,21
Matmonai,hyjal,1603,shaman,elemental,42,19,23
Elrayitos,shendralar,1601,shaman,elemental,42,26,16
Regnever,draenor,1596,shaman,elemental,84,30,54
Kemurus,kazzak,1589,shaman,elemental,41,23,18
Ânuk,blackrock,1589,shaman,elemental,120,56,64
Гудлаик,soulflayer,1584,shaman,elemental,58,32,26
Smorclelx,khadgar,1583,shaman,elemental,30,19,11
Alwaysangry,silvermoon,1573,shaman,elemental,36,22,14
Twiva,silvermoon,1572,shaman,elemental,76,45,31
Anøüchkä,ysondre,1572,shaman,elemental,42,21,21
Neotrax,outland,1571,shaman,elemental,60,31,29
Løun,archimonde,1561,shaman,elemental,42,23,19
Harod,suramar,1558,shaman,elemental,66,34,32
Hapkin,defias-brotherhood,1558,shaman,elemental,54,27,27
Deeck,ravencrest,1557,shaman,elemental,60,38,22
Nykhara,sanguino,1554,shaman,elemental,30,17,13
Aviciix,sanguino,1547,shaman,elemental,68,26,42
Brugdar,tarren-mill,1544,shaman,elemental,24,19,5
Sniffix,ysondre,1538,shaman,elemental,85,43,42
Rungozvs,blackrock,1535,shaman,elemental,24,16,8
Batan,kazzak,1535,shaman,elemental,71,31,40
Connecting,hyjal,1534,shaman,elemental,30,16,14
Essneces,burning-legion,1523,shaman,elemental,36,18,18
Jímmy,frostwhisper,1520,shaman,elemental,36,24,12
Blízzilassø,malygos,1518,shaman,elemental,161,82,79
Valunii,lordaeron,1517,shaman,elemental,94,42,52
Mariomental,draenor,1517,shaman,elemental,36,16,20
Mezzoblu,sanguino,1508,shaman,elemental,49,23,26
Máui,korgall,1506,shaman,elemental,42,21,21
Ralokar,blackrock,1505,shaman,elemental,42,23,19
Милфшама,blackscar,1505,shaman,elemental,35,17,18
Borbor,argent-dawn,1496,shaman,elemental,34,16,18
Касикандрэра,soulflayer,1491,shaman,elemental,66,38,28
Хэйзл,ashenvale,1490,shaman,elemental,44,25,19
Robofat,ravencrest,1490,shaman,elemental,30,17,13
Zna,archimonde,1474,shaman,elemental,52,25,27
Дестройбэйби,gordunni,1469,shaman,elemental,54,32,22
Lafia,blackrock,1463,shaman,elemental,42,16,26
Athul,theradras,1456,shaman,elemental,43,23,20
Kirak,anetheron,1455,shaman,elemental,72,40,32
Томёрк,gordunni,1448,shaman,elemental,118,55,63
Mèåtbåll,ravencrest,1439,shaman,elemental,18,15,3
Baarona,neptulon,1434,shaman,elemental,27,17,10
Skrbkic,tarren-mill,1429,shaman,elemental,91,48,43
Cracklord,outland,1427,shaman,elemental,30,17,13
Тыщатристах,howling-fjord,1426,shaman,elemental,36,25,11
Fúth,ysondre,1420,shaman,elemental,34,17,17
Alèks,forscherliga,1415,shaman,elemental,56,36,20
Reignisover,silvermoon,1415,shaman,elemental,33,17,16
Pórçé,shattered-hand,1410,shaman,elemental,42,24,18
Waaghbozz,eredar,1406,shaman,elemental,30,16,14
Flubberman,blackrock,1402,shaman,elemental,33,18,15
Olawizard,draenor,1401,shaman,elemental,43,22,21
Rohknar,ragnaros,1374,shaman,elemental,30,17,13
Kimpa,minahonda,1373,shaman,elemental,66,37,29
Chøurøx,hyjal,1358,shaman,elemental,37,21,16
Canjo,aegwynn,1350,shaman,elemental,36,15,21
Onlyfansmod,uldum,1349,shaman,elemental,36,16,20
Tempest,kul-tiras,1346,shaman,elemental,41,23,18
Doneteasy,blackrock,1344,shaman,elemental,40,19,21
Tâsty,blackmoore,1343,shaman,elemental,24,14,10
Jelvin,tarren-mill,1343,shaman,elemental,24,14,10
Raintlordx,twisting-nether,1342,shaman,elemental,18,14,4
Херург,soulflayer,1342,shaman,elemental,30,14,16
Флоррэт,gordunni,1340,shaman,elemental,78,33,45
Sshaasam,tarren-mill,1337,shaman,elemental,24,14,10
Xesti,twisting-nether,1337,shaman,elemental,54,26,28
Totemlyhot,blackrock,1333,shaman,elemental,24,14,10
Гексанол,soulflayer,1332,shaman,elemental,34,16,18
Screwz,archimonde,1327,shaman,elemental,44,21,23
Microb,blackmoore,1326,shaman,elemental,30,14,16
Vulcainn,marécage-de-zangar,1324,shaman,elemental,77,49,28
Bâllz,anetheron,1314,shaman,elemental,54,23,31
Amanishama,twisting-nether,1313,shaman,elemental,42,21,21
Lavamann,blackmoore,1313,shaman,elemental,36,18,18
Uselesslaso,sanguino,1310,shaman,elemental,29,14,15
Prêxy,kazzak,1307,shaman,elemental,35,14,21
Elshifotrem,throkferoth,1282,shaman,elemental,52,28,24
Xfiles,garona,1278,shaman,elemental,48,24,24
Pawsh,dun-modr,1273,shaman,elemental,33,17,16
Bigboisham,outland,1260,shaman,elemental,59,27,32
Blackyx,dun-modr,1247,shaman,elemental,18,13,5
Dretch,dun-morogh,1247,shaman,elemental,24,13,11
Starpior,stormscale,1246,shaman,elemental,33,14,19
Shibol,ravencrest,1246,shaman,elemental,34,14,20
Pxsquals,ravencrest,1245,shaman,elemental,24,13,11
Quizx,blackrock,1245,shaman,elemental,60,25,35
Kohnân,hyjal,1244,shaman,elemental,24,13,11
Gagné,hyjal,1239,shaman,elemental,24,13,11
Makgoa,ysondre,1237,shaman,elemental,18,13,5
Couldar,stormscale,1236,shaman,elemental,18,13,5
Sunsong,twisting-nether,1234,shaman,elemental,30,13,17
Bigheal,quelthalas,1222,shaman,elemental,30,13,17
Waterboi,blackmoore,1219,shaman,elemental,24,13,11
Сосмыслом,howling-fjord,1217,shaman,elemental,30,13,17
Maggoshishi,blackmoore,1214,shaman,elemental,66,34,32
Rekhtar,burning-legion,1201,shaman,elemental,56,29,27
Märthalouise,twisting-nether,1191,shaman,elemental,29,15,14
Scurvy,malganis,1185,shaman,elemental,57,31,26
Lechirurgien,elune,1184,shaman,elemental,74,39,35
Тессельхоф,howling-fjord,1179,shaman,elemental,22,13,9
Superkee,kazzak,1169,shaman,elemental,53,28,25
Фистинктотем,soulflayer,1162,shaman,elemental,35,16,19
Велгур,soulflayer,1161,shaman,elemental,50,23,27
Azmerloth,outland,1152,shaman,elemental,18,12,6
Neverplayele,kazzak,1151,shaman,elemental,24,12,12
Feetenjoyerx,kazzak,1151,shaman,elemental,24,12,12
Dräpàrn,sylvanas,1151,shaman,elemental,24,12,12
Kapïtão,aggra-português,1150,shaman,elemental,18,12,6
Мэморисс,gordunni,1149,shaman,elemental,24,12,12
Justweirdaf,blackmoore,1148,shaman,elemental,45,20,25
Diaba,sylvanas,1146,shaman,elemental,24,12,12
Dzielnysham,silvermoon,1145,shaman,elemental,21,13,8
Headthirst,ragnaros,1145,shaman,elemental,24,12,12
Goromar,kirin-tor,1144,shaman,elemental,54,22,32
Hemradi,blackmoore,1141,shaman,elemental,18,12,6
Carusø,thrall,1139,shaman,elemental,27,15,12
Boxo,frostwolf,1137,shaman,elemental,70,38,32
Djent,outland,1133,shaman,elemental,24,12,12
Bowtenstorm,ravencrest,1120,shaman,elemental,25,16,9
Farùk,ravencrest,1102,shaman,elemental,21,13,8
Earthtjockis,ragnaros,1087,shaman,elemental,17,12,5
Élé,twisting-nether,1056,shaman,elemental,18,11,7
Bärtigeberta,aegwynn,1056,shaman,elemental,18,11,7
Houmpf,hyjal,1056,shaman,elemental,18,11,7
Pheazka,outland,1056,shaman,elemental,18,11,7
Matmons,hyjal,1056,shaman,elemental,24,11,13
Ласара,eversong,1054,shaman,elemental,24,11,13
Èrò,blackhand,1053,shaman,elemental,24,11,13
Monstermunch,ravencrest,1053,shaman,elemental,30,11,19
Manaphi,arthas,1052,shaman,elemental,24,11,13
Louler,ragnaros,1049,shaman,elemental,24,11,13
Magnetoe,ravencrest,1049,shaman,elemental,24,11,13
Dropdattotem,stormscale,1049,shaman,elemental,24,11,13
Kylas,die-ewige-wacht,1047,shaman,elemental,18,11,7
Ormanthep,hyjal,1029,shaman,elemental,18,11,7
Flochy,argent-dawn,1027,shaman,elemental,53,31,22
Магмарончик,gordunni,980,shaman,elemental,36,11,25
Shrmful,dun-modr,960,shaman,elemental,12,10,2
Дашажмихекс,howling-fjord,960,shaman,elemental,12,10,2
Nëllaqt,archimonde,960,shaman,elemental,18,10,8
Haumx,blackrock,960,shaman,elemental,24,10,14
Smashz,stormscale,959,shaman,elemental,18,10,8
Aspên,archimonde,959,shaman,elemental,18,10,8
Stickix,malganis,959,shaman,elemental,18,10,8
Incredibade,stormscale,958,shaman,elemental,18,10,8
Atuaßëlha,grim-batol,957,shaman,elemental,24,10,14
Obesisham,outland,943,shaman,elemental,30,11,19
Smorcxx,kazzak,934,shaman,elemental,30,10,20
Orishimaru,blackrock,932,shaman,elemental,23,10,13
Ximid,doomhammer,922,shaman,elemental,47,19,28
Соленый,booty-bay,883,shaman,elemental,81,36,45
Bambustic,kazzak,864,shaman,elemental,12,9,3
ßaraky,kazzak,864,shaman,elemental,12,9,3
Plazmorc,stormscale,864,shaman,elemental,12,9,3
Elegodx,ravencrest,864,shaman,elemental,12,9,3
Blackyx,cthun,864,shaman,elemental,12,9,3
Хеллбат,howling-fjord,864,shaman,elemental,18,9,9
Elvalya,archimonde,864,shaman,elemental,18,9,9
Jøhnwick,ysondre,864,shaman,elemental,18,9,9
Nevershearx,blackrock,864,shaman,elemental,18,9,9
Raknoxye,blackrock,863,shaman,elemental,12,9,3
Johncoltrane,archimonde,863,shaman,elemental,12,9,3
Гивми,blackscar,863,shaman,elemental,16,10,6
Drainergødx,ragnaros,863,shaman,elemental,18,9,9
Smort,frostwolf,863,shaman,elemental,18,9,9
Мистеркутёж,gordunni,863,shaman,elemental,18,9,9
Думсия,gordunni,863,shaman,elemental,18,9,9
Torouk,rashgarroth,862,shaman,elemental,18,9,9
Рэйвантотем,soulflayer,862,shaman,elemental,18,9,9
Bunnz,kazzak,861,shaman,elemental,12,9,3
Rakzhaza,blackmoore,860,shaman,elemental,18,9,9
Штормбайт,azuregos,858,shaman,elemental,12,9,3
Magath,nethersturm,857,shaman,elemental,18,9,9
Tiamât,culte-de-la-rive-noire,835,shaman,elemental,30,9,21
Holdafstand,tarren-mill,798,shaman,elemental,14,9,5
Guzzelinare,tarren-mill,768,shaman,elemental,12,8,4
Visboer,stormscale,768,shaman,elemental,12,8,4
Dumpaman,frostmane,768,shaman,elemental,12,8,4
Òoòoòoòoòoòo,silvermoon,768,shaman,elemental,18,8,10
Adamyo,stormscale,768,shaman,elemental,18,8,10
Naphe,ysondre,768,shaman,elemental,18,8,10
Thorunir,sylvanas,768,shaman,elemental,24,8,16
Ædshearan,blackmoore,767,shaman,elemental,12,8,4
Nachtary,blackmoore,767,shaman,elemental,12,8,4
Yang,der-rat-von-dalaran,767,shaman,elemental,12,8,4
Skeiilz,hyjal,767,shaman,elemental,12,8,4
Shaakez,kazzak,767,shaman,elemental,18,8,10
Elevlach,drakthul,767,shaman,elemental,24,8,16
Totempoo,the-maelstrom,766,shaman,elemental,12,8,4
Parthon,ravencrest,765,shaman,elemental,12,8,4
Noyá,argent-dawn,764,shaman,elemental,18,8,10
Itsnasty,blackmoore,753,shaman,elemental,18,8,10
Эфирад,blackscar,708,shaman,elemental,20,9,11
Кирагаз,gordunni,703,shaman,elemental,11,8,3
Replicusele,doomhammer,672,shaman,elemental,12,7,5
Ðãvê,veknilash,672,shaman,elemental,12,7,5
Koífish,ravencrest,672,shaman,elemental,12,7,5
Hothand,thrall,672,shaman,elemental,12,7,5
Dòrfy,silvermoon,672,shaman,elemental,12,7,5
Thordes,forscherliga,672,shaman,elemental,12,7,5
Jehae,archimonde,672,shaman,elemental,12,7,5
Reburdacoxis,sanguino,672,shaman,elemental,12,7,5
Eðualc,hyjal,672,shaman,elemental,12,7,5
Kæde,dun-morogh,672,shaman,elemental,12,7,5
Shamandoino,wildhammer,672,shaman,elemental,12,7,5
Bosslikex,ravencrest,672,shaman,elemental,12,7,5
Гарбаджи,galakrond,672,shaman,elemental,12,7,5
Horizons,the-maelstrom,672,shaman,elemental,12,7,5
Støya,archimonde,672,shaman,elemental,18,7,11
Endry,elune,672,shaman,elemental,18,7,11
Thriveqt,nemesis,672,shaman,elemental,24,7,17
Hotis,onyxia,672,shaman,elemental,24,7,17
Fâro,dun-modr,671,shaman,elemental,12,7,5
Lêmberger,eredar,671,shaman,elemental,12,7,5
Griins,ravencrest,670,shaman,elemental,12,7,5
Hugzy,argent-dawn,665,shaman,elemental,12,7,5
Watson,conseil-des-ombres,660,shaman,elemental,18,7,11
Федосик,galakrond,658,shaman,elemental,18,7,11
Alfang,turalyon,638,shaman,elemental,23,7,16
Айвимэдисон,howling-fjord,623,shaman,elemental,17,7,10
Zanyun,burning-legion,607,shaman,elemental,14,7,7
Jåime,ravencrest,576,shaman,elemental,6,6,0
Trastamar,dun-modr,576,shaman,elemental,6,6,0
Lavalava,blackmoore,576,shaman,elemental,12,6,6
Simppe,stormreaver,576,shaman,elemental,12,6,6
Веег,deathweaver,576,shaman,elemental,12,6,6
Windfúhrèr,tarren-mill,576,shaman,elemental,12,6,6
Cïgänää,archimonde,576,shaman,elemental,12,6,6
Fullavaids,grim-batol,576,shaman,elemental,12,6,6
Bigrambo,draenor,576,shaman,elemental,12,6,6
Дзод,deathweaver,576,shaman,elemental,12,6,6
Nokster,twisting-nether,576,shaman,elemental,12,6,6
Forrak,argent-dawn,576,shaman,elemental,12,6,6
Woof,culte-de-la-rive-noire,576,shaman,elemental,12,6,6
Localicious,ragnaros,576,shaman,elemental,12,6,6
Xelphia,frostmane,576,shaman,elemental,12,6,6
Totemkahmun,kazzak,576,shaman,elemental,12,6,6
Dsgrc,tarren-mill,576,shaman,elemental,18,6,12
Unding,azshara,576,shaman,elemental,24,6,18
Sunraiser,blackmoore,575,shaman,elemental,12,6,6
Layonne,ysondre,575,shaman,elemental,12,6,6
Syndia,das-konsortium,575,shaman,elemental,12,6,6
Isheartears,outland,543,shaman,elemental,11,6,5
Hanatopikeur,grim-batol,527,shaman,elemental,17,6,11
Turbokrapka,tarren-mill,522,shaman,elemental,17,8,9
Bumstead,ragnaros,480,shaman,elemental,6,5,1
Efdemin,blackmoore,480,shaman,elemental,6,5,1
Grambozz,blackrock,480,shaman,elemental,6,5,1
Эртирон,howling-fjord,480,shaman,elemental,6,5,1
Shocknrun,sylvanas,480,shaman,elemental,6,5,1
Тандерхх,howling-fjord,480,shaman,elemental,6,5,1
Смоуктли,howling-fjord,480,shaman,elemental,6,5,1
Phobiatics,thrall,480,shaman,elemental,6,5,1
Navyblue,sylvanas,480,shaman,elemental,6,5,1
Minimalist,stormscale,480,shaman,elemental,6,5,1
Muscade,silvermoon,480,shaman,elemental,6,5,1
Hexina,ragnaros,480,shaman,elemental,6,5,1
Rhonix,blackmoore,480,shaman,elemental,6,5,1
Zoomar,tarren-mill,480,shaman,elemental,6,5,1
Autopanne,malganis,480,shaman,elemental,6,5,1
Lovelyshaman,silvermoon,480,shaman,elemental,7,5,2
Khalamity,ravencrest,480,shaman,elemental,9,6,3
Xereús,kazzak,480,shaman,elemental,10,6,4
Ejx,arthas,480,shaman,elemental,10,6,4
Дваллинн,gordunni,480,shaman,elemental,12,5,7
Velkin,thrall,480,shaman,elemental,12,5,7
Swapxy,outland,480,shaman,elemental,12,5,7
Loshohealva,stormscale,480,shaman,elemental,12,5,7
Kelvok,silvermoon,480,shaman,elemental,12,5,7
Skullføck,argent-dawn,480,shaman,elemental,12,5,7
Élémentyum,archimonde,480,shaman,elemental,12,5,7
Matmodir,hyjal,480,shaman,elemental,12,5,7
Shkook,archimonde,480,shaman,elemental,12,5,7
Ulfax,argent-dawn,480,shaman,elemental,18,5,13
Aldonatello,blackrock,479,shaman,elemental,12,5,7
Sinwithin,ravencrest,478,shaman,elemental,12,5,7
Aslakki,turalyon,478,shaman,elemental,30,5,25
Novka,eredar,447,shaman,elemental,11,5,6
Jâydizzle,draenor,431,shaman,elemental,17,5,12
Disharmony,outland,426,shaman,elemental,13,6,7
Lianitus,tarren-mill,416,shaman,elemental,16,5,11
Blùé,tarren-mill,399,shaman,elemental,5,5,0
Ezala,blackhand,384,shaman,elemental,6,4,2
Kévinn,draenor,384,shaman,elemental,6,4,2
Trustlemac,onyxia,384,shaman,elemental,6,4,2
Daemp,draenor,384,shaman,elemental,6,4,2
Kraksham,ravencrest,384,shaman,elemental,6,4,2
Schamîx,blackrock,384,shaman,elemental,6,4,2
Trixxsham,twisting-nether,384,shaman,elemental,6,4,2
Thëtis,chogall,384,shaman,elemental,6,4,2
Dócshock,blackmoore,384,shaman,elemental,6,4,2
Føxï,pozzo-delleternità,384,shaman,elemental,6,4,2
Bkdgoodz,aegwynn,384,shaman,elemental,6,4,2
Sojee,ysondre,384,shaman,elemental,6,4,2
Ruvxy,twisting-nether,384,shaman,elemental,6,4,2
Sebubu,twisting-nether,384,shaman,elemental,6,4,2
Selonthyx,ravencrest,384,shaman,elemental,6,4,2
Ehlaina,outland,384,shaman,elemental,6,4,2
Jacklupin,ravencrest,384,shaman,elemental,6,4,2
Voymir,kazzak,384,shaman,elemental,6,4,2
Shamurky,kazzak,384,shaman,elemental,6,4,2
Ludo,lothar,384,shaman,elemental,6,4,2
Voltyum,zuljin,384,shaman,elemental,6,4,2
Шоу,gordunni,384,shaman,elemental,6,4,2
Hobblefoot,stormscale,384,shaman,elemental,6,4,2
Alëxx,hyjal,384,shaman,elemental,6,4,2
Shafallen,tarren-mill,384,shaman,elemental,6,4,2
Klicken,tarren-mill,384,shaman,elemental,6,4,2
Whizjy,sanguino,384,shaman,elemental,6,4,2
Nyed,hyjal,384,shaman,elemental,6,4,2
Hí,bronzebeard,384,shaman,elemental,12,4,8
Eskìmo,malganis,384,shaman,elemental,12,4,8
Setac,stormscale,384,shaman,elemental,12,4,8
Snusy,stormscale,384,shaman,elemental,12,4,8
Goitbate,azuremyst,384,shaman,elemental,12,4,8
Ххенеси,soulflayer,384,shaman,elemental,12,4,8
Belsazar,frostwolf,384,shaman,elemental,12,4,8
Вензеро,howling-fjord,384,shaman,elemental,12,4,8
Réläx,kazzak,384,shaman,elemental,12,4,8
Апинсмок,soulflayer,384,shaman,elemental,12,4,8
Zengã,kazzak,384,shaman,elemental,12,4,8
Zokah,emeriss,383,shaman,elemental,6,4,2
Kennyo,uldum,379,shaman,elemental,12,4,8
Незнаком,booty-bay,379,shaman,elemental,12,4,8
Wacomtablet,kazzak,319,shaman,elemental,5,4,1
Easyplay,kazzak,319,shaman,elemental,8,4,4
Ankzul,exodar,319,shaman,elemental,14,4,10
Наладчик,gordunni,288,shaman,elemental,6,3,3
Symy,draenor,288,shaman,elemental,6,3,3
Lunarsloth,hyjal,288,shaman,elemental,6,3,3
Wàve,stormscale,288,shaman,elemental,6,3,3
Kärdyo,archimonde,288,shaman,elemental,6,3,3
Solosüper,ravencrest,288,shaman,elemental,6,3,3
Nobrac,rajaxx,288,shaman,elemental,6,3,3
Dagra,twisting-nether,288,shaman,elemental,6,3,3
Крто,thermaplugg,288,shaman,elemental,6,3,3
Shamanmans,grim-batol,288,shaman,elemental,6,3,3
Blyátmán,twisting-nether,288,shaman,elemental,6,3,3
Рокутаро,gordunni,288,shaman,elemental,6,3,3
Teccatwo,outland,288,shaman,elemental,6,3,3
Сепич,gordunni,288,shaman,elemental,6,3,3
Shoewalker,ragnaros,288,shaman,elemental,6,3,3
Qenninka,drakthul,288,shaman,elemental,6,3,3
Ангустиа,galakrond,288,shaman,elemental,6,3,3
Jeelypink,dalaran,288,shaman,elemental,6,3,3
Amu,ravencrest,288,shaman,elemental,6,3,3
Gissary,drakthul,288,shaman,elemental,6,3,3
Davinshhe,kazzak,288,shaman,elemental,6,3,3
Реалайзер,blackscar,288,shaman,elemental,6,3,3
Spruehkot,aegwynn,288,shaman,elemental,6,3,3
Nerdshockz,blackhand,288,shaman,elemental,6,3,3
Родохрозид,blackscar,288,shaman,elemental,6,3,3
Ghostwolfgg,archimonde,288,shaman,elemental,6,3,3
Brandbombe,frostwolf,288,shaman,elemental,6,3,3
Joeyexe,outland,288,shaman,elemental,6,3,3
Vukroth,argent-dawn,288,shaman,elemental,6,3,3
Kónjo,kazzak,288,shaman,elemental,6,3,3
Rolftheswine,defias-brotherhood,288,shaman,elemental,6,3,3
Hethne,kazzak,288,shaman,elemental,6,3,3
Volvíc,tichondrius,288,shaman,elemental,6,3,3
Херургх,soulflayer,288,shaman,elemental,6,3,3
Khaleeya,blackmoore,288,shaman,elemental,6,3,3
Firella,the-maelstrom,288,shaman,elemental,6,3,3
Энхай,azuregos,288,shaman,elemental,6,3,3
Ironbuttrfly,magtheridon,288,shaman,elemental,6,3,3
Дудивтф,soulflayer,288,shaman,elemental,6,3,3
Fufupartyxx,blackrock,288,shaman,elemental,6,3,3
Санрэйн,soulflayer,288,shaman,elemental,6,3,3
Bhargonen,silvermoon,288,shaman,elemental,6,3,3
Hotstorm,bronzebeard,288,shaman,elemental,6,3,3
Rottulos,stormrage,288,shaman,elemental,6,3,3
Nightingäle,silvermoon,288,shaman,elemental,6,3,3
Gammeldunder,shattered-hand,288,shaman,elemental,12,3,9
Samlik,antonidas,288,shaman,elemental,12,3,9
Jaeslin,tarren-mill,288,shaman,elemental,12,3,9
Naix,silvermoon,288,shaman,elemental,12,3,9
Megaherz,sanguino,287,shaman,elemental,6,3,3
Twotwozero,defias-brotherhood,286,shaman,elemental,6,3,3
Вещун,deathguard,284,shaman,elemental,12,3,9
Naturexz,silvermoon,234,shaman,elemental,8,4,4
Stíckíx,malganis,192,shaman,elemental,4,3,1
Krahg,garona,192,shaman,elemental,4,3,1
Cloovster,magtheridon,192,shaman,elemental,6,2,4
Драгенхз,gordunni,192,shaman,elemental,6,2,4
Ratatakéas,archimonde,192,shaman,elemental,6,2,4
Ahrim,argent-dawn,192,shaman,elemental,6,2,4
Nuvet,argent-dawn,192,shaman,elemental,6,2,4
Shàmeonyou,dun-morogh,192,shaman,elemental,6,2,4
Renegad,archimonde,192,shaman,elemental,6,2,4
Zackyboi,tarren-mill,192,shaman,elemental,6,2,4
Zinlay,tarren-mill,192,shaman,elemental,6,2,4
Nuekx,sanguino,192,shaman,elemental,6,2,4
Rakermän,dun-modr,192,shaman,elemental,6,2,4
Fuzzbolt,silvermoon,192,shaman,elemental,6,2,4
Dormido,sanguino,192,shaman,elemental,6,2,4
Thornyberrý,outland,192,shaman,elemental,6,2,4
Macetoyaface,darksorrow,192,shaman,elemental,6,2,4
Albatroz,the-maelstrom,192,shaman,elemental,6,2,4
Attm,twisting-nether,192,shaman,elemental,6,2,4
Windspêaker,outland,192,shaman,elemental,6,2,4
Ishkadar,twisting-nether,192,shaman,elemental,6,2,4
Blancc,kazzak,192,shaman,elemental,6,2,4
Шаеман,soulflayer,192,shaman,elemental,6,2,4
Nnekalol,twisting-nether,192,shaman,elemental,6,2,4
Шлолка,gordunni,192,shaman,elemental,6,2,4
Rezervoir,bladefist,192,shaman,elemental,6,2,4
Дагод,booty-bay,192,shaman,elemental,6,2,4
Huyø,stormscale,192,shaman,elemental,6,2,4
Ìløvêxÿú,ravencrest,192,shaman,elemental,6,2,4
Sgf,stormscale,192,shaman,elemental,6,2,4
Präsi,die-aldor,192,shaman,elemental,6,2,4
Bluéshirtguy,blackhand,192,shaman,elemental,6,2,4
Zbysiu,ravencrest,192,shaman,elemental,6,2,4
Squixi,ravencrest,192,shaman,elemental,6,2,4
Cleandann,stormscale,192,shaman,elemental,6,2,4
Shockbestie,eredar,192,shaman,elemental,7,2,5
Sweetcåndy,stormscale,192,shaman,elemental,12,2,10
Ærö,outland,192,shaman,elemental,12,2,10
Nakenfeigy,stormreaver,192,shaman,elemental,12,2,10
Виспепешам,gordunni,192,shaman,elemental,12,2,10
Jazzrod,stormscale,192,shaman,elemental,12,2,10
Lycburst,twisting-nether,192,shaman,elemental,12,2,10
Максобман,howling-fjord,192,shaman,elemental,12,2,10
Zíp,archimonde,192,shaman,elemental,12,2,10
Thunderstryk,sylvanas,191,shaman,elemental,6,2,4
Aspirio,ravencrest,175,shaman,elemental,11,2,9
Lavaburstx,antonidas,138,shaman,elemental,10,3,7
Fàkecast,outland,128,shaman,elemental,4,2,2
Bram,aggra-português,96,shaman,elemental,3,2,1
Fattmorte,hyjal,96,shaman,elemental,3,2,1
Nopivøt,hyjal,96,shaman,elemental,7,2,5
Champïx,archimonde,96,shaman,elemental,9,2,7
Сентес,soulflayer,96,shaman,elemental,6,1,5
Hästdvärg,the-maelstrom,96,shaman,elemental,6,1,5
Depucova,silvermoon,96,shaman,elemental,6,1,5
Bonestompamc,blackmoore,96,shaman,elemental,6,1,5
Vodoochild,hyjal,96,shaman,elemental,6,1,5
Fatflop,sylvanas,96,shaman,elemental,6,1,5
Shamsteaks,ysera,96,shaman,elemental,6,1,5
Sayokô,grim-batol,96,shaman,elemental,6,1,5
Freexx,aegwynn,96,shaman,elemental,6,1,5
Rawside,thrall,96,shaman,elemental,6,1,5
Izir,archimonde,96,shaman,elemental,6,1,5
Ânne,blackrock,96,shaman,elemental,6,1,5
Pomegranate,arthas,96,shaman,elemental,6,1,5
Woolysocks,draenor,96,shaman,elemental,6,1,5
Magicmekoz,draenor,96,shaman,elemental,6,1,5
Magmamartin,antonidas,96,shaman,elemental,6,1,5
Альтегро,blackscar,96,shaman,elemental,6,1,5
Пэппивкашке,howling-fjord,96,shaman,elemental,6,1,5
Shamira,nethersturm,96,shaman,elemental,6,1,5
Shaminista,ravencrest,96,shaman,elemental,6,1,5
Heheheyup,ravencrest,96,shaman,elemental,6,1,5
Takkenuma,hyjal,96,shaman,elemental,6,1,5
Kyst,elune,95,shaman,elemental,6,1,5
Torepåsporet,deathwing,79,shaman,elemental,5,1,4
Zarakuda,magtheridon,42,shaman,elemental,10,2,8
Snusyy,ravencrest,31,shaman,elemental,2,1,1
Memourian,drakthul,16,shaman,elemental,7,1,6
Mûnch,kazzak,2369,shaman,enhancement,104,69,35
Крааули,soulflayer,2270,shaman,enhancement,204,106,98
Axdn,ravencrest,2229,shaman,enhancement,80,47,33
Bredare,ravencrest,2209,shaman,enhancement,70,60,10
Дудивтф,soulflayer,2177,shaman,enhancement,87,51,36
Myguns,silvermoon,2164,shaman,enhancement,78,47,31
Avines,twisting-nether,2156,shaman,enhancement,158,80,78
Fatpig,stormscale,2143,shaman,enhancement,71,38,33
Sillaas,ysondre,2131,shaman,enhancement,102,50,52
Shïnnkøk,stormscale,2130,shaman,enhancement,72,43,29
Fckumen,blackmoore,2124,shaman,enhancement,106,61,45
Shadi,stormscale,2119,shaman,enhancement,84,44,40
Strippzz,stormscale,2116,shaman,enhancement,78,46,32
Sparkyxd,twisting-nether,2102,shaman,enhancement,78,40,38
Ruffepuffe,twisting-nether,2096,shaman,enhancement,150,85,65
Baconbazooka,tarren-mill,2089,shaman,enhancement,95,55,40
Trulylove,tarren-mill,2085,shaman,enhancement,66,34,32
Smorcshamyy,kazzak,2084,shaman,enhancement,66,39,27
Karpsham,stormscale,2069,shaman,enhancement,73,38,35
Читорра,gordunni,2062,shaman,enhancement,66,37,29
Maelstrom,eredar,2035,shaman,enhancement,240,134,106
Milheroj,tarren-mill,1999,shaman,enhancement,69,41,28
Yüri,stormscale,1994,shaman,enhancement,163,81,82
Joeyexe,outland,1985,shaman,enhancement,61,34,27
Viablous,ravencrest,1984,shaman,enhancement,119,82,37
Shïnnøk,stormscale,1984,shaman,enhancement,193,99,94
Инсэйнгод,soulflayer,1983,shaman,enhancement,63,32,31
Тандерстарк,howling-fjord,1956,shaman,enhancement,66,40,26
Shadiqt,stormscale,1942,shaman,enhancement,60,31,29
Plsdontpress,stormscale,1929,shaman,enhancement,79,46,33
Panzarkamp,stormscale,1894,shaman,enhancement,95,58,37
Gottiy,blackhand,1893,shaman,enhancement,102,50,52
Бафамет,blackscar,1890,shaman,enhancement,36,20,16
Turbostruck,ravencrest,1886,shaman,enhancement,66,27,39
Rabalalaha,twisting-nether,1885,shaman,enhancement,128,72,56
Вацунвец,goldrinn,1883,shaman,enhancement,98,54,44
Xa,blackrock,1882,shaman,enhancement,30,20,10
Morguk,zuljin,1880,shaman,enhancement,67,39,28
Azifox,hyjal,1872,shaman,enhancement,48,25,23
Hermerejildo,stormscale,1872,shaman,enhancement,54,28,26
Etox,darksorrow,1870,shaman,enhancement,60,32,28
Jäy,twisting-nether,1867,shaman,enhancement,52,31,21
Ниокумибейт,soulflayer,1866,shaman,enhancement,52,34,18
Nopre,blackrock,1857,shaman,enhancement,63,36,27
Mustakrakish,terokkar,1855,shaman,enhancement,36,24,12
Buffdraventy,archimonde,1855,shaman,enhancement,42,25,17
Radåhn,outland,1854,shaman,enhancement,72,44,28
Lokes,drakthul,1854,shaman,enhancement,48,28,20
Gúîtårgøð,sanguino,1854,shaman,enhancement,60,31,29
Hexmex,stormreaver,1853,shaman,enhancement,42,21,21
Enhshamanop,draenor,1851,shaman,enhancement,90,44,46
Totemofgreed,rexxar,1843,shaman,enhancement,84,40,44
Stribbzz,stormscale,1842,shaman,enhancement,47,32,15
Сахарокь,soulflayer,1840,shaman,enhancement,42,27,15
Shamanyxx,tarren-mill,1838,shaman,enhancement,60,31,29
Actionhank,area-52,1834,shaman,enhancement,57,30,27
Zetorgg,burning-legion,1832,shaman,enhancement,71,36,35
Horelio,sanguino,1830,shaman,enhancement,87,52,35
Друггрумилей,soulflayer,1828,shaman,enhancement,42,24,18
Нарленд,gordunni,1826,shaman,enhancement,54,28,26
Uhøfligeulf,draenor,1824,shaman,enhancement,42,23,19
Chakafuyo,dun-modr,1822,shaman,enhancement,42,25,17
Пэппивкашке,howling-fjord,1818,shaman,enhancement,38,23,15
Argotan,drakthul,1817,shaman,enhancement,71,43,28
Brokenguyman,defias-brotherhood,1817,shaman,enhancement,35,20,15
Mckoy,kazzak,1816,shaman,enhancement,40,27,13
Frankone,outland,1815,shaman,enhancement,66,42,24
Naochí,silvermoon,1813,shaman,enhancement,29,20,9
Bikdig,dun-modr,1812,shaman,enhancement,78,47,31
Вацустайл,goldrinn,1810,shaman,enhancement,48,32,16
Taktouka,archimonde,1810,shaman,enhancement,54,24,30
Wishstêên,stormscale,1809,shaman,enhancement,64,29,35
Ятебясмету,gordunni,1808,shaman,enhancement,42,29,13
Xôàrqt,eredar,1806,shaman,enhancement,185,101,84
Yombaï,archimonde,1806,shaman,enhancement,90,39,51
Ниу,thermaplugg,1805,shaman,enhancement,42,25,17
Реактиватор,soulflayer,1803,shaman,enhancement,47,27,20
Syllaas,ysondre,1800,shaman,enhancement,54,28,26
Mèátßãllgøðx,kazzak,1799,shaman,enhancement,111,56,55
Proccq,twisting-nether,1795,shaman,enhancement,48,24,24
Arhitopg,silvermoon,1794,shaman,enhancement,84,42,42
Lurkmon,twisting-nether,1790,shaman,enhancement,52,34,18
Talrall,twisting-nether,1789,shaman,enhancement,60,31,29
Alterem,kazzak,1778,shaman,enhancement,66,34,32
Shamarach,sylvanas,1773,shaman,enhancement,30,22,8
Pýthøn,silvermoon,1772,shaman,enhancement,54,27,27
Ananasanax,twisting-nether,1770,shaman,enhancement,90,49,41
Grende,sylvanas,1764,shaman,enhancement,66,35,31
Чаапалах,blackscar,1760,shaman,enhancement,61,28,33
Shamtard,frostwhisper,1758,shaman,enhancement,54,26,28
Senroxx,blackrock,1757,shaman,enhancement,42,27,15
Voodoodoouu,stormscale,1757,shaman,enhancement,36,20,16
Wóllff,archimonde,1757,shaman,enhancement,42,21,21
Китраст,soulflayer,1756,shaman,enhancement,34,19,15
Бренненд,howling-fjord,1753,shaman,enhancement,47,27,20
Falseshepard,kazzak,1751,shaman,enhancement,42,23,19
Yashëa,ysondre,1749,shaman,enhancement,32,30,2
Naïda,conseil-des-ombres,1743,shaman,enhancement,47,26,21
Vayshibro,turalyon,1740,shaman,enhancement,48,26,22
Рэггдолл,soulflayer,1739,shaman,enhancement,72,28,44
Deaslow,hyjal,1736,shaman,enhancement,53,31,22
Wacomtablet,kazzak,1736,shaman,enhancement,36,19,17
Basz,aegwynn,1732,shaman,enhancement,37,21,16
Tobanga,malganis,1730,shaman,enhancement,48,29,19
Boombastíc,ravencrest,1728,shaman,enhancement,47,23,24
Mírídíuss,silvermoon,1727,shaman,enhancement,29,19,10
Халльбьерн,howling-fjord,1726,shaman,enhancement,60,36,24
Floorislava,culte-de-la-rive-noire,1723,shaman,enhancement,48,24,24
Asaakira,blackmoore,1721,shaman,enhancement,77,35,42
Salvadr,zuljin,1720,shaman,enhancement,50,27,23
Ázøk,stormscale,1717,shaman,enhancement,100,49,51
Snëakyboom,stormscale,1717,shaman,enhancement,96,46,50
Тралси,howling-fjord,1715,shaman,enhancement,24,18,6
Enhx,ravencrest,1707,shaman,enhancement,36,23,13
Fotmburstwin,blackmoore,1704,shaman,enhancement,42,27,15
Bluetide,ravencrest,1699,shaman,enhancement,45,32,13
Lersham,the-maelstrom,1698,shaman,enhancement,54,32,22
Veloudinos,twisting-nether,1692,shaman,enhancement,78,53,25
Sangoma,frostmane,1688,shaman,enhancement,107,47,60
Sígrun,aegwynn,1685,shaman,enhancement,36,24,12
Ripstorm,sylvanas,1685,shaman,enhancement,48,24,24
Wheygodx,ravencrest,1679,shaman,enhancement,87,46,41
Moini,eredar,1674,shaman,enhancement,42,21,21
Greythunda,archimonde,1672,shaman,enhancement,36,23,13
Gelthan,zuljin,1665,shaman,enhancement,78,42,36
Isucklasso,aegwynn,1664,shaman,enhancement,48,29,19
Neurax,sanguino,1663,shaman,enhancement,88,47,41
Khelyyn,tarren-mill,1662,shaman,enhancement,64,33,31
Царьбер,soulflayer,1658,shaman,enhancement,74,41,33
Nînadobrevx,stormscale,1657,shaman,enhancement,111,65,46
Casualhex,argent-dawn,1656,shaman,enhancement,60,35,25
Láynert,dun-modr,1654,shaman,enhancement,165,81,84
Tartakos,ravencrest,1652,shaman,enhancement,61,36,25
Ludwigson,tarren-mill,1652,shaman,enhancement,98,57,41
Stormbreáker,twisting-nether,1650,shaman,enhancement,105,67,38
Взалходил,soulflayer,1650,shaman,enhancement,35,19,16
Bumbummann,blackmoore,1649,shaman,enhancement,94,49,45
Халльбиорн,gordunni,1648,shaman,enhancement,56,25,31
Слакербэдбой,gordunni,1644,shaman,enhancement,54,23,31
Энха,howling-fjord,1641,shaman,enhancement,36,21,15
Fözk,outland,1641,shaman,enhancement,36,21,15
Painshock,outland,1640,shaman,enhancement,36,21,15
Ryhèn,stormscale,1637,shaman,enhancement,93,54,39
Shambamm,stormscale,1637,shaman,enhancement,54,31,23
Elemoont,tarren-mill,1633,shaman,enhancement,42,25,17
Legitbro,ravencrest,1633,shaman,enhancement,48,22,26
Joanna,frostwolf,1632,shaman,enhancement,42,19,23
Dennismanone,tarren-mill,1628,shaman,enhancement,42,20,22
Kammek,tarren-mill,1624,shaman,enhancement,63,41,22
Канамаш,borean-tundra,1624,shaman,enhancement,42,27,15
Ozilie,khaz-modan,1623,shaman,enhancement,42,25,17
Chamkalix,sanguino,1623,shaman,enhancement,72,37,35
Toteemikylpy,argent-dawn,1622,shaman,enhancement,30,22,8
Reparagos,sanguino,1622,shaman,enhancement,47,27,20
Recaim,outland,1622,shaman,enhancement,30,17,13
Xestil,blackmoore,1622,shaman,enhancement,37,20,17
Úpli,blackmoore,1621,shaman,enhancement,30,18,12
Echoingshock,argent-dawn,1619,shaman,enhancement,36,22,14
Чухансмент,gordunni,1617,shaman,enhancement,54,29,25
Madmadbro,tarren-mill,1616,shaman,enhancement,36,24,12
Spetsnazz,archimonde,1613,shaman,enhancement,78,35,43
Typhoön,sanguino,1612,shaman,enhancement,139,71,68
Obrijames,tarren-mill,1606,shaman,enhancement,36,22,14
Raveell,defias-brotherhood,1606,shaman,enhancement,46,22,24
Grrud,draenor,1604,shaman,enhancement,42,23,19
Kynaz,sanguino,1604,shaman,enhancement,57,22,35
Shocktopussi,stormscale,1603,shaman,enhancement,51,32,19
Elèon,blackrock,1603,shaman,enhancement,48,22,26
Moaxtyr,blackmoore,1601,shaman,enhancement,42,29,13
Apexpredlol,blackmoore,1601,shaman,enhancement,72,35,37
Venomos,kazzak,1601,shaman,enhancement,39,18,21
Pontifhkas,ragnaros,1597,shaman,enhancement,33,22,11
Sndheal,kazzak,1596,shaman,enhancement,24,19,5
Jabaraklol,stormscale,1595,shaman,enhancement,70,45,25
Belroc,ravencrest,1591,shaman,enhancement,36,19,17
Calvey,magtheridon,1589,shaman,enhancement,34,17,17
Rayoton,burning-legion,1589,shaman,enhancement,48,20,28
Hexwife,archimonde,1588,shaman,enhancement,62,32,30
Monamour,twisting-nether,1583,shaman,enhancement,36,21,15
Pumanii,silvermoon,1583,shaman,enhancement,48,23,25
Цс,azuregos,1579,shaman,enhancement,116,63,53
Cåmilis,archimonde,1579,shaman,enhancement,48,24,24
Krovn,aszune,1578,shaman,enhancement,54,26,28
Azzizael,argent-dawn,1577,shaman,enhancement,72,37,35
Nexdown,archimonde,1571,shaman,enhancement,30,17,13
Chendra,scarshield-legion,1570,shaman,enhancement,83,40,43
Voodoohexman,kazzak,1569,shaman,enhancement,48,29,19
Ореганно,howling-fjord,1566,shaman,enhancement,60,32,28
Автозакзак,soulflayer,1563,shaman,enhancement,35,17,18
Argarok,argent-dawn,1561,shaman,enhancement,30,18,12
Kosface,tarren-mill,1557,shaman,enhancement,83,44,39
Kanaky,hyjal,1556,shaman,enhancement,30,17,13
Ашхикиган,howling-fjord,1556,shaman,enhancement,54,19,35
Порнёреф,howling-fjord,1553,shaman,enhancement,87,56,31
Mõrax,ysondre,1550,shaman,enhancement,43,20,23
Лолимин,borean-tundra,1548,shaman,enhancement,33,21,12
Эбгерсон,soulflayer,1548,shaman,enhancement,102,55,47
Äijä,chromaggus,1544,shaman,enhancement,42,23,19
Кинговели,soulflayer,1543,shaman,enhancement,84,40,44
Oronakgladx,ravencrest,1538,shaman,enhancement,60,32,28
Enhahaha,tarren-mill,1535,shaman,enhancement,24,16,8
Smozze,grim-batol,1534,shaman,enhancement,78,38,40
Барракудах,gordunni,1534,shaman,enhancement,90,40,50
Tornis,terokkar,1532,shaman,enhancement,48,24,24
Skullstorm,talnivarr,1530,shaman,enhancement,24,16,8
Defiaz,stormscale,1527,shaman,enhancement,34,25,9
Элетеми,soulflayer,1527,shaman,enhancement,48,26,22
Kutipaperi,stormscale,1526,shaman,enhancement,30,18,12
Szublime,stormscale,1520,shaman,enhancement,36,20,16
Ubies,silvermoon,1518,shaman,enhancement,42,23,19
Patsham,wildhammer,1515,shaman,enhancement,66,39,27
Paintball,kazzak,1508,shaman,enhancement,42,21,21
Voodooms,laughing-skull,1507,shaman,enhancement,29,20,9
Zayliha,ravencrest,1500,shaman,enhancement,24,16,8
Totemticks,aegwynn,1497,shaman,enhancement,30,16,14
Sozetwo,tarren-mill,1494,shaman,enhancement,22,16,6
Heeze,doomhammer,1494,shaman,enhancement,112,60,52
Blackibird,garona,1489,shaman,enhancement,33,17,16
Vascodagama,twisting-nether,1488,shaman,enhancement,42,25,17
Gerethor,burning-legion,1484,shaman,enhancement,57,25,32
Shyrion,onyxia,1479,shaman,enhancement,48,21,27
Xxloon,blackrock,1477,shaman,enhancement,54,33,21
Stormkiler,defias-brotherhood,1476,shaman,enhancement,54,21,33
Chimp,lightnings-blade,1475,shaman,enhancement,36,21,15
Lumii,azshara,1471,shaman,enhancement,42,21,21
Enigmar,stormscale,1471,shaman,enhancement,93,43,50
Mcbloob,kazzak,1469,shaman,enhancement,81,39,42
Дефибо,howling-fjord,1468,shaman,enhancement,72,36,36
Shamãn,draenor,1467,shaman,enhancement,42,19,23
Argonautt,drakthul,1466,shaman,enhancement,66,28,38
Пеклоь,soulflayer,1465,shaman,enhancement,40,18,22
Shockxy,norgannon,1464,shaman,enhancement,34,16,18
Nyxoqtx,draenor,1454,shaman,enhancement,24,21,3
Шторсонг,gordunni,1451,shaman,enhancement,74,48,26
Arkaos,exodar,1439,shaman,enhancement,37,21,16
Dshaman,aegwynn,1438,shaman,enhancement,18,15,3
Perunya,tarren-mill,1438,shaman,enhancement,47,24,23
Shaayys,archimonde,1438,shaman,enhancement,78,35,43
Áä,stormscale,1436,shaman,enhancement,18,15,3
Thorâ,frostmane,1435,shaman,enhancement,30,21,9
Jondil,das-syndikat,1433,shaman,enhancement,36,16,20
Царьколтрэйн,blackscar,1432,shaman,enhancement,36,16,20
Spicemélange,archimonde,1431,shaman,enhancement,24,15,9
Hayvaan,blackrock,1431,shaman,enhancement,78,46,32
Estasham,stormscale,1430,shaman,enhancement,72,38,34
Шокмужик,gordunni,1428,shaman,enhancement,30,15,15
Yurkën,uldum,1428,shaman,enhancement,60,29,31
Vulkân,silvermoon,1427,shaman,enhancement,36,21,15
Dcanne,outland,1426,shaman,enhancement,69,37,32
Ïï,archimonde,1425,shaman,enhancement,42,19,23
Chêlëx,silvermoon,1421,shaman,enhancement,44,19,25
Zuvx,ravencrest,1420,shaman,enhancement,66,38,28
Zarkab,ysondre,1419,shaman,enhancement,22,16,6
Tescriamelio,ysondre,1418,shaman,enhancement,24,15,9
Rocktopus,outland,1418,shaman,enhancement,27,16,11
Курси,gordunni,1407,shaman,enhancement,30,15,15
Shambolicc,ravencrest,1404,shaman,enhancement,35,15,20
Kenseienh,kazzak,1402,shaman,enhancement,121,61,60
Îzanami,ravencrest,1380,shaman,enhancement,48,24,24
Shockthat,draenor,1375,shaman,enhancement,40,26,14
Sparkarse,argent-dawn,1374,shaman,enhancement,24,17,7
Tahsus,blackmoore,1372,shaman,enhancement,36,17,19
Cahuna,stormscale,1371,shaman,enhancement,63,24,39
Notoxus,antonidas,1364,shaman,enhancement,78,39,39
Ðezûga,antonidas,1361,shaman,enhancement,48,22,26
Херургх,soulflayer,1357,shaman,enhancement,26,15,11
Дрегтан,howling-fjord,1344,shaman,enhancement,61,23,38
Faydé,stormscale,1343,shaman,enhancement,30,14,16
Lassolasse,sylvanas,1341,shaman,enhancement,18,14,4
Jtouni,outland,1341,shaman,enhancement,24,14,10
Stensham,stormreaver,1340,shaman,enhancement,24,14,10
Totemlover,draenor,1338,shaman,enhancement,28,18,10
Clembute,cthun,1335,shaman,enhancement,36,23,13
Dalgia,tarren-mill,1335,shaman,enhancement,24,14,10
Bolgrath,blackmoore,1332,shaman,enhancement,24,14,10
Chämalö,archimonde,1332,shaman,enhancement,90,47,43
Turbopuddi,kazzak,1329,shaman,enhancement,30,14,16
Juliaroberts,ragnaros,1325,shaman,enhancement,75,38,37
Thrâwl,kazzak,1324,shaman,enhancement,18,14,4
Ørgus,aegwynn,1321,shaman,enhancement,179,99,80
Ошиндра,gordunni,1320,shaman,enhancement,28,15,13
Плаглорд,howling-fjord,1317,shaman,enhancement,24,14,10
Maajo,tarren-mill,1312,shaman,enhancement,42,16,26
Tyrox,kirin-tor,1310,shaman,enhancement,24,14,10
Sangvinus,outland,1308,shaman,enhancement,30,14,16
Mcslammer,kazzak,1305,shaman,enhancement,36,14,22
Wedís,outland,1299,shaman,enhancement,42,22,20
Sunetee,kazzak,1294,shaman,enhancement,54,23,31
Trîkill,hyjal,1289,shaman,enhancement,48,19,29
Shamaneo,outland,1288,shaman,enhancement,33,24,9
Manrod,tarren-mill,1279,shaman,enhancement,66,34,32
Madboys,kazzak,1279,shaman,enhancement,31,15,16
Katastrofuss,stormscale,1273,shaman,enhancement,35,21,14
Gurtok,drakthul,1271,shaman,enhancement,24,15,9
Lavashnikov,burning-legion,1269,shaman,enhancement,43,21,22
Verlas,kazzak,1266,shaman,enhancement,46,22,24
Другалёк,howling-fjord,1263,shaman,enhancement,30,17,13
Ùseless,archimonde,1248,shaman,enhancement,24,13,11
Testosterone,dun-modr,1246,shaman,enhancement,18,13,5
Маелштромс,soulflayer,1246,shaman,enhancement,24,13,11
Максобман,howling-fjord,1243,shaman,enhancement,24,13,11
Stormasaurus,anachronos,1242,shaman,enhancement,22,14,8
Виндфуриа,gordunni,1242,shaman,enhancement,42,22,20
Shambambum,blackrock,1239,shaman,enhancement,30,13,17
Чёкнутое,soulflayer,1236,shaman,enhancement,39,23,16
Mesrines,archimonde,1236,shaman,enhancement,24,13,11
Nibblez,aegwynn,1235,shaman,enhancement,18,13,5
Ecclîpce,archimonde,1235,shaman,enhancement,24,13,11
Kijin,kirin-tor,1235,shaman,enhancement,24,13,11
Pvegame,tarren-mill,1233,shaman,enhancement,30,13,17
Басари,gordunni,1232,shaman,enhancement,18,13,5
Convîcted,grim-batol,1230,shaman,enhancement,22,14,8
Stromkek,eredar,1223,shaman,enhancement,24,13,11
Zandali,tarren-mill,1222,shaman,enhancement,54,30,24
Lokresh,azjolnerub,1220,shaman,enhancement,24,13,11
Alphas,draenor,1220,shaman,enhancement,24,13,11
Dendyre,outland,1214,shaman,enhancement,29,13,16
Shamaray,stormscale,1212,shaman,enhancement,42,22,20
Yeemayne,outland,1206,shaman,enhancement,18,13,5
Шалман,thermaplugg,1202,shaman,enhancement,101,48,53
Grimtøtem,defias-brotherhood,1198,shaman,enhancement,30,14,16
Kuzsham,archimonde,1195,shaman,enhancement,27,13,14
Saduria,antonidas,1194,shaman,enhancement,78,44,34
Броаркар,razuvious,1190,shaman,enhancement,48,24,24
Prømetheüs,sanguino,1176,shaman,enhancement,40,23,17
Плюжка,greymane,1175,shaman,enhancement,110,58,52
Тленозавр,gordunni,1173,shaman,enhancement,33,13,20
Тиидишам,blackscar,1152,shaman,enhancement,18,12,6
Teknorave,dun-modr,1152,shaman,enhancement,18,12,6
Treyway,dun-modr,1151,shaman,enhancement,18,12,6
Phobiatics,thrall,1151,shaman,enhancement,18,12,6
Cløke,stormscale,1151,shaman,enhancement,18,12,6
Kulefesk,grim-batol,1151,shaman,enhancement,24,12,12
Daybidaybi,stormscale,1151,shaman,enhancement,28,13,15
Altotem,blackmoore,1150,shaman,enhancement,18,12,6
Møldør,tarren-mill,1150,shaman,enhancement,18,12,6
Kezron,aegwynn,1150,shaman,enhancement,18,12,6
Dmgaddict,kazzak,1149,shaman,enhancement,24,12,12
Zulmalis,twisting-nether,1149,shaman,enhancement,24,12,12
Barbebiendur,archimonde,1148,shaman,enhancement,24,12,12
Thalir,aegwynn,1148,shaman,enhancement,27,13,14
Shamira,nethersturm,1148,shaman,enhancement,30,12,18
Famepolîce,blackrock,1147,shaman,enhancement,18,12,6
Porphy,kazzak,1147,shaman,enhancement,18,12,6
Gøretterøg,ysondre,1147,shaman,enhancement,19,12,7
Kargos,stormscale,1146,shaman,enhancement,24,12,12
Atée,silvermoon,1146,shaman,enhancement,24,12,12
Sêarix,aegwynn,1144,shaman,enhancement,18,12,6
Экспатриот,greymane,1143,shaman,enhancement,18,12,6
Shock,magtheridon,1140,shaman,enhancement,29,17,12
Sg,la-croisade-écarlate,1135,shaman,enhancement,37,18,19
Filigran,ragnaros,1132,shaman,enhancement,24,12,12
Justweirdaf,blackmoore,1129,shaman,enhancement,30,12,18
Arcura,twisting-nether,1127,shaman,enhancement,24,13,11
Лэнгипас,gordunni,1125,shaman,enhancement,69,31,38
Aquæ,suramar,1124,shaman,enhancement,47,26,21
Igniis,frostmane,1120,shaman,enhancement,18,12,6
Атл,deathguard,1117,shaman,enhancement,20,13,7
Precíous,sporeggar,1115,shaman,enhancement,34,19,15
Windfury,sylvanas,1112,shaman,enhancement,41,19,22
Быковат,booty-bay,1101,shaman,enhancement,30,12,18
Kringspierce,twisting-nether,1086,shaman,enhancement,55,34,21
Хмелецкий,soulflayer,1085,shaman,enhancement,30,18,12
Wargriman,kelthuzad,1081,shaman,enhancement,24,15,9
Zmech,chamber-of-aspects,1068,shaman,enhancement,25,12,13
Stormrex,magtheridon,1062,shaman,enhancement,42,20,22
Kärmá,stormscale,1056,shaman,enhancement,18,11,7
Pusspatrol,kazzak,1056,shaman,enhancement,24,11,13
Pay,stormscale,1055,shaman,enhancement,18,11,7
Trobø,ravencrest,1055,shaman,enhancement,33,12,21
Khrin,blackmoore,1054,shaman,enhancement,18,11,7
Lavarage,kazzak,1054,shaman,enhancement,18,11,7
Elémenta,turalyon,1053,shaman,enhancement,18,11,7
Hitmeagain,blackhand,1053,shaman,enhancement,24,11,13
Palmalecki,ravencrest,1053,shaman,enhancement,30,11,19
Hulcky,grim-batol,1051,shaman,enhancement,18,11,7
Hopefully,eredar,1050,shaman,enhancement,18,11,7
Biglynx,sanguino,1049,shaman,enhancement,66,36,30
Erupted,draenor,1049,shaman,enhancement,30,11,19
Щцц,soulflayer,1047,shaman,enhancement,18,11,7
Shamrøck,archimonde,1042,shaman,enhancement,30,15,15
Ipbar,blackrock,1038,shaman,enhancement,18,11,7
Элетар,gordunni,1031,shaman,enhancement,30,11,19
Cimer,sargeras,1017,shaman,enhancement,30,12,18
Beletili,chogall,997,shaman,enhancement,25,12,13
Khamo,twisting-nether,990,shaman,enhancement,17,11,6
Jeki,ysondre,989,shaman,enhancement,34,11,23
Mendoz,nazjatar,977,shaman,enhancement,42,20,22
Yunero,argent-dawn,975,shaman,enhancement,19,11,8
Kushme,silvermoon,970,shaman,enhancement,36,12,24
Dumhuvud,stormscale,960,shaman,enhancement,12,10,2
Worstshamy,sanguino,960,shaman,enhancement,12,10,2
Crysis,sanguino,960,shaman,enhancement,18,10,8
Dumbasha,ravencrest,960,shaman,enhancement,18,10,8
Mëditåtïøñ,blackrock,960,shaman,enhancement,24,10,14
Cripxo,sanguino,959,shaman,enhancement,12,10,2
Yacu,blackrock,959,shaman,enhancement,18,10,8
Enoughh,the-maelstrom,959,shaman,enhancement,18,10,8
Skyróxx,blackrock,959,shaman,enhancement,18,10,8
Шампуньхан,blackscar,959,shaman,enhancement,24,10,14
Buuddha,drakthul,958,shaman,enhancement,18,10,8
Myngo,thrall,958,shaman,enhancement,18,10,8
Jasnäh,ysondre,958,shaman,enhancement,18,10,8
Towi,krasus,955,shaman,enhancement,12,10,2
Rushfabi,aegwynn,948,shaman,enhancement,24,10,14
Janserey,burning-legion,947,shaman,enhancement,24,10,14
Shamanigans,terrordar,945,shaman,enhancement,12,10,2
Nethershock,blackmoore,942,shaman,enhancement,60,33,27
Mimsy,hyjal,941,shaman,enhancement,41,17,24
Fòóxi,ravencrest,935,shaman,enhancement,42,20,22
Чухмандос,gordunni,932,shaman,enhancement,23,11,12
Бойкийкот,gordunni,926,shaman,enhancement,24,10,14
Izaarleus,argent-dawn,920,shaman,enhancement,17,10,7
Rorenth,blackhand,912,shaman,enhancement,56,24,32
Chronochrome,chamber-of-aspects,894,shaman,enhancement,24,11,13
Tosemist,stormscale,864,shaman,enhancement,12,9,3
Blaukraut,stormscale,864,shaman,enhancement,12,9,3
Axilary,tarren-mill,864,shaman,enhancement,12,9,3
Blackyx,dun-modr,864,shaman,enhancement,12,9,3
Kilomanjaro,bloodfeather,864,shaman,enhancement,12,9,3
Sonnestorm,tarren-mill,864,shaman,enhancement,12,9,3
Politemanner,stormscale,864,shaman,enhancement,18,9,9
Johncoltrane,archimonde,863,shaman,enhancement,12,9,3
Maddogxz,frostwolf,863,shaman,enhancement,12,9,3
Shamrún,sylvanas,863,shaman,enhancement,12,9,3
Sházam,destromath,863,shaman,enhancement,12,9,3
Hezdnalien,aegwynn,863,shaman,enhancement,18,9,9
Qauter,hellfire,863,shaman,enhancement,18,9,9
Taraesh,blackhand,863,shaman,enhancement,18,9,9
Kættmæck,tarren-mill,863,shaman,enhancement,18,9,9
Shyne,vashj,863,shaman,enhancement,18,9,9
Онеоне,deathweaver,863,shaman,enhancement,18,9,9
Faltygo,drakthul,863,shaman,enhancement,24,9,15
Sgtspyke,ragnaros,863,shaman,enhancement,24,9,15
Моктрогтар,ashenvale,862,shaman,enhancement,12,9,3
Romacherry,aegwynn,862,shaman,enhancement,12,9,3
Laix,khaz-modan,862,shaman,enhancement,18,9,9
Moodoo,antonidas,862,shaman,enhancement,24,9,15
Zzadoxor,doomhammer,860,shaman,enhancement,18,9,9
Furioous,ravencrest,857,shaman,enhancement,18,9,9
Noiduttu,tarren-mill,854,shaman,enhancement,12,9,3
Vaesk,auchindoun,850,shaman,enhancement,18,9,9
Рэйпушка,gordunni,847,shaman,enhancement,23,9,14
Ryujìñjakka,culte-de-la-rive-noire,812,shaman,enhancement,18,9,9
Twotwozero,defias-brotherhood,803,shaman,enhancement,24,9,15
Nubokesel,ragnaros,796,shaman,enhancement,20,9,11
Dêblâzê,thrall,768,shaman,enhancement,12,8,4
Aswøg,kazzak,768,shaman,enhancement,12,8,4
Драгенхз,gordunni,768,shaman,enhancement,12,8,4
Qätär,ravencrest,768,shaman,enhancement,12,8,4
Tdogfx,blackhand,768,shaman,enhancement,12,8,4
Mehex,tarren-mill,768,shaman,enhancement,12,8,4
Healníx,ravencrest,768,shaman,enhancement,12,8,4
Bobonbu,forscherliga,768,shaman,enhancement,12,8,4
Lytningx,ravencrest,768,shaman,enhancement,12,8,4
Thunderdøme,stormscale,768,shaman,enhancement,12,8,4
Dhedge,draenor,768,shaman,enhancement,12,8,4
Bmtotem,twisting-nether,768,shaman,enhancement,18,8,10
Paschol,aegwynn,768,shaman,enhancement,18,8,10
Shámi,gilneas,768,shaman,enhancement,18,8,10
Gnomecake,vashj,768,shaman,enhancement,18,8,10
Zró,blackrock,768,shaman,enhancement,24,8,16
Faxsham,draenor,767,shaman,enhancement,12,8,4
Wertih,burning-legion,767,shaman,enhancement,12,8,4
Иннреи,howling-fjord,767,shaman,enhancement,12,8,4
Darhgan,argent-dawn,767,shaman,enhancement,12,8,4
Tschacô,malganis,767,shaman,enhancement,18,8,10
Nâs,kazzak,767,shaman,enhancement,18,8,10
Carlos,magtheridon,767,shaman,enhancement,18,8,10
Toxicnux,nemesis,767,shaman,enhancement,18,8,10
Шанья,gordunni,767,shaman,enhancement,30,8,22
Neptun,twisting-nether,766,shaman,enhancement,18,8,10
Durek,sylvanas,765,shaman,enhancement,12,8,4
Волкк,soulflayer,764,shaman,enhancement,12,8,4
Рыргаск,howling-fjord,764,shaman,enhancement,18,8,10
Strygwyrl,doomhammer,764,shaman,enhancement,18,8,10
Carusø,thrall,764,shaman,enhancement,18,8,10
Hectoraïus,ysondre,763,shaman,enhancement,18,8,10
Murog,dalaran,762,shaman,enhancement,12,8,4
Шамблабла,soulflayer,756,shaman,enhancement,30,8,22
Fotmslave,laughing-skull,749,shaman,enhancement,15,10,5
Arslos,twisting-nether,735,shaman,enhancement,14,9,5
Тотемныйчад,gordunni,731,shaman,enhancement,16,8,8
Trenhard,wildhammer,731,shaman,enhancement,17,8,9
Kunancementa,ravencrest,718,shaman,enhancement,17,8,9
Thossa,draenor,695,shaman,enhancement,17,8,9
Bärtigeberta,aegwynn,672,shaman,enhancement,10,8,2
Koiru,argent-dawn,672,shaman,enhancement,12,7,5
Tuncha,runetotem,672,shaman,enhancement,12,7,5
Tufftnamn,frostmane,672,shaman,enhancement,12,7,5
Metalbeef,xavius,672,shaman,enhancement,12,7,5
Ekinoz,outland,672,shaman,enhancement,12,7,5
Proper,tichondrius,672,shaman,enhancement,12,7,5
Roineé,draenor,672,shaman,enhancement,12,7,5
Kyshka,tarren-mill,672,shaman,enhancement,12,7,5
Akatuseiwah,blackrock,672,shaman,enhancement,12,7,5
Matchstíck,draenor,672,shaman,enhancement,18,7,11
Иллюминэйшн,soulflayer,672,shaman,enhancement,18,7,11
Krishun,blackmoore,672,shaman,enhancement,18,7,11
Джоннси,howling-fjord,671,shaman,enhancement,12,7,5
Rutil,blackhand,671,shaman,enhancement,12,7,5
Birnenpfeffi,malfurion,671,shaman,enhancement,12,7,5
Dwarfofwar,ravencrest,671,shaman,enhancement,12,7,5
Dénekha,zuljin,671,shaman,enhancement,12,7,5
Florgegoyd,eredar,670,shaman,enhancement,12,7,5
Nakenfeigy,stormreaver,670,shaman,enhancement,12,7,5
Viandehachee,dalaran,667,shaman,enhancement,12,7,5
Bumm,twisting-nether,665,shaman,enhancement,24,7,17
Øzy,sanguino,660,shaman,enhancement,12,7,5
Dakotasham,ravencrest,623,shaman,enhancement,11,7,4
Oldstorm,ravencrest,618,shaman,enhancement,22,10,12
Ugory,die-aldor,576,shaman,enhancement,6,6,0
Noboorst,stormscale,576,shaman,enhancement,6,6,0
Crowness,ragnaros,576,shaman,enhancement,6,6,0
Shamflurry,ravencrest,576,shaman,enhancement,6,6,0
Babalahziz,ysondre,576,shaman,enhancement,6,6,0
Tarantan,eredar,576,shaman,enhancement,12,6,6
Dwarfstil,blackmoore,576,shaman,enhancement,12,6,6
Tzaish,blackmoore,576,shaman,enhancement,12,6,6
Dami,die-aldor,576,shaman,enhancement,12,6,6
Nìno,azshara,576,shaman,enhancement,12,6,6
Ayame,burning-steppes,576,shaman,enhancement,12,6,6
Boidarbre,sargeras,576,shaman,enhancement,12,6,6
Shawck,ravencrest,576,shaman,enhancement,12,6,6
Gandy,the-maelstrom,576,shaman,enhancement,12,6,6
Szelenamoonx,outland,576,shaman,enhancement,12,6,6
Ягном,soulflayer,576,shaman,enhancement,12,6,6
Puumbaa,defias-brotherhood,576,shaman,enhancement,12,6,6
Tharma,blackmoore,576,shaman,enhancement,12,6,6
Voodoodocter,kazzak,576,shaman,enhancement,12,6,6
Pinkylol,stormscale,576,shaman,enhancement,12,6,6
Kolbászlelkü,ragnaros,576,shaman,enhancement,12,6,6
Purada,blackrock,576,shaman,enhancement,12,6,6
Critonian,twisting-nether,576,shaman,enhancement,12,6,6
Elemefayoh,tarren-mill,576,shaman,enhancement,12,6,6
Purgerooni,haomarush,576,shaman,enhancement,12,6,6
Bullx,magtheridon,576,shaman,enhancement,12,6,6
Alethea,frostmane,576,shaman,enhancement,12,6,6
Kelvok,silvermoon,576,shaman,enhancement,12,6,6
Marohk,uldum,576,shaman,enhancement,12,6,6
Testogodx,defias-brotherhood,576,shaman,enhancement,18,6,12
Javaburst,ragnaros,576,shaman,enhancement,24,6,18
Elijaá,nordrassil,575,shaman,enhancement,12,6,6
Киллдрак,howling-fjord,575,shaman,enhancement,12,6,6
Finni,hyjal,575,shaman,enhancement,12,6,6
Мамонтшам,howling-fjord,575,shaman,enhancement,12,6,6
Hexrated,draenor,575,shaman,enhancement,15,7,8
Nurychic,twisting-nether,575,shaman,enhancement,24,6,18
Mahlga,argent-dawn,574,shaman,enhancement,18,6,12
Tashunka,twisting-nether,574,shaman,enhancement,24,6,18
Дядяшаман,gordunni,573,shaman,enhancement,24,6,18
Shaminista,ravencrest,571,shaman,enhancement,12,6,6
Krakennm,dalaran,571,shaman,enhancement,12,6,6
Earthhulk,thrall,544,shaman,enhancement,10,7,3
Juniyaa,blackrock,543,shaman,enhancement,14,7,7
Yaar,alleria,542,shaman,enhancement,11,6,5
Narevoqi,madmortem,542,shaman,enhancement,13,7,6
Капарис,deathweaver,527,shaman,enhancement,15,6,9
Шаманутый,soulflayer,522,shaman,enhancement,14,7,7
Whizjy,sanguino,521,shaman,enhancement,22,9,13
Lavashock,tarren-mill,511,shaman,enhancement,22,6,16
Ruintotems,twisting-nether,510,shaman,enhancement,11,7,4
Ипа,thermaplugg,508,shaman,enhancement,17,6,11
Watzocham,archimonde,496,shaman,enhancement,13,6,7
Agathoulis,burning-legion,480,shaman,enhancement,6,5,1
Ðexx,stormscale,480,shaman,enhancement,6,5,1
Earthquaker,the-maelstrom,480,shaman,enhancement,6,5,1
Wooyoungsham,sylvanas,480,shaman,enhancement,6,5,1
Øutfox,silvermoon,480,shaman,enhancement,6,5,1
Zulren,draenor,480,shaman,enhancement,6,5,1
Genrok,burning-blade,480,shaman,enhancement,6,5,1
Windsòng,stormscale,480,shaman,enhancement,6,5,1
Medoje,argent-dawn,480,shaman,enhancement,6,5,1
Complete,hyjal,480,shaman,enhancement,6,5,1
Synergizer,kazzak,480,shaman,enhancement,6,5,1
Evííl,tarren-mill,480,shaman,enhancement,6,5,1
Ðevi,ravencrest,480,shaman,enhancement,6,5,1
Таиров,soulflayer,480,shaman,enhancement,6,5,1
Martini,tichondrius,480,shaman,enhancement,9,6,3
Itswoland,tarren-mill,480,shaman,enhancement,10,6,4
Ogmehu,stormreaver,480,shaman,enhancement,12,5,7
Ancestro,kazzak,480,shaman,enhancement,12,5,7
Hiron,sylvanas,480,shaman,enhancement,12,5,7
Deathshamãn,stormscale,480,shaman,enhancement,12,5,7
Жуксик,greymane,480,shaman,enhancement,12,5,7
Тыпроиграл,gordunni,480,shaman,enhancement,12,5,7
Neroty,blackmoore,480,shaman,enhancement,12,5,7
Kaimountain,defias-brotherhood,480,shaman,enhancement,12,5,7
Grosgourdin,la-croisade-écarlate,480,shaman,enhancement,12,5,7
Volcanò,outland,480,shaman,enhancement,12,5,7
Bowtenstorm,ravencrest,480,shaman,enhancement,12,5,7
Traktorchox,draenor,480,shaman,enhancement,12,5,7
Tonifo,nemesis,480,shaman,enhancement,12,5,7
Frostýx,draenor,480,shaman,enhancement,12,5,7
Pank,kazzak,480,shaman,enhancement,12,5,7
Lilmarco,stormreaver,480,shaman,enhancement,12,5,7
Schoølbøyq,blackrock,480,shaman,enhancement,12,5,7
Fanatroka,ravencrest,480,shaman,enhancement,12,5,7
Duhdelido,ravencrest,480,shaman,enhancement,12,5,7
Kabard,silvermoon,480,shaman,enhancement,12,5,7
Satanloveme,stormscale,480,shaman,enhancement,18,5,13
Амг,booty-bay,479,shaman,enhancement,12,5,7
Chamrøck,hyjal,479,shaman,enhancement,12,5,7
Yasan,kazzak,479,shaman,enhancement,13,5,8
Asstroy,sanguino,477,shaman,enhancement,6,5,1
Sardemar,defias-brotherhood,472,shaman,enhancement,12,5,7
Даблпамп,howling-fjord,431,shaman,enhancement,17,5,12
Hodir,bronzebeard,415,shaman,enhancement,10,5,5
Shamomo,hyjal,400,shaman,enhancement,13,5,8
Lilmozart,twisting-nether,384,shaman,enhancement,6,4,2
Robzn,blackrock,384,shaman,enhancement,6,4,2
Mistahbeard,stormscale,384,shaman,enhancement,6,4,2
Chamirox,ysondre,384,shaman,enhancement,6,4,2
Baldurr,sylvanas,384,shaman,enhancement,6,4,2
Ihealbro,blackrock,384,shaman,enhancement,6,4,2
Юрахафанбой,blackscar,384,shaman,enhancement,6,4,2
Hermerejildo,tarren-mill,384,shaman,enhancement,6,4,2
Richtigfies,kazzak,384,shaman,enhancement,6,4,2
Нийрагонго,gordunni,384,shaman,enhancement,6,4,2
Bantzer,twisting-nether,384,shaman,enhancement,6,4,2
Россаврн,galakrond,384,shaman,enhancement,6,4,2
Jaykezap,kazzak,384,shaman,enhancement,6,4,2
Simularcum,kazzak,384,shaman,enhancement,6,4,2
Мистерэнх,soulflayer,384,shaman,enhancement,6,4,2
Олешао,howling-fjord,384,shaman,enhancement,6,4,2
Abdegor,burning-legion,384,shaman,enhancement,6,4,2
Sûckmytotem,ragnaros,384,shaman,enhancement,6,4,2
Xalta,eldrethalas,384,shaman,enhancement,6,4,2
Rakermän,dun-modr,384,shaman,enhancement,6,4,2
Fyrkaz,aegwynn,384,shaman,enhancement,6,4,2
Shds,blackmoore,384,shaman,enhancement,6,4,2
Tijae,ravencrest,384,shaman,enhancement,6,4,2
Sinwithin,ravencrest,384,shaman,enhancement,6,4,2
Фролыч,deathguard,384,shaman,enhancement,6,4,2
Rodneymullen,tarren-mill,384,shaman,enhancement,6,4,2
Lovèless,stormscale,384,shaman,enhancement,6,4,2
Runè,azjolnerub,384,shaman,enhancement,6,4,2
Ilkim,hyjal,384,shaman,enhancement,6,4,2
Isogrind,archimonde,384,shaman,enhancement,6,4,2
Piripolkka,defias-brotherhood,384,shaman,enhancement,6,4,2
Чифсоса,soulflayer,384,shaman,enhancement,6,4,2
Шамунчез,gordunni,384,shaman,enhancement,6,4,2
Rykarn,eredar,384,shaman,enhancement,9,5,4
Drade,aegwynn,384,shaman,enhancement,8,4,4
Xhahal,hyjal,384,shaman,enhancement,10,4,6
Asçele,kazzak,384,shaman,enhancement,12,4,8
Dóómd,kazzak,384,shaman,enhancement,12,4,8
Claodze,stormscale,384,shaman,enhancement,12,4,8
Бигмамуля,booty-bay,384,shaman,enhancement,12,4,8
Meatballspam,stormscale,384,shaman,enhancement,12,4,8
Дюнволкер,razuvious,384,shaman,enhancement,12,4,8
Waterboi,blackmoore,384,shaman,enhancement,12,4,8
Палачок,eversong,384,shaman,enhancement,12,4,8
Brooce,sylvanas,384,shaman,enhancement,12,4,8
Видсон,soulflayer,384,shaman,enhancement,12,4,8
Kanabi,darkspear,384,shaman,enhancement,12,4,8
Blixtnedslag,shattered-hand,384,shaman,enhancement,12,4,8
Chamtroulku,ysondre,384,shaman,enhancement,12,4,8
Johnisplay,tarren-mill,384,shaman,enhancement,12,4,8
Votie,tarren-mill,384,shaman,enhancement,12,4,8
Рокмару,soulflayer,384,shaman,enhancement,12,4,8
Türak,tarren-mill,384,shaman,enhancement,12,4,8
Derryo,silvermoon,384,shaman,enhancement,18,4,14
Domiro,ravencrest,384,shaman,enhancement,18,4,14
Màverìck,nemesis,383,shaman,enhancement,6,4,2
Wolkano,zuljin,383,shaman,enhancement,10,5,5
Аеесо,gordunni,383,shaman,enhancement,12,4,8
Asogg,archimonde,379,shaman,enhancement,12,4,8
Disciplé,blackmoore,367,shaman,enhancement,11,4,7
Kireekoura,tarren-mill,336,shaman,enhancement,9,4,5
Mazokuu,ragnaros,329,shaman,enhancement,16,6,10
Hurtigtotem,ravencrest,320,shaman,enhancement,10,4,6
Nargrul,tarren-mill,319,shaman,enhancement,5,4,1
Gigamuscle,ravencrest,304,shaman,enhancement,7,4,3
Айбьорн,gordunni,288,shaman,enhancement,6,3,3
Китрасст,soulflayer,288,shaman,enhancement,6,3,3
Garulf,twisting-nether,288,shaman,enhancement,6,3,3
Shockaibo,drakthul,288,shaman,enhancement,6,3,3
Stormfury,balnazzar,288,shaman,enhancement,6,3,3
Xesti,twisting-nether,288,shaman,enhancement,6,3,3
Otacboziji,sylvanas,288,shaman,enhancement,6,3,3
Caelx,ragnaros,288,shaman,enhancement,6,3,3
Mmsalatik,nemesis,288,shaman,enhancement,6,3,3
Sodor,laughing-skull,288,shaman,enhancement,6,3,3
Мэлик,howling-fjord,288,shaman,enhancement,6,3,3
Zokah,emeriss,288,shaman,enhancement,6,3,3
Ñtk,dun-modr,288,shaman,enhancement,6,3,3
Неутолимыйх,blackscar,288,shaman,enhancement,6,3,3
Hansdieter,antonidas,288,shaman,enhancement,6,3,3
Tâktoukâ,archimonde,288,shaman,enhancement,6,3,3
Рыганский,blackscar,288,shaman,enhancement,6,3,3
Uomae,dun-modr,288,shaman,enhancement,6,3,3
Тыщатристах,howling-fjord,288,shaman,enhancement,6,3,3
Nëÿrën,drakthul,288,shaman,enhancement,6,3,3
Kedall,archimonde,288,shaman,enhancement,6,3,3
Pelicius,sanguino,288,shaman,enhancement,6,3,3
Furrymane,blackmoore,288,shaman,enhancement,6,3,3
Shambolicc,kazzak,288,shaman,enhancement,6,3,3
Likê,aegwynn,288,shaman,enhancement,6,3,3
Chehkhan,archimonde,288,shaman,enhancement,6,3,3
Kafese,uldaman,288,shaman,enhancement,6,3,3
Xfiles,garona,288,shaman,enhancement,6,3,3
Millesabords,dun-morogh,288,shaman,enhancement,6,3,3
Totoostoy,burning-legion,288,shaman,enhancement,6,3,3
Magosh,blackmoore,288,shaman,enhancement,6,3,3
Veteroth,argent-dawn,288,shaman,enhancement,6,3,3
Funkins,hyjal,288,shaman,enhancement,6,3,3
Lahur,blackmoore,288,shaman,enhancement,6,3,3
Blazingfiré,tarren-mill,288,shaman,enhancement,6,3,3
Wakoteh,quelthalas,288,shaman,enhancement,6,3,3
Loshohealva,stormscale,288,shaman,enhancement,6,3,3
Azrs,ravencrest,288,shaman,enhancement,6,3,3
Håõkåh,hyjal,288,shaman,enhancement,6,3,3
Eomsham,magtheridon,288,shaman,enhancement,6,3,3
Chrisbrownx,outland,288,shaman,enhancement,6,3,3
Kulho,stormscale,288,shaman,enhancement,6,3,3
Depucova,silvermoon,288,shaman,enhancement,6,3,3
Kemurus,kazzak,288,shaman,enhancement,6,3,3
Ronctaha,blackrock,288,shaman,enhancement,6,3,3
Lilkazamm,blackrock,288,shaman,enhancement,6,3,3
Guqin,ravencrest,288,shaman,enhancement,6,3,3
Ñax,silvermoon,288,shaman,enhancement,6,3,3
Ccedtodeath,sylvanas,288,shaman,enhancement,6,3,3
Rejrax,ravencrest,288,shaman,enhancement,6,3,3
Hurbi,twisting-nether,288,shaman,enhancement,12,3,9
Dastarus,archimonde,288,shaman,enhancement,12,3,9
Æskalatiøn,aegwynn,288,shaman,enhancement,12,3,9
Brunütansol,sylvanas,288,shaman,enhancement,12,3,9
Maybeyes,twisting-nether,288,shaman,enhancement,12,3,9
Lorthargol,chamber-of-aspects,288,shaman,enhancement,12,3,9
Занги,soulflayer,288,shaman,enhancement,12,3,9
Jorny,burning-legion,288,shaman,enhancement,12,3,9
Rhakhatheckh,nemesis,288,shaman,enhancement,12,3,9
Sacrx,dalaran,288,shaman,enhancement,12,3,9
Лорикок,grom,288,shaman,enhancement,18,3,15
Gibspark,twisting-nether,287,shaman,enhancement,6,3,3
Trotzig,aegwynn,287,shaman,enhancement,6,3,3
Biphrost,nemesis,287,shaman,enhancement,6,3,3
Nothìnto,pozzo-delleternità,287,shaman,enhancement,6,3,3
Korzo,amanthul,287,shaman,enhancement,6,3,3
Slappybag,ravencrest,287,shaman,enhancement,6,3,3
Deeblu,nemesis,287,shaman,enhancement,6,3,3
Laghärta,dun-modr,286,shaman,enhancement,6,3,3
Madbud,stormscale,271,shaman,enhancement,11,3,8
Jehae,archimonde,239,shaman,enhancement,5,3,2
Ивми,gordunni,239,shaman,enhancement,5,3,2
Mooshock,balnazzar,223,shaman,enhancement,8,3,5
Nefasti,stormscale,223,shaman,enhancement,8,3,5
Tiamât,culte-de-la-rive-noire,208,shaman,enhancement,7,3,4
Elektekk,blackrock,192,shaman,enhancement,4,3,1
Stratholmee,drakthul,192,shaman,enhancement,6,2,4
Bladeyx,ragnaros,192,shaman,enhancement,6,2,4
Turbinká,burning-legion,192,shaman,enhancement,6,2,4
Тенав,blackscar,192,shaman,enhancement,6,2,4
Louvreparis,frostwolf,192,shaman,enhancement,6,2,4
Diya,karazhan,192,shaman,enhancement,6,2,4
Zarosh,los-errantes,192,shaman,enhancement,6,2,4
Tornadozzer,burning-legion,192,shaman,enhancement,6,2,4
Родохрозид,blackscar,192,shaman,enhancement,6,2,4
Dalgorr,magtheridon,192,shaman,enhancement,6,2,4
Kohzen,outland,192,shaman,enhancement,6,2,4
Hightotem,sanguino,192,shaman,enhancement,6,2,4
Savan,darkspear,192,shaman,enhancement,6,2,4
Bonethugdex,bladefist,192,shaman,enhancement,6,2,4
Pøllemodex,frostwhisper,192,shaman,enhancement,6,2,4
Xharnel,defias-brotherhood,192,shaman,enhancement,6,2,4
Реалайзер,blackscar,192,shaman,enhancement,6,2,4
Urshak,alleria,192,shaman,enhancement,6,2,4
Spiritualx,argent-dawn,192,shaman,enhancement,6,2,4
Elementhor,archimonde,192,shaman,enhancement,6,2,4
Haasshaman,ravencrest,192,shaman,enhancement,6,2,4
Ghostkod,burning-legion,192,shaman,enhancement,6,2,4
Destroilleur,archimonde,192,shaman,enhancement,6,2,4
Саксаул,fordragon,192,shaman,enhancement,6,2,4
Snapbábe,blackmoore,192,shaman,enhancement,6,2,4
Restmuell,blackmoore,192,shaman,enhancement,6,2,4
Volvíc,tichondrius,192,shaman,enhancement,6,2,4
Shrektar,outland,192,shaman,enhancement,6,2,4
Pulvêrizêr,agamaggan,192,shaman,enhancement,6,2,4
Sgf,stormscale,192,shaman,enhancement,6,2,4
Jhagy,archimonde,192,shaman,enhancement,6,2,4
Palarins,dalaran,192,shaman,enhancement,6,2,4
Bram,aggra-português,192,shaman,enhancement,6,2,4
Ostosmvp,ravencrest,192,shaman,enhancement,6,2,4
Elsassi,ravencrest,192,shaman,enhancement,6,2,4
Aubesombre,dalaran,192,shaman,enhancement,6,2,4
Lafia,blackrock,192,shaman,enhancement,6,2,4
Patites,twisting-nether,192,shaman,enhancement,6,2,4
Lovros,kazzak,192,shaman,enhancement,6,2,4
Elektrikci,silvermoon,192,shaman,enhancement,6,2,4
Bábbajaggí,blackrock,192,shaman,enhancement,6,2,4
Acces,stormscale,192,shaman,enhancement,6,2,4
Fufupartyxx,blackrock,192,shaman,enhancement,6,2,4
Shambamty,thrall,192,shaman,enhancement,6,2,4
Layonne,ysondre,192,shaman,enhancement,6,2,4
Амфеминка,gordunni,192,shaman,enhancement,6,2,4
Borindor,silvermoon,192,shaman,enhancement,6,2,4
Shamaniak,tarren-mill,192,shaman,enhancement,12,2,10
Blutschrei,tarren-mill,192,shaman,enhancement,12,2,10
Blautorkel,amanthul,159,shaman,enhancement,5,2,3
Tookaageeroo,burning-legion,159,shaman,enhancement,8,3,5
Tianoele,drakthul,144,shaman,enhancement,3,3,0
Lekthar,draenor,138,shaman,enhancement,10,3,7
Lavalew,lightbringer,96,shaman,enhancement,6,1,5
Avattar,twisting-nether,96,shaman,enhancement,6,1,5
Shøckz,azjolnerub,96,shaman,enhancement,6,1,5
Zugzie,draenor,96,shaman,enhancement,6,1,5
Vrontes,kazzak,96,shaman,enhancement,6,1,5
Vladraxes,draenor,96,shaman,enhancement,6,1,5
Bambustic,kazzak,96,shaman,enhancement,6,1,5
Eclaîr,thrall,96,shaman,enhancement,6,1,5
Дромгрон,howling-fjord,96,shaman,enhancement,6,1,5
Relampago,eredar,96,shaman,enhancement,6,1,5
Thoranis,kazzak,96,shaman,enhancement,6,1,5
Ghaargrim,tarren-mill,96,shaman,enhancement,6,1,5
Corvux,tarren-mill,96,shaman,enhancement,6,1,5
Preshear,twisting-nether,96,shaman,enhancement,6,1,5
Grabmytotemz,tarren-mill,96,shaman,enhancement,6,1,5
Sparkygødx,twisting-nether,96,shaman,enhancement,6,1,5
Réläx,kazzak,96,shaman,enhancement,6,1,5
Nnele,sanguino,96,shaman,enhancement,6,1,5
Hyamala,chamber-of-aspects,96,shaman,enhancement,6,1,5
Eneel,blackmoore,96,shaman,enhancement,6,1,5
Weaslêy,frostwolf,96,shaman,enhancement,6,1,5
Zoogang,ragnaros,96,shaman,enhancement,6,1,5
Sïlvek,sanguino,96,shaman,enhancement,6,1,5
Maskinett,stormscale,96,shaman,enhancement,6,1,5
Goldhand,ravencrest,96,shaman,enhancement,6,1,5
Blutshock,zuluhed,96,shaman,enhancement,6,1,5
Нерезшок,soulflayer,96,shaman,enhancement,6,1,5
Nuluadroguri,twisting-nether,96,shaman,enhancement,6,1,5
Kappatotem,silvermoon,96,shaman,enhancement,6,1,5
Casarú,arthas,96,shaman,enhancement,6,1,5
Châmanco,dun-modr,96,shaman,enhancement,6,1,5
Freexx,aegwynn,96,shaman,enhancement,8,1,7
Gälädhan,ysondre,95,shaman,enhancement,6,1,5
Blitzviech,aegwynn,79,shaman,enhancement,5,1,4
Rký,outland,48,shaman,enhancement,3,1,2
Wenesday,ysondre,48,shaman,enhancement,3,1,2
Lesnitt,kazzak,42,shaman,enhancement,9,2,7
Hanumanas,kazzak,31,shaman,enhancement,2,1,1
Arabesk,arygos,31,shaman,enhancement,2,1,1
Dotjürgen,blackrock,2205,warlock,demonology,84,48,36
Rikkërt,draenor,2186,warlock,demonology,83,45,38
Tuskawl,stormreaver,2154,warlock,demonology,91,51,40
Kimkold,twisting-nether,2146,warlock,demonology,102,61,41
Firochektro,ravencrest,2141,warlock,demonology,69,42,27
Nayolana,argent-dawn,2140,warlock,demonology,60,43,17
Syntaxzwo,blackmoore,2116,warlock,demonology,78,44,34
Rumour,sunstrider,2115,warlock,demonology,72,39,33
Supergeîl,blackrock,2112,warlock,demonology,71,38,33
Млечный,blackscar,2092,warlock,demonology,89,51,38
Anthh,doomhammer,2076,warlock,demonology,66,36,30
Whøknøws,twisting-nether,2070,warlock,demonology,72,37,35
Shablagoo,twisting-nether,2063,warlock,demonology,84,49,35
Demoner,tarren-mill,2047,warlock,demonology,60,35,25
Sad,lightnings-blade,2041,warlock,demonology,108,59,49
Britneý,stormscale,2008,warlock,demonology,118,58,60
Амеаль,eversong,2003,warlock,demonology,150,77,73
Maintarget,blackrock,2000,warlock,demonology,106,54,52
Хаосболик,gordunni,1993,warlock,demonology,30,21,9
Locktrainer,tarren-mill,1991,warlock,demonology,74,34,40
Конидэмико,blackscar,1954,warlock,demonology,83,38,45
Jimboneutron,stormscale,1946,warlock,demonology,29,21,8
Badapow,stormscale,1943,warlock,demonology,48,27,21
Juicybolt,chogall,1917,warlock,demonology,70,40,30
Kamorilock,blackhand,1912,warlock,demonology,36,20,16
Dabezdwl,outland,1904,warlock,demonology,54,31,23
Anúki,kazzak,1900,warlock,demonology,25,21,4
Pogbõss,kazzak,1894,warlock,demonology,51,30,21
Outofcurses,earthen-ring,1892,warlock,demonology,59,32,27
Stafar,kazzak,1875,warlock,demonology,60,33,27
Höfmänn,kazzak,1865,warlock,demonology,39,25,14
Адво,howling-fjord,1863,warlock,demonology,53,28,25
Nemwl,draenor,1861,warlock,demonology,54,32,22
Bluh,twisting-nether,1860,warlock,demonology,36,22,14
Dhärc,sanguino,1854,warlock,demonology,54,31,23
Smaúg,archimonde,1851,warlock,demonology,60,28,32
Дёмын,howling-fjord,1850,warlock,demonology,60,30,30
Capsloq,la-croisade-écarlate,1849,warlock,demonology,48,28,20
Höfmänn,grim-batol,1847,warlock,demonology,48,31,17
Динодотз,howling-fjord,1847,warlock,demonology,54,27,27
Purplemonkey,burning-blade,1846,warlock,demonology,29,20,9
Ravendoor,grim-batol,1839,warlock,demonology,58,28,30
Attritiona,stormscale,1838,warlock,demonology,60,32,28
Zouglougou,archimonde,1829,warlock,demonology,48,25,23
Тьмазвёздная,gordunni,1828,warlock,demonology,45,26,19
Benne,stormscale,1825,warlock,demonology,49,31,18
Онлидемон,gordunni,1824,warlock,demonology,44,26,18
Malificus,silvermoon,1823,warlock,demonology,114,67,47
Cellfear,kazzak,1818,warlock,demonology,42,24,18
Onlylock,outland,1817,warlock,demonology,36,26,10
Stankaemayne,blackhand,1817,warlock,demonology,49,29,20
Bualock,tarren-mill,1815,warlock,demonology,36,22,14
Devilfluffy,blackhand,1815,warlock,demonology,59,35,24
Cigänä,archimonde,1815,warlock,demonology,36,19,17
Blackdog,argent-dawn,1814,warlock,demonology,48,23,25
Crathar,kazzak,1809,warlock,demonology,64,32,32
Тёмабиль,gordunni,1807,warlock,demonology,131,71,60
Lúcìfér,stormscale,1806,warlock,demonology,66,34,32
Splicer,eredar,1803,warlock,demonology,49,29,20
Nyotu,antonidas,1802,warlock,demonology,48,25,23
Htaedfo,tarren-mill,1802,warlock,demonology,74,32,42
Dontargetme,draenor,1794,warlock,demonology,36,24,12
Fearrari,ragnaros,1794,warlock,demonology,42,27,15
Shakuroz,frostwolf,1792,warlock,demonology,62,36,26
Malzeva,ravencrest,1784,warlock,demonology,65,29,36
Инфезиус,deathweaver,1776,warlock,demonology,53,29,24
Fiveyearque,sylvanas,1773,warlock,demonology,48,30,18
Catchlock,tarren-mill,1752,warlock,demonology,36,20,16
Dæhli,argent-dawn,1744,warlock,demonology,36,22,14
Храбзар,gordunni,1744,warlock,demonology,76,34,42
Lïñglïñg,twisting-nether,1730,warlock,demonology,30,22,8
Ambitions,hyjal,1728,warlock,demonology,40,24,16
Bonnieparkêr,onyxia,1724,warlock,demonology,30,18,12
Stalowwy,silvermoon,1720,warlock,demonology,78,39,39
Годнодх,gordunni,1716,warlock,demonology,30,18,12
Zelieknight,ysondre,1711,warlock,demonology,54,25,29
Кварий,howling-fjord,1709,warlock,demonology,125,58,67
Шекигами,gordunni,1701,warlock,demonology,36,24,12
Glavy,burning-legion,1699,warlock,demonology,66,36,30
Оброссыш,gordunni,1697,warlock,demonology,30,18,12
Totephia,kazzak,1696,warlock,demonology,72,33,39
Киёкка,howling-fjord,1695,warlock,demonology,54,31,23
Rune,aegwynn,1695,warlock,demonology,52,29,23
Adafbhf,tichondrius,1694,warlock,demonology,35,20,15
Tyrantlol,sylvanas,1686,warlock,demonology,36,23,13
Jinusek,burning-legion,1682,warlock,demonology,43,23,20
Grêenbull,eredar,1680,warlock,demonology,49,27,22
Hellguards,silvermoon,1678,warlock,demonology,36,21,15
Dâedra,argent-dawn,1669,warlock,demonology,42,21,21
Osbaa,bladefist,1668,warlock,demonology,42,22,20
Tjockoloco,tarren-mill,1663,warlock,demonology,86,49,37
Kemel,thrall,1655,warlock,demonology,30,21,9
Niyyu,blackmoore,1654,warlock,demonology,48,22,26
Djshyasiañ,perenolde,1650,warlock,demonology,164,85,79
Utsus,tarren-mill,1645,warlock,demonology,36,23,13
Eleriya,argent-dawn,1639,warlock,demonology,54,27,27
Snackstickz,twisting-nether,1637,warlock,demonology,42,26,16
Tiffyilock,blackrock,1637,warlock,demonology,42,20,22
Erøne,archimonde,1631,warlock,demonology,94,51,43
Shugglock,draenor,1630,warlock,demonology,36,20,16
Dimmybyrger,stormreaver,1627,warlock,demonology,30,17,13
Interceptêr,blackrock,1627,warlock,demonology,42,22,20
Егосяхаос,soulflayer,1627,warlock,demonology,120,61,59
Neuth,draenor,1627,warlock,demonology,50,21,29
Indrâxx,hyjal,1626,warlock,demonology,18,17,1
Malowix,outland,1625,warlock,demonology,36,17,19
Dualla,aegwynn,1623,warlock,demonology,36,17,19
Dasda,defias-brotherhood,1622,warlock,demonology,77,43,34
Firochek,ravencrest,1622,warlock,demonology,36,20,16
Itspoint,draenor,1618,warlock,demonology,53,29,24
Smâûhg,blackrock,1617,warlock,demonology,24,17,7
Hâres,anetheron,1614,warlock,demonology,69,32,37
Proßlock,kazzak,1612,warlock,demonology,33,22,11
Eroszakolock,ragnaros,1611,warlock,demonology,24,17,7
Kody,blackmoore,1609,warlock,demonology,24,17,7
Shuggul,draenor,1606,warlock,demonology,37,22,15
Demonjoker,blackhand,1604,warlock,demonology,51,31,20
Impaler,tarren-mill,1604,warlock,demonology,158,73,85
Havexis,tichondrius,1602,warlock,demonology,42,32,10
Despépêche,garona,1601,warlock,demonology,30,19,11
Vultzbolt,draenor,1601,warlock,demonology,30,19,11
Gemors,ravenholdt,1599,warlock,demonology,60,32,28
Moffguldan,sanguino,1597,warlock,demonology,30,20,10
Nerzhull,stormscale,1596,warlock,demonology,81,43,38
Alphalock,mannoroth,1595,warlock,demonology,33,18,15
Ájszmen,ravencrest,1592,warlock,demonology,36,20,16
Potatowl,ravencrest,1582,warlock,demonology,36,18,18
Бельведерчи,blackscar,1580,warlock,demonology,36,24,12
Darcîa,destromath,1576,warlock,demonology,66,36,30
Épidémie,outland,1569,warlock,demonology,42,17,25
Импака,howling-fjord,1563,warlock,demonology,168,87,81
Altffeer,blackmoore,1561,warlock,demonology,41,25,16
Dotsyoudown,kelthuzad,1560,warlock,demonology,36,18,18
Sedryn,turalyon,1541,warlock,demonology,241,125,116
Ahollic,frostwolf,1535,warlock,demonology,24,16,8
Synthiax,silvermoon,1534,warlock,demonology,24,16,8
Fsandtwo,ravencrest,1534,warlock,demonology,30,16,14
Lokmonji,perenolde,1533,warlock,demonology,30,16,14
Tonin,antonidas,1528,warlock,demonology,41,25,16
Musallat,argent-dawn,1527,warlock,demonology,30,16,14
Deamonsmith,silvermoon,1518,warlock,demonology,36,20,16
Ayóó,doomhammer,1513,warlock,demonology,124,65,59
Эволюционист,gordunni,1511,warlock,demonology,30,17,13
Roedin,tarren-mill,1507,warlock,demonology,90,33,57
Sïlïthuss,ravencrest,1476,warlock,demonology,36,19,17
Solitariøus,arathi,1473,warlock,demonology,30,16,14
Bakýra,dun-modr,1461,warlock,demonology,36,26,10
Шэдоубёрн,soulflayer,1449,warlock,demonology,48,27,21
Нгага,howling-fjord,1443,warlock,demonology,227,111,116
Lankycheese,kazzak,1439,warlock,demonology,24,15,9
Dispeluapls,blackmoore,1439,warlock,demonology,30,15,15
Dominvs,silvermoon,1438,warlock,demonology,40,23,17
Ilarizium,ysondre,1435,warlock,demonology,41,23,18
Kalinowa,burning-legion,1435,warlock,demonology,60,31,29
Nerigo,senjin,1435,warlock,demonology,30,15,15
Weso,grim-batol,1435,warlock,demonology,30,15,15
Silenozz,ragnaros,1434,warlock,demonology,67,38,29
Sineko,twisting-nether,1431,warlock,demonology,78,37,41
Corbiejr,tarren-mill,1425,warlock,demonology,70,29,41
Panic,stormrage,1418,warlock,demonology,42,26,16
Tudii,frostwolf,1401,warlock,demonology,54,32,22
Nimh,azjolnerub,1393,warlock,demonology,33,20,13
Absúrd,turalyon,1390,warlock,demonology,132,75,57
Esgül,draenor,1382,warlock,demonology,29,16,13
Sevastus,argent-dawn,1378,warlock,demonology,72,36,36
Ädarä,cthun,1370,warlock,demonology,36,18,18
Olsel,draenor,1349,warlock,demonology,36,16,20
Dotyboi,tarren-mill,1343,warlock,demonology,18,14,4
Dedalus,zuluhed,1336,warlock,demonology,76,47,29
Summonit,blackmoore,1334,warlock,demonology,24,14,10
Фортэр,ashenvale,1332,warlock,demonology,30,14,16
Gulldan,bloodfeather,1327,warlock,demonology,42,21,21
Rpez,archimonde,1325,warlock,demonology,100,50,50
Иллугис,gordunni,1323,warlock,demonology,30,14,16
Stormblast,azshara,1321,warlock,demonology,30,19,11
Wåfa,kazzak,1318,warlock,demonology,30,17,13
Wítchær,blackhand,1307,warlock,demonology,30,17,13
Erkai,kazzak,1286,warlock,demonology,27,15,12
Гулдарий,howling-fjord,1283,warlock,demonology,45,23,22
Jondi,blackmoore,1274,warlock,demonology,25,15,10
Priszcilla,twisting-nether,1270,warlock,demonology,24,14,10
Инсип,blackscar,1256,warlock,demonology,42,18,24
Mesîkatayut,outland,1247,warlock,demonology,45,24,21
Бриант,gordunni,1245,warlock,demonology,35,14,21
Санявахтовик,blackscar,1244,warlock,demonology,24,13,11
Sanguinis,theradras,1243,warlock,demonology,24,13,11
Джердхаус,fordragon,1242,warlock,demonology,24,13,11
Нэкрил,howling-fjord,1241,warlock,demonology,21,13,8
Стокыч,soulflayer,1241,warlock,demonology,36,13,23
Morgan,jaedenar,1240,warlock,demonology,30,13,17
Felburrn,twisting-nether,1238,warlock,demonology,24,13,11
Tekron,blackhand,1237,warlock,demonology,18,13,5
Чутьчутьзлая,gordunni,1237,warlock,demonology,24,13,11
Расмурът,soulflayer,1201,warlock,demonology,30,13,17
Vorgoth,argent-dawn,1179,warlock,demonology,28,13,15
Valadair,sanguino,1164,warlock,demonology,36,17,19
Scallington,shattered-hand,1152,warlock,demonology,18,12,6
Zehirisalari,twisting-nether,1152,warlock,demonology,18,12,6
Bloodlock,onyxia,1152,warlock,demonology,24,12,12
Benvyx,twisting-nether,1152,warlock,demonology,24,12,12
Zerulian,ragnaros,1151,warlock,demonology,18,12,6
Инфес,deathweaver,1151,warlock,demonology,18,12,6
Мешшугга,howling-fjord,1148,warlock,demonology,24,12,12
Kolskegg,doomhammer,1147,warlock,demonology,30,12,18
Gwl,archimonde,1146,warlock,demonology,24,12,12
Паникс,gordunni,1145,warlock,demonology,24,12,12
Cahoa,archimonde,1139,warlock,demonology,18,12,6
Арон,soulflayer,1119,warlock,demonology,23,12,11
Razzguul,blackmoore,1112,warlock,demonology,22,12,10
Ишла,gordunni,1086,warlock,demonology,29,12,17
Jesez,aegwynn,1056,warlock,demonology,12,11,1
Glooness,burning-legion,1056,warlock,demonology,18,11,7
Adellara,draenor,1056,warlock,demonology,18,11,7
Tamatóax,tarren-mill,1055,warlock,demonology,12,11,1
Khavar,antonidas,1055,warlock,demonology,18,11,7
Cørpse,burning-legion,1055,warlock,demonology,21,12,9
Dàrksoul,thrall,1054,warlock,demonology,18,11,7
Algolagniac,stormscale,1054,warlock,demonology,18,11,7
Zanzarismo,nemesis,1049,warlock,demonology,21,12,9
Forthewin,stormreaver,1042,warlock,demonology,24,11,13
Trellaras,bloodfeather,1028,warlock,demonology,23,11,12
Flocca,archimonde,990,warlock,demonology,20,11,9
Krøl,nemesis,960,warlock,demonology,12,10,2
Yamadea,stormscale,960,warlock,demonology,18,10,8
Oggelock,tarren-mill,960,warlock,demonology,18,10,8
Lonelock,blackrock,960,warlock,demonology,18,10,8
Xenastro,silvermoon,960,warlock,demonology,18,10,8
Демоник,deathguard,960,warlock,demonology,18,10,8
Jopasiski,draenor,960,warlock,demonology,24,10,14
Míkæ,ravencrest,959,warlock,demonology,18,10,8
Greeylock,blackhand,959,warlock,demonology,18,10,8
Abdelkarime,khaz-modan,959,warlock,demonology,18,10,8
Xtyran,blackmoore,959,warlock,demonology,24,10,14
Nécron,ysondre,959,warlock,demonology,24,10,14
Seriasa,blackmoore,959,warlock,demonology,24,10,14
Stormytrumpy,twisting-nether,957,warlock,demonology,21,11,10
Ablas,bladefist,940,warlock,demonology,35,10,25
Fearmydear,alleria,926,warlock,demonology,17,10,7
Acuacx,drakthul,909,warlock,demonology,17,10,7
Rngmåchinêx,ravencrest,896,warlock,demonology,16,10,6
Netcownt,silvermoon,886,warlock,demonology,25,11,14
Migyardondup,exodar,872,warlock,demonology,18,10,8
Yazurí,ravencrest,864,warlock,demonology,12,9,3
Ooroothothz,frostwolf,864,warlock,demonology,12,9,3
Öbsury,hyjal,864,warlock,demonology,12,9,3
Fandirxd,draenor,864,warlock,demonology,18,9,9
Nargøf,outland,864,warlock,demonology,18,9,9
Fedpikkefar,kazzak,864,warlock,demonology,18,9,9
Fîgøk,conseil-des-ombres,864,warlock,demonology,24,9,15
Darksoll,hyjal,864,warlock,demonology,24,9,15
Hellbboy,azjolnerub,863,warlock,demonology,12,9,3
Ashzu,quelthalas,863,warlock,demonology,18,9,9
Nosoulnoprob,sylvanas,863,warlock,demonology,24,9,15
Lunden,drakthul,862,warlock,demonology,18,9,9
Waltrude,conseil-des-ombres,860,warlock,demonology,30,9,21
Lifesteal,auchindoun,858,warlock,demonology,18,9,9
Golborg,draenor,832,warlock,demonology,28,9,19
Анрали,soulflayer,831,warlock,demonology,17,9,8
Azraëlle,drekthar,815,warlock,demonology,15,10,5
Бирел,soulflayer,799,warlock,demonology,16,9,7
Dotosgyörgy,ragnaros,768,warlock,demonology,12,8,4
Topmodelx,eredar,768,warlock,demonology,12,8,4
Котрх,gordunni,768,warlock,demonology,12,8,4
Deaddydoo,kazzak,768,warlock,demonology,12,8,4
Staenkymayne,blackhand,768,warlock,demonology,12,8,4
Xerkh,thrall,768,warlock,demonology,12,8,4
Koldarr,blackmoore,768,warlock,demonology,18,8,10
Djezzick,stormscale,768,warlock,demonology,18,8,10
Idkdot,ravencrest,768,warlock,demonology,18,8,10
Biest,drakthul,768,warlock,demonology,18,8,10
Slockoló,ragnaros,768,warlock,demonology,24,8,16
Tojezlo,drakthul,767,warlock,demonology,12,8,4
Auxi,the-maelstrom,767,warlock,demonology,12,8,4
Sovrìn,blackrock,767,warlock,demonology,12,8,4
Chimera,mugthol,767,warlock,demonology,18,8,10
Guccie,ravencrest,766,warlock,demonology,17,10,7
Zeddy,draenor,766,warlock,demonology,18,8,10
Merzavka,kazzak,765,warlock,demonology,12,8,4
Njutbar,ragnaros,765,warlock,demonology,18,8,10
Ясяшотлав,soulflayer,761,warlock,demonology,22,11,11
Wanderingowl,blackmoore,760,warlock,demonology,12,8,4
Ambralia,blackmoore,755,warlock,demonology,18,8,10
Nedivh,stormscale,751,warlock,demonology,23,8,15
Нафлэпил,gordunni,735,warlock,demonology,17,8,9
Dotwhat,ravencrest,719,warlock,demonology,17,8,9
Lifetap,tarren-mill,703,warlock,demonology,14,8,6
Простоседой,gordunni,703,warlock,demonology,17,8,9
Aldhelm,draenor,701,warlock,demonology,16,8,8
Plâytïmè,stormscale,672,warlock,demonology,12,7,5
Ballerlock,ravencrest,672,warlock,demonology,12,7,5
Louên,dun-modr,672,warlock,demonology,12,7,5
Framelock,draenor,672,warlock,demonology,12,7,5
Shazem,tarren-mill,672,warlock,demonology,12,7,5
Bigbagelbob,archimonde,672,warlock,demonology,12,7,5
Ravenglass,argent-dawn,672,warlock,demonology,12,7,5
Dirtytyrant,sanguino,672,warlock,demonology,12,7,5
Dalamon,draenor,672,warlock,demonology,12,7,5
Fearfearfear,archimonde,672,warlock,demonology,12,7,5
Blekspel,outland,672,warlock,demonology,12,7,5
Ipetsincl,kazzak,672,warlock,demonology,12,7,5
Wiitchdoktor,twisting-nether,672,warlock,demonology,12,7,5
Гвоздяшка,blackscar,672,warlock,demonology,12,7,5
Fearu,kazzak,672,warlock,demonology,18,7,11
Dedobozhe,ravencrest,671,warlock,demonology,12,7,5
Lockaria,zuljin,671,warlock,demonology,12,7,5
Dabulock,blackmoore,671,warlock,demonology,15,8,7
Bewbys,draenor,671,warlock,demonology,24,7,17
Warlockxx,ravencrest,607,warlock,demonology,11,7,4
Kennÿfõx,ysondre,576,warlock,demonology,6,6,0
Bicuriousdad,tarren-mill,576,warlock,demonology,6,6,0
Stafar,outland,576,warlock,demonology,6,6,0
Rikkért,draenor,576,warlock,demonology,6,6,0
Емс,gordunni,576,warlock,demonology,12,6,6
Hamnam,blackrock,576,warlock,demonology,12,6,6
Wacamolymojo,tarren-mill,576,warlock,demonology,12,6,6
Cringetamer,silvermoon,576,warlock,demonology,12,6,6
Nephystø,archimonde,576,warlock,demonology,12,6,6
Rîas,hyjal,576,warlock,demonology,12,6,6
Bibiflexberg,eredar,576,warlock,demonology,12,6,6
Аоепампгодх,howling-fjord,576,warlock,demonology,12,6,6
Элси,howling-fjord,576,warlock,demonology,12,6,6
Gruldran,khaz-modan,576,warlock,demonology,12,6,6
Mustasheen,stormscale,576,warlock,demonology,12,6,6
Jarodshadow,stormscale,576,warlock,demonology,12,6,6
Vîmø,antonidas,576,warlock,demonology,12,6,6
Сладкийпир,soulflayer,576,warlock,demonology,12,6,6
Darcol,archimonde,576,warlock,demonology,12,6,6
Rikmeyzter,burning-blade,576,warlock,demonology,12,6,6
Smallpee,kazzak,576,warlock,demonology,12,6,6
Icò,ravencrest,576,warlock,demonology,18,6,12
Redshíne,hyjal,576,warlock,demonology,18,6,12
Oldasianman,blackrock,576,warlock,demonology,18,6,12
Sublînê,blackmoore,576,warlock,demonology,18,6,12
Deadleth,blackrock,575,warlock,demonology,10,7,3
Profylaxis,arathor,575,warlock,demonology,12,6,6
Xerxia,blackrock,575,warlock,demonology,18,6,12
Truckpunch,defias-brotherhood,575,warlock,demonology,18,6,12
Methmuncher,twisting-nether,574,warlock,demonology,24,6,18
Absurdd,turalyon,568,warlock,demonology,14,9,5
Raez,burning-blade,559,warlock,demonology,17,6,11
Longdickie,ravencrest,480,warlock,demonology,6,5,1
Rektube,sanguino,480,warlock,demonology,6,5,1
Фирвебало,soulflayer,480,warlock,demonology,6,5,1
Froschhaxen,blackhand,480,warlock,demonology,6,5,1
Syntax,blackmoore,480,warlock,demonology,6,5,1
Mércé,stormscale,480,warlock,demonology,6,5,1
Bibilockbert,aegwynn,480,warlock,demonology,6,5,1
Chromex,dentarg,480,warlock,demonology,6,5,1
Köftemec,blackrock,480,warlock,demonology,6,5,1
Törtidotcom,blackrock,480,warlock,demonology,12,5,7
Khâmélÿa,culte-de-la-rive-noire,480,warlock,demonology,12,5,7
Purepkbob,quelthalas,480,warlock,demonology,12,5,7
Morshax,ysondre,480,warlock,demonology,12,5,7
Kukcaryfuk,drakthul,480,warlock,demonology,12,5,7
Alotami,frostwolf,480,warlock,demonology,12,5,7
Durátor,ravencrest,480,warlock,demonology,12,5,7
Døwz,ysondre,480,warlock,demonology,12,5,7
Britneÿ,stormscale,480,warlock,demonology,12,5,7
Morwëk,ysondre,480,warlock,demonology,12,5,7
Wëndigo,stormscale,480,warlock,demonology,12,5,7
Søcraqt,blackrock,480,warlock,demonology,13,5,8
Gúldn,outland,480,warlock,demonology,18,5,13
Brodoh,dun-modr,480,warlock,demonology,18,5,13
Jag,neptulon,479,warlock,demonology,6,5,1
Ezekîél,blackhand,479,warlock,demonology,6,5,1
Cmzdalock,ravencrest,479,warlock,demonology,6,5,1
Аттропа,gordunni,477,warlock,demonology,6,5,1
Lokko,nemesis,415,warlock,demonology,14,5,9
Otemlock,sanguino,384,warlock,demonology,6,4,2
Déemón,draenor,384,warlock,demonology,6,4,2
Nekhar,twisting-nether,384,warlock,demonology,6,4,2
Lamboo,tarren-mill,384,warlock,demonology,6,4,2
Ahollic,antonidas,384,warlock,demonology,6,4,2
Indiasummerx,turalyon,384,warlock,demonology,6,4,2
Zoreck,uldum,384,warlock,demonology,6,4,2
Bankstair,stormscale,384,warlock,demonology,6,4,2
Enviroq,burning-legion,384,warlock,demonology,6,4,2
Kfo,ragnaros,384,warlock,demonology,6,4,2
Llilithh,draenor,384,warlock,demonology,6,4,2
Æternallock,nemesis,384,warlock,demonology,6,4,2
Zzooxx,silvermoon,384,warlock,demonology,6,4,2
Fredé,kazzak,384,warlock,demonology,6,4,2
Devildodo,elune,384,warlock,demonology,6,4,2
Vêzor,twisting-nether,384,warlock,demonology,6,4,2
Devour,magtheridon,384,warlock,demonology,6,4,2
Rövsmärta,ragnaros,384,warlock,demonology,6,4,2
Eatherial,twilights-hammer,384,warlock,demonology,6,4,2
Marador,drakthul,384,warlock,demonology,6,4,2
Bigballerguy,sylvanas,384,warlock,demonology,6,4,2
Chedipes,stormscale,384,warlock,demonology,6,4,2
Tropìcal,grim-batol,384,warlock,demonology,6,4,2
Endherkonk,sanguino,384,warlock,demonology,6,4,2
Nattû,outland,384,warlock,demonology,6,4,2
Demosteaks,thrall,384,warlock,demonology,6,4,2
Куськысь,gordunni,384,warlock,demonology,9,5,4
Zartax,kazzak,384,warlock,demonology,12,4,8
Tuz,blackrock,384,warlock,demonology,12,4,8
Graveshaker,quelthalas,384,warlock,demonology,12,4,8
Acererak,thunderhorn,384,warlock,demonology,12,4,8
Môrgán,draenor,384,warlock,demonology,18,4,14
Millhaus,gorgonnash,384,warlock,demonology,18,4,14
Honetia,ravencrest,367,warlock,demonology,11,4,7
Monroé,hellfire,367,warlock,demonology,11,4,7
Nili,dethecus,351,warlock,demonology,11,4,7
Floriae,argent-dawn,329,warlock,demonology,13,5,8
Mingingclass,stormscale,288,warlock,demonology,6,3,3
Alotadot,ravencrest,288,warlock,demonology,6,3,3
Väladar,sanguino,288,warlock,demonology,6,3,3
Wendetta,stormreaver,288,warlock,demonology,6,3,3
Gulzot,turalyon,288,warlock,demonology,6,3,3
Myliege,kilrogg,288,warlock,demonology,6,3,3
Kosfáce,kazzak,288,warlock,demonology,6,3,3
Парачо,eversong,288,warlock,demonology,6,3,3
Bono,frostwhisper,288,warlock,demonology,6,3,3
Zerx,malganis,288,warlock,demonology,6,3,3
Buserella,eredar,288,warlock,demonology,6,3,3
Лысыйлокоть,soulflayer,288,warlock,demonology,6,3,3
Talindra,stormscale,288,warlock,demonology,6,3,3
Afflimoomoo,tarren-mill,288,warlock,demonology,6,3,3
Waîdo,blackhand,288,warlock,demonology,6,3,3
Sidragasoss,drakthul,288,warlock,demonology,6,3,3
Jetset,moonglade,288,warlock,demonology,6,3,3
Mombo,the-maelstrom,288,warlock,demonology,6,3,3
Локистраик,borean-tundra,288,warlock,demonology,6,3,3
Bionic,eredar,288,warlock,demonology,6,3,3
Alcringe,kazzak,288,warlock,demonology,6,3,3
Matheus,zenedar,288,warlock,demonology,6,3,3
Infernion,stormscale,288,warlock,demonology,6,3,3
Дотботх,howling-fjord,288,warlock,demonology,6,3,3
Suucc,draenor,288,warlock,demonology,6,3,3
Elmîr,blackmoore,288,warlock,demonology,6,3,3
Klaab,hyjal,288,warlock,demonology,6,3,3
Hannens,blackrock,288,warlock,demonology,6,3,3
Opiumers,kazzak,288,warlock,demonology,6,3,3
Horststenzl,blackrock,288,warlock,demonology,6,3,3
Xjms,darksorrow,288,warlock,demonology,6,3,3
Wombsa,blackmoore,288,warlock,demonology,6,3,3
Immaginare,sylvanas,288,warlock,demonology,6,3,3
Кьютсанни,howling-fjord,288,warlock,demonology,6,3,3
Babayagâ,sanguino,288,warlock,demonology,6,3,3
Immolleria,frostmane,288,warlock,demonology,6,3,3
Pipoûc,archimonde,288,warlock,demonology,6,3,3
Xiraq,nathrezim,288,warlock,demonology,6,3,3
Rushkush,ravencrest,288,warlock,demonology,7,3,4
Tunrîda,illidan,288,warlock,demonology,10,3,7
Nâzgrel,tarren-mill,288,warlock,demonology,12,3,9
Ftpete,argent-dawn,288,warlock,demonology,12,3,9
Kamí,sanguino,288,warlock,demonology,12,3,9
Зарлог,soulflayer,288,warlock,demonology,12,3,9
Themengh,stormscale,288,warlock,demonology,12,3,9
Dardec,hyjal,288,warlock,demonology,12,3,9
Cassen,outland,288,warlock,demonology,12,3,9
Hartee,argent-dawn,288,warlock,demonology,18,3,15
Ydidntuwait,ragnaros,288,warlock,demonology,18,3,15
Remthorn,frostmane,287,warlock,demonology,6,3,3
Calypso,korgall,239,warlock,demonology,5,3,2
Vreyax,aegwynn,239,warlock,demonology,5,3,2
Iblis,grim-batol,192,warlock,demonology,6,2,4
Zyréx,eredar,192,warlock,demonology,6,2,4
Kasztyk,grim-batol,192,warlock,demonology,6,2,4
Indifférence,archimonde,192,warlock,demonology,6,2,4
Ukjjkhj,frostmane,192,warlock,demonology,6,2,4
Gammalgubbe,stormscale,192,warlock,demonology,6,2,4
Seldonn,pozzo-delleternità,192,warlock,demonology,6,2,4
Äåäåäåäåäåäå,ravencrest,192,warlock,demonology,6,2,4
Bowti,ravencrest,192,warlock,demonology,6,2,4
Epoku,stormscale,192,warlock,demonology,6,2,4
Flatwolenzy,blackrock,192,warlock,demonology,6,2,4
Кайрана,blackscar,192,warlock,demonology,6,2,4
Жериновсский,gordunni,192,warlock,demonology,6,2,4
Ïvar,ysondre,192,warlock,demonology,6,2,4
Nastychâtøn,ysondre,192,warlock,demonology,6,2,4
Surfingbirdz,ragnaros,192,warlock,demonology,6,2,4
Скверногрик,fordragon,192,warlock,demonology,6,2,4
Mendozaah,kazzak,192,warlock,demonology,6,2,4
Dust,argent-dawn,192,warlock,demonology,6,2,4
Azurma,tarren-mill,192,warlock,demonology,6,2,4
Salvatoríy,outland,192,warlock,demonology,6,2,4
Stromzii,silvermoon,192,warlock,demonology,6,2,4
Shadowvirus,auchindoun,192,warlock,demonology,6,2,4
Cali,ahnqiraj,192,warlock,demonology,6,2,4
Кхадгард,howling-fjord,192,warlock,demonology,6,2,4
Repah,doomhammer,192,warlock,demonology,6,2,4
Irnx,tarren-mill,192,warlock,demonology,6,2,4
Médeâ,ravencrest,192,warlock,demonology,6,2,4
Jkz,blackrock,192,warlock,demonology,6,2,4
Nazw,ravencrest,192,warlock,demonology,6,2,4
Эссминет,soulflayer,192,warlock,demonology,6,2,4
Xoky,argent-dawn,192,warlock,demonology,6,2,4
Bu,zirkel-des-cenarius,192,warlock,demonology,6,2,4
Hypotax,ragnaros,192,warlock,demonology,6,2,4
Fatkkroth,ravencrest,192,warlock,demonology,6,2,4
Sneptics,draenor,192,warlock,demonology,6,2,4
Kumamoto,tarren-mill,192,warlock,demonology,6,2,4
Baradür,sanguino,192,warlock,demonology,6,2,4
Chram,uldum,192,warlock,demonology,7,2,5
Déadwish,ravencrest,192,warlock,demonology,12,2,10
Xanatar,blackhand,192,warlock,demonology,12,2,10
Henriett,ravencrest,192,warlock,demonology,12,2,10
Warlockyo,blackrock,159,warlock,demonology,5,2,3
Letzterlude,thrall,159,warlock,demonology,5,2,3
Militianu,sylvanas,96,warlock,demonology,6,1,5
Tid,burning-legion,96,warlock,demonology,6,1,5
Ðßøhßäøùí,blackmoore,96,warlock,demonology,6,1,5
Divvaa,tarren-mill,96,warlock,demonology,6,1,5
Bolt,stormscale,96,warlock,demonology,6,1,5
Nécromancér,doomhammer,96,warlock,demonology,6,1,5
Árkan,thrall,96,warlock,demonology,6,1,5
Necroless,shadowsong,96,warlock,demonology,6,1,5
Ароматныйх,howling-fjord,96,warlock,demonology,6,1,5
Marann,dun-morogh,96,warlock,demonology,6,1,5
Utuklululu,archimonde,96,warlock,demonology,6,1,5
Кайзершлафен,fordragon,31,warlock,demonology,2,1,1
Infïnitýx,silvermoon,31,warlock,demonology,2,1,1
Loghit,ravencrest,16,warlock,demonology,1,1,0
Mundunugu,sanguino,16,warlock,demonology,1,1,0
Грешъник,gordunni,16,warlock,demonology,1,1,0
Papilena,turalyon,16,warlock,demonology,1,1,0
Inferniøn,ravencrest,2339,warlock,destruction,69,52,17
Lopari,aegwynn,2275,warlock,destruction,106,65,41
Фаерморн,blackscar,2269,warlock,destruction,60,44,16
Canabolic,stormscale,2269,warlock,destruction,90,55,35
Боуман,howling-fjord,2243,warlock,destruction,96,56,40
Acentro,stormscale,2231,warlock,destruction,71,46,25
Yùna,frostwolf,2209,warlock,destruction,72,48,24
Телола,gordunni,2208,warlock,destruction,72,48,24
Absurdity,twisting-nether,2189,warlock,destruction,84,45,39
Rootzlx,ravencrest,2177,warlock,destruction,103,61,42
Dæhli,argent-dawn,2175,warlock,destruction,90,49,41
Bóbtown,stormscale,2159,warlock,destruction,72,45,27
Handicapped,burning-legion,2158,warlock,destruction,78,47,31
Erutaerc,drakthul,2154,warlock,destruction,48,32,16
Anihli,kazzak,2149,warlock,destruction,78,45,33
Tópdogg,twisting-nether,2140,warlock,destruction,54,43,11
Ønlyfans,blackhand,2136,warlock,destruction,72,45,27
Zélroth,argent-dawn,2133,warlock,destruction,90,55,35
Паилка,galakrond,2133,warlock,destruction,123,70,53
Jâzggz,twisting-nether,2130,warlock,destruction,54,37,17
Necromanya,ravencrest,2129,warlock,destruction,120,75,45
Arfdispo,hyjal,2120,warlock,destruction,101,55,46
Snapperz,stormscale,2116,warlock,destruction,90,49,41
Velv,nagrand,2112,warlock,destruction,90,45,45
Рауваскх,howling-fjord,2110,warlock,destruction,53,31,22
Cryzzbad,stormscale,2109,warlock,destruction,36,29,7
Císuh,stormreaver,2108,warlock,destruction,96,56,40
Xeremas,blackrock,2104,warlock,destruction,59,45,14
Lywov,stormscale,2103,warlock,destruction,60,34,26
Артик,gordunni,2101,warlock,destruction,48,37,11
Фримех,soulflayer,2095,warlock,destruction,59,45,14
Bäle,stormreaver,2093,warlock,destruction,84,50,34
Dabzw,twisting-nether,2075,warlock,destruction,67,43,24
Voldby,kazzak,2064,warlock,destruction,66,33,33
Azurma,tarren-mill,2053,warlock,destruction,48,31,17
Простишутках,gordunni,2051,warlock,destruction,48,30,18
Héffer,outland,2044,warlock,destruction,121,80,41
Chaosbuster,magtheridon,2041,warlock,destruction,84,56,28
Кенгарь,howling-fjord,2032,warlock,destruction,90,52,38
Zàkx,silvermoon,2026,warlock,destruction,190,111,79
Влицотьмой,gordunni,2023,warlock,destruction,66,37,29
Creatúre,drakthul,2021,warlock,destruction,36,28,8
Djmcwarlock,kazzak,2020,warlock,destruction,53,32,21
Bualock,sylvanas,2019,warlock,destruction,54,30,24
Felcamino,outland,2019,warlock,destruction,72,36,36
Wldot,ravencrest,2016,warlock,destruction,66,41,25
Geluwu,tarren-mill,2015,warlock,destruction,60,35,25
Ánderxyo,dun-modr,2010,warlock,destruction,36,29,7
Drainsouls,stormscale,2009,warlock,destruction,159,86,73
Кишмякхб,howling-fjord,2008,warlock,destruction,60,32,28
Supergeîl,blackrock,2003,warlock,destruction,60,36,24
Gulwer,blackmoore,1997,warlock,destruction,42,26,16
Vitus,malganis,1995,warlock,destruction,78,48,30
Steckenpferd,blackmoore,1994,warlock,destruction,42,27,15
Shangalar,burning-legion,1994,warlock,destruction,66,40,26
Bigbolt,arathor,1994,warlock,destruction,74,41,33
Ìpen,bloodfeather,1990,warlock,destruction,47,31,16
Asáel,blackrock,1990,warlock,destruction,54,33,21
Corbbolt,drakthul,1989,warlock,destruction,54,36,18
Инферналках,gordunni,1983,warlock,destruction,59,39,20
Hotdoghomie,tarren-mill,1974,warlock,destruction,36,28,8
Кириланскил,gordunni,1974,warlock,destruction,48,30,18
Laedreth,argent-dawn,1972,warlock,destruction,86,52,34
Ffpiiras,dunemaul,1972,warlock,destruction,63,37,26
Whakkx,blackrock,1967,warlock,destruction,42,25,17
Koisk,tarren-mill,1966,warlock,destruction,60,34,26
Gogmorok,dunemaul,1962,warlock,destruction,154,80,74
Zèlêph,archimonde,1961,warlock,destruction,126,80,46
Zarisya,blackmoore,1961,warlock,destruction,48,29,19
Portlock,kazzak,1959,warlock,destruction,66,39,27
Vvj,ravencrest,1959,warlock,destruction,72,39,33
Hladankurac,twisting-nether,1956,warlock,destruction,42,26,16
Malgarøth,tarren-mill,1955,warlock,destruction,60,28,32
Сумракк,gordunni,1954,warlock,destruction,66,35,31
Stefcheto,twilights-hammer,1953,warlock,destruction,72,40,32
Spookytouch,draenor,1947,warlock,destruction,82,44,38
Haedache,tarren-mill,1946,warlock,destruction,36,21,15
Сильвиос,howling-fjord,1943,warlock,destruction,100,49,51
Rexløck,nozdormu,1942,warlock,destruction,75,50,25
Онлидемон,gordunni,1942,warlock,destruction,73,38,35
Ryûsuke,dun-modr,1941,warlock,destruction,36,24,12
Logicdotexé,tarren-mill,1940,warlock,destruction,61,39,22
Nellyvato,eredar,1940,warlock,destruction,54,29,25
Aestheatic,draenor,1938,warlock,destruction,143,77,66
Rhüd,twisting-nether,1934,warlock,destruction,66,38,28
Suprezz,sylvanas,1929,warlock,destruction,60,36,24
Аоепампгодх,howling-fjord,1923,warlock,destruction,74,56,18
Amdead,sylvanas,1919,warlock,destruction,35,28,7
Bewegen,frostwolf,1915,warlock,destruction,48,28,20
Шархихохо,gordunni,1914,warlock,destruction,60,33,27
Legionlockxd,twisting-nether,1910,warlock,destruction,64,33,31
Zoodíac,blackrock,1904,warlock,destruction,48,32,16
Healylockx,stormscale,1904,warlock,destruction,48,28,20
Рашчер,gordunni,1901,warlock,destruction,42,24,18
Rúbs,sylvanas,1897,warlock,destruction,102,55,47
Mxxmmllm,kargath,1896,warlock,destruction,101,62,39
Kaktakto,ravencrest,1895,warlock,destruction,54,30,24
Decimus,darkspear,1893,warlock,destruction,78,47,31
Vregor,twisting-nether,1892,warlock,destruction,36,26,10
Twisted,malganis,1890,warlock,destruction,78,45,33
Juhpz,blackrock,1888,warlock,destruction,52,24,28
Kwoleriker,norgannon,1885,warlock,destruction,58,33,25
Nëismz,hyjal,1884,warlock,destruction,42,25,17
Hânex,ravencrest,1883,warlock,destruction,42,28,14
Мспечень,howling-fjord,1882,warlock,destruction,42,32,10
Bankstair,stormscale,1882,warlock,destruction,30,20,10
Henmur,stormscale,1879,warlock,destruction,64,37,27
Eboyclass,twisting-nether,1875,warlock,destruction,33,23,10
Lhestér,outland,1875,warlock,destruction,45,30,15
Ulora,zirkel-des-cenarius,1875,warlock,destruction,59,33,26
Kumamoto,tarren-mill,1874,warlock,destruction,42,27,15
Kimkold,twisting-nether,1873,warlock,destruction,72,32,40
Ðènnis,tarren-mill,1870,warlock,destruction,42,28,14
Isuckwarlock,aegwynn,1870,warlock,destruction,48,26,22
Djdampening,bloodhoof,1868,warlock,destruction,34,27,7
Dooms,antonidas,1868,warlock,destruction,42,31,11
Lockisbadx,draenor,1866,warlock,destruction,48,26,22
Rohyna,archimonde,1865,warlock,destruction,36,27,9
Djhanzó,outland,1865,warlock,destruction,39,24,15
Fearo,kazzak,1864,warlock,destruction,54,32,22
Sheitana,ysondre,1863,warlock,destruction,60,39,21
Rokkarn,kazzak,1863,warlock,destruction,48,29,19
Makîø,hyjal,1860,warlock,destruction,53,27,26
Блейдап,razuvious,1859,warlock,destruction,54,31,23
Drdoit,blackrock,1859,warlock,destruction,60,31,29
Beebs,aegwynn,1858,warlock,destruction,42,31,11
Homerbamboom,hyjal,1857,warlock,destruction,41,32,9
Chaoscrit,eredar,1856,warlock,destruction,62,37,25
Darksoll,hyjal,1853,warlock,destruction,41,31,10
Vîmø,antonidas,1853,warlock,destruction,59,42,17
Wankdiesel,der-rat-von-dalaran,1853,warlock,destruction,108,54,54
Jawoxoxo,rexxar,1852,warlock,destruction,48,20,28
Tuplajekku,sylvanas,1851,warlock,destruction,59,29,30
Johnylock,draenor,1850,warlock,destruction,116,71,45
Kuckacocucka,outland,1849,warlock,destruction,54,33,21
Themut,draenor,1847,warlock,destruction,76,49,27
Keybump,outland,1847,warlock,destruction,96,60,36
Кобре,howling-fjord,1847,warlock,destruction,42,26,16
Magonyth,ravencrest,1847,warlock,destruction,54,33,21
Noomaca,drakthul,1847,warlock,destruction,60,36,24
Ayperos,tyrande,1847,warlock,destruction,72,38,34
Шрэкс,blackscar,1846,warlock,destruction,42,22,20
Schrimz,blackrock,1844,warlock,destruction,48,24,24
Nekrosd,tarren-mill,1843,warlock,destruction,126,68,58
Fîgøk,conseil-des-ombres,1841,warlock,destruction,72,42,30
Djfearbot,kazzak,1840,warlock,destruction,72,46,26
Attilergg,stormscale,1839,warlock,destruction,32,23,9
Ecoxx,aegwynn,1839,warlock,destruction,48,34,14
Ñila,ravencrest,1839,warlock,destruction,36,23,13
Ripnsew,ravencrest,1839,warlock,destruction,41,26,15
Nayolana,argent-dawn,1839,warlock,destruction,75,35,40
Wällaar,ragnaros,1837,warlock,destruction,60,33,27
Lockchonk,kazzak,1835,warlock,destruction,60,41,19
Sïeur,archimonde,1835,warlock,destruction,107,67,40
Belial,minahonda,1835,warlock,destruction,57,33,24
Блакхен,blackscar,1835,warlock,destruction,42,23,19
Médeâ,ravencrest,1834,warlock,destruction,76,42,34
Válýrá,blackhand,1832,warlock,destruction,41,30,11
Garlan,dun-modr,1832,warlock,destruction,118,64,54
Ftpete,argent-dawn,1831,warlock,destruction,98,58,40
Umbraz,blackmoore,1829,warlock,destruction,48,26,22
Extingul,tarren-mill,1828,warlock,destruction,30,23,7
Someonepro,tarren-mill,1828,warlock,destruction,53,25,28
Deathfløw,draenor,1826,warlock,destruction,42,31,11
Plaguee,outland,1826,warlock,destruction,62,37,25
Hairyporta,blackmoore,1826,warlock,destruction,95,55,40
Freddaxd,outland,1825,warlock,destruction,52,33,19
Соргосор,gordunni,1825,warlock,destruction,53,30,23
Worse,kazzak,1823,warlock,destruction,48,29,19
Maderto,burning-legion,1823,warlock,destruction,185,101,84
Killáksi,ravencrest,1821,warlock,destruction,42,26,16
Mocha,ravencrest,1819,warlock,destruction,48,31,17
Ethiq,blackrock,1818,warlock,destruction,30,19,11
Srkzlol,durotan,1817,warlock,destruction,66,35,31
Alcringe,kazzak,1816,warlock,destruction,158,90,68
Matsuei,tarren-mill,1816,warlock,destruction,48,23,25
Louloudots,ragnaros,1815,warlock,destruction,36,22,14
Тьмазвёздная,gordunni,1814,warlock,destruction,42,31,11
Кейкегенкай,gordunni,1814,warlock,destruction,69,40,29
Nemwl,draenor,1814,warlock,destruction,66,31,35
Kamoriwl,blackhand,1813,warlock,destruction,30,19,11
Asbest,blackrock,1813,warlock,destruction,48,28,20
Whisperer,defias-brotherhood,1812,warlock,destruction,54,29,25
Smaúg,archimonde,1811,warlock,destruction,69,33,36
Looneytoonz,blackrock,1810,warlock,destruction,48,31,17
Gregwyn,hellscream,1809,warlock,destruction,24,19,5
Cujo,draenor,1807,warlock,destruction,48,29,19
Mangolicious,twisting-nether,1807,warlock,destruction,54,28,26
Tikondrus,ravencrest,1806,warlock,destruction,24,19,5
Rûttna,kazzak,1806,warlock,destruction,53,27,26
Pumpelumpe,twisting-nether,1806,warlock,destruction,45,20,25
Yøshinø,wildhammer,1805,warlock,destruction,48,36,12
Visceris,ravencrest,1804,warlock,destruction,36,19,17
Laolife,twisting-nether,1803,warlock,destruction,60,30,30
Ertogrul,draenor,1802,warlock,destruction,24,19,5
Richerdgir,ravencrest,1802,warlock,destruction,39,25,14
Glooness,burning-legion,1802,warlock,destruction,42,22,20
Kerídiin,twisting-nether,1801,warlock,destruction,42,23,19
Infý,ravencrest,1800,warlock,destruction,38,25,13
Skrana,kazzak,1800,warlock,destruction,65,39,26
Tschapatalpi,blackhand,1795,warlock,destruction,52,27,25
Robertóó,burning-legion,1792,warlock,destruction,64,34,30
Ërîkå,ravencrest,1785,warlock,destruction,99,59,40
Doodle,the-maelstrom,1785,warlock,destruction,60,34,26
Påsqúåls,ravencrest,1783,warlock,destruction,36,22,14
Knoxwhite,stormscale,1781,warlock,destruction,42,28,14
Orgebixx,blackmoore,1781,warlock,destruction,42,26,16
Nògg,frostwhisper,1780,warlock,destruction,30,21,9
Rockbèll,blackmoore,1775,warlock,destruction,30,22,8
Kikeri,blackhand,1775,warlock,destruction,42,26,16
Ispankmysuc,korgall,1775,warlock,destruction,51,31,20
Dualla,aegwynn,1774,warlock,destruction,54,33,21
Crse,antonidas,1772,warlock,destruction,79,52,27
Immaginare,sylvanas,1772,warlock,destruction,54,32,22
Demoner,tarren-mill,1769,warlock,destruction,156,90,66
Тагочи,gordunni,1765,warlock,destruction,44,26,18
Wintheirl,argent-dawn,1765,warlock,destruction,96,54,42
Демоник,deathguard,1763,warlock,destruction,42,24,18
Khoug,blackmoore,1758,warlock,destruction,48,26,22
Slytherim,stormscale,1757,warlock,destruction,75,49,26
Vmorghuliss,sanguino,1757,warlock,destruction,84,38,46
Èlton,tarren-mill,1756,warlock,destruction,72,42,30
Dogoon,sylvanas,1756,warlock,destruction,83,48,35
Mønarch,argent-dawn,1755,warlock,destruction,67,40,27
Silmerion,twilights-hammer,1751,warlock,destruction,48,30,18
Хирацука,howling-fjord,1749,warlock,destruction,45,31,14
Mércé,stormscale,1748,warlock,destruction,30,22,8
Якурюимнепох,gordunni,1748,warlock,destruction,77,42,35
Kivilock,dun-modr,1745,warlock,destruction,60,36,24
Madridistaß,outland,1744,warlock,destruction,54,27,27
Bianchii,stormscale,1743,warlock,destruction,27,20,7
Fizzydark,malganis,1743,warlock,destruction,48,26,22
Ícekíss,hyjal,1742,warlock,destruction,30,21,9
Jegfaller,wildhammer,1740,warlock,destruction,177,90,87
Ванадий,soulflayer,1739,warlock,destruction,47,23,24
Brainac,blackrock,1736,warlock,destruction,30,19,11
Взорг,soulflayer,1736,warlock,destruction,60,30,30
Sneptics,draenor,1734,warlock,destruction,115,73,42
Dotalike,kazzak,1734,warlock,destruction,42,22,20
Десло,thermaplugg,1731,warlock,destruction,42,25,17
Upsahl,twisting-nether,1729,warlock,destruction,110,61,49
Айхопъюдай,blackscar,1724,warlock,destruction,30,18,12
Motcha,kazzak,1724,warlock,destruction,30,18,12
Olsel,draenor,1723,warlock,destruction,35,24,11
Dersdog,twisting-nether,1723,warlock,destruction,28,19,9
Killerbolt,blackmoore,1720,warlock,destruction,42,28,14
Бжк,gordunni,1717,warlock,destruction,54,31,23
Rivmuu,argent-dawn,1716,warlock,destruction,66,42,24
Variu,blackhand,1716,warlock,destruction,95,58,37
Öbsury,hyjal,1715,warlock,destruction,43,23,20
Büm,kazzak,1715,warlock,destruction,48,24,24
Ràzek,kazzak,1712,warlock,destruction,77,38,39
Carelock,chamber-of-aspects,1709,warlock,destruction,24,18,6
Boumbye,ysondre,1707,warlock,destruction,38,23,15
Junakot,silvermoon,1706,warlock,destruction,30,18,12
Barneyboi,tarren-mill,1704,warlock,destruction,53,38,15
Laokoon,blackmoore,1702,warlock,destruction,24,18,6
Bàbyløck,archimonde,1702,warlock,destruction,46,28,18
Cencible,twisting-nether,1702,warlock,destruction,60,34,26
Xunzu,drakthul,1702,warlock,destruction,42,18,24
Ganjubass,tarren-mill,1698,warlock,destruction,36,23,13
Kenachaos,twisting-nether,1698,warlock,destruction,77,45,32
Depressedkid,ravencrest,1698,warlock,destruction,42,23,19
Twiseqtt,stormscale,1697,warlock,destruction,30,18,12
Ilovebronko,blackrock,1697,warlock,destruction,47,28,19
Porchpirate,draenor,1695,warlock,destruction,42,22,20
Kerway,outland,1694,warlock,destruction,48,26,22
Sargus,drakthul,1692,warlock,destruction,68,35,33
Hellguards,silvermoon,1692,warlock,destruction,48,24,24
Таксидермия,gordunni,1691,warlock,destruction,49,29,20
Fearfearfear,archimonde,1690,warlock,destruction,60,27,33
Kiwibob,defias-brotherhood,1688,warlock,destruction,47,27,20
Véstheim,saurfang,1685,warlock,destruction,48,29,19
Kayloo,archimonde,1685,warlock,destruction,30,18,12
Ôlo,rajaxx,1684,warlock,destruction,36,23,13
Fredé,kazzak,1684,warlock,destruction,47,24,23
Fearlessgødx,ravencrest,1683,warlock,destruction,64,35,29
Delumia,tarren-mill,1680,warlock,destruction,78,42,36
Raepist,terokkar,1679,warlock,destruction,42,25,17
Sad,lightnings-blade,1677,warlock,destruction,30,18,12
Juppi,blackrock,1677,warlock,destruction,96,56,40
Whiteðevil,draenor,1677,warlock,destruction,36,21,15
Whøîäm,kazzak,1676,warlock,destruction,30,22,8
Acidmvp,ravencrest,1676,warlock,destruction,72,38,34
Feardotbye,stormscale,1675,warlock,destruction,27,18,9
Opiumers,kazzak,1674,warlock,destruction,53,28,25
Wåfa,kazzak,1673,warlock,destruction,24,18,6
Dogdrakex,tarren-mill,1672,warlock,destruction,34,20,14
Zloezlo,ravencrest,1670,warlock,destruction,96,54,42
Killning,medivh,1670,warlock,destruction,78,42,36
Tàkaz,drekthar,1669,warlock,destruction,52,31,21
Колодун,gordunni,1669,warlock,destruction,36,20,16
Boltzer,archimonde,1668,warlock,destruction,36,23,13
Yukokotier,archimonde,1667,warlock,destruction,66,38,28
Ðemonsoul,stormscale,1667,warlock,destruction,78,36,42
Rêctûmsêêkêr,ravencrest,1664,warlock,destruction,36,19,17
Dotshok,aegwynn,1664,warlock,destruction,42,22,20
Stromzii,silvermoon,1664,warlock,destruction,54,27,27
Bono,frostwhisper,1663,warlock,destruction,47,29,18
Aajora,malganis,1660,warlock,destruction,72,47,25
Limity,nozdormu,1660,warlock,destruction,42,24,18
Áutísm,silvermoon,1658,warlock,destruction,72,41,31
Chaozvx,kazzak,1655,warlock,destruction,24,18,6
Edrahil,lordaeron,1653,warlock,destruction,48,29,19
Magonyth,tarren-mill,1652,warlock,destruction,31,22,9
Ceu,tarren-mill,1651,warlock,destruction,27,19,8
Kaspersdame,ravencrest,1650,warlock,destruction,47,24,23
Psýcholoc,kazzak,1648,warlock,destruction,38,25,13
Røiheenøk,archimonde,1648,warlock,destruction,102,47,55
Boltilicious,kazzak,1646,warlock,destruction,36,21,15
Sleethy,destromath,1642,warlock,destruction,36,20,16
Quarimathras,antonidas,1642,warlock,destruction,48,25,23
Shérlock,ravencrest,1640,warlock,destruction,42,22,20
Diablist,kazzak,1638,warlock,destruction,42,23,19
Shádóws,nagrand,1637,warlock,destruction,50,29,21
Hafufxd,runetotem,1635,warlock,destruction,24,21,3
Htaedfo,tarren-mill,1634,warlock,destruction,90,41,49
Amited,drakthul,1633,warlock,destruction,36,23,13
Bónz,outland,1630,warlock,destruction,30,17,13
Kasualdot,stormscale,1629,warlock,destruction,24,17,7
Hebbxw,kazzak,1629,warlock,destruction,42,24,18
Telodotto,nemesis,1629,warlock,destruction,30,17,13
Xfz,stormscale,1629,warlock,destruction,30,17,13
Порртвейн,howling-fjord,1628,warlock,destruction,29,18,11
Koldarr,blackmoore,1627,warlock,destruction,46,26,20
Litox,twisting-nether,1627,warlock,destruction,63,32,31
Rakshazza,eredar,1626,warlock,destruction,48,28,20
Dótstuff,draenor,1625,warlock,destruction,30,17,13
Zarastro,sunstrider,1625,warlock,destruction,39,21,18
Isodjdojk,ravencrest,1624,warlock,destruction,18,17,1
Armellixd,dun-modr,1624,warlock,destruction,42,20,22
Pørtal,aggra-português,1622,warlock,destruction,30,17,13
Alphazero,zuluhed,1621,warlock,destruction,35,19,16
Essealaes,stormscale,1621,warlock,destruction,35,18,17
Kìmar,amanthul,1620,warlock,destruction,78,42,36
Beåtrìce,archimonde,1620,warlock,destruction,57,28,29
Elyö,dalaran,1620,warlock,destruction,71,28,43
Reeween,argent-dawn,1619,warlock,destruction,30,18,12
Evylock,draenor,1619,warlock,destruction,30,17,13
Nerfbolts,archimonde,1615,warlock,destruction,24,17,7
Laciewaifu,silvermoon,1615,warlock,destruction,36,20,16
Biest,drakthul,1615,warlock,destruction,36,17,19
Shadock,scarshield-legion,1614,warlock,destruction,24,17,7
Xuthil,korgall,1614,warlock,destruction,48,25,23
Väladar,sanguino,1614,warlock,destruction,35,18,17
Nherthul,sanguino,1611,warlock,destruction,84,44,40
Tjl,kazzak,1611,warlock,destruction,35,17,18
Hongkonger,kazzak,1610,warlock,destruction,126,69,57
Meatbot,tarren-mill,1609,warlock,destruction,46,31,15
Lockyswag,draenor,1609,warlock,destruction,66,37,29
Badguldan,blackmoore,1609,warlock,destruction,39,20,19
Nybbx,frostmane,1609,warlock,destruction,90,41,49
Esmuel,argent-dawn,1608,warlock,destruction,71,43,28
Ketamol,ravencrest,1607,warlock,destruction,42,24,18
Azthral,nemesis,1607,warlock,destruction,124,64,60
Ðîâblô,silvermoon,1606,warlock,destruction,41,22,19
Banishedone,stormreaver,1605,warlock,destruction,74,43,31
Rotinhell,kazzak,1605,warlock,destruction,64,33,31
Dreamnyâsha,tarren-mill,1603,warlock,destruction,42,19,23
Çamille,ulduar,1602,warlock,destruction,34,20,14
Xtleonidas,uldum,1602,warlock,destruction,78,41,37
Flawzo,blackmoore,1601,warlock,destruction,30,19,11
Skrikipanik,kazzak,1601,warlock,destruction,36,21,15
Despayr,tarren-mill,1601,warlock,destruction,42,19,23
Ignittes,ragnaros,1599,warlock,destruction,30,21,9
Kenthal,nemesis,1599,warlock,destruction,57,28,29
Vultzbolt,draenor,1596,warlock,destruction,60,35,25
Nøl,sargeras,1596,warlock,destruction,279,141,138
Malame,hyjal,1593,warlock,destruction,42,22,20
Ajgreedyy,grim-batol,1586,warlock,destruction,30,18,12
Réxz,ravencrest,1586,warlock,destruction,72,36,36
Dödkärringx,auchindoun,1585,warlock,destruction,30,19,11
Mallevs,outland,1585,warlock,destruction,36,20,16
Bolt,stormscale,1584,warlock,destruction,46,32,14
Isata,ravencrest,1584,warlock,destruction,48,30,18
Kenjix,blackrock,1584,warlock,destruction,48,20,28
Deezbolts,kazzak,1582,warlock,destruction,30,18,12
Døtàndrun,archimonde,1582,warlock,destruction,30,17,13
Plamena,neptulon,1579,warlock,destruction,37,26,11
Wewondak,drakthul,1578,warlock,destruction,38,24,14
Ludé,eredar,1577,warlock,destruction,66,32,34
Aloof,outland,1574,warlock,destruction,139,74,65
Ánárchy,stormscale,1572,warlock,destruction,42,22,20
Spoíl,tarren-mill,1571,warlock,destruction,48,27,21
Ghachi,draenor,1571,warlock,destruction,36,18,18
Plâytïmè,stormscale,1570,warlock,destruction,36,18,18
Noahh,kazzak,1567,warlock,destruction,83,51,32
Gimlidota,tarren-mill,1565,warlock,destruction,59,35,24
Kerthan,malorne,1563,warlock,destruction,42,29,13
Cmdxo,malganis,1556,warlock,destruction,42,18,24
Boltonez,outland,1555,warlock,destruction,36,18,18
Forcas,archimonde,1551,warlock,destruction,42,25,17
Белвет,blackscar,1550,warlock,destruction,51,25,26
Nijva,silvermoon,1550,warlock,destruction,36,17,19
Abbzey,tarren-mill,1549,warlock,destruction,36,18,18
Jinxme,tarren-mill,1547,warlock,destruction,36,22,14
Pprwl,tarren-mill,1547,warlock,destruction,66,37,29
Dzey,drakthul,1546,warlock,destruction,63,35,28
Kamí,sanguino,1544,warlock,destruction,41,20,21
Chaøs,thrall,1543,warlock,destruction,24,19,5
Bazoo,nathrezim,1540,warlock,destruction,48,22,26
Lysanruth,la-croisade-écarlate,1537,warlock,destruction,60,28,32
Героуд,howling-fjord,1536,warlock,destruction,58,35,23
Spõk,ysondre,1536,warlock,destruction,101,55,46
Rawsauce,outland,1535,warlock,destruction,18,16,2
Senkai,kelthuzad,1535,warlock,destruction,24,16,8
Faermorn,kazzak,1535,warlock,destruction,24,16,8
Quickccast,draenor,1535,warlock,destruction,64,38,26
Dsï,outland,1534,warlock,destruction,30,16,14
Zoh,archimonde,1534,warlock,destruction,51,26,25
Höfmänn,kazzak,1532,warlock,destruction,49,32,17
Гивмисоул,soulflayer,1531,warlock,destruction,24,16,8
Tehkorrum,archimonde,1531,warlock,destruction,30,16,14
Napoloen,kazzak,1530,warlock,destruction,30,16,14
Aoea,draenor,1529,warlock,destruction,24,16,8
Felcollíns,ravencrest,1529,warlock,destruction,24,16,8
Danidelarge,aegwynn,1529,warlock,destruction,40,18,22
Varaxxis,twisting-nether,1528,warlock,destruction,30,16,14
Ltheory,aegwynn,1528,warlock,destruction,36,19,17
Asilock,eredar,1527,warlock,destruction,24,16,8
Zoradiale,twisting-nether,1527,warlock,destruction,30,18,12
Nospamcliqu,ysondre,1527,warlock,destruction,30,16,14
Murdee,kazzak,1526,warlock,destruction,42,16,26
Shaterz,dun-modr,1524,warlock,destruction,18,16,2
Garbageclass,outland,1523,warlock,destruction,30,16,14
Bisacodyl,outland,1521,warlock,destruction,101,53,48
Kognah,defias-brotherhood,1518,warlock,destruction,24,16,8
Veracruza,draenor,1516,warlock,destruction,89,45,44
Belastiz,blackmoore,1510,warlock,destruction,24,16,8
Atraped,zuljin,1507,warlock,destruction,84,45,39
Cørleen,eredar,1507,warlock,destruction,52,20,32
Tóuché,aegwynn,1505,warlock,destruction,42,20,22
Дэнаа,fordragon,1504,warlock,destruction,42,18,24
Sickening,twilights-hammer,1502,warlock,destruction,31,23,8
Kïng,elune,1498,warlock,destruction,48,25,23
Naemys,archimonde,1496,warlock,destruction,27,21,6
Interceptêr,blackrock,1496,warlock,destruction,36,18,18
Tzeeñtch,tarren-mill,1496,warlock,destruction,47,22,25
Blackiouz,stormscale,1495,warlock,destruction,48,19,29
Trainindummy,ravencrest,1494,warlock,destruction,23,19,4
Warlocat,the-maelstrom,1493,warlock,destruction,72,34,38
Спаводах,soulflayer,1486,warlock,destruction,23,16,7
Xârtôr,blackrock,1477,warlock,destruction,102,59,43
Demonkïng,archimonde,1477,warlock,destruction,54,31,23
Deathscréam,burning-legion,1477,warlock,destruction,72,34,38
Иванфаков,soulflayer,1475,warlock,destruction,29,17,12
Samyoung,kazzak,1470,warlock,destruction,60,35,25
Diablotiin,hyjal,1470,warlock,destruction,78,41,37
Маларгас,soulflayer,1469,warlock,destruction,54,31,23
Noxsix,gorgonnash,1465,warlock,destruction,48,26,22
Holaw,tarren-mill,1464,warlock,destruction,84,41,43
Алхун,razuvious,1463,warlock,destruction,30,17,13
Datendariza,kazzak,1462,warlock,destruction,38,20,18
Chaosprophet,argent-dawn,1459,warlock,destruction,32,18,14
Колдунишка,fordragon,1458,warlock,destruction,30,17,13
Aleê,twisting-nether,1454,warlock,destruction,47,23,24
Untactful,tarren-mill,1452,warlock,destruction,48,31,17
Achluophobiå,ravencrest,1451,warlock,destruction,25,16,9
Wicherson,burning-legion,1451,warlock,destruction,37,18,19
Çhãøsførÿã,blackmoore,1448,warlock,destruction,84,42,42
Czx,twisting-nether,1447,warlock,destruction,30,18,12
Импака,howling-fjord,1445,warlock,destruction,52,27,25
Lockybàlboa,tarren-mill,1443,warlock,destruction,30,19,11
Мицуру,howling-fjord,1443,warlock,destruction,30,19,11
Stürmer,thrall,1443,warlock,destruction,42,23,19
Bfaexpert,ravencrest,1440,warlock,destruction,18,15,3
Trickyy,azjolnerub,1440,warlock,destruction,30,20,10
Unrealia,hyjal,1440,warlock,destruction,36,19,17
Ignorantduck,sunstrider,1440,warlock,destruction,39,19,20
Kitchiarû,uldaman,1437,warlock,destruction,24,15,9
Wester,blackmoore,1435,warlock,destruction,30,15,15
Calli,blackrock,1432,warlock,destruction,22,16,6
Dexterr,sylvanas,1432,warlock,destruction,62,36,26
Tajit,eredar,1432,warlock,destruction,30,15,15
Nedivh,stormscale,1432,warlock,destruction,35,17,18
Slëydark,sanguino,1431,warlock,destruction,24,15,9
Manhart,burning-legion,1431,warlock,destruction,24,15,9
Nitmoredots,dun-modr,1427,warlock,destruction,24,15,9
Nerzhull,stormscale,1427,warlock,destruction,115,55,60
Lewdrumpslap,kazzak,1425,warlock,destruction,42,28,14
Shufflous,ghostlands,1424,warlock,destruction,28,16,12
Asmonmald,stormscale,1424,warlock,destruction,70,36,34
Sesoumaru,azshara,1424,warlock,destruction,42,16,26
Thugsupreme,ravencrest,1422,warlock,destruction,36,19,17
Ablas,bladefist,1421,warlock,destruction,118,53,65
Kosfáce,kazzak,1420,warlock,destruction,44,19,25
Saffíe,ravencrest,1417,warlock,destruction,34,16,18
Dreadnogg,tarren-mill,1416,warlock,destruction,52,26,26
Nekros,archimonde,1415,warlock,destruction,24,17,7
Veoxohr,argent-dawn,1411,warlock,destruction,63,41,22
Frilante,terokkar,1410,warlock,destruction,33,24,9
Davyjonessx,twisting-nether,1409,warlock,destruction,44,17,27
Kumas,hyjal,1406,warlock,destruction,30,16,14
Zlohell,drakthul,1405,warlock,destruction,48,30,18
Obrusik,burning-legion,1405,warlock,destruction,34,15,19
Sinsemilla,turalyon,1404,warlock,destruction,29,19,10
Моргоника,howling-fjord,1403,warlock,destruction,42,15,27
Peardrax,draenor,1402,warlock,destruction,24,15,9
Voidislife,alakir,1402,warlock,destruction,99,49,50
Nàughty,ragnaros,1398,warlock,destruction,30,15,15
Грань,ashenvale,1396,warlock,destruction,102,53,49
Zivalelia,silvermoon,1389,warlock,destruction,102,49,53
Blackjackk,tarren-mill,1372,warlock,destruction,48,19,29
Nibblez,shadowsong,1369,warlock,destruction,40,22,18
Qaripidia,ravencrest,1368,warlock,destruction,28,15,13
Voltadol,dun-modr,1368,warlock,destruction,42,18,24
Fêars,blackrock,1364,warlock,destruction,40,25,15
Pipêz,blackmoore,1364,warlock,destruction,29,18,11
Faro,trollbane,1364,warlock,destruction,60,22,38
Vakgu,blackmoore,1362,warlock,destruction,41,25,16
Zeddy,draenor,1362,warlock,destruction,30,17,13
Strikeførce,ravencrest,1361,warlock,destruction,23,15,8
Gricorby,drakthul,1360,warlock,destruction,23,16,7
Salazaros,die-silberne-hand,1360,warlock,destruction,30,15,15
Сатенекс,soulflayer,1358,warlock,destruction,47,28,19
Äsmødée,dalaran,1357,warlock,destruction,48,29,19
Запрещаю,galakrond,1353,warlock,destruction,36,19,17
Wedlock,stormscale,1345,warlock,destruction,42,23,19
Drututt,the-maelstrom,1344,warlock,destruction,24,14,10
Isata,blackhand,1343,warlock,destruction,24,14,10
Anthraxus,argent-dawn,1343,warlock,destruction,24,14,10
Setyouinfear,ravencrest,1343,warlock,destruction,30,14,16
Инсинирейтх,gordunni,1342,warlock,destruction,18,14,4
Alphå,blackmoore,1340,warlock,destruction,18,14,4
Tsumde,dalaran,1340,warlock,destruction,38,22,16
Dìablò,sylvanas,1339,warlock,destruction,36,24,12
Likeqtz,thrall,1339,warlock,destruction,24,14,10
Dimmybyrger,stormreaver,1339,warlock,destruction,30,14,16
Shaxlock,draenor,1338,warlock,destruction,46,21,25
Zetsubo,drakthul,1337,warlock,destruction,28,15,13
Кварий,howling-fjord,1337,warlock,destruction,36,14,22
Anomen,sanguino,1334,warlock,destruction,30,14,16
Kasuni,sanguino,1332,warlock,destruction,30,14,16
Rustos,ravencrest,1331,warlock,destruction,24,14,10
Беллулар,howling-fjord,1331,warlock,destruction,24,14,10
Ínsidióus,tarren-mill,1329,warlock,destruction,24,14,10
Vegetita,stormscale,1329,warlock,destruction,63,35,28
Chram,uldum,1328,warlock,destruction,36,25,11
Wilog,silvermoon,1327,warlock,destruction,24,14,10
Chickoz,eredar,1321,warlock,destruction,49,31,18
Üserper,chamber-of-aspects,1319,warlock,destruction,47,18,29
Soulgünter,blackmoore,1317,warlock,destruction,34,23,11
Tuz,blackrock,1316,warlock,destruction,90,40,50
Rottend,aggra-português,1314,warlock,destruction,47,21,26
Ghostfiend,tarren-mill,1313,warlock,destruction,21,15,6
Vicktorious,stormscale,1312,warlock,destruction,42,20,22
Ryurans,cthun,1310,warlock,destruction,92,45,47
Worgonzolâ,madmortem,1307,warlock,destruction,24,17,7
Unkash,zuljin,1302,warlock,destruction,47,26,21
Lodem,darksorrow,1298,warlock,destruction,36,15,21
Kaedinx,twisting-nether,1297,warlock,destruction,187,91,96
Terris,khaz-modan,1294,warlock,destruction,45,22,23
Skruios,anetheron,1290,warlock,destruction,34,16,18
Azrail,anubarak,1290,warlock,destruction,66,31,35
Valcan,ragnaros,1288,warlock,destruction,43,21,22
Sorxez,thrall,1286,warlock,destruction,36,16,20
Märtas,burning-blade,1283,warlock,destruction,29,14,15
Ocaya,kazzak,1275,warlock,destruction,30,16,14
Nopower,dun-morogh,1273,warlock,destruction,23,15,8
Andtheysay,outland,1272,warlock,destruction,32,16,16
Sovrìn,blackrock,1264,warlock,destruction,20,14,6
Pookabee,ravencrest,1263,warlock,destruction,30,14,16
Pensiblesie,runetotem,1251,warlock,destruction,132,62,70
Anderxyo,sanguino,1248,warlock,destruction,18,13,5
Twork,tarren-mill,1248,warlock,destruction,24,13,11
Славеномен,howling-fjord,1248,warlock,destruction,93,42,51
Xxjz,ravencrest,1247,warlock,destruction,24,13,11
Osîrîs,aegwynn,1247,warlock,destruction,24,13,11
Nyiks,blackhand,1247,warlock,destruction,24,13,11
Slavecry,silvermoon,1246,warlock,destruction,18,13,5
Artys,tarren-mill,1246,warlock,destruction,18,13,5
Fiveyearque,sylvanas,1246,warlock,destruction,18,13,5
Kwoh,saurfang,1246,warlock,destruction,24,13,11
Schøkøbasher,blackrock,1245,warlock,destruction,24,13,11
Todesgurke,alleria,1245,warlock,destruction,24,13,11
Slf,the-maelstrom,1245,warlock,destruction,30,13,17
Jisera,kiljaeden,1245,warlock,destruction,30,13,17
Krachol,emeriss,1244,warlock,destruction,24,13,11
Alxor,archimonde,1243,warlock,destruction,24,13,11
Demoz,sanguino,1243,warlock,destruction,52,27,25
Profesorr,defias-brotherhood,1243,warlock,destruction,30,13,17
Berkobaggins,ravencrest,1242,warlock,destruction,24,13,11
Zeinth,sanguino,1241,warlock,destruction,18,13,5
Гупперлок,howling-fjord,1238,warlock,destruction,24,13,11
Кулутха,soulflayer,1237,warlock,destruction,18,13,5
Scrim,laughing-skull,1236,warlock,destruction,20,14,6
Чиназис,gordunni,1235,warlock,destruction,66,30,36
Sirmic,hyjal,1235,warlock,destruction,30,13,17
Chaoxz,outland,1231,warlock,destruction,18,13,5
Инсип,blackscar,1230,warlock,destruction,24,14,10
Jobbymancer,twisting-nether,1225,warlock,destruction,30,18,12
Onetwobolt,archimonde,1222,warlock,destruction,30,13,17
Lokajci,outland,1217,warlock,destruction,25,15,10
Westfaliu,blackhand,1217,warlock,destruction,66,24,42
Guntok,tarren-mill,1211,warlock,destruction,37,22,15
Гулдас,thermaplugg,1209,warlock,destruction,36,18,18
Symbiosis,kazzak,1207,warlock,destruction,24,13,11
Felbunni,silvermoon,1205,warlock,destruction,49,21,28
Nerokin,blackrock,1198,warlock,destruction,24,18,6
Bluefungirl,stormscale,1197,warlock,destruction,17,13,4
Карьерщица,booty-bay,1197,warlock,destruction,30,15,15
Rizzbolt,ravencrest,1195,warlock,destruction,47,21,26
Emoriy,blackmoore,1190,warlock,destruction,64,34,30
Rackare,darksorrow,1187,warlock,destruction,21,13,8
Ayóó,doomhammer,1187,warlock,destruction,65,36,29
Neetlock,suramar,1185,warlock,destruction,30,14,16
Sylrathas,burning-legion,1184,warlock,destruction,58,30,28
Fromfuneral,anetheron,1180,warlock,destruction,65,42,23
Kaeos,ravencrest,1176,warlock,destruction,24,15,9
Lokko,nemesis,1173,warlock,destruction,24,14,10
Lovrog,twisting-nether,1169,warlock,destruction,21,13,8
Thorenss,medivh,1164,warlock,destruction,36,15,21
Vulgrim,kirin-tor,1162,warlock,destruction,33,15,18
Artyrus,burning-legion,1157,warlock,destruction,54,27,27
Exitlock,thrall,1152,warlock,destruction,12,12,0
Rmpfarmer,kazzak,1152,warlock,destruction,18,12,6
Soundmagic,silvermoon,1152,warlock,destruction,18,12,6
Ekàti,ravencrest,1152,warlock,destruction,24,12,12
Ниезвестнно,soulflayer,1152,warlock,destruction,24,12,12
Teiser,nemesis,1152,warlock,destruction,24,12,12
Консидёро,gordunni,1152,warlock,destruction,30,12,18
Leman,sylvanas,1151,warlock,destruction,18,12,6
Nutyx,twisting-nether,1151,warlock,destruction,18,12,6
Marador,drakthul,1151,warlock,destruction,18,12,6
Fluugew,tarren-mill,1151,warlock,destruction,24,12,12
Mohihi,ravencrest,1151,warlock,destruction,24,12,12
Elldialock,draenor,1151,warlock,destruction,24,12,12
Hannahowo,garona,1150,warlock,destruction,18,12,6
Estefanía,tarren-mill,1150,warlock,destruction,18,12,6
Gjallarbrù,archimonde,1150,warlock,destruction,18,12,6
Kikaikek,stormscale,1150,warlock,destruction,18,12,6
Boglock,argent-dawn,1150,warlock,destruction,18,12,6
Scadar,kazzak,1149,warlock,destruction,18,12,6
Kritcheq,alakir,1149,warlock,destruction,60,29,31
Maikus,stormscale,1148,warlock,destruction,18,12,6
Nebulus,lightnings-blade,1146,warlock,destruction,18,12,6
Jinxzed,frostwhisper,1143,warlock,destruction,18,12,6
Nosoulnoprob,sylvanas,1142,warlock,destruction,24,12,12
Lobotomic,argent-dawn,1140,warlock,destruction,18,12,6
Niszoght,dun-modr,1132,warlock,destruction,35,24,11
Блэкмайндер,howling-fjord,1131,warlock,destruction,18,12,6
Drillingsdad,dun-morogh,1126,warlock,destruction,24,12,12
Riitaall,khaz-modan,1125,warlock,destruction,49,18,31
Ruul,sanguino,1124,warlock,destruction,38,16,22
Fiddlock,draenor,1117,warlock,destruction,22,13,9
Ilovemimi,hyjal,1087,warlock,destruction,23,12,11
Razek,eredar,1086,warlock,destruction,23,12,11
Atruruz,antonidas,1084,warlock,destruction,59,29,30
Maxxilla,twisting-nether,1081,warlock,destruction,113,50,63
Mizxxta,zuljin,1071,warlock,destruction,17,12,5
Troyana,chants-éternels,1067,warlock,destruction,26,19,7
Nëismz,azuremyst,1056,warlock,destruction,12,11,1
Exephia,laughing-skull,1056,warlock,destruction,12,11,1
Tuskawl,stormreaver,1056,warlock,destruction,12,11,1
Rabasta,blackmoore,1056,warlock,destruction,12,11,1
Kalwyn,stormscale,1056,warlock,destruction,18,11,7
Shadöwmäre,draenor,1056,warlock,destruction,18,11,7
Кремация,blackscar,1056,warlock,destruction,18,11,7
Sterlock,sylvanas,1056,warlock,destruction,18,11,7
Èmøgøðqt,ravencrest,1056,warlock,destruction,18,11,7
Fjutta,outland,1056,warlock,destruction,18,11,7
Avenueat,kazzak,1056,warlock,destruction,18,11,7
Secretx,kazzak,1056,warlock,destruction,18,11,7
Zila,sylvanas,1056,warlock,destruction,24,11,13
Purexlock,dragonblight,1055,warlock,destruction,16,12,4
Óop,outland,1055,warlock,destruction,18,11,7
Boomsparkle,blackrock,1055,warlock,destruction,18,11,7
Usianbølts,blackmoore,1055,warlock,destruction,18,11,7
Raknoxyeyeye,blackrock,1055,warlock,destruction,18,11,7
Imforcedtowl,aegwynn,1055,warlock,destruction,18,11,7
Fløkee,blackmoore,1055,warlock,destruction,18,11,7
Insanely,kazzak,1055,warlock,destruction,39,20,19
Borrìs,blackhand,1055,warlock,destruction,106,50,56
Watchdots,blackrock,1055,warlock,destruction,24,11,13
Xiraq,nathrezim,1055,warlock,destruction,24,11,13
Shena,chogall,1055,warlock,destruction,24,11,13
Helldoom,drakthul,1055,warlock,destruction,30,11,19
Jørdanna,blackrock,1054,warlock,destruction,18,11,7
Hydrôlîc,blackrock,1054,warlock,destruction,24,11,13
Коилсестры,blackscar,1053,warlock,destruction,21,12,9
Vimb,archimonde,1053,warlock,destruction,24,11,13
Peterpaîn,blackmoore,1050,warlock,destruction,22,14,8
Yoplen,drakthul,1050,warlock,destruction,18,11,7
Whine,uldum,1050,warlock,destruction,54,24,30
Gåylørd,ravencrest,1050,warlock,destruction,30,11,19
Скул,soulflayer,1049,warlock,destruction,24,11,13
Waandi,ravencrest,1047,warlock,destruction,18,11,7
Äbsalom,hyjal,1045,warlock,destruction,50,30,20
Orisess,bronze-dragonflight,1044,warlock,destruction,36,20,16
Somanydots,twisting-nether,1039,warlock,destruction,24,11,13
Buserella,eredar,1036,warlock,destruction,24,11,13
Demonoulis,bloodhoof,1026,warlock,destruction,18,11,7
Naniika,blackmoore,1025,warlock,destruction,24,17,7
Cráxx,onyxia,1014,warlock,destruction,26,12,14
Jaqqy,blackmoore,1005,warlock,destruction,18,12,6
Whitebanshee,turalyon,1005,warlock,destruction,18,11,7
Diseased,darksorrow,1005,warlock,destruction,26,14,12
Babayagaa,drakthul,1002,warlock,destruction,26,11,15
Iltharian,die-todeskrallen,1000,warlock,destruction,17,11,6
Juïcylucy,kazzak,999,warlock,destruction,22,15,7
Merçedesa,tarren-mill,991,warlock,destruction,17,11,6
Loveløck,blackrock,991,warlock,destruction,23,11,12
Yudy,burning-legion,987,warlock,destruction,20,11,9
Lynchéd,argent-dawn,986,warlock,destruction,17,11,6
Eisenkiefer,thrall,961,warlock,destruction,65,22,43
Korialstraz,sylvanas,960,warlock,destruction,12,10,2
Gishor,burning-legion,960,warlock,destruction,12,10,2
Slomg,sylvanas,960,warlock,destruction,12,10,2
Sjödin,tarren-mill,960,warlock,destruction,12,10,2
Brokenearman,defias-brotherhood,960,warlock,destruction,12,10,2
Nerfmeplz,archimonde,960,warlock,destruction,12,10,2
Hopéléss,aggra-português,960,warlock,destruction,12,10,2
Harefrøken,ravencrest,960,warlock,destruction,12,10,2
Skillførçé,kazzak,960,warlock,destruction,12,10,2
Graystache,blackhand,960,warlock,destruction,12,10,2
Fyxs,talnivarr,960,warlock,destruction,12,10,2
Шедон,soulflayer,960,warlock,destruction,12,10,2
Ñia,ravencrest,960,warlock,destruction,12,10,2
Destrolockz,tarren-mill,960,warlock,destruction,16,11,5
Gödisdëäd,sanguino,960,warlock,destruction,18,10,8
Ashlÿn,draenor,960,warlock,destruction,18,10,8
Anniefuchsia,ravencrest,960,warlock,destruction,18,10,8
Mafteryo,blackrock,960,warlock,destruction,18,10,8
Tbs,blackhand,960,warlock,destruction,18,10,8
Eviil,tarren-mill,960,warlock,destruction,18,10,8
Lìmè,silvermoon,960,warlock,destruction,18,10,8
Adoxilock,twisting-nether,960,warlock,destruction,18,10,8
Fornaio,nemesis,960,warlock,destruction,18,10,8
Kyiüû,archimonde,960,warlock,destruction,22,12,10
Gorillabolts,tarren-mill,960,warlock,destruction,24,10,14
Withered,nagrand,959,warlock,destruction,12,10,2
Cursecannon,outland,959,warlock,destruction,12,10,2
Zízýéró,sylvanas,959,warlock,destruction,12,10,2
Boterham,kilrogg,959,warlock,destruction,12,10,2
Olympïe,archimonde,959,warlock,destruction,16,11,5
Gwl,archimonde,959,warlock,destruction,18,10,8
Kekbólt,twisting-nether,959,warlock,destruction,18,10,8
Limoges,archimonde,959,warlock,destruction,18,10,8
Unstablemind,nemesis,959,warlock,destruction,18,10,8
Иренхх,gordunni,959,warlock,destruction,18,10,8
Adipure,blackrock,959,warlock,destruction,24,10,14
Sluba,stormscale,959,warlock,destruction,24,10,14
Proßlock,kazzak,959,warlock,destruction,24,10,14
Slâyâ,blackrock,958,warlock,destruction,12,10,2
Чернокнжник,soulflayer,958,warlock,destruction,18,10,8
Annihilatîon,aegwynn,958,warlock,destruction,18,10,8
Адво,howling-fjord,958,warlock,destruction,18,10,8
Ragequit,xavius,958,warlock,destruction,18,10,8
Baloc,kirin-tor,957,warlock,destruction,18,10,8
Blackmagic,stormscale,957,warlock,destruction,18,10,8
Saloninus,argent-dawn,957,warlock,destruction,24,10,14
Parley,frostmane,956,warlock,destruction,24,10,14
Absurdd,turalyon,955,warlock,destruction,16,11,5
Thranerm,ravencrest,955,warlock,destruction,24,10,14
Vâgg,blackmoore,955,warlock,destruction,24,10,14
Babayagâ,sanguino,954,warlock,destruction,12,10,2
Realshady,kazzak,954,warlock,destruction,18,10,8
Бигтедок,gordunni,954,warlock,destruction,66,29,37
Арцах,soulflayer,954,warlock,destruction,24,10,14
Gerart,tarren-mill,953,warlock,destruction,18,10,8
Drfóx,draenor,952,warlock,destruction,24,10,14
Gehirnwäsche,frostwolf,951,warlock,destruction,16,11,5
Aftxrlife,arathor,951,warlock,destruction,16,11,5
Paranoid,sylvanas,951,warlock,destruction,18,10,8
Kääk,sylvanas,947,warlock,destruction,18,10,8
Крутизол,fordragon,944,warlock,destruction,25,11,14
Бомбшелл,soulflayer,942,warlock,destruction,20,11,9
Äzarel,khaz-modan,933,warlock,destruction,12,10,2
Mýlìfêbélike,kazzak,927,warlock,destruction,14,11,3
Racursed,outland,927,warlock,destruction,16,10,6
Demowlition,archimonde,908,warlock,destruction,24,10,14
Debbskidjur,tarren-mill,896,warlock,destruction,16,10,6
Fandirxd,draenor,894,warlock,destruction,17,10,7
Bèkshà,blackrock,894,warlock,destruction,20,10,10
Critchlock,tarren-mill,879,warlock,destruction,17,10,7
Divvaa,tarren-mill,876,warlock,destruction,29,12,17
Reizouka,twisting-nether,864,warlock,destruction,12,9,3
Boltmaster,burning-legion,864,warlock,destruction,12,9,3
Märkähuikka,stormreaver,864,warlock,destruction,12,9,3
Vamanos,stormscale,864,warlock,destruction,12,9,3
Howtofake,doomhammer,864,warlock,destruction,12,9,3
Brødo,dun-modr,864,warlock,destruction,12,9,3
Øßey,magtheridon,864,warlock,destruction,12,9,3
Chàsx,archimonde,864,warlock,destruction,12,9,3
Peon,blackrock,864,warlock,destruction,12,9,3
Noobgg,kazzak,864,warlock,destruction,12,9,3
Soulboltx,ragnaros,864,warlock,destruction,12,9,3
Веномхх,lich-king,864,warlock,destruction,12,9,3
Zikozor,ravencrest,864,warlock,destruction,16,10,6
Силорий,howling-fjord,864,warlock,destruction,18,9,9
Panda,aegwynn,864,warlock,destruction,18,9,9
Reznör,archimonde,864,warlock,destruction,18,9,9
Чернокок,blackscar,864,warlock,destruction,18,9,9
Wlistoohard,stormscale,864,warlock,destruction,18,9,9
Gis,laughing-skull,864,warlock,destruction,18,9,9
Köftemec,blackrock,864,warlock,destruction,18,9,9
Doomwrath,tarren-mill,864,warlock,destruction,18,9,9
Potatowl,ragnaros,864,warlock,destruction,18,9,9
Xesh,kiljaeden,864,warlock,destruction,18,9,9
Indraxx,hyjal,864,warlock,destruction,18,9,9
Dastey,stormscale,864,warlock,destruction,18,9,9
Nògg,kazzak,864,warlock,destruction,18,9,9
Фейкгодх,soulflayer,864,warlock,destruction,24,9,15
Mxdojsrvqxzq,ravencrest,864,warlock,destruction,24,9,15
Covariance,nemesis,863,warlock,destruction,12,9,3
Narzok,kazzak,863,warlock,destruction,12,9,3
Elerodril,ysondre,863,warlock,destruction,12,9,3
Zelyx,archimonde,863,warlock,destruction,12,9,3
Mooncrushed,stormscale,863,warlock,destruction,12,9,3
Verson,silvermoon,863,warlock,destruction,18,9,9
Гвоздяшка,blackscar,863,warlock,destruction,18,9,9
Andrealphus,outland,863,warlock,destruction,18,9,9
Salouppio,archimonde,863,warlock,destruction,24,9,15
Brútality,nethersturm,863,warlock,destruction,36,9,27
Lokibra,antonidas,862,warlock,destruction,12,9,3
Miltuast,blackrock,862,warlock,destruction,12,9,3
Bíggun,outland,862,warlock,destruction,12,9,3
Osyx,ravencrest,862,warlock,destruction,16,11,5
Гринлайм,howling-fjord,861,warlock,destruction,12,9,3
Xhartus,argent-dawn,860,warlock,destruction,18,9,9
Synnox,blackrock,844,warlock,destruction,18,9,9
Архидрако,gordunni,832,warlock,destruction,24,9,15
Tid,burning-legion,830,warlock,destruction,17,9,8
Krestox,blackmoore,814,warlock,destruction,23,9,14
Merloc,magtheridon,801,warlock,destruction,20,10,10
Nimbin,taerar,796,warlock,destruction,20,9,11
Fearbeachx,ravencrest,768,warlock,destruction,12,8,4
Maxlox,tarren-mill,768,warlock,destruction,12,8,4
Imissbfa,stormscale,768,warlock,destruction,12,8,4
Sizexl,silvermoon,768,warlock,destruction,12,8,4
Zilalol,sylvanas,768,warlock,destruction,12,8,4
Nodavé,stormscale,768,warlock,destruction,12,8,4
Firecast,kazzak,768,warlock,destruction,12,8,4
Burningdemon,kazzak,768,warlock,destruction,12,8,4
Imbalockzwei,aegwynn,768,warlock,destruction,12,8,4
Dalyvan,blackrock,768,warlock,destruction,12,8,4
Kaeb,archimonde,768,warlock,destruction,12,8,4
Overbuffed,wildhammer,768,warlock,destruction,12,8,4
Korbendallas,anubarak,768,warlock,destruction,12,8,4
Квейдсан,howling-fjord,768,warlock,destruction,12,8,4
Dmonlock,hyjal,768,warlock,destruction,12,8,4
Fearu,kazzak,768,warlock,destruction,12,8,4
Wìtçhßlåðes,ysondre,768,warlock,destruction,12,8,4
Trickytée,tarren-mill,768,warlock,destruction,12,8,4
Coilxo,ravencrest,768,warlock,destruction,12,8,4
Fiddyp,kazzak,768,warlock,destruction,12,8,4
Linuviel,argent-dawn,768,warlock,destruction,12,8,4
Fulcanelli,sargeras,768,warlock,destruction,12,8,4
Nunomendes,archimonde,768,warlock,destruction,12,8,4
Coeurnichon,archimonde,768,warlock,destruction,12,8,4
Dejin,tarren-mill,768,warlock,destruction,12,8,4
Хастла,ashenvale,768,warlock,destruction,12,8,4
Freshademic,tarren-mill,768,warlock,destruction,12,8,4
Nephystø,archimonde,768,warlock,destruction,12,8,4
Horststenzl,blackrock,768,warlock,destruction,18,8,10
Flatulenzus,blackrock,768,warlock,destruction,18,8,10
Odenbest,silvermoon,768,warlock,destruction,18,8,10
Zelieknight,ysondre,768,warlock,destruction,18,8,10
Tydra,die-aldor,768,warlock,destruction,18,8,10
Deadlyrust,ragnaros,768,warlock,destruction,18,8,10
Hexdoctor,ravencrest,768,warlock,destruction,24,8,16
Wurdulock,silvermoon,767,warlock,destruction,12,8,4
Darcîa,destromath,767,warlock,destruction,12,8,4
Бирел,soulflayer,767,warlock,destruction,12,8,4
Enydible,frostmane,767,warlock,destruction,12,8,4
Eotlid,shattered-hand,767,warlock,destruction,12,8,4
Shadowburst,outland,767,warlock,destruction,12,8,4
Jaimê,thrall,767,warlock,destruction,12,8,4
Nili,dethecus,767,warlock,destruction,12,8,4
Ammathrel,moonglade,767,warlock,destruction,12,8,4
Fearster,twisting-nether,767,warlock,destruction,12,8,4
Lorelèi,silvermoon,767,warlock,destruction,12,8,4
Егосяхаос,soulflayer,767,warlock,destruction,18,8,10
Делегент,deathguard,767,warlock,destruction,18,8,10
Nerfwarriors,stormscale,767,warlock,destruction,18,8,10
Islazoldyck,draenor,767,warlock,destruction,24,8,16
Lockedaway,ravencrest,766,warlock,destruction,12,8,4
Antoniolm,cthun,766,warlock,destruction,16,9,7
Mavelya,blackmoore,766,warlock,destruction,24,8,16
Toffifae,argent-dawn,765,warlock,destruction,12,8,4
Shutdown,sylvanas,756,warlock,destruction,18,8,10
Lémonz,stormscale,751,warlock,destruction,17,8,9
Salastro,ragnaros,735,warlock,destruction,11,8,3
Shaodul,stormscale,735,warlock,destruction,17,8,9
Хиёрис,eversong,731,warlock,destruction,18,9,9
Dayken,silvermoon,720,warlock,destruction,9,9,0
Warlocklordx,ravencrest,713,warlock,destruction,22,9,13
Kartanos,stormscale,703,warlock,destruction,11,8,3
Джастсак,gordunni,703,warlock,destruction,11,8,3
Kycknosa,archimonde,703,warlock,destruction,20,8,12
Shadowrey,blackrock,702,warlock,destruction,16,8,8
Börsenborisq,aegwynn,687,warlock,destruction,11,8,3
Otemlock,sanguino,672,warlock,destruction,12,7,5
Inflicts,frostmane,672,warlock,destruction,12,7,5
Midnigthh,sanguino,672,warlock,destruction,12,7,5
Brokengodx,dun-modr,672,warlock,destruction,12,7,5
Мэрджис,soulflayer,672,warlock,destruction,12,7,5
Veridy,kazzak,672,warlock,destruction,12,7,5
Lottopallo,arathor,672,warlock,destruction,12,7,5
Envizer,ravencrest,672,warlock,destruction,12,7,5
Cigarrette,draenor,672,warlock,destruction,12,7,5
Lúcìfér,stormscale,672,warlock,destruction,12,7,5
Mowxll,blackrock,672,warlock,destruction,12,7,5
Filippö,eredar,672,warlock,destruction,12,7,5
Scud,frostwolf,672,warlock,destruction,12,7,5
Брузир,gordunni,672,warlock,destruction,12,7,5
Матрикспз,soulflayer,672,warlock,destruction,12,7,5
Vileclass,ravencrest,672,warlock,destruction,12,7,5
Denasty,nemesis,672,warlock,destruction,12,7,5
Fraky,frostwhisper,672,warlock,destruction,12,7,5
Vilenia,doomhammer,672,warlock,destruction,12,7,5
Pöhz,archimonde,672,warlock,destruction,12,7,5
Анкхзул,howling-fjord,672,warlock,destruction,12,7,5
Hell,twisting-nether,672,warlock,destruction,12,7,5
Snackstickz,twisting-nether,672,warlock,destruction,12,7,5
Çüñ,shattered-hand,672,warlock,destruction,12,7,5
Necrobtch,quelthalas,672,warlock,destruction,12,7,5
Veríty,kazzak,672,warlock,destruction,12,7,5
Артисона,gordunni,672,warlock,destruction,12,7,5
Mempricious,ravencrest,672,warlock,destruction,12,7,5
Chapo,alleria,672,warlock,destruction,12,7,5
Limecqt,dun-morogh,672,warlock,destruction,12,7,5
Hædês,antonidas,672,warlock,destruction,18,7,11
Fatbëlly,argent-dawn,672,warlock,destruction,18,7,11
Topmodelx,eredar,672,warlock,destruction,18,7,11
Vulluin,blackrock,672,warlock,destruction,18,7,11
Ðôtgøðx,ravencrest,672,warlock,destruction,18,7,11
Mudwalkin,ravencrest,672,warlock,destruction,18,7,11
Nineinchlock,silvermoon,672,warlock,destruction,18,7,11
Britnèyfears,twisting-nether,672,warlock,destruction,18,7,11
Andrewdaniel,twisting-nether,672,warlock,destruction,18,7,11
Belakh,draenor,672,warlock,destruction,18,7,11
Katâra,tarren-mill,672,warlock,destruction,18,7,11
Omegazero,zuluhed,672,warlock,destruction,18,7,11
Marripa,sanguino,672,warlock,destruction,24,7,17
Afflicted,trollbane,671,warlock,destruction,12,7,5
Proflock,drakthul,671,warlock,destruction,12,7,5
Galardodric,outland,671,warlock,destruction,12,7,5
Saadq,draenor,671,warlock,destruction,12,7,5
Fauxshow,ravencrest,671,warlock,destruction,12,7,5
Baladas,nemesis,671,warlock,destruction,12,7,5
Panicbolt,ravencrest,671,warlock,destruction,12,7,5
Zillinzy,frostmane,671,warlock,destruction,12,7,5
Cømps,blackrock,671,warlock,destruction,12,7,5
Postymalony,kazzak,671,warlock,destruction,12,7,5
Mazaear,stormscale,671,warlock,destruction,16,8,8
Vengidotcom,outland,671,warlock,destruction,18,7,11
Gillgarres,twisting-nether,671,warlock,destruction,18,7,11
Natsume,ragnaros,671,warlock,destruction,18,7,11
Margincalled,kazzak,671,warlock,destruction,18,7,11
Нафлэпил,gordunni,670,warlock,destruction,12,7,5
Qloss,burning-legion,670,warlock,destruction,12,7,5
Galath,wrathbringer,670,warlock,destruction,16,8,8
Mortori,tarren-mill,668,warlock,destruction,12,7,5
Gâlvâtorix,frostmourne,668,warlock,destruction,18,7,11
Johntrabolta,chogall,667,warlock,destruction,12,7,5
Vladlevad,argent-dawn,667,warlock,destruction,12,7,5
Ternisia,draenor,655,warlock,destruction,14,8,6
Dobonard,sylvanas,639,warlock,destruction,16,7,9
Shakuroz,frostwolf,624,warlock,destruction,21,8,13
Гангстахохо,soulflayer,622,warlock,destruction,16,7,9
Zxò,twisting-nether,608,warlock,destruction,10,7,3
Bryanz,sanguino,608,warlock,destruction,10,7,3
Érunali,archimonde,607,warlock,destruction,11,7,4
Willthehoe,alonsus,607,warlock,destruction,11,7,4
Morathy,drekthar,576,warlock,destruction,6,6,0
Whaii,ravencrest,576,warlock,destruction,6,6,0
Muleerox,kazzak,576,warlock,destruction,6,6,0
Notben,outland,576,warlock,destruction,6,6,0
Peacedust,grim-batol,576,warlock,destruction,6,6,0
Ceryss,argent-dawn,576,warlock,destruction,6,6,0
Solosuperr,ravencrest,576,warlock,destruction,6,6,0
Phobilock,guldan,576,warlock,destruction,6,6,0
Catchlock,tarren-mill,576,warlock,destruction,6,6,0
Idfearthat,ragnaros,576,warlock,destruction,6,6,0
Sulnar,burning-legion,576,warlock,destruction,6,6,0
Skuvee,archimonde,576,warlock,destruction,6,6,0
Voukserys,tarren-mill,576,warlock,destruction,6,6,0
Cafardcancer,archimonde,576,warlock,destruction,6,6,0
Popecandy,archimonde,576,warlock,destruction,6,6,0
Klaier,dun-modr,576,warlock,destruction,9,7,2
Drainforlife,blackrock,576,warlock,destruction,12,6,6
Ezdotggwp,stormscale,576,warlock,destruction,12,6,6
Нгага,howling-fjord,576,warlock,destruction,12,6,6
Dotg,blackrock,576,warlock,destruction,12,6,6
Keibo,drakthul,576,warlock,destruction,12,6,6
Kalagorn,azshara,576,warlock,destruction,12,6,6
Loulou,nagrand,576,warlock,destruction,12,6,6
Mocfernando,ravencrest,576,warlock,destruction,12,6,6
Kukkojapallo,ravencrest,576,warlock,destruction,12,6,6
Ðåñtåy,ravencrest,576,warlock,destruction,12,6,6
Dèv,draenor,576,warlock,destruction,12,6,6
Enyras,nemesis,576,warlock,destruction,12,6,6
Noobtamer,kazzak,576,warlock,destruction,12,6,6
Gatewatcher,argent-dawn,576,warlock,destruction,12,6,6
Эннинотбэд,howling-fjord,576,warlock,destruction,12,6,6
Enaio,mannoroth,576,warlock,destruction,12,6,6
Chafir,kazzak,576,warlock,destruction,12,6,6
Akumako,stormscale,576,warlock,destruction,12,6,6
Ilikebolts,blackmoore,576,warlock,destruction,12,6,6
Staudi,eredar,576,warlock,destruction,12,6,6
Marenov,kazzak,576,warlock,destruction,12,6,6
Mayden,uldum,576,warlock,destruction,12,6,6
Skarløck,blackmoore,576,warlock,destruction,12,6,6
Warlockyo,blackrock,576,warlock,destruction,12,6,6
Diabolics,twisting-nether,576,warlock,destruction,12,6,6
Britneyfears,burning-legion,576,warlock,destruction,12,6,6
Hepheisto,blackmoore,576,warlock,destruction,12,6,6
Benzakenta,sylvanas,576,warlock,destruction,12,6,6
Mosslock,silvermoon,576,warlock,destruction,12,6,6
Chromagnus,drakthul,576,warlock,destruction,12,6,6
ßenäfflock,ragnaros,576,warlock,destruction,12,6,6
Súícìdèbøy,colinas-pardas,576,warlock,destruction,12,6,6
Сайзэр,soulflayer,576,warlock,destruction,15,7,8
Klasikas,kazzak,576,warlock,destruction,16,7,9
Naitix,argent-dawn,576,warlock,destruction,18,6,12
Letswreck,outland,576,warlock,destruction,18,6,12
Solomohn,steamwheedle-cartel,575,warlock,destruction,6,6,0
Brarvile,zuljin,575,warlock,destruction,12,6,6
Gengada,blackhand,575,warlock,destruction,12,6,6
Swagzz,silvermoon,575,warlock,destruction,12,6,6
Nemssy,dun-modr,575,warlock,destruction,18,6,12
Ramurox,rexxar,575,warlock,destruction,18,6,12
Lucîfear,silvermoon,574,warlock,destruction,12,6,6
Marann,dun-morogh,569,warlock,destruction,12,6,6
Fearylia,aegwynn,543,warlock,destruction,8,7,1
Epzi,outland,543,warlock,destruction,11,6,5
Lolock,archimonde,543,warlock,destruction,14,7,7
Sicktir,aerie-peak,527,warlock,destruction,11,6,5
Стафилокок,deepholm,527,warlock,destruction,11,6,5
Pouletmicuie,archimonde,527,warlock,destruction,11,6,5
Indynamo,blackrock,527,warlock,destruction,11,6,5
Wolferand,argent-dawn,521,warlock,destruction,24,7,17
Nøxxlock,blackhand,511,warlock,destruction,8,6,2
Evilhippie,kazzak,511,warlock,destruction,11,6,5
Beepbepp,grim-batol,496,warlock,destruction,7,6,1
Nëismz,ravencrest,496,warlock,destruction,7,6,1
Salvatoriy,outland,480,warlock,destruction,6,5,1
Rensayy,ysondre,480,warlock,destruction,6,5,1
Shortyi,thrall,480,warlock,destruction,6,5,1
Zurael,mannoroth,480,warlock,destruction,6,5,1
Levinbrz,ravencrest,480,warlock,destruction,6,5,1
Whatamellown,aegwynn,480,warlock,destruction,6,5,1
Mïllâïneeqtx,archimonde,480,warlock,destruction,6,5,1
Файрусх,soulflayer,480,warlock,destruction,6,5,1
Wÿvërnn,archimonde,480,warlock,destruction,6,5,1
Aritrosyo,ravencrest,480,warlock,destruction,6,5,1
Андаинг,soulflayer,480,warlock,destruction,6,5,1
Demonmilf,ysondre,480,warlock,destruction,6,5,1
Ragïa,archimonde,480,warlock,destruction,6,5,1
Djløckgødx,ravencrest,480,warlock,destruction,6,5,1
Sadixxqt,ravencrest,480,warlock,destruction,6,5,1
Sâlty,stormscale,480,warlock,destruction,6,5,1
Scandalfogel,frostmane,480,warlock,destruction,6,5,1
Lazytown,silvermoon,480,warlock,destruction,6,5,1
Verminosiss,stormscale,480,warlock,destruction,6,5,1
Møärdötd,aggra-português,480,warlock,destruction,6,5,1
Southylolz,stormscale,480,warlock,destruction,6,5,1
Drainurlife,zenedar,480,warlock,destruction,6,5,1
Whitebøy,hyjal,480,warlock,destruction,6,5,1
Lockukaracha,malganis,480,warlock,destruction,6,5,1
Журанайсбой,blackscar,480,warlock,destruction,6,5,1
Destinyz,dun-modr,480,warlock,destruction,6,5,1
Sotapen,ragnaros,480,warlock,destruction,6,5,1
Ампе,blackscar,480,warlock,destruction,6,5,1
Jkz,blackrock,480,warlock,destruction,6,5,1
Азерок,howling-fjord,480,warlock,destruction,6,5,1
Barbyqueue,kazzak,480,warlock,destruction,6,5,1
Веберх,howling-fjord,480,warlock,destruction,6,5,1
Lyndi,nerathor,480,warlock,destruction,6,5,1
Phît,kilrogg,480,warlock,destruction,6,5,1
Letmecast,sylvanas,480,warlock,destruction,6,5,1
Höglund,twisting-nether,480,warlock,destruction,6,5,1
Kaakmasta,der-abyssische-rat,480,warlock,destruction,6,5,1
Debz,twisting-nether,480,warlock,destruction,6,5,1
Бриант,gordunni,480,warlock,destruction,6,5,1
Lísbeth,sylvanas,480,warlock,destruction,6,5,1
Deruud,defias-brotherhood,480,warlock,destruction,6,5,1
Xjay,malorne,480,warlock,destruction,6,5,1
Stazox,drakthul,480,warlock,destruction,6,5,1
Vankraken,silvermoon,480,warlock,destruction,6,5,1
Mazuto,outland,480,warlock,destruction,6,5,1
Exiled,dragonblight,480,warlock,destruction,6,5,1
Náwwk,blackmoore,480,warlock,destruction,6,5,1
Trollgubbe,twilights-hammer,480,warlock,destruction,6,5,1
ßualock,sylvanas,480,warlock,destruction,6,5,1
Kieman,tarren-mill,480,warlock,destruction,12,5,7
Bajsibyx,tarren-mill,480,warlock,destruction,12,5,7
Enragelock,tarren-mill,480,warlock,destruction,12,5,7
Rumour,sunstrider,480,warlock,destruction,12,5,7
Nanotrik,draenor,480,warlock,destruction,12,5,7
Bricktot,ragnaros,480,warlock,destruction,12,5,7
Динодотз,howling-fjord,480,warlock,destruction,12,5,7
Asper,ragnaros,480,warlock,destruction,12,5,7
Shreedlock,blackmoore,480,warlock,destruction,12,5,7
Hexdoc,alakir,480,warlock,destruction,12,5,7
Yhwäch,archimonde,480,warlock,destruction,12,5,7
Gravedîgger,aggra-português,480,warlock,destruction,12,5,7
Fluxlight,frostmourne,480,warlock,destruction,12,5,7
Tomiaa,burning-legion,480,warlock,destruction,12,5,7
Kigro,burning-legion,480,warlock,destruction,12,5,7
Raverboyy,blackrock,480,warlock,destruction,12,5,7
Yeluna,alleria,480,warlock,destruction,12,5,7
Shadowscurse,sylvanas,480,warlock,destruction,12,5,7
Voidzero,hyjal,480,warlock,destruction,12,5,7
Kimwexler,ravencrest,480,warlock,destruction,12,5,7
Voodooskull,kazzak,480,warlock,destruction,12,5,7
Käristäjä,outland,480,warlock,destruction,12,5,7
Yokûjin,twisting-nether,480,warlock,destruction,12,5,7
Mirenli,kazzak,480,warlock,destruction,12,5,7
Zêngâ,kazzak,480,warlock,destruction,12,5,7
Domdon,stormscale,480,warlock,destruction,12,5,7
Zeanort,zuljin,480,warlock,destruction,12,5,7
Infectius,kazzak,480,warlock,destruction,18,5,13
Maledictio,blackrock,480,warlock,destruction,18,5,13
Hejhana,drakthul,480,warlock,destruction,18,5,13
Эктос,soulflayer,479,warlock,destruction,6,5,1
Сенсация,ashenvale,479,warlock,destruction,12,5,7
Öyo,outland,479,warlock,destruction,12,5,7
Archélion,silvermoon,479,warlock,destruction,12,5,7
Dubbzy,outland,479,warlock,destruction,18,5,13
Soulsdeads,sylvanas,478,warlock,destruction,12,5,7
Снчч,soulflayer,463,warlock,destruction,11,5,6
Moelock,frostmane,463,warlock,destruction,17,5,12
Avogeiñ,tarren-mill,447,warlock,destruction,11,5,6
Winterx,argent-dawn,447,warlock,destruction,11,5,6
Acrion,blackrock,432,warlock,destruction,9,6,3
Daeyon,ravencrest,432,warlock,destruction,9,5,4
Charmine,tarren-mill,400,warlock,destruction,7,5,2
Vêzor,twisting-nether,384,warlock,destruction,6,4,2
Purplemonkey,burning-blade,384,warlock,destruction,6,4,2
Psykøø,shendralar,384,warlock,destruction,6,4,2
Cajnik,sylvanas,384,warlock,destruction,6,4,2
Diemilch,blackmoore,384,warlock,destruction,6,4,2
Drshegs,darkspear,384,warlock,destruction,6,4,2
Xarfoul,grim-batol,384,warlock,destruction,6,4,2
Jazggzkxx,twisting-nether,384,warlock,destruction,6,4,2
Falel,das-konsortium,384,warlock,destruction,6,4,2
Uqrlock,twisting-nether,384,warlock,destruction,6,4,2
Zilthon,dragonblight,384,warlock,destruction,6,4,2
Chochliko,silvermoon,384,warlock,destruction,6,4,2
Patirass,sanguino,384,warlock,destruction,6,4,2
Äri,blackmoore,384,warlock,destruction,6,4,2
Cloud,kazzak,384,warlock,destruction,6,4,2
Amyw,magtheridon,384,warlock,destruction,6,4,2
Harrydotterx,alakir,384,warlock,destruction,6,4,2
Iulu,sylvanas,384,warlock,destruction,6,4,2
Grôteskûs,tarren-mill,384,warlock,destruction,6,4,2
Discordîân,twisting-nether,384,warlock,destruction,6,4,2
Sehk,stormreaver,384,warlock,destruction,6,4,2
Dotritos,tarren-mill,384,warlock,destruction,6,4,2
Dotacy,kazzak,384,warlock,destruction,6,4,2
Korupcijax,kazzak,384,warlock,destruction,6,4,2
Яичнаялапша,soulflayer,384,warlock,destruction,6,4,2
Póssiblyreef,silvermoon,384,warlock,destruction,6,4,2
Боуманн,howling-fjord,384,warlock,destruction,6,4,2
Døxz,blackrock,384,warlock,destruction,6,4,2
Zekarat,blackrock,384,warlock,destruction,6,4,2
Кичи,gordunni,384,warlock,destruction,6,4,2
Darkwíngduck,aegwynn,384,warlock,destruction,6,4,2
Kar,haomarush,384,warlock,destruction,6,4,2
Пчелокнижник,howling-fjord,384,warlock,destruction,6,4,2
Rénna,twisting-nether,384,warlock,destruction,6,4,2
Predlocktwo,twisting-nether,384,warlock,destruction,6,4,2
Sneltjej,draenor,384,warlock,destruction,6,4,2
Acilock,outland,384,warlock,destruction,6,4,2
Lockteb,tarren-mill,384,warlock,destruction,6,4,2
Onekxz,blackrock,384,warlock,destruction,6,4,2
Gambos,kazzak,384,warlock,destruction,6,4,2
Ädarä,cthun,384,warlock,destruction,6,4,2
Abdulrahim,archimonde,384,warlock,destruction,6,4,2
Zéik,archimonde,384,warlock,destruction,6,4,2
Incesticide,ragnaros,384,warlock,destruction,6,4,2
Shutupkid,ravencrest,384,warlock,destruction,6,4,2
Azae,outland,384,warlock,destruction,6,4,2
Deßra,stormscale,384,warlock,destruction,6,4,2
Raddikal,archimonde,384,warlock,destruction,6,4,2
Holiax,archimonde,384,warlock,destruction,6,4,2
Høliax,archimonde,384,warlock,destruction,6,4,2
Striks,ragnaros,384,warlock,destruction,6,4,2
Xskyrov,blackmoore,384,warlock,destruction,6,4,2
Fatburner,draenor,384,warlock,destruction,6,4,2
Darkwìngduck,ravencrest,384,warlock,destruction,6,4,2
Вешка,azuregos,384,warlock,destruction,6,4,2
Aldiac,aegwynn,384,warlock,destruction,6,4,2
Simony,ravencrest,384,warlock,destruction,6,4,2
Janemba,ysondre,384,warlock,destruction,6,4,2
Cigänä,archimonde,384,warlock,destruction,6,4,2
Flayør,ravencrest,384,warlock,destruction,6,4,2
Allêgrâ,blackrock,384,warlock,destruction,6,4,2
Ðuß,nemesis,384,warlock,destruction,6,4,2
Spectarlock,tarren-mill,384,warlock,destruction,6,4,2
Boltyboi,chamber-of-aspects,384,warlock,destruction,6,4,2
Siyaa,eredar,384,warlock,destruction,6,4,2
Corano,ravencrest,384,warlock,destruction,6,4,2
Unfeared,blackhand,384,warlock,destruction,6,4,2
Balding,blackhand,384,warlock,destruction,6,4,2
Анрали,soulflayer,384,warlock,destruction,6,4,2
Nilsa,eredar,384,warlock,destruction,6,4,2
Zevil,emerald-dream,384,warlock,destruction,6,4,2
Arthesia,archimonde,384,warlock,destruction,6,4,2
Xenastro,silvermoon,384,warlock,destruction,6,4,2
Smithlock,blackrock,384,warlock,destruction,6,4,2
Sïlïthuss,ravencrest,384,warlock,destruction,6,4,2
Íntikam,blackrock,384,warlock,destruction,6,4,2
Feyreah,blackmoore,384,warlock,destruction,6,4,2
Gorthunz,kazzak,384,warlock,destruction,6,4,2
Notloveless,stormscale,384,warlock,destruction,6,4,2
Hulagirl,ravencrest,384,warlock,destruction,6,4,2
Precogbtw,ravencrest,384,warlock,destruction,6,4,2
Warlockery,argent-dawn,384,warlock,destruction,6,4,2
Yifu,ravencrest,384,warlock,destruction,6,4,2
Рыжевласочка,eversong,384,warlock,destruction,9,5,4
Tekron,blackhand,384,warlock,destruction,12,4,8
Sædotern,stormscale,384,warlock,destruction,12,4,8
Юникна,gordunni,384,warlock,destruction,12,4,8
Уфц,grom,384,warlock,destruction,12,4,8
Лоллиторпеда,gordunni,384,warlock,destruction,12,4,8
Sindown,the-maelstrom,384,warlock,destruction,12,4,8
Palihatschi,eredar,384,warlock,destruction,12,4,8
Gulzot,turalyon,384,warlock,destruction,12,4,8
Impvader,argent-dawn,384,warlock,destruction,12,4,8
Azmondan,ahnqiraj,384,warlock,destruction,12,4,8
Reidonk,blackrock,384,warlock,destruction,12,4,8
Shadowflare,blackmoore,384,warlock,destruction,12,4,8
Xshay,dun-modr,384,warlock,destruction,12,4,8
Axy,dun-modr,384,warlock,destruction,12,4,8
Чиззихаос,soulflayer,384,warlock,destruction,12,4,8
Garimberas,silvermoon,384,warlock,destruction,12,4,8
Darkmaw,drakthul,384,warlock,destruction,12,4,8
Mustalol,outland,384,warlock,destruction,12,4,8
Happysrme,thrall,384,warlock,destruction,18,4,14
Stunspectoo,turalyon,383,warlock,destruction,6,4,2
Okulus,quelthalas,383,warlock,destruction,6,4,2
Angrynoob,silvermoon,383,warlock,destruction,6,4,2
Demirchayan,twisting-nether,383,warlock,destruction,6,4,2
Zøhaz,burning-legion,383,warlock,destruction,12,4,8
Dathos,ragnaros,383,warlock,destruction,12,4,8
Ахпорбес,gordunni,382,warlock,destruction,6,4,2
Britneyfear,aegwynn,351,warlock,destruction,8,5,3
Зеленаямразь,soulflayer,336,warlock,destruction,9,4,5
Khano,twisting-nether,336,warlock,destruction,15,4,11
Рейнджр,eversong,330,warlock,destruction,15,6,9
Makaspam,stormscale,320,warlock,destruction,10,4,6
Sapheâ,burning-legion,319,warlock,destruction,5,4,1
Chev,nemesis,319,warlock,destruction,5,4,1
Krokator,draenor,319,warlock,destruction,5,4,1
Daubi,ravencrest,319,warlock,destruction,8,4,4
Líok,eredar,319,warlock,destruction,11,4,7
Empra,stormscale,304,warlock,destruction,7,4,3
Esthrella,thrall,302,warlock,destruction,7,4,3
Maevex,stormscale,288,warlock,destruction,6,3,3
Flaming,ravencrest,288,warlock,destruction,6,3,3
Deamheòlas,ravencrest,288,warlock,destruction,6,3,3
Flocca,archimonde,288,warlock,destruction,6,3,3
Wauwish,stormscale,288,warlock,destruction,6,3,3
Epoku,stormscale,288,warlock,destruction,6,3,3
Issyl,kazzak,288,warlock,destruction,6,3,3
Koramu,blackrock,288,warlock,destruction,6,3,3
Sidragasoss,drakthul,288,warlock,destruction,6,3,3
Chaosborn,ravencrest,288,warlock,destruction,6,3,3
Djshyasiañ,perenolde,288,warlock,destruction,6,3,3
Zuldanius,stormscale,288,warlock,destruction,6,3,3
Evaksiá,draenor,288,warlock,destruction,6,3,3
Wajiggity,ravencrest,288,warlock,destruction,6,3,3
Huaraches,stormscale,288,warlock,destruction,6,3,3
Fsandtwo,ravencrest,288,warlock,destruction,6,3,3
Icq,ravencrest,288,warlock,destruction,6,3,3
Rokudaime,stormscale,288,warlock,destruction,6,3,3
Oimera,frostwolf,288,warlock,destruction,6,3,3
Rhaznor,frostwolf,288,warlock,destruction,6,3,3
Feardotfive,frostwolf,288,warlock,destruction,6,3,3
Palmtri,stormscale,288,warlock,destruction,6,3,3
Ghosthound,stormscale,288,warlock,destruction,6,3,3
Neirah,stormscale,288,warlock,destruction,6,3,3
Xoregar,nemesis,288,warlock,destruction,6,3,3
Dieger,thunderhorn,288,warlock,destruction,6,3,3
Boccebelle,pozzo-delleternità,288,warlock,destruction,6,3,3
Sateerik,draenor,288,warlock,destruction,6,3,3
Lamboo,tarren-mill,288,warlock,destruction,6,3,3
Herador,draenor,288,warlock,destruction,6,3,3
Belnea,draenor,288,warlock,destruction,6,3,3
Kïrah,ysondre,288,warlock,destruction,6,3,3
Gulleigh,draenor,288,warlock,destruction,6,3,3
Exitumos,eredar,288,warlock,destruction,6,3,3
Bladey,ragnaros,288,warlock,destruction,6,3,3
Шеизла,borean-tundra,288,warlock,destruction,6,3,3
Hairylock,outland,288,warlock,destruction,6,3,3
Macchíato,ragnaros,288,warlock,destruction,6,3,3
Sehere,ragnaros,288,warlock,destruction,6,3,3
Bte,draenor,288,warlock,destruction,6,3,3
Bh,ragnaros,288,warlock,destruction,6,3,3
Saymore,ragnaros,288,warlock,destruction,6,3,3
Wäisted,ravencrest,288,warlock,destruction,6,3,3
Кайдзуки,howling-fjord,288,warlock,destruction,6,3,3
Uneedtherapy,silvermoon,288,warlock,destruction,6,3,3
Brodoh,dun-modr,288,warlock,destruction,6,3,3
Flatwolenzy,blackrock,288,warlock,destruction,6,3,3
Динодотх,gordunni,288,warlock,destruction,6,3,3
Глотающий,gordunni,288,warlock,destruction,6,3,3
Thebigsuck,tarren-mill,288,warlock,destruction,6,3,3
Chubson,tarren-mill,288,warlock,destruction,6,3,3
Blazed,dentarg,288,warlock,destruction,6,3,3
Læssêkøñgð,twisting-nether,288,warlock,destruction,6,3,3
Wdauwg,nazjatar,288,warlock,destruction,6,3,3
Cpump,twisting-nether,288,warlock,destruction,6,3,3
Arizyoxot,twisting-nether,288,warlock,destruction,6,3,3
Laanik,twisting-nether,288,warlock,destruction,6,3,3
Bluh,twisting-nether,288,warlock,destruction,6,3,3
Phántom,frostmane,288,warlock,destruction,6,3,3
Stopfëar,ysondre,288,warlock,destruction,6,3,3
Huaian,darksorrow,288,warlock,destruction,6,3,3
Contemtus,frostwhisper,288,warlock,destruction,6,3,3
Hiroyukí,frostmane,288,warlock,destruction,6,3,3
Chroll,nerathor,288,warlock,destruction,6,3,3
Nargøf,outland,288,warlock,destruction,6,3,3
Ragdoll,twisting-nether,288,warlock,destruction,6,3,3
Zartax,kazzak,288,warlock,destruction,6,3,3
Helvetica,darksorrow,288,warlock,destruction,6,3,3
Funcky,terokkar,288,warlock,destruction,6,3,3
Lockki,blades-edge,288,warlock,destruction,6,3,3
Pixelz,twisting-nether,288,warlock,destruction,6,3,3
Lockskalle,tarren-mill,288,warlock,destruction,6,3,3
Zabani,das-syndikat,288,warlock,destruction,6,3,3
Waryald,dun-modr,288,warlock,destruction,6,3,3
Finlock,kult-der-verdammten,288,warlock,destruction,6,3,3
Boltez,twisting-nether,288,warlock,destruction,6,3,3
Бешентумай,goldrinn,288,warlock,destruction,6,3,3
Dement,sanguino,288,warlock,destruction,6,3,3
Demox,arathor,288,warlock,destruction,6,3,3
Talt,dalaran,288,warlock,destruction,6,3,3
Pcbbwarlock,sylvanas,288,warlock,destruction,6,3,3
Demónfire,sylvanas,288,warlock,destruction,6,3,3
Kiritsugi,aszune,288,warlock,destruction,6,3,3
Besthun,drakthul,288,warlock,destruction,6,3,3
Frankieboi,drakthul,288,warlock,destruction,6,3,3
Mewarlock,bronze-dragonflight,288,warlock,destruction,6,3,3
Doublebolt,the-maelstrom,288,warlock,destruction,6,3,3
Truckpunch,defias-brotherhood,288,warlock,destruction,6,3,3
Toskanoamani,blackmoore,288,warlock,destruction,6,3,3
Fandusttwo,drakthul,288,warlock,destruction,6,3,3
Moonpoxlock,nerathor,288,warlock,destruction,6,3,3
Dragmetohêll,blackhand,288,warlock,destruction,6,3,3
Elmîr,blackmoore,288,warlock,destruction,6,3,3
Dexterlol,blackmoore,288,warlock,destruction,6,3,3
Gnargamehl,nemesis,288,warlock,destruction,12,3,9
Neoe,stormscale,288,warlock,destruction,12,3,9
Ðæthpäct,dalaran,288,warlock,destruction,12,3,9
Mitrela,ravencrest,288,warlock,destruction,12,3,9
Мирмех,gordunni,288,warlock,destruction,12,3,9
Milfhaunter,aegwynn,288,warlock,destruction,12,3,9
Tiffyilock,blackrock,288,warlock,destruction,12,3,9
Èrmes,eldrethalas,288,warlock,destruction,12,3,9
Dreameater,twilights-hammer,288,warlock,destruction,12,3,9
Jumbodot,tarren-mill,288,warlock,destruction,12,3,9
Killerbeez,burning-blade,288,warlock,destruction,12,3,9
Bope,the-maelstrom,288,warlock,destruction,12,3,9
Phéar,deathwing,288,warlock,destruction,12,3,9
Nathgar,drakthul,288,warlock,destruction,12,3,9
Voib,silvermoon,288,warlock,destruction,12,3,9
Svartalfen,outland,288,warlock,destruction,12,3,9
Fewton,eonar,288,warlock,destruction,18,3,15
Грашек,soulflayer,287,warlock,destruction,6,3,3
Destri,blackmoore,286,warlock,destruction,6,3,3
Smíkz,blackhand,239,warlock,destruction,5,3,2
Insertchaos,draenor,239,warlock,destruction,5,3,2
Telaldrah,argent-dawn,239,warlock,destruction,5,3,2
Kelek,anachronos,239,warlock,destruction,5,3,2
Вроман,fordragon,234,warlock,destruction,10,5,5
Neffy,sinstralis,234,warlock,destruction,10,4,6
Dotsyoudown,kelthuzad,208,warlock,destruction,7,3,4
Vortëxx,tarren-mill,192,warlock,destruction,9,3,6
Oxypvp,ravencrest,192,warlock,destruction,9,3,6
Chaotìc,nemesis,192,warlock,destruction,6,2,4
Oldemoilépti,hyjal,192,warlock,destruction,6,2,4
Astralvoid,outland,192,warlock,destruction,6,2,4
Евнухоидизм,gordunni,192,warlock,destruction,6,2,4
Олимта,blackscar,192,warlock,destruction,6,2,4
Jaliyah,outland,192,warlock,destruction,6,2,4
Piouturass,hyjal,192,warlock,destruction,6,2,4
Мерседэсс,gordunni,192,warlock,destruction,6,2,4
Емс,gordunni,192,warlock,destruction,6,2,4
Хашонмвп,gordunni,192,warlock,destruction,6,2,4
Werkx,archimonde,192,warlock,destruction,6,2,4
Bulgyeøng,archimonde,192,warlock,destruction,6,2,4
Necrofearz,sylvanas,192,warlock,destruction,6,2,4
Jetset,moonglade,192,warlock,destruction,6,2,4
Millhaus,gorgonnash,192,warlock,destruction,6,2,4
Rojas,trollbane,192,warlock,destruction,6,2,4
Diddia,malganis,192,warlock,destruction,6,2,4
Шэдоубёрн,soulflayer,192,warlock,destruction,6,2,4
Fearfearfear,blackhand,192,warlock,destruction,6,2,4
Уставок,soulflayer,192,warlock,destruction,6,2,4
Splojf,the-maelstrom,192,warlock,destruction,6,2,4
Kleing,dragonblight,192,warlock,destruction,6,2,4
Ðiavel,kazzak,192,warlock,destruction,6,2,4
Saabnoolock,ragnaros,192,warlock,destruction,6,2,4
Kemel,thrall,192,warlock,destruction,6,2,4
Zigfipszen,blackmoore,192,warlock,destruction,6,2,4
Colevid,blackmoore,192,warlock,destruction,6,2,4
Legiozock,draenor,192,warlock,destruction,6,2,4
Visable,kazzak,192,warlock,destruction,6,2,4
Degdeehei,draenor,192,warlock,destruction,6,2,4
Bloodysûgar,blackmoore,192,warlock,destruction,6,2,4
Sublînê,blackmoore,192,warlock,destruction,6,2,4
Guldän,quelthalas,192,warlock,destruction,6,2,4
Houndread,kazzak,192,warlock,destruction,6,2,4
Merengue,uldum,192,warlock,destruction,6,2,4
Zenaidaa,doomhammer,192,warlock,destruction,6,2,4
Absúrd,turalyon,192,warlock,destruction,6,2,4
Kospar,dun-morogh,192,warlock,destruction,6,2,4
Locknroll,terokkar,192,warlock,destruction,6,2,4
Kvanmor,kaelthas,192,warlock,destruction,6,2,4
Zagana,neptulon,192,warlock,destruction,6,2,4
Daeneerys,skullcrusher,192,warlock,destruction,6,2,4
Satanizm,silvermoon,192,warlock,destruction,6,2,4
Levitibus,argent-dawn,192,warlock,destruction,6,2,4
Cindela,eredar,192,warlock,destruction,6,2,4
Костикк,howling-fjord,192,warlock,destruction,6,2,4
Stepwarlock,kazzak,192,warlock,destruction,6,2,4
Anthor,tarren-mill,192,warlock,destruction,6,2,4
Bailerlock,antonidas,192,warlock,destruction,6,2,4
Valthorion,arthas,192,warlock,destruction,6,2,4
Kontanthjælp,tarren-mill,192,warlock,destruction,6,2,4
Pelkopeelo,tarren-mill,192,warlock,destruction,6,2,4
Sinlockz,tarren-mill,192,warlock,destruction,6,2,4
Fatkkroth,ravencrest,192,warlock,destruction,6,2,4
Zeelotko,drakthul,192,warlock,destruction,6,2,4
Stopdaddyplz,ravencrest,192,warlock,destruction,6,2,4
Yourdeaath,ravencrest,192,warlock,destruction,6,2,4
Warlockxx,ravencrest,192,warlock,destruction,6,2,4
Joemontana,blackrock,192,warlock,destruction,6,2,4
Aurelíá,ravencrest,192,warlock,destruction,6,2,4
Ðaddyy,stormscale,192,warlock,destruction,6,2,4
Ívânguldán,twisting-nether,192,warlock,destruction,6,2,4
Kabowie,twisting-nether,192,warlock,destruction,6,2,4
Hheavens,ragnaros,192,warlock,destruction,6,2,4
Guldån,twisting-nether,192,warlock,destruction,6,2,4
Ooze,kazzak,192,warlock,destruction,6,2,4
Банкапевка,howling-fjord,192,warlock,destruction,6,2,4
Thîras,tarren-mill,192,warlock,destruction,7,2,5
Noctiz,pozzo-delleternità,192,warlock,destruction,7,2,5
Nimwyn,argent-dawn,192,warlock,destruction,12,2,10
Amnésïa,eldrethalas,192,warlock,destruction,12,2,10
Punishteens,blackmoore,192,warlock,destruction,12,2,10
Àbraxàs,nemesis,192,warlock,destruction,12,2,10
Мглавечная,soulflayer,192,warlock,destruction,12,2,10
Línkéd,blackmoore,192,warlock,destruction,12,2,10
Нэйрокризиз,howling-fjord,192,warlock,destruction,12,2,10
Kokainas,dun-modr,192,warlock,destruction,12,2,10
Zùrghan,elune,191,warlock,destruction,4,3,1
Watchlock,burning-legion,191,warlock,destruction,6,2,4
Arlu,blackrock,191,warlock,destruction,6,2,4
Геролин,goldrinn,169,warlock,destruction,18,6,12
Starlok,nemesis,159,warlock,destruction,5,2,3
Hp,ysondre,159,warlock,destruction,5,2,3
Dony,dun-morogh,159,warlock,destruction,5,2,3
Jiltoks,blackmoore,159,warlock,destruction,5,2,3
Hahahahah,draenor,159,warlock,destruction,5,2,3
Grimlòck,antonidas,159,warlock,destruction,5,2,3
Favris,antonidas,159,warlock,destruction,5,2,3
Alucena,silvermoon,138,warlock,destruction,10,4,6
Rb,anachronos,138,warlock,destruction,8,3,5
Delen,ravencrest,128,warlock,destruction,4,2,2
Перегном,blackscar,127,warlock,destruction,8,2,6
Mergon,ravencrest,96,warlock,destruction,3,2,1
Oggelock,tarren-mill,96,warlock,destruction,3,2,1
Mulimarus,die-todeskrallen,96,warlock,destruction,3,2,1
Hørcrux,ravencrest,96,warlock,destruction,6,1,5
Kneereap,antonidas,96,warlock,destruction,6,1,5
Pilock,stormscale,96,warlock,destruction,6,1,5
Ramuhn,antonidas,96,warlock,destruction,6,1,5
Kopfkissen,azshara,96,warlock,destruction,6,1,5
Dalfgan,wildhammer,96,warlock,destruction,6,1,5
Rigour,silvermoon,96,warlock,destruction,6,1,5
Lugnalennart,tarren-mill,96,warlock,destruction,6,1,5
Neburlock,dun-modr,96,warlock,destruction,6,1,5
Dabezdwl,outland,96,warlock,destruction,6,1,5
Стоишьвфире,gordunni,96,warlock,destruction,6,1,5
Musallat,argent-dawn,96,warlock,destruction,6,1,5
Matheus,zenedar,96,warlock,destruction,6,1,5
Oloki,kazzak,96,warlock,destruction,6,1,5
Darlih,ravencrest,96,warlock,destruction,6,1,5
Daemonic,shattered-hand,96,warlock,destruction,6,1,5
Werlock,sanguino,96,warlock,destruction,6,1,5
Wuahlock,doomhammer,96,warlock,destruction,6,1,5
Gothgul,sanguino,96,warlock,destruction,6,1,5
Jaines,forscherliga,96,warlock,destruction,6,1,5
Kokonix,defias-brotherhood,96,warlock,destruction,6,1,5
Claralock,silvermoon,96,warlock,destruction,6,1,5
Satânius,les-sentinelles,96,warlock,destruction,6,1,5
Mariahscary,auchindoun,96,warlock,destruction,6,1,5
Chaostheory,stormscale,96,warlock,destruction,6,1,5
Srhal,blackmoore,96,warlock,destruction,6,1,5
Icritmore,stormscale,96,warlock,destruction,6,1,5
Birimbau,outland,96,warlock,destruction,6,1,5
Lomendro,blackmoore,96,warlock,destruction,6,1,5
Dotsfired,aegwynn,96,warlock,destruction,6,1,5
Neuth,draenor,96,warlock,destruction,6,1,5
Киёкка,howling-fjord,96,warlock,destruction,6,1,5
Иммолэйтх,gordunni,96,warlock,destruction,6,1,5
Tropìcal,grim-batol,96,warlock,destruction,6,1,5
Lilskunk,draenor,96,warlock,destruction,6,1,5
Wt,twisting-nether,96,warlock,destruction,6,1,5
Tiig,blackrock,96,warlock,destruction,6,1,5
Alithia,sylvanas,96,warlock,destruction,12,1,11
Malagate,sylvanas,96,warlock,destruction,12,1,11
Grêenbull,eredar,96,warlock,destruction,15,1,14
Néca,blackmoore,64,warlock,destruction,4,1,3
Obichamcici,tarren-mill,42,warlock,destruction,8,2,6
Asmodaî,anubarak,31,warlock,destruction,2,1,1
Orkamorfin,silvermoon,16,warlock,destruction,1,1,0
Khrym,stormscale,16,warlock,destruction,1,1,0
Dyingdog,kazzak,2173,warrior,fury,67,38,29
Gottdustin,lothar,2124,warrior,fury,143,78,65
Níghtfúry,ravencrest,2102,warrior,fury,84,43,41
Quanny,die-aldor,2078,warrior,fury,108,63,45
Schultze,kazzak,1998,warrior,fury,107,48,59
Corvínus,blackrock,1989,warrior,fury,72,39,33
Gregorez,silvermoon,1938,warrior,fury,60,36,24
Thezug,blackmoore,1935,warrior,fury,96,48,48
Sublex,blackrock,1933,warrior,fury,60,34,26
Дахирарг,fordragon,1872,warrior,fury,54,28,26
Thorana,twisting-nether,1859,warrior,fury,168,76,92
Brythwyn,antonidas,1856,warrior,fury,54,30,24
Wruxar,bronzebeard,1856,warrior,fury,54,29,25
Pflanzling,nozdormu,1852,warrior,fury,42,22,20
Kwesta,kazzak,1850,warrior,fury,60,34,26
Sockerbagarn,zenedar,1849,warrior,fury,43,23,20
Jeco,tarren-mill,1845,warrior,fury,54,33,21
Castlevania,ravencrest,1840,warrior,fury,66,36,30
Sublex,aegwynn,1838,warrior,fury,54,33,21
Kenryu,argent-dawn,1825,warrior,fury,60,32,28
Sonnyzz,sanguino,1824,warrior,fury,36,21,15
Timewarrior,ravencrest,1824,warrior,fury,54,30,24
Deatheart,ysondre,1824,warrior,fury,76,41,35
Трэйдар,blackscar,1823,warrior,fury,48,27,21
Letiis,blackrock,1816,warrior,fury,105,57,48
Adian,ravencrest,1813,warrior,fury,42,26,16
Schlauberg,azshara,1811,warrior,fury,48,29,19
Мигнт,howling-fjord,1810,warrior,fury,42,23,19
Zyalen,stormscale,1806,warrior,fury,60,32,28
Robycoleman,nemesis,1804,warrior,fury,66,38,28
Nóvamh,draenor,1802,warrior,fury,42,24,18
Sporctaco,nemesis,1797,warrior,fury,106,53,53
Gladius,blutkessel,1791,warrior,fury,90,46,44
Tóffèl,thrall,1773,warrior,fury,48,32,16
Rïmxøxø,haomarush,1773,warrior,fury,48,32,16
Ryonâgai,aegwynn,1773,warrior,fury,54,30,24
Unstopablle,twisting-nether,1755,warrior,fury,78,47,31
Kizzyo,draenor,1751,warrior,fury,78,40,38
Ranmaru,kazzak,1747,warrior,fury,55,28,27
Эйримор,gordunni,1742,warrior,fury,113,61,52
Рыгатрон,galakrond,1732,warrior,fury,36,19,17
Vÿnk,ysondre,1726,warrior,fury,74,44,30
Råzor,blackhand,1726,warrior,fury,123,73,50
Juna,hellscream,1726,warrior,fury,91,47,44
Даймонддогс,gordunni,1725,warrior,fury,64,36,28
Zednos,twilights-hammer,1725,warrior,fury,172,93,79
Osha,hyjal,1720,warrior,fury,72,39,33
Imolderthenu,blackrock,1720,warrior,fury,119,64,55
Кавайтити,blackscar,1718,warrior,fury,39,19,20
Варынеопэ,gordunni,1717,warrior,fury,65,35,30
Тьмасвятая,gordunni,1710,warrior,fury,42,22,20
Очепенец,soulflayer,1706,warrior,fury,117,61,56
Stansmash,kazzak,1704,warrior,fury,30,18,12
Badon,burning-legion,1697,warrior,fury,42,27,15
Insanedmg,dun-modr,1696,warrior,fury,60,31,29
Capitalista,das-konsortium,1694,warrior,fury,66,35,31
Discoklaus,blackmoore,1693,warrior,fury,96,50,46
Yodabär,blackmoore,1690,warrior,fury,120,62,58
Elsensor,sylvanas,1685,warrior,fury,60,23,37
Slaycon,sanguino,1680,warrior,fury,63,26,37
Peli,burning-blade,1679,warrior,fury,144,73,71
Даркслеерх,howling-fjord,1674,warrior,fury,36,18,18
Бубаигавар,gordunni,1673,warrior,fury,42,22,20
Протектор,soulflayer,1665,warrior,fury,106,52,54
Clellin,silvermoon,1663,warrior,fury,91,51,40
Luxurious,argent-dawn,1661,warrior,fury,42,24,18
Averenx,frostwolf,1659,warrior,fury,110,57,53
Zupkaztrópka,burning-legion,1656,warrior,fury,77,43,34
Vesnãpusic,draenor,1655,warrior,fury,45,29,16
Lífelover,tarren-mill,1655,warrior,fury,60,29,31
Megalann,silvermoon,1654,warrior,fury,60,30,30
Noproblem,ragnaros,1650,warrior,fury,65,34,31
Ðènlos,destromath,1647,warrior,fury,36,21,15
Broley,blackhand,1645,warrior,fury,43,27,16
Späns,ragnaros,1637,warrior,fury,41,19,22
Шлифую,howling-fjord,1636,warrior,fury,60,30,30
Bastquirage,dalaran,1633,warrior,fury,42,24,18
Вадло,soulflayer,1631,warrior,fury,48,24,24
Iagô,argent-dawn,1627,warrior,fury,48,28,20
Bözzy,stormreaver,1627,warrior,fury,84,45,39
Криккс,greymane,1625,warrior,fury,66,32,34
Злопиканка,gordunni,1618,warrior,fury,43,22,21
Dronikos,ravencrest,1612,warrior,fury,36,22,14
Kocmochka,tarren-mill,1611,warrior,fury,30,20,10
Walexmaryk,ragnaros,1610,warrior,fury,107,58,49
Celn,silvermoon,1608,warrior,fury,145,80,65
Ðønøvan,sanguino,1605,warrior,fury,40,23,17
Jetman,ravencrest,1605,warrior,fury,40,19,21
Abnôrmus,tarren-mill,1604,warrior,fury,96,44,52
Méido,argent-dawn,1601,warrior,fury,156,80,76
Ebonheart,argent-dawn,1599,warrior,fury,41,23,18
Дарккардинал,deathguard,1598,warrior,fury,35,19,16
Kwedrowar,burning-legion,1594,warrior,fury,42,22,20
Methodxd,outland,1592,warrior,fury,72,35,37
Azazelslayer,dethecus,1591,warrior,fury,48,33,15
Truckfury,ravencrest,1591,warrior,fury,52,31,21
Yaler,alakir,1587,warrior,fury,30,19,11
Байсал,gordunni,1579,warrior,fury,42,22,20
Evrybodydown,draenor,1576,warrior,fury,124,68,56
Koljach,sylvanas,1574,warrior,fury,121,62,59
Halfbroken,moonglade,1569,warrior,fury,42,18,24
Saadx,ravencrest,1567,warrior,fury,42,23,19
Хенгард,gordunni,1566,warrior,fury,36,20,16
ßbç,ysondre,1565,warrior,fury,72,36,36
Stahlhund,silvermoon,1564,warrior,fury,87,47,40
Мурмадонио,soulflayer,1562,warrior,fury,42,19,23
Сариату,soulflayer,1556,warrior,fury,72,34,38
Wabisabì,silvermoon,1534,warrior,fury,35,18,17
Hejduk,frostmane,1533,warrior,fury,30,20,10
Telrion,silvermoon,1525,warrior,fury,30,16,14
Pokopo,blackrock,1510,warrior,fury,42,23,19
Втораянатура,howling-fjord,1508,warrior,fury,36,22,14
Вменяемый,gordunni,1506,warrior,fury,42,20,22
Garlogar,twisting-nether,1504,warrior,fury,30,18,12
Sebastian,ravencrest,1498,warrior,fury,60,29,31
Craghak,twisting-nether,1490,warrior,fury,70,36,34
Wøokz,argent-dawn,1490,warrior,fury,111,53,58
Добиватель,howling-fjord,1488,warrior,fury,24,16,8
Ärmodäuss,norgannon,1486,warrior,fury,63,31,32
Hrodulf,moonglade,1476,warrior,fury,72,33,39
Вундеркитти,soulflayer,1470,warrior,fury,36,17,19
Арестант,soulflayer,1469,warrior,fury,65,39,26
Grubshak,burning-legion,1460,warrior,fury,47,22,25
Анакронокс,howling-fjord,1458,warrior,fury,40,20,20
Thagzar,burning-legion,1449,warrior,fury,26,16,10
Mustar,alexstrasza,1434,warrior,fury,59,35,24
Zaximos,twisting-nether,1433,warrior,fury,33,17,16
Tweegles,argent-dawn,1433,warrior,fury,65,31,34
Boos,burning-legion,1432,warrior,fury,24,15,9
Cuzyxtwo,blackrock,1431,warrior,fury,24,15,9
Хуфхорнс,soulflayer,1425,warrior,fury,27,16,11
Reidunøks,kazzak,1422,warrior,fury,59,32,27
Madaxe,kazzak,1421,warrior,fury,24,15,9
Krauus,silvermoon,1418,warrior,fury,79,44,35
Jarggyül,culte-de-la-rive-noire,1401,warrior,fury,24,15,9
Akînos,kazzak,1400,warrior,fury,57,27,30
Hidaykus,bronzebeard,1399,warrior,fury,70,35,35
Bobitybob,ravencrest,1388,warrior,fury,24,15,9
Borntothis,zuljin,1388,warrior,fury,53,32,21
Terisá,blackmoore,1377,warrior,fury,40,20,20
Dragão,kazzak,1373,warrior,fury,48,20,28
Torok,antonidas,1372,warrior,fury,30,21,9
Corrin,frostmourne,1368,warrior,fury,45,25,20
Roidspam,outland,1368,warrior,fury,41,15,26
Gruttak,aegwynn,1361,warrior,fury,24,16,8
Toundrâa,archimonde,1360,warrior,fury,105,51,54
Níká,bronzebeard,1354,warrior,fury,25,15,10
Zeliøn,elune,1353,warrior,fury,36,22,14
Ninja,bronze-dragonflight,1347,warrior,fury,78,38,40
Zíreael,ravencrest,1342,warrior,fury,60,29,31
Stretch,thrall,1341,warrior,fury,31,15,16
Mitu,sanguino,1338,warrior,fury,24,14,10
Акози,fordragon,1332,warrior,fury,60,33,27
Kragar,anetheron,1329,warrior,fury,45,25,20
Kirkwood,terokkar,1328,warrior,fury,35,21,14
Grâkul,twisting-nether,1319,warrior,fury,35,15,20
Kundrak,blackhand,1317,warrior,fury,31,16,15
Вархаус,blackscar,1313,warrior,fury,39,21,18
Ribastur,blackmoore,1312,warrior,fury,54,30,24
Touguro,aggra-português,1312,warrior,fury,33,15,18
Барабумм,soulflayer,1310,warrior,fury,77,41,36
Ælvstan,argent-dawn,1310,warrior,fury,59,30,29
Ryù,dun-modr,1310,warrior,fury,30,14,16
Coyle,eredar,1308,warrior,fury,35,16,19
Bigrooster,argent-dawn,1303,warrior,fury,102,52,50
Tragix,hyjal,1301,warrior,fury,36,16,20
Sammäel,eldrethalas,1300,warrior,fury,30,17,13
Машамеч,blackscar,1289,warrior,fury,84,42,42
Usz,thunderhorn,1284,warrior,fury,30,19,11
Xsasuke,ragnaros,1282,warrior,fury,24,14,10
Trollboii,ravencrest,1274,warrior,fury,27,14,13
Watntietnn,burning-blade,1268,warrior,fury,49,24,25
Toughwar,tarren-mill,1267,warrior,fury,30,17,13
Варрвик,howling-fjord,1264,warrior,fury,33,14,19
Gritzi,dragonblight,1262,warrior,fury,60,29,31
Аштау,howling-fjord,1262,warrior,fury,85,38,47
Бормормуш,gordunni,1261,warrior,fury,73,30,43
Antismoke,silvermoon,1259,warrior,fury,33,15,18
Buzzingwarr,tarren-mill,1259,warrior,fury,36,16,20
Dizzyndumb,draenor,1256,warrior,fury,66,32,34
Immørtálx,tarren-mill,1248,warrior,fury,24,13,11
Рагнарульв,gordunni,1248,warrior,fury,36,15,21
Thors,deathwing,1243,warrior,fury,34,18,16
Латахо,gordunni,1241,warrior,fury,24,13,11
Рсдрпб,eversong,1241,warrior,fury,30,15,15
Lâmy,khaz-modan,1240,warrior,fury,54,23,31
Deusi,garrosh,1234,warrior,fury,30,16,14
Profär,archimonde,1233,warrior,fury,24,13,11
Buzzingorc,tarren-mill,1232,warrior,fury,36,18,18
Reckless,tarren-mill,1231,warrior,fury,30,15,15
Skullfondler,argent-dawn,1226,warrior,fury,24,13,11
Èscøbar,dalaran,1226,warrior,fury,33,14,19
Quigatron,frostmane,1225,warrior,fury,42,25,17
Старопрамен,thermaplugg,1225,warrior,fury,73,35,38
Schmetterina,proudmoore,1223,warrior,fury,49,28,21
Svênsk,argent-dawn,1211,warrior,fury,24,13,11
Warrmax,darksorrow,1208,warrior,fury,42,22,20
Oughn,silvermoon,1207,warrior,fury,35,16,19
Lillebibbi,tarren-mill,1206,warrior,fury,29,13,16
Blaying,ravencrest,1192,warrior,fury,23,13,10
Agitoyami,defias-brotherhood,1180,warrior,fury,36,21,15
Delinde,cthun,1175,warrior,fury,87,42,45
Hobbó,draenor,1175,warrior,fury,48,13,35
Номер,eversong,1174,warrior,fury,126,56,70
Nubá,burning-legion,1164,warrior,fury,24,17,7
Säl,ragnaros,1160,warrior,fury,31,17,14
Sonnylolxd,dun-modr,1152,warrior,fury,18,12,6
Joeférnandes,ragnaros,1152,warrior,fury,18,12,6
Исскатель,gordunni,1150,warrior,fury,12,12,0
Roxxyy,stormreaver,1148,warrior,fury,18,12,6
Лимор,howling-fjord,1146,warrior,fury,30,12,18
Baoni,hyjal,1144,warrior,fury,30,12,18
Нордгаар,howling-fjord,1143,warrior,fury,18,12,6
Кимиюки,gordunni,1143,warrior,fury,24,12,12
Gìlgamesh,dun-modr,1141,warrior,fury,18,12,6
Bluemango,ragnaros,1141,warrior,fury,24,12,12
Васильна,soulflayer,1137,warrior,fury,18,12,6
Exhumator,blackhand,1135,warrior,fury,36,12,24
Skefe,archimonde,1130,warrior,fury,18,12,6
Dundulinka,outland,1128,warrior,fury,34,13,21
Kebra,blackmoore,1122,warrior,fury,34,19,15
Nykyro,draenor,1119,warrior,fury,54,23,31
Moustachu,kirin-tor,1118,warrior,fury,27,14,13
Rayeron,sanguino,1117,warrior,fury,24,12,12
Sabrewølf,blackmoore,1096,warrior,fury,48,24,24
Floppikatten,kazzak,1091,warrior,fury,18,13,5
Seka,nozdormu,1068,warrior,fury,60,32,28
Помойник,gordunni,1062,warrior,fury,47,31,16
Копенгаген,ashenvale,1061,warrior,fury,24,13,11
Stóna,blackmoore,1056,warrior,fury,30,11,19
Читора,blackscar,1055,warrior,fury,18,11,7
Maroux,malganis,1055,warrior,fury,18,11,7
Âshnâzgðûr,burning-blade,1055,warrior,fury,30,11,19
Грамол,soulflayer,1054,warrior,fury,18,11,7
Джелорд,howling-fjord,1052,warrior,fury,24,11,13
Stratoz,ragnaros,1052,warrior,fury,27,12,15
Æsterius,blackmoore,1051,warrior,fury,21,12,9
Hítmachine,outland,1051,warrior,fury,24,11,13
Amagaddon,draenor,1050,warrior,fury,28,12,16
Murgrimm,die-silberne-hand,1048,warrior,fury,39,23,16
Orcgrim,nozdormu,1047,warrior,fury,30,15,15
Нириэла,howling-fjord,1047,warrior,fury,24,11,13
Whysospicey,lightbringer,1043,warrior,fury,21,12,9
Rìsàs,draenor,1041,warrior,fury,95,38,57
Zerm,draenor,1038,warrior,fury,18,11,7
Tigron,burning-legion,1037,warrior,fury,18,11,7
Ragecap,rexxar,1033,warrior,fury,24,11,13
Tdanielt,burning-legion,1032,warrior,fury,18,11,7
Falaliss,elune,1030,warrior,fury,36,18,18
Azzog,archimonde,1028,warrior,fury,48,21,27
Valhrann,dalaran,1024,warrior,fury,24,11,13
Ragnòk,eredar,1017,warrior,fury,30,11,19
Achonar,draenor,1012,warrior,fury,23,11,12
Fknmoo,kazzak,997,warrior,fury,78,39,39
Kurko,blackmoore,997,warrior,fury,23,11,12
Sairos,kirin-tor,988,warrior,fury,36,19,17
Krlebajker,tarren-mill,977,warrior,fury,27,14,13
Эребб,howling-fjord,966,warrior,fury,60,29,31
Pj,sanguino,960,warrior,fury,12,10,2
Highoverlord,aggra-português,959,warrior,fury,18,10,8
Geez,burning-blade,959,warrior,fury,18,10,8
Футжисубо,razuvious,959,warrior,fury,24,10,14
Груббоб,booty-bay,958,warrior,fury,18,10,8
Гронвер,soulflayer,957,warrior,fury,18,10,8
Budwise,stormscale,957,warrior,fury,18,10,8
Botgrinder,blackhand,955,warrior,fury,12,10,2
Борзило,howling-fjord,953,warrior,fury,18,10,8
Well,kult-der-verdammten,951,warrior,fury,18,10,8
Draxxann,ravencrest,946,warrior,fury,12,10,2
Xaturesw,twisting-nether,943,warrior,fury,12,10,2
Kungeen,silvermoon,927,warrior,fury,30,10,20
Rédsonja,chamber-of-aspects,914,warrior,fury,36,18,18
Иктиннос,gordunni,911,warrior,fury,23,10,13
Inconcussae,drakthul,903,warrior,fury,18,11,7
Sperta,frostmourne,903,warrior,fury,24,11,13
Ogerit,blackmoore,898,warrior,fury,30,14,16
Суферна,howling-fjord,894,warrior,fury,27,13,14
Bëlzé,les-clairvoyants,887,warrior,fury,36,13,23
Enzja,nazjatar,878,warrior,fury,19,10,9
Jâbs,hyjal,875,warrior,fury,36,11,25
Kihili,twisting-nether,864,warrior,fury,12,9,3
Asmoche,archimonde,864,warrior,fury,12,9,3
Sparkzu,twisting-nether,864,warrior,fury,12,9,3
Азктор,soulflayer,864,warrior,fury,18,9,9
Рэйвисмашина,gordunni,864,warrior,fury,24,9,15
Broksigarr,ragnaros,863,warrior,fury,12,9,3
Веоленс,gordunni,863,warrior,fury,12,9,3
Нейв,blackscar,863,warrior,fury,18,9,9
Wornag,argent-dawn,863,warrior,fury,18,9,9
Tandrall,rexxar,863,warrior,fury,24,9,15
Picciocino,nemesis,863,warrior,fury,24,9,15
Zyzie,argent-dawn,863,warrior,fury,24,9,15
Grimleaper,twisting-nether,862,warrior,fury,18,9,9
Itchiiz,alonsus,862,warrior,fury,18,9,9
Жироштемп,gordunni,861,warrior,fury,24,9,15
Valkirya,arthas,859,warrior,fury,24,9,15
Ranndall,blackrock,851,warrior,fury,18,9,9
Taurras,nathrezim,850,warrior,fury,41,20,21
Ânaxi,silvermoon,831,warrior,fury,14,10,4
Shieldlord,kazzak,824,warrior,fury,35,9,26
Jøtawarrior,sanguino,815,warrior,fury,17,9,8
Варриорнир,howling-fjord,814,warrior,fury,14,10,4
Blutwar,kazzak,799,warrior,fury,20,10,10
Gamepresa,silvermoon,783,warrior,fury,13,9,4
Zern,draenor,768,warrior,fury,12,8,4
Артен,ashenvale,768,warrior,fury,12,8,4
Killhound,argent-dawn,768,warrior,fury,12,8,4
Spokowar,hyjal,768,warrior,fury,12,8,4
Émalkay,tarren-mill,768,warrior,fury,12,8,4
Gôrilla,kazzak,768,warrior,fury,18,8,10
Skylexs,burning-legion,768,warrior,fury,18,8,10
Wgdx,ravencrest,768,warrior,fury,18,8,10
Joéfernandés,sylvanas,768,warrior,fury,18,8,10
Мастерпве,blackscar,767,warrior,fury,12,8,4
Gronos,silvermoon,767,warrior,fury,12,8,4
Ананаслорд,blackscar,767,warrior,fury,12,8,4
Alexandrrior,rexxar,767,warrior,fury,12,8,4
Settin,silvermoon,767,warrior,fury,12,8,4
Skeptikal,argent-dawn,767,warrior,fury,12,8,4
Divyx,tarren-mill,767,warrior,fury,18,8,10
Ðíscøwârrìør,nethersturm,767,warrior,fury,18,8,10
Bukisan,sylvanas,767,warrior,fury,18,8,10
Dallion,azjolnerub,767,warrior,fury,18,8,10
Ампутиль,gordunni,766,warrior,fury,12,8,4
Thebiggreen,twisting-nether,766,warrior,fury,12,8,4
Лазба,gordunni,766,warrior,fury,16,9,7
Неуно,howling-fjord,766,warrior,fury,18,8,10
Alevucerdaa,draenor,766,warrior,fury,18,8,10
Сэч,gordunni,765,warrior,fury,12,8,4
Warinator,ravencrest,765,warrior,fury,12,8,4
Hangovar,thrall,764,warrior,fury,15,9,6
Greatsword,turalyon,763,warrior,fury,12,8,4
Ipes,blackmoore,763,warrior,fury,15,9,6
Cazzpowa,frostmane,762,warrior,fury,12,8,4
Khaalo,blackhand,760,warrior,fury,12,8,4
Plackø,draenor,751,warrior,fury,17,8,9
Blaktarr,dunemaul,719,warrior,fury,15,8,7
Вагранна,soulflayer,719,warrior,fury,17,8,9
Осгаард,gordunni,711,warrior,fury,21,10,11
Mamox,archimonde,687,warrior,fury,13,8,5
Слайдус,gordunni,678,warrior,fury,21,10,11
Quadfather,kazzak,672,warrior,fury,12,7,5
Zwareboy,frostmane,672,warrior,fury,12,7,5
Где,blackscar,672,warrior,fury,12,7,5
Snuzzygeezer,ravencrest,672,warrior,fury,12,7,5
Yserá,auchindoun,672,warrior,fury,12,7,5
Thorken,ragnaros,672,warrior,fury,12,7,5
Yawalad,stormscale,672,warrior,fury,15,8,7
Emcix,aszune,672,warrior,fury,18,7,11
Андервульф,booty-bay,672,warrior,fury,18,7,11
Toporceanul,kazzak,672,warrior,fury,18,7,11
Biturboo,blackrock,672,warrior,fury,22,8,14
Теокрафт,howling-fjord,671,warrior,fury,12,7,5
Dgyfh,dun-morogh,671,warrior,fury,12,7,5
Buffury,twisting-nether,671,warrior,fury,12,7,5
Broknagar,draenor,671,warrior,fury,12,7,5
Cocojumbo,azuremyst,671,warrior,fury,12,7,5
Sniperwølf,tyrande,671,warrior,fury,12,7,5
Unn,ragnaros,671,warrior,fury,12,7,5
Jaowa,blackmoore,671,warrior,fury,18,7,11
Hagoxfit,los-errantes,671,warrior,fury,18,7,11
Wärfäcë,blades-edge,670,warrior,fury,12,7,5
Toecutter,defias-brotherhood,670,warrior,fury,15,8,7
Garosh,drakthul,666,warrior,fury,12,7,5
Merdé,blackhand,658,warrior,fury,12,7,5
Gabbz,aggra-português,637,warrior,fury,15,8,7
Aleextrasza,silvermoon,607,warrior,fury,14,7,7
Fatspacka,argent-dawn,607,warrior,fury,14,7,7
Tato,frostmourne,606,warrior,fury,11,7,4
Берззлой,gordunni,576,warrior,fury,6,6,0
Артэкриогг,soulflayer,576,warrior,fury,6,6,0
Licious,outland,576,warrior,fury,6,6,0
Féélmyfury,tarren-mill,576,warrior,fury,6,6,0
Thrallhall,kazzak,576,warrior,fury,6,6,0
Elainax,eredar,576,warrior,fury,12,6,6
Shintuargar,blackrock,576,warrior,fury,12,6,6
Humanboi,ravencrest,576,warrior,fury,12,6,6
Zadirich,burning-blade,576,warrior,fury,12,6,6
Thodak,blackrock,576,warrior,fury,12,6,6
Flexbot,blackmoore,576,warrior,fury,12,6,6
Arkataz,argent-dawn,576,warrior,fury,12,6,6
Dírectdash,draenor,576,warrior,fury,12,6,6
Honzakesl,drakthul,576,warrior,fury,12,6,6
Redwraith,stormscale,576,warrior,fury,12,6,6
Nallepúh,silvermoon,576,warrior,fury,12,6,6
Pouckette,hyjal,576,warrior,fury,12,6,6
Crandalius,kazzak,576,warrior,fury,12,6,6
Глинм,gordunni,576,warrior,fury,12,6,6
Shurubel,outland,576,warrior,fury,12,6,6
Рэйлет,gordunni,576,warrior,fury,12,6,6
Circumcist,dragonblight,576,warrior,fury,12,6,6
Showerfresh,silvermoon,576,warrior,fury,12,6,6
Stanfury,sylvanas,576,warrior,fury,12,6,6
Dhloos,kazzak,576,warrior,fury,12,6,6
Monbun,silvermoon,576,warrior,fury,12,6,6
Eygón,silvermoon,576,warrior,fury,12,6,6
Сталиран,gordunni,576,warrior,fury,18,6,12
Mazzkze,silvermoon,576,warrior,fury,18,6,12
Fightinghell,stormrage,575,warrior,fury,12,6,6
Суммрак,grom,575,warrior,fury,12,6,6
Bigmercy,ragnaros,575,warrior,fury,12,6,6
Malasortë,sylvanas,575,warrior,fury,12,6,6
Realz,malganis,575,warrior,fury,12,6,6
Daramir,turalyon,575,warrior,fury,12,6,6
Oravedenes,draenor,575,warrior,fury,12,6,6
Cuuz,outland,575,warrior,fury,12,6,6
Flaggerware,stormscale,575,warrior,fury,12,6,6
Nmwar,turalyon,575,warrior,fury,12,6,6
Ikkr,kazzak,575,warrior,fury,18,6,12
Honeymew,draenor,575,warrior,fury,18,6,12
Rèckless,argent-dawn,574,warrior,fury,12,6,6
Вкусныисыр,soulflayer,574,warrior,fury,12,6,6
Блиблоб,eversong,574,warrior,fury,12,6,6
Guinnasse,khaz-modan,567,warrior,fury,12,6,6
Miina,blutkessel,566,warrior,fury,12,6,6
Discølove,frostwolf,543,warrior,fury,11,6,5
Skeptikal,tarren-mill,527,warrior,fury,11,6,5
Dûrøtan,marécage-de-zangar,527,warrior,fury,15,6,9
Balsor,frostmane,526,warrior,fury,11,6,5
Retmain,draenor,522,warrior,fury,20,8,12
Mortalclaw,kazzak,521,warrior,fury,27,7,20
Flówér,auchindoun,480,warrior,fury,6,5,1
Horovoko,kazzak,480,warrior,fury,6,5,1
Tweran,drakthul,480,warrior,fury,6,5,1
Дайбек,howling-fjord,480,warrior,fury,6,5,1
Astreimehns,sanguino,480,warrior,fury,6,5,1
Ézélya,dalaran,480,warrior,fury,6,5,1
Спайкуссь,goldrinn,480,warrior,fury,6,5,1
Easypoîntsx,tarren-mill,480,warrior,fury,6,5,1
Timmyda,dalaran,480,warrior,fury,6,5,1
Релайк,gordunni,480,warrior,fury,6,5,1
Ptp,argent-dawn,480,warrior,fury,6,5,1
Ødên,frostmane,480,warrior,fury,12,5,7
Гатал,howling-fjord,480,warrior,fury,12,5,7
Eddíemòrphin,kazzak,480,warrior,fury,12,5,7
Whimbux,stormscale,480,warrior,fury,12,5,7
Hellocritty,blackmoore,480,warrior,fury,12,5,7
Kondomi,stormreaver,480,warrior,fury,12,5,7
Soullmike,drakthul,480,warrior,fury,12,5,7
Savarøx,blackmoore,480,warrior,fury,12,5,7
Напутанность,soulflayer,480,warrior,fury,12,5,7
Ulthrak,archimonde,480,warrior,fury,12,5,7
Axamo,ragnaros,480,warrior,fury,12,5,7
Darthmalgus,stormscale,480,warrior,fury,12,5,7
Sodium,pozzo-delleternità,480,warrior,fury,12,5,7
Orkoje,argent-dawn,480,warrior,fury,12,5,7
Arthayl,eredar,480,warrior,fury,12,5,7
Альмас,galakrond,480,warrior,fury,12,5,7
Beznacaj,outland,480,warrior,fury,12,5,7
Soakmybeet,archimonde,480,warrior,fury,12,5,7
Stkacha,sanguino,480,warrior,fury,12,5,7
Fîlzlaus,area-52,480,warrior,fury,12,5,7
Касюлин,gordunni,480,warrior,fury,12,5,7
Jugg,emerald-dream,480,warrior,fury,12,5,7
Nightmareb,magtheridon,480,warrior,fury,12,5,7
Варёнок,soulflayer,479,warrior,fury,12,5,7
Prime,outland,479,warrior,fury,12,5,7
Motorhead,tirion,479,warrior,fury,12,5,7
Kaerz,ysondre,479,warrior,fury,12,5,7
Solidier,archimonde,479,warrior,fury,12,5,7
Элейд,thermaplugg,479,warrior,fury,12,5,7
Luciferkhan,twisting-nether,479,warrior,fury,12,5,7
Rqyz,tarren-mill,479,warrior,fury,12,5,7
Дерзкаяфурия,gordunni,479,warrior,fury,12,5,7
Harbee,stormscale,479,warrior,fury,15,5,10
Offpants,drakthul,479,warrior,fury,18,5,13
Destrzadora,exodar,477,warrior,fury,12,5,7
Roostai,shattered-hand,476,warrior,fury,12,5,7
Stroj,aerie-peak,472,warrior,fury,12,5,7
Horymir,ravencrest,463,warrior,fury,11,5,6
Fenr,sanguino,444,warrior,fury,11,7,4
Piinte,naxxramas,444,warrior,fury,11,5,6
Yugoslav,argent-dawn,426,warrior,fury,16,6,10
Nogo,nagrand,425,warrior,fury,9,6,3
Djranji,kazzak,416,warrior,fury,10,5,5
Famous,argent-dawn,400,warrior,fury,7,5,2
Нерморрог,howling-fjord,384,warrior,fury,6,4,2
Bloódángel,frostwolf,384,warrior,fury,6,4,2
Bravest,ragnaros,384,warrior,fury,6,4,2
Razzani,nathrezim,384,warrior,fury,6,4,2
Daldiee,ravencrest,384,warrior,fury,6,4,2
Баджераа,soulflayer,384,warrior,fury,6,4,2
Кайзерчиф,soulflayer,384,warrior,fury,6,4,2
Diioxyde,temple-noir,384,warrior,fury,6,4,2
Dominow,ysondre,384,warrior,fury,6,4,2
Orkboii,ravencrest,384,warrior,fury,6,4,2
Вульрайс,deepholm,384,warrior,fury,6,4,2
Madvlad,twisting-nether,384,warrior,fury,6,4,2
Bersurker,draenor,384,warrior,fury,6,4,2
Pierøne,nemesis,384,warrior,fury,6,4,2
Míngxuan,tarren-mill,384,warrior,fury,6,4,2
Báshx,outland,384,warrior,fury,6,4,2
Tanja,bronzebeard,384,warrior,fury,6,4,2
Bravestar,ungoro,384,warrior,fury,6,4,2
Стано,booty-bay,384,warrior,fury,6,4,2
Nihroxis,blackrock,384,warrior,fury,6,4,2
Впижаме,gordunni,384,warrior,fury,6,4,2
Sanngridr,defias-brotherhood,384,warrior,fury,6,4,2
Suzzon,hyjal,384,warrior,fury,6,4,2
Gandosh,blackmoore,384,warrior,fury,6,4,2
Vullgrîm,blackmoore,384,warrior,fury,6,4,2
Dollystyle,kazzak,384,warrior,fury,6,4,2
Lair,zuljin,384,warrior,fury,6,4,2
Chipstjuven,tarren-mill,384,warrior,fury,6,4,2
Oksimbillah,blackrock,384,warrior,fury,6,4,2
Lôcutus,thrall,384,warrior,fury,6,4,2
Vivaladirt,argent-dawn,384,warrior,fury,6,4,2
Executte,zuljin,384,warrior,fury,6,4,2
Колобочек,eversong,384,warrior,fury,12,4,8
Gromrigg,draenor,384,warrior,fury,12,4,8
Midvînter,silvermoon,384,warrior,fury,12,4,8
Råkeff,tarren-mill,384,warrior,fury,12,4,8
Drswing,kazzak,384,warrior,fury,12,4,8
Тактоядобрый,ashenvale,384,warrior,fury,12,4,8
Янесними,soulflayer,384,warrior,fury,12,4,8
Fortressa,ravencrest,384,warrior,fury,12,4,8
Darriuso,kazzak,384,warrior,fury,12,4,8
Andjuu,doomhammer,384,warrior,fury,12,4,8
Изберг,soulflayer,384,warrior,fury,12,4,8
Аркашевич,gordunni,384,warrior,fury,12,4,8
Nekerka,burning-legion,384,warrior,fury,12,4,8
Kurenn,tarren-mill,384,warrior,fury,12,4,8
Garradoom,stormscale,384,warrior,fury,17,5,12
Thibow,hyjal,383,warrior,fury,6,4,2
Siltiel,marécage-de-zangar,383,warrior,fury,6,4,2
Romanondo,doomhammer,383,warrior,fury,6,4,2
Dullegriet,veknilash,383,warrior,fury,12,4,8
Tiscanno,nemesis,382,warrior,fury,6,4,2
Beogor,grim-batol,367,warrior,fury,11,4,7
Bolss,silvermoon,352,warrior,fury,10,4,6
Greensmash,hyjal,351,warrior,fury,14,5,9
Bossít,doomhammer,336,warrior,fury,9,4,5
Skillissues,argent-dawn,330,warrior,fury,11,7,4
Ragedotcom,archimonde,320,warrior,fury,10,4,6
Hawkman,outland,319,warrior,fury,5,4,1
Limejuicer,argent-dawn,319,warrior,fury,8,4,4
Manelar,draenor,319,warrior,fury,8,4,4
Anaba,voljin,318,warrior,fury,10,4,6
Mfdoöm,draenor,288,warrior,fury,6,3,3
Jengaa,draenor,288,warrior,fury,6,3,3
Punahabe,draenor,288,warrior,fury,6,3,3
Sakumo,sylvanas,288,warrior,fury,6,3,3
Васяжелезо,gordunni,288,warrior,fury,6,3,3
Лаинвуд,soulflayer,288,warrior,fury,6,3,3
Ibunnyone,blackrock,288,warrior,fury,6,3,3
Izrael,alakir,288,warrior,fury,6,3,3
Damonx,draenor,288,warrior,fury,6,3,3
Ntouziera,silvermoon,288,warrior,fury,6,3,3
Bindera,silvermoon,288,warrior,fury,6,3,3
Kronmw,dun-modr,288,warrior,fury,6,3,3
Friendlytwo,quelthalas,288,warrior,fury,6,3,3
Uncledazzo,quelthalas,288,warrior,fury,6,3,3
Wunderwaffle,xavius,288,warrior,fury,6,3,3
Tabboonishka,draenor,288,warrior,fury,6,3,3
Morganãrogán,ragnaros,288,warrior,fury,6,3,3
Spitonem,blackrock,288,warrior,fury,6,3,3
Тегриско,goldrinn,288,warrior,fury,6,3,3
Xerone,doomhammer,288,warrior,fury,6,3,3
Honör,sylvanas,288,warrior,fury,6,3,3
Гацс,soulflayer,288,warrior,fury,6,3,3
Taeshalach,der-abyssische-rat,288,warrior,fury,6,3,3
Waroworgen,terokkar,288,warrior,fury,6,3,3
Immera,silvermoon,288,warrior,fury,6,3,3
Hazarku,colinas-pardas,288,warrior,fury,6,3,3
Geicoo,dalaran,288,warrior,fury,6,3,3
Furyre,ysondre,288,warrior,fury,6,3,3
Drfeelgud,twisting-nether,288,warrior,fury,6,3,3
Bønecleaver,blackrock,288,warrior,fury,6,3,3
Frankytank,antonidas,288,warrior,fury,6,3,3
Skullsmasher,stormscale,288,warrior,fury,6,3,3
Léonie,arakarahm,288,warrior,fury,6,3,3
Hortswarr,drakthul,288,warrior,fury,6,3,3
Madhardy,chamber-of-aspects,288,warrior,fury,6,3,3
Ruixxted,stormreaver,288,warrior,fury,6,3,3
Balltas,drakthul,288,warrior,fury,6,3,3
Dríppy,aegwynn,288,warrior,fury,6,3,3
Dangeruos,ragnaros,288,warrior,fury,6,3,3
Obox,ravencrest,288,warrior,fury,6,3,3
Afk,emeriss,288,warrior,fury,6,3,3
Vory,ravencrest,288,warrior,fury,6,3,3
Lâppön,blackmoore,288,warrior,fury,6,3,3
Bstgame,frostmane,288,warrior,fury,6,3,3
Whàtsup,stormscale,288,warrior,fury,6,3,3
Eekz,haomarush,288,warrior,fury,6,3,3
Barrocket,aegwynn,288,warrior,fury,6,3,3
Mïîäm,archimonde,288,warrior,fury,6,3,3
Aìrwave,blackmoore,288,warrior,fury,6,3,3
Kagsteelfist,twisting-nether,288,warrior,fury,6,3,3
Cryze,ravencrest,288,warrior,fury,6,3,3
Kapuchino,twisting-nether,288,warrior,fury,6,3,3
Ivailowar,ravencrest,288,warrior,fury,6,3,3
Didgedelik,archimonde,288,warrior,fury,6,3,3
Prixor,grim-batol,288,warrior,fury,6,3,3
Eleborn,tarren-mill,288,warrior,fury,6,3,3
Septymyya,eredar,288,warrior,fury,9,4,5
Xeraaya,kirin-tor,288,warrior,fury,12,3,9
Kiryn,draenor,288,warrior,fury,12,3,9
Valldi,argent-dawn,288,warrior,fury,12,3,9
Aphae,defias-brotherhood,288,warrior,fury,12,3,9
Rofos,hellscream,288,warrior,fury,12,3,9
Grommer,dentarg,288,warrior,fury,12,3,9
Nightvision,skullcrusher,288,warrior,fury,12,3,9
Bäiley,drakthul,288,warrior,fury,12,3,9
Ganian,stormscale,288,warrior,fury,12,3,9
Urabrask,stormscale,288,warrior,fury,12,3,9
Pamila,outland,288,warrior,fury,12,3,9
Confliction,outland,288,warrior,fury,12,3,9
Dabliu,burning-legion,288,warrior,fury,12,3,9
Atelier,magtheridon,287,warrior,fury,6,3,3
Mistawolf,ravencrest,287,warrior,fury,6,3,3
Xonnico,ravencrest,287,warrior,fury,6,3,3
Arnnau,dun-modr,287,warrior,fury,6,3,3
Agunnai,karazhan,286,warrior,fury,6,3,3
Tiapollo,dun-modr,271,warrior,fury,11,3,8
Moggorr,nemesis,271,warrior,fury,11,3,8
Tàuruss,blackhand,256,warrior,fury,10,3,7
Execute,sanguino,239,warrior,fury,5,3,2
Hazl,balnazzar,238,warrior,fury,5,3,2
Xqt,laughing-skull,234,warrior,fury,9,4,5
Iarsonn,drakthul,223,warrior,fury,8,3,5
Флокт,howling-fjord,208,warrior,fury,7,3,4
Имбанутыйвар,soulflayer,192,warrior,fury,4,3,1
Чпонькмашина,soulflayer,192,warrior,fury,6,2,4
Durrüti,sanguino,192,warrior,fury,6,2,4
Khòrne,sanguino,192,warrior,fury,6,2,4
Wembley,proudmoore,192,warrior,fury,6,2,4
Zalazain,burning-legion,192,warrior,fury,6,2,4
Frowenn,ravencrest,192,warrior,fury,6,2,4
Ifir,hyjal,192,warrior,fury,6,2,4
Piixxz,hyjal,192,warrior,fury,6,2,4
Velgur,ravencrest,192,warrior,fury,6,2,4
Amédé,ysondre,192,warrior,fury,6,2,4
Basingaa,pozzo-delleternità,192,warrior,fury,6,2,4
Skykrow,ysondre,192,warrior,fury,6,2,4
Warrzor,auchindoun,192,warrior,fury,6,2,4
Picklejuicer,argent-dawn,192,warrior,fury,6,2,4
Bulletpants,argent-dawn,192,warrior,fury,6,2,4
Eyolf,thunderhorn,192,warrior,fury,6,2,4
Jriddyzug,ravencrest,192,warrior,fury,6,2,4
Alxqt,outland,192,warrior,fury,6,2,4
Apacolata,outland,192,warrior,fury,6,2,4
Gregórry,eredar,192,warrior,fury,6,2,4
Suichôken,archimonde,192,warrior,fury,6,2,4
Lianore,sanguino,192,warrior,fury,6,2,4
Nemecic,arathor,192,warrior,fury,6,2,4
Кентафурик,soulflayer,192,warrior,fury,6,2,4
Чюнилингус,soulflayer,192,warrior,fury,6,2,4
Zirvey,tarren-mill,192,warrior,fury,6,2,4
Souler,burning-legion,192,warrior,fury,6,2,4
Avgorcgodx,stormscale,192,warrior,fury,6,2,4
Mîcî,tarren-mill,192,warrior,fury,6,2,4
Evilweraz,turalyon,192,warrior,fury,6,2,4
Miotyz,ahnqiraj,192,warrior,fury,6,2,4
Hördê,zuljin,192,warrior,fury,6,2,4
Саркон,ashenvale,192,warrior,fury,6,2,4
Maniaco,kazzak,192,warrior,fury,6,2,4
Freddie,baelgun,192,warrior,fury,6,2,4
Гудмунт,borean-tundra,192,warrior,fury,6,2,4
Jorund,archimonde,192,warrior,fury,6,2,4
Rayyes,stormscale,192,warrior,fury,6,2,4
Grobler,blackhand,192,warrior,fury,6,2,4
Buntstift,thrall,192,warrior,fury,6,2,4
Artheim,silvermoon,192,warrior,fury,6,2,4
Nabucadnozor,illidan,192,warrior,fury,6,2,4
Løktær,blackmoore,192,warrior,fury,6,2,4
Shownomercy,blackrock,192,warrior,fury,6,2,4
Nokturnâl,silvermoon,192,warrior,fury,6,2,4
Pakusrage,defias-brotherhood,192,warrior,fury,12,2,10
Angrethar,tarren-mill,192,warrior,fury,12,2,10
Arzes,draenor,192,warrior,fury,12,2,10
Sycon,chamber-of-aspects,192,warrior,fury,12,2,10
Торакусу,gordunni,191,warrior,fury,6,2,4
Tömahawk,defias-brotherhood,191,warrior,fury,6,2,4
Omosha,burning-legion,191,warrior,fury,6,2,4
Dorinaz,die-aldor,191,warrior,fury,6,2,4
Кереешка,howling-fjord,175,warrior,fury,11,2,9
Brülldozer,kargath,159,warrior,fury,5,2,3
Mybigcow,darkspear,159,warrior,fury,5,2,3
Æxcoast,ravencrest,128,warrior,fury,4,2,2
Feltias,drakthul,96,warrior,fury,6,1,5
Furyfame,darksorrow,96,warrior,fury,6,1,5
Zyn,outland,96,warrior,fury,6,1,5
Swordluw,argent-dawn,96,warrior,fury,6,1,5
Raakalainen,vashj,96,warrior,fury,6,1,5
Spacemachine,kazzak,96,warrior,fury,6,1,5
Dolora,ragnaros,96,warrior,fury,6,1,5
Wanzzeur,hyjal,96,warrior,fury,6,1,5
Temprament,ravencrest,96,warrior,fury,6,1,5
Marícan,blackmoore,96,warrior,fury,6,1,5
Dp,area-52,96,warrior,fury,6,1,5
Mot,terenas,96,warrior,fury,6,1,5
Greekazi,kazzak,96,warrior,fury,6,1,5
Stratic,blackmoore,96,warrior,fury,6,1,5
Galenthor,ravencrest,96,warrior,fury,6,1,5
Sorkk,kazzak,96,warrior,fury,6,1,5
Moldamis,blackhand,96,warrior,fury,6,1,5
Coldstory,draenor,96,warrior,fury,6,1,5
Azrail,xavius,96,warrior,fury,6,1,5
Naspy,stormscale,96,warrior,fury,6,1,5
Raixxon,ragnaros,96,warrior,fury,6,1,5
Albabhaltair,quelthalas,96,warrior,fury,6,1,5
Армапипец,soulflayer,96,warrior,fury,6,1,5
Фиббоначи,deathguard,96,warrior,fury,6,1,5
Hágríd,ragnaros,96,warrior,fury,12,1,11
Pitii,burning-legion,63,warrior,fury,2,2,0
Хоркан,blackscar,31,warrior,fury,2,1,1
Marcus,ravencrest,2144,warrior,arms,90,46,44
Réckx,twisting-nether,2136,warrior,arms,69,39,30
Blîxtgordon,tarren-mill,2133,warrior,arms,78,42,36
Palianytsia,ravencrest,2125,warrior,arms,77,40,37
Noragrets,stormscale,2116,warrior,arms,80,41,39
Regnarok,sylvanas,2115,warrior,arms,154,90,64
Grkpwh,silvermoon,2105,warrior,arms,88,48,40
Immørtálx,tarren-mill,2102,warrior,arms,72,38,34
Midgetdamis,blackhand,2093,warrior,arms,78,56,22
Nikkí,naxxramas,2074,warrior,arms,90,47,43
Кокдиллак,soulflayer,2073,warrior,arms,122,62,60
Ulrid,draenor,2052,warrior,arms,66,36,30
Savesta,dalaran,2047,warrior,arms,126,66,60
Скварх,howling-fjord,2041,warrior,arms,90,56,34
Sickjackenn,executus,2038,warrior,arms,87,41,46
Gabrijel,draenor,2021,warrior,arms,77,38,39
Mitu,sanguino,2016,warrior,arms,185,95,90
Manaskhan,tarren-mill,2011,warrior,arms,66,39,27
Scardrex,defias-brotherhood,2008,warrior,arms,70,37,33
Thomasman,nerathor,2006,warrior,arms,72,36,36
Trâshwarriør,blackhand,1998,warrior,arms,62,27,35
Elwarroo,dun-modr,1997,warrior,arms,100,56,44
Оркабал,howling-fjord,1987,warrior,arms,101,55,46
Комочекгнева,howling-fjord,1968,warrior,arms,55,30,25
Zak,stormscale,1955,warrior,arms,78,37,41
Disarmed,auchindoun,1945,warrior,arms,54,31,23
Myonmyonmyon,blackmoore,1937,warrior,arms,68,41,27
Wràthfúl,kazzak,1937,warrior,arms,119,60,59
Seifcham,ragnaros,1926,warrior,arms,72,35,37
Kapuchino,twisting-nether,1921,warrior,arms,48,27,21
Cerry,ravencrest,1919,warrior,arms,81,39,42
Merked,kazzak,1912,warrior,arms,60,31,29
Timpey,kazzak,1911,warrior,arms,54,30,24
Naronnas,drakthul,1910,warrior,arms,104,58,46
Pentagramlol,twisting-nether,1895,warrior,arms,54,27,27
Julololo,archimonde,1893,warrior,arms,72,40,32
Courageous,ravencrest,1889,warrior,arms,66,39,27
Ástriax,ravencrest,1888,warrior,arms,135,68,67
Drclapit,blackrock,1884,warrior,arms,42,23,19
Qtcockxx,stormscale,1883,warrior,arms,54,27,27
Sagethi,blackrock,1883,warrior,arms,77,37,40
Schaufelørc,blackrock,1881,warrior,arms,60,31,29
Куесэс,howling-fjord,1880,warrior,arms,36,20,16
Cathériné,drakthul,1875,warrior,arms,48,27,21
Doomqt,terokkar,1873,warrior,arms,47,27,20
Хэйре,howling-fjord,1873,warrior,arms,113,61,52
Hellguard,archimonde,1872,warrior,arms,84,47,37
Emix,arygos,1871,warrior,arms,54,31,23
Karny,ravencrest,1870,warrior,arms,48,31,17
Bigboomer,frostmane,1861,warrior,arms,72,31,41
Gewyon,ragnaros,1859,warrior,arms,42,22,20
Длоордпро,soulflayer,1859,warrior,arms,41,20,21
Sekwar,twisting-nether,1858,warrior,arms,42,21,21
Бодибилдерыч,gordunni,1857,warrior,arms,83,48,35
Alegral,ravencrest,1856,warrior,arms,71,32,39
Брокскрим,soulflayer,1854,warrior,arms,54,28,26
Mômsboy,tarren-mill,1853,warrior,arms,64,33,31
Ланро,gordunni,1853,warrior,arms,65,33,32
Skorm,mugthol,1849,warrior,arms,36,27,9
Thenx,tarren-mill,1849,warrior,arms,63,30,33
Krônm,dun-modr,1847,warrior,arms,78,33,45
Daredevìl,eredar,1843,warrior,arms,83,40,43
Thorana,twisting-nether,1842,warrior,arms,47,27,20
Вэшикх,soulflayer,1841,warrior,arms,53,29,24
Xvlanter,silvermoon,1841,warrior,arms,78,41,37
Jriddyzug,ravencrest,1840,warrior,arms,62,33,29
Хиро,deathweaver,1839,warrior,arms,54,27,27
Ozrenac,kazzak,1838,warrior,arms,60,34,26
Ässholedamis,blackhand,1837,warrior,arms,48,35,13
Gguts,archimonde,1836,warrior,arms,67,37,30
Вандэрбой,howling-fjord,1836,warrior,arms,102,48,54
Аэска,deathweaver,1836,warrior,arms,60,28,32
Tozzhug,ragnaros,1835,warrior,arms,48,28,20
Chaddimus,draenor,1833,warrior,arms,42,28,14
Bàrbandit,archimonde,1832,warrior,arms,42,24,18
Боссберс,soulflayer,1831,warrior,arms,89,44,45
Watrux,outland,1831,warrior,arms,66,31,35
Rhâpsodyw,ravencrest,1829,warrior,arms,48,29,19
Aerês,tarren-mill,1828,warrior,arms,90,45,45
Kamked,burning-legion,1828,warrior,arms,107,50,57
Blazefüry,ravencrest,1827,warrior,arms,61,33,28
Jenkinzz,stormscale,1826,warrior,arms,36,23,13
Варбоссец,soulflayer,1825,warrior,arms,66,35,31
Lanstus,silvermoon,1823,warrior,arms,72,42,30
Crîxús,silvermoon,1822,warrior,arms,60,25,35
Greenblób,kazzak,1821,warrior,arms,60,25,35
Uzamaki,bronzebeard,1820,warrior,arms,48,32,16
Knutrex,tarren-mill,1820,warrior,arms,61,35,26
Лилиофаныч,soulflayer,1820,warrior,arms,35,20,15
Лимпс,gordunni,1819,warrior,arms,30,19,11
Флагмэн,gordunni,1819,warrior,arms,65,36,29
Ðênnis,ravencrest,1818,warrior,arms,30,19,11
Pürporcc,archimonde,1818,warrior,arms,97,48,49
Sneakydrm,kazzak,1817,warrior,arms,34,22,12
Экзекьютлол,soulflayer,1816,warrior,arms,47,25,22
Joéfernandés,sylvanas,1816,warrior,arms,36,19,17
Apacolata,outland,1816,warrior,arms,45,23,22
Klonyarik,ravencrest,1815,warrior,arms,36,19,17
Gnømércy,stormscale,1815,warrior,arms,36,19,17
Leethal,outland,1814,warrior,arms,60,27,33
Juank,minahonda,1814,warrior,arms,48,21,27
Joeférnandes,ragnaros,1813,warrior,arms,53,28,25
Vic,tarren-mill,1813,warrior,arms,47,20,27
Axinit,blackrock,1811,warrior,arms,42,23,19
Idiotplay,drekthar,1811,warrior,arms,42,19,23
Johnmeadows,ravencrest,1810,warrior,arms,36,23,13
Ðiscordia,blackhand,1810,warrior,arms,84,43,41
Connorzw,blackmoore,1809,warrior,arms,36,23,13
Oldchap,nordrassil,1807,warrior,arms,48,31,17
Олдборовс,soulflayer,1807,warrior,arms,53,29,24
Варзила,blackscar,1807,warrior,arms,53,22,31
Piccante,nemesis,1806,warrior,arms,36,26,10
Wayneson,tarren-mill,1806,warrior,arms,108,58,50
Книфэк,howling-fjord,1806,warrior,arms,76,40,36
Hulkensmash,kazzak,1806,warrior,arms,124,64,60
Куртфорренс,gordunni,1805,warrior,arms,43,19,24
Zheaks,kazzak,1804,warrior,arms,60,30,30
Çatàclysmíc,kazzak,1804,warrior,arms,60,30,30
Hanìbal,ravencrest,1803,warrior,arms,60,32,28
Gatts,krasus,1803,warrior,arms,125,60,65
Ghakra,kazzak,1802,warrior,arms,36,25,11
Selenez,outland,1802,warrior,arms,60,29,31
Маклецкий,gordunni,1802,warrior,arms,144,68,76
Zombossio,tarren-mill,1801,warrior,arms,62,33,29
Phalek,argent-dawn,1800,warrior,arms,48,28,20
Shortcvnt,ravencrest,1800,warrior,arms,48,28,20
Azudaddy,blackmoore,1800,warrior,arms,59,34,25
Böggzbunny,tarren-mill,1800,warrior,arms,42,24,18
Dairøx,blackrock,1800,warrior,arms,60,31,29
Oswáld,defias-brotherhood,1793,warrior,arms,24,19,5
Rngmonster,kazzak,1793,warrior,arms,88,61,27
Вокилог,soulflayer,1793,warrior,arms,155,78,77
Maarshl,ysondre,1789,warrior,arms,121,67,54
Ezøn,aegwynn,1786,warrior,arms,59,31,28
Voxz,stormscale,1783,warrior,arms,123,62,61
Кладбошаа,gordunni,1779,warrior,arms,77,45,32
Bloodhorn,blackhand,1779,warrior,arms,101,50,51
Urasli,doomhammer,1777,warrior,arms,30,20,10
Agoen,silvermoon,1777,warrior,arms,42,19,23
Komissarecks,aegwynn,1776,warrior,arms,45,27,18
Shookyx,ravencrest,1775,warrior,arms,42,24,18
Stupidz,hyjal,1773,warrior,arms,48,21,27
Kiyomaro,stormscale,1771,warrior,arms,48,25,23
Enøt,kazzak,1767,warrior,arms,41,20,21
Zhangbeihai,ravencrest,1766,warrior,arms,54,26,28
Khÿze,ysondre,1764,warrior,arms,52,34,18
Chucho,argent-dawn,1761,warrior,arms,48,26,22
Palmsweaty,stormrage,1761,warrior,arms,54,23,31
Shilix,twisting-nether,1758,warrior,arms,91,38,53
Мелькорт,gordunni,1755,warrior,arms,36,25,11
Messermozart,blackmoore,1755,warrior,arms,42,20,22
Шурпач,deathguard,1753,warrior,arms,42,20,22
Cleaver,tarren-mill,1752,warrior,arms,54,29,25
Ущипнузатитю,deathguard,1752,warrior,arms,66,29,37
Pj,sanguino,1750,warrior,arms,68,30,38
Воинлета,howling-fjord,1748,warrior,arms,91,52,39
Toscothegoat,ravencrest,1747,warrior,arms,30,19,11
Nozuki,archimonde,1747,warrior,arms,167,84,83
Gigadot,arathor,1746,warrior,arms,138,71,67
Mojotsche,taerar,1738,warrior,arms,64,36,28
Cerßere,archimonde,1738,warrior,arms,60,29,31
Cesr,bloodhoof,1738,warrior,arms,106,47,59
Cisataker,hyjal,1737,warrior,arms,24,20,4
Pivcuga,kazzak,1736,warrior,arms,93,44,49
Galeron,kazzak,1734,warrior,arms,48,22,26
Reccey,blackrock,1732,warrior,arms,93,46,47
Magnî,auchindoun,1731,warrior,arms,54,29,25
Jengaa,draenor,1731,warrior,arms,78,40,38
Yellowjuice,stormscale,1728,warrior,arms,114,69,45
Sahl,sylvanas,1728,warrior,arms,87,49,38
Dõxqt,kazzak,1726,warrior,arms,44,24,20
Khalimov,tarren-mill,1724,warrior,arms,60,29,31
Yorgal,arakarahm,1723,warrior,arms,36,18,18
Dannyp,twisting-nether,1722,warrior,arms,36,18,18
Blåvingad,kazzak,1720,warrior,arms,38,23,15
Mystylez,silvermoon,1720,warrior,arms,48,22,26
Flinta,blackmoore,1719,warrior,arms,36,20,16
Gucciwarrior,blackhand,1716,warrior,arms,66,26,40
Arkataz,argent-dawn,1715,warrior,arms,60,30,30
ßloodz,hyjal,1712,warrior,arms,54,27,27
Lyriae,argent-dawn,1711,warrior,arms,60,34,26
Ítikovan,aegwynn,1710,warrior,arms,127,61,66
Karuck,tarren-mill,1709,warrior,arms,30,19,11
Otp,ravencrest,1708,warrior,arms,42,22,20
Grimlok,sylvanas,1708,warrior,arms,47,21,26
Гатсберсерк,gordunni,1707,warrior,arms,95,52,43
Caméltoe,frostwolf,1707,warrior,arms,66,32,34
Cherserker,ragnaros,1704,warrior,arms,52,29,23
Thrux,dalaran,1701,warrior,arms,36,26,10
Wasro,norgannon,1701,warrior,arms,48,25,23
Therealman,kazzak,1699,warrior,arms,38,23,15
Klonyarika,ravencrest,1699,warrior,arms,36,20,16
Bigboyx,kazzak,1697,warrior,arms,38,21,17
Атаир,deathweaver,1696,warrior,arms,40,24,16
Jakim,tarren-mill,1694,warrior,arms,90,48,42
Riptack,anetheron,1693,warrior,arms,104,62,42
Hasbullá,kazzak,1693,warrior,arms,86,42,44
Maldark,scarshield-legion,1693,warrior,arms,94,44,50
Grántor,eredar,1691,warrior,arms,42,29,13
Oluwafunmila,tarren-mill,1691,warrior,arms,50,26,24
Дайбайхенд,howling-fjord,1691,warrior,arms,60,30,30
Robou,hyjal,1691,warrior,arms,74,29,45
Bôlufonâ,dun-modr,1690,warrior,arms,47,25,22
Омепразол,gordunni,1688,warrior,arms,107,55,52
Sharpen,chamber-of-aspects,1688,warrior,arms,56,24,32
Crandalius,kazzak,1686,warrior,arms,81,49,32
Poolboyx,tarren-mill,1683,warrior,arms,78,40,38
Spártacus,kazzak,1683,warrior,arms,76,33,43
Nargez,outland,1682,warrior,arms,36,22,14
Rbbx,tarren-mill,1682,warrior,arms,44,24,20
Skädy,dun-modr,1682,warrior,arms,36,18,18
Solezte,tarren-mill,1678,warrior,arms,84,50,34
Аоетакси,soulflayer,1678,warrior,arms,66,34,32
Thyréc,blackmoore,1676,warrior,arms,48,24,24
Cazaril,kazzak,1673,warrior,arms,101,50,51
Aeyon,burning-blade,1672,warrior,arms,33,20,13
Fràgile,ravencrest,1672,warrior,arms,48,24,24
Xgs,archimonde,1671,warrior,arms,107,55,52
Mazaharine,archimonde,1671,warrior,arms,42,20,22
Оксенфурт,soulflayer,1671,warrior,arms,48,21,27
Yelanx,twisting-nether,1670,warrior,arms,36,25,11
Шагах,soulflayer,1669,warrior,arms,89,44,45
Xendyo,frostmourne,1669,warrior,arms,84,38,46
Khanox,twisting-nether,1668,warrior,arms,54,29,25
Туранк,howling-fjord,1667,warrior,arms,49,26,23
Krew,drakthul,1665,warrior,arms,60,31,29
Balltas,drakthul,1664,warrior,arms,50,26,24
Mirageous,tarren-mill,1664,warrior,arms,53,25,28
Nardoch,archimonde,1663,warrior,arms,46,23,23
Mortalfist,stormscale,1662,warrior,arms,31,19,12
Theryk,sanguino,1658,warrior,arms,53,21,32
Киссмиплис,gordunni,1655,warrior,arms,57,29,28
Asquare,stormscale,1655,warrior,arms,40,18,22
Spartaz,eredar,1653,warrior,arms,48,22,26
Vratranzhul,kirin-tor,1647,warrior,arms,109,56,53
Dríx,hyjal,1646,warrior,arms,48,25,23
Kobeni,ysondre,1646,warrior,arms,59,29,30
Поршекаен,howling-fjord,1645,warrior,arms,71,29,42
Untiltèd,ravencrest,1644,warrior,arms,77,55,22
Woobaby,outland,1644,warrior,arms,42,23,19
Odenscolddry,kazzak,1642,warrior,arms,53,25,28
Дроктул,howling-fjord,1641,warrior,arms,113,53,60
Gigasmash,pozzo-delleternità,1640,warrior,arms,102,50,52
Фенилэфрин,gordunni,1639,warrior,arms,110,56,54
Вуриор,howling-fjord,1636,warrior,arms,78,39,39
Nitheriá,draenor,1636,warrior,arms,161,78,83
Atlizz,twisting-nether,1635,warrior,arms,78,41,37
Spijkerbroek,alakir,1633,warrior,arms,83,46,37
Lyroe,blackrock,1633,warrior,arms,42,21,21
Reapo,blackhand,1632,warrior,arms,137,67,70
Flaãy,ravencrest,1631,warrior,arms,83,49,34
Donquiexote,ravencrest,1631,warrior,arms,36,20,16
Lyes,uldaman,1631,warrior,arms,113,57,56
Blayr,tarren-mill,1631,warrior,arms,71,33,38
Facestomper,onyxia,1627,warrior,arms,66,37,29
Rageco,ravencrest,1626,warrior,arms,36,23,13
Zëhef,hyjal,1626,warrior,arms,42,26,16
Ebonheart,argent-dawn,1626,warrior,arms,104,50,54
Amokdamis,blackhand,1626,warrior,arms,45,21,24
Trôth,kazzak,1625,warrior,arms,24,17,7
Xiiver,burning-legion,1624,warrior,arms,44,27,17
Civok,kult-der-verdammten,1624,warrior,arms,30,17,13
Æriø,dalaran,1624,warrior,arms,30,17,13
Watashilfy,ravencrest,1624,warrior,arms,48,24,24
Wlãð,archimonde,1624,warrior,arms,48,23,25
Sefty,tarren-mill,1622,warrior,arms,35,17,18
Мастерион,soulflayer,1621,warrior,arms,48,25,23
Dunecrab,tarren-mill,1619,warrior,arms,30,17,13
Aeldran,argent-dawn,1617,warrior,arms,42,23,19
Gladius,ysera,1615,warrior,arms,86,43,43
Zexa,tarren-mill,1615,warrior,arms,36,17,19
Manoito,argent-dawn,1615,warrior,arms,48,22,26
Damagz,tarren-mill,1615,warrior,arms,53,22,31
Ðezia,tarren-mill,1614,warrior,arms,84,45,39
Asenine,sylvanas,1612,warrior,arms,154,72,82
Гримг,lich-king,1610,warrior,arms,51,25,26
Benzemá,sanguino,1609,warrior,arms,24,17,7
Strife,ravencrest,1609,warrior,arms,81,51,30
Wismerx,kazzak,1609,warrior,arms,42,20,22
Javakt,stormscale,1609,warrior,arms,48,20,28
Whoosah,ragnaros,1608,warrior,arms,105,54,51
Kaieh,argent-dawn,1607,warrior,arms,30,17,13
Jambaz,ravencrest,1607,warrior,arms,47,23,24
Ryle,anubarak,1607,warrior,arms,72,34,38
Erikeverhard,nathrezim,1607,warrior,arms,36,17,19
Кибервайфу,howling-fjord,1606,warrior,arms,24,17,7
Штурмгешутц,deathweaver,1605,warrior,arms,96,51,45
Haraldjuhnke,frostwolf,1605,warrior,arms,53,27,26
Nerfmyrage,hyjal,1603,warrior,arms,30,20,10
Андреевич,blackscar,1603,warrior,arms,140,71,69
Batïk,blackmoore,1603,warrior,arms,71,31,40
Eselhirte,blackmoore,1602,warrior,arms,85,46,39
Хэлслэйтэр,gordunni,1602,warrior,arms,118,61,57
Kupr,outland,1601,warrior,arms,40,21,19
Ragnou,tarren-mill,1601,warrior,arms,54,27,27
Naait,draenor,1600,warrior,arms,45,24,21
Malebolia,mugthol,1600,warrior,arms,69,34,35
Hellespont,hellscream,1598,warrior,arms,65,24,41
Луновоин,gordunni,1597,warrior,arms,36,24,12
Вагранна,soulflayer,1597,warrior,arms,54,26,28
Shirøx,blackrock,1595,warrior,arms,67,38,29
Toroespaña,draenor,1595,warrior,arms,42,22,20
Giganza,outland,1595,warrior,arms,60,27,33
Haanok,ravencrest,1591,warrior,arms,59,34,25
Trashman,bronzebeard,1590,warrior,arms,30,17,13
Bruxus,blackhand,1590,warrior,arms,118,59,59
Aestheticon,burning-blade,1589,warrior,arms,30,19,11
Lazytowl,outland,1588,warrior,arms,69,34,35
Alexandrrior,rexxar,1588,warrior,arms,66,31,35
Btr,archimonde,1588,warrior,arms,42,19,23
Paranoiás,ragnaros,1588,warrior,arms,44,19,25
Mckinseybcg,outland,1585,warrior,arms,30,21,9
Quotx,stormscale,1585,warrior,arms,46,18,28
Skrawarr,das-syndikat,1584,warrior,arms,78,41,37
Picciocino,nemesis,1584,warrior,arms,48,19,29
Троммтар,howling-fjord,1584,warrior,arms,48,19,29
Hortswarr,drakthul,1583,warrior,arms,36,24,12
Fragmeista,ragnaros,1582,warrior,arms,36,17,19
Krigipigi,antonidas,1582,warrior,arms,48,20,28
Shooky,blackrock,1576,warrior,arms,29,17,12
Taistelumage,stormreaver,1576,warrior,arms,35,17,18
Mypzo,kazzak,1575,warrior,arms,66,31,35
Erotixboi,blackrock,1573,warrior,arms,36,23,13
Оргнар,ashenvale,1573,warrior,arms,48,27,21
Monbun,silvermoon,1570,warrior,arms,101,51,50
Rîdler,ravencrest,1569,warrior,arms,193,97,96
Yeahq,kazzak,1569,warrior,arms,42,19,23
Дугмар,gordunni,1569,warrior,arms,71,31,40
Оргрриммар,soulflayer,1568,warrior,arms,132,63,69
Дейдулус,soulflayer,1566,warrior,arms,60,24,36
Tyrasîà,hyjal,1565,warrior,arms,48,18,30
Едигейй,gordunni,1564,warrior,arms,58,32,26
Gozga,twisting-nether,1564,warrior,arms,75,39,36
Bloodbrother,blackmoore,1562,warrior,arms,36,20,16
Pajalousta,elune,1562,warrior,arms,74,36,38
Daýz,draenor,1561,warrior,arms,48,18,30
Wardruine,dun-modr,1560,warrior,arms,77,32,45
Lollydhur,nemesis,1559,warrior,arms,24,17,7
Zhoti,outland,1559,warrior,arms,34,17,17
Anthalar,argent-dawn,1559,warrior,arms,42,19,23
Imfiñe,outland,1558,warrior,arms,107,51,56
Boldinq,ravencrest,1556,warrior,arms,78,31,47
Çon,ravencrest,1554,warrior,arms,72,35,37
Reider,twisting-nether,1553,warrior,arms,119,47,72
Warmâchine,burning-legion,1551,warrior,arms,54,19,35
Philatou,antonidas,1547,warrior,arms,35,20,15
Nightmareowl,tarren-mill,1547,warrior,arms,42,19,23
Varyian,sporeggar,1542,warrior,arms,102,47,55
Wrynir,archimonde,1541,warrior,arms,78,38,40
Pachipachi,blackmoore,1540,warrior,arms,32,17,15
Гуорг,howling-fjord,1538,warrior,arms,75,32,43
Kurbá,stormscale,1535,warrior,arms,24,16,8
Anakhas,archimonde,1535,warrior,arms,30,16,14
Bluto,dunemaul,1534,warrior,arms,30,18,12
Lpa,stormscale,1534,warrior,arms,36,19,17
Ønogal,archimonde,1533,warrior,arms,30,16,14
Serastul,rajaxx,1533,warrior,arms,80,38,42
Tiwâz,eredar,1531,warrior,arms,51,26,25
Èzekiel,dalaran,1530,warrior,arms,36,18,18
Áäáäáäáä,aegwynn,1529,warrior,arms,30,16,14
Nyxz,blackhand,1529,warrior,arms,32,17,15
Morthôr,grim-batol,1529,warrior,arms,57,27,30
Чпокерз,gordunni,1528,warrior,arms,48,25,23
Брок,soulflayer,1528,warrior,arms,36,16,20
Pokopo,blackrock,1527,warrior,arms,199,101,98
Gravityfalls,blackmoore,1527,warrior,arms,78,39,39
Bumoletroll,draenor,1526,warrior,arms,33,17,16
Miko,ysondre,1524,warrior,arms,42,20,22
Chargeurface,ragnaros,1522,warrior,arms,24,16,8
Zeddone,drakthul,1522,warrior,arms,30,16,14
Darshan,grim-batol,1522,warrior,arms,36,16,20
Shrekwarr,kazzak,1521,warrior,arms,95,46,49
Norwegian,silvermoon,1521,warrior,arms,80,37,43
Aurélus,rexxar,1520,warrior,arms,30,20,10
Каосвар,howling-fjord,1520,warrior,arms,24,16,8
Мэйрил,lich-king,1519,warrior,arms,190,99,91
Shownomercy,blackrock,1519,warrior,arms,48,23,25
Arcreign,kazzak,1519,warrior,arms,54,25,29
Vallahan,argent-dawn,1517,warrior,arms,131,66,65
Genjutsubeat,blackmoore,1516,warrior,arms,42,24,18
Arandyr,archimonde,1516,warrior,arms,36,16,20
Spärtan,dun-modr,1515,warrior,arms,66,34,32
Darksídex,silvermoon,1515,warrior,arms,140,71,69
Everdipper,outland,1515,warrior,arms,42,16,26
Думхаммер,howling-fjord,1514,warrior,arms,47,30,17
Craghak,twisting-nether,1514,warrior,arms,84,43,41
Aizy,blackhand,1510,warrior,arms,24,16,8
Wildblue,sylvanas,1510,warrior,arms,54,30,24
Cyruk,blackmoore,1509,warrior,arms,36,16,20
Трешконтент,gordunni,1508,warrior,arms,36,17,19
Бурчун,deathguard,1507,warrior,arms,42,25,17
Кефтеме,fordragon,1507,warrior,arms,69,35,34
Raakalainen,vashj,1505,warrior,arms,41,20,21
Киллдекс,gordunni,1505,warrior,arms,60,25,35
Franzbardon,archimonde,1504,warrior,arms,36,21,15
Gely,silvermoon,1503,warrior,arms,36,17,19
Nighat,sanguino,1500,warrior,arms,152,77,75
Громпузан,galakrond,1500,warrior,arms,42,18,24
Blackwólf,bloodhoof,1498,warrior,arms,94,42,52
Svënja,ysondre,1496,warrior,arms,84,37,47
Dragoons,tyrande,1495,warrior,arms,36,16,20
Llestatl,hyjal,1494,warrior,arms,59,32,27
Irén,hellfire,1493,warrior,arms,38,19,19
Friskos,dalaran,1492,warrior,arms,46,20,26
Pumpadzhîja,outland,1491,warrior,arms,66,32,34
Romanul,terokkar,1490,warrior,arms,42,20,22
Bastrick,argent-dawn,1490,warrior,arms,69,32,37
Hôrn,stormscale,1489,warrior,arms,54,32,22
Endeawour,ravencrest,1489,warrior,arms,129,75,54
Divyx,tarren-mill,1489,warrior,arms,48,25,23
Hefthyn,sanguino,1488,warrior,arms,36,20,16
Gargaflike,aggra-português,1488,warrior,arms,54,18,36
Hindbærsaft,stormscale,1487,warrior,arms,55,32,23
Sorkk,kazzak,1487,warrior,arms,30,16,14
Мускулатор,soulflayer,1487,warrior,arms,60,30,30
Заверчу,soulflayer,1485,warrior,arms,30,17,13
Togas,silvermoon,1483,warrior,arms,75,40,35
Marcnky,stormscale,1478,warrior,arms,39,22,17
Арткес,gordunni,1477,warrior,arms,45,23,22
Fizzywarrior,blackmoore,1477,warrior,arms,51,23,28
Slidmacka,twisting-nether,1476,warrior,arms,93,39,54
Leomance,hyjal,1473,warrior,arms,30,18,12
Authar,tarren-mill,1473,warrior,arms,43,22,21
Icekissx,hyjal,1473,warrior,arms,76,37,39
Tmp,blackrock,1470,warrior,arms,42,22,20
Clellin,silvermoon,1469,warrior,arms,75,37,38
Sonìe,kazzak,1468,warrior,arms,41,26,15
Phenowarri,blackhand,1468,warrior,arms,61,33,28
Напутанность,soulflayer,1467,warrior,arms,206,105,101
Dárkhammer,tarren-mill,1465,warrior,arms,54,24,30
Raley,ragnaros,1464,warrior,arms,54,26,28
Notinfa,draenor,1460,warrior,arms,54,30,24
Mljecho,kazzak,1460,warrior,arms,30,16,14
Ckz,ysondre,1455,warrior,arms,24,16,8
Jokkul,tarren-mill,1455,warrior,arms,40,16,24
Crriminal,ravencrest,1454,warrior,arms,42,17,25
Omgihithard,draenor,1452,warrior,arms,36,17,19
Dzvenyhora,darkspear,1449,warrior,arms,78,36,42
Norinhell,ravencrest,1448,warrior,arms,48,20,28
Ajax,defias-brotherhood,1447,warrior,arms,36,16,20
Trenbullone,kazzak,1446,warrior,arms,45,28,17
Endan,kelthuzad,1446,warrior,arms,66,37,29
Tyëlin,elune,1446,warrior,arms,71,35,36
Faustà,nemesis,1445,warrior,arms,54,23,31
Karimlebrave,hyjal,1440,warrior,arms,68,33,35
Markers,twisting-nether,1439,warrior,arms,30,15,15
Makerrw,ravencrest,1438,warrior,arms,50,26,24
Ardmoo,burning-legion,1437,warrior,arms,39,20,19
Gorocpt,doomhammer,1437,warrior,arms,38,18,20
Thundersword,sylvanas,1437,warrior,arms,36,15,21
Ганблейд,eversong,1437,warrior,arms,47,19,28
Alyx,mugthol,1436,warrior,arms,66,33,33
Lachandrius,blackhand,1435,warrior,arms,72,33,39
Europ,silvermoon,1435,warrior,arms,36,15,21
Nedåh,blackrock,1434,warrior,arms,30,15,15
Mazzkze,silvermoon,1433,warrior,arms,168,85,83
Мерсилессх,gordunni,1433,warrior,arms,54,24,30
Frozenliøn,twisting-nether,1431,warrior,arms,30,15,15
Otiep,blackmoore,1430,warrior,arms,36,24,12
Dataçasé,silvermoon,1430,warrior,arms,24,15,9
Ordwinz,silvermoon,1429,warrior,arms,37,19,18
Андэрс,gordunni,1429,warrior,arms,106,51,55
Asuramaru,aegwynn,1428,warrior,arms,47,24,23
Trapoulas,kazzak,1428,warrior,arms,48,15,33
Alinash,aegwynn,1427,warrior,arms,51,24,27
Brizeis,malganis,1426,warrior,arms,30,15,15
Icybladez,kazzak,1422,warrior,arms,46,22,24
Gacel,dun-modr,1420,warrior,arms,48,23,25
Zellxd,stormscale,1418,warrior,arms,36,20,16
Avelyr,pozzo-delleternità,1418,warrior,arms,30,15,15
Nuahka,blackmoore,1416,warrior,arms,28,17,11
Lyarinsky,tyrande,1416,warrior,arms,48,26,22
Cléàvage,silvermoon,1416,warrior,arms,60,23,37
Madaxe,kazzak,1414,warrior,arms,24,20,4
Дообрыйшмель,soulflayer,1414,warrior,arms,45,28,17
Oruka,mannoroth,1412,warrior,arms,42,24,18
Drushíí,shattrath,1411,warrior,arms,35,17,18
Megtorló,ragnaros,1408,warrior,arms,51,24,27
Jáson,kazzak,1408,warrior,arms,41,18,23
Варгана,soulflayer,1405,warrior,arms,34,19,15
Gorchak,blackmoore,1405,warrior,arms,89,43,46
Stormfist,tarren-mill,1403,warrior,arms,36,19,17
Bjösk,stormscale,1403,warrior,arms,45,23,22
Éls,argent-dawn,1401,warrior,arms,36,17,19
Северот,deepholm,1401,warrior,arms,35,16,19
Diz,terokkar,1400,warrior,arms,67,38,29
Джасткипинг,gordunni,1399,warrior,arms,84,45,39
Taylorswifty,twisting-nether,1398,warrior,arms,60,34,26
Mograinê,blackmoore,1398,warrior,arms,48,26,22
Абабоба,gordunni,1398,warrior,arms,30,16,14
Mortalik,silvermoon,1398,warrior,arms,110,52,58
Zosska,burning-legion,1398,warrior,arms,36,17,19
Hradball,twilights-hammer,1398,warrior,arms,36,17,19
ßladex,azshara,1395,warrior,arms,35,21,14
Bládez,ravencrest,1394,warrior,arms,66,36,30
Nekerka,burning-legion,1394,warrior,arms,65,33,32
Papipulki,zuljin,1394,warrior,arms,56,23,33
Chakrator,la-croisade-écarlate,1393,warrior,arms,36,17,19
Mfdoöm,draenor,1392,warrior,arms,42,16,26
Dranush,onyxia,1391,warrior,arms,68,35,33
Jumbodolmen,tarren-mill,1389,warrior,arms,30,16,14
Diástasi,twisting-nether,1384,warrior,arms,90,48,42
Кэфтэмэ,soulflayer,1382,warrior,arms,73,35,38
Фелпир,soulflayer,1381,warrior,arms,60,27,33
Okoru,stormscale,1381,warrior,arms,48,17,31
Doxinator,silvermoon,1380,warrior,arms,33,16,17
Peack,ravencrest,1379,warrior,arms,53,28,25
Qiz,silvermoon,1378,warrior,arms,128,66,62
Xaheld,blackrock,1376,warrior,arms,30,16,14
Malalulu,burning-legion,1376,warrior,arms,95,45,50
Temprament,ravencrest,1375,warrior,arms,36,21,15
Bleckwarrior,ravencrest,1371,warrior,arms,78,39,39
Einherjer,burning-legion,1369,warrior,arms,34,21,13
Throck,drakthul,1369,warrior,arms,36,18,18
Qvate,twisting-nether,1369,warrior,arms,53,26,27
Dokô,twisting-nether,1366,warrior,arms,42,18,24
Taikyokuken,hyjal,1365,warrior,arms,48,22,26
Nucleargrab,twilights-hammer,1362,warrior,arms,73,35,38
Arreat,chogall,1362,warrior,arms,72,30,42
Hatefury,twisting-nether,1360,warrior,arms,72,33,39
Nabul,thunderhorn,1359,warrior,arms,30,16,14
Палачубийца,deathguard,1356,warrior,arms,48,27,21
Bonesz,jaedenar,1356,warrior,arms,63,32,31
Tealbell,chamber-of-aspects,1354,warrior,arms,101,55,46
Vølverinwar,thrall,1354,warrior,arms,54,23,31
Espröc,kazzak,1353,warrior,arms,101,52,49
Reider,kazzak,1353,warrior,arms,34,16,18
Nelthôr,alleria,1350,warrior,arms,59,29,30
Staribrko,outland,1347,warrior,arms,102,45,57
Tarkosha,terokkar,1346,warrior,arms,150,70,80
Zargor,kazzak,1344,warrior,arms,36,22,14
Pazl,outland,1344,warrior,arms,36,17,19
Belattor,silvermoon,1343,warrior,arms,30,14,16
Colard,ravencrest,1343,warrior,arms,30,14,16
Pazùzu,twisting-nether,1342,warrior,arms,24,14,10
Istyos,hyjal,1342,warrior,arms,30,14,16
Infernion,jaedenar,1341,warrior,arms,24,14,10
Zzeed,auchindoun,1341,warrior,arms,48,19,29
Морнстар,gordunni,1340,warrior,arms,24,14,10
Buyya,ravencrest,1340,warrior,arms,46,25,21
Zandawar,drakthul,1339,warrior,arms,59,33,26
Pacosky,burning-legion,1339,warrior,arms,45,24,21
Nassir,stormscale,1338,warrior,arms,30,14,16
Raixxon,ragnaros,1336,warrior,arms,48,20,28
Samîr,arthas,1334,warrior,arms,24,14,10
Carras,confrérie-du-thorium,1332,warrior,arms,89,38,51
Барсток,soulflayer,1332,warrior,arms,36,14,22
Флэксик,soulflayer,1331,warrior,arms,24,14,10
Tazdingowar,antonidas,1328,warrior,arms,46,18,28
Лисерк,howling-fjord,1328,warrior,arms,36,14,22
Behemothwr,kazzak,1327,warrior,arms,75,37,38
Nàsher,frostwolf,1327,warrior,arms,30,14,16
Greekazi,kazzak,1327,warrior,arms,48,21,27
Chádtóurps,drakthul,1326,warrior,arms,29,14,15
Нетконечно,howling-fjord,1325,warrior,arms,30,14,16
Белхэнд,soulflayer,1325,warrior,arms,42,14,28
Highz,grim-batol,1324,warrior,arms,30,16,14
Ähäkutti,frostmane,1323,warrior,arms,42,23,19
Bxnx,aegwynn,1321,warrior,arms,24,15,9
Dragão,kazzak,1320,warrior,arms,30,14,16
Crayz,twisting-nether,1320,warrior,arms,30,14,16
Неосим,gordunni,1319,warrior,arms,24,15,9
Informatica,doomhammer,1318,warrior,arms,24,14,10
Lostbull,kazzak,1317,warrior,arms,30,14,16
Astven,blackmoore,1316,warrior,arms,40,16,24
Exot,eredar,1315,warrior,arms,36,22,14
Guruntar,kirin-tor,1315,warrior,arms,62,29,33
Ràgnarok,chogall,1314,warrior,arms,60,33,27
Unarde,silvermoon,1314,warrior,arms,137,69,68
Kmica,khadgar,1314,warrior,arms,61,27,34
Адво,gordunni,1312,warrior,arms,36,15,21
Lebronjones,sylvanas,1311,warrior,arms,42,21,21
Оморальный,soulflayer,1311,warrior,arms,88,39,49
Malevolént,silvermoon,1310,warrior,arms,48,23,25
Carsannies,stormscale,1310,warrior,arms,48,22,26
Скользкийбро,gordunni,1310,warrior,arms,54,24,30
Гардринг,howling-fjord,1309,warrior,arms,30,17,13
Roctah,auchindoun,1309,warrior,arms,46,24,22
Neverkind,twisting-nether,1307,warrior,arms,66,37,29
Tucomessuelo,cthun,1306,warrior,arms,30,15,15
Piksitron,silvermoon,1305,warrior,arms,40,28,12
Xunaakt,nemesis,1305,warrior,arms,45,23,22
Jigsar,argent-dawn,1304,warrior,arms,36,21,15
Kirowarrior,silvermoon,1303,warrior,arms,24,14,10
Pakusrage,defias-brotherhood,1302,warrior,arms,36,14,22
Bossít,doomhammer,1301,warrior,arms,80,44,36
Jisoowar,blackhand,1301,warrior,arms,36,17,19
Агамемнан,soulflayer,1300,warrior,arms,82,40,42
Рыгулька,gordunni,1298,warrior,arms,29,14,15
Hobo,ravencrest,1298,warrior,arms,29,14,15
Weareinspace,stormscale,1296,warrior,arms,34,18,16
Zaatar,draenor,1296,warrior,arms,54,27,27
Seliasbro,kazzak,1295,warrior,arms,30,15,15
Сэлфиш,lich-king,1295,warrior,arms,29,14,15
Chippéd,draenor,1294,warrior,arms,23,14,9
Inelegant,tarren-mill,1290,warrior,arms,60,32,28
Ghorglukk,lightnings-blade,1290,warrior,arms,60,28,32
Huscar,thrall,1290,warrior,arms,35,14,21
Pangowar,elune,1288,warrior,arms,27,14,13
Cutting,burning-legion,1288,warrior,arms,29,14,15
Ingensan,lightbringer,1288,warrior,arms,51,22,29
Безбожник,eversong,1286,warrior,arms,30,17,13
Blackbiird,blackmoore,1286,warrior,arms,29,14,15
Zool,madmortem,1285,warrior,arms,45,20,25
Arithael,dun-modr,1283,warrior,arms,72,33,39
Lûckystríké,blackmoore,1283,warrior,arms,46,21,25
Leroxius,ragnaros,1283,warrior,arms,60,26,34
Grahatia,magtheridon,1281,warrior,arms,24,15,9
Thisguyfax,the-venture-co,1281,warrior,arms,54,27,27
Diggawhat,antonidas,1280,warrior,arms,52,24,28
Гогрикк,ashenvale,1279,warrior,arms,72,35,37
Инелутабл,eversong,1273,warrior,arms,23,14,9
Ангрол,grom,1273,warrior,arms,35,14,21
Дикийппц,gordunni,1271,warrior,arms,24,14,10
Kaîsaschnitt,malganis,1269,warrior,arms,22,14,8
Ragnacore,ravencrest,1265,warrior,arms,35,19,16
Ranran,emerald-dream,1264,warrior,arms,32,14,18
Colosius,stormscale,1262,warrior,arms,48,29,19
Silabozija,ravencrest,1262,warrior,arms,60,29,31
Sertigan,dun-modr,1262,warrior,arms,39,16,23
Рестат,soulflayer,1262,warrior,arms,71,25,46
Iluwar,ragnaros,1260,warrior,arms,40,15,25
Swefy,sanguino,1259,warrior,arms,91,36,55
Apôlyon,antonidas,1256,warrior,arms,29,14,15
Soulcleaver,stormreaver,1255,warrior,arms,44,23,21
Кентаныч,howling-fjord,1254,warrior,arms,48,22,26
Zeroskllz,outland,1252,warrior,arms,34,16,18
Aggamemnus,ravencrest,1248,warrior,arms,32,20,12
Соджиро,howling-fjord,1248,warrior,arms,24,13,11
Semmino,nemesis,1248,warrior,arms,24,13,11
Dirtyjoe,khaz-modan,1248,warrior,arms,77,36,41
Kanté,burning-blade,1247,warrior,arms,18,13,5
Leeches,aggramar,1247,warrior,arms,24,13,11
Mastodøntes,hyjal,1247,warrior,arms,30,13,17
Zheq,ragnaros,1246,warrior,arms,24,13,11
Saadx,ravencrest,1245,warrior,arms,18,13,5
Fruiittyy,ravencrest,1245,warrior,arms,24,13,11
Pummelthru,burning-legion,1244,warrior,arms,30,13,17
Morrzerk,sylvanas,1243,warrior,arms,23,14,9
Zaerna,draenor,1243,warrior,arms,24,13,11
Tinkaton,sylvanas,1243,warrior,arms,30,13,17
Soundso,blackmoore,1242,warrior,arms,26,15,11
Kelhim,blackrock,1242,warrior,arms,24,13,11
Furukawa,ravencrest,1242,warrior,arms,24,13,11
Phóó,thrall,1242,warrior,arms,30,13,17
Кхаррнн,gordunni,1242,warrior,arms,30,13,17
Gonutz,sylvanas,1241,warrior,arms,24,13,11
Ðræms,eldrethalas,1241,warrior,arms,60,27,33
Laavapoeg,outland,1240,warrior,arms,24,13,11
Архиватор,gordunni,1239,warrior,arms,24,13,11
Màb,antonidas,1239,warrior,arms,24,13,11
Exoblade,silvermoon,1238,warrior,arms,36,14,22
Tahzwolf,stormscale,1236,warrior,arms,18,13,5
Perkoulator,archimonde,1236,warrior,arms,63,25,38
Makgorei,outland,1236,warrior,arms,39,14,25
Endermite,magtheridon,1234,warrior,arms,35,20,15
Scrèàm,tarren-mill,1234,warrior,arms,24,13,11
Plt,talnivarr,1233,warrior,arms,41,25,16
Funknîco,wrathbringer,1233,warrior,arms,37,19,18
Ральдвин,gordunni,1230,warrior,arms,34,17,17
Кизуми,gordunni,1227,warrior,arms,33,14,19
Iljaana,blackrock,1226,warrior,arms,24,13,11
Azëlls,archimonde,1225,warrior,arms,82,42,40
Элейд,thermaplugg,1225,warrior,arms,47,23,24
Yuriko,onyxia,1222,warrior,arms,24,13,11
Zøom,ysondre,1222,warrior,arms,40,20,20
Solaría,garona,1222,warrior,arms,30,15,15
Draleckx,sanguino,1222,warrior,arms,94,43,51
Kloppnîx,blackmoore,1221,warrior,arms,38,23,15
Дрейсен,gordunni,1219,warrior,arms,24,14,10
Propanex,kazzak,1219,warrior,arms,27,14,13
Ghostwarx,blackmoore,1215,warrior,arms,38,19,19
Troma,archimonde,1213,warrior,arms,35,13,22
Youokhun,kazzak,1212,warrior,arms,24,13,11
Maggisauce,aegwynn,1209,warrior,arms,57,32,25
Karden,doomhammer,1206,warrior,arms,42,16,26
Excutíé,twisting-nether,1202,warrior,arms,30,18,12
Lûxn,silvermoon,1202,warrior,arms,102,49,53
Beans,argent-dawn,1202,warrior,arms,60,22,38
Aiarm,twisting-nether,1200,warrior,arms,48,31,17
Quarantino,ysondre,1199,warrior,arms,64,30,34
Mañtís,argent-dawn,1198,warrior,arms,80,41,39
Mozterwar,ravencrest,1197,warrior,arms,66,28,38
Kugghalfswor,doomhammer,1196,warrior,arms,57,23,34
Reapersrage,twisting-nether,1195,warrior,arms,27,13,14
Rèâpèr,kazzak,1192,warrior,arms,36,24,12
Slaughteredd,kazzak,1190,warrior,arms,48,17,31
Garosh,drakthul,1187,warrior,arms,54,25,29
Галактозар,soulflayer,1187,warrior,arms,48,18,30
Pyret,outland,1185,warrior,arms,40,14,26
Sýkz,exodar,1181,warrior,arms,35,13,22
Hellzint,sanguino,1179,warrior,arms,129,50,79
Виднокрай,gordunni,1177,warrior,arms,36,13,23
Ovcharq,steamwheedle-cartel,1175,warrior,arms,43,17,26
Whàtsup,stormscale,1166,warrior,arms,36,17,19
Sistabossen,magtheridon,1165,warrior,arms,24,13,11
Daguangming,outland,1165,warrior,arms,59,23,36
Grinrok,thrall,1160,warrior,arms,60,25,35
Kerisandra,silvermoon,1157,warrior,arms,31,18,13
Regna,eredar,1157,warrior,arms,90,42,48
Belfodiris,stormscale,1152,warrior,arms,18,12,6
Grimogør,stormscale,1152,warrior,arms,24,12,12
Dõxlol,kazzak,1152,warrior,arms,24,12,12
Azotz,archimonde,1152,warrior,arms,24,12,12
Сладкаяхурма,howling-fjord,1152,warrior,arms,30,12,18
Xurainzone,eredar,1151,warrior,arms,18,12,6
Мираккл,borean-tundra,1151,warrior,arms,18,12,6
Valoo,malganis,1151,warrior,arms,24,12,12
Dnoire,ravencrest,1151,warrior,arms,24,12,12
Konebankærn,ravencrest,1151,warrior,arms,30,12,18
Jínro,draenor,1151,warrior,arms,30,12,18
Saidi,outland,1151,warrior,arms,31,12,19
Eidzø,tarren-mill,1150,warrior,arms,18,12,6
Crazykind,kazzak,1150,warrior,arms,24,12,12
Downpipe,twisting-nether,1150,warrior,arms,24,12,12
Cassândrä,dalaran,1150,warrior,arms,30,12,18
Bamme,archimonde,1149,warrior,arms,24,12,12
Crushonyou,aegwynn,1149,warrior,arms,24,12,12
Sloppychoppy,silvermoon,1149,warrior,arms,41,18,23
Smoothbrian,ravencrest,1148,warrior,arms,18,12,6
ßigarms,ravencrest,1148,warrior,arms,18,12,6
Jonalina,gilneas,1148,warrior,arms,84,42,42
Regnarøk,sylvanas,1148,warrior,arms,24,12,12
Seraphys,ravencrest,1148,warrior,arms,24,12,12
Chillycheesy,blackmoore,1148,warrior,arms,36,12,24
Trenôdeca,stormscale,1147,warrior,arms,24,12,12
Ïnahö,hyjal,1147,warrior,arms,24,12,12
Zwerk,rajaxx,1147,warrior,arms,24,12,12
Nevergladx,kazzak,1147,warrior,arms,30,12,18
Remen,archimonde,1147,warrior,arms,36,12,24
Neoh,onyxia,1146,warrior,arms,51,29,22
Riyan,lothar,1146,warrior,arms,24,12,12
Эпитафорх,blackscar,1146,warrior,arms,24,12,12
Bucketheadde,thrall,1144,warrior,arms,36,12,24
Hùmøngöúslåm,ravencrest,1143,warrior,arms,18,12,6
Ràkar,stormscale,1142,warrior,arms,24,12,12
Brahlus,frostwolf,1142,warrior,arms,30,13,17
Скрежет,gordunni,1142,warrior,arms,30,12,18
Raznon,magtheridon,1140,warrior,arms,30,12,18
Narox,arathor,1139,warrior,arms,30,13,17
Баварриор,greymane,1137,warrior,arms,30,12,18
Téldrus,blackrock,1135,warrior,arms,24,12,12
Ironsteve,blackmoore,1133,warrior,arms,118,46,72
Миранир,soulflayer,1132,warrior,arms,40,21,19
Eekz,haomarush,1132,warrior,arms,24,12,12
Rahaaxhia,kaelthas,1131,warrior,arms,18,12,6
Газрош,howling-fjord,1130,warrior,arms,28,14,14
Крахгал,soulflayer,1128,warrior,arms,88,42,46
Átlás,blackmoore,1128,warrior,arms,31,13,18
Tajiri,alakir,1126,warrior,arms,64,32,32
Фикпопадешь,lich-king,1124,warrior,arms,39,13,26
Tercio,exodar,1123,warrior,arms,60,26,34
Pawn,twisting-nether,1122,warrior,arms,30,12,18
Joka,dun-modr,1121,warrior,arms,25,14,11
Yüle,uldaman,1121,warrior,arms,30,15,15
Ferpylél,ragnaros,1119,warrior,arms,25,13,12
Draktul,aegwynn,1116,warrior,arms,24,14,10
Wyshh,silvermoon,1115,warrior,arms,63,27,36
Dreamkil,archimonde,1112,warrior,arms,44,19,25
Sûgma,blackhand,1108,warrior,arms,44,23,21
Atelier,magtheridon,1106,warrior,arms,24,14,10
Ordínaryname,blackrock,1102,warrior,arms,162,83,79
Doveloo,kazzak,1102,warrior,arms,30,15,15
Argadea,archimonde,1102,warrior,arms,36,15,21
Mélindà,silvermoon,1098,warrior,arms,15,12,3
Хазгора,howling-fjord,1096,warrior,arms,30,13,17
Дрейтон,eversong,1095,warrior,arms,30,13,17
Røiivar,hyjal,1094,warrior,arms,78,29,49
Perykø,sanguino,1094,warrior,arms,34,12,22
Копенгаген,ashenvale,1091,warrior,arms,33,13,20
Ragark,quelthalas,1087,warrior,arms,30,13,17
Obscurìa,argent-dawn,1068,warrior,arms,84,35,49
Inticam,durotan,1066,warrior,arms,26,14,12
Дикийлёха,soulflayer,1064,warrior,arms,30,15,15
Jasperr,nemesis,1063,warrior,arms,61,27,34
Ezjau,blackmoore,1061,warrior,arms,42,24,18
Áosr,ravencrest,1057,warrior,arms,47,24,23
Рексторм,soulflayer,1056,warrior,arms,12,11,1
Schwän,twisting-nether,1056,warrior,arms,18,11,7
Rexonawarr,kazzak,1056,warrior,arms,18,11,7
Pummelpete,grim-batol,1056,warrior,arms,18,11,7
Àlexander,ravencrest,1056,warrior,arms,18,11,7
Klnrk,ravencrest,1056,warrior,arms,18,11,7
Êphêý,kazzak,1056,warrior,arms,24,11,13
Xåb,dun-morogh,1056,warrior,arms,30,11,19
Eidzo,tarren-mill,1055,warrior,arms,18,11,7
Sanerion,antonidas,1055,warrior,arms,18,11,7
Westwyde,hyjal,1055,warrior,arms,18,11,7
Анархорок,howling-fjord,1055,warrior,arms,18,11,7
Brogre,stormrage,1055,warrior,arms,18,11,7
Wake,eredar,1055,warrior,arms,24,11,13
Scormash,burning-legion,1055,warrior,arms,24,11,13
Huyer,stormscale,1055,warrior,arms,24,11,13
Neoballac,uldum,1055,warrior,arms,24,11,13
Stuble,blackhand,1055,warrior,arms,35,15,20
Aemox,silvermoon,1054,warrior,arms,18,11,7
Markorok,kazzak,1054,warrior,arms,18,11,7
Râmi,perenolde,1054,warrior,arms,24,11,13
Apollos,der-mithrilorden,1054,warrior,arms,30,11,19
Orgi,drakthul,1053,warrior,arms,30,11,19
Scusi,burning-blade,1053,warrior,arms,30,11,19
Fruitdealer,shattrath,1053,warrior,arms,37,11,26
Ormert,sylvanas,1052,warrior,arms,22,12,10
Сика,blackscar,1052,warrior,arms,24,11,13
Swayzze,frostwolf,1052,warrior,arms,30,11,19
Deviousjr,ragnaros,1051,warrior,arms,18,11,7
Nameless,ysondre,1051,warrior,arms,24,11,13
Шорпит,howling-fjord,1051,warrior,arms,66,26,40
Spargebuci,draenor,1051,warrior,arms,30,11,19
Farrusco,nemesis,1050,warrior,arms,24,11,13
Dafok,rashgarroth,1050,warrior,arms,24,11,13
Ironsíde,alakir,1050,warrior,arms,30,11,19
Grumpy,lightbringer,1050,warrior,arms,30,11,19
Ylana,eldrethalas,1049,warrior,arms,24,11,13
Beelzebuu,blackhand,1048,warrior,arms,18,11,7
Lyfttokyo,tarren-mill,1047,warrior,arms,24,11,13
Krigsdunken,draenor,1047,warrior,arms,48,15,33
Kestialezin,archimonde,1046,warrior,arms,18,11,7
Batalius,dalaran,1046,warrior,arms,30,11,19
Roponmatsu,draenor,1045,warrior,arms,24,11,13
Arkcules,ghostlands,1044,warrior,arms,24,11,13
Zeldaixi,twisting-nether,1043,warrior,arms,18,11,7
Odonko,blackmoore,1042,warrior,arms,30,16,14
Авентадорх,deathguard,1042,warrior,arms,42,11,31
Peldreas,silvermoon,1041,warrior,arms,29,11,18
Ènteqt,antonidas,1040,warrior,arms,18,11,7
Nokturnâl,silvermoon,1037,warrior,arms,18,11,7
Crixusxx,sanguino,1035,warrior,arms,19,11,8
Степанычь,gordunni,1034,warrior,arms,24,11,13
Katzz,dun-morogh,1031,warrior,arms,24,11,13
Teraa,the-maelstrom,1030,warrior,arms,30,16,14
Dariusvolt,argent-dawn,1028,warrior,arms,53,27,26
Velinde,outland,1019,warrior,arms,23,11,12
Oralinde,silvermoon,1017,warrior,arms,78,43,35
Tazkax,archimonde,1016,warrior,arms,22,11,11
Jebzmiecza,kazzak,1015,warrior,arms,24,11,13
Роккар,gordunni,1012,warrior,arms,24,11,13
Merdé,blackhand,1007,warrior,arms,90,43,47
Conanh,pozzo-delleternità,1007,warrior,arms,32,13,19
Rumer,tarren-mill,1006,warrior,arms,29,11,18
Rejectofrage,ragnaros,1000,warrior,arms,30,15,15
Adrï,draenor,993,warrior,arms,64,35,29
Geicoo,dalaran,988,warrior,arms,56,29,27
Chilp,archimonde,981,warrior,arms,25,12,13
Oldhatreds,twisting-nether,979,warrior,arms,22,11,11
Зед,blackscar,977,warrior,arms,25,13,12
Kravaiski,argent-dawn,977,warrior,arms,30,13,17
Onee,terrordar,971,warrior,arms,19,11,8
Chipstjuven,tarren-mill,963,warrior,arms,25,11,14
Bigschnäbi,blackhand,960,warrior,arms,12,10,2
Абырабыр,howling-fjord,960,warrior,arms,12,10,2
Wintertimex,stormscale,960,warrior,arms,12,10,2
Proeliator,argent-dawn,960,warrior,arms,18,10,8
Andabad,silvermoon,960,warrior,arms,18,10,8
Sponkss,tarren-mill,960,warrior,arms,18,10,8
Broarextiger,ragnaros,960,warrior,arms,18,10,8
Марльин,howling-fjord,960,warrior,arms,18,10,8
Hirurg,thrall,960,warrior,arms,18,10,8
Xxeqtr,kazzak,960,warrior,arms,24,10,14
Элетий,soulflayer,960,warrior,arms,24,10,14
Bravopla,silvermoon,960,warrior,arms,24,10,14
Sindrener,ysondre,960,warrior,arms,30,10,20
Jaythegodx,blackrock,960,warrior,arms,30,10,20
Mbappé,dragonblight,959,warrior,arms,12,10,2
Искристый,howling-fjord,959,warrior,arms,12,10,2
Zdi,blackrock,959,warrior,arms,18,10,8
Hasmocaru,silvermoon,959,warrior,arms,18,10,8
Rabaozi,blackhand,959,warrior,arms,18,10,8
Rookian,blackrock,959,warrior,arms,18,10,8
Badwarr,blackhand,959,warrior,arms,18,10,8
Fearmedear,sylvanas,959,warrior,arms,18,10,8
Maikouyes,archimonde,959,warrior,arms,18,10,8
Meistersykes,silvermoon,959,warrior,arms,21,11,10
Geckoo,emerald-dream,959,warrior,arms,24,10,14
Enzja,nazjatar,959,warrior,arms,24,10,14
Orn,tarren-mill,959,warrior,arms,24,10,14
Gromkarg,draenor,959,warrior,arms,30,10,20
Krônôs,thrall,958,warrior,arms,18,10,8
Убитаякорова,soulflayer,958,warrior,arms,18,10,8
Rogersrage,ragnaros,958,warrior,arms,18,10,8
Braindeady,burning-legion,958,warrior,arms,18,10,8
Vilass,silvermoon,958,warrior,arms,18,10,8
Nøcturnaqq,silvermoon,958,warrior,arms,18,10,8
Gorlemar,blackmoore,958,warrior,arms,18,10,8
Фктпх,blackscar,958,warrior,arms,24,10,14
Vymd,archimonde,958,warrior,arms,28,11,17
Kilsorrow,silvermoon,957,warrior,arms,24,10,14
Латексник,booty-bay,957,warrior,arms,30,10,20
Pag,hyjal,956,warrior,arms,12,10,2
Lucasqt,magtheridon,956,warrior,arms,18,10,8
Mllmmxxm,kargath,956,warrior,arms,24,10,14
Genç,ysondre,955,warrior,arms,18,10,8
Dreadshanks,doomhammer,955,warrior,arms,24,13,11
Xarmog,hyjal,955,warrior,arms,24,10,14
Buntstift,thrall,955,warrior,arms,30,10,20
Hellrokk,drakthul,954,warrior,arms,18,10,8
Труперсила,howling-fjord,954,warrior,arms,24,10,14
Ayelsyssup,silvermoon,954,warrior,arms,24,10,14
Ôwndbylx,aegwynn,954,warrior,arms,27,11,16
Tontonsmoky,hyjal,954,warrior,arms,25,10,15
Cliwar,ragnaros,951,warrior,arms,18,11,7
Warriornrv,ysondre,950,warrior,arms,18,10,8
Волрок,howling-fjord,950,warrior,arms,25,13,12
Zerm,draenor,949,warrior,arms,18,10,8
Jaru,alleria,949,warrior,arms,18,10,8
Taurosk,burning-legion,949,warrior,arms,24,10,14
Warsky,archimonde,948,warrior,arms,18,12,6
Bòónki,ravencrest,948,warrior,arms,40,17,23
Доминатори,grom,948,warrior,arms,24,10,14
Axedingus,tarren-mill,947,warrior,arms,18,10,8
Balyndâ,aegwynn,945,warrior,arms,20,10,10
Draemmer,minahonda,943,warrior,arms,18,10,8
Ахиллслэм,howling-fjord,943,warrior,arms,29,10,19
Ragedotcom,archimonde,940,warrior,arms,18,10,8
Mågne,tarren-mill,939,warrior,arms,30,10,20
Fdmachine,kazzak,934,warrior,arms,24,10,14
Tabboonishka,draenor,927,warrior,arms,16,11,5
Ganik,malganis,927,warrior,arms,23,10,13
Perseó,minahonda,927,warrior,arms,42,11,31
Shavoi,die-aldor,926,warrior,arms,29,10,19
Raldjorn,hyjal,924,warrior,arms,18,10,8
Dearmooses,stormscale,920,warrior,arms,36,18,18
Bluntsword,twisting-nether,919,warrior,arms,24,11,13
Matti,magtheridon,911,warrior,arms,17,10,7
Зеленыйжмых,thermaplugg,909,warrior,arms,21,10,11
Grroom,tarren-mill,908,warrior,arms,27,10,17
Durmithor,silvermoon,906,warrior,arms,35,10,25
Discogoon,twilights-hammer,897,warrior,arms,60,20,40
Ispor,shattered-halls,887,warrior,arms,47,24,23
Рагнарульв,gordunni,885,warrior,arms,14,10,4
Дотрен,galakrond,883,warrior,arms,42,20,22
Pigleto,ravencrest,870,warrior,arms,22,12,10
Antìcìdè,ravencrest,864,warrior,arms,12,9,3
Drvx,twisting-nether,864,warrior,arms,12,9,3
Zaedt,tarren-mill,864,warrior,arms,12,9,3
Preliator,outland,864,warrior,arms,12,9,3
Noitoved,outland,864,warrior,arms,20,10,10
Summerkarma,wildhammer,864,warrior,arms,18,9,9
Skylåw,archimonde,864,warrior,arms,18,9,9
Prøject,archimonde,864,warrior,arms,18,9,9
Renwíck,burning-legion,864,warrior,arms,18,9,9
Brutilda,antonidas,864,warrior,arms,18,9,9
Кимлий,deathweaver,864,warrior,arms,18,9,9
Puremëtal,silvermoon,864,warrior,arms,18,9,9
Quadfather,kazzak,864,warrior,arms,18,9,9
Purporcc,archimonde,864,warrior,arms,21,10,11
Vôx,sylvanas,864,warrior,arms,24,9,15
Vikktor,doomhammer,864,warrior,arms,24,9,15
Mercey,stormscale,864,warrior,arms,24,9,15
Devidz,outland,864,warrior,arms,24,9,15
Oplarxigos,kazzak,864,warrior,arms,24,9,15
Витодпс,howling-fjord,864,warrior,arms,24,9,15
Morbaac,archimonde,864,warrior,arms,30,9,21
Rilor,burning-legion,864,warrior,arms,30,9,21
Banîsher,drakthul,864,warrior,arms,30,9,21
Eyeslicer,quelthalas,863,warrior,arms,18,9,9
Kantarion,stormscale,863,warrior,arms,18,9,9
Грэйм,gordunni,863,warrior,arms,18,9,9
Saofang,twisting-nether,863,warrior,arms,18,9,9
Дейниксис,howling-fjord,863,warrior,arms,18,9,9
Grezlyk,drakthul,863,warrior,arms,18,9,9
Salamandar,zenedar,863,warrior,arms,24,9,15
Rakuna,tarren-mill,863,warrior,arms,24,9,15
Zoefernandes,kazzak,863,warrior,arms,30,9,21
Teronth,burning-legion,863,warrior,arms,30,9,21
Bobloblaww,doomhammer,862,warrior,arms,18,9,9
Rodenet,dun-modr,862,warrior,arms,18,9,9
Démigodx,stormscale,862,warrior,arms,24,9,15
Scarloc,archimonde,862,warrior,arms,24,9,15
Elyrax,dun-modr,861,warrior,arms,18,9,9
Dûrøtan,marécage-de-zangar,861,warrior,arms,18,9,9
Orwêll,uldum,860,warrior,arms,18,9,9
Atus,dun-modr,860,warrior,arms,19,9,10
Woopzi,twisting-nether,860,warrior,arms,36,9,27
Wolfgladius,cthun,859,warrior,arms,18,9,9
Synrosh,hyjal,859,warrior,arms,18,9,9
Issatank,frostmane,859,warrior,arms,18,9,9
Маханхет,soulflayer,859,warrior,arms,24,9,15
Дрекзот,howling-fjord,858,warrior,arms,15,10,5
Kval,kazzak,858,warrior,arms,18,9,9
Агтеррокк,deathweaver,858,warrior,arms,24,9,15
Варбыкмашина,howling-fjord,857,warrior,arms,18,9,9
Etelä,stormreaver,856,warrior,arms,18,9,9
Kixx,twisting-nether,855,warrior,arms,30,14,16
Uclat,archimonde,855,warrior,arms,24,9,15
Nøiir,malfurion,854,warrior,arms,18,9,9
Pawnerlol,mannoroth,847,warrior,arms,17,9,8
Bordi,nemesis,847,warrior,arms,29,9,20
Ruga,echsenkessel,846,warrior,arms,21,11,10
Luunk,ravencrest,846,warrior,arms,24,9,15
Sanhaevel,ravencrest,838,warrior,arms,21,10,11
Furanos,blackrock,831,warrior,arms,17,9,8
Ajgreedy,grim-batol,829,warrior,arms,23,9,14
Overdose,anetheron,827,warrior,arms,17,10,7
Gèrralt,hyjal,812,warrior,arms,17,9,8
Garwarr,twisting-nether,808,warrior,arms,19,10,9
Actuallyorc,twisting-nether,799,warrior,arms,14,9,5
Vyctimz,ravencrest,799,warrior,arms,16,9,7
Bumbx,kazzak,796,warrior,arms,14,9,5
Кейнорин,howling-fjord,789,warrior,arms,28,9,19
Finalsmasher,thrall,784,warrior,arms,42,16,26
Bulfwart,zuljin,768,warrior,arms,12,8,4
Psinovich,sylvanas,768,warrior,arms,12,8,4
Иктиннос,gordunni,768,warrior,arms,12,8,4
Liked,tarren-mill,768,warrior,arms,12,8,4
Chadsmorc,twisting-nether,768,warrior,arms,12,8,4
Muyubu,eredar,768,warrior,arms,12,8,4
Solaje,dun-modr,768,warrior,arms,12,8,4
Littlebugger,ravencrest,768,warrior,arms,12,8,4
Feckdech,blackrock,768,warrior,arms,12,8,4
Ballin,dragonblight,768,warrior,arms,12,8,4
Maisner,stormscale,768,warrior,arms,15,9,6
Vlorgboi,drakthul,768,warrior,arms,18,8,10
Røidrage,stormscale,768,warrior,arms,18,8,10
Brunodressed,aegwynn,768,warrior,arms,18,8,10
Crawly,aegwynn,768,warrior,arms,18,8,10
Néxtlølz,twisting-nether,768,warrior,arms,18,8,10
Dreadbanga,blackmoore,768,warrior,arms,18,8,10
Ragestarved,ragnaros,768,warrior,arms,18,8,10
Warounet,hyjal,768,warrior,arms,18,8,10
Visari,kiljaeden,768,warrior,arms,18,8,10
Xanatos,khazgoroth,768,warrior,arms,18,8,10
Aauv,twisting-nether,768,warrior,arms,18,8,10
Planina,ravencrest,768,warrior,arms,18,8,10
Уэсгар,blackscar,768,warrior,arms,24,8,16
Hulksmsh,hyjal,768,warrior,arms,24,8,16
Jackyred,silvermoon,768,warrior,arms,24,8,16
Micromachine,argent-dawn,768,warrior,arms,24,8,16
Fosler,frostmane,768,warrior,arms,24,8,16
Khireebonk,hyjal,767,warrior,arms,12,8,4
Mkazy,kirin-tor,767,warrior,arms,12,8,4
Abnôrmus,tarren-mill,767,warrior,arms,12,8,4
Prolyx,doomhammer,767,warrior,arms,12,8,4
Yoilenno,argent-dawn,767,warrior,arms,12,8,4
Бокалпивка,soulflayer,767,warrior,arms,15,9,6
Draer,sanguino,767,warrior,arms,17,9,8
Ashiku,zuljin,767,warrior,arms,18,8,10
Lrb,tarren-mill,767,warrior,arms,18,8,10
Ricssonz,burning-legion,767,warrior,arms,18,8,10
Каутто,howling-fjord,767,warrior,arms,18,8,10
Bekkey,lightbringer,767,warrior,arms,18,8,10
Øfè,ysondre,767,warrior,arms,18,8,10
Akim,ysondre,767,warrior,arms,18,8,10
Ríta,silvermoon,767,warrior,arms,18,8,10
Арбузикхаха,soulflayer,767,warrior,arms,18,8,10
Alphachadwar,azjolnerub,767,warrior,arms,18,8,10
Футжисубо,razuvious,767,warrior,arms,18,8,10
Waegon,twisting-nether,767,warrior,arms,18,8,10
Utero,drakthul,767,warrior,arms,18,8,10
Horseye,eredar,767,warrior,arms,18,8,10
Hermosse,dalaran,767,warrior,arms,18,8,10
Folsack,sanguino,767,warrior,arms,18,8,10
Ronoh,kazzak,767,warrior,arms,18,8,10
Chrekk,khaz-modan,767,warrior,arms,18,8,10
Shoesmith,outland,767,warrior,arms,30,8,22
Aomen,ravencrest,766,warrior,arms,12,8,4
Shehalk,stormscale,766,warrior,arms,12,8,4
Beamis,ragnaros,766,warrior,arms,18,8,10
Savh,silvermoon,766,warrior,arms,18,8,10
Kianit,ravencrest,766,warrior,arms,30,8,22
Opseagull,defias-brotherhood,765,warrior,arms,12,8,4
Kurzen,voljin,765,warrior,arms,18,8,10
Wärfäcë,blades-edge,765,warrior,arms,18,8,10
Trajkovic,ravencrest,764,warrior,arms,18,8,10
Ferrum,sunstrider,763,warrior,arms,18,8,10
Giggadaddy,tarren-mill,763,warrior,arms,18,8,10
Aliasus,outland,763,warrior,arms,24,8,16
Syforce,ravencrest,762,warrior,arms,12,8,4
Korvjnus,burning-blade,762,warrior,arms,18,8,10
Fatbeard,twilights-hammer,762,warrior,arms,18,8,10
Øruch,draenor,761,warrior,arms,18,8,10
Машамеч,blackscar,760,warrior,arms,30,8,22
Diliul,doomhammer,759,warrior,arms,18,8,10
Satanås,silvermoon,758,warrior,arms,18,8,10
Upturn,ravencrest,757,warrior,arms,24,8,16
Calipp,die-aldor,750,warrior,arms,24,8,16
Shadrassil,eonar,747,warrior,arms,18,8,10
Punishers,ysondre,746,warrior,arms,102,37,65
Кофесмолоком,ashenvale,735,warrior,arms,29,8,21
Tinkley,quelthalas,734,warrior,arms,16,8,8
Madict,outland,733,warrior,arms,18,8,10
Takashia,ravencrest,731,warrior,arms,16,9,7
Antraex,zuljin,726,warrior,arms,24,10,14
Grolbein,blackhand,719,warrior,arms,17,9,8
Anaxiam,drakthul,719,warrior,arms,17,8,9
Zíreael,ravencrest,718,warrior,arms,29,8,21
Zelwar,drakthul,714,warrior,arms,14,10,4
Thehans,grim-batol,708,warrior,arms,26,11,15
Fáro,ravencrest,704,warrior,arms,16,8,8
Ferv,tarren-mill,703,warrior,arms,17,8,9
Stratic,blackmoore,697,warrior,arms,26,8,18
Melców,eredar,687,warrior,arms,11,8,3
Xiennas,stormscale,679,warrior,arms,19,9,10
Smèdbérg,ravencrest,672,warrior,arms,12,7,5
Krionos,ravencrest,672,warrior,arms,12,7,5
Azarek,blackmoore,672,warrior,arms,12,7,5
Narcx,kazzak,672,warrior,arms,12,7,5
Wargak,stormscale,672,warrior,arms,12,7,5
Klearr,silvermoon,672,warrior,arms,12,7,5
Ødên,frostmane,672,warrior,arms,12,7,5
Fiveboy,tarren-mill,672,warrior,arms,12,7,5
Cleavnseagal,ravencrest,672,warrior,arms,12,7,5
Biscuitoliva,hyjal,672,warrior,arms,12,7,5
Warriovar,draenor,672,warrior,arms,12,7,5
Демолишеер,howling-fjord,672,warrior,arms,12,7,5
Dréngr,blackrock,672,warrior,arms,12,7,5
Yosiwa,draenor,672,warrior,arms,12,7,5
Midnightrain,archimonde,672,warrior,arms,12,7,5
Хашонвар,gordunni,672,warrior,arms,12,7,5
Орданис,deathguard,672,warrior,arms,12,7,5
Трэйдар,blackscar,672,warrior,arms,12,7,5
Masakerr,ragnaros,672,warrior,arms,12,7,5
Sickjackenx,executus,672,warrior,arms,12,7,5
Billorc,twisting-nether,672,warrior,arms,12,7,5
Kwasimodo,blackmoore,672,warrior,arms,12,7,5
Арсон,soulflayer,672,warrior,arms,12,7,5
Kriticah,sanguino,672,warrior,arms,12,7,5
Tenvee,outland,672,warrior,arms,12,7,5
Devìlscandy,stormscale,672,warrior,arms,12,7,5
Engalxsol,tarren-mill,672,warrior,arms,12,7,5
Antïsøcial,thrall,672,warrior,arms,12,7,5
Бигдэмс,soulflayer,672,warrior,arms,12,7,5
Boonur,arthas,672,warrior,arms,12,7,5
Tamesulo,silvermoon,672,warrior,arms,12,7,5
Malgár,argent-dawn,672,warrior,arms,12,7,5
Ридиусх,gordunni,672,warrior,arms,12,7,5
Fiverare,stormscale,672,warrior,arms,12,7,5
Gramr,silvermoon,672,warrior,arms,12,7,5
Senshin,sanguino,672,warrior,arms,12,7,5
Incendix,stormscale,672,warrior,arms,12,7,5
Ufu,outland,672,warrior,arms,12,7,5
Джераса,borean-tundra,672,warrior,arms,12,7,5
Crøwñd,twisting-nether,672,warrior,arms,12,7,5
Allthèwayup,kazzak,672,warrior,arms,12,7,5
Tìera,ravencrest,672,warrior,arms,15,8,7
Chàrgex,blackrock,672,warrior,arms,15,8,7
Kamilfury,burning-legion,672,warrior,arms,16,8,8
Gruxx,ragnaros,672,warrior,arms,18,7,11
Silencxý,blackrock,672,warrior,arms,18,7,11
Kryszii,ragnaros,672,warrior,arms,18,7,11
Hollydeffs,blackmoore,672,warrior,arms,18,7,11
Rightversion,sylvanas,672,warrior,arms,18,7,11
Lusan,sylvanas,672,warrior,arms,18,7,11
Mezugzugyou,draenor,672,warrior,arms,18,7,11
Swàck,mazrigos,672,warrior,arms,18,7,11
Twoonewin,ragnaros,672,warrior,arms,18,7,11
Warrieron,stormscale,672,warrior,arms,18,7,11
Khoroc,die-aldor,672,warrior,arms,18,7,11
Trilon,blackrock,672,warrior,arms,18,7,11
Warhero,burning-legion,672,warrior,arms,18,7,11
Jeonsoyeon,argent-dawn,672,warrior,arms,18,7,11
Skullsmasher,stormscale,672,warrior,arms,18,7,11
Salpaaja,frostwhisper,672,warrior,arms,18,7,11
Tomsom,sanguino,672,warrior,arms,18,7,11
Стефанидзе,soulflayer,672,warrior,arms,18,7,11
Bufdefstance,kazzak,672,warrior,arms,18,7,11
Luxurious,argent-dawn,672,warrior,arms,27,8,19
Vøidwalker,ragnaros,672,warrior,arms,24,7,17
Gôrilla,kazzak,672,warrior,arms,30,7,23
Shedzo,tarren-mill,671,warrior,arms,12,7,5
Dosenbier,gorgonnash,671,warrior,arms,12,7,5
Elyalol,ragnaros,671,warrior,arms,12,7,5
Hades,kazzak,671,warrior,arms,12,7,5
Deanx,ragnaros,671,warrior,arms,12,7,5
Vez,arathor,671,warrior,arms,12,7,5
Semanor,aegwynn,671,warrior,arms,12,7,5
Escà,archimonde,671,warrior,arms,12,7,5
Когарт,gordunni,671,warrior,arms,12,7,5
Rawne,kirin-tor,671,warrior,arms,12,7,5
Roshas,twisting-nether,671,warrior,arms,12,7,5
Fluxerella,azjolnerub,671,warrior,arms,12,7,5
Schneklinge,blutkessel,671,warrior,arms,12,7,5
Dukhe,sanguino,671,warrior,arms,12,7,5
Lågærtha,blackmoore,671,warrior,arms,12,7,5
Grimsong,antonidas,671,warrior,arms,12,7,5
Haris,malganis,671,warrior,arms,18,7,11
Tempii,ragnaros,671,warrior,arms,18,7,11
Unstorm,drakthul,671,warrior,arms,18,7,11
Kishkamen,ravencrest,671,warrior,arms,18,7,11
Segovaxx,twisting-nether,671,warrior,arms,18,7,11
Армсец,howling-fjord,671,warrior,arms,18,7,11
Бубаигавар,gordunni,671,warrior,arms,24,7,17
Bigbaduglyy,twisting-nether,671,warrior,arms,24,7,17
Mysteryman,defias-brotherhood,670,warrior,arms,12,7,5
Nurychïc,twisting-nether,670,warrior,arms,12,7,5
Ismellurfeet,ravencrest,670,warrior,arms,12,7,5
Lightit,aegwynn,670,warrior,arms,12,7,5
Contrariety,ravencrest,670,warrior,arms,12,7,5
Kilsera,blackmoore,670,warrior,arms,12,7,5
Grunwi,burning-legion,670,warrior,arms,12,7,5
Nixtor,defias-brotherhood,670,warrior,arms,18,7,11
Rhonack,ragnaros,670,warrior,arms,18,7,11
Jackycoke,blackhand,670,warrior,arms,18,7,11
Eyesonly,blackmoore,670,warrior,arms,18,7,11
Infusione,nemesis,669,warrior,arms,12,7,5
Фастод,greymane,669,warrior,arms,12,7,5
Lø,chogall,669,warrior,arms,20,7,13
Nightclaimer,pozzo-delleternità,669,warrior,arms,24,7,17
Árkantos,ravencrest,668,warrior,arms,12,7,5
Woukong,blackmoore,668,warrior,arms,18,7,11
Математик,razuvious,667,warrior,arms,12,7,5
Papati,twisting-nether,667,warrior,arms,18,7,11
Bubciu,burning-legion,667,warrior,arms,24,7,17
Dlstroyer,eonar,657,warrior,arms,12,7,5
Fantasý,burning-legion,655,warrior,arms,23,7,16
Xienia,dun-morogh,655,warrior,arms,24,7,17
Дедсдрыном,howling-fjord,654,warrior,arms,17,7,10
Alothar,khaz-modan,646,warrior,arms,18,7,11
Broarexlion,ragnaros,639,warrior,arms,17,7,10
Râsk,kazzak,638,warrior,arms,16,8,8
Набосуюногу,gordunni,623,warrior,arms,17,7,10
Kwesta,kazzak,607,warrior,arms,11,7,4
Szelenamoon,outland,607,warrior,arms,14,7,7
Facepálm,kazzak,607,warrior,arms,14,7,7
Matatorero,uldum,607,warrior,arms,16,7,9
Trundledaddy,silvermoon,607,warrior,arms,17,7,10
Jethiss,ravencrest,576,warrior,arms,6,6,0
Ciocaboca,draenor,576,warrior,arms,6,6,0
Marqinios,archimonde,576,warrior,arms,6,6,0
Whýsøsîleñt,ragnaros,576,warrior,arms,10,7,3
Братишкаа,gordunni,576,warrior,arms,12,6,6
Голдибитч,gordunni,576,warrior,arms,12,6,6
Skaylulz,ragnaros,576,warrior,arms,12,6,6
Нерморрог,howling-fjord,576,warrior,arms,12,6,6
Tddyy,silvermoon,576,warrior,arms,12,6,6
Шизам,howling-fjord,576,warrior,arms,12,6,6
Hycate,blackrock,576,warrior,arms,12,6,6
Rorix,blackrock,576,warrior,arms,12,6,6
Nørst,draenor,576,warrior,arms,12,6,6
Juggawumba,kazzak,576,warrior,arms,12,6,6
Belfodil,outland,576,warrior,arms,12,6,6
Pathocend,kazzak,576,warrior,arms,12,6,6
Oneoneseven,archimonde,576,warrior,arms,12,6,6
Toqk,draenor,576,warrior,arms,12,6,6
Данзетар,howling-fjord,576,warrior,arms,12,6,6
Borndet,eredar,576,warrior,arms,12,6,6
Slám,burning-legion,576,warrior,arms,12,6,6
Малаятварь,gordunni,576,warrior,arms,12,6,6
Wøokz,argent-dawn,576,warrior,arms,12,6,6
Boshim,ravencrest,576,warrior,arms,12,6,6
Hamilton,bronzebeard,576,warrior,arms,12,6,6
Heltslut,tarren-mill,576,warrior,arms,12,6,6
Goringbame,draenor,576,warrior,arms,12,6,6
Lostday,blackrock,576,warrior,arms,12,6,6
Sydre,nerathor,576,warrior,arms,12,6,6
Audítóre,proudmoore,576,warrior,arms,12,6,6
Testonator,outland,576,warrior,arms,12,6,6
Bigboibeeper,draenor,576,warrior,arms,12,6,6
Coolaa,kazzak,576,warrior,arms,12,6,6
Nèssa,outland,576,warrior,arms,12,6,6
Долирия,gordunni,576,warrior,arms,12,6,6
Keshâr,blackhand,576,warrior,arms,12,6,6
Dedewawa,ysondre,576,warrior,arms,12,6,6
Josem,sanguino,576,warrior,arms,12,6,6
Jøtawarrior,sanguino,576,warrior,arms,12,6,6
Whýsøsîlêñt,ragnaros,576,warrior,arms,12,6,6
Radîtz,blackmoore,576,warrior,arms,12,6,6
Grimarg,drakthul,576,warrior,arms,12,6,6
Reacôn,twisting-nether,576,warrior,arms,12,6,6
Fookyoup,stormscale,576,warrior,arms,12,6,6
Gíu,blackhand,576,warrior,arms,12,6,6
Architectman,twisting-nether,576,warrior,arms,12,6,6
Majestatix,doomhammer,576,warrior,arms,12,6,6
Melfis,aegwynn,576,warrior,arms,12,6,6
Rakhaldin,blackhand,576,warrior,arms,12,6,6
Bismárck,nathrezim,576,warrior,arms,12,6,6
Darkseid,burning-legion,576,warrior,arms,12,6,6
Тассэй,eversong,576,warrior,arms,12,6,6
Bigdamtosco,ravencrest,576,warrior,arms,12,6,6
Nexpwns,blackhand,576,warrior,arms,12,6,6
Xqt,laughing-skull,576,warrior,arms,12,6,6
Qurujaa,kirin-tor,576,warrior,arms,12,6,6
Fluffycute,blackhand,576,warrior,arms,12,6,6
Pitii,burning-legion,576,warrior,arms,14,6,8
Skumslag,blackmoore,576,warrior,arms,18,6,12
Hazzaogx,draenor,576,warrior,arms,18,6,12
Kímó,silvermoon,576,warrior,arms,18,6,12
Zhulgar,azjolnerub,576,warrior,arms,18,6,12
Fracto,draenor,576,warrior,arms,18,6,12
Shaked,dun-modr,576,warrior,arms,18,6,12
Бавовник,howling-fjord,576,warrior,arms,18,6,12
Autumnfálls,kazzak,576,warrior,arms,18,6,12
Slunecniq,azjolnerub,576,warrior,arms,18,6,12
Jeriko,archimonde,576,warrior,arms,18,6,12
Guts,frostwhisper,576,warrior,arms,18,6,12
Мопк,howling-fjord,576,warrior,arms,18,6,12
Zirêael,kazzak,576,warrior,arms,24,6,18
Shinydjuwlz,turalyon,575,warrior,arms,6,6,0
Thiccrich,argent-dawn,575,warrior,arms,6,6,0
Pesroc,blackmoore,575,warrior,arms,9,7,2
Mödhan,archimonde,575,warrior,arms,12,6,6
Zutto,conseil-des-ombres,575,warrior,arms,12,6,6
Golonko,burning-legion,575,warrior,arms,12,6,6
Oneshót,norgannon,575,warrior,arms,12,6,6
Акози,fordragon,575,warrior,arms,12,6,6
Tarbhfathach,draenor,575,warrior,arms,12,6,6
Ràgnàmetàl,tarren-mill,575,warrior,arms,12,6,6
Donátos,aegwynn,575,warrior,arms,12,6,6
Шлифую,howling-fjord,575,warrior,arms,12,6,6
Ozok,blackrock,575,warrior,arms,12,6,6
Arriess,drakthul,575,warrior,arms,12,6,6
Soofies,madmortem,575,warrior,arms,12,6,6
Бэдбрэйнс,soulflayer,575,warrior,arms,12,6,6
Bravest,ragnaros,575,warrior,arms,12,6,6
Critycall,drakthul,575,warrior,arms,12,6,6
Wørgenn,hyjal,575,warrior,arms,12,6,6
Euforija,kazzak,575,warrior,arms,12,6,6
Vauster,draenor,575,warrior,arms,16,7,9
Shuraj,hyjal,575,warrior,arms,16,6,10
Nicperh,dun-modr,575,warrior,arms,18,6,12
Kosttya,argent-dawn,575,warrior,arms,18,6,12
Vegäpunk,nemesis,575,warrior,arms,18,6,12
Grimhew,argent-dawn,575,warrior,arms,18,6,12
Gervvand,burning-legion,575,warrior,arms,18,6,12
Кимиюки,gordunni,575,warrior,arms,18,6,12
Goldins,drakthul,575,warrior,arms,18,6,12
Hirbus,ravencrest,575,warrior,arms,19,6,13
Solatika,alexstrasza,574,warrior,arms,12,6,6
Киефси,howling-fjord,574,warrior,arms,12,6,6
Gnuhl,eredar,574,warrior,arms,15,7,8
Zogyall,ysondre,574,warrior,arms,18,6,12
Dicaprios,silvermoon,574,warrior,arms,18,6,12
Pips,minahonda,574,warrior,arms,24,6,18
Manymen,outland,572,warrior,arms,12,6,6
Raduriel,antonidas,571,warrior,arms,12,6,6
Unkmòr,pozzo-delleternità,568,warrior,arms,12,6,6
Dj,ragnaros,568,warrior,arms,12,6,6
Liferuiner,rexxar,543,warrior,arms,14,7,7
Kalarar,blackrock,543,warrior,arms,26,7,19
Energo,drakthul,542,warrior,arms,12,6,6
Zugstorm,outland,528,warrior,arms,9,7,2
Kåñéthy,outland,528,warrior,arms,15,7,8
Imabeatyoass,kazzak,527,warrior,arms,11,6,5
Titanhaut,frostwolf,525,warrior,arms,11,6,5
Hammerfíst,kazzak,523,warrior,arms,11,6,5
Брамон,gordunni,512,warrior,arms,10,6,4
Лысыч,gordunni,495,warrior,arms,13,6,7
Фоссбро,gordunni,494,warrior,arms,21,6,15
Liptonxecute,blackhand,480,warrior,arms,6,5,1
Karmaloop,stormscale,480,warrior,arms,6,5,1
Slg,tarren-mill,480,warrior,arms,6,5,1
Prymebeevz,blackmoore,480,warrior,arms,6,5,1
Rockygifll,sinstralis,480,warrior,arms,6,5,1
Lurion,malganis,480,warrior,arms,6,5,1
Massiveape,argent-dawn,480,warrior,arms,6,5,1
Bashuk,grim-batol,480,warrior,arms,6,5,1
Shînsø,dalaran,480,warrior,arms,6,5,1
Warbringer,burning-blade,480,warrior,arms,6,5,1
Halsandre,hyjal,480,warrior,arms,6,5,1
Thusha,silvermoon,480,warrior,arms,6,5,1
Tekmali,archimonde,480,warrior,arms,6,5,1
Murp,lightnings-blade,480,warrior,arms,6,5,1
Himarsenko,silvermoon,480,warrior,arms,6,5,1
Okcool,twisting-nether,480,warrior,arms,6,5,1
Warbigboss,draenor,480,warrior,arms,6,5,1
Wargoth,draenor,480,warrior,arms,6,5,1
Maniackz,tarren-mill,480,warrior,arms,6,5,1
Tørrminator,stormscale,480,warrior,arms,6,5,1
Дядядмг,blackscar,480,warrior,arms,6,5,1
Хэрест,gordunni,480,warrior,arms,6,5,1
Cuzyxtwo,blackrock,480,warrior,arms,6,5,1
Asasius,ravencrest,480,warrior,arms,6,5,1
Remylacroix,blackrock,480,warrior,arms,6,5,1
Рвбстох,blackscar,480,warrior,arms,6,5,1
Pihvikostaja,stormreaver,480,warrior,arms,6,5,1
Гневныйвиги,howling-fjord,480,warrior,arms,6,5,1
Соловейч,howling-fjord,480,warrior,arms,6,5,1
Mertik,twisting-nether,480,warrior,arms,6,5,1
Nyamnyamnyam,blackmoore,480,warrior,arms,12,5,7
Neíd,malganis,480,warrior,arms,12,5,7
Wazraf,khaz-modan,480,warrior,arms,12,5,7
Victôr,silvermoon,480,warrior,arms,12,5,7
Cortix,blackmoore,480,warrior,arms,12,5,7
Whiteowlx,argent-dawn,480,warrior,arms,12,5,7
Dortenz,ragnaros,480,warrior,arms,12,5,7
Garradoom,stormscale,480,warrior,arms,12,5,7
Apacho,outland,480,warrior,arms,12,5,7
Rowr,argent-dawn,480,warrior,arms,12,5,7
Deathbleeder,argent-dawn,480,warrior,arms,12,5,7
Ilovealma,kiljaeden,480,warrior,arms,12,5,7
Chadgrave,argent-dawn,480,warrior,arms,12,5,7
Vitezandro,stormscale,480,warrior,arms,12,5,7
Alexwar,draenor,480,warrior,arms,12,5,7
Cryhoof,ragnaros,480,warrior,arms,12,5,7
Whysobold,quelthalas,480,warrior,arms,12,5,7
Keäghan,kazzak,480,warrior,arms,12,5,7
Succel,drakthul,480,warrior,arms,12,5,7
Kalopsia,drakthul,480,warrior,arms,12,5,7
Cramatao,shadowsong,480,warrior,arms,12,5,7
Foxxzorr,aszune,480,warrior,arms,12,5,7
Sinbuay,malygos,480,warrior,arms,12,5,7
Mesmash,uldum,480,warrior,arms,12,5,7
Horsewarrior,stormscale,480,warrior,arms,12,5,7
Reìvah,silvermoon,480,warrior,arms,12,5,7
Ragingclue,draenor,480,warrior,arms,12,5,7
Gerrmund,silvermoon,480,warrior,arms,12,5,7
Lïyah,eldrethalas,480,warrior,arms,12,5,7
Olesbawro,ragnaros,480,warrior,arms,12,5,7
Arakhu,blackmoore,480,warrior,arms,12,5,7
Binsaueramk,ravencrest,480,warrior,arms,12,5,7
Budwise,stormscale,480,warrior,arms,12,5,7
Garouzo,hellfire,480,warrior,arms,12,5,7
Supersonîc,aegwynn,480,warrior,arms,12,5,7
Buckiesøde,twisting-nether,480,warrior,arms,12,5,7
Huxies,draenor,480,warrior,arms,12,5,7
Leroyluca,gilneas,480,warrior,arms,12,5,7
Отнулядоста,gordunni,480,warrior,arms,12,5,7
Nêgan,stormscale,480,warrior,arms,12,5,7
Tenthøusand,sylvanas,480,warrior,arms,12,5,7
Zirriox,wildhammer,480,warrior,arms,12,5,7
ßzv,veklor,480,warrior,arms,12,5,7
Фуджитаку,gordunni,480,warrior,arms,12,5,7
Dmgsponge,stormscale,480,warrior,arms,12,5,7
Síúkanto,blackrock,480,warrior,arms,12,5,7
Lüund,ravencrest,480,warrior,arms,12,5,7
Adzipotlewap,burning-legion,480,warrior,arms,12,5,7
Klonyarikjr,ravencrest,480,warrior,arms,12,5,7
Anahkas,archimonde,480,warrior,arms,12,5,7
Oplix,antonidas,480,warrior,arms,12,5,7
Лилиофанныч,soulflayer,480,warrior,arms,12,5,7
Шифик,soulflayer,480,warrior,arms,12,5,7
Hoomeer,sylvanas,480,warrior,arms,12,5,7
Agoobagoo,alakir,480,warrior,arms,12,5,7
Najjs,eredar,480,warrior,arms,12,5,7
Alborozie,archimonde,480,warrior,arms,12,5,7
Джондо,gordunni,480,warrior,arms,12,5,7
Тевивар,gordunni,480,warrior,arms,12,5,7
Altimáte,antonidas,480,warrior,arms,12,5,7
Zkou,wrathbringer,480,warrior,arms,12,5,7
Ràgê,silvermoon,480,warrior,arms,12,5,7
Xintha,frostwolf,480,warrior,arms,12,5,7
Zeryyo,blackrock,480,warrior,arms,12,5,7
Земибор,soulflayer,480,warrior,arms,12,5,7
Nuckii,antonidas,480,warrior,arms,12,5,7
Древилгод,gordunni,480,warrior,arms,12,5,7
Бейлеор,gordunni,480,warrior,arms,12,5,7
Bacioleggero,nemesis,480,warrior,arms,12,5,7
Lockmagewar,burning-legion,480,warrior,arms,15,6,9
Развалочка,howling-fjord,480,warrior,arms,16,6,10
Belzebud,kazzak,480,warrior,arms,18,5,13
Huullkk,nazjatar,480,warrior,arms,18,5,13
Lahzar,krasus,480,warrior,arms,18,5,13
Unßörn,archimonde,480,warrior,arms,18,5,13
Larrydankin,draenor,480,warrior,arms,18,5,13
Roykór,auchindoun,480,warrior,arms,18,5,13
Тандэр,borean-tundra,480,warrior,arms,18,5,13
Séphi,archimonde,480,warrior,arms,18,5,13
Курящийпро,blackscar,480,warrior,arms,18,5,13
Zeepp,ravencrest,480,warrior,arms,18,5,13
Vhy,antonidas,480,warrior,arms,25,5,20
Neltharon,silvermoon,479,warrior,arms,6,5,1
Leyon,blades-edge,479,warrior,arms,6,5,1
Knego,ragnaros,479,warrior,arms,6,5,1
Ceteris,eredar,479,warrior,arms,6,5,1
Тычо,soulflayer,479,warrior,arms,12,5,7
Krostapunk,colinas-pardas,479,warrior,arms,12,5,7
Kllinac,kazzak,479,warrior,arms,12,5,7
Etharedon,kul-tiras,479,warrior,arms,12,5,7
Releave,draenor,479,warrior,arms,12,5,7
Pappkopf,rexxar,479,warrior,arms,12,5,7
Dúg,tarren-mill,479,warrior,arms,12,5,7
Meresin,madmortem,479,warrior,arms,12,5,7
Grèèn,turalyon,479,warrior,arms,12,5,7
Swtparanoid,sylvanas,479,warrior,arms,12,5,7
Shpitzu,stormscale,479,warrior,arms,12,5,7
Izestyi,blackrock,479,warrior,arms,18,5,13
Qvil,sanguino,479,warrior,arms,24,5,19
Sfarpi,burning-legion,478,warrior,arms,12,5,7
Swordluw,argent-dawn,478,warrior,arms,18,5,13
Pwettygal,tarren-mill,478,warrior,arms,18,5,13
Sahaminho,draenor,478,warrior,arms,18,5,13
Милославский,gordunni,477,warrior,arms,12,5,7
Execútioner,sylvanas,463,warrior,arms,11,5,6
Bigtulipe,archimonde,463,warrior,arms,11,5,6
Henzelhoff,stormreaver,447,warrior,arms,10,5,5
Takethisduck,stormscale,447,warrior,arms,11,5,6
Мегаяйца,gordunni,447,warrior,arms,11,5,6
Kviqr,auchindoun,447,warrior,arms,11,5,6
Чпонькмашина,soulflayer,447,warrior,arms,17,5,12
Spoofie,doomhammer,432,warrior,arms,15,5,10
Madswarrior,tarren-mill,431,warrior,arms,11,5,6
Knî,archimonde,426,warrior,arms,15,6,9
Dodgeslam,eredar,416,warrior,arms,16,5,11
Prime,outland,416,warrior,arms,16,5,11
Ironbutter,ravencrest,415,warrior,arms,8,6,2
Kìrìtosan,pozzo-delleternità,415,warrior,arms,8,5,3
Rhxy,burning-legion,415,warrior,arms,10,5,5
Brùtus,exodar,415,warrior,arms,11,5,6
Danx,culte-de-la-rive-noire,413,warrior,arms,16,5,11
Leizey,stormscale,384,warrior,arms,6,4,2
Døkidøki,silvermoon,384,warrior,arms,6,4,2
Kevlarsusan,the-maelstrom,384,warrior,arms,6,4,2
Rongh,saurfang,384,warrior,arms,6,4,2
Sveñor,the-maelstrom,384,warrior,arms,6,4,2
Ddfxz,draenor,384,warrior,arms,6,4,2
Pillu,stormscale,384,warrior,arms,6,4,2
Cmonbrah,ravencrest,384,warrior,arms,6,4,2
Huuln,outland,384,warrior,arms,6,4,2
Rebiy,ravencrest,384,warrior,arms,6,4,2
Tolga,draenor,384,warrior,arms,6,4,2
Arsinal,blackhand,384,warrior,arms,6,4,2
Hamonbophis,kirin-tor,384,warrior,arms,6,4,2
Nazhar,kult-der-verdammten,384,warrior,arms,6,4,2
Yseras,aegwynn,384,warrior,arms,6,4,2
Swig,twisting-nether,384,warrior,arms,6,4,2
Kennyföx,ysondre,384,warrior,arms,6,4,2
Abunai,thrall,384,warrior,arms,6,4,2
Måydåy,twisting-nether,384,warrior,arms,6,4,2
Bubawarrior,silvermoon,384,warrior,arms,6,4,2
Фиббоначи,deathguard,384,warrior,arms,6,4,2
Xzm,stormscale,384,warrior,arms,6,4,2
Bigbosscho,draenor,384,warrior,arms,6,4,2
Litlijón,ravencrest,384,warrior,arms,6,4,2
Schawar,draenor,384,warrior,arms,6,4,2
Rastaj,defias-brotherhood,384,warrior,arms,6,4,2
Braveorc,kazzak,384,warrior,arms,6,4,2
Tandrak,ravencrest,384,warrior,arms,6,4,2
Ceen,alakir,384,warrior,arms,6,4,2
Dianâ,der-abyssische-rat,384,warrior,arms,6,4,2
Duarel,blackmoore,384,warrior,arms,6,4,2
Grimoire,drakthul,384,warrior,arms,6,4,2
Becca,rexxar,384,warrior,arms,6,4,2
Hexzo,ravencrest,384,warrior,arms,6,4,2
Psychðtïc,archimonde,384,warrior,arms,6,4,2
Гигасмэш,gordunni,384,warrior,arms,6,4,2
Bonza,blackrock,384,warrior,arms,6,4,2
Ollyaa,ravencrest,384,warrior,arms,6,4,2
Sokarbey,twisting-nether,384,warrior,arms,6,4,2
Hackamore,suramar,384,warrior,arms,6,4,2
Takeashower,hyjal,384,warrior,arms,6,4,2
Arnnau,dun-modr,384,warrior,arms,6,4,2
Strapnslap,argent-dawn,384,warrior,arms,6,4,2
Banshor,ysondre,384,warrior,arms,6,4,2
Varzeluu,sylvanas,384,warrior,arms,6,4,2
Swaàg,archimonde,384,warrior,arms,6,4,2
Surthur,magtheridon,384,warrior,arms,6,4,2
Beznacaj,outland,384,warrior,arms,6,4,2
Eseishard,hyjal,384,warrior,arms,6,4,2
Pelicos,grim-batol,384,warrior,arms,6,4,2
Rayner,illidan,384,warrior,arms,6,4,2
Dräparren,ragnaros,384,warrior,arms,6,4,2
Roadsick,outland,384,warrior,arms,6,4,2
Fizé,blackmoore,384,warrior,arms,6,4,2
Думрайт,gordunni,384,warrior,arms,6,4,2
Hiraclès,archimonde,384,warrior,arms,6,4,2
Thorbjør,silvermoon,384,warrior,arms,6,4,2
Беспонятия,blackscar,384,warrior,arms,6,4,2
Kymari,sanguino,384,warrior,arms,6,4,2
Imondiet,ragnaros,384,warrior,arms,6,4,2
Anndersen,defias-brotherhood,384,warrior,arms,6,4,2
Zidbi,argent-dawn,384,warrior,arms,6,4,2
Capigo,tarren-mill,384,warrior,arms,6,4,2
Лагалиер,borean-tundra,384,warrior,arms,6,4,2
Sucemabanner,hyjal,384,warrior,arms,6,4,2
Rohäc,drakthul,384,warrior,arms,6,4,2
Slâkkxz,outland,384,warrior,arms,6,4,2
Mold,nemesis,384,warrior,arms,6,4,2
Ragëë,tarren-mill,384,warrior,arms,6,4,2
Lanahan,argent-dawn,384,warrior,arms,6,4,2
Dallion,azjolnerub,384,warrior,arms,6,4,2
Kaylì,ravencrest,384,warrior,arms,6,4,2
Eggsecutor,stormscale,384,warrior,arms,9,5,4
Тролльвоен,gordunni,384,warrior,arms,9,4,5
Deathwingx,azuremyst,384,warrior,arms,15,5,10
Hubusan,blackmoore,384,warrior,arms,12,4,8
Модныйклык,eversong,384,warrior,arms,12,4,8
Schjøtt,ravencrest,384,warrior,arms,12,4,8
Shiqo,ravencrest,384,warrior,arms,12,4,8
Palthor,drakthul,384,warrior,arms,12,4,8
Syel,sinstralis,384,warrior,arms,12,4,8
Седлайккеану,howling-fjord,384,warrior,arms,12,4,8
Mortus,baelgun,384,warrior,arms,12,4,8
Executorä,stormscale,384,warrior,arms,12,4,8
Wilko,twisting-nether,384,warrior,arms,12,4,8
Ambraxon,blackmoore,384,warrior,arms,12,4,8
Hogu,nemesis,384,warrior,arms,12,4,8
Ellissari,tirion,384,warrior,arms,12,4,8
Sorô,antonidas,384,warrior,arms,12,4,8
Swaxx,ravencrest,384,warrior,arms,12,4,8
Vaxillium,argent-dawn,384,warrior,arms,12,4,8
Adorlyna,silvermoon,384,warrior,arms,12,4,8
Borion,blackmoore,384,warrior,arms,12,4,8
Mârcxb,antonidas,384,warrior,arms,12,4,8
Heubba,hyjal,384,warrior,arms,12,4,8
Invictàs,hyjal,384,warrior,arms,12,4,8
Starkz,hellscream,384,warrior,arms,12,4,8
Bladestorm,dun-morogh,384,warrior,arms,12,4,8
Sebotagelol,twisting-nether,384,warrior,arms,12,4,8
Yakhshar,silvermoon,384,warrior,arms,12,4,8
Grunkor,eldrethalas,384,warrior,arms,12,4,8
Ezop,burning-blade,384,warrior,arms,12,4,8
Sztixi,silvermoon,384,warrior,arms,12,4,8
Darkchao,madmortem,384,warrior,arms,12,4,8
Suduri,drakthul,384,warrior,arms,12,4,8
Kgx,argent-dawn,384,warrior,arms,12,4,8
Dwarfdruine,dun-modr,384,warrior,arms,12,4,8
Karbeg,ravencrest,384,warrior,arms,12,4,8
Khvor,blackmoore,384,warrior,arms,12,4,8
Фаллопиев,borean-tundra,384,warrior,arms,12,4,8
Ansi,argent-dawn,384,warrior,arms,12,4,8
Gromock,the-maelstrom,384,warrior,arms,12,4,8
Minetaur,burning-legion,384,warrior,arms,12,4,8
Mórghúlís,aegwynn,384,warrior,arms,12,4,8
Amarthon,sylvanas,384,warrior,arms,12,4,8
Iameconomist,twisting-nether,384,warrior,arms,12,4,8
Salpaaja,tarren-mill,384,warrior,arms,12,4,8
Rumbldore,ragnaros,384,warrior,arms,12,4,8
Raynorwarr,tarren-mill,384,warrior,arms,12,4,8
Jjokkerr,magtheridon,384,warrior,arms,12,4,8
Osteskanken,ravencrest,384,warrior,arms,12,4,8
Веоленс,gordunni,384,warrior,arms,12,4,8
Казгримм,howling-fjord,384,warrior,arms,12,4,8
Tommia,burning-legion,384,warrior,arms,12,4,8
Vooice,sylvanas,384,warrior,arms,12,4,8
Ðræberen,kazzak,384,warrior,arms,12,4,8
Realdrdob,kazzak,384,warrior,arms,12,4,8
Haldrium,malganis,384,warrior,arms,12,4,8
Nerfslam,stormscale,384,warrior,arms,12,4,8
Blackzor,ragnaros,384,warrior,arms,12,4,8
Дахирарг,fordragon,384,warrior,arms,12,4,8
Bélløne,dalaran,384,warrior,arms,12,4,8
Endagon,ravencrest,384,warrior,arms,12,4,8
Xállek,veknilash,384,warrior,arms,12,4,8
Jorund,archimonde,384,warrior,arms,18,4,14
Vanaxd,blackrock,384,warrior,arms,20,4,16
Dazed,kazzak,383,warrior,arms,6,4,2
Бежа,gordunni,383,warrior,arms,6,4,2
Freestýlz,archimonde,383,warrior,arms,6,4,2
Ironstep,silvermoon,383,warrior,arms,6,4,2
Adelphi,blackrock,383,warrior,arms,6,4,2
Angrytmyself,silvermoon,383,warrior,arms,6,4,2
Иалаи,howling-fjord,383,warrior,arms,8,4,4
Zêrklatscher,lordaeron,383,warrior,arms,12,4,8
Dundee,sanguino,383,warrior,arms,12,4,8
Gladiattus,drakthul,383,warrior,arms,12,4,8
Nélow,khaz-modan,383,warrior,arms,12,4,8
Scill,silvermoon,383,warrior,arms,12,4,8
Xonnico,ravencrest,383,warrior,arms,18,4,14
Cowlunderowl,tarren-mill,383,warrior,arms,18,4,14
Aethwa,stormscale,382,warrior,arms,6,4,2
Fatbob9D64A4,tarren-mill,382,warrior,arms,6,4,2
Orchëstre,eitrigg,382,warrior,arms,6,4,2
Ethem,twisting-nether,378,warrior,arms,16,5,11
Ruppydeluxe,frostwolf,367,warrior,arms,11,4,7
Отсекатель,howling-fjord,367,warrior,arms,17,4,13
Krevó,ragnaros,351,warrior,arms,11,4,7
Megaloddon,ravencrest,351,warrior,arms,11,4,7
Shînta,hyjal,351,warrior,arms,11,4,7
Vizn,emerald-dream,351,warrior,arms,17,4,13
Dolforden,burning-legion,335,warrior,arms,11,4,7
Железныйбард,gordunni,335,warrior,arms,17,4,13
Párta,ravencrest,320,warrior,arms,10,4,6
Dyingdog,kazzak,320,warrior,arms,10,4,6
Rivah,tarren-mill,320,warrior,arms,10,4,6
Scarlettjo,outland,320,warrior,arms,10,4,6
Stancenation,draenor,320,warrior,arms,16,4,12
Stompare,tarren-mill,288,warrior,arms,6,3,3
Twelvearmsun,tarren-mill,288,warrior,arms,6,3,3
Møtomoto,defias-brotherhood,288,warrior,arms,6,3,3
Imglad,ragnaros,288,warrior,arms,6,3,3
Miniwitts,ravencrest,288,warrior,arms,6,3,3
Savaski,thrall,288,warrior,arms,6,3,3
Ludjack,tarren-mill,288,warrior,arms,6,3,3
Goochi,turalyon,288,warrior,arms,6,3,3
Doloresvp,zuljin,288,warrior,arms,6,3,3
Jammy,dentarg,288,warrior,arms,6,3,3
Martøswarr,uldum,288,warrior,arms,6,3,3
Ваншотч,blackscar,288,warrior,arms,6,3,3
Warristyles,arygos,288,warrior,arms,6,3,3
Гатсх,blackscar,288,warrior,arms,6,3,3
Balthew,defias-brotherhood,288,warrior,arms,6,3,3
Чтота,gordunni,288,warrior,arms,6,3,3
Suizix,blackrock,288,warrior,arms,6,3,3
Somalisktjur,tarren-mill,288,warrior,arms,6,3,3
Féélmyfury,tarren-mill,288,warrior,arms,6,3,3
Arashicage,emeriss,288,warrior,arms,6,3,3
Mønzie,outland,288,warrior,arms,6,3,3
Tojaraa,kazzak,288,warrior,arms,6,3,3
Хирошка,gordunni,288,warrior,arms,6,3,3
Threnewar,kazzak,288,warrior,arms,6,3,3
Shchoor,ravencrest,288,warrior,arms,6,3,3
Бигдэм,howling-fjord,288,warrior,arms,6,3,3
Грассфеникс,gordunni,288,warrior,arms,6,3,3
Lisera,thrall,288,warrior,arms,6,3,3
Béhrus,blackmoore,288,warrior,arms,6,3,3
Notthateasy,blackrock,288,warrior,arms,6,3,3
Imora,silvermoon,288,warrior,arms,6,3,3
Eradya,ravencrest,288,warrior,arms,6,3,3
Willywolxx,silvermoon,288,warrior,arms,6,3,3
Greatsword,turalyon,288,warrior,arms,6,3,3
Bigdstance,outland,288,warrior,arms,6,3,3
Ashkandur,antonidas,288,warrior,arms,6,3,3
Warriorri,haomarush,288,warrior,arms,6,3,3
Дуухаст,gordunni,288,warrior,arms,6,3,3
Warriur,outland,288,warrior,arms,6,3,3
Krisusama,ravencrest,288,warrior,arms,6,3,3
Pyxis,argent-dawn,288,warrior,arms,6,3,3
Hanna,argent-dawn,288,warrior,arms,6,3,3
Xaidos,antonidas,288,warrior,arms,6,3,3
Flürix,outland,288,warrior,arms,6,3,3
Raistwar,magtheridon,288,warrior,arms,6,3,3
Eren,todeswache,288,warrior,arms,6,3,3
Raikaz,ravencrest,288,warrior,arms,6,3,3
Alphyn,veknilash,288,warrior,arms,6,3,3
Thickslam,argent-dawn,288,warrior,arms,6,3,3
Zersei,los-errantes,288,warrior,arms,6,3,3
Ланат,ashenvale,288,warrior,arms,6,3,3
Sonyd,tarren-mill,288,warrior,arms,6,3,3
Суферна,howling-fjord,288,warrior,arms,6,3,3
Khorgash,ravencrest,288,warrior,arms,6,3,3
Sydian,burning-legion,288,warrior,arms,6,3,3
Qweoamsd,sylvanas,288,warrior,arms,6,3,3
Barbatos,saurfang,288,warrior,arms,6,3,3
Boig,ragnaros,288,warrior,arms,6,3,3
Veav,norgannon,288,warrior,arms,6,3,3
Xqty,ravencrest,288,warrior,arms,6,3,3
Lìcious,outland,288,warrior,arms,6,3,3
Бардеон,gordunni,288,warrior,arms,6,3,3
Johnfogerty,twisting-nether,288,warrior,arms,6,3,3
Gorejaws,draenor,288,warrior,arms,6,3,3
Mauricet,elune,288,warrior,arms,6,3,3
Онлихелл,howling-fjord,288,warrior,arms,6,3,3
Bladesmiths,argent-dawn,288,warrior,arms,6,3,3
Варбаул,soulflayer,288,warrior,arms,6,3,3
Rianhh,tarren-mill,288,warrior,arms,6,3,3
Jimei,temple-noir,288,warrior,arms,6,3,3
Tinydik,stormscale,288,warrior,arms,6,3,3
Opticsynfel,argent-dawn,288,warrior,arms,6,3,3
Precel,burning-legion,288,warrior,arms,6,3,3
Exeqty,the-maelstrom,288,warrior,arms,6,3,3
Despacitus,burning-legion,288,warrior,arms,6,3,3
Nazgrosh,burning-legion,288,warrior,arms,6,3,3
Hatefull,onyxia,288,warrior,arms,6,3,3
Valus,earthen-ring,288,warrior,arms,6,3,3
Hydracleave,ravencrest,288,warrior,arms,6,3,3
Nøøbisator,archimonde,288,warrior,arms,6,3,3
Bonkonator,stormscale,288,warrior,arms,6,3,3
Koliastra,magtheridon,288,warrior,arms,6,3,3
Schmelzlord,thrall,288,warrior,arms,6,3,3
Elainax,eredar,288,warrior,arms,6,3,3
Spearmisser,argent-dawn,288,warrior,arms,6,3,3
Mightyzuv,the-maelstrom,288,warrior,arms,6,3,3
Valíon,outland,288,warrior,arms,6,3,3
Kunodontas,draenor,288,warrior,arms,6,3,3
Nahkampfnoob,blackmoore,288,warrior,arms,6,3,3
Shædøw,archimonde,288,warrior,arms,6,3,3
Ckx,kazzak,288,warrior,arms,6,3,3
Tbomb,stormscale,288,warrior,arms,6,3,3
Learningwarr,eredar,288,warrior,arms,6,3,3
Ghostlord,dunemaul,288,warrior,arms,6,3,3
Mobyl,twisting-nether,288,warrior,arms,6,3,3
Лёшавор,howling-fjord,288,warrior,arms,6,3,3
Rézinplin,archimonde,288,warrior,arms,6,3,3
Greifax,eredar,288,warrior,arms,6,3,3
Gnolimits,antonidas,288,warrior,arms,6,3,3
Sumprunkare,stormscale,288,warrior,arms,6,3,3
Reckq,eredar,288,warrior,arms,6,3,3
Lödbrök,dalaran,288,warrior,arms,6,3,3
Raïgã,hyjal,288,warrior,arms,6,3,3
Bloodx,archimonde,288,warrior,arms,6,3,3
Klistertejp,argent-dawn,288,warrior,arms,6,3,3
Naskwar,archimonde,288,warrior,arms,6,3,3
Afes,kazzak,288,warrior,arms,6,3,3
Difalco,archimonde,288,warrior,arms,6,3,3
Venturez,stormscale,288,warrior,arms,6,3,3
Mâlitek,archimonde,288,warrior,arms,6,3,3
Cerßêre,archimonde,288,warrior,arms,6,3,3
Dðni,archimonde,288,warrior,arms,6,3,3
Nipes,nozdormu,288,warrior,arms,6,3,3
Toby,rexxar,288,warrior,arms,6,3,3
Tùcky,ysondre,288,warrior,arms,6,3,3
Resttanis,arathor,288,warrior,arms,6,3,3
Waron,dalaran,288,warrior,arms,6,3,3
Shïn,kaelthas,288,warrior,arms,6,3,3
Frenzyqt,zuljin,288,warrior,arms,6,3,3
Warwarsat,ysondre,288,warrior,arms,6,3,3
Fnoon,taerar,288,warrior,arms,6,3,3
Bootyclapper,runetotem,288,warrior,arms,6,3,3
Pwncallxx,kazzak,288,warrior,arms,6,3,3
Hanibalbarca,tarren-mill,288,warrior,arms,6,3,3
Kindface,the-maelstrom,288,warrior,arms,6,3,3
Nikoma,silvermoon,288,warrior,arms,6,3,3
Sergra,ysondre,288,warrior,arms,6,3,3
Issus,aggra-português,288,warrior,arms,6,3,3
Arnoldr,ysondre,288,warrior,arms,6,3,3
Oesche,frostmourne,288,warrior,arms,6,3,3
Matrixer,aegwynn,288,warrior,arms,6,3,3
Gabbz,aggra-português,288,warrior,arms,6,3,3
Bânkai,aegwynn,288,warrior,arms,6,3,3
Moorgoth,ysondre,288,warrior,arms,6,3,3
Fidicenz,ysondre,288,warrior,arms,6,3,3
Hitt,ysondre,288,warrior,arms,6,3,3
Lydianite,stormrage,288,warrior,arms,6,3,3
Górut,zuljin,288,warrior,arms,10,3,7
Wingüi,dun-modr,288,warrior,arms,12,3,9
Telrion,silvermoon,288,warrior,arms,12,3,9
Grodor,alakir,288,warrior,arms,12,3,9
Maxxiwumms,amanthul,288,warrior,arms,12,3,9
Methaniwths,twisting-nether,288,warrior,arms,12,3,9
Flexay,archimonde,288,warrior,arms,12,3,9
Шпингалетыч,howling-fjord,288,warrior,arms,12,3,9
Sway,eonar,288,warrior,arms,12,3,9
Бэнчпресс,soulflayer,288,warrior,arms,12,3,9
Азизос,gordunni,288,warrior,arms,12,3,9
Тирхо,gordunni,288,warrior,arms,12,3,9
Steroidkidx,stormscale,288,warrior,arms,12,3,9
Abrash,ysondre,288,warrior,arms,12,3,9
Warzaph,ravencrest,288,warrior,arms,12,3,9
Melliug,ysondre,288,warrior,arms,12,3,9
Анакронокс,howling-fjord,288,warrior,arms,12,3,9
Ruioz,draenor,288,warrior,arms,12,3,9
Carksn,blackmoore,288,warrior,arms,12,3,9
Sorryforwhat,stormscale,288,warrior,arms,12,3,9
Poluneikos,turalyon,288,warrior,arms,12,3,9
Koorkhan,outland,288,warrior,arms,12,3,9
Mercûry,stormscale,288,warrior,arms,12,3,9
Smökey,silvermoon,288,warrior,arms,12,3,9
Bolvarson,malganis,288,warrior,arms,12,3,9
Calmdownbrú,frostmane,288,warrior,arms,12,3,9
Грруд,galakrond,288,warrior,arms,12,3,9
Iarsonn,drakthul,288,warrior,arms,12,3,9
Zhodd,zuljin,288,warrior,arms,12,3,9
Esegryel,argent-dawn,288,warrior,arms,12,3,9
Jonukas,argent-dawn,288,warrior,arms,12,3,9
Romic,guldan,288,warrior,arms,12,3,9
Qdex,kazzak,288,warrior,arms,12,3,9
Garganelli,tarren-mill,288,warrior,arms,12,3,9
Raithwall,stormreaver,288,warrior,arms,12,3,9
Blxxwar,blackmoore,288,warrior,arms,12,3,9
Ravedeath,tarren-mill,288,warrior,arms,12,3,9
Aiwar,tarren-mill,288,warrior,arms,12,3,9
Wanzzeur,hyjal,288,warrior,arms,17,3,14
Luckysop,chants-éternels,288,warrior,arms,18,3,15
Sheriff,dragonblight,287,warrior,arms,6,3,3
Olagkhan,minahonda,287,warrior,arms,6,3,3
Bashion,ghostlands,287,warrior,arms,6,3,3
Mercaderx,stormscale,287,warrior,arms,6,3,3
Smeshh,burning-legion,287,warrior,arms,6,3,3
Lapyy,drakthul,287,warrior,arms,6,3,3
Smkw,kazzak,287,warrior,arms,6,3,3
Àke,darksorrow,287,warrior,arms,12,3,9
Freakzy,blackhand,287,warrior,arms,12,3,9
Heavenheart,bronzebeard,286,warrior,arms,6,3,3
Рф,thermaplugg,271,warrior,arms,11,3,8
Evèllon,blackmoore,271,warrior,arms,11,3,8
Gwagonbrabus,twisting-nether,271,warrior,arms,17,3,14
Kanyequest,bloodhoof,266,warrior,arms,15,5,10
Fion,kult-der-verdammten,255,warrior,arms,8,4,4
Vagor,aegwynn,255,warrior,arms,8,4,4
Greeneroi,khaz-modan,255,warrior,arms,11,3,8
Ânaxi,silvermoon,255,warrior,arms,11,3,8
Ahlda,hyjal,240,warrior,arms,15,3,12
Армсег,soulflayer,239,warrior,arms,5,3,2
Sarma,trollbane,239,warrior,arms,5,3,2
Inselmo,grim-batol,239,warrior,arms,5,3,2
Renji,proudmoore,239,warrior,arms,5,3,2
Keffboi,draenor,239,warrior,arms,5,3,2
Bubidiblumxq,twisting-nether,239,warrior,arms,9,4,5
Tstrike,silvermoon,234,warrior,arms,9,4,5
Enÿo,stormscale,234,warrior,arms,23,6,17
Ball,zirkel-des-cenarius,223,warrior,arms,8,3,5
Шрекинатор,soulflayer,208,warrior,arms,7,3,4
Vexxenn,outland,192,warrior,arms,4,3,1
Барнаул,gordunni,192,warrior,arms,6,2,4
Ratafya,hyjal,192,warrior,arms,6,2,4
Athënã,archimonde,192,warrior,arms,6,2,4
Highoverlord,aggra-português,192,warrior,arms,6,2,4
Sinkiss,archimonde,192,warrior,arms,6,2,4
Touthi,archimonde,192,warrior,arms,6,2,4
Äsgeïr,archimonde,192,warrior,arms,6,2,4
Syrebral,archimonde,192,warrior,arms,6,2,4
Kharabik,silvermoon,192,warrior,arms,6,2,4
Frézzér,blackrock,192,warrior,arms,6,2,4
Falaliss,elune,192,warrior,arms,6,2,4
Acour,elune,192,warrior,arms,6,2,4
Ryonâgai,aegwynn,192,warrior,arms,6,2,4
Eyolf,thunderhorn,192,warrior,arms,6,2,4
Delfrion,pozzo-delleternità,192,warrior,arms,6,2,4
Shimy,pozzo-delleternità,192,warrior,arms,6,2,4
Cjak,pozzo-delleternità,192,warrior,arms,6,2,4
Salsetti,nemesis,192,warrior,arms,6,2,4
Vaaýzx,blackrock,192,warrior,arms,6,2,4
Raggnnar,blackrock,192,warrior,arms,6,2,4
Bonkors,bronzebeard,192,warrior,arms,6,2,4
Рагаксес,blackscar,192,warrior,arms,6,2,4
Гудмунт,borean-tundra,192,warrior,arms,6,2,4
Røcksteady,festung-der-stürme,192,warrior,arms,6,2,4
Андервульф,booty-bay,192,warrior,arms,6,2,4
Blademir,aegwynn,192,warrior,arms,6,2,4
Груббоб,booty-bay,192,warrior,arms,6,2,4
Rutch,hyjal,192,warrior,arms,6,2,4
Cyrø,blackmoore,192,warrior,arms,6,2,4
Därlara,amanthul,192,warrior,arms,6,2,4
Krîspie,archimonde,192,warrior,arms,6,2,4
Dariman,aegwynn,192,warrior,arms,6,2,4
Burkek,hyjal,192,warrior,arms,6,2,4
Ехрерау,gordunni,192,warrior,arms,6,2,4
Kerando,tirion,192,warrior,arms,6,2,4
Lâppön,blackmoore,192,warrior,arms,6,2,4
Хедтакер,gordunni,192,warrior,arms,6,2,4
Apolyptica,blackmoore,192,warrior,arms,6,2,4
Злопиканка,gordunni,192,warrior,arms,6,2,4
Ивантуз,gordunni,192,warrior,arms,6,2,4
Trohr,blackmoore,192,warrior,arms,6,2,4
Hundar,archimonde,192,warrior,arms,6,2,4
Stweye,frostmane,192,warrior,arms,6,2,4
Bráïnléss,silvermoon,192,warrior,arms,6,2,4
Elinyar,aegwynn,192,warrior,arms,6,2,4
Yatõ,blackmoore,192,warrior,arms,6,2,4
Miotyz,ahnqiraj,192,warrior,arms,6,2,4
Rhaegon,laughing-skull,192,warrior,arms,6,2,4
Brutalizator,talnivarr,192,warrior,arms,6,2,4
Hitmanler,frostmane,192,warrior,arms,6,2,4
Scheroh,aegwynn,192,warrior,arms,6,2,4
Prs,defias-brotherhood,192,warrior,arms,6,2,4
Longy,mazrigos,192,warrior,arms,6,2,4
Darkwa,azjolnerub,192,warrior,arms,6,2,4
Эгнораш,soulflayer,192,warrior,arms,6,2,4
Algazarra,aggra-português,192,warrior,arms,6,2,4
Хэлвид,soulflayer,192,warrior,arms,6,2,4
Экзекутэр,soulflayer,192,warrior,arms,6,2,4
Казньшалав,gordunni,192,warrior,arms,6,2,4
Totenkrieger,draenor,192,warrior,arms,6,2,4
Rayeron,sanguino,192,warrior,arms,6,2,4
Chromoly,aegwynn,192,warrior,arms,6,2,4
Guryn,sanguino,192,warrior,arms,6,2,4
Fugrim,draenor,192,warrior,arms,6,2,4
Faláfel,zuljin,192,warrior,arms,6,2,4
Enzylolz,sanguino,192,warrior,arms,6,2,4
Katypärry,outland,192,warrior,arms,6,2,4
Ericmontana,draenor,192,warrior,arms,6,2,4
Бормормуш,gordunni,192,warrior,arms,6,2,4
Kurosawa,uldum,192,warrior,arms,6,2,4
Artheim,silvermoon,192,warrior,arms,6,2,4
Creezê,blackmoore,192,warrior,arms,6,2,4
Lildiabeto,darkspear,192,warrior,arms,6,2,4
Yoz,uldaman,192,warrior,arms,6,2,4
Kante,frostmane,192,warrior,arms,6,2,4
Meìlie,outland,192,warrior,arms,6,2,4
Chloade,burning-legion,192,warrior,arms,6,2,4
Tigron,burning-legion,192,warrior,arms,6,2,4
Ruuster,norgannon,192,warrior,arms,6,2,4
Nêithan,dun-modr,192,warrior,arms,6,2,4
Bellator,arakarahm,192,warrior,arms,6,2,4
Maeselance,dun-modr,192,warrior,arms,6,2,4
Vlader,dun-modr,192,warrior,arms,6,2,4
Shádówfáxí,outland,192,warrior,arms,6,2,4
Grimilax,hellscream,192,warrior,arms,6,2,4
Geforce,hellscream,192,warrior,arms,6,2,4
Spaiché,azshara,192,warrior,arms,6,2,4
Wilæm,argent-dawn,192,warrior,arms,6,2,4
Kaerz,ysondre,192,warrior,arms,6,2,4
Kíllguard,kazzak,192,warrior,arms,6,2,4
Linberg,ysondre,192,warrior,arms,6,2,4
Weezing,argent-dawn,192,warrior,arms,6,2,4
Ptp,argent-dawn,192,warrior,arms,6,2,4
Arthayl,eredar,192,warrior,arms,6,2,4
Lakes,eredar,192,warrior,arms,6,2,4
Unehuitsept,eredar,192,warrior,arms,6,2,4
Mifuune,argent-dawn,192,warrior,arms,6,2,4
Nurekin,argent-dawn,192,warrior,arms,6,2,4
Rochful,frostwolf,192,warrior,arms,6,2,4
Phalekxox,twisting-nether,192,warrior,arms,6,2,4
Tekà,tarren-mill,192,warrior,arms,6,2,4
Vearpayne,silvermoon,192,warrior,arms,6,2,4
Míngxuan,tarren-mill,192,warrior,arms,6,2,4
Fastnfuryous,antonidas,192,warrior,arms,6,2,4
Paow,tarren-mill,192,warrior,arms,6,2,4
Zugpump,tarren-mill,192,warrior,arms,6,2,4
Spacemachine,kazzak,192,warrior,arms,6,2,4
Eleborn,tarren-mill,192,warrior,arms,6,2,4
Blizo,tarren-mill,192,warrior,arms,6,2,4
Gaarrossh,kazzak,192,warrior,arms,6,2,4
Nînes,tarren-mill,192,warrior,arms,6,2,4
Astost,silvermoon,192,warrior,arms,6,2,4
Dutteh,tarren-mill,192,warrior,arms,6,2,4
Ciuez,tarren-mill,192,warrior,arms,6,2,4
Milant,antonidas,192,warrior,arms,6,2,4
Zerxees,tarren-mill,192,warrior,arms,6,2,4
Pvpstyle,bloodscalp,192,warrior,arms,6,2,4
Havkon,twisting-nether,192,warrior,arms,6,2,4
Xilthy,stormscale,192,warrior,arms,6,2,4
Sibali,stormreaver,192,warrior,arms,6,2,4
Rieku,kazzak,192,warrior,arms,6,2,4
Repó,twisting-nether,192,warrior,arms,6,2,4
Ken,twisting-nether,192,warrior,arms,6,2,4
Bulduzer,kazzak,192,warrior,arms,6,2,4
Stepmomgodx,kazzak,192,warrior,arms,6,2,4
Kladers,ravencrest,192,warrior,arms,6,2,4
Amphie,silvermoon,192,warrior,arms,6,2,4
Gretathunb,twisting-nether,192,warrior,arms,6,2,4
Woghard,drakthul,192,warrior,arms,6,2,4
Warrlee,ravencrest,192,warrior,arms,6,2,4
Byedriver,kazzak,192,warrior,arms,6,2,4
Seghrim,drakthul,192,warrior,arms,6,2,4
ßandit,ravencrest,192,warrior,arms,6,2,4
Thebigtosco,ravencrest,192,warrior,arms,6,2,4
Bigestdamugr,stormscale,192,warrior,arms,6,2,4
Robthebruce,ravencrest,192,warrior,arms,6,2,4
Darlith,azshara,192,warrior,arms,6,2,4
Siberianstag,ravencrest,192,warrior,arms,6,2,4
Myshu,ravencrest,192,warrior,arms,6,2,4
Чухануспрайм,howling-fjord,192,warrior,arms,6,2,4
Кичисан,howling-fjord,192,warrior,arms,6,2,4
Ærion,die-aldor,192,warrior,arms,6,2,4
Bulbasaur,twisting-nether,192,warrior,arms,6,2,4
Abibe,aggra-português,192,warrior,arms,6,2,4
Nocton,blackhand,192,warrior,arms,6,2,4
Gkavlaki,ravencrest,192,warrior,arms,6,2,4
Svepscumata,twisting-nether,192,warrior,arms,6,2,4
Aléxsandra,ravencrest,192,warrior,arms,6,2,4
Broley,blackhand,192,warrior,arms,6,2,4
Dabr,stormscale,192,warrior,arms,6,2,4
Ratnìk,stormscale,192,warrior,arms,6,2,4
Blackfrosty,stormscale,192,warrior,arms,6,2,4
Galenthor,ravencrest,192,warrior,arms,6,2,4
Redencounter,stormscale,192,warrior,arms,6,2,4
Кереешка,howling-fjord,192,warrior,arms,6,2,4
Irherklek,stormscale,192,warrior,arms,6,2,4
Unhingéd,stormscale,192,warrior,arms,6,2,4
Zaoclap,blackhand,192,warrior,arms,6,2,4
Frcwar,kazzak,192,warrior,arms,6,2,4
Ladoz,ragnaros,192,warrior,arms,6,2,4
Мэднас,howling-fjord,192,warrior,arms,6,2,4
Lortèn,stormscale,192,warrior,arms,6,2,4
Wfx,kazzak,192,warrior,arms,6,2,4
Jäky,ragnaros,192,warrior,arms,6,2,4
Bazsika,ragnaros,192,warrior,arms,6,2,4
Eriqua,archimonde,192,warrior,arms,8,2,6
Actoni,sylvanas,192,warrior,arms,12,2,10
Vazzle,nethersturm,192,warrior,arms,12,2,10
Younes,ravencrest,192,warrior,arms,12,2,10
Velcorn,ravencrest,192,warrior,arms,12,2,10
Péridotruite,hyjal,192,warrior,arms,12,2,10
Solidier,archimonde,192,warrior,arms,12,2,10
Gorzan,dragonmaw,192,warrior,arms,12,2,10
Утонаган,fordragon,192,warrior,arms,12,2,10
Furybringer,silvermoon,192,warrior,arms,12,2,10
Lzdmfckmeazy,blackmoore,192,warrior,arms,12,2,10
Bhallts,twisting-nether,192,warrior,arms,12,2,10
Battousai,sanguino,192,warrior,arms,12,2,10
Takatoa,argent-dawn,192,warrior,arms,12,2,10
Rukkeg,silvermoon,192,warrior,arms,12,2,10
Tyranoth,defias-brotherhood,192,warrior,arms,12,2,10
Radge,hyjal,192,warrior,arms,12,2,10
Maxeyn,kazzak,192,warrior,arms,18,2,16
Razzimak,eredar,191,warrior,arms,4,3,1
Oxascand,kazzak,175,warrior,arms,11,2,9
Номер,eversong,160,warrior,arms,10,2,8
Khilax,ragnaros,159,warrior,arms,5,2,3
Deadwily,twisting-nether,159,warrior,arms,5,2,3
Kibb,sylvanas,159,warrior,arms,5,2,3
Bloodpyre,nemesis,159,warrior,arms,11,2,9
Amystad,ahnqiraj,144,warrior,arms,9,2,7
Gondyr,quelthalas,144,warrior,arms,15,2,13
Nobelisarius,norgannon,138,warrior,arms,11,5,6
Lilsib,outland,138,warrior,arms,7,3,4
Hasira,xavius,128,warrior,arms,4,2,2
Ugardosh,burning-legion,128,warrior,arms,4,2,2
Dreadoran,voljin,112,warrior,arms,7,2,5
Estarotte,ravencrest,112,warrior,arms,7,2,5
Rdeniro,blackmoore,96,warrior,arms,3,2,1
Nekwar,ravencrest,96,warrior,arms,3,2,1
Kyraxe,silvermoon,96,warrior,arms,3,2,1
Lasttfallen,hyjal,96,warrior,arms,3,2,1
Monsterborn,bloodhoof,96,warrior,arms,6,1,5
Feltias,drakthul,96,warrior,arms,6,1,5
Tomhankz,ravencrest,96,warrior,arms,6,1,5
Elsinner,ravencrest,96,warrior,arms,6,1,5
Humanboi,ravencrest,96,warrior,arms,6,1,5
Letha,twisting-nether,96,warrior,arms,6,1,5
Rohc,kazzak,96,warrior,arms,6,1,5
Ivailowar,ravencrest,96,warrior,arms,6,1,5
Æxcoast,ravencrest,96,warrior,arms,6,1,5
Xail,rexxar,96,warrior,arms,6,1,5
Sebastian,ravencrest,96,warrior,arms,6,1,5
Sarkan,ravencrest,96,warrior,arms,6,1,5
Fàlconry,kazzak,96,warrior,arms,6,1,5
Executê,kazzak,96,warrior,arms,6,1,5
Davidass,drakthul,96,warrior,arms,6,1,5
Santorro,drakthul,96,warrior,arms,6,1,5
Luntee,ragnaros,96,warrior,arms,6,1,5
Tidùs,nethersturm,96,warrior,arms,6,1,5
Marax,spinebreaker,96,warrior,arms,6,1,5
Beduin,twilights-hammer,96,warrior,arms,6,1,5
Galatan,kazzak,96,warrior,arms,6,1,5
Acudam,stormscale,96,warrior,arms,6,1,5
Lithanør,silvermoon,96,warrior,arms,6,1,5
Pyrul,antonidas,96,warrior,arms,6,1,5
Deathsnarl,ragnaros,96,warrior,arms,6,1,5
Greenbeanx,antonidas,96,warrior,arms,6,1,5
Zeover,ragnaros,96,warrior,arms,6,1,5
Claymøre,khaz-modan,96,warrior,arms,6,1,5
Juanvaco,tarren-mill,96,warrior,arms,6,1,5
Ordovis,silvermoon,96,warrior,arms,6,1,5
Karyoroo,eredar,96,warrior,arms,6,1,5
Catrine,drakthul,96,warrior,arms,6,1,5
Spritekoppen,ravencrest,96,warrior,arms,6,1,5
Stillpetao,dun-modr,96,warrior,arms,6,1,5
Rikkavikki,argent-dawn,96,warrior,arms,6,1,5
Kamelskum,draenor,96,warrior,arms,6,1,5
Dundulinka,outland,96,warrior,arms,6,1,5
Durrüti,sanguino,96,warrior,arms,6,1,5
Ayasaki,argent-dawn,96,warrior,arms,6,1,5
Brutannya,argent-dawn,96,warrior,arms,6,1,5
Blackmoor,argent-dawn,96,warrior,arms,6,1,5
Kronmw,dun-modr,96,warrior,arms,6,1,5
Bloodpath,stormrage,96,warrior,arms,6,1,5
Dracos,mannoroth,96,warrior,arms,6,1,5
Armyne,kazzak,96,warrior,arms,6,1,5
Üzzy,dun-modr,96,warrior,arms,6,1,5
Gramash,grim-batol,96,warrior,arms,6,1,5
Шапканауши,eversong,96,warrior,arms,6,1,5
Midvînter,silvermoon,96,warrior,arms,6,1,5
Bravestar,ungoro,96,warrior,arms,6,1,5
Moowar,defias-brotherhood,96,warrior,arms,6,1,5
Kylian,aegwynn,96,warrior,arms,6,1,5
Oksimbillah,blackrock,96,warrior,arms,6,1,5
Murämasä,hyjal,96,warrior,arms,6,1,5
Molløtov,sargeras,96,warrior,arms,6,1,5
Yngvar,darksorrow,96,warrior,arms,6,1,5
Otzi,sargeras,96,warrior,arms,6,1,5
Слоз,gordunni,96,warrior,arms,6,1,5
Romppu,shattered-hand,96,warrior,arms,6,1,5
Belmont,doomhammer,96,warrior,arms,6,1,5
Gnomeð,blackrock,96,warrior,arms,6,1,5
Abukrd,turalyon,96,warrior,arms,6,1,5
Crook,doomhammer,96,warrior,arms,6,1,5
Axelitee,draenor,96,warrior,arms,6,1,5
Warfield,draenor,96,warrior,arms,6,1,5
Leryswarro,sanguino,96,warrior,arms,6,1,5
Gorroth,chamber-of-aspects,96,warrior,arms,6,1,5
Ifir,hyjal,96,warrior,arms,6,1,5
Lilsweép,draenor,96,warrior,arms,6,1,5
Рсдрпб,eversong,96,warrior,arms,6,1,5
Stretch,thrall,96,warrior,arms,6,1,5
Naiph,blackmoore,96,warrior,arms,6,1,5
Winedru,bronzebeard,96,warrior,arms,6,1,5
Craftorar,defias-brotherhood,96,warrior,arms,6,1,5
Leapling,blackmoore,96,warrior,arms,6,1,5
Osopeligroso,outland,96,warrior,arms,6,1,5
Pwndrizle,blackmoore,96,warrior,arms,6,1,5
Арленхейтлав,gordunni,96,warrior,arms,6,1,5
Талейлан,gordunni,96,warrior,arms,6,1,5
Pinkblast,sylvanas,96,warrior,arms,6,1,5
Màndø,archimonde,96,warrior,arms,7,1,6
Moshpít,antonidas,96,warrior,arms,12,1,11
Babæ,ravencrest,96,warrior,arms,12,1,11
Отпустите,howling-fjord,96,warrior,arms,12,1,11
Blufurys,nemesis,96,warrior,arms,14,1,13
Sangarane,archimonde,95,warrior,arms,3,2,1
Gìlgamesh,dun-modr,84,warrior,arms,19,4,15
Koboone,tarren-mill,79,warrior,arms,5,1,4
Dorya,aegwynn,79,warrior,arms,5,1,4
Shãne,ysondre,64,warrior,arms,4,1,3
Jvpx,silvermoon,64,warrior,arms,4,1,3
Rimmedpigeon,alakir,64,warrior,arms,4,1,3
Corlo,uldaman,63,warrior,arms,2,2,0
Angrethar,tarren-mill,63,warrior,arms,2,2,0
Rinos,silvermoon,63,warrior,arms,8,2,6
Elloo,tarren-mill,48,warrior,arms,3,1,2
Данилатитич,howling-fjord,48,warrior,arms,3,1,2
Матумбо,gordunni,48,warrior,arms,3,1,2
Garaha,argent-dawn,48,warrior,arms,3,1,2
Warriar,sylvanas,42,warrior,arms,11,3,8
Богадорога,howling-fjord,42,warrior,arms,11,3,8
Артен,ashenvale,42,warrior,arms,10,2,8
Glut,drakthul,42,warrior,arms,12,2,10
Reyon,argent-dawn,41,warrior,arms,6,2,4
Гангстарэпер,gordunni,31,warrior,arms,2,1,1
Eijnar,kazzak,31,warrior,arms,2,1,1
Clówny,garrosh,31,warrior,arms,8,1,7
Ugrlak,drakthul,16,warrior,arms,7,1,6
Swagenknecht,blackrock,1840,warrior,protection,66,31,35
Narrative,kazzak,1091,warrior,protection,48,17,31
Tríbún,kult-der-verdammten,854,warrior,protection,18,9,9
Sublexgg,blackrock,784,warrior,protection,19,9,10
Ferran,sanguino,383,warrior,protection,12,4,8
Flinn,die-nachtwache,376,warrior,protection,18,4,14
Blaying,ravencrest,288,warrior,protection,6,3,3
Флоуби,razuvious,287,warrior,protection,6,3,3
Денеур,gordunni,192,warrior,protection,6,2,4
