name,realm,rating,cls,spec,play,win,lose
Эваер,blackscar,1506,deathknight,blood,60,29,31
Rahbekius,kazzak,1475,deathknight,blood,131,54,77
Nîghtmáre,ravencrest,1150,deathknight,blood,29,16,13
Horrorda,defias-brotherhood,1119,deathknight,blood,27,14,13
Maylined,antonidas,576,deathknight,blood,12,6,6
Оосака,gordunni,573,deathknight,blood,24,6,18
Pinkish,argent-dawn,379,deathknight,blood,12,4,8
Барагган,thermaplugg,288,deathknight,blood,6,3,3
Кмамехочу,howling-fjord,288,deathknight,blood,18,3,15
Schiva,eredar,252,deathknight,blood,11,3,8
Хайвейтухэлл,soulflayer,2098,deathknight,unholy,96,48,48
Conqueròr,tarren-mill,2083,deathknight,unholy,94,46,48
Bóby,ravencrest,2040,deathknight,unholy,195,95,100
Leónid,kazzak,1962,deathknight,unholy,72,36,36
Нишимба,soulflayer,1962,deathknight,unholy,72,36,36
Vakü,burning-legion,1962,deathknight,unholy,238,117,121
Кромгона,soulflayer,1961,deathknight,unholy,112,69,43
Bedstemoor,ravencrest,1955,deathknight,unholy,90,47,43
Enzy,drakthul,1948,deathknight,unholy,42,26,16
Шайбовёрт,gordunni,1946,deathknight,unholy,90,48,42
Дайтоолгоун,gordunni,1937,deathknight,unholy,113,56,57
Shadowdeathj,kazzak,1913,deathknight,unholy,54,27,27
Ipanic,argent-dawn,1902,deathknight,unholy,162,88,74
Hotcherryx,dun-modr,1901,deathknight,unholy,96,48,48
Murky,kazzak,1901,deathknight,unholy,164,79,85
Валькейн,blackscar,1883,deathknight,unholy,60,32,28
Fxckingmad,ravencrest,1883,deathknight,unholy,72,37,35
Akaliz,die-aldor,1876,deathknight,unholy,66,35,31
Narali,argent-dawn,1859,deathknight,unholy,72,34,38
Vallenhal,twisting-nether,1850,deathknight,unholy,48,23,25
Azüla,ysondre,1848,deathknight,unholy,66,30,36
Worlviuz,argent-dawn,1847,deathknight,unholy,123,59,64
Меланндрис,gordunni,1845,deathknight,unholy,60,44,16
Øtherànóther,stormscale,1843,deathknight,unholy,54,30,24
Ezlyy,ravencrest,1843,deathknight,unholy,114,60,54
Amnésyx,ysondre,1842,deathknight,unholy,64,32,32
Дэхон,gordunni,1841,deathknight,unholy,64,37,27
Nómòre,ravencrest,1839,deathknight,unholy,60,30,30
Mockingbirdo,sanguino,1836,deathknight,unholy,36,24,12
Аронас,blackscar,1833,deathknight,unholy,83,42,41
Lilshiet,stormreaver,1831,deathknight,unholy,66,30,36
Namzera,draenor,1827,deathknight,unholy,114,70,44
Bøby,kul-tiras,1827,deathknight,unholy,48,24,24
Неондк,eversong,1821,deathknight,unholy,104,53,51
Zokko,blackrock,1820,deathknight,unholy,59,31,28
Cealdris,blackmoore,1819,deathknight,unholy,30,20,10
Обледенение,gordunni,1819,deathknight,unholy,36,19,17
Mávé,tarren-mill,1819,deathknight,unholy,59,31,28
Lutcher,hellfire,1818,deathknight,unholy,36,20,16
Rankor,grim-batol,1816,deathknight,unholy,66,36,30
Necrofear,grim-batol,1816,deathknight,unholy,126,62,64
Jesûsx,ravencrest,1814,deathknight,unholy,78,45,33
Argonat,silvermoon,1814,deathknight,unholy,99,57,42
Quizon,tarren-mill,1813,deathknight,unholy,60,31,29
Aryash,silvermoon,1812,deathknight,unholy,66,31,35
Аоепупс,gordunni,1809,deathknight,unholy,57,28,29
Allmawt,argent-dawn,1808,deathknight,unholy,89,51,38
Лордэскорт,gordunni,1805,deathknight,unholy,78,37,41
Køley,draenor,1804,deathknight,unholy,53,30,23
Annabolik,ravencrest,1804,deathknight,unholy,36,19,17
Icegrin,silvermoon,1803,deathknight,unholy,150,81,69
Butthurtx,stormscale,1802,deathknight,unholy,46,27,19
Бургер,soulflayer,1802,deathknight,unholy,78,33,45
Inflex,silvermoon,1800,deathknight,unholy,102,51,51
Grepetta,argent-dawn,1800,deathknight,unholy,243,121,122
Тхиро,gordunni,1797,deathknight,unholy,53,20,33
Itreachesout,ravencrest,1792,deathknight,unholy,88,45,43
Дайтоолгоун,deathguard,1783,deathknight,unholy,69,38,31
Darkknights,archimonde,1774,deathknight,unholy,56,35,21
Leomordf,doomhammer,1774,deathknight,unholy,166,92,74
Фростинг,gordunni,1757,deathknight,unholy,42,23,19
Necrølyte,sylvanas,1748,deathknight,unholy,54,29,25
Zerachy,blackmoore,1733,deathknight,unholy,30,19,11
Shanariel,khaz-modan,1733,deathknight,unholy,102,58,44
Змейняша,soulflayer,1723,deathknight,unholy,90,43,47
Skulm,twisting-nether,1722,deathknight,unholy,48,20,28
Ghostreign,tarren-mill,1719,deathknight,unholy,68,33,35
Aifam,twisting-nether,1717,deathknight,unholy,74,35,39
Oscman,silvermoon,1716,deathknight,unholy,111,56,55
Koranderx,argent-dawn,1713,deathknight,unholy,30,18,12
Ûñhølýðéåthj,tarren-mill,1711,deathknight,unholy,47,23,24
Storhøf,sanguino,1710,deathknight,unholy,36,22,14
Fabricius,blackrock,1710,deathknight,unholy,48,26,22
Слендер,howling-fjord,1705,deathknight,unholy,66,35,31
Wôrgenator,kazzak,1704,deathknight,unholy,48,18,30
Эриданс,gordunni,1699,deathknight,unholy,124,69,55
Kwc,ravencrest,1696,deathknight,unholy,87,43,44
Synthwave,tarren-mill,1694,deathknight,unholy,63,29,34
Kickbot,outland,1693,deathknight,unholy,154,78,76
Vainajala,die-aldor,1691,deathknight,unholy,77,46,31
Вирко,eversong,1689,deathknight,unholy,88,46,42
Verminosis,stormscale,1689,deathknight,unholy,54,21,33
Yandeäth,chants-éternels,1687,deathknight,unholy,71,41,30
Unhóly,tarren-mill,1687,deathknight,unholy,84,47,37
Кулькулегал,ashenvale,1685,deathknight,unholy,54,27,27
Sangíus,blackmoore,1684,deathknight,unholy,245,118,127
Sanlex,twisting-nether,1684,deathknight,unholy,115,51,64
Thezftw,kazzak,1684,deathknight,unholy,59,25,34
Eyyoo,blackmoore,1682,deathknight,unholy,52,24,28
ßankoedno,stormscale,1681,deathknight,unholy,120,62,58
Wombo,dentarg,1677,deathknight,unholy,57,30,27
Lovroo,silvermoon,1677,deathknight,unholy,93,43,50
Vatø,tarren-mill,1676,deathknight,unholy,60,27,33
Femilista,dun-modr,1671,deathknight,unholy,42,23,19
Сантамо,soulflayer,1669,deathknight,unholy,50,27,23
Exoflake,kazzak,1669,deathknight,unholy,52,26,26
Faznik,twisting-nether,1664,deathknight,unholy,59,28,31
Олинф,deathguard,1664,deathknight,unholy,56,23,33
Blazeberg,blackrock,1662,deathknight,unholy,58,33,25
Andreàs,silvermoon,1662,deathknight,unholy,42,22,20
Økah,outland,1659,deathknight,unholy,54,25,29
Тыпидо,howling-fjord,1652,deathknight,unholy,48,29,19
Feministi,stormreaver,1652,deathknight,unholy,48,24,24
Reann,argent-dawn,1649,deathknight,unholy,55,31,24
Aeneriah,tarren-mill,1648,deathknight,unholy,61,36,25
Кидер,blackscar,1647,deathknight,unholy,53,29,24
Ampdk,ravencrest,1647,deathknight,unholy,36,19,17
Äyrenn,draenor,1645,deathknight,unholy,61,35,26
Arizon,drakthul,1645,deathknight,unholy,72,26,46
Nèrfx,ragnaros,1641,deathknight,unholy,66,30,36
Leanâdle,hyjal,1640,deathknight,unholy,80,39,41
Çruél,silvermoon,1638,deathknight,unholy,48,21,27
Bokrak,norgannon,1637,deathknight,unholy,76,50,26
Crenshawx,twisting-nether,1636,deathknight,unholy,89,39,50
Garrinchá,stormscale,1636,deathknight,unholy,48,21,27
Капустас,gordunni,1633,deathknight,unholy,36,21,15
Sølîta,archimonde,1632,deathknight,unholy,71,39,32
Гронташ,howling-fjord,1628,deathknight,unholy,59,30,29
Fraeya,sunstrider,1628,deathknight,unholy,84,40,44
Herumor,nerzhul,1627,deathknight,unholy,60,32,28
Metalmanethé,tarren-mill,1627,deathknight,unholy,187,96,91
Bredox,ravencrest,1626,deathknight,unholy,54,24,30
Deathlog,silvermoon,1625,deathknight,unholy,84,42,42
Quetza,twisting-nether,1621,deathknight,unholy,36,17,19
Necrotic,blackrock,1618,deathknight,unholy,29,18,11
Кокосоус,gordunni,1618,deathknight,unholy,36,18,18
Аркёт,howling-fjord,1618,deathknight,unholy,42,19,23
Gladiadk,ysondre,1618,deathknight,unholy,42,17,25
Baltersa,blackhand,1614,deathknight,unholy,48,19,29
Pellizquitas,sanguino,1612,deathknight,unholy,30,17,13
Lockhead,stormscale,1612,deathknight,unholy,90,50,40
Inâste,thrall,1612,deathknight,unholy,36,20,16
Oj,darkspear,1611,deathknight,unholy,96,47,49
Darkertimes,ragnaros,1610,deathknight,unholy,126,57,69
Castlevanía,ravencrest,1609,deathknight,unholy,97,48,49
Bíllÿ,kazzak,1605,deathknight,unholy,42,17,25
Notsyndra,nemesis,1603,deathknight,unholy,42,23,19
Jiodythyy,archimonde,1602,deathknight,unholy,54,23,31
Nazgül,drakthul,1600,deathknight,unholy,110,58,52
Aceléss,drakthul,1600,deathknight,unholy,42,20,22
Deathcaller,zuljin,1593,deathknight,unholy,59,29,30
Nommad,archimonde,1587,deathknight,unholy,83,39,44
Yusehz,kazzak,1587,deathknight,unholy,47,21,26
Deathvid,ravencrest,1586,deathknight,unholy,60,33,27
Lichbørn,ragnaros,1585,deathknight,unholy,54,25,29
Creatar,kazzak,1582,deathknight,unholy,36,22,14
Péterpain,antonidas,1581,deathknight,unholy,42,17,25
Ronsôn,terrordar,1578,deathknight,unholy,42,20,22
Ghaloob,draenor,1576,deathknight,unholy,42,20,22
Ктунец,blackscar,1570,deathknight,unholy,36,19,17
Маххес,howling-fjord,1570,deathknight,unholy,36,17,19
Söttguetsi,blackrock,1566,deathknight,unholy,41,23,18
Motvinden,stormscale,1566,deathknight,unholy,46,22,24
Körthazz,hyjal,1563,deathknight,unholy,55,27,28
Хорссэ,soulflayer,1562,deathknight,unholy,37,22,15
Винерас,soulflayer,1562,deathknight,unholy,66,31,35
Вурдулакх,gordunni,1561,deathknight,unholy,96,48,48
Моровой,blackscar,1559,deathknight,unholy,41,20,21
Oweiowei,blackrock,1558,deathknight,unholy,30,18,12
Pavkata,outland,1555,deathknight,unholy,130,68,62
Qtxi,nozdormu,1552,deathknight,unholy,96,52,44
Vexxed,magtheridon,1549,deathknight,unholy,45,27,18
Gargalon,drakthul,1547,deathknight,unholy,54,28,26
Turboface,kazzak,1546,deathknight,unholy,60,34,26
Apoikos,argent-dawn,1546,deathknight,unholy,36,19,17
Элекна,deepholm,1541,deathknight,unholy,48,24,24
Кадавров,gordunni,1540,deathknight,unholy,72,37,35
Ullefuz,silvermoon,1537,deathknight,unholy,30,21,9
Хассандра,galakrond,1537,deathknight,unholy,68,33,35
Zoree,draenor,1534,deathknight,unholy,95,50,45
Smörj,aggramar,1534,deathknight,unholy,42,17,25
Walkeni,defias-brotherhood,1530,deathknight,unholy,35,19,16
Алсидис,gordunni,1527,deathknight,unholy,72,29,43
Bephomet,onyxia,1524,deathknight,unholy,45,16,29
Halez,antonidas,1523,deathknight,unholy,66,34,32
Рыжаяпедаль,soulflayer,1522,deathknight,unholy,24,16,8
Woddey,blackrock,1520,deathknight,unholy,72,39,33
Garasu,eredar,1517,deathknight,unholy,42,16,26
Greymarker,kirin-tor,1513,deathknight,unholy,66,37,29
Акамахи,ashenvale,1513,deathknight,unholy,30,16,14
Zff,hyjal,1510,deathknight,unholy,30,20,10
Ardros,eredar,1507,deathknight,unholy,48,23,25
Apoikia,argent-dawn,1507,deathknight,unholy,42,19,23
Дерайв,gordunni,1506,deathknight,unholy,42,19,23
Hellguy,draenor,1506,deathknight,unholy,177,78,99
Арцевус,gordunni,1504,deathknight,unholy,70,36,34
Megdeath,silvermoon,1504,deathknight,unholy,90,43,47
Сванхильда,grom,1503,deathknight,unholy,72,34,38
Sîck,bladefist,1503,deathknight,unholy,60,22,38
Numnuts,alakir,1502,deathknight,unholy,36,21,15
Devilknight,dentarg,1500,deathknight,unholy,136,68,68
Ахелекус,blackscar,1498,deathknight,unholy,30,17,13
Aleejha,draenor,1496,deathknight,unholy,40,22,18
Moko,defias-brotherhood,1495,deathknight,unholy,42,20,22
Dörfl,antonidas,1494,deathknight,unholy,81,38,43
Барагган,thermaplugg,1489,deathknight,unholy,48,24,24
Мёрдерфэйсх,soulflayer,1488,deathknight,unholy,90,46,44
Торедх,howling-fjord,1488,deathknight,unholy,60,23,37
Riceeater,kazzak,1483,deathknight,unholy,59,29,30
Ceranto,frostwolf,1481,deathknight,unholy,71,44,27
Лекъса,gordunni,1481,deathknight,unholy,87,44,43
Bloodbane,burning-blade,1481,deathknight,unholy,36,18,18
Anaralien,ravencrest,1479,deathknight,unholy,89,40,49
Maradk,drakthul,1473,deathknight,unholy,41,21,20
Deathcam,emerald-dream,1472,deathknight,unholy,71,32,39
Derfitt,sanguino,1472,deathknight,unholy,48,20,28
Fennro,ysondre,1471,deathknight,unholy,210,89,121
Sorostew,twisting-nether,1467,deathknight,unholy,42,23,19
Arxelas,sylvanas,1467,deathknight,unholy,115,60,55
Salezians,drakthul,1463,deathknight,unholy,53,31,22
Utyr,ragnaros,1463,deathknight,unholy,30,16,14
Bärdk,forscherliga,1461,deathknight,unholy,77,37,40
Rizzlerdk,blackhand,1461,deathknight,unholy,78,30,48
Metalist,ravencrest,1460,deathknight,unholy,30,17,13
Смердонос,grom,1460,deathknight,unholy,86,48,38
Шифычдк,howling-fjord,1460,deathknight,unholy,60,27,33
Blízna,kazzak,1459,deathknight,unholy,96,45,51
Nospets,kazzak,1459,deathknight,unholy,54,25,29
Deusmort,ravencrest,1457,deathknight,unholy,66,26,40
Gethunts,drakthul,1455,deathknight,unholy,36,22,14
Manovar,archimonde,1455,deathknight,unholy,47,20,27
Deadroses,tarren-mill,1453,deathknight,unholy,60,38,22
Teljujad,sanguino,1453,deathknight,unholy,92,45,47
Xado,frostwolf,1451,deathknight,unholy,78,44,34
Нарилуне,blackscar,1451,deathknight,unholy,262,130,132
Борнтудай,borean-tundra,1445,deathknight,unholy,48,17,31
Quantumshift,ravencrest,1444,deathknight,unholy,36,23,13
Unholy,ragnaros,1444,deathknight,unholy,38,20,18
Blorin,sylvanas,1441,deathknight,unholy,73,34,39
Ðiesel,stormscale,1441,deathknight,unholy,69,25,44
Сенкрул,gordunni,1440,deathknight,unholy,72,48,24
Smallbaboon,stormreaver,1438,deathknight,unholy,36,15,21
Ganessha,sanguino,1437,deathknight,unholy,27,16,11
Assgripper,hyjal,1433,deathknight,unholy,30,21,9
Facèpalm,ravencrest,1432,deathknight,unholy,47,26,21
Спавни,blackscar,1432,deathknight,unholy,135,62,73
Sélyne,dalaran,1431,deathknight,unholy,42,15,27
Jalapeñofan,tarren-mill,1430,deathknight,unholy,36,18,18
Goreshovel,stormscale,1428,deathknight,unholy,36,19,17
Babsyknight,wildhammer,1426,deathknight,unholy,78,32,46
Анихиме,howling-fjord,1424,deathknight,unholy,75,37,38
Skøurge,silvermoon,1421,deathknight,unholy,126,64,62
Discochoppa,blackmoore,1421,deathknight,unholy,36,15,21
Hawkthuglife,dun-modr,1421,deathknight,unholy,42,17,25
Mìa,kragjin,1415,deathknight,unholy,73,33,40
Ràiven,blackmoore,1411,deathknight,unholy,35,15,20
Terren,ravencrest,1409,deathknight,unholy,52,29,23
Xirra,tarren-mill,1409,deathknight,unholy,67,33,34
Hêalz,ungoro,1408,deathknight,unholy,66,34,32
Pawcio,argent-dawn,1404,deathknight,unholy,84,44,40
Arkaris,blackmoore,1402,deathknight,unholy,26,17,9
Dkbladet,ravencrest,1400,deathknight,unholy,75,39,36
Fýhr,silvermoon,1398,deathknight,unholy,36,18,18
Lorvetis,malorne,1395,deathknight,unholy,42,19,23
Frostmommy,argent-dawn,1394,deathknight,unholy,87,37,50
Unholycard,argent-dawn,1389,deathknight,unholy,36,19,17
Sathmayla,silvermoon,1384,deathknight,unholy,29,18,11
Hordak,stormscale,1384,deathknight,unholy,39,15,24
Gaurk,aggra-português,1382,deathknight,unholy,42,24,18
Ithis,zuljin,1379,deathknight,unholy,78,34,44
Züg,draenor,1375,deathknight,unholy,54,26,28
Gødofredo,dun-modr,1370,deathknight,unholy,60,30,30
Tyvra,blackhand,1369,deathknight,unholy,47,17,30
Десхоб,soulflayer,1368,deathknight,unholy,120,43,77
Fizzdk,pozzo-delleternità,1366,deathknight,unholy,42,19,23
Дедхо,soulflayer,1365,deathknight,unholy,36,15,21
Jäätynyt,zenedar,1360,deathknight,unholy,111,43,68
Arthrex,twisting-nether,1358,deathknight,unholy,36,21,15
Draforce,quelthalas,1349,deathknight,unholy,23,15,8
Prænklý,blackrock,1348,deathknight,unholy,30,15,15
Jihm,silvermoon,1344,deathknight,unholy,123,65,58
Ahilus,bladefist,1343,deathknight,unholy,31,15,16
Zeghor,ragnaros,1343,deathknight,unholy,42,15,27
Segrim,drakthul,1342,deathknight,unholy,26,15,11
Крус,blackscar,1342,deathknight,unholy,57,27,30
Roaredrick,draenor,1342,deathknight,unholy,87,40,47
Хейткрю,howling-fjord,1342,deathknight,unholy,48,21,27
Yagoora,silvermoon,1339,deathknight,unholy,33,15,18
Брексиен,gordunni,1338,deathknight,unholy,48,14,34
Happsor,eredar,1336,deathknight,unholy,36,14,22
Alessia,alonsus,1335,deathknight,unholy,24,14,10
Pandahapci,ragnaros,1335,deathknight,unholy,30,14,16
Sveinnhran,kazzak,1333,deathknight,unholy,94,44,50
Akelæ,draenor,1331,deathknight,unholy,56,29,27
Evelys,kazzak,1329,deathknight,unholy,34,17,17
Kalantii,draenor,1326,deathknight,unholy,36,19,17
Ridire,saurfang,1326,deathknight,unholy,43,22,21
Nilodk,nemesis,1321,deathknight,unholy,135,70,65
Teflonphobos,stormreaver,1320,deathknight,unholy,18,14,4
Bloodkatana,drakthul,1320,deathknight,unholy,30,14,16
Detrah,argent-dawn,1315,deathknight,unholy,52,27,25
Negzul,blackmoore,1314,deathknight,unholy,54,26,28
Heyabigail,wildhammer,1312,deathknight,unholy,30,14,16
Gareath,ragnaros,1311,deathknight,unholy,36,14,22
Sictir,stormscale,1310,deathknight,unholy,188,90,98
Zegaan,kazzak,1305,deathknight,unholy,54,22,32
Mojodango,outland,1299,deathknight,unholy,26,15,11
Reportmeplz,ragnaros,1298,deathknight,unholy,42,20,22
Endlesspain,burning-legion,1298,deathknight,unholy,53,22,31
Крикед,soulflayer,1297,deathknight,unholy,102,55,47
Роземайер,ashenvale,1297,deathknight,unholy,60,29,31
Ничер,thermaplugg,1289,deathknight,unholy,24,14,10
Reapocalypse,blackhand,1287,deathknight,unholy,119,52,67
Бреч,gordunni,1285,deathknight,unholy,42,14,28
Tyranus,quelthalas,1282,deathknight,unholy,109,48,61
Zelbørk,medivh,1276,deathknight,unholy,30,17,13
Альмон,howling-fjord,1276,deathknight,unholy,30,14,16
Zracul,nordrassil,1272,deathknight,unholy,85,41,44
Jöndas,drakthul,1272,deathknight,unholy,42,20,22
Razzvy,darkspear,1271,deathknight,unholy,45,20,25
Tanenoss,kazzak,1270,deathknight,unholy,48,20,28
Necrozy,aggra-português,1269,deathknight,unholy,84,43,41
Morinosei,twisting-nether,1269,deathknight,unholy,59,30,29
Necrocancerr,twisting-nether,1269,deathknight,unholy,104,49,55
Kaletorn,ragnaros,1265,deathknight,unholy,84,41,43
Undtot,azshara,1264,deathknight,unholy,36,16,20
Pjthedk,lightbringer,1263,deathknight,unholy,42,21,21
Évìl,stormscale,1262,deathknight,unholy,27,14,13
Drenodur,amanthul,1261,deathknight,unholy,24,14,10
Superere,hyjal,1261,deathknight,unholy,36,17,19
Dunkàn,silvermoon,1260,deathknight,unholy,30,21,9
Таможникс,soulflayer,1260,deathknight,unholy,23,14,9
Lobotomia,burning-blade,1259,deathknight,unholy,47,23,24
Reidemorte,minahonda,1259,deathknight,unholy,36,15,21
Persefal,nemesis,1259,deathknight,unholy,42,15,27
Gûuts,archimonde,1256,deathknight,unholy,174,86,88
Dklékata,archimonde,1252,deathknight,unholy,29,15,14
Rottenpete,grim-batol,1247,deathknight,unholy,24,13,11
Âlîce,culte-de-la-rive-noire,1247,deathknight,unholy,30,15,15
Mîîkkaa,blackhand,1247,deathknight,unholy,30,13,17
Undeadcell,ravencrest,1245,deathknight,unholy,24,13,11
Fishtruction,tarren-mill,1243,deathknight,unholy,60,31,29
Raust,xavius,1242,deathknight,unholy,26,13,13
Shabiri,twisting-nether,1238,deathknight,unholy,29,14,15
Руариди,gordunni,1237,deathknight,unholy,24,13,11
Khorag,mannoroth,1235,deathknight,unholy,30,13,17
Кристер,lich-king,1234,deathknight,unholy,30,13,17
Yousaindk,blackrock,1232,deathknight,unholy,30,13,17
Джайвана,soulflayer,1222,deathknight,unholy,112,55,57
Ínví,aegwynn,1219,deathknight,unholy,30,13,17
Fentanil,elune,1215,deathknight,unholy,76,35,41
Abnormus,tarren-mill,1175,deathknight,unholy,45,19,26
Ezreo,neptulon,1167,deathknight,unholy,31,14,17
Ashlëy,kaelthas,1159,deathknight,unholy,120,62,58
Râke,teldrassil,1152,deathknight,unholy,24,12,12
Fyrkadk,aegwynn,1151,deathknight,unholy,24,12,12
Dklol,dun-morogh,1150,deathknight,unholy,36,14,22
Eltorro,ravencrest,1150,deathknight,unholy,36,13,23
Numnutz,alakir,1149,deathknight,unholy,25,13,12
Lurkkiss,ravencrest,1149,deathknight,unholy,30,12,18
Frege,tarren-mill,1149,deathknight,unholy,30,12,18
Линфео,galakrond,1149,deathknight,unholy,36,12,24
Zugzugdecay,kazzak,1148,deathknight,unholy,24,12,12
Triffdich,blackrock,1146,deathknight,unholy,30,12,18
Клиссанг,razuvious,1146,deathknight,unholy,42,12,30
Nødder,ragnaros,1145,deathknight,unholy,18,12,6
Späwn,ysondre,1145,deathknight,unholy,30,12,18
Trialist,dun-modr,1143,deathknight,unholy,24,12,12
Mãshi,hyjal,1140,deathknight,unholy,59,26,33
Sevatar,zuljin,1137,deathknight,unholy,18,12,6
Fineral,argent-dawn,1134,deathknight,unholy,24,12,12
Aesthaetik,draenor,1133,deathknight,unholy,22,13,9
Jowân,blackmoore,1131,deathknight,unholy,24,13,11
Qmy,outland,1131,deathknight,unholy,24,12,12
Dêku,aegwynn,1130,deathknight,unholy,79,44,35
Asakurai,grim-batol,1126,deathknight,unholy,42,22,20
Darkhallow,thrall,1125,deathknight,unholy,101,50,51
Híruzen,blackrock,1115,deathknight,unholy,30,15,15
Auru,tarren-mill,1111,deathknight,unholy,27,14,13
Ârtjom,aegwynn,1106,deathknight,unholy,28,12,16
Asakim,tarren-mill,1102,deathknight,unholy,23,12,11
Saromón,ravencrest,1101,deathknight,unholy,30,18,12
Roykoopa,hyjal,1099,deathknight,unholy,30,13,17
Apolyio,outland,1095,deathknight,unholy,35,14,21
Nestia,emerald-dream,1090,deathknight,unholy,30,12,18
Diatriss,argent-dawn,1078,deathknight,unholy,63,27,36
Ahlat,blackmoore,1074,deathknight,unholy,18,12,6
Ennigmá,stormscale,1066,deathknight,unholy,24,13,11
Квашонка,howling-fjord,1061,deathknight,unholy,36,12,24
Likewise,twisting-nether,1056,deathknight,unholy,30,11,19
Wallenschøld,kazzak,1055,deathknight,unholy,18,11,7
Nysaia,blackmoore,1055,deathknight,unholy,18,11,7
Вовчан,howling-fjord,1055,deathknight,unholy,24,11,13
Doozz,draenor,1055,deathknight,unholy,30,11,19
Turkknight,outland,1053,deathknight,unholy,24,11,13
Erodevil,kazzak,1051,deathknight,unholy,30,11,19
Аирфрост,howling-fjord,1049,deathknight,unholy,24,11,13
Dunklerlord,malfurion,1045,deathknight,unholy,24,11,13
Xênôrr,archimonde,1045,deathknight,unholy,24,11,13
Ilovegouàng,khaz-modan,1041,deathknight,unholy,36,15,21
Охъламон,soulflayer,1033,deathknight,unholy,48,17,31
Kixx,bloodfeather,1030,deathknight,unholy,47,17,30
Мокраявода,soulflayer,1026,deathknight,unholy,94,49,45
Pamplemouse,burning-blade,1016,deathknight,unholy,79,36,43
Takåtry,archimonde,1004,deathknight,unholy,30,14,16
Tyrannus,earthen-ring,1000,deathknight,unholy,23,13,10
Gowther,blackmoore,999,deathknight,unholy,30,16,14
Gravetitan,shattrath,999,deathknight,unholy,53,19,34
Assasínator,tarren-mill,995,deathknight,unholy,72,37,35
Karalun,nagrand,992,deathknight,unholy,54,25,29
Gathalion,the-maelstrom,980,deathknight,unholy,48,28,20
Trigárdon,antonidas,968,deathknight,unholy,30,16,14
Сгеатог,gordunni,960,deathknight,unholy,18,10,8
Èvíl,stormscale,960,deathknight,unholy,18,10,8
Kaliro,sylvanas,960,deathknight,unholy,18,10,8
Кромгондк,soulflayer,960,deathknight,unholy,24,10,14
Gripbroblem,nemesis,960,deathknight,unholy,30,10,20
Mammacitaa,argent-dawn,959,deathknight,unholy,18,10,8
Nasxsy,blackmoore,959,deathknight,unholy,18,10,8
Скизм,howling-fjord,959,deathknight,unholy,24,10,14
Prekliatylad,burning-blade,959,deathknight,unholy,24,10,14
Silvergreed,kazzak,959,deathknight,unholy,24,10,14
Анзорини,gordunni,959,deathknight,unholy,30,10,20
Dzemoo,drakthul,958,deathknight,unholy,18,10,8
Exanex,ragnaros,957,deathknight,unholy,18,10,8
Funds,kazzak,957,deathknight,unholy,24,10,14
Logoz,dun-modr,956,deathknight,unholy,18,10,8
Fpsrvg,minahonda,956,deathknight,unholy,53,23,30
Шейзо,soulflayer,954,deathknight,unholy,16,11,5
Sigarå,twisting-nether,945,deathknight,unholy,24,10,14
Recoil,blackrock,925,deathknight,unholy,20,11,9
Abcdk,sargeras,925,deathknight,unholy,20,11,9
Fluffínator,kazzak,915,deathknight,unholy,26,11,15
Sang,deathwing,912,deathknight,unholy,15,11,4
Kaldhan,nemesis,910,deathknight,unholy,24,10,14
Nauser,kazzak,906,deathknight,unholy,29,10,19
Lastdragon,dun-modr,896,deathknight,unholy,30,12,18
Лордэнергон,gordunni,888,deathknight,unholy,16,10,6
Restodrowd,tarren-mill,888,deathknight,unholy,24,11,13
Orcborg,zuljin,868,deathknight,unholy,25,10,15
Panorboy,tarren-mill,864,deathknight,unholy,18,9,9
Khalifamia,alonsus,864,deathknight,unholy,18,9,9
Usbdock,stormscale,864,deathknight,unholy,18,9,9
Catloaf,silvermoon,864,deathknight,unholy,24,9,15
Geraltbg,twisting-nether,864,deathknight,unholy,24,9,15
Linuzbunny,zenedar,863,deathknight,unholy,12,9,3
Styxdk,blackhand,863,deathknight,unholy,18,9,9
Bertonilo,burning-legion,863,deathknight,unholy,18,9,9
Synchronic,stormscale,863,deathknight,unholy,18,9,9
Frostplague,aegwynn,863,deathknight,unholy,24,9,15
Vrez,argent-dawn,862,deathknight,unholy,24,9,15
Veçh,turalyon,861,deathknight,unholy,30,9,21
Тзинч,soulflayer,859,deathknight,unholy,18,9,9
Dzahnecro,archimonde,858,deathknight,unholy,18,9,9
Кмамехочу,howling-fjord,857,deathknight,unholy,12,9,3
Tarfu,kazzak,856,deathknight,unholy,18,9,9
Marcianorock,dalaran,850,deathknight,unholy,18,9,9
Mellowqt,aegwynn,846,deathknight,unholy,24,9,15
Deathcleave,burning-legion,845,deathknight,unholy,23,9,14
Arthursq,stormscale,835,deathknight,unholy,30,12,18
Cryistyx,draenor,828,deathknight,unholy,14,10,4
Малп,gordunni,827,deathknight,unholy,18,9,9
Zot,twisting-nether,814,deathknight,unholy,18,10,8
Branchë,stormscale,814,deathknight,unholy,21,10,11
Beinlausi,dalaran,807,deathknight,unholy,15,9,6
Шмуркич,gordunni,798,deathknight,unholy,23,10,13
Некронн,grom,795,deathknight,unholy,17,9,8
Oldu,haomarush,794,deathknight,unholy,39,15,24
Radan,stormscale,768,deathknight,unholy,12,8,4
Wórzzag,arygos,768,deathknight,unholy,12,8,4
Critycal,draenor,768,deathknight,unholy,12,8,4
Preddktwo,twisting-nether,768,deathknight,unholy,12,8,4
Шадоудез,gordunni,768,deathknight,unholy,12,8,4
Aladonreith,zenedar,768,deathknight,unholy,12,8,4
Psychopathz,tarren-mill,768,deathknight,unholy,12,8,4
Barnëylord,argent-dawn,768,deathknight,unholy,12,8,4
Schweezlord,tarren-mill,768,deathknight,unholy,12,8,4
Rimda,twisting-nether,768,deathknight,unholy,12,8,4
Sanuky,blackrock,768,deathknight,unholy,18,8,10
Apacstanya,ragnaros,768,deathknight,unholy,18,8,10
Кромгак,soulflayer,768,deathknight,unholy,18,8,10
Juliean,blackmoore,768,deathknight,unholy,18,8,10
Senkingodx,ravencrest,768,deathknight,unholy,24,8,16
Zatrina,blackrock,768,deathknight,unholy,24,8,16
Fosswire,stormscale,767,deathknight,unholy,12,8,4
Amelia,ambossar,767,deathknight,unholy,12,8,4
Lavonobatas,kazzak,767,deathknight,unholy,12,8,4
Epoch,azjolnerub,767,deathknight,unholy,24,8,16
Nuadar,outland,767,deathknight,unholy,24,8,16
Raizhen,ragnaros,767,deathknight,unholy,24,8,16
Payat,aegwynn,766,deathknight,unholy,12,8,4
Krinoe,dalaran,766,deathknight,unholy,18,8,10
Elíta,draenor,766,deathknight,unholy,18,8,10
Zombienatíon,silvermoon,766,deathknight,unholy,24,8,16
Kazay,madmortem,763,deathknight,unholy,18,8,10
Деркхаус,soulflayer,762,deathknight,unholy,12,8,4
Badbrian,draenor,760,deathknight,unholy,12,8,4
Rognvald,les-sentinelles,755,deathknight,unholy,17,11,6
Ricardiob,argent-dawn,748,deathknight,unholy,16,9,7
Nickolass,skullcrusher,747,deathknight,unholy,18,8,10
Tesasd,silvermoon,732,deathknight,unholy,22,9,13
Aldramil,gorgonnash,726,deathknight,unholy,24,9,15
Dzwiadke,burning-legion,718,deathknight,unholy,27,8,19
Промештейн,gordunni,712,deathknight,unholy,29,10,19
Jess,blackhand,694,deathknight,unholy,17,8,9
Полонит,gordunni,672,deathknight,unholy,12,7,5
Judin,kazzak,672,deathknight,unholy,12,7,5
Зибак,soulflayer,672,deathknight,unholy,12,7,5
Chrispbacøn,ragnaros,672,deathknight,unholy,12,7,5
Gushik,twisting-nether,672,deathknight,unholy,12,7,5
Gøretterog,ysondre,672,deathknight,unholy,12,7,5
Moonpoxdk,nerathor,672,deathknight,unholy,12,7,5
Никнейм,gordunni,672,deathknight,unholy,18,7,11
Darkarthás,aegwynn,672,deathknight,unholy,18,7,11
Dräpârn,sylvanas,672,deathknight,unholy,18,7,11
Gadres,aegwynn,672,deathknight,unholy,18,7,11
Yamisukehiro,drakthul,672,deathknight,unholy,18,7,11
Чумазная,howling-fjord,672,deathknight,unholy,18,7,11
Soulchaos,ravencrest,672,deathknight,unholy,18,7,11
Bigdickdk,ragnaros,672,deathknight,unholy,18,7,11
Unholykebab,defias-brotherhood,672,deathknight,unholy,18,7,11
Dimania,the-maelstrom,672,deathknight,unholy,24,7,17
Smightydk,kazzak,671,deathknight,unholy,12,7,5
Дэдушка,gordunni,671,deathknight,unholy,12,7,5
Empiu,blackhand,671,deathknight,unholy,12,7,5
Ультерис,deathguard,671,deathknight,unholy,12,7,5
Gegham,ravencrest,671,deathknight,unholy,12,7,5
Mcrune,ravencrest,671,deathknight,unholy,18,7,11
Defeated,thrall,671,deathknight,unholy,18,7,11
Ráisy,outland,671,deathknight,unholy,24,7,17
Amencore,kazzak,670,deathknight,unholy,14,7,7
Unzul,twisting-nether,660,deathknight,unholy,12,7,5
Dekayo,blackrock,640,deathknight,unholy,16,7,9
Dasvidania,ragnaros,576,deathknight,unholy,6,6,0
Duriel,stormscale,576,deathknight,unholy,12,6,6
Nephalêm,thrall,576,deathknight,unholy,12,6,6
Kurían,burning-legion,576,deathknight,unholy,12,6,6
Swordkill,drakthul,576,deathknight,unholy,12,6,6
Lemain,drakthul,576,deathknight,unholy,12,6,6
Mefhesto,tarren-mill,576,deathknight,unholy,12,6,6
Myeltior,kazzak,576,deathknight,unholy,12,6,6
Ketnissq,blackrock,576,deathknight,unholy,12,6,6
Feelmyfuri,mazrigos,576,deathknight,unholy,12,6,6
Дэбон,howling-fjord,576,deathknight,unholy,12,6,6
Sfintter,uldum,576,deathknight,unholy,12,6,6
Gigadk,ragnaros,576,deathknight,unholy,12,6,6
Fatøumatata,archimonde,576,deathknight,unholy,12,6,6
Fringles,twisting-nether,576,deathknight,unholy,12,6,6
Моорта,soulflayer,576,deathknight,unholy,12,6,6
Kebabpizza,argent-dawn,576,deathknight,unholy,12,6,6
Maxto,outland,576,deathknight,unholy,12,6,6
Critgødx,draenor,576,deathknight,unholy,13,6,7
Pestikus,thrall,576,deathknight,unholy,18,6,12
Exult,twisting-nether,576,deathknight,unholy,18,6,12
Инлакеш,howling-fjord,576,deathknight,unholy,18,6,12
Itokawa,tarren-mill,576,deathknight,unholy,18,6,12
Oxxöw,draenor,576,deathknight,unholy,18,6,12
Darhma,archimonde,576,deathknight,unholy,24,6,18
Dekatos,twisting-nether,575,deathknight,unholy,12,6,6
Arrakìs,nemesis,575,deathknight,unholy,12,6,6
Oldiseas,grim-batol,575,deathknight,unholy,12,6,6
Feugen,hyjal,575,deathknight,unholy,12,6,6
Mosscraciun,kazzak,575,deathknight,unholy,12,6,6
Havi,thunderhorn,575,deathknight,unholy,12,6,6
Zathron,blackmoore,574,deathknight,unholy,12,6,6
Xawias,ulduar,522,deathknight,unholy,14,7,7
Deadpòól,twisting-nether,521,deathknight,unholy,33,7,26
Seal,lightnings-blade,511,deathknight,unholy,26,9,17
Náthrakh,argent-dawn,480,deathknight,unholy,6,5,1
Theamine,silvermoon,480,deathknight,unholy,6,5,1
Лордпафос,blackscar,480,deathknight,unholy,6,5,1
Deathgrab,twisting-nether,480,deathknight,unholy,6,5,1
Scotty,ravencrest,480,deathknight,unholy,6,5,1
Izanagii,exodar,480,deathknight,unholy,6,5,1
Slade,blackrock,480,deathknight,unholy,12,5,7
Dêeath,madmortem,480,deathknight,unholy,12,5,7
Wttdmg,kazzak,480,deathknight,unholy,12,5,7
Morgianà,argent-dawn,480,deathknight,unholy,12,5,7
Rêxaks,dun-modr,480,deathknight,unholy,12,5,7
Mamanica,sanguino,480,deathknight,unholy,12,5,7
Kelebglin,silvermoon,480,deathknight,unholy,12,5,7
Deathkanta,antonidas,480,deathknight,unholy,12,5,7
Frostich,ragnaros,480,deathknight,unholy,12,5,7
Дядьдим,soulflayer,480,deathknight,unholy,12,5,7
Azrìal,agamaggan,480,deathknight,unholy,12,5,7
Gigacow,outland,480,deathknight,unholy,12,5,7
Deathmonsta,auchindoun,480,deathknight,unholy,12,5,7
Luciferon,zenedar,480,deathknight,unholy,12,5,7
Шэйп,fordragon,480,deathknight,unholy,12,5,7
Shewoman,stormreaver,480,deathknight,unholy,12,5,7
Kaeyz,blackmoore,480,deathknight,unholy,12,5,7
Sipsip,tarren-mill,480,deathknight,unholy,12,5,7
Cbalife,ragnaros,480,deathknight,unholy,12,5,7
Миракл,howling-fjord,480,deathknight,unholy,12,5,7
Zhugzug,ragnaros,480,deathknight,unholy,12,5,7
Rammsteïn,ravencrest,480,deathknight,unholy,15,6,9
Shining,blackrock,480,deathknight,unholy,21,6,15
Тоши,fordragon,480,deathknight,unholy,18,5,13
Xad,blackrock,480,deathknight,unholy,18,5,13
Ziuziu,twisting-nether,480,deathknight,unholy,18,5,13
Maxïmus,argent-dawn,480,deathknight,unholy,24,5,19
Skèltòn,rexxar,479,deathknight,unholy,6,5,1
Еххел,soulflayer,479,deathknight,unholy,12,5,7
Mjölnir,sanguino,479,deathknight,unholy,12,5,7
Kraken,aerie-peak,479,deathknight,unholy,18,5,13
Hacknorris,aegwynn,478,deathknight,unholy,12,5,7
Нуурргл,howling-fjord,478,deathknight,unholy,18,5,13
Mailasse,dalaran,476,deathknight,unholy,10,6,4
Kailara,draenor,463,deathknight,unholy,11,5,6
Grubbins,kul-tiras,447,deathknight,unholy,11,5,6
Táli,tarren-mill,432,deathknight,unholy,15,5,10
Ezlar,silvermoon,400,deathknight,unholy,7,5,2
Redduck,silvermoon,384,deathknight,unholy,6,4,2
Copium,hyjal,384,deathknight,unholy,6,4,2
Krisigaped,blackhand,384,deathknight,unholy,6,4,2
Yggrauthr,argent-dawn,384,deathknight,unholy,6,4,2
Servein,stormscale,384,deathknight,unholy,6,4,2
Брюшина,gordunni,384,deathknight,unholy,6,4,2
Lichkunt,stormscale,384,deathknight,unholy,6,4,2
Emphendk,twisting-nether,384,deathknight,unholy,6,4,2
Neph,sanguino,384,deathknight,unholy,6,4,2
Helmich,frostmane,384,deathknight,unholy,6,4,2
Bølvar,zuljin,384,deathknight,unholy,6,4,2
Шуршаня,blackscar,384,deathknight,unholy,6,4,2
Sprangers,ravencrest,384,deathknight,unholy,6,4,2
Stepknìght,draenor,384,deathknight,unholy,6,4,2
Cheethdoom,ragnaros,384,deathknight,unholy,6,4,2
Ecormcpz,eredar,384,deathknight,unholy,12,4,8
Pängei,frostwolf,384,deathknight,unholy,12,4,8
Szayestra,draenor,384,deathknight,unholy,12,4,8
Razdig,dun-modr,384,deathknight,unholy,12,4,8
Кромгон,soulflayer,384,deathknight,unholy,12,4,8
Dreadmind,blackrock,384,deathknight,unholy,12,4,8
Demrior,hellfire,384,deathknight,unholy,12,4,8
Сивкабурка,fordragon,384,deathknight,unholy,12,4,8
Syncros,blackrock,384,deathknight,unholy,12,4,8
Агереро,howling-fjord,384,deathknight,unholy,12,4,8
Колхозник,howling-fjord,384,deathknight,unholy,12,4,8
Zpartan,ragnaros,384,deathknight,unholy,12,4,8
Deathboost,archimonde,384,deathknight,unholy,12,4,8
Mustakäsi,ravencrest,384,deathknight,unholy,12,4,8
Протосеня,soulflayer,384,deathknight,unholy,12,4,8
Kratagon,thrall,384,deathknight,unholy,12,4,8
Sekkah,tarren-mill,384,deathknight,unholy,12,4,8
Алкеокол,soulflayer,384,deathknight,unholy,12,4,8
Mawdrym,twisting-nether,384,deathknight,unholy,12,4,8
Thoir,ahnqiraj,384,deathknight,unholy,12,4,8
Cervâ,twisting-nether,384,deathknight,unholy,12,4,8
Derimathras,stormscale,384,deathknight,unholy,12,4,8
Sugarcakedk,blackrock,384,deathknight,unholy,18,4,14
Cyliandra,silvermoon,384,deathknight,unholy,18,4,14
Форнителли,howling-fjord,384,deathknight,unholy,18,4,14
Dizin,ravencrest,384,deathknight,unholy,19,4,15
Zoombie,draenor,383,deathknight,unholy,6,4,2
Cervanteso,uldum,383,deathknight,unholy,6,4,2
Fortinateur,dalaran,383,deathknight,unholy,6,4,2
Flippmo,argent-dawn,383,deathknight,unholy,9,5,4
Aczheron,argent-dawn,383,deathknight,unholy,12,4,8
Хворной,howling-fjord,383,deathknight,unholy,12,4,8
Gothenburger,darksorrow,383,deathknight,unholy,12,4,8
Варрлнишнс,soulflayer,367,deathknight,unholy,11,4,7
Ogomegee,ravencrest,352,deathknight,unholy,10,4,6
Icyplague,ravencrest,351,deathknight,unholy,8,5,3
Millknight,norgannon,341,deathknight,unholy,15,6,9
Randomdkxd,ravencrest,304,deathknight,unholy,13,4,9
Saryn,burning-steppes,304,deathknight,unholy,13,4,9
Jénga,ghostlands,288,deathknight,unholy,6,3,3
Мионеелол,goldrinn,288,deathknight,unholy,6,3,3
Rävjakt,twisting-nether,288,deathknight,unholy,6,3,3
Darknemesis,nemesis,288,deathknight,unholy,6,3,3
Joyt,argent-dawn,288,deathknight,unholy,6,3,3
Løz,kazzak,288,deathknight,unholy,6,3,3
Fredriksend,argent-dawn,288,deathknight,unholy,6,3,3
Uvros,bloodhoof,288,deathknight,unholy,6,3,3
Израф,soulflayer,288,deathknight,unholy,6,3,3
Athanatøs,archimonde,288,deathknight,unholy,6,3,3
Feekus,deathwing,288,deathknight,unholy,6,3,3
Xisaark,blackrock,288,deathknight,unholy,6,3,3
Cyphîllyth,auchindoun,288,deathknight,unholy,6,3,3
Galgalí,blackmoore,288,deathknight,unholy,6,3,3
Тряпьё,galakrond,288,deathknight,unholy,6,3,3
Карвалан,eversong,288,deathknight,unholy,6,3,3
Mocca,aegwynn,288,deathknight,unholy,6,3,3
Heresjohny,stormrage,288,deathknight,unholy,6,3,3
Crudelias,aegwynn,288,deathknight,unholy,6,3,3
Dakyforfun,ravencrest,288,deathknight,unholy,6,3,3
Krookidk,archimonde,288,deathknight,unholy,6,3,3
Tenzøftw,archimonde,288,deathknight,unholy,6,3,3
Frostbone,ravencrest,288,deathknight,unholy,6,3,3
Clérora,argent-dawn,288,deathknight,unholy,6,3,3
Merekx,emerald-dream,288,deathknight,unholy,6,3,3
Grendul,blackmoore,288,deathknight,unholy,6,3,3
Дкшрёдингера,gordunni,288,deathknight,unholy,6,3,3
Taylorswiift,tarren-mill,288,deathknight,unholy,6,3,3
Calina,frostwolf,288,deathknight,unholy,6,3,3
Gbdk,xavius,288,deathknight,unholy,6,3,3
Taylorswiftz,tarren-mill,288,deathknight,unholy,6,3,3
Puppétmastér,kazzak,288,deathknight,unholy,6,3,3
Vip,argent-dawn,288,deathknight,unholy,6,3,3
Zfeuda,azshara,288,deathknight,unholy,6,3,3
Manego,eredar,288,deathknight,unholy,6,3,3
Zêlëph,archimonde,288,deathknight,unholy,6,3,3
Альдафьод,howling-fjord,288,deathknight,unholy,6,3,3
Wpízdu,aegwynn,288,deathknight,unholy,6,3,3
Eibon,drakthul,288,deathknight,unholy,6,3,3
Babs,sylvanas,288,deathknight,unholy,6,3,3
Krozzytwo,draenor,288,deathknight,unholy,6,3,3
Nmedk,grim-batol,288,deathknight,unholy,15,4,11
Ashgôrath,defias-brotherhood,288,deathknight,unholy,12,3,9
Эвессом,goldrinn,288,deathknight,unholy,12,3,9
Cleverb,silvermoon,288,deathknight,unholy,12,3,9
Axram,ravencrest,288,deathknight,unholy,12,3,9
Drraugrinn,tarren-mill,288,deathknight,unholy,12,3,9
Dagë,twisting-nether,288,deathknight,unholy,12,3,9
Lair,shendralar,288,deathknight,unholy,12,3,9
Tyranuse,kazzak,288,deathknight,unholy,12,3,9
Chains,sanguino,288,deathknight,unholy,12,3,9
Морталес,azuregos,288,deathknight,unholy,12,3,9
Helixsdk,outland,288,deathknight,unholy,12,3,9
Plaguebones,ravencrest,288,deathknight,unholy,12,3,9
Valanaari,argent-dawn,288,deathknight,unholy,12,3,9
Juicyjayho,stormscale,288,deathknight,unholy,12,3,9
Каскадёрка,howling-fjord,287,deathknight,unholy,12,3,9
Kirkster,terokkar,287,deathknight,unholy,12,3,9
Abyad,dalaran,285,deathknight,unholy,12,3,9
Narrua,die-aldor,255,deathknight,unholy,11,3,8
Hateem,sylvanas,255,deathknight,unholy,11,3,8
Difestia,silvermoon,239,deathknight,unholy,5,3,2
Даркслэш,howling-fjord,234,deathknight,unholy,17,5,12
Charai,blackhand,234,deathknight,unholy,14,4,10
Nexium,outland,192,deathknight,unholy,4,3,1
Alti,blackmoore,192,deathknight,unholy,4,3,1
Шинратенсеи,howling-fjord,192,deathknight,unholy,6,2,4
Jixcore,draenor,192,deathknight,unholy,6,2,4
Буризан,blackscar,192,deathknight,unholy,6,2,4
Bubbledeath,tarren-mill,192,deathknight,unholy,6,2,4
Haeydez,draenor,192,deathknight,unholy,6,2,4
Engelinä,ysondre,192,deathknight,unholy,6,2,4
Kromas,silvermoon,192,deathknight,unholy,6,2,4
Valkion,nemesis,192,deathknight,unholy,6,2,4
Njor,twisting-nether,192,deathknight,unholy,6,2,4
Eigrin,argent-dawn,192,deathknight,unholy,6,2,4
Iziqroi,archimonde,192,deathknight,unholy,6,2,4
Zixcommixx,hyjal,192,deathknight,unholy,6,2,4
Feldøøm,nemesis,192,deathknight,unholy,6,2,4
Norux,alonsus,192,deathknight,unholy,6,2,4
Mustapha,kazzak,192,deathknight,unholy,6,2,4
Bigblackgrip,hyjal,192,deathknight,unholy,6,2,4
Unholyysteel,silvermoon,192,deathknight,unholy,6,2,4
Гнилец,soulflayer,192,deathknight,unholy,6,2,4
Letudra,outland,192,deathknight,unholy,6,2,4
Urukaye,silvermoon,192,deathknight,unholy,6,2,4
Hoggster,kazzak,192,deathknight,unholy,6,2,4
Scorbion,kilrogg,192,deathknight,unholy,6,2,4
Amyntasz,twisting-nether,192,deathknight,unholy,6,2,4
Clipe,sanguino,192,deathknight,unholy,6,2,4
Postura,kazzak,192,deathknight,unholy,6,2,4
Scareanger,argent-dawn,192,deathknight,unholy,6,2,4
Doubledead,the-maelstrom,192,deathknight,unholy,6,2,4
Аэрит,howling-fjord,192,deathknight,unholy,6,2,4
Lithics,blades-edge,192,deathknight,unholy,6,2,4
Homelándér,blackmoore,192,deathknight,unholy,6,2,4
Worldwiynd,ravencrest,192,deathknight,unholy,6,2,4
Elendren,blackrock,192,deathknight,unholy,6,2,4
Nihilistyx,blackrock,192,deathknight,unholy,6,2,4
Glower,burning-blade,192,deathknight,unholy,6,2,4
Kacpèr,burning-legion,192,deathknight,unholy,6,2,4
Barnalord,dentarg,192,deathknight,unholy,6,2,4
Thryndiel,ravencrest,192,deathknight,unholy,6,2,4
Fdkgotbuffed,tarren-mill,192,deathknight,unholy,6,2,4
Bårêlýgød,blackmoore,192,deathknight,unholy,6,2,4
Dk,earthen-ring,192,deathknight,unholy,6,2,4
Alameda,nathrezim,192,deathknight,unholy,6,2,4
Jodure,silvermoon,192,deathknight,unholy,6,2,4
Nirna,argent-dawn,192,deathknight,unholy,12,2,10
Vîrus,kazzak,192,deathknight,unholy,12,2,10
Гадиния,soulflayer,191,deathknight,unholy,4,3,1
Àragørn,blackrock,191,deathknight,unholy,6,2,4
Джагат,gordunni,191,deathknight,unholy,12,2,10
Ândi,alleria,190,deathknight,unholy,12,2,10
Civilredevil,ravencrest,159,deathknight,unholy,5,2,3
Calhoun,teldrassil,159,deathknight,unholy,5,2,3
Dødsmanna,twisting-nether,144,deathknight,unholy,9,2,7
Cayliadk,tarren-mill,138,deathknight,unholy,14,4,10
Sämäël,outland,137,deathknight,unholy,8,3,5
Auto,hyjal,128,deathknight,unholy,4,2,2
Flinsen,blackmoore,106,deathknight,unholy,12,3,9
Inmau,sanguino,96,deathknight,unholy,3,2,1
Jarhèad,grim-batol,96,deathknight,unholy,10,3,7
Peiie,ravencrest,96,deathknight,unholy,6,1,5
Spøøk,defias-brotherhood,96,deathknight,unholy,6,1,5
Rongos,norgannon,96,deathknight,unholy,6,1,5
Джеттар,howling-fjord,96,deathknight,unholy,6,1,5
Stely,alonsus,96,deathknight,unholy,6,1,5
Yagashi,stormscale,96,deathknight,unholy,6,1,5
Cameltôe,frostwolf,96,deathknight,unholy,6,1,5
Коилкоилкоил,blackscar,96,deathknight,unholy,6,1,5
Кернесса,blackscar,96,deathknight,unholy,6,1,5
Dumbclass,wildhammer,96,deathknight,unholy,6,1,5
Antexdk,drakthul,96,deathknight,unholy,6,1,5
Инфлюминс,soulflayer,96,deathknight,unholy,6,1,5
Madsgrip,tarren-mill,96,deathknight,unholy,6,1,5
Verssatus,archimonde,96,deathknight,unholy,6,1,5
Dextèr,stormreaver,96,deathknight,unholy,6,1,5
Bytedk,aggra-português,96,deathknight,unholy,6,1,5
Муунрок,howling-fjord,96,deathknight,unholy,6,1,5
Unholygunnds,ravencrest,96,deathknight,unholy,6,1,5
Fixmybones,frostmane,96,deathknight,unholy,6,1,5
Eívór,garrosh,96,deathknight,unholy,6,1,5
Sulf,burning-legion,96,deathknight,unholy,6,1,5
Madseason,burning-legion,96,deathknight,unholy,6,1,5
Wavemaker,kazzak,96,deathknight,unholy,6,1,5
Gdubet,kazzak,96,deathknight,unholy,6,1,5
Lieven,tarren-mill,96,deathknight,unholy,6,1,5
Skrati,das-syndikat,96,deathknight,unholy,6,1,5
Sìrmooalot,twisting-nether,96,deathknight,unholy,6,1,5
Orrengo,blackrock,96,deathknight,unholy,6,1,5
Grimgôr,kazzak,96,deathknight,unholy,6,1,5
Mámmôn,malygos,96,deathknight,unholy,7,1,6
Buzknight,twisting-nether,96,deathknight,unholy,12,1,11
Brasith,outland,96,deathknight,unholy,12,1,11
Bestiaccia,nemesis,95,deathknight,unholy,6,1,5
Necromedes,kazzak,64,deathknight,unholy,4,1,3
Шарабум,howling-fjord,16,deathknight,unholy,7,1,6
Никнейм,gordunni,2123,deathknight,frost,102,55,47
Garrinchá,stormscale,2040,deathknight,frost,60,36,24
Anotherdkx,ravencrest,1997,deathknight,frost,60,36,24
Имерсий,gordunni,1929,deathknight,frost,42,26,16
Igetmount,draenor,1895,deathknight,frost,36,20,16
Viuff,kazzak,1894,deathknight,frost,42,23,19
Murbastic,draenor,1866,deathknight,frost,197,96,101
Fdkgotbuffed,tarren-mill,1865,deathknight,frost,48,25,23
Jeanice,blackhand,1833,deathknight,frost,42,23,19
Duriel,stormscale,1739,deathknight,frost,66,39,27
Дарргг,ashenvale,1722,deathknight,frost,96,47,49
Frostlux,archimonde,1719,deathknight,frost,419,204,215
Gorobijec,drakthul,1684,deathknight,frost,96,47,49
Mikagoddess,argent-dawn,1668,deathknight,frost,42,22,20
Винкис,gordunni,1666,deathknight,frost,54,34,20
Rêxaks,dun-modr,1630,deathknight,frost,42,19,23
Geunieve,ysondre,1621,deathknight,frost,60,23,37
Espatula,ravencrest,1619,deathknight,frost,48,23,25
Banishabomb,ragnaros,1615,deathknight,frost,78,39,39
Vidofnir,argent-dawn,1611,deathknight,frost,56,31,25
Xolaani,outland,1596,deathknight,frost,36,20,16
Deucàlyqt,nemesis,1589,deathknight,frost,64,28,36
Arxelas,sylvanas,1580,deathknight,frost,166,86,80
Kailara,draenor,1556,deathknight,frost,48,26,22
Raylenx,uldaman,1543,deathknight,frost,63,31,32
Deucalyqt,nemesis,1538,deathknight,frost,66,31,35
Diogenisis,arthas,1530,deathknight,frost,36,16,20
Dripgrip,ravencrest,1529,deathknight,frost,77,36,41
Chakko,ravencrest,1503,deathknight,frost,36,16,20
Brawlerbabe,stormscale,1502,deathknight,frost,126,56,70
Regniér,frostwolf,1501,deathknight,frost,128,60,68
Leónid,kazzak,1486,deathknight,frost,33,17,16
Hatriox,outland,1454,deathknight,frost,85,46,39
Furleyc,argent-dawn,1433,deathknight,frost,48,29,19
Dktroll,blackmoore,1428,deathknight,frost,151,67,84
Stevensdk,darkspear,1427,deathknight,frost,36,17,19
Кулькулегал,ashenvale,1424,deathknight,frost,24,15,9
Fallenjaina,kazzak,1420,deathknight,frost,113,53,60
Асаала,soulflayer,1419,deathknight,frost,27,19,8
Маклайкнайт,gordunni,1417,deathknight,frost,78,36,42
Skorice,dalaran,1415,deathknight,frost,42,17,25
Düksito,dun-modr,1392,deathknight,frost,63,32,31
Флаттершайдк,booty-bay,1383,deathknight,frost,37,16,21
Фростмаран,soulflayer,1373,deathknight,frost,96,45,51
Ðeucaly,nemesis,1357,deathknight,frost,66,30,36
Mocca,aegwynn,1357,deathknight,frost,52,21,31
Selena,blackmoore,1335,deathknight,frost,24,14,10
Comehere,norgannon,1321,deathknight,frost,30,19,11
Døuffy,hyjal,1319,deathknight,frost,48,24,24
Spøøk,defias-brotherhood,1316,deathknight,frost,84,38,46
Ihatelife,frostwolf,1304,deathknight,frost,42,19,23
Superere,hyjal,1298,deathknight,frost,108,58,50
Âlîce,culte-de-la-rive-noire,1297,deathknight,frost,54,26,28
Forgive,blackrock,1285,deathknight,frost,28,15,13
Devilknight,dentarg,1282,deathknight,frost,60,31,29
Кроуфрост,gordunni,1245,deathknight,frost,42,19,23
Düks,dun-modr,1238,deathknight,frost,87,39,48
Arthasuk,dun-modr,1234,deathknight,frost,74,40,34
Twardobaba,burning-legion,1231,deathknight,frost,50,24,26
Satyriasis,twisting-nether,1224,deathknight,frost,28,16,12
Frostmommy,argent-dawn,1214,deathknight,frost,41,16,25
Êbøla,sanguino,1199,deathknight,frost,60,25,35
Deucalygodx,nemesis,1181,deathknight,frost,42,13,29
Krasny,hyjal,1179,deathknight,frost,78,42,36
Abnormus,tarren-mill,1179,deathknight,frost,72,38,34
Cayliadk,tarren-mill,1174,deathknight,frost,167,76,91
Aceléss,drakthul,1150,deathknight,frost,18,12,6
Tenzøftw,archimonde,1148,deathknight,frost,24,12,12
Neitoperho,frostmane,1148,deathknight,frost,30,12,18
Nôsferatú,amanthul,1145,deathknight,frost,78,39,39
Morgouse,kazzak,1145,deathknight,frost,47,17,30
Darkchas,silvermoon,1144,deathknight,frost,24,12,12
Геннош,howling-fjord,1143,deathknight,frost,24,12,12
Zerodude,silvermoon,1142,deathknight,frost,60,30,30
Azrador,frostwolf,1140,deathknight,frost,54,21,33
Mattesøs,drakthul,1130,deathknight,frost,36,13,23
Dkruffos,draenor,1114,deathknight,frost,60,24,36
Woddey,blackrock,1073,deathknight,frost,48,22,26
Вафельнаяфея,blackscar,1073,deathknight,frost,43,17,26
Polimeh,draenor,1060,deathknight,frost,60,32,28
Unaxito,sanguino,1052,deathknight,frost,24,11,13
Keronaterol,blackhand,1044,deathknight,frost,18,11,7
Zioan,jaedenar,1022,deathknight,frost,32,16,16
Alastoras,nemesis,1011,deathknight,frost,24,11,13
Quantumshift,ravencrest,1004,deathknight,frost,17,11,6
Ivik,the-maelstrom,1001,deathknight,frost,32,19,13
Zandruq,twisting-nether,983,deathknight,frost,22,11,11
Dakyforfun,ravencrest,960,deathknight,frost,12,10,2
Flúrrý,kazzak,960,deathknight,frost,24,10,14
Клиссанг,razuvious,959,deathknight,frost,18,10,8
Ubiystvo,kazzak,955,deathknight,frost,18,10,8
Collinná,aegwynn,939,deathknight,frost,30,10,20
Mauryr,drakthul,913,deathknight,frost,30,10,20
Dursall,thrall,912,deathknight,frost,119,56,63
Касуляпвнз,gordunni,902,deathknight,frost,21,10,11
Нифер,deathguard,894,deathknight,frost,20,10,10
Карвалан,eversong,884,deathknight,frost,36,18,18
Peachvajz,turalyon,882,deathknight,frost,54,27,27
Kixx,bloodfeather,873,deathknight,frost,53,13,40
Fareast,nerathor,865,deathknight,frost,78,36,42
Mellion,ragnaros,864,deathknight,frost,12,9,3
ßambøøzle,draenor,864,deathknight,frost,18,9,9
Løz,kazzak,864,deathknight,frost,18,9,9
Zektal,thrall,864,deathknight,frost,18,9,9
Nellion,kazzak,864,deathknight,frost,24,9,15
Murky,kazzak,863,deathknight,frost,18,9,9
Asphyxias,alleria,863,deathknight,frost,18,9,9
Wrathlich,tyrande,863,deathknight,frost,18,9,9
Nymfo,tirion,862,deathknight,frost,12,9,3
Neorteriona,argent-dawn,860,deathknight,frost,18,9,9
Vîrus,kazzak,859,deathknight,frost,18,9,9
Kãra,ysondre,859,deathknight,frost,18,9,9
Belía,blackmoore,854,deathknight,frost,24,9,15
Khelthalas,teldrassil,841,deathknight,frost,13,10,3
Guillemet,turalyon,830,deathknight,frost,16,10,6
Elbaqwan,the-shatar,827,deathknight,frost,30,13,17
Craftmaker,eonar,816,deathknight,frost,44,19,25
Afadk,kazzak,802,deathknight,frost,48,18,30
Ниффер,deathguard,800,deathknight,frost,22,9,13
Iaccidens,stormscale,791,deathknight,frost,28,9,19
Elendren,blackrock,768,deathknight,frost,12,8,4
Селес,ashenvale,768,deathknight,frost,12,8,4
Sonnedeath,tarren-mill,768,deathknight,frost,16,9,7
Blácked,draenor,767,deathknight,frost,12,8,4
Kooklynn,aggra-português,767,deathknight,frost,12,8,4
Zaouros,silvermoon,767,deathknight,frost,18,8,10
Jollíe,tarren-mill,767,deathknight,frost,24,8,16
Арнорос,lich-king,764,deathknight,frost,12,8,4
Orcborg,zuljin,764,deathknight,frost,18,8,10
Gageth,shadowsong,763,deathknight,frost,33,9,24
Fullbusterr,hyjal,761,deathknight,frost,12,8,4
Zerdon,frostmane,756,deathknight,frost,12,8,4
Lichfils,chogall,745,deathknight,frost,27,8,19
Odaijini,archimonde,719,deathknight,frost,17,8,9
Madseason,burning-legion,672,deathknight,frost,12,7,5
Veneera,emeriss,672,deathknight,frost,12,7,5
Малтель,howling-fjord,672,deathknight,frost,12,7,5
Gorefiend,kazzak,672,deathknight,frost,12,7,5
Halohuntress,outland,671,deathknight,frost,18,7,11
Меланндрис,gordunni,669,deathknight,frost,15,8,7
Moosbirne,blackhand,669,deathknight,frost,18,7,11
Gravehammer,sylvanas,663,deathknight,frost,12,7,5
Aczheron,argent-dawn,660,deathknight,frost,24,7,17
Планус,booty-bay,576,deathknight,frost,12,6,6
Orangatang,dalaran,576,deathknight,frost,12,6,6
Narali,argent-dawn,576,deathknight,frost,12,6,6
Rubbann,ravencrest,576,deathknight,frost,12,6,6
Parayysite,eredar,576,deathknight,frost,18,6,12
Tugarinzmey,tarren-mill,575,deathknight,frost,18,6,12
Izanagii,exodar,572,deathknight,frost,12,6,6
Tyranuse,kazzak,527,deathknight,frost,17,6,11
Exodiuss,dalaran,510,deathknight,frost,16,6,10
Deckbulle,blackhand,480,deathknight,frost,6,5,1
Thebangman,ravencrest,480,deathknight,frost,9,6,3
Gringly,tarren-mill,480,deathknight,frost,12,5,7
Feelmyfuri,mazrigos,480,deathknight,frost,12,5,7
Руин,blackscar,480,deathknight,frost,12,5,7
Картафилиус,soulflayer,480,deathknight,frost,12,5,7
Worlviuz,argent-dawn,480,deathknight,frost,12,5,7
Ûñhølýðéåthj,tarren-mill,480,deathknight,frost,12,5,7
Runepride,argent-dawn,480,deathknight,frost,12,5,7
Deathknight,spinebreaker,480,deathknight,frost,12,5,7
Sindó,blackrock,479,deathknight,frost,12,5,7
Ostridz,grim-batol,479,deathknight,frost,12,5,7
Xtream,blackmoore,479,deathknight,frost,12,5,7
Deadpòól,twisting-nether,479,deathknight,frost,18,5,13
Copium,hyjal,477,deathknight,frost,12,5,7
Fishtruction,tarren-mill,476,deathknight,frost,12,5,7
Kejpo,drakthul,473,deathknight,frost,12,5,7
Predatormkdd,ravencrest,429,deathknight,frost,11,5,6
Oldiseas,grim-batol,384,deathknight,frost,6,4,2
Enzy,drakthul,384,deathknight,frost,6,4,2
Namzera,draenor,384,deathknight,frost,6,4,2
Indrette,archimonde,384,deathknight,frost,6,4,2
Reann,argent-dawn,384,deathknight,frost,6,4,2
Gozuryu,kazzak,384,deathknight,frost,6,4,2
Doodcraft,tarren-mill,384,deathknight,frost,12,4,8
Buldog,laughing-skull,384,deathknight,frost,12,4,8
Sipsip,tarren-mill,384,deathknight,frost,12,4,8
Джайвана,soulflayer,384,deathknight,frost,12,4,8
Uthn,outland,384,deathknight,frost,12,4,8
Anasûrimbor,tarren-mill,384,deathknight,frost,12,4,8
Pestilerous,draenor,384,deathknight,frost,12,4,8
Æew,kazzak,384,deathknight,frost,12,4,8
Prokszii,turalyon,384,deathknight,frost,12,4,8
Кокосоус,gordunni,384,deathknight,frost,17,4,13
Фламмивир,gordunni,383,deathknight,frost,6,4,2
Beherith,sunstrider,383,deathknight,frost,6,4,2
Tÿnak,der-mithrilorden,383,deathknight,frost,9,4,5
Eckodk,aggra-português,383,deathknight,frost,12,4,8
Kivo,marécage-de-zangar,383,deathknight,frost,12,4,8
Breeze,xavius,383,deathknight,frost,12,4,8
Бранс,gordunni,383,deathknight,frost,12,4,8
Гадиния,soulflayer,383,deathknight,frost,12,4,8
Belâam,archimonde,383,deathknight,frost,24,4,20
Дневнои,howling-fjord,382,deathknight,frost,12,4,8
Vaanor,draenor,288,deathknight,frost,6,3,3
Kèén,kazzak,288,deathknight,frost,6,3,3
Nazgül,drakthul,288,deathknight,frost,6,3,3
Jjayker,kazzak,288,deathknight,frost,6,3,3
Wintersons,tarren-mill,288,deathknight,frost,6,3,3
Шэйп,fordragon,288,deathknight,frost,6,3,3
Whippy,ravencrest,288,deathknight,frost,6,3,3
Persefal,nemesis,288,deathknight,frost,6,3,3
Moko,defias-brotherhood,288,deathknight,frost,6,3,3
Endlesspain,burning-legion,288,deathknight,frost,6,3,3
Dexterlul,blackmoore,288,deathknight,frost,6,3,3
Apraxia,ravencrest,288,deathknight,frost,6,3,3
Ogomegee,ravencrest,288,deathknight,frost,6,3,3
Merdenhall,argent-dawn,288,deathknight,frost,6,3,3
Modelo,twisting-nether,288,deathknight,frost,6,3,3
Necrozy,aggra-português,288,deathknight,frost,6,3,3
Джеттар,howling-fjord,288,deathknight,frost,6,3,3
Cptneverdie,stormscale,288,deathknight,frost,6,3,3
Cyphîllyth,auchindoun,288,deathknight,frost,6,3,3
Leahthebad,sylvanas,288,deathknight,frost,6,3,3
Xanthic,ravencrest,288,deathknight,frost,6,3,3
Keridíin,twisting-nether,288,deathknight,frost,6,3,3
Raihor,outland,288,deathknight,frost,8,3,5
Thilior,silvermoon,288,deathknight,frost,12,3,9
Eynoway,blackmoore,288,deathknight,frost,12,3,9
Zoree,draenor,288,deathknight,frost,12,3,9
Thedk,voljin,288,deathknight,frost,12,3,9
Тенелла,gordunni,288,deathknight,frost,12,3,9
Prekliatylad,burning-blade,288,deathknight,frost,12,3,9
Zuggandk,tarren-mill,288,deathknight,frost,12,3,9
Dzengiskhan,draenor,288,deathknight,frost,18,3,15
Dekagramcz,drakthul,287,deathknight,frost,6,3,3
Antîlâ,antonidas,286,deathknight,frost,6,3,3
Venthyrgwa,kazzak,284,deathknight,frost,7,5,2
Фэйлстрайк,azuregos,223,deathknight,frost,8,3,5
Chifuyu,azjolnerub,192,deathknight,frost,6,2,4
Deathcardos,die-aldor,192,deathknight,frost,6,2,4
Gotendk,draenor,192,deathknight,frost,6,2,4
Klingenblut,blackrock,192,deathknight,frost,6,2,4
Ilovegouàng,khaz-modan,192,deathknight,frost,6,2,4
Doubledead,the-maelstrom,192,deathknight,frost,6,2,4
Adreak,defias-brotherhood,192,deathknight,frost,6,2,4
Mennal,the-maelstrom,192,deathknight,frost,6,2,4
Køley,draenor,192,deathknight,frost,6,2,4
Grumpykathi,blackmoore,192,deathknight,frost,6,2,4
Doozz,draenor,192,deathknight,frost,6,2,4
Toffy,anetheron,192,deathknight,frost,6,2,4
Seasonfive,arathor,192,deathknight,frost,6,2,4
Pandahapci,ragnaros,192,deathknight,frost,6,2,4
Merdraut,alakir,192,deathknight,frost,6,2,4
Kane,destromath,192,deathknight,frost,6,2,4
Ullefuz,silvermoon,192,deathknight,frost,6,2,4
Leonis,arthas,192,deathknight,frost,6,2,4
Necrossis,stormscale,192,deathknight,frost,6,2,4
Royalcrown,stormscale,192,deathknight,frost,6,2,4
Dreadmind,blackrock,192,deathknight,frost,6,2,4
Vaffe,tarren-mill,192,deathknight,frost,6,2,4
Ratge,hyjal,192,deathknight,frost,6,2,4
Notstacy,dragonblight,192,deathknight,frost,6,2,4
Tyró,ravencrest,192,deathknight,frost,6,2,4
Abadonn,archimonde,192,deathknight,frost,6,2,4
Hordak,stormscale,192,deathknight,frost,6,2,4
Ilaenu,ravencrest,192,deathknight,frost,6,2,4
Narrua,die-aldor,192,deathknight,frost,12,2,10
Deadlygnome,silvermoon,192,deathknight,frost,12,2,10
Scorbion,kilrogg,191,deathknight,frost,7,2,5
Nîghtmáre,ravencrest,159,deathknight,frost,5,2,3
Tzunâ,blackmoore,138,deathknight,frost,21,3,18
Thínkk,ysondre,96,deathknight,frost,6,1,5
Буризан,blackscar,96,deathknight,frost,6,1,5
Tofin,dunemaul,96,deathknight,frost,6,1,5
Syncros,blackrock,96,deathknight,frost,6,1,5
Housemeyster,antonidas,96,deathknight,frost,6,1,5
Discochoppa,blackmoore,96,deathknight,frost,6,1,5
Thryndiel,ravencrest,96,deathknight,frost,6,1,5
Бахлыщ,soulflayer,96,deathknight,frost,6,1,5
Kaeyz,blackmoore,96,deathknight,frost,6,1,5
Dïkcite,archimonde,96,deathknight,frost,6,1,5
Menacê,ravencrest,96,deathknight,frost,6,1,5
Urukaye,silvermoon,96,deathknight,frost,6,1,5
Ezlar,silvermoon,96,deathknight,frost,6,1,5
Cleverb,silvermoon,96,deathknight,frost,6,1,5
Gotbaked,outland,96,deathknight,frost,6,1,5
Arrèsted,aegwynn,96,deathknight,frost,6,1,5
Feddk,stormscale,96,deathknight,frost,6,1,5
Slimez,magtheridon,96,deathknight,frost,6,1,5
Hydross,archimonde,96,deathknight,frost,6,1,5
Gigadk,ragnaros,96,deathknight,frost,6,1,5
Veçh,turalyon,96,deathknight,frost,6,1,5
Arthursq,stormscale,95,deathknight,frost,6,1,5
Assølid,arathor,42,deathknight,frost,11,2,9
Elswavé,kazzak,2262,demonhunter,havoc,102,60,42
Norgàn,die-aldor,2178,demonhunter,havoc,81,44,37
Itsdampbaby,kazzak,2170,demonhunter,havoc,91,48,43
Ðesz,sanguino,2153,demonhunter,havoc,95,52,43
Enysia,twisting-nether,2127,demonhunter,havoc,122,62,60
Heatx,ysondre,2124,demonhunter,havoc,144,83,61
Ohseri,defias-brotherhood,2116,demonhunter,havoc,138,72,66
Melan,sanguino,2116,demonhunter,havoc,108,54,54
Zslebaans,dun-modr,2107,demonhunter,havoc,170,85,85
Лфгхиро,soulflayer,2101,demonhunter,havoc,65,37,28
Razzagall,elune,2101,demonhunter,havoc,54,30,24
Boostbydh,archimonde,2101,demonhunter,havoc,219,115,104
Veon,ravencrest,2075,demonhunter,havoc,269,133,136
Évø,silvermoon,2064,demonhunter,havoc,90,44,46
Aiean,ravencrest,2062,demonhunter,havoc,108,57,51
Cuddlypeanut,argent-dawn,2051,demonhunter,havoc,106,52,54
Battlebruh,ghostlands,2032,demonhunter,havoc,83,39,44
Læsy,antonidas,2026,demonhunter,havoc,107,56,51
Glìmpsêgøðx,twisting-nether,2013,demonhunter,havoc,60,32,28
Íllìðåñgøðx,twisting-nether,2012,demonhunter,havoc,70,37,33
Betterevoker,outland,2000,demonhunter,havoc,102,59,43
Wibez,twisting-nether,1986,demonhunter,havoc,60,39,21
Badtime,malganis,1979,demonhunter,havoc,84,45,39
Norgan,die-aldor,1976,demonhunter,havoc,60,33,27
Zuklio,ysondre,1973,demonhunter,havoc,83,39,44
Anabbele,kazzak,1968,demonhunter,havoc,96,52,44
Paschli,tarren-mill,1963,demonhunter,havoc,114,60,54
Illislan,darksorrow,1955,demonhunter,havoc,209,109,100
Onof,hyjal,1954,demonhunter,havoc,84,42,42
Bxdh,outland,1952,demonhunter,havoc,75,36,39
Мортрэд,gordunni,1950,demonhunter,havoc,66,39,27
Sofun,stormscale,1950,demonhunter,havoc,98,50,48
Pipeandy,kazzak,1946,demonhunter,havoc,95,52,43
Battlebruuh,ghostlands,1935,demonhunter,havoc,66,27,39
Ïîï,archimonde,1934,demonhunter,havoc,79,37,42
Scubaman,tarren-mill,1932,demonhunter,havoc,54,31,23
Oldforwow,outland,1928,demonhunter,havoc,138,75,63
Demonalpha,stormscale,1925,demonhunter,havoc,49,27,22
Iryut,onyxia,1918,demonhunter,havoc,72,39,33
Cydh,auchindoun,1917,demonhunter,havoc,90,45,45
Brawndow,draenor,1914,demonhunter,havoc,93,48,45
Damatche,outland,1910,demonhunter,havoc,136,68,68
Ïfï,archimonde,1909,demonhunter,havoc,107,59,48
Boxssabanned,archimonde,1903,demonhunter,havoc,89,44,45
Gilletteabdi,argent-dawn,1902,demonhunter,havoc,91,44,47
Gíftig,ravencrest,1900,demonhunter,havoc,53,29,24
Истребитель,blackscar,1892,demonhunter,havoc,186,106,80
Çøððøøððøøðð,blackmoore,1883,demonhunter,havoc,84,45,39
Walkmyshoes,twisting-nether,1877,demonhunter,havoc,102,51,51
Tyssra,argent-dawn,1870,demonhunter,havoc,96,42,54
Donkeydh,tarren-mill,1868,demonhunter,havoc,54,36,18
Màuul,ravencrest,1866,demonhunter,havoc,195,97,98
Bojestvena,twisting-nether,1859,demonhunter,havoc,72,36,36
Brolafsen,ravencrest,1859,demonhunter,havoc,66,32,34
Apfelbaum,die-aldor,1857,demonhunter,havoc,60,40,20
Possomhd,kazzak,1856,demonhunter,havoc,114,70,44
Carboen,tarren-mill,1856,demonhunter,havoc,96,52,44
Fiveyearques,sylvanas,1856,demonhunter,havoc,102,49,53
Kebabidin,kazzak,1856,demonhunter,havoc,66,30,36
Mädchen,blackhand,1854,demonhunter,havoc,48,23,25
Dasein,tarren-mill,1852,demonhunter,havoc,54,29,25
Elipireli,doomhammer,1846,demonhunter,havoc,42,20,22
Хэллшок,eversong,1843,demonhunter,havoc,48,28,20
Клопобойка,gordunni,1842,demonhunter,havoc,69,37,32
Bloodwatcher,twisting-nether,1842,demonhunter,havoc,54,27,27
Eyasluna,twisting-nether,1842,demonhunter,havoc,60,29,31
Fotmdehatwo,blackrock,1837,demonhunter,havoc,61,32,29
Nøbodyx,tarren-mill,1837,demonhunter,havoc,66,33,33
Xarôth,eredar,1837,demonhunter,havoc,66,32,34
Ðoksy,archimonde,1835,demonhunter,havoc,60,31,29
Zkrdh,kazzak,1835,demonhunter,havoc,65,33,32
Mongoose,drakthul,1832,demonhunter,havoc,131,68,63
Zeroques,frostmane,1831,demonhunter,havoc,66,33,33
Сасун,galakrond,1831,demonhunter,havoc,69,32,37
Supay,rexxar,1830,demonhunter,havoc,58,31,27
Badtimes,malganis,1829,demonhunter,havoc,237,118,119
Yamehd,stormreaver,1827,demonhunter,havoc,42,26,16
Chxpo,twisting-nether,1826,demonhunter,havoc,89,47,42
Сибу,soulflayer,1825,demonhunter,havoc,48,21,27
Mürh,nordrassil,1824,demonhunter,havoc,54,25,29
Дантеллиан,gordunni,1823,demonhunter,havoc,135,77,58
Khétí,tarren-mill,1821,demonhunter,havoc,101,53,48
Элизар,howling-fjord,1821,demonhunter,havoc,120,61,59
Dadøw,dun-modr,1820,demonhunter,havoc,66,31,35
Malignantx,ragnaros,1819,demonhunter,havoc,54,30,24
Razex,kazzak,1819,demonhunter,havoc,111,59,52
Krm,dun-modr,1818,demonhunter,havoc,38,23,15
Amnésysx,ysondre,1818,demonhunter,havoc,72,35,37
Luwayne,blackmoore,1818,demonhunter,havoc,47,21,26
Dreamslash,tarren-mill,1817,demonhunter,havoc,52,29,23
Airelidari,tyrande,1817,demonhunter,havoc,149,76,73
Flyingwhale,terokkar,1815,demonhunter,havoc,33,21,12
Perna,ghostlands,1814,demonhunter,havoc,74,34,40
Unseenshadow,ragnaros,1813,demonhunter,havoc,60,25,35
Tórstenstøck,ravencrest,1811,demonhunter,havoc,47,31,16
Elsynn,dalaran,1811,demonhunter,havoc,66,35,31
Djratatouill,kazzak,1810,demonhunter,havoc,42,27,15
Nèvér,silvermoon,1809,demonhunter,havoc,60,30,30
Хменчик,soulflayer,1809,demonhunter,havoc,97,47,50
Yúki,blackrock,1809,demonhunter,havoc,48,23,25
Ææçëñ,ravencrest,1808,demonhunter,havoc,36,23,13
Mandariâ,blackmoore,1808,demonhunter,havoc,60,32,28
Çrymemøre,dun-modr,1808,demonhunter,havoc,60,32,28
Jumpmeister,ragnaros,1806,demonhunter,havoc,42,25,17
Gøat,nemesis,1804,demonhunter,havoc,96,55,41
Cláw,ravencrest,1804,demonhunter,havoc,90,45,45
Дэн,blackscar,1802,demonhunter,havoc,48,28,20
Batik,blackmoore,1802,demonhunter,havoc,136,69,67
Barbarinjo,silvermoon,1800,demonhunter,havoc,36,22,14
Миелион,gordunni,1800,demonhunter,havoc,65,29,36
Kindablind,aggramar,1799,demonhunter,havoc,83,40,43
Icekissl,hyjal,1797,demonhunter,havoc,40,20,20
Lassudan,stormreaver,1796,demonhunter,havoc,47,23,24
Finwe,outland,1795,demonhunter,havoc,51,31,20
Mazöku,ravencrest,1787,demonhunter,havoc,72,41,31
Maytherel,blackhand,1787,demonhunter,havoc,102,46,56
Stazó,drakthul,1785,demonhunter,havoc,97,53,44
Vexanic,chamber-of-aspects,1783,demonhunter,havoc,87,45,42
Майотх,gordunni,1783,demonhunter,havoc,113,55,58
Spheria,outland,1780,demonhunter,havoc,123,63,60
Hunee,kazzak,1778,demonhunter,havoc,60,38,22
Funkiller,stormscale,1774,demonhunter,havoc,58,30,28
Felom,garona,1771,demonhunter,havoc,54,32,22
Автокикер,soulflayer,1771,demonhunter,havoc,54,31,23
Pulsefuzzy,burning-legion,1770,demonhunter,havoc,48,28,20
Stickidan,malganis,1770,demonhunter,havoc,60,30,30
Lelaniae,blackhand,1759,demonhunter,havoc,48,20,28
Lagseven,ravencrest,1757,demonhunter,havoc,46,25,21
Mojothejojo,ravencrest,1752,demonhunter,havoc,56,31,25
Primolover,outland,1751,demonhunter,havoc,66,33,33
Billyhassan,kazzak,1742,demonhunter,havoc,48,31,17
Demonmatheo,stormscale,1742,demonhunter,havoc,48,27,21
Rvnx,archimonde,1741,demonhunter,havoc,170,93,77
Zerinitý,outland,1737,demonhunter,havoc,54,29,25
Камуи,gordunni,1737,demonhunter,havoc,60,28,32
Лизарин,gordunni,1735,demonhunter,havoc,47,21,26
Cuirnoir,ravencrest,1734,demonhunter,havoc,36,20,16
Skywålker,stormscale,1733,demonhunter,havoc,57,27,30
Wyna,aggra-português,1732,demonhunter,havoc,65,32,33
Donipwnz,blackrock,1729,demonhunter,havoc,83,35,48
Trashcarlitô,eredar,1726,demonhunter,havoc,56,30,26
Alundil,ravencrest,1725,demonhunter,havoc,60,32,28
Kinstak,sanguino,1725,demonhunter,havoc,54,27,27
Balberith,twisting-nether,1722,demonhunter,havoc,81,44,37
Phesxdh,sylvanas,1721,demonhunter,havoc,98,62,36
Wibergdh,kazzak,1718,demonhunter,havoc,24,18,6
Врежимеэтти,soulflayer,1716,demonhunter,havoc,46,24,22
Eurobeat,dun-modr,1714,demonhunter,havoc,72,42,30
Maevê,frostmourne,1712,demonhunter,havoc,37,19,18
Írony,draenor,1711,demonhunter,havoc,38,20,18
Ewlyna,stormscale,1710,demonhunter,havoc,42,21,21
Satånist,outland,1710,demonhunter,havoc,66,32,34
Mavorz,blackhand,1709,demonhunter,havoc,30,18,12
Depure,blackrock,1707,demonhunter,havoc,48,24,24
Demonichanta,azjolnerub,1706,demonhunter,havoc,178,93,85
Evil,uldum,1704,demonhunter,havoc,101,57,44
Smoothbraiin,ravencrest,1702,demonhunter,havoc,42,23,19
Kïallz,hyjal,1702,demonhunter,havoc,219,117,102
Авилолз,gordunni,1702,demonhunter,havoc,48,25,23
Enfy,twisting-nether,1701,demonhunter,havoc,71,35,36
Indral,argent-dawn,1699,demonhunter,havoc,48,28,20
Merelini,twisting-nether,1699,demonhunter,havoc,34,19,15
Haldin,kazzak,1699,demonhunter,havoc,59,30,29
Аркантт,soulflayer,1699,demonhunter,havoc,122,52,70
Belákor,twisting-nether,1698,demonhunter,havoc,187,95,92
Fruchtzwerg,tarren-mill,1697,demonhunter,havoc,54,31,23
Нэйтиси,soulflayer,1697,demonhunter,havoc,53,26,27
Tanjero,stormscale,1696,demonhunter,havoc,53,36,17
Киттигоплей,soulflayer,1694,demonhunter,havoc,66,34,32
Yousaindh,blackrock,1694,demonhunter,havoc,66,29,37
Simshady,stormscale,1692,demonhunter,havoc,48,30,18
Çôæ,twisting-nether,1691,demonhunter,havoc,99,48,51
Âspen,archimonde,1690,demonhunter,havoc,66,42,24
Zhadrom,ragnaros,1690,demonhunter,havoc,54,24,30
Jawohunt,rexxar,1690,demonhunter,havoc,90,36,54
Lanadelbae,teldrassil,1689,demonhunter,havoc,103,54,49
Dxæn,archimonde,1687,demonhunter,havoc,41,24,17
Uldren,defias-brotherhood,1687,demonhunter,havoc,170,82,88
Fazero,silvermoon,1686,demonhunter,havoc,60,30,30
Aofaye,aegwynn,1686,demonhunter,havoc,59,24,35
Demonkata,twisting-nether,1684,demonhunter,havoc,80,46,34
Susanoø,eredar,1684,demonhunter,havoc,177,96,81
Slutkitten,ravencrest,1684,demonhunter,havoc,48,21,27
Shanaplow,hyjal,1684,demonhunter,havoc,60,26,34
Soizis,drakthul,1682,demonhunter,havoc,42,23,19
Emurid,les-sentinelles,1682,demonhunter,havoc,54,26,28
Guësswho,twisting-nether,1680,demonhunter,havoc,41,20,21
Aethinos,sylvanas,1678,demonhunter,havoc,42,27,15
Ботология,gordunni,1675,demonhunter,havoc,60,30,30
Weez,kilrogg,1675,demonhunter,havoc,78,36,42
Ranked,drakthul,1675,demonhunter,havoc,63,24,39
Ryänåir,ravencrest,1674,demonhunter,havoc,60,36,24
Mentalìst,blackmoore,1674,demonhunter,havoc,63,37,26
Шахдан,howling-fjord,1673,demonhunter,havoc,76,43,33
Xekaul,tarren-mill,1673,demonhunter,havoc,175,84,91
Nuxzhell,tarren-mill,1672,demonhunter,havoc,168,82,86
Felwinter,ravencrest,1670,demonhunter,havoc,84,40,44
Imslapping,draenor,1669,demonhunter,havoc,66,37,29
Shadyblady,nemesis,1664,demonhunter,havoc,70,34,36
Nyalah,eredar,1662,demonhunter,havoc,48,24,24
Nolitara,exodar,1661,demonhunter,havoc,60,33,27
Ðisgraze,argent-dawn,1660,demonhunter,havoc,60,35,25
Shaihulud,sanguino,1658,demonhunter,havoc,163,91,72
Кейтпрнстарс,howling-fjord,1657,demonhunter,havoc,100,53,47
Netherim,twisting-nether,1657,demonhunter,havoc,92,38,54
Sailen,blackmoore,1656,demonhunter,havoc,48,21,27
Faufilé,garona,1655,demonhunter,havoc,42,19,23
Quazr,outland,1653,demonhunter,havoc,175,102,73
Camtoe,ravencrest,1653,demonhunter,havoc,101,57,44
Thorair,ravenholdt,1653,demonhunter,havoc,60,31,29
Felski,outland,1653,demonhunter,havoc,49,23,26
Cheetòs,blackmoore,1651,demonhunter,havoc,30,20,10
Xalgalor,silvermoon,1650,demonhunter,havoc,48,29,19
Velysaría,guldan,1650,demonhunter,havoc,46,25,21
Gigasloth,outland,1646,demonhunter,havoc,30,23,7
Íllìðåñgøðx,antonidas,1646,demonhunter,havoc,108,52,56
Rylqt,blackmoore,1644,demonhunter,havoc,67,33,34
Èfiie,culte-de-la-rive-noire,1644,demonhunter,havoc,41,19,22
Azaleia,archimonde,1643,demonhunter,havoc,130,68,62
Shtahuntna,tarren-mill,1639,demonhunter,havoc,126,74,52
Boozlike,tarren-mill,1637,demonhunter,havoc,72,41,31
Picpouc,archimonde,1637,demonhunter,havoc,54,24,30
Rezer,stormscale,1637,demonhunter,havoc,60,26,34
Nisirae,argent-dawn,1635,demonhunter,havoc,105,62,43
Riptos,blackhand,1635,demonhunter,havoc,46,22,24
ßerdína,tarren-mill,1634,demonhunter,havoc,75,38,37
Temac,magtheridon,1630,demonhunter,havoc,42,22,20
Molntuss,ravencrest,1629,demonhunter,havoc,80,36,44
Reckqt,eredar,1628,demonhunter,havoc,30,17,13
Nøvillain,blackrock,1627,demonhunter,havoc,96,55,41
Юзлескласс,gordunni,1627,demonhunter,havoc,36,20,16
Felen,zuljin,1627,demonhunter,havoc,118,54,64
Xetalar,burning-legion,1626,demonhunter,havoc,144,84,60
Omegapump,ravencrest,1626,demonhunter,havoc,36,19,17
Unkqt,dalaran,1625,demonhunter,havoc,36,20,16
Jumboo,tarren-mill,1625,demonhunter,havoc,53,29,24
Lindzor,frostmane,1624,demonhunter,havoc,47,32,15
Drmanaburn,ravencrest,1624,demonhunter,havoc,30,17,13
Dominik,the-maelstrom,1623,demonhunter,havoc,126,73,53
Mêgumi,kirin-tor,1623,demonhunter,havoc,63,34,29
Koomaliha,outland,1623,demonhunter,havoc,85,42,43
Demobob,tarren-mill,1623,demonhunter,havoc,42,20,22
Jolyh,nemesis,1622,demonhunter,havoc,36,24,12
Sweetpety,tarren-mill,1622,demonhunter,havoc,63,37,26
Demonmancer,ravencrest,1622,demonhunter,havoc,120,64,56
Ðemøñsåy,blackrock,1622,demonhunter,havoc,53,24,29
Пибзянка,howling-fjord,1616,demonhunter,havoc,36,20,16
Sepdy,draenor,1615,demonhunter,havoc,42,23,19
Itadora,antonidas,1615,demonhunter,havoc,36,17,19
Mønkeyx,kazzak,1614,demonhunter,havoc,24,17,7
Azraethx,ravencrest,1614,demonhunter,havoc,48,29,19
Lilfly,twisting-nether,1611,demonhunter,havoc,30,17,13
Anerana,malganis,1611,demonhunter,havoc,42,17,25
Демонблэйдс,gordunni,1610,demonhunter,havoc,30,17,13
Gündüzgezen,silvermoon,1610,demonhunter,havoc,59,30,29
Jeannedäsh,archimonde,1610,demonhunter,havoc,36,17,19
Ted,frostwolf,1610,demonhunter,havoc,36,17,19
Турбосвинья,gordunni,1608,demonhunter,havoc,48,26,22
Przemson,mazrigos,1607,demonhunter,havoc,42,22,20
Râindra,twisting-nether,1607,demonhunter,havoc,168,87,81
Майкелелекек,gordunni,1606,demonhunter,havoc,36,17,19
Havocer,burning-legion,1605,demonhunter,havoc,66,36,30
Despèradø,archimonde,1605,demonhunter,havoc,72,39,33
Èstefany,stormscale,1604,demonhunter,havoc,90,49,41
Zevsa,ravencrest,1604,demonhunter,havoc,48,25,23
Zayláh,ravencrest,1604,demonhunter,havoc,87,42,45
Nixzon,thrall,1604,demonhunter,havoc,78,31,47
Фэсс,soulflayer,1603,demonhunter,havoc,60,32,28
Thingawoop,tarren-mill,1601,demonhunter,havoc,44,22,22
Крикадский,howling-fjord,1598,demonhunter,havoc,84,50,34
Великаямыша,blackscar,1598,demonhunter,havoc,44,26,18
Рейз,howling-fjord,1597,demonhunter,havoc,138,67,71
Speedførce,antonidas,1596,demonhunter,havoc,54,21,33
Demoncyka,twisting-nether,1595,demonhunter,havoc,54,17,37
Misli,stormscale,1594,demonhunter,havoc,42,27,15
Nillrogthedh,stormscale,1594,demonhunter,havoc,96,61,35
Sebyk,doomhammer,1591,demonhunter,havoc,54,32,22
Трукейт,gordunni,1582,demonhunter,havoc,56,33,23
Wojtall,silvermoon,1581,demonhunter,havoc,176,89,87
Neralith,ravencrest,1579,demonhunter,havoc,60,28,32
Геммула,howling-fjord,1575,demonhunter,havoc,144,70,74
Ignasei,archimonde,1572,demonhunter,havoc,53,22,31
Roaf,twisting-nether,1568,demonhunter,havoc,81,40,41
Dhqoo,blackrock,1565,demonhunter,havoc,42,18,24
Zireáel,stormscale,1562,demonhunter,havoc,32,18,14
Lghdtv,ravencrest,1560,demonhunter,havoc,72,36,36
Incanator,tarren-mill,1556,demonhunter,havoc,60,30,30
Zintu,draenor,1554,demonhunter,havoc,108,53,55
Akkita,ravencrest,1552,demonhunter,havoc,84,43,41
Dhzor,twisting-nether,1552,demonhunter,havoc,64,32,32
Däshgødx,stormscale,1543,demonhunter,havoc,54,31,23
Zitx,ravencrest,1543,demonhunter,havoc,65,36,29
Pibzya,ravencrest,1542,demonhunter,havoc,39,19,20
Sidekiq,silvermoon,1540,demonhunter,havoc,41,22,19
Чанпэн,soulflayer,1539,demonhunter,havoc,128,68,60
Dyamo,sylvanas,1538,demonhunter,havoc,243,121,122
Winxclub,ravencrest,1534,demonhunter,havoc,53,32,21
Ambudh,kazzak,1533,demonhunter,havoc,30,16,14
Crappyftw,ravencrest,1533,demonhunter,havoc,167,88,79
Neverdance,ravencrest,1533,demonhunter,havoc,36,16,20
Глефавочко,gordunni,1533,demonhunter,havoc,36,16,20
Neunelfturbo,ravencrest,1532,demonhunter,havoc,18,16,2
Мужичок,soulflayer,1532,demonhunter,havoc,72,39,33
Shylea,ravencrest,1531,demonhunter,havoc,90,48,42
Smydi,blackmoore,1529,demonhunter,havoc,23,22,1
Zedxx,kazzak,1529,demonhunter,havoc,24,16,8
Eyecandy,scarshield-legion,1529,demonhunter,havoc,30,16,14
Eréthrus,ravencrest,1529,demonhunter,havoc,30,16,14
Iphanaa,frostmane,1529,demonhunter,havoc,40,20,20
Kostiq,kazzak,1527,demonhunter,havoc,30,16,14
Alcóhon,ravencrest,1526,demonhunter,havoc,35,17,18
Glímpse,ravencrest,1524,demonhunter,havoc,60,29,31
Garoteromani,draenor,1523,demonhunter,havoc,72,41,31
Snitchezz,blackmoore,1523,demonhunter,havoc,102,55,47
Уполномочен,howling-fjord,1523,demonhunter,havoc,30,16,14
Yeedhlol,blackmoore,1523,demonhunter,havoc,30,16,14
Vênedri,eredar,1522,demonhunter,havoc,36,22,14
Nyalaah,eredar,1522,demonhunter,havoc,30,16,14
Sekørm,ragnaros,1522,demonhunter,havoc,30,16,14
Bestro,tarren-mill,1519,demonhunter,havoc,30,16,14
Akaria,blackrock,1518,demonhunter,havoc,58,39,19
Guccibaby,silvermoon,1517,demonhunter,havoc,54,27,27
Ferihokurva,outland,1515,demonhunter,havoc,30,16,14
Azzïnoth,sargeras,1515,demonhunter,havoc,36,17,19
Сосочков,soulflayer,1515,demonhunter,havoc,94,41,53
Telarris,twisting-nether,1513,demonhunter,havoc,165,94,71
Slaanaesh,kazzak,1511,demonhunter,havoc,45,17,28
Draxie,turalyon,1509,demonhunter,havoc,28,17,11
Blacklidan,blackrock,1509,demonhunter,havoc,40,17,23
Edh,dalaran,1507,demonhunter,havoc,45,18,27
Solarae,silvermoon,1506,demonhunter,havoc,52,27,25
Tenawees,blackmoore,1505,demonhunter,havoc,36,22,14
Цэрри,soulflayer,1501,demonhunter,havoc,60,30,30
Thehûnt,outland,1500,demonhunter,havoc,66,38,28
Nuitrayer,hyjal,1497,demonhunter,havoc,50,33,17
Hauntedseoul,grim-batol,1496,demonhunter,havoc,90,54,36
Dinastye,archimonde,1493,demonhunter,havoc,53,27,26
Dibo,blackmoore,1490,demonhunter,havoc,53,27,26
Échô,tarren-mill,1489,demonhunter,havoc,40,18,22
Jesana,argent-dawn,1488,demonhunter,havoc,84,45,39
Kolrex,ragnaros,1488,demonhunter,havoc,41,20,21
Fullsënd,ragnaros,1486,demonhunter,havoc,90,38,52
Pvpabuser,ravencrest,1483,demonhunter,havoc,47,27,20
Oonn,outland,1482,demonhunter,havoc,45,21,24
Brisingamen,outland,1481,demonhunter,havoc,36,19,17
Сложныйдх,howling-fjord,1480,demonhunter,havoc,30,19,11
Oggidanbuu,tarren-mill,1479,demonhunter,havoc,36,17,19
Tkr,zuljin,1475,demonhunter,havoc,60,35,25
Frevee,outland,1475,demonhunter,havoc,95,54,41
Tamtheone,silvermoon,1475,demonhunter,havoc,72,34,38
Баттлрэп,soulflayer,1473,demonhunter,havoc,74,36,38
Ziltush,archimonde,1472,demonhunter,havoc,98,50,48
Vorbis,twisting-nether,1472,demonhunter,havoc,42,17,25
Treehunter,ravencrest,1470,demonhunter,havoc,30,16,14
Myztiko,hellscream,1470,demonhunter,havoc,140,72,68
Xenca,ravencrest,1469,demonhunter,havoc,29,19,10
Stellarvore,nemesis,1468,demonhunter,havoc,54,25,29
Цезарий,gordunni,1465,demonhunter,havoc,84,40,44
Фумиан,soulflayer,1465,demonhunter,havoc,52,22,30
Rxor,eredar,1464,demonhunter,havoc,42,16,26
Рэгес,howling-fjord,1463,demonhunter,havoc,30,16,14
Lasaka,stormscale,1460,demonhunter,havoc,30,19,11
Împd,ravencrest,1456,demonhunter,havoc,90,43,47
Коньх,goldrinn,1456,demonhunter,havoc,48,21,27
Flaybalbooll,ragnaros,1454,demonhunter,havoc,84,45,39
Cantseêyou,blackmoore,1453,demonhunter,havoc,54,29,25
Ноубрейндыха,gordunni,1453,demonhunter,havoc,60,28,32
Мужна,grom,1452,demonhunter,havoc,34,19,15
Enthia,antonidas,1452,demonhunter,havoc,59,29,30
Duffin,doomhammer,1451,demonhunter,havoc,120,57,63
Ülquiorrä,kazzak,1450,demonhunter,havoc,53,34,19
Аянамирейко,blackscar,1450,demonhunter,havoc,60,36,24
Кирсена,gordunni,1450,demonhunter,havoc,35,17,18
Choclatballs,stormscale,1450,demonhunter,havoc,60,28,32
Shadoss,ravencrest,1447,demonhunter,havoc,54,22,32
Покахонта,soulflayer,1446,demonhunter,havoc,88,47,41
Kékw,stormscale,1445,demonhunter,havoc,42,26,16
Дашажмимету,blackscar,1439,demonhunter,havoc,32,16,16
Mephîsto,sylvanas,1439,demonhunter,havoc,42,20,22
Chotzbrocke,blackhand,1438,demonhunter,havoc,24,15,9
Blizdliksk,outland,1437,demonhunter,havoc,42,22,20
Sturmimon,arthas,1436,demonhunter,havoc,36,15,21
Malakbel,nemesis,1435,demonhunter,havoc,97,47,50
Dhgoddess,kazzak,1434,demonhunter,havoc,30,15,15
Ifeeldirty,draenor,1431,demonhunter,havoc,31,16,15
Métakagoule,ysondre,1431,demonhunter,havoc,81,38,43
Hialdoo,sylvanas,1426,demonhunter,havoc,36,15,21
Méruème,hyjal,1424,demonhunter,havoc,31,16,15
Йактон,soulflayer,1424,demonhunter,havoc,36,15,21
Culywurly,silvermoon,1423,demonhunter,havoc,60,28,32
Enhtailo,draenor,1421,demonhunter,havoc,24,15,9
Ilidrax,hyjal,1421,demonhunter,havoc,30,15,15
Kayzel,argent-dawn,1420,demonhunter,havoc,108,49,59
Doomcake,emeriss,1419,demonhunter,havoc,24,15,9
Эллий,blackscar,1419,demonhunter,havoc,36,15,21
Yugsiturath,drakthul,1418,demonhunter,havoc,42,20,22
Adapterinput,auchindoun,1416,demonhunter,havoc,62,36,26
Toddsnuggles,thrall,1414,demonhunter,havoc,36,23,13
Valarauk,ravencrest,1411,demonhunter,havoc,105,59,46
Illiada,spinebreaker,1411,demonhunter,havoc,30,15,15
Baball,kazzak,1410,demonhunter,havoc,57,31,26
Albunico,draenor,1410,demonhunter,havoc,123,64,59
Ibeem,dentarg,1408,demonhunter,havoc,45,31,14
Бельторо,soulflayer,1407,demonhunter,havoc,69,33,36
Arnokia,kazzak,1407,demonhunter,havoc,78,34,44
Balsza,burning-legion,1406,demonhunter,havoc,30,17,13
Luzifer,ambossar,1406,demonhunter,havoc,129,68,61
Garretos,senjin,1403,demonhunter,havoc,31,22,9
Vaynahi,grim-batol,1401,demonhunter,havoc,72,36,36
Mareen,pozzo-delleternità,1400,demonhunter,havoc,42,21,21
Деструкцыя,howling-fjord,1399,demonhunter,havoc,45,24,21
Древиал,gordunni,1399,demonhunter,havoc,30,16,14
Malabala,grim-batol,1398,demonhunter,havoc,23,15,8
Razziyel,ragnaros,1396,demonhunter,havoc,41,21,20
Дартарин,gordunni,1395,demonhunter,havoc,62,34,28
Immune,aegwynn,1394,demonhunter,havoc,36,17,19
Beerseewälk,ragnaros,1392,demonhunter,havoc,64,30,34
Thugrøse,blackrock,1385,demonhunter,havoc,90,45,45
Tayo,dun-modr,1385,demonhunter,havoc,66,31,35
Hatemrankone,outland,1383,demonhunter,havoc,51,23,28
Cptxo,tarren-mill,1382,demonhunter,havoc,35,16,19
Øbsessiøn,kazzak,1379,demonhunter,havoc,54,24,30
Imlegalblind,ragnaros,1378,demonhunter,havoc,73,31,42
Keanujeeves,dentarg,1376,demonhunter,havoc,60,33,27
Itheos,kazzak,1374,demonhunter,havoc,119,59,60
Adalya,stormrage,1373,demonhunter,havoc,82,35,47
Anstict,kazzak,1371,demonhunter,havoc,48,22,26
Шмальнуть,gordunni,1371,demonhunter,havoc,44,18,26
Khalestya,shendralar,1370,demonhunter,havoc,60,27,33
Súrinox,blackrock,1367,demonhunter,havoc,83,48,35
Seyran,silvermoon,1367,demonhunter,havoc,30,15,15
Afuwarrior,doomhammer,1366,demonhunter,havoc,45,23,22
Iaml,ravencrest,1366,demonhunter,havoc,49,24,25
Monkeypox,twisting-nether,1366,demonhunter,havoc,46,19,27
Olddemon,ravencrest,1363,demonhunter,havoc,35,24,11
Imsickleavme,draenor,1363,demonhunter,havoc,64,32,32
Varedisa,kazzak,1363,demonhunter,havoc,41,19,22
Nezruslfive,dun-modr,1361,demonhunter,havoc,36,18,18
Phudi,tarren-mill,1361,demonhunter,havoc,83,36,47
Alithy,kazzak,1357,demonhunter,havoc,89,49,40
Wrakdh,archimonde,1355,demonhunter,havoc,56,34,22
Агрочика,borean-tundra,1349,demonhunter,havoc,36,16,20
Pówèr,ravencrest,1345,demonhunter,havoc,48,25,23
Thalamis,kazzak,1345,demonhunter,havoc,75,33,42
Darrkdemon,kazzak,1344,demonhunter,havoc,137,62,75
Ларэгар,azuregos,1343,demonhunter,havoc,70,28,42
Icelucard,argent-dawn,1342,demonhunter,havoc,47,23,24
Ragnirok,deathwing,1341,demonhunter,havoc,78,37,41
Grimjow,arthas,1341,demonhunter,havoc,30,14,16
Illídana,azjolnerub,1340,demonhunter,havoc,62,32,30
Nepthýs,blackhand,1338,demonhunter,havoc,33,15,18
Faytundh,kult-der-verdammten,1336,demonhunter,havoc,30,14,16
Hawoc,chamber-of-aspects,1334,demonhunter,havoc,42,26,16
Soca,ysondre,1334,demonhunter,havoc,60,27,33
Оригамушка,gordunni,1332,demonhunter,havoc,30,14,16
Orochimaruu,kargath,1332,demonhunter,havoc,63,22,41
Irenzy,twisting-nether,1331,demonhunter,havoc,30,14,16
Kïng,frostmane,1330,demonhunter,havoc,18,14,4
Checakore,argent-dawn,1329,demonhunter,havoc,66,34,32
Ðraudræm,ravencrest,1329,demonhunter,havoc,83,39,44
Øctågøñ,blackrock,1328,demonhunter,havoc,46,18,28
Kiirtach,dun-modr,1326,demonhunter,havoc,21,15,6
Louloulou,aegwynn,1326,demonhunter,havoc,93,52,41
Theaisbae,twisting-nether,1325,demonhunter,havoc,30,14,16
Lozakum,draenor,1323,demonhunter,havoc,60,30,30
Felleaf,ragnaros,1322,demonhunter,havoc,34,15,19
Геннитиро,deathguard,1321,demonhunter,havoc,24,14,10
Kâtsulol,ysondre,1321,demonhunter,havoc,30,14,16
Zumei,stormreaver,1319,demonhunter,havoc,24,14,10
Иллиферрат,blackscar,1317,demonhunter,havoc,47,21,26
Ilovelilith,zuljin,1316,demonhunter,havoc,51,23,28
Yvrig,eredar,1313,demonhunter,havoc,24,14,10
Obey,exodar,1312,demonhunter,havoc,47,22,25
Notcrashy,eredar,1311,demonhunter,havoc,23,17,6
Délyria,blackhand,1311,demonhunter,havoc,54,32,22
Jayhan,chamber-of-aspects,1311,demonhunter,havoc,68,37,31
Bestdemon,tarren-mill,1311,demonhunter,havoc,39,20,19
Кельдарк,soulflayer,1309,demonhunter,havoc,106,44,62
Мицлейн,gordunni,1309,demonhunter,havoc,57,21,36
Demonk,nemesis,1308,demonhunter,havoc,30,19,11
Sinninse,blackmoore,1308,demonhunter,havoc,30,18,12
Slowcuzclick,stormscale,1307,demonhunter,havoc,85,44,41
Экселия,howling-fjord,1306,demonhunter,havoc,24,14,10
Breezzdh,twisting-nether,1305,demonhunter,havoc,29,14,15
Каралас,soulflayer,1301,demonhunter,havoc,36,21,15
Isila,alakir,1301,demonhunter,havoc,48,17,31
Chapzi,ragnaros,1300,demonhunter,havoc,42,23,19
Luckertwo,tarren-mill,1300,demonhunter,havoc,98,49,49
Cheethless,ragnaros,1300,demonhunter,havoc,36,16,20
Сумърак,grom,1292,demonhunter,havoc,61,27,34
Тарапынька,gordunni,1291,demonhunter,havoc,76,42,34
Coltender,drakthul,1290,demonhunter,havoc,61,28,33
Bläckdëvïl,uldum,1285,demonhunter,havoc,40,25,15
Momochi,silvermoon,1285,demonhunter,havoc,24,14,10
Сильверган,soulflayer,1284,demonhunter,havoc,120,62,58
Billidan,eredar,1282,demonhunter,havoc,54,25,29
Даблкорк,soulflayer,1281,demonhunter,havoc,53,31,22
Ozeey,draenor,1280,demonhunter,havoc,29,14,15
Symbul,blackrock,1279,demonhunter,havoc,42,19,23
Máédhros,ravencrest,1278,demonhunter,havoc,28,14,14
Pleskdh,malganis,1272,demonhunter,havoc,48,20,28
Shizá,burning-legion,1270,demonhunter,havoc,44,22,22
Philona,die-aldor,1269,demonhunter,havoc,87,42,45
Даргсайд,gordunni,1269,demonhunter,havoc,36,16,20
Sabe,ravencrest,1267,demonhunter,havoc,23,14,9
Ämi,blackmoore,1267,demonhunter,havoc,76,31,45
Nanocsika,twisting-nether,1260,demonhunter,havoc,69,35,34
Téthis,uldaman,1257,demonhunter,havoc,54,26,28
Schahmiran,kargath,1252,demonhunter,havoc,30,14,16
Jahannam,ysondre,1251,demonhunter,havoc,48,22,26
Norac,silvermoon,1248,demonhunter,havoc,41,16,25
Kanabiz,outland,1247,demonhunter,havoc,42,16,26
Bokajr,ragnaros,1246,demonhunter,havoc,18,13,5
Rehagen,ysondre,1246,demonhunter,havoc,30,13,17
Burchulica,sylvanas,1245,demonhunter,havoc,24,13,11
Мэйзиквин,howling-fjord,1245,demonhunter,havoc,24,13,11
Найтбладия,gordunni,1243,demonhunter,havoc,24,13,11
Anubias,ravencrest,1243,demonhunter,havoc,36,13,23
Thorno,argent-dawn,1243,demonhunter,havoc,36,13,23
Cptncucumber,blackmoore,1242,demonhunter,havoc,24,13,11
Khray,archimonde,1242,demonhunter,havoc,24,13,11
Xenits,kazzak,1242,demonhunter,havoc,30,13,17
Rabæ,blackhand,1242,demonhunter,havoc,30,13,17
Obitum,burning-legion,1241,demonhunter,havoc,66,32,34
Зарах,gordunni,1241,demonhunter,havoc,30,13,17
Kezumå,tarren-mill,1241,demonhunter,havoc,30,13,17
Easywaay,kazzak,1236,demonhunter,havoc,18,13,5
Gïzmó,tarren-mill,1236,demonhunter,havoc,30,13,17
Claere,blackhand,1234,demonhunter,havoc,75,41,34
Хингарский,deathguard,1234,demonhunter,havoc,24,13,11
Bøøgý,silvermoon,1234,demonhunter,havoc,42,19,23
Thëos,argent-dawn,1233,demonhunter,havoc,48,22,26
Titanslayyer,azjolnerub,1233,demonhunter,havoc,30,13,17
Nvampire,draenor,1230,demonhunter,havoc,18,13,5
Эндимэн,soulflayer,1230,demonhunter,havoc,38,23,15
Nasghul,drakthul,1229,demonhunter,havoc,24,13,11
Djaris,ghostlands,1228,demonhunter,havoc,18,13,5
Alury,blackrock,1228,demonhunter,havoc,24,13,11
Munja,hyjal,1227,demonhunter,havoc,140,74,66
Даудаев,gordunni,1225,demonhunter,havoc,36,19,17
Hirbs,silvermoon,1222,demonhunter,havoc,61,25,36
Ashrena,ysondre,1218,demonhunter,havoc,18,13,5
Betråyêr,draenor,1213,demonhunter,havoc,38,15,23
Thegamesucks,ravencrest,1209,demonhunter,havoc,192,93,99
Bessus,aggra-português,1207,demonhunter,havoc,48,24,24
Davidastt,drakthul,1207,demonhunter,havoc,35,13,22
Maltok,ysondre,1206,demonhunter,havoc,43,21,22
Tharysan,sanguino,1203,demonhunter,havoc,18,13,5
Tokoloshë,ragnaros,1200,demonhunter,havoc,30,16,14
Blisdon,argent-dawn,1197,demonhunter,havoc,24,15,9
Самфор,soulflayer,1197,demonhunter,havoc,66,33,33
Vozol,stormscale,1195,demonhunter,havoc,30,20,10
Lùcîfer,hellfire,1185,demonhunter,havoc,48,21,27
Wréckful,ravencrest,1185,demonhunter,havoc,42,15,27
Люцифэйль,gordunni,1184,demonhunter,havoc,32,15,17
Demonligos,draenor,1183,demonhunter,havoc,72,36,36
Zakaji,blackmoore,1177,demonhunter,havoc,26,13,13
Fikyx,draenor,1177,demonhunter,havoc,32,14,18
Schonevrouw,aszune,1176,demonhunter,havoc,36,20,16
Scarebearz,outland,1171,demonhunter,havoc,54,31,23
Kiriall,blackmoore,1166,demonhunter,havoc,72,33,39
Oxydh,ravencrest,1165,demonhunter,havoc,28,13,15
Дитяхаоса,howling-fjord,1165,demonhunter,havoc,42,15,27
Dämokröte,ambossar,1164,demonhunter,havoc,24,14,10
Lagordin,aggramar,1161,demonhunter,havoc,18,14,4
Athoribos,silvermoon,1160,demonhunter,havoc,60,32,28
Itsukix,stormscale,1153,demonhunter,havoc,36,21,15
Brainlessdmg,ragnaros,1151,demonhunter,havoc,18,12,6
Oniramqt,aegwynn,1151,demonhunter,havoc,24,12,12
Hagana,tirion,1151,demonhunter,havoc,24,12,12
Мишаметапамп,grom,1151,demonhunter,havoc,24,12,12
Hopéless,aggra-português,1151,demonhunter,havoc,24,12,12
Testôdh,blackrock,1151,demonhunter,havoc,30,12,18
Illidrax,outland,1151,demonhunter,havoc,30,12,18
Chïbrøne,archimonde,1151,demonhunter,havoc,36,12,24
Onlyw,ravencrest,1150,demonhunter,havoc,17,13,4
Seleverkauft,antonidas,1149,demonhunter,havoc,18,12,6
Bigboychaos,twisting-nether,1149,demonhunter,havoc,36,19,17
Jórúnn,twisting-nether,1149,demonhunter,havoc,24,12,12
Ардатйякши,borean-tundra,1149,demonhunter,havoc,29,12,17
Daemonax,ragnaros,1149,demonhunter,havoc,30,12,18
Schøck,blackhand,1148,demonhunter,havoc,18,12,6
Brodor,alakir,1148,demonhunter,havoc,24,12,12
Trashclass,draenor,1148,demonhunter,havoc,28,13,15
Sturmovik,ravencrest,1147,demonhunter,havoc,18,12,6
Åelita,burning-legion,1147,demonhunter,havoc,18,12,6
Cynmatic,kargath,1147,demonhunter,havoc,18,12,6
Guanzho,silvermoon,1147,demonhunter,havoc,69,26,43
Exceltor,sanguino,1147,demonhunter,havoc,36,12,24
Zahadius,silvermoon,1146,demonhunter,havoc,18,12,6
Razrsolo,tarren-mill,1145,demonhunter,havoc,24,12,12
Emerelle,die-aldor,1145,demonhunter,havoc,30,12,18
Satanmanna,twisting-nether,1145,demonhunter,havoc,30,12,18
Thkingragnar,sanguino,1144,demonhunter,havoc,18,12,6
Джигурдинец,gordunni,1144,demonhunter,havoc,30,17,13
Убийца,soulflayer,1143,demonhunter,havoc,18,12,6
Anandria,blutkessel,1140,demonhunter,havoc,71,42,29
Poutanaola,twisting-nether,1140,demonhunter,havoc,24,12,12
Dreggath,doomhammer,1139,demonhunter,havoc,53,26,27
Hornyhexy,stormscale,1139,demonhunter,havoc,30,12,18
Gullveîg,archimonde,1136,demonhunter,havoc,24,12,12
Тушино,lich-king,1135,demonhunter,havoc,18,12,6
Øutsider,blackmoore,1131,demonhunter,havoc,42,15,27
Егордемон,soulflayer,1129,demonhunter,havoc,34,15,19
Gurthalak,alakir,1129,demonhunter,havoc,35,14,21
Бичерезх,soulflayer,1127,demonhunter,havoc,24,12,12
Tursal,dun-morogh,1125,demonhunter,havoc,27,14,13
Zyasea,blackmoore,1125,demonhunter,havoc,36,12,24
Sarissa,dun-modr,1120,demonhunter,havoc,26,14,12
Sharhan,sylvanas,1118,demonhunter,havoc,42,16,26
Sua,outland,1116,demonhunter,havoc,24,12,12
Zulthealbino,tarren-mill,1110,demonhunter,havoc,20,13,7
Zengor,twilights-hammer,1109,demonhunter,havoc,28,14,14
Kaizzy,twisting-nether,1107,demonhunter,havoc,78,35,43
Lögan,uldum,1103,demonhunter,havoc,30,14,16
Hellboii,kilrogg,1097,demonhunter,havoc,24,14,10
Twistyy,drakthul,1097,demonhunter,havoc,72,41,31
Hawek,madmortem,1096,demonhunter,havoc,30,16,14
Demonronin,the-maelstrom,1095,demonhunter,havoc,20,12,8
Аллилания,fordragon,1092,demonhunter,havoc,44,29,15
Kebiz,ragnaros,1090,demonhunter,havoc,23,12,11
Embruixada,sanguino,1087,demonhunter,havoc,20,13,7
Antrixa,ravencrest,1087,demonhunter,havoc,23,12,11
Âkazza,archimonde,1086,demonhunter,havoc,26,12,14
Venøøm,eldrethalas,1084,demonhunter,havoc,90,40,50
Мотек,howling-fjord,1084,demonhunter,havoc,54,23,31
Azazelkw,ragnaros,1082,demonhunter,havoc,42,22,20
Дэрзлорд,fordragon,1082,demonhunter,havoc,23,12,11
Stonebanker,turalyon,1079,demonhunter,havoc,23,14,9
Allalina,draenor,1079,demonhunter,havoc,24,13,11
Byah,kazzak,1076,demonhunter,havoc,49,20,29
Ascanius,nemesis,1072,demonhunter,havoc,42,24,18
Айвэнгос,thermaplugg,1072,demonhunter,havoc,45,25,20
Koiskdh,tarren-mill,1071,demonhunter,havoc,22,13,9
Milkeyes,ravencrest,1071,demonhunter,havoc,60,31,29
Bicskas,ragnaros,1070,demonhunter,havoc,32,13,19
Kladius,skullcrusher,1067,demonhunter,havoc,21,12,9
Mojois,ravenholdt,1063,demonhunter,havoc,27,15,12
Gabquist,argent-dawn,1063,demonhunter,havoc,47,25,22
Dantert,zuljin,1056,demonhunter,havoc,18,11,7
Ayyo,agamaggan,1056,demonhunter,havoc,24,11,13
Mittÿ,tarren-mill,1056,demonhunter,havoc,24,11,13
Véin,stormscale,1056,demonhunter,havoc,30,11,19
Dhlee,ravencrest,1055,demonhunter,havoc,18,11,7
Tdh,sanguino,1055,demonhunter,havoc,18,11,7
Cappaowx,ravencrest,1054,demonhunter,havoc,18,11,7
Përry,archimonde,1054,demonhunter,havoc,24,11,13
Cayssaelle,argent-dawn,1053,demonhunter,havoc,18,11,7
Teoma,hyjal,1053,demonhunter,havoc,64,32,32
Dragontwist,sylvanas,1053,demonhunter,havoc,24,11,13
Thedudex,dunemaul,1053,demonhunter,havoc,30,11,19
Crylater,twisting-nether,1052,demonhunter,havoc,18,11,7
Squan,blackmoore,1050,demonhunter,havoc,20,12,8
Aphulucky,kazzak,1050,demonhunter,havoc,30,11,19
Shadowkick,archimonde,1047,demonhunter,havoc,156,76,80
Flowen,stormreaver,1047,demonhunter,havoc,30,11,19
Byakugaan,drakthul,1045,demonhunter,havoc,18,11,7
Trekxx,ragnaros,1044,demonhunter,havoc,18,11,7
Noctilucent,executus,1044,demonhunter,havoc,78,42,36
Metadel,outland,1043,demonhunter,havoc,127,66,61
Kaitlyyn,norgannon,1038,demonhunter,havoc,30,11,19
Нохелет,deepholm,1037,demonhunter,havoc,103,53,50
Aamonath,tarren-mill,1030,demonhunter,havoc,30,16,14
Увиден,eversong,1021,demonhunter,havoc,47,22,25
Vio,jaedenar,1011,demonhunter,havoc,24,14,10
Demontripo,silvermoon,1005,demonhunter,havoc,81,43,38
Delfee,twisting-nether,1005,demonhunter,havoc,54,25,29
Дисофи,soulflayer,1004,demonhunter,havoc,23,11,12
Гарнаш,howling-fjord,993,demonhunter,havoc,60,30,30
Viridisignis,silvermoon,993,demonhunter,havoc,36,16,20
Никельдон,howling-fjord,992,demonhunter,havoc,36,22,14
Hunterston,twisting-nether,992,demonhunter,havoc,68,38,30
Найтшифт,blackscar,991,demonhunter,havoc,16,11,5
Níghtwing,wildhammer,986,demonhunter,havoc,23,11,12
Sintoraz,amanthul,975,demonhunter,havoc,36,21,15
Demonhyan,chants-éternels,975,demonhunter,havoc,55,26,29
Дианист,gordunni,960,demonhunter,havoc,16,11,5
Keýrañe,ragnaros,960,demonhunter,havoc,18,10,8
Анхардх,gordunni,960,demonhunter,havoc,18,10,8
Reckqqt,eredar,960,demonhunter,havoc,18,10,8
Yerla,burning-legion,960,demonhunter,havoc,24,10,14
Shõ,twisting-nether,960,demonhunter,havoc,30,10,20
Íamprepared,tarren-mill,960,demonhunter,havoc,30,10,20
Smâshêd,stormscale,959,demonhunter,havoc,12,10,2
Völkswagen,dun-modr,959,demonhunter,havoc,18,10,8
Tylleröwittu,grim-batol,959,demonhunter,havoc,18,10,8
Катякрылышки,gordunni,959,demonhunter,havoc,18,10,8
Kéftëmé,ravencrest,959,demonhunter,havoc,18,10,8
Гранкрю,blackscar,959,demonhunter,havoc,18,10,8
Zamassu,kazzak,959,demonhunter,havoc,18,10,8
Broglaive,sylvanas,959,demonhunter,havoc,18,10,8
Darnke,silvermoon,959,demonhunter,havoc,30,10,20
Аитерия,gordunni,958,demonhunter,havoc,12,10,2
Shivarræ,stormreaver,958,demonhunter,havoc,18,10,8
Knùbbz,ravencrest,958,demonhunter,havoc,21,11,10
Critlerman,blackmoore,957,demonhunter,havoc,16,11,5
Aedilles,ravencrest,957,demonhunter,havoc,18,10,8
Skarvy,bronze-dragonflight,957,demonhunter,havoc,18,10,8
Vìdhar,tarren-mill,957,demonhunter,havoc,18,10,8
Morphiyy,tarren-mill,955,demonhunter,havoc,18,10,8
Argnils,tarren-mill,953,demonhunter,havoc,12,10,2
Полетела,gordunni,953,demonhunter,havoc,18,10,8
Цейн,azuregos,952,demonhunter,havoc,39,15,24
Jemoer,twisting-nether,951,demonhunter,havoc,20,13,7
Flamme,amanthul,951,demonhunter,havoc,18,11,7
Alandrisz,argent-dawn,949,demonhunter,havoc,30,10,20
Mcsmackface,hellfire,944,demonhunter,havoc,30,10,20
Sinthetyx,quelthalas,940,demonhunter,havoc,24,14,10
Shishiro,alakir,937,demonhunter,havoc,24,10,14
Флеркенкот,galakrond,936,demonhunter,havoc,85,42,43
Yuka,earthen-ring,933,demonhunter,havoc,24,10,14
Nelairia,tarren-mill,931,demonhunter,havoc,18,10,8
Zermut,culte-de-la-rive-noire,925,demonhunter,havoc,17,10,7
Noire,zuljin,917,demonhunter,havoc,29,10,19
Andij,frostwolf,913,demonhunter,havoc,29,11,18
Taliaa,drakthul,911,demonhunter,havoc,21,10,11
Lorcanmar,draenor,911,demonhunter,havoc,39,16,23
Hicgidik,outland,905,demonhunter,havoc,24,11,13
Kroepoeks,mazrigos,894,demonhunter,havoc,30,16,14
Demonsqueezy,nemesis,889,demonhunter,havoc,16,10,6
Jamule,dun-morogh,889,demonhunter,havoc,36,15,21
Nuriia,arthas,886,demonhunter,havoc,30,15,15
Ìllídán,ravencrest,882,demonhunter,havoc,20,10,10
Skylinex,dentarg,880,demonhunter,havoc,60,29,31
Stringsz,ragnaros,874,demonhunter,havoc,17,10,7
Fruttidimare,frostwolf,873,demonhunter,havoc,22,10,12
Фирулия,goldrinn,869,demonhunter,havoc,56,30,26
Silan,kiljaeden,868,demonhunter,havoc,23,11,12
Charteryo,eredar,864,demonhunter,havoc,12,9,3
Zy,ahnqiraj,864,demonhunter,havoc,12,9,3
Folygale,outland,864,demonhunter,havoc,12,9,3
Смутсайбот,howling-fjord,864,demonhunter,havoc,18,9,9
Saene,ravencrest,864,demonhunter,havoc,18,9,9
Draqula,ravencrest,864,demonhunter,havoc,18,9,9
Toschadh,blackmoore,864,demonhunter,havoc,18,9,9
Эридари,blackscar,864,demonhunter,havoc,18,9,9
Raïley,archimonde,864,demonhunter,havoc,18,9,9
Sghemon,pozzo-delleternità,864,demonhunter,havoc,18,9,9
Thulânn,twisting-nether,864,demonhunter,havoc,18,9,9
Chosabreka,zuljin,864,demonhunter,havoc,18,9,9
Zophý,ragnaros,864,demonhunter,havoc,18,9,9
Batx,ravencrest,864,demonhunter,havoc,24,9,15
Míàkhãlîfâýð,stormscale,864,demonhunter,havoc,24,9,15
Bignugs,ravencrest,864,demonhunter,havoc,24,9,15
Chàk,marécage-de-zangar,864,demonhunter,havoc,30,9,21
Солевыеглефы,gordunni,863,demonhunter,havoc,12,9,3
Sunestaa,kazzak,863,demonhunter,havoc,12,9,3
Дайкиаомине,soulflayer,863,demonhunter,havoc,18,9,9
Sadzari,burning-legion,863,demonhunter,havoc,18,9,9
Illidaia,ravencrest,863,demonhunter,havoc,18,9,9
Ììîîííììîîíí,tarren-mill,863,demonhunter,havoc,18,9,9
Kenzaii,aegwynn,863,demonhunter,havoc,18,9,9
Ydrael,terokkar,863,demonhunter,havoc,18,9,9
Onecho,ragnaros,863,demonhunter,havoc,18,9,9
Djdhh,draenor,863,demonhunter,havoc,20,9,11
Darktérror,silvermoon,863,demonhunter,havoc,24,9,15
Illidarisi,auchindoun,863,demonhunter,havoc,24,9,15
Luunz,argent-dawn,863,demonhunter,havoc,30,9,21
Zappikdh,silvermoon,862,demonhunter,havoc,18,9,9
Ruíko,dun-morogh,862,demonhunter,havoc,18,9,9
Finstergraf,blackmoore,862,demonhunter,havoc,30,14,16
Demonstorpix,drakthul,862,demonhunter,havoc,24,9,15
Illidián,chamber-of-aspects,862,demonhunter,havoc,24,9,15
Letidyr,ravencrest,861,demonhunter,havoc,24,9,15
Blîndmaster,ravencrest,861,demonhunter,havoc,24,9,15
Hellarious,ragnaros,860,demonhunter,havoc,18,9,9
Кайриель,gordunni,860,demonhunter,havoc,18,9,9
Эридали,gordunni,860,demonhunter,havoc,18,9,9
Pichkachu,sylvanas,859,demonhunter,havoc,18,9,9
Овецловец,deathguard,859,demonhunter,havoc,18,9,9
Никкэс,gordunni,859,demonhunter,havoc,18,9,9
Doobregeesy,burning-legion,859,demonhunter,havoc,21,10,11
Dmgchris,sylvanas,859,demonhunter,havoc,30,9,21
Deadskill,alexstrasza,858,demonhunter,havoc,54,21,33
Asmedios,twisting-nether,856,demonhunter,havoc,74,25,49
Dadicek,drakthul,853,demonhunter,havoc,12,9,3
Eranduur,draenor,846,demonhunter,havoc,18,9,9
Subelsiu,alakir,840,demonhunter,havoc,63,26,37
Fckmlf,outland,839,demonhunter,havoc,21,12,9
Brunhity,twisting-nether,815,demonhunter,havoc,17,9,8
Illidaniellé,tarren-mill,799,demonhunter,havoc,17,9,8
Deadhuntor,daggerspine,795,demonhunter,havoc,17,9,8
Dombra,kult-der-verdammten,788,demonhunter,havoc,11,9,2
Kundans,aegwynn,787,demonhunter,havoc,17,9,8
Brawngodx,draenor,783,demonhunter,havoc,13,9,4
Traumadh,tarren-mill,768,demonhunter,havoc,12,8,4
Alythes,stormscale,768,demonhunter,havoc,12,8,4
Dedemøn,ysondre,768,demonhunter,havoc,12,8,4
Enjøybrah,nemesis,768,demonhunter,havoc,12,8,4
Eysndh,blackrock,768,demonhunter,havoc,12,8,4
Vayshi,turalyon,768,demonhunter,havoc,18,8,10
Ethína,kazzak,768,demonhunter,havoc,18,8,10
Nthday,draenor,768,demonhunter,havoc,18,8,10
Stinkymonkey,pozzo-delleternità,768,demonhunter,havoc,18,8,10
Höllymedx,blackmoore,768,demonhunter,havoc,18,8,10
Saleny,blackrock,768,demonhunter,havoc,18,8,10
Mollamaija,defias-brotherhood,768,demonhunter,havoc,18,8,10
Perojeina,draenor,768,demonhunter,havoc,18,8,10
Thestrength,twisting-nether,768,demonhunter,havoc,18,8,10
Kins,dun-modr,768,demonhunter,havoc,18,8,10
Sakumi,azshara,768,demonhunter,havoc,18,8,10
Iíïììïiíïìïï,alakir,768,demonhunter,havoc,18,8,10
Аоешный,howling-fjord,768,demonhunter,havoc,18,8,10
Delanoss,blackmoore,768,demonhunter,havoc,19,8,11
Bichmicher,earthen-ring,768,demonhunter,havoc,24,8,16
Rõb,magtheridon,768,demonhunter,havoc,24,8,16
Grimberg,tarren-mill,767,demonhunter,havoc,12,8,4
Aååááååââåâå,arygos,767,demonhunter,havoc,12,8,4
Demøniac,ravencrest,767,demonhunter,havoc,12,8,4
Ninetzqp,tarren-mill,767,demonhunter,havoc,12,8,4
Эска,razuvious,767,demonhunter,havoc,12,8,4
Ziplar,tarren-mill,767,demonhunter,havoc,12,8,4
Baddxd,ragnaros,767,demonhunter,havoc,14,9,5
Zmasteez,ahnqiraj,767,demonhunter,havoc,18,8,10
Hcsgötze,dalaran,767,demonhunter,havoc,18,8,10
Bamßi,ragnaros,767,demonhunter,havoc,18,8,10
Danedemlia,magtheridon,766,demonhunter,havoc,12,8,4
Skrelarent,argent-dawn,766,demonhunter,havoc,12,8,4
Badgyalriri,hyjal,766,demonhunter,havoc,18,8,10
Demonjay,stormscale,766,demonhunter,havoc,22,9,13
Akäly,hyjal,765,demonhunter,havoc,19,9,10
Natazia,eredar,765,demonhunter,havoc,18,8,10
Xellnaga,twisting-nether,763,demonhunter,havoc,18,8,10
Попкасиська,eversong,763,demonhunter,havoc,47,19,28
Covidian,kilrogg,762,demonhunter,havoc,12,8,4
Unsainted,blackhand,762,demonhunter,havoc,18,8,10
Amaterasù,alleria,761,demonhunter,havoc,18,8,10
Maßik,terokkar,757,demonhunter,havoc,15,9,6
Цион,soulflayer,757,demonhunter,havoc,18,8,10
Maryjane,nordrassil,756,demonhunter,havoc,18,8,10
Roostidh,shattered-hand,753,demonhunter,havoc,18,8,10
Кусьзакиску,soulflayer,753,demonhunter,havoc,18,8,10
Pismanik,drakthul,752,demonhunter,havoc,12,8,4
Ikari,neptulon,748,demonhunter,havoc,17,8,9
Butcherr,ulduar,736,demonhunter,havoc,24,8,16
Zealdancer,veknilash,734,demonhunter,havoc,17,8,9
Gushìñgwøuñð,blackmoore,719,demonhunter,havoc,11,8,3
Jco,kazzak,703,demonhunter,havoc,20,8,12
Стрепа,grom,693,demonhunter,havoc,17,8,9
Maddificator,silvermoon,686,demonhunter,havoc,14,8,6
Ronstoppable,ravencrest,672,demonhunter,havoc,12,7,5
Damnituther,kazzak,672,demonhunter,havoc,12,7,5
Caronte,los-errantes,672,demonhunter,havoc,12,7,5
Mür,nordrassil,672,demonhunter,havoc,12,7,5
Esadeáth,ravencrest,672,demonhunter,havoc,12,7,5
Atrikagodx,kazzak,672,demonhunter,havoc,12,7,5
Äzräël,dun-modr,672,demonhunter,havoc,12,7,5
Actuallytrol,argent-dawn,672,demonhunter,havoc,12,7,5
Bizl,arygos,672,demonhunter,havoc,12,7,5
Jincksdh,kazzak,672,demonhunter,havoc,12,7,5
Wintalker,nemesis,672,demonhunter,havoc,12,7,5
Pepenger,kazzak,672,demonhunter,havoc,12,7,5
Glevenuschii,blackmoore,672,demonhunter,havoc,12,7,5
Alied,burning-blade,672,demonhunter,havoc,12,7,5
Antrix,ravencrest,672,demonhunter,havoc,12,7,5
Stonedaf,ravencrest,672,demonhunter,havoc,12,7,5
Illyriel,antonidas,672,demonhunter,havoc,12,7,5
Styxdh,blackhand,672,demonhunter,havoc,12,7,5
Hextechz,stormscale,672,demonhunter,havoc,12,7,5
Lirigizel,hellscream,672,demonhunter,havoc,12,7,5
Sutures,ravencrest,672,demonhunter,havoc,12,7,5
Gandzsä,ragnaros,672,demonhunter,havoc,12,7,5
Yorxdh,eredar,672,demonhunter,havoc,12,7,5
Шалдарон,howling-fjord,672,demonhunter,havoc,12,7,5
Tachala,khaz-modan,672,demonhunter,havoc,12,7,5
Ozu,blackrock,672,demonhunter,havoc,12,7,5
Safedaddy,silvermoon,672,demonhunter,havoc,15,8,7
Kekburagól,kazzak,672,demonhunter,havoc,15,8,7
Abigorien,blackmoore,672,demonhunter,havoc,18,7,11
Alareey,antonidas,672,demonhunter,havoc,18,7,11
Yukiz,ravencrest,672,demonhunter,havoc,18,7,11
Demondulle,kazzak,672,demonhunter,havoc,18,7,11
Келидаррия,soulflayer,672,demonhunter,havoc,18,7,11
Zoyle,blackrock,672,demonhunter,havoc,18,7,11
Satti,sargeras,672,demonhunter,havoc,18,7,11
Крикетх,soulflayer,672,demonhunter,havoc,18,7,11
Charleyzard,argent-dawn,672,demonhunter,havoc,18,7,11
Onizukadh,archimonde,672,demonhunter,havoc,18,7,11
Chrístíe,sanguino,672,demonhunter,havoc,18,7,11
Gnarpump,emeriss,672,demonhunter,havoc,18,7,11
Viced,kazzak,672,demonhunter,havoc,18,7,11
Calcïum,archimonde,672,demonhunter,havoc,24,7,17
Jokas,archimonde,672,demonhunter,havoc,24,7,17
Nerfy,silvermoon,671,demonhunter,havoc,12,7,5
Meji,ravencrest,671,demonhunter,havoc,12,7,5
Nxmpys,sanguino,671,demonhunter,havoc,12,7,5
Geashy,blackmoore,671,demonhunter,havoc,12,7,5
Ddvh,drakthul,671,demonhunter,havoc,12,7,5
Abrahêll,dun-modr,671,demonhunter,havoc,18,7,11
Moojdh,malganis,671,demonhunter,havoc,18,7,11
Хорбелий,deathguard,671,demonhunter,havoc,18,7,11
Rebelion,dun-modr,671,demonhunter,havoc,18,7,11
Corelly,ragnaros,671,demonhunter,havoc,18,7,11
Adraelia,archimonde,670,demonhunter,havoc,12,7,5
Милинайт,eversong,670,demonhunter,havoc,12,7,5
Hyunkél,kirin-tor,670,demonhunter,havoc,18,7,11
Hannipham,silvermoon,669,demonhunter,havoc,15,8,7
Necrotyle,twisting-nether,669,demonhunter,havoc,21,8,13
Kumoko,burning-legion,669,demonhunter,havoc,21,8,13
Valen,die-aldor,669,demonhunter,havoc,24,7,17
Nylaria,dethecus,668,demonhunter,havoc,12,7,5
Danshokudino,kazzak,665,demonhunter,havoc,18,7,11
Judderzz,bronze-dragonflight,658,demonhunter,havoc,12,7,5
Blutox,antonidas,653,demonhunter,havoc,19,8,11
Notlars,chamber-of-aspects,639,demonhunter,havoc,17,7,10
Legionek,burning-blade,629,demonhunter,havoc,14,8,6
Snelle,outland,624,demonhunter,havoc,15,7,8
Аллидариан,howling-fjord,623,demonhunter,havoc,17,7,10
Подкрадунзай,soulflayer,621,demonhunter,havoc,12,9,3
Makhabunda,terokkar,618,demonhunter,havoc,28,8,20
Phalekxox,ravencrest,607,demonhunter,havoc,11,7,4
Mèlfurion,hyjal,607,demonhunter,havoc,13,8,5
Prouser,turalyon,588,demonhunter,havoc,21,8,13
Hellwynne,archimonde,576,demonhunter,havoc,6,6,0
Mímð,ravencrest,576,demonhunter,havoc,6,6,0
Alasune,twisting-nether,576,demonhunter,havoc,6,6,0
Ranzerg,tarren-mill,576,demonhunter,havoc,6,6,0
Сихая,howling-fjord,576,demonhunter,havoc,12,6,6
Pyleá,malganis,576,demonhunter,havoc,12,6,6
Aeshalla,blackmoore,576,demonhunter,havoc,12,6,6
Peacedopice,drakthul,576,demonhunter,havoc,12,6,6
Lezzo,tarren-mill,576,demonhunter,havoc,12,6,6
Länika,drakthul,576,demonhunter,havoc,12,6,6
Demonzøku,ravencrest,576,demonhunter,havoc,12,6,6
Lawus,blackhand,576,demonhunter,havoc,12,6,6
Вафлистикус,ashenvale,576,demonhunter,havoc,12,6,6
Noovedh,ravencrest,576,demonhunter,havoc,12,6,6
Rhinozerg,kazzak,576,demonhunter,havoc,12,6,6
Blæm,archimonde,576,demonhunter,havoc,12,6,6
Paindemon,outland,576,demonhunter,havoc,12,6,6
Soulmortal,draenor,576,demonhunter,havoc,12,6,6
Quavanity,sylvanas,576,demonhunter,havoc,12,6,6
Kyuzo,sanguino,576,demonhunter,havoc,12,6,6
Minifranger,archimonde,576,demonhunter,havoc,12,6,6
Stickihunt,malganis,576,demonhunter,havoc,12,6,6
Muyoni,eredar,576,demonhunter,havoc,12,6,6
Xyrs,draenor,576,demonhunter,havoc,12,6,6
Lyzzra,blackmoore,576,demonhunter,havoc,12,6,6
Straizo,malganis,576,demonhunter,havoc,12,6,6
Størmrage,sanguino,576,demonhunter,havoc,12,6,6
Ehrin,lightbringer,576,demonhunter,havoc,12,6,6
Lòsêr,ravencrest,576,demonhunter,havoc,12,6,6
Notapistol,outland,576,demonhunter,havoc,12,6,6
Õmen,ravencrest,576,demonhunter,havoc,12,6,6
Lanaël,kaelthas,576,demonhunter,havoc,12,6,6
Lurtéx,kazzak,576,demonhunter,havoc,12,6,6
Муими,soulflayer,576,demonhunter,havoc,12,6,6
Tëvnic,kazzak,576,demonhunter,havoc,12,6,6
Kâsúxôxô,ravencrest,576,demonhunter,havoc,16,7,9
Zaÿn,antonidas,576,demonhunter,havoc,18,6,12
Pinx,archimonde,576,demonhunter,havoc,18,6,12
Bämbøué,hyjal,576,demonhunter,havoc,18,6,12
Ilyerias,twisting-nether,576,demonhunter,havoc,18,6,12
Shyoxdh,twisting-nether,576,demonhunter,havoc,18,6,12
Nøøßønline,hyjal,576,demonhunter,havoc,18,6,12
Dèsdemøna,nemesis,576,demonhunter,havoc,18,6,12
Стараятварь,thermaplugg,576,demonhunter,havoc,24,6,18
Pèpsì,kazzak,576,demonhunter,havoc,24,6,18
Shizuuli,outland,576,demonhunter,havoc,30,6,24
Extraxtreme,ravencrest,575,demonhunter,havoc,12,6,6
Daweeo,the-maelstrom,575,demonhunter,havoc,12,6,6
Instinctivee,sylvanas,575,demonhunter,havoc,12,6,6
Kamaz,twisting-nether,575,demonhunter,havoc,12,6,6
Saftad,outland,575,demonhunter,havoc,12,6,6
Antidevil,kazzak,575,demonhunter,havoc,16,7,9
Wauway,ragnaros,575,demonhunter,havoc,14,6,8
Aelzeran,stormscale,575,demonhunter,havoc,18,6,12
Candylicks,kazzak,575,demonhunter,havoc,18,6,12
Sangita,tarren-mill,574,demonhunter,havoc,12,6,6
Ôlowain,blackmoore,574,demonhunter,havoc,18,6,12
Rúpél,thrall,573,demonhunter,havoc,18,6,12
Klave,argent-dawn,573,demonhunter,havoc,18,6,12
Tatsukiyuzu,hyjal,572,demonhunter,havoc,6,6,0
Caria,twisting-nether,570,demonhunter,havoc,12,6,6
Bahmut,argent-dawn,569,demonhunter,havoc,12,6,6
Дантавул,gordunni,568,demonhunter,havoc,18,6,12
Glerog,ragnaros,558,demonhunter,havoc,10,7,3
Mâdzylîa,archimonde,543,demonhunter,havoc,11,6,5
Kalr,silvermoon,527,demonhunter,havoc,11,6,5
Makiu,archimonde,527,demonhunter,havoc,15,6,9
Иланари,gordunni,526,demonhunter,havoc,11,6,5
Хисаго,gordunni,522,demonhunter,havoc,15,7,8
Gnjurac,outland,511,demonhunter,havoc,14,6,8
Asperity,antonidas,511,demonhunter,havoc,18,6,12
Amionisiken,amanthul,496,demonhunter,havoc,13,6,7
Morrion,blackmoore,480,demonhunter,havoc,6,5,1
Mouga,hyjal,480,demonhunter,havoc,6,5,1
Valshatt,sanguino,480,demonhunter,havoc,6,5,1
Kimberleh,doomhammer,480,demonhunter,havoc,6,5,1
Kanéki,sylvanas,480,demonhunter,havoc,6,5,1
Guziel,kazzak,480,demonhunter,havoc,6,5,1
Toonsdh,kazzak,480,demonhunter,havoc,6,5,1
Nekkëtsu,archimonde,480,demonhunter,havoc,6,5,1
Jugøbænned,blackrock,480,demonhunter,havoc,6,5,1
Selcan,archimonde,480,demonhunter,havoc,6,5,1
Táti,blackrock,480,demonhunter,havoc,6,5,1
Happykx,draenor,480,demonhunter,havoc,6,5,1
Monion,defias-brotherhood,480,demonhunter,havoc,6,5,1
Giboo,emerald-dream,480,demonhunter,havoc,6,5,1
Muharaar,ravencrest,480,demonhunter,havoc,6,5,1
Подэхилла,galakrond,480,demonhunter,havoc,10,6,4
Kainenn,silvermoon,480,demonhunter,havoc,12,5,7
Revérse,stormscale,480,demonhunter,havoc,12,5,7
Deathblades,twisting-nether,480,demonhunter,havoc,12,5,7
Nstea,cthun,480,demonhunter,havoc,12,5,7
Varthag,antonidas,480,demonhunter,havoc,12,5,7
Topg,bladefist,480,demonhunter,havoc,12,5,7
Tastyblades,blackmoore,480,demonhunter,havoc,12,5,7
Daemonai,neptulon,480,demonhunter,havoc,12,5,7
Bhaz,tichondrius,480,demonhunter,havoc,12,5,7
Нереалочка,blackscar,480,demonhunter,havoc,12,5,7
Tomkis,ravencrest,480,demonhunter,havoc,12,5,7
Onlyfangodx,antonidas,480,demonhunter,havoc,12,5,7
Kithan,zuljin,480,demonhunter,havoc,12,5,7
Зедю,howling-fjord,480,demonhunter,havoc,12,5,7
Wrathia,rexxar,480,demonhunter,havoc,12,5,7
Spitface,aegwynn,480,demonhunter,havoc,12,5,7
Tthic,shadowsong,480,demonhunter,havoc,12,5,7
Giftìg,ravencrest,480,demonhunter,havoc,12,5,7
Alandiel,twisting-nether,480,demonhunter,havoc,12,5,7
Takad,twisting-nether,480,demonhunter,havoc,12,5,7
Дракомуфлон,gordunni,480,demonhunter,havoc,12,5,7
Dhaosh,nemesis,480,demonhunter,havoc,12,5,7
Natzú,ravencrest,480,demonhunter,havoc,12,5,7
Такетомии,gordunni,480,demonhunter,havoc,12,5,7
Superchocowo,sanguino,480,demonhunter,havoc,12,5,7
Hakakuri,ravencrest,480,demonhunter,havoc,12,5,7
Филеровщик,deathguard,480,demonhunter,havoc,12,5,7
Blueformeld,draenor,480,demonhunter,havoc,12,5,7
Backflipgødx,uldaman,480,demonhunter,havoc,12,5,7
Jotaros,ravencrest,480,demonhunter,havoc,12,5,7
Этмер,soulflayer,480,demonhunter,havoc,12,5,7
Tatoos,bronze-dragonflight,480,demonhunter,havoc,12,5,7
Veryfunhaha,ravencrest,480,demonhunter,havoc,12,5,7
Korrupt,draenor,480,demonhunter,havoc,12,5,7
Lyanadh,blackhand,480,demonhunter,havoc,12,5,7
Solrosfrön,stormscale,480,demonhunter,havoc,12,5,7
Calendith,arathor,480,demonhunter,havoc,15,6,9
Shyynedh,grim-batol,480,demonhunter,havoc,15,6,9
Neiden,deathwing,480,demonhunter,havoc,18,5,13
Aelina,area-52,480,demonhunter,havoc,18,5,13
Dübler,gorgonnash,480,demonhunter,havoc,18,5,13
Slizer,draenor,480,demonhunter,havoc,18,5,13
Natarásh,blackmoore,480,demonhunter,havoc,18,5,13
Lòsâng,sanguino,480,demonhunter,havoc,18,5,13
Wajoglaive,blackhand,480,demonhunter,havoc,18,5,13
Кайренсс,howling-fjord,480,demonhunter,havoc,18,5,13
Lovesong,the-shatar,480,demonhunter,havoc,18,5,13
Sholon,kiljaeden,479,demonhunter,havoc,6,5,1
Sephiris,argent-dawn,479,demonhunter,havoc,6,5,1
Saìras,blackhand,479,demonhunter,havoc,12,5,7
Merilidan,blackrock,479,demonhunter,havoc,12,5,7
Approxis,archimonde,479,demonhunter,havoc,12,5,7
Goatcorpse,blackmoore,479,demonhunter,havoc,12,5,7
Hupon,drakthul,479,demonhunter,havoc,12,5,7
Marsterkush,malygos,479,demonhunter,havoc,12,5,7
Demontevz,outland,479,demonhunter,havoc,12,5,7
Gryphory,ravencrest,479,demonhunter,havoc,12,5,7
Chàuvequipeu,dalaran,479,demonhunter,havoc,12,5,7
Shreddern,ragnaros,479,demonhunter,havoc,13,5,8
Makkivar,terenas,479,demonhunter,havoc,18,5,13
Gigipletosu,ravencrest,479,demonhunter,havoc,18,5,13
Карнавалыч,gordunni,479,demonhunter,havoc,30,5,25
Скудайвер,gordunni,478,demonhunter,havoc,12,5,7
Besnik,stormscale,478,demonhunter,havoc,18,5,13
Kairidemon,eredar,477,demonhunter,havoc,12,5,7
Winnztlol,chamber-of-aspects,477,demonhunter,havoc,15,5,10
Гачирабыня,lich-king,477,demonhunter,havoc,30,5,25
Vincbengt,tarren-mill,476,demonhunter,havoc,12,5,7
Cometofloki,outland,475,demonhunter,havoc,12,5,7
Illikan,stormscale,474,demonhunter,havoc,12,5,7
Etraidor,turalyon,473,demonhunter,havoc,12,5,7
Anishara,die-nachtwache,463,demonhunter,havoc,13,6,7
Илнари,soulflayer,447,demonhunter,havoc,11,5,6
Majînßûü,ravencrest,447,demonhunter,havoc,11,5,6
Shaundead,drakthul,447,demonhunter,havoc,11,5,6
Иллианэль,howling-fjord,432,demonhunter,havoc,9,5,4
Ataddcay,outland,430,demonhunter,havoc,13,5,8
Opmuch,eonar,416,demonhunter,havoc,10,5,5
Juha,bronze-dragonflight,398,demonhunter,havoc,7,5,2
Twopumpchump,twisting-nether,384,demonhunter,havoc,6,4,2
Mýg,ravencrest,384,demonhunter,havoc,6,4,2
Adírael,cthun,384,demonhunter,havoc,6,4,2
Varonx,drakthul,384,demonhunter,havoc,6,4,2
Véspé,naxxramas,384,demonhunter,havoc,6,4,2
Ðârksìðê,stormscale,384,demonhunter,havoc,6,4,2
Niellarsc,ravencrest,384,demonhunter,havoc,6,4,2
Greedsmoke,kazzak,384,demonhunter,havoc,6,4,2
Márcin,burning-legion,384,demonhunter,havoc,6,4,2
Lemondehunta,twisting-nether,384,demonhunter,havoc,6,4,2
Apsodemon,twisting-nether,384,demonhunter,havoc,6,4,2
Iken,ragnaros,384,demonhunter,havoc,6,4,2
Plagues,quelthalas,384,demonhunter,havoc,6,4,2
Drilloz,ravencrest,384,demonhunter,havoc,6,4,2
Demoncalle,the-maelstrom,384,demonhunter,havoc,6,4,2
Kriszidan,arathor,384,demonhunter,havoc,6,4,2
Талисзора,gordunni,384,demonhunter,havoc,6,4,2
Maupau,ravencrest,384,demonhunter,havoc,6,4,2
Itsfinee,outland,384,demonhunter,havoc,6,4,2
Deathbydeaf,terenas,384,demonhunter,havoc,6,4,2
Шизванаденс,gordunni,384,demonhunter,havoc,6,4,2
Vidagín,blackmoore,384,demonhunter,havoc,6,4,2
Elfmonger,ravencrest,384,demonhunter,havoc,6,4,2
Akaniiaa,blackmoore,384,demonhunter,havoc,6,4,2
Anklàr,blackrock,384,demonhunter,havoc,6,4,2
Memedhbtw,outland,384,demonhunter,havoc,6,4,2
Schejtan,blackmoore,384,demonhunter,havoc,6,4,2
Cielis,outland,384,demonhunter,havoc,6,4,2
Arløw,archimonde,384,demonhunter,havoc,10,5,5
Freakerzoid,kazzak,384,demonhunter,havoc,11,4,7
Becknárn,sylvanas,384,demonhunter,havoc,12,4,8
Leylas,nagrand,384,demonhunter,havoc,12,4,8
Mamio,chogall,384,demonhunter,havoc,12,4,8
Ninjantiz,antonidas,384,demonhunter,havoc,12,4,8
Crushidemon,draenor,384,demonhunter,havoc,12,4,8
Joezus,draenor,384,demonhunter,havoc,12,4,8
Dannyp,ravencrest,384,demonhunter,havoc,12,4,8
Blüëräin,draenor,384,demonhunter,havoc,12,4,8
Innocuouss,twisting-nether,384,demonhunter,havoc,12,4,8
Mempaan,magtheridon,384,demonhunter,havoc,12,4,8
Frostidh,ysondre,384,demonhunter,havoc,12,4,8
Одзангейра,blackscar,384,demonhunter,havoc,12,4,8
Realtrance,sanguino,384,demonhunter,havoc,12,4,8
Fotmfgt,eredar,384,demonhunter,havoc,12,4,8
Dirtydoggy,dun-modr,384,demonhunter,havoc,12,4,8
Arkta,kazzak,384,demonhunter,havoc,12,4,8
Maeltus,hyjal,384,demonhunter,havoc,12,4,8
Alleyezønme,outland,384,demonhunter,havoc,12,4,8
Purpleturtle,blackrock,384,demonhunter,havoc,12,4,8
Артёмблэйдх,blackscar,384,demonhunter,havoc,12,4,8
Krvckhead,hyjal,384,demonhunter,havoc,12,4,8
Moonbeàm,kazzak,384,demonhunter,havoc,12,4,8
Floridaboy,ravencrest,384,demonhunter,havoc,12,4,8
Valkorion,chamber-of-aspects,384,demonhunter,havoc,12,4,8
Deadrawdh,aegwynn,384,demonhunter,havoc,12,4,8
Shabalda,dun-morogh,384,demonhunter,havoc,12,4,8
Lîllîv,wrathbringer,384,demonhunter,havoc,12,4,8
Exodlia,silvermoon,384,demonhunter,havoc,12,4,8
Cutforshred,zenedar,384,demonhunter,havoc,12,4,8
Rivy,magtheridon,384,demonhunter,havoc,12,4,8
Бистлайк,soulflayer,384,demonhunter,havoc,12,4,8
Saikamango,blackhand,384,demonhunter,havoc,12,4,8
Хокану,gordunni,384,demonhunter,havoc,12,4,8
Pijvijie,shattrath,384,demonhunter,havoc,12,4,8
Stormshred,stormscale,384,demonhunter,havoc,12,4,8
Лупидолх,soulflayer,384,demonhunter,havoc,12,4,8
Reachfight,lothar,384,demonhunter,havoc,12,4,8
Redgi,tarren-mill,384,demonhunter,havoc,18,4,14
Sazukè,blackmoore,384,demonhunter,havoc,18,4,14
Poliex,khaz-modan,383,demonhunter,havoc,6,4,2
Némesîs,cthun,383,demonhunter,havoc,6,4,2
Rouzi,defias-brotherhood,383,demonhunter,havoc,6,4,2
Vengatoria,cthun,383,demonhunter,havoc,12,4,8
Шоеррей,gordunni,383,demonhunter,havoc,12,4,8
Thorskinius,ravencrest,383,demonhunter,havoc,12,4,8
Elenastar,kazzak,383,demonhunter,havoc,12,4,8
Liondam,pozzo-delleternità,382,demonhunter,havoc,6,4,2
Nazzan,destromath,382,demonhunter,havoc,6,4,2
Ёмайл,soulflayer,381,demonhunter,havoc,12,4,8
Åáäàáåàáäàáå,dun-modr,377,demonhunter,havoc,15,6,9
Lexxdh,blackmoore,351,demonhunter,havoc,8,5,3
Летучий,howling-fjord,351,demonhunter,havoc,8,5,3
Блэйденрифтс,soulflayer,351,demonhunter,havoc,11,4,7
Foxylama,stormscale,336,demonhunter,havoc,9,5,4
Nyxxeria,drakthul,336,demonhunter,havoc,15,4,11
Hyperflex,blackrock,320,demonhunter,havoc,10,4,6
Felwaifu,tarren-mill,319,demonhunter,havoc,8,4,4
Кейсимег,soulflayer,288,demonhunter,havoc,6,3,3
Meleidar,kazzak,288,demonhunter,havoc,6,3,3
Dadagodx,kazzak,288,demonhunter,havoc,6,3,3
Wrathill,draenor,288,demonhunter,havoc,6,3,3
Killaden,ravenholdt,288,demonhunter,havoc,6,3,3
Cirino,defias-brotherhood,288,demonhunter,havoc,6,3,3
Xénôns,archimonde,288,demonhunter,havoc,6,3,3
Demonzeus,archimonde,288,demonhunter,havoc,6,3,3
Shaadraz,stormscale,288,demonhunter,havoc,6,3,3
Gwoodza,archimonde,288,demonhunter,havoc,6,3,3
Брилаброви,soulflayer,288,demonhunter,havoc,6,3,3
Иллидал,greymane,288,demonhunter,havoc,6,3,3
Extitan,twisting-nether,288,demonhunter,havoc,6,3,3
Lonedh,sylvanas,288,demonhunter,havoc,6,3,3
Valø,malganis,288,demonhunter,havoc,6,3,3
Шрэдэр,thermaplugg,288,demonhunter,havoc,6,3,3
Cnbâckbb,archimonde,288,demonhunter,havoc,6,3,3
Cienlowczyni,silvermoon,288,demonhunter,havoc,6,3,3
Hellboi,dun-modr,288,demonhunter,havoc,6,3,3
Алистреель,gordunni,288,demonhunter,havoc,6,3,3
Hyonzyyesh,silvermoon,288,demonhunter,havoc,6,3,3
Nerudas,blackhand,288,demonhunter,havoc,6,3,3
Nørðìç,nordrassil,288,demonhunter,havoc,6,3,3
Cursedblade,archimonde,288,demonhunter,havoc,6,3,3
Albdh,kazzak,288,demonhunter,havoc,6,3,3
Ашерис,deathguard,288,demonhunter,havoc,6,3,3
Ðêmønìnsìðê,blackmoore,288,demonhunter,havoc,6,3,3
Betterdk,twilights-hammer,288,demonhunter,havoc,6,3,3
Kyoukaii,kazzak,288,demonhunter,havoc,6,3,3
Jaace,silvermoon,288,demonhunter,havoc,6,3,3
Дэйнни,blackscar,288,demonhunter,havoc,6,3,3
Slaanesh,xavius,288,demonhunter,havoc,6,3,3
Zsídakabra,ragnaros,288,demonhunter,havoc,6,3,3
Kätarïnas,confrérie-du-thorium,288,demonhunter,havoc,6,3,3
Ittas,archimonde,288,demonhunter,havoc,6,3,3
Lailâh,blackmoore,288,demonhunter,havoc,6,3,3
Cindras,turalyon,288,demonhunter,havoc,6,3,3
Kerog,blackmoore,288,demonhunter,havoc,6,3,3
Sèptember,draenor,288,demonhunter,havoc,6,3,3
Норилайнн,gordunni,288,demonhunter,havoc,6,3,3
Øhka,outland,288,demonhunter,havoc,6,3,3
Mortyb,kazzak,288,demonhunter,havoc,6,3,3
Schwitte,tichondrius,288,demonhunter,havoc,6,3,3
Резако,soulflayer,288,demonhunter,havoc,6,3,3
Myuøu,hyjal,288,demonhunter,havoc,6,3,3
Khenetai,silvermoon,288,demonhunter,havoc,6,3,3
Xellidan,dun-modr,288,demonhunter,havoc,6,3,3
Bunzi,sylvanas,288,demonhunter,havoc,6,3,3
Bossmac,mugthol,288,demonhunter,havoc,6,3,3
Андрюхадх,soulflayer,288,demonhunter,havoc,6,3,3
Vaterdenke,defias-brotherhood,288,demonhunter,havoc,6,3,3
Naargof,outland,288,demonhunter,havoc,6,3,3
Aaryaa,archimonde,288,demonhunter,havoc,6,3,3
Dzikalocha,burning-legion,288,demonhunter,havoc,6,3,3
Akhyra,ysondre,288,demonhunter,havoc,6,3,3
Lilithxz,blackmoore,288,demonhunter,havoc,6,3,3
Неффкодх,howling-fjord,288,demonhunter,havoc,6,3,3
Error,ravencrest,288,demonhunter,havoc,6,3,3
Jaquees,stormscale,288,demonhunter,havoc,6,3,3
Deschacke,eredar,288,demonhunter,havoc,6,3,3
Barneeéy,tarren-mill,288,demonhunter,havoc,6,3,3
Demonsushi,tarren-mill,288,demonhunter,havoc,6,3,3
Annaboliik,ravencrest,288,demonhunter,havoc,6,3,3
Neony,blackmoore,288,demonhunter,havoc,6,3,3
Âstræa,antonidas,288,demonhunter,havoc,6,3,3
Nameerr,ragnaros,288,demonhunter,havoc,6,3,3
Гарражж,howling-fjord,288,demonhunter,havoc,6,3,3
Cánoo,blackhand,288,demonhunter,havoc,6,3,3
Alfaa,outland,288,demonhunter,havoc,6,3,3
Sayph,hyjal,288,demonhunter,havoc,6,3,3
Shattre,silvermoon,288,demonhunter,havoc,6,3,3
Сангвиннус,howling-fjord,288,demonhunter,havoc,6,3,3
Songur,blackhand,288,demonhunter,havoc,6,3,3
Азместь,howling-fjord,288,demonhunter,havoc,6,3,3
Зографос,fordragon,288,demonhunter,havoc,6,3,3
Shinnu,antonidas,288,demonhunter,havoc,6,3,3
Анавеллка,howling-fjord,288,demonhunter,havoc,6,3,3
Sandem,blackrock,288,demonhunter,havoc,6,3,3
Sayee,drakthul,288,demonhunter,havoc,6,3,3
Kritflake,blackrock,288,demonhunter,havoc,6,3,3
Imvnrcvr,dalaran,288,demonhunter,havoc,6,3,3
Smoochygodx,antonidas,288,demonhunter,havoc,6,3,3
Fantabolous,ragnaros,288,demonhunter,havoc,6,3,3
Aethilios,kazzak,288,demonhunter,havoc,11,3,8
Ayö,draenor,288,demonhunter,havoc,15,4,11
Cptgmiasbria,eredar,288,demonhunter,havoc,12,3,9
Illidorie,twisting-nether,288,demonhunter,havoc,12,3,9
Vaenil,hyjal,288,demonhunter,havoc,12,3,9
Rurt,sanguino,288,demonhunter,havoc,12,3,9
Vandazza,argent-dawn,288,demonhunter,havoc,12,3,9
Ultîma,hyjal,288,demonhunter,havoc,12,3,9
Шавермье,gordunni,288,demonhunter,havoc,12,3,9
Asporos,pozzo-delleternità,288,demonhunter,havoc,12,3,9
Firebringer,silvermoon,288,demonhunter,havoc,12,3,9
Lamello,nemesis,288,demonhunter,havoc,12,3,9
Ïvø,sargeras,288,demonhunter,havoc,12,3,9
Рагнос,goldrinn,288,demonhunter,havoc,12,3,9
Vulcaan,ravencrest,288,demonhunter,havoc,12,3,9
Artwar,stormscale,288,demonhunter,havoc,12,3,9
Tenaebris,silvermoon,288,demonhunter,havoc,12,3,9
Tuffêli,turalyon,288,demonhunter,havoc,12,3,9
Laurana,argent-dawn,288,demonhunter,havoc,12,3,9
Milanto,antonidas,288,demonhunter,havoc,12,3,9
Skajlan,burning-legion,288,demonhunter,havoc,12,3,9
Феяужаса,soulflayer,288,demonhunter,havoc,12,3,9
Linea,jaedenar,288,demonhunter,havoc,12,3,9
Metaman,archimonde,288,demonhunter,havoc,12,3,9
Nightwalk,blackmoore,288,demonhunter,havoc,12,3,9
Kruthor,taerar,288,demonhunter,havoc,12,3,9
Naturalis,die-todeskrallen,288,demonhunter,havoc,12,3,9
Bengleng,draenor,288,demonhunter,havoc,12,3,9
Jimdh,quelthalas,288,demonhunter,havoc,18,3,15
Devildust,ravencrest,288,demonhunter,havoc,18,3,15
Lasthija,dun-modr,288,demonhunter,havoc,18,3,15
Saturnein,stormscale,287,demonhunter,havoc,6,3,3
Glaiverush,alakir,287,demonhunter,havoc,6,3,3
Menutzdh,tarren-mill,287,demonhunter,havoc,6,3,3
Гёнке,gordunni,287,demonhunter,havoc,18,3,15
Dàrkinette,archimonde,286,demonhunter,havoc,6,3,3
Devilmonkey,ambossar,276,demonhunter,havoc,24,6,18
Gêliôs,kazzak,271,demonhunter,havoc,11,3,8
Nithraim,kazzak,240,demonhunter,havoc,9,3,6
Itskarmax,outland,239,demonhunter,havoc,5,3,2
Ponn,blackmoore,239,demonhunter,havoc,5,3,2
Xaro,quelthalas,239,demonhunter,havoc,5,3,2
Beraxulus,aegwynn,234,demonhunter,havoc,10,4,6
Munamasa,archimonde,234,demonhunter,havoc,11,4,7
Demoqt,ragnaros,192,demonhunter,havoc,4,3,1
Erenyeagerr,kazzak,192,demonhunter,havoc,4,3,1
Scarath,eredar,192,demonhunter,havoc,6,2,4
Aytèè,eredar,192,demonhunter,havoc,6,2,4
Rybn,eredar,192,demonhunter,havoc,6,2,4
Tacodhx,ravencrest,192,demonhunter,havoc,6,2,4
Sälexz,ysondre,192,demonhunter,havoc,6,2,4
Barocs,antonidas,192,demonhunter,havoc,6,2,4
Malkyor,ysondre,192,demonhunter,havoc,6,2,4
Aggrodíte,antonidas,192,demonhunter,havoc,6,2,4
Остроухйй,blackscar,192,demonhunter,havoc,6,2,4
Папичгодх,borean-tundra,192,demonhunter,havoc,6,2,4
Тэнсу,borean-tundra,192,demonhunter,havoc,6,2,4
Мэлифсб,blackscar,192,demonhunter,havoc,6,2,4
Zenô,antonidas,192,demonhunter,havoc,6,2,4
Илизарнный,gordunni,192,demonhunter,havoc,6,2,4
Ragnarak,amanthul,192,demonhunter,havoc,6,2,4
Nanana,doomhammer,192,demonhunter,havoc,6,2,4
Деорру,gordunni,192,demonhunter,havoc,6,2,4
Zxcjklcasdlk,sylvanas,192,demonhunter,havoc,6,2,4
Andariell,sylvanas,192,demonhunter,havoc,6,2,4
Bogren,sylvanas,192,demonhunter,havoc,6,2,4
Sajr,twisting-nether,192,demonhunter,havoc,6,2,4
Riveén,blackhand,192,demonhunter,havoc,6,2,4
Kakovicz,gorgonnash,192,demonhunter,havoc,6,2,4
Wolfex,hellfire,192,demonhunter,havoc,6,2,4
Grinchdemon,nagrand,192,demonhunter,havoc,6,2,4
Беатриз,soulflayer,192,demonhunter,havoc,6,2,4
Маскитол,soulflayer,192,demonhunter,havoc,6,2,4
Zlett,draenor,192,demonhunter,havoc,6,2,4
Chlorel,arthas,192,demonhunter,havoc,6,2,4
Demonpegasus,draenor,192,demonhunter,havoc,6,2,4
Rúllio,rexxar,192,demonhunter,havoc,6,2,4
Gnaget,the-maelstrom,192,demonhunter,havoc,6,2,4
Sazzox,blackrock,192,demonhunter,havoc,6,2,4
Saphira,laughing-skull,192,demonhunter,havoc,6,2,4
Friidaadh,lightbringer,192,demonhunter,havoc,6,2,4
Datejust,archimonde,192,demonhunter,havoc,6,2,4
Сязекть,goldrinn,192,demonhunter,havoc,6,2,4
Roxxis,mazrigos,192,demonhunter,havoc,6,2,4
Hicke,burning-legion,192,demonhunter,havoc,6,2,4
Hamssterek,magtheridon,192,demonhunter,havoc,6,2,4
Dhslayer,magtheridon,192,demonhunter,havoc,6,2,4
Anayihh,dun-modr,192,demonhunter,havoc,6,2,4
Malzehar,tarren-mill,192,demonhunter,havoc,6,2,4
Bhuta,aerie-peak,192,demonhunter,havoc,6,2,4
Martøsdh,uldum,192,demonhunter,havoc,6,2,4
Noitradh,zuljin,192,demonhunter,havoc,6,2,4
Gorilla,korgall,192,demonhunter,havoc,6,2,4
Karpandero,stormreaver,192,demonhunter,havoc,6,2,4
Мейьибейьи,howling-fjord,192,demonhunter,havoc,6,2,4
Шоксенсацияя,howling-fjord,192,demonhunter,havoc,6,2,4
Tbomb,ragnaros,192,demonhunter,havoc,6,2,4
Juicyglaives,ragnaros,192,demonhunter,havoc,6,2,4
Emkogødx,outland,192,demonhunter,havoc,6,2,4
Ànavar,twisting-nether,192,demonhunter,havoc,6,2,4
Cíondra,aegwynn,192,demonhunter,havoc,6,2,4
Donstyle,anachronos,192,demonhunter,havoc,6,2,4
Williamgrant,alonsus,192,demonhunter,havoc,6,2,4
Dhamp,kazzak,192,demonhunter,havoc,6,2,4
Demontoolz,outland,192,demonhunter,havoc,6,2,4
Alcadejas,pozzo-delleternità,192,demonhunter,havoc,6,2,4
Disconecting,outland,192,demonhunter,havoc,6,2,4
Usaïnbolts,archimonde,192,demonhunter,havoc,6,2,4
Haveadad,outland,192,demonhunter,havoc,6,2,4
Nairra,blackmoore,192,demonhunter,havoc,6,2,4
Dikcitx,archimonde,192,demonhunter,havoc,6,2,4
Harrah,archimonde,192,demonhunter,havoc,6,2,4
Stifeur,archimonde,192,demonhunter,havoc,6,2,4
Cøldlean,ravencrest,192,demonhunter,havoc,6,2,4
Bratti,kazzak,192,demonhunter,havoc,6,2,4
Newgens,kazzak,192,demonhunter,havoc,6,2,4
Lucziane,blackmoore,192,demonhunter,havoc,6,2,4
Anödyth,kirin-tor,192,demonhunter,havoc,6,2,4
Ascindra,kazzak,192,demonhunter,havoc,6,2,4
Palaurx,kazzak,192,demonhunter,havoc,6,2,4
Sñüîîâ,kazzak,192,demonhunter,havoc,6,2,4
Linkôs,aegwynn,192,demonhunter,havoc,6,2,4
Glìmpsêgøðx,antonidas,192,demonhunter,havoc,6,2,4
Sweåfy,outland,192,demonhunter,havoc,6,2,4
Azzinoth,outland,192,demonhunter,havoc,6,2,4
Inflection,ravencrest,192,demonhunter,havoc,12,2,10
Badess,malfurion,192,demonhunter,havoc,12,2,10
Gagfordaddy,ravencrest,192,demonhunter,havoc,12,2,10
Mettdaemon,ravencrest,192,demonhunter,havoc,12,2,10
Zaydra,the-maelstrom,192,demonhunter,havoc,12,2,10
Парагони,gordunni,192,demonhunter,havoc,12,2,10
Enygamy,frostmane,192,demonhunter,havoc,12,2,10
Spideymon,ragnaros,192,demonhunter,havoc,12,2,10
Gouteça,la-croisade-écarlate,192,demonhunter,havoc,12,2,10
Tôx,dalaran,192,demonhunter,havoc,12,2,10
Drâparn,sylvanas,192,demonhunter,havoc,12,2,10
Zynês,draenor,192,demonhunter,havoc,12,2,10
Ekhlipz,ysondre,192,demonhunter,havoc,12,2,10
Deehoh,twisting-nether,192,demonhunter,havoc,12,2,10
Ûro,dun-modr,192,demonhunter,havoc,12,2,10
Bobdh,twisting-nether,192,demonhunter,havoc,17,2,15
Deathniresa,argent-dawn,191,demonhunter,havoc,6,2,4
Hellforce,nemesis,191,demonhunter,havoc,6,2,4
Noorrd,hyjal,191,demonhunter,havoc,12,2,10
Manjirosano,blackmoore,191,demonhunter,havoc,12,2,10
Lilarii,argent-dawn,191,demonhunter,havoc,12,2,10
Onorera,tarren-mill,160,demonhunter,havoc,10,2,8
Dârhma,archimonde,159,demonhunter,havoc,5,2,3
Galafel,outland,159,demonhunter,havoc,5,2,3
Kélida,dun-modr,144,demonhunter,havoc,9,2,7
Amatèrasu,burning-legion,110,demonhunter,havoc,13,2,11
Felsbane,argent-dawn,96,demonhunter,havoc,3,2,1
Tòd,silvermoon,96,demonhunter,havoc,6,1,5
Stàmàzza,nemesis,96,demonhunter,havoc,6,1,5
Riñ,twisting-nether,96,demonhunter,havoc,6,1,5
Reikuel,nemesis,96,demonhunter,havoc,6,1,5
Ryuhayabusa,stormscale,96,demonhunter,havoc,6,1,5
Nagh,archimonde,96,demonhunter,havoc,6,1,5
Cruptiq,kazzak,96,demonhunter,havoc,6,1,5
Bitex,archimonde,96,demonhunter,havoc,6,1,5
Mlecznygolem,silvermoon,96,demonhunter,havoc,6,1,5
Stormma,kazzak,96,demonhunter,havoc,6,1,5
Jiínx,kazzak,96,demonhunter,havoc,6,1,5
Teimotevey,silvermoon,96,demonhunter,havoc,6,1,5
Dhgoddess,ravencrest,96,demonhunter,havoc,6,1,5
Сочняга,gordunni,96,demonhunter,havoc,6,1,5
Blulake,silvermoon,96,demonhunter,havoc,6,1,5
Аззазэль,howling-fjord,96,demonhunter,havoc,6,1,5
Evlos,hyjal,96,demonhunter,havoc,6,1,5
Cameclc,hyjal,96,demonhunter,havoc,6,1,5
Ганстапутин,howling-fjord,96,demonhunter,havoc,6,1,5
Соларт,howling-fjord,96,demonhunter,havoc,6,1,5
Vrazjababa,dragonmaw,96,demonhunter,havoc,6,1,5
Найлинель,fordragon,96,demonhunter,havoc,6,1,5
Cmi,tarren-mill,96,demonhunter,havoc,6,1,5
Norebb,sanguino,96,demonhunter,havoc,6,1,5
Camotheck,stormscale,96,demonhunter,havoc,6,1,5
Läderjoel,ravencrest,96,demonhunter,havoc,6,1,5
Malvax,tarren-mill,96,demonhunter,havoc,6,1,5
Aygael,archimonde,96,demonhunter,havoc,6,1,5
Flasqo,eredar,96,demonhunter,havoc,6,1,5
Askari,lothar,96,demonhunter,havoc,6,1,5
Burritodh,tarren-mill,96,demonhunter,havoc,6,1,5
Esthá,argent-dawn,96,demonhunter,havoc,6,1,5
Ilovesabrina,dun-modr,96,demonhunter,havoc,6,1,5
Annee,eredar,96,demonhunter,havoc,6,1,5
Giace,drakthul,96,demonhunter,havoc,6,1,5
Dýlän,argent-dawn,96,demonhunter,havoc,6,1,5
Demonicat,twisting-nether,96,demonhunter,havoc,6,1,5
Illidarios,blackhand,96,demonhunter,havoc,6,1,5
Kiô,drakthul,96,demonhunter,havoc,6,1,5
Äzot,burning-legion,96,demonhunter,havoc,6,1,5
Maikko,los-errantes,96,demonhunter,havoc,6,1,5
Hørnyßæ,drakthul,96,demonhunter,havoc,6,1,5
Daekon,ahnqiraj,96,demonhunter,havoc,6,1,5
Trinchensdh,blackhand,96,demonhunter,havoc,6,1,5
Ghetzlel,draenor,96,demonhunter,havoc,6,1,5
Спокоивич,soulflayer,96,demonhunter,havoc,6,1,5
Максимлолпро,howling-fjord,96,demonhunter,havoc,6,1,5
Джэкмэн,soulflayer,96,demonhunter,havoc,6,1,5
Синнэрлити,soulflayer,96,demonhunter,havoc,6,1,5
Demongorgon,arathor,96,demonhunter,havoc,6,1,5
Shylaría,blackhand,96,demonhunter,havoc,6,1,5
Pkdaemon,draenor,96,demonhunter,havoc,6,1,5
Ellare,burning-blade,96,demonhunter,havoc,6,1,5
Destructs,sylvanas,96,demonhunter,havoc,6,1,5
Bradzdh,outland,96,demonhunter,havoc,6,1,5
Sgit,doomhammer,96,demonhunter,havoc,6,1,5
Nairu,doomhammer,96,demonhunter,havoc,6,1,5
Zarafel,hyjal,96,demonhunter,havoc,6,1,5
Blish,blackhand,96,demonhunter,havoc,6,1,5
Jyzu,festung-der-stürme,96,demonhunter,havoc,6,1,5
Ripgodx,bronzebeard,96,demonhunter,havoc,6,1,5
Gucknicht,blackrock,96,demonhunter,havoc,6,1,5
Niqel,blackrock,96,demonhunter,havoc,6,1,5
Wìxx,blackrock,96,demonhunter,havoc,6,1,5
Babyyéah,sunstrider,96,demonhunter,havoc,12,1,11
Ecthelionn,outland,96,demonhunter,havoc,12,1,11
Jásírá,shattrath,96,demonhunter,havoc,12,1,11
Shinarei,silvermoon,95,demonhunter,havoc,6,1,5
Deamo,stormscale,79,demonhunter,havoc,5,1,4
Elldarion,blackhand,79,demonhunter,havoc,5,1,4
Caluxe,blackmoore,79,demonhunter,havoc,5,1,4
Omegasyx,dun-modr,64,demonhunter,havoc,4,1,3
Гадх,gordunni,42,demonhunter,havoc,8,2,6
Greyfel,blackhand,31,demonhunter,havoc,2,1,1
Sinjinzoo,blackrock,31,demonhunter,havoc,2,1,1
Herzbann,madmortem,16,demonhunter,havoc,1,1,0
Vengeancezin,frostwhisper,2000,demonhunter,vengeance,126,67,59
Jedidiah,aggra-português,1667,demonhunter,vengeance,39,19,20
Zarín,outland,1394,demonhunter,vengeance,78,41,37
Strqt,archimonde,862,demonhunter,vengeance,18,9,9
Kubusz,ravencrest,856,demonhunter,vengeance,30,12,18
Kekburagól,kazzak,575,demonhunter,vengeance,12,6,6
Demonlucy,colinas-pardas,287,demonhunter,vengeance,12,3,9
Askari,lothar,192,demonhunter,vengeance,6,2,4
Геммула,howling-fjord,192,demonhunter,vengeance,6,2,4
Camtoe,ravencrest,192,demonhunter,vengeance,6,2,4
Enithy,twisting-nether,192,demonhunter,vengeance,6,2,4
Сумърак,grom,192,demonhunter,vengeance,12,2,10
Xenits,kazzak,96,demonhunter,vengeance,6,1,5
Arussil,pozzo-delleternità,96,demonhunter,vengeance,6,1,5
Zarafel,hyjal,95,demonhunter,vengeance,12,1,11
Hibibi,kazzak,2257,druid,restoration,113,66,47
Kev,elune,2190,druid,restoration,185,102,83
Pegasu,kelthuzad,2182,druid,restoration,114,66,48
Vanostboom,kazzak,2181,druid,restoration,88,50,38
Iloveher,ravencrest,2180,druid,restoration,160,89,71
Miouzy,archimonde,2156,druid,restoration,66,36,30
Årt,ravencrest,2155,druid,restoration,132,72,60
Unohanâ,archimonde,2103,druid,restoration,108,65,43
Nesedondon,stormscale,2101,druid,restoration,60,44,16
Trèes,outland,2074,druid,restoration,192,107,85
Angrykejton,silvermoon,2066,druid,restoration,240,125,115
Dendariottvx,sunstrider,2042,druid,restoration,73,44,29
Bambambimbim,draenor,2023,druid,restoration,84,44,40
Afky,stormreaver,2021,druid,restoration,90,47,43
Yoogy,ravencrest,1995,druid,restoration,60,37,23
Shinöbü,sanguino,1995,druid,restoration,69,42,27
Rives,sylvanas,1978,druid,restoration,78,46,32
Tjxaxa,ravencrest,1966,druid,restoration,78,38,40
Galadronìa,aegwynn,1960,druid,restoration,65,38,27
Mentallyill,ravencrest,1949,druid,restoration,204,106,98
Thotz,kazzak,1949,druid,restoration,132,65,67
Sheippi,stormreaver,1945,druid,restoration,54,31,23
Acondris,kazzak,1944,druid,restoration,96,45,51
Håbibi,kazzak,1936,druid,restoration,48,25,23
Skrrlock,ravencrest,1923,druid,restoration,108,53,55
Syví,outland,1912,druid,restoration,59,29,30
Hånukkah,outland,1911,druid,restoration,58,29,29
Lunamimi,argent-dawn,1899,druid,restoration,254,132,122
Thugzie,kazzak,1896,druid,restoration,53,26,27
Thysabtw,archimonde,1894,druid,restoration,53,33,20
Amaré,burning-legion,1893,druid,restoration,48,26,22
Ovérheal,ravencrest,1889,druid,restoration,59,33,26
Drjmy,silvermoon,1887,druid,restoration,48,38,10
Maxpojke,ravencrest,1876,druid,restoration,142,88,54
Niksidruid,grim-batol,1868,druid,restoration,28,21,7
Ralaa,guldan,1865,druid,restoration,54,29,25
Arthéas,archimonde,1865,druid,restoration,174,89,85
Hadok,azjolnerub,1865,druid,restoration,78,34,44
Naffelle,ysondre,1862,druid,restoration,71,34,37
Threesixnìne,dun-morogh,1857,druid,restoration,66,39,27
Druidrak,eredar,1855,druid,restoration,66,32,34
Lalalime,arthas,1851,druid,restoration,64,31,33
Clone,aegwynn,1849,druid,restoration,96,55,41
Nastycat,magtheridon,1849,druid,restoration,179,88,91
Åä,ravencrest,1837,druid,restoration,32,20,12
Thebiggest,ravencrest,1836,druid,restoration,42,25,17
Andr,voljin,1835,druid,restoration,60,26,34
Jmdr,silvermoon,1830,druid,restoration,71,31,40
Spamclone,draenor,1828,druid,restoration,57,30,27
Kanyevotèrx,ravencrest,1828,druid,restoration,54,25,29
Gummysnake,aszune,1823,druid,restoration,42,25,17
Zydrux,outland,1822,druid,restoration,48,36,12
Theatrex,ravencrest,1820,druid,restoration,147,85,62
Doodlez,blackrock,1820,druid,restoration,60,27,33
Baawz,blackmoore,1820,druid,restoration,60,25,35
Metagrass,stormscale,1818,druid,restoration,129,59,70
Skadooshee,kazzak,1816,druid,restoration,36,19,17
Køngx,blackhand,1812,druid,restoration,125,64,61
Sorryblya,ravencrest,1809,druid,restoration,60,26,34
Promethezine,tarren-mill,1807,druid,restoration,147,78,69
Мафио,blackscar,1805,druid,restoration,48,25,23
Asaj,argent-dawn,1804,druid,restoration,189,106,83
Riplilpeep,grim-batol,1803,druid,restoration,54,28,26
Gaeldeth,silvermoon,1802,druid,restoration,105,63,42
Wraithshape,stormscale,1800,druid,restoration,60,32,28
Tedel,kazzak,1791,druid,restoration,53,33,20
Reins,silvermoon,1786,druid,restoration,84,45,39
Jìnró,ravencrest,1782,druid,restoration,129,63,66
Chas,ravencrest,1776,druid,restoration,42,25,17
Weezíng,ysondre,1771,druid,restoration,44,27,17
Heçtôr,silvermoon,1767,druid,restoration,60,27,33
Dokixo,kazzak,1766,druid,restoration,35,19,16
Chacopic,archimonde,1764,druid,restoration,114,58,56
Gøðførm,silvermoon,1758,druid,restoration,118,63,55
Wéédmâñ,ravencrest,1756,druid,restoration,45,30,15
Jaytiz,ravencrest,1753,druid,restoration,41,21,20
Hizzy,burning-legion,1751,druid,restoration,243,119,124
Migami,nemesis,1748,druid,restoration,65,27,38
Matteps,outland,1742,druid,restoration,41,19,22
Дикаякиара,blackscar,1741,druid,restoration,149,68,81
Улдрэйн,deathguard,1739,druid,restoration,66,38,28
Qjkuug,twisting-nether,1737,druid,restoration,130,78,52
Lifelover,outland,1734,druid,restoration,48,23,25
Skrood,kazzak,1732,druid,restoration,48,25,23
Bëstwôrld,archimonde,1732,druid,restoration,64,32,32
Druncha,sunstrider,1726,druid,restoration,102,38,64
Филавтия,gordunni,1724,druid,restoration,60,32,28
Josedudu,twisting-nether,1722,druid,restoration,48,21,27
Treliuz,twilights-hammer,1718,druid,restoration,212,117,95
Druidella,stormscale,1716,druid,restoration,30,18,12
Alolexx,archimonde,1711,druid,restoration,30,18,12
Крашдру,gordunni,1710,druid,restoration,28,20,8
Muraebbasta,pozzo-delleternità,1709,druid,restoration,42,18,24
Bloomitize,ravencrest,1708,druid,restoration,54,23,31
Sintiq,silvermoon,1705,druid,restoration,41,24,17
Wraithmoon,stormscale,1705,druid,restoration,36,18,18
Moonbee,burning-blade,1704,druid,restoration,42,28,14
Kìttÿ,dun-modr,1703,druid,restoration,30,19,11
Hólo,blackrock,1701,druid,restoration,47,24,23
Moondra,outland,1688,druid,restoration,95,39,56
Luhmanish,thunderhorn,1684,druid,restoration,102,52,50
Nasduck,ravencrest,1680,druid,restoration,40,27,13
Erika,vashj,1676,druid,restoration,48,26,22
Buffbloom,auchindoun,1668,druid,restoration,126,67,59
Eedaza,argent-dawn,1665,druid,restoration,75,38,37
Funnyjoker,outland,1665,druid,restoration,36,18,18
Joksica,draenor,1664,druid,restoration,35,20,15
Builtdiffy,kazzak,1659,druid,restoration,190,98,92
Demerit,aegwynn,1657,druid,restoration,32,18,14
Sélia,sylvanas,1657,druid,restoration,116,57,59
Bâneth,destromath,1656,druid,restoration,60,33,27
Olaphy,elune,1653,druid,restoration,155,77,78
Catgirlx,ravencrest,1652,druid,restoration,42,26,16
Orayin,ravencrest,1649,druid,restoration,60,43,17
Pogoth,turalyon,1641,druid,restoration,72,38,34
Praetorian,sylvanas,1638,druid,restoration,90,40,50
Drøødis,archimonde,1636,druid,restoration,42,24,18
Чухх,howling-fjord,1636,druid,restoration,52,29,23
Trèes,draenor,1636,druid,restoration,46,22,24
Adjaara,ravencrest,1635,druid,restoration,115,68,47
Pardus,ambossar,1635,druid,restoration,50,27,23
Rawri,blackmoore,1633,druid,restoration,48,26,22
Рамзес,gordunni,1631,druid,restoration,30,20,10
Mafiasnipe,ravencrest,1630,druid,restoration,24,17,7
Friedbrocolí,tarren-mill,1629,druid,restoration,30,17,13
Asga,stormscale,1628,druid,restoration,30,17,13
Джелони,soulflayer,1626,druid,restoration,36,17,19
Mortalnight,sinstralis,1625,druid,restoration,194,99,95
Tropjeune,dalaran,1623,druid,restoration,36,17,19
Frances,auchindoun,1622,druid,restoration,51,30,21
Pawful,malganis,1621,druid,restoration,83,50,33
Bellatrx,darksorrow,1620,druid,restoration,36,21,15
Миледистайпи,gordunni,1619,druid,restoration,32,18,14
Floka,archimonde,1617,druid,restoration,48,30,18
Elu,eredar,1617,druid,restoration,48,28,20
Diolives,stormscale,1617,druid,restoration,180,95,85
Nancey,auchindoun,1617,druid,restoration,149,75,74
Wømbat,ravencrest,1616,druid,restoration,36,17,19
Goldrax,outland,1615,druid,restoration,24,17,7
Драменбейз,gordunni,1615,druid,restoration,42,20,22
Xoriauz,archimonde,1609,druid,restoration,78,37,41
Slaugh,zuljin,1608,druid,restoration,48,20,28
Опапенелопа,blackscar,1607,druid,restoration,39,27,12
Bigmeandruid,twisting-nether,1606,druid,restoration,30,17,13
Jcpenney,xavius,1605,druid,restoration,124,63,61
Bîrke,blackrock,1604,druid,restoration,36,17,19
Naraia,aegwynn,1602,druid,restoration,30,17,13
Watchmebear,stormscale,1601,druid,restoration,42,23,19
Ðarckness,kazzak,1600,druid,restoration,24,17,7
Swifte,argent-dawn,1600,druid,restoration,48,27,21
Akmón,tarren-mill,1600,druid,restoration,58,20,38
Ittei,korgall,1596,druid,restoration,120,63,57
Hyggefinger,ravencrest,1596,druid,restoration,42,19,23
Zhosy,shattrath,1583,druid,restoration,55,20,35
Diriculous,kazzak,1575,druid,restoration,54,18,36
Ninadobrev,ragnaros,1568,druid,restoration,33,18,15
Sandirion,silvermoon,1567,druid,restoration,404,204,200
Eyvimel,ravencrest,1561,druid,restoration,78,43,35
Kheazar,blackmoore,1558,druid,restoration,103,61,42
Rhonir,twisting-nether,1558,druid,restoration,41,18,23
Crïn,ravencrest,1553,druid,restoration,36,17,19
Néllä,archimonde,1552,druid,restoration,36,25,11
Slayced,blackrock,1550,druid,restoration,35,21,14
Bearform,blackhand,1548,druid,restoration,48,23,25
Khunahype,thrall,1546,druid,restoration,88,48,40
Атмос,deathguard,1541,druid,restoration,124,72,52
Trollisha,mannoroth,1540,druid,restoration,233,109,124
Нубстримсс,gordunni,1538,druid,restoration,82,38,44
Tôrmêñtêd,outland,1535,druid,restoration,99,62,37
Devióus,twilights-hammer,1533,druid,restoration,131,68,63
Kundz,dalaran,1530,druid,restoration,148,81,67
Eviscreator,stormscale,1529,druid,restoration,45,27,18
Kætachy,archimonde,1529,druid,restoration,42,16,26
Hasselhoof,eredar,1526,druid,restoration,63,26,37
Xalio,ravencrest,1525,druid,restoration,45,29,16
Deluron,malganis,1525,druid,restoration,113,59,54
Lyvuni,blackmoore,1524,druid,restoration,54,33,21
Bjoernbrudn,ravencrest,1524,druid,restoration,30,16,14
Skillfall,ravencrest,1524,druid,restoration,42,16,26
Bloomies,tarren-mill,1522,druid,restoration,88,53,35
Dwaokut,ravencrest,1514,druid,restoration,47,24,23
Asanaria,ravencrest,1513,druid,restoration,56,25,31
Rozi,draenor,1512,druid,restoration,24,16,8
Arogane,outland,1512,druid,restoration,63,32,31
Homek,eredar,1505,druid,restoration,42,24,18
Feelstreeman,twisting-nether,1504,druid,restoration,77,42,35
Lÿter,dun-modr,1502,druid,restoration,42,18,24
Setztes,tarren-mill,1494,druid,restoration,61,34,27
Kicki,outland,1494,druid,restoration,66,34,32
Маккаланн,soulflayer,1493,druid,restoration,48,30,18
Rougetreize,khaz-modan,1490,druid,restoration,30,16,14
Atôtheex,kazzak,1488,druid,restoration,43,21,22
Haszard,outland,1485,druid,restoration,82,35,47
Scorlok,eredar,1484,druid,restoration,50,30,20
Scra,anubarak,1482,druid,restoration,83,45,38
Legyna,ravencrest,1481,druid,restoration,41,25,16
Pureballs,twisting-nether,1477,druid,restoration,165,93,72
Nyxxz,shattered-hand,1477,druid,restoration,36,19,17
Zaerox,ambossar,1474,druid,restoration,48,23,25
Kukisanban,stormscale,1472,druid,restoration,193,109,84
Eeivi,argent-dawn,1467,druid,restoration,111,60,51
Trúdl,das-konsortium,1466,druid,restoration,24,18,6
Jtepdru,ravencrest,1466,druid,restoration,85,43,42
Drbse,silvermoon,1461,druid,restoration,56,28,28
Bammedrudu,archimonde,1459,druid,restoration,30,17,13
Spliçe,draenor,1458,druid,restoration,42,21,21
Xôárqt,aegwynn,1458,druid,restoration,66,29,37
Ёу,soulflayer,1454,druid,restoration,77,34,43
Ööh,outland,1453,druid,restoration,48,25,23
Warami,eredar,1453,druid,restoration,54,24,30
Eaglefox,aszune,1452,druid,restoration,47,21,26
Euskal,chogall,1451,druid,restoration,42,18,24
Tamburoo,tarren-mill,1449,druid,restoration,119,52,67
Велаине,soulflayer,1447,druid,restoration,99,53,46
Vashiko,tarren-mill,1446,druid,restoration,83,41,42
Bägira,sylvanas,1444,druid,restoration,107,60,47
Flum,darksorrow,1441,druid,restoration,148,77,71
Xyruden,kazzak,1441,druid,restoration,171,69,102
Panigale,dun-modr,1438,druid,restoration,30,15,15
Ына,gordunni,1438,druid,restoration,81,39,42
Síggíe,eredar,1436,druid,restoration,30,17,13
Shredzz,ravencrest,1436,druid,restoration,36,15,21
Hellofresh,silvermoon,1436,druid,restoration,42,17,25
Блумха,howling-fjord,1435,druid,restoration,66,34,32
Andromedda,twisting-nether,1435,druid,restoration,66,31,35
Aesha,los-errantes,1434,druid,restoration,30,15,15
Evílz,kazzak,1431,druid,restoration,24,15,9
Làhen,ravencrest,1431,druid,restoration,58,27,31
Guccicken,garona,1430,druid,restoration,100,53,47
Брэвно,gordunni,1430,druid,restoration,225,116,109
Thanom,auchindoun,1428,druid,restoration,181,92,89
Kittý,terokkar,1427,druid,restoration,156,76,80
Analmonstret,shattered-hand,1427,druid,restoration,35,17,18
Halyconwings,outland,1424,druid,restoration,51,24,27
Tunling,ravencrest,1423,druid,restoration,30,20,10
Ilyethea,earthen-ring,1420,druid,restoration,386,206,180
Lukass,drakthul,1420,druid,restoration,107,56,51
Mindru,sylvanas,1417,druid,restoration,45,22,23
Styleexd,ragnaros,1408,druid,restoration,63,34,29
Plàntz,tarren-mill,1406,druid,restoration,79,39,40
Фапдрим,howling-fjord,1404,druid,restoration,60,29,31
Dûdûrînâ,blackrock,1400,druid,restoration,24,15,9
Wenciorek,kazzak,1400,druid,restoration,75,37,38
Ghaara,outland,1399,druid,restoration,46,28,18
Друлёнышь,eversong,1394,druid,restoration,125,65,60
Clovér,outland,1394,druid,restoration,30,15,15
Maethar,stormrage,1393,druid,restoration,87,53,34
Shufflê,blackmoore,1392,druid,restoration,125,57,68
Cörelly,ravencrest,1385,druid,restoration,181,106,75
Катяблум,gordunni,1375,druid,restoration,60,24,36
Kajiun,silvermoon,1373,druid,restoration,36,21,15
Badbloom,ravencrest,1370,druid,restoration,46,22,24
Balanc,ragnaros,1366,druid,restoration,42,22,20
Bigßoi,stormscale,1364,druid,restoration,78,41,37
Solàryx,hyjal,1364,druid,restoration,42,20,22
Lindémann,blackhand,1363,druid,restoration,24,15,9
Wooshy,kazzak,1358,druid,restoration,40,17,23
Zwierzyniec,jaedenar,1357,druid,restoration,60,27,33
Ивантяй,gordunni,1349,druid,restoration,107,52,55
Zaeli,archimonde,1344,druid,restoration,24,14,10
Acxaryl,ravencrest,1343,druid,restoration,30,14,16
Mòzat,stormscale,1342,druid,restoration,24,14,10
Kyomã,burning-legion,1342,druid,restoration,36,14,22
Cplazi,kazzak,1341,druid,restoration,24,14,10
Kooglaash,kazzak,1335,druid,restoration,85,41,44
Supremecat,kazzak,1335,druid,restoration,36,17,19
Shifthappénz,draenor,1334,druid,restoration,60,28,32
Ooktharg,turalyon,1332,druid,restoration,24,14,10
Вакидзами,gordunni,1331,druid,restoration,48,28,20
Fabsl,archimonde,1330,druid,restoration,30,14,16
Khalec,silvermoon,1327,druid,restoration,24,17,7
Scaleo,stormreaver,1326,druid,restoration,42,26,16
Knzm,dun-modr,1323,druid,restoration,120,62,58
Wwvwwvwwvwvw,burning-legion,1322,druid,restoration,69,23,46
Вексиус,gordunni,1321,druid,restoration,24,14,10
Koemarkt,sunstrider,1319,druid,restoration,46,29,17
Béccàbtw,draenor,1318,druid,restoration,24,14,10
Yenwe,kazzak,1317,druid,restoration,124,65,59
Крайсонг,soulflayer,1316,druid,restoration,36,18,18
Idect,silvermoon,1314,druid,restoration,106,55,51
Nayokô,grim-batol,1310,druid,restoration,30,15,15
Rabacki,blackmoore,1310,druid,restoration,38,16,22
Mangy,xavius,1309,druid,restoration,78,39,39
Иггдрассиль,blackscar,1309,druid,restoration,30,15,15
Bloompuf,draenor,1309,druid,restoration,36,14,22
Dafapa,twilights-hammer,1306,druid,restoration,30,14,16
Nasgra,malganis,1305,druid,restoration,35,14,21
Друидсимба,howling-fjord,1296,druid,restoration,93,49,44
Ekologiskxx,outland,1296,druid,restoration,85,40,45
Wannabanhere,outland,1295,druid,restoration,41,16,25
Callìa,sylvanas,1294,druid,restoration,36,18,18
Leliaen,sylvanas,1291,druid,restoration,51,28,23
Shelby,tirion,1291,druid,restoration,69,36,33
Microw,ghostlands,1289,druid,restoration,51,28,23
Varrdru,kazzak,1288,druid,restoration,91,42,49
Hideme,tarren-mill,1288,druid,restoration,42,15,27
Кнесис,howling-fjord,1286,druid,restoration,25,17,8
Рефикс,gordunni,1286,druid,restoration,91,57,34
Feinberg,stormscale,1286,druid,restoration,42,14,28
Хуссипусси,galakrond,1285,druid,restoration,29,14,15
Seikoo,defias-brotherhood,1284,druid,restoration,91,41,50
Ninø,gorgonnash,1282,druid,restoration,42,23,19
Paawz,stormscale,1281,druid,restoration,65,33,32
Kaamirach,blackmoore,1280,druid,restoration,23,16,7
Chinoiserie,aszune,1277,druid,restoration,156,83,73
Урька,blackscar,1272,druid,restoration,59,26,33
Cubalitis,tarren-mill,1271,druid,restoration,36,22,14
Basajáun,dun-modr,1268,druid,restoration,42,15,27
Mchots,ragnaros,1267,druid,restoration,95,42,53
Walexx,kazzak,1266,druid,restoration,44,25,19
Delmond,sylvanas,1266,druid,restoration,185,93,92
Nalreaa,kazzak,1265,druid,restoration,48,27,21
Lalon,blackrock,1265,druid,restoration,48,24,24
Elainx,thrall,1264,druid,restoration,30,16,14
Обейрин,gordunni,1261,druid,restoration,78,40,38
Wazam,kazzak,1261,druid,restoration,86,43,43
Cuxorb,rexxar,1259,druid,restoration,48,21,27
Delarion,nemesis,1258,druid,restoration,36,21,15
Liquis,outland,1249,druid,restoration,109,56,53
Surfingbirdx,ragnaros,1248,druid,restoration,24,13,11
Loleh,ragnaros,1247,druid,restoration,24,13,11
Deltsur,stormscale,1247,druid,restoration,35,17,18
Boomayé,archimonde,1246,druid,restoration,36,22,14
Lamatoes,ravencrest,1246,druid,restoration,30,13,17
Doodougie,silvermoon,1245,druid,restoration,30,13,17
Hotlotta,aegwynn,1244,druid,restoration,24,13,11
Crep,krasus,1243,druid,restoration,30,21,9
Bellhooks,blackrock,1239,druid,restoration,24,13,11
Ironveins,ravencrest,1238,druid,restoration,42,28,14
Grololotte,dalaran,1238,druid,restoration,24,14,10
ßløøm,outland,1236,druid,restoration,24,16,8
Zaratras,arathor,1230,druid,restoration,50,23,27
Zelíx,bronzebeard,1229,druid,restoration,42,28,14
Корнерит,gordunni,1229,druid,restoration,82,43,39
Lucael,blackmoore,1228,druid,restoration,42,16,26
Vanlise,ravencrest,1227,druid,restoration,42,20,22
Acwi,dun-morogh,1226,druid,restoration,72,36,36
Weregoon,blackmoore,1225,druid,restoration,191,91,100
Arear,frostmane,1225,druid,restoration,42,20,22
Wagoneis,grim-batol,1224,druid,restoration,28,14,14
Sgtdrood,archimonde,1223,druid,restoration,30,13,17
Fettpumpad,karazhan,1221,druid,restoration,103,59,44
Cazzette,grim-batol,1220,druid,restoration,40,24,16
Siako,sanguino,1218,druid,restoration,71,32,39
Vícvega,ravencrest,1213,druid,restoration,24,15,9
Deretus,blackmoore,1213,druid,restoration,34,13,21
Dreaddot,archimonde,1210,druid,restoration,24,13,11
Jehtrotull,nemesis,1210,druid,restoration,37,17,20
Autoritär,gilneas,1209,druid,restoration,49,26,23
Irondruid,silvermoon,1208,druid,restoration,70,39,31
Ubbeleg,kazzak,1206,druid,restoration,30,18,12
Bjútiful,silvermoon,1206,druid,restoration,29,13,16
Дилайт,blackscar,1201,druid,restoration,30,13,17
Namenloser,azshara,1200,druid,restoration,72,39,33
Juicy,stormreaver,1194,druid,restoration,36,21,15
Amakary,blackrock,1193,druid,restoration,42,19,23
Bonza,agamaggan,1191,druid,restoration,30,14,16
Plsbuffdruid,ravencrest,1189,druid,restoration,28,14,14
Chable,hyjal,1187,druid,restoration,60,31,29
Jiujiteiro,tarren-mill,1184,druid,restoration,47,26,21
Collîî,aegwynn,1183,druid,restoration,44,25,19
Røxhot,archimonde,1182,druid,restoration,23,13,10
Inkeyes,outland,1182,druid,restoration,107,45,62
Mitnik,stormscale,1180,druid,restoration,104,58,46
Papanik,tarren-mill,1179,druid,restoration,54,30,24
Amberleaff,auchindoun,1178,druid,restoration,31,16,15
Julss,archimonde,1176,druid,restoration,36,15,21
Hílarío,sanguino,1174,druid,restoration,38,13,25
Diastra,silvermoon,1168,druid,restoration,42,18,24
Halleyz,hyjal,1165,druid,restoration,117,61,56
Bynxx,antonidas,1163,druid,restoration,118,57,61
Дудумейстер,howling-fjord,1160,druid,restoration,144,60,84
Røsary,stormscale,1156,druid,restoration,81,43,38
Mochiløxz,tarren-mill,1155,druid,restoration,24,13,11
Walenok,thrall,1155,druid,restoration,185,90,95
Cäsïo,khaz-modan,1154,druid,restoration,54,32,22
Ceapamatii,sylvanas,1153,druid,restoration,30,15,15
Lfsecondreju,ravencrest,1151,druid,restoration,18,12,6
Myndrá,varimathras,1151,druid,restoration,24,12,12
Dreathqt,twisting-nether,1150,druid,restoration,24,12,12
Rozt,ravencrest,1150,druid,restoration,24,12,12
Hatecrew,twisting-nether,1147,druid,restoration,18,12,6
Weiden,twisting-nether,1147,druid,restoration,24,13,11
Olympïee,archimonde,1147,druid,restoration,24,12,12
Elmáestró,aegwynn,1146,druid,restoration,24,12,12
Shiftway,stormscale,1145,druid,restoration,24,12,12
Utopiah,ravencrest,1144,druid,restoration,18,12,6
Trànsformer,nemesis,1142,druid,restoration,30,12,18
Adiycrazy,outland,1138,druid,restoration,54,22,32
Hót,ravencrest,1138,druid,restoration,42,14,28
Arfedan,kazzak,1136,druid,restoration,42,24,18
Exane,ragnaros,1132,druid,restoration,24,14,10
Bioházard,blackrock,1129,druid,restoration,30,17,13
Räysa,archimonde,1127,druid,restoration,133,68,65
Dadud,twisting-nether,1126,druid,restoration,30,18,12
Hashtagone,ysondre,1124,druid,restoration,29,12,17
Tsuteymanga,veknilash,1123,druid,restoration,60,28,32
Sinthorasia,blackrock,1122,druid,restoration,24,12,12
Maryjuanita,silvermoon,1122,druid,restoration,104,43,61
Raysa,archimonde,1119,druid,restoration,69,35,34
Ndnd,drakthul,1112,druid,restoration,82,42,40
Сваткумбрат,eversong,1110,druid,restoration,78,26,52
Dobbmaster,aegwynn,1107,druid,restoration,222,113,109
Fotmrerollér,darksorrow,1103,druid,restoration,30,20,10
Mendozä,stormscale,1103,druid,restoration,55,28,27
Zirkuszwei,aegwynn,1102,druid,restoration,29,14,15
Эверих,soulflayer,1102,druid,restoration,28,13,15
Snowrk,hyjal,1101,druid,restoration,36,22,14
Ankhenature,outland,1100,druid,restoration,71,40,31
Ccmydcv,archimonde,1095,druid,restoration,25,13,12
Yespapa,kazzak,1089,druid,restoration,129,72,57
Farodiin,blackmoore,1087,druid,restoration,48,24,24
Relache,twisting-nether,1086,druid,restoration,42,23,19
Vurgyl,hyjal,1079,druid,restoration,54,33,21
Vranz,draenor,1074,druid,restoration,54,24,30
Bloomly,tarren-mill,1073,druid,restoration,36,18,18
Eko,auchindoun,1073,druid,restoration,75,35,40
Алунар,lich-king,1070,druid,restoration,84,39,45
Киберужас,gordunni,1069,druid,restoration,116,54,62
Betelgues,kazzak,1067,druid,restoration,54,31,23
Spidete,sanguino,1067,druid,restoration,66,36,30
Elanrya,argent-dawn,1066,druid,restoration,53,15,38
Gyvunas,silvermoon,1065,druid,restoration,37,22,15
Mutato,draenor,1065,druid,restoration,156,82,74
Аматэррасу,blackscar,1065,druid,restoration,30,15,15
Midnightstry,alakir,1064,druid,restoration,84,42,42
Moonshîne,arygos,1063,druid,restoration,41,26,15
Digestivebis,defias-brotherhood,1062,druid,restoration,54,31,23
Hypnosoad,outland,1062,druid,restoration,76,31,45
Justforgames,ravencrest,1056,druid,restoration,12,11,1
Bananadru,stormscale,1056,druid,restoration,18,11,7
Kobrá,ravencrest,1056,druid,restoration,18,11,7
Niknoom,azjolnerub,1056,druid,restoration,54,32,22
Asklepion,twisting-nether,1056,druid,restoration,24,11,13
Хлайси,gordunni,1056,druid,restoration,24,11,13
Sprøut,drakthul,1056,druid,restoration,24,11,13
Weisslogia,aegwynn,1055,druid,restoration,18,11,7
Дуггизавр,howling-fjord,1055,druid,restoration,24,11,13
Oschlandor,blackmoore,1054,druid,restoration,12,11,1
Shenandoah,hyjal,1054,druid,restoration,30,14,16
Solern,ravencrest,1054,druid,restoration,24,11,13
Azchuk,blackmoore,1054,druid,restoration,24,11,13
Светдру,blackscar,1054,druid,restoration,24,11,13
Wernøs,archimonde,1054,druid,restoration,27,12,15
Тчаёк,gordunni,1052,druid,restoration,21,13,8
Phala,outland,1052,druid,restoration,24,11,13
Xenva,blackmoore,1052,druid,restoration,30,13,17
Benjosef,blackmoore,1051,druid,restoration,62,31,31
Азя,blackscar,1050,druid,restoration,24,11,13
Moonfan,darkmoon-faire,1049,druid,restoration,36,14,22
Lestty,the-maelstrom,1048,druid,restoration,18,11,7
Cptfalcony,outland,1048,druid,restoration,18,11,7
Влажныйдру,soulflayer,1048,druid,restoration,24,11,13
Felfran,ravencrest,1047,druid,restoration,36,13,23
Sodamncute,ravencrest,1046,druid,restoration,24,11,13
Greengolly,argent-dawn,1042,druid,restoration,30,11,19
Luarbak,kazzak,1041,druid,restoration,18,11,7
Ковамедведь,borean-tundra,1035,druid,restoration,30,11,19
Cárnagè,stormscale,1034,druid,restoration,74,32,42
Mirana,drakthul,1032,druid,restoration,24,13,11
Xadidruîd,blackrock,1030,druid,restoration,42,11,31
Degentiuso,alakir,1029,druid,restoration,18,14,4
Storpboom,drakthul,1028,druid,restoration,31,13,18
Davincidru,tarren-mill,1026,druid,restoration,68,32,36
Herbiko,turalyon,1024,druid,restoration,53,24,29
Vertymbras,hyjal,1021,druid,restoration,24,13,11
Raysien,doomhammer,1021,druid,restoration,24,13,11
Shanikya,argent-dawn,1021,druid,restoration,44,20,24
Tângo,eredar,1019,druid,restoration,25,12,13
Zyska,outland,1018,druid,restoration,97,37,60
Wyngx,blackrock,1017,druid,restoration,18,11,7
Омгдру,gordunni,1016,druid,restoration,117,53,64
Sertris,kazzak,1015,druid,restoration,31,11,20
Эмканегодяйк,galakrond,1011,druid,restoration,59,31,28
Мирафлоресс,booty-bay,1009,druid,restoration,30,15,15
Ukri,ravencrest,1008,druid,restoration,22,11,11
Bakicadr,sylvanas,1005,druid,restoration,15,12,3
Дремлин,deathguard,1005,druid,restoration,41,14,27
Feedbark,stormscale,1002,druid,restoration,23,13,10
Saimdude,blackrock,1001,druid,restoration,24,11,13
Hopê,burning-legion,996,druid,restoration,60,36,24
Bearinator,aggramar,985,druid,restoration,57,26,31
Liloè,onyxia,984,druid,restoration,30,16,14
Karlsn,ravencrest,983,druid,restoration,20,11,9
Dirtyhacks,blackmoore,982,druid,restoration,24,12,12
Ellismera,argent-dawn,978,druid,restoration,36,17,19
Флиперкэт,howling-fjord,978,druid,restoration,30,11,19
Robutt,runetotem,976,druid,restoration,22,12,10
Naruhot,archimonde,975,druid,restoration,19,11,8
Ráw,dun-modr,974,druid,restoration,25,11,14
Spoco,defias-brotherhood,972,druid,restoration,78,40,38
Menolao,dun-morogh,970,druid,restoration,32,18,14
Wegian,sylvanas,962,druid,restoration,63,36,27
Snedden,silvermoon,959,druid,restoration,30,15,15
Siuo,ravencrest,959,druid,restoration,24,10,14
Çãm,magtheridon,957,druid,restoration,18,10,8
Plúx,antonidas,956,druid,restoration,26,10,16
Элеарсия,gordunni,956,druid,restoration,42,15,27
Маминапуська,soulflayer,955,druid,restoration,18,10,8
Inspiredrood,archimonde,954,druid,restoration,30,18,12
Moonfetamine,silvermoon,954,druid,restoration,30,10,20
Bazilika,argent-dawn,953,druid,restoration,29,13,16
Wolfeiy,ravenholdt,952,druid,restoration,42,23,19
Энчантерес,gordunni,952,druid,restoration,30,10,20
Soratess,azshara,949,druid,restoration,24,10,14
Thieane,blackhand,948,druid,restoration,18,10,8
Merakir,dun-modr,948,druid,restoration,30,11,19
Johndru,kazzak,948,druid,restoration,71,26,45
Zarlaac,ravencrest,947,druid,restoration,18,10,8
Thélon,antonidas,945,druid,restoration,69,35,34
Corias,blackmoore,944,druid,restoration,36,10,26
Cigamt,kazzak,943,druid,restoration,12,10,2
Pudseytree,doomhammer,941,druid,restoration,30,15,15
Nimèl,argent-dawn,936,druid,restoration,42,18,24
Krollix,dun-morogh,929,druid,restoration,47,25,22
Maldrýn,stormscale,927,druid,restoration,17,10,7
Buffspencer,ragnaros,923,druid,restoration,77,39,38
Missfar,doomhammer,923,druid,restoration,36,13,23
Фэйблуд,blackscar,921,druid,restoration,78,38,40
Fubarmeep,outland,918,druid,restoration,36,18,18
Shokazu,blackmoore,917,druid,restoration,64,29,35
Yesco,malganis,912,druid,restoration,33,10,23
Уэсериктх,blackscar,911,druid,restoration,15,10,5
Chainbrake,sylvanas,911,druid,restoration,17,10,7
Fryén,archimonde,911,druid,restoration,27,10,17
Бехеровка,grom,910,druid,restoration,58,24,34
Nachtelf,lightbringer,907,druid,restoration,75,26,49
Kárél,drakthul,906,druid,restoration,24,12,12
Delviri,stormreaver,905,druid,restoration,21,11,10
Akifumi,archimonde,903,druid,restoration,35,11,24
Jambonmaster,archimonde,899,druid,restoration,24,12,12
Didi,frostwhisper,899,druid,restoration,36,11,25
Celéry,silvermoon,896,druid,restoration,16,10,6
Mw,dun-modr,893,druid,restoration,23,10,13
Driiptoohard,turalyon,892,druid,restoration,40,17,23
Feanthur,drakthul,886,druid,restoration,148,72,76
ßlackßåmßå,zuljin,886,druid,restoration,29,13,16
Do,alakir,876,druid,restoration,24,10,14
Ratskrone,alleria,872,druid,restoration,66,30,36
Allod,stormscale,869,druid,restoration,53,23,30
Healbrah,burning-blade,865,druid,restoration,54,10,44
Naphé,ysondre,864,druid,restoration,12,9,3
Uñsullied,kazzak,864,druid,restoration,12,9,3
Viggez,outland,864,druid,restoration,18,9,9
Tjann,darksorrow,864,druid,restoration,18,9,9
Иксвовски,gordunni,864,druid,restoration,18,9,9
Лабирон,soulflayer,864,druid,restoration,24,9,15
Stonesight,argent-dawn,863,druid,restoration,12,9,3
Madmanul,draenor,863,druid,restoration,18,9,9
Elviiradruid,tarren-mill,863,druid,restoration,18,9,9
Místergreen,ravencrest,863,druid,restoration,18,9,9
Jikuni,ravencrest,862,druid,restoration,18,9,9
Yandris,argent-dawn,862,druid,restoration,18,9,9
Csmedruid,blackrock,862,druid,restoration,18,9,9
Ipossible,kazzak,862,druid,restoration,24,9,15
Badbeliø,hyjal,862,druid,restoration,30,9,21
Smucka,ragnaros,861,druid,restoration,24,9,15
Thardruid,stormscale,860,druid,restoration,18,9,9
Suunto,blackrock,859,druid,restoration,18,9,9
Gandraste,neptulon,857,druid,restoration,12,9,3
Shadraw,arakarahm,857,druid,restoration,24,9,15
Tharandrél,argent-dawn,855,druid,restoration,36,9,27
Relxc,outland,854,druid,restoration,12,9,3
Happyhoter,blackrock,854,druid,restoration,24,9,15
Chéchédroïd,marécage-de-zangar,854,druid,restoration,30,10,20
Droodfist,khaz-modan,853,druid,restoration,48,23,25
Nious,kazzak,853,druid,restoration,24,9,15
Lunatrixs,dun-modr,852,druid,restoration,18,9,9
Maxekaxe,sylvanas,852,druid,restoration,24,9,15
Simouch,archimonde,848,druid,restoration,124,57,67
Folzenqt,archimonde,848,druid,restoration,35,13,22
Арбузир,howling-fjord,846,druid,restoration,30,9,21
Ellinaki,neptulon,845,druid,restoration,66,30,36
Djungelgrabb,twisting-nether,844,druid,restoration,18,9,9
Chujogrzmot,kazzak,843,druid,restoration,23,9,14
Houwalia,archimonde,840,druid,restoration,42,18,24
Jagu,blackrock,839,druid,restoration,18,9,9
Triplej,twisting-nether,836,druid,restoration,18,9,9
Lyndruid,sylvanas,833,druid,restoration,72,27,45
Robeala,twisting-nether,832,druid,restoration,42,17,25
Ånåphorå,archimonde,830,druid,restoration,17,9,8
Malandrin,khazgoroth,830,druid,restoration,24,9,15
Nube,alonsus,826,druid,restoration,66,25,41
Ruap,blackmoore,822,druid,restoration,20,10,10
Blolzz,silvermoon,819,druid,restoration,24,9,15
Metaboss,ravencrest,817,druid,restoration,71,24,47
Zillo,stormscale,815,druid,restoration,26,10,16
Macanbre,tarren-mill,813,druid,restoration,54,22,32
Spiralout,nemesis,789,druid,restoration,150,65,85
Bidodici,nemesis,783,druid,restoration,135,57,78
Buufu,kazzak,780,druid,restoration,19,9,10
Nutzlos,azshara,775,druid,restoration,63,18,45
Dablol,draenor,768,druid,restoration,12,8,4
Ecological,outland,768,druid,restoration,12,8,4
Rînaa,ravencrest,768,druid,restoration,12,8,4
Мекс,gordunni,768,druid,restoration,12,8,4
Zmira,outland,768,druid,restoration,18,8,10
Taurvid,outland,768,druid,restoration,18,8,10
Crìmz,aszune,768,druid,restoration,24,8,16
Alexialol,silvermoon,767,druid,restoration,12,8,4
Fanboij,kazzak,767,druid,restoration,18,8,10
Brindefolie,archimonde,767,druid,restoration,18,8,10
Tåylor,laughing-skull,767,druid,restoration,18,8,10
Exilia,kragjin,767,druid,restoration,18,8,10
Jugaia,frostmourne,767,druid,restoration,18,8,10
Noxlunaire,ravencrest,766,druid,restoration,18,8,10
Crydotcom,aegwynn,765,druid,restoration,18,8,10
Ischumekcid,anubarak,765,druid,restoration,18,8,10
Memento,kazzak,765,druid,restoration,18,8,10
Erdnuckèl,antonidas,761,druid,restoration,15,9,6
Димитруа,howling-fjord,761,druid,restoration,18,8,10
Semiflora,silvermoon,757,druid,restoration,24,8,16
Mandy,spinebreaker,755,druid,restoration,18,8,10
Caturday,terrordar,755,druid,restoration,24,9,15
Jimmorris,eredar,754,druid,restoration,18,8,10
Nargaí,kargath,753,druid,restoration,18,8,10
Hootymactoot,magtheridon,752,druid,restoration,12,8,4
Karochi,kazzak,751,druid,restoration,12,8,4
Iprex,outland,748,druid,restoration,12,8,4
Frostfox,ghostlands,741,druid,restoration,22,9,13
Skilloxus,gilneas,740,druid,restoration,81,26,55
Sfarcolacul,tarren-mill,739,druid,restoration,18,8,10
Lexopewpew,ravencrest,736,druid,restoration,23,8,15
Ivysun,auchindoun,734,druid,restoration,20,9,11
Skailzdruid,hyjal,732,druid,restoration,10,9,1
Saxondale,aszune,729,druid,restoration,18,8,10
Лордсенка,eversong,721,druid,restoration,18,8,10
Catman,eredar,717,druid,restoration,15,9,6
Weremyst,outland,702,druid,restoration,26,8,18
Sylocin,earthen-ring,699,druid,restoration,16,8,8
Nizkul,dun-modr,699,druid,restoration,22,8,14
Høtbøt,ysera,688,druid,restoration,13,8,5
Найтед,gordunni,678,druid,restoration,17,10,7
Магараганага,azuregos,675,druid,restoration,25,8,17
Dïsä,ravencrest,672,druid,restoration,12,7,5
Stevedru,ravencrest,672,druid,restoration,12,7,5
Isitbleedin,silvermoon,672,druid,restoration,12,7,5
Vinniehacker,archimonde,672,druid,restoration,12,7,5
Zarune,sanguino,672,druid,restoration,12,7,5
Maiverdr,ravencrest,672,druid,restoration,12,7,5
Dortalon,outland,672,druid,restoration,12,7,5
Bntyx,dun-modr,672,druid,restoration,12,7,5
Luuxiå,archimonde,672,druid,restoration,12,7,5
Jakeffsake,stormscale,672,druid,restoration,12,7,5
Monatamis,kazzak,672,druid,restoration,12,7,5
Icecöld,silvermoon,672,druid,restoration,12,7,5
Jackyblue,silvermoon,672,druid,restoration,18,7,11
Smightydr,silvermoon,672,druid,restoration,18,7,11
Juhudy,kazzak,672,druid,restoration,18,7,11
Nozome,draenor,672,druid,restoration,18,7,11
Buzzlîghtyea,outland,672,druid,restoration,18,7,11
Dartdogg,sanguino,672,druid,restoration,18,7,11
Стомпбр,gordunni,672,druid,restoration,24,7,17
Champaa,aggra-português,672,druid,restoration,24,7,17
Badballance,outland,671,druid,restoration,12,7,5
Séyla,blackrock,671,druid,restoration,12,7,5
Norkenis,neptulon,671,druid,restoration,12,7,5
Мамамышь,gordunni,671,druid,restoration,12,7,5
Göli,argent-dawn,671,druid,restoration,12,7,5
Pomdöner,echsenkessel,671,druid,restoration,12,7,5
Darktigrou,archimonde,671,druid,restoration,12,7,5
Yunalaa,blackmoore,671,druid,restoration,12,7,5
Zkasnoname,archimonde,671,druid,restoration,18,7,11
Scuta,sylvanas,671,druid,restoration,18,7,11
Шеданна,gordunni,671,druid,restoration,24,7,17
Morfer,grim-batol,670,druid,restoration,12,7,5
Buckxxz,nazjatar,670,druid,restoration,12,7,5
Hanibalector,silvermoon,670,druid,restoration,15,8,7
Proxis,the-maelstrom,670,druid,restoration,18,7,11
Soný,aegwynn,670,druid,restoration,18,7,11
Thaeldres,argent-dawn,667,druid,restoration,18,7,11
Kaod,outland,666,druid,restoration,12,7,5
Gribix,kazzak,666,druid,restoration,12,7,5
Кишкинахир,razuvious,665,druid,restoration,12,7,5
Bepanten,azshara,665,druid,restoration,18,7,11
Çhuucky,khaz-modan,663,druid,restoration,30,7,23
Shaorma,ravencrest,661,druid,restoration,12,7,5
Petitchät,archimonde,661,druid,restoration,16,8,8
Druiddamage,the-maelstrom,660,druid,restoration,18,7,11
Сутулоерыгло,howling-fjord,658,druid,restoration,20,7,13
Борзойрог,soulflayer,656,druid,restoration,18,7,11
Erebear,ravencrest,653,druid,restoration,17,7,10
Arianator,culte-de-la-rive-noire,652,druid,restoration,18,7,11
Foaqi,aegwynn,639,druid,restoration,16,7,9
Schwertlilie,aegwynn,639,druid,restoration,17,7,10
Lutzmiller,eredar,637,druid,restoration,39,14,25
Kùrámágødx,ravencrest,624,druid,restoration,17,7,10
Aolynk,twisting-nether,615,druid,restoration,23,8,15
ßïgßúll,twisting-nether,614,druid,restoration,19,8,11
Zerschmatzen,aegwynn,610,druid,restoration,28,9,19
Panørax,archimonde,607,druid,restoration,11,7,4
Heavysmoker,emeriss,607,druid,restoration,11,7,4
Lorucka,die-nachtwache,607,druid,restoration,14,7,7
Метафрея,gordunni,605,druid,restoration,11,7,4
Medreas,argent-dawn,594,druid,restoration,16,7,9
Draxedin,kazzak,576,druid,restoration,6,6,0
Fknmad,burning-blade,576,druid,restoration,6,6,0
Jnzymiau,blackrock,576,druid,restoration,10,7,3
Ravnac,aegwynn,576,druid,restoration,12,6,6
Sálty,aegwynn,576,druid,restoration,12,6,6
Layzz,archimonde,576,druid,restoration,12,6,6
Kyssope,chants-éternels,576,druid,restoration,12,6,6
Jhiun,ragnaros,576,druid,restoration,12,6,6
Foxyfeet,outland,576,druid,restoration,12,6,6
Сладуляя,gordunni,576,druid,restoration,12,6,6
Sakkosækk,ravencrest,576,druid,restoration,12,6,6
Muraglia,pozzo-delleternità,576,druid,restoration,12,6,6
Elayria,blackmoore,576,druid,restoration,12,6,6
Ferraribob,ravencrest,576,druid,restoration,12,6,6
Афклалка,gordunni,576,druid,restoration,12,6,6
Vijaja,aegwynn,576,druid,restoration,12,6,6
Felisin,ravencrest,576,druid,restoration,12,6,6
Telpha,onyxia,576,druid,restoration,12,6,6
Cyriaan,eredar,576,druid,restoration,12,6,6
Thorns,blackrock,576,druid,restoration,12,6,6
Zaelithree,archimonde,576,druid,restoration,12,6,6
Jin,the-venture-co,576,druid,restoration,12,6,6
Caldino,tarren-mill,576,druid,restoration,17,7,10
Pölkky,argent-dawn,576,druid,restoration,18,6,12
Neverpanic,stormscale,576,druid,restoration,18,6,12
Джунали,howling-fjord,576,druid,restoration,18,6,12
Tjillevippen,tarren-mill,576,druid,restoration,18,6,12
Shaelx,nethersturm,576,druid,restoration,18,6,12
Eluñeãdore,silvermoon,575,druid,restoration,6,6,0
Ekaterina,dun-morogh,575,druid,restoration,12,6,6
Lucidor,frostmane,575,druid,restoration,12,6,6
Лэвиш,blackscar,575,druid,restoration,12,6,6
Afret,kazzak,575,druid,restoration,12,6,6
Geeorge,stormscale,575,druid,restoration,12,6,6
Iamsocute,silvermoon,575,druid,restoration,12,6,6
Scarrymonsta,outland,575,druid,restoration,12,6,6
Shylanna,ragnaros,575,druid,restoration,12,6,6
Jinxaran,culte-de-la-rive-noire,575,druid,restoration,12,6,6
Garbloom,silvermoon,575,druid,restoration,12,6,6
Storfjåset,stormscale,575,druid,restoration,18,6,12
Indann,kazzak,575,druid,restoration,18,6,12
Pouletqt,archimonde,575,druid,restoration,18,6,12
Telaroxx,die-nachtwache,575,druid,restoration,18,6,12
Avilary,tarren-mill,575,druid,restoration,18,6,12
Mascraxx,earthen-ring,575,druid,restoration,18,6,12
Tsihsel,ravencrest,574,druid,restoration,12,6,6
Mcneil,wrathbringer,574,druid,restoration,12,6,6
Ruberg,kazzak,574,druid,restoration,12,6,6
Spritzer,tarren-mill,574,druid,restoration,12,6,6
Goatmeal,draenor,574,druid,restoration,24,6,18
Зервес,gordunni,574,druid,restoration,24,6,18
Лаегмерил,gordunni,573,druid,restoration,10,7,3
Dfjguidfg,baelgun,573,druid,restoration,18,6,12
Ragdru,twisting-nether,573,druid,restoration,24,6,18
Nøboorst,ravencrest,571,druid,restoration,12,6,6
Kirïllx,silvermoon,571,druid,restoration,12,6,6
Bearshift,aggra-português,571,druid,restoration,18,6,12
Pussn,twisting-nether,570,druid,restoration,18,6,12
Essya,earthen-ring,569,druid,restoration,31,7,24
Walkao,tarren-mill,566,druid,restoration,12,6,6
Wellsie,blackmoore,565,druid,restoration,18,6,12
Vlookup,tarren-mill,543,druid,restoration,17,6,11
Siahra,khaz-modan,534,druid,restoration,48,6,42
Quorn,pozzo-delleternità,527,druid,restoration,13,7,6
Dablolo,ravencrest,521,druid,restoration,12,7,5
Nøkki,draenor,517,druid,restoration,21,8,13
Endoplazmik,silvermoon,494,druid,restoration,13,6,7
Piñaclo,archimonde,480,druid,restoration,6,5,1
Мегабамбук,soulflayer,480,druid,restoration,6,5,1
Mykk,ravencrest,480,druid,restoration,6,5,1
Epicskin,kazzak,480,druid,restoration,12,5,7
Vaacku,stormreaver,480,druid,restoration,12,5,7
Marmotini,the-maelstrom,480,druid,restoration,12,5,7
Jebaitor,tarren-mill,480,druid,restoration,12,5,7
Horstyolo,blackrock,480,druid,restoration,12,5,7
Helløkittyßß,dun-modr,480,druid,restoration,12,5,7
Steuerung,twisting-nether,480,druid,restoration,12,5,7
Nightmoon,hellscream,480,druid,restoration,12,5,7
Devastras,ravencrest,480,druid,restoration,12,5,7
Druni,blackrock,480,druid,restoration,12,5,7
Asude,outland,480,druid,restoration,12,5,7
Solutionx,aegwynn,480,druid,restoration,12,5,7
Madshad,draenor,480,druid,restoration,12,5,7
Troc,karazhan,480,druid,restoration,12,5,7
Jenovas,argent-dawn,480,druid,restoration,12,5,7
Skirr,kelthuzad,480,druid,restoration,12,5,7
Друрашка,soulflayer,480,druid,restoration,12,5,7
Kvalitet,outland,480,druid,restoration,12,5,7
Holybarkz,aegwynn,480,druid,restoration,12,5,7
Napsta,sylvanas,480,druid,restoration,12,5,7
Druidicchi,stormscale,480,druid,restoration,12,5,7
Febricyla,blackmoore,480,druid,restoration,12,5,7
Slimp,the-maelstrom,480,druid,restoration,12,5,7
Higuys,the-maelstrom,480,druid,restoration,12,5,7
Crysís,sanguino,480,druid,restoration,12,5,7
Ванечка,razuvious,480,druid,restoration,18,5,13
Bigbaddream,stormscale,480,druid,restoration,18,5,13
Clownrad,tarren-mill,480,druid,restoration,18,5,13
Yseraheal,drakthul,480,druid,restoration,18,5,13
Клиптыч,soulflayer,479,druid,restoration,6,5,1
Kezbaniye,silvermoon,479,druid,restoration,6,5,1
Epidruid,stormrage,479,druid,restoration,12,5,7
Ballosh,hyjal,479,druid,restoration,12,5,7
Klerosa,moonglade,479,druid,restoration,12,5,7
Bhorumir,colinas-pardas,479,druid,restoration,12,5,7
Alfrëd,quelthalas,479,druid,restoration,12,5,7
Випера,gordunni,479,druid,restoration,12,5,7
Inspira,teldrassil,479,druid,restoration,12,5,7
Delphina,dun-modr,479,druid,restoration,12,5,7
Tanariel,ravencrest,479,druid,restoration,12,5,7
Nissemand,ravencrest,479,druid,restoration,12,5,7
Reiss,tarren-mill,479,druid,restoration,12,5,7
Quiksx,blackrock,479,druid,restoration,13,5,8
Whiskers,emerald-dream,479,druid,restoration,16,6,10
Drix,frostwolf,479,druid,restoration,15,5,10
Jemyd,aegwynn,479,druid,restoration,24,5,19
Kroshka,sylvanas,478,druid,restoration,12,5,7
Iqfrags,silvermoon,477,druid,restoration,6,5,1
Sýrês,malganis,475,druid,restoration,12,5,7
Prowlinger,silvermoon,473,druid,restoration,12,5,7
Aivy,boulderfist,472,druid,restoration,12,5,7
Druidicmorr,sylvanas,447,druid,restoration,10,5,5
Oyoyo,kaelthas,446,druid,restoration,8,6,2
Ambracer,silvermoon,444,druid,restoration,8,6,2
Исмалат,howling-fjord,429,druid,restoration,11,5,6
Domsz,dalaran,428,druid,restoration,21,5,16
Meridus,thrall,400,druid,restoration,13,5,8
Bartoluca,twisting-nether,393,druid,restoration,28,6,22
Koala,temple-noir,384,druid,restoration,6,4,2
Zonsy,twisting-nether,384,druid,restoration,6,4,2
Нагетсмяу,howling-fjord,384,druid,restoration,6,4,2
Yazari,nathrezim,384,druid,restoration,6,4,2
Zeroclones,the-maelstrom,384,druid,restoration,6,4,2
Jellyxdd,silvermoon,384,druid,restoration,6,4,2
Wrak,eonar,384,druid,restoration,6,4,2
Jìnro,stormscale,384,druid,restoration,6,4,2
Bigborst,ravencrest,384,druid,restoration,6,4,2
Цукерище,gordunni,384,druid,restoration,6,4,2
Heathen,defias-brotherhood,384,druid,restoration,6,4,2
Thatzdmg,blackmoore,384,druid,restoration,6,4,2
Sensisdruid,blackmoore,384,druid,restoration,6,4,2
Legharta,ravencrest,384,druid,restoration,6,4,2
Mistgone,hyjal,384,druid,restoration,6,4,2
Leyô,archimonde,384,druid,restoration,6,4,2
Darkyblood,archimonde,384,druid,restoration,6,4,2
Xandersito,sanguino,384,druid,restoration,6,4,2
Kattbjörnen,ragnaros,384,druid,restoration,6,4,2
Greenberry,eonar,384,druid,restoration,6,4,2
Cerius,drakthul,384,druid,restoration,6,4,2
Stinka,ravencrest,384,druid,restoration,6,4,2
Марголав,gordunni,384,druid,restoration,6,4,2
Simplydrood,archimonde,384,druid,restoration,12,4,8
Neverfall,aegwynn,384,druid,restoration,12,4,8
Farashh,archimonde,384,druid,restoration,12,4,8
Toffyfee,anetheron,384,druid,restoration,12,4,8
Sâty,draenor,384,druid,restoration,12,4,8
Farmmygold,dun-modr,384,druid,restoration,12,4,8
Holybarkzqt,aegwynn,384,druid,restoration,12,4,8
Bulldócer,sanguino,384,druid,restoration,12,4,8
Biglet,tarren-mill,384,druid,restoration,12,4,8
Ravenfel,argent-dawn,384,druid,restoration,12,4,8
Erinark,aegwynn,384,druid,restoration,12,4,8
Plantpuzzl,silvermoon,384,druid,restoration,12,4,8
Irrlycht,blackrock,384,druid,restoration,12,4,8
Найадра,gordunni,384,druid,restoration,12,4,8
Baraforet,archimonde,384,druid,restoration,12,4,8
Lyricx,kazzak,384,druid,restoration,12,4,8
Celtimi,antonidas,384,druid,restoration,12,4,8
Swiftlife,blackrock,384,druid,restoration,12,4,8
Kobra,twilights-hammer,384,druid,restoration,12,4,8
Xanxiety,outland,384,druid,restoration,12,4,8
Murlwywy,blackmoore,384,druid,restoration,12,4,8
Davorian,frostmane,384,druid,restoration,12,4,8
Solstrale,ravencrest,384,druid,restoration,12,4,8
Sneedlewøødz,exodar,384,druid,restoration,12,4,8
Meowu,twisting-nether,384,druid,restoration,12,4,8
Àlec,silvermoon,384,druid,restoration,12,4,8
Nediena,twisting-nether,384,druid,restoration,12,4,8
Litany,drakthul,384,druid,restoration,13,4,9
Tokifong,kazzak,384,druid,restoration,18,4,14
Hrz,kazzak,384,druid,restoration,18,4,14
Druibe,burning-legion,384,druid,restoration,18,4,14
Nezara,kazzak,384,druid,restoration,18,4,14
Lathlas,defias-brotherhood,383,druid,restoration,6,4,2
Blackfür,sylvanas,383,druid,restoration,6,4,2
Jabbah,defias-brotherhood,383,druid,restoration,6,4,2
Santoniq,dun-morogh,383,druid,restoration,6,4,2
Прожималодру,deathguard,383,druid,restoration,12,4,8
Xidenn,quelthalas,383,druid,restoration,12,4,8
Noxndruid,blackhand,383,druid,restoration,12,4,8
Mimisiek,burning-legion,383,druid,restoration,12,4,8
Opla,nethersturm,383,druid,restoration,12,4,8
Semenisback,archimonde,383,druid,restoration,12,4,8
Høpè,die-silberne-hand,383,druid,restoration,12,4,8
Itê,dun-morogh,383,druid,restoration,18,4,14
Santamonica,blackrock,383,druid,restoration,18,4,14
Шикалат,howling-fjord,383,druid,restoration,24,4,20
Nali,arthas,382,druid,restoration,6,4,2
Loumpa,hyjal,382,druid,restoration,6,4,2
Xele,destromath,382,druid,restoration,6,4,2
Mongetout,ravencrest,382,druid,restoration,6,4,2
Muju,stormscale,382,druid,restoration,12,4,8
Roséa,ravencrest,382,druid,restoration,12,4,8
Pega,nazjatar,382,druid,restoration,12,4,8
Voodoodrood,draenor,382,druid,restoration,24,4,20
Amalou,ravencrest,381,druid,restoration,12,4,8
Djclonex,archimonde,381,druid,restoration,12,4,8
Dolob,ragnaros,381,druid,restoration,18,4,14
Haveacoffee,stormscale,379,druid,restoration,12,4,8
Tranquillo,outland,379,druid,restoration,12,4,8
Demerit,defias-brotherhood,351,druid,restoration,11,4,7
Biegel,ysera,351,druid,restoration,11,4,7
Nøbødy,silvermoon,351,druid,restoration,11,4,7
Lyvaley,dun-modr,350,druid,restoration,16,4,12
Orgazmo,archimonde,335,druid,restoration,11,4,7
Wuppii,blackmoore,329,druid,restoration,10,6,4
Hubek,silvermoon,328,druid,restoration,8,6,2
Кэлиборн,gordunni,319,druid,restoration,5,4,1
Sygko,kazzak,288,druid,restoration,6,3,3
Owldschool,blackmoore,288,druid,restoration,6,3,3
Nelffie,kazzak,288,druid,restoration,6,3,3
Зурсага,deathguard,288,druid,restoration,6,3,3
Ксенона,gordunni,288,druid,restoration,6,3,3
Moonbloom,defias-brotherhood,288,druid,restoration,6,3,3
Cyclonebroo,blackmoore,288,druid,restoration,6,3,3
Ripmacmiller,grim-batol,288,druid,restoration,6,3,3
Shufflebot,sylvanas,288,druid,restoration,6,3,3
Bunzor,sylvanas,288,druid,restoration,6,3,3
Arns,kazzak,288,druid,restoration,6,3,3
Juhato,outland,288,druid,restoration,6,3,3
Tarshish,outland,288,druid,restoration,6,3,3
Shyni,outland,288,druid,restoration,6,3,3
Elsnorro,sylvanas,288,druid,restoration,6,3,3
Фонш,soulflayer,288,druid,restoration,6,3,3
Qwopeiqpwoid,kazzak,288,druid,restoration,6,3,3
Faustîno,dun-modr,288,druid,restoration,6,3,3
Тое,soulflayer,288,druid,restoration,6,3,3
Сайнтификх,gordunni,288,druid,restoration,6,3,3
Miyá,sylvanas,288,druid,restoration,6,3,3
Eô,antonidas,288,druid,restoration,6,3,3
Jincksdru,ravencrest,288,druid,restoration,6,3,3
Friyiee,stormscale,288,druid,restoration,6,3,3
Brosephiné,stormscale,288,druid,restoration,6,3,3
Shadowdury,frostwolf,288,druid,restoration,6,3,3
Bêlion,dun-modr,288,druid,restoration,6,3,3
Noobr,ravencrest,288,druid,restoration,6,3,3
Ipsdray,ysondre,288,druid,restoration,6,3,3
Zaethul,draenor,288,druid,restoration,6,3,3
Skuhlxz,thrall,288,druid,restoration,6,3,3
Vacuumcleanr,ravencrest,288,druid,restoration,6,3,3
Lèafy,silvermoon,288,druid,restoration,6,3,3
Starcrash,amanthul,288,druid,restoration,6,3,3
Exïlla,archimonde,288,druid,restoration,6,3,3
Mnine,twisting-nether,288,druid,restoration,6,3,3
Танганэку,howling-fjord,288,druid,restoration,6,3,3
Vickepicke,stormreaver,288,druid,restoration,6,3,3
Derie,nazjatar,288,druid,restoration,6,3,3
Мехнакиске,howling-fjord,288,druid,restoration,6,3,3
Eftersmak,ravencrest,288,druid,restoration,6,3,3
Néøu,archimonde,288,druid,restoration,6,3,3
Milknosugar,tarren-mill,288,druid,restoration,6,3,3
Drozzie,twisting-nether,288,druid,restoration,6,3,3
Nohos,blackrock,288,druid,restoration,6,3,3
Lolaven,turalyon,288,druid,restoration,6,3,3
Wurzeldor,ravencrest,288,druid,restoration,6,3,3
Hurutuk,ysondre,288,druid,restoration,6,3,3
Magiskeforme,draenor,288,druid,restoration,6,3,3
Myos,conseil-des-ombres,288,druid,restoration,6,3,3
Ghøstavdruid,ravencrest,288,druid,restoration,6,3,3
Rumbus,sanguino,288,druid,restoration,7,3,4
Piñaclonada,archimonde,288,druid,restoration,9,3,6
Draawun,burning-legion,288,druid,restoration,11,3,8
Smarticle,aegwynn,288,druid,restoration,11,3,8
Harrasmoes,ravencrest,288,druid,restoration,12,3,9
Eladhria,arakarahm,288,druid,restoration,12,3,9
Shiotake,hyjal,288,druid,restoration,12,3,9
Ahuevshiy,wildhammer,288,druid,restoration,12,3,9
Mchøt,ravencrest,288,druid,restoration,12,3,9
Ezils,silvermoon,288,druid,restoration,12,3,9
Restaidpvs,wildhammer,288,druid,restoration,12,3,9
Храмульчик,blackscar,288,druid,restoration,12,3,9
Coínlíp,drakthul,288,druid,restoration,12,3,9
Amstaffio,blackhand,288,druid,restoration,12,3,9
Restodruidx,ravencrest,288,druid,restoration,12,3,9
Nostigon,azshara,288,druid,restoration,12,3,9
Imoen,hyjal,288,druid,restoration,12,3,9
Trolthelhas,chogall,288,druid,restoration,12,3,9
Bigbones,frostwolf,288,druid,restoration,12,3,9
Areidhel,pozzo-delleternità,288,druid,restoration,12,3,9
Marryat,argent-dawn,288,druid,restoration,12,3,9
Lukøu,blackrock,288,druid,restoration,12,3,9
Rawillinen,kazzak,288,druid,restoration,12,3,9
Teah,darkmoon-faire,288,druid,restoration,12,3,9
Rakuy,thrall,288,druid,restoration,18,3,15
Yøungreidzz,blackrock,288,druid,restoration,18,3,15
Krizak,eredar,287,druid,restoration,6,3,3
Kuokkanen,azuremyst,287,druid,restoration,6,3,3
Smittly,bloodhoof,287,druid,restoration,6,3,3
Kuhlheit,der-rat-von-dalaran,287,druid,restoration,6,3,3
Taskingoman,twisting-nether,287,druid,restoration,6,3,3
Boompjeh,chamber-of-aspects,287,druid,restoration,6,3,3
Lundx,ravencrest,287,druid,restoration,6,3,3
Seabath,kirin-tor,287,druid,restoration,12,3,9
Xulian,exodar,287,druid,restoration,12,3,9
Wildblu,nemesis,287,druid,restoration,12,3,9
Papalegba,kilrogg,287,druid,restoration,12,3,9
Kebanos,ravencrest,286,druid,restoration,6,3,3
Paniel,amanthul,286,druid,restoration,6,3,3
Elônea,antonidas,285,druid,restoration,12,3,9
Gladyon,ravencrest,285,druid,restoration,12,3,9
Bunga,quelthalas,255,druid,restoration,11,3,8
Duduque,twisting-nether,255,druid,restoration,11,3,8
Cultivatedz,twisting-nether,250,druid,restoration,18,7,11
Yopi,stormscale,240,druid,restoration,15,3,12
Mayte,ragnaros,239,druid,restoration,5,3,2
Amélor,ragnaros,239,druid,restoration,5,3,2
Thornat,chamber-of-aspects,239,druid,restoration,5,3,2
Потнаякиса,grom,239,druid,restoration,5,3,2
Акетчи,howling-fjord,239,druid,restoration,5,3,2
Izhusky,ravencrest,234,druid,restoration,8,4,4
Vioboomie,blackrock,234,druid,restoration,9,4,5
Zagrem,antonidas,234,druid,restoration,10,4,6
Beerplusbeer,kazzak,234,druid,restoration,23,6,17
Moodee,kazzak,192,druid,restoration,6,2,4
Chrisdruid,argent-dawn,192,druid,restoration,6,2,4
Navra,ravencrest,192,druid,restoration,6,2,4
Nooz,thrall,192,druid,restoration,6,2,4
Trolléverte,archimonde,192,druid,restoration,6,2,4
Sajlol,doomhammer,192,druid,restoration,6,2,4
Golddy,hyjal,192,druid,restoration,6,2,4
Huebbi,blackmoore,192,druid,restoration,6,2,4
Шокоокулист,gordunni,192,druid,restoration,6,2,4
Raila,pozzo-delleternità,192,druid,restoration,6,2,4
Benjiee,kazzak,192,druid,restoration,6,2,4
Zadrood,rashgarroth,192,druid,restoration,6,2,4
Skraks,ysondre,192,druid,restoration,6,2,4
Príimé,kazzak,192,druid,restoration,6,2,4
Ymöthep,archimonde,192,druid,restoration,6,2,4
Rtxy,hyjal,192,druid,restoration,6,2,4
Midrialis,sinstralis,192,druid,restoration,6,2,4
Griminal,norgannon,192,druid,restoration,6,2,4
Drúídárn,talnivarr,192,druid,restoration,6,2,4
Kbåkå,ravencrest,192,druid,restoration,6,2,4
Громозилка,soulflayer,192,druid,restoration,6,2,4
Skavenlol,zuljin,192,druid,restoration,6,2,4
Атитока,goldrinn,192,druid,restoration,6,2,4
Sartipus,draenor,192,druid,restoration,6,2,4
Drukae,stormscale,192,druid,restoration,6,2,4
Milkmepls,balnazzar,192,druid,restoration,6,2,4
Restoboi,stormscale,192,druid,restoration,6,2,4
Prayx,dalaran,192,druid,restoration,6,2,4
Traffix,outland,192,druid,restoration,6,2,4
Kkona,silvermoon,192,druid,restoration,6,2,4
Инский,howling-fjord,192,druid,restoration,6,2,4
Lunglung,blutkessel,192,druid,restoration,6,2,4
Tooclosex,outland,192,druid,restoration,6,2,4
Nelfurion,twisting-nether,192,druid,restoration,6,2,4
Berdix,ragnaros,192,druid,restoration,6,2,4
Conn,ravencrest,192,druid,restoration,6,2,4
Gailiûga,kazzak,192,druid,restoration,6,2,4
Pinkpanda,arthas,192,druid,restoration,6,2,4
Fanso,burning-legion,192,druid,restoration,6,2,4
Hydrochronic,ravencrest,192,druid,restoration,6,2,4
Адорабэль,deathguard,192,druid,restoration,6,2,4
Shaggí,draenor,192,druid,restoration,11,2,9
Maceyx,ravencrest,192,druid,restoration,12,2,10
Imperador,tyrande,192,druid,restoration,12,2,10
Qocotte,archimonde,192,druid,restoration,12,2,10
Drâcâ,antonidas,192,druid,restoration,12,2,10
Prettysavage,blackhand,192,druid,restoration,12,2,10
Nakkikastike,magtheridon,192,druid,restoration,12,2,10
Skorpo,blackrock,192,druid,restoration,12,2,10
Asøri,antonidas,192,druid,restoration,12,2,10
Testomake,kazzak,192,druid,restoration,12,2,10
Spaartaa,blackhand,192,druid,restoration,12,2,10
Lisovamavka,draenor,192,druid,restoration,12,2,10
Салона,deathguard,192,druid,restoration,12,2,10
Amaaja,blackmoore,192,druid,restoration,12,2,10
Kizanimagus,magtheridon,192,druid,restoration,12,2,10
Anníe,tarren-mill,192,druid,restoration,12,2,10
Blâckrök,blackhand,192,druid,restoration,12,2,10
Vertabrain,twilights-hammer,192,druid,restoration,12,2,10
Bigstop,kazzak,192,druid,restoration,17,2,15
Охломон,gordunni,192,druid,restoration,24,2,22
Дела,eversong,191,druid,restoration,6,2,4
Siyoo,thrall,191,druid,restoration,6,2,4
Зулгасилич,howling-fjord,191,druid,restoration,6,2,4
Bingó,blutkessel,191,druid,restoration,6,2,4
Эхосна,howling-fjord,191,druid,restoration,12,2,10
Котанет,gordunni,191,druid,restoration,12,2,10
Mômmôm,aggra-português,191,druid,restoration,12,2,10
Iamtheone,ragnaros,175,druid,restoration,11,2,9
Stkk,dun-modr,159,druid,restoration,5,2,3
Martinesämst,outland,138,druid,restoration,6,3,3
Kokanine,ravencrest,138,druid,restoration,9,3,6
Watchmymoon,blackrock,138,druid,restoration,10,3,7
Ihatewhales,ravencrest,128,druid,restoration,4,2,2
Qjkuug,ravencrest,128,druid,restoration,4,2,2
Jendiiss,drakthul,127,druid,restoration,4,2,2
Thaiboimbyy,veknilash,127,druid,restoration,4,2,2
Xneji,sylvanas,111,druid,restoration,13,2,11
Seekíng,blackmoore,96,druid,restoration,6,1,5
Cowárd,blackmoore,96,druid,restoration,6,1,5
Naturaven,sylvanas,96,druid,restoration,6,1,5
Secô,sylvanas,96,druid,restoration,6,1,5
Druidguden,tarren-mill,96,druid,restoration,6,1,5
Álou,dalaran,96,druid,restoration,6,1,5
Nuwell,arathor,96,druid,restoration,6,1,5
Marynlord,dalaran,96,druid,restoration,6,1,5
Taicoo,outland,96,druid,restoration,6,1,5
Släshes,stormreaver,96,druid,restoration,6,1,5
Søfiaa,argent-dawn,96,druid,restoration,6,1,5
Haginator,twisting-nether,96,druid,restoration,6,1,5
Kisyqt,aegwynn,96,druid,restoration,6,1,5
Uuni,sylvanas,96,druid,restoration,6,1,5
Winstonka,doomhammer,96,druid,restoration,6,1,5
Lyj,dalaran,96,druid,restoration,6,1,5
Tilikum,stormscale,96,druid,restoration,6,1,5
Meisterd,aegwynn,96,druid,restoration,6,1,5
Nanuu,sylvanas,96,druid,restoration,6,1,5
Pølïna,ysondre,96,druid,restoration,6,1,5
Tranduiil,drakthul,96,druid,restoration,6,1,5
Kerydwen,silvermoon,96,druid,restoration,6,1,5
Effi,aggramar,96,druid,restoration,6,1,5
Blazor,eredar,96,druid,restoration,6,1,5
Thaïs,blackmoore,96,druid,restoration,6,1,5
Druvian,argent-dawn,96,druid,restoration,6,1,5
Hotundwech,blackrock,96,druid,restoration,6,1,5
Nuggetspøwa,dalaran,96,druid,restoration,6,1,5
Qdrood,quelthalas,96,druid,restoration,6,1,5
Сейтил,deathguard,96,druid,restoration,6,1,5
Тианна,razuvious,96,druid,restoration,6,1,5
Мунпраид,gordunni,96,druid,restoration,6,1,5
Sqoopy,tarren-mill,96,druid,restoration,6,1,5
Blanoz,ravencrest,96,druid,restoration,6,1,5
Kruwkamilka,burning-legion,96,druid,restoration,6,1,5
Sylindra,argent-dawn,96,druid,restoration,6,1,5
Gintoni,dun-modr,96,druid,restoration,6,1,5
Tshungubuäch,eredar,96,druid,restoration,6,1,5
Teengirl,blackmoore,96,druid,restoration,6,1,5
Elo,dun-morogh,96,druid,restoration,6,1,5
Sozu,magtheridon,96,druid,restoration,6,1,5
Swarmah,draenor,96,druid,restoration,6,1,5
Винш,grom,96,druid,restoration,6,1,5
Nermax,kazzak,96,druid,restoration,6,1,5
Reinulfen,blackmoore,96,druid,restoration,6,1,5
Ka,the-maelstrom,96,druid,restoration,6,1,5
Linkin,azshara,96,druid,restoration,6,1,5
Avalora,the-maelstrom,96,druid,restoration,12,1,11
Xilmai,darksorrow,96,druid,restoration,12,1,11
Püpply,antonidas,96,druid,restoration,12,1,11
Morkius,ravencrest,96,druid,restoration,12,1,11
Foyboy,ravencrest,96,druid,restoration,12,1,11
Лапунька,gordunni,96,druid,restoration,12,1,11
Natur,gorgonnash,96,druid,restoration,12,1,11
Athenex,azshara,96,druid,restoration,12,1,11
Dreäms,ravencrest,95,druid,restoration,6,1,5
Pobrica,stormscale,79,druid,restoration,5,1,4
Сугрик,deathweaver,64,druid,restoration,10,1,9
Rasserdruid,runetotem,63,druid,restoration,2,2,0
Quizdarude,draenor,42,druid,restoration,10,3,7
Therøn,dun-modr,42,druid,restoration,11,3,8
Growlithe,hellfire,42,druid,restoration,8,2,6
Eceria,the-maelstrom,42,druid,restoration,9,2,7
Acidbrate,aegwynn,42,druid,restoration,9,2,7
Onacor,stormrage,42,druid,restoration,10,2,8
Noxann,archimonde,42,druid,restoration,10,2,8
Uniquz,sylvanas,42,druid,restoration,11,2,9
Vanarea,argent-dawn,42,druid,restoration,14,2,12
Druiden,the-maelstrom,31,druid,restoration,2,1,1
Djemdruid,argent-dawn,1585,druid,guardian,42,18,24
Bulleyo,ysondre,1536,druid,guardian,65,35,30
Windythemilf,stormscale,1303,druid,guardian,148,77,71
Rbgbear,blackhand,1156,druid,guardian,36,15,21
Rapatera,argent-dawn,1115,druid,guardian,24,12,12
Сверххищникк,soulflayer,1106,druid,guardian,32,13,19
Микайо,goldrinn,986,druid,guardian,41,17,24
Lioky,dun-modr,670,druid,guardian,12,7,5
Critter,kargath,572,druid,guardian,18,6,12
Crazydudu,tarren-mill,550,druid,guardian,27,8,19
Bigdomas,sylvanas,532,druid,guardian,16,6,10
Tigerbear,argent-dawn,384,druid,guardian,12,4,8
Avisa,blackhand,378,druid,guardian,12,4,8
Horizonline,terokkar,350,druid,guardian,11,4,7
Zinister,hyjal,192,druid,guardian,6,2,4
Kárrde,balnazzar,192,druid,guardian,6,2,4
Sároman,ravencrest,192,druid,guardian,6,2,4
Astralcore,stormscale,192,druid,guardian,6,2,4
Fynvola,anubarak,192,druid,guardian,12,2,10
Nwal,thunderhorn,192,druid,guardian,12,2,10
Avior,eonar,192,druid,guardian,13,2,11
Pure,kul-tiras,190,druid,guardian,15,3,12
Oõ,aggra-português,96,druid,guardian,6,1,5
Almightydudu,draenor,96,druid,guardian,6,1,5
Beteralsjij,frostwhisper,96,druid,guardian,6,1,5
Twinklex,ravencrest,2230,druid,feral,100,52,48
Xercas,outland,2166,druid,feral,65,39,26
Cataferal,ravencrest,2133,druid,feral,102,56,46
Desenlace,ravencrest,2127,druid,feral,149,82,67
Dashfull,ravencrest,2112,druid,feral,167,94,73
Bloodyredlyx,ysera,2112,druid,feral,90,46,44
Brutaldamage,ravencrest,2090,druid,feral,78,39,39
Zøte,ravencrest,2083,druid,feral,84,43,41
Purgatxry,ravencrest,2074,druid,feral,305,158,147
Jakamx,ravencrest,2073,druid,feral,162,85,77
Ktx,aegwynn,2067,druid,feral,66,40,26
Crøwnd,twisting-nether,2056,druid,feral,54,34,20
Rapatera,argent-dawn,2019,druid,feral,54,30,24
Öøöøöøöøöøöø,anachronos,2003,druid,feral,48,31,17
Nìm,outland,2002,druid,feral,106,49,57
Lxve,tarren-mill,1999,druid,feral,60,31,29
Trøüpäx,outland,1994,druid,feral,84,43,41
Uebiwe,silvermoon,1991,druid,feral,78,44,34
Taladruide,archimonde,1989,druid,feral,72,36,36
Råñkønêbëår,ravencrest,1982,druid,feral,60,36,24
Ромкабикстар,gordunni,1952,druid,feral,60,30,30
Mmlprox,burning-legion,1930,druid,feral,67,36,31
Tomyn,burning-legion,1928,druid,feral,60,36,24
Iminz,ravencrest,1928,druid,feral,179,83,96
Djgírlßøssqt,argent-dawn,1924,druid,feral,60,31,29
Cløwnferalx,argent-dawn,1921,druid,feral,54,25,29
Yone,blackmoore,1918,druid,feral,60,33,27
Cåssidy,archimonde,1911,druid,feral,72,32,40
Annksunamún,ysondre,1907,druid,feral,153,92,61
Desenlace,silvermoon,1903,druid,feral,126,57,69
Nîîght,ravencrest,1895,druid,feral,54,26,28
Норланда,gordunni,1884,druid,feral,60,32,28
Trauller,outland,1872,druid,feral,72,30,42
Symbiosa,silvermoon,1870,druid,feral,30,20,10
Tilikum,stormscale,1862,druid,feral,281,143,138
Obeseferal,outland,1859,druid,feral,66,31,35
Minaervea,antonidas,1846,druid,feral,72,33,39
Kattenvoer,stormscale,1842,druid,feral,36,27,9
Ålleyézoffme,ravencrest,1842,druid,feral,36,25,11
Alessathrina,argent-dawn,1838,druid,feral,66,34,32
Skatch,sylvanas,1836,druid,feral,54,28,26
Опакот,howling-fjord,1833,druid,feral,62,27,35
Houmrx,ravencrest,1830,druid,feral,36,23,13
Февти,gordunni,1828,druid,feral,59,34,25
Drbeef,sanguino,1823,druid,feral,45,28,17
Zelaron,twisting-nether,1823,druid,feral,42,22,20
Фейкхехе,gordunni,1822,druid,feral,48,27,21
Kroñm,dun-modr,1818,druid,feral,60,25,35
Jarethy,dun-modr,1815,druid,feral,81,39,42
Fendrïl,varimathras,1814,druid,feral,90,55,35
Nøfåmïly,silvermoon,1814,druid,feral,160,83,77
Mortality,proudmoore,1812,druid,feral,65,31,34
Nfxdruid,argent-dawn,1810,druid,feral,90,54,36
Mabkferal,ravencrest,1807,druid,feral,55,28,27
Jhiun,ragnaros,1806,druid,feral,72,40,32
Bigangrycatx,ravencrest,1803,druid,feral,62,26,36
Ratsimulator,tarren-mill,1802,druid,feral,54,32,22
Skytek,silvermoon,1802,druid,feral,84,41,43
Мелталиора,soulflayer,1800,druid,feral,59,30,29
Djmeowxd,blackrock,1784,druid,feral,66,30,36
Yesbody,tarren-mill,1779,druid,feral,42,21,21
Catkovic,kult-der-verdammten,1777,druid,feral,47,24,23
Jabbari,outland,1775,druid,feral,101,56,45
Elfsu,ravencrest,1773,druid,feral,54,31,23
Блюгилли,ashenvale,1764,druid,feral,80,35,45
Mykk,ravencrest,1755,druid,feral,39,27,12
Kikihoux,ravencrest,1747,druid,feral,41,22,19
Elîas,kazzak,1745,druid,feral,42,25,17
Alexmeow,ravencrest,1739,druid,feral,36,24,12
Moldrokk,ravencrest,1739,druid,feral,52,31,21
Garbagemonky,amanthul,1738,druid,feral,96,61,35
Rubbershark,ravencrest,1737,druid,feral,46,35,11
Nouin,twisting-nether,1732,druid,feral,72,36,36
Apuasaatana,stormreaver,1731,druid,feral,36,20,16
Jukeboks,silvermoon,1726,druid,feral,55,25,30
Moonkniight,ravencrest,1724,druid,feral,24,18,6
Boostedbear,ragnaros,1723,druid,feral,48,22,26
Goodtrip,archimonde,1720,druid,feral,74,38,36
Mutaattori,sylvanas,1720,druid,feral,37,18,19
Tael,elune,1719,druid,feral,42,24,18
Ethryl,ravencrest,1719,druid,feral,54,27,27
Shiftydruid,thunderhorn,1718,druid,feral,134,63,71
Dzandel,silvermoon,1715,druid,feral,341,168,173
Mysticalmoon,ravencrest,1715,druid,feral,60,25,35
Fyrkax,aegwynn,1713,druid,feral,36,21,15
Pänthërä,ravencrest,1711,druid,feral,36,18,18
Reward,ragnaros,1711,druid,feral,52,24,28
Итильтириэль,gordunni,1704,druid,feral,68,29,39
Pilaf,emerald-dream,1702,druid,feral,103,47,56
Nasukka,grim-batol,1694,druid,feral,60,34,26
Blvckðvitchz,ravencrest,1692,druid,feral,36,18,18
Degmond,silvermoon,1689,druid,feral,48,23,25
Natakis,blades-edge,1688,druid,feral,48,25,23
Adabsurdum,kazzak,1688,druid,feral,118,53,65
Doopdroo,tarren-mill,1687,druid,feral,48,20,28
Tangela,stormreaver,1684,druid,feral,24,18,6
ßgøðx,argent-dawn,1681,druid,feral,79,45,34
Freyanah,argent-dawn,1675,druid,feral,96,41,55
Трэвисдог,gordunni,1673,druid,feral,35,18,17
Aedui,tarren-mill,1668,druid,feral,38,20,18
Ðrüid,ravencrest,1668,druid,feral,72,34,38
Rbgbot,ragnaros,1667,druid,feral,48,27,21
Jgltrainer,archimonde,1666,druid,feral,53,31,22
Silksharp,ravencrest,1663,druid,feral,60,31,29
Bernfried,silvermoon,1661,druid,feral,58,25,33
Triluxa,blackmoore,1659,druid,feral,48,25,23
Unoseeme,outland,1655,druid,feral,66,29,37
Opresse,archimonde,1655,druid,feral,54,23,31
Phenova,sargeras,1652,druid,feral,83,32,51
Indann,kazzak,1651,druid,feral,48,19,29
Yongala,archimonde,1650,druid,feral,48,29,19
Fückøff,ravencrest,1649,druid,feral,47,25,22
Klaerke,tarren-mill,1645,druid,feral,41,18,23
Kouda,draenor,1642,druid,feral,52,22,30
Simdruid,stormscale,1641,druid,feral,36,19,17
Bulan,ghostlands,1638,druid,feral,66,41,25
Ñøpe,ravencrest,1630,druid,feral,30,17,13
Ddru,ravencrest,1629,druid,feral,36,20,16
Jellytardx,outland,1628,druid,feral,66,35,31
Avanah,silvermoon,1628,druid,feral,54,26,28
Котосапенс,howling-fjord,1623,druid,feral,42,23,19
Skypinho,blackhand,1616,druid,feral,48,22,26
Khunahype,thrall,1610,druid,feral,24,17,7
Zaibastus,doomhammer,1610,druid,feral,54,21,33
Banzeye,nordrassil,1607,druid,feral,68,35,33
Bigpapad,ravencrest,1605,druid,feral,36,19,17
Evilshade,ravencrest,1604,druid,feral,115,47,68
Акиша,deepholm,1602,druid,feral,44,21,23
Asçdruid,kazzak,1602,druid,feral,50,22,28
Mcvøvà,kazzak,1601,druid,feral,30,17,13
Kàraba,archimonde,1598,druid,feral,34,20,14
Narunis,tarren-mill,1583,druid,feral,72,33,39
Риама,blackscar,1558,druid,feral,78,38,40
Зонкс,gordunni,1557,druid,feral,82,44,38
Jasperqt,silvermoon,1556,druid,feral,30,18,12
Drylle,argent-dawn,1555,druid,feral,93,50,43
Feralwilder,turalyon,1548,druid,feral,123,47,76
Raznos,ravencrest,1546,druid,feral,53,32,21
Smuktøs,twisting-nether,1546,druid,feral,47,28,19
Chiwsy,outland,1546,druid,feral,53,27,26
Eranor,archimonde,1541,druid,feral,140,72,68
Vëgâñgøðx,ragnaros,1540,druid,feral,104,55,49
Shyngodx,archimonde,1533,druid,feral,41,17,24
Maccín,draenor,1530,druid,feral,52,18,34
Féral,hyjal,1527,druid,feral,42,19,23
Tani,kazzak,1525,druid,feral,45,22,23
Stopwatching,outland,1524,druid,feral,36,16,20
Оудин,blackscar,1521,druid,feral,47,23,24
Мунпраид,gordunni,1514,druid,feral,72,35,37
Муумуумуу,howling-fjord,1512,druid,feral,108,49,59
Rami,sylvanas,1512,druid,feral,66,28,38
Nå,outland,1508,druid,feral,30,16,14
Jerrybeans,ravencrest,1504,druid,feral,120,57,63
Бобасик,fordragon,1491,druid,feral,42,21,21
Rollozuu,blackrock,1483,druid,feral,96,46,50
Màz,blackmoore,1480,druid,feral,140,64,76
Larryburns,nathrezim,1475,druid,feral,42,21,21
Арбузег,gordunni,1472,druid,feral,41,19,22
Clipsy,twilights-hammer,1469,druid,feral,125,60,65
Extracssion,ysondre,1468,druid,feral,44,17,27
Oleander,zuljin,1465,druid,feral,133,66,67
Грязныекогти,gordunni,1464,druid,feral,29,17,12
Zaethul,draenor,1460,druid,feral,30,20,10
Arlina,magtheridon,1454,druid,feral,57,26,31
Margueriti,the-maelstrom,1452,druid,feral,43,17,26
Baerminatør,blackrock,1451,druid,feral,60,26,34
Микайо,goldrinn,1443,druid,feral,107,49,58
Тёмныйзверь,borean-tundra,1435,druid,feral,42,18,24
Boomzter,frostmane,1433,druid,feral,75,36,39
Kaldorei,nemesis,1430,druid,feral,30,15,15
Thaelyy,drakthul,1430,druid,feral,54,22,32
Tazdino,destromath,1427,druid,feral,48,15,33
Arilíaxo,amanthul,1426,druid,feral,18,15,3
Phesxd,sylvanas,1425,druid,feral,42,21,21
Одряя,soulflayer,1424,druid,feral,36,20,16
Lugtedyr,draenor,1423,druid,feral,59,29,30
Vancis,ravencrest,1421,druid,feral,51,29,22
Mervend,tarren-mill,1420,druid,feral,41,15,26
Adastroeolo,sanguino,1419,druid,feral,24,15,9
Panthéra,ravencrest,1417,druid,feral,126,59,67
Vlcák,drakthul,1410,druid,feral,76,37,39
Texoria,twisting-nether,1405,druid,feral,66,28,38
Epicplays,sylvanas,1395,druid,feral,42,23,19
Lukeyferalxo,argent-dawn,1386,druid,feral,114,53,61
Legitx,dentarg,1385,druid,feral,43,17,26
Liqoú,tarren-mill,1380,druid,feral,44,26,18
Sÿlph,sylvanas,1377,druid,feral,90,46,44
Ferøsse,hyjal,1374,druid,feral,42,21,21
Pipima,kazzak,1374,druid,feral,48,20,28
Kimpine,kirin-tor,1365,druid,feral,57,30,27
Bigdaddytate,kazzak,1364,druid,feral,29,17,12
Sabertoon,argent-dawn,1364,druid,feral,131,55,76
Blintschiki,echsenkessel,1363,druid,feral,71,32,39
Rottweiler,doomhammer,1363,druid,feral,48,19,29
Эскоф,gordunni,1359,druid,feral,31,17,14
Manoestouro,draenor,1353,druid,feral,48,19,29
Ripgødx,outland,1350,druid,feral,124,64,60
Biffsteak,blackhand,1349,druid,feral,96,46,50
Беконайзер,howling-fjord,1349,druid,feral,34,16,18
Tyldormeow,tarren-mill,1347,druid,feral,90,40,50
Zechey,stormreaver,1343,druid,feral,24,14,10
Nainket,ravencrest,1341,druid,feral,30,14,16
Fangornn,outland,1340,druid,feral,24,14,10
Cörelly,ravencrest,1340,druid,feral,84,41,43
Enjoik,drakthul,1338,druid,feral,60,27,33
Котфилин,gordunni,1334,druid,feral,60,33,27
Druidicmorr,sylvanas,1332,druid,feral,50,21,29
Tîma,blackmoore,1331,druid,feral,70,31,39
Kärmä,eldrethalas,1326,druid,feral,24,14,10
Chirnaruk,ravencrest,1326,druid,feral,42,17,25
Sartipus,draenor,1323,druid,feral,30,14,16
Vanhelsíng,dun-modr,1322,druid,feral,22,15,7
Беркамп,howling-fjord,1319,druid,feral,99,41,58
Crtx,blackhand,1317,druid,feral,54,33,21
Балаклаваа,soulflayer,1316,druid,feral,29,18,11
Shinshìva,twisting-nether,1316,druid,feral,157,82,75
Алексина,fordragon,1315,druid,feral,36,20,16
Лякокля,soulflayer,1313,druid,feral,60,33,27
Soléda,thrall,1309,druid,feral,60,28,32
Majokz,ravencrest,1307,druid,feral,44,23,21
Regelè,sylvanas,1305,druid,feral,86,45,41
Carakal,outland,1301,druid,feral,42,19,23
ßußßo,ravencrest,1294,druid,feral,24,19,5
Donoz,ravencrest,1293,druid,feral,30,17,13
Grimgoor,burning-legion,1291,druid,feral,36,21,15
Elitarian,argent-dawn,1291,druid,feral,66,29,37
Heyiamdan,tarren-mill,1286,druid,feral,29,16,13
Weydjin,garona,1278,druid,feral,30,16,14
Taigarus,aerie-peak,1277,druid,feral,48,23,25
Nalaa,festung-der-stürme,1277,druid,feral,83,35,48
Laguna,ravencrest,1271,druid,feral,41,14,27
Jxst,tarren-mill,1270,druid,feral,48,19,29
Pepeja,doomhammer,1253,druid,feral,24,15,9
Liionheart,khaz-modan,1252,druid,feral,36,19,17
Kirmelastas,kazzak,1249,druid,feral,50,24,26
Yaddas,draenor,1248,druid,feral,18,13,5
Goldrax,outland,1246,druid,feral,24,13,11
Mooncarnatio,burning-legion,1241,druid,feral,36,13,23
Salseo,uldum,1239,druid,feral,33,14,19
Cheddar,tyrande,1237,druid,feral,29,14,15
Migajde,ravencrest,1234,druid,feral,47,28,19
Cleandc,blackhand,1234,druid,feral,34,20,14
Twyty,khaz-modan,1234,druid,feral,70,33,37
Кеорл,gordunni,1234,druid,feral,102,43,59
Тётявискас,howling-fjord,1233,druid,feral,24,13,11
Webla,blackmoore,1231,druid,feral,29,15,14
Deviantdruid,tarren-mill,1231,druid,feral,39,20,19
Bâbusch,blackmoore,1230,druid,feral,24,13,11
Катяблум,gordunni,1230,druid,feral,30,13,17
Degentiuso,alakir,1229,druid,feral,84,45,39
Shaggery,stormscale,1227,druid,feral,69,27,42
Whísperclaw,ravencrest,1226,druid,feral,41,21,20
Calaftayou,ravencrest,1224,druid,feral,42,17,25
Azmerloth,antonidas,1214,druid,feral,36,13,23
Trusten,nemesis,1209,druid,feral,42,24,18
Exortas,kazzak,1206,druid,feral,49,23,26
Shymä,hyjal,1206,druid,feral,73,30,43
Stelthee,silvermoon,1202,druid,feral,54,21,33
Devonshira,ravencrest,1198,druid,feral,36,14,22
Dougi,argent-dawn,1194,druid,feral,54,23,31
Богарт,soulflayer,1193,druid,feral,24,14,10
Droodae,hyjal,1191,druid,feral,29,14,15
Lorcàn,argent-dawn,1189,druid,feral,52,22,30
Tussenfryd,draenor,1184,druid,feral,88,37,51
Mônchô,sanguino,1182,druid,feral,51,28,23
Kodobursto,stormscale,1182,druid,feral,30,15,15
Hottad,tarren-mill,1179,druid,feral,60,31,29
Hushorde,twisting-nether,1179,druid,feral,29,13,16
Arnwaald,kaelthas,1173,druid,feral,30,16,14
Dadzeus,khaz-modan,1170,druid,feral,23,13,10
Millenia,darkmoon-faire,1170,druid,feral,91,45,46
Kynji,twisting-nether,1169,druid,feral,60,27,33
Blazor,eredar,1161,druid,feral,40,23,17
Cocaqt,nemesis,1151,druid,feral,18,12,6
Howtonio,archimonde,1151,druid,feral,18,12,6
Lenyl,dun-modr,1151,druid,feral,24,12,12
Zbear,kazzak,1151,druid,feral,36,16,20
Tibozx,stormscale,1146,druid,feral,36,21,15
Dirtyfantasy,alakir,1142,druid,feral,42,22,20
Veryfast,blackhand,1142,druid,feral,24,12,12
Malfyurion,ragnaros,1138,druid,feral,36,14,22
Jinxaran,culte-de-la-rive-noire,1135,druid,feral,36,12,24
Koffee,archimonde,1129,druid,feral,24,12,12
Äcajou,hyjal,1125,druid,feral,24,12,12
Кыцко,soulflayer,1124,druid,feral,24,12,12
Swagmode,draenor,1119,druid,feral,49,30,19
Mudpie,stormscale,1114,druid,feral,42,17,25
Malvakten,kazzak,1112,druid,feral,25,13,12
Feraligator,sanguino,1103,druid,feral,74,32,42
Battleray,twisting-nether,1102,druid,feral,45,21,24
Salviaf,silvermoon,1097,druid,feral,70,33,37
Cubswansón,outland,1095,druid,feral,26,13,13
Zivertgodx,argent-dawn,1093,druid,feral,42,20,22
Kyoshî,blackmoore,1092,druid,feral,118,58,60
Nicos,elune,1091,druid,feral,29,13,16
Zaltaruk,sanguino,1089,druid,feral,42,19,23
Vidlna,outland,1089,druid,feral,60,26,34
Tsajj,stormreaver,1083,druid,feral,39,23,16
Hönör,ysondre,1075,druid,feral,72,34,38
Kageioshi,kazzak,1070,druid,feral,56,28,28
Owling,antonidas,1061,druid,feral,48,24,24
Yøløswag,naxxramas,1060,druid,feral,71,38,33
Kermit,die-aldor,1059,druid,feral,51,18,33
Bleêds,dun-modr,1056,druid,feral,18,11,7
Derzis,eonar,1055,druid,feral,54,25,29
Belsebub,ravencrest,1055,druid,feral,30,11,19
Liya,ravencrest,1054,druid,feral,30,11,19
Togara,kazzak,1050,druid,feral,24,11,13
Weedum,kazzak,1046,druid,feral,24,11,13
Zokix,doomhammer,1040,druid,feral,30,12,18
Storslev,stormscale,1039,druid,feral,42,11,31
Mpounia,twilights-hammer,1032,druid,feral,77,40,37
Eternas,elune,1027,druid,feral,82,37,45
Mewantpets,eredar,1022,druid,feral,18,11,7
Dubakoo,outland,1021,druid,feral,22,11,11
Amoonaa,kazzak,1020,druid,feral,42,22,20
Phanterus,chamber-of-aspects,1012,druid,feral,24,11,13
Tatabomba,archimonde,1008,druid,feral,60,30,30
Брэмблс,soulflayer,1008,druid,feral,35,15,20
Smittly,bloodhoof,1005,druid,feral,58,23,35
Tsopúnisher,twisting-nether,990,druid,feral,28,13,15
Bæghira,draenor,986,druid,feral,34,18,16
Janjalism,silvermoon,973,druid,feral,63,34,29
Descendance,ysondre,965,druid,feral,42,20,22
Tjxaxa,ravencrest,960,druid,feral,12,10,2
Nîghtz,ravencrest,960,druid,feral,18,10,8
Docmedlove,aegwynn,960,druid,feral,24,10,14
Muckì,alleria,960,druid,feral,24,10,14
Nøkki,draenor,959,druid,feral,18,10,8
Beerista,tarren-mill,959,druid,feral,24,11,13
Hahafun,ravencrest,959,druid,feral,24,10,14
Паинтер,blackscar,959,druid,feral,24,10,14
Gediminas,argent-dawn,959,druid,feral,30,10,20
Cyph,shadowsong,958,druid,feral,18,10,8
Nîchtsnutz,blackmoore,958,druid,feral,18,10,8
Corrupthz,outland,955,druid,feral,24,10,14
Zjukov,ragnaros,955,druid,feral,24,10,14
Snøwden,twisting-nether,952,druid,feral,18,10,8
Ефомитстерша,gordunni,952,druid,feral,24,10,14
Реептилоид,soulflayer,942,druid,feral,24,10,14
Jåkeferalta,outland,942,druid,feral,29,10,19
Злодзейка,gordunni,941,druid,feral,29,11,18
Klatro,terokkar,936,druid,feral,18,11,7
Stéely,ravencrest,926,druid,feral,24,12,12
Teddîursa,kazzak,915,druid,feral,34,10,24
Bagheera,archimonde,908,druid,feral,23,10,13
Paranoia,outland,895,druid,feral,22,10,12
Mommonga,onyxia,874,druid,feral,38,14,24
Wex,darksorrow,864,druid,feral,12,9,3
Quikahn,outland,864,druid,feral,12,9,3
Urfi,tyrande,864,druid,feral,12,9,3
Aleatório,grim-batol,864,druid,feral,18,9,9
Cocomojo,outland,864,druid,feral,18,9,9
Bignik,tarren-mill,864,druid,feral,18,9,9
Sixmonthbann,ravencrest,864,druid,feral,18,9,9
Fürfur,ravencrest,864,druid,feral,18,9,9
Paramore,outland,864,druid,feral,18,9,9
Fyrka,aegwynn,864,druid,feral,18,9,9
Luphrekfurry,ysondre,864,druid,feral,18,9,9
Furrykruger,the-maelstrom,864,druid,feral,18,9,9
Каергорн,soulflayer,864,druid,feral,24,9,15
Фейк,howling-fjord,864,druid,feral,24,9,15
Hugepepega,ravencrest,863,druid,feral,18,9,9
Deehe,thrall,863,druid,feral,18,9,9
Cjparker,archimonde,863,druid,feral,18,9,9
Rbg,dun-modr,863,druid,feral,22,10,12
Пиггипоп,soulflayer,863,druid,feral,24,9,15
Олежасутра,howling-fjord,863,druid,feral,30,9,21
Мунфайр,galakrond,862,druid,feral,18,9,9
Кецян,gordunni,862,druid,feral,19,9,10
Nalreaa,kazzak,859,druid,feral,18,9,9
Snapeshifter,blackhand,859,druid,feral,18,9,9
Caèlas,outland,859,druid,feral,18,9,9
Hadespool,sanguino,859,druid,feral,18,9,9
Бруан,gordunni,859,druid,feral,24,9,15
Collnaris,ravencrest,857,druid,feral,12,9,3
Paws,dun-modr,857,druid,feral,24,9,15
Dudeimgodly,ravencrest,857,druid,feral,36,9,27
Mgelolaf,doomhammer,856,druid,feral,12,9,3
Noyake,ragnaros,854,druid,feral,24,9,15
Wainl,hyjal,854,druid,feral,30,9,21
Nightfáll,tarren-mill,853,druid,feral,30,9,21
Реалаг,howling-fjord,847,druid,feral,23,9,14
Morfâns,ragnaros,835,druid,feral,24,9,15
Zulazain,bladefist,835,druid,feral,78,28,50
Progodd,silvermoon,833,druid,feral,24,9,15
Hadesx,blackhand,832,druid,feral,18,9,9
Chepochem,stormscale,829,druid,feral,26,10,16
Рефикс,gordunni,827,druid,feral,17,9,8
Kîñg,tarren-mill,821,druid,feral,70,30,40
Théó,grim-batol,818,druid,feral,41,18,23
Snupy,outland,815,druid,feral,17,9,8
Йванныч,gordunni,793,druid,feral,26,9,17
Plingan,argent-dawn,768,druid,feral,12,8,4
Mikor,aegwynn,768,druid,feral,12,8,4
Fallken,burning-blade,768,druid,feral,12,8,4
Snkxo,perenolde,768,druid,feral,12,8,4
Verbxp,kazzak,768,druid,feral,12,8,4
Coineagan,frostmourne,768,druid,feral,18,8,10
Nzmdruid,burning-legion,768,druid,feral,18,8,10
Nédith,archimonde,768,druid,feral,18,8,10
Апвель,gordunni,768,druid,feral,18,8,10
Thørkang,dun-modr,767,druid,feral,12,8,4
Mimir,la-croisade-écarlate,767,druid,feral,12,8,4
Kørnuto,nemesis,767,druid,feral,12,8,4
Seysso,silvermoon,767,druid,feral,18,8,10
Стэлларпауэр,gordunni,767,druid,feral,18,8,10
Jeezuschrist,archimonde,767,druid,feral,18,8,10
Acéré,archimonde,767,druid,feral,24,8,16
Pneuma,xavius,767,druid,feral,24,8,16
Laek,chogall,767,druid,feral,24,8,16
Thielyy,blackmoore,766,druid,feral,18,8,10
Crow,saurfang,766,druid,feral,20,8,12
Krvopito,tarren-mill,765,druid,feral,12,8,4
Plankface,ravencrest,765,druid,feral,18,8,10
Chunkeykill,alonsus,765,druid,feral,18,8,10
Bâlou,nathrezim,764,druid,feral,18,8,10
Shuffey,frostmane,763,druid,feral,12,8,4
Lemmí,frostwolf,763,druid,feral,18,8,10
Käissi,blackmoore,763,druid,feral,18,8,10
Dash,the-maelstrom,763,druid,feral,18,8,10
Holditorsken,grim-batol,761,druid,feral,18,8,10
Ziovris,silvermoon,761,druid,feral,24,8,16
Jupter,burning-blade,755,druid,feral,18,8,10
Zhosy,shattrath,751,druid,feral,17,8,9
Плагиат,grom,749,druid,feral,30,8,22
Lohki,eredar,746,druid,feral,15,9,6
Erelae,twisting-nether,735,druid,feral,16,8,8
Ytzù,archimonde,719,druid,feral,11,8,3
Cyriaan,eredar,719,druid,feral,17,8,9
Tyranderawr,ravencrest,714,druid,feral,21,9,12
Euskal,chogall,703,druid,feral,14,8,6
Xarxius,sanguino,699,druid,feral,32,8,24
Диздру,howling-fjord,672,druid,feral,12,7,5
Goodtrip,hyjal,672,druid,feral,12,7,5
Lolhaha,ravencrest,672,druid,feral,12,7,5
Snkyferalmov,aegwynn,672,druid,feral,12,7,5
Bomoth,kazzak,672,druid,feral,12,7,5
Runeclaws,twisting-nether,672,druid,feral,12,7,5
Àzà,dun-modr,672,druid,feral,12,7,5
Kaÿn,tarren-mill,672,druid,feral,12,7,5
Fíja,blackmoore,672,druid,feral,12,7,5
Фекаллис,soulflayer,672,druid,feral,12,7,5
Dureka,tarren-mill,672,druid,feral,12,7,5
Coldkíng,twisting-nether,672,druid,feral,18,7,11
Ðevilwhite,nemesis,672,druid,feral,18,7,11
Luveena,kazzak,672,druid,feral,18,7,11
Druiidou,dalaran,672,druid,feral,18,7,11
Sethread,ragnaros,672,druid,feral,18,7,11
Oni,kelthuzad,672,druid,feral,18,7,11
Hässelhoof,ragnaros,672,druid,feral,18,7,11
Feytique,aegwynn,672,druid,feral,18,7,11
Liptonbite,blackhand,672,druid,feral,24,7,17
Starliner,ravencrest,672,druid,feral,24,7,17
Селфика,gordunni,672,druid,feral,30,7,23
Криашин,goldrinn,671,druid,feral,12,7,5
Déme,twisting-nether,671,druid,feral,12,7,5
Sôalôgel,blackrock,671,druid,feral,12,7,5
Calîmerô,blackrock,671,druid,feral,12,7,5
Eltroncazo,sanguino,671,druid,feral,18,7,11
Henessi,ragnaros,671,druid,feral,18,7,11
Toron,dalaran,671,druid,feral,18,7,11
Bærbell,blackrock,671,druid,feral,18,7,11
Lazerbinks,blackmoore,671,druid,feral,24,7,17
Noobbiiee,silvermoon,670,druid,feral,12,7,5
Biorythm,draenor,670,druid,feral,12,7,5
Cøcøpøpsmøke,archimonde,670,druid,feral,18,7,11
Toredorxy,blackrock,669,druid,feral,12,7,5
Radime,khaz-modan,669,druid,feral,12,7,5
Терамин,howling-fjord,669,druid,feral,18,7,11
Itzferal,durotan,668,druid,feral,15,7,8
Фаллендэл,gordunni,663,druid,feral,12,7,5
Kovlian,argent-dawn,655,druid,feral,17,7,10
Эвгедент,deathguard,646,druid,feral,30,7,23
Mordpaw,stormscale,639,druid,feral,14,8,6
Nspirit,ravencrest,639,druid,feral,17,7,10
Sìa,frostmane,639,druid,feral,23,7,16
Отхода,gordunni,623,druid,feral,17,7,10
Shalys,archimonde,622,druid,feral,11,7,4
Àyóorts,archimonde,607,druid,feral,14,7,7
Mistic,twisting-nether,601,druid,feral,17,7,10
Hadoukan,ravencrest,576,druid,feral,6,6,0
Shifthappens,dun-modr,576,druid,feral,12,6,6
Tonycatmeow,ravencrest,576,druid,feral,12,6,6
Baccthana,auchindoun,576,druid,feral,12,6,6
Amandial,silvermoon,576,druid,feral,12,6,6
Flawkin,kazzak,576,druid,feral,12,6,6
Snkyexpress,aegwynn,576,druid,feral,12,6,6
Svass,ragnaros,576,druid,feral,12,6,6
Сиэн,ashenvale,576,druid,feral,12,6,6
Vulko,lightbringer,576,druid,feral,12,6,6
Arlandia,drakthul,576,druid,feral,12,6,6
Radauronny,malganis,576,druid,feral,18,6,12
Bilis,nazjatar,576,druid,feral,18,6,12
Fluffygoon,azjolnerub,576,druid,feral,18,6,12
Хокан,deepholm,576,druid,feral,18,6,12
Psixx,blackhand,575,druid,feral,12,6,6
Xurta,kazzak,575,druid,feral,12,6,6
Drudonja,silvermoon,575,druid,feral,12,6,6
Leidbulle,blackrock,575,druid,feral,12,6,6
Скайтибрайдх,gordunni,575,druid,feral,18,6,12
Ghettoven,kazzak,575,druid,feral,18,6,12
Zeyne,ravencrest,574,druid,feral,12,6,6
Tricklou,tarren-mill,574,druid,feral,12,6,6
Lunamimi,argent-dawn,574,druid,feral,12,6,6
Hetalia,culte-de-la-rive-noire,571,druid,feral,12,6,6
Друлевой,greymane,570,druid,feral,12,6,6
Маветт,blackscar,567,druid,feral,18,6,12
Spangle,stormscale,554,druid,feral,21,7,14
Диджейкошка,howling-fjord,527,druid,feral,11,6,5
Блиденг,gordunni,522,druid,feral,21,8,13
Nuashoa,argent-dawn,521,druid,feral,16,7,9
Ryselol,nemesis,480,druid,feral,6,5,1
Dracaan,boulderfist,480,druid,feral,6,5,1
Retzerbil,ravencrest,480,druid,feral,10,6,4
Annksunamun,ysondre,480,druid,feral,12,5,7
Hardbasior,burning-legion,480,druid,feral,12,5,7
Arfgtdispo,hyjal,480,druid,feral,12,5,7
Диаболус,gordunni,480,druid,feral,12,5,7
Hipølita,zuljin,480,druid,feral,12,5,7
Zurllyn,ravencrest,480,druid,feral,12,5,7
Saabeq,hyjal,480,druid,feral,12,5,7
Einsfünfkcat,madmortem,480,druid,feral,12,5,7
Moonglade,deathwing,480,druid,feral,12,5,7
Herten,tarren-mill,480,druid,feral,12,5,7
Медверх,gordunni,480,druid,feral,12,5,7
Sketz,stormscale,480,druid,feral,12,5,7
Rayjinn,dun-modr,480,druid,feral,12,5,7
Rysejr,nemesis,480,druid,feral,12,5,7
Shylovez,aegwynn,480,druid,feral,12,5,7
Hasted,kazzak,480,druid,feral,12,5,7
Turkus,draenor,480,druid,feral,12,5,7
Flum,darksorrow,480,druid,feral,12,5,7
Wucherwurzel,eredar,480,druid,feral,12,5,7
Ashtral,kazzak,480,druid,feral,12,5,7
Шэйпшифт,fordragon,480,druid,feral,12,5,7
Bloomly,tarren-mill,480,druid,feral,12,5,7
Rímeru,blackmoore,480,druid,feral,12,5,7
Rapzr,argent-dawn,480,druid,feral,12,5,7
Animålz,archimonde,480,druid,feral,12,5,7
Erenalby,draenor,480,druid,feral,12,5,7
Siire,ravencrest,480,druid,feral,12,5,7
Hrabioid,burning-legion,480,druid,feral,12,5,7
Kardashìan,ravencrest,480,druid,feral,13,5,8
Derrezzed,stormscale,480,druid,feral,18,5,13
Yiradur,stormscale,480,druid,feral,18,5,13
Enylasi,hyjal,480,druid,feral,18,5,13
Outtanowhere,drakthul,480,druid,feral,18,5,13
Wølveríne,frostmane,480,druid,feral,18,5,13
Mérias,archimonde,480,druid,feral,18,5,13
Yamkar,blackrock,480,druid,feral,18,5,13
Pethebär,tarren-mill,480,druid,feral,18,5,13
Älênkâ,drakthul,480,druid,feral,18,5,13
Cdsxr,outland,480,druid,feral,24,5,19
Alcik,silvermoon,480,druid,feral,24,5,19
Papan,sylvanas,479,druid,feral,6,5,1
Telpha,onyxia,479,druid,feral,12,5,7
Shifts,the-maelstrom,479,druid,feral,12,5,7
Defløwer,aegwynn,479,druid,feral,12,5,7
Poskehh,outland,479,druid,feral,12,5,7
Mambalol,sanguino,479,druid,feral,12,5,7
Terror,agamaggan,479,druid,feral,12,5,7
Шадараф,howling-fjord,479,druid,feral,15,6,9
Менстряк,howling-fjord,479,druid,feral,18,5,13
Друличч,blackscar,479,druid,feral,18,5,13
Yorashi,blackhand,478,druid,feral,6,5,1
Cattastrophe,bronzebeard,477,druid,feral,12,5,7
Mitomen,ragnaros,476,druid,feral,12,5,7
Skylarr,alexstrasza,475,druid,feral,12,5,7
Apetino,dun-modr,447,druid,feral,11,5,6
Carldroid,sylvanas,445,druid,feral,16,5,11
Sároman,ravencrest,431,druid,feral,11,5,6
Zynmeow,lordaeron,416,druid,feral,19,6,13
Nipply,ravencrest,415,druid,feral,15,6,9
Béar,arathor,413,druid,feral,16,5,11
Loyoq,elune,384,druid,feral,6,4,2
Kgn,blackmoore,384,druid,feral,6,4,2
Ryáanz,ravencrest,384,druid,feral,6,4,2
Ryseqt,nemesis,384,druid,feral,6,4,2
Fzx,aegwynn,384,druid,feral,6,4,2
Minaye,hyjal,384,druid,feral,6,4,2
Lïved,nemesis,384,druid,feral,6,4,2
Aslanah,hyjal,384,druid,feral,6,4,2
Diktus,outland,384,druid,feral,6,4,2
Osaviciosa,shendralar,384,druid,feral,6,4,2
Knatch,outland,384,druid,feral,6,4,2
Enock,hyjal,384,druid,feral,6,4,2
Seekx,silvermoon,384,druid,feral,6,4,2
Noxxzar,stormscale,384,druid,feral,6,4,2
Takamizy,ysondre,384,druid,feral,6,4,2
Lakaport,dun-modr,384,druid,feral,6,4,2
Faveyo,die-nachtwache,384,druid,feral,6,4,2
Ábomínatíon,draenor,384,druid,feral,6,4,2
Dystaleon,blackrock,384,druid,feral,6,4,2
Tróllinger,blackrock,384,druid,feral,6,4,2
Сириль,soulflayer,384,druid,feral,6,4,2
Шабашиоргия,soulflayer,384,druid,feral,6,4,2
Pitchou,karazhan,384,druid,feral,12,4,8
Ялория,azuregos,384,druid,feral,12,4,8
Фдру,eversong,384,druid,feral,12,4,8
Tenader,draenor,384,druid,feral,12,4,8
Milkniatrump,tarren-mill,384,druid,feral,12,4,8
Byet,kazzak,384,druid,feral,12,4,8
Notsad,dun-modr,384,druid,feral,12,4,8
Carridwyn,argent-dawn,384,druid,feral,12,4,8
Sekunden,ravencrest,384,druid,feral,12,4,8
Shiotake,hyjal,384,druid,feral,12,4,8
Mbk,kazzak,384,druid,feral,12,4,8
Goatmeal,draenor,384,druid,feral,12,4,8
Турбокалясик,gordunni,384,druid,feral,12,4,8
Plandros,draenor,384,druid,feral,18,4,14
Nidaalee,thrall,383,druid,feral,6,4,2
Tombenuit,tarren-mill,383,druid,feral,6,4,2
Bearshift,aggra-português,383,druid,feral,6,4,2
Tsukuyómi,ragnaros,383,druid,feral,6,4,2
Tettsu,silvermoon,383,druid,feral,12,4,8
Loafy,the-maelstrom,383,druid,feral,12,4,8
Спэкк,gordunni,383,druid,feral,12,4,8
Tastyrawr,blackhand,383,druid,feral,12,4,8
Lutis,magtheridon,383,druid,feral,12,4,8
Tl,archimonde,383,druid,feral,12,4,8
Bumsbert,teldrassil,382,druid,feral,6,4,2
Altramuz,uldum,382,druid,feral,6,4,2
Viølin,silvermoon,381,druid,feral,12,4,8
Phandris,argent-dawn,379,druid,feral,12,4,8
Verbat,cthun,379,druid,feral,12,4,8
Infêrno,twisting-nether,367,druid,feral,17,4,13
Rakuy,thrall,352,druid,feral,10,4,6
Âltashamane,elune,351,druid,feral,11,4,7
Krekigaadzre,draenor,335,druid,feral,9,4,5
Wolfly,ravencrest,329,druid,feral,17,6,11
Броодяга,razuvious,319,druid,feral,5,4,1
Muffler,ragnaros,288,druid,feral,6,3,3
Wildthing,blackmoore,288,druid,feral,6,3,3
Azyol,argent-dawn,288,druid,feral,6,3,3
Carlitto,blackmoore,288,druid,feral,6,3,3
Redlung,outland,288,druid,feral,6,3,3
Мивинчик,ashenvale,288,druid,feral,6,3,3
Fuzzylol,haomarush,288,druid,feral,6,3,3
Ferpylul,ragnaros,288,druid,feral,6,3,3
Giaya,turalyon,288,druid,feral,6,3,3
Druidou,kaelthas,288,druid,feral,6,3,3
Alkurosa,sylvanas,288,druid,feral,6,3,3
Urgrull,baelgun,288,druid,feral,6,3,3
Chinoiserie,aszune,288,druid,feral,6,3,3
Beckett,aszune,288,druid,feral,6,3,3
Xercàs,outland,288,druid,feral,6,3,3
Yepnesse,khaz-modan,288,druid,feral,6,3,3
Sylvy,dun-modr,288,druid,feral,6,3,3
Lyrasanna,argent-dawn,288,druid,feral,6,3,3
Dianabigby,silvermoon,288,druid,feral,6,3,3
Oddform,silvermoon,288,druid,feral,6,3,3
Nightdruidcz,turalyon,288,druid,feral,6,3,3
Fraptal,dalaran,288,druid,feral,6,3,3
Хённим,howling-fjord,288,druid,feral,6,3,3
Даркедес,gordunni,288,druid,feral,6,3,3
Moskaros,turalyon,288,druid,feral,6,3,3
Nefertiti,baelgun,288,druid,feral,6,3,3
Melsson,stormreaver,288,druid,feral,6,3,3
Chouan,marécage-de-zangar,288,druid,feral,6,3,3
Hundavidsad,quelthalas,288,druid,feral,6,3,3
Worgenshiftr,kazzak,288,druid,feral,6,3,3
Леромейкен,fordragon,288,druid,feral,6,3,3
Fearthecat,defias-brotherhood,288,druid,feral,6,3,3
Moonpuff,kazzak,288,druid,feral,6,3,3
Chronoqtxd,ravencrest,288,druid,feral,6,3,3
Babynaty,ravencrest,288,druid,feral,6,3,3
Reservebär,blackhand,288,druid,feral,6,3,3
Druidicchi,stormscale,288,druid,feral,6,3,3
Vãrima,ravencrest,288,druid,feral,6,3,3
Biggestnick,ravencrest,288,druid,feral,6,3,3
Lunanikuya,ravencrest,288,druid,feral,6,3,3
Ðeathwatch,ravencrest,288,druid,feral,6,3,3
Madgazfanboi,ravencrest,288,druid,feral,6,3,3
Broccoliform,eredar,288,druid,feral,6,3,3
Kúùsh,frostwolf,288,druid,feral,6,3,3
Mooqt,alexstrasza,288,druid,feral,6,3,3
Zantill,chamber-of-aspects,288,druid,feral,7,3,4
Shingeki,alonsus,288,druid,feral,8,3,5
Myex,exodar,288,druid,feral,12,3,9
Alimona,the-venture-co,288,druid,feral,12,3,9
Bénjî,khazgoroth,288,druid,feral,12,3,9
Skywíng,stormscale,288,druid,feral,12,3,9
Kittyclâw,perenolde,288,druid,feral,12,3,9
Lupa,drakthul,288,druid,feral,12,3,9
Лорья,azuregos,288,druid,feral,12,3,9
Psychodeliya,ragnaros,288,druid,feral,12,3,9
Drocos,genjuros,288,druid,feral,12,3,9
Zink,sanguino,288,druid,feral,12,3,9
Phòènìx,twisting-nether,288,druid,feral,12,3,9
Trikill,hyjal,288,druid,feral,13,3,10
Tallbutshort,stormscale,288,druid,feral,18,3,15
Frincessa,burning-legion,288,druid,feral,18,3,15
Denadu,turalyon,288,druid,feral,18,3,15
Жекакотик,eversong,287,druid,feral,6,3,3
Giosis,stormscale,287,druid,feral,6,3,3
Cemendur,bronzebeard,287,druid,feral,6,3,3
Vólotyr,ravencrest,287,druid,feral,12,3,9
Vicendius,drakthul,287,druid,feral,12,3,9
Kyth,forscherliga,287,druid,feral,12,3,9
Greenfingerz,azjolnerub,287,druid,feral,12,3,9
Poxu,eredar,287,druid,feral,18,3,15
Bakar,ghostlands,286,druid,feral,6,3,3
Zottelmahne,blackrock,286,druid,feral,6,3,3
Zhabka,silvermoon,286,druid,feral,6,3,3
Glanis,malorne,271,druid,feral,11,3,8
Bartax,culte-de-la-rive-noire,240,druid,feral,9,3,6
Anyône,dun-morogh,229,druid,feral,16,4,12
Druiddamage,the-maelstrom,192,druid,feral,6,2,4
Nelfboyuk,tarren-mill,192,druid,feral,6,2,4
Erundrood,ysondre,192,druid,feral,6,2,4
Chikiz,ghostlands,192,druid,feral,6,2,4
Вендьета,blackscar,192,druid,feral,6,2,4
Sandirion,silvermoon,192,druid,feral,6,2,4
Feralsaber,ghostlands,192,druid,feral,6,2,4
Nidra,silvermoon,192,druid,feral,6,2,4
Voyerka,drakthul,192,druid,feral,6,2,4
Pitsas,silvermoon,192,druid,feral,6,2,4
Astlanes,ysondre,192,druid,feral,6,2,4
Melcow,eredar,192,druid,feral,6,2,4
Эриэс,gordunni,192,druid,feral,6,2,4
Трясишатай,gordunni,192,druid,feral,6,2,4
Sølaria,kazzak,192,druid,feral,6,2,4
Dwaokut,ravencrest,192,druid,feral,6,2,4
Snuggums,argent-dawn,192,druid,feral,6,2,4
Crisspurolss,ysondre,192,druid,feral,6,2,4
Tøpkittyg,twisting-nether,192,druid,feral,6,2,4
Dilleydank,ravencrest,192,druid,feral,6,2,4
Sheiheda,kazzak,192,druid,feral,6,2,4
Variolus,dun-modr,192,druid,feral,6,2,4
Catbear,kazzak,192,druid,feral,6,2,4
Jimmyxdd,kazzak,192,druid,feral,6,2,4
Wuzzington,outland,192,druid,feral,6,2,4
Jamaican,outland,192,druid,feral,6,2,4
Docdruid,outland,192,druid,feral,6,2,4
Glyn,earthen-ring,192,druid,feral,6,2,4
Канвус,gordunni,192,druid,feral,6,2,4
Xilmai,darksorrow,192,druid,feral,6,2,4
Savagehèals,ravencrest,192,druid,feral,6,2,4
Rimpularaisa,grim-batol,192,druid,feral,6,2,4
Citrus,sargeras,192,druid,feral,6,2,4
Rabatout,eitrigg,192,druid,feral,6,2,4
Lilkâzzam,blackrock,192,druid,feral,6,2,4
Glenn,alakir,192,druid,feral,6,2,4
Naetsch,blackrock,192,druid,feral,6,2,4
Zyron,sanguino,192,druid,feral,6,2,4
Ephixa,burning-legion,192,druid,feral,6,2,4
Metamø,blackrock,192,druid,feral,6,2,4
Catwild,blackmoore,192,druid,feral,6,2,4
Leylå,ravencrest,192,druid,feral,6,2,4
Aryitu,blackrock,192,druid,feral,6,2,4
Treepoloski,stormscale,192,druid,feral,6,2,4
Nicodruid,ravencrest,192,druid,feral,6,2,4
Mcservietsky,chogall,192,druid,feral,6,2,4
Seekíng,blackmoore,192,druid,feral,6,2,4
Kiizal,twisting-nether,192,druid,feral,6,2,4
Ckelf,ravencrest,192,druid,feral,6,2,4
Rabacki,blackmoore,192,druid,feral,6,2,4
Вохако,howling-fjord,192,druid,feral,6,2,4
Kisskossa,stormscale,192,druid,feral,6,2,4
Bóssít,doomhammer,192,druid,feral,6,2,4
Lyvaley,dun-modr,192,druid,feral,6,2,4
Santamonica,blackrock,192,druid,feral,6,2,4
Trànsformer,nemesis,192,druid,feral,12,2,10
Affines,the-maelstrom,192,druid,feral,12,2,10
Nkoyi,argent-dawn,192,druid,feral,12,2,10
Erelieva,silvermoon,192,druid,feral,12,2,10
Speegle,kazzak,192,druid,feral,12,2,10
Vanarea,argent-dawn,192,druid,feral,12,2,10
Nicotex,draenor,192,druid,feral,12,2,10
Feralzeus,sylvanas,192,druid,feral,12,2,10
Naturexbot,silvermoon,192,druid,feral,12,2,10
Amoveo,argent-dawn,192,druid,feral,12,2,10
Ôpium,eldrethalas,191,druid,feral,6,2,4
Jompemanfish,stormscale,191,druid,feral,6,2,4
Kittasek,drakthul,191,druid,feral,6,2,4
Loriann,twisting-nether,191,druid,feral,18,2,16
Meuhtéki,hyjal,190,druid,feral,13,3,10
Avisa,blackhand,190,druid,feral,12,2,10
Shadøwdruid,silvermoon,190,druid,feral,18,2,16
Ilyethea,earthen-ring,175,druid,feral,11,2,9
Muryo,der-rat-von-dalaran,159,druid,feral,5,2,3
Hiloqtdruid,blackmoore,159,druid,feral,5,2,3
Korkskruven,draenor,159,druid,feral,5,2,3
Найадра,gordunni,144,druid,feral,9,2,7
Azaría,aegwynn,128,druid,feral,4,2,2
Lionquokk,azjolnerub,128,druid,feral,4,2,2
Baniaucygana,draenor,127,druid,feral,4,2,2
Wurnas,silvermoon,121,druid,feral,15,3,12
Dèxò,blackmoore,96,druid,feral,11,4,7
Moderntalkin,aegwynn,96,druid,feral,17,4,13
Nidrien,doomhammer,96,druid,feral,6,1,5
Ragnai,emerald-dream,96,druid,feral,6,1,5
Imsothorny,genjuros,96,druid,feral,6,1,5
Albinoape,doomhammer,96,druid,feral,6,1,5
Gurudru,tarren-mill,96,druid,feral,6,1,5
Fabulous,genjuros,96,druid,feral,6,1,5
Ayatola,conseil-des-ombres,96,druid,feral,6,1,5
Tshungubuäch,eredar,96,druid,feral,6,1,5
Catgirlx,ravencrest,96,druid,feral,6,1,5
Benfufu,kazzak,96,druid,feral,6,1,5
Noxxìe,draenor,96,druid,feral,6,1,5
Горртек,howling-fjord,96,druid,feral,6,1,5
Théodên,dalaran,96,druid,feral,6,1,5
Tael,argent-dawn,96,druid,feral,6,1,5
Venomjr,bloodhoof,96,druid,feral,6,1,5
Strand,ragnaros,96,druid,feral,6,1,5
Maräanhatähr,silvermoon,96,druid,feral,6,1,5
Sabresheep,twisting-nether,96,druid,feral,6,1,5
Saliencias,kazzak,96,druid,feral,6,1,5
Kuw,archimonde,96,druid,feral,6,1,5
Awán,aegwynn,96,druid,feral,6,1,5
Мурталор,soulflayer,96,druid,feral,6,1,5
Yarrp,stormscale,96,druid,feral,6,1,5
Majesty,nagrand,96,druid,feral,6,1,5
Haragmancs,arathor,96,druid,feral,6,1,5
Ãnimal,argent-dawn,96,druid,feral,6,1,5
Zinister,hyjal,96,druid,feral,6,1,5
Yabooni,ravencrest,96,druid,feral,6,1,5
Zðe,la-croisade-écarlate,96,druid,feral,6,1,5
Бабакошка,gordunni,96,druid,feral,6,1,5
Jamera,stormscale,96,druid,feral,6,1,5
Plàntz,tarren-mill,96,druid,feral,6,1,5
Thaneo,blackmoore,96,druid,feral,6,1,5
Snootxt,blackmoore,96,druid,feral,6,1,5
Хэрес,gordunni,96,druid,feral,6,1,5
Hccl,blackhand,96,druid,feral,6,1,5
Markuslanz,blackrock,96,druid,feral,6,1,5
Heav,kiljaeden,96,druid,feral,6,1,5
Taco,eredar,96,druid,feral,12,1,11
Mäywen,ravencrest,96,druid,feral,12,1,11
Veyronn,burning-legion,96,druid,feral,12,1,11
Nakkikastike,magtheridon,96,druid,feral,12,1,11
Farnae,kirin-tor,96,druid,feral,12,1,11
Teám,tarren-mill,96,druid,feral,12,1,11
Bidodici,nemesis,95,druid,feral,6,1,5
Allîyâ,archimonde,79,druid,feral,5,1,4
Forigiver,draenor,64,druid,feral,4,1,3
Прокси,gordunni,64,druid,feral,4,1,3
Aendy,tarren-mill,48,druid,feral,3,1,2
Wadles,draenor,48,druid,feral,3,1,2
Fuséton,tarren-mill,2332,druid,balance,197,120,77
Maroxd,stormscale,2305,druid,balance,64,48,16
Merceý,ravencrest,2288,druid,balance,87,59,28
Bd,stormscale,2225,druid,balance,83,49,34
Wriong,ravencrest,2224,druid,balance,129,79,50
Immuz,kazzak,2215,druid,balance,101,55,46
Broccoliboy,sylvanas,2199,druid,balance,78,46,32
Norgand,die-aldor,2173,druid,balance,42,33,9
Tmeister,kazzak,2145,druid,balance,84,50,34
Sleepyhallow,blackmoore,2142,druid,balance,100,58,42
Thelire,silvermoon,2137,druid,balance,192,105,87
Isatá,ravencrest,2123,druid,balance,66,42,24
Ackiz,ravencrest,2121,druid,balance,69,42,27
Shayia,aegwynn,2121,druid,balance,119,65,54
Jwrld,stormscale,2121,druid,balance,66,35,31
Skivesnulle,kazzak,2119,druid,balance,119,60,59
Ursulaboomer,blackrock,2117,druid,balance,66,43,23
Batboomie,zuljin,2117,druid,balance,227,126,101
Winkler,kazzak,2109,druid,balance,50,38,12
Crippaa,tarren-mill,2106,druid,balance,63,45,18
Deép,nazjatar,2106,druid,balance,84,45,39
Бубаджек,howling-fjord,2102,druid,balance,48,31,17
Aggroasian,tarren-mill,2084,druid,balance,219,127,92
Ôwlnur,kult-der-verdammten,2080,druid,balance,85,50,35
Mephîs,ravencrest,2078,druid,balance,76,49,27
Eviscreator,stormscale,2076,druid,balance,120,76,44
Vabore,twisting-nether,2075,druid,balance,72,41,31
Dincks,draenor,2069,druid,balance,77,50,27
Agagagagagag,ravencrest,2065,druid,balance,75,42,33
Rexonadudu,kazzak,2060,druid,balance,141,84,57
Sadgeconvoke,draenor,2059,druid,balance,118,86,32
Antahka,archimonde,2057,druid,balance,60,34,26
Shivany,twisting-nether,2052,druid,balance,130,66,64
Eôxxd,blackrock,2051,druid,balance,65,45,20
Positivîty,stormscale,2048,druid,balance,138,82,56
Turtleform,blackrock,2046,druid,balance,88,42,46
Méáckós,aegwynn,2041,druid,balance,116,58,58
Nutsnack,tarren-mill,2039,druid,balance,78,38,40
Рейзакх,howling-fjord,2036,druid,balance,102,57,45
Oskol,tarren-mill,2033,druid,balance,58,31,27
Владисзади,gordunni,2024,druid,balance,101,55,46
Flanagân,hyjal,2020,druid,balance,42,26,16
Akinimod,ravencrest,2017,druid,balance,74,47,27
Saufeb,stormscale,2016,druid,balance,83,50,33
Qtkitty,outland,2016,druid,balance,177,106,71
Bulla,culte-de-la-rive-noire,2004,druid,balance,118,74,44
Gulmi,outland,2003,druid,balance,77,47,30
Wwboomy,kazzak,1999,druid,balance,72,38,34
Käyn,argent-dawn,1997,druid,balance,99,57,42
Klimakleber,ravencrest,1997,druid,balance,135,67,68
Shåmss,kazzak,1995,druid,balance,42,27,15
Catchmê,archimonde,1993,druid,balance,62,36,26
Bittebads,stormscale,1987,druid,balance,54,35,19
Rootzxx,ravencrest,1983,druid,balance,78,46,32
Karvajyrä,stormreaver,1972,druid,balance,162,96,66
Newaccount,kazzak,1966,druid,balance,66,45,21
ßa,blackmoore,1960,druid,balance,59,38,21
Uglyrasputin,blackmoore,1960,druid,balance,156,94,62
Ganqb,ravencrest,1955,druid,balance,315,179,136
Flæppy,blackmoore,1952,druid,balance,145,75,70
Kruwkamilka,burning-legion,1950,druid,balance,92,54,38
Disvikz,outland,1950,druid,balance,66,38,28
Néllÿ,elune,1942,druid,balance,102,51,51
Slaugh,zuljin,1935,druid,balance,89,48,41
Wizzlafa,ravencrest,1930,druid,balance,76,44,32
Howgh,destromath,1926,druid,balance,162,88,74
Crnkie,sylvanas,1925,druid,balance,30,24,6
Transmangodx,tarren-mill,1923,druid,balance,60,38,22
Mooskie,draenor,1921,druid,balance,54,37,17
Muhammadali,ravencrest,1921,druid,balance,54,28,26
Bákhar,ravencrest,1921,druid,balance,83,42,41
Handsoff,stormscale,1919,druid,balance,144,72,72
Fredhqt,tarren-mill,1918,druid,balance,59,37,22
Laserchicken,malganis,1912,druid,balance,95,47,48
Win,hellscream,1907,druid,balance,84,45,39
Trntydr,senjin,1906,druid,balance,41,30,11
Feelstreeman,twisting-nether,1905,druid,balance,30,20,10
Secrägodx,ragnaros,1903,druid,balance,54,32,22
Muufasa,blackmoore,1899,druid,balance,170,88,82
Zendda,hyjal,1896,druid,balance,61,30,31
Malex,auchindoun,1895,druid,balance,54,32,22
Rek,sanguino,1893,druid,balance,57,33,24
Votionex,tarren-mill,1891,druid,balance,64,38,26
Hppsr,eredar,1889,druid,balance,66,35,31
Небесныйхант,soulflayer,1887,druid,balance,77,42,35
Даирлин,gordunni,1883,druid,balance,112,54,58
Kankstery,stormscale,1882,druid,balance,65,44,21
Bastodonte,skullcrusher,1881,druid,balance,136,72,64
Greenful,drakthul,1880,druid,balance,36,24,12
Blopstar,stormscale,1879,druid,balance,54,34,20
Mdrgtwo,ravencrest,1877,druid,balance,47,34,13
Sentería,sylvanas,1876,druid,balance,60,30,30
Øncê,durotan,1871,druid,balance,54,29,25
Tobid,blackrock,1869,druid,balance,48,36,12
Fiskmåsn,twisting-nether,1866,druid,balance,125,74,51
Hunkex,frostmane,1864,druid,balance,57,32,25
Zødzin,kazzak,1863,druid,balance,42,25,17
Flanagàn,hyjal,1860,druid,balance,58,31,27
Rbgkári,draenor,1857,druid,balance,48,36,12
Didiee,kazzak,1857,druid,balance,84,46,38
Ghostpaws,ravencrest,1857,druid,balance,66,35,31
Maijs,ravencrest,1857,druid,balance,66,31,35
Peaches,aerie-peak,1856,druid,balance,59,41,18
Starbro,grim-batol,1856,druid,balance,48,27,21
Damigjat,sylvanas,1854,druid,balance,167,107,60
Emmdru,silvermoon,1854,druid,balance,101,63,38
Näela,archimonde,1850,druid,balance,54,27,27
Øhmygød,stormscale,1848,druid,balance,48,26,22
Найттир,gordunni,1848,druid,balance,60,32,28
Gurru,xavius,1848,druid,balance,113,58,55
Tzeeni,stormscale,1847,druid,balance,35,28,7
Mesmerizing,ravencrest,1847,druid,balance,54,31,23
Credenz,frostmane,1845,druid,balance,90,52,38
Laker,stormscale,1843,druid,balance,82,45,37
Арадия,gordunni,1843,druid,balance,66,35,31
Gipi,ravencrest,1843,druid,balance,60,31,29
Imperiusx,ravencrest,1840,druid,balance,132,76,56
Hrz,kazzak,1839,druid,balance,79,50,29
Starfallkey,dun-modr,1839,druid,balance,99,61,38
Pluginbaby,stormscale,1838,druid,balance,64,41,23
Knùbz,ravencrest,1837,druid,balance,71,35,36
Tjillevippen,tarren-mill,1836,druid,balance,36,23,13
Metamoo,tarren-mill,1835,druid,balance,47,36,11
Atrosity,ravencrest,1835,druid,balance,66,40,26
Zuterlø,ragnaros,1834,druid,balance,54,28,26
Izhusky,ravencrest,1833,druid,balance,41,26,15
Tommyruin,the-venture-co,1833,druid,balance,46,28,18
Кирукхэ,gordunni,1832,druid,balance,36,28,8
Nuvemone,stormscale,1832,druid,balance,90,51,39
Tárzáñ,ravencrest,1831,druid,balance,60,37,23
Meowcry,outland,1830,druid,balance,60,37,23
Ezeke,eredar,1830,druid,balance,160,79,81
Mopboomkin,twisting-nether,1828,druid,balance,48,29,19
Rngmåchinéx,ravencrest,1827,druid,balance,109,74,35
Nyndrà,archimonde,1826,druid,balance,135,66,69
Carnivals,twisting-nether,1825,druid,balance,54,31,23
Afret,kazzak,1824,druid,balance,186,96,90
Dizay,xavius,1823,druid,balance,60,40,20
Hammd,kazzak,1823,druid,balance,50,32,18
Bearpawzz,kazzak,1823,druid,balance,48,29,19
Faxotium,argent-dawn,1822,druid,balance,30,21,9
Djemdruid,argent-dawn,1822,druid,balance,42,27,15
Рябчиик,blackscar,1822,druid,balance,122,71,51
Ciucciotutto,nemesis,1821,druid,balance,30,24,6
Хальтенис,gordunni,1819,druid,balance,58,34,24
Sunshinex,silvermoon,1818,druid,balance,96,47,49
Moonhusky,blackrock,1817,druid,balance,54,34,20
Captaïn,twisting-nether,1816,druid,balance,36,27,9
Lunahu,argent-dawn,1816,druid,balance,72,42,30
Astrobazooka,stormreaver,1815,druid,balance,77,48,29
Миртлэкшн,gordunni,1815,druid,balance,71,38,33
Wrathgodx,aegwynn,1814,druid,balance,36,24,12
Dudukid,nemesis,1814,druid,balance,78,39,39
Hyac,the-maelstrom,1811,druid,balance,36,26,10
Flanders,blackrock,1811,druid,balance,36,25,11
Bashmac,mugthol,1811,druid,balance,72,49,23
Juicypus,ragnaros,1809,druid,balance,48,29,19
Ferawri,draenor,1808,druid,balance,42,24,18
Scaleo,stormreaver,1808,druid,balance,90,48,42
Icek,outland,1806,druid,balance,54,33,21
Solariah,garona,1804,druid,balance,143,84,59
Cøntrol,argent-dawn,1804,druid,balance,60,34,26
Ruetinjeri,blackmoore,1804,druid,balance,73,38,35
Pvekek,stormscale,1801,druid,balance,38,25,13
Geîl,blackrock,1801,druid,balance,42,24,18
Punxybear,ravencrest,1798,druid,balance,192,97,95
Narq,sylvanas,1792,druid,balance,54,32,22
Andreud,dunemaul,1788,druid,balance,71,33,38
Ventrìx,alleria,1787,druid,balance,84,43,41
Longhornjohn,ragnaros,1784,druid,balance,58,33,25
Trekkertt,zuljin,1784,druid,balance,53,28,25
Euphørie,twisting-nether,1783,druid,balance,163,94,69
Kjøttberit,moonglade,1775,druid,balance,30,23,7
Darktigrou,archimonde,1775,druid,balance,30,21,9
Zkrd,kazzak,1774,druid,balance,61,33,28
Gehrkehotter,silvermoon,1773,druid,balance,84,54,30
Xyzy,burning-legion,1770,druid,balance,72,38,34
Dyroxs,twisting-nether,1770,druid,balance,89,44,45
Abyssaldepth,ravencrest,1768,druid,balance,84,58,26
Kirexz,blackrock,1767,druid,balance,36,27,9
Shiftowl,tarren-mill,1766,druid,balance,36,25,11
Mirynn,elune,1766,druid,balance,127,64,63
Bøøstèdtréè,ravencrest,1765,druid,balance,60,38,22
Starsy,frostmane,1764,druid,balance,42,20,22
Сосисосочка,gordunni,1763,druid,balance,48,23,25
Ccoco,aegwynn,1761,druid,balance,36,24,12
Neirdá,hyjal,1760,druid,balance,161,87,74
Jenovas,argent-dawn,1759,druid,balance,57,30,27
Escaa,stormscale,1757,druid,balance,36,21,15
Babynaty,ravencrest,1756,druid,balance,158,77,81
Gudñ,tarren-mill,1751,druid,balance,53,32,21
Kørra,dun-modr,1747,druid,balance,55,34,21
Shàal,ysondre,1747,druid,balance,59,32,27
Ånaðeårmas,outland,1746,druid,balance,77,47,30
Sylvy,dun-modr,1746,druid,balance,100,55,45
Mochiløxz,tarren-mill,1745,druid,balance,68,44,24
Yuhor,outland,1745,druid,balance,112,64,48
Limme,ravencrest,1741,druid,balance,46,32,14
Meowmf,silvermoon,1739,druid,balance,60,39,21
Dràkàn,dethecus,1739,druid,balance,42,24,18
Gallokiriko,zuljin,1738,druid,balance,66,32,34
Qtrly,ravencrest,1737,druid,balance,44,21,23
Fuzzylol,haomarush,1736,druid,balance,41,24,17
Connorz,blackmoore,1735,druid,balance,42,25,17
Bigbaddream,stormscale,1733,druid,balance,60,34,26
Трэйкотик,blackscar,1728,druid,balance,53,32,21
Pultsarí,tarren-mill,1725,druid,balance,39,24,15
Pouletqt,archimonde,1723,druid,balance,42,21,21
Bumkin,bloodhoof,1722,druid,balance,36,21,15
Boomjutzu,kazzak,1721,druid,balance,30,18,12
Calê,blackrock,1720,druid,balance,69,44,25
Hugeragê,stormreaver,1719,druid,balance,71,33,38
Kalgarm,burning-legion,1719,druid,balance,66,29,37
Quadpulse,ravencrest,1718,druid,balance,36,18,18
Elissian,silvermoon,1717,druid,balance,155,84,71
Pwnylol,teldrassil,1716,druid,balance,64,43,21
Подпивасникх,gordunni,1715,druid,balance,30,20,10
Онличикен,gordunni,1714,druid,balance,108,54,54
Владибой,gordunni,1712,druid,balance,36,18,18
Bîjaqt,blackmoore,1710,druid,balance,30,18,12
Ахисса,gordunni,1709,druid,balance,48,24,24
Shreedex,blackmoore,1707,druid,balance,54,37,17
Linkin,azshara,1704,druid,balance,102,53,49
Naturez,sylvanas,1704,druid,balance,74,37,37
Травкер,howling-fjord,1702,druid,balance,197,93,104
Neufcinqq,archimonde,1700,druid,balance,39,26,13
Thardruid,stormscale,1699,druid,balance,72,42,30
Drutro,hellfire,1699,druid,balance,42,23,19
Htxo,kazzak,1698,druid,balance,30,18,12
Raykk,culte-de-la-rive-noire,1696,druid,balance,30,18,12
Kaabeedo,ravencrest,1696,druid,balance,42,23,19
Pyaw,kazzak,1693,druid,balance,48,30,18
Starcowx,ragnaros,1692,druid,balance,51,27,24
Melyssea,argent-dawn,1691,druid,balance,41,23,18
Pneuma,xavius,1691,druid,balance,111,62,49
Néxct,stormscale,1688,druid,balance,36,22,14
Gambós,kazzak,1687,druid,balance,29,18,11
Kenzia,stormrage,1687,druid,balance,30,18,12
Zerozerosex,archimonde,1686,druid,balance,54,25,29
Güccïmane,twisting-nether,1685,druid,balance,72,53,19
Shakso,stormscale,1683,druid,balance,36,21,15
Лёхалепеха,gordunni,1682,druid,balance,48,29,19
Mäismz,hyjal,1680,druid,balance,48,34,14
Leqt,ravencrest,1680,druid,balance,48,29,19
Macron,terokkar,1677,druid,balance,52,30,22
Highonfire,grim-batol,1676,druid,balance,60,41,19
Nassii,antonidas,1675,druid,balance,96,61,35
Wrldx,twisting-nether,1673,druid,balance,54,31,23
Сибирячечка,greymane,1672,druid,balance,89,48,41
Alxzdru,auchindoun,1671,druid,balance,51,36,15
Мэдикейт,soulflayer,1668,druid,balance,54,33,21
Drcaøs,sanguino,1668,druid,balance,84,47,37
Æøøm,blackmoore,1667,druid,balance,89,48,41
Esrín,the-maelstrom,1667,druid,balance,84,45,39
Kribie,aegwynn,1663,druid,balance,30,20,10
Даена,razuvious,1662,druid,balance,24,19,5
Ahuevshiy,wildhammer,1662,druid,balance,36,25,11
Millions,tarren-mill,1661,druid,balance,61,40,21
Cyriaan,eredar,1660,druid,balance,81,44,37
Jøkèr,outland,1660,druid,balance,41,22,19
Shapeshift,sanguino,1659,druid,balance,62,34,28
Møømøø,tarren-mill,1658,druid,balance,30,18,12
Kaïnak,dalaran,1657,druid,balance,48,25,23
Jamzydruid,kazzak,1657,druid,balance,72,37,35
Shaakm,nerathor,1656,druid,balance,54,32,22
Jaycutler,archimonde,1655,druid,balance,66,34,32
Mendorin,stormrage,1654,druid,balance,60,33,27
Svend,kazzak,1653,druid,balance,59,36,23
Tuttu,kazzak,1651,druid,balance,36,19,17
Dreathqt,twisting-nether,1651,druid,balance,66,28,38
Oommis,outland,1649,druid,balance,42,23,19
Justyo,archimonde,1648,druid,balance,29,22,7
Troc,karazhan,1648,druid,balance,30,21,9
Snøø,frostwolf,1647,druid,balance,48,25,23
Grisdrood,draenor,1647,druid,balance,155,79,76
Xora,kazzak,1646,druid,balance,143,72,71
Ampdru,ravencrest,1644,druid,balance,23,18,5
Hyunâ,dalaran,1644,druid,balance,42,27,15
Twitchmoney,archimonde,1643,druid,balance,32,24,8
Øffroadz,blackmoore,1643,druid,balance,30,20,10
Panpanqcul,archimonde,1643,druid,balance,46,29,17
Pradasurge,ravencrest,1642,druid,balance,149,81,68
Ploho,blackmoore,1642,druid,balance,39,19,20
Mqs,stormscale,1641,druid,balance,39,27,12
Хотдиллер,howling-fjord,1639,druid,balance,30,20,10
Zapx,hyjal,1639,druid,balance,90,50,40
Yarinai,blackmoore,1637,druid,balance,54,29,25
Obrys,tarren-mill,1637,druid,balance,42,21,21
Bambye,stormscale,1636,druid,balance,42,28,14
Grafíx,blackrock,1636,druid,balance,30,18,12
Derfaï,kaelthas,1636,druid,balance,41,21,20
Deví,twilights-hammer,1634,druid,balance,48,30,18
Elunælle,les-sentinelles,1634,druid,balance,39,24,15
Naturalbeef,argent-dawn,1634,druid,balance,40,22,18
Settembre,ragnaros,1633,druid,balance,33,22,11
Слоич,howling-fjord,1632,druid,balance,51,23,28
Rekked,alleria,1631,druid,balance,42,23,19
Masakrelol,sanguino,1631,druid,balance,36,18,18
Squirtdogx,drakthul,1630,druid,balance,30,17,13
Hotsincee,stormscale,1629,druid,balance,71,41,30
Èøèøèøèøè,stormscale,1627,druid,balance,18,17,1
Legitx,dentarg,1627,druid,balance,42,22,20
Ööh,outland,1624,druid,balance,30,17,13
Зетзул,grom,1624,druid,balance,197,101,96
Amoveo,argent-dawn,1623,druid,balance,51,31,20
Лсдспайсы,soulflayer,1623,druid,balance,36,21,15
Çhîñêséðrüîð,kazzak,1623,druid,balance,36,21,15
Durkdriven,kazzak,1623,druid,balance,45,24,21
Kåmen,ravenholdt,1620,druid,balance,91,53,38
Kabôôm,stormscale,1620,druid,balance,30,17,13
Moonzysunzy,sylvanas,1620,druid,balance,30,17,13
Landesverrat,kazzak,1619,druid,balance,24,21,3
Nastyclones,kazzak,1619,druid,balance,24,17,7
Blanoz,ravencrest,1619,druid,balance,42,17,25
Whisker,outland,1618,druid,balance,24,17,7
Youngdinozzo,dalaran,1618,druid,balance,35,23,12
Ícekiss,hyjal,1617,druid,balance,30,24,6
Друлякич,gordunni,1617,druid,balance,30,17,13
Kabuul,dun-modr,1616,druid,balance,89,54,35
Ryuzu,aegwynn,1616,druid,balance,79,45,34
Âlhajillo,dun-modr,1615,druid,balance,30,17,13
Stepgødx,twisting-nether,1614,druid,balance,36,17,19
Hilom,grim-batol,1613,druid,balance,30,18,12
Exilara,twisting-nether,1612,druid,balance,61,38,23
Cptnclone,blackmoore,1612,druid,balance,60,30,30
Hornykarenn,bladefist,1611,druid,balance,24,17,7
Pëchy,aggra-português,1611,druid,balance,54,33,21
Xenuss,kazzak,1611,druid,balance,36,22,14
Trinket,frostmane,1610,druid,balance,30,23,7
Вбг,soulflayer,1610,druid,balance,30,17,13
Аласторвов,deathweaver,1610,druid,balance,60,28,32
Deadmeøw,outland,1609,druid,balance,34,21,13
Större,twisting-nether,1607,druid,balance,42,28,14
Slahnesh,aegwynn,1607,druid,balance,36,20,16
Doncy,ragnaros,1607,druid,balance,54,24,30
Ryng,nagrand,1606,druid,balance,60,41,19
Porzi,eredar,1606,druid,balance,66,41,25
Lillevän,tarren-mill,1606,druid,balance,30,18,12
Teaser,dun-modr,1606,druid,balance,48,26,22
Scamlafsen,ragnaros,1606,druid,balance,42,22,20
Milkywáys,draenor,1606,druid,balance,106,55,51
Neverpanic,stormscale,1605,druid,balance,30,21,9
Hashishi,grim-batol,1605,druid,balance,60,34,26
Kkona,silvermoon,1605,druid,balance,71,37,34
Isylia,twisting-nether,1605,druid,balance,72,36,36
Угощаюх,howling-fjord,1604,druid,balance,24,17,7
Goom,rexxar,1602,druid,balance,168,101,67
Rá,outland,1599,druid,balance,28,21,7
Bigtouch,draenor,1597,druid,balance,54,31,23
Horadruid,silvermoon,1596,druid,balance,196,110,86
Zhof,ravencrest,1596,druid,balance,100,50,50
Eärendir,ravencrest,1595,druid,balance,84,47,37
Каралесер,gordunni,1594,druid,balance,91,50,41
Malfurien,magtheridon,1593,druid,balance,30,17,13
Balanc,ragnaros,1592,druid,balance,83,44,39
Suprachybre,arathi,1591,druid,balance,24,18,6
Saltymoo,tarren-mill,1589,druid,balance,41,24,17
Ôp,aegwynn,1589,druid,balance,65,31,34
Xä,bloodscalp,1587,druid,balance,159,86,73
Veyronn,burning-legion,1586,druid,balance,48,25,23
Happybear,outland,1583,druid,balance,57,42,15
Iamobito,blackmoore,1582,druid,balance,30,18,12
Píøøx,tarren-mill,1580,druid,balance,60,36,24
Yinx,darksorrow,1580,druid,balance,30,17,13
Kokslina,sylvanas,1580,druid,balance,35,17,18
Malvakten,kazzak,1579,druid,balance,116,54,62
Ittei,korgall,1575,druid,balance,36,22,14
Merawr,ravencrest,1573,druid,balance,129,66,63
Сансплэш,lich-king,1572,druid,balance,24,20,4
Kaalil,argent-dawn,1572,druid,balance,36,19,17
Rasgath,kazzak,1570,druid,balance,130,78,52
Alamâ,madmortem,1570,druid,balance,36,17,19
Stinkyicky,sylvanas,1569,druid,balance,36,25,11
Bôoze,nathrezim,1569,druid,balance,36,19,17
Kënzo,ravencrest,1568,druid,balance,30,21,9
Ðrpressure,blackrock,1568,druid,balance,84,56,28
Bobcup,tarren-mill,1567,druid,balance,68,38,30
Obsessíon,kazzak,1566,druid,balance,30,17,13
Izzi,arathor,1562,druid,balance,48,28,20
Elodìa,antonidas,1561,druid,balance,30,21,9
Hotlife,ravencrest,1559,druid,balance,55,29,26
Starcrash,amanthul,1559,druid,balance,60,28,32
Frikolina,outland,1558,druid,balance,63,32,31
Rode,magtheridon,1556,druid,balance,105,61,44
Carismatic,blackmoore,1555,druid,balance,206,109,97
Sweetner,outland,1553,druid,balance,52,34,18
Pewpewdruid,blackmoore,1553,druid,balance,48,27,21
Taylorshîft,burning-legion,1553,druid,balance,42,18,24
Tâliah,silvermoon,1551,druid,balance,30,18,12
Баттнэйкед,gordunni,1551,druid,balance,83,41,42
Cantdonothig,ravencrest,1550,druid,balance,90,50,40
Wildmistake,argent-dawn,1550,druid,balance,35,17,18
Potatodru,ragnaros,1549,druid,balance,30,17,13
Грибомания,soulflayer,1548,druid,balance,35,18,17
Azurai,blackmoore,1544,druid,balance,42,22,20
Algír,argent-dawn,1539,druid,balance,107,53,54
Lazerbinks,blackmoore,1536,druid,balance,29,18,11
Jazzme,aegwynn,1535,druid,balance,24,16,8
Druidflight,ravencrest,1534,druid,balance,48,24,24
Maaw,tarren-mill,1533,druid,balance,42,23,19
Pyqmi,stormscale,1531,druid,balance,30,22,8
Leathy,eredar,1531,druid,balance,48,29,19
Majokz,ravencrest,1529,druid,balance,70,34,36
Ljóskan,kazzak,1528,druid,balance,36,16,20
Ðelix,ysera,1527,druid,balance,56,33,23
Lisbethqt,nemesis,1523,druid,balance,24,16,8
Eddiethepunk,ravencrest,1520,druid,balance,44,29,15
Chansnax,thrall,1519,druid,balance,52,29,23
Exca,stormscale,1519,druid,balance,54,28,26
Whiskers,emerald-dream,1518,druid,balance,49,26,23
Brainjuice,blackrock,1517,druid,balance,30,16,14
Døttore,garona,1517,druid,balance,80,38,42
Ylmh,archimonde,1516,druid,balance,24,16,8
Aleza,tarren-mill,1516,druid,balance,27,17,10
Elrroir,dun-modr,1516,druid,balance,42,24,18
Brokul,kazzak,1516,druid,balance,48,25,23
Муниня,gordunni,1515,druid,balance,54,30,24
Cowgurl,stormscale,1511,druid,balance,30,16,14
Opla,nethersturm,1510,druid,balance,40,27,13
Detü,blackrock,1509,druid,balance,28,17,11
Goüsta,archimonde,1509,druid,balance,42,24,18
Whythis,archimonde,1507,druid,balance,52,27,25
Druidka,grim-batol,1507,druid,balance,42,20,22
Мунстрайк,borean-tundra,1505,druid,balance,23,16,7
Gurudru,tarren-mill,1505,druid,balance,96,41,55
Hollymedx,blackmoore,1504,druid,balance,44,26,18
Gstahr,taerar,1504,druid,balance,48,25,23
Suevlaki,ragnaros,1500,druid,balance,91,54,37
Trylune,blackmoore,1498,druid,balance,30,17,13
Uptoyou,defias-brotherhood,1497,druid,balance,47,28,19
Winarchikxxl,tarren-mill,1497,druid,balance,110,57,53
Thcpositiv,aegwynn,1496,druid,balance,42,16,26
Gorthunx,kazzak,1494,druid,balance,28,19,9
Гнетея,howling-fjord,1494,druid,balance,53,30,23
Храш,gordunni,1493,druid,balance,23,16,7
Бамболони,gordunni,1492,druid,balance,50,33,17
Yiradur,stormscale,1491,druid,balance,61,33,28
Diggear,doomhammer,1490,druid,balance,24,16,8
Quorn,pozzo-delleternità,1489,druid,balance,59,28,31
Cupoftea,drakthul,1488,druid,balance,59,35,24
Dematos,forscherliga,1487,druid,balance,78,46,32
Niul,aegwynn,1486,druid,balance,104,58,46
Arkatt,outland,1482,druid,balance,36,24,12
Kolt,rajaxx,1481,druid,balance,62,32,30
Mahist,archimonde,1479,druid,balance,42,26,16
Halouest,archimonde,1478,druid,balance,41,21,20
Demonbalance,silvermoon,1477,druid,balance,52,33,19
Zømßie,outland,1477,druid,balance,50,25,25
Sodapop,aszune,1475,druid,balance,77,45,32
Moffwastaken,kazzak,1473,druid,balance,90,41,49
Kbdd,outland,1472,druid,balance,36,16,20
Kubzii,archimonde,1469,druid,balance,30,16,14
Telbo,ravencrest,1467,druid,balance,30,16,14
Knuffle,eredar,1463,druid,balance,52,31,21
Sagezza,draenor,1463,druid,balance,36,18,18
Monkeynight,ambossar,1462,druid,balance,29,16,13
Meatwallet,defias-brotherhood,1460,druid,balance,41,24,17
Primdâhl,ravencrest,1459,druid,balance,60,31,29
Fiomy,blackhand,1458,druid,balance,47,36,11
Farmerone,tarren-mill,1458,druid,balance,84,51,33
Itadorikun,silvermoon,1456,druid,balance,43,29,14
Dabudi,kazzak,1455,druid,balance,57,32,25
Viverion,ravencrest,1454,druid,balance,42,22,20
Guthíx,silvermoon,1451,druid,balance,54,24,30
Aègon,ravencrest,1450,druid,balance,67,37,30
Brandyballix,twisting-nether,1450,druid,balance,47,21,26
Aik,gorgonnash,1448,druid,balance,60,30,30
Грандал,howling-fjord,1448,druid,balance,40,17,23
Tawaraki,outland,1444,druid,balance,156,84,72
Мантоя,gordunni,1443,druid,balance,59,34,25
Dudana,argent-dawn,1441,druid,balance,48,29,19
Chillerin,draenor,1440,druid,balance,36,19,17
Duridlol,nemesis,1439,druid,balance,18,15,3
Lappe,stormreaver,1439,druid,balance,30,15,15
Ferraridudux,ravencrest,1437,druid,balance,18,15,3
Magiskeforme,draenor,1437,druid,balance,26,19,7
Duskdawn,xavius,1436,druid,balance,30,16,14
Hillarious,blackmoore,1435,druid,balance,29,18,11
Restromide,ravencrest,1432,druid,balance,30,15,15
Skywíng,stormscale,1432,druid,balance,42,19,23
Tonutc,sanguino,1430,druid,balance,51,25,26
Ibnform,archimonde,1429,druid,balance,18,15,3
Cmfg,blackrock,1429,druid,balance,21,16,5
Wildanomaly,argent-dawn,1429,druid,balance,52,25,27
Kazuid,argent-dawn,1428,druid,balance,38,24,14
Neova,dun-modr,1428,druid,balance,51,28,23
Sequisha,tarren-mill,1427,druid,balance,24,15,9
Ziele,the-maelstrom,1427,druid,balance,28,17,11
Crackfat,stormscale,1426,druid,balance,30,20,10
Seboom,outland,1426,druid,balance,42,25,17
Spaceshift,magtheridon,1426,druid,balance,45,26,19
Seudoz,silvermoon,1425,druid,balance,36,21,15
Däkk,draenor,1425,druid,balance,72,32,40
Rilak,nordrassil,1424,druid,balance,30,18,12
Czarnykocur,burning-legion,1424,druid,balance,66,38,28
Anabola,frostwhisper,1423,druid,balance,24,15,9
Inghlo,blackmoore,1423,druid,balance,53,29,24
Dantet,the-maelstrom,1421,druid,balance,30,15,15
Pawel,defias-brotherhood,1421,druid,balance,54,23,31
Petiteorange,archimonde,1420,druid,balance,24,16,8
Fransman,sylvanas,1419,druid,balance,41,19,22
Kanataka,stormscale,1418,druid,balance,48,29,19
Shuffey,frostmane,1418,druid,balance,39,21,18
Sqoopy,tarren-mill,1417,druid,balance,18,15,3
Carebearlol,frostmane,1416,druid,balance,42,17,25
Irishdemón,ravencrest,1415,druid,balance,78,43,35
Hypam,archimonde,1413,druid,balance,42,19,23
Ххансолл,gordunni,1411,druid,balance,90,53,37
Mogi,pozzo-delleternità,1411,druid,balance,69,32,37
Sefinana,malganis,1411,druid,balance,81,33,48
Strinx,ragnaros,1406,druid,balance,60,39,21
Madhatterr,kazzak,1406,druid,balance,48,28,20
Fruitdealer,antonidas,1404,druid,balance,36,20,16
Fantomasik,drakthul,1401,druid,balance,93,41,52
Blackfür,sylvanas,1401,druid,balance,74,32,42
Boomalot,auchindoun,1399,druid,balance,48,25,23
Asterism,stormscale,1397,druid,balance,105,57,48
Редмун,soulflayer,1395,druid,balance,54,28,26
Kylaaz,die-ewige-wacht,1394,druid,balance,27,16,11
Nujus,kazzak,1394,druid,balance,30,15,15
Almrudi,blackrock,1394,druid,balance,36,16,20
Rassia,blackrock,1393,druid,balance,24,15,9
Kénshin,blackhand,1392,druid,balance,30,15,15
Chäz,sanguino,1389,druid,balance,26,18,8
Møønhorn,nemesis,1386,druid,balance,68,31,37
Джоннчек,gordunni,1385,druid,balance,40,26,14
Ðiàblos,nemesis,1383,druid,balance,66,39,27
Lyø,draenor,1380,druid,balance,30,18,12
Cptsponksa,tarren-mill,1380,druid,balance,30,16,14
Rbgbear,blackhand,1379,druid,balance,41,22,19
Rédbull,outland,1379,druid,balance,70,36,34
Séxycàt,ravencrest,1378,druid,balance,69,35,34
Stìck,archimonde,1377,druid,balance,41,23,18
Wize,pozzo-delleternità,1377,druid,balance,44,20,24
Rexiehunty,aszune,1376,druid,balance,59,28,31
Тёмныйзверь,borean-tundra,1373,druid,balance,84,43,41
Bløødax,hyjal,1372,druid,balance,130,63,67
Hackamore,archimonde,1371,druid,balance,36,16,20
Pø,blackrock,1371,druid,balance,59,26,33
Darksbear,draenor,1368,druid,balance,24,16,8
Drøøkîé,antonidas,1368,druid,balance,66,37,29
Шубаиздуба,howling-fjord,1368,druid,balance,42,22,20
Pøpp,archimonde,1367,druid,balance,23,15,8
Arreton,silvermoon,1365,druid,balance,22,15,7
Shìrò,kelthuzad,1365,druid,balance,48,24,24
Frodds,grim-batol,1363,druid,balance,18,16,2
Heanra,frostmane,1363,druid,balance,35,22,13
Insølitø,sanguino,1363,druid,balance,63,32,31
Zhroomx,blackmoore,1351,druid,balance,44,20,24
Кекичшрекич,soulflayer,1349,druid,balance,42,20,22
Ketama,sylvanas,1346,druid,balance,30,16,14
Felysae,kazzak,1344,druid,balance,18,14,4
Bum,ravencrest,1344,druid,balance,18,14,4
Divref,tarren-mill,1343,druid,balance,18,14,4
Lilpumpz,outland,1343,druid,balance,24,14,10
Broxisqt,blackrock,1343,druid,balance,24,14,10
Krtt,tarren-mill,1343,druid,balance,105,47,58
Rosskemp,tarren-mill,1342,druid,balance,18,14,4
Suppencaster,frostwolf,1342,druid,balance,18,14,4
Pôpcorn,ragnaros,1342,druid,balance,54,33,21
Björnskift,tarren-mill,1341,druid,balance,24,14,10
Ravneskrig,ravencrest,1340,druid,balance,18,14,4
Альмазар,lich-king,1339,druid,balance,48,25,23
Kalthazar,twisting-nether,1338,druid,balance,24,14,10
Hadoukan,ravencrest,1337,druid,balance,35,21,14
Insanexp,antonidas,1336,druid,balance,18,14,4
Nuqa,thrall,1336,druid,balance,21,15,6
Artío,the-maelstrom,1335,druid,balance,39,21,18
Chrevarraige,saurfang,1335,druid,balance,90,47,43
Забурсчу,howling-fjord,1333,druid,balance,30,20,10
Soward,la-croisade-écarlate,1331,druid,balance,38,17,21
Oiseth,tarren-mill,1331,druid,balance,36,15,21
Velnens,shattered-halls,1330,druid,balance,42,21,21
Sanaponic,burning-legion,1329,druid,balance,24,14,10
Shyngodx,archimonde,1329,druid,balance,24,14,10
Hisoca,tarren-mill,1328,druid,balance,49,28,21
Бонони,booty-bay,1328,druid,balance,30,14,16
Wazam,kazzak,1325,druid,balance,26,19,7
Druiddamage,the-maelstrom,1321,druid,balance,176,92,84
Экстазиус,borean-tundra,1321,druid,balance,42,14,28
Wildthing,blackmoore,1316,druid,balance,44,25,19
Megaball,sylvanas,1314,druid,balance,66,39,27
Silvix,blackrock,1314,druid,balance,30,14,16
Seysso,silvermoon,1313,druid,balance,60,25,35
Nøny,gorgonnash,1311,druid,balance,24,14,10
Fhi,antonidas,1310,druid,balance,36,21,15
Klappskaft,outland,1309,druid,balance,23,14,9
Likwidator,stormscale,1307,druid,balance,36,18,18
Haginator,twisting-nether,1306,druid,balance,90,43,47
Convokeboost,archimonde,1305,druid,balance,65,42,23
Solarian,ravencrest,1304,druid,balance,42,26,16
Adizero,blackrock,1303,druid,balance,25,15,10
Asinistar,ravencrest,1303,druid,balance,26,15,11
Шадарлогот,gordunni,1300,druid,balance,90,52,38
Droodfarm,hyjal,1300,druid,balance,46,26,20
Callmev,hyjal,1294,druid,balance,18,14,4
Mayhh,ragnaros,1294,druid,balance,79,45,34
Xclonedotcom,aegwynn,1289,druid,balance,30,19,11
Quiksx,blackrock,1286,druid,balance,43,20,23
Storpboom,drakthul,1285,druid,balance,66,37,29
Thielyy,blackmoore,1284,druid,balance,24,15,9
Myex,exodar,1280,druid,balance,30,14,16
Slurmms,sylvanas,1278,druid,balance,114,70,44
Corrupthz,outland,1276,druid,balance,23,14,9
Meezy,ragnaros,1273,druid,balance,30,15,15
Àsúnâ,eredar,1272,druid,balance,42,15,27
Chugs,draenor,1271,druid,balance,30,16,14
Hardí,tarren-mill,1268,druid,balance,60,28,32
Rektjin,stormscale,1266,druid,balance,36,15,21
Melyo,blackmoore,1265,druid,balance,36,21,15
Druidere,outland,1262,druid,balance,54,23,31
Sheâ,nemesis,1261,druid,balance,73,38,35
Zeifana,khaz-modan,1260,druid,balance,24,15,9
Нэйроуз,howling-fjord,1259,druid,balance,77,40,37
Vaizier,defias-brotherhood,1259,druid,balance,48,22,26
Ilovedruid,forscherliga,1259,druid,balance,34,15,19
Fillet,aggra-português,1257,druid,balance,20,15,5
Buhuu,blackmoore,1256,druid,balance,30,14,16
Rullader,draenor,1255,druid,balance,36,23,13
Киллиманжаро,howling-fjord,1254,druid,balance,96,45,51
Medreas,argent-dawn,1253,druid,balance,71,46,25
Tygra,blackrock,1248,druid,balance,18,13,5
Superchïcken,archimonde,1247,druid,balance,24,13,11
Valijan,blackrock,1247,druid,balance,28,14,14
Triskelion,burning-legion,1246,druid,balance,18,13,5
Ymagyne,frostmane,1246,druid,balance,24,13,11
Beanery,aegwynn,1245,druid,balance,18,13,5
Frenkoz,outland,1244,druid,balance,18,13,5
Hotdóts,outland,1244,druid,balance,18,13,5
Матумбо,razuvious,1244,druid,balance,192,89,103
Eranor,archimonde,1243,druid,balance,18,13,5
Kroaxs,draenor,1243,druid,balance,30,16,14
Smittly,bloodhoof,1243,druid,balance,36,17,19
Sazo,elune,1242,druid,balance,24,13,11
Kittyboomy,burning-blade,1242,druid,balance,63,30,33
Kl,archimonde,1242,druid,balance,30,13,17
Hirmo,ragnaros,1238,druid,balance,24,13,11
Vulyr,outland,1237,druid,balance,36,17,19
Fouser,shattered-hand,1235,druid,balance,24,13,11
Жизэ,galakrond,1234,druid,balance,18,13,5
Lèafy,silvermoon,1234,druid,balance,25,13,12
Мунмунмун,gordunni,1229,druid,balance,43,19,24
Patchlølx,blackmoore,1228,druid,balance,21,15,6
Psycloniac,ravencrest,1228,druid,balance,24,13,11
Limmiited,ravencrest,1228,druid,balance,36,19,17
Vrill,kazzak,1228,druid,balance,75,38,37
Oxox,defias-brotherhood,1227,druid,balance,24,14,10
Santoniq,dun-morogh,1225,druid,balance,96,42,54
Notmyfriend,sylvanas,1224,druid,balance,23,16,7
Smuktøs,twisting-nether,1224,druid,balance,24,15,9
Restouz,twisting-nether,1220,druid,balance,33,14,19
Àlec,silvermoon,1217,druid,balance,114,61,53
Fantaclause,tarren-mill,1215,druid,balance,88,41,47
Vasilona,sanguino,1211,druid,balance,24,13,11
Cagaboliches,sanguino,1208,druid,balance,30,14,16
Eliaster,ysondre,1204,druid,balance,30,18,12
Abercrombx,thrall,1199,druid,balance,26,14,12
Jeesman,sylvanas,1198,druid,balance,36,19,17
Shåmssz,kazzak,1194,druid,balance,20,15,5
Suitti,ravencrest,1191,druid,balance,23,13,10
Chulainn,sylvanas,1181,druid,balance,24,18,6
Dotclass,outland,1180,druid,balance,20,13,7
Avior,eonar,1178,druid,balance,47,14,33
Farodiin,blackmoore,1177,druid,balance,48,18,30
Мяурицао,howling-fjord,1175,druid,balance,53,30,23
Larbre,dalaran,1174,druid,balance,22,19,3
Forestrun,sylvanas,1174,druid,balance,30,17,13
Maelinou,archimonde,1168,druid,balance,36,19,17
Стампид,blackscar,1164,druid,balance,35,15,20
Wartôn,blackhand,1161,druid,balance,34,19,15
Bearcosby,burning-legion,1160,druid,balance,23,13,10
Northstar,sylvanas,1156,druid,balance,18,13,5
Kørn,drakthul,1155,druid,balance,31,13,18
Gnotten,thunderhorn,1154,druid,balance,23,13,10
Conn,ravencrest,1153,druid,balance,27,16,11
Boomky,blackmoore,1152,druid,balance,24,12,12
Minado,outland,1151,druid,balance,12,12,0
Connydor,stormscale,1151,druid,balance,18,12,6
Morlán,blackmoore,1151,druid,balance,18,12,6
Øwlkin,ravencrest,1151,druid,balance,24,12,12
Фигарофигаро,gordunni,1149,druid,balance,18,12,6
Owenwilson,twisting-nether,1149,druid,balance,18,12,6
Daÿdream,ravencrest,1149,druid,balance,18,12,6
Deblin,ragnaros,1148,druid,balance,41,23,18
Бруан,gordunni,1148,druid,balance,35,19,16
Calambius,blackhand,1148,druid,balance,24,12,12
Leafsandstuf,ragnaros,1147,druid,balance,18,12,6
Wolfhealer,blackmoore,1147,druid,balance,30,16,14
Mnqn,ravencrest,1146,druid,balance,18,12,6
Ashär,kirin-tor,1146,druid,balance,75,33,42
Урркке,soulflayer,1145,druid,balance,18,12,6
Ðoxi,draenor,1145,druid,balance,84,37,47
Meuhtéki,hyjal,1143,druid,balance,18,12,6
Duis,twilights-hammer,1143,druid,balance,24,12,12
Requinymph,ravencrest,1141,druid,balance,24,12,12
Loriann,twisting-nether,1141,druid,balance,75,36,39
Pavesino,nemesis,1140,druid,balance,18,12,6
Gardenstate,silvermoon,1139,druid,balance,30,18,12
Shiotake,hyjal,1139,druid,balance,24,12,12
Zoxen,nefarian,1138,druid,balance,30,12,18
Mascraxx,earthen-ring,1137,druid,balance,49,22,27
Дайтеполено,howling-fjord,1137,druid,balance,58,25,33
Tankis,dalaran,1132,druid,balance,39,25,14
Colibrix,ravencrest,1124,druid,balance,36,13,23
Nømat,defias-brotherhood,1123,druid,balance,18,12,6
Weisslogia,aegwynn,1120,druid,balance,36,13,23
Exactt,blackrock,1119,druid,balance,36,13,23
Tjoepert,azjolnerub,1117,druid,balance,72,28,44
Scottparker,sylvanas,1115,druid,balance,18,12,6
Braokhull,stormscale,1111,druid,balance,30,14,16
Morlas,kazzak,1111,druid,balance,50,22,28
Hightotem,hakkar,1104,druid,balance,29,16,13
Toxida,antonidas,1096,druid,balance,34,15,19
Ruberg,kazzak,1091,druid,balance,21,12,9
Amalou,ravencrest,1091,druid,balance,54,27,27
Vaacku,stormreaver,1082,druid,balance,22,12,10
Catmøm,blackmoore,1076,druid,balance,22,12,10
Alethorn,twisting-nether,1070,druid,balance,13,12,1
Buckshee,doomhammer,1066,druid,balance,47,25,22
Cubir,turalyon,1065,druid,balance,23,12,11
Altix,blackmoore,1063,druid,balance,24,12,12
Exiztenz,deathwing,1062,druid,balance,36,18,18
Malammore,burning-legion,1058,druid,balance,24,18,6
Исмалат,howling-fjord,1058,druid,balance,27,13,14
ßoomin,tarren-mill,1056,druid,balance,18,11,7
Gonyogonyo,blackmoore,1056,druid,balance,18,11,7
Dakotaboomer,ravencrest,1056,druid,balance,18,11,7
Broflovskii,tarren-mill,1056,druid,balance,24,11,13
Drmoe,blackmoore,1055,druid,balance,15,12,3
Vitaex,blackrock,1055,druid,balance,18,11,7
Айрокси,blackscar,1055,druid,balance,18,11,7
Huxleyys,draenor,1055,druid,balance,18,11,7
Buckmysallz,archimonde,1055,druid,balance,18,11,7
Stb,outland,1055,druid,balance,18,11,7
Lóvebeam,ravencrest,1055,druid,balance,18,11,7
Shiffe,argent-dawn,1055,druid,balance,18,11,7
Yore,tichondrius,1054,druid,balance,18,11,7
Saabeq,hyjal,1053,druid,balance,18,11,7
Drutiful,outland,1052,druid,balance,24,11,13
Taylorshift,argent-dawn,1050,druid,balance,18,11,7
Bashfui,draenor,1050,druid,balance,18,11,7
Bigpopp,kazzak,1050,druid,balance,18,11,7
Aimwaré,ravencrest,1050,druid,balance,24,11,13
Couleaf,stormscale,1049,druid,balance,13,11,2
Soguu,thrall,1049,druid,balance,18,11,7
Ramgis,sanguino,1049,druid,balance,24,11,13
Deadmorph,ysondre,1049,druid,balance,24,11,13
Skyphi,silvermoon,1048,druid,balance,18,11,7
Pfandmalle,blackrock,1046,druid,balance,18,11,7
Tchoubouléru,throkferoth,1045,druid,balance,36,13,23
Rorugo,sanguino,1044,druid,balance,18,11,7
Chúcky,twisting-nether,1044,druid,balance,21,12,9
Мутаборец,howling-fjord,1043,druid,balance,32,18,14
Salseo,uldum,1041,druid,balance,12,11,1
Астраджет,gordunni,1039,druid,balance,24,11,13
Elonax,eredar,1038,druid,balance,18,11,7
Quoting,ravencrest,1038,druid,balance,23,11,12
Hárty,tarren-mill,1035,druid,balance,24,11,13
Anerol,arthas,1031,druid,balance,36,19,17
Diepauline,aegwynn,1030,druid,balance,42,22,20
Dudukush,eredar,1029,druid,balance,43,19,24
Ronî,arthas,1028,druid,balance,30,11,19
Кулунхе,soulflayer,1027,druid,balance,18,11,7
Mianmar,silvermoon,1027,druid,balance,18,11,7
Smexim,dalaran,1026,druid,balance,47,25,22
Søfiaa,argent-dawn,1022,druid,balance,71,38,33
Bearhugzz,outland,1022,druid,balance,95,50,45
Bullmarkets,kazzak,1013,druid,balance,24,12,12
ßalmain,nethersturm,1013,druid,balance,24,11,13
Лякокля,soulflayer,1013,druid,balance,30,12,18
Медведяра,howling-fjord,1009,druid,balance,35,16,19
Yolobolo,ragnaros,1007,druid,balance,17,11,6
Кашаган,howling-fjord,998,druid,balance,21,11,10
Ледруд,gordunni,991,druid,balance,26,11,15
Skvll,silvermoon,987,druid,balance,26,11,15
Bulvai,medivh,979,druid,balance,14,11,3
Kakaiy,shadowsong,971,druid,balance,60,32,28
Воому,soulflayer,960,druid,balance,12,10,2
Eselhirte,blackhand,960,druid,balance,12,10,2
Nätsügødxqt,archimonde,960,druid,balance,12,10,2
Ноунэймбич,blackscar,960,druid,balance,12,10,2
Nàaz,stormscale,960,druid,balance,12,10,2
Rozi,draenor,960,druid,balance,18,10,8
Djfukface,ravencrest,960,druid,balance,18,10,8
Feralisser,ravencrest,959,druid,balance,12,10,2
Drooshy,ravencrest,959,druid,balance,15,11,4
Zarune,sanguino,959,druid,balance,18,10,8
Treesus,blackrock,959,druid,balance,18,10,8
Tiktokstar,blackrock,959,druid,balance,18,10,8
Tallu,das-konsortium,959,druid,balance,18,10,8
Zeptune,tarren-mill,959,druid,balance,24,10,14
Thepuma,dun-modr,958,druid,balance,12,10,2
Gallorath,draenor,958,druid,balance,18,10,8
Keynn,kazzak,958,druid,balance,18,10,8
Хастла,galakrond,958,druid,balance,18,10,8
Pèps,dalaran,958,druid,balance,18,10,8
Kuhgucci,blackmoore,958,druid,balance,18,10,8
Darisom,alexstrasza,958,druid,balance,135,71,64
Elatadru,silvermoon,958,druid,balance,24,10,14
Élán,sylvanas,958,druid,balance,24,10,14
Coldleans,kazzak,957,druid,balance,12,10,2
Verenai,bloodfeather,957,druid,balance,12,10,2
Levéltetü,ragnaros,957,druid,balance,18,10,8
Gbq,ravencrest,957,druid,balance,18,10,8
Báco,dun-modr,957,druid,balance,24,10,14
Andjuga,doomhammer,957,druid,balance,30,10,20
Sajlol,doomhammer,955,druid,balance,18,10,8
Boomzter,frostmane,955,druid,balance,24,10,14
Gluqt,outland,953,druid,balance,18,10,8
Bolskigg,stormreaver,953,druid,balance,24,10,14
Оудин,blackscar,952,druid,balance,18,10,8
Kaspurr,ravencrest,951,druid,balance,12,10,2
Hypnosoad,outland,951,druid,balance,24,10,14
Littleneo,ambossar,949,druid,balance,29,12,17
Two,silvermoon,947,druid,balance,30,11,19
Yepnesse,khaz-modan,946,druid,balance,18,10,8
Certton,arakarahm,943,druid,balance,24,10,14
Orchard,silvermoon,936,druid,balance,18,10,8
Resthunor,draenor,935,druid,balance,18,10,8
Naone,silvermoon,929,druid,balance,24,10,14
Kotomer,defias-brotherhood,926,druid,balance,108,38,70
Calistane,silvermoon,926,druid,balance,69,24,45
Numberonebs,silvermoon,925,druid,balance,17,10,7
Жибка,howling-fjord,925,druid,balance,20,11,9
Mööñ,hyjal,917,druid,balance,16,11,5
Cöyote,hyjal,916,druid,balance,54,28,26
Суггуторр,howling-fjord,909,druid,balance,87,42,45
Juvencus,twisting-nether,864,druid,balance,12,9,3
Крейзикет,eversong,864,druid,balance,12,9,3
Illebra,defias-brotherhood,864,druid,balance,12,9,3
Yshára,darkmoon-faire,864,druid,balance,12,9,3
Taurendruid,the-maelstrom,864,druid,balance,12,9,3
Bakkú,ravencrest,864,druid,balance,12,9,3
Tronchetto,nemesis,864,druid,balance,24,9,15
Pezuñera,sanguino,863,druid,balance,12,9,3
Merq,ravencrest,863,druid,balance,12,9,3
Gòrgoth,pozzo-delleternità,863,druid,balance,12,9,3
Füsselviech,frostwolf,863,druid,balance,12,9,3
Aolynk,twisting-nether,863,druid,balance,12,9,3
Empi,sanguino,863,druid,balance,18,9,9
Kittyexpress,arygos,863,druid,balance,18,9,9
Croquetoro,sanguino,863,druid,balance,18,9,9
Pitbull,archimonde,863,druid,balance,18,9,9
Zaoow,stormscale,863,druid,balance,18,9,9
Bxxmkin,draenor,862,druid,balance,12,9,3
Metaboss,ravencrest,862,druid,balance,18,9,9
Angharradh,arthas,862,druid,balance,18,9,9
Qocotte,archimonde,862,druid,balance,18,9,9
Mindruid,kazzak,862,druid,balance,18,9,9
Jabbah,defias-brotherhood,862,druid,balance,18,9,9
Амахасла,deathweaver,861,druid,balance,12,9,3
Кортанус,gordunni,861,druid,balance,15,10,5
Fruntimmern,sylvanas,861,druid,balance,18,9,9
Maurana,sylvanas,861,druid,balance,24,9,15
Ennelle,silvermoon,860,druid,balance,12,9,3
Drocos,genjuros,860,druid,balance,18,9,9
Muhz,nathrezim,860,druid,balance,22,10,12
Hushorde,twisting-nether,860,druid,balance,30,9,21
Corias,blackmoore,859,druid,balance,30,9,21
Grizzlyhills,silvermoon,856,druid,balance,12,9,3
Lunably,silvermoon,855,druid,balance,18,9,9
Happysw,thrall,853,druid,balance,32,9,23
Tombenuit,tarren-mill,843,druid,balance,18,9,9
Rockymarci,dalaran,840,druid,balance,12,9,3
Tarâkings,outland,832,druid,balance,18,9,9
Théodên,dalaran,830,druid,balance,128,57,71
Сомеваск,deathweaver,830,druid,balance,23,9,14
Pretender,arathi,829,druid,balance,22,9,13
Kawaíï,frostwolf,809,druid,balance,21,10,11
Bluebanana,bronzebeard,774,druid,balance,25,9,16
Éatshiftndie,tarren-mill,768,druid,balance,12,8,4
Celtimi,antonidas,768,druid,balance,12,8,4
Pjuske,silvermoon,768,druid,balance,12,8,4
Nyetoo,dun-modr,768,druid,balance,12,8,4
Светдру,blackscar,768,druid,balance,12,8,4
Memphiswhx,drakthul,768,druid,balance,12,8,4
Rifthy,nemesis,768,druid,balance,12,8,4
Elgatos,kazzak,768,druid,balance,12,8,4
Клыкояр,goldrinn,768,druid,balance,12,8,4
Beutow,archimonde,768,druid,balance,12,8,4
Àspro,hyjal,768,druid,balance,12,8,4
Pikatwo,tyrande,768,druid,balance,12,8,4
Kissaey,emeriss,768,druid,balance,12,8,4
Ðíør,ravencrest,768,druid,balance,12,8,4
Jometatile,hyjal,768,druid,balance,12,8,4
Everdreamx,arathor,768,druid,balance,12,8,4
Citróne,blackrock,768,druid,balance,12,8,4
Emochicken,silvermoon,768,druid,balance,15,9,6
Réhagen,archimonde,768,druid,balance,18,8,10
Boompjeh,chamber-of-aspects,768,druid,balance,18,8,10
Friidaf,lightbringer,768,druid,balance,18,8,10
Malolepszy,burning-legion,768,druid,balance,18,8,10
Shroomdoom,ravencrest,768,druid,balance,18,8,10
Ábomínatíon,draenor,767,druid,balance,12,8,4
Aryitu,blackrock,767,druid,balance,12,8,4
Kheleñ,blackrock,767,druid,balance,12,8,4
Rhaf,argent-dawn,767,druid,balance,12,8,4
Bigsmoké,die-aldor,767,druid,balance,12,8,4
Екфта,gordunni,767,druid,balance,18,8,10
Tongá,draenor,767,druid,balance,18,8,10
Bogahcan,twisting-nether,767,druid,balance,18,8,10
Ilovehannah,laughing-skull,767,druid,balance,18,8,10
Sylindra,argent-dawn,767,druid,balance,18,8,10
Alterejuv,ravencrest,767,druid,balance,18,8,10
Loswochos,blackmoore,767,druid,balance,18,8,10
Schebäb,blackhand,767,druid,balance,24,8,16
Drazefin,twisting-nether,767,druid,balance,24,8,16
Древнина,gordunni,766,druid,balance,12,8,4
Whísperclaw,ravencrest,766,druid,balance,12,8,4
Humanoidpt,aggra-português,766,druid,balance,12,8,4
Catsgomeow,outland,766,druid,balance,18,8,10
Bztémor,archimonde,766,druid,balance,18,8,10
Doomkin,tichondrius,766,druid,balance,18,8,10
Darthiud,outland,765,druid,balance,12,8,4
When,kirin-tor,765,druid,balance,18,8,10
Machie,argent-dawn,765,druid,balance,18,8,10
Arenshimoon,kazzak,765,druid,balance,18,8,10
Сейтил,deathguard,764,druid,balance,30,8,22
Druice,tyrande,763,druid,balance,12,8,4
Laiquaril,ravencrest,762,druid,balance,25,8,17
Sároman,ravencrest,761,druid,balance,24,8,16
Fakers,the-maelstrom,747,druid,balance,12,8,4
Ddggss,ragnaros,734,druid,balance,17,8,9
Aggibääm,blackhand,724,druid,balance,18,8,10
Maw,hellfire,717,druid,balance,11,8,3
Ærîs,garona,717,druid,balance,17,8,9
Dobradoonga,exodar,713,druid,balance,15,9,6
Thaiboimbyy,veknilash,708,druid,balance,27,9,18
Durtidikdave,kazzak,703,druid,balance,17,8,9
Rønièl,tarren-mill,702,druid,balance,11,8,3
Papalegba,kilrogg,700,druid,balance,14,8,6
Mazalot,kazzak,687,druid,balance,13,8,5
Rofyx,twisting-nether,672,druid,balance,12,7,5
Lörex,ravencrest,672,druid,balance,12,7,5
Hïrøshïmå,malganis,672,druid,balance,12,7,5
Lilim,culte-de-la-rive-noire,672,druid,balance,12,7,5
Kÿara,khaz-modan,672,druid,balance,12,7,5
Teddyxbear,nefarian,672,druid,balance,12,7,5
Амераки,blackscar,672,druid,balance,12,7,5
Hajlol,sylvanas,672,druid,balance,12,7,5
Epicplays,sylvanas,672,druid,balance,12,7,5
Trønchetto,nemesis,672,druid,balance,12,7,5
Sweedrood,hyjal,672,druid,balance,12,7,5
Surlax,defias-brotherhood,672,druid,balance,12,7,5
Ultrapoulet,archimonde,672,druid,balance,12,7,5
Thornat,chamber-of-aspects,672,druid,balance,12,7,5
Shapees,sylvanas,672,druid,balance,12,7,5
Okøë,marécage-de-zangar,672,druid,balance,12,7,5
Mommymìlkers,archimonde,672,druid,balance,12,7,5
Øsbura,silvermoon,672,druid,balance,12,7,5
Twerkdabooty,azjolnerub,672,druid,balance,12,7,5
Mythiaran,argent-dawn,672,druid,balance,12,7,5
Deeizm,ravencrest,672,druid,balance,12,7,5
Delarion,nemesis,672,druid,balance,12,7,5
Yungtrappy,stormscale,672,druid,balance,12,7,5
Qyoon,argent-dawn,672,druid,balance,12,7,5
Tease,blackrock,672,druid,balance,12,7,5
Glúingél,tarren-mill,672,druid,balance,12,7,5
Criaø,blackrock,672,druid,balance,12,7,5
Pansaa,stormscale,672,druid,balance,15,8,7
Avimoo,tarren-mill,672,druid,balance,18,7,11
Redyogurt,outland,672,druid,balance,18,7,11
Núri,lordaeron,672,druid,balance,18,7,11
Ravenfang,dun-modr,672,druid,balance,18,7,11
Нортикус,soulflayer,672,druid,balance,18,7,11
Rivella,blackrock,672,druid,balance,18,7,11
Auches,argent-dawn,672,druid,balance,18,7,11
Antiseptik,ysondre,671,druid,balance,12,7,5
Rikayn,tarren-mill,671,druid,balance,12,7,5
Alexuwu,draenor,671,druid,balance,12,7,5
Hauntie,kazzak,671,druid,balance,12,7,5
Feral,mazrigos,671,druid,balance,12,7,5
Найадра,gordunni,671,druid,balance,12,7,5
Spoco,defias-brotherhood,671,druid,balance,12,7,5
Bearhúg,kazzak,671,druid,balance,18,7,11
Fleq,antonidas,671,druid,balance,18,7,11
Snedden,silvermoon,671,druid,balance,18,7,11
Felfran,ravencrest,671,druid,balance,18,7,11
Усыильвиры,soulflayer,671,druid,balance,18,7,11
Fesenjon,blackhand,671,druid,balance,18,7,11
Thunderzeus,mazrigos,671,druid,balance,18,7,11
Taskingoman,twisting-nether,670,druid,balance,12,7,5
Balzàc,ravencrest,670,druid,balance,12,7,5
Fréki,ravenholdt,670,druid,balance,12,7,5
Rayðii,archimonde,670,druid,balance,17,7,10
Challi,nordrassil,669,druid,balance,18,7,11
Sabresheep,twisting-nether,669,druid,balance,24,7,17
Freshener,antonidas,665,druid,balance,12,7,5
Drrestospec,tarren-mill,665,druid,balance,12,7,5
Ånåphorå,archimonde,624,druid,balance,15,7,8
Nille,tarren-mill,617,druid,balance,14,8,6
Kidawi,frostwolf,617,druid,balance,16,8,8
Dao,aegwynn,607,druid,balance,14,7,7
Chadru,magtheridon,607,druid,balance,14,7,7
Trollisha,mannoroth,605,druid,balance,14,7,7
Bubidiblumdr,twisting-nether,605,druid,balance,16,7,9
Rtfz,ravencrest,591,druid,balance,13,7,6
Clonorrhea,tarren-mill,576,druid,balance,6,6,0
Qpoof,sylvanas,576,druid,balance,6,6,0
Ухухуня,gordunni,576,druid,balance,6,6,0
Mønrøe,ravencrest,576,druid,balance,9,7,2
Pælter,draenor,576,druid,balance,12,6,6
Knozylg,kazzak,576,druid,balance,12,6,6
Inbml,silvermoon,576,druid,balance,12,6,6
Naturexbot,silvermoon,576,druid,balance,12,6,6
Dyuuna,hyjal,576,druid,balance,12,6,6
Zerofrenzy,hyjal,576,druid,balance,12,6,6
Diolives,stormscale,576,druid,balance,12,6,6
Forthis,frostmane,576,druid,balance,12,6,6
Thefudge,silvermoon,576,druid,balance,12,6,6
Nuggetspøwa,dalaran,576,druid,balance,12,6,6
Kamenká,aegwynn,576,druid,balance,12,6,6
Pórts,kazzak,576,druid,balance,12,6,6
Ashkaxx,ragnaros,576,druid,balance,12,6,6
Whêylon,ragnaros,576,druid,balance,12,6,6
Layle,argent-dawn,576,druid,balance,12,6,6
Quinten,ulduar,576,druid,balance,12,6,6
Teryx,blackmoore,576,druid,balance,12,6,6
Mikhaili,stormreaver,576,druid,balance,12,6,6
Shoca,die-ewige-wacht,576,druid,balance,12,6,6
Illmíndofboo,twisting-nether,576,druid,balance,12,6,6
Littlecok,blackmoore,576,druid,balance,12,6,6
Mentaldead,tarren-mill,576,druid,balance,12,6,6
Doncaino,amanthul,576,druid,balance,12,6,6
Degnosaur,outland,576,druid,balance,12,6,6
Зулкхаку,soulflayer,576,druid,balance,12,6,6
Wrx,sylvanas,576,druid,balance,12,6,6
Nancey,auchindoun,576,druid,balance,12,6,6
Vulkayn,ysondre,576,druid,balance,12,6,6
Caltvalai,ravencrest,576,druid,balance,12,6,6
Мунпраид,gordunni,576,druid,balance,12,6,6
Høtbøx,aegwynn,576,druid,balance,15,6,9
Smedoge,outland,576,druid,balance,18,6,12
Zevis,outland,576,druid,balance,18,6,12
Ishaqu,bladefist,576,druid,balance,18,6,12
Applestrudle,blackrock,576,druid,balance,24,6,18
Dingeren,stormscale,575,druid,balance,12,6,6
Gruvkatt,stormscale,575,druid,balance,12,6,6
Zaratras,arathor,575,druid,balance,12,6,6
Òniz,hyjal,575,druid,balance,12,6,6
Raxona,blackmoore,575,druid,balance,12,6,6
Praythysun,khaz-modan,575,druid,balance,12,6,6
Orazien,ravencrest,575,druid,balance,12,6,6
Robinchwän,archimonde,575,druid,balance,18,6,12
Shag,archimonde,575,druid,balance,18,6,12
Lúthiëñ,silvermoon,575,druid,balance,24,6,18
Тиликум,goldrinn,574,druid,balance,12,6,6
Shainá,dun-modr,574,druid,balance,12,6,6
Momaa,neptulon,574,druid,balance,12,6,6
Жекакотик,eversong,574,druid,balance,24,6,18
Kittasek,drakthul,572,druid,balance,12,6,6
Tarantinonon,kazzak,572,druid,balance,18,6,12
Duwaz,blackmoore,543,druid,balance,14,7,7
Arecsne,turalyon,543,druid,balance,14,7,7
Ancientix,burning-legion,543,druid,balance,17,6,11
Xyiz,ravencrest,528,druid,balance,15,6,9
Aionx,ravencrest,527,druid,balance,11,6,5
Atbõs,stormscale,527,druid,balance,11,6,5
Lyøñ,dun-modr,527,druid,balance,11,6,5
Humizon,silvermoon,522,druid,balance,15,7,8
Tåylor,laughing-skull,480,druid,balance,6,5,1
Corkiy,tarren-mill,480,druid,balance,6,5,1
Svartvit,sylvanas,480,druid,balance,6,5,1
Harrydòtter,eredar,480,druid,balance,6,5,1
Хлайси,gordunni,480,druid,balance,6,5,1
Hashtagone,ysondre,480,druid,balance,6,5,1
Опущеныйкелх,gordunni,480,druid,balance,6,5,1
Smøkyyd,eredar,480,druid,balance,6,5,1
Eñzo,stormscale,480,druid,balance,6,5,1
Entas,kazzak,480,druid,balance,6,5,1
Fabuboomy,blackrock,480,druid,balance,6,5,1
Smølboi,ravencrest,480,druid,balance,6,5,1
Roroa,ravencrest,480,druid,balance,6,5,1
Xoap,kazzak,480,druid,balance,6,5,1
Jöggel,perenolde,480,druid,balance,6,5,1
Bambøué,khaz-modan,480,druid,balance,6,5,1
Ibêx,blackmoore,480,druid,balance,6,5,1
Füllxtrap,hyjal,480,druid,balance,6,5,1
Cowieowie,draenor,480,druid,balance,6,5,1
Brovis,sylvanas,480,druid,balance,6,5,1
Murdok,suramar,480,druid,balance,6,5,1
Fäcker,blackhand,480,druid,balance,6,5,1
Stkk,sanguino,480,druid,balance,6,5,1
Pinkpanda,arthas,480,druid,balance,6,5,1
Sebikboomie,ravencrest,480,druid,balance,6,5,1
Lifecycle,nemesis,480,druid,balance,12,5,7
Elayria,blackmoore,480,druid,balance,12,5,7
Aetheris,varimathras,480,druid,balance,12,5,7
Хрофт,blackscar,480,druid,balance,12,5,7
Skadruid,blackmoore,480,druid,balance,12,5,7
Blark,sylvanas,480,druid,balance,12,5,7
Doup,alakir,480,druid,balance,12,5,7
Revølter,kazzak,480,druid,balance,12,5,7
Elrandir,tarren-mill,480,druid,balance,12,5,7
Zomgcow,twisting-nether,480,druid,balance,12,5,7
Superpoulet,archimonde,480,druid,balance,12,5,7
Yabbah,blackrock,480,druid,balance,12,5,7
Angrykejton,silvermoon,480,druid,balance,12,5,7
Lemonjohn,outland,480,druid,balance,12,5,7
Goated,stormscale,480,druid,balance,12,5,7
Yadon,the-maelstrom,480,druid,balance,12,5,7
Rwq,outland,480,druid,balance,12,5,7
Naturina,shattered-hand,480,druid,balance,12,5,7
Lifeseed,ravencrest,480,druid,balance,12,5,7
Pròtodrù,twisting-nether,480,druid,balance,12,5,7
Acwi,dun-morogh,480,druid,balance,12,5,7
Karodoom,twisting-nether,480,druid,balance,12,5,7
Dremdra,draenor,480,druid,balance,12,5,7
Wainl,hyjal,480,druid,balance,12,5,7
Liiandri,khaz-modan,480,druid,balance,12,5,7
Krathar,kazzak,480,druid,balance,12,5,7
Slâkkxz,kazzak,480,druid,balance,12,5,7
Qïx,outland,480,druid,balance,15,6,9
Pansarbamse,outland,480,druid,balance,13,5,8
Kunya,tarren-mill,480,druid,balance,18,5,13
Mariss,chogall,479,druid,balance,6,5,1
Rumjin,burning-blade,479,druid,balance,12,5,7
Forigiver,draenor,479,druid,balance,12,5,7
Máximus,blades-edge,479,druid,balance,12,5,7
Larsia,nordrassil,479,druid,balance,12,5,7
Betol,das-konsortium,479,druid,balance,12,5,7
Elfsu,ravencrest,479,druid,balance,12,5,7
Hengst,laughing-skull,479,druid,balance,18,5,13
Músclébéach,silvermoon,479,druid,balance,18,5,13
Тахикамару,blackscar,479,druid,balance,18,5,13
Lysende,arathor,478,druid,balance,12,5,7
Чепенкос,gordunni,478,druid,balance,12,5,7
Барли,grom,478,druid,balance,16,6,10
Druvian,argent-dawn,478,druid,balance,24,5,19
Zenkay,naxxramas,476,druid,balance,16,6,10
Iskaarjx,archimonde,463,druid,balance,11,5,6
Chouan,marécage-de-zangar,457,druid,balance,21,7,14
Yaendra,dun-modr,445,druid,balance,11,5,6
Eloahdruid,blackhand,432,druid,balance,9,5,4
Pine,aggramar,415,druid,balance,8,5,3
Foxîo,frostmane,415,druid,balance,8,5,3
Pikamoo,kazzak,415,druid,balance,11,5,6
Shiftmeow,tarren-mill,384,druid,balance,6,4,2
Cioaralba,sylvanas,384,druid,balance,6,4,2
Benzinoid,silvermoon,384,druid,balance,6,4,2
Dermegon,outland,384,druid,balance,6,4,2
Ekologiskxx,outland,384,druid,balance,6,4,2
Yunød,silvermoon,384,druid,balance,6,4,2
Weremyst,outland,384,druid,balance,6,4,2
Kosadoodoo,sylvanas,384,druid,balance,6,4,2
Amellian,silvermoon,384,druid,balance,6,4,2
Bearygrylls,sylvanas,384,druid,balance,6,4,2
Meillaeth,sylvanas,384,druid,balance,6,4,2
Lasertipu,tarren-mill,384,druid,balance,6,4,2
Holziger,azshara,384,druid,balance,6,4,2
Blazek,sylvanas,384,druid,balance,6,4,2
Vertabrain,twilights-hammer,384,druid,balance,6,4,2
Dikc,twisting-nether,384,druid,balance,6,4,2
Rawr,dun-morogh,384,druid,balance,6,4,2
Narkiza,blackhand,384,druid,balance,6,4,2
Лолэтохег,soulflayer,384,druid,balance,6,4,2
Fatfingerx,blackrock,384,druid,balance,6,4,2
Gúccî,blackrock,384,druid,balance,6,4,2
Msb,the-maelstrom,384,druid,balance,6,4,2
Daluria,malganis,384,druid,balance,6,4,2
Freshpussyz,ravencrest,384,druid,balance,6,4,2
Cpt,xavius,384,druid,balance,6,4,2
Tulleku,azjolnerub,384,druid,balance,6,4,2
Gretathnberg,ravencrest,384,druid,balance,6,4,2
Fordragos,ravencrest,384,druid,balance,6,4,2
Smøuler,sanguino,384,druid,balance,6,4,2
Fzx,aegwynn,384,druid,balance,6,4,2
Borticow,sanguino,384,druid,balance,6,4,2
Mylanqx,ragnaros,384,druid,balance,6,4,2
Ðevilwhite,nemesis,384,druid,balance,6,4,2
Kasugia,aegwynn,384,druid,balance,6,4,2
Lolaven,turalyon,384,druid,balance,6,4,2
Xvmon,draenor,384,druid,balance,6,4,2
Izzyb,draenor,384,druid,balance,6,4,2
Bafere,twisting-nether,384,druid,balance,6,4,2
Lakersinfive,argent-dawn,384,druid,balance,6,4,2
Jeaylqt,archimonde,384,druid,balance,6,4,2
Kattbjörnen,ragnaros,384,druid,balance,6,4,2
Wotahn,antonidas,384,druid,balance,6,4,2
Blood,frostwolf,384,druid,balance,6,4,2
Moonsama,twisting-nether,384,druid,balance,6,4,2
Seasexsune,antonidas,384,druid,balance,6,4,2
Sunisan,stormscale,384,druid,balance,6,4,2
Фамай,howling-fjord,384,druid,balance,8,4,4
Màlàkaii,hyjal,384,druid,balance,12,4,8
Commonsense,kazzak,384,druid,balance,12,4,8
Tønychopper,sanguino,384,druid,balance,12,4,8
Alanpapi,sanguino,384,druid,balance,12,4,8
Axrae,ravencrest,384,druid,balance,12,4,8
Druidytrudy,blackrock,384,druid,balance,12,4,8
Ibroninad,ragnaros,384,druid,balance,12,4,8
Veijari,deathwing,384,druid,balance,12,4,8
Ohndankalan,kazzak,384,druid,balance,12,4,8
Piiti,burning-legion,384,druid,balance,12,4,8
Astralbody,auchindoun,384,druid,balance,12,4,8
Феразинария,gordunni,384,druid,balance,12,4,8
Achre,thunderhorn,384,druid,balance,12,4,8
Sixtyinches,burning-blade,384,druid,balance,12,4,8
Yee,twisting-nether,384,druid,balance,12,4,8
Tmhaikyu,blackhand,384,druid,balance,12,4,8
Dancingrain,ravencrest,384,druid,balance,12,4,8
Astracat,korgall,384,druid,balance,12,4,8
Губкобоб,galakrond,384,druid,balance,16,4,12
Óffstér,kazzak,384,druid,balance,18,4,14
Mlyzioz,ahnqiraj,383,druid,balance,6,4,2
Храмульчик,blackscar,383,druid,balance,6,4,2
Mongwau,blackrock,383,druid,balance,6,4,2
Summertearz,thrall,383,druid,balance,12,4,8
Moonpouk,archimonde,383,druid,balance,12,4,8
Blablábla,silvermoon,383,druid,balance,12,4,8
Iamramen,blackmoore,383,druid,balance,24,4,20
Katharo,kult-der-verdammten,383,druid,balance,24,4,20
Катафей,deathguard,382,druid,balance,6,4,2
Suranaelle,argent-dawn,369,druid,balance,20,8,12
Ráw,dun-modr,367,druid,balance,11,4,7
Ambracer,silvermoon,366,druid,balance,17,4,13
Blakemonster,khaz-modan,351,druid,balance,8,5,3
Ратататата,blackscar,351,druid,balance,8,5,3
Nightshaðe,argent-dawn,351,druid,balance,11,4,7
Zybri,ragnaros,351,druid,balance,11,4,7
Blownaway,outland,336,druid,balance,9,4,5
Sketit,grim-batol,335,druid,balance,11,4,7
Hilliax,sanguino,330,druid,balance,13,5,8
Martinesämst,outland,320,druid,balance,10,4,6
Holyconvoke,stormscale,319,druid,balance,5,4,1
Eclipße,silvermoon,319,druid,balance,5,4,1
Ohpfo,outland,319,druid,balance,5,4,1
Imaginarý,ravencrest,319,druid,balance,5,4,1
Locite,blackrock,288,druid,balance,6,3,3
Blietmachine,ravencrest,288,druid,balance,6,3,3
Islandbôy,blackrock,288,druid,balance,6,3,3
Flower,aggramar,288,druid,balance,6,3,3
Tritit,marécage-de-zangar,288,druid,balance,6,3,3
Druidat,kazzak,288,druid,balance,6,3,3
Meretrizx,kazzak,288,druid,balance,6,3,3
Natoro,outland,288,druid,balance,6,3,3
Neincat,sylvanas,288,druid,balance,6,3,3
Ullainho,stormscale,288,druid,balance,6,3,3
Mørshac,blackrock,288,druid,balance,6,3,3
Катяблум,gordunni,288,druid,balance,6,3,3
Trollskee,draenor,288,druid,balance,6,3,3
Testopöllö,ravencrest,288,druid,balance,6,3,3
Seey,thrall,288,druid,balance,6,3,3
Вооми,gordunni,288,druid,balance,6,3,3
Svantte,stormreaver,288,druid,balance,6,3,3
Amakary,blackrock,288,druid,balance,6,3,3
Junglelist,antonidas,288,druid,balance,6,3,3
Блинчек,gordunni,288,druid,balance,6,3,3
Lushe,kazzak,288,druid,balance,6,3,3
Jirenthegrey,antonidas,288,druid,balance,6,3,3
Ciwone,blackrock,288,druid,balance,6,3,3
Yeats,blackmoore,288,druid,balance,6,3,3
Ellüna,ravencrest,288,druid,balance,6,3,3
Barbulloup,hyjal,288,druid,balance,6,3,3
Pogoth,turalyon,288,druid,balance,6,3,3
Siuo,ravencrest,288,druid,balance,6,3,3
Покусаютебя,gordunni,288,druid,balance,6,3,3
Hordepwnr,sylvanas,288,druid,balance,6,3,3
Helguard,silvermoon,288,druid,balance,6,3,3
Mirâculixx,dethecus,288,druid,balance,6,3,3
Biologie,onyxia,288,druid,balance,6,3,3
Nareeik,tarren-mill,288,druid,balance,6,3,3
Cryspie,hyjal,288,druid,balance,6,3,3
Fishe,twisting-nether,288,druid,balance,6,3,3
Coogee,malganis,288,druid,balance,6,3,3
Leslra,agamaggan,288,druid,balance,6,3,3
Karolg,tyrande,288,druid,balance,6,3,3
Sparkex,ravencrest,288,druid,balance,6,3,3
Néøu,archimonde,288,druid,balance,6,3,3
Блиденг,gordunni,288,druid,balance,6,3,3
Lærken,the-maelstrom,288,druid,balance,6,3,3
Kooglaash,kazzak,288,druid,balance,6,3,3
Orangeterror,stormscale,288,druid,balance,6,3,3
Maruuk,argent-dawn,288,druid,balance,6,3,3
Зонкс,gordunni,288,druid,balance,6,3,3
Quinteness,silvermoon,288,druid,balance,6,3,3
Srkameltouss,sanguino,288,druid,balance,6,3,3
Maelkan,sanguino,288,druid,balance,6,3,3
Kamatea,eredar,288,druid,balance,6,3,3
Derie,nazjatar,288,druid,balance,6,3,3
Ilus,outland,288,druid,balance,6,3,3
Дарзамат,blackscar,288,druid,balance,6,3,3
Cörelly,ravencrest,288,druid,balance,6,3,3
Àyóorts,archimonde,288,druid,balance,6,3,3
Byjiblznuk,kazzak,288,druid,balance,6,3,3
Bámbí,sylvanas,288,druid,balance,6,3,3
Nefariz,dun-modr,288,druid,balance,6,3,3
Rbg,dun-modr,288,druid,balance,6,3,3
Segundø,archimonde,288,druid,balance,12,3,9
Chavinelf,twisting-nether,288,druid,balance,12,3,9
Crywingz,antonidas,288,druid,balance,12,3,9
Wardruíd,outland,288,druid,balance,12,3,9
Аматэррасу,blackscar,288,druid,balance,12,3,9
Thaneo,blackmoore,288,druid,balance,12,3,9
Merfje,karazhan,288,druid,balance,12,3,9
Kivu,blackrock,288,druid,balance,12,3,9
Loverace,dun-modr,288,druid,balance,12,3,9
Tayswiftmend,defias-brotherhood,288,druid,balance,12,3,9
Groncowski,blackmoore,288,druid,balance,12,3,9
Kidow,wrathbringer,288,druid,balance,12,3,9
Brujo,azjolnerub,288,druid,balance,12,3,9
Skirr,kelthuzad,288,druid,balance,12,3,9
Bigcappa,ahnqiraj,287,druid,balance,6,3,3
Lindémann,blackhand,287,druid,balance,6,3,3
Dasgrandeur,kazzak,287,druid,balance,6,3,3
Walkao,tarren-mill,287,druid,balance,6,3,3
Metamorfurio,arthas,287,druid,balance,6,3,3
Eikthyrson,nozdormu,256,druid,balance,4,4,0
Jhiun,ragnaros,256,druid,balance,4,4,0
Lxz,blackhand,256,druid,balance,10,3,7
Пушистаялапа,blackscar,255,druid,balance,4,4,0
Bóssít,doomhammer,255,druid,balance,11,3,8
Melábufes,dun-modr,208,druid,balance,7,3,4
Beamgødx,thrall,192,druid,balance,4,3,1
Euphoríax,ravencrest,192,druid,balance,4,3,1
Яммаккаасии,grom,192,druid,balance,6,2,4
Leliaen,sylvanas,192,druid,balance,6,2,4
Fanboij,kazzak,192,druid,balance,6,2,4
Коктявзер,deathweaver,192,druid,balance,6,2,4
Kasiopee,hyjal,192,druid,balance,6,2,4
Athenã,blackmoore,192,druid,balance,6,2,4
Filderah,doomhammer,192,druid,balance,6,2,4
Tadoson,blackmoore,192,druid,balance,6,2,4
Tamburoo,tarren-mill,192,druid,balance,6,2,4
Nilatsfloda,quelthalas,192,druid,balance,6,2,4
Noou,aegwynn,192,druid,balance,6,2,4
Bidochonne,ravencrest,192,druid,balance,6,2,4
Rústy,baelgun,192,druid,balance,6,2,4
Kivimon,dun-modr,192,druid,balance,6,2,4
Saliencias,kazzak,192,druid,balance,6,2,4
Kwenden,arygos,192,druid,balance,6,2,4
Sorkoxd,silvermoon,192,druid,balance,6,2,4
Маалир,gordunni,192,druid,balance,6,2,4
Kotkacy,silvermoon,192,druid,balance,6,2,4
Spidete,sanguino,192,druid,balance,6,2,4
Лунныйфилин,deathguard,192,druid,balance,6,2,4
Druidbox,ravencrest,192,druid,balance,6,2,4
Rootbeamftw,ravencrest,192,druid,balance,6,2,4
Jaffacakeqt,draenor,192,druid,balance,6,2,4
Luveena,kazzak,192,druid,balance,6,2,4
Луноэльф,gordunni,192,druid,balance,6,2,4
Halfaway,ravencrest,192,druid,balance,6,2,4
Uglydruid,drakthul,192,druid,balance,6,2,4
Canezmvp,blackrock,192,druid,balance,6,2,4
Kheluna,the-maelstrom,192,druid,balance,6,2,4
Tranduiil,drakthul,192,druid,balance,6,2,4
Héryse,hyjal,192,druid,balance,6,2,4
Gnoobr,ravencrest,192,druid,balance,6,2,4
Dresten,burning-blade,192,druid,balance,6,2,4
Åkømo,aegwynn,192,druid,balance,6,2,4
Kaamirach,blackmoore,192,druid,balance,6,2,4
Emidrem,ravencrest,192,druid,balance,6,2,4
Chzycow,twisting-nether,192,druid,balance,6,2,4
Hotributionx,ravencrest,192,druid,balance,6,2,4
Hâyâbusa,antonidas,192,druid,balance,6,2,4
Fishanchips,archimonde,192,druid,balance,6,2,4
Wheyproteín,dun-modr,192,druid,balance,6,2,4
Barbielolz,archimonde,192,druid,balance,6,2,4
Старселлер,gordunni,192,druid,balance,6,2,4
Baccon,ravencrest,192,druid,balance,6,2,4
Darkillaa,anetheron,192,druid,balance,6,2,4
Снэйк,borean-tundra,192,druid,balance,6,2,4
Akiíra,twisting-nether,192,druid,balance,6,2,4
Nolak,frostwolf,192,druid,balance,6,2,4
Restaidpvs,wildhammer,192,druid,balance,6,2,4
Laødinay,hyjal,192,druid,balance,6,2,4
Maxiturbogay,stormscale,192,druid,balance,6,2,4
Paulskinbak,tarren-mill,192,druid,balance,6,2,4
Zolduran,archimonde,192,druid,balance,6,2,4
Kovalawa,archimonde,192,druid,balance,6,2,4
Chupapoya,pozzo-delleternità,192,druid,balance,6,2,4
Epidruid,stormrage,192,druid,balance,6,2,4
Jimmyxdd,kazzak,192,druid,balance,6,2,4
Tallbutshort,stormscale,192,druid,balance,6,2,4
Gurranq,argent-dawn,192,druid,balance,11,3,8
Sodniss,aggra-português,192,druid,balance,8,2,6
Nctmé,tarren-mill,192,druid,balance,12,2,10
Eyune,tarren-mill,192,druid,balance,12,2,10
Fallingmoon,ravencrest,192,druid,balance,12,2,10
Broasted,stormscale,192,druid,balance,12,2,10
Leekroom,forscherliga,192,druid,balance,12,2,10
Trækvinden,ravencrest,192,druid,balance,12,2,10
Millworgen,norgannon,191,druid,balance,6,2,4
Catbear,kazzak,191,druid,balance,6,2,4
Silvacustos,teldrassil,191,druid,balance,12,2,10
Arrock,malfurion,191,druid,balance,12,2,10
Drix,frostwolf,175,druid,balance,11,2,9
Jaiyen,ravencrest,159,druid,balance,5,2,3
Vendeqt,aegwynn,159,druid,balance,5,2,3
Кыцко,soulflayer,128,druid,balance,4,2,2
Tekilaz,sanguino,128,druid,balance,4,2,2
Ligoz,silvermoon,96,druid,balance,3,2,1
Ischumekcid,anubarak,96,druid,balance,3,2,1
Druidja,sylvanas,96,druid,balance,6,1,5
Ipsdray,ysondre,96,druid,balance,6,1,5
Devióus,twilights-hammer,96,druid,balance,6,1,5
Druidlaba,drakthul,96,druid,balance,6,1,5
Blazor,eredar,96,druid,balance,6,1,5
Маминапуська,soulflayer,96,druid,balance,6,1,5
Eredhion,stormscale,96,druid,balance,6,1,5
Kaira,kazzak,96,druid,balance,6,1,5
Ãnimal,argent-dawn,96,druid,balance,6,1,5
Ayven,kazzak,96,druid,balance,6,1,5
Nermax,kazzak,96,druid,balance,6,1,5
Samuelito,ravencrest,96,druid,balance,6,1,5
Xwerzz,stormscale,96,druid,balance,6,1,5
Ghostdoggie,stormscale,96,druid,balance,6,1,5
Kabòöóm,outland,96,druid,balance,6,1,5
Cattdamon,outland,96,druid,balance,6,1,5
Lemónde,outland,96,druid,balance,6,1,5
Batmòn,stormscale,96,druid,balance,6,1,5
Herekitykity,frostmane,96,druid,balance,6,1,5
Enolcyc,frostmane,96,druid,balance,6,1,5
Ösdru,tarren-mill,96,druid,balance,6,1,5
Tykè,outland,96,druid,balance,6,1,5
Whelpss,archimonde,96,druid,balance,6,1,5
Siahra,khaz-modan,96,druid,balance,6,1,5
Hotseîdank,blackrock,96,druid,balance,6,1,5
Арбузир,howling-fjord,96,druid,balance,6,1,5
Baracüda,draenor,96,druid,balance,6,1,5
Yosimoo,draenor,96,druid,balance,6,1,5
Arún,nazjatar,96,druid,balance,6,1,5
Garudax,blackrock,96,druid,balance,6,1,5
Nayemi,blackmoore,96,druid,balance,6,1,5
Variolus,dun-modr,96,druid,balance,6,1,5
Tortugo,dun-modr,96,druid,balance,6,1,5
Asrais,dun-modr,96,druid,balance,6,1,5
Lilkâzzam,blackrock,96,druid,balance,6,1,5
Tigerbalm,ravenholdt,96,druid,balance,6,1,5
Plankface,ravencrest,96,druid,balance,13,2,11
Mondino,blackrock,96,druid,balance,12,1,11
Negríno,cthun,95,druid,balance,3,2,1
Revoidý,blackmoore,79,druid,balance,5,1,4
Kodobursto,stormscale,79,druid,balance,6,1,5
Madschinken,malganis,42,druid,balance,8,2,6
Melonjuicer,argent-dawn,42,druid,balance,9,2,7
Ðãddy,ravencrest,31,druid,balance,2,1,1
Nalreaa,kazzak,31,druid,balance,8,1,7
Báttlx,blackrock,16,druid,balance,7,1,6
Kankethyr,korgall,2241,evoker,preservation,95,56,39
Гачитварь,galakrond,2194,evoker,preservation,245,126,119
Bodytypezero,terenas,2169,evoker,preservation,110,62,48
Zychodrac,draenor,2145,evoker,preservation,148,74,74
Néthy,argent-dawn,2131,evoker,preservation,102,57,45
Бедныйгрузин,howling-fjord,2125,evoker,preservation,66,39,27
Sukkmymadnes,draenor,2120,evoker,preservation,79,39,40
Dn,shattered-hand,2111,evoker,preservation,89,46,43
Nesedon,stormscale,2108,evoker,preservation,227,118,109
Dragonsweat,hyjal,2057,evoker,preservation,78,45,33
Gardennewt,ravencrest,2001,evoker,preservation,78,39,39
Haxyia,outland,1997,evoker,preservation,66,36,30
Drogon,shendralar,1992,evoker,preservation,84,48,36
Puzikloh,ravencrest,1973,evoker,preservation,42,23,19
Amadeusx,ravencrest,1960,evoker,preservation,84,45,39
Шафлэнжоер,fordragon,1958,evoker,preservation,30,22,8
Theories,blackhand,1958,evoker,preservation,104,50,54
Dizablise,burning-legion,1954,evoker,preservation,59,33,26
Kronata,sanguino,1948,evoker,preservation,78,33,45
Sinéstrà,antonidas,1916,evoker,preservation,156,78,78
Rvrsl,outland,1916,evoker,preservation,96,48,48
Waifuwu,blackhand,1900,evoker,preservation,175,85,90
Humòngóus,kazzak,1897,evoker,preservation,42,23,19
Lazey,stormscale,1891,evoker,preservation,54,30,24
Jamesdéan,twisting-nether,1888,evoker,preservation,48,35,13
Huxleysroar,draenor,1888,evoker,preservation,54,26,28
Phnx,blackrock,1886,evoker,preservation,246,125,121
Matrixslave,tarren-mill,1875,evoker,preservation,81,46,35
Vokedrak,eredar,1875,evoker,preservation,66,32,34
Ноубадиаттак,soulflayer,1867,evoker,preservation,90,39,51
Xays,ravencrest,1864,evoker,preservation,70,34,36
Ipho,twisting-nether,1856,evoker,preservation,100,45,55
Bodytypefour,stormscale,1854,evoker,preservation,66,28,38
Podonok,ravencrest,1849,evoker,preservation,72,36,36
Myshagini,ravencrest,1846,evoker,preservation,45,27,18
Æzorahai,area-52,1845,evoker,preservation,72,33,39
Сансетшторм,gordunni,1841,evoker,preservation,52,27,25
Yulinex,argent-dawn,1833,evoker,preservation,160,92,68
Zimbello,nemesis,1826,evoker,preservation,36,26,10
Onelastdance,ravencrest,1821,evoker,preservation,59,50,9
Healevoker,aegwynn,1819,evoker,preservation,129,61,68
Jakelóng,ravencrest,1818,evoker,preservation,52,25,27
Baiyuekui,blackmoore,1815,evoker,preservation,304,151,153
Smâûg,silvermoon,1812,evoker,preservation,48,27,21
Mixn,argent-dawn,1812,evoker,preservation,93,41,52
Infidus,ravencrest,1810,evoker,preservation,145,82,63
Smellybreath,ravencrest,1810,evoker,preservation,36,19,17
Puffthemagic,archimonde,1810,evoker,preservation,60,28,32
Dragonmeta,kazzak,1808,evoker,preservation,36,19,17
Ripgódx,bronzebeard,1806,evoker,preservation,185,96,89
Wakûwakû,kazzak,1805,evoker,preservation,135,72,63
Cptdrakon,twisting-nether,1802,evoker,preservation,77,43,34
Lerrastrasza,zirkel-des-cenarius,1802,evoker,preservation,48,24,24
Talim,terrordar,1800,evoker,preservation,78,37,41
Lurkî,blackhand,1779,evoker,preservation,48,23,25
Swainsupp,archimonde,1776,evoker,preservation,42,19,23
Drakela,frostwhisper,1761,evoker,preservation,30,19,11
Froststraza,chamber-of-aspects,1758,evoker,preservation,54,27,27
Bümber,stormscale,1750,evoker,preservation,88,40,48
Asyncgosa,ravencrest,1749,evoker,preservation,60,25,35
Dragondaddy,eredar,1748,evoker,preservation,42,19,23
Kalevra,eredar,1737,evoker,preservation,105,56,49
Антошадф,gordunni,1736,evoker,preservation,48,25,23
Gneltharion,draenor,1723,evoker,preservation,56,25,31
Camdaddy,magtheridon,1715,evoker,preservation,117,60,57
Трейш,soulflayer,1714,evoker,preservation,72,29,43
Seafolk,stormscale,1705,evoker,preservation,134,70,64
Alusiedrake,ravencrest,1704,evoker,preservation,154,87,67
Themasktw,kazzak,1702,evoker,preservation,58,25,33
Ранкондракон,lich-king,1695,evoker,preservation,89,38,51
Ðåñîq,kazzak,1691,evoker,preservation,48,23,25
Tombeelee,kazzak,1687,evoker,preservation,36,21,15
Devidra,defias-brotherhood,1683,evoker,preservation,93,39,54
Nyghtx,sanguino,1680,evoker,preservation,76,33,43
Roth,stormreaver,1679,evoker,preservation,106,55,51
Phyrrax,silvermoon,1678,evoker,preservation,30,18,12
Nakavoker,arygos,1676,evoker,preservation,46,18,28
Ezinice,hyjal,1672,evoker,preservation,46,20,26
Драконсила,gordunni,1663,evoker,preservation,41,21,20
Eryot,aggra-português,1660,evoker,preservation,54,25,29
Antiflexx,ragnaros,1642,evoker,preservation,48,26,22
Béatér,aegwynn,1642,evoker,preservation,36,18,18
Аскми,blackscar,1642,evoker,preservation,84,35,49
Âspên,archimonde,1639,evoker,preservation,51,24,27
Ramfurry,kazzak,1632,evoker,preservation,49,21,28
Shroudflight,draenor,1632,evoker,preservation,54,23,31
Rüllatorsven,stormscale,1631,evoker,preservation,36,21,15
Тирэсплюс,soulflayer,1630,evoker,preservation,30,17,13
Kaipha,ravencrest,1630,evoker,preservation,59,29,30
Bònéz,blackmoore,1629,evoker,preservation,101,48,53
Bugdul,twisting-nether,1625,evoker,preservation,56,33,23
Kackaloch,tarren-mill,1625,evoker,preservation,69,37,32
Aeste,dun-modr,1624,evoker,preservation,42,23,19
Даэдра,gordunni,1623,evoker,preservation,132,64,68
Methamfetami,kazzak,1619,evoker,preservation,72,40,32
Akaos,silvermoon,1613,evoker,preservation,38,20,18
Lytër,sanguino,1610,evoker,preservation,123,68,55
Hjucen,twisting-nether,1603,evoker,preservation,90,49,41
Потныйдракон,soulflayer,1603,evoker,preservation,42,20,22
Malowux,outland,1600,evoker,preservation,36,19,17
Dragnthsnuts,sylvanas,1590,evoker,preservation,50,26,24
Malboroasted,archimonde,1586,evoker,preservation,42,21,21
Scarydragôn,draenor,1582,evoker,preservation,93,56,37
Эндемический,soulflayer,1582,evoker,preservation,48,21,27
Setraxia,argent-dawn,1578,evoker,preservation,48,32,16
Häröpallo,stormscale,1572,evoker,preservation,60,32,28
Nahkiainen,darksorrow,1569,evoker,preservation,42,19,23
Valkroth,argent-dawn,1565,evoker,preservation,107,47,60
Fearawr,malganis,1552,evoker,preservation,63,22,41
Дарконикс,gordunni,1547,evoker,preservation,86,40,46
Штеци,howling-fjord,1544,evoker,preservation,241,113,128
Kirivoker,dun-modr,1540,evoker,preservation,54,26,28
Нежныйболт,howling-fjord,1536,evoker,preservation,134,68,66
Torae,burning-legion,1535,evoker,preservation,48,23,25
Dârys,kazzak,1531,evoker,preservation,36,16,20
Zenvoker,silvermoon,1523,evoker,preservation,30,17,13
Sinistrea,conseil-des-ombres,1514,evoker,preservation,81,47,34
Crocodeal,ysondre,1506,evoker,preservation,24,16,8
Хронолиса,blackscar,1497,evoker,preservation,121,55,66
Odensbest,silvermoon,1496,evoker,preservation,55,32,23
Bigaluga,blackmoore,1492,evoker,preservation,42,18,24
Didii,frostwhisper,1490,evoker,preservation,117,53,64
Luderx,outland,1489,evoker,preservation,66,38,28
Tenibris,die-nachtwache,1489,evoker,preservation,119,55,64
Бадикабаер,thermaplugg,1484,evoker,preservation,131,68,63
Sakade,archimonde,1480,evoker,preservation,40,18,22
Tobbebakar,silvermoon,1478,evoker,preservation,36,17,19
Ятромантис,gordunni,1474,evoker,preservation,273,139,134
Ацидракон,blackscar,1472,evoker,preservation,72,29,43
Indragon,blackmoore,1471,evoker,preservation,63,29,34
Obbwoke,ravencrest,1471,evoker,preservation,90,37,53
Kuramir,twisting-nether,1469,evoker,preservation,30,16,14
Oldwhiteman,guldan,1465,evoker,preservation,52,25,27
Tarecgosa,sanguino,1462,evoker,preservation,96,43,53
Polzeig,dentarg,1458,evoker,preservation,41,17,24
Madelynxoxo,draenor,1450,evoker,preservation,30,25,5
Dragoncya,archimonde,1447,evoker,preservation,72,33,39
Condrage,grim-batol,1445,evoker,preservation,42,22,20
Spiragon,ysondre,1434,evoker,preservation,72,37,35
Wernøker,archimonde,1431,evoker,preservation,36,15,21
Mortlalune,conseil-des-ombres,1429,evoker,preservation,100,59,41
Sedricae,twisting-nether,1429,evoker,preservation,131,67,64
Dokkàmxk,archimonde,1429,evoker,preservation,36,15,21
Dazaar,kazzak,1428,evoker,preservation,18,16,2
Maxthecar,draenor,1428,evoker,preservation,47,29,18
Yeatsa,blackmoore,1417,evoker,preservation,24,15,9
Th,stormscale,1415,evoker,preservation,48,32,16
Saga,aegwynn,1410,evoker,preservation,113,59,54
Nanthira,darksorrow,1410,evoker,preservation,74,33,41
Evizard,nagrand,1407,evoker,preservation,53,30,23
Dracanus,bronze-dragonflight,1404,evoker,preservation,36,19,17
Loveheart,die-aldor,1396,evoker,preservation,82,37,45
Cragheart,ravencrest,1391,evoker,preservation,60,28,32
Nadoney,hyjal,1389,evoker,preservation,67,42,25
Matysniak,burning-legion,1388,evoker,preservation,36,18,18
Ammendorn,blackrock,1384,evoker,preservation,46,27,19
Azorgaron,outland,1383,evoker,preservation,60,26,34
Asraestrasz,silvermoon,1380,evoker,preservation,38,24,14
Jamiewing,ravencrest,1380,evoker,preservation,42,25,17
Cenca,blackmoore,1375,evoker,preservation,109,54,55
Nexxà,archimonde,1373,evoker,preservation,39,28,11
Scalie,ravencrest,1353,evoker,preservation,54,31,23
Шкуроносец,gordunni,1352,evoker,preservation,30,15,15
Liliwood,ravencrest,1349,evoker,preservation,82,38,44
Evokazoran,dentarg,1349,evoker,preservation,78,27,51
Choubalo,archimonde,1348,evoker,preservation,60,33,27
Cinquanteuro,hyjal,1347,evoker,preservation,101,45,56
Rescuegirl,blackrock,1345,evoker,preservation,99,50,49
Adriia,draenor,1341,evoker,preservation,18,14,4
Drarent,hyjal,1340,evoker,preservation,54,24,30
Profdrake,zuluhed,1337,evoker,preservation,24,14,10
Badrig,silvermoon,1336,evoker,preservation,118,55,63
Gissthebuzzy,dun-modr,1326,evoker,preservation,42,24,18
Dwagonzuv,the-maelstrom,1323,evoker,preservation,24,14,10
Sorextrazy,twisting-nether,1318,evoker,preservation,64,27,37
Thellon,frostwolf,1317,evoker,preservation,29,17,12
Uroegevoker,twisting-nether,1316,evoker,preservation,68,36,32
Breall,tarren-mill,1309,evoker,preservation,176,79,97
Draxaer,outland,1307,evoker,preservation,98,52,46
Xerragon,ravencrest,1306,evoker,preservation,60,20,40
Whitelizzard,tarren-mill,1305,evoker,preservation,42,24,18
Fredgobrr,tarren-mill,1299,evoker,preservation,84,53,31
Nonolildrake,ysondre,1297,evoker,preservation,82,46,36
Geckonen,stormreaver,1292,evoker,preservation,109,59,50
Scalo,kazzak,1292,evoker,preservation,90,41,49
Nazalath,eonar,1290,evoker,preservation,36,17,19
Discodidling,silvermoon,1287,evoker,preservation,63,32,31
Malfø,exodar,1282,evoker,preservation,115,58,57
Asinitaris,ravencrest,1279,evoker,preservation,47,26,21
Superflyy,kazzak,1278,evoker,preservation,110,42,68
Lynastrasza,silvermoon,1274,evoker,preservation,147,78,69
Dragonerr,kiljaeden,1273,evoker,preservation,36,20,16
Vaermithor,tarren-mill,1270,evoker,preservation,59,33,26
Drackheal,kaelthas,1269,evoker,preservation,35,21,14
Erhvoker,veknilash,1269,evoker,preservation,69,29,40
Ludracy,antonidas,1267,evoker,preservation,66,34,32
Thundermifln,nemesis,1264,evoker,preservation,42,23,19
Nagoli,silvermoon,1250,evoker,preservation,55,26,29
Dinotron,uldaman,1249,evoker,preservation,54,27,27
Jkdrage,stormscale,1247,evoker,preservation,24,13,11
Najikí,tarren-mill,1247,evoker,preservation,24,13,11
Chasxstrasza,ravencrest,1247,evoker,preservation,36,13,23
Novvae,hyjal,1243,evoker,preservation,24,13,11
Crottedezen,archimonde,1243,evoker,preservation,30,13,17
Apaçi,ravencrest,1243,evoker,preservation,51,19,32
Kymura,archimonde,1239,evoker,preservation,30,13,17
Тектрис,howling-fjord,1238,evoker,preservation,126,58,68
Shnptyr,ragnaros,1236,evoker,preservation,30,16,14
Beenus,doomhammer,1228,evoker,preservation,36,24,12
Pelington,silvermoon,1227,evoker,preservation,24,13,11
Âbs,archimonde,1227,evoker,preservation,99,41,58
Патриотика,howling-fjord,1225,evoker,preservation,59,26,33
Stjáuni,ravencrest,1218,evoker,preservation,46,23,23
Lojinevo,twisting-nether,1215,evoker,preservation,95,43,52
Ruinastrasza,silvermoon,1212,evoker,preservation,24,13,11
Varaug,veklor,1211,evoker,preservation,40,25,15
Muccavok,stormrage,1204,evoker,preservation,36,20,16
Amaterãsu,kazzak,1204,evoker,preservation,43,21,22
Kurger,twisting-nether,1198,evoker,preservation,39,17,22
Jimmytrivet,archimonde,1198,evoker,preservation,39,16,23
Yeetsera,thrall,1195,evoker,preservation,58,25,33
Howtodragon,twisting-nether,1189,evoker,preservation,36,17,19
Ohcaralho,outland,1188,evoker,preservation,39,16,23
Nivoker,kazzak,1182,evoker,preservation,27,13,14
Uztfuzt,blackmoore,1178,evoker,preservation,40,27,13
Belkavoker,zirkel-des-cenarius,1177,evoker,preservation,42,14,28
Dragonna,argent-dawn,1171,evoker,preservation,48,23,25
Zethreus,silvermoon,1170,evoker,preservation,58,30,28
Dayandnight,quelthalas,1170,evoker,preservation,60,28,32
Aphi,frostwolf,1170,evoker,preservation,57,26,31
Tennin,thrall,1157,evoker,preservation,45,27,18
Eagleflow,aszune,1154,evoker,preservation,31,13,18
Gardenewt,ravencrest,1152,evoker,preservation,18,12,6
Jmy,bloodhoof,1152,evoker,preservation,18,12,6
Anso,sanguino,1152,evoker,preservation,48,23,25
Mistrßroducr,stormreaver,1151,evoker,preservation,24,12,12
Hehehihihaha,ravencrest,1151,evoker,preservation,24,12,12
Elleavo,tarren-mill,1149,evoker,preservation,30,12,18
Ámenó,stormscale,1148,evoker,preservation,18,12,6
Dragawn,grim-batol,1147,evoker,preservation,73,41,32
Nekrosdrake,tarren-mill,1146,evoker,preservation,24,12,12
Sinusiitiis,destromath,1142,evoker,preservation,18,12,6
Wrcdragon,drakthul,1141,evoker,preservation,24,12,12
Ryujíin,kazzak,1139,evoker,preservation,23,12,11
Donns,frostmane,1125,evoker,preservation,22,13,9
Adnoc,tarren-mill,1124,evoker,preservation,19,13,6
Алифсе,howling-fjord,1123,evoker,preservation,60,18,42
Drachenglas,antonidas,1112,evoker,preservation,30,13,17
Sibvoker,kazzak,1107,evoker,preservation,57,23,34
Алекстраса,blackscar,1097,evoker,preservation,30,16,14
Saphirá,hyjal,1094,evoker,preservation,28,13,15
Wingzy,chogall,1090,evoker,preservation,188,89,99
Singe,nemesis,1081,evoker,preservation,48,12,36
Drakeish,kazzak,1077,evoker,preservation,29,13,16
Blackli,kazzak,1074,evoker,preservation,33,14,19
Tsukiko,archimonde,1074,evoker,preservation,31,12,19
Pikiscalez,bronzebeard,1072,evoker,preservation,24,12,12
Viseron,zuljin,1067,evoker,preservation,57,19,38
Saucy,sanguino,1063,evoker,preservation,18,12,6
Lizardofoz,argent-dawn,1058,evoker,preservation,30,18,12
Вискписк,soulflayer,1056,evoker,preservation,12,11,1
Berlyvoke,stormscale,1056,evoker,preservation,18,11,7
Omac,sylvanas,1055,evoker,preservation,18,11,7
Samidr,ravencrest,1054,evoker,preservation,30,11,19
Bombrush,ragnaros,1052,evoker,preservation,27,15,12
Dragonsimp,archimonde,1047,evoker,preservation,18,11,7
Sarapakara,burning-blade,1047,evoker,preservation,24,11,13
Уконэ,blackscar,1047,evoker,preservation,30,12,18
Zeigrem,antonidas,1044,evoker,preservation,12,11,1
Thymian,ambossar,1041,evoker,preservation,86,43,43
Predatax,drakthul,1039,evoker,preservation,142,71,71
Deadfyre,dun-modr,1034,evoker,preservation,24,13,11
Rafale,the-maelstrom,1029,evoker,preservation,47,22,25
Chrisú,thrall,1029,evoker,preservation,30,12,18
Шадофдрагон,deathweaver,1027,evoker,preservation,36,24,12
Zathîel,argent-dawn,1026,evoker,preservation,149,64,85
Drazor,blackhand,1021,evoker,preservation,23,11,12
Spirow,archimonde,1019,evoker,preservation,24,14,10
Navilism,kazzak,1004,evoker,preservation,179,93,86
Archont,eredar,999,evoker,preservation,42,12,30
Draklorn,moonglade,997,evoker,preservation,35,18,17
Morlie,argent-dawn,997,evoker,preservation,70,32,38
Tf,doomhammer,988,evoker,preservation,40,15,25
Palindre,argent-dawn,987,evoker,preservation,29,14,15
Retyss,twisting-nether,978,evoker,preservation,295,143,152
Hool,silvermoon,975,evoker,preservation,120,59,61
Slashlowe,archimonde,972,evoker,preservation,36,17,19
Reddeaddrago,silvermoon,966,evoker,preservation,44,24,20
Folevo,stormreaver,965,evoker,preservation,151,58,93
Ecovoker,outland,960,evoker,preservation,18,10,8
Salamanderx,stormscale,959,evoker,preservation,12,10,2
Mauül,ravencrest,959,evoker,preservation,12,10,2
Thèrèse,hyjal,959,evoker,preservation,24,10,14
Eidachsal,antonidas,959,evoker,preservation,36,10,26
Síire,ravencrest,958,evoker,preservation,12,10,2
Skypov,sylvanas,957,evoker,preservation,18,10,8
Kleftra,stormscale,954,evoker,preservation,18,10,8
Fubukinoryuu,frostwolf,954,evoker,preservation,18,10,8
Bobonakia,sylvanas,950,evoker,preservation,24,10,14
Raøug,blackmoore,950,evoker,preservation,30,10,20
Jhoanna,grim-batol,938,evoker,preservation,30,15,15
Pigioto,silvermoon,937,evoker,preservation,145,68,77
Винтер,azuregos,935,evoker,preservation,19,11,8
Drakars,kazzak,934,evoker,preservation,50,23,27
Vozzat,stormscale,934,evoker,preservation,24,11,13
Morsan,tichondrius,931,evoker,preservation,36,19,17
Jurrassic,defias-brotherhood,929,evoker,preservation,18,10,8
Branados,argent-dawn,926,evoker,preservation,18,10,8
Vores,norgannon,908,evoker,preservation,59,26,33
Cárried,twilights-hammer,902,evoker,preservation,33,11,22
Canitabravar,cthun,898,evoker,preservation,60,30,30
Marasz,silvermoon,893,evoker,preservation,42,22,20
Eosin,blackrock,890,evoker,preservation,23,10,13
Drachi,ambossar,880,evoker,preservation,78,35,43
Jamesdouglas,eredar,867,evoker,preservation,18,10,8
Dreamwalk,archimonde,864,evoker,preservation,12,9,3
Antifightx,kazzak,864,evoker,preservation,12,9,3
Drgigapump,blackmoore,864,evoker,preservation,18,9,9
Dracum,kazzak,864,evoker,preservation,18,9,9
Moondraka,outland,864,evoker,preservation,18,9,9
Kremost,sylvanas,864,evoker,preservation,18,9,9
Мишанячешуя,gordunni,863,evoker,preservation,12,9,3
Cupcâke,dalaran,863,evoker,preservation,18,9,9
Valtion,stormscale,863,evoker,preservation,18,9,9
Anlong,alakir,863,evoker,preservation,23,10,13
Lazurius,ravencrest,863,evoker,preservation,24,9,15
Etier,aegwynn,862,evoker,preservation,18,9,9
Sissilisko,sylvanas,861,evoker,preservation,12,9,3
Blazeros,sylvanas,861,evoker,preservation,36,15,21
Lynt,burning-blade,860,evoker,preservation,12,9,3
Nisiris,doomhammer,860,evoker,preservation,12,9,3
Mistvoke,kazzak,860,evoker,preservation,18,9,9
Lithnxv,bladefist,859,evoker,preservation,18,9,9
Aphelïon,dun-modr,859,evoker,preservation,24,9,15
Evok,deathwing,858,evoker,preservation,24,10,14
Мйлкйвей,deathguard,852,evoker,preservation,11,10,1
Gilgakek,darksorrow,852,evoker,preservation,24,9,15
Javåscript,outland,849,evoker,preservation,18,9,9
Kuubski,ravencrest,846,evoker,preservation,14,11,3
Sumo,burning-legion,841,evoker,preservation,36,16,20
Drâkarys,khaz-modan,839,evoker,preservation,35,10,25
Damssx,medivh,837,evoker,preservation,21,11,10
Viseriðn,archimonde,827,evoker,preservation,24,9,15
Miumyuki,drakthul,815,evoker,preservation,54,21,33
Мэриджэин,soulflayer,809,evoker,preservation,21,9,12
Aayala,dalaran,806,evoker,preservation,21,9,12
Yadormi,sylvanas,795,evoker,preservation,42,16,26
Dratheon,dun-modr,794,evoker,preservation,32,10,22
Тирдде,deathweaver,791,evoker,preservation,78,32,46
Верметор,soulflayer,773,evoker,preservation,90,27,63
Nst,zuljin,768,evoker,preservation,12,8,4
Zemar,dalaran,768,evoker,preservation,12,8,4
Zendaë,archimonde,768,evoker,preservation,12,8,4
Ringil,tarren-mill,768,evoker,preservation,18,8,10
Jaje,nerathor,768,evoker,preservation,18,8,10
Blyatcuka,kazzak,767,evoker,preservation,12,8,4
Baszz,aegwynn,767,evoker,preservation,18,8,10
Мефодийевок,howling-fjord,767,evoker,preservation,18,8,10
Chronowalker,ragnaros,767,evoker,preservation,18,8,10
Draelaynex,eredar,767,evoker,preservation,24,8,16
Stormwing,twilights-hammer,765,evoker,preservation,12,8,4
Ithijin,blackmoore,765,evoker,preservation,18,8,10
Mfdragon,grim-batol,765,evoker,preservation,24,8,16
Smrdimipytel,drakthul,765,evoker,preservation,28,8,20
Уполнамоченн,soulflayer,764,evoker,preservation,12,8,4
Azurewings,argent-dawn,764,evoker,preservation,36,9,27
Mikevoker,aegwynn,763,evoker,preservation,12,8,4
Nagimurr,kazzak,763,evoker,preservation,12,8,4
Arecibo,tarren-mill,762,evoker,preservation,12,8,4
Dreamiee,kazzak,758,evoker,preservation,24,8,16
Dragonrocker,silvermoon,757,evoker,preservation,24,8,16
Дрэгтир,lich-king,755,evoker,preservation,14,8,6
Nahfr,terenas,736,evoker,preservation,22,8,14
Evodorie,ravencrest,703,evoker,preservation,14,8,6
Scaleyfurry,azshara,702,evoker,preservation,15,9,6
Vyron,amanthul,702,evoker,preservation,16,8,8
Sunfyres,frostmane,679,evoker,preservation,28,8,20
Stormnn,kazzak,672,evoker,preservation,12,7,5
Fûrý,twisting-nether,672,evoker,preservation,12,7,5
Blazelt,blackrock,672,evoker,preservation,12,7,5
Sârmikas,blackhand,672,evoker,preservation,12,7,5
Elcocodrilo,tarren-mill,672,evoker,preservation,12,7,5
Evyzz,blackmoore,672,evoker,preservation,12,7,5
Kharduk,outland,672,evoker,preservation,15,8,7
Sulführer,sanguino,672,evoker,preservation,18,7,11
Spacebreath,ravencrest,672,evoker,preservation,18,7,11
Dragarius,tarren-mill,672,evoker,preservation,18,7,11
Detdragetid,zenedar,672,evoker,preservation,24,7,17
Орехдракона,gordunni,671,evoker,preservation,12,7,5
Drakkujjer,twisting-nether,671,evoker,preservation,12,7,5
Draaxy,twisting-nether,671,evoker,preservation,15,8,7
Fusanabide,kazzak,671,evoker,preservation,14,7,7
Karristrasza,silvermoon,671,evoker,preservation,18,7,11
Myszostrasza,burning-legion,670,evoker,preservation,12,7,5
Esalisko,kazzak,670,evoker,preservation,12,7,5
Nedflanderss,silvermoon,670,evoker,preservation,12,7,5
Smokitor,kazzak,670,evoker,preservation,12,7,5
Coaxoch,thunderhorn,670,evoker,preservation,12,7,5
Leblon,stormreaver,670,evoker,preservation,12,7,5
Draevil,emerald-dream,669,evoker,preservation,18,7,11
Lapaneri,sylvanas,669,evoker,preservation,24,7,17
Dracnass,silvermoon,668,evoker,preservation,12,7,5
Prikkedøden,grim-batol,668,evoker,preservation,18,7,11
Acnologîa,ysondre,665,evoker,preservation,12,7,5
Gihzmo,tarren-mill,664,evoker,preservation,12,7,5
Эбиб,gordunni,664,evoker,preservation,18,7,11
Awfultrash,archimonde,655,evoker,preservation,23,7,16
Sính,ravencrest,576,evoker,preservation,12,6,6
Sindragonk,ravencrest,576,evoker,preservation,12,6,6
Вексалис,gordunni,576,evoker,preservation,12,6,6
Krayvoker,tarren-mill,576,evoker,preservation,12,6,6
Parodize,thrall,576,evoker,preservation,12,6,6
Mesarin,eredar,576,evoker,preservation,12,6,6
Jacko,nemesis,576,evoker,preservation,12,6,6
Talynn,sylvanas,576,evoker,preservation,12,6,6
Dedx,sylvanas,576,evoker,preservation,12,6,6
Bluesaphir,ravencrest,576,evoker,preservation,12,6,6
Iandret,destromath,576,evoker,preservation,12,6,6
Snipy,burning-legion,576,evoker,preservation,12,6,6
Lolprevoker,outland,576,evoker,preservation,18,6,12
Discodraken,stormscale,576,evoker,preservation,18,6,12
Myntara,tarren-mill,576,evoker,preservation,18,6,12
Enzetrius,argent-dawn,576,evoker,preservation,18,6,12
Lìssàndra,argent-dawn,576,evoker,preservation,24,6,18
Raegos,ravencrest,575,evoker,preservation,12,6,6
Pasqvoker,ravencrest,575,evoker,preservation,12,6,6
Draccaris,silvermoon,575,evoker,preservation,12,6,6
Nevara,ragnaros,575,evoker,preservation,12,6,6
Tarystrasza,blackrock,574,evoker,preservation,12,6,6
Groovyy,hyjal,574,evoker,preservation,12,6,6
Schenlong,kelthuzad,574,evoker,preservation,12,6,6
Drakpojke,stormscale,574,evoker,preservation,12,6,6
Dracarysfire,kazzak,573,evoker,preservation,12,6,6
Ewings,archimonde,573,evoker,preservation,24,6,18
Steeken,haomarush,572,evoker,preservation,18,6,12
Synhtol,ragnaros,564,evoker,preservation,18,6,12
ßëkûsåùrús,ragnaros,559,evoker,preservation,17,6,11
Rasalhague,uldum,522,evoker,preservation,15,6,9
Dracarysx,grim-batol,520,evoker,preservation,15,7,8
Drakthur,terenas,519,evoker,preservation,27,7,20
Tyuz,antonidas,509,evoker,preservation,14,6,8
Holyvoker,aegwynn,480,evoker,preservation,6,5,1
Sürion,grim-batol,480,evoker,preservation,6,5,1
Stêwpit,blackhand,480,evoker,preservation,6,5,1
Jmyzard,tarren-mill,480,evoker,preservation,10,6,4
Lichbõrne,outland,480,evoker,preservation,12,5,7
Alanikus,silvermoon,480,evoker,preservation,12,5,7
Vizdraken,tarren-mill,480,evoker,preservation,12,5,7
Deathwingx,sylvanas,480,evoker,preservation,12,5,7
Soupmah,silvermoon,480,evoker,preservation,12,5,7
Alamostrasza,doomhammer,480,evoker,preservation,12,5,7
Bigreddragon,outland,480,evoker,preservation,12,5,7
Fnom,hyjal,480,evoker,preservation,12,5,7
Uwudyret,tarren-mill,480,evoker,preservation,12,5,7
Dragonsito,cthun,480,evoker,preservation,12,5,7
Óceiros,silvermoon,480,evoker,preservation,12,5,7
Iwaavoker,archimonde,480,evoker,preservation,12,5,7
Nemrák,blackmoore,480,evoker,preservation,12,5,7
Emeraldcomun,twisting-nether,480,evoker,preservation,12,5,7
Reptak,stormscale,480,evoker,preservation,12,5,7
Evoris,frostmane,480,evoker,preservation,12,5,7
Evokoloko,outland,480,evoker,preservation,12,5,7
Голденджо,gordunni,480,evoker,preservation,23,5,18
Rise,tarren-mill,480,evoker,preservation,24,5,19
Draktoros,kazzak,479,evoker,preservation,6,5,1
Sudrac,antonidas,479,evoker,preservation,12,5,7
Verithian,kazzak,479,evoker,preservation,12,5,7
Luftwaffel,blackmoore,479,evoker,preservation,12,5,7
Dmn,defias-brotherhood,479,evoker,preservation,12,5,7
Kaiser,trollbane,479,evoker,preservation,12,5,7
Shosk,chamber-of-aspects,479,evoker,preservation,12,5,7
Kampe,nemesis,479,evoker,preservation,12,5,7
Scaleflux,argent-dawn,479,evoker,preservation,12,5,7
Puffdaddyxd,twisting-nether,479,evoker,preservation,12,5,7
Dragondisnut,sylvanas,479,evoker,preservation,12,5,7
Zymotîx,stormscale,479,evoker,preservation,18,5,13
Baléryon,archimonde,478,evoker,preservation,6,5,1
Haawwt,eredar,478,evoker,preservation,12,5,7
Kärlethos,dun-modr,478,evoker,preservation,12,5,7
Widow,chromaggus,478,evoker,preservation,12,5,7
Bbuszek,outland,478,evoker,preservation,18,5,13
Fodom,medivh,477,evoker,preservation,12,5,7
Dragorasi,frostwolf,476,evoker,preservation,24,5,19
Гарил,grom,475,evoker,preservation,12,5,7
Fricandela,sanguino,472,evoker,preservation,12,5,7
Avizz,tarren-mill,462,evoker,preservation,17,8,9
Zerario,blackhand,447,evoker,preservation,11,5,6
Thyriån,kazzak,447,evoker,preservation,11,5,6
Эфирид,blackscar,443,evoker,preservation,17,5,12
Jcloud,shattered-hand,432,evoker,preservation,15,5,10
Grajade,dun-modr,422,evoker,preservation,15,6,9
Krakadayle,archimonde,384,evoker,preservation,6,4,2
Roastedpig,kazzak,384,evoker,preservation,6,4,2
Zaffira,kazzak,384,evoker,preservation,6,4,2
Aymoreth,argent-dawn,384,evoker,preservation,6,4,2
Drakatha,kazzak,384,evoker,preservation,6,4,2
Dracronix,the-maelstrom,384,evoker,preservation,6,4,2
Bindrasz,ahnqiraj,384,evoker,preservation,6,4,2
Pe,dalaran,384,evoker,preservation,6,4,2
Pflanz,nozdormu,384,evoker,preservation,6,4,2
Darigo,ravencrest,384,evoker,preservation,6,4,2
Пидрактир,soulflayer,384,evoker,preservation,6,4,2
Nhoru,stormscale,384,evoker,preservation,6,4,2
Sondosa,twisting-nether,384,evoker,preservation,12,4,8
Hyggëê,sanguino,384,evoker,preservation,12,4,8
Nerfevøker,ragnaros,384,evoker,preservation,12,4,8
Mirajhti,blackrock,384,evoker,preservation,12,4,8
Castytopg,blackrock,384,evoker,preservation,12,4,8
Killafoolz,kazzak,384,evoker,preservation,12,4,8
Evokker,antonidas,384,evoker,preservation,12,4,8
Toílet,blackmoore,384,evoker,preservation,12,4,8
Fogwing,ravencrest,384,evoker,preservation,18,4,14
Drakutyr,defias-brotherhood,383,evoker,preservation,6,4,2
Timeshifter,stormscale,383,evoker,preservation,6,4,2
Кефтыме,soulflayer,383,evoker,preservation,6,4,2
Doriangray,drakthul,383,evoker,preservation,6,4,2
Entombevoker,twisting-nether,383,evoker,preservation,6,4,2
Zahaak,doomhammer,383,evoker,preservation,6,4,2
Drakares,la-croisade-écarlate,383,evoker,preservation,12,4,8
Vereeza,draenor,383,evoker,preservation,12,4,8
Flawxy,blackmoore,383,evoker,preservation,12,4,8
Drogøn,khaz-modan,383,evoker,preservation,12,4,8
Yaldthion,dun-modr,383,evoker,preservation,18,4,14
Steadyop,doomhammer,382,evoker,preservation,6,4,2
Dreiwyn,kazzak,382,evoker,preservation,6,4,2
Dolceprada,stormscale,381,evoker,preservation,12,4,8
Мизурион,gordunni,379,evoker,preservation,12,4,8
Blackwing,twilights-hammer,351,evoker,preservation,16,4,12
Sinastral,sanguino,350,evoker,preservation,11,4,7
Keizal,twisting-nether,288,evoker,preservation,6,3,3
Zordrach,quelthalas,288,evoker,preservation,6,3,3
Saphiraa,lightnings-blade,288,evoker,preservation,6,3,3
Jackarlys,outland,288,evoker,preservation,6,3,3
Rømmegrøt,tarren-mill,288,evoker,preservation,6,3,3
Rhaenîra,twisting-nether,288,evoker,preservation,6,3,3
Ladrieth,hyjal,288,evoker,preservation,6,3,3
Icemushu,twisting-nether,288,evoker,preservation,6,3,3
Setoc,blackrock,288,evoker,preservation,6,3,3
Jmý,tarren-mill,288,evoker,preservation,6,3,3
Asrwea,draenor,288,evoker,preservation,6,3,3
Distinkd,draenor,288,evoker,preservation,6,3,3
Konstraz,kazzak,288,evoker,preservation,6,3,3
Yesdaddyowo,draenor,288,evoker,preservation,6,3,3
Viseriøn,kazzak,288,evoker,preservation,6,3,3
Meezyevo,ragnaros,288,evoker,preservation,6,3,3
Rippo,tarren-mill,288,evoker,preservation,6,3,3
Niffdra,twisting-nether,288,evoker,preservation,6,3,3
Ivokerz,tarren-mill,288,evoker,preservation,6,3,3
Renalia,blackrock,288,evoker,preservation,6,3,3
Nezruslfarm,cthun,288,evoker,preservation,6,3,3
Eurydíke,blackhand,288,evoker,preservation,6,3,3
Моралдракон,soulflayer,288,evoker,preservation,6,3,3
Drageye,tarren-mill,288,evoker,preservation,6,3,3
Pruttburk,draenor,288,evoker,preservation,6,3,3
Tactician,stormreaver,288,evoker,preservation,6,3,3
Escaaboy,stormscale,288,evoker,preservation,6,3,3
Dangai,draenor,288,evoker,preservation,6,3,3
Kanketo,ravencrest,288,evoker,preservation,6,3,3
Drachenlilie,aegwynn,288,evoker,preservation,6,3,3
Azwel,khaz-modan,288,evoker,preservation,6,3,3
Evokimag,grim-batol,288,evoker,preservation,6,3,3
Botomforgold,ravencrest,288,evoker,preservation,6,3,3
Сулистраза,blackscar,288,evoker,preservation,6,3,3
Speckjarrow,blackrock,288,evoker,preservation,6,3,3
Vyore,silvermoon,288,evoker,preservation,6,3,3
Colacorta,zuljin,288,evoker,preservation,6,3,3
Cadwalader,blades-edge,288,evoker,preservation,12,3,9
Bemil,twisting-nether,288,evoker,preservation,12,3,9
Websensation,twisting-nether,288,evoker,preservation,12,3,9
Боевойхомякд,howling-fjord,288,evoker,preservation,12,3,9
Taktcik,archimonde,288,evoker,preservation,12,3,9
Dreamdoll,tarren-mill,288,evoker,preservation,12,3,9
Reelona,silvermoon,288,evoker,preservation,12,3,9
Horiz,kazzak,288,evoker,preservation,12,3,9
Monftroglou,archimonde,288,evoker,preservation,12,3,9
Moltenazo,dun-modr,288,evoker,preservation,13,3,10
Милеис,soulflayer,287,evoker,preservation,6,3,3
Büsselberg,blackmoore,287,evoker,preservation,6,3,3
Elexatra,hyjal,287,evoker,preservation,12,3,9
Valystrá,die-aldor,285,evoker,preservation,24,3,21
Trellie,die-aldor,255,evoker,preservation,11,3,8
Agnî,sanguino,240,evoker,preservation,9,3,6
Smoochbumble,argent-dawn,240,evoker,preservation,9,3,6
Nêrifiel,hyjal,239,evoker,preservation,5,3,2
Mugeki,burning-legion,234,evoker,preservation,7,4,3
Baranzion,twisting-nether,207,evoker,preservation,8,3,5
Иванза,howling-fjord,192,evoker,preservation,6,2,4
Myndragosa,varimathras,192,evoker,preservation,6,2,4
Høt,nemesis,192,evoker,preservation,6,2,4
Arbîter,eredar,192,evoker,preservation,6,2,4
Dägon,drakthul,192,evoker,preservation,6,2,4
Freesckretx,archimonde,192,evoker,preservation,6,2,4
Azurog,blackmoore,192,evoker,preservation,6,2,4
Nordomu,silvermoon,192,evoker,preservation,6,2,4
Cousinbetty,defias-brotherhood,192,evoker,preservation,6,2,4
Dno,archimonde,192,evoker,preservation,6,2,4
Flipflapflop,twisting-nether,192,evoker,preservation,6,2,4
Dragonzo,arathor,192,evoker,preservation,6,2,4
Adriia,ravencrest,192,evoker,preservation,6,2,4
Arniye,ravencrest,192,evoker,preservation,6,2,4
Shinad,ravencrest,192,evoker,preservation,6,2,4
Faijer,blackmoore,192,evoker,preservation,6,2,4
Mistime,twisting-nether,192,evoker,preservation,6,2,4
Pureshot,archimonde,192,evoker,preservation,6,2,4
Sheràqt,blackrock,192,evoker,preservation,6,2,4
Crazylucifer,kazzak,192,evoker,preservation,6,2,4
Voldermort,ravencrest,192,evoker,preservation,6,2,4
Invinite,blackrock,192,evoker,preservation,6,2,4
Youzfull,blackrock,192,evoker,preservation,6,2,4
Puzzles,ravencrest,192,evoker,preservation,6,2,4
Lînkôs,aegwynn,192,evoker,preservation,6,2,4
Vermithors,ravencrest,192,evoker,preservation,6,2,4
Glurak,stormscale,192,evoker,preservation,6,2,4
Margouillax,archimonde,192,evoker,preservation,12,2,10
Pico,madmortem,192,evoker,preservation,12,2,10
Dracipsouk,drakthul,192,evoker,preservation,18,2,16
Touge,varimathras,191,evoker,preservation,6,2,4
Yuyux,sanguino,191,evoker,preservation,6,2,4
Drazikz,archimonde,191,evoker,preservation,6,2,4
Azza,uldum,191,evoker,preservation,12,2,10
Charezard,draenor,159,evoker,preservation,5,2,3
Eldrax,emerald-dream,159,evoker,preservation,5,2,3
Stinka,blackmoore,138,evoker,preservation,9,5,4
Primepewpew,ragnaros,138,evoker,preservation,15,3,12
Zzaazaa,argent-dawn,137,evoker,preservation,10,3,7
Odiin,dun-modr,96,evoker,preservation,3,2,1
Yaboismok,burning-legion,96,evoker,preservation,6,1,5
Kaezmasterx,blackrock,96,evoker,preservation,6,1,5
Alphabét,ravencrest,96,evoker,preservation,6,1,5
Reska,archimonde,96,evoker,preservation,6,1,5
Hizzo,burning-legion,96,evoker,preservation,6,1,5
Iblvicanfly,stormscale,96,evoker,preservation,6,1,5
Kitoed,aegwynn,96,evoker,preservation,6,1,5
Awienz,kazzak,96,evoker,preservation,6,1,5
Mulqahdiiv,archimonde,96,evoker,preservation,6,1,5
Chocodragon,blackmoore,96,evoker,preservation,6,1,5
Macdrac,area-52,96,evoker,preservation,6,1,5
Hakuzah,terokkar,96,evoker,preservation,6,1,5
Смехокрыл,deathguard,96,evoker,preservation,6,1,5
Ch,ghostlands,96,evoker,preservation,6,1,5
Галактиг,thermaplugg,96,evoker,preservation,6,1,5
Drakenballen,ragnaros,96,evoker,preservation,6,1,5
Brystrasza,quelthalas,96,evoker,preservation,6,1,5
Tályn,twisting-nether,96,evoker,preservation,6,1,5
Oogabuga,outland,96,evoker,preservation,6,1,5
Targzæ,hyjal,96,evoker,preservation,6,1,5
Vatiras,magtheridon,96,evoker,preservation,6,1,5
Ceerdrogo,twisting-nether,96,evoker,preservation,9,1,8
Dragonban,tarren-mill,96,evoker,preservation,12,1,11
Vullgred,sylvanas,96,evoker,preservation,12,1,11
Sopollina,draenor,96,evoker,preservation,12,1,11
Frreeyya,silvermoon,96,evoker,preservation,12,1,11
Kamings,outland,95,evoker,preservation,8,1,7
Fluffykoi,silvermoon,95,evoker,preservation,12,1,11
Imend,stormscale,79,evoker,preservation,5,1,4
Sentos,blackmoore,64,evoker,preservation,10,1,9
Балрогхаоса,gordunni,63,evoker,preservation,2,2,0
Nickydragonx,stormscale,42,evoker,preservation,10,3,7
Minikuja,culte-de-la-rive-noire,31,evoker,preservation,2,1,1
Rexzstrasza,eredar,2114,evoker,devastation,78,49,29
Sârmikas,blackhand,2113,evoker,devastation,120,67,53
Kàido,ravencrest,2110,evoker,devastation,360,185,175
Heõ,twisting-nether,2058,evoker,devastation,87,41,46
Babodrake,blackhand,2019,evoker,devastation,55,27,28
Claxy,ragnaros,1952,evoker,devastation,72,38,34
Brokz,twisting-nether,1938,evoker,devastation,94,49,45
Wexvoker,darksorrow,1936,evoker,devastation,109,59,50
Drakenyasha,tarren-mill,1929,evoker,devastation,165,78,87
Нерфсрочно,gordunni,1914,evoker,devastation,162,78,84
Edvoker,twisting-nether,1909,evoker,devastation,78,42,36
Darkssoul,outland,1904,evoker,devastation,90,48,42
Eldunaries,argent-dawn,1896,evoker,devastation,78,43,35
Ízma,ravencrest,1893,evoker,devastation,180,93,87
Twodeep,blackrock,1874,evoker,devastation,60,33,27
Enzetrius,argent-dawn,1868,evoker,devastation,30,20,10
Dracohfeu,archimonde,1868,evoker,devastation,54,31,23
Hehehihihaha,ravencrest,1866,evoker,devastation,54,25,29
Meust,blackrock,1864,evoker,devastation,42,28,14
Nigesaurus,burning-legion,1862,evoker,devastation,39,21,18
Frozendragon,twisting-nether,1849,evoker,devastation,45,32,13
Xzvoker,kazzak,1848,evoker,devastation,134,67,67
Sagrax,silvermoon,1835,evoker,devastation,68,40,28
Mizamiza,blackrock,1832,evoker,devastation,142,75,67
Korvi,ravencrest,1830,evoker,devastation,44,25,19
Lizardbøi,blackhand,1827,evoker,devastation,66,33,33
Драгонтьма,gordunni,1823,evoker,devastation,65,33,32
Ryujíin,kazzak,1821,evoker,devastation,60,37,23
Obbwoke,ravencrest,1819,evoker,devastation,54,31,23
Дракшотик,soulflayer,1817,evoker,devastation,30,19,11
Jamzyevoker,emerald-dream,1816,evoker,devastation,49,26,23
Amadeusx,ravencrest,1810,evoker,devastation,55,30,25
Valdrakon,doomhammer,1807,evoker,devastation,66,39,27
Animenorgam,alakir,1806,evoker,devastation,54,40,14
Bigmacfrite,ysondre,1794,evoker,devastation,76,38,38
Tremmérz,outland,1794,evoker,devastation,60,30,30
Avë,kazzak,1790,evoker,devastation,77,39,38
Diznutz,kazzak,1781,evoker,devastation,36,21,15
Ipanicsoar,tarren-mill,1778,evoker,devastation,50,24,26
Hanoostrasz,tarren-mill,1771,evoker,devastation,103,61,42
Hollowbreath,sanguino,1770,evoker,devastation,174,86,88
Sawk,archimonde,1766,evoker,devastation,90,57,33
Lidldragon,argent-dawn,1760,evoker,devastation,26,20,6
Famouszorc,sanguino,1760,evoker,devastation,156,92,64
Merkels,blackmoore,1742,evoker,devastation,105,57,48
Hëroinhenry,tarren-mill,1738,evoker,devastation,42,28,14
Atoll,scarshield-legion,1732,evoker,devastation,43,20,23
Evøkergøðx,outland,1719,evoker,devastation,38,20,18
Lesgrossman,ravencrest,1716,evoker,devastation,30,18,12
Kymaíra,hyjal,1716,evoker,devastation,48,22,26
Melodio,outland,1713,evoker,devastation,60,37,23
Irvethius,argent-dawn,1703,evoker,devastation,143,69,74
Tezkaz,blackmoore,1700,evoker,devastation,172,91,81
Хетсв,gordunni,1691,evoker,devastation,96,55,41
Дарратель,gordunni,1688,evoker,devastation,147,78,69
Jamiewing,ravencrest,1671,evoker,devastation,124,63,61
Oontäälihis,ravencrest,1655,evoker,devastation,85,39,46
Yuhabahha,kazzak,1653,evoker,devastation,166,87,79
Dispelgodx,eredar,1647,evoker,devastation,42,20,22
Dracoli,eredar,1646,evoker,devastation,85,45,40
Cinnannoe,tarren-mill,1644,evoker,devastation,103,60,43
Дреадди,soulflayer,1643,evoker,devastation,64,34,30
Sürion,grim-batol,1642,evoker,devastation,60,33,27
Ясъелинеры,gordunni,1640,evoker,devastation,54,31,23
Archdragon,argent-dawn,1639,evoker,devastation,67,38,29
Serulyon,draenor,1636,evoker,devastation,72,37,35
Hyperan,twisting-nether,1635,evoker,devastation,82,40,42
Piyuli,silvermoon,1632,evoker,devastation,47,27,20
Papayoyo,draenor,1630,evoker,devastation,156,75,81
Ironwing,sanguino,1627,evoker,devastation,387,204,183
Evodraxx,hyjal,1627,evoker,devastation,36,17,19
Zmej,twisting-nether,1621,evoker,devastation,36,17,19
Саммеракс,gordunni,1619,evoker,devastation,54,22,32
Ryuujin,outland,1618,evoker,devastation,42,20,22
Rahzk,twisting-nether,1616,evoker,devastation,30,17,13
Batsquatch,argent-dawn,1612,evoker,devastation,36,23,13
Drazam,blackrock,1612,evoker,devastation,94,55,39
Balthinar,argent-dawn,1612,evoker,devastation,42,17,25
Draxxys,blackmoore,1607,evoker,devastation,48,23,25
Denegos,sylvanas,1606,evoker,devastation,66,40,26
Ludwoker,tarren-mill,1605,evoker,devastation,67,44,23
Lizarduck,tarren-mill,1605,evoker,devastation,52,26,26
Аймбадикабтв,howling-fjord,1605,evoker,devastation,60,29,31
Мнякуня,howling-fjord,1600,evoker,devastation,46,24,22
Fyndassil,blackrock,1599,evoker,devastation,48,17,31
Pêengei,blackrock,1596,evoker,devastation,66,36,30
Sintharion,ravencrest,1596,evoker,devastation,57,25,32
Shimmerscale,blackhand,1590,evoker,devastation,105,59,46
Krothus,outland,1590,evoker,devastation,124,67,57
Ðø,antonidas,1589,evoker,devastation,35,18,17
Инсейнмэн,soulflayer,1580,evoker,devastation,74,40,34
Углекислот,howling-fjord,1580,evoker,devastation,60,26,34
Фиамниэль,gordunni,1574,evoker,devastation,36,18,18
Øxyom,archimonde,1570,evoker,devastation,46,27,19
Duvahkahr,ragnaros,1570,evoker,devastation,45,20,25
Ken,la-croisade-écarlate,1556,evoker,devastation,126,68,58
Спайрок,gordunni,1556,evoker,devastation,103,49,54
Ch,ghostlands,1551,evoker,devastation,41,20,21
Cûddles,hyjal,1548,evoker,devastation,132,68,64
Rokki,blackrock,1547,evoker,devastation,42,20,22
Kuve,stormscale,1541,evoker,devastation,46,27,19
Tetsú,tarren-mill,1541,evoker,devastation,42,23,19
Kayly,twisting-nether,1540,evoker,devastation,42,29,13
Lilpooper,bloodhoof,1536,evoker,devastation,45,24,21
Hyperflexx,blackrock,1521,evoker,devastation,30,16,14
Jeannedebruj,ravencrest,1520,evoker,devastation,75,29,46
Emmagosa,argent-dawn,1512,evoker,devastation,48,27,21
Drakea,sanguino,1511,evoker,devastation,74,40,34
Tibimbo,blackrock,1506,evoker,devastation,68,39,29
Feyrbrand,ysera,1506,evoker,devastation,86,48,38
Arbylegion,outland,1506,evoker,devastation,106,58,48
Ocanada,draenor,1506,evoker,devastation,54,28,26
Ryuu,mazrigos,1498,evoker,devastation,29,16,13
Mommystrasza,dentarg,1493,evoker,devastation,86,43,43
Ruinastrasza,silvermoon,1490,evoker,devastation,145,71,74
Agnî,sanguino,1490,evoker,devastation,82,40,42
Kaynyxia,argent-dawn,1487,evoker,devastation,45,25,20
Bodytypechad,ravencrest,1482,evoker,devastation,60,32,28
Лабриса,galakrond,1482,evoker,devastation,70,32,38
Dracyan,taerar,1479,evoker,devastation,42,24,18
Parisinka,silvermoon,1473,evoker,devastation,227,118,109
Draghad,blackmoore,1472,evoker,devastation,40,19,21
Drákon,dalaran,1459,evoker,devastation,95,45,50
Baroqs,antonidas,1456,evoker,devastation,24,18,6
Nagoli,silvermoon,1456,evoker,devastation,52,27,25
Malfoyer,arathor,1452,evoker,devastation,54,30,24
Ghiscar,dentarg,1451,evoker,devastation,102,50,52
Snoby,onyxia,1451,evoker,devastation,92,42,50
Кунидракон,gordunni,1450,evoker,devastation,50,22,28
Flügelnix,blackmoore,1439,evoker,devastation,42,21,21
Ларенил,gordunni,1436,evoker,devastation,30,15,15
Паунфаунд,eversong,1435,evoker,devastation,96,45,51
Homeoffice,zenedar,1430,evoker,devastation,24,15,9
Pippomale,nemesis,1430,evoker,devastation,42,22,20
Caliss,archimonde,1427,evoker,devastation,71,38,33
Nazalath,eonar,1427,evoker,devastation,77,40,37
Dratheon,dun-modr,1416,evoker,devastation,33,19,14
Stefanosxios,bloodfeather,1416,evoker,devastation,48,22,26
Gasparievok,sylvanas,1416,evoker,devastation,42,19,23
Dowaa,tarren-mill,1414,evoker,devastation,30,15,15
Drakshoff,khaz-modan,1411,evoker,devastation,125,64,61
Xtdrakaris,uldum,1400,evoker,devastation,278,137,141
Ксдз,soulflayer,1397,evoker,devastation,54,27,27
Yaboismok,burning-legion,1393,evoker,devastation,47,22,25
Øseria,khaz-modan,1392,evoker,devastation,60,35,25
Shoggoth,chogall,1391,evoker,devastation,64,32,32
Tályn,twisting-nether,1385,evoker,devastation,48,25,23
Drunkino,aegwynn,1377,evoker,devastation,48,23,25
Nathraakhza,argent-dawn,1375,evoker,devastation,48,26,22
Voldermort,ravencrest,1362,evoker,devastation,29,15,14
Yála,anetheron,1362,evoker,devastation,183,90,93
Yol,bladefist,1362,evoker,devastation,36,15,21
Sakade,archimonde,1359,evoker,devastation,66,22,44
Darktempest,onyxia,1357,evoker,devastation,48,25,23
Grillkylling,outland,1356,evoker,devastation,36,18,18
Rowzy,sylvanas,1350,evoker,devastation,59,28,31
Thyriån,kazzak,1344,evoker,devastation,42,19,23
Yoshinora,archimonde,1337,evoker,devastation,30,15,15
Potéto,rashgarroth,1334,evoker,devastation,72,31,41
Fogwing,ravencrest,1330,evoker,devastation,29,15,14
Karnâks,silvermoon,1326,evoker,devastation,30,16,14
Steeken,haomarush,1324,evoker,devastation,93,43,50
Димадракон,gordunni,1321,evoker,devastation,58,37,21
Dakir,blackmoore,1312,evoker,devastation,38,26,12
Favill,blackhand,1312,evoker,devastation,69,30,39
Hömeöffice,sylvanas,1304,evoker,devastation,29,14,15
Draxone,malfurion,1297,evoker,devastation,54,33,21
Dragoncloak,blackrock,1280,evoker,devastation,78,48,30
Airbourne,sanguino,1280,evoker,devastation,38,18,20
Sharaxis,blackmoore,1279,evoker,devastation,30,17,13
Rieper,twisting-nether,1279,evoker,devastation,84,42,42
Veo,aggra-português,1275,evoker,devastation,30,15,15
Драганайт,gordunni,1274,evoker,devastation,94,58,36
Shmog,stormscale,1272,evoker,devastation,41,15,26
Gharløk,outland,1262,evoker,devastation,50,27,23
Echoker,stormscale,1261,evoker,devastation,31,16,15
Llael,blackhand,1259,evoker,devastation,86,36,50
Коляомон,gordunni,1255,evoker,devastation,42,24,18
Magmarôs,argent-dawn,1252,evoker,devastation,31,16,15
Доракарис,deathweaver,1252,evoker,devastation,30,15,15
Orazur,hyjal,1247,evoker,devastation,18,13,5
Azorgaron,outland,1246,evoker,devastation,18,13,5
Swapxyevo,ravencrest,1246,evoker,devastation,24,13,11
Childofdawn,blackmoore,1244,evoker,devastation,36,19,17
Flaminghot,stormreaver,1243,evoker,devastation,236,129,107
Shenronblue,bloodscalp,1237,evoker,devastation,24,13,11
Lagerstrasza,stormreaver,1234,evoker,devastation,30,13,17
Tokzestra,hyjal,1222,evoker,devastation,62,28,34
Dragonaked,silvermoon,1220,evoker,devastation,42,18,24
Шотнутый,soulflayer,1219,evoker,devastation,33,18,15
Душнот,fordragon,1216,evoker,devastation,36,18,18
Yaldthion,dun-modr,1212,evoker,devastation,36,14,22
Ppiaxx,dalaran,1207,evoker,devastation,24,13,11
Isizzu,draenor,1205,evoker,devastation,73,37,36
Йормунгандка,soulflayer,1189,evoker,devastation,27,14,13
Xfckd,ragnaros,1178,evoker,devastation,30,14,16
Dragomakry,blackmoore,1176,evoker,devastation,18,14,4
Ольменго,fordragon,1175,evoker,devastation,28,13,15
Ahiresegyfej,ragnaros,1170,evoker,devastation,42,25,17
Daboc,tarren-mill,1168,evoker,devastation,30,14,16
Imwhite,doomhammer,1161,evoker,devastation,36,18,18
Thebigsmoke,lightbringer,1155,evoker,devastation,90,44,46
Kôlaghan,archimonde,1148,evoker,devastation,24,12,12
Nuvese,tarren-mill,1147,evoker,devastation,24,12,12
Zaralek,stormscale,1145,evoker,devastation,18,12,6
Туймаада,soulflayer,1141,evoker,devastation,18,12,6
Kaìdo,tarren-mill,1140,evoker,devastation,24,12,12
Elorand,ulduar,1140,evoker,devastation,42,15,27
Алыйкиви,howling-fjord,1127,evoker,devastation,27,15,12
Sleepnot,argent-dawn,1121,evoker,devastation,18,12,6
Lektar,eredar,1118,evoker,devastation,29,13,16
Ayders,khaz-modan,1118,evoker,devastation,60,22,38
Rytoshi,medivh,1111,evoker,devastation,72,25,47
Theredpepper,outland,1104,evoker,devastation,30,12,18
Iolite,dun-modr,1087,evoker,devastation,72,35,37
Padrepì,nemesis,1078,evoker,devastation,18,13,5
Ekko,nethersturm,1076,evoker,devastation,36,19,17
Syraxis,shadowsong,1074,evoker,devastation,22,12,10
Akúda,blackhand,1069,evoker,devastation,42,20,22
Evojøa,tarren-mill,1056,evoker,devastation,18,11,7
Soleric,drakthul,1054,evoker,devastation,24,11,13
Rzektwo,eredar,1054,evoker,devastation,30,11,19
Pêrcevâl,archimonde,1053,evoker,devastation,24,11,13
Lecutos,sunstrider,1052,evoker,devastation,18,11,7
Motloh,ravencrest,1052,evoker,devastation,18,11,7
Skywitch,ragnaros,1052,evoker,devastation,30,11,19
Avizz,tarren-mill,1049,evoker,devastation,15,12,3
Tenshà,nemesis,1048,evoker,devastation,18,11,7
Azzul,teldrassil,1046,evoker,devastation,25,14,11
Рептилойдина,howling-fjord,1030,evoker,devastation,24,11,13
Canitabravar,cthun,1023,evoker,devastation,48,23,25
Pedogos,outland,1016,evoker,devastation,75,31,44
Lugarius,gilneas,986,evoker,devastation,27,13,14
Rhegal,auchindoun,960,evoker,devastation,12,10,2
Juicyjeffe,blackrock,960,evoker,devastation,12,10,2
Spicylizard,stormscale,960,evoker,devastation,18,10,8
Myxker,burning-legion,960,evoker,devastation,24,10,14
Apacstrasza,ragnaros,960,evoker,devastation,24,10,14
Lùñe,hyjal,959,evoker,devastation,12,10,2
Terradòr,die-aldor,959,evoker,devastation,18,10,8
Aegón,uldum,959,evoker,devastation,30,10,20
Eskavoker,kazzak,958,evoker,devastation,18,10,8
Evokimag,grim-batol,958,evoker,devastation,24,10,14
Solandor,kazzak,957,evoker,devastation,18,10,8
Enzospatalo,nemesis,955,evoker,devastation,18,10,8
Danaval,blackhand,955,evoker,devastation,18,10,8
Maccen,twisting-nether,955,evoker,devastation,18,10,8
Grajade,dun-modr,954,evoker,devastation,18,10,8
Cuufizix,silvermoon,952,evoker,devastation,18,10,8
Scalash,drakthul,950,evoker,devastation,36,20,16
Leskano,aegwynn,948,evoker,devastation,24,12,12
Xendrag,silvermoon,947,evoker,devastation,24,10,14
Evosker,zuljin,947,evoker,devastation,30,10,20
Алексатэтсуя,ashenvale,945,evoker,devastation,24,10,14
Scalo,kazzak,935,evoker,devastation,17,10,7
Быковскии,howling-fjord,912,evoker,devastation,48,27,21
Donairian,doomhammer,911,evoker,devastation,54,27,27
Stormydude,doomhammer,907,evoker,devastation,24,13,11
Sleipnyr,garrosh,888,evoker,devastation,60,27,33
Rîncêwind,uldum,882,evoker,devastation,24,12,12
Jelboen,draenor,881,evoker,devastation,16,10,6
Shaze,zuljin,879,evoker,devastation,17,10,7
Crynerf,ravencrest,867,evoker,devastation,66,31,35
Deny,frostmane,864,evoker,devastation,12,9,3
Гневиан,eversong,864,evoker,devastation,12,9,3
Pinacóladaqt,stormscale,864,evoker,devastation,18,9,9
Yimvoker,blackrock,864,evoker,devastation,18,9,9
Kmzi,twisting-nether,864,evoker,devastation,18,9,9
Féféledragon,archimonde,863,evoker,devastation,18,9,9
Рогатыйдебик,gordunni,863,evoker,devastation,18,9,9
Amnevoker,dalaran,863,evoker,devastation,18,9,9
Saragoza,kirin-tor,862,evoker,devastation,18,9,9
Honz,antonidas,862,evoker,devastation,18,9,9
Dschíses,malganis,858,evoker,devastation,18,9,9
Crygon,outland,857,evoker,devastation,18,9,9
Mesmerìze,khaz-modan,857,evoker,devastation,18,9,9
Dragotar,malygos,850,evoker,devastation,46,21,25
Флардикас,gordunni,842,evoker,devastation,24,9,15
Dragonhero,arygos,830,evoker,devastation,36,16,20
Пивнаябошка,soulflayer,768,evoker,devastation,12,8,4
Tsunamì,ysondre,768,evoker,devastation,12,8,4
Gloombloom,emeriss,768,evoker,devastation,12,8,4
Meust,destromath,768,evoker,devastation,18,8,10
Zp,kazzak,768,evoker,devastation,18,8,10
Nekrosdrake,tarren-mill,768,evoker,devastation,18,8,10
Mazakqt,draenor,768,evoker,devastation,18,8,10
Fayral,blackmoore,767,evoker,devastation,12,8,4
Dragonlia,blackrock,767,evoker,devastation,12,8,4
Balerioon,draenor,767,evoker,devastation,12,8,4
Deathwingx,sylvanas,767,evoker,devastation,18,8,10
Zapaflap,silvermoon,767,evoker,devastation,18,8,10
Dragonide,draenor,767,evoker,devastation,18,8,10
Скорукх,gordunni,767,evoker,devastation,18,8,10
Flawxy,blackmoore,766,evoker,devastation,18,8,10
Драгтир,blackscar,764,evoker,devastation,12,8,4
Firebutt,argent-dawn,763,evoker,devastation,12,8,4
Keeqo,silvermoon,762,evoker,devastation,18,8,10
Sethos,dalaran,761,evoker,devastation,24,8,16
Otr,draenor,759,evoker,devastation,24,8,16
Dragônslayer,amanthul,756,evoker,devastation,12,8,4
Drakenballen,ragnaros,755,evoker,devastation,15,8,7
Gonzalo,dun-modr,672,evoker,devastation,12,7,5
Styxev,blackhand,672,evoker,devastation,12,7,5
Эбиб,gordunni,672,evoker,devastation,12,7,5
Crueh,outland,672,evoker,devastation,12,7,5
Flythe,silvermoon,672,evoker,devastation,12,7,5
Sebek,archimonde,672,evoker,devastation,12,7,5
Varagon,rexxar,672,evoker,devastation,12,7,5
Кеннокс,soulflayer,672,evoker,devastation,18,7,11
Bindrasz,ahnqiraj,672,evoker,devastation,18,7,11
Glurakk,aegwynn,672,evoker,devastation,18,7,11
Saintly,kult-der-verdammten,672,evoker,devastation,18,7,11
Släshés,ravencrest,672,evoker,devastation,24,7,17
Tiganj,silvermoon,671,evoker,devastation,12,7,5
Kábutø,antonidas,671,evoker,devastation,12,7,5
Nurilla,twisting-nether,671,evoker,devastation,12,7,5
Evoslaps,norgannon,671,evoker,devastation,12,7,5
Ouaitamaman,draenor,671,evoker,devastation,12,7,5
Woasid,outland,671,evoker,devastation,12,7,5
Stalkhyr,elune,671,evoker,devastation,18,7,11
Enemi,twisting-nether,669,evoker,devastation,14,9,5
Kvothe,malygos,668,evoker,devastation,18,7,11
Fruhans,tarren-mill,667,evoker,devastation,12,7,5
Vucashi,blackhand,665,evoker,devastation,18,7,11
Draknil,ysondre,640,evoker,devastation,16,7,9
Zharas,nemesis,623,evoker,devastation,11,7,4
Morsan,tichondrius,619,evoker,devastation,11,7,4
Minikuja,culte-de-la-rive-noire,612,evoker,devastation,24,7,17
Dovakin,arathi,601,evoker,devastation,14,7,7
Lago,gorgonnash,588,evoker,devastation,13,7,6
Zpartadraga,ragnaros,584,evoker,devastation,9,8,1
Henmon,defias-brotherhood,576,evoker,devastation,6,6,0
Xendragon,kazzak,576,evoker,devastation,12,6,6
Dracalos,silvermoon,576,evoker,devastation,12,6,6
Phanex,bloodhoof,576,evoker,devastation,12,6,6
Krazuntus,argent-dawn,576,evoker,devastation,12,6,6
Scathethrel,draenor,576,evoker,devastation,12,6,6
Khimari,xavius,576,evoker,devastation,12,6,6
Фаламэйн,soulflayer,576,evoker,devastation,12,6,6
Puffdaddyxd,twisting-nether,576,evoker,devastation,12,6,6
Terrorclaw,ragnaros,576,evoker,devastation,12,6,6
Mattyastrasz,hyjal,576,evoker,devastation,12,6,6
Haltorr,ravencrest,576,evoker,devastation,18,6,12
Lifestrasza,drakthul,575,evoker,devastation,6,6,0
Chuckyy,archimonde,575,evoker,devastation,12,6,6
Chunlooi,baelgun,575,evoker,devastation,12,6,6
Meyowuo,doomhammer,575,evoker,devastation,14,6,8
Copíum,silvermoon,575,evoker,devastation,18,6,12
Snitties,tarren-mill,575,evoker,devastation,18,6,12
Mazzg,blackmoore,574,evoker,devastation,21,7,14
Morph,talnivarr,574,evoker,devastation,18,6,12
Firaxis,kazzak,573,evoker,devastation,12,6,6
Аверьятор,fordragon,573,evoker,devastation,12,6,6
Xatures,twisting-nether,572,evoker,devastation,6,6,0
Thebabayag,kazzak,568,evoker,devastation,12,6,6
Ryújín,blackhand,527,evoker,devastation,17,6,11
Ashlàr,earthen-ring,525,evoker,devastation,15,6,9
Rise,tarren-mill,522,evoker,devastation,12,7,5
Hornytail,doomhammer,480,evoker,devastation,6,5,1
Tovaro,xavius,480,evoker,devastation,6,5,1
Jinthyr,anachronos,480,evoker,devastation,6,5,1
Tooltipshow,ragnaros,480,evoker,devastation,6,5,1
Kirinde,draenor,480,evoker,devastation,6,5,1
Nyedrak,kilrogg,480,evoker,devastation,6,5,1
Drackial,zuljin,480,evoker,devastation,6,5,1
Spyro,bloodfeather,480,evoker,devastation,12,5,7
Pandagos,archimonde,480,evoker,devastation,12,5,7
Abehethan,archimonde,480,evoker,devastation,12,5,7
Predictrash,archimonde,480,evoker,devastation,12,5,7
Леерустан,howling-fjord,480,evoker,devastation,12,5,7
Loveheart,die-aldor,480,evoker,devastation,12,5,7
Pavelito,ysondre,480,evoker,devastation,12,5,7
Burnrate,draenor,480,evoker,devastation,12,5,7
Raagnar,kazzak,480,evoker,devastation,12,5,7
Dracnass,silvermoon,480,evoker,devastation,12,5,7
Kda,die-nachtwache,480,evoker,devastation,12,5,7
Sloeez,kazzak,480,evoker,devastation,18,5,13
Mallor,kirin-tor,479,evoker,devastation,6,5,1
Ignisaureus,silvermoon,479,evoker,devastation,12,5,7
Dragis,die-aldor,479,evoker,devastation,12,5,7
Vermithors,ravencrest,479,evoker,devastation,12,5,7
Oeos,dragonblight,478,evoker,devastation,24,5,19
Vanima,forscherliga,477,evoker,devastation,6,5,1
Acedragniir,khaz-modan,473,evoker,devastation,12,5,7
Julerion,draenor,472,evoker,devastation,12,5,7
Elitedraach,tarren-mill,463,evoker,devastation,11,5,6
Voklath,kazzak,432,evoker,devastation,15,5,10
Scalewind,twisting-nether,384,evoker,devastation,6,4,2
Billyhassan,stormscale,384,evoker,devastation,6,4,2
Theralon,tarren-mill,384,evoker,devastation,6,4,2
Advancedboy,archimonde,384,evoker,devastation,6,4,2
Штеци,howling-fjord,384,evoker,devastation,6,4,2
Delorraine,burning-legion,384,evoker,devastation,6,4,2
Wurm,shadowsong,384,evoker,devastation,6,4,2
Zyevoker,silvermoon,384,evoker,devastation,6,4,2
Nochance,dentarg,384,evoker,devastation,6,4,2
Skiora,argent-dawn,384,evoker,devastation,6,4,2
Luu,the-maelstrom,384,evoker,devastation,6,4,2
Deathdream,stormscale,384,evoker,devastation,6,4,2
Molem,defias-brotherhood,384,evoker,devastation,6,4,2
Dragorus,stormscale,384,evoker,devastation,6,4,2
Karistrasza,sylvanas,384,evoker,devastation,6,4,2
Smegma,norgannon,384,evoker,devastation,6,4,2
Iblvicanfly,stormscale,384,evoker,devastation,6,4,2
Beeragos,deathwing,384,evoker,devastation,6,4,2
Spyróò,ravencrest,384,evoker,devastation,12,4,8
Nynnaydoth,drakthul,384,evoker,devastation,12,4,8
Croker,ravencrest,384,evoker,devastation,12,4,8
Lilvorki,silvermoon,384,evoker,devastation,12,4,8
Дракарус,soulflayer,384,evoker,devastation,12,4,8
Лавеон,gordunni,384,evoker,devastation,12,4,8
Dracofeuxd,archimonde,384,evoker,devastation,12,4,8
Bæxo,blackrock,384,evoker,devastation,18,4,14
Jamesdouglas,eredar,383,evoker,devastation,6,4,2
Hekatonshire,hyjal,383,evoker,devastation,6,4,2
Bombrush,ragnaros,383,evoker,devastation,9,5,4
Flameclaw,argent-dawn,382,evoker,devastation,6,4,2
Kayizer,archimonde,382,evoker,devastation,6,4,2
Calonddraig,turalyon,382,evoker,devastation,6,4,2
Мизурион,gordunni,382,evoker,devastation,6,4,2
Davioncz,thunderhorn,382,evoker,devastation,6,4,2
Sheego,anetheron,382,evoker,devastation,6,4,2
Dracsamdi,tarren-mill,367,evoker,devastation,11,4,7
Belkavoker,zirkel-des-cenarius,319,evoker,devastation,5,4,1
Somntersu,argent-dawn,319,evoker,devastation,5,4,1
Эндемический,soulflayer,288,evoker,devastation,6,3,3
Nørgan,die-aldor,288,evoker,devastation,6,3,3
Mollÿ,sanguino,288,evoker,devastation,6,3,3
Paizz,tarren-mill,288,evoker,devastation,6,3,3
Geckonen,stormreaver,288,evoker,devastation,6,3,3
Тектрис,howling-fjord,288,evoker,devastation,6,3,3
Ralfferion,auchindoun,288,evoker,devastation,6,3,3
Malowux,outland,288,evoker,devastation,6,3,3
Ðragøn,argent-dawn,288,evoker,devastation,6,3,3
Nózdormuwu,argent-dawn,288,evoker,devastation,6,3,3
Darthagos,outland,288,evoker,devastation,6,3,3
Jrmdragik,kaelthas,288,evoker,devastation,6,3,3
Lajra,ragnaros,288,evoker,devastation,6,3,3
Flippmoker,argent-dawn,288,evoker,devastation,6,3,3
Ughvoker,kazzak,288,evoker,devastation,6,3,3
Драккалис,eversong,288,evoker,devastation,6,3,3
Jaykvoker,kazzak,288,evoker,devastation,6,3,3
Ripgódx,bronzebeard,288,evoker,devastation,6,3,3
Adônis,malorne,288,evoker,devastation,6,3,3
Azurog,blackmoore,288,evoker,devastation,6,3,3
Feinerkerl,blackmoore,288,evoker,devastation,6,3,3
Mirazare,khadgar,288,evoker,devastation,6,3,3
Навидх,howling-fjord,288,evoker,devastation,6,3,3
Whaazzdragon,tarren-mill,288,evoker,devastation,6,3,3
Fivebeers,silvermoon,288,evoker,devastation,6,3,3
Dalsath,silvermoon,288,evoker,devastation,6,3,3
Drachenwut,aegwynn,288,evoker,devastation,6,3,3
Zettaflare,nazjatar,288,evoker,devastation,6,3,3
Nerfmeplze,outland,288,evoker,devastation,6,3,3
Dracofion,ravencrest,288,evoker,devastation,6,3,3
Merqury,ravencrest,288,evoker,devastation,6,3,3
Feldrac,ravencrest,288,evoker,devastation,6,3,3
Shindragøsa,ysondre,288,evoker,devastation,6,3,3
Azustraza,ysondre,288,evoker,devastation,6,3,3
Hateroll,ravencrest,288,evoker,devastation,6,3,3
Valdrakken,anubarak,288,evoker,devastation,12,3,9
Kirien,blackhand,288,evoker,devastation,12,3,9
Hästdrake,the-maelstrom,288,evoker,devastation,12,3,9
Rhel,the-maelstrom,288,evoker,devastation,12,3,9
Tamargon,frostwhisper,288,evoker,devastation,12,3,9
Belianf,silvermoon,287,evoker,devastation,6,3,3
Ewoky,ravencrest,287,evoker,devastation,6,3,3
Sliimshady,dalaran,287,evoker,devastation,6,3,3
Shenrøn,garona,287,evoker,devastation,6,3,3
Drks,draenor,287,evoker,devastation,12,4,8
Sivaas,arathi,286,evoker,devastation,6,3,3
Филлид,gordunni,255,evoker,devastation,8,4,4
Серцедраконн,gordunni,240,evoker,devastation,9,3,6
Färsia,drakthul,223,evoker,devastation,8,3,5
Vynestria,argent-dawn,192,evoker,devastation,6,2,4
Kandragor,antonidas,192,evoker,devastation,6,2,4
Lelemion,arathor,192,evoker,devastation,6,2,4
Norskairline,kazzak,192,evoker,devastation,6,2,4
Reddeaddrago,silvermoon,192,evoker,devastation,6,2,4
Митокада,soulflayer,192,evoker,devastation,6,2,4
Chürbis,blackmoore,192,evoker,devastation,6,2,4
Fueu,draenor,192,evoker,devastation,6,2,4
Skulblakas,blackmoore,192,evoker,devastation,6,2,4
Twokgbananas,blackhand,192,evoker,devastation,6,2,4
Exitelolx,blackrock,192,evoker,devastation,6,2,4
Draconz,stormrage,192,evoker,devastation,6,2,4
Oogabuga,outland,192,evoker,devastation,6,2,4
Draaxy,twisting-nether,192,evoker,devastation,6,2,4
Bittewhyally,grim-batol,192,evoker,devastation,6,2,4
Wuiflyta,dun-modr,192,evoker,devastation,6,2,4
Bal,arakarahm,192,evoker,devastation,6,2,4
Adamâs,archimonde,192,evoker,devastation,6,2,4
Niluslangbal,stormscale,192,evoker,devastation,6,2,4
Ellphi,illidan,192,evoker,devastation,6,2,4
Raøug,blackmoore,192,evoker,devastation,6,2,4
Kroqmoo,drekthar,192,evoker,devastation,7,2,5
Nybxx,frostmane,192,evoker,devastation,12,2,10
Дракомант,eversong,192,evoker,devastation,12,2,10
Andragosa,confrérie-du-thorium,192,evoker,devastation,12,2,10
Jacra,twisting-nether,192,evoker,devastation,12,2,10
Erenhan,archimonde,192,evoker,devastation,12,2,10
Tenkenfutsu,elune,192,evoker,devastation,18,2,16
Kraakraa,turalyon,191,evoker,devastation,6,2,4
Deimong,khaz-modan,191,evoker,devastation,6,2,4
Drakridarn,kazzak,159,evoker,devastation,5,2,3
Вжухкия,gordunni,159,evoker,devastation,5,2,3
Gypsydrake,tarren-mill,159,evoker,devastation,8,3,5
Эллъис,gordunni,144,evoker,devastation,21,2,19
Tremola,twisting-nether,128,evoker,devastation,4,2,2
Tneen,stormscale,96,evoker,devastation,3,2,1
Rufistraz,burning-legion,96,evoker,devastation,3,2,1
Juhadormu,stormreaver,96,evoker,devastation,6,1,5
Terrorwings,twisting-nether,96,evoker,devastation,6,1,5
Devanthar,argent-dawn,96,evoker,devastation,6,1,5
Suba,tarren-mill,96,evoker,devastation,6,1,5
Skyfire,stormscale,96,evoker,devastation,6,1,5
Lubyan,pozzo-delleternità,96,evoker,devastation,6,1,5
Asharys,argent-dawn,96,evoker,devastation,6,1,5
Jetfqds,archimonde,96,evoker,devastation,6,1,5
Ominobari,silvermoon,96,evoker,devastation,6,1,5
Czerwonooki,turalyon,96,evoker,devastation,6,1,5
Мельхиор,booty-bay,96,evoker,devastation,6,1,5
Zørix,hyjal,96,evoker,devastation,6,1,5
Jpeo,blackhand,96,evoker,devastation,6,1,5
Dracarysfire,kazzak,96,evoker,devastation,6,1,5
Retyss,twisting-nether,96,evoker,devastation,6,1,5
Holdya,archimonde,96,evoker,devastation,6,1,5
Oldlizard,blackrock,96,evoker,devastation,6,1,5
Eosin,blackrock,96,evoker,devastation,6,1,5
Lurkî,blackhand,96,evoker,devastation,6,1,5
Ronmanarmy,blackrock,96,evoker,devastation,6,1,5
Spioche,burning-legion,96,evoker,devastation,12,1,11
Setur,outland,96,evoker,devastation,12,1,11
Xidalulz,sylvanas,63,evoker,devastation,2,2,0
Bulydracguir,kazzak,42,evoker,devastation,7,2,5
Âspên,archimonde,31,evoker,devastation,2,1,1
Stavfel,kazzak,2037,hunter,marksmanship,89,49,40
Pjållistani,ravencrest,2014,hunter,marksmanship,113,64,49
Olyleskotch,ravencrest,1983,hunter,marksmanship,60,31,29
Matasso,burning-legion,1981,hunter,marksmanship,131,67,64
Nennimi,ravencrest,1978,hunter,marksmanship,87,44,43
Alêx,outland,1973,hunter,marksmanship,114,58,56
Yasuohasagi,archimonde,1967,hunter,marksmanship,60,30,30
Drxta,blackrock,1937,hunter,marksmanship,72,36,36
Yezzu,sylvanas,1936,hunter,marksmanship,68,34,34
Wruck,echsenkessel,1933,hunter,marksmanship,84,50,34
Мартидэн,howling-fjord,1918,hunter,marksmanship,143,69,74
Huprah,ravencrest,1901,hunter,marksmanship,126,63,63
Душнила,razuvious,1898,hunter,marksmanship,83,44,39
Evacuatur,argent-dawn,1826,hunter,marksmanship,66,33,33
Wildheárt,aegwynn,1824,hunter,marksmanship,66,35,31
Ancalarion,tarren-mill,1824,hunter,marksmanship,54,26,28
Buffrøgues,ravencrest,1817,hunter,marksmanship,85,46,39
Hï,eitrigg,1817,hunter,marksmanship,66,32,34
Techpoint,silvermoon,1816,hunter,marksmanship,42,27,15
Crôwley,twisting-nether,1816,hunter,marksmanship,54,30,24
Xoarqt,aegwynn,1812,hunter,marksmanship,72,32,40
Áñmy,ravencrest,1804,hunter,marksmanship,53,28,25
Mogwai,stormscale,1801,hunter,marksmanship,59,29,30
Myice,twisting-nether,1771,hunter,marksmanship,66,36,30
Huntsmart,kazzak,1769,hunter,marksmanship,66,31,35
Murtagh,khaz-modan,1767,hunter,marksmanship,66,35,31
Ceitronox,argent-dawn,1765,hunter,marksmanship,42,23,19
Scheixanter,drakthul,1753,hunter,marksmanship,130,66,64
Johnreapèr,sylvanas,1751,hunter,marksmanship,71,33,38
Aimywinehaus,drakthul,1732,hunter,marksmanship,48,24,24
Passalaqua,aegwynn,1729,hunter,marksmanship,54,32,22
Trashcarlito,eredar,1725,hunter,marksmanship,36,23,13
Onlystuns,sylvanas,1720,hunter,marksmanship,47,22,25
Hallé,frostmane,1714,hunter,marksmanship,78,43,35
Strikke,archimonde,1709,hunter,marksmanship,42,18,24
Bestregards,ravencrest,1708,hunter,marksmanship,77,32,45
Huntrag,tarren-mill,1698,hunter,marksmanship,163,80,83
Xanter,blackrock,1698,hunter,marksmanship,62,29,33
Setyouintrap,ravencrest,1690,hunter,marksmanship,30,19,11
Skilachi,stormscale,1684,hunter,marksmanship,48,21,27
Lowcaskor,turalyon,1678,hunter,marksmanship,47,26,21
Velrox,blackmoore,1674,hunter,marksmanship,60,30,30
Lenooby,blades-edge,1672,hunter,marksmanship,42,24,18
Bearmane,tarren-mill,1670,hunter,marksmanship,82,42,40
Jabela,eredar,1668,hunter,marksmanship,78,35,43
Triggaz,stormscale,1661,hunter,marksmanship,67,32,35
Eldrekou,kazzak,1657,hunter,marksmanship,48,22,26
Podroto,tyrande,1654,hunter,marksmanship,41,18,23
Murkek,drakthul,1653,hunter,marksmanship,42,26,16
Misstrap,drakthul,1652,hunter,marksmanship,35,22,13
Адвентурер,howling-fjord,1652,hunter,marksmanship,96,53,43
Speedhack,argent-dawn,1650,hunter,marksmanship,63,35,28
Xqzmytrapz,blackrock,1650,hunter,marksmanship,36,18,18
Dragnial,kazzak,1649,hunter,marksmanship,47,22,25
Травок,gordunni,1648,hunter,marksmanship,58,32,26
Лотариель,howling-fjord,1645,hunter,marksmanship,48,24,24
Ремонтлицаа,gordunni,1642,hunter,marksmanship,85,49,36
Amistat,kazzak,1642,hunter,marksmanship,72,33,39
Evengance,dragonblight,1637,hunter,marksmanship,54,38,16
Dexter,ravencrest,1634,hunter,marksmanship,107,49,58
Naid,lordaeron,1632,hunter,marksmanship,36,20,16
Куфачка,soulflayer,1627,hunter,marksmanship,36,17,19
Килофвратх,gordunni,1624,hunter,marksmanship,66,32,34
Nidaliyae,archimonde,1624,hunter,marksmanship,42,20,22
Natchell,ysondre,1623,hunter,marksmanship,48,22,26
Ледо,deathguard,1621,hunter,marksmanship,42,19,23
Khregan,aerie-peak,1612,hunter,marksmanship,36,17,19
Mógwaí,stormscale,1611,hunter,marksmanship,36,21,15
Дарктеххно,howling-fjord,1611,hunter,marksmanship,30,17,13
Inayah,outland,1606,hunter,marksmanship,103,57,46
Streetxpres,nethersturm,1602,hunter,marksmanship,35,19,16
Gugenot,tarren-mill,1589,hunter,marksmanship,56,33,23
Desudi,tarren-mill,1588,hunter,marksmanship,59,30,29
Крой,howling-fjord,1588,hunter,marksmanship,71,34,37
Recrent,kazzak,1582,hunter,marksmanship,96,53,43
Yarnvid,twisting-nether,1572,hunter,marksmanship,105,56,49
Chaussons,kazzak,1570,hunter,marksmanship,78,42,36
Lebalaffré,arathi,1562,hunter,marksmanship,77,41,36
Лисатия,gordunni,1562,hunter,marksmanship,48,22,26
Мизэрица,soulflayer,1556,hunter,marksmanship,66,32,34
Swïtchz,hyjal,1555,hunter,marksmanship,57,31,26
Jetay,silvermoon,1555,hunter,marksmanship,42,22,20
Mantinell,hellfire,1553,hunter,marksmanship,36,20,16
Nätzz,dun-modr,1545,hunter,marksmanship,37,18,19
Миссклик,soulflayer,1544,hunter,marksmanship,54,33,21
Mînérvá,blackhand,1530,hunter,marksmanship,60,38,22
Jamzyhunter,emerald-dream,1530,hunter,marksmanship,42,17,25
Miladinorc,azjolnerub,1524,hunter,marksmanship,42,26,16
Àfpro,hyjal,1515,hunter,marksmanship,40,20,20
Çryneth,ravencrest,1513,hunter,marksmanship,56,28,28
Eferos,quelthalas,1513,hunter,marksmanship,60,26,34
Souljâh,ravencrest,1511,hunter,marksmanship,35,20,15
Lobos,ravencrest,1509,hunter,marksmanship,42,21,21
Kariss,khaz-modan,1507,hunter,marksmanship,138,68,70
Jup,elune,1507,hunter,marksmanship,49,17,32
Elja,laughing-skull,1506,hunter,marksmanship,36,21,15
Surtfire,alonsus,1500,hunter,marksmanship,54,28,26
Rattentäter,alexstrasza,1498,hunter,marksmanship,54,28,26
Daela,elune,1492,hunter,marksmanship,54,22,32
Minisay,magtheridon,1491,hunter,marksmanship,202,98,104
Vangeroth,kazzak,1489,hunter,marksmanship,186,96,90
Аскентр,gordunni,1484,hunter,marksmanship,43,21,22
Vavabxl,ysondre,1483,hunter,marksmanship,78,39,39
Афигеннски,ashenvale,1473,hunter,marksmanship,66,31,35
Хальвеген,gordunni,1471,hunter,marksmanship,141,69,72
Дисконнэктор,soulflayer,1467,hunter,marksmanship,72,27,45
Nanns,silvermoon,1461,hunter,marksmanship,47,24,23
Вееном,gordunni,1455,hunter,marksmanship,36,16,20
Rex,chamber-of-aspects,1454,hunter,marksmanship,39,23,16
Autoturret,eredar,1454,hunter,marksmanship,48,24,24
Короткиствол,gordunni,1452,hunter,marksmanship,42,18,24
Mizumo,burning-legion,1449,hunter,marksmanship,97,57,40
Ashimaru,sylvanas,1449,hunter,marksmanship,51,26,25
Bollo,malganis,1449,hunter,marksmanship,61,29,32
Meinkoenig,frostwolf,1448,hunter,marksmanship,48,30,18
Будкусломаю,grom,1447,hunter,marksmanship,77,35,42
Bapt,blackrock,1447,hunter,marksmanship,42,17,25
Hunsed,sanguino,1445,hunter,marksmanship,42,26,16
Balamut,aegwynn,1445,hunter,marksmanship,83,45,38
Asthorio,stormscale,1442,hunter,marksmanship,83,36,47
Джоуе,ashenvale,1437,hunter,marksmanship,30,15,15
Luuszapfae,aegwynn,1436,hunter,marksmanship,29,16,13
Nagu,antonidas,1435,hunter,marksmanship,30,15,15
Skillzone,silvermoon,1432,hunter,marksmanship,36,15,21
Tntabsotrap,silvermoon,1431,hunter,marksmanship,70,37,33
Pickaboo,defias-brotherhood,1431,hunter,marksmanship,168,82,86
Tupalax,outland,1428,hunter,marksmanship,40,19,21
Длинноемоджо,soulflayer,1424,hunter,marksmanship,151,70,81
Summa,silvermoon,1424,hunter,marksmanship,60,27,33
Kalima,malfurion,1416,hunter,marksmanship,72,28,44
Mindgap,pozzo-delleternità,1415,hunter,marksmanship,80,38,42
Firescorpion,onyxia,1414,hunter,marksmanship,30,19,11
Darts,outland,1414,hunter,marksmanship,30,15,15
Keskolica,outland,1414,hunter,marksmanship,36,17,19
Elonyr,sanguino,1411,hunter,marksmanship,196,90,106
Xalaar,frostwolf,1405,hunter,marksmanship,44,26,18
Åíøñs,kazzak,1405,hunter,marksmanship,29,15,14
Shootingbob,blackrock,1404,hunter,marksmanship,30,17,13
Hiðe,archimonde,1399,hunter,marksmanship,56,28,28
Darm,sunstrider,1398,hunter,marksmanship,36,15,21
Meskette,ravencrest,1396,hunter,marksmanship,24,15,9
Шимэйла,gordunni,1390,hunter,marksmanship,61,30,31
Carpante,nemesis,1385,hunter,marksmanship,66,29,37
Gilgharsh,rajaxx,1380,hunter,marksmanship,42,20,22
Bøøgy,silvermoon,1376,hunter,marksmanship,104,55,49
Lincolne,ravencrest,1375,hunter,marksmanship,41,17,24
Stingarrow,stormscale,1374,hunter,marksmanship,42,24,18
Zelira,boulderfist,1368,hunter,marksmanship,40,19,21
Doncar,stormscale,1367,hunter,marksmanship,81,35,46
Mmaaee,ravencrest,1365,hunter,marksmanship,58,33,25
Iòvól,azuremyst,1364,hunter,marksmanship,60,33,27
Absolutnoob,blackrock,1362,hunter,marksmanship,38,21,17
Slmao,tarren-mill,1357,hunter,marksmanship,60,27,33
Ensomnia,silvermoon,1354,hunter,marksmanship,18,15,3
Szybky,defias-brotherhood,1354,hunter,marksmanship,60,25,35
Оленнька,howling-fjord,1349,hunter,marksmanship,36,21,15
Cenaa,ragnaros,1343,hunter,marksmanship,19,14,5
Gromaya,elune,1342,hunter,marksmanship,47,23,24
Аккулэйд,blackscar,1340,hunter,marksmanship,36,14,22
Encore,sylvanas,1334,hunter,marksmanship,48,23,25
Rzeezznik,burning-legion,1333,hunter,marksmanship,24,14,10
Aimnfire,anachronos,1333,hunter,marksmanship,40,20,20
Røxxilia,blackmoore,1333,hunter,marksmanship,54,23,31
Moschtix,forscherliga,1333,hunter,marksmanship,48,20,28
Gunlaugr,defias-brotherhood,1331,hunter,marksmanship,27,14,13
Deadfire,hyjal,1325,hunter,marksmanship,42,20,22
Diapositiv,draenor,1325,hunter,marksmanship,30,14,16
Maroxy,ragnaros,1325,hunter,marksmanship,35,14,21
Selaesa,chamber-of-aspects,1321,hunter,marksmanship,45,22,23
Amphi,stormscale,1320,hunter,marksmanship,66,36,30
Zirgoo,outland,1320,hunter,marksmanship,66,28,38
Glad,argent-dawn,1320,hunter,marksmanship,77,32,45
Амореселф,gordunni,1317,hunter,marksmanship,35,14,21
Smitheye,argent-dawn,1314,hunter,marksmanship,129,63,66
Narawinger,silvermoon,1310,hunter,marksmanship,36,21,15
Arrowdoxx,silvermoon,1310,hunter,marksmanship,117,51,66
Boomkillshot,zuljin,1306,hunter,marksmanship,56,32,24
Prodanhunts,frostmane,1306,hunter,marksmanship,60,28,32
Høward,aegwynn,1300,hunter,marksmanship,36,20,16
Samhunt,blackrock,1299,hunter,marksmanship,29,14,15
Yoúmad,draenor,1288,hunter,marksmanship,28,14,14
Kyudo,ravencrest,1286,hunter,marksmanship,35,15,20
Rabiate,blackrock,1284,hunter,marksmanship,34,16,18
Bigfoot,argent-dawn,1283,hunter,marksmanship,90,40,50
Fauda,hellscream,1277,hunter,marksmanship,30,15,15
Doomhorg,quelthalas,1276,hunter,marksmanship,60,30,30
Poatan,outland,1268,hunter,marksmanship,128,68,60
Ekz,twisting-nether,1267,hunter,marksmanship,28,14,14
Хантвкроксах,gordunni,1257,hunter,marksmanship,22,14,8
Феорика,grom,1257,hunter,marksmanship,66,33,33
Booms,eonar,1254,hunter,marksmanship,65,31,34
Kravên,anubarak,1251,hunter,marksmanship,45,17,28
Mönster,ravenholdt,1248,hunter,marksmanship,27,14,13
Одисенс,eversong,1248,hunter,marksmanship,103,53,50
Hardscoped,tarren-mill,1247,hunter,marksmanship,34,14,20
Iilac,argent-dawn,1242,hunter,marksmanship,184,104,80
Sindorian,aggra-português,1242,hunter,marksmanship,24,13,11
Sizemattersx,kazzak,1241,hunter,marksmanship,32,13,19
Barnabaz,skullcrusher,1238,hunter,marksmanship,24,13,11
Silvyina,todeswache,1236,hunter,marksmanship,28,14,14
Shedzargo,twisting-nether,1234,hunter,marksmanship,24,13,11
Fränko,ravencrest,1234,hunter,marksmanship,30,13,17
Ронингуд,gordunni,1233,hunter,marksmanship,24,13,11
Ксидре,eversong,1231,hunter,marksmanship,30,15,15
Mainblu,nemesis,1231,hunter,marksmanship,30,14,16
Xesih,twisting-nether,1228,hunter,marksmanship,53,23,30
Babclaar,culte-de-la-rive-noire,1227,hunter,marksmanship,18,13,5
Sivoh,silvermoon,1227,hunter,marksmanship,50,23,27
Loretta,ragnaros,1225,hunter,marksmanship,23,13,10
Rmnsbm,blackmoore,1224,hunter,marksmanship,24,13,11
Travels,tarren-mill,1222,hunter,marksmanship,30,13,17
Adariana,archimonde,1220,hunter,marksmanship,30,13,17
Redneckjoe,draenor,1219,hunter,marksmanship,41,18,23
Bgkrasavec,stormscale,1214,hunter,marksmanship,35,19,16
Арийская,gordunni,1213,hunter,marksmanship,41,17,24
Elyxa,ysondre,1211,hunter,marksmanship,54,30,24
Vïcødïnë,sinstralis,1205,hunter,marksmanship,42,17,25
Arize,quelthalas,1204,hunter,marksmanship,67,32,35
Jeston,amanthul,1202,hunter,marksmanship,31,14,17
Skohal,draenor,1200,hunter,marksmanship,78,36,42
Blowplac,moonglade,1198,hunter,marksmanship,40,16,24
Watty,chogall,1195,hunter,marksmanship,88,45,43
Скартэкс,howling-fjord,1191,hunter,marksmanship,20,14,6
Touscahunter,kazzak,1188,hunter,marksmanship,264,133,131
Féliché,elune,1188,hunter,marksmanship,72,27,45
Blackas,dun-modr,1180,hunter,marksmanship,48,21,27
Naven,minahonda,1170,hunter,marksmanship,36,15,21
Zirilan,nemesis,1163,hunter,marksmanship,28,13,15
Breier,argent-dawn,1158,hunter,marksmanship,42,20,22
Sâetha,dun-modr,1157,hunter,marksmanship,36,14,22
Celtya,archimonde,1155,hunter,marksmanship,48,26,22
Jodd,ragnaros,1152,hunter,marksmanship,24,12,12
Eenel,twisting-nether,1148,hunter,marksmanship,24,12,12
Farmerjoee,alakir,1147,hunter,marksmanship,24,13,11
Каизик,soulflayer,1146,hunter,marksmanship,29,13,16
Kendow,blackrock,1146,hunter,marksmanship,55,24,31
Роктджана,deathguard,1143,hunter,marksmanship,24,12,12
Smekminbåge,tarren-mill,1142,hunter,marksmanship,30,12,18
Voitelka,terokkar,1141,hunter,marksmanship,62,32,30
Mántîs,argent-dawn,1138,hunter,marksmanship,31,15,16
Хапмьюзик,howling-fjord,1138,hunter,marksmanship,42,13,29
Дайпострелят,gordunni,1127,hunter,marksmanship,30,12,18
Cooroona,stormrage,1119,hunter,marksmanship,24,12,12
Serihu,cthun,1119,hunter,marksmanship,36,12,24
Kakadoo,twisting-nether,1110,hunter,marksmanship,24,12,12
Hollabackgrl,outland,1105,hunter,marksmanship,42,18,24
Swáy,twisting-nether,1100,hunter,marksmanship,214,100,114
Анхантэй,lich-king,1092,hunter,marksmanship,136,69,67
Overhït,hyjal,1090,hunter,marksmanship,77,34,43
Сандабар,borean-tundra,1083,hunter,marksmanship,35,18,17
Robìnhood,nemesis,1080,hunter,marksmanship,36,19,17
Хакаар,grom,1080,hunter,marksmanship,42,18,24
Thelasiel,aerie-peak,1079,hunter,marksmanship,67,33,34
Лорбан,gordunni,1078,hunter,marksmanship,26,13,13
Bendit,eredar,1076,hunter,marksmanship,42,20,22
Narøs,blackhand,1076,hunter,marksmanship,76,31,45
Еввнух,gordunni,1067,hunter,marksmanship,25,12,13
Lillynahh,argent-dawn,1066,hunter,marksmanship,92,38,54
Opsi,area-52,1066,hunter,marksmanship,32,12,20
Jisila,ravencrest,1060,hunter,marksmanship,33,16,17
Tinlop,ragnaros,1058,hunter,marksmanship,72,29,43
Epheso,daggerspine,1055,hunter,marksmanship,18,11,7
Suchskill,stormreaver,1055,hunter,marksmanship,24,11,13
Iceyx,stormscale,1055,hunter,marksmanship,30,11,19
Dentaar,draenor,1054,hunter,marksmanship,83,40,43
Artémíss,kazzak,1050,hunter,marksmanship,24,11,13
Kbesagrillo,sanguino,1050,hunter,marksmanship,24,11,13
Lennylynx,garrosh,1049,hunter,marksmanship,24,11,13
Эльк,gordunni,1048,hunter,marksmanship,18,11,7
Слезыотлука,howling-fjord,1048,hunter,marksmanship,18,11,7
Zendar,blackmoore,1047,hunter,marksmanship,33,12,21
Ønske,azjolnerub,1045,hunter,marksmanship,24,11,13
Sisilianno,khaz-modan,1045,hunter,marksmanship,70,27,43
Blacksyo,elune,1042,hunter,marksmanship,27,11,16
Винтаж,deepholm,1041,hunter,marksmanship,59,26,33
Cêdric,alleria,1041,hunter,marksmanship,28,12,16
Madtony,aegwynn,1029,hunter,marksmanship,24,11,13
Hoody,culte-de-la-rive-noire,1027,hunter,marksmanship,25,13,12
Neosmoke,shadowsong,1026,hunter,marksmanship,30,11,19
Crní,tarren-mill,1024,hunter,marksmanship,18,11,7
Naghtel,die-silberne-hand,1024,hunter,marksmanship,18,11,7
Fetts,silvermoon,1023,hunter,marksmanship,24,11,13
Slicer,arthas,1023,hunter,marksmanship,73,31,42
Lonewolfe,ravencrest,1021,hunter,marksmanship,90,39,51
Noobatala,tarren-mill,1018,hunter,marksmanship,36,17,19
Tránsphobic,kilrogg,1017,hunter,marksmanship,24,11,13
Tungusta,defias-brotherhood,1006,hunter,marksmanship,42,19,23
Nutzz,ragnaros,1006,hunter,marksmanship,41,15,26
Брухлянка,gordunni,1003,hunter,marksmanship,24,12,12
Ispo,frostwolf,999,hunter,marksmanship,58,25,33
Ayshæ,tarren-mill,994,hunter,marksmanship,23,14,9
Jaýlah,draenor,991,hunter,marksmanship,54,24,30
Bonquiesha,tarren-mill,991,hunter,marksmanship,25,11,14
Lookmyezzy,ravencrest,990,hunter,marksmanship,20,11,9
Bélier,hyjal,986,hunter,marksmanship,30,14,16
Ártemide,pozzo-delleternità,975,hunter,marksmanship,33,15,18
Oatmeal,dun-morogh,974,hunter,marksmanship,50,22,28
Talcaliste,archimonde,964,hunter,marksmanship,38,14,24
Tomtus,aggramar,961,hunter,marksmanship,49,24,25
Nyxìa,shattered-halls,960,hunter,marksmanship,18,10,8
Vanstro,ragnaros,960,hunter,marksmanship,18,10,8
Квит,blackscar,960,hunter,marksmanship,24,10,14
Velites,aggra-português,959,hunter,marksmanship,18,10,8
Тамирка,deathguard,958,hunter,marksmanship,12,10,2
Metalbaci,sylvanas,958,hunter,marksmanship,18,10,8
Yelanna,argent-dawn,957,hunter,marksmanship,18,10,8
Agarez,blackrock,957,hunter,marksmanship,24,12,12
Zlejkadlec,burning-blade,957,hunter,marksmanship,24,10,14
Huntazt,draenor,956,hunter,marksmanship,18,10,8
Tiidus,burning-legion,955,hunter,marksmanship,18,10,8
Bobleearrow,darkspear,955,hunter,marksmanship,18,10,8
Johnydep,silvermoon,955,hunter,marksmanship,30,10,20
Setis,uldaman,955,hunter,marksmanship,36,10,26
Фузег,deathguard,953,hunter,marksmanship,18,10,8
Taveon,turalyon,953,hunter,marksmanship,18,10,8
Rediction,ravencrest,953,hunter,marksmanship,24,10,14
Phillon,blackrock,949,hunter,marksmanship,12,10,2
Aaryel,outland,948,hunter,marksmanship,18,10,8
Azaella,tarren-mill,948,hunter,marksmanship,18,10,8
Yanger,burning-legion,946,hunter,marksmanship,30,10,20
Freezyshinkn,blackrock,945,hunter,marksmanship,18,11,7
Mhood,dun-morogh,945,hunter,marksmanship,36,18,18
Ililivillumi,tarren-mill,945,hunter,marksmanship,24,10,14
Survivr,frostmane,937,hunter,marksmanship,18,10,8
Thauana,los-errantes,934,hunter,marksmanship,18,10,8
Madida,ravencrest,925,hunter,marksmanship,12,10,2
Эвилтар,soulflayer,925,hunter,marksmanship,20,11,9
Snaped,malganis,924,hunter,marksmanship,23,10,13
Laara,khaz-modan,922,hunter,marksmanship,107,49,58
Pappous,kul-tiras,911,hunter,marksmanship,26,11,15
Амобарбиталх,gordunni,901,hunter,marksmanship,33,11,22
Zicko,argent-dawn,897,hunter,marksmanship,35,13,22
Ранбоу,howling-fjord,892,hunter,marksmanship,49,19,30
Aliyah,blackmoore,891,hunter,marksmanship,60,31,29
Adventures,darkmoon-faire,881,hunter,marksmanship,18,10,8
Sinsé,conseil-des-ombres,879,hunter,marksmanship,16,10,6
Luckyshooter,nethersturm,877,hunter,marksmanship,71,32,39
Tenkai,cthun,871,hunter,marksmanship,24,12,12
Aszasi,azjolnerub,871,hunter,marksmanship,25,10,15
Krøsh,blackmoore,870,hunter,marksmanship,36,16,20
Feelmyfurý,tarren-mill,864,hunter,marksmanship,12,9,3
Nyjal,archimonde,864,hunter,marksmanship,12,9,3
Chindala,zuljin,864,hunter,marksmanship,18,9,9
Mòzetonq,ravencrest,864,hunter,marksmanship,18,9,9
Arung,ravencrest,864,hunter,marksmanship,18,9,9
Rizlay,the-maelstrom,864,hunter,marksmanship,24,9,15
Migro,sylvanas,863,hunter,marksmanship,18,9,9
Jayri,ravencrest,863,hunter,marksmanship,18,9,9
Какжеплевать,gordunni,862,hunter,marksmanship,12,9,3
Obii,stormscale,862,hunter,marksmanship,18,9,9
Огнеборик,howling-fjord,862,hunter,marksmanship,24,9,15
Theuzikat,ragnaros,861,hunter,marksmanship,24,9,15
Jalcer,draenor,860,hunter,marksmanship,30,9,21
Джимуха,soulflayer,859,hunter,marksmanship,30,15,15
Gorá,dethecus,858,hunter,marksmanship,12,9,3
Bazrzokh,elune,858,hunter,marksmanship,18,9,9
Gwalëndil,hyjal,858,hunter,marksmanship,24,9,15
Zushji,ysondre,858,hunter,marksmanship,36,9,27
Krippie,dun-modr,857,hunter,marksmanship,36,16,20
Gintønic,blackmoore,857,hunter,marksmanship,36,9,27
Qmbonboni,ravencrest,855,hunter,marksmanship,24,9,15
Baraduh,sylvanas,853,hunter,marksmanship,18,9,9
Baldazr,shadowsong,853,hunter,marksmanship,24,9,15
Eldrilaon,arthas,852,hunter,marksmanship,39,18,21
Zerkarok,draenor,851,hunter,marksmanship,30,9,21
Фридор,deathguard,850,hunter,marksmanship,24,10,14
Bluetiger,azshara,842,hunter,marksmanship,22,10,12
Heavenlyx,area-52,835,hunter,marksmanship,36,9,27
Куфа,blackscar,831,hunter,marksmanship,20,10,10
Hylzen,outland,828,hunter,marksmanship,17,9,8
Wìndrunner,malfurion,826,hunter,marksmanship,59,25,34
Azsräel,dalaran,822,hunter,marksmanship,38,15,23
Rollei,uldum,816,hunter,marksmanship,18,9,9
Klarix,outland,815,hunter,marksmanship,17,9,8
Grafhunter,antonidas,814,hunter,marksmanship,69,32,37
Йошумитсу,howling-fjord,803,hunter,marksmanship,26,10,16
Retroxia,stormreaver,798,hunter,marksmanship,14,9,5
Väärä,stormscale,780,hunter,marksmanship,22,9,13
Greel,saurfang,771,hunter,marksmanship,54,21,33
Maticshorter,blackmoore,768,hunter,marksmanship,12,8,4
Рбг,blackscar,768,hunter,marksmanship,18,8,10
Celesticx,chamber-of-aspects,768,hunter,marksmanship,18,8,10
Carre,twilights-hammer,768,hunter,marksmanship,18,8,10
Кривоватый,galakrond,767,hunter,marksmanship,12,8,4
Sylverain,silvermoon,767,hunter,marksmanship,12,8,4
Mareyn,argent-dawn,767,hunter,marksmanship,12,8,4
Thallia,todeswache,767,hunter,marksmanship,18,8,10
Skitari,draenor,767,hunter,marksmanship,18,8,10
Raegal,sanguino,767,hunter,marksmanship,18,8,10
Focushunter,outland,767,hunter,marksmanship,18,8,10
Dasimir,blackrock,767,hunter,marksmanship,18,8,10
Иоссифсталин,soulflayer,767,hunter,marksmanship,24,8,16
Ëluna,burning-legion,766,hunter,marksmanship,12,8,4
Shoót,blackmoore,766,hunter,marksmanship,18,8,10
Ixôn,tarren-mill,765,hunter,marksmanship,24,8,16
Aourön,archimonde,764,hunter,marksmanship,18,8,10
Shibai,outland,762,hunter,marksmanship,18,8,10
Серргио,soulflayer,761,hunter,marksmanship,12,8,4
Wetto,ravencrest,759,hunter,marksmanship,18,8,10
Neldrassil,blackmoore,758,hunter,marksmanship,18,8,10
Fèhn,krasus,757,hunter,marksmanship,12,8,4
Erestor,hellfire,747,hunter,marksmanship,12,8,4
Ønur,twisting-nether,747,hunter,marksmanship,18,8,10
Ashkabous,kazzak,745,hunter,marksmanship,18,8,10
Calea,zirkel-des-cenarius,743,hunter,marksmanship,24,9,15
Лордввт,howling-fjord,734,hunter,marksmanship,18,8,10
Deathøfrats,ravencrest,719,hunter,marksmanship,11,8,3
Загзигзаг,soulflayer,710,hunter,marksmanship,21,9,12
Weilerz,drakthul,672,hunter,marksmanship,12,7,5
Bigbowyahurd,draenor,672,hunter,marksmanship,12,7,5
Nêzz,tarren-mill,672,hunter,marksmanship,12,7,5
Avaren,archimonde,672,hunter,marksmanship,12,7,5
Merquryh,ravencrest,672,hunter,marksmanship,12,7,5
Costner,darksorrow,672,hunter,marksmanship,12,7,5
Killershadow,twisting-nether,672,hunter,marksmanship,12,7,5
Dis,twilights-hammer,672,hunter,marksmanship,12,7,5
Dtq,silvermoon,672,hunter,marksmanship,12,7,5
Fluttershy,terokkar,672,hunter,marksmanship,12,7,5
Thugzilla,auchindoun,672,hunter,marksmanship,12,7,5
Jurá,perenolde,672,hunter,marksmanship,12,7,5
Eilyn,quelthalas,672,hunter,marksmanship,12,7,5
Кисяныч,gordunni,672,hunter,marksmanship,12,7,5
Агелетка,gordunni,672,hunter,marksmanship,12,7,5
Хвоостт,gordunni,672,hunter,marksmanship,12,7,5
Гусецап,gordunni,672,hunter,marksmanship,12,7,5
Hesuss,kazzak,672,hunter,marksmanship,12,7,5
Corrupth,outland,672,hunter,marksmanship,15,8,7
Землепух,howling-fjord,672,hunter,marksmanship,18,7,11
Трольболь,eversong,672,hunter,marksmanship,18,7,11
Ahrtemís,destromath,672,hunter,marksmanship,18,7,11
Medgical,outland,672,hunter,marksmanship,18,7,11
Birgitta,jaedenar,672,hunter,marksmanship,18,7,11
Джарвиз,soulflayer,672,hunter,marksmanship,18,7,11
Påtrîckbátém,ravencrest,672,hunter,marksmanship,18,7,11
Онкьяр,gordunni,672,hunter,marksmanship,24,7,17
Griffithstew,blackmoore,672,hunter,marksmanship,24,7,17
Манаррия,soulflayer,672,hunter,marksmanship,24,7,17
Rísu,argent-dawn,671,hunter,marksmanship,12,7,5
Vruh,antonidas,671,hunter,marksmanship,12,7,5
Ôrïøn,archimonde,671,hunter,marksmanship,12,7,5
Халикер,soulflayer,671,hunter,marksmanship,12,7,5
Maknamara,tarren-mill,671,hunter,marksmanship,12,7,5
Guerrilla,stormscale,671,hunter,marksmanship,18,7,11
Спелла,goldrinn,671,hunter,marksmanship,18,7,11
Ashrak,frostmourne,671,hunter,marksmanship,18,7,11
Makaxx,stormscale,671,hunter,marksmanship,18,7,11
Sjufemman,ravencrest,671,hunter,marksmanship,24,7,17
Aureboby,hyjal,671,hunter,marksmanship,24,7,17
Ямакасси,thermaplugg,671,hunter,marksmanship,36,7,29
Deathtrapper,bronzebeard,670,hunter,marksmanship,12,7,5
Pewpewshotz,stormscale,670,hunter,marksmanship,12,7,5
Helioshin,pozzo-delleternità,670,hunter,marksmanship,18,7,11
Jðsi,dalaran,670,hunter,marksmanship,18,7,11
Yip,twisting-nether,670,hunter,marksmanship,18,7,11
Bulseye,kilrogg,670,hunter,marksmanship,18,7,11
Spêctrâ,sylvanas,670,hunter,marksmanship,18,7,11
Kaudza,archimonde,669,hunter,marksmanship,18,7,11
Jaggatee,senjin,668,hunter,marksmanship,12,7,5
Wishmeweed,kazzak,668,hunter,marksmanship,18,7,11
Eilaa,ravencrest,662,hunter,marksmanship,18,7,11
Arkman,malganis,660,hunter,marksmanship,30,7,23
Shokre,silvermoon,657,hunter,marksmanship,12,7,5
Breezhunt,twisting-nether,655,hunter,marksmanship,17,7,10
Есселин,thermaplugg,650,hunter,marksmanship,18,7,11
Aadarshh,turalyon,645,hunter,marksmanship,18,7,11
Sogoru,dun-modr,637,hunter,marksmanship,15,8,7
Scark,tarren-mill,621,hunter,marksmanship,11,7,4
Miezuu,ravencrest,620,hunter,marksmanship,15,7,8
Crétin,archimonde,617,hunter,marksmanship,20,8,12
Iniduhr,dalaran,617,hunter,marksmanship,21,8,13
Weridia,der-rat-von-dalaran,607,hunter,marksmanship,11,7,4
Chizuna,dun-morogh,606,hunter,marksmanship,14,7,7
Connyrövöga,draenor,576,hunter,marksmanship,6,6,0
Ofortuna,silvermoon,576,hunter,marksmanship,6,6,0
Mfbloom,blackmoore,576,hunter,marksmanship,12,6,6
Инкризшот,gordunni,576,hunter,marksmanship,12,6,6
Shína,argent-dawn,576,hunter,marksmanship,12,6,6
Wolfud,pozzo-delleternità,576,hunter,marksmanship,12,6,6
Fantus,sylvanas,576,hunter,marksmanship,12,6,6
Aenina,kazzak,576,hunter,marksmanship,12,6,6
Djidawn,ysondre,576,hunter,marksmanship,12,6,6
Nirn,ravencrest,576,hunter,marksmanship,12,6,6
Crudeconzept,talnivarr,576,hunter,marksmanship,12,6,6
Vorsia,tarren-mill,576,hunter,marksmanship,12,6,6
Watchouttah,the-maelstrom,576,hunter,marksmanship,12,6,6
Jettraichu,aggra-português,576,hunter,marksmanship,12,6,6
Hunlin,kazzak,576,hunter,marksmanship,12,6,6
Imfiné,outland,576,hunter,marksmanship,18,6,12
Такувами,gordunni,576,hunter,marksmanship,18,6,12
Луврен,deepholm,576,hunter,marksmanship,18,6,12
Сашатетива,gordunni,576,hunter,marksmanship,18,6,12
Oneeyedjoe,the-maelstrom,575,hunter,marksmanship,12,6,6
Noxxen,burning-legion,575,hunter,marksmanship,12,6,6
Elladiel,blackmoore,575,hunter,marksmanship,12,6,6
Kilölek,ragnaros,575,hunter,marksmanship,12,6,6
Fugass,ragnaros,575,hunter,marksmanship,12,6,6
Xeragon,frostwolf,575,hunter,marksmanship,12,6,6
Muddí,ravencrest,575,hunter,marksmanship,12,6,6
Dirtydolores,thrall,575,hunter,marksmanship,12,6,6
Tolkienn,archimonde,575,hunter,marksmanship,12,6,6
Ruger,hyjal,575,hunter,marksmanship,12,6,6
Pøca,kaelthas,575,hunter,marksmanship,12,6,6
Ina,tarren-mill,575,hunter,marksmanship,12,6,6
Honzu,silvermoon,575,hunter,marksmanship,12,6,6
Loca,twilights-hammer,575,hunter,marksmanship,12,6,6
Lightarròw,nordrassil,575,hunter,marksmanship,18,6,12
Egy,the-maelstrom,574,hunter,marksmanship,12,6,6
Seariko,draenor,574,hunter,marksmanship,18,6,12
Omixloua,ragnaros,572,hunter,marksmanship,18,6,12
Isarnexx,dun-modr,571,hunter,marksmanship,12,6,6
Selini,bloodfeather,570,hunter,marksmanship,12,6,6
Kartouche,culte-de-la-rive-noire,565,hunter,marksmanship,12,6,6
Sauer,stormreaver,564,hunter,marksmanship,18,6,12
Mooj,malganis,559,hunter,marksmanship,11,6,5
Matarmeya,los-errantes,539,hunter,marksmanship,16,7,9
Rockymarciaa,dalaran,527,hunter,marksmanship,21,6,15
Ímpulsion,stormscale,511,hunter,marksmanship,14,6,8
Фэйсконтроль,azuregos,506,hunter,marksmanship,20,6,14
Сальверди,gordunni,480,hunter,marksmanship,6,5,1
Toptìérgoðx,drakthul,480,hunter,marksmanship,6,5,1
Ðarrk,tarren-mill,480,hunter,marksmanship,6,5,1
Îløvémêld,kazzak,480,hunter,marksmanship,6,5,1
Elyar,eredar,480,hunter,marksmanship,6,5,1
Waltuhwhite,teldrassil,480,hunter,marksmanship,6,5,1
Antiork,doomhammer,480,hunter,marksmanship,6,5,1
Полития,azuregos,480,hunter,marksmanship,9,6,3
Nothrokh,auchindoun,480,hunter,marksmanship,12,5,7
Tavira,zuljin,480,hunter,marksmanship,12,5,7
Galou,ghostlands,480,hunter,marksmanship,12,5,7
Brk,dun-modr,480,hunter,marksmanship,12,5,7
Шотнес,gordunni,480,hunter,marksmanship,12,5,7
Leílah,kazzak,480,hunter,marksmanship,12,5,7
Zajaczek,burning-legion,480,hunter,marksmanship,12,5,7
Huntardös,outland,480,hunter,marksmanship,12,5,7
Dritzdòurden,dun-modr,480,hunter,marksmanship,12,5,7
Sashobg,aerie-peak,480,hunter,marksmanship,12,5,7
Spitchy,kazzak,480,hunter,marksmanship,12,5,7
Wowkulaka,kazzak,480,hunter,marksmanship,12,5,7
Куников,booty-bay,480,hunter,marksmanship,12,5,7
Кайсго,gordunni,480,hunter,marksmanship,12,5,7
Lourse,ysondre,480,hunter,marksmanship,12,5,7
Ðõt,ravencrest,480,hunter,marksmanship,12,5,7
Shieryu,archimonde,480,hunter,marksmanship,12,5,7
Øßlíck,ysondre,480,hunter,marksmanship,12,5,7
Littlerat,kult-der-verdammten,480,hunter,marksmanship,12,5,7
Scartet,blackmoore,480,hunter,marksmanship,12,5,7
Carrilynn,blackrock,480,hunter,marksmanship,12,5,7
Deathmarks,blackrock,480,hunter,marksmanship,12,5,7
Denaik,ravencrest,480,hunter,marksmanship,12,5,7
Fylealaes,ravencrest,480,hunter,marksmanship,12,5,7
Jomerin,thrall,480,hunter,marksmanship,12,5,7
Zion,kul-tiras,480,hunter,marksmanship,12,5,7
Agbaba,twisting-nether,480,hunter,marksmanship,12,5,7
Hÿyrøk,ysondre,480,hunter,marksmanship,18,5,13
Тэуреэль,gordunni,480,hunter,marksmanship,18,5,13
Dramin,defias-brotherhood,480,hunter,marksmanship,18,5,13
Tetiscaza,sanguino,480,hunter,marksmanship,24,5,19
Jozsiur,ragnaros,479,hunter,marksmanship,6,5,1
Lunalai,antonidas,479,hunter,marksmanship,12,5,7
Nígruløl,arthas,479,hunter,marksmanship,12,5,7
Nìsalle,argent-dawn,479,hunter,marksmanship,12,5,7
Zäyk,zuljin,479,hunter,marksmanship,12,5,7
Whereismypet,azjolnerub,479,hunter,marksmanship,12,5,7
Vèreesa,azjolnerub,479,hunter,marksmanship,12,5,7
Arrown,outland,479,hunter,marksmanship,17,6,11
Зиргус,gordunni,479,hunter,marksmanship,18,5,13
Nightarrows,ravencrest,478,hunter,marksmanship,6,5,1
Tiph,argent-dawn,478,hunter,marksmanship,12,5,7
Thebalrog,korgall,478,hunter,marksmanship,12,5,7
Bloodshot,nethersturm,477,hunter,marksmanship,12,5,7
Miisakaa,antonidas,477,hunter,marksmanship,12,5,7
Robros,dentarg,475,hunter,marksmanship,12,5,7
Klittcrit,bloodhoof,475,hunter,marksmanship,12,5,7
Jibolad,stormreaver,475,hunter,marksmanship,12,5,7
Sixty,rajaxx,474,hunter,marksmanship,18,5,13
Karmios,drakthul,473,hunter,marksmanship,12,5,7
Juki,pozzo-delleternità,472,hunter,marksmanship,12,5,7
Littlenugget,ravencrest,447,hunter,marksmanship,11,5,6
Haleth,uldum,447,hunter,marksmanship,17,5,12
Thedanchodak,stormrage,440,hunter,marksmanship,11,5,6
Jocitwitch,ragnaros,432,hunter,marksmanship,9,6,3
Zaragattas,aggra-português,426,hunter,marksmanship,17,7,10
Sylasteria,twisting-nether,426,hunter,marksmanship,16,6,10
Quinty,durotan,414,hunter,marksmanship,8,5,3
Sandchaton,ragnaros,384,hunter,marksmanship,6,4,2
Earlyspring,ragnaros,384,hunter,marksmanship,6,4,2
Burninghunt,ravencrest,384,hunter,marksmanship,6,4,2
Ixxmhunt,blackrock,384,hunter,marksmanship,6,4,2
Faenor,arygos,384,hunter,marksmanship,6,4,2
Nöbody,khaz-modan,384,hunter,marksmanship,6,4,2
Donneraàn,blackrock,384,hunter,marksmanship,6,4,2
Bosseleon,blackrock,384,hunter,marksmanship,6,4,2
Myoui,silvermoon,384,hunter,marksmanship,6,4,2
Hntudwn,azshara,384,hunter,marksmanship,6,4,2
Rymous,nemesis,384,hunter,marksmanship,6,4,2
Kaktus,shattered-hand,384,hunter,marksmanship,6,4,2
Øtemløol,sanguino,384,hunter,marksmanship,6,4,2
Kragán,silvermoon,384,hunter,marksmanship,6,4,2
Aidsmacka,shattered-hand,384,hunter,marksmanship,6,4,2
Джеймсфранко,blackscar,384,hunter,marksmanship,6,4,2
Sùnzí,alakir,384,hunter,marksmanship,6,4,2
Silvyn,pozzo-delleternità,384,hunter,marksmanship,6,4,2
Velen,pozzo-delleternità,384,hunter,marksmanship,6,4,2
Destynarîa,illidan,384,hunter,marksmanship,6,4,2
Nßatrapper,outland,384,hunter,marksmanship,6,4,2
Galadris,kirin-tor,384,hunter,marksmanship,6,4,2
Xzmiq,outland,384,hunter,marksmanship,6,4,2
Darllene,kazzak,384,hunter,marksmanship,6,4,2
Zulthat,thrall,384,hunter,marksmanship,6,4,2
Ðøper,hyjal,384,hunter,marksmanship,6,4,2
Intoxd,sylvanas,384,hunter,marksmanship,6,4,2
Donfabio,norgannon,384,hunter,marksmanship,6,4,2
Anpaytoo,antonidas,384,hunter,marksmanship,6,4,2
Metak,auchindoun,384,hunter,marksmanship,6,4,2
Likandria,blackmoore,384,hunter,marksmanship,6,4,2
Ðæom,outland,384,hunter,marksmanship,6,4,2
Kikilirilivi,ysondre,384,hunter,marksmanship,6,4,2
Оверман,azuregos,384,hunter,marksmanship,6,4,2
Lrr,grim-batol,384,hunter,marksmanship,6,4,2
Denkstah,tarren-mill,384,hunter,marksmanship,6,4,2
Dariusmm,silvermoon,384,hunter,marksmanship,6,4,2
Doloresman,tarren-mill,384,hunter,marksmanship,6,4,2
Doubletap,ysondre,384,hunter,marksmanship,6,4,2
Killitoss,blackmoore,384,hunter,marksmanship,6,4,2
Comegetme,auchindoun,384,hunter,marksmanship,6,4,2
Yoey,tarren-mill,384,hunter,marksmanship,6,4,2
Unßørn,archimonde,384,hunter,marksmanship,6,4,2
Qiruun,draenor,384,hunter,marksmanship,6,4,2
Сынсема,blackscar,384,hunter,marksmanship,6,4,2
Jägarenen,kazzak,384,hunter,marksmanship,6,4,2
Slo,sylvanas,384,hunter,marksmanship,6,4,2
Сацыви,gordunni,384,hunter,marksmanship,6,4,2
Хантероо,gordunni,384,hunter,marksmanship,6,4,2
Snipinx,draenor,384,hunter,marksmanship,6,4,2
Wîldhunt,burning-legion,384,hunter,marksmanship,11,4,7
Egodennis,frostwolf,384,hunter,marksmanship,12,4,8
Йинги,gordunni,384,hunter,marksmanship,12,4,8
Døømslayer,nemesis,384,hunter,marksmanship,12,4,8
Свадебная,gordunni,384,hunter,marksmanship,12,4,8
Peonfarmer,argent-dawn,384,hunter,marksmanship,12,4,8
Hashaya,hyjal,384,hunter,marksmanship,12,4,8
Ruppig,nozdormu,384,hunter,marksmanship,12,4,8
Tartaupommes,hyjal,384,hunter,marksmanship,12,4,8
Naestra,tarren-mill,384,hunter,marksmanship,12,4,8
Rapid,sylvanas,384,hunter,marksmanship,12,4,8
Vallêria,malganis,384,hunter,marksmanship,12,4,8
Noobhuntress,norgannon,384,hunter,marksmanship,12,4,8
Querro,azshara,384,hunter,marksmanship,12,4,8
Narziel,die-todeskrallen,384,hunter,marksmanship,12,4,8
Rupeebtw,stormscale,384,hunter,marksmanship,12,4,8
Fennecshand,colinas-pardas,384,hunter,marksmanship,12,4,8
Kanlina,ravencrest,384,hunter,marksmanship,12,4,8
Dangerousfoe,argent-dawn,384,hunter,marksmanship,12,4,8
Deeparrow,stormscale,384,hunter,marksmanship,12,4,8
Darilli,wildhammer,384,hunter,marksmanship,12,4,8
Zurzok,blackrock,384,hunter,marksmanship,12,4,8
Sharún,sylvanas,384,hunter,marksmanship,12,4,8
Абунай,soulflayer,384,hunter,marksmanship,12,4,8
Thengill,draenor,384,hunter,marksmanship,12,4,8
Darkshe,dun-modr,384,hunter,marksmanship,12,4,8
Spirys,drakthul,384,hunter,marksmanship,12,4,8
Bugspitz,outland,384,hunter,marksmanship,12,4,8
Gødzftw,kazzak,384,hunter,marksmanship,14,4,10
Kêêpsmile,blackmoore,384,hunter,marksmanship,18,4,14
Конар,soulflayer,383,hunter,marksmanship,6,4,2
Hanzolo,uldum,383,hunter,marksmanship,12,4,8
Penelopé,darkmoon-faire,383,hunter,marksmanship,12,4,8
Kyéra,kirin-tor,383,hunter,marksmanship,12,4,8
Zirriath,mazrigos,383,hunter,marksmanship,12,4,8
Anguerande,khaz-modan,383,hunter,marksmanship,12,4,8
Nezuqo,archimonde,383,hunter,marksmanship,18,4,14
Koreic,silvermoon,383,hunter,marksmanship,18,4,14
Agnõr,chants-éternels,382,hunter,marksmanship,6,4,2
Banshees,sylvanas,382,hunter,marksmanship,6,4,2
Бурбоньчик,soulflayer,382,hunter,marksmanship,12,4,8
Armoredtiger,grim-batol,381,hunter,marksmanship,12,4,8
Saccä,ysondre,381,hunter,marksmanship,12,4,8
Euphellius,darkmoon-faire,380,hunter,marksmanship,15,5,10
Lumidii,burning-legion,379,hunter,marksmanship,12,4,8
Pâthfînder,destromath,379,hunter,marksmanship,12,4,8
Éddiémórphín,kazzak,367,hunter,marksmanship,11,4,7
Boehelientje,defias-brotherhood,351,hunter,marksmanship,11,4,7
Shadoox,argent-dawn,335,hunter,marksmanship,11,4,7
Sharpeyezz,ravencrest,330,hunter,marksmanship,16,5,11
Arwenna,argent-dawn,328,hunter,marksmanship,11,6,5
Bloópy,silvermoon,320,hunter,marksmanship,10,4,6
Lioness,ahnqiraj,288,hunter,marksmanship,6,3,3
Barbrady,nethersturm,288,hunter,marksmanship,6,3,3
Velne,ravencrest,288,hunter,marksmanship,6,3,3
Eéilin,the-maelstrom,288,hunter,marksmanship,6,3,3
Techpøint,silvermoon,288,hunter,marksmanship,6,3,3
Threeguns,blackrock,288,hunter,marksmanship,6,3,3
Kaminôr,antonidas,288,hunter,marksmanship,6,3,3
Osie,kazzak,288,hunter,marksmanship,6,3,3
Shadowxx,silvermoon,288,hunter,marksmanship,6,3,3
Антисерт,ashenvale,288,hunter,marksmanship,6,3,3
Feyoonxx,blackrock,288,hunter,marksmanship,6,3,3
Kahbe,ravencrest,288,hunter,marksmanship,6,3,3
Fize,blackmoore,288,hunter,marksmanship,6,3,3
Brûmovitch,archimonde,288,hunter,marksmanship,6,3,3
Piit,elune,288,hunter,marksmanship,6,3,3
Экономист,fordragon,288,hunter,marksmanship,6,3,3
Storphunt,drakthul,288,hunter,marksmanship,6,3,3
Ozzaty,drekthar,288,hunter,marksmanship,6,3,3
Kundra,ravencrest,288,hunter,marksmanship,6,3,3
Atranex,ravencrest,288,hunter,marksmanship,6,3,3
Bocek,silvermoon,288,hunter,marksmanship,6,3,3
Ев,lich-king,288,hunter,marksmanship,6,3,3
Lithell,kazzak,288,hunter,marksmanship,6,3,3
Djøgi,archimonde,288,hunter,marksmanship,6,3,3
Snipèr,blackmoore,288,hunter,marksmanship,6,3,3
Zøk,stormscale,288,hunter,marksmanship,6,3,3
Ayiu,argent-dawn,288,hunter,marksmanship,6,3,3
Eliune,silvermoon,288,hunter,marksmanship,6,3,3
Dedral,aegwynn,288,hunter,marksmanship,6,3,3
Sissnik,thrall,288,hunter,marksmanship,6,3,3
Lilsnuss,outland,288,hunter,marksmanship,6,3,3
Deadluck,kazzak,288,hunter,marksmanship,6,3,3
Нойран,eversong,288,hunter,marksmanship,6,3,3
Ökisek,drakthul,288,hunter,marksmanship,6,3,3
Elektrô,blackmoore,288,hunter,marksmanship,6,3,3
Celebor,sanguino,288,hunter,marksmanship,6,3,3
Джинксан,blackscar,288,hunter,marksmanship,6,3,3
Dreemshoot,stormscale,288,hunter,marksmanship,6,3,3
Aamön,tarren-mill,288,hunter,marksmanship,6,3,3
Трапавграунд,howling-fjord,288,hunter,marksmanship,6,3,3
Комомура,soulflayer,288,hunter,marksmanship,6,3,3
Zugzlug,tarren-mill,288,hunter,marksmanship,6,3,3
Samasukë,grim-batol,288,hunter,marksmanship,6,3,3
Яроняютрапу,gordunni,288,hunter,marksmanship,6,3,3
Pläpp,stormscale,288,hunter,marksmanship,6,3,3
Phinecone,stormscale,288,hunter,marksmanship,6,3,3
Hurion,sanguino,288,hunter,marksmanship,6,3,3
Burbutsuluki,silvermoon,288,hunter,marksmanship,6,3,3
Scatshot,grim-batol,288,hunter,marksmanship,6,3,3
ßæro,hyjal,288,hunter,marksmanship,6,3,3
Aimshotx,stormscale,288,hunter,marksmanship,6,3,3
Neescafe,sylvanas,288,hunter,marksmanship,6,3,3
Люблюлюбовь,gordunni,288,hunter,marksmanship,6,3,3
Nerdhark,hyjal,288,hunter,marksmanship,6,3,3
Лесбиянюсь,gordunni,288,hunter,marksmanship,6,3,3
Blackbane,ravencrest,288,hunter,marksmanship,6,3,3
Áragorn,frostmane,288,hunter,marksmanship,6,3,3
Nightarrowq,tarren-mill,288,hunter,marksmanship,9,4,5
Amdéa,boulderfist,288,hunter,marksmanship,10,4,6
Robingood,alexstrasza,288,hunter,marksmanship,11,4,7
Secrety,doomhammer,288,hunter,marksmanship,11,3,8
Deneja,kilrogg,288,hunter,marksmanship,12,3,9
Zubro,kazzak,288,hunter,marksmanship,12,3,9
Nutshotx,stormscale,288,hunter,marksmanship,12,3,9
Nezekielle,drekthar,288,hunter,marksmanship,12,3,9
Oduross,minahonda,288,hunter,marksmanship,12,3,9
Naaztko,stormscale,288,hunter,marksmanship,12,3,9
Lùchiean,kazzak,288,hunter,marksmanship,12,3,9
Ghenter,sargeras,288,hunter,marksmanship,12,3,9
Ceres,kaelthas,288,hunter,marksmanship,12,3,9
Augie,kazzak,288,hunter,marksmanship,12,3,9
Жабра,gordunni,288,hunter,marksmanship,12,3,9
Хедшоттер,blackscar,288,hunter,marksmanship,12,3,9
Spakster,blackrock,288,hunter,marksmanship,12,3,9
Белыйатомщик,howling-fjord,288,hunter,marksmanship,12,3,9
Ричардн,howling-fjord,288,hunter,marksmanship,12,3,9
Бубунн,howling-fjord,288,hunter,marksmanship,12,3,9
Deahtviper,blackmoore,288,hunter,marksmanship,12,3,9
Fatfrumos,twisting-nether,288,hunter,marksmanship,12,3,9
Астериел,blackscar,288,hunter,marksmanship,12,3,9
Deify,grim-batol,288,hunter,marksmanship,12,3,9
Deathshots,aggra-português,288,hunter,marksmanship,12,3,9
Chassuu,khaz-modan,288,hunter,marksmanship,12,3,9
Jakis,silvermoon,288,hunter,marksmanship,12,3,9
Thalanel,arthas,288,hunter,marksmanship,12,3,9
Haraigoshí,grim-batol,288,hunter,marksmanship,12,3,9
Incompetence,argent-dawn,288,hunter,marksmanship,12,3,9
Triggery,ravencrest,288,hunter,marksmanship,12,3,9
Enablee,lightbringer,288,hunter,marksmanship,18,3,15
Shademd,ahnqiraj,288,hunter,marksmanship,18,3,15
Andtamed,thunderhorn,288,hunter,marksmanship,18,3,15
Marcher,aggra-português,288,hunter,marksmanship,18,3,15
Showdope,drakthul,288,hunter,marksmanship,18,3,15
Pylos,azshara,287,hunter,marksmanship,6,3,3
Мокку,howling-fjord,287,hunter,marksmanship,6,3,3
Анариэлль,gordunni,287,hunter,marksmanship,6,3,3
Оркос,deathweaver,287,hunter,marksmanship,6,3,3
Gorett,kazzak,287,hunter,marksmanship,12,3,9
Dwoas,darkspear,287,hunter,marksmanship,12,3,9
Jomoguin,stormscale,286,hunter,marksmanship,6,3,3
Millhunter,norgannon,284,hunter,marksmanship,12,3,9
Rdevill,outland,256,hunter,marksmanship,10,3,7
Urith,les-clairvoyants,255,hunter,marksmanship,8,4,4
Samuru,auchindoun,239,hunter,marksmanship,5,3,2
Jaguarundy,dun-modr,239,hunter,marksmanship,5,3,2
Incrediown,tarren-mill,234,hunter,marksmanship,7,4,3
Twinshot,anetheron,234,hunter,marksmanship,10,4,6
Cais,drakthul,234,hunter,marksmanship,12,4,8
Sayn,la-croisade-écarlate,192,hunter,marksmanship,6,2,4
Rixxâr,blackrock,192,hunter,marksmanship,6,2,4
Vâleriaa,blackrock,192,hunter,marksmanship,6,2,4
Zulldek,sanguino,192,hunter,marksmanship,6,2,4
Мафчик,razuvious,192,hunter,marksmanship,6,2,4
Mobshot,twisting-nether,192,hunter,marksmanship,6,2,4
Sjins,draenor,192,hunter,marksmanship,6,2,4
Majuli,stormrage,192,hunter,marksmanship,6,2,4
Notikâ,aegwynn,192,hunter,marksmanship,6,2,4
Nelf,shattered-hand,192,hunter,marksmanship,6,2,4
Viktorijå,draenor,192,hunter,marksmanship,6,2,4
Silenta,outland,192,hunter,marksmanship,6,2,4
Горгудц,gordunni,192,hunter,marksmanship,6,2,4
Фетсол,soulflayer,192,hunter,marksmanship,6,2,4
Realme,blackrock,192,hunter,marksmanship,6,2,4
Anoroxx,arthas,192,hunter,marksmanship,6,2,4
Elvyns,silvermoon,192,hunter,marksmanship,6,2,4
Axran,ravencrest,192,hunter,marksmanship,6,2,4
Jamais02AEE6,stormscale,192,hunter,marksmanship,6,2,4
Beletor,medivh,192,hunter,marksmanship,6,2,4
Kodakcrack,draenor,192,hunter,marksmanship,6,2,4
Greenstar,twisting-nether,192,hunter,marksmanship,6,2,4
Jskey,aggramar,192,hunter,marksmanship,6,2,4
Brizza,talnivarr,192,hunter,marksmanship,6,2,4
Lilsnipè,outland,192,hunter,marksmanship,6,2,4
Velvett,blackmoore,192,hunter,marksmanship,6,2,4
Zinà,naxxramas,192,hunter,marksmanship,6,2,4
Kerrveros,ravencrest,192,hunter,marksmanship,6,2,4
Bellecoq,arathi,192,hunter,marksmanship,6,2,4
Sarblade,bronze-dragonflight,192,hunter,marksmanship,6,2,4
Becoming,burning-legion,192,hunter,marksmanship,6,2,4
Bobshmurda,defias-brotherhood,192,hunter,marksmanship,6,2,4
Gotha,festung-der-stürme,192,hunter,marksmanship,6,2,4
Tytoyz,khaz-modan,192,hunter,marksmanship,6,2,4
Foxmis,kazzak,192,hunter,marksmanship,6,2,4
Amiosi,sanguino,192,hunter,marksmanship,6,2,4
Darkstripe,turalyon,192,hunter,marksmanship,6,2,4
Bóssit,skullcrusher,192,hunter,marksmanship,6,2,4
Охотуначал,soulflayer,192,hunter,marksmanship,6,2,4
Meetyour,stormscale,192,hunter,marksmanship,6,2,4
Aliriana,doomhammer,192,hunter,marksmanship,6,2,4
Darkshàdow,archimonde,192,hunter,marksmanship,6,2,4
Deadyeyez,doomhammer,192,hunter,marksmanship,6,2,4
Aspergun,ragnaros,192,hunter,marksmanship,6,2,4
Rafaela,genjuros,192,hunter,marksmanship,6,2,4
Galintzor,area-52,192,hunter,marksmanship,6,2,4
Corrector,outland,192,hunter,marksmanship,6,2,4
Bowner,frostmane,192,hunter,marksmanship,6,2,4
Réja,norgannon,192,hunter,marksmanship,6,2,4
Трисциллочка,howling-fjord,192,hunter,marksmanship,6,2,4
Huntbeard,ragnaros,192,hunter,marksmanship,6,2,4
Carioca,blackhand,192,hunter,marksmanship,6,2,4
Nnoyk,defias-brotherhood,192,hunter,marksmanship,6,2,4
Anklar,blackrock,192,hunter,marksmanship,6,2,4
Bláckheart,doomhammer,192,hunter,marksmanship,6,2,4
Имбакласс,howling-fjord,192,hunter,marksmanship,6,2,4
Miracleh,tarren-mill,192,hunter,marksmanship,6,2,4
Nimri,kazzak,192,hunter,marksmanship,6,2,4
Merveilleux,hyjal,192,hunter,marksmanship,6,2,4
Doknak,gilneas,192,hunter,marksmanship,6,2,4
Garrash,teldrassil,192,hunter,marksmanship,6,2,4
Monnee,outland,192,hunter,marksmanship,6,2,4
Хисдед,howling-fjord,192,hunter,marksmanship,6,2,4
Draknik,nemesis,192,hunter,marksmanship,6,2,4
Hadto,der-rat-von-dalaran,192,hunter,marksmanship,6,2,4
Slayman,kazzak,192,hunter,marksmanship,6,2,4
Olrik,dentarg,192,hunter,marksmanship,6,2,4
Domsín,ravencrest,192,hunter,marksmanship,6,2,4
Othellö,kazzak,192,hunter,marksmanship,6,2,4
Freexkite,aegwynn,192,hunter,marksmanship,8,2,6
Hunterhouse,draenor,192,hunter,marksmanship,11,2,9
Ghostriders,archimonde,192,hunter,marksmanship,11,2,9
Dmanite,ravencrest,192,hunter,marksmanship,12,2,10
Katharyne,argent-dawn,192,hunter,marksmanship,12,2,10
Friskì,draenor,192,hunter,marksmanship,12,2,10
Muckel,area-52,192,hunter,marksmanship,12,2,10
Weedonyhunt,hyjal,192,hunter,marksmanship,12,2,10
Meläna,ysondre,192,hunter,marksmanship,12,2,10
Ruhen,aegwynn,192,hunter,marksmanship,12,2,10
Explicits,stormscale,192,hunter,marksmanship,12,2,10
Apolix,ragnaros,192,hunter,marksmanship,12,2,10
Banglor,shattered-hand,192,hunter,marksmanship,12,2,10
Stormhoofd,bloodhoof,191,hunter,marksmanship,6,2,4
Milandria,antonidas,191,hunter,marksmanship,6,2,4
Chalyto,dun-morogh,191,hunter,marksmanship,12,2,10
Kure,blackrock,191,hunter,marksmanship,12,2,10
Buttsnipe,sylvanas,159,hunter,marksmanship,5,2,3
Jaguàr,kazzak,159,hunter,marksmanship,5,2,3
Neremyn,sylvanas,138,hunter,marksmanship,9,3,6
Dampfwâlzê,nozdormu,127,hunter,marksmanship,8,2,6
Пушкабомби,soulflayer,126,hunter,marksmanship,8,2,6
Chrishyh,blackrock,112,hunter,marksmanship,7,2,5
Tryx,darksorrow,96,hunter,marksmanship,3,2,1
Akahr,thrall,96,hunter,marksmanship,3,2,1
Tyrone,saurfang,96,hunter,marksmanship,9,2,7
Akaname,ravencrest,96,hunter,marksmanship,6,1,5
Fayenia,ravencrest,96,hunter,marksmanship,6,1,5
Honilsom,thunderhorn,96,hunter,marksmanship,6,1,5
Meletis,stormreaver,96,hunter,marksmanship,6,1,5
Лсныйпамп,howling-fjord,96,hunter,marksmanship,6,1,5
Гижуна,howling-fjord,96,hunter,marksmanship,6,1,5
Tillhunt,kargath,96,hunter,marksmanship,6,1,5
Kolgrim,temple-noir,96,hunter,marksmanship,6,1,5
Nethria,antonidas,96,hunter,marksmanship,6,1,5
Наладдчик,howling-fjord,96,hunter,marksmanship,6,1,5
Sinplify,emeriss,96,hunter,marksmanship,6,1,5
Cítyzens,drakthul,96,hunter,marksmanship,6,1,5
Tiguy,archimonde,96,hunter,marksmanship,6,1,5
Ihateyoumore,ravencrest,96,hunter,marksmanship,6,1,5
Spacenøub,archimonde,96,hunter,marksmanship,6,1,5
Chantalia,ravencrest,96,hunter,marksmanship,6,1,5
Burondeya,twisting-nether,96,hunter,marksmanship,6,1,5
Pestilencio,shendralar,96,hunter,marksmanship,6,1,5
Горгонт,blackscar,96,hunter,marksmanship,6,1,5
Desow,blackrock,96,hunter,marksmanship,6,1,5
Tuljan,ravencrest,96,hunter,marksmanship,6,1,5
Wolfmcquade,draenor,96,hunter,marksmanship,6,1,5
Nalys,argent-dawn,96,hunter,marksmanship,6,1,5
Jimbow,blackrock,96,hunter,marksmanship,6,1,5
Tesourinho,aggra-português,96,hunter,marksmanship,6,1,5
Wèdra,hyjal,96,hunter,marksmanship,6,1,5
Superfacial,twisting-nether,96,hunter,marksmanship,6,1,5
Фаффурион,gordunni,96,hunter,marksmanship,6,1,5
Камсшотт,gordunni,96,hunter,marksmanship,6,1,5
Sloee,sylvanas,96,hunter,marksmanship,6,1,5
Salie,argent-dawn,96,hunter,marksmanship,6,1,5
Faccacamoale,twisting-nether,96,hunter,marksmanship,6,1,5
Feedbackloop,silvermoon,96,hunter,marksmanship,6,1,5
Xaraimz,ravencrest,96,hunter,marksmanship,6,1,5
Ренектон,soulflayer,96,hunter,marksmanship,6,1,5
Drolarin,zuljin,96,hunter,marksmanship,6,1,5
Avizi,anachronos,96,hunter,marksmanship,6,1,5
Chaydee,stormscale,96,hunter,marksmanship,6,1,5
Eskubar,burning-legion,96,hunter,marksmanship,6,1,5
Cléò,kazzak,96,hunter,marksmanship,6,1,5
Killzo,sylvanas,96,hunter,marksmanship,6,1,5
Leaxs,onyxia,96,hunter,marksmanship,6,1,5
Castbuny,drakthul,96,hunter,marksmanship,6,1,5
Eowale,outland,96,hunter,marksmanship,6,1,5
Cxc,dun-modr,96,hunter,marksmanship,6,1,5
Wàterloo,marécage-de-zangar,96,hunter,marksmanship,6,1,5
Grimazg,chogall,96,hunter,marksmanship,6,1,5
Хантунец,soulflayer,96,hunter,marksmanship,6,1,5
Zwerglogan,amanthul,96,hunter,marksmanship,6,1,5
Statik,deathwing,96,hunter,marksmanship,6,1,5
Syx,amanthul,96,hunter,marksmanship,6,1,5
Deadlymayhem,dragonblight,96,hunter,marksmanship,6,1,5
Badkirves,kazzak,96,hunter,marksmanship,6,1,5
Sekeh,ragnaros,96,hunter,marksmanship,6,1,5
Donáldtrúmp,tarren-mill,96,hunter,marksmanship,12,1,11
Denixxia,bronzebeard,95,hunter,marksmanship,3,2,1
Magahra,thrall,95,hunter,marksmanship,6,1,5
Gettóbuxa,arathor,79,hunter,marksmanship,5,1,4
Dréws,kazzak,64,hunter,marksmanship,4,1,3
Najetazruda,drakthul,64,hunter,marksmanship,4,1,3
Draugrinnh,tarren-mill,48,hunter,marksmanship,3,1,2
Imortaltroll,kazzak,16,hunter,marksmanship,1,1,0
Elgango,blackrock,16,hunter,marksmanship,1,1,0
Pridz,archimonde,2137,hunter,survival,150,76,74
Rynex,festung-der-stürme,2134,hunter,survival,78,45,33
Uglybaboon,draenor,2128,hunter,survival,107,55,52
Harrianlar,ravenholdt,2128,hunter,survival,166,84,82
Corossity,blackmoore,2107,hunter,survival,101,67,34
Pokefangirlx,grim-batol,2107,hunter,survival,209,121,88
Razoorine,blackrock,2102,hunter,survival,156,87,69
Bonquiesha,tarren-mill,2091,hunter,survival,114,63,51
Fíng,tarren-mill,2079,hunter,survival,210,106,104
Belaux,archimonde,2071,hunter,survival,125,62,63
Mspt,archimonde,2057,hunter,survival,114,59,55
Götdelen,kult-der-verdammten,2053,hunter,survival,88,49,39
Rayadz,nethersturm,2017,hunter,survival,108,55,53
Yeezu,sylvanas,2009,hunter,survival,66,36,30
Mestar,outland,2001,hunter,survival,199,100,99
Gíggí,malganis,2000,hunter,survival,60,31,29
Huntity,kazzak,1994,hunter,survival,95,51,44
Crucfixion,kazzak,1993,hunter,survival,60,35,25
Лесбиянюсь,gordunni,1985,hunter,survival,90,53,37
Booxun,sylvanas,1982,hunter,survival,133,68,65
Yemistar,archimonde,1967,hunter,survival,72,40,32
Macrolaim,outland,1952,hunter,survival,132,61,71
Hyderr,aegwynn,1939,hunter,survival,42,27,15
Горгонт,blackscar,1924,hunter,survival,126,70,56
Stormblãze,ravencrest,1921,hunter,survival,131,59,72
Zhulk,los-errantes,1910,hunter,survival,90,44,46
Kagrot,silvermoon,1907,hunter,survival,72,36,36
Nikzeubii,archimonde,1882,hunter,survival,48,24,24
Jackjager,ravencrest,1867,hunter,survival,39,26,13
Lágåta,outland,1864,hunter,survival,53,27,26
Ryomen,garona,1862,hunter,survival,189,99,90
Øvade,argent-dawn,1861,hunter,survival,67,41,26
Avaren,archimonde,1852,hunter,survival,106,56,50
Feignfisto,draenor,1840,hunter,survival,33,20,13
Momohenní,archimonde,1840,hunter,survival,150,82,68
Thugzilla,auchindoun,1837,hunter,survival,65,38,27
Zerberas,blackrock,1835,hunter,survival,60,32,28
Квит,blackscar,1832,hunter,survival,30,20,10
Earfalass,twisting-nether,1832,hunter,survival,104,58,46
Josethepimpo,stormscale,1832,hunter,survival,66,32,34
Easyclass,hyjal,1828,hunter,survival,72,40,32
Vunter,malganis,1828,hunter,survival,48,26,22
Dabeszt,draenor,1827,hunter,survival,60,38,22
Ravebae,silvermoon,1822,hunter,survival,138,69,69
Mogumogu,blackhand,1814,hunter,survival,42,22,20
Polaqu,burning-legion,1809,hunter,survival,60,37,23
Djshibalxd,argent-dawn,1807,hunter,survival,48,27,21
Nwnw,tarren-mill,1802,hunter,survival,30,19,11
Zpf,silvermoon,1801,hunter,survival,56,30,26
Djheartstrng,argent-dawn,1799,hunter,survival,52,30,22
Fatbushpig,stormscale,1786,hunter,survival,30,19,11
Frog,crushridge,1783,hunter,survival,72,42,30
Glosendra,ravencrest,1782,hunter,survival,45,29,16
Onlylfg,drakthul,1772,hunter,survival,68,35,33
Calesthas,tarren-mill,1770,hunter,survival,60,30,30
Madzynette,archimonde,1769,hunter,survival,43,30,13
Летмимейт,howling-fjord,1759,hunter,survival,96,53,43
Dreämhäck,ravencrest,1758,hunter,survival,66,41,25
Lugnåls,hyjal,1755,hunter,survival,47,24,23
Dyndns,blackmoore,1752,hunter,survival,54,24,30
Зеленыйиисус,gordunni,1750,hunter,survival,89,50,39
Obbnfriends,ravencrest,1749,hunter,survival,66,30,36
Clifton,archimonde,1748,hunter,survival,42,27,15
Exquisitor,draenor,1748,hunter,survival,67,33,34
Mewithoutyou,ragnaros,1748,hunter,survival,176,84,92
Sorozo,aegwynn,1745,hunter,survival,65,36,29
Burbutsuluki,silvermoon,1739,hunter,survival,42,23,19
Hunjo,quelthalas,1739,hunter,survival,90,40,50
Âkane,argent-dawn,1737,hunter,survival,54,30,24
Чууч,blackscar,1732,hunter,survival,75,36,39
Subha,quelthalas,1731,hunter,survival,48,31,17
Jànet,ravencrest,1725,hunter,survival,36,18,18
Avizi,anachronos,1724,hunter,survival,78,41,37
Yosia,draenor,1723,hunter,survival,60,31,29
Alexdi,kazzak,1722,hunter,survival,42,19,23
Closeenought,ravencrest,1721,hunter,survival,60,33,27
Mmkekw,guldan,1716,hunter,survival,30,22,8
Boops,ragnaros,1714,hunter,survival,30,18,12
Minibicmex,aegwynn,1709,hunter,survival,30,18,12
Хансбург,howling-fjord,1701,hunter,survival,54,26,28
Snippy,sanguino,1701,hunter,survival,84,39,45
Razôr,blackhand,1700,hunter,survival,30,18,12
Киссмайпет,howling-fjord,1700,hunter,survival,60,34,26
Åíøñs,kazzak,1699,hunter,survival,30,20,10
Разплюханка,howling-fjord,1699,hunter,survival,108,56,52
Оскорбление,howling-fjord,1697,hunter,survival,66,34,32
Rubydacherrý,argent-dawn,1696,hunter,survival,30,21,9
Yazqua,deathwing,1696,hunter,survival,70,42,28
Fusko,ysondre,1695,hunter,survival,54,29,25
Búddhìst,ravencrest,1694,hunter,survival,48,22,26
Sneakyshoot,nemesis,1691,hunter,survival,41,21,20
Akronis,outland,1684,hunter,survival,60,24,36
Rewgodxq,ravencrest,1673,hunter,survival,60,25,35
Dackeldustin,norgannon,1670,hunter,survival,30,27,3
Knokkelmann,outland,1668,hunter,survival,36,24,12
Scypher,ragnaros,1667,hunter,survival,33,23,10
Yemmeth,argent-dawn,1667,hunter,survival,192,100,92
Pwon,ravencrest,1667,hunter,survival,176,90,86
Calyssae,shattered-halls,1665,hunter,survival,76,47,29
Zøk,stormscale,1664,hunter,survival,59,37,22
Gedept,blackrock,1663,hunter,survival,62,33,29
Kyosoku,silvermoon,1662,hunter,survival,39,18,21
Kurkelx,ravencrest,1661,hunter,survival,48,30,18
Gukexa,outland,1656,hunter,survival,36,22,14
Monkeytrapz,norgannon,1655,hunter,survival,42,23,19
Zäroury,ravencrest,1653,hunter,survival,64,32,32
Nemámponetí,drakthul,1649,hunter,survival,54,33,21
Ódelagga,sylvanas,1642,hunter,survival,90,51,39
Halfogre,draenor,1640,hunter,survival,30,20,10
Zulldek,sanguino,1638,hunter,survival,78,42,36
Fablet,draenor,1637,hunter,survival,42,24,18
Renathir,argent-dawn,1628,hunter,survival,50,28,22
Skyh,outland,1628,hunter,survival,101,48,53
Cjezka,blackmoore,1628,hunter,survival,42,18,24
Кулерквест,soulflayer,1627,hunter,survival,85,46,39
Xiumiune,antonidas,1626,hunter,survival,54,32,22
Kajtarn,outland,1621,hunter,survival,60,27,33
Копия,azuregos,1619,hunter,survival,42,18,24
Nienel,archimonde,1618,hunter,survival,71,29,42
Ntwoõ,ravencrest,1615,hunter,survival,65,37,28
Pizzafanatic,blackrock,1614,hunter,survival,49,25,24
Aboleon,ragnaros,1612,hunter,survival,44,20,24
Ruxhunter,sanguino,1607,hunter,survival,90,50,40
Гудхантер,blackscar,1605,hunter,survival,66,38,28
Ázurâ,blackhand,1605,hunter,survival,98,48,50
Robzyhunter,kazzak,1604,hunter,survival,36,23,13
Ищименявтени,gordunni,1604,hunter,survival,65,36,29
Стингергодх,gordunni,1604,hunter,survival,39,19,20
Жэш,howling-fjord,1602,hunter,survival,42,21,21
Tillhunt,kargath,1600,hunter,survival,57,36,21
Сабакаа,borean-tundra,1599,hunter,survival,66,38,28
Lukez,ravencrest,1599,hunter,survival,42,23,19
Микихаса,galakrond,1599,hunter,survival,57,29,28
Darllene,kazzak,1599,hunter,survival,101,46,55
Dariusmm,silvermoon,1598,hunter,survival,58,32,26
Unsáinted,ravencrest,1592,hunter,survival,105,56,49
Aspergun,ragnaros,1590,hunter,survival,46,22,24
Танчибосс,soulflayer,1589,hunter,survival,92,47,45
Sznxøxo,ravencrest,1585,hunter,survival,42,24,18
Saejku,archimonde,1585,hunter,survival,69,36,33
Losiané,thrall,1585,hunter,survival,76,38,38
Westcøãst,archimonde,1578,hunter,survival,48,30,18
Свадебная,gordunni,1572,hunter,survival,148,78,70
Marryme,blackhand,1568,hunter,survival,42,26,16
Urtanis,stormscale,1564,hunter,survival,42,23,19
Бубунн,howling-fjord,1563,hunter,survival,51,29,22
Suzumebachi,twisting-nether,1562,hunter,survival,54,34,20
Turdy,executus,1559,hunter,survival,40,23,17
Zeer,sylvanas,1558,hunter,survival,93,40,53
Майен,thermaplugg,1554,hunter,survival,36,17,19
Ðarrk,tarren-mill,1551,hunter,survival,66,35,31
Âmalphy,ravencrest,1549,hunter,survival,42,17,25
Psychotik,stormreaver,1540,hunter,survival,94,50,44
Wikariusz,kazzak,1540,hunter,survival,66,27,39
Brkh,ravencrest,1535,hunter,survival,24,16,8
Sarrow,ravencrest,1535,hunter,survival,69,36,33
Knoxblå,stormscale,1533,hunter,survival,24,16,8
Næ,kazzak,1531,hunter,survival,79,44,35
Garxzhunter,tarren-mill,1528,hunter,survival,30,16,14
Sphexya,ravencrest,1528,hunter,survival,30,16,14
Atalnta,ravencrest,1523,hunter,survival,63,28,35
Rizlay,the-maelstrom,1520,hunter,survival,66,30,36
Saliressa,ravencrest,1517,hunter,survival,36,16,20
Jakis,silvermoon,1513,hunter,survival,35,17,18
Zacxx,ravencrest,1512,hunter,survival,47,33,14
Skydraz,ysondre,1512,hunter,survival,36,18,18
Хитвейн,gordunni,1510,hunter,survival,42,19,23
Миаур,gordunni,1495,hunter,survival,36,16,20
Clicker,runetotem,1494,hunter,survival,54,25,29
Notikâ,aegwynn,1489,hunter,survival,48,25,23
Иснсейшн,soulflayer,1489,hunter,survival,35,18,17
Фломидзе,gordunni,1487,hunter,survival,36,23,13
Hakkoti,argent-dawn,1486,hunter,survival,66,33,33
Riema,ragnaros,1483,hunter,survival,70,31,39
Lxoh,turalyon,1478,hunter,survival,191,90,101
Horxxa,kul-tiras,1476,hunter,survival,72,43,29
Defjacks,argent-dawn,1469,hunter,survival,32,17,15
Sayn,la-croisade-écarlate,1462,hunter,survival,35,19,16
Raztreadör,dun-modr,1459,hunter,survival,147,75,72
Kalani,la-croisade-écarlate,1459,hunter,survival,105,50,55
Nalys,argent-dawn,1447,hunter,survival,64,36,28
Arykes,drakthul,1440,hunter,survival,53,25,28
Sipsomewater,ravencrest,1439,hunter,survival,24,15,9
Olk,stormscale,1439,hunter,survival,24,15,9
Wastage,draenor,1439,hunter,survival,48,25,23
Vengefull,draenor,1431,hunter,survival,84,45,39
Qwèrts,stormscale,1427,hunter,survival,30,15,15
Eunte,archimonde,1427,hunter,survival,30,15,15
Nurki,the-maelstrom,1427,hunter,survival,30,15,15
Тэмплест,howling-fjord,1411,hunter,survival,24,15,9
Комомура,soulflayer,1410,hunter,survival,41,20,21
Juniorm,kazzak,1407,hunter,survival,30,15,15
Capullospawn,dun-morogh,1406,hunter,survival,24,15,9
Вандамос,soulflayer,1406,hunter,survival,37,21,16
Китас,soulflayer,1402,hunter,survival,68,42,26
Shoty,zuluhed,1402,hunter,survival,106,50,56
Andjelaa,kazzak,1398,hunter,survival,30,15,15
Crème,blackrock,1395,hunter,survival,65,26,39
Ballistix,elune,1394,hunter,survival,30,15,15
Кфоззи,soulflayer,1391,hunter,survival,30,15,15
Betarayjinx,kazzak,1382,hunter,survival,27,15,12
Ðoñko,hyjal,1379,hunter,survival,123,58,65
Slagatronic,ragnaros,1378,hunter,survival,96,53,43
Стивстифлер,razuvious,1377,hunter,survival,42,25,17
Глаззалмаз,howling-fjord,1373,hunter,survival,28,16,12
Сильвиина,eversong,1372,hunter,survival,36,17,19
Ðrãke,blackmoore,1370,hunter,survival,30,15,15
Shootingu,aegwynn,1364,hunter,survival,96,49,47
Йинги,gordunni,1362,hunter,survival,52,27,25
Suxino,doomhammer,1360,hunter,survival,82,37,45
Zwerghauer,arthas,1358,hunter,survival,30,17,13
Abovival,ragnaros,1349,hunter,survival,30,20,10
Icetrapped,eredar,1341,hunter,survival,30,14,16
Xaone,blackrock,1340,hunter,survival,18,14,4
Субоота,gordunni,1335,hunter,survival,24,14,10
Kobayashi,arathor,1331,hunter,survival,89,40,49
Taurïel,stormscale,1326,hunter,survival,38,20,18
Штынь,gordunni,1323,hunter,survival,30,14,16
Jamalinho,silvermoon,1322,hunter,survival,60,38,22
Santiägø,archimonde,1322,hunter,survival,42,23,19
Zaphody,doomhammer,1322,hunter,survival,57,29,28
Карвинн,soulflayer,1321,hunter,survival,30,14,16
Ниалла,thermaplugg,1319,hunter,survival,36,15,21
Zehned,ysondre,1316,hunter,survival,57,25,32
Malgorn,burning-legion,1314,hunter,survival,34,23,11
Vâleriaa,blackrock,1314,hunter,survival,30,14,16
Makeawish,antonidas,1310,hunter,survival,40,20,20
Littlhuntard,tarren-mill,1306,hunter,survival,24,14,10
Tortillia,madmortem,1305,hunter,survival,30,14,16
Karabeg,twisting-nether,1301,hunter,survival,53,22,31
Prodanhunts,frostmane,1296,hunter,survival,30,14,16
Мандалорецц,soulflayer,1294,hunter,survival,56,24,32
Feignindeath,twisting-nether,1291,hunter,survival,32,17,15
Kasperle,frostwolf,1281,hunter,survival,24,14,10
Ksreport,stormscale,1278,hunter,survival,34,14,20
Getsniffarn,sylvanas,1277,hunter,survival,36,18,18
Daweí,draenor,1275,hunter,survival,40,15,25
Nvukaze,argent-dawn,1262,hunter,survival,33,22,11
Herubin,doomhammer,1259,hunter,survival,33,16,17
Huntiika,silvermoon,1257,hunter,survival,64,27,37
Spitchy,kazzak,1248,hunter,survival,36,17,19
Ajko,blackmoore,1247,hunter,survival,30,15,15
Jumong,ragnaros,1246,hunter,survival,24,13,11
Vargar,arygos,1245,hunter,survival,24,13,11
Guanchin,silvermoon,1245,hunter,survival,42,16,26
Albumx,hyjal,1244,hunter,survival,163,76,87
Axehead,outland,1243,hunter,survival,30,14,16
Paxiwtf,eredar,1242,hunter,survival,22,14,8
Fmatzen,the-maelstrom,1241,hunter,survival,24,13,11
Bicepspump,dun-morogh,1240,hunter,survival,30,13,17
Бомбетта,grom,1238,hunter,survival,36,13,23
Ashablack,argent-dawn,1235,hunter,survival,95,47,48
Hreo,twisting-nether,1234,hunter,survival,24,13,11
Шадак,soulflayer,1227,hunter,survival,35,15,20
Hoffen,dentarg,1223,hunter,survival,18,13,5
Гаррельд,blackscar,1219,hunter,survival,30,13,17
Foxyfoxo,guldan,1216,hunter,survival,35,15,20
Steezowl,kazzak,1198,hunter,survival,29,13,16
Sainttcc,thrall,1195,hunter,survival,54,25,29
Kazzaak,kazzak,1188,hunter,survival,72,26,46
Draxil,archimonde,1180,hunter,survival,22,13,9
Maiverx,ravencrest,1152,hunter,survival,18,12,6
Ketaminösa,zuljin,1151,hunter,survival,18,12,6
Wonkeedx,ravencrest,1151,hunter,survival,24,12,12
Ähäkutti,kazzak,1151,hunter,survival,30,12,18
Nkl,archimonde,1150,hunter,survival,24,12,12
Grulog,kazzak,1150,hunter,survival,30,12,18
Rasmi,kazzak,1148,hunter,survival,24,12,12
Lìmpy,stormreaver,1147,hunter,survival,24,12,12
Cira,archimonde,1147,hunter,survival,24,12,12
Rettoo,aszune,1146,hunter,survival,19,12,7
Yake,kazzak,1140,hunter,survival,40,15,25
Gilzog,exodar,1138,hunter,survival,30,12,18
Cabaim,eredar,1137,hunter,survival,18,12,6
Boggy,outland,1137,hunter,survival,24,12,12
Floris,outland,1126,hunter,survival,24,12,12
Cämper,aegwynn,1124,hunter,survival,24,12,12
Absolutnoob,blackrock,1118,hunter,survival,32,17,15
Aszasi,azjolnerub,1096,hunter,survival,23,12,11
Melissax,silvermoon,1095,hunter,survival,34,13,21
Spakker,the-shatar,1094,hunter,survival,28,14,14
Skyyw,tarren-mill,1073,hunter,survival,22,12,10
Guccyfied,blackrock,1056,hunter,survival,18,11,7
Lutza,sanguino,1056,hunter,survival,24,11,13
Shiceloch,blackmoore,1055,hunter,survival,18,11,7
Curbý,blackhand,1055,hunter,survival,18,11,7
Djtrápálót,dragonmaw,1055,hunter,survival,18,11,7
Sunyjuyono,ravencrest,1055,hunter,survival,24,11,13
Killerkatze,outland,1055,hunter,survival,24,11,13
Véncsótány,ragnaros,1054,hunter,survival,18,11,7
Babûsch,blackmoore,1054,hunter,survival,24,11,13
Éddiémórphín,kazzak,1053,hunter,survival,24,11,13
Cataleýà,outland,1052,hunter,survival,18,11,7
Твояпомощь,gordunni,1052,hunter,survival,18,11,7
Skzu,archimonde,1050,hunter,survival,18,11,7
Doru,silvermoon,1025,hunter,survival,24,11,13
Dragonflayer,sylvanas,1021,hunter,survival,18,11,7
Bloodxx,ragnaros,1017,hunter,survival,30,11,19
Voltár,antonidas,1017,hunter,survival,30,11,19
Giobi,draenor,996,hunter,survival,24,13,11
Änubïs,culte-de-la-rive-noire,973,hunter,survival,22,12,10
Reviam,ravencrest,960,hunter,survival,12,10,2
Kukenisluken,stormscale,960,hunter,survival,18,10,8
Islide,ravencrest,960,hunter,survival,24,10,14
Neddly,draenor,960,hunter,survival,24,10,14
Stuckstepbro,silvermoon,960,hunter,survival,24,10,14
Xallis,outland,959,hunter,survival,18,10,8
Iceyx,stormscale,959,hunter,survival,18,10,8
Cadier,argent-dawn,959,hunter,survival,24,10,14
Terrorduni,tarren-mill,959,hunter,survival,24,10,14
Менстряк,deathguard,958,hunter,survival,18,10,8
Смолильщик,gordunni,958,hunter,survival,18,10,8
Amilienne,nozdormu,958,hunter,survival,27,11,16
Галятрицепс,eversong,957,hunter,survival,24,10,14
Mcgloebels,archimonde,956,hunter,survival,21,11,10
Dorota,auchindoun,955,hunter,survival,18,10,8
Binhoker,argent-dawn,953,hunter,survival,12,10,2
Vorsord,zuljin,952,hunter,survival,24,10,14
Айхана,gordunni,951,hunter,survival,18,10,8
Memli,uldaman,950,hunter,survival,18,10,8
Marluxiâ,archimonde,947,hunter,survival,30,11,19
Zipzâp,blackrock,936,hunter,survival,18,10,8
Neilime,marécage-de-zangar,936,hunter,survival,74,33,41
Kürze,silvermoon,926,hunter,survival,16,11,5
Pechvogel,blackmoore,910,hunter,survival,17,10,7
Ирртой,grom,885,hunter,survival,24,10,14
Ðévi,ravencrest,864,hunter,survival,12,9,3
Куджикс,soulflayer,864,hunter,survival,12,9,3
Nttcoopzz,silvermoon,864,hunter,survival,12,9,3
Urrane,archimonde,864,hunter,survival,12,9,3
Bicmex,ravencrest,864,hunter,survival,12,9,3
Nooksem,blackrock,864,hunter,survival,18,9,9
Svinrbglol,arygos,864,hunter,survival,18,9,9
Mileysaures,stormscale,863,hunter,survival,12,9,3
Murkek,drakthul,863,hunter,survival,12,9,3
Natchell,ysondre,863,hunter,survival,18,9,9
Тиометра,gordunni,862,hunter,survival,12,9,3
Вилдфлекс,gordunni,861,hunter,survival,12,9,3
Rollin,khaz-modan,861,hunter,survival,12,9,3
Gakco,twisting-nether,858,hunter,survival,18,9,9
Caelas,outland,858,hunter,survival,18,9,9
Huntoruu,outland,858,hunter,survival,89,37,52
Wôôdsy,blackrock,858,hunter,survival,24,9,15
Норапина,eversong,857,hunter,survival,24,12,12
Бандерака,goldrinn,857,hunter,survival,18,9,9
Ilovejwrld,dun-modr,810,hunter,survival,22,10,12
Drolig,blackmoore,793,hunter,survival,17,9,8
Killdembro,sunstrider,786,hunter,survival,40,9,31
Крысюкпифпаф,blackscar,783,hunter,survival,13,9,4
Poggersdaddy,kazzak,768,hunter,survival,12,8,4
Maiver,ravencrest,768,hunter,survival,12,8,4
Djfortnite,ravencrest,768,hunter,survival,12,8,4
Noop,sylvanas,768,hunter,survival,12,8,4
Velen,pozzo-delleternità,768,hunter,survival,12,8,4
Пьёт,gordunni,768,hunter,survival,18,8,10
Аркеро,soulflayer,768,hunter,survival,18,8,10
Фираналь,blackscar,768,hunter,survival,18,8,10
Jäinenool,outland,768,hunter,survival,18,8,10
Epicsurvive,kazzak,768,hunter,survival,24,8,16
Onefatalshot,the-maelstrom,767,hunter,survival,12,8,4
Тиандриса,soulflayer,767,hunter,survival,12,8,4
Querro,azshara,767,hunter,survival,24,8,16
Harrak,ysondre,761,hunter,survival,12,8,4
Jomoguin,stormscale,761,hunter,survival,24,8,16
Хантероо,gordunni,756,hunter,survival,18,8,10
Powerhord,burning-legion,751,hunter,survival,18,8,10
Оверман,azuregos,735,hunter,survival,26,9,17
Frapt,dalaran,704,hunter,survival,16,8,8
Xelsera,antonidas,672,hunter,survival,12,7,5
Рэдхаант,soulflayer,672,hunter,survival,12,7,5
Amadia,defias-brotherhood,672,hunter,survival,12,7,5
Мигнитюша,blackscar,672,hunter,survival,12,7,5
Глефард,fordragon,672,hunter,survival,12,7,5
Ilovemax,archimonde,672,hunter,survival,12,7,5
Snôptas,blackmoore,672,hunter,survival,12,7,5
Burninghunt,ravencrest,672,hunter,survival,12,7,5
Slizzle,sporeggar,672,hunter,survival,12,7,5
Robinbuds,stormscale,672,hunter,survival,12,7,5
Wórldz,dun-modr,672,hunter,survival,12,7,5
Avashah,ravencrest,672,hunter,survival,16,7,9
Барабаша,deathguard,672,hunter,survival,18,7,11
Fyoni,silvermoon,671,hunter,survival,12,7,5
Raenard,ragnaros,671,hunter,survival,15,8,7
Алестея,gordunni,671,hunter,survival,18,7,11
Blackox,zirkel-des-cenarius,670,hunter,survival,12,7,5
Sasquaczek,burning-legion,670,hunter,survival,12,7,5
Мертвыйпсарь,soulflayer,670,hunter,survival,12,7,5
Szybky,defias-brotherhood,666,hunter,survival,12,7,5
Skyythe,dun-morogh,649,hunter,survival,18,7,11
Marvelmary,ravencrest,639,hunter,survival,17,7,10
Wicmex,archimonde,624,hunter,survival,9,8,1
Bugspitz,outland,622,hunter,survival,11,7,4
Tyrone,saurfang,607,hunter,survival,12,7,5
Animàl,argent-dawn,607,hunter,survival,16,7,9
Iloveluna,silvermoon,576,hunter,survival,6,6,0
Gitanìlla,dun-modr,576,hunter,survival,6,6,0
Haileyjones,darkmoon-faire,576,hunter,survival,6,6,0
Løvebombing,ravencrest,576,hunter,survival,6,6,0
Alissón,aegwynn,576,hunter,survival,6,6,0
Morkahs,dalaran,576,hunter,survival,12,6,6
Snoude,silvermoon,576,hunter,survival,12,6,6
Torelk,dalaran,576,hunter,survival,12,6,6
Nunziatellà,nemesis,576,hunter,survival,12,6,6
Mouganstine,archimonde,576,hunter,survival,12,6,6
Bø,burning-blade,576,hunter,survival,12,6,6
Jamoneame,sanguino,576,hunter,survival,12,6,6
Nirn,ravencrest,576,hunter,survival,12,6,6
Weraxo,ravencrest,576,hunter,survival,12,6,6
Itchy,das-syndikat,576,hunter,survival,12,6,6
Savageone,frostwhisper,576,hunter,survival,12,6,6
Alibigjungle,ravencrest,576,hunter,survival,12,6,6
Maddoqx,frostwolf,576,hunter,survival,12,6,6
Huntanova,antonidas,576,hunter,survival,18,6,12
Хантзер,howling-fjord,576,hunter,survival,18,6,12
Ashendan,silvermoon,576,hunter,survival,18,6,12
Hevl,silvermoon,575,hunter,survival,12,6,6
Junglez,nagrand,575,hunter,survival,12,6,6
Grimazg,chogall,575,hunter,survival,12,6,6
Pãstèque,ravencrest,575,hunter,survival,12,6,6
Thëoden,cthun,575,hunter,survival,12,6,6
Orcpie,defias-brotherhood,575,hunter,survival,12,6,6
Занзуолли,howling-fjord,575,hunter,survival,12,6,6
Nektard,ravencrest,575,hunter,survival,12,6,6
Йеттеринг,deathweaver,575,hunter,survival,15,7,8
Дондонандон,gordunni,575,hunter,survival,18,6,12
Sekkeh,ragnaros,575,hunter,survival,18,6,12
Bôbby,kelthuzad,575,hunter,survival,18,6,12
Amjamh,hyjal,575,hunter,survival,18,6,12
Milandra,the-maelstrom,573,hunter,survival,12,6,6
Vuloshi,twisting-nether,573,hunter,survival,18,6,12
Shanè,blackrock,557,hunter,survival,17,6,11
Mâjôô,blackhand,544,hunter,survival,10,6,4
Боцекабузер,galakrond,543,hunter,survival,11,6,5
Reðrighthånð,throkferoth,528,hunter,survival,9,6,3
Deek,ysera,480,hunter,survival,6,5,1
Röwene,argent-dawn,480,hunter,survival,6,5,1
Sebikh,ravencrest,480,hunter,survival,6,5,1
Mòzetónq,ravencrest,480,hunter,survival,6,5,1
Davidghettô,dalaran,480,hunter,survival,6,5,1
Ватмано,gordunni,480,hunter,survival,6,5,1
Jaggy,hyjal,480,hunter,survival,6,5,1
Musen,draenor,480,hunter,survival,6,5,1
Smellygroin,darksorrow,480,hunter,survival,6,5,1
Glama,archimonde,480,hunter,survival,6,5,1
Vilopez,arthas,480,hunter,survival,6,5,1
Вкинулматрас,gordunni,480,hunter,survival,12,5,7
Agnêas,silvermoon,480,hunter,survival,12,5,7
Yakayoshi,kazzak,480,hunter,survival,12,5,7
Doloresman,tarren-mill,480,hunter,survival,12,5,7
Discoråttan,stormscale,480,hunter,survival,12,5,7
Abeba,grim-batol,480,hunter,survival,12,5,7
Horku,kazzak,480,hunter,survival,12,5,7
Ector,silvermoon,480,hunter,survival,12,5,7
Grusijohn,executus,480,hunter,survival,12,5,7
Unferth,the-venture-co,480,hunter,survival,12,5,7
Coopatron,silvermoon,480,hunter,survival,12,5,7
Løwg,drekthar,480,hunter,survival,12,5,7
Kirax,ravencrest,480,hunter,survival,12,5,7
Moscowmule,tarren-mill,480,hunter,survival,12,5,7
Hunterado,burning-legion,480,hunter,survival,12,5,7
Aequitaz,blackhand,480,hunter,survival,18,5,13
Badboyxoxo,stormscale,479,hunter,survival,6,5,1
Daltyr,ravencrest,479,hunter,survival,12,5,7
Cásper,tarren-mill,479,hunter,survival,18,5,13
Mahemi,mazrigos,478,hunter,survival,24,5,19
Pôîson,kazzak,478,hunter,survival,24,5,19
Bowkeeper,kazzak,471,hunter,survival,18,5,13
Jabela,eredar,447,hunter,survival,11,5,6
Azuren,twisting-nether,430,hunter,survival,11,5,6
Raelaf,zuljin,384,hunter,survival,6,4,2
Gogolehunt,archimonde,384,hunter,survival,6,4,2
Jamboss,twisting-nether,384,hunter,survival,6,4,2
Oldlynx,ravencrest,384,hunter,survival,6,4,2
Dauria,blackhand,384,hunter,survival,6,4,2
Пятницкий,soulflayer,384,hunter,survival,6,4,2
Gharzok,blackrock,384,hunter,survival,6,4,2
Repap,defias-brotherhood,384,hunter,survival,6,4,2
Giggiwho,malganis,384,hunter,survival,6,4,2
Virzion,silvermoon,384,hunter,survival,6,4,2
Youngbepse,blackrock,384,hunter,survival,6,4,2
Shenra,argent-dawn,384,hunter,survival,6,4,2
Nomorex,frostwhisper,384,hunter,survival,6,4,2
Uranîa,blackmoore,384,hunter,survival,6,4,2
Nyxìa,shattered-halls,384,hunter,survival,6,4,2
Luftikuss,arthas,384,hunter,survival,6,4,2
Djøgi,archimonde,384,hunter,survival,6,4,2
Fyrya,ravencrest,384,hunter,survival,6,4,2
Katzila,outland,384,hunter,survival,6,4,2
Оути,azuregos,384,hunter,survival,6,4,2
Xxø,ravencrest,384,hunter,survival,6,4,2
Куфа,blackscar,384,hunter,survival,6,4,2
Mooj,malganis,384,hunter,survival,6,4,2
Ледо,deathguard,384,hunter,survival,6,4,2
Trapandstun,aszune,384,hunter,survival,6,4,2
Renegansnipe,silvermoon,384,hunter,survival,6,4,2
Speartusk,blackhand,384,hunter,survival,6,4,2
Tôm,ravencrest,384,hunter,survival,6,4,2
Trappewpew,blackmoore,384,hunter,survival,6,4,2
Аминотоксид,blackscar,384,hunter,survival,6,4,2
Himpy,twisting-nether,384,hunter,survival,6,4,2
Vádîazmeý,twisting-nether,384,hunter,survival,6,4,2
Gradevine,twisting-nether,384,hunter,survival,6,4,2
Flamehand,kazzak,384,hunter,survival,6,4,2
Dettas,silvermoon,384,hunter,survival,12,4,8
Voldagor,hyjal,384,hunter,survival,12,4,8
Wärft,arathi,384,hunter,survival,12,4,8
Clicktrap,runetotem,384,hunter,survival,12,4,8
Eâgleêyê,frostwolf,384,hunter,survival,12,4,8
Abgeherjoe,antonidas,384,hunter,survival,12,4,8
Фурболгов,gordunni,384,hunter,survival,12,4,8
Тэуреэль,gordunni,384,hunter,survival,12,4,8
Fiskerr,darksorrow,384,hunter,survival,12,4,8
Sharpeyezz,ravencrest,384,hunter,survival,12,4,8
Skumrask,outland,384,hunter,survival,12,4,8
Magicnanø,nemesis,384,hunter,survival,12,4,8
Waziralwazar,auchindoun,384,hunter,survival,12,4,8
Beaststeaks,thrall,384,hunter,survival,12,4,8
Salie,argent-dawn,384,hunter,survival,12,4,8
Fíwhale,tarren-mill,384,hunter,survival,12,4,8
Eledanu,blackmoore,383,hunter,survival,6,4,2
Døømslayer,nemesis,383,hunter,survival,6,4,2
Bâng,zuljin,383,hunter,survival,12,4,8
Одисенс,eversong,383,hunter,survival,12,4,8
Platza,ragnaros,383,hunter,survival,12,4,8
Hanibale,burning-blade,382,hunter,survival,18,4,14
Thëhunter,tyrande,367,hunter,survival,11,4,7
Ghob,kazzak,330,hunter,survival,8,5,3
Xexhel,twisting-nether,330,hunter,survival,10,5,5
Clydefrog,outland,320,hunter,survival,16,4,12
Sùnzí,alakir,319,hunter,survival,6,4,2
Simppeli,sylvanas,288,hunter,survival,6,3,3
Faccacamoale,twisting-nether,288,hunter,survival,6,3,3
Crispystix,draenor,288,hunter,survival,6,3,3
Hühneknubbel,blackmoore,288,hunter,survival,6,3,3
Eazzyy,auchindoun,288,hunter,survival,6,3,3
Schwabbels,silvermoon,288,hunter,survival,6,3,3
Arrowknee,outland,288,hunter,survival,6,3,3
Hræsvëlg,archimonde,288,hunter,survival,6,3,3
Helvetiya,sylvanas,288,hunter,survival,6,3,3
Himatoumi,elune,288,hunter,survival,6,3,3
Prinzz,blackmoore,288,hunter,survival,6,3,3
Jayquillen,sylvanas,288,hunter,survival,6,3,3
Goblinstyle,kazzak,288,hunter,survival,6,3,3
Sworra,silvermoon,288,hunter,survival,6,3,3
Natheldir,silvermoon,288,hunter,survival,6,3,3
Паркх,soulflayer,288,hunter,survival,6,3,3
Kleiar,dun-modr,288,hunter,survival,6,3,3
Lightxyz,ravencrest,288,hunter,survival,6,3,3
Nobuno,dun-modr,288,hunter,survival,6,3,3
Spakster,blackrock,288,hunter,survival,6,3,3
Jäegarn,ravencrest,288,hunter,survival,6,3,3
Oneeyedjoe,the-maelstrom,288,hunter,survival,6,3,3
Assaultrifle,frostmane,288,hunter,survival,6,3,3
Engetsu,drakthul,288,hunter,survival,6,3,3
Ремонтлицаа,gordunni,288,hunter,survival,6,3,3
Rákthar,blackmoore,288,hunter,survival,6,3,3
Deskö,shendralar,288,hunter,survival,6,3,3
Unöhänä,archimonde,288,hunter,survival,6,3,3
Крэин,howling-fjord,288,hunter,survival,6,3,3
Aidsmacka,shattered-hand,288,hunter,survival,6,3,3
Bicmeks,ravencrest,288,hunter,survival,6,3,3
Jorhan,ravencrest,288,hunter,survival,6,3,3
Aleenya,dalaran,288,hunter,survival,12,3,9
Сногивкабину,soulflayer,288,hunter,survival,12,3,9
Nestór,todeswache,288,hunter,survival,12,3,9
Satantrapbot,outland,288,hunter,survival,12,3,9
Шмалетар,gordunni,288,hunter,survival,12,3,9
Bláckthorn,ravencrest,288,hunter,survival,12,3,9
Lezigoulleur,marécage-de-zangar,287,hunter,survival,6,3,3
Charlet,archimonde,287,hunter,survival,6,3,3
Twinkhunter,pozzo-delleternità,256,hunter,survival,10,3,7
Санясурв,gordunni,239,hunter,survival,10,6,4
Axiøs,thrall,239,hunter,survival,5,3,2
Sizemattersx,kazzak,239,hunter,survival,11,3,8
Хантвкроксах,gordunni,208,hunter,survival,7,3,4
Xamisch,eredar,192,hunter,survival,4,3,1
Steffxd,twisting-nether,192,hunter,survival,6,2,4
Ammò,kazzak,192,hunter,survival,6,2,4
Gynax,hyjal,192,hunter,survival,6,2,4
Ilòóll,veknilash,192,hunter,survival,6,2,4
Beletor,medivh,192,hunter,survival,6,2,4
Robosexual,ravencrest,192,hunter,survival,6,2,4
Daarkkhunter,twisting-nether,192,hunter,survival,6,2,4
Valtondre,argent-dawn,192,hunter,survival,6,2,4
Epicsurvive,ravencrest,192,hunter,survival,6,2,4
Bigmøist,ravencrest,192,hunter,survival,6,2,4
Eromoar,outland,192,hunter,survival,6,2,4
Sakaryali,silvermoon,192,hunter,survival,6,2,4
Jarekk,auchindoun,192,hunter,survival,6,2,4
Yezzu,sylvanas,192,hunter,survival,6,2,4
Esperion,ragnaros,192,hunter,survival,6,2,4
Grundibg,chamber-of-aspects,192,hunter,survival,6,2,4
Bùddhíst,ravencrest,192,hunter,survival,6,2,4
Evazeonhunt,antonidas,192,hunter,survival,6,2,4
Zøøkëëper,silvermoon,192,hunter,survival,6,2,4
Hunttes,nagrand,192,hunter,survival,6,2,4
Adram,burning-legion,192,hunter,survival,6,2,4
Aggrobatics,blackmoore,192,hunter,survival,6,2,4
Abeji,malygos,192,hunter,survival,6,2,4
Mufassa,sinstralis,192,hunter,survival,6,2,4
Roscke,drakthul,192,hunter,survival,6,2,4
Djsecousse,hyjal,192,hunter,survival,6,2,4
Dedral,aegwynn,192,hunter,survival,6,2,4
Vasco,chogall,192,hunter,survival,6,2,4
Gerzyy,drakthul,192,hunter,survival,6,2,4
Tdapills,sanguino,192,hunter,survival,6,2,4
Jailevaccin,khaz-modan,192,hunter,survival,6,2,4
Draugrinnh,tarren-mill,192,hunter,survival,6,2,4
Flexifys,tarren-mill,192,hunter,survival,6,2,4
Rølyn,hyjal,192,hunter,survival,6,2,4
Brindefolìe,archimonde,192,hunter,survival,6,2,4
Whyareurunin,silvermoon,192,hunter,survival,6,2,4
Неужто,deathguard,192,hunter,survival,6,2,4
Наладдчик,howling-fjord,192,hunter,survival,6,2,4
Regale,archimonde,192,hunter,survival,6,2,4
Васябицепс,howling-fjord,192,hunter,survival,6,2,4
Trabucones,sanguino,192,hunter,survival,6,2,4
Lithell,kazzak,192,hunter,survival,6,2,4
Coromant,blackrock,192,hunter,survival,8,2,6
Skewdar,hyjal,192,hunter,survival,12,2,10
Haskeer,shattrath,192,hunter,survival,12,2,10
Yinn,kilrogg,192,hunter,survival,12,2,10
Réja,norgannon,192,hunter,survival,12,2,10
Ecthelione,the-venture-co,192,hunter,survival,12,2,10
Akibane,blackmoore,159,hunter,survival,8,3,5
Rdwlf,draenor,138,hunter,survival,8,3,5
Aimywinehaus,drakthul,96,hunter,survival,6,1,5
Enistee,silvermoon,96,hunter,survival,6,1,5
Supcuz,stormscale,96,hunter,survival,6,1,5
Дэнитрехо,soulflayer,96,hunter,survival,6,1,5
Zynga,sylvanas,96,hunter,survival,6,1,5
Эвилтар,soulflayer,96,hunter,survival,6,1,5
Panzershot,hyjal,96,hunter,survival,6,1,5
Fantus,sylvanas,96,hunter,survival,6,1,5
Серомиг,eversong,96,hunter,survival,6,1,5
Brattamer,twisting-nether,96,hunter,survival,6,1,5
Grollar,ragnaros,96,hunter,survival,6,1,5
Куоль,gordunni,96,hunter,survival,6,1,5
Cryts,dun-modr,96,hunter,survival,6,1,5
Katzchen,burning-legion,96,hunter,survival,6,1,5
Shanndu,ravencrest,96,hunter,survival,6,1,5
Leaxs,onyxia,96,hunter,survival,6,1,5
Ryztik,garona,96,hunter,survival,6,1,5
Keinzira,hyjal,96,hunter,survival,6,1,5
Escaflôwn,aegwynn,96,hunter,survival,6,1,5
Zárnah,defias-brotherhood,96,hunter,survival,6,1,5
Zuggi,defias-brotherhood,96,hunter,survival,6,1,5
Saksa,blackrock,96,hunter,survival,6,1,5
Рангмар,howling-fjord,79,hunter,survival,5,1,4
Jacobszy,outland,63,hunter,survival,2,2,0
Velrhegal,tarren-mill,16,hunter,survival,7,1,6
Mariabanks,aegwynn,2278,hunter,beastmastery,222,118,104
Brokeasalwys,ravencrest,2164,hunter,beastmastery,84,46,38
Cbã,ravencrest,2156,hunter,beastmastery,60,32,28
Hypse,kazzak,2144,hunter,beastmastery,244,120,124
Plugonbaby,hyjal,2035,hunter,beastmastery,77,37,40
Берх,gordunni,2032,hunter,beastmastery,112,56,56
Kfcmanagerx,silvermoon,2024,hunter,beastmastery,90,42,48
Esperion,ragnaros,2012,hunter,beastmastery,120,57,63
Тружка,soulflayer,2000,hunter,beastmastery,96,44,52
Baltímore,stormscale,1983,hunter,beastmastery,59,28,31
Gernoqz,frostwolf,1973,hunter,beastmastery,107,51,56
Eldrekou,kazzak,1968,hunter,beastmastery,72,41,31
Feevah,frostmane,1947,hunter,beastmastery,272,137,135
Zyphx,der-rat-von-dalaran,1936,hunter,beastmastery,102,46,56
Truejkee,silvermoon,1929,hunter,beastmastery,101,51,50
Куфа,blackscar,1909,hunter,beastmastery,36,20,16
Aimshots,twisting-nether,1906,hunter,beastmastery,66,36,30
Libanais,archimonde,1905,hunter,beastmastery,251,119,132
Thing,kazzak,1900,hunter,beastmastery,36,21,15
Eazzyy,auchindoun,1895,hunter,beastmastery,78,42,36
Trapgoddxx,archimonde,1894,hunter,beastmastery,65,44,21
Биско,gordunni,1890,hunter,beastmastery,80,40,40
Manj,blackhand,1888,hunter,beastmastery,54,29,25
Tagz,ravencrest,1887,hunter,beastmastery,60,29,31
Ynv,argent-dawn,1885,hunter,beastmastery,74,37,37
Odeôn,twisting-nether,1884,hunter,beastmastery,59,24,35
Blackszpak,jaedenar,1876,hunter,beastmastery,42,23,19
Дианнесса,howling-fjord,1876,hunter,beastmastery,77,38,39
Dogetrainer,silvermoon,1875,hunter,beastmastery,108,58,50
Jambomambo,twisting-nether,1873,hunter,beastmastery,54,26,28
Phesx,sylvanas,1865,hunter,beastmastery,54,27,27
Ígrågøßñø,silvermoon,1864,hunter,beastmastery,44,30,14
Twineyes,ravencrest,1864,hunter,beastmastery,88,44,44
Breezme,twisting-nether,1864,hunter,beastmastery,72,33,39
Hanuong,ragnaros,1862,hunter,beastmastery,36,20,16
Moscowmule,tarren-mill,1859,hunter,beastmastery,59,29,30
Fãdê,ravencrest,1858,hunter,beastmastery,42,30,12
Krampack,dun-modr,1858,hunter,beastmastery,54,31,23
Draxil,archimonde,1855,hunter,beastmastery,54,24,30
Найстити,deathguard,1854,hunter,beastmastery,66,31,35
Doghxnter,ravencrest,1853,hunter,beastmastery,42,21,21
Sipsomewater,ravencrest,1852,hunter,beastmastery,57,30,27
Nexztwo,blackrock,1852,hunter,beastmastery,69,33,36
Jägarnmt,twisting-nether,1848,hunter,beastmastery,77,33,44
Âmalphy,ravencrest,1846,hunter,beastmastery,47,23,24
Safnirx,tarren-mill,1845,hunter,beastmastery,66,27,39
Онкьяр,gordunni,1844,hunter,beastmastery,51,28,23
Колякилшот,gordunni,1844,hunter,beastmastery,60,29,31
Nyzuri,die-aldor,1843,hunter,beastmastery,54,26,28
Luzivarus,malganis,1842,hunter,beastmastery,59,29,30
Wilfyre,twisting-nether,1840,hunter,beastmastery,75,36,39
Thogel,hyjal,1838,hunter,beastmastery,72,33,39
Miløø,silvermoon,1835,hunter,beastmastery,48,26,22
Gaeln,outland,1833,hunter,beastmastery,144,70,74
Rákthar,blackmoore,1832,hunter,beastmastery,66,32,34
Гринмех,gordunni,1831,hunter,beastmastery,60,31,29
Orcji,blackhand,1827,hunter,beastmastery,83,42,41
Qtìp,aegwynn,1826,hunter,beastmastery,71,34,37
Bilbohunter,draenor,1825,hunter,beastmastery,48,27,21
Горгонт,blackscar,1825,hunter,beastmastery,47,25,22
Burninghunt,ravencrest,1822,hunter,beastmastery,60,32,28
Dìgítal,twisting-nether,1821,hunter,beastmastery,42,25,17
Wêskêr,tarren-mill,1821,hunter,beastmastery,66,31,35
Куроните,howling-fjord,1820,hunter,beastmastery,48,27,21
Sukzess,antonidas,1818,hunter,beastmastery,54,27,27
Bíllybobbs,argent-dawn,1815,hunter,beastmastery,36,19,17
Ooh,doomhammer,1815,hunter,beastmastery,120,56,64
Jabela,eredar,1814,hunter,beastmastery,53,39,14
Kachaxa,kazzak,1812,hunter,beastmastery,64,30,34
Rndhunt,shattrath,1811,hunter,beastmastery,60,30,30
Марчик,blackscar,1810,hunter,beastmastery,42,19,23
Лесбиянюсь,gordunni,1808,hunter,beastmastery,48,36,12
Corossity,blackmoore,1808,hunter,beastmastery,30,19,11
Silverwolfa,dun-modr,1808,hunter,beastmastery,51,29,22
Hiddenx,blackmoore,1808,hunter,beastmastery,42,21,21
Trend,silvermoon,1808,hunter,beastmastery,48,23,25
Поппишот,blackscar,1806,hunter,beastmastery,36,19,17
Цитрукс,gordunni,1806,hunter,beastmastery,90,47,43
Huntchonk,kazzak,1806,hunter,beastmastery,53,27,26
Пивопьюня,ashenvale,1805,hunter,beastmastery,53,27,26
Lysanhunt,zuljin,1804,hunter,beastmastery,54,27,27
Crippa,tarren-mill,1803,hunter,beastmastery,54,28,26
Dafhel,hyjal,1801,hunter,beastmastery,65,30,35
Jàsøn,ravencrest,1801,hunter,beastmastery,66,29,37
Izmad,archimonde,1796,hunter,beastmastery,245,138,107
Fluphy,thrall,1794,hunter,beastmastery,70,41,29
Easyclass,hyjal,1789,hunter,beastmastery,120,70,50
Wodhunterxdd,outland,1788,hunter,beastmastery,53,25,28
Вождь,howling-fjord,1787,hunter,beastmastery,53,27,26
Appirc,tarren-mill,1785,hunter,beastmastery,48,24,24
Wîldhunt,burning-legion,1781,hunter,beastmastery,161,76,85
Alpharaven,ravencrest,1779,hunter,beastmastery,54,29,25
Мориартис,ashenvale,1778,hunter,beastmastery,65,35,30
Jamesyy,ravencrest,1776,hunter,beastmastery,60,28,32
Babýrage,twisting-nether,1774,hunter,beastmastery,42,21,21
Gucçi,kazzak,1769,hunter,beastmastery,68,39,29
Erethrus,ravencrest,1769,hunter,beastmastery,48,19,29
Amyndôr,ravencrest,1767,hunter,beastmastery,48,27,21
Séyena,outland,1764,hunter,beastmastery,42,19,23
Fullxtrap,hyjal,1763,hunter,beastmastery,41,19,22
Jamzyhunter,emerald-dream,1762,hunter,beastmastery,48,24,24
Nystaleoss,grim-batol,1759,hunter,beastmastery,130,62,68
Nimhunt,dentarg,1759,hunter,beastmastery,65,29,36
Futureman,blackrock,1758,hunter,beastmastery,54,31,23
Порошокк,gordunni,1756,hunter,beastmastery,69,29,40
Мэлвиса,borean-tundra,1754,hunter,beastmastery,90,50,40
Priceqtxd,ravencrest,1752,hunter,beastmastery,97,60,37
Ilovemax,archimonde,1750,hunter,beastmastery,46,20,26
Mekerosh,burning-legion,1749,hunter,beastmastery,46,23,23
Ðéadsøulz,stormscale,1746,hunter,beastmastery,111,62,49
Фираналь,blackscar,1743,hunter,beastmastery,69,35,34
Expiraa,twisting-nether,1742,hunter,beastmastery,48,25,23
Åsynåmvp,twisting-nether,1742,hunter,beastmastery,65,29,36
Carioca,blackhand,1741,hunter,beastmastery,66,30,36
Pewpewshotz,stormscale,1740,hunter,beastmastery,60,32,28
Treaz,sanguino,1739,hunter,beastmastery,66,33,33
Tyranski,ravencrest,1738,hunter,beastmastery,75,40,35
Saggymilkies,outland,1735,hunter,beastmastery,54,23,31
Hawkeyé,forscherliga,1734,hunter,beastmastery,47,19,28
Nèxz,blackrock,1732,hunter,beastmastery,77,33,44
Играсломана,howling-fjord,1730,hunter,beastmastery,48,30,18
Valkrys,die-aldor,1726,hunter,beastmastery,64,32,32
Duppdupp,eredar,1726,hunter,beastmastery,84,38,46
Nolove,burning-legion,1725,hunter,beastmastery,54,31,23
Triggaz,stormscale,1721,hunter,beastmastery,186,95,91
Mtrider,twisting-nether,1721,hunter,beastmastery,105,50,55
Эвилтар,soulflayer,1715,hunter,beastmastery,48,29,19
Дашатрирубля,soulflayer,1715,hunter,beastmastery,42,21,21
Noversia,aegwynn,1714,hunter,beastmastery,71,33,38
Jägarntwo,stormscale,1710,hunter,beastmastery,51,20,31
Mogwai,stormscale,1709,hunter,beastmastery,42,18,24
Omegakek,madmortem,1707,hunter,beastmastery,46,23,23
Vajraw,blackrock,1707,hunter,beastmastery,42,20,22
Bebar,kazzak,1705,hunter,beastmastery,66,37,29
Impxgodx,outland,1704,hunter,beastmastery,51,24,27
Shinkichi,archimonde,1699,hunter,beastmastery,30,18,12
Elamondria,outland,1699,hunter,beastmastery,72,42,30
Sznxøxo,ravencrest,1699,hunter,beastmastery,54,29,25
Irefutabilâ,outland,1696,hunter,beastmastery,96,43,53
Samanou,kazzak,1695,hunter,beastmastery,64,25,39
Bebiyo,sanguino,1694,hunter,beastmastery,40,23,17
Merquryh,ravencrest,1693,hunter,beastmastery,48,27,21
Krix,ragnaros,1691,hunter,beastmastery,54,34,20
Экономист,fordragon,1691,hunter,beastmastery,42,24,18
Пихпахах,gordunni,1691,hunter,beastmastery,82,43,39
Paimen,darksorrow,1690,hunter,beastmastery,96,54,42
Fize,blackmoore,1690,hunter,beastmastery,65,30,35
Shroomynuts,kazzak,1689,hunter,beastmastery,90,52,38
Pawzz,kazzak,1687,hunter,beastmastery,54,25,29
Akaris,archimonde,1686,hunter,beastmastery,54,27,27
Letsrock,outland,1682,hunter,beastmastery,33,20,13
Bynen,tarren-mill,1682,hunter,beastmastery,59,26,33
Скадхи,blackscar,1681,hunter,beastmastery,46,23,23
Шергала,soulflayer,1681,hunter,beastmastery,149,68,81
Nestór,todeswache,1678,hunter,beastmastery,47,28,19
Sïmc,archimonde,1678,hunter,beastmastery,102,55,47
Erilis,twisting-nether,1676,hunter,beastmastery,37,22,15
Отерон,gordunni,1676,hunter,beastmastery,128,74,54
Трапгодикс,eversong,1674,hunter,beastmastery,126,66,60
Roarmantic,blackrock,1672,hunter,beastmastery,42,19,23
Hlogic,tarren-mill,1672,hunter,beastmastery,84,33,51
Забзаб,soulflayer,1671,hunter,beastmastery,51,25,26
Father,auchindoun,1670,hunter,beastmastery,77,39,38
Ixix,blackhand,1669,hunter,beastmastery,36,19,17
Techpøint,silvermoon,1669,hunter,beastmastery,35,18,17
Unßørn,archimonde,1669,hunter,beastmastery,66,25,41
Kamar,archimonde,1665,hunter,beastmastery,60,39,21
Lowfet,neptulon,1665,hunter,beastmastery,66,42,24
Dréws,kazzak,1665,hunter,beastmastery,40,18,22
Grynu,kazzak,1662,hunter,beastmastery,60,24,36
Trenesta,tarren-mill,1659,hunter,beastmastery,34,18,16
Pérnix,tarren-mill,1657,hunter,beastmastery,30,18,12
Idtrapthat,nagrand,1657,hunter,beastmastery,54,25,29
Klausmanne,blackrock,1657,hunter,beastmastery,164,75,89
Scrubbi,destromath,1656,hunter,beastmastery,39,19,20
Zanpa,archimonde,1656,hunter,beastmastery,68,29,39
Irefutabil,stormscale,1656,hunter,beastmastery,54,22,32
Cnby,stormscale,1652,hunter,beastmastery,43,26,17
Røzy,twisting-nether,1647,hunter,beastmastery,48,35,13
Parhainkoira,argent-dawn,1647,hunter,beastmastery,42,25,17
Oldcocknbals,silvermoon,1645,hunter,beastmastery,100,54,46
Povish,twisting-nether,1644,hunter,beastmastery,43,23,20
Nîøssx,blackrock,1644,hunter,beastmastery,53,28,25
Raindra,twisting-nether,1643,hunter,beastmastery,36,18,18
Ericspet,stormscale,1641,hunter,beastmastery,36,24,12
Astari,outland,1641,hunter,beastmastery,48,21,27
Eaglexx,twisting-nether,1638,hunter,beastmastery,72,37,35
Drøøðqt,blackrock,1637,hunter,beastmastery,60,31,29
Janko,ravencrest,1637,hunter,beastmastery,192,99,93
Horhyndan,ragnaros,1631,hunter,beastmastery,51,24,27
Xiioo,ravencrest,1631,hunter,beastmastery,65,29,36
Imcuteandfun,ravencrest,1630,hunter,beastmastery,60,24,36
Lofiel,blackrock,1628,hunter,beastmastery,53,27,26
Ataxyz,draenor,1627,hunter,beastmastery,36,17,19
Рагнарианх,gordunni,1627,hunter,beastmastery,75,30,45
Eggcowmeow,azjolnerub,1626,hunter,beastmastery,42,22,20
Порошокк,howling-fjord,1625,hunter,beastmastery,30,17,13
Дэнвин,deathweaver,1625,hunter,beastmastery,42,22,20
Gibiswag,outland,1625,hunter,beastmastery,36,17,19
Uglybaboon,draenor,1625,hunter,beastmastery,42,17,25
Lambo,laughing-skull,1624,hunter,beastmastery,36,17,19
Sicktrapbtw,hyjal,1624,hunter,beastmastery,42,17,25
Sníper,aggra-português,1621,hunter,beastmastery,50,28,22
Índigo,kazzak,1620,hunter,beastmastery,56,30,26
Vezeka,ravencrest,1618,hunter,beastmastery,42,26,16
Pfizershotx,khaz-modan,1617,hunter,beastmastery,36,17,19
Notdilly,varimathras,1617,hunter,beastmastery,48,20,28
Ганидони,soulflayer,1616,hunter,beastmastery,59,23,36
Diapositiv,draenor,1613,hunter,beastmastery,54,31,23
Missmytraps,ravencrest,1613,hunter,beastmastery,39,20,19
Лордсахарок,gordunni,1612,hunter,beastmastery,56,21,35
Aroeris,ravencrest,1611,hunter,beastmastery,57,32,25
Pekaxôxô,sanguino,1609,hunter,beastmastery,48,34,14
Nordafrøst,antonidas,1609,hunter,beastmastery,66,27,39
Lobo,kazzak,1608,hunter,beastmastery,54,19,35
Taoshii,die-aldor,1604,hunter,beastmastery,66,36,30
Céah,blackrock,1604,hunter,beastmastery,54,28,26
Chasseurcool,argent-dawn,1603,hunter,beastmastery,50,28,22
Bànsundara,hyjal,1603,hunter,beastmastery,97,53,44
Pluttbug,xavius,1602,hunter,beastmastery,32,19,13
Sparcùs,stormreaver,1602,hunter,beastmastery,68,36,32
Оути,azuregos,1601,hunter,beastmastery,51,28,23
Brisbya,khaz-modan,1600,hunter,beastmastery,29,21,8
Stickey,antonidas,1600,hunter,beastmastery,66,34,32
Moistmán,kazzak,1594,hunter,beastmastery,68,34,34
Poupoune,uldum,1593,hunter,beastmastery,36,17,19
Huntma,kazzak,1592,hunter,beastmastery,30,19,11
Memehunter,aegwynn,1591,hunter,beastmastery,66,41,25
Búddhá,stormscale,1591,hunter,beastmastery,174,83,91
Зоотян,gordunni,1589,hunter,beastmastery,111,55,56
Nottberozz,silvermoon,1589,hunter,beastmastery,122,59,63
Mânhunt,blackhand,1589,hunter,beastmastery,270,129,141
Eagletalon,twisting-nether,1588,hunter,beastmastery,42,21,21
Fanjah,sylvanas,1586,hunter,beastmastery,33,18,15
Каоссхант,howling-fjord,1585,hunter,beastmastery,29,20,9
Xxiioo,ravencrest,1583,hunter,beastmastery,79,46,33
Coldmonster,tarren-mill,1583,hunter,beastmastery,131,76,55
Тиблэк,soulflayer,1579,hunter,beastmastery,101,51,50
Næmes,hyjal,1576,hunter,beastmastery,36,18,18
Traplørdx,sylvanas,1576,hunter,beastmastery,42,18,24
Hacz,bronzebeard,1575,hunter,beastmastery,60,22,38
Grusijohn,executus,1573,hunter,beastmastery,66,33,33
Леао,howling-fjord,1571,hunter,beastmastery,45,30,15
Мунлэс,lich-king,1569,hunter,beastmastery,69,30,39
Комомура,soulflayer,1568,hunter,beastmastery,53,24,29
Sagethunt,blackrock,1565,hunter,beastmastery,41,17,24
Ariabeast,archimonde,1564,hunter,beastmastery,36,17,19
Жокра,greymane,1557,hunter,beastmastery,42,19,23
Søuïlløn,archimonde,1553,hunter,beastmastery,48,30,18
Gunde,kazzak,1551,hunter,beastmastery,102,52,50
Gedzer,silvermoon,1547,hunter,beastmastery,40,19,21
Zuxz,blackmoore,1546,hunter,beastmastery,42,18,24
Пулявзубах,gordunni,1544,hunter,beastmastery,92,49,43
Кразайс,ashenvale,1542,hunter,beastmastery,44,18,26
Nickyhunt,stormscale,1539,hunter,beastmastery,47,22,25
Антисерт,ashenvale,1538,hunter,beastmastery,70,33,37
Snipertjuh,silvermoon,1537,hunter,beastmastery,55,27,28
Arcø,dun-modr,1535,hunter,beastmastery,30,16,14
Hultasy,outland,1535,hunter,beastmastery,122,58,64
Corrupth,outland,1533,hunter,beastmastery,30,17,13
Bortian,argent-dawn,1532,hunter,beastmastery,49,29,20
Jêsslíne,ravencrest,1532,hunter,beastmastery,30,16,14
Sonìc,kazzak,1531,hunter,beastmastery,44,25,19
Jeeso,baelgun,1530,hunter,beastmastery,106,48,58
Tayaa,draenor,1528,hunter,beastmastery,91,47,44
Feralhound,exodar,1528,hunter,beastmastery,72,34,38
Almogrote,sanguino,1526,hunter,beastmastery,42,21,21
Nkdchef,outland,1526,hunter,beastmastery,36,17,19
Vaelyste,doomhammer,1524,hunter,beastmastery,59,31,28
Sarrow,ravencrest,1523,hunter,beastmastery,77,41,36
Eufumo,sanguino,1521,hunter,beastmastery,58,36,22
Liquidhunter,quelthalas,1520,hunter,beastmastery,24,16,8
Palaur,kazzak,1519,hunter,beastmastery,94,50,44
Ryuwen,dun-modr,1517,hunter,beastmastery,60,28,32
Haltrâdar,archimonde,1511,hunter,beastmastery,33,17,16
Draugrinnh,tarren-mill,1511,hunter,beastmastery,66,29,37
Córelly,outland,1510,hunter,beastmastery,55,24,31
Kafkules,outland,1507,hunter,beastmastery,83,44,39
Sharún,sylvanas,1507,hunter,beastmastery,39,17,22
Icetrapped,eredar,1502,hunter,beastmastery,41,25,16
Leriath,shadowsong,1502,hunter,beastmastery,89,52,37
Druckwelle,frostwolf,1502,hunter,beastmastery,62,25,37
Hîldegard,todeswache,1499,hunter,beastmastery,36,16,20
Slmao,tarren-mill,1497,hunter,beastmastery,36,16,20
Gumm,gorgonnash,1496,hunter,beastmastery,30,17,13
Funkalation,ravencrest,1495,hunter,beastmastery,36,20,16
Laoriane,hyjal,1489,hunter,beastmastery,51,28,23
Nallepuuoh,outland,1487,hunter,beastmastery,63,30,33
Трэйсх,howling-fjord,1487,hunter,beastmastery,36,17,19
Снюсинка,gordunni,1485,hunter,beastmastery,41,21,20
Ahlgood,stormscale,1484,hunter,beastmastery,30,16,14
Аллони,booty-bay,1484,hunter,beastmastery,108,50,58
Гигапупсх,howling-fjord,1482,hunter,beastmastery,54,30,24
Askaway,sylvanas,1481,hunter,beastmastery,24,16,8
Gnouminøu,archimonde,1479,hunter,beastmastery,85,45,40
Шэйдуокер,gordunni,1479,hunter,beastmastery,158,78,80
Mariehunt,blackmoore,1472,hunter,beastmastery,78,38,40
Wingclip,ravencrest,1472,hunter,beastmastery,40,17,23
Bastianapa,twisting-nether,1471,hunter,beastmastery,66,31,35
Aenina,kazzak,1466,hunter,beastmastery,30,19,11
Trapzila,aggra-português,1466,hunter,beastmastery,42,21,21
Råhl,zuljin,1466,hunter,beastmastery,41,17,24
Baileé,onyxia,1464,hunter,beastmastery,50,30,20
Oldbear,frostmane,1463,hunter,beastmastery,22,16,6
Куоль,gordunni,1463,hunter,beastmastery,47,21,26
Jas,kargath,1462,hunter,beastmastery,54,30,24
Xüscha,ysera,1459,hunter,beastmastery,66,29,37
Ázurâ,blackhand,1458,hunter,beastmastery,75,39,36
Yoggys,outland,1451,hunter,beastmastery,36,18,18
Shawnrai,drakthul,1449,hunter,beastmastery,44,24,20
Rynx,hellfire,1446,hunter,beastmastery,42,16,26
Drigs,blackrock,1444,hunter,beastmastery,35,18,17
Ayyubi,blackrock,1440,hunter,beastmastery,65,33,32
Маунтдроп,gordunni,1439,hunter,beastmastery,79,42,37
Ilovekatsu,archimonde,1437,hunter,beastmastery,24,15,9
Vrikenh,tarren-mill,1436,hunter,beastmastery,26,18,8
Яроняютрапу,gordunni,1436,hunter,beastmastery,30,20,10
Каосси,gordunni,1436,hunter,beastmastery,38,17,21
Vinsanity,dunemaul,1436,hunter,beastmastery,36,15,21
Mágaz,draenor,1435,hunter,beastmastery,48,26,22
Zäyk,zuljin,1432,hunter,beastmastery,31,17,14
Orcoro,ysondre,1432,hunter,beastmastery,115,51,64
Tukene,kazzak,1432,hunter,beastmastery,45,17,28
Shoranon,stormscale,1431,hunter,beastmastery,30,15,15
Rdom,stormreaver,1431,hunter,beastmastery,74,36,38
Badkirves,kazzak,1430,hunter,beastmastery,78,35,43
Tåxi,silvermoon,1429,hunter,beastmastery,90,46,44
Khatia,blackrock,1429,hunter,beastmastery,36,18,18
Dzikapumpa,burning-legion,1429,hunter,beastmastery,39,18,21
Jomerin,thrall,1429,hunter,beastmastery,36,15,21
Афонадзе,gordunni,1428,hunter,beastmastery,66,33,33
Anjeschka,nemesis,1427,hunter,beastmastery,40,24,16
Gondoo,tarren-mill,1427,hunter,beastmastery,30,15,15
Ххун,gordunni,1426,hunter,beastmastery,34,18,16
Fåded,ravencrest,1425,hunter,beastmastery,31,16,15
Ingvi,antonidas,1425,hunter,beastmastery,36,15,21
Qmbonboni,ravencrest,1423,hunter,beastmastery,46,30,16
Anca,aegwynn,1422,hunter,beastmastery,78,36,42
Metalmaison,archimonde,1422,hunter,beastmastery,76,33,43
Rhee,the-maelstrom,1421,hunter,beastmastery,90,39,51
Waalth,ragnaros,1420,hunter,beastmastery,72,34,38
Jarekk,auchindoun,1417,hunter,beastmastery,35,19,16
Traktorr,stormscale,1413,hunter,beastmastery,48,24,24
Kalt,twisting-nether,1412,hunter,beastmastery,54,30,24
Velocity,nagrand,1411,hunter,beastmastery,41,19,22
Reptile,outland,1410,hunter,beastmastery,24,15,9
Cubro,sanguino,1409,hunter,beastmastery,36,16,20
Unrealy,grim-batol,1406,hunter,beastmastery,96,53,43
Толяарканшот,razuvious,1405,hunter,beastmastery,24,15,9
Neíth,the-maelstrom,1405,hunter,beastmastery,42,17,25
Mytown,hyjal,1403,hunter,beastmastery,84,40,44
Avatarofwoe,blackmoore,1402,hunter,beastmastery,36,15,21
Váal,dun-modr,1401,hunter,beastmastery,63,36,27
Rushgarroth,ravencrest,1401,hunter,beastmastery,66,33,33
Камшотовна,blackscar,1400,hunter,beastmastery,51,31,20
Kethos,draenor,1399,hunter,beastmastery,24,15,9
Dramin,defias-brotherhood,1399,hunter,beastmastery,168,90,78
Phinecone,stormscale,1399,hunter,beastmastery,42,18,24
Бубунн,howling-fjord,1394,hunter,beastmastery,96,42,54
Xystîco,thrall,1393,hunter,beastmastery,54,26,28
Desow,blackrock,1390,hunter,beastmastery,42,25,17
Афигеннски,ashenvale,1387,hunter,beastmastery,54,25,29
Acmé,kazzak,1385,hunter,beastmastery,36,15,21
Felorya,kazzak,1383,hunter,beastmastery,30,18,12
Hammertime,sanguino,1382,hunter,beastmastery,53,26,27
Metsänmies,defias-brotherhood,1381,hunter,beastmastery,29,19,10
Pammycakes,bronze-dragonflight,1381,hunter,beastmastery,135,68,67
Drestan,drakthul,1379,hunter,beastmastery,48,22,26
Bambamgalke,antonidas,1378,hunter,beastmastery,72,34,38
Loógosh,blackmoore,1376,hunter,beastmastery,54,26,28
Esgar,blackrock,1374,hunter,beastmastery,74,34,40
Честнный,howling-fjord,1373,hunter,beastmastery,113,51,62
Boulaax,ysondre,1372,hunter,beastmastery,118,66,52
Raymear,kazzak,1370,hunter,beastmastery,30,16,14
Travels,tarren-mill,1370,hunter,beastmastery,81,42,39
Elsasehunter,zuljin,1370,hunter,beastmastery,102,44,58
Стреладемона,gordunni,1368,hunter,beastmastery,51,30,21
Сатарр,gordunni,1362,hunter,beastmastery,90,43,47
Zúzú,hyjal,1357,hunter,beastmastery,42,26,16
Asousa,stormscale,1356,hunter,beastmastery,48,26,22
Nycrom,ravencrest,1354,hunter,beastmastery,32,15,17
Киборка,howling-fjord,1352,hunter,beastmastery,30,15,15
Meskette,ravencrest,1347,hunter,beastmastery,62,27,35
Чапуршилов,lich-king,1346,hunter,beastmastery,106,50,56
Porch,dragonmaw,1345,hunter,beastmastery,31,16,15
Brokenpetman,defias-brotherhood,1344,hunter,beastmastery,24,14,10
Oliene,twisting-nether,1343,hunter,beastmastery,36,19,17
Ðoxz,blackrock,1342,hunter,beastmastery,24,14,10
Pryse,hyjal,1342,hunter,beastmastery,30,14,16
Jungletime,outland,1341,hunter,beastmastery,24,14,10
Sentriks,tarren-mill,1340,hunter,beastmastery,30,14,16
Joshalama,quelthalas,1339,hunter,beastmastery,35,19,16
Douglas,die-silberne-hand,1338,hunter,beastmastery,30,14,16
Saromán,ravencrest,1336,hunter,beastmastery,36,19,17
Straybullet,kazzak,1336,hunter,beastmastery,89,40,49
Notikâ,aegwynn,1336,hunter,beastmastery,48,20,28
Feignindeath,twisting-nether,1335,hunter,beastmastery,30,19,11
Bravestarr,blades-edge,1334,hunter,beastmastery,36,19,17
Lascazador,dun-modr,1332,hunter,beastmastery,30,14,16
Жмыххунтер,howling-fjord,1331,hunter,beastmastery,30,14,16
Trapwann,argent-dawn,1329,hunter,beastmastery,24,14,10
Strélka,blackrock,1325,hunter,beastmastery,30,14,16
Trapyx,malganis,1325,hunter,beastmastery,69,24,45
Amitar,tarren-mill,1321,hunter,beastmastery,24,15,9
Hantro,argent-dawn,1321,hunter,beastmastery,30,18,12
Ríckybobby,kazzak,1319,hunter,beastmastery,43,22,21
Hogar,frostwolf,1317,hunter,beastmastery,24,14,10
Чизано,deathguard,1315,hunter,beastmastery,41,18,23
Meredo,burning-legion,1313,hunter,beastmastery,58,30,28
Muspigen,tarren-mill,1313,hunter,beastmastery,81,37,44
Туруханец,gordunni,1312,hunter,beastmastery,78,42,36
Люблюлюбовь,gordunni,1310,hunter,beastmastery,42,27,15
Zantorious,ravencrest,1308,hunter,beastmastery,33,20,13
Belorgrim,kirin-tor,1306,hunter,beastmastery,30,16,14
Mètrolog,twisting-nether,1306,hunter,beastmastery,54,21,33
Platzpatron,eredar,1297,hunter,beastmastery,36,15,21
Sixty,rajaxx,1293,hunter,beastmastery,30,16,14
Greathorn,arthas,1288,hunter,beastmastery,22,15,7
Salvia,chromaggus,1288,hunter,beastmastery,96,51,45
Ägris,die-todeskrallen,1286,hunter,beastmastery,75,36,39
Benbutton,antonidas,1286,hunter,beastmastery,46,22,24
Chagaure,hyjal,1283,hunter,beastmastery,30,14,16
Cobra,magtheridon,1282,hunter,beastmastery,71,30,41
Кулинарк,howling-fjord,1279,hunter,beastmastery,48,23,25
Tháyn,tarren-mill,1268,hunter,beastmastery,23,14,9
Kiingsane,archimonde,1268,hunter,beastmastery,33,15,18
Basìcs,nemesis,1265,hunter,beastmastery,30,16,14
Flunkytim,blackmoore,1261,hunter,beastmastery,60,30,30
Maknamara,tarren-mill,1255,hunter,beastmastery,48,24,24
Linchpin,dentarg,1255,hunter,beastmastery,62,28,34
Encore,sylvanas,1251,hunter,beastmastery,30,15,15
Шионо,howling-fjord,1250,hunter,beastmastery,26,14,12
Pareia,blackrock,1248,hunter,beastmastery,18,13,5
Ðowz,ysondre,1248,hunter,beastmastery,24,13,11
Kásúxôxô,ravencrest,1248,hunter,beastmastery,24,13,11
Rïm,haomarush,1247,hunter,beastmastery,24,13,11
Jawox,antonidas,1247,hunter,beastmastery,30,13,17
Pagman,thrall,1247,hunter,beastmastery,30,13,17
Дафирия,deathguard,1247,hunter,beastmastery,40,17,23
Petshopgirl,ravencrest,1246,hunter,beastmastery,24,13,11
Símpíng,tarren-mill,1245,hunter,beastmastery,18,13,5
Fatmum,magtheridon,1243,hunter,beastmastery,24,13,11
Spidak,stormscale,1239,hunter,beastmastery,24,13,11
Neescafe,sylvanas,1236,hunter,beastmastery,27,14,13
Johnwick,aerie-peak,1233,hunter,beastmastery,18,13,5
Rxr,kazzak,1232,hunter,beastmastery,30,13,17
Shaznak,argent-dawn,1231,hunter,beastmastery,36,17,19
Skidzo,alakir,1231,hunter,beastmastery,32,15,17
Davíncí,tarren-mill,1224,hunter,beastmastery,77,41,36
Neeske,sylvanas,1224,hunter,beastmastery,30,13,17
Vexhh,outland,1221,hunter,beastmastery,24,13,11
Stogie,auchindoun,1217,hunter,beastmastery,24,13,11
Анютикус,gordunni,1213,hunter,beastmastery,42,26,16
Lusifa,antonidas,1212,hunter,beastmastery,62,33,29
Bufosh,twisting-nether,1211,hunter,beastmastery,75,37,38
Snipingdog,stormscale,1209,hunter,beastmastery,36,18,18
Heylie,senjin,1206,hunter,beastmastery,47,16,31
Diac,dalaran,1201,hunter,beastmastery,18,13,5
Slojork,thrall,1190,hunter,beastmastery,92,40,52
Ashjen,aszune,1188,hunter,beastmastery,29,18,11
Eddy,the-maelstrom,1187,hunter,beastmastery,36,20,16
Arnatti,tyrande,1186,hunter,beastmastery,23,13,10
Быщь,gordunni,1186,hunter,beastmastery,29,14,15
Cinan,twisting-nether,1182,hunter,beastmastery,40,21,19
Pancakesgo,twilights-hammer,1179,hunter,beastmastery,35,13,22
Haleth,uldum,1177,hunter,beastmastery,29,13,16
Æblesaft,stormscale,1177,hunter,beastmastery,34,13,21
Амобарбиталх,gordunni,1173,hunter,beastmastery,39,20,19
Skullstah,ravencrest,1169,hunter,beastmastery,24,13,11
Harpin,azuremyst,1166,hunter,beastmastery,42,20,22
Балласкиндер,gordunni,1164,hunter,beastmastery,60,31,29
Olamay,blackmoore,1159,hunter,beastmastery,50,26,24
Oròme,pozzo-delleternità,1157,hunter,beastmastery,60,31,29
Kyliun,frostmane,1155,hunter,beastmastery,29,13,16
Rafizox,kazzak,1152,hunter,beastmastery,18,12,6
Пожилойпупь,soulflayer,1151,hunter,beastmastery,18,12,6
Brawnshunt,stormscale,1151,hunter,beastmastery,24,12,12
Cor,ravencrest,1151,hunter,beastmastery,24,12,12
Diktatos,kazzak,1151,hunter,beastmastery,24,12,12
Dohter,kazzak,1151,hunter,beastmastery,25,12,13
Digimørtal,kazzak,1150,hunter,beastmastery,18,12,6
Raythe,argent-dawn,1150,hunter,beastmastery,24,12,12
Galileo,sanguino,1150,hunter,beastmastery,26,12,14
Misstrap,nemesis,1150,hunter,beastmastery,30,12,18
Амореселф,gordunni,1150,hunter,beastmastery,30,12,18
Kondy,twisting-nether,1149,hunter,beastmastery,18,12,6
Mâjôô,blackhand,1149,hunter,beastmastery,22,13,9
Lòò,aegwynn,1148,hunter,beastmastery,18,12,6
Freebïrd,shattered-hand,1147,hunter,beastmastery,18,12,6
Dmanite,ravencrest,1147,hunter,beastmastery,24,12,12
Zubro,kazzak,1146,hunter,beastmastery,30,12,18
Ловихимеру,soulflayer,1145,hunter,beastmastery,18,12,6
Лсныйпамп,howling-fjord,1145,hunter,beastmastery,24,12,12
Tempestes,tarren-mill,1144,hunter,beastmastery,57,29,28
Fiftyóne,festung-der-stürme,1144,hunter,beastmastery,30,12,18
Artemisas,draenor,1144,hunter,beastmastery,36,12,24
Geete,kazzak,1141,hunter,beastmastery,18,12,6
Синглшот,blackscar,1141,hunter,beastmastery,24,12,12
Zpy,blackmoore,1137,hunter,beastmastery,18,12,6
Blastarrow,the-maelstrom,1135,hunter,beastmastery,42,13,29
Abovival,ragnaros,1134,hunter,beastmastery,24,12,12
Grrizzly,kazzak,1132,hunter,beastmastery,24,12,12
Джантига,howling-fjord,1128,hunter,beastmastery,24,12,12
Jaky,illidan,1117,hunter,beastmastery,107,59,48
Schnezzler,nerathor,1116,hunter,beastmastery,74,38,36
Tsoutsoukoss,silvermoon,1115,hunter,beastmastery,77,37,40
Karstarkk,sanguino,1115,hunter,beastmastery,47,20,27
Juha,the-maelstrom,1111,hunter,beastmastery,26,13,13
Куфачка,soulflayer,1103,hunter,beastmastery,17,12,5
Cruelsummer,kul-tiras,1100,hunter,beastmastery,48,17,31
Savori,kazzak,1096,hunter,beastmastery,31,18,13
Nieki,eitrigg,1096,hunter,beastmastery,74,28,46
Nerfjuice,silvermoon,1094,hunter,beastmastery,33,18,15
Goonii,bronzebeard,1094,hunter,beastmastery,24,12,12
Pigoen,sporeggar,1092,hunter,beastmastery,71,29,42
Ertestuing,tarren-mill,1090,hunter,beastmastery,30,14,16
Ezelina,lightnings-blade,1089,hunter,beastmastery,36,18,18
Luckyhunty,dalaran,1086,hunter,beastmastery,36,15,21
Brometheus,sylvanas,1083,hunter,beastmastery,41,15,26
Ládysháyà,blackrock,1074,hunter,beastmastery,24,13,11
Spiritshot,baelgun,1066,hunter,beastmastery,34,14,20
Deblaze,aegwynn,1056,hunter,beastmastery,18,11,7
Trapgodxx,archimonde,1056,hunter,beastmastery,24,11,13
Smhx,stormscale,1055,hunter,beastmastery,18,11,7
Thogelle,hyjal,1055,hunter,beastmastery,24,11,13
Хастла,greymane,1055,hunter,beastmastery,24,11,13
Bigdog,eredar,1055,hunter,beastmastery,29,11,18
Ledrox,ravencrest,1054,hunter,beastmastery,18,11,7
Daveq,drakthul,1054,hunter,beastmastery,24,11,13
Spinella,antonidas,1054,hunter,beastmastery,24,11,13
Gorgorm,ravencrest,1054,hunter,beastmastery,24,11,13
Фетсол,soulflayer,1053,hunter,beastmastery,12,11,1
Darllene,kazzak,1051,hunter,beastmastery,30,11,19
Pilogbueferd,silvermoon,1050,hunter,beastmastery,18,11,7
Коблазнх,howling-fjord,1048,hunter,beastmastery,24,11,13
Sourxete,silvermoon,1048,hunter,beastmastery,24,11,13
Дипшот,deathguard,1047,hunter,beastmastery,24,11,13
Halgen,medivh,1043,hunter,beastmastery,35,11,24
Venkox,archimonde,1038,hunter,beastmastery,67,35,32
Yukina,frostmourne,1038,hunter,beastmastery,28,13,15
Bøwjøb,arthas,1038,hunter,beastmastery,24,11,13
Pumukle,madmortem,1035,hunter,beastmastery,34,15,19
Айлиси,soulflayer,1031,hunter,beastmastery,43,11,32
Румлис,gordunni,1029,hunter,beastmastery,29,14,15
Øutkast,silvermoon,1021,hunter,beastmastery,23,13,10
Smegmagol,baelgun,1021,hunter,beastmastery,23,11,12
Dioxis,silvermoon,1021,hunter,beastmastery,60,27,33
Ветиринарша,gordunni,1020,hunter,beastmastery,30,11,19
Grollar,ragnaros,1014,hunter,beastmastery,80,42,38
Altimor,blackmoore,1007,hunter,beastmastery,23,11,12
Soulshoot,khaz-modan,1007,hunter,beastmastery,46,21,25
Винченцо,blackscar,1003,hunter,beastmastery,21,11,10
Shpider,burning-blade,1000,hunter,beastmastery,52,22,30
Feigur,sanguino,999,hunter,beastmastery,47,24,23
Sinux,lordaeron,995,hunter,beastmastery,17,11,6
Arrechus,khaz-modan,992,hunter,beastmastery,74,31,43
Frencharena,the-venture-co,990,hunter,beastmastery,29,11,18
Mykris,aegwynn,989,hunter,beastmastery,41,14,27
Loyalman,blackmoore,985,hunter,beastmastery,16,11,5
Вагар,blackscar,974,hunter,beastmastery,18,12,6
Missmytrap,archimonde,960,hunter,beastmastery,12,10,2
Dathrixjr,ravencrest,960,hunter,beastmastery,12,10,2
Kásúxøxø,ravencrest,960,hunter,beastmastery,16,11,5
Akhtabot,twisting-nether,960,hunter,beastmastery,18,10,8
Lajnus,frostmane,960,hunter,beastmastery,18,10,8
Solò,eredar,960,hunter,beastmastery,18,10,8
Mòzetonq,ravencrest,960,hunter,beastmastery,18,10,8
Zeanort,nordrassil,960,hunter,beastmastery,24,10,14
Jägarn,stormscale,960,hunter,beastmastery,24,10,14
Luzivar,malganis,960,hunter,beastmastery,30,10,20
Thinkerer,silvermoon,959,hunter,beastmastery,18,10,8
Blazeityolo,outland,959,hunter,beastmastery,18,10,8
Spider,zuljin,959,hunter,beastmastery,18,10,8
Lëgølåslõrdx,blackrock,959,hunter,beastmastery,18,10,8
Arakton,drakthul,959,hunter,beastmastery,40,18,22
Djøgi,archimonde,959,hunter,beastmastery,24,10,14
Grabbin,silvermoon,959,hunter,beastmastery,24,10,14
Homesz,blackmoore,958,hunter,beastmastery,18,10,8
Зуланария,howling-fjord,958,hunter,beastmastery,18,10,8
Dragosvis,arathor,958,hunter,beastmastery,18,10,8
Sylariel,die-aldor,958,hunter,beastmastery,18,10,8
Адыгах,blackscar,958,hunter,beastmastery,19,10,9
Shieryu,archimonde,958,hunter,beastmastery,24,10,14
Blainehunts,arathor,958,hunter,beastmastery,36,11,25
Choukzt,archimonde,957,hunter,beastmastery,18,10,8
Toralfmoralf,aegwynn,957,hunter,beastmastery,18,10,8
Хлопс,howling-fjord,956,hunter,beastmastery,18,10,8
Wolfster,kazzak,956,hunter,beastmastery,30,10,20
Berkobaggins,twisting-nether,955,hunter,beastmastery,24,10,14
Herpray,blackmoore,953,hunter,beastmastery,18,10,8
Magarosh,eredar,953,hunter,beastmastery,24,10,14
Darkdexou,defias-brotherhood,951,hunter,beastmastery,18,10,8
Ecalter,dun-modr,951,hunter,beastmastery,18,10,8
Lioness,ahnqiraj,951,hunter,beastmastery,24,10,14
Nidromel,stormscale,951,hunter,beastmastery,78,31,47
Zappikhunter,silvermoon,950,hunter,beastmastery,24,10,14
Nerdhark,hyjal,950,hunter,beastmastery,27,11,16
Cêleste,kaelthas,947,hunter,beastmastery,22,11,11
Lemeric,blackmoore,942,hunter,beastmastery,19,10,9
Безос,soulflayer,942,hunter,beastmastery,24,10,14
Deadlysnîpe,antonidas,941,hunter,beastmastery,16,11,5
Kure,blackrock,938,hunter,beastmastery,55,23,32
Dariatate,eredar,933,hunter,beastmastery,24,10,14
Enanorabioso,minahonda,927,hunter,beastmastery,24,10,14
Paînfull,kazzak,926,hunter,beastmastery,23,10,13
Goliathoz,blackmoore,917,hunter,beastmastery,35,19,16
Stjordal,chamber-of-aspects,917,hunter,beastmastery,63,30,33
Happyrme,thrall,916,hunter,beastmastery,24,12,12
Kronzucker,eredar,914,hunter,beastmastery,36,16,20
Allcollapse,outland,910,hunter,beastmastery,21,11,10
Adram,burning-legion,909,hunter,beastmastery,17,10,7
Mankkis,stormscale,909,hunter,beastmastery,48,14,34
Mehtäsika,xavius,904,hunter,beastmastery,21,10,11
Zoomiesuwu,antonidas,895,hunter,beastmastery,17,10,7
Fizè,blackmoore,894,hunter,beastmastery,17,10,7
Kënshiro,kazzak,893,hunter,beastmastery,20,10,10
Bornum,khaz-modan,892,hunter,beastmastery,31,10,21
Floppybobby,burning-blade,890,hunter,beastmastery,23,10,13
Catmother,grim-batol,886,hunter,beastmastery,20,12,8
Lissudarlin,stormreaver,884,hunter,beastmastery,66,33,33
Eenel,twisting-nether,864,hunter,beastmastery,12,9,3
Lilpancake,kazzak,864,hunter,beastmastery,12,9,3
Kapowz,kazzak,864,hunter,beastmastery,12,9,3
Hispanøxd,sanguino,864,hunter,beastmastery,12,9,3
Painaldeepz,stormscale,864,hunter,beastmastery,18,9,9
Иоссифсталин,soulflayer,864,hunter,beastmastery,18,9,9
Leza,kult-der-verdammten,864,hunter,beastmastery,18,9,9
Negz,eredar,864,hunter,beastmastery,18,9,9
Pussirotta,stormreaver,864,hunter,beastmastery,24,9,15
Kreiden,twisting-nether,864,hunter,beastmastery,24,9,15
Valhnir,sanguino,864,hunter,beastmastery,24,9,15
Downey,azshara,864,hunter,beastmastery,24,9,15
Denkstah,tarren-mill,864,hunter,beastmastery,24,9,15
Bluefluclue,draenor,864,hunter,beastmastery,28,9,19
Nillaxy,blackmoore,863,hunter,beastmastery,18,9,9
Jahunter,aggra-português,863,hunter,beastmastery,18,9,9
Fléxyz,sylvanas,863,hunter,beastmastery,18,9,9
Massimox,draenor,862,hunter,beastmastery,12,9,3
Lokiis,hyjal,862,hunter,beastmastery,12,9,3
Pumbuboo,deathwing,862,hunter,beastmastery,18,9,9
Vyrê,ghostlands,862,hunter,beastmastery,18,9,9
Tsivoula,twisting-nether,861,hunter,beastmastery,12,9,3
Settisetä,defias-brotherhood,861,hunter,beastmastery,18,9,9
Mordhunterx,draenor,861,hunter,beastmastery,18,9,9
Llamp,draenor,859,hunter,beastmastery,24,10,14
Darilli,wildhammer,858,hunter,beastmastery,19,9,10
Halessia,ravencrest,858,hunter,beastmastery,24,9,15
Бруксиан,fordragon,857,hunter,beastmastery,19,9,10
Sika,nozdormu,857,hunter,beastmastery,24,9,15
Nesthor,sinstralis,856,hunter,beastmastery,24,9,15
Ulyash,ysondre,854,hunter,beastmastery,18,9,9
Towu,archimonde,849,hunter,beastmastery,24,9,15
Greenstar,twisting-nether,846,hunter,beastmastery,27,10,17
Vystrelil,drakthul,833,hunter,beastmastery,42,19,23
Гримнар,borean-tundra,831,hunter,beastmastery,17,9,8
Nixxay,antonidas,831,hunter,beastmastery,24,11,13
Enty,blackrock,830,hunter,beastmastery,14,10,4
Deathmarks,blackrock,830,hunter,beastmastery,29,9,20
Sithrom,blackmoore,829,hunter,beastmastery,22,9,13
Võnbødefeld,frostmourne,827,hunter,beastmastery,17,9,8
Ønur,twisting-nether,827,hunter,beastmastery,30,11,19
Пушкабомби,soulflayer,823,hunter,beastmastery,46,19,27
Anoroxx,arthas,815,hunter,beastmastery,17,9,8
Шаурмэ,gordunni,815,hunter,beastmastery,21,9,12
Mirmona,stormscale,799,hunter,beastmastery,22,9,13
Colth,hyjal,799,hunter,beastmastery,29,9,20
Slaghunter,argent-dawn,798,hunter,beastmastery,17,9,8
Grokis,blackhand,782,hunter,beastmastery,67,28,39
Teacee,twisting-nether,773,hunter,beastmastery,20,9,11
Drewsx,ravencrest,768,hunter,beastmastery,12,8,4
Mettämies,twisting-nether,768,hunter,beastmastery,12,8,4
Weoneshot,ravencrest,768,hunter,beastmastery,12,8,4
Laserkamel,aegwynn,768,hunter,beastmastery,12,8,4
Irükandji,chants-éternels,768,hunter,beastmastery,12,8,4
Charleramsey,outland,768,hunter,beastmastery,12,8,4
Трапча,soulflayer,768,hunter,beastmastery,12,8,4
Suffrebobbs,ravencrest,768,hunter,beastmastery,12,8,4
Vilopez,arthas,768,hunter,beastmastery,12,8,4
Spergmeister,argent-dawn,768,hunter,beastmastery,12,8,4
Nivshot,kazzak,768,hunter,beastmastery,12,8,4
Мираклдримз,gordunni,768,hunter,beastmastery,12,8,4
Ebobuss,tarren-mill,768,hunter,beastmastery,12,8,4
Krakenaspect,kazzak,768,hunter,beastmastery,18,8,10
Krâýnn,aegwynn,768,hunter,beastmastery,18,8,10
Appollo,magtheridon,768,hunter,beastmastery,18,8,10
Dispairge,antonidas,768,hunter,beastmastery,18,8,10
Vasco,chogall,768,hunter,beastmastery,18,8,10
Зимняясказка,soulflayer,768,hunter,beastmastery,18,8,10
Ishotharambe,doomhammer,768,hunter,beastmastery,18,8,10
Pewpewstuff,draenor,768,hunter,beastmastery,18,8,10
Mufdii,sylvanas,768,hunter,beastmastery,18,8,10
Guccihuntlol,ravencrest,768,hunter,beastmastery,18,8,10
Vargar,arygos,768,hunter,beastmastery,18,8,10
Nelida,ragnaros,768,hunter,beastmastery,24,8,16
Fridion,argent-dawn,768,hunter,beastmastery,24,8,16
Duïvell,grim-batol,768,hunter,beastmastery,24,8,16
Mogumogu,blackhand,768,hunter,beastmastery,24,8,16
Леоа,howling-fjord,768,hunter,beastmastery,24,8,16
Hugø,twisting-nether,768,hunter,beastmastery,30,8,22
Kestlér,outland,768,hunter,beastmastery,30,8,22
Kuljaa,ravencrest,767,hunter,beastmastery,12,8,4
Awoe,blackrock,767,hunter,beastmastery,12,8,4
Devøurer,blackmoore,767,hunter,beastmastery,12,8,4
Hlynsson,tarren-mill,767,hunter,beastmastery,12,8,4
Huntyadaun,blackrock,767,hunter,beastmastery,12,8,4
Солевойй,gordunni,767,hunter,beastmastery,18,8,10
Gbureczka,burning-legion,767,hunter,beastmastery,18,8,10
Earnzie,outland,767,hunter,beastmastery,18,8,10
Solot,silvermoon,767,hunter,beastmastery,18,8,10
Prodanhunts,frostmane,767,hunter,beastmastery,24,8,16
Шурикцаревич,galakrond,767,hunter,beastmastery,24,8,16
Shinibon,blackmoore,767,hunter,beastmastery,24,8,16
Vassiliadis,bronze-dragonflight,767,hunter,beastmastery,24,8,16
Miracleh,tarren-mill,766,hunter,beastmastery,18,8,10
Rickh,ravencrest,765,hunter,beastmastery,12,8,4
Фаталлити,grom,763,hunter,beastmastery,12,8,4
Laerya,les-clairvoyants,763,hunter,beastmastery,18,8,10
Plong,argent-dawn,761,hunter,beastmastery,12,8,4
Vachekiki,archimonde,759,hunter,beastmastery,12,8,4
Sushimän,kaelthas,751,hunter,beastmastery,12,8,4
Sayn,la-croisade-écarlate,751,hunter,beastmastery,23,8,15
Remiss,sanguino,738,hunter,beastmastery,22,10,12
Ремонтлицаа,gordunni,735,hunter,beastmastery,17,8,9
Marlaska,exodar,732,hunter,beastmastery,18,8,10
Spycke,dalaran,709,hunter,beastmastery,15,9,6
Бей,gordunni,703,hunter,beastmastery,14,8,6
Sélenaé,hyjal,703,hunter,beastmastery,16,8,8
Andjelaa,kazzak,703,hunter,beastmastery,16,8,8
Feyoonx,blackrock,703,hunter,beastmastery,23,9,14
Huntbeard,aegwynn,695,hunter,beastmastery,22,8,14
Utoast,ravencrest,672,hunter,beastmastery,12,7,5
Сашказнаток,azuregos,672,hunter,beastmastery,12,7,5
Найтсол,greymane,672,hunter,beastmastery,12,7,5
Lustor,ravencrest,672,hunter,beastmastery,12,7,5
Drukan,hyjal,672,hunter,beastmastery,12,7,5
Bigramy,sanguino,672,hunter,beastmastery,12,7,5
Knokkelmann,outland,672,hunter,beastmastery,12,7,5
Dåo,doomhammer,672,hunter,beastmastery,12,7,5
Beorind,frostwolf,672,hunter,beastmastery,12,7,5
Potatobeast,twisting-nether,672,hunter,beastmastery,12,7,5
Ufecläimbe,eredar,672,hunter,beastmastery,12,7,5
Fôx,frostmane,672,hunter,beastmastery,12,7,5
Nukenfoobs,draenor,672,hunter,beastmastery,12,7,5
Jèrsèy,draenor,672,hunter,beastmastery,12,7,5
Ulfrîc,exodar,672,hunter,beastmastery,12,7,5
Belaux,archimonde,672,hunter,beastmastery,12,7,5
Ahotnik,aegwynn,672,hunter,beastmastery,12,7,5
Загзигзаг,soulflayer,672,hunter,beastmastery,12,7,5
Подлыйстарик,gordunni,672,hunter,beastmastery,12,7,5
Karuso,ravencrest,672,hunter,beastmastery,12,7,5
Riflur,stormscale,672,hunter,beastmastery,12,7,5
Marcsman,blackrock,672,hunter,beastmastery,12,7,5
Hasáblover,ragnaros,672,hunter,beastmastery,12,7,5
Slejpy,drakthul,672,hunter,beastmastery,12,7,5
Stamzer,drakthul,672,hunter,beastmastery,12,7,5
Kissay,blackmoore,672,hunter,beastmastery,12,7,5
Boybiron,silvermoon,672,hunter,beastmastery,18,7,11
Düivell,grim-batol,672,hunter,beastmastery,18,7,11
Hunterstein,archimonde,672,hunter,beastmastery,18,7,11
Zublime,dragonblight,672,hunter,beastmastery,18,7,11
Svolatch,blackrock,672,hunter,beastmastery,18,7,11
Ромкола,gordunni,672,hunter,beastmastery,18,7,11
Баянист,soulflayer,672,hunter,beastmastery,18,7,11
Gitanìlla,dun-modr,672,hunter,beastmastery,18,7,11
Дьярэ,gordunni,672,hunter,beastmastery,18,7,11
Ansâvage,ravencrest,672,hunter,beastmastery,18,7,11
Lis,gorgonnash,672,hunter,beastmastery,24,7,17
Coltan,nemesis,672,hunter,beastmastery,24,7,17
Chúx,twisting-nether,672,hunter,beastmastery,24,7,17
Setyouintrap,ravencrest,672,hunter,beastmastery,24,7,17
Летмимейт,howling-fjord,672,hunter,beastmastery,26,7,19
Strade,argent-dawn,671,hunter,beastmastery,12,7,5
Кежма,howling-fjord,671,hunter,beastmastery,12,7,5
Døømslayer,nemesis,671,hunter,beastmastery,12,7,5
Mazekhin,khaz-modan,671,hunter,beastmastery,12,7,5
Cxc,dun-modr,671,hunter,beastmastery,12,7,5
Waidø,blackhand,671,hunter,beastmastery,12,7,5
Jaydogg,lightbringer,671,hunter,beastmastery,12,7,5
Lunaunii,argent-dawn,671,hunter,beastmastery,12,7,5
Tomli,nemesis,671,hunter,beastmastery,12,7,5
Бэталол,gordunni,671,hunter,beastmastery,12,7,5
Ashryqt,ravencrest,671,hunter,beastmastery,12,7,5
Doubleoseven,frostmane,671,hunter,beastmastery,12,7,5
Akkonas,antonidas,671,hunter,beastmastery,12,7,5
Dràcula,tarren-mill,671,hunter,beastmastery,18,7,11
Orian,argent-dawn,671,hunter,beastmastery,18,7,11
Блудитролль,soulflayer,671,hunter,beastmastery,18,7,11
Mindgap,pozzo-delleternità,671,hunter,beastmastery,18,7,11
Rifle,dun-morogh,671,hunter,beastmastery,18,7,11
Câonimâ,twisting-nether,671,hunter,beastmastery,18,7,11
Castbuny,drakthul,671,hunter,beastmastery,18,7,11
Wodlenprince,draenor,671,hunter,beastmastery,18,7,11
Жэш,howling-fjord,670,hunter,beastmastery,12,7,5
Casey,zuluhed,669,hunter,beastmastery,18,7,11
Nelerias,defias-brotherhood,669,hunter,beastmastery,24,7,17
Poatan,outland,667,hunter,beastmastery,18,7,11
Rollei,uldum,666,hunter,beastmastery,12,7,5
Aroldo,kazzak,665,hunter,beastmastery,12,7,5
Саэсантессис,howling-fjord,665,hunter,beastmastery,18,7,11
Electrastar,illidan,664,hunter,beastmastery,12,7,5
Rubyblack,archimonde,663,hunter,beastmastery,12,7,5
Сяову,gordunni,643,hunter,beastmastery,30,7,23
Notchan,stormscale,639,hunter,beastmastery,11,7,4
Oife,auchindoun,637,hunter,beastmastery,17,7,10
Zwergnàse,thrall,616,hunter,beastmastery,23,7,16
Michaelvm,ravencrest,576,hunter,beastmastery,6,6,0
Luke,chromaggus,576,hunter,beastmastery,6,6,0
Xraay,stormscale,576,hunter,beastmastery,10,7,3
Autopilot,aegwynn,576,hunter,beastmastery,12,6,6
Paraskámu,twisting-nether,576,hunter,beastmastery,12,6,6
Sallya,kazzak,576,hunter,beastmastery,12,6,6
Rdwlf,draenor,576,hunter,beastmastery,12,6,6
Xenvantoss,silvermoon,576,hunter,beastmastery,12,6,6
Xéraphine,mannoroth,576,hunter,beastmastery,12,6,6
Burbutsuluki,silvermoon,576,hunter,beastmastery,12,6,6
Razoorine,blackrock,576,hunter,beastmastery,12,6,6
Magicnanø,nemesis,576,hunter,beastmastery,12,6,6
Therakal,culte-de-la-rive-noire,576,hunter,beastmastery,12,6,6
Ângell,kirin-tor,576,hunter,beastmastery,12,6,6
Chïefhunt,twisting-nether,576,hunter,beastmastery,12,6,6
Raegal,sanguino,576,hunter,beastmastery,12,6,6
Ausgefuchst,forscherliga,576,hunter,beastmastery,12,6,6
Dtq,silvermoon,576,hunter,beastmastery,12,6,6
Asery,blackmoore,576,hunter,beastmastery,12,6,6
Iuyiuy,dalaran,576,hunter,beastmastery,12,6,6
Vu,shattered-hand,576,hunter,beastmastery,12,6,6
Petitsui,zuljin,576,hunter,beastmastery,12,6,6
Dorkos,sanguino,576,hunter,beastmastery,12,6,6
Holdmypurse,kazzak,576,hunter,beastmastery,12,6,6
Jackjager,ravencrest,576,hunter,beastmastery,12,6,6
Logales,dragonblight,576,hunter,beastmastery,12,6,6
Nagu,antonidas,576,hunter,beastmastery,12,6,6
Metalbaci,sylvanas,576,hunter,beastmastery,12,6,6
Earlygrey,ravencrest,576,hunter,beastmastery,12,6,6
Fogknows,ravencrest,576,hunter,beastmastery,12,6,6
Акройя,gordunni,576,hunter,beastmastery,12,6,6
Стёпкахант,gordunni,576,hunter,beastmastery,12,6,6
Зеленыйиисус,gordunni,576,hunter,beastmastery,12,6,6
Toptìérgoðx,drakthul,576,hunter,beastmastery,12,6,6
Шмыгахант,gordunni,576,hunter,beastmastery,12,6,6
Deathcode,stormscale,576,hunter,beastmastery,12,6,6
Badhunt,stormscale,576,hunter,beastmastery,12,6,6
Беспокойный,soulflayer,576,hunter,beastmastery,12,6,6
Cítyzens,drakthul,576,hunter,beastmastery,12,6,6
Showdope,drakthul,576,hunter,beastmastery,12,6,6
Saymqt,blackrock,576,hunter,beastmastery,15,7,8
Teals,blackrock,576,hunter,beastmastery,15,6,9
Матанал,gordunni,576,hunter,beastmastery,18,6,12
Vhalín,magtheridon,576,hunter,beastmastery,18,6,12
Uselessx,kazzak,576,hunter,beastmastery,18,6,12
Ryxzn,eredar,576,hunter,beastmastery,18,6,12
Wetto,ravencrest,576,hunter,beastmastery,18,6,12
Такувами,gordunni,576,hunter,beastmastery,18,6,12
Cicatrice,kazzak,576,hunter,beastmastery,18,6,12
Azrhu,ravencrest,576,hunter,beastmastery,18,6,12
Suisiide,antonidas,576,hunter,beastmastery,18,6,12
Свадебная,gordunni,576,hunter,beastmastery,18,6,12
Realme,blackrock,576,hunter,beastmastery,18,6,12
Disyö,kazzak,576,hunter,beastmastery,18,6,12
Vescar,argent-dawn,576,hunter,beastmastery,24,6,18
Дзэнмашина,booty-bay,575,hunter,beastmastery,12,6,6
Truedetectiv,aggramar,575,hunter,beastmastery,12,6,6
Krasavcik,shattrath,575,hunter,beastmastery,12,6,6
Cäri,colinas-pardas,575,hunter,beastmastery,12,6,6
Бирмингем,ashenvale,575,hunter,beastmastery,12,6,6
Darkhunt,ysondre,575,hunter,beastmastery,12,6,6
Dirtydolores,thrall,575,hunter,beastmastery,12,6,6
Ommadawn,dun-modr,575,hunter,beastmastery,12,6,6
Gløbi,malfurion,575,hunter,beastmastery,12,6,6
Puska,gilneas,575,hunter,beastmastery,12,6,6
Абунай,soulflayer,575,hunter,beastmastery,12,6,6
Ghanik,draenor,575,hunter,beastmastery,12,6,6
Täpy,arathor,575,hunter,beastmastery,18,6,12
Фузег,deathguard,575,hunter,beastmastery,18,6,12
Tedohunter,ragnaros,574,hunter,beastmastery,12,6,6
Dravara,blackmoore,574,hunter,beastmastery,12,6,6
Kruk,blackhand,574,hunter,beastmastery,12,6,6
Atraxi,aegwynn,574,hunter,beastmastery,18,6,12
Kannon,twisting-nether,574,hunter,beastmastery,18,6,12
Penelopé,darkmoon-faire,573,hunter,beastmastery,12,6,6
Jsâ,blackmoore,571,hunter,beastmastery,12,6,6
Rachelgg,ravencrest,543,hunter,beastmastery,11,6,5
Velites,aggra-português,543,hunter,beastmastery,11,6,5
Dreemshoot,stormscale,542,hunter,beastmastery,11,6,5
Braatski,stormscale,526,hunter,beastmastery,18,7,11
Jinxbomber,draenor,480,hunter,beastmastery,6,5,1
Glizzygobblr,kazzak,480,hunter,beastmastery,6,5,1
Hidethegun,draenor,480,hunter,beastmastery,6,5,1
Reshka,dunemaul,480,hunter,beastmastery,6,5,1
Tigerups,burning-legion,480,hunter,beastmastery,6,5,1
Мунмейстер,blackscar,480,hunter,beastmastery,6,5,1
Simpyani,silvermoon,480,hunter,beastmastery,6,5,1
Wellocérapt,confrérie-du-thorium,480,hunter,beastmastery,6,5,1
Dogliz,stormscale,480,hunter,beastmastery,6,5,1
Тирин,ashenvale,480,hunter,beastmastery,6,5,1
Connyrövöga,draenor,480,hunter,beastmastery,6,5,1
Торая,gordunni,480,hunter,beastmastery,6,5,1
Келен,blackscar,480,hunter,beastmastery,6,5,1
Виралатта,gordunni,480,hunter,beastmastery,6,5,1
Tøkÿöghøül,ravencrest,480,hunter,beastmastery,7,5,2
Survabuse,silvermoon,480,hunter,beastmastery,9,6,3
Speartusk,blackhand,480,hunter,beastmastery,12,5,7
Tiendat,kazzak,480,hunter,beastmastery,12,5,7
Arrowman,burning-legion,480,hunter,beastmastery,12,5,7
Pilpetra,tarren-mill,480,hunter,beastmastery,12,5,7
Lolez,dun-modr,480,hunter,beastmastery,12,5,7
Lsa,kazzak,480,hunter,beastmastery,12,5,7
Kerólus,blackhand,480,hunter,beastmastery,12,5,7
Mdmalol,malganis,480,hunter,beastmastery,12,5,7
Silvos,blackrock,480,hunter,beastmastery,12,5,7
Fotmrerollér,aegwynn,480,hunter,beastmastery,12,5,7
Khort,twisting-nether,480,hunter,beastmastery,12,5,7
Jimbowjones,antonidas,480,hunter,beastmastery,12,5,7
Wèndy,blackrock,480,hunter,beastmastery,12,5,7
Aamön,tarren-mill,480,hunter,beastmastery,12,5,7
Yamadorî,blackrock,480,hunter,beastmastery,12,5,7
Jins,illidan,480,hunter,beastmastery,12,5,7
Джеймсфранко,blackscar,480,hunter,beastmastery,12,5,7
Tracrium,hyjal,480,hunter,beastmastery,12,5,7
Shantala,frostwolf,480,hunter,beastmastery,12,5,7
Dyve,antonidas,480,hunter,beastmastery,12,5,7
Kachaxaa,ravencrest,480,hunter,beastmastery,12,5,7
Келкузд,howling-fjord,480,hunter,beastmastery,12,5,7
Blupo,stormscale,480,hunter,beastmastery,12,5,7
Квит,blackscar,480,hunter,beastmastery,12,5,7
Elvenian,twisting-nether,480,hunter,beastmastery,12,5,7
Waneìs,stormscale,480,hunter,beastmastery,12,5,7
Géeked,ravencrest,480,hunter,beastmastery,12,5,7
Рафлекс,eversong,480,hunter,beastmastery,12,5,7
Китас,soulflayer,480,hunter,beastmastery,12,5,7
Seviaz,draenor,480,hunter,beastmastery,12,5,7
Bubbahubba,ragnaros,480,hunter,beastmastery,12,5,7
Chenony,ravencrest,480,hunter,beastmastery,12,5,7
Vimd,archimonde,480,hunter,beastmastery,12,5,7
Tizzlbang,ragnaros,480,hunter,beastmastery,12,5,7
Naposin,ragnaros,480,hunter,beastmastery,12,5,7
Crasharrow,stormscale,480,hunter,beastmastery,12,5,7
Bubby,burning-legion,480,hunter,beastmastery,16,6,10
Latschodives,malorne,480,hunter,beastmastery,15,5,10
Sillychilly,frostwolf,480,hunter,beastmastery,18,5,13
Chrishyh,blackrock,480,hunter,beastmastery,18,5,13
Begøne,draenor,480,hunter,beastmastery,18,5,13
Rheyl,dun-morogh,480,hunter,beastmastery,24,5,19
Gladiátor,kult-der-verdammten,479,hunter,beastmastery,6,5,1
Djzntrap,outland,479,hunter,beastmastery,12,5,7
Sàclak,ysondre,479,hunter,beastmastery,12,5,7
Boompuf,draenor,479,hunter,beastmastery,12,5,7
Arhyah,medivh,479,hunter,beastmastery,12,5,7
Ivanrockstar,draenor,479,hunter,beastmastery,12,5,7
Straikkeri,draenor,479,hunter,beastmastery,12,5,7
Ninjaskillss,ravencrest,479,hunter,beastmastery,12,5,7
Droubidi,garona,479,hunter,beastmastery,12,5,7
Killzo,sylvanas,479,hunter,beastmastery,12,5,7
Cliff,kiljaeden,479,hunter,beastmastery,24,5,19
Добрыйклыкач,gordunni,478,hunter,beastmastery,12,5,7
Bouboule,elune,477,hunter,beastmastery,6,5,1
Бодрыйсэм,soulflayer,477,hunter,beastmastery,12,5,7
Venõm,pozzo-delleternità,476,hunter,beastmastery,15,7,8
Xyrone,bladefist,476,hunter,beastmastery,12,5,7
Ghostaim,kazzak,475,hunter,beastmastery,10,6,4
Chipok,outland,474,hunter,beastmastery,17,5,12
Ahilleaa,aegwynn,472,hunter,beastmastery,12,5,7
Momohenní,archimonde,448,hunter,beastmastery,10,5,5
Bellecoq,arathi,447,hunter,beastmastery,11,5,6
Såvëâmäzøñíà,stormscale,431,hunter,beastmastery,11,5,6
Angeedau,kazzak,431,hunter,beastmastery,11,5,6
Topbow,talnivarr,415,hunter,beastmastery,10,5,5
Darkshe,dun-modr,415,hunter,beastmastery,14,5,9
Chindaliña,zuljin,384,hunter,beastmastery,6,4,2
Ghõst,frostmane,384,hunter,beastmastery,6,4,2
Nomorepain,outland,384,hunter,beastmastery,6,4,2
Zanéy,ravencrest,384,hunter,beastmastery,6,4,2
Mothmanx,kazzak,384,hunter,beastmastery,6,4,2
Swâân,sanguino,384,hunter,beastmastery,6,4,2
Jaxxoo,outland,384,hunter,beastmastery,6,4,2
Fendros,kazzak,384,hunter,beastmastery,6,4,2
Патапум,deathguard,384,hunter,beastmastery,6,4,2
Celebor,sanguino,384,hunter,beastmastery,6,4,2
Hetzenauer,nathrezim,384,hunter,beastmastery,6,4,2
Mestar,outland,384,hunter,beastmastery,6,4,2
Xndr,sanguino,384,hunter,beastmastery,6,4,2
Robbingyou,tarren-mill,384,hunter,beastmastery,6,4,2
Sejkxi,malganis,384,hunter,beastmastery,6,4,2
Illaice,antonidas,384,hunter,beastmastery,6,4,2
Nulldmgmaker,malganis,384,hunter,beastmastery,6,4,2
Lultrap,nemesis,384,hunter,beastmastery,6,4,2
Jaxteller,archimonde,384,hunter,beastmastery,6,4,2
Разплюханка,howling-fjord,384,hunter,beastmastery,6,4,2
Azzazeal,drakthul,384,hunter,beastmastery,6,4,2
Srvol,dun-modr,384,hunter,beastmastery,6,4,2
Bøøya,aegwynn,384,hunter,beastmastery,6,4,2
Nith,ungoro,384,hunter,beastmastery,6,4,2
Garratha,burning-legion,384,hunter,beastmastery,6,4,2
Вуйчеч,howling-fjord,384,hunter,beastmastery,6,4,2
Кайсго,gordunni,384,hunter,beastmastery,6,4,2
Pufyrella,kilrogg,384,hunter,beastmastery,6,4,2
Weiaw,blackmoore,384,hunter,beastmastery,6,4,2
Khregan,aerie-peak,384,hunter,beastmastery,6,4,2
Varkiza,sylvanas,384,hunter,beastmastery,6,4,2
Слышумертвых,gordunni,384,hunter,beastmastery,6,4,2
Йокуя,blackscar,384,hunter,beastmastery,6,4,2
Kareltje,stormscale,384,hunter,beastmastery,6,4,2
Machinedream,sylvanas,384,hunter,beastmastery,6,4,2
Løløsifredo,ysondre,384,hunter,beastmastery,6,4,2
Hask,pozzo-delleternità,384,hunter,beastmastery,6,4,2
Хантнерюга,gordunni,384,hunter,beastmastery,6,4,2
Нью,soulflayer,384,hunter,beastmastery,6,4,2
Xiviora,archimonde,384,hunter,beastmastery,6,4,2
Komesz,ragnaros,384,hunter,beastmastery,6,4,2
Dregor,nemesis,384,hunter,beastmastery,6,4,2
Thursty,twisting-nether,384,hunter,beastmastery,6,4,2
Nocturr,ragnaros,384,hunter,beastmastery,6,4,2
Хантунец,soulflayer,384,hunter,beastmastery,6,4,2
Djurmästaren,ravencrest,384,hunter,beastmastery,6,4,2
Riema,ragnaros,384,hunter,beastmastery,6,4,2
Grapemint,blackrock,384,hunter,beastmastery,6,4,2
Alexdi,kazzak,384,hunter,beastmastery,6,4,2
Flytomars,ravencrest,384,hunter,beastmastery,6,4,2
Mînérvá,blackhand,384,hunter,beastmastery,6,4,2
Гримкааг,eversong,384,hunter,beastmastery,9,5,4
Healscare,dalaran,384,hunter,beastmastery,10,5,5
Showerhead,silvermoon,384,hunter,beastmastery,8,4,4
Lännennopein,outland,384,hunter,beastmastery,17,6,11
Dissectiøn,hyjal,384,hunter,beastmastery,12,4,8
Tøixøna,tyrande,384,hunter,beastmastery,12,4,8
Saiko,kazzak,384,hunter,beastmastery,12,4,8
Aléxy,sanguino,384,hunter,beastmastery,12,4,8
Дэлмор,greymane,384,hunter,beastmastery,12,4,8
Whatifany,tarren-mill,384,hunter,beastmastery,12,4,8
Dotkor,laughing-skull,384,hunter,beastmastery,12,4,8
Nîco,nathrezim,384,hunter,beastmastery,12,4,8
Navarro,nemesis,384,hunter,beastmastery,12,4,8
Hollyz,auchindoun,384,hunter,beastmastery,12,4,8
Øï,outland,384,hunter,beastmastery,12,4,8
Zippyzen,twisting-nether,384,hunter,beastmastery,12,4,8
Thérón,ravencrest,384,hunter,beastmastery,12,4,8
Zynga,sylvanas,384,hunter,beastmastery,12,4,8
Sjufemman,ravencrest,384,hunter,beastmastery,12,4,8
Лузановка,gordunni,384,hunter,beastmastery,12,4,8
Valomeere,tarren-mill,384,hunter,beastmastery,12,4,8
Вейзу,ashenvale,384,hunter,beastmastery,12,4,8
Neocb,ravencrest,384,hunter,beastmastery,12,4,8
Exwifey,ravencrest,384,hunter,beastmastery,12,4,8
Талигар,razuvious,384,hunter,beastmastery,12,4,8
Horxxa,kul-tiras,384,hunter,beastmastery,12,4,8
Siegbald,ragnaros,384,hunter,beastmastery,12,4,8
Monnee,outland,384,hunter,beastmastery,12,4,8
Nßatrapper,outland,384,hunter,beastmastery,12,4,8
Sharpeneye,ragnaros,384,hunter,beastmastery,12,4,8
Amigoss,argent-dawn,384,hunter,beastmastery,12,4,8
Catman,stormreaver,384,hunter,beastmastery,12,4,8
Pergola,spinebreaker,384,hunter,beastmastery,12,4,8
Хедшоттер,blackscar,384,hunter,beastmastery,18,4,14
Bláckheart,doomhammer,384,hunter,beastmastery,18,4,14
Hunterbeck,ravencrest,384,hunter,beastmastery,18,4,14
Tervueren,burning-blade,384,hunter,beastmastery,18,4,14
Amdonesia,ravencrest,384,hunter,beastmastery,18,4,14
Bemtistaru,draenor,384,hunter,beastmastery,18,4,14
Resonate,stormreaver,383,hunter,beastmastery,6,4,2
Jelezenchuk,outland,383,hunter,beastmastery,6,4,2
Xscaper,twilights-hammer,383,hunter,beastmastery,6,4,2
Leemool,ysondre,383,hunter,beastmastery,12,4,8
Oldrocker,sylvanas,383,hunter,beastmastery,12,4,8
Ridlas,silvermoon,383,hunter,beastmastery,12,4,8
Delazi,proudmoore,383,hunter,beastmastery,12,4,8
Гоу,fordragon,383,hunter,beastmastery,12,4,8
Guanchin,silvermoon,383,hunter,beastmastery,18,4,14
Kikijojo,ravencrest,382,hunter,beastmastery,6,4,2
Zinnady,outland,382,hunter,beastmastery,6,4,2
Beerox,ysondre,382,hunter,beastmastery,12,4,8
Neuwi,stormreaver,382,hunter,beastmastery,12,4,8
Thelasiel,aerie-peak,379,hunter,beastmastery,12,4,8
Wlâd,archimonde,367,hunter,beastmastery,11,4,7
Stingsz,chogall,352,hunter,beastmastery,22,4,18
Valldes,argent-dawn,336,hunter,beastmastery,9,4,5
Harpers,kazzak,336,hunter,beastmastery,15,4,11
Ozunâ,blackmoore,330,hunter,beastmastery,14,5,9
Skyh,outland,330,hunter,beastmastery,16,5,11
Джэромо,gordunni,288,hunter,beastmastery,6,3,3
Traenuss,azuremyst,288,hunter,beastmastery,6,3,3
Микихаса,galakrond,288,hunter,beastmastery,6,3,3
Chasseeur,archimonde,288,hunter,beastmastery,6,3,3
Козладой,gordunni,288,hunter,beastmastery,6,3,3
Kanwfulldmg,stormscale,288,hunter,beastmastery,6,3,3
Blmlooter,stormreaver,288,hunter,beastmastery,6,3,3
Retroxia,stormreaver,288,hunter,beastmastery,6,3,3
Niedzwiedzor,silvermoon,288,hunter,beastmastery,6,3,3
Flugsmälla,kazzak,288,hunter,beastmastery,6,3,3
Assbúrgers,silvermoon,288,hunter,beastmastery,6,3,3
Nosfuratu,stormscale,288,hunter,beastmastery,6,3,3
Thebigboom,outland,288,hunter,beastmastery,6,3,3
Kukenisluken,stormscale,288,hunter,beastmastery,6,3,3
Kragán,silvermoon,288,hunter,beastmastery,6,3,3
Midist,stormscale,288,hunter,beastmastery,6,3,3
Mobshot,twisting-nether,288,hunter,beastmastery,6,3,3
Lioneli,sylvanas,288,hunter,beastmastery,6,3,3
Kondirox,twisting-nether,288,hunter,beastmastery,6,3,3
Ekz,twisting-nether,288,hunter,beastmastery,6,3,3
Cryptomars,twisting-nether,288,hunter,beastmastery,6,3,3
Hallem,karazhan,288,hunter,beastmastery,6,3,3
Daela,elune,288,hunter,beastmastery,6,3,3
Zoophobiaqt,silvermoon,288,hunter,beastmastery,6,3,3
Taurïel,stormscale,288,hunter,beastmastery,6,3,3
Xðxðxðxðxðxð,sylvanas,288,hunter,beastmastery,6,3,3
Живучийорех,gordunni,288,hunter,beastmastery,6,3,3
Artze,outland,288,hunter,beastmastery,6,3,3
Боураш,gordunni,288,hunter,beastmastery,6,3,3
Chillbroo,twisting-nether,288,hunter,beastmastery,6,3,3
Bnji,hyjal,288,hunter,beastmastery,6,3,3
Fedya,kazzak,288,hunter,beastmastery,6,3,3
Мэдраэль,deathguard,288,hunter,beastmastery,6,3,3
Baïonnettex,archimonde,288,hunter,beastmastery,6,3,3
Wödën,argent-dawn,288,hunter,beastmastery,6,3,3
Imonér,frostmane,288,hunter,beastmastery,6,3,3
Mooj,malganis,288,hunter,beastmastery,6,3,3
Yümekø,khaz-modan,288,hunter,beastmastery,6,3,3
Dùmbo,khaz-modan,288,hunter,beastmastery,6,3,3
Рофшор,gordunni,288,hunter,beastmastery,6,3,3
Shedzargo,twisting-nether,288,hunter,beastmastery,6,3,3
Sauce,alonsus,288,hunter,beastmastery,6,3,3
Abonah,khaz-modan,288,hunter,beastmastery,6,3,3
Enthur,sylvanas,288,hunter,beastmastery,6,3,3
Джарвиз,soulflayer,288,hunter,beastmastery,6,3,3
Lûnelle,argent-dawn,288,hunter,beastmastery,6,3,3
Кискавтесте,gordunni,288,hunter,beastmastery,6,3,3
Garfie,tarren-mill,288,hunter,beastmastery,6,3,3
Hattorisama,ghostlands,288,hunter,beastmastery,6,3,3
Демела,gordunni,288,hunter,beastmastery,6,3,3
Yssup,frostmane,288,hunter,beastmastery,6,3,3
Blazeblue,hyjal,288,hunter,beastmastery,6,3,3
Kronkh,nemesis,288,hunter,beastmastery,6,3,3
Наладдчик,howling-fjord,288,hunter,beastmastery,6,3,3
Bugspitz,outland,288,hunter,beastmastery,6,3,3
Scräppÿ,kazzak,288,hunter,beastmastery,6,3,3
Iliíilíiílíl,outland,288,hunter,beastmastery,6,3,3
Шеннокс,howling-fjord,288,hunter,beastmastery,6,3,3
Sakaryali,silvermoon,288,hunter,beastmastery,6,3,3
Оксанчек,howling-fjord,288,hunter,beastmastery,6,3,3
Yoey,tarren-mill,288,hunter,beastmastery,6,3,3
Kxx,kazzak,288,hunter,beastmastery,6,3,3
Доррети,howling-fjord,288,hunter,beastmastery,6,3,3
Valtondre,argent-dawn,288,hunter,beastmastery,6,3,3
Hunterlolz,tarren-mill,288,hunter,beastmastery,6,3,3
Оркос,deathweaver,288,hunter,beastmastery,6,3,3
Сотк,howling-fjord,288,hunter,beastmastery,6,3,3
Arsola,sylvanas,288,hunter,beastmastery,6,3,3
Трапавграунд,howling-fjord,288,hunter,beastmastery,6,3,3
Razuye,nerathor,288,hunter,beastmastery,6,3,3
Скукота,grom,288,hunter,beastmastery,6,3,3
Axran,ravencrest,288,hunter,beastmastery,6,3,3
Bòw,antonidas,288,hunter,beastmastery,6,3,3
Visas,burning-legion,288,hunter,beastmastery,6,3,3
Колтрэйнборз,blackscar,288,hunter,beastmastery,6,3,3
Tràxes,quelthalas,288,hunter,beastmastery,6,3,3
Труласек,blackscar,288,hunter,beastmastery,6,3,3
Nervetøxin,ravencrest,288,hunter,beastmastery,6,3,3
Sebikh,ravencrest,288,hunter,beastmastery,6,3,3
Katzchen,burning-legion,288,hunter,beastmastery,6,3,3
Ipad,cthun,288,hunter,beastmastery,6,3,3
Thekev,ravencrest,288,hunter,beastmastery,6,3,3
Klèo,frostwhisper,288,hunter,beastmastery,6,3,3
Svinrbglol,arygos,288,hunter,beastmastery,6,3,3
Zinco,ravencrest,288,hunter,beastmastery,6,3,3
Будкусломаю,grom,288,hunter,beastmastery,6,3,3
Øßlíck,ysondre,288,hunter,beastmastery,6,3,3
Anhur,blackmoore,288,hunter,beastmastery,6,3,3
Djtrapyasis,blackmoore,288,hunter,beastmastery,6,3,3
Haggy,die-nachtwache,288,hunter,beastmastery,6,3,3
Noréaga,suramar,288,hunter,beastmastery,6,3,3
Dealtqt,ysondre,288,hunter,beastmastery,6,3,3
Beletor,medivh,288,hunter,beastmastery,6,3,3
Darkstripe,turalyon,288,hunter,beastmastery,6,3,3
Beefchops,draenor,288,hunter,beastmastery,6,3,3
Natchell,ysondre,288,hunter,beastmastery,6,3,3
Nestereo,zirkel-des-cenarius,288,hunter,beastmastery,6,3,3
Хантероо,gordunni,288,hunter,beastmastery,8,3,5
Riik,ragnaros,288,hunter,beastmastery,12,3,9
Karên,blackmoore,288,hunter,beastmastery,12,3,9
Фитьфитий,howling-fjord,288,hunter,beastmastery,12,3,9
Ímpulsion,stormscale,288,hunter,beastmastery,12,3,9
Akù,magtheridon,288,hunter,beastmastery,12,3,9
Craná,blackrock,288,hunter,beastmastery,12,3,9
Spirys,drakthul,288,hunter,beastmastery,12,3,9
Coôkie,ysondre,288,hunter,beastmastery,12,3,9
Jellyfat,silvermoon,288,hunter,beastmastery,12,3,9
Rachelzane,blackrock,288,hunter,beastmastery,12,3,9
Jamesbownd,ravencrest,288,hunter,beastmastery,12,3,9
Narziel,die-todeskrallen,288,hunter,beastmastery,12,3,9
Pawder,silvermoon,288,hunter,beastmastery,12,3,9
Headhunterzz,dun-modr,288,hunter,beastmastery,12,3,9
Stuckstepbro,silvermoon,288,hunter,beastmastery,12,3,9
Rrushi,argent-dawn,288,hunter,beastmastery,12,3,9
Jaguarundy,dun-modr,288,hunter,beastmastery,12,3,9
Mârked,argent-dawn,288,hunter,beastmastery,12,3,9
Frikandelli,outland,288,hunter,beastmastery,12,3,9
Bicmax,archimonde,288,hunter,beastmastery,12,3,9
Хансбург,howling-fjord,288,hunter,beastmastery,12,3,9
Pkz,dun-modr,288,hunter,beastmastery,12,3,9
Kayvaal,kaelthas,288,hunter,beastmastery,12,3,9
Phillon,blackrock,288,hunter,beastmastery,12,3,9
Xoarqt,aegwynn,288,hunter,beastmastery,12,3,9
Nerøz,ravencrest,288,hunter,beastmastery,12,3,9
Spakster,blackrock,288,hunter,beastmastery,12,3,9
Orgasmatronn,stormscale,288,hunter,beastmastery,12,3,9
Demónhunter,frostmane,288,hunter,beastmastery,12,3,9
Drakess,daggerspine,288,hunter,beastmastery,12,3,9
Bjarnhild,die-aldor,287,hunter,beastmastery,6,3,3
Ohwagga,pozzo-delleternità,287,hunter,beastmastery,6,3,3
Asca,eldrethalas,287,hunter,beastmastery,12,3,9
Oatmeal,dun-morogh,287,hunter,beastmastery,12,3,9
Voraxh,draenor,287,hunter,beastmastery,12,3,9
Jolox,blackrock,286,hunter,beastmastery,6,3,3
Trapgodz,ragnaros,271,hunter,beastmastery,11,3,8
Lightrandom,kazzak,269,hunter,beastmastery,11,3,8
Moonae,ravencrest,255,hunter,beastmastery,11,3,8
Sarblade,bronze-dragonflight,255,hunter,beastmastery,11,3,8
Shoothim,destromath,254,hunter,beastmastery,8,4,4
Johnblønn,stormscale,240,hunter,beastmastery,9,3,6
Кулерквест,soulflayer,240,hunter,beastmastery,9,3,6
Grufflin,bronzebeard,239,hunter,beastmastery,5,3,2
Barzti,thrall,239,hunter,beastmastery,5,3,2
Bigbababotan,blackrock,234,hunter,beastmastery,9,4,5
Johntoffee,eredar,234,hunter,beastmastery,17,4,13
Shagora,dalaran,223,hunter,beastmastery,8,3,5
Musraah,zuljin,192,hunter,beastmastery,5,3,2
Jarran,karazhan,192,hunter,beastmastery,6,2,4
Shademd,ahnqiraj,192,hunter,beastmastery,6,2,4
Sacroz,frostwhisper,192,hunter,beastmastery,6,2,4
Травок,gordunni,192,hunter,beastmastery,6,2,4
Scatterinc,antonidas,192,hunter,beastmastery,6,2,4
Xeragon,frostwolf,192,hunter,beastmastery,6,2,4
Silencxz,aegwynn,192,hunter,beastmastery,6,2,4
Jayyke,frostmane,192,hunter,beastmastery,6,2,4
Гернриета,gordunni,192,hunter,beastmastery,6,2,4
Инкризшот,gordunni,192,hunter,beastmastery,6,2,4
Kanzlerkohl,frostwolf,192,hunter,beastmastery,6,2,4
Lísy,hyjal,192,hunter,beastmastery,6,2,4
Ренектон,soulflayer,192,hunter,beastmastery,6,2,4
Фэйсконтроль,azuregos,192,hunter,beastmastery,6,2,4
Aughtism,turalyon,192,hunter,beastmastery,6,2,4
Soen,zuljin,192,hunter,beastmastery,6,2,4
Holytrapqt,aegwynn,192,hunter,beastmastery,6,2,4
Sarbacanes,hyjal,192,hunter,beastmastery,6,2,4
Lothram,les-sentinelles,192,hunter,beastmastery,6,2,4
Серцебиение,soulflayer,192,hunter,beastmastery,6,2,4
Deskö,shendralar,192,hunter,beastmastery,6,2,4
Ridbàck,archimonde,192,hunter,beastmastery,6,2,4
Maeba,shendralar,192,hunter,beastmastery,6,2,4
Kirinó,ragnaros,192,hunter,beastmastery,6,2,4
Zulldek,sanguino,192,hunter,beastmastery,6,2,4
Ефрейя,gordunni,192,hunter,beastmastery,6,2,4
Privelle,argent-dawn,192,hunter,beastmastery,6,2,4
Dentaar,draenor,192,hunter,beastmastery,6,2,4
Doraxa,sanguino,192,hunter,beastmastery,6,2,4
Azahunt,kazzak,192,hunter,beastmastery,6,2,4
Erenjaeger,onyxia,192,hunter,beastmastery,6,2,4
Bówyóurfácé,outland,192,hunter,beastmastery,6,2,4
Focùs,eredar,192,hunter,beastmastery,6,2,4
Nikzeubii,archimonde,192,hunter,beastmastery,6,2,4
As,kazzak,192,hunter,beastmastery,6,2,4
Bethenny,draenor,192,hunter,beastmastery,6,2,4
Ancalarion,tarren-mill,192,hunter,beastmastery,6,2,4
Jeskö,tarren-mill,192,hunter,beastmastery,6,2,4
Raztreadör,dun-modr,192,hunter,beastmastery,6,2,4
Lurigalinda,twisting-nether,192,hunter,beastmastery,6,2,4
Feedbackloop,silvermoon,192,hunter,beastmastery,6,2,4
Snarthelg,tarren-mill,192,hunter,beastmastery,6,2,4
Viktorijå,draenor,192,hunter,beastmastery,6,2,4
Samodiva,twisting-nether,192,hunter,beastmastery,6,2,4
Sarganno,archimonde,192,hunter,beastmastery,6,2,4
Wodhunterjr,ravencrest,192,hunter,beastmastery,6,2,4
Avp,sylvanas,192,hunter,beastmastery,6,2,4
Níne,sylvanas,192,hunter,beastmastery,6,2,4
Mugiwaras,eldrethalas,192,hunter,beastmastery,6,2,4
Marzenielas,silvermoon,192,hunter,beastmastery,6,2,4
Dis,twilights-hammer,192,hunter,beastmastery,6,2,4
Willýs,ysondre,192,hunter,beastmastery,6,2,4
Pixxeel,khaz-modan,192,hunter,beastmastery,6,2,4
Arykes,drakthul,192,hunter,beastmastery,6,2,4
Wøden,ysondre,192,hunter,beastmastery,6,2,4
Comegetme,auchindoun,192,hunter,beastmastery,6,2,4
Wülfhart,argent-dawn,192,hunter,beastmastery,6,2,4
Имбакласс,howling-fjord,192,hunter,beastmastery,6,2,4
Lifeiscool,drakthul,192,hunter,beastmastery,6,2,4
Bradunov,sylvanas,192,hunter,beastmastery,6,2,4
Luuszapfae,aegwynn,192,hunter,beastmastery,6,2,4
Legolex,burning-blade,192,hunter,beastmastery,6,2,4
Nómarak,drakthul,192,hunter,beastmastery,6,2,4
Zusale,azshara,192,hunter,beastmastery,6,2,4
Díkembe,aegwynn,192,hunter,beastmastery,6,2,4
Thecorruptor,skullcrusher,192,hunter,beastmastery,6,2,4
Тофуитер,howling-fjord,192,hunter,beastmastery,6,2,4
Droz,blackmoore,192,hunter,beastmastery,6,2,4
Hitray,stormscale,192,hunter,beastmastery,6,2,4
Wildwingsebb,nazjatar,192,hunter,beastmastery,6,2,4
Ataxyjr,ravencrest,192,hunter,beastmastery,6,2,4
Marryme,blackhand,192,hunter,beastmastery,6,2,4
Dragoki,blackmoore,192,hunter,beastmastery,6,2,4
Anghron,minahonda,192,hunter,beastmastery,6,2,4
Gandro,blackmoore,192,hunter,beastmastery,6,2,4
Gunmeister,bronzebeard,192,hunter,beastmastery,6,2,4
Phyllobates,blackrock,192,hunter,beastmastery,6,2,4
Noxin,blackrock,192,hunter,beastmastery,6,2,4
Willzz,ravencrest,192,hunter,beastmastery,6,2,4
Bernhardoder,blackhand,192,hunter,beastmastery,6,2,4
Bobon,stormscale,192,hunter,beastmastery,6,2,4
Ecthelione,the-venture-co,192,hunter,beastmastery,6,2,4
Tillhunt,kargath,192,hunter,beastmastery,6,2,4
Korrekt,stormscale,192,hunter,beastmastery,6,2,4
Sekzpitch,blackmoore,192,hunter,beastmastery,6,2,4
Naid,lordaeron,192,hunter,beastmastery,6,2,4
Dahunter,blackmoore,192,hunter,beastmastery,6,2,4
Tràpz,archimonde,192,hunter,beastmastery,8,2,6
Куджикс,soulflayer,192,hunter,beastmastery,19,4,15
Keinzira,hyjal,192,hunter,beastmastery,10,2,8
Psailaa,azjolnerub,192,hunter,beastmastery,12,2,10
Calesthas,tarren-mill,192,hunter,beastmastery,12,2,10
Biorson,silvermoon,192,hunter,beastmastery,12,2,10
Talmïr,archimonde,192,hunter,beastmastery,12,2,10
Örrn,ragnaros,192,hunter,beastmastery,12,2,10
Elja,laughing-skull,192,hunter,beastmastery,12,2,10
Hêndricks,eredar,192,hunter,beastmastery,12,2,10
Janjal,silvermoon,192,hunter,beastmastery,12,2,10
Кронн,howling-fjord,192,hunter,beastmastery,12,2,10
Schräubchen,antonidas,192,hunter,beastmastery,12,2,10
Slayman,kazzak,192,hunter,beastmastery,18,2,16
Traknard,confrérie-du-thorium,191,hunter,beastmastery,6,2,4
Адула,eversong,191,hunter,beastmastery,6,2,4
Charlet,archimonde,191,hunter,beastmastery,6,2,4
Begehunter,sylvanas,191,hunter,beastmastery,6,2,4
Kizscamander,magtheridon,191,hunter,beastmastery,12,2,10
Guna,aggra-português,159,hunter,beastmastery,5,2,3
Zakos,kirin-tor,159,hunter,beastmastery,5,2,3
Rakmo,blackmoore,159,hunter,beastmastery,5,2,3
Zarlena,tarren-mill,159,hunter,beastmastery,11,2,9
Phinox,sanguino,159,hunter,beastmastery,11,2,9
Åånei,twisting-nether,144,hunter,beastmastery,9,2,7
Deathøfrats,ravencrest,128,hunter,beastmastery,4,2,2
Elnazar,archimonde,128,hunter,beastmastery,4,2,2
Valiriz,blackmoore,96,hunter,beastmastery,6,1,5
Grigur,dalaran,96,hunter,beastmastery,6,1,5
Darkray,dalaran,96,hunter,beastmastery,6,1,5
Anun,magtheridon,96,hunter,beastmastery,6,1,5
Arielowy,doomhammer,96,hunter,beastmastery,6,1,5
Wayland,dalaran,96,hunter,beastmastery,6,1,5
Brønkø,azshara,96,hunter,beastmastery,6,1,5
Dasmusdrückn,antonidas,96,hunter,beastmastery,6,1,5
Badboybørge,draenor,96,hunter,beastmastery,6,1,5
Raggeh,frostwhisper,96,hunter,beastmastery,6,1,5
Nomorex,frostwhisper,96,hunter,beastmastery,6,1,5
Кертион,howling-fjord,96,hunter,beastmastery,6,1,5
Pjållistani,ravencrest,96,hunter,beastmastery,6,1,5
Дочьпескова,gordunni,96,hunter,beastmastery,6,1,5
Блэкстейдж,howling-fjord,96,hunter,beastmastery,6,1,5
Hÿyrøk,ysondre,96,hunter,beastmastery,6,1,5
Huntarbeît,eredar,96,hunter,beastmastery,6,1,5
Jozsiur,ragnaros,96,hunter,beastmastery,6,1,5
Attileus,ragnaros,96,hunter,beastmastery,6,1,5
Евилик,gordunni,96,hunter,beastmastery,6,1,5
Bloodking,madmortem,96,hunter,beastmastery,6,1,5
Bobtroll,twisting-nether,96,hunter,beastmastery,6,1,5
Táráh,proudmoore,96,hunter,beastmastery,6,1,5
Runescimmy,twisting-nether,96,hunter,beastmastery,6,1,5
Bogüen,sanguino,96,hunter,beastmastery,6,1,5
Сочнаятурель,howling-fjord,96,hunter,beastmastery,6,1,5
Gurkans,aggramar,96,hunter,beastmastery,6,1,5
Øô,blackrock,96,hunter,beastmastery,6,1,5
Justchill,ravencrest,96,hunter,beastmastery,6,1,5
Trollohunt,twisting-nether,96,hunter,beastmastery,6,1,5
Zogzøg,draenor,96,hunter,beastmastery,6,1,5
Wórldz,dun-modr,96,hunter,beastmastery,6,1,5
Gramzy,blackmoore,96,hunter,beastmastery,6,1,5
Spineshot,thrall,96,hunter,beastmastery,6,1,5
Sokrám,sanguino,96,hunter,beastmastery,6,1,5
Beastmaster,ragnaros,96,hunter,beastmastery,6,1,5
Ichbringbier,blackrock,96,hunter,beastmastery,6,1,5
Bensoussan,archimonde,96,hunter,beastmastery,6,1,5
Imahuntard,frostmane,96,hunter,beastmastery,6,1,5
Zurzok,blackrock,96,hunter,beastmastery,6,1,5
ßèástymãç,ravencrest,96,hunter,beastmastery,6,1,5
Bloodpanter,ragnaros,96,hunter,beastmastery,6,1,5
Hashaya,hyjal,96,hunter,beastmastery,6,1,5
Буреклык,gordunni,96,hunter,beastmastery,6,1,5
Facepálm,kazzak,96,hunter,beastmastery,6,1,5
Jägerjokke,blackrock,96,hunter,beastmastery,6,1,5
Exorbitant,blackrock,96,hunter,beastmastery,6,1,5
Steez,hyjal,96,hunter,beastmastery,6,1,5
Derhùnethàl,hyjal,96,hunter,beastmastery,6,1,5
Achiles,die-todeskrallen,96,hunter,beastmastery,6,1,5
Weafster,outland,96,hunter,beastmastery,6,1,5
Zugzlug,tarren-mill,96,hunter,beastmastery,6,1,5
Traptard,blackrock,96,hunter,beastmastery,6,1,5
Betarayjinx,kazzak,96,hunter,beastmastery,6,1,5
Hntudwn,azshara,96,hunter,beastmastery,6,1,5
Hõth,kazzak,96,hunter,beastmastery,6,1,5
Bobletty,tarren-mill,96,hunter,beastmastery,6,1,5
Itzcritch,tarren-mill,96,hunter,beastmastery,6,1,5
Crittix,kiljaeden,96,hunter,beastmastery,6,1,5
Hairyplottér,kazzak,96,hunter,beastmastery,6,1,5
Chambiann,tarren-mill,96,hunter,beastmastery,6,1,5
Zergst,nathrezim,96,hunter,beastmastery,6,1,5
Mævis,ravencrest,96,hunter,beastmastery,12,1,11
Críted,blackmoore,96,hunter,beastmastery,12,1,11
Thóorin,ravencrest,96,hunter,beastmastery,12,1,11
Jamaro,dun-modr,96,hunter,beastmastery,12,1,11
Tsyapka,tarren-mill,96,hunter,beastmastery,12,1,11
Milandria,antonidas,96,hunter,beastmastery,18,1,17
Халфен,eversong,79,hunter,beastmastery,5,1,4
Yahamenistos,ysondre,64,hunter,beastmastery,4,1,3
Jaszczomp,magtheridon,64,hunter,beastmastery,4,1,3
Youngjinh,ravencrest,64,hunter,beastmastery,4,1,3
Voldtzeig,dentarg,42,hunter,beastmastery,13,4,9
Liscie,silvermoon,42,hunter,beastmastery,14,2,12
Tunhaa,arthas,16,hunter,beastmastery,1,1,0
Gwaan,outland,9,hunter,beastmastery,6,2,4
Aleç,ravencrest,1932,mage,arcane,60,31,29
Choll,stormscale,1866,mage,arcane,30,20,10
Bebenm,archimonde,1851,mage,arcane,87,41,46
Нефростмаг,gordunni,1843,mage,arcane,114,61,53
Castorcato,kazzak,1841,mage,arcane,60,34,26
Wàneís,ravencrest,1840,mage,arcane,72,37,35
Obbjob,ravencrest,1748,mage,arcane,60,30,30
Фоулли,howling-fjord,1741,mage,arcane,48,25,23
Raíku,ravencrest,1723,mage,arcane,30,18,12
Непутевыймаг,gordunni,1715,mage,arcane,24,23,1
Mercem,stormscale,1711,mage,arcane,30,21,9
Wracrz,argent-dawn,1701,mage,arcane,72,41,31
Covran,stormscale,1697,mage,arcane,53,25,28
Radagulf,outland,1691,mage,arcane,85,43,42
Shirrunn,the-maelstrom,1687,mage,arcane,38,19,19
Frostseeker,tarren-mill,1684,mage,arcane,30,18,12
Persi,dentarg,1684,mage,arcane,156,78,78
Dardíe,ravencrest,1681,mage,arcane,54,31,23
Aleteia,stormscale,1667,mage,arcane,54,23,31
Dárdie,ravencrest,1662,mage,arcane,40,21,19
Sallesauruus,outland,1651,mage,arcane,54,26,28
Шттрвблнкт,soulflayer,1644,mage,arcane,83,41,42
Magijoana,silvermoon,1629,mage,arcane,32,18,14
Sérc,ravencrest,1626,mage,arcane,30,17,13
Orkamor,sylvanas,1622,mage,arcane,42,17,25
Tokerlol,stormscale,1566,mage,arcane,47,27,20
Манкай,fordragon,1564,mage,arcane,111,63,48
Ecovation,tarren-mill,1559,mage,arcane,56,29,27
Alustrasz,skullcrusher,1555,mage,arcane,72,38,34
Lemaroxd,draenor,1550,mage,arcane,29,17,12
Absie,tarren-mill,1520,mage,arcane,54,35,19
Nakamura,outland,1516,mage,arcane,338,169,169
Samirra,stormscale,1485,mage,arcane,60,32,28
Sukalamink,alonsus,1477,mage,arcane,42,22,20
Waterhagx,tarren-mill,1462,mage,arcane,23,16,7
Ekron,sanguino,1457,mage,arcane,182,91,91
Ogarcanefist,outland,1424,mage,arcane,69,35,34
Раканчик,gordunni,1406,mage,arcane,86,42,44
Lusionator,defias-brotherhood,1394,mage,arcane,54,31,23
Portal,scarshield-legion,1386,mage,arcane,30,17,13
Ephreaym,stormscale,1380,mage,arcane,41,15,26
Jhawkwizard,draenor,1379,mage,arcane,109,57,52
Barspin,lightnings-blade,1368,mage,arcane,66,36,30
Másterdukè,silvermoon,1365,mage,arcane,36,15,21
Ðøæø,twisting-nether,1346,mage,arcane,93,46,47
Tnhigh,blackrock,1343,mage,arcane,57,31,26
Проблембойх,gordunni,1343,mage,arcane,30,14,16
Elor,eredar,1331,mage,arcane,33,17,16
Diper,burning-legion,1328,mage,arcane,36,15,21
Манаманна,gordunni,1304,mage,arcane,177,89,88
Nefrendel,kazzak,1299,mage,arcane,68,33,35
Валбериса,deepholm,1298,mage,arcane,60,39,21
Akâri,silvermoon,1293,mage,arcane,42,24,18
Trucy,eredar,1292,mage,arcane,96,41,55
Pradapimp,ravencrest,1286,mage,arcane,32,15,17
Nimdáá,stormscale,1286,mage,arcane,54,24,30
Весиал,deathguard,1282,mage,arcane,42,23,19
Léa,rashgarroth,1275,mage,arcane,36,17,19
Magikere,tarren-mill,1273,mage,arcane,83,48,35
Tokyodes,twisting-nether,1262,mage,arcane,65,29,36
Arkeus,turalyon,1260,mage,arcane,35,22,13
Xiaomofashi,quelthalas,1252,mage,arcane,54,28,26
Meolchum,outland,1237,mage,arcane,45,22,23
Nécrømage,confrérie-du-thorium,1235,mage,arcane,18,13,5
Scaleeth,kazzak,1233,mage,arcane,30,13,17
Rezre,stormscale,1212,mage,arcane,54,28,26
Нормалмап,soulflayer,1210,mage,arcane,36,13,23
Sszz,ravencrest,1197,mage,arcane,84,47,37
Канеллис,howling-fjord,1197,mage,arcane,37,14,23
Ozdewish,hyjal,1187,mage,arcane,103,47,56
Scaless,stormscale,1170,mage,arcane,34,14,20
Demizboub,archimonde,1154,mage,arcane,168,85,83
Cubis,archimonde,1152,mage,arcane,24,12,12
Tiqma,sylvanas,1151,mage,arcane,24,12,12
Сизаам,howling-fjord,1147,mage,arcane,24,12,12
Paradigma,sylvanas,1142,mage,arcane,24,12,12
Hardways,archimonde,1091,mage,arcane,114,47,67
Sulteaxion,garrosh,1085,mage,arcane,24,12,12
Макотшельник,gordunni,1056,mage,arcane,12,11,1
Nïo,ravencrest,1047,mage,arcane,30,11,19
Roulettefar,kazzak,1038,mage,arcane,24,11,13
Noarcane,twisting-nether,999,mage,arcane,42,21,21
Mylord,bronze-dragonflight,993,mage,arcane,53,21,32
Iwannakissu,gorgonnash,992,mage,arcane,29,15,14
Burstology,kazzak,959,mage,arcane,18,10,8
Иссэя,borean-tundra,954,mage,arcane,37,21,16
Zezt,tarren-mill,939,mage,arcane,30,10,20
Frostdeath,medivh,906,mage,arcane,24,10,14
Mannenye,stormscale,899,mage,arcane,30,11,19
Nelfchewer,ravencrest,878,mage,arcane,17,10,7
Вадимодесса,soulflayer,877,mage,arcane,61,28,33
Puni,emerald-dream,864,mage,arcane,12,9,3
Fuhry,tarren-mill,864,mage,arcane,12,9,3
Bullegong,archimonde,863,mage,arcane,18,9,9
Дырявка,galakrond,859,mage,arcane,24,9,15
Kobrass,spinebreaker,855,mage,arcane,30,9,21
Zimbabweborc,burning-legion,768,mage,arcane,12,8,4
Яшабурстх,blackscar,768,mage,arcane,18,8,10
Zehnvonzehn,antonidas,767,mage,arcane,18,8,10
Aeghis,darkspear,765,mage,arcane,18,8,10
Ímnotback,outland,718,mage,arcane,23,8,15
Freshforces,ragnaros,703,mage,arcane,22,8,14
Jengele,argent-dawn,672,mage,arcane,12,7,5
Doryy,silvermoon,672,mage,arcane,12,7,5
Nötmârtònxø,ragnaros,671,mage,arcane,12,7,5
Thorstäin,ragnaros,670,mage,arcane,18,7,11
Fôôxy,aegwynn,668,mage,arcane,12,7,5
Кронни,razuvious,662,mage,arcane,17,7,10
Димаскунфу,howling-fjord,640,mage,arcane,22,7,15
Fearbeäch,ravencrest,623,mage,arcane,11,7,4
Mageé,argent-dawn,621,mage,arcane,17,7,10
Зухвала,howling-fjord,611,mage,arcane,23,7,16
Roughfked,silvermoon,599,mage,arcane,17,8,9
Рбгпотаскуха,gordunni,576,mage,arcane,6,6,0
Pyllymake,kazzak,576,mage,arcane,12,6,6
Tarovan,defias-brotherhood,575,mage,arcane,12,6,6
Spicymash,chogall,575,mage,arcane,12,6,6
Sticlachivas,stormscale,575,mage,arcane,18,6,12
Sarjeta,grim-batol,572,mage,arcane,18,6,12
Сморгонец,gordunni,571,mage,arcane,12,6,6
Banjó,twilights-hammer,480,mage,arcane,6,5,1
Tamtheone,frostwhisper,480,mage,arcane,6,5,1
Alarak,drakthul,480,mage,arcane,12,5,7
Pwntt,terenas,480,mage,arcane,12,5,7
Astrryy,burning-legion,480,mage,arcane,12,5,7
Venchimage,silvermoon,480,mage,arcane,12,5,7
Barryscótt,stormscale,480,mage,arcane,12,5,7
Soulraider,tarren-mill,480,mage,arcane,12,5,7
Vaerén,malganis,480,mage,arcane,12,5,7
Ледянойкекс,gordunni,480,mage,arcane,18,5,13
Mðj,kazzak,480,mage,arcane,18,5,13
Ewina,twisting-nether,479,mage,arcane,6,5,1
Mortlol,chamber-of-aspects,479,mage,arcane,12,5,7
Plor,exodar,478,mage,arcane,14,6,8
Gorn,ravencrest,478,mage,arcane,12,5,7
Папущенный,soulflayer,458,mage,arcane,20,7,13
Apollohouse,ravencrest,384,mage,arcane,6,4,2
Fadi,anachronos,384,mage,arcane,6,4,2
Letsa,stormscale,384,mage,arcane,6,4,2
Мглавечная,azuregos,384,mage,arcane,6,4,2
Yunox,stormscale,384,mage,arcane,6,4,2
Hexmath,tarren-mill,384,mage,arcane,6,4,2
Бигдикмаг,soulflayer,384,mage,arcane,6,4,2
Rizzlybear,outland,384,mage,arcane,6,4,2
Boogeyone,drakthul,384,mage,arcane,12,4,8
Angélique,ragnaros,384,mage,arcane,12,4,8
Cysbb,arathi,384,mage,arcane,12,4,8
Uskomaaginen,ravencrest,384,mage,arcane,12,4,8
Zoot,ravencrest,384,mage,arcane,12,4,8
Uní,emerald-dream,384,mage,arcane,12,4,8
Mäalaka,archimonde,384,mage,arcane,12,4,8
Mupana,nagrand,384,mage,arcane,12,4,8
Säga,the-venture-co,384,mage,arcane,18,4,14
Mikaelà,blackmoore,383,mage,arcane,6,4,2
Дантрий,gordunni,382,mage,arcane,6,4,2
Bigshape,frostwolf,351,mage,arcane,11,4,7
Onlymage,outland,288,mage,arcane,6,3,3
Aristarco,outland,288,mage,arcane,6,3,3
Khoshgele,draenor,288,mage,arcane,6,3,3
Magiwan,silvermoon,288,mage,arcane,6,3,3
Euphorie,twisting-nether,288,mage,arcane,6,3,3
Æskalatîøn,blackmoore,288,mage,arcane,6,3,3
Kyrn,zuljin,288,mage,arcane,6,3,3
Hachiro,onyxia,288,mage,arcane,6,3,3
Brokenlegman,defias-brotherhood,288,mage,arcane,6,3,3
Winterblues,frostmourne,288,mage,arcane,6,3,3
Ovrpwrdxd,kazzak,288,mage,arcane,6,3,3
Gagaj,ravencrest,288,mage,arcane,6,3,3
Choise,stormscale,288,mage,arcane,6,3,3
Auchenax,argent-dawn,288,mage,arcane,6,3,3
Deadtedd,twisting-nether,288,mage,arcane,6,3,3
Даанрен,galakrond,288,mage,arcane,6,3,3
Dcolon,tarren-mill,288,mage,arcane,6,3,3
Serctheone,ravencrest,288,mage,arcane,9,4,5
Хблэйз,howling-fjord,288,mage,arcane,12,3,9
Kudakto,ravencrest,288,mage,arcane,12,3,9
Malshash,outland,287,mage,arcane,6,3,3
Arcadua,sanguino,287,mage,arcane,6,3,3
Neséri,blackmoore,287,mage,arcane,10,3,7
Kasus,sporeggar,286,mage,arcane,6,3,3
Исусина,borean-tundra,286,mage,arcane,6,3,3
Brugg,antonidas,284,mage,arcane,12,3,9
Naween,hyjal,239,mage,arcane,5,3,2
Phyzed,archimonde,192,mage,arcane,6,2,4
Shiranize,aegwynn,192,mage,arcane,6,2,4
Naomypayton,tarren-mill,192,mage,arcane,6,2,4
Superduck,ragnaros,192,mage,arcane,6,2,4
Зерагуд,eversong,192,mage,arcane,6,2,4
Teeclis,twisting-nether,192,mage,arcane,6,2,4
Schøkø,eredar,192,mage,arcane,6,2,4
Галадриелька,gordunni,192,mage,arcane,6,2,4
Ãshs,archimonde,192,mage,arcane,6,2,4
Arimila,sylvanas,192,mage,arcane,6,2,4
Baravar,blackrock,192,mage,arcane,6,2,4
Kbd,outland,192,mage,arcane,6,2,4
Noxkin,stormscale,192,mage,arcane,6,2,4
Versachi,neptulon,192,mage,arcane,6,2,4
Kuhwar,echsenkessel,192,mage,arcane,6,2,4
Ryûblast,archimonde,192,mage,arcane,6,2,4
Nerzzhul,burning-legion,192,mage,arcane,6,2,4
Леракобольд,gordunni,192,mage,arcane,6,2,4
Drinte,blackmoore,192,mage,arcane,6,2,4
Линклер,fordragon,192,mage,arcane,6,2,4
Hruon,ravenholdt,192,mage,arcane,6,2,4
Kold,stormscale,192,mage,arcane,6,2,4
Æones,kult-der-verdammten,192,mage,arcane,12,2,10
Icx,tarren-mill,191,mage,arcane,6,2,4
Veveroiu,defias-brotherhood,191,mage,arcane,6,2,4
Magse,kirin-tor,191,mage,arcane,6,2,4
Jamzymage,emerald-dream,96,mage,arcane,3,2,1
Sorrow,outland,96,mage,arcane,6,1,5
Animaze,argent-dawn,96,mage,arcane,6,1,5
Hólmess,silvermoon,96,mage,arcane,6,1,5
Souldemon,burning-legion,96,mage,arcane,6,1,5
Døomey,ravencrest,96,mage,arcane,6,1,5
Nohbrain,blackmoore,96,mage,arcane,6,1,5
Sidildur,ravencrest,96,mage,arcane,6,1,5
Старкскрим,gordunni,96,mage,arcane,6,1,5
Thelastmage,outland,96,mage,arcane,6,1,5
Moosemæn,stormscale,96,mage,arcane,6,1,5
Мерац,howling-fjord,96,mage,arcane,6,1,5
Azakadabra,ysondre,96,mage,arcane,6,1,5
Seraf,argent-dawn,96,mage,arcane,6,1,5
Magicpowers,silvermoon,96,mage,arcane,12,1,11
Манднесс,azuregos,79,mage,arcane,11,1,10
Thegoodoctor,kazzak,2096,mage,fire,75,41,34
Gelußaßa,ravencrest,2076,mage,fire,77,42,35
Håtsu,ravencrest,2060,mage,fire,78,39,39
Twizzkek,silvermoon,2032,mage,fire,87,43,44
Slôw,kazzak,2029,mage,fire,42,29,13
Ráìkù,ravencrest,2021,mage,fire,60,32,28
Реордиан,gordunni,1975,mage,fire,86,38,48
Яшабурстх,blackscar,1943,mage,fire,72,38,34
Рофкастер,gordunni,1929,mage,fire,113,53,60
Tommy,laughing-skull,1928,mage,fire,60,34,26
Rizzlybear,outland,1918,mage,fire,75,35,40
Laynerz,kazzak,1917,mage,fire,27,21,6
Milkenjoyer,ravencrest,1906,mage,fire,47,30,17
Mssilvy,sylvanas,1900,mage,fire,213,116,97
Шипми,gordunni,1893,mage,fire,90,46,44
Hatsu,kazzak,1884,mage,fire,60,32,28
Uknowhowwedu,aegwynn,1879,mage,fire,36,20,16
Hey,khazgoroth,1857,mage,fire,54,35,19
Uniquenoodle,alakir,1857,mage,fire,72,34,38
Cörnflekz,stormscale,1850,mage,fire,44,28,16
Dardie,ravencrest,1849,mage,fire,48,30,18
Hazewrld,ravencrest,1848,mage,fire,132,62,70
Lotharie,aegwynn,1847,mage,fire,36,23,13
Spelltastíc,blackmoore,1844,mage,fire,54,34,20
Dazz,ravencrest,1841,mage,fire,60,30,30
Libre,stormscale,1837,mage,fire,118,70,48
Wàneís,ravencrest,1831,mage,fire,40,25,15
Archíques,kazzak,1831,mage,fire,46,24,22
Твейзи,blackscar,1823,mage,fire,40,24,16
Evohz,stormscale,1822,mage,fire,66,33,33
Hólmess,silvermoon,1821,mage,fire,84,42,42
Nøw,kazzak,1816,mage,fire,48,29,19
Elmaestró,aegwynn,1815,mage,fire,48,30,18
Bigkent,stormscale,1814,mage,fire,62,27,35
Nihilvm,dalaran,1812,mage,fire,46,26,20
Smlx,outland,1799,mage,fire,54,31,23
Ygø,hyjal,1799,mage,fire,126,60,66
Cesi,silvermoon,1793,mage,fire,36,19,17
Djflashz,archimonde,1779,mage,fire,46,24,22
Reyown,archimonde,1777,mage,fire,54,40,14
Ókamí,ravencrest,1776,mage,fire,115,59,56
Ширм,blackscar,1774,mage,fire,42,22,20
Magethings,kazzak,1763,mage,fire,54,35,19
Jirt,stormscale,1752,mage,fire,53,30,23
Zzpf,silvermoon,1752,mage,fire,60,28,32
Siérra,outland,1751,mage,fire,90,57,33
Dizzy,ahnqiraj,1751,mage,fire,78,35,43
Cienaños,outland,1750,mage,fire,96,54,42
Диссоциация,greymane,1746,mage,fire,42,26,16
Гекомория,fordragon,1736,mage,fire,65,26,39
Isenhour,frostmane,1729,mage,fire,156,76,80
Asterixus,sylvanas,1728,mage,fire,72,44,28
Mágetráiner,ravencrest,1721,mage,fire,36,18,18
Naps,argent-dawn,1713,mage,fire,66,43,23
Petar,tarren-mill,1711,mage,fire,61,36,25
Rekzaop,ravencrest,1700,mage,fire,28,19,9
Dxdxdxdxdx,drakthul,1700,mage,fire,48,26,22
Jumpfanqt,stormscale,1685,mage,fire,30,23,7
Disnay,draenor,1679,mage,fire,237,127,110
Авгурей,howling-fjord,1678,mage,fire,112,54,58
Skrex,blackrock,1677,mage,fire,138,78,60
Spelltastìc,blackmoore,1675,mage,fire,36,18,18
Medivqt,ragnaros,1666,mage,fire,30,23,7
Radiantfury,outland,1662,mage,fire,52,24,28
Isildurone,ragnaros,1648,mage,fire,44,24,20
Itrius,tarren-mill,1647,mage,fire,48,23,25
Magenerfed,archimonde,1637,mage,fire,42,21,21
Ðevlqt,blackmoore,1636,mage,fire,30,22,8
Fuego,sylvanas,1633,mage,fire,57,30,27
Прауз,soulflayer,1633,mage,fire,39,20,19
Sheepmeepbip,ravencrest,1632,mage,fire,81,35,46
Obbjob,ravencrest,1631,mage,fire,72,36,36
Mikefires,blackrock,1630,mage,fire,32,21,11
Ayken,burning-legion,1628,mage,fire,42,26,16
Roxxis,kazzak,1625,mage,fire,30,17,13
Frøstqt,ravencrest,1625,mage,fire,41,19,22
Evovar,silvermoon,1621,mage,fire,40,18,22
Macheat,kazzak,1619,mage,fire,48,25,23
Lilblinks,silvermoon,1609,mage,fire,90,49,41
Elldiamage,draenor,1608,mage,fire,35,21,14
Ênizt,archimonde,1604,mage,fire,33,21,12
Айслэнц,howling-fjord,1602,mage,fire,42,21,21
Frozentwink,kul-tiras,1601,mage,fire,40,21,19
Doonii,ragnaros,1596,mage,fire,47,20,27
Dantiqa,ravencrest,1593,mage,fire,158,81,77
Underscore,outland,1592,mage,fire,35,20,15
Råståfåri,uldum,1589,mage,fire,75,39,36
Whats,korgall,1585,mage,fire,70,39,31
Czd,outland,1574,mage,fire,53,21,32
Gaárá,stormscale,1566,mage,fire,60,29,31
Quentin,grim-batol,1563,mage,fire,42,20,22
Hardtimes,blackhand,1556,mage,fire,74,38,36
Stoychav,outland,1545,mage,fire,78,38,40
Camiina,shattered-hand,1544,mage,fire,78,44,34
Babidi,nemesis,1544,mage,fire,42,23,19
Вовзон,howling-fjord,1540,mage,fire,35,19,16
Ghalanz,ravencrest,1537,mage,fire,83,43,40
Gagaj,ravencrest,1534,mage,fire,42,20,22
Calientay,ragnaros,1533,mage,fire,42,21,21
Фоулли,howling-fjord,1526,mage,fire,30,16,14
Hexmath,tarren-mill,1518,mage,fire,53,30,23
Hil,blackrock,1516,mage,fire,30,19,11
Enandia,darksorrow,1514,mage,fire,63,30,33
Consquens,aszune,1509,mage,fire,24,16,8
Экзорсус,goldrinn,1504,mage,fire,146,73,73
Carinuz,blackmoore,1503,mage,fire,49,22,27
Glïder,archimonde,1482,mage,fire,30,16,14
Insanewizard,kazzak,1480,mage,fire,59,30,29
Lokilus,dalaran,1476,mage,fire,30,20,10
Эстерленс,gordunni,1459,mage,fire,36,25,11
Aikamie,draenor,1456,mage,fire,71,37,34
Htwhy,kazzak,1448,mage,fire,36,16,20
Secretagent,aegwynn,1439,mage,fire,66,37,29
Mäalaka,archimonde,1439,mage,fire,48,26,22
Auchenax,argent-dawn,1429,mage,fire,22,16,6
Shahnoza,thrall,1428,mage,fire,24,15,9
Neird,sinstralis,1428,mage,fire,72,38,34
Plætinum,ravencrest,1427,mage,fire,110,55,55
Fireblood,runetotem,1426,mage,fire,36,15,21
Достижений,soulflayer,1422,mage,fire,42,15,27
Insaneex,aegwynn,1414,mage,fire,30,17,13
Aimaniac,stormscale,1403,mage,fire,107,58,49
Vzrmage,antonidas,1402,mage,fire,108,46,62
Колдрагос,gordunni,1398,mage,fire,42,17,25
Intz,twisting-nether,1397,mage,fire,39,16,23
Gnomag,argent-dawn,1392,mage,fire,78,37,41
Razrkh,ragnaros,1391,mage,fire,66,34,32
Ледянойкекс,gordunni,1390,mage,fire,52,26,26
Skarxaa,sanguino,1390,mage,fire,48,23,25
Rayniß,blackmoore,1389,mage,fire,66,30,36
Дрраго,greymane,1386,mage,fire,93,46,47
Деозар,eversong,1382,mage,fire,102,49,53
Kappotjeplif,ravencrest,1378,mage,fire,90,47,43
Tiltedpapi,ravencrest,1377,mage,fire,41,18,23
Линклер,fordragon,1374,mage,fire,24,15,9
Shizzy,onyxia,1370,mage,fire,45,22,23
Atixx,aegwynn,1369,mage,fire,48,20,28
Triplesevenx,silvermoon,1365,mage,fire,59,27,32
Рифтиг,howling-fjord,1365,mage,fire,61,27,34
Apócalyptic,tarren-mill,1364,mage,fire,105,51,54
Bonto,tarren-mill,1364,mage,fire,48,23,25
Noviina,argent-dawn,1348,mage,fire,31,18,13
Pisini,tarren-mill,1342,mage,fire,30,14,16
Zestrax,kazzak,1339,mage,fire,42,29,13
Нереварин,soulflayer,1338,mage,fire,27,15,12
Ryzea,ravencrest,1338,mage,fire,41,21,20
Bloodycast,archimonde,1338,mage,fire,40,16,24
Reqwyz,ragnaros,1337,mage,fire,32,16,16
Аквамэрис,gordunni,1336,mage,fire,24,14,10
Аквамелис,gordunni,1334,mage,fire,30,14,16
Fenrirson,drakthul,1325,mage,fire,48,28,20
Magicalmig,draenor,1323,mage,fire,126,75,51
Darríck,argent-dawn,1323,mage,fire,41,16,25
Momomagic,silvermoon,1318,mage,fire,64,31,33
Stylaaz,twisting-nether,1317,mage,fire,35,18,17
Аваон,deathguard,1317,mage,fire,124,62,62
Imtrynasheep,kazzak,1311,mage,fire,24,14,10
Gerdâ,chants-éternels,1305,mage,fire,53,29,24
Liendri,aegwynn,1305,mage,fire,30,14,16
Bclaudiu,terokkar,1303,mage,fire,28,15,13
Fiveboyjr,tarren-mill,1302,mage,fire,54,29,25
Bobbasor,defias-brotherhood,1299,mage,fire,45,21,24
Mauvé,blades-edge,1279,mage,fire,43,23,20
Manvo,bloodscalp,1279,mage,fire,42,21,21
Быкуня,gordunni,1276,mage,fire,36,20,16
Dóncójones,blackrock,1276,mage,fire,77,37,40
Tûttifrutti,ravencrest,1274,mage,fire,36,14,22
Вселениум,razuvious,1271,mage,fire,58,31,27
Zéngã,kazzak,1263,mage,fire,31,15,16
Nocturnes,sylvanas,1262,mage,fire,31,14,17
Cinoox,blackrock,1259,mage,fire,78,41,37
Varenca,blackrock,1256,mage,fire,75,35,40
Quiwi,dun-modr,1249,mage,fire,22,16,6
Magmarro,burning-legion,1248,mage,fire,77,36,41
Фрозитв,blackscar,1247,mage,fire,18,13,5
Prácticemàge,archimonde,1246,mage,fire,18,13,5
Fingolfin,amanthul,1246,mage,fire,237,111,126
Yanir,die-arguswacht,1245,mage,fire,24,13,11
Âcryz,blackrock,1242,mage,fire,30,13,17
Zensheep,silvermoon,1235,mage,fire,24,13,11
Pandathis,frostwolf,1233,mage,fire,18,13,5
Elcølgaø,sanguino,1233,mage,fire,30,13,17
Смилер,gordunni,1231,mage,fire,24,13,11
Tokerlol,stormscale,1231,mage,fire,27,13,14
Faunas,kazzak,1230,mage,fire,46,27,19
Goomba,tarren-mill,1227,mage,fire,43,14,29
Warwizz,sanguino,1226,mage,fire,24,13,11
Yshax,malganis,1225,mage,fire,29,13,16
Mëgu,silvermoon,1222,mage,fire,155,76,79
Ràyden,khaz-modan,1219,mage,fire,36,18,18
Nuvx,ravencrest,1212,mage,fire,72,39,33
Romethito,dun-modr,1203,mage,fire,24,17,7
Immortanjoe,thrall,1203,mage,fire,54,24,30
Skylezy,blackrock,1198,mage,fire,23,13,10
Eutkir,silvermoon,1195,mage,fire,31,16,15
Wizmec,silvermoon,1191,mage,fire,72,30,42
Töframaður,draenor,1184,mage,fire,22,13,9
Caesarclown,silvermoon,1181,mage,fire,43,25,18
Dobbite,archimonde,1178,mage,fire,30,21,9
Firedeáth,kazzak,1176,mage,fire,22,13,9
Athenå,dalaran,1176,mage,fire,48,21,27
Blitzo,madmortem,1174,mage,fire,53,29,24
Critr,sylvanas,1155,mage,fire,59,30,29
Nilitar,kazzak,1152,mage,fire,24,12,12
Pyrobomb,sylvanas,1150,mage,fire,18,12,6
Kaki,stormscale,1150,mage,fire,30,16,14
Azulêera,archimonde,1149,mage,fire,24,12,12
Rewq,twisting-nether,1147,mage,fire,18,12,6
Utarii,deathwing,1146,mage,fire,18,12,6
Demensida,ravencrest,1145,mage,fire,28,13,15
Büyübaba,twisting-nether,1145,mage,fire,30,12,18
Elesios,blackmoore,1144,mage,fire,24,12,12
Avakadaver,draenor,1143,mage,fire,24,12,12
Revanov,outland,1142,mage,fire,18,12,6
Texmexguden,tarren-mill,1142,mage,fire,30,12,18
Themagicguy,silvermoon,1140,mage,fire,24,12,12
Lybazinga,frostmane,1118,mage,fire,37,16,21
Fritmckhaine,archimonde,1114,mage,fire,48,27,21
Nezousta,sinstralis,1094,mage,fire,24,12,12
Rapidfrost,drakthul,1092,mage,fire,28,18,10
Gorleg,draenor,1072,mage,fire,47,17,30
Newtwo,ravencrest,1070,mage,fire,25,12,13
Mowns,ravencrest,1056,mage,fire,24,11,13
Твейдей,blackscar,1056,mage,fire,24,11,13
Sleepingfate,stormscale,1055,mage,fire,18,11,7
Anisovsky,archimonde,1055,mage,fire,24,11,13
Emoden,silvermoon,1054,mage,fire,18,11,7
Anshara,stormscale,1052,mage,fire,30,16,14
Aulny,kaelthas,1049,mage,fire,24,11,13
Мозифорест,gordunni,1047,mage,fire,30,11,19
Icx,tarren-mill,1043,mage,fire,63,35,28
Laetitiah,archimonde,1042,mage,fire,26,11,15
Mikaelà,blackmoore,1040,mage,fire,18,11,7
Larah,les-clairvoyants,1038,mage,fire,18,11,7
Hahahehe,aegwynn,1033,mage,fire,24,11,13
Freezeballs,blackmoore,1017,mage,fire,37,12,25
Pablø,blackrock,1014,mage,fire,31,15,16
Cyrîll,malygos,1004,mage,fire,73,36,37
Drunkpunk,kazzak,974,mage,fire,18,11,7
Magijoana,silvermoon,959,mage,fire,36,10,26
Rambau,archimonde,958,mage,fire,18,10,8
Akâri,silvermoon,958,mage,fire,18,10,8
Symera,dun-modr,958,mage,fire,18,10,8
Mejtschazor,twisting-nether,957,mage,fire,18,10,8
Charizard,emerald-dream,956,mage,fire,15,11,4
Arandartis,kazzak,954,mage,fire,18,10,8
Wizarð,archimonde,952,mage,fire,18,10,8
Çana,thrall,952,mage,fire,30,10,20
Leontus,outland,951,mage,fire,12,10,2
Shealá,blackhand,951,mage,fire,24,10,14
Firewitch,blackhand,950,mage,fire,24,10,14
Kuríbo,gorgonnash,944,mage,fire,21,11,10
Дмблдр,soulflayer,943,mage,fire,21,11,10
Sèrum,drakthul,927,mage,fire,23,10,13
Santoz,blackrock,926,mage,fire,58,30,28
Freezandrun,tarren-mill,918,mage,fire,47,21,26
Pyro,daggerspine,904,mage,fire,18,11,7
Magicspark,madmortem,904,mage,fire,74,35,39
Nåzmyz,outland,891,mage,fire,17,10,7
Sagregas,silvermoon,876,mage,fire,65,28,37
Turbomedusa,draenor,864,mage,fire,12,9,3
Dyen,hyjal,864,mage,fire,12,9,3
Magão,frostmane,864,mage,fire,12,9,3
Magerocks,ragnaros,864,mage,fire,12,9,3
Lemaroxd,draenor,864,mage,fire,18,9,9
Spacehoe,stormscale,864,mage,fire,18,9,9
Nùts,archimonde,864,mage,fire,18,9,9
Tagrine,kaelthas,863,mage,fire,12,9,3
Smíte,kazzak,863,mage,fire,12,9,3
Sakuranosuke,twisting-nether,863,mage,fire,18,9,9
Estelliên,burning-legion,863,mage,fire,18,9,9
Steveishigh,tarren-mill,863,mage,fire,19,9,10
Rilac,nordrassil,862,mage,fire,18,9,9
Weedup,zuljin,862,mage,fire,18,9,9
Morphis,talnivarr,862,mage,fire,18,9,9
Silatara,twisting-nether,860,mage,fire,18,9,9
Чоуза,gordunni,858,mage,fire,24,9,15
Løxyy,ysondre,852,mage,fire,26,11,15
Netherstorm,chogall,848,mage,fire,24,10,14
Bigbazzabean,silvermoon,840,mage,fire,36,13,23
Firen,thrall,827,mage,fire,18,9,9
Baxeraa,draenor,824,mage,fire,20,10,10
Takayaki,terokkar,783,mage,fire,19,9,10
Mlodysimba,burning-legion,768,mage,fire,12,8,4
Larmp,outland,768,mage,fire,12,8,4
Fakeklepter,sylvanas,768,mage,fire,12,8,4
Matsuratkø,nemesis,768,mage,fire,12,8,4
Ilikesheep,blackmoore,768,mage,fire,12,8,4
Yésdávé,stormscale,768,mage,fire,12,8,4
Apollohouse,ravencrest,768,mage,fire,12,8,4
Nuj,blackrock,768,mage,fire,12,8,4
Choll,stormscale,768,mage,fire,18,8,10
Незерёб,soulflayer,768,mage,fire,18,8,10
Zelimeth,outland,768,mage,fire,18,8,10
Sanjoop,tarren-mill,768,mage,fire,18,8,10
Zoot,ravencrest,768,mage,fire,24,8,16
Airo,drakthul,768,mage,fire,24,8,16
Mðj,kazzak,768,mage,fire,24,8,16
Алаурс,howling-fjord,767,mage,fire,18,8,10
Witak,ysondre,767,mage,fire,18,8,10
Pluggis,the-maelstrom,767,mage,fire,18,8,10
Mieria,argent-dawn,767,mage,fire,18,8,10
Dynamica,ravencrest,767,mage,fire,18,8,10
Røvso,ragnaros,767,mage,fire,18,8,10
Dauwen,silvermoon,767,mage,fire,18,8,10
Магмагистр,blackscar,767,mage,fire,24,8,16
Takiix,antonidas,766,mage,fire,12,8,4
Versachi,neptulon,766,mage,fire,18,8,10
Exitelol,blackrock,764,mage,fire,18,8,10
Estwald,arathor,763,mage,fire,18,8,10
Wîtchcurse,dentarg,763,mage,fire,24,8,16
Iamslow,sylvanas,762,mage,fire,12,8,4
Вельдрик,soulflayer,762,mage,fire,24,8,16
Majinbo,doomhammer,760,mage,fire,18,8,10
Arcadua,sanguino,758,mage,fire,12,8,4
Фиеран,grom,747,mage,fire,26,10,16
Rasputina,blackrock,744,mage,fire,35,12,23
Kalyypso,arygos,735,mage,fire,16,9,7
Mitchmage,ravencrest,732,mage,fire,17,8,9
Drè,daggerspine,672,mage,fire,12,7,5
Equálity,blackrock,672,mage,fire,12,7,5
Эммилиарда,gordunni,672,mage,fire,12,7,5
Thughunterqt,silvermoon,672,mage,fire,12,7,5
Iconic,eredar,672,mage,fire,12,7,5
Zíru,outland,672,mage,fire,12,7,5
Двинск,soulflayer,672,mage,fire,12,7,5
Anaxtra,guldan,672,mage,fire,18,7,11
Tiáno,drakthul,672,mage,fire,18,7,11
Mangiafuoco,nemesis,672,mage,fire,18,7,11
Arcann,ravencrest,671,mage,fire,12,7,5
Calegos,twisting-nether,671,mage,fire,12,7,5
Spellfaker,drakthul,671,mage,fire,12,7,5
Zaci,argent-dawn,671,mage,fire,12,7,5
Zeklo,frostmane,671,mage,fire,18,7,11
Sadrã,kazzak,671,mage,fire,18,7,11
Camelshaver,tarren-mill,671,mage,fire,18,7,11
Magicuze,argent-dawn,671,mage,fire,18,7,11
Ustafrr,argent-dawn,670,mage,fire,13,7,6
Жгумпель,howling-fjord,670,mage,fire,24,7,17
Magikere,tarren-mill,639,mage,fire,17,7,10
Vulcanx,stormscale,638,mage,fire,17,7,10
Bezelgeuse,pozzo-delleternità,623,mage,fire,17,7,10
Chrismage,argent-dawn,606,mage,fire,20,7,13
Whócárés,dragonmaw,576,mage,fire,6,6,0
Apcg,sylvanas,576,mage,fire,6,6,0
Arcticfury,ravencrest,576,mage,fire,6,6,0
Zimbabweborc,burning-legion,576,mage,fire,12,6,6
Octtmiss,twisting-nether,576,mage,fire,12,6,6
Canceled,kazzak,576,mage,fire,12,6,6
Serctheone,ravencrest,576,mage,fire,12,6,6
Skylez,blackrock,576,mage,fire,12,6,6
Pradapimp,ravencrest,576,mage,fire,12,6,6
Feath,ravencrest,576,mage,fire,12,6,6
Macey,ravencrest,576,mage,fire,12,6,6
Rhodghar,ravencrest,576,mage,fire,12,6,6
Бингчилинг,howling-fjord,576,mage,fire,12,6,6
Säroumäne,archimonde,576,mage,fire,12,6,6
Codeincassie,blackhand,576,mage,fire,12,6,6
Relik,sylvanas,576,mage,fire,18,6,12
Akhali,chamber-of-aspects,575,mage,fire,12,6,6
Sukalamink,alonsus,575,mage,fire,12,6,6
Arhi,silvermoon,575,mage,fire,12,6,6
Saturator,burning-legion,575,mage,fire,18,6,12
Lupuus,anubarak,575,mage,fire,24,6,18
Explosìve,arthas,574,mage,fire,12,6,6
Durdi,silvermoon,574,mage,fire,12,6,6
Nâmiz,blackrock,528,mage,fire,9,6,3
Bzzr,tarren-mill,480,mage,fire,6,5,1
Excuséme,ravencrest,480,mage,fire,6,5,1
Kurtcobain,draenor,480,mage,fire,6,5,1
Yoku,nethersturm,480,mage,fire,6,5,1
Cleancc,blackhand,480,mage,fire,6,5,1
Jíncks,draenor,480,mage,fire,6,5,1
Jél,stormscale,480,mage,fire,6,5,1
Magechonk,kazzak,480,mage,fire,12,5,7
Sheepwithmeh,blackrock,480,mage,fire,12,5,7
Ziscine,tarren-mill,480,mage,fire,12,5,7
Arcandor,tarren-mill,480,mage,fire,12,5,7
Røysi,ravencrest,480,mage,fire,12,5,7
Ахиригиз,gordunni,480,mage,fire,12,5,7
Schøkø,eredar,480,mage,fire,12,5,7
Brokenlegman,defias-brotherhood,480,mage,fire,12,5,7
Проблембойх,gordunni,480,mage,fire,12,5,7
Runbabyrun,hyjal,480,mage,fire,12,5,7
Teeclis,twisting-nether,480,mage,fire,12,5,7
Backped,kazzak,480,mage,fire,18,5,13
Валбериса,deepholm,479,mage,fire,6,5,1
Spispi,burning-legion,479,mage,fire,15,6,9
Нетлель,soulflayer,479,mage,fire,18,5,13
Nohbrain,blackmoore,479,mage,fire,18,5,13
Iceorb,azshara,479,mage,fire,24,5,19
Spader,argent-dawn,478,mage,fire,12,5,7
Skitsó,shadowsong,477,mage,fire,12,5,7
Exorifrigo,dun-modr,477,mage,fire,22,5,17
Eldiablo,dun-modr,476,mage,fire,12,5,7
Draenaya,forscherliga,473,mage,fire,21,6,15
Buuszek,outland,430,mage,fire,11,5,6
Fäust,drakthul,425,mage,fire,28,6,22
Файрусх,deathguard,384,mage,fire,6,4,2
Gidsor,silvermoon,384,mage,fire,6,4,2
Saryotheone,silvermoon,384,mage,fire,6,4,2
Drewna,silvermoon,384,mage,fire,6,4,2
Waterhagx,tarren-mill,384,mage,fire,6,4,2
Naween,hyjal,384,mage,fire,6,4,2
Doryy,silvermoon,384,mage,fire,6,4,2
Blinker,frostwhisper,384,mage,fire,6,4,2
Гандолъер,soulflayer,384,mage,fire,6,4,2
Rotøk,burning-legion,384,mage,fire,6,4,2
Zyreanx,blackrock,384,mage,fire,6,4,2
Gennésïs,darksorrow,384,mage,fire,6,4,2
Pavlé,draenor,384,mage,fire,6,4,2
Mnday,ravencrest,384,mage,fire,6,4,2
Ovrpwrdxd,kazzak,384,mage,fire,6,4,2
Azîlko,frostwolf,384,mage,fire,6,4,2
Wormhole,kazzak,384,mage,fire,6,4,2
Praison,defias-brotherhood,384,mage,fire,6,4,2
Нефростмаг,gordunni,384,mage,fire,6,4,2
Kitchimage,ravencrest,384,mage,fire,6,4,2
Cardioexpert,ravencrest,384,mage,fire,6,4,2
Aarcheon,kazzak,384,mage,fire,12,4,8
Anthrex,drakthul,384,mage,fire,12,4,8
Zuckerzimt,ravencrest,384,mage,fire,12,4,8
Genviedgiclé,arathi,384,mage,fire,12,4,8
Викликс,borean-tundra,384,mage,fire,12,4,8
Popbg,outland,384,mage,fire,12,4,8
Rooven,aegwynn,384,mage,fire,12,4,8
Kazeen,silvermoon,384,mage,fire,12,4,8
Раканчик,gordunni,384,mage,fire,12,4,8
Деорро,gordunni,384,mage,fire,12,4,8
Lusionator,defias-brotherhood,384,mage,fire,18,4,14
Джеззабэль,ashenvale,383,mage,fire,6,4,2
Мэджиксул,grom,383,mage,fire,12,4,8
Lusifera,outland,336,mage,fire,9,4,5
Niivel,ysondre,336,mage,fire,15,4,11
Мэдраша,gordunni,335,mage,fire,17,4,13
Tigerblod,tarren-mill,330,mage,fire,10,5,5
Frøstdream,dun-modr,288,mage,fire,6,3,3
Modrone,ragnaros,288,mage,fire,6,3,3
Maveya,blackmoore,288,mage,fire,6,3,3
Lëyra,ysondre,288,mage,fire,6,3,3
Мэджу,gordunni,288,mage,fire,6,3,3
Fuchso,area-52,288,mage,fire,6,3,3
Fleurdelacur,ravencrest,288,mage,fire,6,3,3
Zøe,aggra-português,288,mage,fire,6,3,3
Feuererdnuss,blackhand,288,mage,fire,6,3,3
Melíssa,silvermoon,288,mage,fire,6,3,3
Росвенд,gordunni,288,mage,fire,6,3,3
Ãzi,ravencrest,288,mage,fire,6,3,3
Driana,dragonmaw,288,mage,fire,6,3,3
Namemage,stormscale,288,mage,fire,6,3,3
Bebenm,archimonde,288,mage,fire,6,3,3
Тудысюдым,eversong,288,mage,fire,6,3,3
Витуз,gordunni,288,mage,fire,6,3,3
Máximus,ravencrest,288,mage,fire,6,3,3
Trowbe,blackmoore,288,mage,fire,6,3,3
Shermî,blackrock,288,mage,fire,6,3,3
Sonybonanza,kazzak,288,mage,fire,6,3,3
Salvadordalí,ravencrest,288,mage,fire,6,3,3
Akrapovic,drakthul,288,mage,fire,6,3,3
Marøjuniõr,draenor,288,mage,fire,6,3,3
Magnobi,sanguino,288,mage,fire,6,3,3
Capphaow,ravencrest,288,mage,fire,6,3,3
Alterwhite,archimonde,288,mage,fire,6,3,3
Funkyfriday,twisting-nether,288,mage,fire,6,3,3
Coachrmp,ravencrest,288,mage,fire,6,3,3
Freeyourmind,kazzak,288,mage,fire,6,3,3
Даатхедра,booty-bay,288,mage,fire,6,3,3
Alyraza,chamber-of-aspects,288,mage,fire,6,3,3
Botstyle,ravencrest,288,mage,fire,6,3,3
Netrinkuet,outland,288,mage,fire,6,3,3
Ørka,stormscale,288,mage,fire,6,3,3
Wankel,blackmoore,288,mage,fire,6,3,3
Meign,eredar,288,mage,fire,6,3,3
Хблэйз,howling-fjord,288,mage,fire,9,4,5
Sokardes,the-maelstrom,288,mage,fire,10,4,6
Колтрэйн,blackscar,288,mage,fire,9,3,6
Kyrn,zuljin,288,mage,fire,10,3,7
Tsubas,blackmoore,288,mage,fire,12,3,9
Frökenfrost,stormscale,288,mage,fire,12,3,9
Urkela,sylvanas,288,mage,fire,12,3,9
Beardmorph,auchindoun,288,mage,fire,12,3,9
Waan,sylvanas,288,mage,fire,12,3,9
Rasaku,argent-dawn,288,mage,fire,12,3,9
Aylan,kazzak,288,mage,fire,12,3,9
Trenpapi,twisting-nether,288,mage,fire,12,3,9
Oblív,ravencrest,288,mage,fire,12,3,9
Rmforever,archimonde,287,mage,fire,6,3,3
Melimar,khaz-modan,287,mage,fire,6,3,3
Worstlove,blackrock,287,mage,fire,8,3,5
Ceanna,argent-dawn,287,mage,fire,12,3,9
Regenn,kazzak,286,mage,fire,6,3,3
Häddës,archimonde,286,mage,fire,6,3,3
Венлич,gordunni,271,mage,fire,9,4,5
Mimicassa,defias-brotherhood,234,mage,fire,10,5,5
Сморгонец,gordunni,222,mage,fire,8,3,5
Worstwòrld,draenor,208,mage,fire,7,3,4
Watchmeclic,archimonde,192,mage,fire,6,2,4
Zerobelow,silvermoon,192,mage,fire,6,2,4
Robowhoore,silvermoon,192,mage,fire,6,2,4
Transformo,draenor,192,mage,fire,6,2,4
Symbiano,twisting-nether,192,mage,fire,6,2,4
Pewwpewwpeww,doomhammer,192,mage,fire,6,2,4
Dnt,twilights-hammer,192,mage,fire,6,2,4
Дэката,grom,192,mage,fire,6,2,4
Elynaé,draenor,192,mage,fire,6,2,4
Mons,the-venture-co,192,mage,fire,6,2,4
Milton,dunemaul,192,mage,fire,6,2,4
Alarak,drakthul,192,mage,fire,6,2,4
Hopewell,aszune,192,mage,fire,6,2,4
Szarbán,ragnaros,192,mage,fire,6,2,4
Айсбоунт,eversong,192,mage,fire,6,2,4
Puracz,defias-brotherhood,192,mage,fire,6,2,4
Malshash,outland,192,mage,fire,6,2,4
Roberx,sanguino,192,mage,fire,6,2,4
Wenndrid,draenor,192,mage,fire,6,2,4
Abêj,malygos,192,mage,fire,6,2,4
Kilféfroid,ysondre,192,mage,fire,6,2,4
Møøk,magtheridon,192,mage,fire,6,2,4
Димаскунфу,howling-fjord,192,mage,fire,6,2,4
Milminmage,ravencrest,192,mage,fire,6,2,4
Vantimere,twisting-nether,192,mage,fire,6,2,4
Eksl,draenor,192,mage,fire,6,2,4
Atzin,sanguino,192,mage,fire,6,2,4
Letitsnow,ravencrest,192,mage,fire,6,2,4
Covran,stormscale,192,mage,fire,6,2,4
Magenox,blackrock,192,mage,fire,6,2,4
Blasic,stormscale,192,mage,fire,6,2,4
Nøw,ravencrest,192,mage,fire,6,2,4
Nötmârtònxø,ragnaros,192,mage,fire,12,2,10
Çatàclysmík,kazzak,192,mage,fire,12,2,10
Kyani,mannoroth,192,mage,fire,12,2,10
Firelight,argent-dawn,192,mage,fire,12,2,10
Mesvef,archimonde,192,mage,fire,12,2,10
Laviathan,die-aldor,191,mage,fire,6,2,4
Veveroiu,defias-brotherhood,191,mage,fire,6,2,4
Nabucor,culte-de-la-rive-noire,190,mage,fire,13,3,10
Wëylin,chogall,128,mage,fire,4,2,2
Ice,sargeras,96,mage,fire,3,2,1
Slashlife,wrathbringer,96,mage,fire,6,1,5
Овеча,gordunni,96,mage,fire,6,1,5
Phenoxi,sylvanas,96,mage,fire,6,1,5
Akadran,blackmoore,96,mage,fire,6,1,5
Mogettemagic,ysondre,96,mage,fire,6,1,5
Миднаит,gordunni,96,mage,fire,6,1,5
Варриморыч,soulflayer,96,mage,fire,6,1,5
Дизордерх,gordunni,96,mage,fire,6,1,5
Infamage,draenor,96,mage,fire,6,1,5
Mexxî,thrall,96,mage,fire,6,1,5
Фантомланс,howling-fjord,96,mage,fire,6,1,5
Alaster,culte-de-la-rive-noire,96,mage,fire,6,1,5
Satheril,argent-dawn,96,mage,fire,6,1,5
Megancox,blackmoore,96,mage,fire,6,1,5
Nodnarb,dragonblight,96,mage,fire,6,1,5
Roey,defias-brotherhood,96,mage,fire,6,1,5
Sylvîe,tarren-mill,96,mage,fire,6,1,5
Ckrax,sanguino,96,mage,fire,6,1,5
Tsungy,twisting-nether,96,mage,fire,6,1,5
Moleester,twisting-nether,96,mage,fire,6,1,5
Пламяорды,soulflayer,96,mage,fire,6,1,5
Radagulf,outland,96,mage,fire,6,1,5
Polÿmorph,stormscale,96,mage,fire,6,1,5
Maybeblood,kazzak,96,mage,fire,6,1,5
Файрус,soulflayer,96,mage,fire,6,1,5
Símple,sylvanas,96,mage,fire,6,1,5
Mallphass,dalaran,96,mage,fire,12,1,11
Shâdozy,blackmoore,89,mage,fire,6,3,3
Incenia,ravencrest,79,mage,fire,5,1,4
Preí,archimonde,42,mage,fire,12,3,9
Озобочений,greymane,31,mage,fire,2,1,1
Ðøæø,twisting-nether,16,mage,fire,1,1,0
Partypower,twisting-nether,2252,mage,frost,129,68,61
Chikounet,archimonde,2188,mage,frost,150,78,72
Tommy,laughing-skull,2144,mage,frost,88,45,43
Ðeejkñ,archimonde,2139,mage,frost,72,45,27
Avizura,kazzak,2134,mage,frost,60,35,25
Serctheone,ravencrest,2105,mage,frost,149,76,73
Dastion,ravencrest,2105,mage,frost,91,45,46
Fakér,ravencrest,2058,mage,frost,184,88,96
Sóz,ravencrest,2033,mage,frost,109,51,58
Laynerz,kazzak,2010,mage,frost,55,31,24
Oseri,defias-brotherhood,2001,mage,frost,131,65,66
Барсуктри,deathguard,1984,mage,frost,60,30,30
Oscarwizyo,ravencrest,1968,mage,frost,77,36,41
Gavno,ravencrest,1955,mage,frost,54,26,28
Efes,dun-modr,1934,mage,frost,58,32,26
Sukmikok,twisting-nether,1926,mage,frost,160,80,80
Nilitar,kazzak,1910,mage,frost,60,24,36
Watchmeclick,archimonde,1909,mage,frost,36,20,16
Auchenax,argent-dawn,1902,mage,frost,131,68,63
Øscarwizyo,ravencrest,1901,mage,frost,54,25,29
Søz,agamaggan,1899,mage,frost,65,31,34
Макотшельник,gordunni,1890,mage,frost,43,29,14
Kurtkiels,draenor,1872,mage,frost,60,29,31
Praison,defias-brotherhood,1863,mage,frost,54,32,22
Kalamaras,quelthalas,1855,mage,frost,44,21,23
Shíróyama,ravencrest,1849,mage,frost,132,77,55
Setyouoncs,ravencrest,1847,mage,frost,54,31,23
Незерёб,soulflayer,1845,mage,frost,66,32,34
Drfeeldgoodd,mazrigos,1843,mage,frost,84,38,46
Aìnz,hyjal,1837,mage,frost,60,27,33
Rekzaop,ravencrest,1835,mage,frost,96,44,52
Exone,sylvanas,1828,mage,frost,66,32,34
Rosady,ragnaros,1826,mage,frost,101,51,50
Lyndsey,dalaran,1826,mage,frost,65,31,34
Laurents,silvermoon,1825,mage,frost,128,86,42
Èverix,ravencrest,1823,mage,frost,106,47,59
Goneforever,draenor,1820,mage,frost,42,27,15
Мэдвэйз,gordunni,1819,mage,frost,48,31,17
Watchmeclic,archimonde,1813,mage,frost,66,29,37
Djdankzter,outland,1812,mage,frost,42,19,23
Zhodusqt,ragnaros,1808,mage,frost,48,24,24
Xmoo,blackrock,1805,mage,frost,48,24,24
Novaco,ravencrest,1805,mage,frost,59,29,30
Baconlance,stormscale,1803,mage,frost,42,23,19
Tellysia,blackmoore,1802,mage,frost,47,26,21
Símple,sylvanas,1802,mage,frost,60,27,33
Kiirin,drakthul,1801,mage,frost,57,34,23
Lidely,kazzak,1800,mage,frost,30,19,11
Zøe,aggra-português,1800,mage,frost,54,34,20
Mgtowforlife,ravencrest,1800,mage,frost,66,35,31
Knometsj,ravencrest,1796,mage,frost,48,26,22
Løwskìll,outland,1795,mage,frost,95,53,42
Darkoftw,ysondre,1791,mage,frost,47,22,25
Ввнд,galakrond,1785,mage,frost,54,22,32
Bombswag,bloodhoof,1776,mage,frost,65,33,32
Медивера,gordunni,1776,mage,frost,54,27,27
Reflexz,thrall,1775,mage,frost,36,21,15
Polÿmorph,stormscale,1774,mage,frost,59,30,29
Ovrpwrdxd,kazzak,1763,mage,frost,24,20,4
Frostgodxqt,ravencrest,1763,mage,frost,82,49,33
Wmp,ravencrest,1763,mage,frost,42,23,19
Henqo,burning-legion,1762,mage,frost,58,25,33
Naynn,archimonde,1760,mage,frost,40,26,14
Jirø,cthun,1760,mage,frost,58,30,28
Shakéx,outland,1758,mage,frost,51,26,25
Sâkuya,blackrock,1756,mage,frost,122,60,62
Crylz,kazzak,1753,mage,frost,47,25,22
Onnÿy,dun-modr,1749,mage,frost,50,25,25
Колинас,soulflayer,1748,mage,frost,101,50,51
Nightfee,eredar,1745,mage,frost,42,21,21
Mlodysimba,burning-legion,1743,mage,frost,52,28,24
Joulz,ravencrest,1738,mage,frost,160,79,81
Sylbris,outland,1736,mage,frost,83,38,45
Zimbabweborc,burning-legion,1733,mage,frost,58,36,22
Gensorèd,darksorrow,1729,mage,frost,63,33,30
Stickiburn,malganis,1729,mage,frost,57,27,30
Neymar,aszune,1725,mage,frost,35,24,11
Blackfirez,ravencrest,1725,mage,frost,30,18,12
Einsmagus,blackrock,1720,mage,frost,42,20,22
Mexxî,thrall,1719,mage,frost,72,37,35
Silverlining,ravencrest,1719,mage,frost,97,48,49
Tánu,quelthalas,1717,mage,frost,66,32,34
Anaxtra,guldan,1714,mage,frost,81,41,40
Lorothar,blackhand,1712,mage,frost,60,24,36
Tagrine,kaelthas,1711,mage,frost,48,24,24
Rambau,archimonde,1711,mage,frost,180,88,92
Shalien,tarren-mill,1704,mage,frost,65,35,30
Soloqtarget,archimonde,1703,mage,frost,98,48,50
Tfmchamp,ravencrest,1698,mage,frost,33,22,11
Ishimura,eredar,1697,mage,frost,54,31,23
Girldalf,silvermoon,1695,mage,frost,131,68,63
Hógwarts,aegwynn,1694,mage,frost,36,23,13
Jaimey,blackhand,1690,mage,frost,161,75,86
Ãshs,archimonde,1690,mage,frost,48,20,28
Alearis,die-aldor,1688,mage,frost,60,32,28
Buddi,burning-blade,1687,mage,frost,275,144,131
Pryt,ragnaros,1686,mage,frost,113,61,52
Алаурс,howling-fjord,1686,mage,frost,42,22,20
Máximus,ravencrest,1685,mage,frost,36,20,16
Swizzy,arathor,1685,mage,frost,64,35,29
Sorrow,outland,1685,mage,frost,42,18,24
Jenggot,ravencrest,1681,mage,frost,35,18,17
Missl,draenor,1680,mage,frost,32,19,13
Excuses,chamber-of-aspects,1679,mage,frost,111,57,54
Vilain,tarren-mill,1678,mage,frost,35,18,17
Raíner,eredar,1675,mage,frost,66,37,29
Zoot,ravencrest,1674,mage,frost,60,22,38
Gossipgirlz,outland,1664,mage,frost,178,85,93
Quinella,ravencrest,1663,mage,frost,84,46,38
Nozarashí,hyjal,1662,mage,frost,40,19,21
Vilenciaga,kazzak,1659,mage,frost,66,35,31
Ironhood,nemesis,1656,mage,frost,30,18,12
Гекомория,fordragon,1654,mage,frost,74,39,35
Bigkent,stormscale,1653,mage,frost,48,22,26
Slobbery,aggramar,1638,mage,frost,38,23,15
Nickg,ravencrest,1636,mage,frost,42,21,21
Magerocks,ragnaros,1635,mage,frost,36,20,16
Sondremage,outland,1635,mage,frost,134,60,74
Äntigood,outland,1633,mage,frost,53,27,26
Xall,silvermoon,1631,mage,frost,36,23,13
Манахк,gordunni,1631,mage,frost,42,19,23
Asiman,eredar,1631,mage,frost,51,22,29
Borêta,blackrock,1630,mage,frost,48,27,21
Sunehx,blackrock,1630,mage,frost,42,22,20
Thesiôu,ravencrest,1629,mage,frost,36,20,16
Bestial,alexstrasza,1627,mage,frost,88,40,48
Ёкай,soulflayer,1623,mage,frost,133,79,54
Glowie,stormreaver,1623,mage,frost,36,20,16
Xenant,ravencrest,1623,mage,frost,42,18,24
Blasty,guldan,1622,mage,frost,57,25,32
Thinamerican,defias-brotherhood,1620,mage,frost,24,18,6
Sykz,hyjal,1617,mage,frost,65,35,30
Afterimage,zuljin,1614,mage,frost,98,47,51
Okayhehexd,dun-morogh,1613,mage,frost,78,46,32
Chazs,kazzak,1613,mage,frost,30,17,13
Cleophe,burning-legion,1611,mage,frost,30,17,13
Xæll,silvermoon,1611,mage,frost,114,61,53
Rihnou,blackmoore,1610,mage,frost,59,27,32
Fireblood,runetotem,1610,mage,frost,48,21,27
Tills,kargath,1606,mage,frost,42,20,22
Jamzymage,emerald-dream,1604,mage,frost,30,17,13
Magethings,kazzak,1603,mage,frost,54,25,29
Bzzr,tarren-mill,1601,mage,frost,54,35,19
Réd,earthen-ring,1601,mage,frost,77,36,41
Emoden,silvermoon,1600,mage,frost,167,81,86
Mecharience,rexxar,1597,mage,frost,33,18,15
Datpolytho,twisting-nether,1596,mage,frost,48,34,14
Ôbsury,hyjal,1588,mage,frost,42,24,18
Sheepthrillz,blackmoore,1578,mage,frost,36,21,15
Ceillech,blackrock,1578,mage,frost,71,36,35
Lo,kilrogg,1578,mage,frost,69,29,40
Óuíja,outland,1576,mage,frost,45,28,17
Esscheppert,blackrock,1576,mage,frost,42,17,25
Мибринк,soulflayer,1575,mage,frost,72,32,40
Petepan,argent-dawn,1570,mage,frost,107,52,55
Ингилейф,howling-fjord,1570,mage,frost,46,18,28
Вендайса,soulflayer,1569,mage,frost,216,127,89
Beaun,tarren-mill,1567,mage,frost,64,36,28
Левелнес,howling-fjord,1567,mage,frost,74,32,42
Elcritadoré,ragnaros,1560,mage,frost,39,20,19
Chareyla,argent-dawn,1558,mage,frost,83,42,41
Gaduz,kazzak,1556,mage,frost,72,31,41
Boomboomciao,nemesis,1555,mage,frost,42,19,23
Dubbleblast,draenor,1553,mage,frost,36,19,17
Voerk,twisting-nether,1552,mage,frost,36,17,19
Ghalanz,ravencrest,1545,mage,frost,60,29,31
Миднаит,gordunni,1545,mage,frost,66,28,38
Бингчилинг,howling-fjord,1543,mage,frost,64,30,34
Демолюшн,soulflayer,1541,mage,frost,53,23,30
Reðemption,dun-modr,1538,mage,frost,23,17,6
Вольняша,azuregos,1534,mage,frost,106,44,62
Alluryeine,draenor,1531,mage,frost,59,34,25
Itzlucky,twisting-nether,1530,mage,frost,129,63,66
Jocelynn,aggramar,1530,mage,frost,36,16,20
Evovar,silvermoon,1530,mage,frost,36,16,20
Tiqma,sylvanas,1528,mage,frost,30,16,14
Фоулли,howling-fjord,1528,mage,frost,34,17,17
Озобочений,greymane,1528,mage,frost,36,17,19
Denaleidi,stormscale,1525,mage,frost,24,17,7
Fullpolly,twisting-nether,1525,mage,frost,36,23,13
Райоми,fordragon,1524,mage,frost,97,47,50
Únna,sanguino,1517,mage,frost,75,42,33
Rankonedeep,kazzak,1516,mage,frost,24,16,8
Phélenia,sargeras,1516,mage,frost,60,30,30
Mupana,nagrand,1516,mage,frost,54,25,29
Helminsterr,archimonde,1511,mage,frost,30,16,14
Ímnotback,outland,1507,mage,frost,133,70,63
Gêrky,drakthul,1507,mage,frost,84,44,40
Iroya,festung-der-stürme,1505,mage,frost,132,63,69
Medara,darkspear,1505,mage,frost,36,16,20
Trowbe,blackmoore,1504,mage,frost,30,16,14
Tromie,archimonde,1503,mage,frost,53,28,25
Dzikk,silvermoon,1502,mage,frost,66,34,32
Comodus,ragnaros,1500,mage,frost,78,37,41
Spellcast,ravencrest,1496,mage,frost,33,18,15
Старкскрим,gordunni,1492,mage,frost,30,16,14
Сосулькина,gordunni,1488,mage,frost,95,50,45
Surlancealot,outland,1488,mage,frost,41,17,24
Sakuranosuke,twisting-nether,1486,mage,frost,30,16,14
Джейнанис,gordunni,1483,mage,frost,30,17,13
Корадо,gordunni,1483,mage,frost,120,54,66
Саваннхмаег,blackscar,1482,mage,frost,33,18,15
Тачмахал,soulflayer,1478,mage,frost,60,31,29
Qqpwn,ragnaros,1477,mage,frost,65,32,33
Магсимум,ashenvale,1476,mage,frost,30,18,12
Hernêise,silvermoon,1476,mage,frost,101,54,47
Octtmiss,twisting-nether,1476,mage,frost,33,17,16
Tàylerdarden,nemesis,1472,mage,frost,47,22,25
Azkarr,stormscale,1470,mage,frost,36,22,14
Tôke,kaelthas,1467,mage,frost,66,38,28
Shainax,dun-modr,1466,mage,frost,88,45,43
Fïttan,stormscale,1464,mage,frost,44,20,24
Arimila,sylvanas,1463,mage,frost,100,44,56
Cheerió,aggramar,1462,mage,frost,219,104,115
Dabka,argent-dawn,1460,mage,frost,62,32,30
Demensida,ravencrest,1459,mage,frost,106,52,54
Novalia,wrathbringer,1458,mage,frost,24,17,7
Walian,burning-blade,1457,mage,frost,30,17,13
Widmage,silvermoon,1457,mage,frost,72,28,44
Hambones,outland,1456,mage,frost,38,16,22
Find,archimonde,1455,mage,frost,56,24,32
Lesoleil,archimonde,1453,mage,frost,30,19,11
Mxrrz,kazzak,1452,mage,frost,116,60,56
Rexør,frostwolf,1449,mage,frost,42,23,19
Dllarky,drakthul,1448,mage,frost,48,24,24
Khivax,twisting-nether,1448,mage,frost,66,27,39
Woorm,sylvanas,1446,mage,frost,76,44,32
Alktraz,outland,1445,mage,frost,48,24,24
Afklow,pozzo-delleternità,1442,mage,frost,39,21,18
Plætinum,ravencrest,1442,mage,frost,114,57,57
Maquiwizz,aggra-português,1442,mage,frost,48,24,24
Sekulicgoga,draenor,1441,mage,frost,201,112,89
Quail,anubarak,1439,mage,frost,51,26,25
Shnitz,stormscale,1436,mage,frost,24,15,9
Фемна,soulflayer,1436,mage,frost,29,18,11
Hayaka,sanguino,1435,mage,frost,59,30,29
Abovè,outland,1434,mage,frost,42,15,27
Alkhazzar,defias-brotherhood,1428,mage,frost,84,37,47
Синийлед,galakrond,1425,mage,frost,60,29,31
Samath,conseil-des-ombres,1421,mage,frost,36,15,21
Absoluteswag,tarren-mill,1416,mage,frost,33,16,17
Hexmath,tarren-mill,1413,mage,frost,30,15,15
Eldariel,ravencrest,1412,mage,frost,59,26,33
Pipihu,silvermoon,1409,mage,frost,54,27,27
Elcølgaø,sanguino,1406,mage,frost,90,39,51
Shüri,kazzak,1404,mage,frost,60,35,25
Shinzel,hyjal,1403,mage,frost,54,24,30
Sixx,aegwynn,1400,mage,frost,41,19,22
Pluribusunum,outland,1398,mage,frost,38,17,21
Кройзис,howling-fjord,1393,mage,frost,60,38,22
Ymirë,khaz-modan,1391,mage,frost,45,20,25
Pizit,ravencrest,1385,mage,frost,72,36,36
Fractox,ysondre,1380,mage,frost,77,42,35
Stillfrostin,blackrock,1378,mage,frost,54,33,21
Iggilaus,blackhand,1378,mage,frost,215,109,106
Icefix,dun-modr,1377,mage,frost,59,29,30
Гатмир,gordunni,1375,mage,frost,107,51,56
Caesarclown,silvermoon,1372,mage,frost,125,63,62
Цепнойпёс,goldrinn,1371,mage,frost,34,17,17
Nimdáá,stormscale,1369,mage,frost,127,68,59
Firehasse,draenor,1368,mage,frost,74,41,33
Bebarz,darksorrow,1365,mage,frost,72,37,35
Игрдлпдров,gordunni,1362,mage,frost,66,32,34
Орижн,howling-fjord,1360,mage,frost,35,20,15
Iulie,kazzak,1358,mage,frost,60,29,31
Akúmã,stormscale,1355,mage,frost,66,35,31
Smöked,tarren-mill,1350,mage,frost,252,128,124
Morphees,twisting-nether,1344,mage,frost,30,19,11
Jíncks,anachronos,1344,mage,frost,24,14,10
Preí,archimonde,1344,mage,frost,37,15,22
Whïm,ysondre,1342,mage,frost,30,14,16
Dmmeforcam,archimonde,1340,mage,frost,26,15,11
Apócalyptic,tarren-mill,1340,mage,frost,64,36,28
Immobilizer,eredar,1339,mage,frost,78,39,39
Animaze,argent-dawn,1335,mage,frost,149,85,64
Spelltastíc,blackmoore,1333,mage,frost,24,14,10
Däpper,ragnaros,1332,mage,frost,36,15,21
Karstnstenzl,blackrock,1331,mage,frost,24,14,10
Elynaé,draenor,1327,mage,frost,30,14,16
Laenadria,argent-dawn,1325,mage,frost,71,28,43
Sused,outland,1321,mage,frost,30,16,14
Alicánte,silvermoon,1320,mage,frost,48,18,30
Гунмаказ,soulflayer,1318,mage,frost,22,16,6
Mdog,stormreaver,1317,mage,frost,68,35,33
Nups,ravencrest,1315,mage,frost,60,24,36
Kaaguraa,ravencrest,1314,mage,frost,72,40,32
Лутиум,howling-fjord,1313,mage,frost,181,100,81
Dyx,nemesis,1313,mage,frost,49,22,27
Søphiâ,thrall,1308,mage,frost,63,33,30
Jedite,die-todeskrallen,1305,mage,frost,87,44,43
Shroomie,eredar,1305,mage,frost,36,16,20
Jackin,burning-legion,1301,mage,frost,54,26,28
Iceterror,ravencrest,1300,mage,frost,24,15,9
Psychosiss,kazzak,1298,mage,frost,49,27,22
Scaleeth,kazzak,1297,mage,frost,34,14,20
Abolf,twisting-nether,1288,mage,frost,30,16,14
Velâska,malganis,1280,mage,frost,39,22,17
Asteria,twisting-nether,1280,mage,frost,42,17,25
Faycia,blackhand,1279,mage,frost,42,18,24
Destruct,doomhammer,1277,mage,frost,30,18,12
Cinoox,blackrock,1275,mage,frost,28,14,14
Leafløver,ravencrest,1267,mage,frost,29,14,15
Katarapower,silvermoon,1267,mage,frost,132,59,73
Дырявка,galakrond,1263,mage,frost,54,23,31
Braxxorz,chamber-of-aspects,1261,mage,frost,36,24,12
Corpusqq,eredar,1261,mage,frost,36,15,21
Gacosane,chamber-of-aspects,1261,mage,frost,36,15,21
Lovësosa,hyjal,1260,mage,frost,41,20,21
Homellander,silvermoon,1258,mage,frost,64,32,32
Shivah,onyxia,1250,mage,frost,46,17,29
Гаразлик,howling-fjord,1249,mage,frost,42,16,26
Pezi,outland,1248,mage,frost,26,14,12
Pwntt,terenas,1248,mage,frost,39,15,24
Emerlyn,ragnaros,1246,mage,frost,24,13,11
Bengé,ragnaros,1245,mage,frost,22,14,8
Dènzx,ravencrest,1244,mage,frost,18,13,5
Мэтаскрим,soulflayer,1244,mage,frost,36,13,23
Nebbur,dun-modr,1243,mage,frost,30,13,17
Oiklo,eitrigg,1243,mage,frost,49,19,30
Manafuzz,outland,1242,mage,frost,24,13,11
Xânârchy,minahonda,1242,mage,frost,72,33,39
Melíssa,silvermoon,1240,mage,frost,18,13,5
Crackheads,hyjal,1239,mage,frost,36,14,22
Titanshao,silvermoon,1237,mage,frost,24,16,8
Дарнивил,gordunni,1236,mage,frost,114,51,63
Пиньон,borean-tundra,1235,mage,frost,18,13,5
Iceorb,azshara,1227,mage,frost,30,13,17
Boredpeon,burning-legion,1225,mage,frost,48,25,23
Seelengott,onyxia,1221,mage,frost,127,63,64
Misscandy,doomhammer,1219,mage,frost,66,31,35
Хблэйз,howling-fjord,1218,mage,frost,24,13,11
Suidas,auchindoun,1217,mage,frost,66,28,38
Pyroden,stormscale,1216,mage,frost,30,14,16
Scaless,stormscale,1209,mage,frost,58,28,30
Smõóve,hyjal,1208,mage,frost,24,13,11
Хируэль,gordunni,1208,mage,frost,30,14,16
Tarkún,dun-modr,1206,mage,frost,30,17,13
Silvariy,stormscale,1204,mage,frost,100,48,52
Zevúlòs,ravencrest,1202,mage,frost,42,28,14
Iceym,ravencrest,1201,mage,frost,35,15,20
Rektd,blackhand,1200,mage,frost,51,20,31
Tradez,norgannon,1197,mage,frost,36,13,23
Айсбоунт,eversong,1193,mage,frost,43,25,18
Сибиди,gordunni,1185,mage,frost,24,13,11
Vathalis,zuluhed,1183,mage,frost,53,19,34
Fleurdelacur,ravencrest,1182,mage,frost,57,29,28
Teuboku,ysondre,1180,mage,frost,25,15,10
Морозящий,howling-fjord,1176,mage,frost,36,20,16
Oathkeepper,silvermoon,1172,mage,frost,112,55,57
Magitron,wildhammer,1170,mage,frost,17,13,4
Zvuta,sanguino,1166,mage,frost,18,14,4
Саназэр,soulflayer,1163,mage,frost,42,20,22
Вескнам,lich-king,1162,mage,frost,42,14,28
Bossgb,twisting-nether,1160,mage,frost,27,15,12
Baravar,blackrock,1155,mage,frost,35,14,21
Gliffy,terokkar,1152,mage,frost,37,22,15
Charliezard,argent-dawn,1152,mage,frost,24,12,12
Noxkin,stormscale,1151,mage,frost,24,12,12
Amicuta,ravencrest,1150,mage,frost,48,24,24
Axhole,darksorrow,1150,mage,frost,24,12,12
Koreanbbq,outland,1148,mage,frost,30,12,18
Anamalhoa,aggra-português,1147,mage,frost,30,15,15
Sukky,todeswache,1146,mage,frost,24,12,12
Ayoubz,outland,1145,mage,frost,24,12,12
Kippercarry,outland,1144,mage,frost,24,12,12
Zionw,frostwolf,1142,mage,frost,24,12,12
Qulinx,kazzak,1142,mage,frost,29,13,16
Айсвеном,gordunni,1142,mage,frost,30,13,17
Latiny,destromath,1135,mage,frost,47,21,26
Zoubaz,archimonde,1132,mage,frost,25,12,13
Iamslow,sylvanas,1130,mage,frost,18,12,6
Вельдрик,soulflayer,1127,mage,frost,85,41,44
Jodiefroster,bronzebeard,1121,mage,frost,30,16,14
Килавый,eversong,1119,mage,frost,18,15,3
Lifemagic,chamber-of-aspects,1118,mage,frost,81,43,38
Saphiregos,dalaran,1113,mage,frost,66,32,34
Snowrain,chogall,1108,mage,frost,35,20,15
Луциаз,gordunni,1102,mage,frost,35,21,14
Pinkis,darkmoon-faire,1098,mage,frost,22,13,9
Zaruna,arathor,1094,mage,frost,27,13,14
Pruneau,hyjal,1094,mage,frost,30,12,18
Momotemp,emerald-dream,1089,mage,frost,74,35,39
Goeb,kazzak,1083,mage,frost,35,14,21
Niivel,ysondre,1082,mage,frost,120,68,52
Qtiepatootie,silvermoon,1077,mage,frost,85,48,37
Aelire,die-aldor,1077,mage,frost,33,12,21
Zwölfte,outland,1076,mage,frost,52,26,26
Schtenen,silvermoon,1075,mage,frost,116,53,63
Дедамаг,eversong,1064,mage,frost,36,18,18
Tacto,ravencrest,1061,mage,frost,94,44,50
Лемозяра,gordunni,1056,mage,frost,12,11,1
Dastion,sylvanas,1056,mage,frost,18,11,7
Sìsia,ragnaros,1056,mage,frost,18,11,7
Soz,agamaggan,1056,mage,frost,18,11,7
Hazzá,ravencrest,1055,mage,frost,18,11,7
Rere,zenedar,1054,mage,frost,26,13,13
Kapueca,jaedenar,1053,mage,frost,27,17,10
Гамаюнх,deathguard,1053,mage,frost,24,11,13
Викликс,borean-tundra,1052,mage,frost,22,13,9
Sangumage,silvermoon,1051,mage,frost,24,11,13
Файрусх,blackscar,1049,mage,frost,18,11,7
Roughfked,silvermoon,1049,mage,frost,42,23,19
Aileean,burning-legion,1046,mage,frost,30,12,18
Irreversal,ravencrest,1045,mage,frost,41,18,23
Férécide,ysondre,1045,mage,frost,30,11,19
Thry,bronzebeard,1042,mage,frost,30,11,19
Блья,howling-fjord,1039,mage,frost,30,20,10
Khoshgele,draenor,1039,mage,frost,24,11,13
Winterblues,frostmourne,1037,mage,frost,24,11,13
Heavyfire,kazzak,1034,mage,frost,18,11,7
Clonefcf,sylvanas,1032,mage,frost,55,31,24
Forestie,silvermoon,1032,mage,frost,50,23,27
Zedsdeadbaby,argent-dawn,1031,mage,frost,33,16,17
Justleblanc,dalaran,1031,mage,frost,36,11,25
Ramcoz,twisting-nether,1029,mage,frost,30,15,15
Arkhaen,archimonde,1022,mage,frost,23,11,12
Бальзамон,eversong,1022,mage,frost,25,11,14
Yasheaa,ysondre,1020,mage,frost,23,11,12
Pinguíni,aegwynn,1014,mage,frost,24,12,12
Мрперут,eversong,1008,mage,frost,54,32,22
Илайла,booty-bay,1007,mage,frost,15,12,3
Rafaeala,argent-dawn,1001,mage,frost,44,19,25
Erzà,todeswache,991,mage,frost,35,18,17
Инкрионити,gordunni,989,mage,frost,17,11,6
Kumakara,archimonde,981,mage,frost,24,12,12
Fashes,sunstrider,977,mage,frost,75,36,39
Dnt,twilights-hammer,974,mage,frost,24,11,13
Ryzea,ravencrest,968,mage,frost,17,12,5
Wracrz,argent-dawn,960,mage,frost,18,10,8
Acx,drakthul,960,mage,frost,18,10,8
Santriss,defias-brotherhood,960,mage,frost,24,10,14
Unsaìntly,kult-der-verdammten,960,mage,frost,25,10,15
Vannq,silvermoon,959,mage,frost,18,10,8
Манакса,gordunni,959,mage,frost,24,10,14
Тортикток,soulflayer,959,mage,frost,24,10,14
Джинетикс,deathguard,958,mage,frost,18,10,8
Track,blackhand,958,mage,frost,24,10,14
Discomorph,the-maelstrom,957,mage,frost,18,10,8
Zenó,blackrock,956,mage,frost,30,10,20
Stryee,ragnaros,954,mage,frost,18,10,8
Margistikus,die-aldor,954,mage,frost,102,54,48
Broduy,draenor,952,mage,frost,42,12,30
Quincy,frostwolf,951,mage,frost,18,10,8
Nightplays,sylvanas,951,mage,frost,18,10,8
Celdra,blackrock,949,mage,frost,24,10,14
Этридемус,howling-fjord,947,mage,frost,30,10,20
Maybeblood,kazzak,946,mage,frost,28,11,17
Evuryl,nemesis,944,mage,frost,24,10,14
Flamya,stormscale,933,mage,frost,23,10,13
Tiefkühler,norgannon,931,mage,frost,24,11,13
Speedshatter,aegwynn,928,mage,frost,22,10,12
Левченкопро,soulflayer,924,mage,frost,70,29,41
Ghostgivree,archimonde,917,mage,frost,30,16,14
Toxttr,drakthul,908,mage,frost,18,11,7
Psika,kazzak,908,mage,frost,29,10,19
Ттэль,gordunni,900,mage,frost,16,11,5
Døliprane,garona,900,mage,frost,36,19,17
Çana,thrall,893,mage,frost,22,10,12
Amazona,veklor,889,mage,frost,32,16,16
Êmmá,blackmoore,885,mage,frost,54,22,32
Piego,turalyon,883,mage,frost,30,16,14
Sammelbot,kargath,872,mage,frost,42,21,21
Lexalia,blackmoore,869,mage,frost,32,14,18
Xæl,ravencrest,866,mage,frost,57,27,30
Fakeklepter,sylvanas,864,mage,frost,12,9,3
Whócárés,dragonmaw,864,mage,frost,12,9,3
Ney,drakthul,864,mage,frost,12,9,3
Djflashz,archimonde,864,mage,frost,18,9,9
Philoû,archimonde,864,mage,frost,18,9,9
Phenoxi,sylvanas,863,mage,frost,12,9,3
Винилочка,deathguard,863,mage,frost,12,9,3
Imbatto,quelthalas,863,mage,frost,12,9,3
Scoodles,kazzak,863,mage,frost,18,9,9
Bebenm,archimonde,863,mage,frost,18,9,9
Qtpoof,sylvanas,863,mage,frost,18,9,9
Qqcult,ravencrest,863,mage,frost,18,9,9
Слизерин,gordunni,863,mage,frost,24,9,15
Apeex,chamber-of-aspects,863,mage,frost,24,9,15
Muchmage,silvermoon,863,mage,frost,24,9,15
Layzzy,kazzak,863,mage,frost,30,9,21
Манднесс,azuregos,861,mage,frost,18,9,9
Strychne,ragnaros,860,mage,frost,12,9,3
Frisstana,outland,859,mage,frost,18,9,9
Klésh,nemesis,858,mage,frost,18,9,9
Naote,blackhand,858,mage,frost,18,9,9
Meydoum,archimonde,858,mage,frost,18,9,9
Suikune,twisting-nether,857,mage,frost,12,9,3
Bolesnimage,draenor,857,mage,frost,18,9,9
Юлианх,gordunni,856,mage,frost,220,99,121
Markasaura,kazzak,856,mage,frost,38,11,27
Voralastor,doomhammer,855,mage,frost,12,9,3
Farrä,dun-modr,854,mage,frost,53,26,27
Nazø,archimonde,853,mage,frost,24,9,15
Вайконд,howling-fjord,853,mage,frost,24,9,15
Iceicebáby,draenor,845,mage,frost,24,9,15
Pickaachu,doomhammer,839,mage,frost,24,11,13
Ezzekkiel,elune,835,mage,frost,18,9,9
Лордбелиал,soulflayer,834,mage,frost,24,9,15
Haljina,kazzak,822,mage,frost,156,67,89
Isolia,silvermoon,810,mage,frost,23,9,14
Lemonshelo,archimonde,806,mage,frost,27,9,18
Frigus,khaz-modan,804,mage,frost,27,9,18
Venu,dun-modr,800,mage,frost,18,9,9
Jobarttrach,les-clairvoyants,794,mage,frost,47,19,28
Tiltedpapi,ravencrest,790,mage,frost,16,9,7
Akâri,silvermoon,784,mage,frost,25,9,16
Crzyubrdrver,blackrock,768,mage,frost,12,8,4
Dsmoke,ravencrest,768,mage,frost,12,8,4
Serclulz,ravencrest,768,mage,frost,12,8,4
Arunx,magtheridon,768,mage,frost,12,8,4
Subzeraxo,archimonde,768,mage,frost,12,8,4
Séxmachiné,draenor,768,mage,frost,12,8,4
Transformo,draenor,768,mage,frost,18,8,10
Takayaki,terokkar,768,mage,frost,18,8,10
Mðj,kazzak,768,mage,frost,18,8,10
Väänik,draenor,768,mage,frost,18,8,10
Гдедипфриз,soulflayer,768,mage,frost,18,8,10
Zelimeth,outland,768,mage,frost,24,8,16
Чистокрут,gordunni,768,mage,frost,24,8,16
Нереварин,soulflayer,768,mage,frost,24,8,16
Buffenhance,ravencrest,768,mage,frost,30,8,22
Chicke,outland,767,mage,frost,12,8,4
Necizbored,tarren-mill,767,mage,frost,12,8,4
Ewina,twisting-nether,767,mage,frost,12,8,4
Tajos,drakthul,767,mage,frost,12,8,4
Gagaj,ravencrest,767,mage,frost,12,8,4
Azakadabra,ysondre,767,mage,frost,12,8,4
Zili,draenor,767,mage,frost,12,8,4
Xyfys,azshara,767,mage,frost,12,8,4
Goodheadcake,ragnaros,767,mage,frost,18,8,10
Bumbumdead,sylvanas,767,mage,frost,18,8,10
Фростидзе,gordunni,767,mage,frost,18,8,10
Quilava,ghostlands,766,mage,frost,12,8,4
Ãzi,ravencrest,766,mage,frost,12,8,4
Nïo,ravencrest,766,mage,frost,12,8,4
Insanewizard,kazzak,766,mage,frost,12,8,4
Jockin,stormrage,766,mage,frost,18,8,10
Anoez,kargath,766,mage,frost,18,8,10
Бабайбайкала,gordunni,766,mage,frost,24,8,16
Kleini,die-aldor,765,mage,frost,12,8,4
Ærrflôw,frostwolf,765,mage,frost,18,8,10
Xakiha,kazzak,764,mage,frost,18,8,10
Dabina,sanguino,763,mage,frost,18,8,10
Skarxaa,sanguino,763,mage,frost,18,8,10
Кельтузат,azuregos,762,mage,frost,12,8,4
Dominos,medivh,762,mage,frost,18,8,10
Lêgólás,blackmoore,762,mage,frost,18,8,10
Qwixxis,sylvanas,761,mage,frost,18,8,10
Леракобольд,gordunni,745,mage,frost,29,10,19
Amalou,stormscale,729,mage,frost,32,9,23
Hetaxata,kazzak,719,mage,frost,15,9,6
Clitch,blutkessel,715,mage,frost,20,9,11
Blinklet,twisting-nether,713,mage,frost,17,10,7
Emesarry,scarshield-legion,703,mage,frost,11,8,3
Rayniß,blackmoore,702,mage,frost,20,8,12
Zzombi,sylvanas,698,mage,frost,20,9,11
Cardioexpert,ravencrest,688,mage,frost,13,8,5
Щавзорву,gordunni,686,mage,frost,16,8,8
Icéy,kazzak,672,mage,frost,12,7,5
Fîsheye,blackrock,672,mage,frost,12,7,5
Skyblink,hyjal,672,mage,frost,12,7,5
Wortyvery,outland,672,mage,frost,12,7,5
Xläderz,ravencrest,672,mage,frost,12,7,5
Lyès,uldaman,672,mage,frost,12,7,5
Yobys,burning-legion,672,mage,frost,12,7,5
Agus,ravencrest,672,mage,frost,12,7,5
Bumboozling,kazzak,672,mage,frost,12,7,5
Evilmagíc,tarren-mill,672,mage,frost,12,7,5
Tenetic,thrall,672,mage,frost,14,7,7
Mageyreid,quelthalas,672,mage,frost,18,7,11
Vinlimar,drakthul,672,mage,frost,18,7,11
Blinkfloyd,blackmoore,672,mage,frost,18,7,11
Aterso,azshara,672,mage,frost,21,8,13
Krookéd,tarren-mill,672,mage,frost,24,7,17
Badphaz,frostmane,671,mage,frost,12,7,5
Møstwãntêd,aegwynn,671,mage,frost,12,7,5
Kaì,twisting-nether,671,mage,frost,12,7,5
Geepie,twisting-nether,671,mage,frost,12,7,5
Ice,sargeras,671,mage,frost,18,7,11
Kyrn,zuljin,671,mage,frost,18,7,11
Frostvirgin,twisting-nether,671,mage,frost,18,7,11
Chread,bronze-dragonflight,671,mage,frost,18,7,11
Nevaehine,ravencrest,670,mage,frost,12,7,5
Hotpotatox,ravencrest,670,mage,frost,13,7,6
Daneliam,outland,670,mage,frost,18,7,11
Unreadyx,archimonde,670,mage,frost,18,7,11
Lukewizard,twisting-nether,668,mage,frost,18,7,11
Lenycz,burning-blade,668,mage,frost,18,7,11
Умелецмаг,gordunni,665,mage,frost,12,7,5
Chogger,blackmoore,656,mage,frost,12,7,5
Helloimgone,blackmoore,655,mage,frost,17,7,10
Stîckî,malganis,639,mage,frost,23,7,16
Lìx,ravencrest,623,mage,frost,11,7,4
Skæde,ravencrest,618,mage,frost,17,11,6
Rinuria,blackrock,576,mage,frost,6,6,0
Escapematrix,ravencrest,576,mage,frost,6,6,0
Estonka,ravencrest,576,mage,frost,6,6,0
Titarie,ravencrest,576,mage,frost,12,6,6
Frostjävel,grim-batol,576,mage,frost,12,6,6
Skdroople,ravencrest,576,mage,frost,12,6,6
Iverson,kazzak,576,mage,frost,12,6,6
Lepronsito,kazzak,576,mage,frost,12,6,6
Firebaw,tarren-mill,576,mage,frost,12,6,6
Nécrømage,confrérie-du-thorium,576,mage,frost,12,6,6
Ecnaclappy,blackrock,576,mage,frost,12,6,6
Нонекс,soulflayer,576,mage,frost,12,6,6
Insømnium,stormscale,576,mage,frost,12,6,6
Sickofme,blackmoore,576,mage,frost,12,6,6
Миллерфест,howling-fjord,576,mage,frost,12,6,6
Диппро,soulflayer,576,mage,frost,12,6,6
Obbjob,ravencrest,576,mage,frost,12,6,6
Sainth,sanguino,576,mage,frost,12,6,6
Kurtcobain,draenor,576,mage,frost,12,6,6
Shakeándbake,ravencrest,576,mage,frost,18,6,12
Ury,hyjal,576,mage,frost,18,6,12
Ephixis,ravencrest,576,mage,frost,18,6,12
Qqlool,draenor,576,mage,frost,18,6,12
Articunoh,ravencrest,576,mage,frost,18,6,12
Yshax,malganis,576,mage,frost,24,6,18
Pitbones,archimonde,575,mage,frost,12,6,6
Коласольдом,gordunni,575,mage,frost,12,6,6
Длинныеухи,blackscar,575,mage,frost,12,6,6
Flakeh,outland,575,mage,frost,18,6,12
Tìnder,tarren-mill,575,mage,frost,18,6,12
Saturator,burning-legion,575,mage,frost,18,6,12
Вхламинка,howling-fjord,574,mage,frost,12,6,6
Yojimbot,archimonde,574,mage,frost,24,6,18
Ananaskana,ragnaros,572,mage,frost,12,6,6
Zenoss,khaz-modan,565,mage,frost,12,6,6
Fôôxy,aegwynn,558,mage,frost,17,6,11
Фиджарь,soulflayer,542,mage,frost,14,7,7
Aerius,lightnings-blade,528,mage,frost,15,6,9
Lidin,draenor,527,mage,frost,11,6,5
Escobar,frostmane,527,mage,frost,14,7,7
Derbomber,guldan,527,mage,frost,17,6,11
Avb,twisting-nether,527,mage,frost,17,6,11
Pharohe,stormscale,522,mage,frost,22,7,15
Kaeki,khaz-modan,520,mage,frost,14,8,6
Tschelo,eredar,512,mage,frost,16,6,10
Miihawkk,khaz-modan,510,mage,frost,20,6,14
Veemi,blackmoore,480,mage,frost,6,5,1
Glindalefay,silvermoon,480,mage,frost,6,5,1
Zehnvonzehn,antonidas,480,mage,frost,6,5,1
Hérä,archimonde,480,mage,frost,6,5,1
Magnopvp,sanguino,480,mage,frost,10,6,4
Primodious,kazzak,480,mage,frost,12,5,7
Аресуперпрес,gordunni,480,mage,frost,12,5,7
Magenox,blackrock,480,mage,frost,12,5,7
Betomage,blackmoore,480,mage,frost,12,5,7
Venque,blackrock,480,mage,frost,12,5,7
Pixlet,kazzak,480,mage,frost,12,5,7
Thelastmage,outland,480,mage,frost,12,5,7
Vapurx,blackmoore,480,mage,frost,12,5,7
Snowsánji,blackmoore,480,mage,frost,12,5,7
Lylla,cthun,480,mage,frost,12,5,7
Zaurok,sanguino,480,mage,frost,12,5,7
Marikisanx,blackmoore,480,mage,frost,12,5,7
Saucise,hyjal,480,mage,frost,12,5,7
Bamz,malganis,480,mage,frost,12,5,7
Moffmage,sylvanas,480,mage,frost,12,5,7
Okey,frostwhisper,480,mage,frost,12,5,7
Chrømy,twisting-nether,480,mage,frost,12,5,7
Gàtsby,outland,480,mage,frost,12,5,7
Milkenjoyer,ravencrest,480,mage,frost,12,5,7
Ikefire,draenor,480,mage,frost,12,5,7
Spell,blackmoore,480,mage,frost,12,5,7
Kleptomania,archimonde,480,mage,frost,12,5,7
Médivh,archimonde,480,mage,frost,12,5,7
Reeroll,arthas,480,mage,frost,12,5,7
Wukidiwn,draenor,480,mage,frost,18,5,13
Shøcked,blackrock,480,mage,frost,18,5,13
Råståfåri,uldum,480,mage,frost,18,5,13
Wàneís,ravencrest,480,mage,frost,18,5,13
Digi,ravencrest,480,mage,frost,21,5,16
Coldstormz,terenas,479,mage,frost,12,5,7
Çxçx,dun-modr,479,mage,frost,12,5,7
Deletron,ragnaros,479,mage,frost,18,5,13
Popixx,magtheridon,479,mage,frost,18,5,13
Feuerflamme,theradras,478,mage,frost,12,5,7
Kadsy,tarren-mill,478,mage,frost,18,5,13
Gønzô,blackmoore,477,mage,frost,18,5,13
Rifinouu,archimonde,476,mage,frost,12,5,7
Polflop,sylvanas,476,mage,frost,12,5,7
Phibonaci,sylvanas,475,mage,frost,12,5,7
Мерджреквест,howling-fjord,462,mage,frost,11,5,6
Blinkinggoat,ragnaros,448,mage,frost,16,5,11
Olivaresa,ravencrest,446,mage,frost,23,5,18
Swemagus,outland,432,mage,frost,9,5,4
Kelthuzed,twisting-nether,432,mage,frost,15,5,10
Hbarftw,ravencrest,426,mage,frost,14,6,8
Euklid,ravencrest,416,mage,frost,10,5,5
Xerathon,ravencrest,414,mage,frost,16,5,11
Leylus,blackmoore,399,mage,frost,5,5,0
Nötmârtònxø,ragnaros,384,mage,frost,6,4,2
Arcitech,tarren-mill,384,mage,frost,6,4,2
Froststarr,burning-legion,384,mage,frost,6,4,2
Botanicula,the-maelstrom,384,mage,frost,6,4,2
Scoxywoxy,ragnaros,384,mage,frost,6,4,2
Grömit,drakthul,384,mage,frost,6,4,2
Sneakii,the-maelstrom,384,mage,frost,6,4,2
Noviina,argent-dawn,384,mage,frost,6,4,2
Zerobelow,silvermoon,384,mage,frost,6,4,2
Sylvîe,tarren-mill,384,mage,frost,6,4,2
Proudmøøre,argent-dawn,384,mage,frost,6,4,2
Cesi,silvermoon,384,mage,frost,6,4,2
Nightcàller,pozzo-delleternità,384,mage,frost,6,4,2
Фирдаркнесс,howling-fjord,384,mage,frost,6,4,2
Nutsa,silvermoon,384,mage,frost,6,4,2
Ðazzftw,archimonde,384,mage,frost,6,4,2
Chililol,dun-modr,384,mage,frost,6,4,2
Ón,burning-steppes,384,mage,frost,6,4,2
Arcticfury,ravencrest,384,mage,frost,6,4,2
Meign,eredar,384,mage,frost,6,4,2
Fuhry,tarren-mill,384,mage,frost,6,4,2
Oblív,ravencrest,384,mage,frost,6,4,2
Snakebit,kazzak,384,mage,frost,6,4,2
Альмодера,gordunni,384,mage,frost,6,4,2
Zionara,stormscale,384,mage,frost,6,4,2
Митгори,gordunni,384,mage,frost,6,4,2
Doryy,silvermoon,384,mage,frost,6,4,2
Pinkusbruh,aggra-português,384,mage,frost,6,4,2
Leontus,outland,384,mage,frost,6,4,2
Ahøllic,frostwolf,384,mage,frost,6,4,2
Razzìatore,pozzo-delleternità,384,mage,frost,7,4,3
Xoouuboo,eredar,384,mage,frost,12,4,8
Юджегс,soulflayer,384,mage,frost,12,4,8
Пламяорды,soulflayer,384,mage,frost,12,4,8
Aern,sinstralis,384,mage,frost,12,4,8
Шипкастермвп,howling-fjord,384,mage,frost,12,4,8
Lambaa,thrall,384,mage,frost,12,4,8
Muntiks,ravencrest,384,mage,frost,12,4,8
Ahdetärjag,silvermoon,384,mage,frost,12,4,8
Stellarie,sylvanas,384,mage,frost,12,4,8
Tærrëñshíll,tarren-mill,384,mage,frost,12,4,8
Acclay,malganis,384,mage,frost,12,4,8
Facerollyo,tarren-mill,384,mage,frost,12,4,8
Newtwo,ravencrest,384,mage,frost,12,4,8
Zikyo,silvermoon,384,mage,frost,12,4,8
Proffset,outland,384,mage,frost,12,4,8
Ioriyagami,dragonmaw,384,mage,frost,12,4,8
Faunas,kazzak,384,mage,frost,12,4,8
Roberx,sanguino,384,mage,frost,12,4,8
Tarovan,defias-brotherhood,384,mage,frost,12,4,8
Lillelord,defias-brotherhood,384,mage,frost,12,4,8
Cavadrex,arathor,384,mage,frost,18,4,14
Wuffwuffspik,grim-batol,383,mage,frost,6,4,2
Brandonjames,ragnaros,383,mage,frost,12,4,8
Juntara,stormscale,383,mage,frost,12,4,8
Magicoliwia,ysera,382,mage,frost,6,4,2
Rintoh,pozzo-delleternità,382,mage,frost,18,4,14
Mimicassa,defias-brotherhood,371,mage,frost,22,9,13
Whosthemage,kazzak,351,mage,frost,8,5,3
Nebby,argent-dawn,351,mage,frost,11,4,7
Tsubas,blackmoore,330,mage,frost,15,5,10
Sleîhg,sanguino,320,mage,frost,10,4,6
Regenn,kazzak,318,mage,frost,5,4,1
Coldnight,uldum,301,mage,frost,13,4,9
Zyllu,argent-dawn,288,mage,frost,6,3,3
Drinte,blackmoore,288,mage,frost,6,3,3
Arandartis,kazzak,288,mage,frost,6,3,3
Narcîsa,sanguino,288,mage,frost,6,3,3
Gladxp,outland,288,mage,frost,6,3,3
Johnnydeepp,archimonde,288,mage,frost,6,3,3
Onegaisenpai,ragnaros,288,mage,frost,6,3,3
Учительйода,ashenvale,288,mage,frost,6,3,3
Orelox,kazzak,288,mage,frost,6,3,3
Magekaoz,sylvanas,288,mage,frost,6,3,3
Dumblemore,ragnaros,288,mage,frost,6,3,3
Bóósh,alakir,288,mage,frost,6,3,3
Kilstine,outland,288,mage,frost,6,3,3
Brunettdelux,archimonde,288,mage,frost,6,3,3
Gotone,tarren-mill,288,mage,frost,6,3,3
Broccosoup,kazzak,288,mage,frost,6,3,3
Rèkt,lightbringer,288,mage,frost,6,3,3
Tommyboy,dragonblight,288,mage,frost,6,3,3
Codeincassie,blackhand,288,mage,frost,6,3,3
Anthrex,drakthul,288,mage,frost,6,3,3
Dragotus,dragonblight,288,mage,frost,6,3,3
Metaboi,ragnaros,288,mage,frost,6,3,3
Haginatorr,twisting-nether,288,mage,frost,6,3,3
Luckydo,turalyon,288,mage,frost,6,3,3
Microsmag,thrall,288,mage,frost,6,3,3
Овеча,gordunni,288,mage,frost,6,3,3
Bigburns,draenor,288,mage,frost,6,3,3
Сизаам,howling-fjord,288,mage,frost,6,3,3
Vodjka,nemesis,288,mage,frost,6,3,3
Muuckie,blackrock,288,mage,frost,6,3,3
Волшебну,soulflayer,288,mage,frost,6,3,3
Sozie,tarren-mill,288,mage,frost,6,3,3
Fboltprocd,ragnaros,288,mage,frost,6,3,3
Сэрруденкент,soulflayer,288,mage,frost,6,3,3
Ripdeepfreez,culte-de-la-rive-noire,288,mage,frost,6,3,3
Lyramage,draenor,288,mage,frost,6,3,3
Smashdown,blackrock,288,mage,frost,6,3,3
Snowberry,blackrock,288,mage,frost,6,3,3
Eliosia,drakthul,288,mage,frost,6,3,3
Ørixx,blackhand,288,mage,frost,6,3,3
Antaos,drakthul,288,mage,frost,6,3,3
Siérra,outland,288,mage,frost,6,3,3
Milminmage,ravencrest,288,mage,frost,6,3,3
Frökenfrost,stormscale,288,mage,frost,6,3,3
Nevertøxic,ravencrest,288,mage,frost,6,3,3
Justvik,eredar,288,mage,frost,6,3,3
Wambamm,ravencrest,288,mage,frost,12,3,9
Naween,hyjal,288,mage,frost,12,3,9
Dumbledores,aegwynn,288,mage,frost,12,3,9
Деметрадон,gordunni,288,mage,frost,12,3,9
Эммилиарда,gordunni,288,mage,frost,12,3,9
Phonkim,stormscale,288,mage,frost,12,3,9
Voraxma,draenor,288,mage,frost,12,3,9
Tadaa,blackmoore,288,mage,frost,12,3,9
Paradigma,sylvanas,288,mage,frost,12,3,9
Ахиригиз,gordunni,288,mage,frost,12,3,9
Gogara,kazzak,288,mage,frost,12,3,9
Sérc,ravencrest,288,mage,frost,12,3,9
Imasheeper,silvermoon,288,mage,frost,12,3,9
Subtempo,silvermoon,288,mage,frost,12,3,9
Потныйдпс,eversong,288,mage,frost,12,3,9
Fernandéz,ravencrest,288,mage,frost,12,3,9
Kaiyn,argent-dawn,288,mage,frost,12,3,9
Blinkmehome,silvermoon,288,mage,frost,12,3,9
Vioulette,elune,288,mage,frost,12,3,9
Consquens,aszune,288,mage,frost,12,3,9
Waterhagx,tarren-mill,288,mage,frost,12,3,9
Distrophy,vashj,288,mage,frost,12,3,9
Tirenia,bloodfeather,288,mage,frost,17,3,14
Wslyx,dun-morogh,288,mage,frost,18,3,15
Magjaw,twisting-nether,287,mage,frost,6,3,3
Fumachustas,kazzak,287,mage,frost,6,3,3
Hagiko,archimonde,287,mage,frost,6,3,3
Wopi,sylvanas,287,mage,frost,6,3,3
Magó,eredar,287,mage,frost,6,3,3
Valtarisoo,amanthul,287,mage,frost,6,3,3
Sylênna,kazzak,287,mage,frost,9,4,5
Kasus,sporeggar,287,mage,frost,12,3,9
Familyfrost,thunderhorn,287,mage,frost,12,3,9
Freeto,blackmoore,286,mage,frost,6,3,3
Maran,outland,286,mage,frost,12,3,9
Soulcatcheus,archimonde,286,mage,frost,12,3,9
Iif,zirkel-des-cenarius,239,mage,frost,5,3,2
Шеллестун,soulflayer,208,mage,frost,7,3,4
Holginho,twilights-hammer,192,mage,frost,12,5,7
Viro,defias-brotherhood,192,mage,frost,9,3,6
Gameart,alexstrasza,192,mage,frost,6,2,4
Funakin,blackrock,192,mage,frost,6,2,4
Xenodike,blackrock,192,mage,frost,6,2,4
Welt,drakthul,192,mage,frost,6,2,4
Laciee,silvermoon,192,mage,frost,6,2,4
Frazztato,tarren-mill,192,mage,frost,6,2,4
Pumpzy,tarren-mill,192,mage,frost,6,2,4
Elor,eredar,192,mage,frost,6,2,4
Alieni,stormreaver,192,mage,frost,6,2,4
Beardyman,haomarush,192,mage,frost,6,2,4
Løxyy,ysondre,192,mage,frost,6,2,4
Alleii,kazzak,192,mage,frost,6,2,4
Nandie,stormreaver,192,mage,frost,6,2,4
Brutal,thrall,192,mage,frost,6,2,4
Ingibjorg,auchindoun,192,mage,frost,6,2,4
Kobrass,spinebreaker,192,mage,frost,6,2,4
Thegoodoctor,kazzak,192,mage,frost,6,2,4
Etherìon,los-errantes,192,mage,frost,6,2,4
Флоой,gordunni,192,mage,frost,6,2,4
Chíefsheep,thrall,192,mage,frost,6,2,4
Cortis,outland,192,mage,frost,6,2,4
Галадриелька,gordunni,192,mage,frost,6,2,4
Smokedaddy,stormscale,192,mage,frost,6,2,4
Rizzlybear,outland,192,mage,frost,6,2,4
Creak,blackhand,192,mage,frost,6,2,4
Maestrá,outland,192,mage,frost,6,2,4
Магниффика,blackscar,192,mage,frost,6,2,4
Tygaone,tirion,192,mage,frost,6,2,4
Maveya,blackmoore,192,mage,frost,6,2,4
Shagee,stormscale,192,mage,frost,6,2,4
Sebers,kazzak,192,mage,frost,6,2,4
Бд,blackscar,192,mage,frost,6,2,4
Dxdxdxdxdx,drakthul,192,mage,frost,6,2,4
Mezaiyh,blackmoore,192,mage,frost,6,2,4
Doidadetanga,aggra-português,192,mage,frost,6,2,4
Feath,ravencrest,192,mage,frost,6,2,4
Ðøæø,twisting-nether,192,mage,frost,6,2,4
Shealá,blackhand,192,mage,frost,6,2,4
Infamage,draenor,192,mage,frost,6,2,4
Balmak,doomhammer,192,mage,frost,6,2,4
Warwizz,sanguino,192,mage,frost,6,2,4
Estupen,sanguino,192,mage,frost,6,2,4
Frostbringer,archimonde,192,mage,frost,6,2,4
Lïppoutou,archimonde,192,mage,frost,6,2,4
Tomia,burning-legion,192,mage,frost,6,2,4
Nøxas,archimonde,192,mage,frost,6,2,4
Crayz,magtheridon,192,mage,frost,6,2,4
Naldora,turalyon,192,mage,frost,6,2,4
Xblaz,draenor,192,mage,frost,6,2,4
Stilnox,nemesis,192,mage,frost,6,2,4
Fikkamika,ragnaros,192,mage,frost,6,2,4
Ehbehad,doomhammer,192,mage,frost,6,2,4
Ckrax,sanguino,192,mage,frost,6,2,4
Meteofrost,draenor,192,mage,frost,6,2,4
Blastus,ragnaros,192,mage,frost,6,2,4
Partagedeco,dalaran,192,mage,frost,6,2,4
Sperow,marécage-de-zangar,192,mage,frost,6,2,4
Bloodymage,zenedar,192,mage,frost,6,2,4
Labius,dun-modr,192,mage,frost,6,2,4
Flamê,ragnaros,192,mage,frost,12,2,10
Ørcan,azshara,192,mage,frost,12,2,10
Xawokem,outland,192,mage,frost,12,2,10
Freezeballs,blackmoore,192,mage,frost,12,2,10
Braínfreeze,kazzak,192,mage,frost,12,2,10
Pogmage,blackrock,192,mage,frost,12,2,10
Myriel,thrall,192,mage,frost,12,2,10
Intêrnet,archimonde,192,mage,frost,12,2,10
Shizzy,onyxia,192,mage,frost,12,2,10
Rapidfrost,drakthul,192,mage,frost,12,2,10
Mariujana,ravencrest,192,mage,frost,12,2,10
Bêta,dun-modr,192,mage,frost,12,2,10
Portnography,draenor,192,mage,frost,12,2,10
Boned,ravencrest,192,mage,frost,12,2,10
Makkertje,silvermoon,191,mage,frost,6,2,4
Mátraxx,silvermoon,191,mage,frost,12,2,10
Magipus,anetheron,190,mage,frost,12,2,10
Чогоце,eversong,189,mage,frost,18,2,16
Dødo,archimonde,159,mage,frost,5,2,3
Azadan,pozzo-delleternità,159,mage,frost,5,2,3
Ivailo,ravencrest,159,mage,frost,5,2,3
Kyan,burning-legion,159,mage,frost,5,2,3
Mínêrvâ,blackrock,144,mage,frost,3,3,0
Zôot,ravencrest,138,mage,frost,11,4,7
Ehren,ravencrest,138,mage,frost,10,3,7
Shakamage,grim-batol,128,mage,frost,4,2,2
Skitsó,shadowsong,127,mage,frost,4,2,2
Firestárter,ravencrest,96,mage,frost,3,2,1
Mutly,kazzak,96,mage,frost,3,2,1
Ntintsec,tarren-mill,96,mage,frost,3,2,1
Nullso,zuljin,96,mage,frost,6,1,5
Xýton,azjolnerub,96,mage,frost,6,1,5
Romaga,quelthalas,96,mage,frost,6,1,5
Fîrestorm,doomhammer,96,mage,frost,6,1,5
Testoletku,twisting-nether,96,mage,frost,6,1,5
Kosso,twisting-nether,96,mage,frost,6,1,5
Alphaburstqx,ragnaros,96,mage,frost,6,1,5
Sheeptonreup,archimonde,96,mage,frost,6,1,5
Teeclis,twisting-nether,96,mage,frost,6,1,5
Luckymango,alakir,96,mage,frost,6,1,5
Мэджиксул,grom,96,mage,frost,6,1,5
Squìshy,magtheridon,96,mage,frost,6,1,5
Luxxurious,xavius,96,mage,frost,6,1,5
Larmp,outland,96,mage,frost,6,1,5
Dzomage,kazzak,96,mage,frost,6,1,5
Rilac,nordrassil,96,mage,frost,6,1,5
Froostii,aegwynn,96,mage,frost,6,1,5
Aarcheon,kazzak,96,mage,frost,6,1,5
Mëgu,silvermoon,96,mage,frost,6,1,5
Devòna,silvermoon,96,mage,frost,6,1,5
Dwarfyy,frostmane,96,mage,frost,6,1,5
Rezre,stormscale,96,mage,frost,6,1,5
Nekroulis,agamaggan,96,mage,frost,6,1,5
Loskapaska,stormreaver,96,mage,frost,6,1,5
Homeessa,stormreaver,96,mage,frost,6,1,5
Niladyel,hyjal,96,mage,frost,6,1,5
Petri,laughing-skull,96,mage,frost,6,1,5
Dyen,hyjal,96,mage,frost,6,1,5
Xèrec,ysondre,96,mage,frost,6,1,5
Kpacey,guldan,96,mage,frost,6,1,5
Деорро,gordunni,96,mage,frost,6,1,5
Холдми,gordunni,96,mage,frost,6,1,5
Колтрэйн,blackscar,96,mage,frost,6,1,5
Nåzmyz,outland,96,mage,frost,6,1,5
Spamblink,archimonde,96,mage,frost,9,1,8
Hruon,ravenholdt,96,mage,frost,9,1,8
Snowy,sargeras,96,mage,frost,12,1,11
Kyraja,arthas,96,mage,frost,12,1,11
Ploufatak,hyjal,96,mage,frost,18,1,17
Aurayaa,teldrassil,95,mage,frost,11,1,10
Nalord,saurfang,95,mage,frost,12,1,11
Bagss,ysondre,95,mage,frost,12,1,11
Milhoux,ysondre,79,mage,frost,5,1,4
Bceps,stormscale,64,mage,frost,4,1,3
Magebraín,ravencrest,63,mage,frost,2,2,0
Gocu,tarren-mill,63,mage,frost,2,2,0
Maege,ragnaros,63,mage,frost,2,2,0
Aeghis,darkspear,42,mage,frost,10,3,7
Mayreel,antonidas,42,mage,frost,11,3,8
Yoxt,blackhand,31,mage,frost,2,1,1
Xaramael,colinas-pardas,8,mage,frost,9,3,6
Fisterino,zuljin,2304,monk,mistweaver,54,42,12
Nnsstt,zuljin,2277,monk,mistweaver,104,64,40
Bankmw,tarren-mill,2265,monk,mistweaver,77,52,25
Brickedup,twisting-nether,2246,monk,mistweaver,139,81,58
Ballademager,magtheridon,2218,monk,mistweaver,90,55,35
Montex,stormscale,2210,monk,mistweaver,96,53,43
Cocojones,tarren-mill,2194,monk,mistweaver,60,42,18
Онимэшнеца,gordunni,2170,monk,mistweaver,77,48,29
Zaerin,eredar,2155,monk,mistweaver,67,39,28
Vivie,destromath,2142,monk,mistweaver,72,46,26
Akanetsu,kazzak,2139,monk,mistweaver,138,80,58
Kêkbûrâgól,kazzak,2136,monk,mistweaver,121,72,49
Ltmxy,ravencrest,2127,monk,mistweaver,66,40,26
Umadbrohuh,outland,2126,monk,mistweaver,66,39,27
Meliowo,ravencrest,2125,monk,mistweaver,90,51,39
Фунтос,soulflayer,2124,monk,mistweaver,66,41,25
Chichigneux,hyjal,2123,monk,mistweaver,87,60,27
Çoomðragon,stormscale,2122,monk,mistweaver,42,29,13
Tryhârdx,stormscale,2122,monk,mistweaver,84,45,39
Kêkburagol,kazzak,2120,monk,mistweaver,108,74,34
Beetlejuicé,stormscale,2118,monk,mistweaver,42,28,14
Loofey,ragnaros,2117,monk,mistweaver,218,128,90
Vanost,kazzak,2114,monk,mistweaver,90,45,45
Joke,ragnaros,2111,monk,mistweaver,78,41,37
Cranex,terenas,2109,monk,mistweaver,118,72,46
Glooni,blackrock,2108,monk,mistweaver,75,46,29
Кимлейн,blackscar,2108,monk,mistweaver,48,29,19
Shonbadatret,argent-dawn,2108,monk,mistweaver,90,54,36
Donitrivegas,blackrock,2106,monk,mistweaver,126,85,41
Sinted,blackmoore,2103,monk,mistweaver,83,52,31
Lifelessons,blackrock,2103,monk,mistweaver,57,34,23
Mibe,alonsus,2103,monk,mistweaver,108,53,55
Blubberwurst,gorgonnash,2102,monk,mistweaver,130,74,56
Flowy,uldum,2101,monk,mistweaver,60,31,29
Stringg,zuljin,2098,monk,mistweaver,258,150,108
Commadore,draenor,2097,monk,mistweaver,84,39,45
Lylleri,darksorrow,2089,monk,mistweaver,68,40,28
Tímmz,blackrock,2088,monk,mistweaver,96,56,40
Pizzabud,ravencrest,2068,monk,mistweaver,64,43,21
Øllen,stormscale,2062,monk,mistweaver,71,41,30
Webhottie,twisting-nether,2061,monk,mistweaver,96,56,40
Wajoba,blackhand,2061,monk,mistweaver,102,51,51
Monkrah,blackmoore,2047,monk,mistweaver,60,35,25
Yellowtape,kiljaeden,2046,monk,mistweaver,149,92,57
Tigermw,twisting-nether,2040,monk,mistweaver,67,45,22
Monkeyi,silvermoon,2040,monk,mistweaver,108,57,51
Mønkeÿ,ravencrest,2035,monk,mistweaver,52,34,18
Леолайт,borean-tundra,2034,monk,mistweaver,106,60,46
Вульфхильда,soulflayer,2028,monk,mistweaver,204,120,84
Pennyflame,stormscale,2026,monk,mistweaver,125,67,58
Quendiz,frostwolf,2025,monk,mistweaver,72,40,32
Adgoh,tarren-mill,2018,monk,mistweaver,58,43,15
Botweaver,tarren-mill,2016,monk,mistweaver,36,28,8
Кулакх,blackscar,2012,monk,mistweaver,106,59,47
Ðalvan,blackrock,2011,monk,mistweaver,78,39,39
Fåtjøë,ravencrest,2010,monk,mistweaver,48,31,17
Коконгкд,blackscar,2010,monk,mistweaver,209,118,91
Flandersmonk,ravencrest,2008,monk,mistweaver,90,57,33
Шортмневноги,howling-fjord,2008,monk,mistweaver,137,74,63
Monkeystar,archimonde,2004,monk,mistweaver,66,38,28
Ouhmaikgød,dun-modr,2003,monk,mistweaver,88,45,43
Суммрачная,gordunni,2002,monk,mistweaver,144,89,55
Seeyoulater,nemesis,1996,monk,mistweaver,216,109,107
Inlakech,auchindoun,1992,monk,mistweaver,129,73,56
Mösêê,eredar,1992,monk,mistweaver,88,39,49
Monkield,kazzak,1991,monk,mistweaver,146,95,51
Brxndimonk,antonidas,1990,monk,mistweaver,63,35,28
Teampro,ragnaros,1990,monk,mistweaver,258,138,120
Qwertyxo,draenor,1987,monk,mistweaver,99,65,34
Pyrìt,blackhand,1985,monk,mistweaver,54,39,15
Bobthewild,draenor,1984,monk,mistweaver,329,165,164
Mememaster,blackhand,1981,monk,mistweaver,112,68,44
Kurbanov,stormscale,1980,monk,mistweaver,63,35,28
Skailzkrtwo,hyjal,1979,monk,mistweaver,66,39,27
Tierrax,cthun,1979,monk,mistweaver,63,33,30
Zeoverx,ragnaros,1977,monk,mistweaver,78,36,42
Shirkán,ragnaros,1969,monk,mistweaver,144,83,61
Loiyh,dun-modr,1969,monk,mistweaver,72,35,37
Turricane,blackmoore,1967,monk,mistweaver,60,31,29
Veganweaver,ravencrest,1966,monk,mistweaver,60,37,23
Zevenblad,stormscale,1965,monk,mistweaver,72,37,35
Howtoown,burning-legion,1960,monk,mistweaver,60,34,26
Bmane,archimonde,1960,monk,mistweaver,53,29,24
Arenatwo,outland,1957,monk,mistweaver,81,51,30
Lp,mugthol,1956,monk,mistweaver,60,36,24
Môûsè,ravencrest,1949,monk,mistweaver,72,46,26
Zonsym,twisting-nether,1948,monk,mistweaver,72,38,34
Beili,ravencrest,1946,monk,mistweaver,79,42,37
Voltzeig,dentarg,1944,monk,mistweaver,208,111,97
Manatoiled,draenor,1941,monk,mistweaver,48,32,16
Couchfrmikea,twisting-nether,1937,monk,mistweaver,72,38,34
Yuukiiqt,kult-der-verdammten,1934,monk,mistweaver,83,47,36
Dmonkz,magtheridon,1932,monk,mistweaver,36,26,10
Ltmdwarf,ravencrest,1932,monk,mistweaver,72,36,36
Trashcarlita,eredar,1931,monk,mistweaver,48,29,19
Monkeymain,tarren-mill,1926,monk,mistweaver,53,29,24
Ûnknöw,archimonde,1921,monk,mistweaver,50,32,18
Gronkr,draenor,1916,monk,mistweaver,94,50,44
Djsqx,outland,1915,monk,mistweaver,30,20,10
Ashm,shattered-halls,1915,monk,mistweaver,60,30,30
Yoghurtz,frostmourne,1913,monk,mistweaver,120,71,49
Zoida,azuremyst,1912,monk,mistweaver,84,46,38
Wwvwwvwwvwwv,ragnaros,1912,monk,mistweaver,66,28,38
Srdarr,kazzak,1910,monk,mistweaver,60,34,26
Bighealz,aggra-português,1904,monk,mistweaver,36,20,16
Meemyo,blackmoore,1904,monk,mistweaver,83,34,49
Moariann,drakthul,1902,monk,mistweaver,120,64,56
Donkeymønk,hyjal,1901,monk,mistweaver,236,136,100
Muchobijca,defias-brotherhood,1900,monk,mistweaver,78,44,34
Bigbummer,blackmoore,1900,monk,mistweaver,96,53,43
Subàru,draenor,1898,monk,mistweaver,93,60,33
Рендикаое,soulflayer,1897,monk,mistweaver,181,104,77
Seventhirty,ravencrest,1896,monk,mistweaver,36,20,16
Neszesmonk,ragnaros,1896,monk,mistweaver,139,77,62
Dragzol,tarren-mill,1896,monk,mistweaver,72,36,36
Dmonk,aegwynn,1891,monk,mistweaver,100,46,54
Manjini,blackhand,1889,monk,mistweaver,59,31,28
Bigbøøty,silvermoon,1889,monk,mistweaver,66,33,33
Halùnkè,eredar,1885,monk,mistweaver,136,77,59
Æøwyn,ragnaros,1881,monk,mistweaver,82,57,25
Deepl,dun-modr,1880,monk,mistweaver,54,27,27
Bigmilkies,ysondre,1874,monk,mistweaver,66,36,30
Roadrunnér,ravencrest,1874,monk,mistweaver,60,30,30
Haìryplotter,kazzak,1872,monk,mistweaver,90,53,37
Тащунаскилле,thermaplugg,1862,monk,mistweaver,62,39,23
Jiafei,tarren-mill,1862,monk,mistweaver,42,25,17
Hiryu,argent-dawn,1862,monk,mistweaver,53,31,22
Effeots,blackrock,1862,monk,mistweaver,222,116,106
Youkâi,blackrock,1859,monk,mistweaver,48,31,17
Rullsimpa,ravencrest,1858,monk,mistweaver,77,34,43
Digzzy,draenor,1856,monk,mistweaver,63,35,28
Waramow,eredar,1855,monk,mistweaver,36,25,11
Supercoach,blackrock,1855,monk,mistweaver,111,65,46
Yexìu,kult-der-verdammten,1855,monk,mistweaver,42,23,19
Фейкнаут,soulflayer,1855,monk,mistweaver,108,57,51
Siignmonk,ravencrest,1853,monk,mistweaver,66,36,30
Døk,twisting-nether,1852,monk,mistweaver,36,24,12
Chanzey,silvermoon,1850,monk,mistweaver,204,114,90
Дамбмонк,blackscar,1849,monk,mistweaver,41,24,17
Глитч,deepholm,1848,monk,mistweaver,48,30,18
Alprox,moonglade,1846,monk,mistweaver,158,83,75
Yamqt,thrall,1845,monk,mistweaver,42,27,15
Pizelx,alakir,1842,monk,mistweaver,54,28,26
Musclemage,turalyon,1841,monk,mistweaver,60,31,29
Yungsooth,stormscale,1838,monk,mistweaver,53,37,16
Kratzl,blackrock,1838,monk,mistweaver,42,27,15
Pøhx,ragnaros,1837,monk,mistweaver,87,51,36
Homes,blackmoore,1837,monk,mistweaver,60,35,25
Shimmichanga,blackrock,1836,monk,mistweaver,65,42,23
Monkdrak,eredar,1835,monk,mistweaver,39,24,15
Jades,emeriss,1835,monk,mistweaver,198,99,99
Toram,burning-legion,1833,monk,mistweaver,60,29,31
Ønlyfäns,kazzak,1831,monk,mistweaver,112,67,45
Нубстриимс,gordunni,1828,monk,mistweaver,62,33,29
Mistyfox,aszune,1828,monk,mistweaver,95,45,50
Koguosa,outland,1827,monk,mistweaver,42,32,10
Véxyra,draenor,1827,monk,mistweaver,48,32,16
Мефодийкун,howling-fjord,1826,monk,mistweaver,108,63,45
Playbîrd,archimonde,1826,monk,mistweaver,100,54,46
Luvmollý,silvermoon,1826,monk,mistweaver,78,41,37
Notachi,doomhammer,1825,monk,mistweaver,243,135,108
Porcman,archimonde,1825,monk,mistweaver,141,71,70
Элонхаск,gordunni,1824,monk,mistweaver,54,29,25
Swagmonk,silvermoon,1824,monk,mistweaver,56,30,26
Cåpybårå,outland,1824,monk,mistweaver,249,131,118
Mbynxtlife,draenor,1824,monk,mistweaver,48,25,23
Vizfist,tarren-mill,1823,monk,mistweaver,54,26,28
Stemanit,draenor,1822,monk,mistweaver,41,28,13
Гроксси,howling-fjord,1820,monk,mistweaver,70,45,25
Luru,outland,1820,monk,mistweaver,53,33,20
Trollroll,defias-brotherhood,1820,monk,mistweaver,132,74,58
Анстапоблх,grom,1820,monk,mistweaver,54,24,30
Hurri,krasus,1819,monk,mistweaver,36,25,11
Perceptîon,thrall,1819,monk,mistweaver,41,23,18
Ганссмонк,blackscar,1819,monk,mistweaver,42,23,19
Bicmex,archimonde,1819,monk,mistweaver,90,42,48
Mistyhoe,twisting-nether,1818,monk,mistweaver,71,37,34
Motang,blackmoore,1816,monk,mistweaver,62,34,28
Mugenzen,sanguino,1816,monk,mistweaver,36,19,17
Твикса,soulflayer,1816,monk,mistweaver,114,54,60
Pwner,daggerspine,1815,monk,mistweaver,259,132,127
Zulein,defias-brotherhood,1814,monk,mistweaver,36,21,15
Savagex,sanguino,1814,monk,mistweaver,60,32,28
Тамаз,gordunni,1814,monk,mistweaver,59,24,35
Calmed,tarren-mill,1813,monk,mistweaver,71,49,22
Crñ,blackmoore,1813,monk,mistweaver,44,26,18
Basilbrushxd,stormscale,1813,monk,mistweaver,48,27,21
Ruurruuru,archimonde,1812,monk,mistweaver,42,29,13
Lünara,ambossar,1812,monk,mistweaver,72,44,28
Santoron,baelgun,1812,monk,mistweaver,63,30,33
Uwû,ravencrest,1811,monk,mistweaver,59,45,14
Onlyfist,stormscale,1811,monk,mistweaver,42,28,14
Sugermum,outland,1811,monk,mistweaver,54,31,23
Claudiå,kazzak,1811,monk,mistweaver,54,27,27
Мичан,howling-fjord,1810,monk,mistweaver,102,63,39
Kapud,twisting-nether,1809,monk,mistweaver,36,23,13
Karmasnitch,antonidas,1808,monk,mistweaver,66,38,28
Uao,tarren-mill,1808,monk,mistweaver,48,22,26
Timmzý,blackmoore,1807,monk,mistweaver,42,29,13
Лиянь,soulflayer,1807,monk,mistweaver,96,56,40
Zanzetsu,twisting-nether,1807,monk,mistweaver,90,49,41
Mobrac,twisting-nether,1807,monk,mistweaver,39,21,18
Kilograme,tarren-mill,1806,monk,mistweaver,66,36,30
Kîrânâ,eredar,1806,monk,mistweaver,54,29,25
Ранки,lich-king,1806,monk,mistweaver,60,27,33
Panson,twisting-nether,1804,monk,mistweaver,54,28,26
Dollyqt,ravencrest,1803,monk,mistweaver,48,28,20
Fùckaround,emeriss,1802,monk,mistweaver,60,37,23
Notzaele,zuljin,1802,monk,mistweaver,42,23,19
Lyashi,dalaran,1801,monk,mistweaver,54,28,26
Jinxini,twisting-nether,1800,monk,mistweaver,24,19,5
Callysra,archimonde,1800,monk,mistweaver,42,30,12
Боецкфц,soulflayer,1800,monk,mistweaver,52,28,24
Mergina,silvermoon,1800,monk,mistweaver,48,25,23
Hurricaine,hyjal,1799,monk,mistweaver,30,19,11
Brewnox,ragnaros,1797,monk,mistweaver,59,30,29
Bossmanfred,outland,1794,monk,mistweaver,66,47,19
Chazu,outland,1793,monk,mistweaver,54,30,24
Rolxx,twisting-nether,1793,monk,mistweaver,74,35,39
Cptsensey,draenor,1788,monk,mistweaver,36,25,11
Tráïner,madmortem,1788,monk,mistweaver,119,62,57
Threesíxníne,dun-morogh,1783,monk,mistweaver,42,22,20
Shâng,blackhand,1780,monk,mistweaver,42,23,19
Monkler,blackhand,1779,monk,mistweaver,78,36,42
Xoconut,kazzak,1774,monk,mistweaver,227,125,102
Wrv,kazzak,1774,monk,mistweaver,140,73,67
Karsat,hyjal,1770,monk,mistweaver,277,140,137
Sinanger,dun-modr,1766,monk,mistweaver,180,100,80
Milkhy,minahonda,1763,monk,mistweaver,46,26,20
Shadezz,blackmoore,1762,monk,mistweaver,46,30,16
Jemp,ravencrest,1761,monk,mistweaver,228,137,91
Legsweep,blackhand,1760,monk,mistweaver,103,68,35
Brysiqtx,aegwynn,1760,monk,mistweaver,63,31,32
Bammemw,archimonde,1760,monk,mistweaver,54,25,29
Siphem,ravencrest,1757,monk,mistweaver,60,34,26
Sniffn,ravencrest,1754,monk,mistweaver,54,35,19
Pitrols,twisting-nether,1754,monk,mistweaver,111,67,44
Limbaskalol,dun-modr,1754,monk,mistweaver,181,90,91
Stifmeister,tarren-mill,1750,monk,mistweaver,94,50,44
Эрмилинда,gordunni,1749,monk,mistweaver,54,26,28
Kaezm,blackrock,1746,monk,mistweaver,42,26,16
Xámell,ravencrest,1746,monk,mistweaver,36,19,17
Yum,anetheron,1746,monk,mistweaver,78,38,40
Jingfeng,arthas,1746,monk,mistweaver,101,49,52
Dewamønk,blackmoore,1744,monk,mistweaver,40,23,17
Mcscrub,ragnaros,1742,monk,mistweaver,35,24,11
Jerymonk,tarren-mill,1742,monk,mistweaver,162,91,71
Kóan,stormscale,1740,monk,mistweaver,60,31,29
Inuria,ravencrest,1739,monk,mistweaver,54,37,17
Амаранточка,howling-fjord,1738,monk,mistweaver,48,29,19
Fatdad,magtheridon,1735,monk,mistweaver,83,41,42
Swaghäuser,blackmoore,1733,monk,mistweaver,138,76,62
Nsq,ravencrest,1731,monk,mistweaver,48,26,22
Greentape,kiljaeden,1730,monk,mistweaver,42,27,15
Butterbean,conseil-des-ombres,1730,monk,mistweaver,36,23,13
Prototyp,burning-legion,1729,monk,mistweaver,36,23,13
Эифорйя,howling-fjord,1726,monk,mistweaver,58,25,33
Babbub,tarren-mill,1725,monk,mistweaver,48,29,19
Koraxx,blackmoore,1724,monk,mistweaver,66,38,28
Yadokaí,darkmoon-faire,1724,monk,mistweaver,48,23,25
Wajøba,blackhand,1722,monk,mistweaver,36,18,18
Iminar,blackrock,1721,monk,mistweaver,42,24,18
Séi,kazzak,1721,monk,mistweaver,36,18,18
Mwrbg,shadowsong,1720,monk,mistweaver,113,63,50
Chimara,kazzak,1718,monk,mistweaver,79,45,34
Аскмилол,deathweaver,1717,monk,mistweaver,60,35,25
Шэганэ,deathguard,1715,monk,mistweaver,51,32,19
Alë,argent-dawn,1714,monk,mistweaver,105,65,40
Blacktee,eredar,1714,monk,mistweaver,36,21,15
Merína,ragnaros,1714,monk,mistweaver,207,109,98
Olympiiee,archimonde,1713,monk,mistweaver,293,157,136
Neisha,drakthul,1711,monk,mistweaver,42,26,16
Mugotea,twisting-nether,1711,monk,mistweaver,48,26,22
Stramonk,nemesis,1711,monk,mistweaver,168,84,84
Ashjaxa,silvermoon,1710,monk,mistweaver,42,18,24
Capkum,dun-modr,1710,monk,mistweaver,48,19,29
Meldi,ravencrest,1709,monk,mistweaver,42,24,18
Ivanzamonka,stormscale,1708,monk,mistweaver,71,47,24
Барлиос,soulflayer,1708,monk,mistweaver,214,113,101
Tjann,stormscale,1706,monk,mistweaver,48,33,15
Drugashe,archimonde,1706,monk,mistweaver,79,37,42
Shyheim,outland,1705,monk,mistweaver,48,36,12
Egg,frostmane,1705,monk,mistweaver,30,18,12
Adis,nerathor,1703,monk,mistweaver,48,28,20
Moontríx,kazzak,1703,monk,mistweaver,48,21,27
Djpunchable,blackrock,1701,monk,mistweaver,35,26,9
Pudgefeed,silvermoon,1701,monk,mistweaver,30,19,11
Shyheimyo,outland,1701,monk,mistweaver,42,21,21
Ziibaa,outland,1698,monk,mistweaver,42,28,14
Evad,kazzak,1698,monk,mistweaver,66,41,25
Rullefald,stormscale,1697,monk,mistweaver,102,57,45
Residùe,kazzak,1695,monk,mistweaver,30,21,9
Quendi,frostwolf,1695,monk,mistweaver,36,23,13
Neash,silvermoon,1695,monk,mistweaver,48,27,21
Enveløp,stormscale,1694,monk,mistweaver,24,18,6
Вакидзави,gordunni,1694,monk,mistweaver,48,31,17
Кикподхвост,blackscar,1694,monk,mistweaver,60,26,34
Milkabtw,kazzak,1692,monk,mistweaver,39,25,14
Фучой,howling-fjord,1692,monk,mistweaver,57,34,23
Táuriéll,eredar,1692,monk,mistweaver,36,18,18
Magixc,drakthul,1691,monk,mistweaver,47,25,22
Sîono,antonidas,1689,monk,mistweaver,30,22,8
Skïrmíshgødx,ravencrest,1688,monk,mistweaver,48,20,28
Birgitbuddha,gorgonnash,1686,monk,mistweaver,54,29,25
Astromune,draenor,1683,monk,mistweaver,41,24,17
Jolude,nemesis,1683,monk,mistweaver,66,35,31
Sadmw,archimonde,1679,monk,mistweaver,36,20,16
Papours,ysondre,1676,monk,mistweaver,30,22,8
Elhäbedehä,eredar,1673,monk,mistweaver,148,76,72
Аци,blackscar,1671,monk,mistweaver,47,31,16
Ræïzò,dun-morogh,1670,monk,mistweaver,36,20,16
Bullergøjen,ravencrest,1668,monk,mistweaver,78,52,26
Elmezz,burning-legion,1668,monk,mistweaver,39,19,20
Zorkev,dun-modr,1667,monk,mistweaver,113,63,50
Dearmw,silvermoon,1666,monk,mistweaver,90,50,40
Áyell,archimonde,1665,monk,mistweaver,81,52,29
Chitea,argent-dawn,1663,monk,mistweaver,35,22,13
Onlyfunn,sanguino,1661,monk,mistweaver,48,27,21
Бадика,howling-fjord,1657,monk,mistweaver,144,80,64
Elvand,twisting-nether,1656,monk,mistweaver,66,39,27
Репаблликуес,gordunni,1656,monk,mistweaver,34,20,14
Varyat,uldum,1656,monk,mistweaver,41,24,17
Trollandroll,stormscale,1655,monk,mistweaver,131,71,60
Эддрос,gordunni,1655,monk,mistweaver,66,35,31
Mangi,rexxar,1655,monk,mistweaver,72,37,35
Cdriscas,aggra-português,1654,monk,mistweaver,50,27,23
Meltfistqt,ravencrest,1654,monk,mistweaver,112,52,60
Jacksa,bronze-dragonflight,1651,monk,mistweaver,130,63,67
Джулибубба,borean-tundra,1650,monk,mistweaver,48,30,18
Skailzkrt,hyjal,1649,monk,mistweaver,43,19,24
Aromipesäx,outland,1647,monk,mistweaver,41,22,19
Otemøøn,sanguino,1646,monk,mistweaver,45,25,20
Wiwâ,outland,1646,monk,mistweaver,37,19,18
Monknice,sylvanas,1646,monk,mistweaver,47,21,26
Jorahmarmond,tarren-mill,1645,monk,mistweaver,30,23,7
Imeon,dun-modr,1644,monk,mistweaver,30,18,12
Jabington,aegwynn,1644,monk,mistweaver,75,42,33
Эрмонд,soulflayer,1644,monk,mistweaver,44,23,21
Unsanegodx,ravencrest,1643,monk,mistweaver,48,35,13
Нийтринно,howling-fjord,1643,monk,mistweaver,36,19,17
Nepho,twisting-nether,1642,monk,mistweaver,38,23,15
Pogimonkey,ragnaros,1642,monk,mistweaver,42,23,19
Nêøø,blackrock,1641,monk,mistweaver,115,80,35
Hajlong,outland,1641,monk,mistweaver,42,21,21
Mer,outland,1640,monk,mistweaver,44,24,20
Fistify,destromath,1639,monk,mistweaver,24,20,4
Suliya,zuluhed,1639,monk,mistweaver,36,21,15
Kirkeý,ravencrest,1638,monk,mistweaver,37,26,11
Timboqt,blackmoore,1638,monk,mistweaver,70,43,27
Actionsusi,area-52,1638,monk,mistweaver,36,21,15
Oikodomos,twisting-nether,1638,monk,mistweaver,47,24,23
Uckkm,ragnaros,1637,monk,mistweaver,42,24,18
Simòna,dun-modr,1637,monk,mistweaver,162,83,79
Apolskis,ravencrest,1636,monk,mistweaver,42,30,12
Артэкрио,soulflayer,1635,monk,mistweaver,36,26,10
Karoou,kelthuzad,1635,monk,mistweaver,89,48,41
Soulring,kazzak,1634,monk,mistweaver,51,23,28
Eugenn,alonsus,1633,monk,mistweaver,46,27,19
Orfantal,ravencrest,1631,monk,mistweaver,60,38,22
Loobee,ravencrest,1630,monk,mistweaver,30,17,13
Orcimon,draenor,1630,monk,mistweaver,30,17,13
Youssee,silvermoon,1629,monk,mistweaver,186,102,84
Seandyche,ravencrest,1628,monk,mistweaver,28,18,10
Pe,blackhand,1628,monk,mistweaver,66,37,29
Løta,blackmoore,1627,monk,mistweaver,30,20,10
Papermakerx,blackrock,1627,monk,mistweaver,46,28,18
Problematic,blackmoore,1626,monk,mistweaver,30,17,13
Twistie,aegwynn,1626,monk,mistweaver,36,17,19
Йорита,soulflayer,1625,monk,mistweaver,30,17,13
Yto,gorgonnash,1624,monk,mistweaver,30,17,13
Sâu,twisting-nether,1623,monk,mistweaver,30,17,13
Ultdave,eredar,1622,monk,mistweaver,105,58,47
Monkim,chogall,1621,monk,mistweaver,36,23,13
Errowin,blackmoore,1621,monk,mistweaver,72,42,30
Cykatea,dun-modr,1620,monk,mistweaver,235,128,107
Happymonktwo,ravencrest,1620,monk,mistweaver,94,50,44
Issho,der-rat-von-dalaran,1620,monk,mistweaver,36,19,17
Jyll,malganis,1620,monk,mistweaver,41,18,23
Inthepoopa,outland,1618,monk,mistweaver,90,51,39
Jpstwo,gorgonnash,1617,monk,mistweaver,54,28,26
Jetleê,eredar,1617,monk,mistweaver,138,71,67
Ричфлекс,howling-fjord,1616,monk,mistweaver,152,95,57
Кулаквнос,gordunni,1616,monk,mistweaver,54,30,24
Fansolini,burning-legion,1616,monk,mistweaver,46,22,24
Binkote,zuljin,1615,monk,mistweaver,77,46,31
Ceeja,blackmoore,1615,monk,mistweaver,137,76,61
Extrimist,sylvanas,1615,monk,mistweaver,99,52,47
Myeers,dun-modr,1615,monk,mistweaver,48,24,24
Kaizetsu,drakthul,1614,monk,mistweaver,36,27,9
Wwception,blackrock,1614,monk,mistweaver,38,22,16
Ipmanlol,archimonde,1614,monk,mistweaver,78,45,33
Sensorium,ravencrest,1614,monk,mistweaver,108,59,49
Watchmedamp,draenor,1613,monk,mistweaver,176,104,72
Soulxq,blackrock,1613,monk,mistweaver,90,51,39
Dokternelg,silvermoon,1612,monk,mistweaver,30,20,10
Sart,aerie-peak,1612,monk,mistweaver,42,22,20
Jayber,laughing-skull,1611,monk,mistweaver,36,22,14
Kåýðø,archimonde,1610,monk,mistweaver,72,42,30
Ryx,twisting-nether,1610,monk,mistweaver,43,21,22
Kitingbuddha,aegwynn,1609,monk,mistweaver,114,62,52
Chiuna,sylvanas,1608,monk,mistweaver,36,20,16
Ignygodx,ragnaros,1608,monk,mistweaver,35,19,16
Òó,vashj,1608,monk,mistweaver,48,24,24
Perelman,burning-legion,1607,monk,mistweaver,39,19,20
Vanoarabidze,ravencrest,1607,monk,mistweaver,54,25,29
Ulns,blackrock,1607,monk,mistweaver,60,25,35
Rogvi,argent-dawn,1605,monk,mistweaver,132,59,73
Igozoom,draenor,1604,monk,mistweaver,36,29,7
Mushush,draenor,1604,monk,mistweaver,40,25,15
Riendy,silvermoon,1604,monk,mistweaver,164,92,72
Hokespokus,silvermoon,1603,monk,mistweaver,53,31,22
Xurf,draenor,1602,monk,mistweaver,30,22,8
Räyh,outland,1602,monk,mistweaver,57,31,26
Kukn,twisting-nether,1602,monk,mistweaver,51,23,28
Zýru,ragnaros,1601,monk,mistweaver,65,38,27
Yörg,eredar,1600,monk,mistweaver,51,30,21
Snookzlol,aegwynn,1600,monk,mistweaver,65,38,27
Hardi,chamber-of-aspects,1597,monk,mistweaver,90,44,46
Бладмонки,soulflayer,1596,monk,mistweaver,36,22,14
Dicedkiwi,quelthalas,1596,monk,mistweaver,149,85,64
Факенщет,soulflayer,1596,monk,mistweaver,36,20,16
Enoffovicz,archimonde,1595,monk,mistweaver,30,21,9
Marqinio,archimonde,1594,monk,mistweaver,36,19,17
Hamsster,ravencrest,1594,monk,mistweaver,78,38,40
Brewstea,kazzak,1594,monk,mistweaver,66,29,37
Chàrràth,blackmoore,1593,monk,mistweaver,121,62,59
Crymonkya,aegwynn,1592,monk,mistweaver,102,61,41
Crôcøpx,blackhand,1592,monk,mistweaver,36,19,17
Yäffa,archimonde,1591,monk,mistweaver,78,37,41
Elmonkodonko,draenor,1590,monk,mistweaver,30,17,13
Brüderlichke,elune,1590,monk,mistweaver,42,19,23
Zenfir,sylvanas,1587,monk,mistweaver,68,43,25
Вдыхайтуман,gordunni,1585,monk,mistweaver,90,51,39
Çz,tarren-mill,1585,monk,mistweaver,30,17,13
Слишкомхорош,thermaplugg,1580,monk,mistweaver,23,17,6
Melamonk,ravencrest,1575,monk,mistweaver,144,74,70
Belärus,outland,1573,monk,mistweaver,36,19,17
Plebmonkx,frostmane,1571,monk,mistweaver,137,73,64
ßojo,kazzak,1570,monk,mistweaver,51,35,16
Warsox,aegwynn,1570,monk,mistweaver,48,26,22
Diffenbachia,outland,1569,monk,mistweaver,51,36,15
Namelessmist,drakthul,1569,monk,mistweaver,42,26,16
Неэверида,deepholm,1569,monk,mistweaver,126,72,54
Orgasmix,tarren-mill,1569,monk,mistweaver,42,21,21
Gronoz,drakthul,1562,monk,mistweaver,66,43,23
Smâsh,blackhand,1561,monk,mistweaver,58,39,19
Pamtu,dun-modr,1561,monk,mistweaver,48,28,20
Yukimøn,hyjal,1560,monk,mistweaver,48,37,11
Bitbird,zirkel-des-cenarius,1557,monk,mistweaver,42,25,17
Rzi,amanthul,1555,monk,mistweaver,143,80,63
Монккд,gordunni,1555,monk,mistweaver,153,85,68
Sindresa,outland,1553,monk,mistweaver,48,25,23
Taìka,archimonde,1546,monk,mistweaver,27,17,10
Prettysus,silvermoon,1546,monk,mistweaver,66,41,25
Macpunchy,defias-brotherhood,1545,monk,mistweaver,30,18,12
Авентусс,howling-fjord,1544,monk,mistweaver,30,22,8
Fìstpwnjk,forscherliga,1542,monk,mistweaver,56,38,18
Тевикс,gordunni,1542,monk,mistweaver,60,30,30
Kapitan,sanguino,1539,monk,mistweaver,63,39,24
Самадайка,howling-fjord,1539,monk,mistweaver,128,69,59
Endorrphine,ravencrest,1538,monk,mistweaver,80,35,45
Ticktak,archimonde,1536,monk,mistweaver,50,36,14
Фуфинус,gordunni,1535,monk,mistweaver,36,16,20
Pembi,blades-edge,1534,monk,mistweaver,80,39,41
Vitnam,auchindoun,1533,monk,mistweaver,84,51,33
Ashenore,outland,1533,monk,mistweaver,42,17,25
Xaíris,blackrock,1529,monk,mistweaver,32,16,16
Hôn,sanguino,1528,monk,mistweaver,23,17,6
Mistbringer,kazzak,1528,monk,mistweaver,244,130,114
Freyas,outland,1527,monk,mistweaver,53,29,24
Shkorwi,drakthul,1525,monk,mistweaver,30,17,13
Musashiden,twisting-nether,1525,monk,mistweaver,42,23,19
Rhatid,twisting-nether,1525,monk,mistweaver,54,28,26
Wernos,archimonde,1523,monk,mistweaver,30,16,14
Fatskeleton,stormreaver,1523,monk,mistweaver,421,197,224
Hollymêdx,blackmoore,1521,monk,mistweaver,37,22,15
Plaguer,nordrassil,1519,monk,mistweaver,30,18,12
Kæmará,blackrock,1519,monk,mistweaver,30,16,14
Dmonk,alakir,1517,monk,mistweaver,72,34,38
Misthera,burning-legion,1517,monk,mistweaver,72,32,40
Mistïnguette,dalaran,1516,monk,mistweaver,90,55,35
Genjosanso,kazzak,1515,monk,mistweaver,119,71,48
Sobadzlolz,alexstrasza,1515,monk,mistweaver,60,28,32
Visk,blackmoore,1514,monk,mistweaver,60,36,24
Patiencebro,archimonde,1514,monk,mistweaver,36,16,20
Notfist,kazzak,1513,monk,mistweaver,54,35,19
Xiaokingqvq,silvermoon,1512,monk,mistweaver,78,41,37
Германика,soulflayer,1511,monk,mistweaver,86,43,43
Loddarita,ravencrest,1510,monk,mistweaver,36,28,8
Medovic,blackmoore,1510,monk,mistweaver,156,89,67
Idrdob,kazzak,1510,monk,mistweaver,87,49,38
Encanthar,blackhand,1508,monk,mistweaver,219,116,103
Urbàs,blackmoore,1507,monk,mistweaver,36,25,11
Zeldrís,ragnaros,1505,monk,mistweaver,57,27,30
Spoompls,argent-dawn,1505,monk,mistweaver,54,24,30
Gravityfist,aegwynn,1503,monk,mistweaver,36,18,18
Mankee,kazzak,1503,monk,mistweaver,32,16,16
Caniluvz,eredar,1501,monk,mistweaver,24,16,8
Гачитварина,galakrond,1499,monk,mistweaver,24,16,8
Njursten,twilights-hammer,1496,monk,mistweaver,189,94,95
Setup,thrall,1495,monk,mistweaver,147,81,66
Heramonk,dun-modr,1495,monk,mistweaver,34,17,17
Miînd,tarren-mill,1494,monk,mistweaver,48,29,19
Monkzdino,destromath,1494,monk,mistweaver,47,24,23
Eckø,rashgarroth,1489,monk,mistweaver,36,24,12
Thuz,kazzak,1488,monk,mistweaver,63,34,29
Moveietss,stormscale,1485,monk,mistweaver,18,16,2
Bóber,kazzak,1485,monk,mistweaver,42,22,20
Waitaminute,outland,1484,monk,mistweaver,96,58,38
Sneezao,ravencrest,1484,monk,mistweaver,150,82,68
Fungku,azjolnerub,1483,monk,mistweaver,187,95,92
Théverre,uldaman,1482,monk,mistweaver,102,61,41
Leblatt,blackhand,1481,monk,mistweaver,36,24,12
Incapme,outland,1479,monk,mistweaver,85,51,34
Vooxis,drakthul,1479,monk,mistweaver,30,17,13
Okdontnerf,kazzak,1478,monk,mistweaver,72,35,37
Kreynich,blackhand,1477,monk,mistweaver,36,25,11
Dìó,tarren-mill,1477,monk,mistweaver,210,117,93
Pikemi,dun-modr,1477,monk,mistweaver,36,17,19
Lukeybabyy,defias-brotherhood,1476,monk,mistweaver,30,20,10
Влажныйтач,soulflayer,1475,monk,mistweaver,30,19,11
Benenutz,archimonde,1474,monk,mistweaver,30,23,7
Grauwe,stormscale,1474,monk,mistweaver,27,17,10
Quezatrix,ravencrest,1473,monk,mistweaver,132,69,63
Амаззонния,soulflayer,1469,monk,mistweaver,90,41,49
Moistweaver,hellfire,1468,monk,mistweaver,84,44,40
Zenified,ragnaros,1468,monk,mistweaver,82,40,42
Zinnout,twisting-nether,1467,monk,mistweaver,36,26,10
Leôlulu,blackmoore,1465,monk,mistweaver,30,23,7
Saitamä,archimonde,1464,monk,mistweaver,68,27,41
Orkiya,archimonde,1463,monk,mistweaver,270,141,129
Psychocop,drakthul,1462,monk,mistweaver,77,37,40
Pøwcow,blackrock,1459,monk,mistweaver,113,61,52
Noni,gorgonnash,1459,monk,mistweaver,65,31,34
Endir,mazrigos,1458,monk,mistweaver,30,19,11
Mîstxd,kazzak,1457,monk,mistweaver,23,16,7
Monkgd,sylvanas,1457,monk,mistweaver,126,73,53
Timmyßênz,kaelthas,1456,monk,mistweaver,42,26,16
Heartless,sporeggar,1448,monk,mistweaver,36,28,8
Suggy,kilrogg,1447,monk,mistweaver,36,20,16
Civix,sanguino,1443,monk,mistweaver,98,57,41
Shiguru,dun-morogh,1441,monk,mistweaver,59,35,24
Фунтих,soulflayer,1439,monk,mistweaver,18,15,3
Vienuolè,silvermoon,1439,monk,mistweaver,24,15,9
Demakis,stormscale,1439,monk,mistweaver,47,29,18
Acidflexx,kazzak,1437,monk,mistweaver,24,16,8
Zukatan,tarren-mill,1436,monk,mistweaver,75,40,35
Cbmonk,sylvanas,1435,monk,mistweaver,30,21,9
Chikokon,silvermoon,1435,monk,mistweaver,43,28,15
Kungfupandy,blackmoore,1435,monk,mistweaver,145,84,61
Подвижник,soulflayer,1434,monk,mistweaver,24,15,9
Lanory,blackmoore,1433,monk,mistweaver,24,15,9
Tokz,ravencrest,1430,monk,mistweaver,30,19,11
Fisterinos,blackrock,1430,monk,mistweaver,48,30,18
Nievah,argent-dawn,1430,monk,mistweaver,39,24,15
Malkaviano,kazzak,1430,monk,mistweaver,80,46,34
Puddinpop,auchindoun,1427,monk,mistweaver,61,29,32
Linshai,eredar,1423,monk,mistweaver,24,15,9
Evâ,stormscale,1423,monk,mistweaver,24,15,9
Yarie,blackmoore,1423,monk,mistweaver,78,39,39
Ðurîmar,ravencrest,1420,monk,mistweaver,27,16,11
Xianxiaa,ravencrest,1420,monk,mistweaver,88,51,37
Индоран,howling-fjord,1419,monk,mistweaver,48,33,15
Lacasyto,sanguino,1417,monk,mistweaver,18,15,3
Elity,archimonde,1416,monk,mistweaver,34,26,8
Yotke,ravencrest,1416,monk,mistweaver,24,15,9
Slugerpigen,stormscale,1416,monk,mistweaver,113,65,48
Calmpalms,tarren-mill,1416,monk,mistweaver,51,25,26
Biftas,nagrand,1415,monk,mistweaver,27,16,11
Mistsen,kazzak,1414,monk,mistweaver,81,47,34
Zenzu,blackmoore,1411,monk,mistweaver,30,20,10
Фапдао,howling-fjord,1410,monk,mistweaver,56,27,29
Applestrûdel,blackrock,1406,monk,mistweaver,39,23,16
Bambøuéqtz,khaz-modan,1404,monk,mistweaver,24,17,7
Freemann,archimonde,1404,monk,mistweaver,189,102,87
Pandacus,silvermoon,1401,monk,mistweaver,78,35,43
Kroyus,antonidas,1399,monk,mistweaver,114,58,56
Farmander,silvermoon,1394,monk,mistweaver,85,51,34
Woushou,outland,1393,monk,mistweaver,54,33,21
Popcornn,archimonde,1389,monk,mistweaver,54,29,25
Haxxo,die-nachtwache,1387,monk,mistweaver,32,22,10
Badcøwboy,archimonde,1387,monk,mistweaver,122,54,68
Rymz,sanguino,1385,monk,mistweaver,85,50,35
Scare,stormreaver,1384,monk,mistweaver,43,23,20
Pundok,blackrock,1383,monk,mistweaver,59,34,25
Umagon,chogall,1383,monk,mistweaver,60,29,31
Nirexi,blackrock,1381,monk,mistweaver,39,16,23
Allosthenos,ravencrest,1379,monk,mistweaver,27,18,9
Kruemelkeks,frostwolf,1378,monk,mistweaver,57,33,24
Vivir,stormreaver,1377,monk,mistweaver,91,50,41
Onlyvegan,ravencrest,1375,monk,mistweaver,28,16,12
Тучковский,lich-king,1373,monk,mistweaver,24,15,9
Faa,archimonde,1367,monk,mistweaver,23,17,6
Beaglemo,blackrock,1366,monk,mistweaver,35,15,20
Мирюзаки,gordunni,1358,monk,mistweaver,34,19,15
Brêwjob,archimonde,1356,monk,mistweaver,34,20,14
Thayne,blades-edge,1354,monk,mistweaver,30,15,15
Romk,darkspear,1352,monk,mistweaver,36,25,11
Патаомальчик,blackscar,1352,monk,mistweaver,35,15,20
Mestro,argent-dawn,1348,monk,mistweaver,124,74,50
Quendi,arthas,1348,monk,mistweaver,149,78,71
Coollann,drakthul,1347,monk,mistweaver,30,15,15
Déffly,ravencrest,1343,monk,mistweaver,18,14,4
Akuuji,silvermoon,1342,monk,mistweaver,24,14,10
Zagar,emeriss,1342,monk,mistweaver,24,14,10
Trifogeorge,archimonde,1342,monk,mistweaver,24,14,10
Ultrasense,outland,1342,monk,mistweaver,24,14,10
Lmnsx,ravencrest,1342,monk,mistweaver,24,14,10
Ipmonk,outland,1341,monk,mistweaver,18,14,4
Dudulinda,silvermoon,1341,monk,mistweaver,66,32,34
Tyzin,blackrock,1340,monk,mistweaver,30,17,13
Shiftkin,stormscale,1339,monk,mistweaver,30,14,16
Cybert,blackmoore,1339,monk,mistweaver,35,15,20
Jeññie,stormscale,1337,monk,mistweaver,18,14,4
Teacup,aegwynn,1337,monk,mistweaver,48,32,16
Aseidith,tarren-mill,1337,monk,mistweaver,24,14,10
Kaàli,pozzo-delleternità,1337,monk,mistweaver,24,14,10
Gigilonis,korgall,1337,monk,mistweaver,115,59,56
Rocknreroll,executus,1336,monk,mistweaver,30,14,16
Løsang,blackrock,1335,monk,mistweaver,86,56,30
Shokko,uldaman,1334,monk,mistweaver,24,14,10
Boomboôom,outland,1332,monk,mistweaver,24,14,10
Fistingfury,burning-blade,1332,monk,mistweaver,72,32,40
Xarêlla,aegwynn,1332,monk,mistweaver,36,14,22
Caskgut,ravencrest,1330,monk,mistweaver,48,29,19
Dumplings,earthen-ring,1329,monk,mistweaver,30,16,14
Sajin,la-croisade-écarlate,1329,monk,mistweaver,36,15,21
Ohmegah,frostmane,1327,monk,mistweaver,18,14,4
Zenmastêr,twisting-nether,1327,monk,mistweaver,69,37,32
Vladikus,tarren-mill,1323,monk,mistweaver,75,35,40
Krylin,antonidas,1322,monk,mistweaver,93,45,48
Kwacisawhe,die-aldor,1321,monk,mistweaver,51,21,30
Akalaja,alakir,1316,monk,mistweaver,34,19,15
Musslee,elune,1316,monk,mistweaver,42,15,27
Bluum,ravencrest,1315,monk,mistweaver,42,19,23
Thegrudge,dragonblight,1315,monk,mistweaver,42,16,26
Bruceflea,blackrock,1313,monk,mistweaver,150,82,68
Shreckmonk,burning-blade,1313,monk,mistweaver,30,14,16
Brewswíllis,tarren-mill,1312,monk,mistweaver,18,14,4
Gråce,nemesis,1312,monk,mistweaver,30,20,10
Moohamood,argent-dawn,1311,monk,mistweaver,36,14,22
Loreo,burning-legion,1310,monk,mistweaver,81,48,33
Onlyfísts,stormscale,1304,monk,mistweaver,48,16,32
Тадоичи,soulflayer,1299,monk,mistweaver,24,14,10
Vetocorleone,kazzak,1299,monk,mistweaver,123,64,59
Джоский,borean-tundra,1299,monk,mistweaver,60,23,37
Камикадзэн,gordunni,1296,monk,mistweaver,24,15,9
Pandimaci,ragnaros,1295,monk,mistweaver,47,27,20
Zenmist,kazzak,1294,monk,mistweaver,23,14,9
Guthäxlul,khazgoroth,1294,monk,mistweaver,144,75,69
Blamethegame,hyjal,1293,monk,mistweaver,17,14,3
Хэйхати,gordunni,1289,monk,mistweaver,53,26,27
Mareki,nethersturm,1288,monk,mistweaver,38,19,19
Carnat,blackrock,1284,monk,mistweaver,30,17,13
Trivi,blackrock,1284,monk,mistweaver,45,24,21
Drboombay,kazzak,1283,monk,mistweaver,38,21,17
Ðëvx,argent-dawn,1281,monk,mistweaver,84,45,39
Numpys,sanguino,1277,monk,mistweaver,29,14,15
Schaulong,blackmoore,1274,monk,mistweaver,42,20,22
Kushvendorx,silvermoon,1273,monk,mistweaver,29,14,15
Ugras,auchindoun,1273,monk,mistweaver,36,14,22
Yeetkunmeep,outland,1272,monk,mistweaver,48,23,25
Oddessa,ravenholdt,1270,monk,mistweaver,84,42,42
Mishax,draenor,1268,monk,mistweaver,78,38,40
Boredom,wildhammer,1266,monk,mistweaver,60,35,25
Szilvia,sylvanas,1263,monk,mistweaver,48,25,23
Evelios,blackmoore,1262,monk,mistweaver,41,23,18
Nîcko,ravencrest,1259,monk,mistweaver,24,14,10
Macgyverr,outland,1258,monk,mistweaver,24,14,10
Лалафест,soulflayer,1258,monk,mistweaver,28,14,14
Chígoku,grim-batol,1257,monk,mistweaver,52,23,29
Vanquishlølz,archimonde,1255,monk,mistweaver,45,21,24
Трикленд,azuregos,1254,monk,mistweaver,30,15,15
Yahní,eredar,1253,monk,mistweaver,47,24,23
Putrezitu,ragnaros,1252,monk,mistweaver,27,17,10
Namitsa,trollbane,1250,monk,mistweaver,30,16,14
Bleja,blackhand,1249,monk,mistweaver,28,15,13
Sheishot,kazzak,1249,monk,mistweaver,31,15,16
Supaverli,archimonde,1248,monk,mistweaver,18,13,5
Angeryw,kazzak,1248,monk,mistweaver,18,13,5
Jackål,silvermoon,1247,monk,mistweaver,21,14,7
Sonydl,archimonde,1247,monk,mistweaver,22,14,8
Loiythree,dun-modr,1247,monk,mistweaver,30,13,17
Natsuø,nemesis,1246,monk,mistweaver,18,13,5
Xdhehehexd,twisting-nether,1246,monk,mistweaver,18,13,5
Йуппи,galakrond,1246,monk,mistweaver,24,13,11
Nesthorian,draenor,1246,monk,mistweaver,123,61,62
Papimonkx,garona,1246,monk,mistweaver,30,13,17
Репабликус,gordunni,1246,monk,mistweaver,30,13,17
Yèna,pozzo-delleternità,1245,monk,mistweaver,60,24,36
Ana,eredar,1244,monk,mistweaver,24,13,11
Toon,eredar,1244,monk,mistweaver,86,41,45
Кубермонкер,gordunni,1243,monk,mistweaver,24,13,11
Nìkâ,blackmoore,1243,monk,mistweaver,57,29,28
Bigmckoy,kazzak,1242,monk,mistweaver,21,14,7
Mmrkick,kazzak,1241,monk,mistweaver,24,13,11
Ouaipäül,archimonde,1241,monk,mistweaver,24,13,11
Chibuku,burning-legion,1240,monk,mistweaver,24,13,11
Kayen,frostwhisper,1238,monk,mistweaver,46,23,23
Baddany,sanguino,1238,monk,mistweaver,54,26,28
Bigballs,ysera,1236,monk,mistweaver,30,13,17
Marrave,chogall,1236,monk,mistweaver,63,22,41
Drpajhiwo,burning-legion,1234,monk,mistweaver,52,30,22
Maiver,stormscale,1230,monk,mistweaver,24,14,10
Chainster,defias-brotherhood,1229,monk,mistweaver,70,35,35
Panicfist,stormscale,1227,monk,mistweaver,27,13,14
Windspiritt,ragnaros,1227,monk,mistweaver,30,13,17
Boomshaq,defias-brotherhood,1226,monk,mistweaver,30,14,16
Tsifsakari,silvermoon,1222,monk,mistweaver,36,13,23
Xplosiv,twisting-nether,1220,monk,mistweaver,18,13,5
Wteg,emerald-dream,1220,monk,mistweaver,30,14,16
Mondrim,burning-legion,1218,monk,mistweaver,40,16,24
Jetchi,twisting-nether,1215,monk,mistweaver,72,43,29
Galaxyfist,ragnaros,1215,monk,mistweaver,48,25,23
Makïi,archimonde,1214,monk,mistweaver,45,25,20
Fistus,dentarg,1214,monk,mistweaver,29,13,16
Bhasundara,turalyon,1212,monk,mistweaver,88,51,37
Monkehst,dun-modr,1210,monk,mistweaver,60,25,35
Badonkamonk,twilights-hammer,1209,monk,mistweaver,42,26,16
Salsina,nemesis,1208,monk,mistweaver,102,54,48
Mofisto,bladefist,1208,monk,mistweaver,60,29,31
Ivi,neptulon,1197,monk,mistweaver,58,29,29
Larå,ravencrest,1190,monk,mistweaver,119,55,64
Ksll,silvermoon,1189,monk,mistweaver,36,17,19
Fulgrem,stormscale,1188,monk,mistweaver,27,15,12
Phrynè,silvermoon,1182,monk,mistweaver,31,16,15
Torqualis,kazzak,1181,monk,mistweaver,96,45,51
Carloz,drakthul,1174,monk,mistweaver,30,16,14
Stolas,spinebreaker,1172,monk,mistweaver,24,14,10
Fistweavr,antonidas,1171,monk,mistweaver,36,14,22
Nevelbeast,rexxar,1169,monk,mistweaver,51,27,24
Boozmoo,stormscale,1166,monk,mistweaver,22,16,6
Brewzleè,ravencrest,1165,monk,mistweaver,34,14,20
Xwtdreamz,hyjal,1156,monk,mistweaver,36,14,22
Yuuhai,ravencrest,1152,monk,mistweaver,18,12,6
Swoshz,ragnaros,1152,monk,mistweaver,24,12,12
Кодизи,gordunni,1151,monk,mistweaver,18,12,6
Shixen,ragnaros,1151,monk,mistweaver,24,12,12
Phyxone,twisting-nether,1151,monk,mistweaver,24,12,12
Monkeycoke,ragnaros,1151,monk,mistweaver,24,12,12
Lildaddymonk,ravencrest,1151,monk,mistweaver,30,12,18
Zesha,zuljin,1151,monk,mistweaver,30,12,18
Xado,aegwynn,1150,monk,mistweaver,18,12,6
Нунтяк,gordunni,1150,monk,mistweaver,24,12,12
Cubw,archimonde,1148,monk,mistweaver,24,12,12
Aryphus,blackmoore,1148,monk,mistweaver,24,12,12
Tokkz,eredar,1143,monk,mistweaver,16,13,3
Tintatama,aszune,1143,monk,mistweaver,82,36,46
Shiftchenko,stormscale,1142,monk,mistweaver,42,24,18
Cicera,kazzak,1138,monk,mistweaver,30,12,18
Syyrø,silvermoon,1137,monk,mistweaver,36,12,24
Lubeï,kirin-tor,1131,monk,mistweaver,34,21,13
Graffy,eonar,1130,monk,mistweaver,24,16,8
Sydras,silvermoon,1130,monk,mistweaver,128,63,65
Bensó,stormscale,1129,monk,mistweaver,18,15,3
Tripitakâ,dun-modr,1120,monk,mistweaver,35,13,22
Лабирончик,blackscar,1119,monk,mistweaver,16,13,3
Trnd,draenor,1119,monk,mistweaver,41,15,26
Jumper,xavius,1118,monk,mistweaver,24,12,12
Akiiro,aegwynn,1118,monk,mistweaver,36,15,21
Cudworth,silvermoon,1116,monk,mistweaver,18,14,4
Assfist,drakthul,1116,monk,mistweaver,84,49,35
Worf,haomarush,1116,monk,mistweaver,24,13,11
Tsouli,twilights-hammer,1116,monk,mistweaver,24,12,12
Friartucker,bloodhoof,1114,monk,mistweaver,33,22,11
Zøubida,draenor,1111,monk,mistweaver,24,12,12
Bullbøx,chamber-of-aspects,1100,monk,mistweaver,27,12,15
Ляосинь,deepholm,1099,monk,mistweaver,24,12,12
Alphafist,argent-dawn,1093,monk,mistweaver,24,12,12
Carcasce,la-croisade-écarlate,1089,monk,mistweaver,36,20,16
Enceladion,burning-legion,1089,monk,mistweaver,42,19,23
Loctak,nathrezim,1075,monk,mistweaver,54,38,16
Hvnm,ravencrest,1073,monk,mistweaver,54,27,27
Saneshayne,ravencrest,1071,monk,mistweaver,17,12,5
Wangho,magtheridon,1067,monk,mistweaver,42,16,26
Benzzy,ragnaros,1064,monk,mistweaver,19,12,7
Bobbyknuckls,ravencrest,1064,monk,mistweaver,54,17,37
Brünó,kazzak,1061,monk,mistweaver,39,26,13
Loiyah,dun-modr,1056,monk,mistweaver,18,11,7
Snówtea,silvermoon,1056,monk,mistweaver,18,11,7
Precocconx,stormreaver,1056,monk,mistweaver,18,11,7
Öhlinmonk,outland,1056,monk,mistweaver,18,11,7
Izuwumi,ragnaros,1056,monk,mistweaver,18,11,7
Vöyage,kazzak,1056,monk,mistweaver,18,11,7
Ffxivrefugee,argent-dawn,1056,monk,mistweaver,24,11,13
Darkmonkky,tarren-mill,1056,monk,mistweaver,24,11,13
Kakor,gorgonnash,1055,monk,mistweaver,18,11,7
Darlaa,ravencrest,1055,monk,mistweaver,18,11,7
Clemoine,archimonde,1055,monk,mistweaver,18,11,7
Cochonhalall,archimonde,1055,monk,mistweaver,24,11,13
Polch,archimonde,1055,monk,mistweaver,24,11,13
Almonkdiga,sanguino,1055,monk,mistweaver,24,11,13
Jakethestake,twilights-hammer,1054,monk,mistweaver,12,11,1
Hærleyquin,ravencrest,1054,monk,mistweaver,18,11,7
Irêfutabil,sylvanas,1054,monk,mistweaver,18,11,7
Neehl,aegwynn,1054,monk,mistweaver,18,11,7
Lanvia,argent-dawn,1054,monk,mistweaver,18,11,7
Pitit,outland,1054,monk,mistweaver,36,11,25
Shàká,stormscale,1052,monk,mistweaver,12,11,1
Pepesmacks,kazzak,1052,monk,mistweaver,18,11,7
Basthek,blackhand,1052,monk,mistweaver,30,11,19
Lambofmonkz,stormscale,1052,monk,mistweaver,36,11,25
Dachilla,gilneas,1051,monk,mistweaver,22,12,10
Campix,blackmoore,1051,monk,mistweaver,24,11,13
Eynodiggity,blackmoore,1050,monk,mistweaver,24,11,13
Brewmâster,kazzak,1050,monk,mistweaver,24,11,13
Sandrafarm,ragnaros,1049,monk,mistweaver,30,19,11
Shiesel,draenor,1048,monk,mistweaver,24,11,13
Fisticuffs,tarren-mill,1048,monk,mistweaver,24,11,13
Mjaweaver,stormscale,1046,monk,mistweaver,62,23,39
Irphan,ravencrest,1042,monk,mistweaver,18,11,7
Ívó,ragnaros,1039,monk,mistweaver,24,11,13
Monkypunch,tarren-mill,1039,monk,mistweaver,28,12,16
Kungfubatti,stormscale,1034,monk,mistweaver,24,11,13
Mcronald,blackhand,1031,monk,mistweaver,46,23,23
Dèathpunch,doomhammer,1025,monk,mistweaver,54,26,28
Ugotcraned,tarren-mill,1019,monk,mistweaver,72,27,45
Birdymonk,boulderfist,1009,monk,mistweaver,36,22,14
Dipdop,blackhand,1008,monk,mistweaver,45,18,27
Mwmkgodxz,archimonde,1007,monk,mistweaver,15,12,3
Celestine,mugthol,1002,monk,mistweaver,60,28,32
Апесиинка,gordunni,1002,monk,mistweaver,24,11,13
Zenchî,ysondre,1001,monk,mistweaver,22,13,9
Fatcarry,blackrock,1001,monk,mistweaver,35,12,23
Lucebree,nozdormu,999,monk,mistweaver,48,18,30
Kégman,silvermoon,992,monk,mistweaver,33,18,15
Heäléna,ragnaros,979,monk,mistweaver,21,15,6
Лолидевочка,soulflayer,973,monk,mistweaver,37,11,26
Äcé,sylvanas,972,monk,mistweaver,25,11,14
Keeba,kirin-tor,967,monk,mistweaver,149,70,79
Suchergebnis,tarren-mill,964,monk,mistweaver,66,23,43
Habmit,ravencrest,960,monk,mistweaver,12,10,2
Kz,culte-de-la-rive-noire,960,monk,mistweaver,12,10,2
Glaphan,the-maelstrom,960,monk,mistweaver,12,10,2
Dihsa,ragnaros,960,monk,mistweaver,12,10,2
Chisurgeon,outland,960,monk,mistweaver,18,10,8
Ofwgkta,moonglade,960,monk,mistweaver,18,10,8
Féfè,archimonde,960,monk,mistweaver,24,10,14
Xoleck,aegwynn,960,monk,mistweaver,24,10,14
Citamonk,blackmoore,959,monk,mistweaver,12,10,2
Steveé,kazzak,959,monk,mistweaver,12,10,2
Mimimatrick,hyjal,959,monk,mistweaver,12,10,2
Xadoqt,aegwynn,959,monk,mistweaver,18,10,8
Zlodey,laughing-skull,959,monk,mistweaver,18,10,8
Såvonnette,ysondre,959,monk,mistweaver,18,10,8
Mâjô,blackhand,959,monk,mistweaver,18,10,8
Erapanzon,nemesis,959,monk,mistweaver,18,10,8
Coularx,stormscale,959,monk,mistweaver,18,10,8
Kickin,burning-legion,959,monk,mistweaver,18,10,8
Минимонахх,blackscar,959,monk,mistweaver,18,10,8
Якунка,soulflayer,959,monk,mistweaver,24,10,14
Stanimirov,outland,959,monk,mistweaver,24,10,14
Zappikmonk,silvermoon,958,monk,mistweaver,12,10,2
Doingmaster,blackrock,958,monk,mistweaver,18,10,8
Fettakules,eredar,958,monk,mistweaver,18,10,8
Oregan,conseil-des-ombres,958,monk,mistweaver,18,10,8
Yuyuni,laughing-skull,958,monk,mistweaver,18,10,8
Búns,draenor,958,monk,mistweaver,18,10,8
Уиннии,soulflayer,958,monk,mistweaver,18,10,8
Imamonk,tarren-mill,957,monk,mistweaver,24,10,14
Erenaar,nemesis,956,monk,mistweaver,12,10,2
Rheinair,antonidas,956,monk,mistweaver,24,10,14
Bruceliam,emerald-dream,955,monk,mistweaver,24,10,14
Йомо,borean-tundra,954,monk,mistweaver,30,10,20
Amélith,kirin-tor,953,monk,mistweaver,18,10,8
Tojokirumi,dalaran,951,monk,mistweaver,12,10,2
Monkyd,stormscale,950,monk,mistweaver,18,10,8
Ariä,marécage-de-zangar,930,monk,mistweaver,24,13,11
Venac,burning-legion,914,monk,mistweaver,14,12,2
Dícxi,ravencrest,910,monk,mistweaver,17,10,7
Myfresh,ysondre,910,monk,mistweaver,26,11,15
Behrens,defias-brotherhood,905,monk,mistweaver,21,11,10
Maikez,stormreaver,896,monk,mistweaver,28,10,18
Indris,dun-modr,895,monk,mistweaver,17,10,7
Changzu,sanguino,894,monk,mistweaver,30,15,15
Kelechi,stormreaver,894,monk,mistweaver,20,10,10
Мишапяточка,howling-fjord,890,monk,mistweaver,12,11,1
Eclipsè,dragonmaw,889,monk,mistweaver,17,10,7
Rokux,kazzak,880,monk,mistweaver,19,10,9
Тиктокмонк,gordunni,877,monk,mistweaver,20,11,9
Mikemanmonk,ravencrest,864,monk,mistweaver,12,9,3
Djsnake,blackrock,864,monk,mistweaver,12,9,3
Remyhadley,dun-modr,864,monk,mistweaver,12,9,3
Iixil,sylvanas,864,monk,mistweaver,12,9,3
Kebabrolle,blackrock,864,monk,mistweaver,18,9,9
Zóma,ragnaros,864,monk,mistweaver,18,9,9
Jiest,outland,864,monk,mistweaver,18,9,9
Monkasape,nemesis,864,monk,mistweaver,18,9,9
Kaguræ,hyjal,864,monk,mistweaver,18,9,9
Balia,blackrock,864,monk,mistweaver,24,9,15
Pô,sanguino,863,monk,mistweaver,12,9,3
Schane,zuluhed,863,monk,mistweaver,12,9,3
Shabaz,draenor,863,monk,mistweaver,12,9,3
Simonex,ravencrest,863,monk,mistweaver,12,9,3
Monkwithlove,blackhand,863,monk,mistweaver,18,9,9
Nimander,burning-legion,863,monk,mistweaver,18,9,9
Kattlåda,darkspear,863,monk,mistweaver,18,9,9
Kyleestrutt,stormscale,863,monk,mistweaver,18,9,9
Niborc,doomhammer,862,monk,mistweaver,12,9,3
Beerbringer,kazzak,862,monk,mistweaver,12,9,3
Inear,chogall,862,monk,mistweaver,18,9,9
Konexzx,blackmoore,861,monk,mistweaver,12,9,3
Mwsama,stormscale,861,monk,mistweaver,12,9,3
Koldar,grim-batol,861,monk,mistweaver,17,12,5
Mistréss,silvermoon,858,monk,mistweaver,18,9,9
Ronanze,silvermoon,858,monk,mistweaver,30,14,16
Herdom,blackmoore,856,monk,mistweaver,12,9,3
Arathos,tichondrius,852,monk,mistweaver,12,9,3
Blackmonk,chromaggus,852,monk,mistweaver,18,9,9
Liwong,antonidas,850,monk,mistweaver,12,9,3
ßæutiful,silvermoon,835,monk,mistweaver,30,13,17
Melysà,antonidas,815,monk,mistweaver,17,9,8
Akkadianx,ravencrest,814,monk,mistweaver,23,9,14
Tèam,defias-brotherhood,810,monk,mistweaver,15,9,6
Extaszeh,turalyon,802,monk,mistweaver,17,11,6
Nyrkkiseski,outland,799,monk,mistweaver,11,9,2
Nawak,archimonde,768,monk,mistweaver,12,8,4
Ciridely,thrall,768,monk,mistweaver,12,8,4
Fckisrael,archimonde,768,monk,mistweaver,12,8,4
Гуппер,howling-fjord,768,monk,mistweaver,12,8,4
Mástermônkèy,tarren-mill,768,monk,mistweaver,12,8,4
Wisebeb,les-clairvoyants,768,monk,mistweaver,12,8,4
Kradder,nordrassil,768,monk,mistweaver,12,8,4
Hurjat,stormreaver,768,monk,mistweaver,12,8,4
Ikuyaa,ravencrest,768,monk,mistweaver,12,8,4
Shyrea,nazjatar,768,monk,mistweaver,12,8,4
Jiuhjitsu,blackmoore,768,monk,mistweaver,12,8,4
Adrianchase,ravencrest,768,monk,mistweaver,12,8,4
Àjay,outland,768,monk,mistweaver,12,8,4
Miamalkøva,nemesis,768,monk,mistweaver,12,8,4
Cattleyah,ysondre,768,monk,mistweaver,12,8,4
Zødiac,quelthalas,768,monk,mistweaver,12,8,4
Brxmonki,antonidas,768,monk,mistweaver,12,8,4
Mvm,outland,768,monk,mistweaver,12,8,4
Brutamonk,blackmoore,768,monk,mistweaver,12,8,4
Rminto,twisting-nether,768,monk,mistweaver,18,8,10
Nillebpgodx,kazzak,768,monk,mistweaver,18,8,10
Ronkingkong,ravencrest,768,monk,mistweaver,18,8,10
Adamlól,tarren-mill,768,monk,mistweaver,18,8,10
Mharlie,stormscale,768,monk,mistweaver,18,8,10
Tøxicweaver,kazzak,768,monk,mistweaver,18,8,10
Blantai,tarren-mill,768,monk,mistweaver,24,8,16
Truelo,eredar,767,monk,mistweaver,12,8,4
Tanyà,hyjal,767,monk,mistweaver,12,8,4
Мистхоррор,gordunni,767,monk,mistweaver,12,8,4
Adzk,tarren-mill,767,monk,mistweaver,12,8,4
Maigraith,malganis,767,monk,mistweaver,12,8,4
Lin,nathrezim,767,monk,mistweaver,12,8,4
Saduh,thrall,767,monk,mistweaver,18,8,10
Luciellie,archimonde,767,monk,mistweaver,18,8,10
Gízmö,tarren-mill,767,monk,mistweaver,18,8,10
Lerouxx,archimonde,767,monk,mistweaver,18,8,10
Qî,ravencrest,767,monk,mistweaver,24,8,16
Snack,mannoroth,766,monk,mistweaver,12,8,4
Nulojeu,archimonde,766,monk,mistweaver,12,8,4
Riip,ysondre,766,monk,mistweaver,12,8,4
Nela,sanguino,766,monk,mistweaver,18,8,10
Astolfochan,silvermoon,766,monk,mistweaver,18,8,10
Gakunie,blackhand,766,monk,mistweaver,18,8,10
Hersmonk,drakthul,765,monk,mistweaver,12,8,4
Lûxz,ragnaros,765,monk,mistweaver,18,8,10
Lilniccí,blackrock,764,monk,mistweaver,12,8,4
Gammelbruno,azshara,763,monk,mistweaver,12,8,4
Pekinn,sanguino,761,monk,mistweaver,18,8,10
Karmasfist,ravencrest,760,monk,mistweaver,12,8,4
Shoshin,stormscale,760,monk,mistweaver,36,17,19
Сукавкимоно,soulflayer,758,monk,mistweaver,18,8,10
Zedruu,tarren-mill,751,monk,mistweaver,18,8,10
Bèfmoka,sargeras,747,monk,mistweaver,120,54,66
Lanuia,aegwynn,720,monk,mistweaver,15,8,7
Ivnatorx,outland,719,monk,mistweaver,11,8,3
Kameltreiba,antonidas,719,monk,mistweaver,17,8,9
Moreløs,stormscale,710,monk,mistweaver,24,10,14
Hidekami,archimonde,702,monk,mistweaver,22,8,14
Oneshotmacro,spinebreaker,672,monk,mistweaver,12,7,5
Dodomino,archimonde,672,monk,mistweaver,12,7,5
Hessuzen,stormreaver,672,monk,mistweaver,12,7,5
Räpeltäjä,stormreaver,672,monk,mistweaver,12,7,5
Capwouk,tarren-mill,672,monk,mistweaver,12,7,5
Bamiegoreng,aegwynn,672,monk,mistweaver,12,7,5
Irønmaxx,die-aldor,672,monk,mistweaver,12,7,5
Mjoo,blackrock,672,monk,mistweaver,12,7,5
Yulon,blackrock,672,monk,mistweaver,12,7,5
Tøwtc,outland,672,monk,mistweaver,12,7,5
Mommymonk,outland,672,monk,mistweaver,12,7,5
Wåñmëíßãøx,sylvanas,672,monk,mistweaver,12,7,5
Mêshuggâh,malganis,672,monk,mistweaver,12,7,5
Flexify,outland,672,monk,mistweaver,12,7,5
Prismaticx,ravencrest,672,monk,mistweaver,12,7,5
Monkel,frostwolf,672,monk,mistweaver,12,7,5
Kbwser,silvermoon,672,monk,mistweaver,12,7,5
Merçury,dun-morogh,672,monk,mistweaver,12,7,5
Bekachu,ragnaros,672,monk,mistweaver,12,7,5
Fugmonk,ravencrest,672,monk,mistweaver,12,7,5
Teamviewer,blackmoore,672,monk,mistweaver,12,7,5
Vingurd,terokkar,672,monk,mistweaver,12,7,5
Frajer,auchindoun,672,monk,mistweaver,12,7,5
Stdzym,tarren-mill,672,monk,mistweaver,18,7,11
Yumhai,dun-modr,672,monk,mistweaver,18,7,11
Leïsha,ysondre,672,monk,mistweaver,18,7,11
Abdulhealer,stormscale,672,monk,mistweaver,18,7,11
Scz,draenor,672,monk,mistweaver,18,7,11
Jagermonk,doomhammer,671,monk,mistweaver,12,7,5
Кисеч,soulflayer,671,monk,mistweaver,12,7,5
Achtal,blackmoore,671,monk,mistweaver,12,7,5
Chigee,kazzak,671,monk,mistweaver,12,7,5
Мистерхюй,gordunni,671,monk,mistweaver,12,7,5
Anadia,blackrock,671,monk,mistweaver,12,7,5
Conguitø,colinas-pardas,671,monk,mistweaver,12,7,5
Fonk,blades-edge,671,monk,mistweaver,12,7,5
Lobnx,kazzak,671,monk,mistweaver,12,7,5
Rebekko,pozzo-delleternità,671,monk,mistweaver,18,7,11
Lazuros,auchindoun,671,monk,mistweaver,18,7,11
Uncleheal,tarren-mill,671,monk,mistweaver,18,7,11
Jarô,silvermoon,671,monk,mistweaver,24,7,17
Zendyy,argent-dawn,670,monk,mistweaver,12,7,5
Ytonie,gorgonnash,670,monk,mistweaver,12,7,5
Monkinamight,turalyon,670,monk,mistweaver,12,7,5
Bréwsléé,ragnaros,670,monk,mistweaver,12,7,5
Rhuru,argent-dawn,670,monk,mistweaver,14,7,7
Loorda,neptulon,669,monk,mistweaver,12,7,5
Zywoo,emerald-dream,668,monk,mistweaver,18,7,11
Fistarfrans,sylvanas,639,monk,mistweaver,8,8,0
Klischi,taerar,639,monk,mistweaver,17,7,10
Chucknorrís,kilrogg,624,monk,mistweaver,15,7,8
Vatsmijter,silvermoon,623,monk,mistweaver,11,7,4
Chìless,shadowsong,576,monk,mistweaver,6,6,0
Lilithrevan,frostmourne,576,monk,mistweaver,6,6,0
Xerzulo,silvermoon,576,monk,mistweaver,6,6,0
Redundänt,kazzak,576,monk,mistweaver,6,6,0
Mowì,stormscale,576,monk,mistweaver,6,6,0
Кувырбек,howling-fjord,576,monk,mistweaver,6,6,0
Chexmonk,silvermoon,576,monk,mistweaver,12,6,6
Åmba,blackrock,576,monk,mistweaver,12,6,6
Xameht,the-maelstrom,576,monk,mistweaver,12,6,6
Musaya,chamber-of-aspects,576,monk,mistweaver,12,6,6
Ygêrne,archimonde,576,monk,mistweaver,12,6,6
Bigkim,khadgar,576,monk,mistweaver,12,6,6
Cøcøøn,blackrock,576,monk,mistweaver,12,6,6
Discoelysia,outland,576,monk,mistweaver,12,6,6
Pivomamrad,drakthul,576,monk,mistweaver,12,6,6
Mistur,blackrock,576,monk,mistweaver,12,6,6
Poohya,silvermoon,576,monk,mistweaver,12,6,6
Oiorie,twisting-nether,576,monk,mistweaver,12,6,6
Iliketofist,ravencrest,576,monk,mistweaver,12,6,6
Mørbradgryde,silvermoon,576,monk,mistweaver,12,6,6
Mahøni,malganis,576,monk,mistweaver,12,6,6
Кончеглаз,soulflayer,576,monk,mistweaver,12,6,6
Telder,sylvanas,576,monk,mistweaver,12,6,6
Aritisi,tarren-mill,576,monk,mistweaver,12,6,6
Vedak,stormreaver,576,monk,mistweaver,12,6,6
Maybeexm,ravencrest,576,monk,mistweaver,12,6,6
Annoyingtwo,archimonde,576,monk,mistweaver,12,6,6
Yez,azjolnerub,576,monk,mistweaver,12,6,6
Goamix,ravencrest,576,monk,mistweaver,12,6,6
Vàlky,outland,576,monk,mistweaver,12,6,6
Potkuri,stormreaver,576,monk,mistweaver,12,6,6
Коумана,gordunni,576,monk,mistweaver,15,7,8
Торен,soulflayer,576,monk,mistweaver,18,6,12
Ness,hyjal,576,monk,mistweaver,18,6,12
Modequillo,blackmoore,576,monk,mistweaver,18,6,12
Renegatt,twisting-nether,576,monk,mistweaver,18,6,12
Heyami,ravencrest,576,monk,mistweaver,24,6,18
Itsthemonkky,tarren-mill,576,monk,mistweaver,24,6,18
Fraideberoa,ravencrest,575,monk,mistweaver,6,6,0
Smitheal,outland,575,monk,mistweaver,6,6,0
Vexzen,tarren-mill,575,monk,mistweaver,12,6,6
Фериго,gordunni,575,monk,mistweaver,12,6,6
Rakowo,arthas,575,monk,mistweaver,12,6,6
Drlyn,blackmoore,575,monk,mistweaver,12,6,6
Samie,ravencrest,575,monk,mistweaver,12,6,6
Tily,stormreaver,575,monk,mistweaver,12,6,6
Drír,archimonde,575,monk,mistweaver,12,6,6
Skonk,frostmane,575,monk,mistweaver,12,6,6
Latify,todeswache,575,monk,mistweaver,18,6,12
Painswîft,blackhand,575,monk,mistweaver,18,6,12
Mulana,sanguino,575,monk,mistweaver,18,6,12
Fellatia,garrosh,574,monk,mistweaver,6,6,0
Othalain,silvermoon,574,monk,mistweaver,12,6,6
Irishdëmon,ravencrest,574,monk,mistweaver,16,6,10
Gârdt,blackmoore,573,monk,mistweaver,6,6,0
Xalyà,archimonde,556,monk,mistweaver,14,8,6
Psychö,zuljin,538,monk,mistweaver,17,6,11
Lidalol,silvermoon,527,monk,mistweaver,9,7,2
Trymax,blackmoore,522,monk,mistweaver,17,7,10
Saliya,draenor,512,monk,mistweaver,10,6,4
Tarzaki,hyjal,494,monk,mistweaver,13,6,7
Dánný,antonidas,494,monk,mistweaver,13,6,7
Holyrop,aegwynn,480,monk,mistweaver,6,5,1
Gaalon,ravencrest,480,monk,mistweaver,6,5,1
Blinkër,sanguino,480,monk,mistweaver,6,5,1
Lfmasctop,ravencrest,480,monk,mistweaver,6,5,1
Veladana,chamber-of-aspects,480,monk,mistweaver,6,5,1
Stromon,silvermoon,480,monk,mistweaver,6,5,1
Dukhi,kazzak,480,monk,mistweaver,6,5,1
Cítysushi,draenor,480,monk,mistweaver,6,5,1
Plancton,kazzak,480,monk,mistweaver,6,5,1
Kaowar,nerzhul,480,monk,mistweaver,6,5,1
Fistpunk,kazzak,480,monk,mistweaver,6,5,1
Sloopkogel,tarren-mill,480,monk,mistweaver,6,5,1
Lovange,silvermoon,480,monk,mistweaver,6,5,1
Pafia,sargeras,480,monk,mistweaver,6,5,1
Подорожнник,gordunni,480,monk,mistweaver,6,5,1
Sio,dentarg,480,monk,mistweaver,6,5,1
Marvboy,aegwynn,480,monk,mistweaver,6,5,1
Керизз,gordunni,480,monk,mistweaver,6,5,1
Павнмонкх,gordunni,480,monk,mistweaver,6,5,1
Такиера,gordunni,480,monk,mistweaver,6,5,1
Биак,howling-fjord,480,monk,mistweaver,8,5,3
Ðrçleañ,stormreaver,480,monk,mistweaver,12,5,7
Kandislee,ravencrest,480,monk,mistweaver,12,5,7
Jacm,blackhand,480,monk,mistweaver,12,5,7
Holyropx,aegwynn,480,monk,mistweaver,12,5,7
Erandja,silvermoon,480,monk,mistweaver,12,5,7
Torinia,madmortem,480,monk,mistweaver,12,5,7
Monkjakt,draenor,480,monk,mistweaver,12,5,7
Bountyño,dun-modr,480,monk,mistweaver,12,5,7
Siezlebabo,blackrock,480,monk,mistweaver,12,5,7
Ajay,outland,480,monk,mistweaver,12,5,7
Gemil,argent-dawn,480,monk,mistweaver,12,5,7
Folfimo,silvermoon,480,monk,mistweaver,12,5,7
Tîptap,blackrock,480,monk,mistweaver,12,5,7
Minervaez,grim-batol,480,monk,mistweaver,12,5,7
Ariluna,tarren-mill,480,monk,mistweaver,12,5,7
Wkiller,outland,480,monk,mistweaver,18,5,13
Diabolùs,blackmoore,480,monk,mistweaver,18,5,13
Madraven,ravencrest,480,monk,mistweaver,18,5,13
Whytoosxy,silvermoon,480,monk,mistweaver,18,5,13
Ðéliora,la-croisade-écarlate,480,monk,mistweaver,24,5,19
Proxxona,eredar,479,monk,mistweaver,6,5,1
Brucechi,kargath,479,monk,mistweaver,6,5,1
Jackamonk,kazzak,479,monk,mistweaver,12,5,7
Sotqyy,stormscale,479,monk,mistweaver,12,5,7
Luigimonk,dun-modr,479,monk,mistweaver,12,5,7
Дарума,grom,479,monk,mistweaver,12,5,7
Яутжа,soulflayer,479,monk,mistweaver,12,5,7
Knotze,eredar,479,monk,mistweaver,18,5,13
Gantz,blackhand,479,monk,mistweaver,24,5,19
Toaborsten,tarren-mill,478,monk,mistweaver,6,5,1
Cheriedevile,drakthul,478,monk,mistweaver,18,5,13
Брэйки,lich-king,478,monk,mistweaver,18,5,13
Drugarix,uldaman,475,monk,mistweaver,12,5,7
Mistyheals,nagrand,474,monk,mistweaver,12,5,7
Jsuispasheal,dalaran,473,monk,mistweaver,12,5,7
Filomenata,rexxar,469,monk,mistweaver,19,5,14
Pìmpìnelle,garona,432,monk,mistweaver,9,6,3
Dræk,twisting-nether,426,monk,mistweaver,19,6,13
Годъяр,gordunni,415,monk,mistweaver,8,5,3
Missislee,aegwynn,384,monk,mistweaver,6,4,2
Олежатоксик,gordunni,384,monk,mistweaver,6,4,2
Эрумонк,gordunni,384,monk,mistweaver,6,4,2
Zanizu,blackhand,384,monk,mistweaver,6,4,2
Naìsh,arygos,384,monk,mistweaver,6,4,2
Escopetin,los-errantes,384,monk,mistweaver,6,4,2
Mialena,eredar,384,monk,mistweaver,6,4,2
Jlo,stormscale,384,monk,mistweaver,6,4,2
Meineaugen,blackhand,384,monk,mistweaver,6,4,2
Valdaras,runetotem,384,monk,mistweaver,6,4,2
Skusle,defias-brotherhood,384,monk,mistweaver,6,4,2
Bhrag,die-aldor,384,monk,mistweaver,6,4,2
Bratana,dun-morogh,384,monk,mistweaver,6,4,2
Alomonk,archimonde,384,monk,mistweaver,6,4,2
Ryac,defias-brotherhood,384,monk,mistweaver,6,4,2
Mugn,sanguino,384,monk,mistweaver,6,4,2
Sinnermonkk,outland,384,monk,mistweaver,6,4,2
Camlen,draenor,384,monk,mistweaver,6,4,2
Callim,blackrock,384,monk,mistweaver,6,4,2
Bigdaddypump,blackmoore,384,monk,mistweaver,6,4,2
Katmunk,kazzak,384,monk,mistweaver,6,4,2
Punkfukanda,drakthul,384,monk,mistweaver,6,4,2
Bréwmáster,silvermoon,384,monk,mistweaver,6,4,2
Peaceweaver,ravencrest,384,monk,mistweaver,6,4,2
Yoogychi,ravencrest,384,monk,mistweaver,6,4,2
Roudious,arathi,384,monk,mistweaver,6,4,2
Bigflex,conseil-des-ombres,384,monk,mistweaver,6,4,2
Ennamoly,blackmoore,384,monk,mistweaver,6,4,2
Jemijedno,drakthul,384,monk,mistweaver,6,4,2
Barracüs,dun-modr,384,monk,mistweaver,6,4,2
Dath,outland,384,monk,mistweaver,6,4,2
Trancendent,silvermoon,384,monk,mistweaver,6,4,2
Муррчалкин,howling-fjord,384,monk,mistweaver,6,4,2
Erannas,turalyon,384,monk,mistweaver,6,4,2
Dog,garona,384,monk,mistweaver,6,4,2
Monkersquad,doomhammer,384,monk,mistweaver,6,4,2
Atenazadonte,sanguino,384,monk,mistweaver,6,4,2
Foaqer,aegwynn,384,monk,mistweaver,6,4,2
Meuhporgg,hyjal,384,monk,mistweaver,6,4,2
Gumar,antonidas,384,monk,mistweaver,6,4,2
Xevol,burning-legion,384,monk,mistweaver,6,4,2
Lizardspock,hyjal,384,monk,mistweaver,6,4,2
Sushiroller,blackrock,384,monk,mistweaver,6,4,2
Леобтв,soulflayer,384,monk,mistweaver,6,4,2
Фешнмонк,soulflayer,384,monk,mistweaver,6,4,2
Highline,draenor,384,monk,mistweaver,6,4,2
Nêrfmeta,kazzak,384,monk,mistweaver,6,4,2
Gangichi,blackhand,384,monk,mistweaver,9,5,4
Kunolis,kazzak,384,monk,mistweaver,8,4,4
Слишкомхорош,howling-fjord,384,monk,mistweaver,12,4,8
Bûl,blackmoore,384,monk,mistweaver,12,4,8
Invsionrush,crushridge,384,monk,mistweaver,12,4,8
Audaz,dun-modr,384,monk,mistweaver,12,4,8
Boîndíl,malfurion,384,monk,mistweaver,12,4,8
Woofi,tarren-mill,384,monk,mistweaver,12,4,8
Eth,nagrand,384,monk,mistweaver,12,4,8
Nebelwandler,blackhand,384,monk,mistweaver,12,4,8
Dromarch,dun-modr,384,monk,mistweaver,12,4,8
Bruceli,darkmoon-faire,384,monk,mistweaver,12,4,8
Тсайм,howling-fjord,384,monk,mistweaver,12,4,8
Daitaro,ravencrest,384,monk,mistweaver,12,4,8
Akùmawíns,archimonde,384,monk,mistweaver,12,4,8
Supwithat,kazzak,383,monk,mistweaver,6,4,2
Wrathing,tarren-mill,383,monk,mistweaver,6,4,2
Senseithai,trollbane,383,monk,mistweaver,12,4,8
Gnomebrew,ravencrest,383,monk,mistweaver,12,4,8
Xentimus,kazzak,383,monk,mistweaver,12,4,8
Eucalyptuz,draenor,383,monk,mistweaver,12,4,8
Fkflying,defias-brotherhood,381,monk,mistweaver,12,4,8
Geeberz,twisting-nether,380,monk,mistweaver,12,4,8
Matrim,arathor,351,monk,mistweaver,8,5,3
Chiá,tarren-mill,351,monk,mistweaver,11,4,7
Thiccbaby,kazzak,336,monk,mistweaver,9,4,5
Yøda,malganis,335,monk,mistweaver,9,4,5
Quotes,darksorrow,330,monk,mistweaver,16,6,10
Midgetyoda,outland,330,monk,mistweaver,17,5,12
Монкиннияя,gordunni,330,monk,mistweaver,21,6,15
Ilikeducks,ravencrest,319,monk,mistweaver,5,4,1
Zaalleh,draenor,319,monk,mistweaver,5,4,1
Strillen,twisting-nether,304,monk,mistweaver,7,4,3
Shoskio,chamber-of-aspects,288,monk,mistweaver,6,3,3
Fistíe,sylvanas,288,monk,mistweaver,6,3,3
Kragor,eredar,288,monk,mistweaver,6,3,3
Родо,blackscar,288,monk,mistweaver,6,3,3
Zyrosmonk,blackmoore,288,monk,mistweaver,6,3,3
Coalsack,outland,288,monk,mistweaver,6,3,3
Culiacàn,blackmoore,288,monk,mistweaver,6,3,3
Perikencito,dun-modr,288,monk,mistweaver,6,3,3
Xanderpowa,sanguino,288,monk,mistweaver,6,3,3
Moinalisaa,outland,288,monk,mistweaver,6,3,3
Dr,sylvanas,288,monk,mistweaver,6,3,3
Fshn,sylvanas,288,monk,mistweaver,6,3,3
Píco,gorgonnash,288,monk,mistweaver,6,3,3
Koba,frostwolf,288,monk,mistweaver,6,3,3
Лемонк,gordunni,288,monk,mistweaver,6,3,3
Dråf,ysondre,288,monk,mistweaver,6,3,3
Baisi,blackhand,288,monk,mistweaver,6,3,3
Loempia,outland,288,monk,mistweaver,6,3,3
Viggex,outland,288,monk,mistweaver,6,3,3
Yutahon,azjolnerub,288,monk,mistweaver,6,3,3
Kaizenthor,runetotem,288,monk,mistweaver,6,3,3
Ninetz,tarren-mill,288,monk,mistweaver,6,3,3
Crommul,burning-legion,288,monk,mistweaver,6,3,3
Louiemon,outland,288,monk,mistweaver,6,3,3
Mecin,ragnaros,288,monk,mistweaver,6,3,3
Lassador,onyxia,288,monk,mistweaver,6,3,3
Domedagsdamp,draenor,288,monk,mistweaver,6,3,3
Uggs,hyjal,288,monk,mistweaver,6,3,3
Киликххл,deathguard,288,monk,mistweaver,6,3,3
Chakuro,ravencrest,288,monk,mistweaver,6,3,3
Mistless,ragnaros,288,monk,mistweaver,6,3,3
Rípple,alakir,288,monk,mistweaver,6,3,3
Mickeyworms,archimonde,288,monk,mistweaver,6,3,3
Fistwave,malganis,288,monk,mistweaver,6,3,3
Moistweaver,drakthul,288,monk,mistweaver,6,3,3
Carlteaz,drakthul,288,monk,mistweaver,6,3,3
Leikô,grim-batol,288,monk,mistweaver,6,3,3
Tiddor,burning-legion,288,monk,mistweaver,6,3,3
Wèéman,grim-batol,288,monk,mistweaver,6,3,3
Fairhand,emerald-dream,288,monk,mistweaver,6,3,3
Kylâas,die-ewige-wacht,288,monk,mistweaver,6,3,3
Neptulion,ravencrest,288,monk,mistweaver,6,3,3
Demmonkz,stormreaver,288,monk,mistweaver,6,3,3
Миражмонк,howling-fjord,288,monk,mistweaver,6,3,3
Atommyran,frostmane,288,monk,mistweaver,6,3,3
Craneovic,kult-der-verdammten,288,monk,mistweaver,6,3,3
Córporation,outland,288,monk,mistweaver,6,3,3
Màlydôr,outland,288,monk,mistweaver,6,3,3
Коррелир,howling-fjord,288,monk,mistweaver,6,3,3
Totemlygodx,alakir,288,monk,mistweaver,6,3,3
Kätelyys,dun-modr,288,monk,mistweaver,6,3,3
Friidam,lightbringer,288,monk,mistweaver,6,3,3
Saáru,argent-dawn,288,monk,mistweaver,6,3,3
Relentlessly,blackrock,288,monk,mistweaver,6,3,3
Askmeout,ravencrest,288,monk,mistweaver,7,3,4
Tossen,ragnaros,288,monk,mistweaver,12,3,9
Nasaislying,grim-batol,288,monk,mistweaver,12,3,9
Løkî,culte-de-la-rive-noire,288,monk,mistweaver,12,3,9
Jinora,theradras,288,monk,mistweaver,12,3,9
Justfistyoux,archimonde,288,monk,mistweaver,12,3,9
Lonechi,sylvanas,288,monk,mistweaver,12,3,9
Olîvê,ravencrest,288,monk,mistweaver,12,3,9
Fistmeg,grim-batol,288,monk,mistweaver,12,3,9
Drunklee,aegwynn,288,monk,mistweaver,12,3,9
Leøni,malfurion,288,monk,mistweaver,12,3,9
Brewdooms,laughing-skull,288,monk,mistweaver,12,3,9
Спартаннка,gordunni,287,monk,mistweaver,6,3,3
Ryanshazier,eredar,287,monk,mistweaver,6,3,3
Bo,malorne,287,monk,mistweaver,6,3,3
Playboicarti,frostwolf,287,monk,mistweaver,6,3,3
Brizs,outland,287,monk,mistweaver,6,3,3
Hanumahn,kilrogg,287,monk,mistweaver,12,3,9
Pepefocho,sanguino,286,monk,mistweaver,6,3,3
Maharaj,terenas,255,monk,mistweaver,11,3,8
Trlmøna,gorgonnash,240,monk,mistweaver,9,4,5
Pikajeww,kazzak,239,monk,mistweaver,5,3,2
Nïkaa,dun-modr,234,monk,mistweaver,8,5,3
Sugra,frostwolf,234,monk,mistweaver,9,4,5
Mouhous,hellscream,234,monk,mistweaver,13,4,9
Арнольдовна,blackscar,234,monk,mistweaver,17,4,13
Colita,kazzak,233,monk,mistweaver,16,5,11
Ronocs,turalyon,223,monk,mistweaver,8,3,5
Fistandfury,outland,192,monk,mistweaver,6,2,4
Shynlee,frostwhisper,192,monk,mistweaver,6,2,4
Wilymonka,dalaran,192,monk,mistweaver,6,2,4
Siouxxsie,thunderhorn,192,monk,mistweaver,6,2,4
Ebonymilfy,archimonde,192,monk,mistweaver,6,2,4
Jetsweep,kazzak,192,monk,mistweaver,6,2,4
Merlyñ,blackmoore,192,monk,mistweaver,6,2,4
Wifeeagro,doomhammer,192,monk,mistweaver,6,2,4
Rbgmachine,burning-legion,192,monk,mistweaver,6,2,4
Kmorhin,antonidas,192,monk,mistweaver,6,2,4
Loveít,blackrock,192,monk,mistweaver,6,2,4
Pleasure,laughing-skull,192,monk,mistweaver,6,2,4
Dalaipyjama,quelthalas,192,monk,mistweaver,6,2,4
Sashun,blackmoore,192,monk,mistweaver,6,2,4
Scorpìon,blackrock,192,monk,mistweaver,6,2,4
Dennismansix,sylvanas,192,monk,mistweaver,6,2,4
Bakersdozen,tarren-mill,192,monk,mistweaver,6,2,4
Auaaua,ravencrest,192,monk,mistweaver,6,2,4
Justacomma,outland,192,monk,mistweaver,6,2,4
Poyi,ravencrest,192,monk,mistweaver,6,2,4
Domingovivas,dun-modr,192,monk,mistweaver,6,2,4
Mystize,shattered-hand,192,monk,mistweaver,6,2,4
Зараз,gordunni,192,monk,mistweaver,6,2,4
Trippyv,ragnaros,192,monk,mistweaver,6,2,4
Yinsho,stormscale,192,monk,mistweaver,6,2,4
Кулаквтебе,borean-tundra,192,monk,mistweaver,6,2,4
Fisterxd,blackrock,192,monk,mistweaver,6,2,4
Tøngpø,argent-dawn,192,monk,mistweaver,6,2,4
Exbuddhist,outland,192,monk,mistweaver,6,2,4
Acbcz,draenor,192,monk,mistweaver,6,2,4
Фистингкоуч,gordunni,192,monk,mistweaver,6,2,4
Jolifine,alleria,192,monk,mistweaver,6,2,4
Cranecannon,aegwynn,192,monk,mistweaver,6,2,4
Sînge,archimonde,192,monk,mistweaver,6,2,4
Rgkekw,dun-modr,192,monk,mistweaver,6,2,4
Liluzi,aszune,192,monk,mistweaver,6,2,4
Каземат,booty-bay,192,monk,mistweaver,6,2,4
Dunkfjås,stormscale,192,monk,mistweaver,6,2,4
Espectrå,dun-modr,192,monk,mistweaver,6,2,4
Тэсси,blackscar,192,monk,mistweaver,6,2,4
Syy,medivh,192,monk,mistweaver,6,2,4
Saintmoon,drakthul,192,monk,mistweaver,6,2,4
Jadefain,argent-dawn,192,monk,mistweaver,6,2,4
Люсилью,howling-fjord,192,monk,mistweaver,6,2,4
Kûngfu,tarren-mill,192,monk,mistweaver,6,2,4
Ascrem,ragnaros,192,monk,mistweaver,12,2,10
Chîca,ysondre,192,monk,mistweaver,12,2,10
Добраядушка,gordunni,192,monk,mistweaver,12,2,10
Konnîchîwa,kazzak,192,monk,mistweaver,12,2,10
Brixelol,kazzak,192,monk,mistweaver,12,2,10
Johnsôn,blackmoore,192,monk,mistweaver,12,2,10
Daltailr,silvermoon,192,monk,mistweaver,12,2,10
Sargnorak,dalaran,191,monk,mistweaver,6,2,4
Чвка,booty-bay,191,monk,mistweaver,6,2,4
Hisagi,khaz-modan,191,monk,mistweaver,6,2,4
Fréýáá,blackrock,191,monk,mistweaver,6,2,4
Pandasia,kargath,186,monk,mistweaver,16,4,12
Andrah,blackmoore,185,monk,mistweaver,14,4,10
Swiftmonky,azuremyst,159,monk,mistweaver,5,2,3
Саас,gordunni,159,monk,mistweaver,5,2,3
Киото,ashenvale,159,monk,mistweaver,5,2,3
Зрти,gordunni,138,monk,mistweaver,12,4,8
Saïtama,krasus,138,monk,mistweaver,10,3,7
Shenlong,burning-blade,138,monk,mistweaver,14,3,11
Wraq,tarren-mill,128,monk,mistweaver,4,2,2
Cheechong,grim-batol,127,monk,mistweaver,8,2,6
Mynaira,tarren-mill,112,monk,mistweaver,19,2,17
Monkolben,blackmoore,96,monk,mistweaver,6,1,5
Kegrøll,doomhammer,96,monk,mistweaver,6,1,5
Legpunch,the-maelstrom,96,monk,mistweaver,6,1,5
Pream,blackrock,96,monk,mistweaver,6,1,5
Kano,burning-legion,96,monk,mistweaver,6,1,5
Àómìñêdâìkí,lightnings-blade,96,monk,mistweaver,6,1,5
Assaalaria,argent-dawn,96,monk,mistweaver,6,1,5
Itxelita,zuljin,96,monk,mistweaver,6,1,5
Shîïna,ysondre,96,monk,mistweaver,6,1,5
Mongretod,ravencrest,96,monk,mistweaver,6,1,5
Whywalker,silvermoon,96,monk,mistweaver,6,1,5
Rostick,drakthul,96,monk,mistweaver,6,1,5
Bænkai,naxxramas,96,monk,mistweaver,6,1,5
Skadchi,blackhand,96,monk,mistweaver,6,1,5
Backbone,auchindoun,96,monk,mistweaver,6,1,5
Brewbunnyqt,thrall,96,monk,mistweaver,6,1,5
Fapmaster,aegwynn,96,monk,mistweaver,6,1,5
Smlpp,kazzak,96,monk,mistweaver,6,1,5
Jusex,stormreaver,96,monk,mistweaver,6,1,5
Whoszeus,archimonde,96,monk,mistweaver,6,1,5
Botsmw,kazzak,96,monk,mistweaver,6,1,5
Brandy,kazzak,96,monk,mistweaver,6,1,5
Glivilalis,drekthar,96,monk,mistweaver,6,1,5
Monkinator,stormreaver,96,monk,mistweaver,6,1,5
Адскиймех,deathweaver,96,monk,mistweaver,6,1,5
Moorf,ravencrest,96,monk,mistweaver,6,1,5
Антошамв,gordunni,96,monk,mistweaver,6,1,5
Ytjin,draenor,96,monk,mistweaver,6,1,5
Jessiemonk,blackhand,96,monk,mistweaver,6,1,5
Lìlíy,taerar,96,monk,mistweaver,6,1,5
Capos,wrathbringer,96,monk,mistweaver,11,1,10
Xiâomèi,dun-modr,96,monk,mistweaver,12,1,11
Upbringer,ragnaros,96,monk,mistweaver,12,1,11
Griffens,argent-dawn,79,monk,mistweaver,5,1,4
Botspec,twisting-nether,63,monk,mistweaver,2,2,0
Rsk,antonidas,42,monk,mistweaver,10,3,7
Egï,azshara,42,monk,mistweaver,8,2,6
Monkeykung,defias-brotherhood,40,monk,mistweaver,16,3,13
Padawang,twisting-nether,767,monk,brewmaster,24,8,16
Winchun,ravencrest,565,monk,brewmaster,13,6,7
Shirôhige,zirkel-des-cenarius,288,monk,brewmaster,6,3,3
Tauroné,draenor,288,monk,brewmaster,12,3,9
Tayoo,aegwynn,192,monk,brewmaster,6,2,4
Badcøwboy,archimonde,96,monk,brewmaster,6,1,5
Tylee,tarren-mill,96,monk,brewmaster,6,1,5
Lubeï,kirin-tor,96,monk,brewmaster,6,1,5
Lòthbar,confrérie-du-thorium,63,monk,brewmaster,2,2,0
Fistyw,stormscale,2313,monk,windwalker,104,60,44
Sîxmonths,stormscale,2263,monk,windwalker,72,48,24
Senretsu,shattered-halls,2230,monk,windwalker,90,50,40
Rmtexter,ravencrest,2198,monk,windwalker,83,44,39
Queteapie,stormscale,2192,monk,windwalker,82,48,34
Plaww,dalaran,2172,monk,windwalker,120,75,45
Monkmeta,frostwolf,2171,monk,windwalker,114,70,44
Daosh,nemesis,2137,monk,windwalker,91,48,43
Stepsyzz,stormscale,2126,monk,windwalker,89,46,43
Tabetai,tarren-mill,2125,monk,windwalker,90,46,44
Lilcatlife,tyrande,2123,monk,windwalker,66,36,30
Brñ,twisting-nether,2121,monk,windwalker,72,39,33
Ewynamonk,silvermoon,2121,monk,windwalker,102,51,51
Unpruneable,stormscale,2120,monk,windwalker,132,67,65
Snusochnocco,the-maelstrom,2120,monk,windwalker,78,39,39
Redundänt,kazzak,2114,monk,windwalker,72,42,30
Váinz,ravencrest,2112,monk,windwalker,78,41,37
Pichouhuahua,elune,2096,monk,windwalker,120,63,57
Ilovehim,antonidas,2092,monk,windwalker,66,41,25
Rivazsunkick,archimonde,2089,monk,windwalker,154,76,78
Fistinguhuhu,outland,2067,monk,windwalker,84,45,39
Niamix,archimonde,2066,monk,windwalker,146,75,71
Hitsuwalker,archimonde,2064,monk,windwalker,102,59,43
Melyda,ravencrest,2008,monk,windwalker,132,74,58
Enerchi,ravencrest,1988,monk,windwalker,72,42,30
Мистмастер,soulflayer,1984,monk,windwalker,48,30,18
Eth,nagrand,1975,monk,windwalker,84,42,42
Jájsemshadow,drakthul,1971,monk,windwalker,66,36,30
Balia,blackrock,1971,monk,windwalker,60,29,31
Pandamoniun,aggra-português,1953,monk,windwalker,120,61,59
Zukatan,tarren-mill,1937,monk,windwalker,88,45,43
Theoww,dragonblight,1937,monk,windwalker,66,31,35
Нелегитимный,howling-fjord,1923,monk,windwalker,190,96,94
Bulluh,blackmoore,1919,monk,windwalker,47,27,20
Sørann,drekthar,1916,monk,windwalker,88,48,40
Hurricrane,kazzak,1915,monk,windwalker,195,98,97
Muix,draenor,1906,monk,windwalker,30,20,10
Riskcapcap,dentarg,1905,monk,windwalker,72,37,35
Soulja,bloodfeather,1902,monk,windwalker,124,67,57
Инрэйджинкап,soulflayer,1900,monk,windwalker,108,52,56
Hastewalker,dun-morogh,1898,monk,windwalker,42,23,19
Ksâin,ravencrest,1896,monk,windwalker,66,34,32
Gyto,archimonde,1893,monk,windwalker,54,33,21
Ninadobrév,stormscale,1891,monk,windwalker,103,63,40
Yassøux,archimonde,1891,monk,windwalker,184,94,90
Муррчалкин,howling-fjord,1880,monk,windwalker,48,28,20
Ellipirelli,doomhammer,1880,monk,windwalker,70,30,40
Санварион,eversong,1875,monk,windwalker,72,36,36
Аррани,thermaplugg,1874,monk,windwalker,58,33,25
Fotmwalker,ragnaros,1872,monk,windwalker,138,72,66
Domww,outland,1871,monk,windwalker,108,59,49
Щищ,gordunni,1871,monk,windwalker,102,55,47
Pitball,ravencrest,1871,monk,windwalker,66,32,34
Projectasura,draenor,1866,monk,windwalker,126,67,59
Stillwater,thrall,1866,monk,windwalker,96,50,46
Ztl,twisting-nether,1861,monk,windwalker,101,59,42
Имортарион,howling-fjord,1860,monk,windwalker,42,25,17
Ladderfiend,stormscale,1858,monk,windwalker,48,21,27
Edenmonk,dun-morogh,1855,monk,windwalker,48,27,21
Troopmonk,ravencrest,1855,monk,windwalker,117,59,58
Vexíllum,sylvanas,1851,monk,windwalker,42,23,19
Kokushibo,cthun,1850,monk,windwalker,54,28,26
Яагрессивный,howling-fjord,1850,monk,windwalker,74,36,38
Sayozz,hyjal,1849,monk,windwalker,102,51,51
Gararasu,eredar,1846,monk,windwalker,42,22,20
Flunkefar,defias-brotherhood,1845,monk,windwalker,90,42,48
Тихийпук,deathguard,1838,monk,windwalker,146,83,63
Santanax,ravencrest,1834,monk,windwalker,42,27,15
Linuxx,ravencrest,1832,monk,windwalker,90,45,45
Monkini,kazzak,1823,monk,windwalker,54,27,27
Klumpenx,draenor,1821,monk,windwalker,80,43,37
Iminzww,ravencrest,1821,monk,windwalker,54,27,27
Tommypistol,runetotem,1820,monk,windwalker,84,42,42
Elinalia,burning-legion,1817,monk,windwalker,48,26,22
Pàrádìsé,ravencrest,1815,monk,windwalker,113,58,55
Monkees,twisting-nether,1815,monk,windwalker,65,33,32
Ароба,blackscar,1814,monk,windwalker,78,38,40
Beernie,tarren-mill,1812,monk,windwalker,54,33,21
Калестонз,howling-fjord,1811,monk,windwalker,54,31,23
Lullerull,silvermoon,1810,monk,windwalker,51,31,20
Nicesky,ravencrest,1810,monk,windwalker,66,32,34
Shpunk,ravencrest,1810,monk,windwalker,102,47,55
Orkamonka,burning-legion,1809,monk,windwalker,30,19,11
Фодз,soulflayer,1809,monk,windwalker,58,26,32
Рэйвх,howling-fjord,1808,monk,windwalker,36,19,17
Mebrin,ragnaros,1805,monk,windwalker,71,37,34
Sushiroll,stormrage,1805,monk,windwalker,99,49,50
Åbyssgòd,kazzak,1805,monk,windwalker,60,24,36
Unangebracht,silvermoon,1803,monk,windwalker,227,121,106
Saltotriks,tarren-mill,1802,monk,windwalker,62,28,34
Notmelo,dun-modr,1801,monk,windwalker,48,25,23
Windwanker,eredar,1800,monk,windwalker,36,22,14
Teressah,argent-dawn,1800,monk,windwalker,42,22,20
Reõ,argent-dawn,1797,monk,windwalker,101,60,41
Twinny,drakthul,1793,monk,windwalker,90,52,38
Karmaisabich,ragnaros,1792,monk,windwalker,30,19,11
Yukfou,tarren-mill,1792,monk,windwalker,59,28,31
Mikedcrybaby,tarren-mill,1790,monk,windwalker,131,69,62
Devilmønk,thrall,1785,monk,windwalker,60,29,31
Skailzkrt,hyjal,1779,monk,windwalker,42,22,20
Freehelper,stormscale,1779,monk,windwalker,60,24,36
Pazü,ysondre,1775,monk,windwalker,71,37,34
Möîne,arathi,1775,monk,windwalker,60,31,29
Narstie,kazzak,1772,monk,windwalker,59,32,27
Heran,ravencrest,1764,monk,windwalker,99,44,55
Rêshi,draenor,1760,monk,windwalker,66,44,22
Moultsou,hyjal,1758,monk,windwalker,66,33,33
Chaospilot,sylvanas,1756,monk,windwalker,74,35,39
Xiâomèi,dun-modr,1755,monk,windwalker,60,28,32
Эльморо,goldrinn,1752,monk,windwalker,42,20,22
Ackken,twisting-nether,1748,monk,windwalker,51,26,25
Kitcheneer,twisting-nether,1742,monk,windwalker,53,27,26
Rorkito,sanguino,1742,monk,windwalker,54,26,28
Niyka,silvermoon,1740,monk,windwalker,48,29,19
Sororicide,stormscale,1740,monk,windwalker,131,63,68
Маруты,soulflayer,1740,monk,windwalker,65,26,39
Dwdw,aerie-peak,1737,monk,windwalker,54,28,26
Pwaff,kazzak,1736,monk,windwalker,72,37,35
Iceym,stormscale,1736,monk,windwalker,51,26,25
Копытька,gordunni,1736,monk,windwalker,51,26,25
Лазанья,grom,1731,monk,windwalker,66,30,36
Mosch,blackrock,1729,monk,windwalker,42,26,16
Hybridtheory,doomhammer,1722,monk,windwalker,65,37,28
Гладастар,soulflayer,1719,monk,windwalker,78,41,37
Трэйци,blackscar,1716,monk,windwalker,39,23,16
Yiannischan,draenor,1715,monk,windwalker,92,49,43
Carbozø,archimonde,1713,monk,windwalker,42,27,15
Виноипиво,soulflayer,1713,monk,windwalker,60,30,30
Sobadzlolz,alexstrasza,1707,monk,windwalker,136,73,63
Джэкичача,soulflayer,1707,monk,windwalker,42,21,21
Dansaam,tarren-mill,1706,monk,windwalker,24,18,6
Peaceweaver,ravencrest,1703,monk,windwalker,47,27,20
Ocëane,sanguino,1703,monk,windwalker,48,27,21
Megatazz,hyjal,1697,monk,windwalker,40,23,17
Faxax,draenor,1696,monk,windwalker,48,23,25
Меняубило,howling-fjord,1696,monk,windwalker,78,37,41
Osalot,ravencrest,1695,monk,windwalker,60,30,30
Testmonial,hyjal,1694,monk,windwalker,48,21,27
Ashânti,eredar,1691,monk,windwalker,62,30,32
Кианасоломид,gordunni,1690,monk,windwalker,41,23,18
Shoenk,blackhand,1689,monk,windwalker,30,18,12
Gonkun,outland,1688,monk,windwalker,67,35,32
Lonechi,sylvanas,1687,monk,windwalker,30,18,12
Tisaki,blackhand,1680,monk,windwalker,41,25,16
Hilzaxsub,archimonde,1679,monk,windwalker,47,29,18
Fistofrage,ravencrest,1677,monk,windwalker,42,25,17
Sàitama,hyjal,1676,monk,windwalker,42,18,24
Edenwalker,dun-morogh,1673,monk,windwalker,48,22,26
Mionoor,aegwynn,1671,monk,windwalker,178,86,92
Ratslayerz,dun-modr,1669,monk,windwalker,42,24,18
Ãmaterasû,kazzak,1665,monk,windwalker,42,19,23
Димакарма,howling-fjord,1661,monk,windwalker,77,31,46
Hefners,grim-batol,1658,monk,windwalker,35,18,17
Zéroneufsix,silvermoon,1658,monk,windwalker,50,19,31
Saduh,thrall,1653,monk,windwalker,44,20,24
Bastos,blackrock,1652,monk,windwalker,269,141,128
Bîmbâmboom,blackmoore,1650,monk,windwalker,48,25,23
Thérez,les-sentinelles,1648,monk,windwalker,42,22,20
Sylicia,alleria,1648,monk,windwalker,97,47,50
Hunkfur,ravencrest,1647,monk,windwalker,44,25,19
Кишмякмонк,howling-fjord,1646,monk,windwalker,60,31,29
Такюн,howling-fjord,1646,monk,windwalker,140,69,71
Гуппер,howling-fjord,1646,monk,windwalker,54,23,31
Cheethfu,ragnaros,1645,monk,windwalker,30,21,9
Deretrox,twisting-nether,1645,monk,windwalker,36,21,15
Idiot,outland,1644,monk,windwalker,42,22,20
Miløøx,silvermoon,1641,monk,windwalker,76,40,36
Locotommy,blackrock,1630,monk,windwalker,30,17,13
Shînøbi,dalaran,1624,monk,windwalker,30,17,13
Mîsts,aszune,1624,monk,windwalker,35,18,17
Anteric,sylvanas,1623,monk,windwalker,30,20,10
Hôllowx,archimonde,1621,monk,windwalker,30,17,13
Catchmee,agamaggan,1616,monk,windwalker,30,17,13
Yacum,blackrock,1616,monk,windwalker,47,21,26
Тринх,ashenvale,1613,monk,windwalker,54,31,23
Saisha,defias-brotherhood,1613,monk,windwalker,36,20,16
Heyami,ravencrest,1613,monk,windwalker,36,17,19
Ravelbaby,blackrock,1613,monk,windwalker,45,21,24
Moistpocket,stormscale,1613,monk,windwalker,42,17,25
Zandoy,draenor,1611,monk,windwalker,52,26,26
Tenshinhann,outland,1610,monk,windwalker,30,17,13
Erenaar,nemesis,1608,monk,windwalker,48,37,11
Виндволкерша,gordunni,1607,monk,windwalker,36,19,17
Nigu,dun-modr,1606,monk,windwalker,67,38,29
Vayarah,antonidas,1605,monk,windwalker,54,28,26
Акумах,blackscar,1605,monk,windwalker,99,48,51
Iastyn,kazzak,1604,monk,windwalker,78,39,39
Valduri,stormscale,1604,monk,windwalker,60,27,33
Rivaz,archimonde,1603,monk,windwalker,36,19,17
Fistu,silvermoon,1602,monk,windwalker,31,18,13
Faustix,blackmoore,1602,monk,windwalker,78,42,36
Gaehitmonlee,ravencrest,1597,monk,windwalker,75,44,31
Rismonk,twisting-nether,1597,monk,windwalker,36,19,17
Pelou,culte-de-la-rive-noire,1597,monk,windwalker,48,25,23
Mónkâs,tarren-mill,1597,monk,windwalker,48,17,31
Thyf,drakthul,1596,monk,windwalker,48,20,28
Doktormonk,blackrock,1592,monk,windwalker,106,56,50
Тэсти,blackscar,1590,monk,windwalker,34,19,15
Рокебайбейби,howling-fjord,1587,monk,windwalker,42,22,20
Sérrè,tarren-mill,1585,monk,windwalker,42,21,21
Notsmol,quelthalas,1585,monk,windwalker,36,18,18
Venuki,blackrock,1582,monk,windwalker,30,19,11
Skiplegsweeb,stormscale,1579,monk,windwalker,30,21,9
Эвэйжион,gordunni,1579,monk,windwalker,42,25,17
Wuux,tarren-mill,1565,monk,windwalker,36,20,16
Jeydi,ravencrest,1563,monk,windwalker,53,36,17
Ютуми,soulflayer,1557,monk,windwalker,36,17,19
Naschitüte,blackrock,1555,monk,windwalker,144,73,71
Pandafuki,ravencrest,1550,monk,windwalker,38,18,20
Sòftx,stormscale,1549,monk,windwalker,34,22,12
Steros,die-aldor,1546,monk,windwalker,36,17,19
Akuuji,silvermoon,1544,monk,windwalker,36,17,19
Xullon,dragonblight,1542,monk,windwalker,60,27,33
Soxx,arthas,1539,monk,windwalker,36,21,15
Сандерстрайк,howling-fjord,1537,monk,windwalker,45,24,21
Fistedx,twisting-nether,1537,monk,windwalker,87,36,51
Chireapz,blackrock,1536,monk,windwalker,36,19,17
Djshady,sylvanas,1536,monk,windwalker,48,23,25
Хекмуги,borean-tundra,1535,monk,windwalker,91,44,47
Дуэльныйчел,howling-fjord,1533,monk,windwalker,76,35,41
Милыйколян,soulflayer,1532,monk,windwalker,36,16,20
Shaolinthug,stormscale,1531,monk,windwalker,36,16,20
Mynokxu,blackmoore,1526,monk,windwalker,27,18,9
Тшейши,howling-fjord,1526,monk,windwalker,54,28,26
Цеска,howling-fjord,1526,monk,windwalker,36,16,20
Fln,blackrock,1525,monk,windwalker,30,16,14
Scribzw,twisting-nether,1524,monk,windwalker,24,16,8
Луэнн,gordunni,1518,monk,windwalker,90,47,43
Bèrïth,kazzak,1517,monk,windwalker,36,18,18
Домудароги,gordunni,1514,monk,windwalker,36,19,17
Shardonay,ravencrest,1512,monk,windwalker,30,16,14
Анпапаяя,galakrond,1507,monk,windwalker,47,26,21
Jolbucheron,hyjal,1507,monk,windwalker,66,34,32
Дивипи,blackscar,1506,monk,windwalker,54,24,30
Kármo,thrall,1495,monk,windwalker,29,16,13
Eonyzi,kazzak,1491,monk,windwalker,42,20,22
Recklusa,stormscale,1487,monk,windwalker,54,31,23
Pêterpump,blackrock,1486,monk,windwalker,36,16,20
Plsnerfmemor,hyjal,1480,monk,windwalker,64,32,32
Диванн,howling-fjord,1478,monk,windwalker,35,16,19
Vuzashiji,argent-dawn,1473,monk,windwalker,36,17,19
Senshí,stormscale,1468,monk,windwalker,42,20,22
Samantonah,nemesis,1467,monk,windwalker,28,18,10
Fungamelol,blackhand,1459,monk,windwalker,30,19,11
Муайтайец,howling-fjord,1459,monk,windwalker,35,16,19
Sagewhisper,ravencrest,1458,monk,windwalker,57,27,30
Dræk,twisting-nether,1456,monk,windwalker,65,35,30
Lycké,silvermoon,1451,monk,windwalker,36,20,16
Монголгодх,howling-fjord,1444,monk,windwalker,120,67,53
Дезмимонк,ashenvale,1438,monk,windwalker,34,16,18
Артемиоксх,blackscar,1437,monk,windwalker,37,15,22
Agitoyamissj,burning-legion,1433,monk,windwalker,63,28,35
Oberháupt,blackrock,1432,monk,windwalker,30,15,15
Anhox,ragnaros,1425,monk,windwalker,30,15,15
Waîzen,uldaman,1417,monk,windwalker,30,17,13
Misutò,tarren-mill,1416,monk,windwalker,30,19,11
Xuuan,argent-dawn,1410,monk,windwalker,71,40,31
Ryle,forscherliga,1409,monk,windwalker,30,15,15
Matlahon,kazzak,1407,monk,windwalker,53,26,27
Kyraxs,silvermoon,1406,monk,windwalker,48,24,24
Янакаблуках,howling-fjord,1404,monk,windwalker,116,62,54
Добраядушка,gordunni,1400,monk,windwalker,36,19,17
Ívó,ragnaros,1400,monk,windwalker,48,20,28
Akÿo,archimonde,1399,monk,windwalker,35,15,20
Lucaspires,sylvanas,1399,monk,windwalker,42,15,27
Pipatvs,drakthul,1398,monk,windwalker,31,21,10
Azato,hyjal,1398,monk,windwalker,48,23,25
Fratznkicker,blackhand,1396,monk,windwalker,61,33,28
Vixia,outland,1390,monk,windwalker,29,15,14
Томтью,gordunni,1381,monk,windwalker,47,22,25
Keskonriz,ysondre,1381,monk,windwalker,84,36,48
Wakmo,bladefist,1380,monk,windwalker,44,22,22
Yobo,archimonde,1379,monk,windwalker,29,15,14
Кюзичка,gordunni,1379,monk,windwalker,83,38,45
Icecoldish,tarren-mill,1378,monk,windwalker,72,39,33
Swiftmonky,azuremyst,1376,monk,windwalker,48,27,21
Spinntowin,blackmoore,1376,monk,windwalker,75,35,40
Минимонахх,blackscar,1373,monk,windwalker,28,15,13
Malutkie,defias-brotherhood,1363,monk,windwalker,66,33,33
Yesman,quelthalas,1361,monk,windwalker,122,64,58
Galaxyfists,blackhand,1361,monk,windwalker,48,22,26
Doobly,kazzak,1359,monk,windwalker,89,44,45
Juujika,ravencrest,1358,monk,windwalker,23,15,8
Îrønfist,blackmoore,1358,monk,windwalker,29,17,12
Bandiya,archimonde,1358,monk,windwalker,61,28,33
Bakash,ysondre,1353,monk,windwalker,128,57,71
Mirôku,onyxia,1352,monk,windwalker,42,22,20
Boutarzi,hyjal,1347,monk,windwalker,54,25,29
Darré,sylvanas,1347,monk,windwalker,115,50,65
Kanõ,outland,1344,monk,windwalker,50,25,25
Omnibar,kazzak,1343,monk,windwalker,24,14,10
Dêsmî,ravencrest,1342,monk,windwalker,22,15,7
Exikûsh,frostwolf,1341,monk,windwalker,30,16,14
Yungdrippy,eredar,1340,monk,windwalker,24,14,10
Schmidti,kazzak,1340,monk,windwalker,30,14,16
Domiqx,blackhand,1339,monk,windwalker,30,14,16
Undefinedid,ravencrest,1335,monk,windwalker,110,57,53
Moonkeeye,stormscale,1332,monk,windwalker,60,36,24
Бладмонки,soulflayer,1328,monk,windwalker,36,15,21
Nikchi,destromath,1325,monk,windwalker,54,20,34
Øbamakush,archimonde,1323,monk,windwalker,36,17,19
Коркирас,howling-fjord,1322,monk,windwalker,84,47,37
Miyaghï,dun-modr,1322,monk,windwalker,43,23,20
Tempestu,twisting-nether,1319,monk,windwalker,30,14,16
Gatyz,archimonde,1317,monk,windwalker,33,14,19
Fûràxx,hyjal,1314,monk,windwalker,60,31,29
Nodzomi,shadowsong,1308,monk,windwalker,45,22,23
Kîngjungeîle,dalaran,1301,monk,windwalker,24,14,10
Djînns,blackmoore,1296,monk,windwalker,30,15,15
Яшкациган,howling-fjord,1290,monk,windwalker,46,19,27
Hampocket,ravencrest,1290,monk,windwalker,38,15,23
Mycki,dalaran,1289,monk,windwalker,29,15,14
Dänÿww,elune,1287,monk,windwalker,32,15,17
Lemmeportbk,ravencrest,1279,monk,windwalker,32,15,17
Likethat,hyjal,1279,monk,windwalker,36,16,20
Bobbyknuckls,ravencrest,1278,monk,windwalker,96,41,55
Mønkeydluffy,blackmoore,1269,monk,windwalker,66,33,33
Kungfumite,twisting-nether,1266,monk,windwalker,83,42,41
Djpunchable,blackrock,1247,monk,windwalker,24,13,11
Fijiwater,draenor,1246,monk,windwalker,18,13,5
Rerowine,magtheridon,1245,monk,windwalker,30,13,17
Эльторо,goldrinn,1244,monk,windwalker,36,13,23
Кирокко,gordunni,1242,monk,windwalker,18,14,4
Brandy,kazzak,1242,monk,windwalker,30,13,17
Pili,aegwynn,1241,monk,windwalker,24,13,11
Чвка,booty-bay,1240,monk,windwalker,37,19,18
Pandermann,antonidas,1238,monk,windwalker,30,16,14
Kouradoskylo,twisting-nether,1234,monk,windwalker,29,16,13
Meltfistqt,ravencrest,1234,monk,windwalker,30,13,17
Янасру,gordunni,1232,monk,windwalker,273,136,137
Kegrøll,doomhammer,1231,monk,windwalker,42,21,21
Gorskie,silvermoon,1230,monk,windwalker,27,13,14
Пампич,borean-tundra,1227,monk,windwalker,30,13,17
Vibé,blackmoore,1226,monk,windwalker,24,13,11
Bruzuh,outland,1215,monk,windwalker,31,15,16
Vushao,blackmoore,1215,monk,windwalker,174,81,93
Blumonk,argent-dawn,1210,monk,windwalker,48,23,25
Imvengeance,stormscale,1204,monk,windwalker,28,14,14
Vercya,dun-morogh,1168,monk,windwalker,37,19,18
Билльбо,fordragon,1157,monk,windwalker,36,16,20
Bellarika,nemesis,1152,monk,windwalker,12,12,0
Sponkas,tarren-mill,1152,monk,windwalker,24,12,12
Tðptier,drakthul,1151,monk,windwalker,18,12,6
Arsonists,argent-dawn,1151,monk,windwalker,18,12,6
Çhina,twisting-nether,1151,monk,windwalker,24,12,12
Adrianchase,ravencrest,1151,monk,windwalker,24,12,12
Healbotzweik,frostwolf,1151,monk,windwalker,24,12,12
Jinpachi,ravencrest,1151,monk,windwalker,30,12,18
Йетисан,gordunni,1149,monk,windwalker,18,12,6
Monk,dun-modr,1148,monk,windwalker,24,12,12
Brorsantuck,frostmane,1147,monk,windwalker,18,12,6
Sesi,drakthul,1147,monk,windwalker,42,12,30
Hosh,ysondre,1146,monk,windwalker,30,12,18
Wwisalright,burning-legion,1145,monk,windwalker,24,12,12
Ролитта,gordunni,1144,monk,windwalker,18,12,6
Gúerrilla,tarren-mill,1139,monk,windwalker,60,32,28
Yøøps,dalaran,1134,monk,windwalker,65,28,37
Elfisto,baelgun,1132,monk,windwalker,24,12,12
Malarie,magtheridon,1127,monk,windwalker,78,43,35
Ехерех,blackscar,1084,monk,windwalker,36,21,15
Xialongbao,khaz-modan,1083,monk,windwalker,29,12,17
Fatlazypanda,argent-dawn,1082,monk,windwalker,24,16,8
Euronymesis,silvermoon,1065,monk,windwalker,23,12,11
Daybaobao,the-maelstrom,1062,monk,windwalker,22,12,10
Одиниз,gordunni,1059,monk,windwalker,48,31,17
Ðâvàizskÿ,ysondre,1056,monk,windwalker,18,11,7
Hôllowx,throkferoth,1056,monk,windwalker,24,11,13
Erazhen,blackrock,1056,monk,windwalker,24,11,13
Chigre,hyjal,1055,monk,windwalker,18,11,7
Lesauceboss,kazzak,1055,monk,windwalker,18,11,7
Cirixx,outland,1055,monk,windwalker,18,11,7
Форгетх,soulflayer,1055,monk,windwalker,24,11,13
Smørc,the-maelstrom,1055,monk,windwalker,24,11,13
Leolilu,ravencrest,1054,monk,windwalker,18,11,7
Futtefut,ravencrest,1054,monk,windwalker,30,11,19
Tiaqa,aegwynn,1053,monk,windwalker,12,11,1
Mink,uldum,1053,monk,windwalker,24,11,13
Вамптолкер,howling-fjord,1049,monk,windwalker,18,11,7
Непорядочная,gordunni,1047,monk,windwalker,30,12,18
Dokuziq,twisting-nether,1046,monk,windwalker,28,12,16
Klapptoast,blackmoore,1036,monk,windwalker,24,11,13
Lòthbar,confrérie-du-thorium,1026,monk,windwalker,18,11,7
Napqi,malganis,1023,monk,windwalker,17,11,6
Broner,dunemaul,1022,monk,windwalker,23,11,12
Trunks,turalyon,1014,monk,windwalker,24,11,13
Marcianorock,archimonde,987,monk,windwalker,30,13,17
Agress,sanguino,984,monk,windwalker,72,33,39
Stronkman,frostwhisper,979,monk,windwalker,18,11,7
Вагонюлеера,howling-fjord,974,monk,windwalker,22,11,11
Wolmachégodx,archimonde,960,monk,windwalker,12,10,2
Mcscrub,ragnaros,960,monk,windwalker,18,10,8
Ðävàizskó,ysondre,960,monk,windwalker,18,10,8
Bugrika,tarren-mill,960,monk,windwalker,18,10,8
Sqoobie,tarren-mill,960,monk,windwalker,18,10,8
Toyless,ravencrest,960,monk,windwalker,18,10,8
Rìnox,blackmoore,960,monk,windwalker,18,10,8
Plånck,archimonde,960,monk,windwalker,18,10,8
Mollytov,tarren-mill,960,monk,windwalker,36,10,26
Nycea,blackrock,959,monk,windwalker,18,10,8
Атакцуки,gordunni,959,monk,windwalker,18,10,8
Vtx,blackrock,959,monk,windwalker,18,10,8
Rayokhen,kazzak,959,monk,windwalker,18,10,8
Inkegomonk,draenor,959,monk,windwalker,30,10,20
Alkanphel,kazzak,958,monk,windwalker,18,10,8
Realiaze,tichondrius,958,monk,windwalker,24,10,14
Монахнехилит,howling-fjord,956,monk,windwalker,24,10,14
Boxpunchkick,kazzak,955,monk,windwalker,24,10,14
Sebbii,twisting-nether,927,monk,windwalker,23,10,13
Wazari,nemesis,922,monk,windwalker,23,10,13
Karmachi,ravencrest,910,monk,windwalker,29,10,19
Dionee,twisting-nether,877,monk,windwalker,21,12,9
Denji,kargath,864,monk,windwalker,12,9,3
Bossdog,mugthol,864,monk,windwalker,12,9,3
Thänkky,kazzak,864,monk,windwalker,12,9,3
Tauti,dun-morogh,864,monk,windwalker,12,9,3
Зестус,galakrond,864,monk,windwalker,18,9,9
Blizò,tarren-mill,864,monk,windwalker,18,9,9
Weaverman,ragnaros,864,monk,windwalker,18,9,9
Snookzlol,aegwynn,864,monk,windwalker,18,9,9
Gankplank,nemesis,864,monk,windwalker,18,9,9
Lrizz,argent-dawn,864,monk,windwalker,18,9,9
Мионелолл,goldrinn,863,monk,windwalker,18,9,9
Otp,hyjal,863,monk,windwalker,18,9,9
Fisty,lightbringer,863,monk,windwalker,24,9,15
Lin,nathrezim,861,monk,windwalker,18,9,9
Monkgol,stormscale,861,monk,windwalker,18,9,9
Joaquuin,sylvanas,855,monk,windwalker,18,9,9
Gidmonk,darkspear,836,monk,windwalker,18,9,9
Брысьли,howling-fjord,828,monk,windwalker,20,10,10
Apprentice,ravencrest,815,monk,windwalker,17,9,8
Bænkai,naxxramas,813,monk,windwalker,17,9,8
Okilexsan,sanguino,797,monk,windwalker,11,9,2
Karatiy,doomhammer,795,monk,windwalker,99,33,66
Shagzy,ravencrest,783,monk,windwalker,11,9,2
Linocence,draenor,775,monk,windwalker,22,10,12
Ðìør,kazzak,768,monk,windwalker,12,8,4
Wladqz,stormscale,768,monk,windwalker,12,8,4
Vajawalkerx,twisting-nether,768,monk,windwalker,12,8,4
Shapzxd,archimonde,768,monk,windwalker,12,8,4
Slayh,archimonde,768,monk,windwalker,12,8,4
Такиера,gordunni,768,monk,windwalker,12,8,4
Eggroll,archimonde,768,monk,windwalker,12,8,4
Karels,archimonde,768,monk,windwalker,12,8,4
Sultanofrizz,draenor,768,monk,windwalker,12,8,4
Shoura,blackmoore,768,monk,windwalker,12,8,4
Fistyfast,hyjal,768,monk,windwalker,12,8,4
Лагвай,gordunni,768,monk,windwalker,12,8,4
Runefists,twisting-nether,768,monk,windwalker,12,8,4
Wonkeed,hyjal,768,monk,windwalker,18,8,10
Laggedfist,kazzak,768,monk,windwalker,18,8,10
Monk,shattered-hand,768,monk,windwalker,18,8,10
Kåtsumi,sanguino,768,monk,windwalker,18,8,10
Gdkz,tarren-mill,768,monk,windwalker,18,8,10
Jeppehmonk,stormscale,768,monk,windwalker,18,8,10
Stÿvww,archimonde,768,monk,windwalker,24,8,16
Yeratel,argent-dawn,768,monk,windwalker,30,8,22
ßibip,hyjal,767,monk,windwalker,14,10,4
Heffertonne,eredar,767,monk,windwalker,12,8,4
Earendil,culte-de-la-rive-noire,767,monk,windwalker,12,8,4
Дыня,gordunni,767,monk,windwalker,12,8,4
Merilwyn,argent-dawn,767,monk,windwalker,12,8,4
Hazzat,nordrassil,767,monk,windwalker,12,8,4
Kneecapper,ravencrest,767,monk,windwalker,18,8,10
Risomonk,blackrock,767,monk,windwalker,18,8,10
Wilywolxx,silvermoon,766,monk,windwalker,12,8,4
Pocaa,arakarahm,766,monk,windwalker,18,8,10
Rollah,ravencrest,765,monk,windwalker,18,8,10
Verfa,twisting-nether,765,monk,windwalker,18,8,10
Kaipo,ragnaros,765,monk,windwalker,24,8,16
Nggz,archimonde,764,monk,windwalker,12,8,4
Czvibuh,drakthul,763,monk,windwalker,24,8,16
Апесиинка,gordunni,758,monk,windwalker,14,8,6
Piedliés,ravencrest,672,monk,windwalker,12,7,5
Potsymist,twisting-nether,672,monk,windwalker,12,7,5
Chiscake,blackrock,672,monk,windwalker,12,7,5
Saodiseng,outland,672,monk,windwalker,12,7,5
Sàlêxz,ysondre,672,monk,windwalker,12,7,5
Chilleê,blackmoore,672,monk,windwalker,12,7,5
Uwuhehe,ravencrest,672,monk,windwalker,12,7,5
Melaz,ravencrest,672,monk,windwalker,12,7,5
Arthanaar,drakthul,672,monk,windwalker,12,7,5
Zenothar,ravencrest,672,monk,windwalker,12,7,5
Bryggarn,draenor,672,monk,windwalker,12,7,5
Dopi,frostmane,672,monk,windwalker,12,7,5
Njursten,twilights-hammer,672,monk,windwalker,12,7,5
Kåýðø,archimonde,672,monk,windwalker,18,7,11
Flowér,auchindoun,672,monk,windwalker,18,7,11
Mefîsto,blackrock,672,monk,windwalker,18,7,11
Galexuz,blackrock,672,monk,windwalker,18,7,11
Волкейн,soulflayer,672,monk,windwalker,18,7,11
Løwping,blackmoore,672,monk,windwalker,18,7,11
Xinxanxonxin,zuljin,672,monk,windwalker,18,7,11
Sonofelrond,twisting-nether,671,monk,windwalker,12,7,5
Chæli,tarren-mill,671,monk,windwalker,12,7,5
Bierdame,blackhand,671,monk,windwalker,12,7,5
Dubhira,blackmoore,671,monk,windwalker,12,7,5
Эзархадон,lich-king,671,monk,windwalker,12,7,5
Discosean,frostmane,671,monk,windwalker,18,7,11
Duches,tarren-mill,671,monk,windwalker,18,7,11
Zhiothe,argent-dawn,670,monk,windwalker,12,7,5
Dummars,ragnaros,670,monk,windwalker,18,7,11
Kirara,talnivarr,668,monk,windwalker,12,7,5
Bal,tyrande,667,monk,windwalker,15,8,7
Fusetonww,tarren-mill,623,monk,windwalker,11,7,4
Rezuz,draenor,576,monk,windwalker,6,6,0
Ferree,tarren-mill,576,monk,windwalker,12,6,6
Ampm,ravencrest,576,monk,windwalker,12,6,6
Yamo,blackrock,576,monk,windwalker,12,6,6
Balance,laughing-skull,576,monk,windwalker,12,6,6
Coollann,drakthul,576,monk,windwalker,12,6,6
Xàrslòulolz,kazzak,576,monk,windwalker,12,6,6
Baltimore,stormscale,576,monk,windwalker,12,6,6
Turbofistsqt,kazzak,576,monk,windwalker,12,6,6
Arshy,silvermoon,576,monk,windwalker,12,6,6
Nyrkkikylpy,ravencrest,576,monk,windwalker,12,6,6
Ijji,argent-dawn,576,monk,windwalker,12,6,6
Fantazero,burning-legion,576,monk,windwalker,12,6,6
Tecisharmony,ravencrest,576,monk,windwalker,12,6,6
Kryzu,ragnaros,576,monk,windwalker,12,6,6
Weezé,outland,576,monk,windwalker,12,6,6
Brüshïë,kazzak,576,monk,windwalker,12,6,6
Gîø,blackmoore,576,monk,windwalker,12,6,6
Luckyjones,tarren-mill,576,monk,windwalker,12,6,6
Miridius,silvermoon,576,monk,windwalker,12,6,6
Niyatî,draenor,576,monk,windwalker,12,6,6
Jollyzug,blackrock,576,monk,windwalker,12,6,6
Купейчик,gordunni,576,monk,windwalker,12,6,6
Geezer,the-maelstrom,576,monk,windwalker,12,6,6
Waaks,archimonde,576,monk,windwalker,12,6,6
Мэрджик,soulflayer,576,monk,windwalker,12,6,6
Cac,argent-dawn,576,monk,windwalker,15,7,8
Däemon,twisting-nether,576,monk,windwalker,15,7,8
Мишадуротар,borean-tundra,576,monk,windwalker,16,7,9
Bbcmonkinc,aegwynn,576,monk,windwalker,16,7,9
Desmî,ravencrest,576,monk,windwalker,18,6,12
Blickx,draenor,576,monk,windwalker,18,6,12
Fiststowin,blackrock,576,monk,windwalker,18,6,12
Norgamx,alakir,576,monk,windwalker,18,6,12
Greytail,argent-dawn,576,monk,windwalker,18,6,12
Кримсон,blackscar,575,monk,windwalker,6,6,0
Woknroll,draenor,575,monk,windwalker,12,6,6
Teetoor,argent-dawn,575,monk,windwalker,12,6,6
Raychi,draenor,575,monk,windwalker,12,6,6
Doreese,moonglade,575,monk,windwalker,12,6,6
Fantasiløs,twisting-nether,575,monk,windwalker,12,6,6
Chiroidz,kazzak,575,monk,windwalker,12,6,6
Patadademijo,tarren-mill,575,monk,windwalker,12,6,6
Iluvatareru,twisting-nether,575,monk,windwalker,12,6,6
Mönchdog,blackmoore,573,monk,windwalker,12,6,6
Mullan,eonar,573,monk,windwalker,24,6,18
Monkiatsu,turalyon,571,monk,windwalker,12,6,6
Cptfist,argent-dawn,543,monk,windwalker,17,6,11
Merjis,stormscale,527,monk,windwalker,11,6,5
Bogey,ragnaros,511,monk,windwalker,14,6,8
Жекадобряк,howling-fjord,503,monk,windwalker,15,7,8
Alandriai,blackmoore,480,monk,windwalker,6,5,1
Kungfuhkyou,tarren-mill,480,monk,windwalker,6,5,1
Zmile,ragnaros,480,monk,windwalker,6,5,1
Larsowns,ragnaros,480,monk,windwalker,6,5,1
Ноупэйн,soulflayer,480,monk,windwalker,6,5,1
Hàtéppl,ravencrest,480,monk,windwalker,6,5,1
Madelnheaven,burning-legion,480,monk,windwalker,6,5,1
Venrea,archimonde,480,monk,windwalker,6,5,1
Jukei,blackmoore,480,monk,windwalker,6,5,1
Noodlesauce,silvermoon,480,monk,windwalker,6,5,1
Fabrina,blackrock,480,monk,windwalker,6,5,1
Kapud,twisting-nether,480,monk,windwalker,6,5,1
Emptyeyés,kazzak,480,monk,windwalker,6,5,1
Killabees,stormscale,480,monk,windwalker,6,5,1
Энвишь,soulflayer,480,monk,windwalker,6,5,1
Nerd,argent-dawn,480,monk,windwalker,12,5,7
Vivvy,argent-dawn,480,monk,windwalker,12,5,7
Kaelwind,burning-legion,480,monk,windwalker,12,5,7
Bimberta,argent-dawn,480,monk,windwalker,12,5,7
Кунфумастер,gordunni,480,monk,windwalker,12,5,7
Onlypressw,tarren-mill,480,monk,windwalker,12,5,7
Archnun,stormscale,480,monk,windwalker,12,5,7
Blyatfast,draenor,480,monk,windwalker,12,5,7
Pîna,onyxia,480,monk,windwalker,12,5,7
Tubørg,ravencrest,480,monk,windwalker,12,5,7
Badcøwboy,archimonde,480,monk,windwalker,12,5,7
Jjslag,stormscale,480,monk,windwalker,12,5,7
Käsefäuste,azshara,480,monk,windwalker,12,5,7
Фортрен,deepholm,480,monk,windwalker,12,5,7
Fistus,dentarg,480,monk,windwalker,12,5,7
Greenshortea,aegwynn,480,monk,windwalker,12,5,7
Nevertouch,blackrock,480,monk,windwalker,12,5,7
Kenjibsen,blackhand,480,monk,windwalker,12,5,7
Investing,silvermoon,480,monk,windwalker,12,5,7
Drfistalot,blackrock,480,monk,windwalker,12,5,7
Mayliene,stormscale,480,monk,windwalker,12,5,7
Diagmonk,kazzak,480,monk,windwalker,12,5,7
Feyzmonk,ysondre,480,monk,windwalker,12,5,7
Enrookiejr,aegwynn,480,monk,windwalker,12,5,7
Akhlÿs,ysondre,480,monk,windwalker,12,5,7
Babyfax,draenor,480,monk,windwalker,12,5,7
Johnsôn,blackmoore,480,monk,windwalker,12,5,7
Мяуки,soulflayer,480,monk,windwalker,12,5,7
Néroburnsred,eredar,480,monk,windwalker,15,6,9
Nicetrybuddy,draenor,480,monk,windwalker,18,5,13
Tetetete,silvermoon,479,monk,windwalker,12,5,7
Øñ,cthun,479,monk,windwalker,18,5,13
Panzeerotto,nemesis,479,monk,windwalker,24,5,19
Khrylx,twisting-nether,473,monk,windwalker,16,10,6
Sadwhi,turalyon,472,monk,windwalker,12,5,7
Martial,arthas,447,monk,windwalker,11,5,6
Lqp,outland,447,monk,windwalker,11,5,6
Камагами,howling-fjord,400,monk,windwalker,7,5,2
Theoalt,dragonblight,399,monk,windwalker,5,5,0
Twinkletoe,twisting-nether,384,monk,windwalker,6,4,2
Clìtfister,silvermoon,384,monk,windwalker,6,4,2
Diagmonk,arathi,384,monk,windwalker,6,4,2
Dadrael,argent-dawn,384,monk,windwalker,6,4,2
Baisi,blackhand,384,monk,windwalker,6,4,2
Thekaj,kazzak,384,monk,windwalker,6,4,2
Windstormcro,ragnaros,384,monk,windwalker,6,4,2
Korié,ravencrest,384,monk,windwalker,6,4,2
Yeol,ravencrest,384,monk,windwalker,6,4,2
Âdonis,twisting-nether,384,monk,windwalker,6,4,2
Màlydôr,outland,384,monk,windwalker,6,4,2
Orênda,silvermoon,384,monk,windwalker,6,4,2
Gramkin,ravencrest,384,monk,windwalker,6,4,2
Orenichi,antonidas,384,monk,windwalker,6,4,2
Bonepalm,kazzak,384,monk,windwalker,6,4,2
Hertel,boulderfist,384,monk,windwalker,6,4,2
Mabkww,ravencrest,384,monk,windwalker,6,4,2
Vetocorleone,kazzak,384,monk,windwalker,6,4,2
Tysonwonka,thrall,384,monk,windwalker,6,4,2
Disciprín,tarren-mill,384,monk,windwalker,6,4,2
Rugys,ravenholdt,384,monk,windwalker,6,4,2
Monkflexi,draenor,384,monk,windwalker,6,4,2
Blazeuu,drakthul,384,monk,windwalker,6,4,2
Palarîns,dalaran,384,monk,windwalker,6,4,2
Емопацан,gordunni,384,monk,windwalker,6,4,2
Vjelan,forscherliga,384,monk,windwalker,6,4,2
Gøøgodx,tarren-mill,384,monk,windwalker,6,4,2
Soulspar,ragnaros,384,monk,windwalker,6,4,2
Quï,hyjal,384,monk,windwalker,6,4,2
Onn,outland,384,monk,windwalker,6,4,2
Tàlo,anachronos,384,monk,windwalker,6,4,2
Вэилэй,gordunni,384,monk,windwalker,6,4,2
Нежненький,gordunni,384,monk,windwalker,6,4,2
Okpm,marécage-de-zangar,384,monk,windwalker,6,4,2
Jafandmeja,tarren-mill,384,monk,windwalker,14,5,9
Räyh,outland,384,monk,windwalker,12,4,8
Bigkim,khadgar,384,monk,windwalker,12,4,8
Mwoinesamdi,hyjal,384,monk,windwalker,12,4,8
Крэйзимедвед,howling-fjord,384,monk,windwalker,12,4,8
Sori,mazrigos,384,monk,windwalker,12,4,8
Ragobd,argent-dawn,384,monk,windwalker,12,4,8
Jessie,bloodscalp,384,monk,windwalker,12,4,8
Goremancey,draenor,384,monk,windwalker,12,4,8
Dëvilliä,ragnaros,384,monk,windwalker,12,4,8
Байтли,gordunni,384,monk,windwalker,12,4,8
Scribzz,twisting-nether,384,monk,windwalker,12,4,8
Aesthetìc,draenor,384,monk,windwalker,12,4,8
Risingspud,frostmane,384,monk,windwalker,12,4,8
Кириешек,deathguard,384,monk,windwalker,12,4,8
Andrah,blackmoore,384,monk,windwalker,12,4,8
Salt,suramar,384,monk,windwalker,12,4,8
Blutáar,khazgoroth,384,monk,windwalker,12,4,8
Bbinzu,lothar,383,monk,windwalker,6,4,2
Jayline,kazzak,383,monk,windwalker,12,4,8
Югэн,azuregos,383,monk,windwalker,12,4,8
Morslee,burning-legion,382,monk,windwalker,16,6,10
Broussly,voljin,380,monk,windwalker,12,4,8
Youngmonk,tarren-mill,351,monk,windwalker,17,4,13
Benkkei,ysondre,336,monk,windwalker,15,4,11
Choje,blackmoore,319,monk,windwalker,5,4,1
Alë,argent-dawn,319,monk,windwalker,8,4,4
Bg,blackhand,288,monk,windwalker,6,3,3
Ðoom,sylvanas,288,monk,windwalker,6,3,3
Daltailr,silvermoon,288,monk,windwalker,6,3,3
Dennismansix,sylvanas,288,monk,windwalker,6,3,3
Zunixxww,terrordar,288,monk,windwalker,6,3,3
Arisua,blackhand,288,monk,windwalker,6,3,3
Joshxao,blackmoore,288,monk,windwalker,6,3,3
Iluvfistinjk,sylvanas,288,monk,windwalker,6,3,3
Расселкроу,galakrond,288,monk,windwalker,6,3,3
Sajin,la-croisade-écarlate,288,monk,windwalker,6,3,3
Авентусс,howling-fjord,288,monk,windwalker,6,3,3
Koot,ragnaros,288,monk,windwalker,6,3,3
Aljabbar,ravencrest,288,monk,windwalker,6,3,3
Mutah,arathor,288,monk,windwalker,6,3,3
Zenified,ragnaros,288,monk,windwalker,6,3,3
Droozy,silvermoon,288,monk,windwalker,6,3,3
Realfighter,arathor,288,monk,windwalker,6,3,3
Kungf,twisting-nether,288,monk,windwalker,6,3,3
Dasjinso,blackhand,288,monk,windwalker,6,3,3
Zelraqt,burning-steppes,288,monk,windwalker,6,3,3
Zìnko,eredar,288,monk,windwalker,6,3,3
Рендикаое,soulflayer,288,monk,windwalker,6,3,3
Jakfuki,ragnaros,288,monk,windwalker,6,3,3
Traxxus,sanguino,288,monk,windwalker,6,3,3
Lørðbrøñkø,blackrock,288,monk,windwalker,6,3,3
Zéná,gilneas,288,monk,windwalker,6,3,3
Monkacek,drakthul,288,monk,windwalker,6,3,3
Bigfistah,tarren-mill,288,monk,windwalker,6,3,3
Hästgodx,the-maelstrom,288,monk,windwalker,6,3,3
Lokregar,blackmoore,288,monk,windwalker,6,3,3
Pabu,emeriss,288,monk,windwalker,6,3,3
Mezz,ahnqiraj,288,monk,windwalker,6,3,3
Ybnobama,outland,288,monk,windwalker,6,3,3
Tjmnk,ravencrest,288,monk,windwalker,6,3,3
Räpeltäjä,stormreaver,288,monk,windwalker,6,3,3
Aaronm,tarren-mill,288,monk,windwalker,6,3,3
Qdwdwqerdads,ravencrest,288,monk,windwalker,6,3,3
Aslêyia,antonidas,288,monk,windwalker,6,3,3
Tinjihn,magtheridon,288,monk,windwalker,6,3,3
Azangar,kazzak,288,monk,windwalker,6,3,3
Nightingalê,silvermoon,288,monk,windwalker,6,3,3
Sizok,blackmoore,288,monk,windwalker,6,3,3
Velduin,dun-modr,288,monk,windwalker,6,3,3
Ratfacè,outland,288,monk,windwalker,6,3,3
Adewelee,dalaran,288,monk,windwalker,6,3,3
Balkanbeastt,draenor,288,monk,windwalker,10,4,6
Clamps,darkspear,288,monk,windwalker,12,3,9
Cøbrakaï,archimonde,288,monk,windwalker,12,3,9
Dòrâ,archimonde,288,monk,windwalker,12,3,9
Monkiki,hyjal,288,monk,windwalker,12,3,9
Barylen,outland,288,monk,windwalker,12,3,9
Халиосфа,gordunni,288,monk,windwalker,12,3,9
Mönchfatih,blackhand,288,monk,windwalker,12,3,9
Geliôs,kazzak,288,monk,windwalker,12,3,9
Elababe,ravencrest,288,monk,windwalker,12,3,9
Votbo,kazzak,288,monk,windwalker,12,3,9
Roxmonk,ravencrest,288,monk,windwalker,12,3,9
Ayyee,blackmoore,288,monk,windwalker,18,3,15
Lewimoäne,khaz-modan,287,monk,windwalker,6,3,3
Brucilli,dalaran,287,monk,windwalker,6,3,3
Syaóran,exodar,286,monk,windwalker,12,3,9
Пкмлкм,gordunni,255,monk,windwalker,11,3,8
Dolkenm,tarren-mill,240,monk,windwalker,9,4,5
Iamzra,kazzak,239,monk,windwalker,11,3,8
Trolleurz,archimonde,224,monk,windwalker,16,3,13
Bignessb,draenor,192,monk,windwalker,4,3,1
Idointcare,ravencrest,192,monk,windwalker,4,3,1
Kano,burning-legion,192,monk,windwalker,9,3,6
Såliten,tarren-mill,192,monk,windwalker,6,2,4
Legeend,dun-modr,192,monk,windwalker,6,2,4
Jamiedhism,ravencrest,192,monk,windwalker,6,2,4
Akkadianx,ravencrest,192,monk,windwalker,6,2,4
Stenhård,azjolnerub,192,monk,windwalker,6,2,4
Geochi,tarren-mill,192,monk,windwalker,6,2,4
Loriodas,tarren-mill,192,monk,windwalker,6,2,4
Awesomebrah,the-maelstrom,192,monk,windwalker,6,2,4
Îreful,tarren-mill,192,monk,windwalker,6,2,4
Bensil,ravencrest,192,monk,windwalker,6,2,4
Brewroll,ravencrest,192,monk,windwalker,6,2,4
Джийви,goldrinn,192,monk,windwalker,6,2,4
Friidam,lightbringer,192,monk,windwalker,6,2,4
Bloodychi,ravencrest,192,monk,windwalker,6,2,4
Fistingfury,burning-blade,192,monk,windwalker,6,2,4
Yaxleyx,dragonblight,192,monk,windwalker,6,2,4
Musclorww,ysondre,192,monk,windwalker,6,2,4
Mcflaïe,ysondre,192,monk,windwalker,6,2,4
Khirazim,ysondre,192,monk,windwalker,6,2,4
Enjàz,sylvanas,192,monk,windwalker,6,2,4
Tjukkas,bloodhoof,192,monk,windwalker,6,2,4
Frajer,auchindoun,192,monk,windwalker,6,2,4
Savecdfornxt,blackmoore,192,monk,windwalker,6,2,4
Bobthewild,draenor,192,monk,windwalker,6,2,4
Latify,todeswache,192,monk,windwalker,6,2,4
Andyww,doomhammer,192,monk,windwalker,6,2,4
Woalter,silvermoon,192,monk,windwalker,6,2,4
Eynodiggity,blackmoore,192,monk,windwalker,6,2,4
Mtmonk,tarren-mill,192,monk,windwalker,6,2,4
Tayoo,aegwynn,192,monk,windwalker,6,2,4
Ревенджж,howling-fjord,192,monk,windwalker,6,2,4
Dodoglad,hyjal,192,monk,windwalker,6,2,4
Lollonko,kazzak,192,monk,windwalker,6,2,4
Belobe,stormscale,192,monk,windwalker,6,2,4
Xoconut,ravencrest,192,monk,windwalker,6,2,4
Dianly,ravencrest,192,monk,windwalker,6,2,4
Miamausebär,blackmoore,192,monk,windwalker,6,2,4
Майамибитч,howling-fjord,192,monk,windwalker,6,2,4
Mezeko,stormscale,192,monk,windwalker,6,2,4
Orcword,ragnaros,192,monk,windwalker,6,2,4
Joachi,outland,192,monk,windwalker,6,2,4
Drýton,blackrock,192,monk,windwalker,6,2,4
Effeots,blackrock,192,monk,windwalker,6,2,4
Zýru,ragnaros,192,monk,windwalker,6,2,4
Howkong,archimonde,192,monk,windwalker,6,2,4
Walterwayne,blackrock,192,monk,windwalker,6,2,4
Bamboosnack,kazzak,192,monk,windwalker,6,2,4
Мистерхюй,gordunni,192,monk,windwalker,12,2,10
Tongat,ravencrest,192,monk,windwalker,12,2,10
Тифуя,gordunni,192,monk,windwalker,12,2,10
Соловьюх,gordunni,191,monk,windwalker,6,2,4
Yianjih,blackmoore,191,monk,windwalker,6,2,4
Roptoglad,hyjal,159,monk,windwalker,5,2,3
Ahlu,argent-dawn,144,monk,windwalker,9,2,7
Ktrina,ravencrest,138,monk,windwalker,9,4,5
Dìó,tarren-mill,96,monk,windwalker,6,1,5
Mìcrøb,blackmoore,96,monk,windwalker,6,1,5
Kickboxer,burning-legion,96,monk,windwalker,6,1,5
Drlightorc,tarren-mill,96,monk,windwalker,6,1,5
Bluum,ravencrest,96,monk,windwalker,6,1,5
Umbrâsyl,ravencrest,96,monk,windwalker,6,1,5
Немонахх,howling-fjord,96,monk,windwalker,6,1,5
Zugzuwg,ahnqiraj,96,monk,windwalker,6,1,5
Olgachocolat,blackmoore,96,monk,windwalker,6,1,5
Тиронфлакс,soulflayer,96,monk,windwalker,6,1,5
Kinføu,hyjal,96,monk,windwalker,6,1,5
Синнэрли,soulflayer,96,monk,windwalker,6,1,5
Kaizenthor,runetotem,96,monk,windwalker,6,1,5
Olympeá,silvermoon,96,monk,windwalker,6,1,5
Konnîchîwa,kazzak,96,monk,windwalker,6,1,5
Mjaweaver,stormscale,96,monk,windwalker,6,1,5
Жъёь,howling-fjord,96,monk,windwalker,6,1,5
Lîlpumpx,outland,96,monk,windwalker,6,1,5
Butrinto,hellfire,96,monk,windwalker,6,1,5
Реброперо,gordunni,96,monk,windwalker,6,1,5
Ilovecravmag,draenor,96,monk,windwalker,6,1,5
Bâsarä,archimonde,96,monk,windwalker,6,1,5
Мяяумяу,gordunni,96,monk,windwalker,6,1,5
Betelgeuse,jaedenar,96,monk,windwalker,6,1,5
Бумчака,blackscar,96,monk,windwalker,6,1,5
Smâsh,blackhand,96,monk,windwalker,6,1,5
Dadeldo,blackrock,96,monk,windwalker,6,1,5
Musaya,chamber-of-aspects,96,monk,windwalker,6,1,5
Embodimonk,twisting-nether,96,monk,windwalker,6,1,5
Onisakebi,nemesis,96,monk,windwalker,10,1,9
Xtcc,kazzak,79,monk,windwalker,5,1,4
Odanobunaga,ravencrest,79,monk,windwalker,5,1,4
Огненныйкит,blackscar,48,monk,windwalker,3,1,2
Xámell,ravencrest,48,monk,windwalker,3,1,2
Scedadle,outland,48,monk,windwalker,3,1,2
Shamarinator,kazzak,42,monk,windwalker,9,2,7
Åbx,argent-dawn,2191,paladin,holy,113,59,54
Crewxdlolz,frostmane,2123,paladin,holy,211,118,93
Likkik,ravencrest,2121,paladin,holy,86,42,44
Wiriday,draenor,2097,paladin,holy,246,124,122
Ranchiek,ravencrest,2019,paladin,holy,60,31,29
Lickssi,outland,2001,paladin,holy,94,56,38
Goyimslayer,ravencrest,1967,paladin,holy,84,47,37
Kyoma,burning-legion,1929,paladin,holy,99,47,52
Jìmjim,ysondre,1916,paladin,holy,114,53,61
Svyata,twisting-nether,1883,paladin,holy,71,38,33
Måvé,tarren-mill,1872,paladin,holy,78,45,33
Tipmax,ravencrest,1856,paladin,holy,61,37,24
Goodpeace,kazzak,1855,paladin,holy,73,35,38
Niwariel,silvermoon,1852,paladin,holy,60,37,23
Типмакс,howling-fjord,1851,paladin,holy,42,25,17
Wheelybin,argent-dawn,1843,paladin,holy,53,23,30
Pêacerainer,stormscale,1840,paladin,holy,126,52,74
Optîmuslîme,veklor,1835,paladin,holy,42,27,15
Nemesisbot,dun-modr,1835,paladin,holy,48,28,20
Seabrook,stormscale,1825,paladin,holy,72,29,43
Phalphlingo,stormscale,1824,paladin,holy,84,40,44
Jeø,stormscale,1823,paladin,holy,54,28,26
Eldorín,blackmoore,1823,paladin,holy,54,20,34
Vaîjin,aegwynn,1820,paladin,holy,89,42,47
Kianpal,silvermoon,1818,paladin,holy,158,89,69
Galaxys,blackhand,1818,paladin,holy,128,62,66
Neverlostx,ravencrest,1816,paladin,holy,48,31,17
Popecrusade,archimonde,1813,paladin,holy,107,66,41
Ránchìek,ravencrest,1812,paladin,holy,54,26,28
Runtheshôw,tarren-mill,1790,paladin,holy,72,34,38
Гигашмяк,howling-fjord,1777,paladin,holy,96,54,42
Jûliâ,archimonde,1777,paladin,holy,88,49,39
Edelarøs,ysondre,1771,paladin,holy,54,27,27
Aww,anachronos,1770,paladin,holy,108,51,57
Pignonn,dalaran,1762,paladin,holy,62,34,28
Valia,argent-dawn,1754,paladin,holy,63,36,27
Welivewewin,defias-brotherhood,1752,paladin,holy,127,64,63
Wokyo,tarren-mill,1749,paladin,holy,190,110,80
Holysacx,aegwynn,1745,paladin,holy,42,25,17
Rettyfield,blackrock,1744,paladin,holy,42,23,19
Powertilt,ravencrest,1743,paladin,holy,123,55,68
Wollymolly,ravencrest,1741,paladin,holy,60,30,30
Everflame,blackmoore,1739,paladin,holy,84,50,34
Dbblou,draenor,1739,paladin,holy,42,20,22
Vindîcator,defias-brotherhood,1736,paladin,holy,191,91,100
Лайтпалочка,soulflayer,1731,paladin,holy,167,85,82
Аришалисичка,blackscar,1727,paladin,holy,70,36,34
Rekieuna,archimonde,1725,paladin,holy,306,157,149
Holylightxz,runetotem,1717,paladin,holy,75,36,39
Tyrsa,defias-brotherhood,1715,paladin,holy,53,23,30
Faíren,mugthol,1697,paladin,holy,66,36,30
Pointguard,blackrock,1696,paladin,holy,36,20,16
Emlight,kazzak,1693,paladin,holy,53,32,21
Акунделар,gordunni,1689,paladin,holy,119,59,60
Алексендлер,howling-fjord,1684,paladin,holy,188,94,94
Lycerax,antonidas,1676,paladin,holy,30,19,11
Voklane,tarren-mill,1676,paladin,holy,48,23,25
Holysac,aegwynn,1669,paladin,holy,48,26,22
Emloses,outland,1661,paladin,holy,96,50,46
Narkal,archimonde,1653,paladin,holy,63,33,30
Itsjulie,sylvanas,1648,paladin,holy,58,29,29
Макстипчик,howling-fjord,1647,paladin,holy,45,22,23
Tibelious,ravencrest,1646,paladin,holy,60,22,38
Kakii,gorgonnash,1645,paladin,holy,59,24,35
Skyf,outland,1641,paladin,holy,155,72,83
Holychît,sanguino,1631,paladin,holy,111,53,58
Baazil,ragnaros,1631,paladin,holy,84,38,46
Insanevegan,ravencrest,1628,paladin,holy,66,33,33
Holeck,aegwynn,1627,paladin,holy,66,26,40
Thaderyl,auchindoun,1618,paladin,holy,78,34,44
Blazerlolz,kazzak,1616,paladin,holy,60,33,27
Nezâ,thrall,1613,paladin,holy,52,23,29
Buntqt,kazzak,1612,paladin,holy,100,54,46
Острит,gordunni,1605,paladin,holy,78,45,33
Джонниджага,blackscar,1604,paladin,holy,58,28,30
Lexó,ravencrest,1604,paladin,holy,42,20,22
Hirolde,zenedar,1601,paladin,holy,116,60,56
Judgejuryexe,kazzak,1600,paladin,holy,92,44,48
Fannypoo,sylvanas,1596,paladin,holy,95,43,52
Сэлфхил,gordunni,1591,paladin,holy,107,47,60
Erathoor,grim-batol,1589,paladin,holy,66,32,34
Astollfo,hyjal,1588,paladin,holy,42,26,16
Shabbyy,bronzebeard,1588,paladin,holy,78,43,35
Ìschtarsdad,blackrock,1588,paladin,holy,180,90,90
Smightypal,silvermoon,1582,paladin,holy,123,62,61
Xenyaa,arygos,1581,paladin,holy,103,53,50
Andûrîl,tarren-mill,1576,paladin,holy,89,42,47
Грор,galakrond,1565,paladin,holy,34,21,13
Tuoppi,steamwheedle-cartel,1562,paladin,holy,29,17,12
Isøri,antonidas,1562,paladin,holy,96,45,51
Blessedpapi,draenor,1561,paladin,holy,48,26,22
Потокденег,howling-fjord,1554,paladin,holy,92,40,52
Skurly,ragnaros,1551,paladin,holy,42,19,23
Rëtnuhka,drakthul,1546,paladin,holy,47,24,23
Алукартик,deathguard,1546,paladin,holy,89,44,45
Myssa,uldum,1545,paladin,holy,36,18,18
Strûgglebûs,outland,1543,paladin,holy,47,25,22
Срувтапкизз,blackscar,1543,paladin,holy,83,29,54
Chosenlight,darkspear,1542,paladin,holy,60,21,39
Тошанич,soulflayer,1539,paladin,holy,54,24,30
Gasilol,frostwolf,1537,paladin,holy,81,41,40
Aíe,draenor,1536,paladin,holy,45,28,17
Andronar,blackmoore,1536,paladin,holy,66,29,37
Rùfus,tarren-mill,1531,paladin,holy,96,51,45
Pooncy,ragnaros,1530,paladin,holy,60,27,33
Athenewins,tarren-mill,1528,paladin,holy,352,182,170
Бадбх,howling-fjord,1527,paladin,holy,90,39,51
Флэшкапро,soulflayer,1521,paladin,holy,190,95,95
Callístó,amanthul,1521,paladin,holy,169,78,91
Arenalena,sylvanas,1520,paladin,holy,150,74,76
Drdeus,kazzak,1518,paladin,holy,86,42,44
Dàrckness,ravencrest,1514,paladin,holy,180,94,86
Sonil,les-sentinelles,1507,paladin,holy,57,24,33
Nåmï,culte-de-la-rive-noire,1501,paladin,holy,30,18,12
Easypala,blackrock,1500,paladin,holy,96,37,59
Aese,dun-modr,1499,paladin,holy,102,51,51
Arysur,defias-brotherhood,1498,paladin,holy,162,72,90
Delmothounet,ysondre,1496,paladin,holy,46,28,18
Bécasszelium,varimathras,1495,paladin,holy,123,64,59
Xsÿde,archimonde,1489,paladin,holy,48,17,31
Mitsaklas,grim-batol,1488,paladin,holy,56,25,31
Chocòbon,archimonde,1487,paladin,holy,36,21,15
Devinèqt,tarren-mill,1481,paladin,holy,43,24,19
Curtfizzle,kazzak,1478,paladin,holy,59,26,33
Présidential,grim-batol,1477,paladin,holy,42,22,20
Sübôvîñ,ravencrest,1472,paladin,holy,63,32,31
Hpal,aegwynn,1469,paladin,holy,93,42,51
Injection,khaz-modan,1464,paladin,holy,69,32,37
Jajmentx,kazzak,1459,paladin,holy,78,40,38
Dathróhán,silvermoon,1455,paladin,holy,231,115,116
Lóde,silvermoon,1454,paladin,holy,84,42,42
Глиндес,gordunni,1453,paladin,holy,150,72,78
Realpalla,ravenholdt,1452,paladin,holy,126,62,64
Marygueguete,archimonde,1449,paladin,holy,60,27,33
Enemylosers,stormscale,1448,paladin,holy,60,30,30
Skinstructor,silvermoon,1448,paladin,holy,36,18,18
Scrimple,stormscale,1447,paladin,holy,73,35,38
Mercedes,arthas,1443,paladin,holy,35,20,15
Fourshaw,ravencrest,1442,paladin,holy,113,54,59
Паладинас,lich-king,1440,paladin,holy,64,21,43
Deodas,kazzak,1438,paladin,holy,124,55,69
Уретроград,soulflayer,1436,paladin,holy,72,36,36
Zabrok,outland,1433,paladin,holy,30,15,15
Ðeswynd,hyjal,1432,paladin,holy,44,19,25
Dömötörp,ragnaros,1430,paladin,holy,63,28,35
Sacbøt,stormscale,1427,paladin,holy,259,132,127
Ekzykes,ravencrest,1427,paladin,holy,48,21,27
Taiso,alonsus,1422,paladin,holy,132,64,68
Hazø,silvermoon,1418,paladin,holy,42,24,18
Phalex,outland,1416,paladin,holy,36,23,13
Preyy,eredar,1414,paladin,holy,54,30,24
Хегия,gordunni,1414,paladin,holy,30,15,15
Zilu,kazzak,1413,paladin,holy,47,24,23
Blazeberg,tirion,1411,paladin,holy,36,20,16
Сашафистинг,gordunni,1411,paladin,holy,159,77,82
Wíw,kazzak,1410,paladin,holy,60,24,36
Ðenlox,destromath,1408,paladin,holy,104,53,51
Xenaké,kazzak,1405,paladin,holy,80,31,49
Hotub,twisting-nether,1404,paladin,holy,77,40,37
Салфеточник,thermaplugg,1403,paladin,holy,60,23,37
Аяпал,blackscar,1401,paladin,holy,72,39,33
Эсерпи,gordunni,1400,paladin,holy,118,61,57
Watras,drakthul,1400,paladin,holy,36,15,21
Витёнокь,howling-fjord,1394,paladin,holy,44,29,15
Реколори,gordunni,1389,paladin,holy,165,90,75
Diamir,rajaxx,1388,paladin,holy,71,52,19
Kantfyrste,ravencrest,1388,paladin,holy,139,59,80
Stinkepieet,blackmoore,1387,paladin,holy,42,17,25
Noliferx,ravencrest,1383,paladin,holy,82,49,33
Zycqo,silvermoon,1377,paladin,holy,174,84,90
Леонящер,gordunni,1376,paladin,holy,150,80,70
Vivalabeef,stormscale,1374,paladin,holy,42,18,24
Cykadin,dun-modr,1372,paladin,holy,54,20,34
Maitrelampe,argent-dawn,1369,paladin,holy,72,34,38
Alldo,drakthul,1366,paladin,holy,66,30,36
Locofatguy,drakthul,1366,paladin,holy,60,26,34
Mecah,hyjal,1365,paladin,holy,42,21,21
Jambbo,twisting-nether,1364,paladin,holy,85,44,41
Зондарк,booty-bay,1364,paladin,holy,53,22,31
Pullheavy,silvermoon,1363,paladin,holy,89,38,51
Xelqt,draenor,1361,paladin,holy,36,15,21
Ramos,aggra-português,1357,paladin,holy,54,19,35
Shakalol,dun-modr,1355,paladin,holy,60,23,37
Itsgossiplol,twisting-nether,1352,paladin,holy,119,59,60
Heilgaharald,blackrock,1351,paladin,holy,110,51,59
Nde,silvermoon,1351,paladin,holy,41,18,23
Fenye,twisting-nether,1351,paladin,holy,51,22,29
Снупарь,blackscar,1351,paladin,holy,45,18,27
Mikemyers,blackhand,1350,paladin,holy,42,20,22
Crusherpala,laughing-skull,1348,paladin,holy,71,28,43
Arlette,moonglade,1345,paladin,holy,72,32,40
Jerryhârvey,kazzak,1342,paladin,holy,24,14,10
Keele,stormscale,1341,paladin,holy,69,32,37
Freaak,dethecus,1337,paladin,holy,60,24,36
Valkhana,draenor,1336,paladin,holy,46,27,19
Sangriul,outland,1336,paladin,holy,93,37,56
Думгохан,howling-fjord,1336,paladin,holy,36,14,22
Pussdocta,ravencrest,1334,paladin,holy,72,38,34
Бэнкли,soulflayer,1332,paladin,holy,30,19,11
Steggeh,argent-dawn,1331,paladin,holy,120,48,72
Rotana,eredar,1328,paladin,holy,18,14,4
Lightbrîng,hyjal,1327,paladin,holy,53,26,27
Кольт,borean-tundra,1324,paladin,holy,73,36,37
Danepala,defias-brotherhood,1322,paladin,holy,29,15,14
Эллиарэй,gordunni,1321,paladin,holy,30,14,16
Kristelle,argent-dawn,1319,paladin,holy,30,14,16
Jcbubs,xavius,1318,paladin,holy,30,14,16
Lastaid,azshara,1318,paladin,holy,104,47,57
Neyd,hyjal,1314,paladin,holy,60,21,39
Erao,the-maelstrom,1313,paladin,holy,36,14,22
Emistesía,stormscale,1312,paladin,holy,36,14,22
Necrozi,stormscale,1311,paladin,holy,60,35,25
Agadin,ysondre,1310,paladin,holy,35,19,16
Bigfailure,blackmoore,1309,paladin,holy,65,21,44
Лимфома,goldrinn,1307,paladin,holy,53,18,35
Skengdaddy,ragnaros,1306,paladin,holy,84,39,45
Nudzolini,tarren-mill,1300,paladin,holy,30,17,13
Strudell,terrordar,1294,paladin,holy,47,26,21
Elohim,echsenkessel,1293,paladin,holy,142,64,78
Kerven,doomhammer,1293,paladin,holy,42,16,26
Daizen,blackrock,1289,paladin,holy,61,41,20
Polydeukis,stormscale,1288,paladin,holy,78,29,49
Алекхей,gordunni,1282,paladin,holy,66,28,38
Satipal,sargeras,1280,paladin,holy,93,36,57
Demecir,twisting-nether,1279,paladin,holy,172,84,88
Ggiwastheret,kazzak,1277,paladin,holy,23,14,9
Bovinequeef,twisting-nether,1272,paladin,holy,30,15,15
Mestgone,dalaran,1270,paladin,holy,42,15,27
Alard,sanguino,1269,paladin,holy,78,31,47
Uzuriel,chogall,1268,paladin,holy,280,126,154
Делатор,gordunni,1267,paladin,holy,48,22,26
Tyktyk,draenor,1264,paladin,holy,30,17,13
Regis,dragonblight,1264,paladin,holy,61,34,27
Tíep,blackmoore,1262,paladin,holy,71,36,35
Pajtash,doomhammer,1261,paladin,holy,59,29,30
Badckes,sylvanas,1261,paladin,holy,58,21,37
Pigpiss,ravencrest,1260,paladin,holy,34,14,20
Amolan,drakthul,1259,paladin,holy,39,24,15
Bloodsoldier,twisting-nether,1258,paladin,holy,88,45,43
Kapikøoqt,suramar,1257,paladin,holy,98,54,44
Kaitlyne,tarren-mill,1252,paladin,holy,91,46,45
Анбели,gordunni,1252,paladin,holy,60,24,36
Goodbit,dentarg,1250,paladin,holy,30,17,13
Hogma,hyjal,1250,paladin,holy,36,14,22
Ginbeam,aegwynn,1248,paladin,holy,60,29,31
Papasito,tarren-mill,1245,paladin,holy,42,13,29
Dawnforged,stormscale,1244,paladin,holy,60,28,32
Hawki,blackmoore,1240,paladin,holy,18,13,5
Demonskiller,alakir,1240,paladin,holy,83,44,39
Kayndornek,ravencrest,1240,paladin,holy,54,25,29
Neithi,twisting-nether,1238,paladin,holy,42,20,22
Ostardo,blackhand,1237,paladin,holy,18,13,5
Pupsihasi,kelthuzad,1237,paladin,holy,29,16,13
Skailzpal,hyjal,1236,paladin,holy,36,21,15
Pablok,minahonda,1236,paladin,holy,42,13,29
Aelly,hyjal,1235,paladin,holy,30,17,13
Wingcomandêr,aegwynn,1235,paladin,holy,30,13,17
Nerdpallyx,tarren-mill,1234,paladin,holy,30,13,17
Jarroshdin,stormscale,1232,paladin,holy,60,38,22
Farata,ravencrest,1230,paladin,holy,160,78,82
Wrathlol,ravencrest,1230,paladin,holy,143,67,76
Vadomar,emerald-dream,1230,paladin,holy,36,13,23
Hîfi,blackmoore,1227,paladin,holy,124,66,58
Mozzie,archimonde,1227,paladin,holy,66,26,40
Emilíá,kazzak,1223,paladin,holy,24,13,11
Ritiv,stormreaver,1219,paladin,holy,72,30,42
Fleny,thrall,1215,paladin,holy,24,13,11
Paladins,archimonde,1214,paladin,holy,38,20,18
Weserwehr,laughing-skull,1214,paladin,holy,54,27,27
Ромерл,gordunni,1210,paladin,holy,211,97,114
Stuzzyy,ravencrest,1209,paladin,holy,36,16,20
Jaezlin,tarren-mill,1207,paladin,holy,124,66,58
Rébél,argent-dawn,1206,paladin,holy,42,17,25
Keryann,argent-dawn,1205,paladin,holy,102,51,51
Skolisse,kazzak,1203,paladin,holy,81,42,39
Xastur,rexxar,1201,paladin,holy,33,17,16
Boric,bloodhoof,1184,paladin,holy,29,16,13
Crispydixx,draenor,1183,paladin,holy,59,29,30
Baubble,silvermoon,1181,paladin,holy,24,14,10
Ugolf,kazzak,1178,paladin,holy,30,14,16
Shiidori,aegwynn,1175,paladin,holy,57,23,34
Rhulana,blackrock,1171,paladin,holy,50,32,18
Toradin,thunderhorn,1167,paladin,holy,27,13,14
Pokébowl,outland,1166,paladin,holy,30,14,16
Puiçanpal,archimonde,1163,paladin,holy,30,15,15
Ragua,tarren-mill,1159,paladin,holy,60,23,37
Kaki,gorgonnash,1151,paladin,holy,18,12,6
Wedervärdig,twilights-hammer,1151,paladin,holy,54,23,31
Lrnz,tarren-mill,1151,paladin,holy,30,12,18
Lezoom,draenor,1150,paladin,holy,47,24,23
Haylø,archimonde,1150,paladin,holy,24,12,12
Chryme,thrall,1149,paladin,holy,18,12,6
Алексендлерх,soulflayer,1149,paladin,holy,18,12,6
Catali,sanguino,1149,paladin,holy,99,50,49
Мифариан,blackscar,1147,paladin,holy,24,12,12
Elsewhere,archimonde,1146,paladin,holy,30,12,18
Lightmamba,draenor,1146,paladin,holy,42,13,29
Rookbeef,eredar,1145,paladin,holy,18,12,6
Quezkal,dun-modr,1144,paladin,holy,39,18,21
Leon,veknilash,1144,paladin,holy,93,39,54
Faildin,arathor,1142,paladin,holy,63,27,36
Коварное,borean-tundra,1141,paladin,holy,24,12,12
Gromezrael,elune,1141,paladin,holy,42,19,23
Cadila,silvermoon,1141,paladin,holy,42,19,23
Archaegis,silvermoon,1141,paladin,holy,30,12,18
Talimañ,kazzak,1140,paladin,holy,18,12,6
Holymax,gorgonnash,1140,paladin,holy,30,17,13
Konane,drekthar,1139,paladin,holy,31,12,19
Trisunonvaki,khazgoroth,1137,paladin,holy,114,58,56
Taraniah,argent-dawn,1137,paladin,holy,54,27,27
Minouminou,archimonde,1136,paladin,holy,24,13,11
Strykar,aggra-português,1136,paladin,holy,36,17,19
Kambood,twisting-nether,1134,paladin,holy,141,60,81
Jasiv,draenor,1132,paladin,holy,36,14,22
Trístesse,tarren-mill,1129,paladin,holy,94,46,48
Expot,blackmoore,1128,paladin,holy,24,12,12
Fleshoflight,arathor,1127,paladin,holy,72,26,46
Zebramann,silvermoon,1121,paladin,holy,48,20,28
Serim,dun-modr,1119,paladin,holy,54,23,31
Guidone,sylvanas,1116,paladin,holy,30,13,17
Kanina,outland,1114,paladin,holy,58,23,35
Tscheba,kazzak,1109,paladin,holy,82,42,40
Holyppower,frostmane,1109,paladin,holy,29,12,17
Unithral,durotan,1107,paladin,holy,24,12,12
Minui,onyxia,1100,paladin,holy,30,12,18
Xray,ahnqiraj,1099,paladin,holy,23,12,11
Deathsfate,defias-brotherhood,1095,paladin,holy,21,12,9
Nosn,ravencrest,1087,paladin,holy,66,34,32
Johnaggro,outland,1087,paladin,holy,34,15,19
Dabstar,antonidas,1086,paladin,holy,88,41,47
Zerfleddern,aegwynn,1083,paladin,holy,89,42,47
Кейлол,soulflayer,1083,paladin,holy,27,12,15
Ðuïvel,grim-batol,1076,paladin,holy,28,12,16
Palanolmal,dun-modr,1068,paladin,holy,33,16,17
Áftershøck,ravencrest,1056,paladin,holy,24,11,13
Casmira,blackrock,1055,paladin,holy,18,11,7
Jeromesavile,tarren-mill,1055,paladin,holy,24,11,13
Дарксайгн,gordunni,1054,paladin,holy,36,11,25
Swâpxy,proudmoore,1053,paladin,holy,18,11,7
Heyley,twisting-nether,1053,paladin,holy,18,11,7
Çrúsader,frostmane,1053,paladin,holy,24,14,10
Neverbuble,archimonde,1053,paladin,holy,30,11,19
Kaktuszfüge,ragnaros,1052,paladin,holy,58,35,23
Emistesia,stormscale,1050,paladin,holy,24,11,13
Truthbearer,darksorrow,1050,paladin,holy,28,12,16
Vintar,quelthalas,1047,paladin,holy,48,26,22
Rekolon,garrosh,1047,paladin,holy,42,16,26
Honeygodx,antonidas,1043,paladin,holy,18,11,7
Cmen,silvermoon,1043,paladin,holy,109,54,55
Babybeater,outland,1043,paladin,holy,37,14,23
Grimbold,hellfire,1042,paladin,holy,18,11,7
Vuup,silvermoon,1039,paladin,holy,18,11,7
Karnwield,kirin-tor,1039,paladin,holy,34,16,18
Øsirix,archimonde,1038,paladin,holy,42,18,24
Kuhs,eredar,1038,paladin,holy,59,23,36
Flashyplays,silvermoon,1037,paladin,holy,30,21,9
Флаила,ashenvale,1031,paladin,holy,30,17,13
Billkop,silvermoon,1030,paladin,holy,43,20,23
Høpé,malganis,1028,paladin,holy,68,32,36
Mjølnîr,eredar,1025,paladin,holy,36,12,24
Drohim,aegwynn,1022,paladin,holy,22,11,11
Perpon,exodar,1017,paladin,holy,24,11,13
Darhuun,antonidas,1012,paladin,holy,60,23,37
Palir,ysondre,1010,paladin,holy,24,11,13
Golldy,burning-legion,1008,paladin,holy,21,12,9
Paliester,stormscale,1007,paladin,holy,18,12,6
Ланиакеа,deathguard,1007,paladin,holy,24,12,12
Alastrr,hyjal,1006,paladin,holy,27,13,14
Dunka,twisting-nether,1003,paladin,holy,100,52,48
Echooes,ravencrest,994,paladin,holy,158,65,93
Satip,archimonde,993,paladin,holy,36,22,14
Паландис,howling-fjord,990,paladin,holy,24,11,13
Poundcake,stormscale,990,paladin,holy,68,30,38
Buddy,conseil-des-ombres,988,paladin,holy,50,24,26
Marik,argent-dawn,987,paladin,holy,17,11,6
Legenda,grim-batol,979,paladin,holy,30,14,16
Psycholas,ysondre,969,paladin,holy,23,11,12
Purificatoru,draenor,966,paladin,holy,30,13,17
Rafox,malygos,964,paladin,holy,42,17,25
Byoß,ravencrest,960,paladin,holy,18,10,8
Ajani,la-croisade-écarlate,960,paladin,holy,24,10,14
Femaleelf,eredar,959,paladin,holy,18,10,8
Norandel,turalyon,959,paladin,holy,24,10,14
Umirinbruv,zenedar,959,paladin,holy,26,10,16
Lofotof,silvermoon,958,paladin,holy,12,10,2
Herayo,aegwynn,958,paladin,holy,24,10,14
Whórainzóne,eredar,958,paladin,holy,36,10,26
Elians,outland,955,paladin,holy,24,10,14
Crusadelight,alakir,953,paladin,holy,80,35,45
Roshï,tarren-mill,953,paladin,holy,30,10,20
Keltinne,ysondre,952,paladin,holy,18,10,8
Bcrp,ragnaros,950,paladin,holy,30,10,20
Ударник,soulflayer,949,paladin,holy,48,25,23
Skwáru,burning-legion,949,paladin,holy,24,10,14
Sweestance,minahonda,949,paladin,holy,30,10,20
Cmelacek,wildhammer,948,paladin,holy,18,10,8
Lightmachine,kirin-tor,945,paladin,holy,12,10,2
Datz,nerathor,943,paladin,holy,24,10,14
Paliat,silvermoon,943,paladin,holy,25,10,15
Groove,colinas-pardas,941,paladin,holy,34,11,23
Messîah,outland,939,paladin,holy,43,19,24
Clerik,eredar,934,paladin,holy,64,30,34
Thickets,argent-dawn,934,paladin,holy,24,10,14
Manole,ravencrest,933,paladin,holy,29,12,17
Yasmira,frostmourne,930,paladin,holy,30,16,14
Paladons,darksorrow,926,paladin,holy,35,19,16
Gabriev,twisting-nether,925,paladin,holy,14,11,3
Миллагрессия,soulflayer,917,paladin,holy,107,46,61
Tömmÿ,draenor,915,paladin,holy,36,15,21
Эвердрим,soulflayer,906,paladin,holy,29,12,17
Reeceboss,ravencrest,906,paladin,holy,29,12,17
Öbedö,malganis,902,paladin,holy,27,10,17
Veléxis,outland,900,paladin,holy,19,11,8
Nykothpn,ghostlands,899,paladin,holy,54,18,36
Яполковник,gordunni,887,paladin,holy,53,30,23
Theisixtus,drakthul,883,paladin,holy,23,12,11
Pisr,draenor,864,paladin,holy,18,9,9
Мылонеуроних,deathguard,864,paladin,holy,18,9,9
Powerpufgirl,blackrock,863,paladin,holy,18,9,9
Дезоиль,gordunni,863,paladin,holy,18,9,9
Рэймета,soulflayer,861,paladin,holy,18,9,9
Ashbrìnger,aegwynn,861,paladin,holy,18,9,9
Ampoula,ravencrest,861,paladin,holy,18,9,9
Niou,alleria,861,paladin,holy,24,9,15
Smirk,aggra-português,857,paladin,holy,12,9,3
Elganwar,hyjal,856,paladin,holy,18,9,9
Kocovic,tarren-mill,855,paladin,holy,24,9,15
Burkaal,antonidas,852,paladin,holy,24,9,15
Фломастер,gordunni,851,paladin,holy,18,9,9
Qyrija,malganis,845,paladin,holy,18,9,9
Fract,aggramar,838,paladin,holy,18,9,9
Veelris,kazzak,825,paladin,holy,72,33,39
Ridethelight,nemesis,823,paladin,holy,18,9,9
Odensson,sylvanas,823,paladin,holy,30,9,21
Salubrifie,archimonde,817,paladin,holy,18,9,9
Thaifo,silvermoon,814,paladin,holy,15,10,5
Syrenia,die-silberne-hand,814,paladin,holy,40,9,31
Chantal,gilneas,813,paladin,holy,30,12,18
Pölark,archimonde,790,paladin,holy,41,14,27
Kaleto,ragnaros,773,paladin,holy,22,10,12
Meldi,dalaran,768,paladin,holy,12,8,4
Mðnsterz,archimonde,768,paladin,holy,18,8,10
Derpe,hellscream,768,paladin,holy,18,8,10
Percocetx,tarren-mill,768,paladin,holy,24,8,16
Crucifiction,balnazzar,768,paladin,holy,24,8,16
Böllerbarbie,silvermoon,767,paladin,holy,12,8,4
Curufin,grim-batol,767,paladin,holy,12,8,4
Qpax,twisting-nether,767,paladin,holy,18,8,10
Micrøsi,thrall,767,paladin,holy,18,8,10
Claudîax,kazzak,767,paladin,holy,18,8,10
Cozm,silvermoon,767,paladin,holy,18,8,10
Ванябублгам,soulflayer,767,paladin,holy,18,8,10
Asenae,draenor,767,paladin,holy,24,8,16
Dunutunicorn,argent-dawn,766,paladin,holy,12,8,4
Bezvakost,thunderhorn,766,paladin,holy,18,8,10
Coopz,defias-brotherhood,765,paladin,holy,18,8,10
Bighammerx,ravencrest,765,paladin,holy,18,8,10
Спэнсэр,gordunni,764,paladin,holy,12,8,4
Ikbenmani,tarren-mill,760,paladin,holy,18,8,10
Galadørn,elune,760,paladin,holy,24,8,16
Jaesa,lordaeron,735,paladin,holy,17,8,9
Anemonaa,argent-dawn,722,paladin,holy,18,8,10
Áfx,blackmoore,714,paladin,holy,38,14,24
Churrucuca,minahonda,713,paladin,holy,15,9,6
Gegge,kazzak,701,paladin,holy,32,8,24
Haros,xavius,686,paladin,holy,13,8,5
Kárlsberg,aegwynn,683,paladin,holy,32,13,19
Gtgpiscine,kirin-tor,672,paladin,holy,12,7,5
Shamoo,archimonde,672,paladin,holy,12,7,5
Ирестли,azuregos,672,paladin,holy,12,7,5
Istani,twisting-nether,672,paladin,holy,18,7,11
Whatisapalla,ragnaros,672,paladin,holy,18,7,11
Fleshgraft,drakthul,672,paladin,holy,18,7,11
Máttés,antonidas,672,paladin,holy,18,7,11
Faíren,blackrock,672,paladin,holy,18,7,11
Daddysiliam,ravencrest,671,paladin,holy,12,7,5
Tepowze,twisting-nether,671,paladin,holy,12,7,5
Tiffanyqt,frostwolf,671,paladin,holy,12,7,5
Skatiaringos,silvermoon,671,paladin,holy,18,7,11
Mohamedx,tarren-mill,671,paladin,holy,18,7,11
Pârabellum,the-maelstrom,670,paladin,holy,18,7,11
Skarn,pozzo-delleternità,670,paladin,holy,18,7,11
Lènnja,baelgun,670,paladin,holy,18,7,11
Seinz,talnivarr,668,paladin,holy,18,7,11
Edwín,tichondrius,667,paladin,holy,12,7,5
Luminix,ragnaros,667,paladin,holy,12,7,5
Warkyria,sanguino,665,paladin,holy,19,8,11
Juicemachine,silvermoon,663,paladin,holy,12,7,5
Mowik,archimonde,662,paladin,holy,24,7,17
Langibo,malfurion,658,paladin,holy,12,7,5
Ázot,burning-legion,656,paladin,holy,24,7,17
Jüther,pozzo-delleternità,623,paladin,holy,17,7,10
Торсгард,howling-fjord,622,paladin,holy,15,8,7
Meive,sanguino,622,paladin,holy,17,7,10
Ubiquitous,kazzak,606,paladin,holy,17,7,10
Rezilience,archimonde,576,paladin,holy,6,6,0
Dogmatic,blackmoore,576,paladin,holy,12,6,6
Jinyssa,silvermoon,576,paladin,holy,12,6,6
Verlinya,archimonde,576,paladin,holy,12,6,6
Nádrüstál,kazzak,576,paladin,holy,12,6,6
Ben,ghostlands,576,paladin,holy,12,6,6
Bapêe,thrall,576,paladin,holy,12,6,6
Kiingen,ragnaros,576,paladin,holy,12,6,6
Holypapa,argent-dawn,576,paladin,holy,12,6,6
Holyfuchsia,ravencrest,576,paladin,holy,12,6,6
Sheldon,sylvanas,576,paladin,holy,12,6,6
Рустиктоп,gordunni,576,paladin,holy,12,6,6
Cerinae,tarren-mill,576,paladin,holy,15,6,9
Язвавгорле,soulflayer,576,paladin,holy,18,6,12
Westranspal,ravencrest,576,paladin,holy,18,6,12
Elfaza,uldum,576,paladin,holy,24,6,18
Подлыйдим,fordragon,576,paladin,holy,24,6,18
Amôn,outland,576,paladin,holy,28,6,22
Matagladis,dun-modr,575,paladin,holy,12,6,6
Dragonwingz,kazzak,575,paladin,holy,12,6,6
Pussas,burning-legion,575,paladin,holy,18,6,12
Нинтендо,grom,575,paladin,holy,18,6,12
Холиэвил,gordunni,575,paladin,holy,18,6,12
Lichbörnè,outland,575,paladin,holy,18,6,12
Elsirosel,dun-modr,574,paladin,holy,12,6,6
Jeyløl,antonidas,574,paladin,holy,12,6,6
Darthdin,stormscale,572,paladin,holy,12,6,6
Santtox,dun-modr,572,paladin,holy,22,7,15
Jessìca,ravenholdt,571,paladin,holy,12,6,6
Кизарыч,galakrond,528,paladin,holy,27,6,21
Heavel,thrall,527,paladin,holy,17,6,11
Ðelusion,sanguino,480,paladin,holy,6,5,1
Teksor,frostmourne,480,paladin,holy,6,5,1
Cunix,draenor,480,paladin,holy,6,5,1
Shockhoe,tarren-mill,480,paladin,holy,12,5,7
Demytxx,silvermoon,480,paladin,holy,12,5,7
Bossedin,aszune,480,paladin,holy,12,5,7
Holydeals,silvermoon,480,paladin,holy,12,5,7
Spinne,tarren-mill,480,paladin,holy,12,5,7
Stepsislana,tarren-mill,480,paladin,holy,12,5,7
Morthiel,burning-blade,480,paladin,holy,12,5,7
Аффикстинка,soulflayer,480,paladin,holy,12,5,7
Wepalapvpbop,ravencrest,480,paladin,holy,12,5,7
Zunis,jaedenar,480,paladin,holy,12,5,7
Fluentx,ravencrest,480,paladin,holy,12,5,7
Lexolex,ravencrest,480,paladin,holy,12,5,7
Alennya,dalaran,480,paladin,holy,12,5,7
Gayestpala,ravencrest,480,paladin,holy,12,5,7
Fluv,ravencrest,480,paladin,holy,12,5,7
Лайхтни,gordunni,480,paladin,holy,12,5,7
Padrak,eredar,480,paladin,holy,12,5,7
Snoogléface,grim-batol,480,paladin,holy,14,5,9
Zymotíx,stormscale,480,paladin,holy,18,5,13
Holydhanas,outland,480,paladin,holy,18,5,13
Гола,gordunni,480,paladin,holy,18,5,13
Omgimapala,kazzak,480,paladin,holy,20,5,15
Tarhal,guldan,479,paladin,holy,6,5,1
Dreamwatcher,outland,479,paladin,holy,12,5,7
Ninko,sylvanas,479,paladin,holy,12,5,7
Stinkytoes,draenor,479,paladin,holy,12,5,7
Sixtynien,outland,479,paladin,holy,12,5,7
Liadry,sylvanas,479,paladin,holy,12,5,7
Малимон,soulflayer,479,paladin,holy,12,5,7
Paluladin,turalyon,479,paladin,holy,12,5,7
Gavril,bloodfeather,479,paladin,holy,12,5,7
Мэйр,howling-fjord,479,paladin,holy,12,5,7
Руслаанеш,soulflayer,479,paladin,holy,12,5,7
Brøadway,eredar,479,paladin,holy,12,5,7
Лазуриса,deathguard,479,paladin,holy,12,5,7
Sultaani,ravencrest,479,paladin,holy,18,5,13
Vulgati,kazzak,479,paladin,holy,18,5,13
Bellamy,vashj,479,paladin,holy,18,5,13
Bubblegum,dentarg,478,paladin,holy,18,5,13
Kaedena,kaelthas,476,paladin,holy,12,5,7
Menagron,tarren-mill,476,paladin,holy,13,5,8
Styflor,dalaran,476,paladin,holy,18,5,13
Bjammin,burning-legion,474,paladin,holy,18,5,13
Jargot,antonidas,472,paladin,holy,12,5,7
Лералучшая,gordunni,464,paladin,holy,19,7,12
Árcangel,minahonda,447,paladin,holy,17,5,12
Memewings,tarren-mill,426,paladin,holy,17,7,10
Тейдехан,gordunni,426,paladin,holy,21,6,15
Eastranspal,ravencrest,426,paladin,holy,24,6,18
Cerseï,frostmane,425,paladin,holy,23,6,17
Ralo,shattrath,415,paladin,holy,16,5,11
Chewwaka,bloodhoof,384,paladin,holy,6,4,2
Lapew,eredar,384,paladin,holy,6,4,2
Elp,ysondre,384,paladin,holy,6,4,2
Bloednicht,dentarg,384,paladin,holy,6,4,2
Первыйпал,blackscar,384,paladin,holy,6,4,2
Wiffy,ravencrest,384,paladin,holy,6,4,2
Dragg,kirin-tor,384,paladin,holy,6,4,2
Rikiji,ravencrest,384,paladin,holy,6,4,2
Chopocrisp,dun-modr,384,paladin,holy,6,4,2
Jokkepaappa,darksorrow,384,paladin,holy,6,4,2
Holydawnx,kazzak,384,paladin,holy,6,4,2
Yimnotprot,ravencrest,384,paladin,holy,6,4,2
Visersion,tarren-mill,384,paladin,holy,12,4,8
Нетораре,howling-fjord,384,paladin,holy,12,4,8
Shívah,auchindoun,384,paladin,holy,12,4,8
Freý,ravencrest,384,paladin,holy,12,4,8
Lianndrin,blackhand,384,paladin,holy,12,4,8
Tyrø,ravencrest,384,paladin,holy,12,4,8
Hammarfall,ravencrest,384,paladin,holy,12,4,8
Vânwêêd,thrall,384,paladin,holy,12,4,8
Imitrex,hyjal,384,paladin,holy,12,4,8
Sebatrøz,ravencrest,384,paladin,holy,12,4,8
Stratarxis,kazzak,384,paladin,holy,12,4,8
Pâmê,kazzak,384,paladin,holy,12,4,8
Fedaikin,stormscale,384,paladin,holy,12,4,8
Дэнриэль,howling-fjord,384,paladin,holy,12,4,8
Eline,zenedar,384,paladin,holy,12,4,8
Psikatchuu,hyjal,384,paladin,holy,12,4,8
Dimetrix,stormscale,384,paladin,holy,12,4,8
Gloonî,blackmoore,384,paladin,holy,18,4,14
Талрэн,howling-fjord,384,paladin,holy,18,4,14
Гниленький,razuvious,384,paladin,holy,24,4,20
Tôra,hyjal,383,paladin,holy,6,4,2
Paidi,die-todeskrallen,383,paladin,holy,9,4,5
Anfe,silvermoon,383,paladin,holy,12,4,8
Maxôr,norgannon,383,paladin,holy,12,4,8
Caumon,los-errantes,383,paladin,holy,12,4,8
Кэлви,blackscar,383,paladin,holy,12,4,8
Superpaladin,draenor,383,paladin,holy,18,4,14
Scissors,dun-morogh,383,paladin,holy,18,4,14
Palafrugell,sanguino,382,paladin,holy,6,4,2
Zetla,khaz-modan,382,paladin,holy,12,4,8
Avengilo,silvermoon,382,paladin,holy,12,4,8
Nêkro,dun-modr,382,paladin,holy,18,4,14
Konpala,blackmoore,367,paladin,holy,11,4,7
Justyowx,archimonde,352,paladin,holy,16,5,11
Pepegasensei,ravencrest,330,paladin,holy,7,5,2
Zeret,twisting-nether,329,paladin,holy,16,6,10
Ysnee,sanguino,320,paladin,holy,16,4,12
Tyn,dragonmaw,288,paladin,holy,6,3,3
Breez,die-aldor,288,paladin,holy,6,3,3
Irefutabila,stormscale,288,paladin,holy,6,3,3
Tacodin,blackrock,288,paladin,holy,6,3,3
Zondãn,blackrock,288,paladin,holy,6,3,3
Zunis,ravencrest,288,paladin,holy,6,3,3
Kherathan,argent-dawn,288,paladin,holy,6,3,3
Wäsabi,khaz-modan,288,paladin,holy,6,3,3
Bandrogina,shattered-hand,288,paladin,holy,6,3,3
Demytx,burning-legion,288,paladin,holy,6,3,3
Vôltuxx,outland,288,paladin,holy,6,3,3
Kiwia,burning-legion,288,paladin,holy,6,3,3
Lunalovesyou,blackmoore,288,paladin,holy,6,3,3
Solumon,gorgonnash,288,paladin,holy,6,3,3
Бладиполи,soulflayer,288,paladin,holy,6,3,3
Preamx,blackrock,288,paladin,holy,6,3,3
Rohanan,blackrock,288,paladin,holy,6,3,3
Вивай,howling-fjord,288,paladin,holy,6,3,3
Grafes,sanguino,288,paladin,holy,6,3,3
Reeley,drakthul,288,paladin,holy,6,3,3
Krayzier,nordrassil,288,paladin,holy,12,3,9
Tyraïa,archimonde,288,paladin,holy,12,3,9
Влажныйбоб,soulflayer,288,paladin,holy,12,3,9
Гуэргос,gordunni,288,paladin,holy,12,3,9
Kapsloch,twisting-nether,288,paladin,holy,12,3,9
Brölin,sanguino,288,paladin,holy,12,3,9
Jctp,ravencrest,288,paladin,holy,12,3,9
Rezvaya,tarren-mill,288,paladin,holy,12,3,9
Kelmarr,blackmoore,288,paladin,holy,12,3,9
Zerohour,kilrogg,288,paladin,holy,12,3,9
Telarii,die-nachtwache,288,paladin,holy,12,3,9
Linxo,argent-dawn,288,paladin,holy,12,3,9
Bigdamjudge,argent-dawn,288,paladin,holy,12,3,9
Mythsion,blackmoore,288,paladin,holy,12,3,9
Сакон,borean-tundra,288,paladin,holy,12,3,9
Arbuzno,draenor,288,paladin,holy,12,3,9
Кузнейц,borean-tundra,288,paladin,holy,14,3,11
Heldarim,ysondre,288,paladin,holy,18,3,15
Palolog,burning-legion,288,paladin,holy,18,3,15
Kaelorian,silvermoon,288,paladin,holy,18,3,15
Макспал,lich-king,287,paladin,holy,6,3,3
Averyholycow,the-maelstrom,287,paladin,holy,6,3,3
Toxií,argent-dawn,287,paladin,holy,12,3,9
Kcore,blackrock,287,paladin,holy,12,3,9
Даурия,soulflayer,287,paladin,holy,12,3,9
Европпа,soulflayer,271,paladin,holy,16,3,13
Gaskohle,blackmoore,255,paladin,holy,11,3,8
Xaérulus,draenor,239,paladin,holy,5,3,2
Xila,blackrock,234,paladin,holy,9,4,5
Mustardio,tarren-mill,234,paladin,holy,14,4,10
Dewastør,blackmoore,234,paladin,holy,15,4,11
Battalgazi,azjolnerub,233,paladin,holy,17,5,12
Faranume,sylvanas,233,paladin,holy,16,4,12
Ниссида,blackscar,224,paladin,holy,10,3,7
Мускатер,gordunni,192,paladin,holy,6,2,4
Truko,frostwolf,192,paladin,holy,6,2,4
Ришардебюр,soulflayer,192,paladin,holy,6,2,4
Envli,ragnaros,192,paladin,holy,6,2,4
Aranael,nemesis,192,paladin,holy,6,2,4
Benedikt,stormscale,192,paladin,holy,6,2,4
Прожектор,gordunni,192,paladin,holy,6,2,4
Poonky,dun-modr,192,paladin,holy,6,2,4
Chusterb,draenor,192,paladin,holy,6,2,4
Pátish,terenas,192,paladin,holy,6,2,4
Edyk,silvermoon,192,paladin,holy,6,2,4
Edgï,confrérie-du-thorium,192,paladin,holy,6,2,4
Galadrion,dun-modr,192,paladin,holy,6,2,4
Lompe,karazhan,192,paladin,holy,6,2,4
Elrack,blackhand,192,paladin,holy,6,2,4
Дюве,blackscar,192,paladin,holy,6,2,4
Бэдмэн,deathguard,192,paladin,holy,6,2,4
Durnell,sylvanas,192,paladin,holy,6,2,4
Míxu,stormreaver,192,paladin,holy,6,2,4
Rulîx,blackmoore,192,paladin,holy,6,2,4
Pagadi,blackhand,192,paladin,holy,6,2,4
Alisonquínn,defias-brotherhood,192,paladin,holy,6,2,4
Bígmachine,draenor,192,paladin,holy,6,2,4
Léinãd,kazzak,192,paladin,holy,6,2,4
Calipse,outland,192,paladin,holy,6,2,4
Паблойд,deathguard,192,paladin,holy,6,2,4
Realdeal,argent-dawn,192,paladin,holy,6,2,4
Rdypaladin,ravencrest,192,paladin,holy,6,2,4
Conker,malganis,192,paladin,holy,6,2,4
Padraic,scarshield-legion,192,paladin,holy,6,2,4
Lafrogge,culte-de-la-rive-noire,192,paladin,holy,6,2,4
Teflonmagìc,ravencrest,192,paladin,holy,6,2,4
Nirvanä,drakthul,192,paladin,holy,6,2,4
Холидугги,howling-fjord,192,paladin,holy,12,2,10
Ztiina,tarren-mill,192,paladin,holy,12,2,10
Silvers,steamwheedle-cartel,192,paladin,holy,12,2,10
Leadfoot,argent-dawn,192,paladin,holy,12,2,10
Пауэрлайт,blackscar,192,paladin,holy,12,2,10
Zeleron,darksorrow,192,paladin,holy,12,2,10
Essina,argent-dawn,192,paladin,holy,12,2,10
Croptol,dun-modr,192,paladin,holy,12,2,10
Кирюшафридом,gordunni,192,paladin,holy,13,2,11
Schrikii,archimonde,192,paladin,holy,18,2,16
Eky,stormreaver,192,paladin,holy,18,2,16
Harycon,thrall,192,paladin,holy,24,2,22
Tiboeufpéi,archimonde,191,paladin,holy,6,2,4
Zuplex,deathwing,191,paladin,holy,6,2,4
Àkí,blackmoore,191,paladin,holy,6,2,4
Chasie,antonidas,191,paladin,holy,12,2,10
Droseros,sylvanas,175,paladin,holy,23,2,21
Кукусяшка,gordunni,159,paladin,holy,8,2,6
Pïñkñætðøðÿ,tarren-mill,138,paladin,holy,14,3,11
Paladzor,twisting-nether,128,paladin,holy,4,2,2
Aéther,quelthalas,96,paladin,holy,3,2,1
Синерина,blackscar,96,paladin,holy,6,1,5
Bubbleheart,ahnqiraj,96,paladin,holy,6,1,5
Flashhèart,draenor,96,paladin,holy,6,1,5
Minirempart,khaz-modan,96,paladin,holy,6,1,5
Bubblebun,kazzak,96,paladin,holy,6,1,5
Holysheto,sanguino,96,paladin,holy,6,1,5
Enriel,temple-noir,96,paladin,holy,6,1,5
Playprist,aegwynn,96,paladin,holy,6,1,5
Dedicatèd,draenor,96,paladin,holy,6,1,5
Wingcomander,aegwynn,96,paladin,holy,6,1,5
Aienest,ragnaros,96,paladin,holy,6,1,5
Andrøiz,dun-modr,96,paladin,holy,6,1,5
Elfaza,dun-modr,96,paladin,holy,6,1,5
Agorasieya,frostwolf,96,paladin,holy,6,1,5
Holyfalls,blackmoore,96,paladin,holy,6,1,5
Acongojante,zuljin,96,paladin,holy,6,1,5
Iamyellow,silvermoon,96,paladin,holy,6,1,5
Ахрониус,soulflayer,96,paladin,holy,6,1,5
Whiskeypal,draenor,96,paladin,holy,6,1,5
Switchflip,frostmane,96,paladin,holy,6,1,5
Colpadeltank,kazzak,96,paladin,holy,6,1,5
Shanik,zuljin,96,paladin,holy,6,1,5
Хочусметанки,howling-fjord,96,paladin,holy,6,1,5
Fükdîscláss,ravencrest,96,paladin,holy,6,1,5
Mybadvibes,tarren-mill,96,paladin,holy,6,1,5
Penth,doomhammer,96,paladin,holy,6,1,5
Демига,ashenvale,96,paladin,holy,6,1,5
Bittersweex,stormscale,96,paladin,holy,6,1,5
Zerafic,sylvanas,96,paladin,holy,6,1,5
Rehtu,malganis,96,paladin,holy,6,1,5
Xephiroxus,the-venture-co,96,paladin,holy,6,1,5
Dobbygotsock,kazzak,96,paladin,holy,6,1,5
Aggressìon,twisting-nether,96,paladin,holy,6,1,5
Înphy,cthun,96,paladin,holy,6,1,5
Shiøn,zuljin,96,paladin,holy,6,1,5
Goldenstern,blackhand,96,paladin,holy,12,1,11
Lunaary,antonidas,96,paladin,holy,12,1,11
Hasler,drakthul,96,paladin,holy,12,1,11
Pigma,outland,96,paladin,holy,12,1,11
Fúrion,burning-blade,96,paladin,holy,12,1,11
Лейфи,howling-fjord,96,paladin,holy,12,1,11
Callon,das-syndikat,95,paladin,holy,6,1,5
Hitaki,tarren-mill,64,paladin,holy,4,1,3
Holymerda,grim-batol,42,paladin,holy,8,2,6
Waltgyubeef,argent-dawn,42,paladin,holy,9,2,7
Zeiserig,antonidas,42,paladin,holy,11,2,9
Stracciatell,archimonde,2177,paladin,retribution,79,64,15
Cosmicstâr,kazzak,2177,paladin,retribution,119,63,56
Steelsuit,argent-dawn,2132,paladin,retribution,176,98,78
Ðâny,elune,2128,paladin,retribution,135,68,67
Аеррис,gordunni,2106,paladin,retribution,113,57,56
Pïkachû,ravencrest,2105,paladin,retribution,60,33,27
Bigspin,ravencrest,2097,paladin,retribution,120,65,55
Miilicium,archimonde,2091,paladin,retribution,83,41,42
Peiker,blackrock,2073,paladin,retribution,112,54,58
Ricexoxo,blackhand,2066,paladin,retribution,98,48,50
Elypsia,tarren-mill,2058,paladin,retribution,104,53,51
Mýstíc,ravencrest,2049,paladin,retribution,118,56,62
Nedith,pozzo-delleternità,2047,paladin,retribution,132,71,61
Davewins,dragonblight,2033,paladin,retribution,42,34,8
Ufø,magtheridon,2025,paladin,retribution,96,48,48
Miriokekw,archimonde,2020,paladin,retribution,96,45,51
Sacredwrath,burning-legion,2017,paladin,retribution,59,30,29
Аполодориан,gordunni,2012,paladin,retribution,102,56,46
Royki,the-maelstrom,2009,paladin,retribution,126,61,65
Kazuroo,blackmoore,2005,paladin,retribution,78,44,34
Xourens,twisting-nether,2003,paladin,retribution,73,33,40
Nastalia,elune,1996,paladin,retribution,48,31,17
Drkp,blackrock,1993,paladin,retribution,49,32,17
Retwar,ravencrest,1986,paladin,retribution,77,49,28
Sonne,tarren-mill,1985,paladin,retribution,72,36,36
Xillindion,blackhand,1984,paladin,retribution,164,84,80
Qshadow,frostwhisper,1984,paladin,retribution,76,36,40
Bernhoftxd,ravencrest,1981,paladin,retribution,140,65,75
Nîhil,silvermoon,1977,paladin,retribution,82,39,43
Нейтхигерс,howling-fjord,1974,paladin,retribution,83,43,40
Sitekx,burning-legion,1968,paladin,retribution,99,45,54
Отловщик,gordunni,1966,paladin,retribution,64,34,30
Bigdblaster,twisting-nether,1965,paladin,retribution,96,47,49
Jowanno,stormscale,1958,paladin,retribution,95,49,46
Monkeytm,archimonde,1957,paladin,retribution,58,27,31
Antou,twisting-nether,1952,paladin,retribution,207,105,102
Wingsteak,draenor,1951,paladin,retribution,75,41,34
Vadya,ravencrest,1947,paladin,retribution,71,41,30
Мрч,howling-fjord,1947,paladin,retribution,60,31,29
Синодх,eversong,1943,paladin,retribution,95,42,53
Ctierpala,ravencrest,1940,paladin,retribution,66,32,34
Günykoloke,blackrock,1939,paladin,retribution,54,33,21
Bersercute,sylvanas,1939,paladin,retribution,96,48,48
Kriszi,burning-legion,1938,paladin,retribution,90,39,51
Pâsla,hyjal,1936,paladin,retribution,119,64,55
Syruplol,blackrock,1932,paladin,retribution,58,32,26
Mezor,dun-modr,1932,paladin,retribution,84,42,42
Агинон,gordunni,1921,paladin,retribution,48,25,23
Harridin,ravencrest,1917,paladin,retribution,66,33,33
Phix,outland,1913,paladin,retribution,147,74,73
Yungboihoj,twisting-nether,1905,paladin,retribution,155,78,77
Mcret,ravencrest,1904,paladin,retribution,76,34,42
Rígel,silvermoon,1899,paladin,retribution,58,35,23
Legodudex,ravencrest,1898,paladin,retribution,66,33,33
Ðeathron,blackmoore,1898,paladin,retribution,128,62,66
Brassaren,stormscale,1890,paladin,retribution,67,36,31
Carlá,silvermoon,1890,paladin,retribution,73,37,36
Pancakee,the-maelstrom,1889,paladin,retribution,66,32,34
Толвард,gordunni,1881,paladin,retribution,25,21,4
Tj,sanguino,1881,paladin,retribution,42,20,22
Bakawolf,burning-legion,1879,paladin,retribution,66,32,34
Saygexx,draenor,1875,paladin,retribution,57,34,23
Стимулин,howling-fjord,1874,paladin,retribution,60,33,27
Shinøaa,wrathbringer,1873,paladin,retribution,53,31,22
Crysania,twisting-nether,1872,paladin,retribution,60,27,33
Msharix,kazzak,1871,paladin,retribution,48,29,19
Zerørespect,ravencrest,1868,paladin,retribution,101,45,56
Vabz,blackrock,1867,paladin,retribution,47,23,24
Дэнискарз,gordunni,1866,paladin,retribution,48,26,22
Thyrec,blackmoore,1865,paladin,retribution,54,32,22
Yungboii,kazzak,1864,paladin,retribution,83,53,30
Лиспорий,gordunni,1862,paladin,retribution,48,24,24
Swahadon,stormscale,1862,paladin,retribution,60,29,31
Freshreroll,tarren-mill,1860,paladin,retribution,48,30,18
Melantus,eredar,1855,paladin,retribution,53,27,26
Smirk,aggra-português,1855,paladin,retribution,72,33,39
Vanthael,chamber-of-aspects,1853,paladin,retribution,201,115,86
Alphaladin,stormscale,1852,paladin,retribution,54,31,23
Jicob,ravencrest,1851,paladin,retribution,48,30,18
Zion,runetotem,1851,paladin,retribution,42,25,17
Dasar,twisting-nether,1851,paladin,retribution,72,31,41
Súnshìne,blackhand,1850,paladin,retribution,42,29,13
Pallyprinces,dentarg,1850,paladin,retribution,60,25,35
Pætter,aggra-português,1849,paladin,retribution,60,34,26
Nein,blackhand,1848,paladin,retribution,102,47,55
Мевар,gordunni,1847,paladin,retribution,48,21,27
Dibzi,argent-dawn,1845,paladin,retribution,54,27,27
Djstompyamom,stormscale,1845,paladin,retribution,99,47,52
Risingfi,kult-der-verdammten,1844,paladin,retribution,78,47,31
Milkyavenger,sylvanas,1843,paladin,retribution,77,53,24
Astilia,sylvanas,1843,paladin,retribution,84,43,41
Palior,sylvanas,1841,paladin,retribution,54,31,23
Hornyret,kazzak,1839,paladin,retribution,96,46,50
Mayhemx,ravencrest,1838,paladin,retribution,154,74,80
Стьюпидбой,howling-fjord,1837,paladin,retribution,131,66,65
Мидэас,gordunni,1837,paladin,retribution,72,35,37
Yuber,ravencrest,1833,paladin,retribution,78,34,44
Анофарин,gordunni,1832,paladin,retribution,66,31,35
Hódle,silvermoon,1831,paladin,retribution,42,29,13
Daybreak,kazzak,1831,paladin,retribution,57,30,27
Ilòvekris,draenor,1830,paladin,retribution,183,93,90
Декионзхц,howling-fjord,1830,paladin,retribution,78,29,49
Ðaegos,blackmoore,1829,paladin,retribution,107,49,58
Hojinson,blackrock,1828,paladin,retribution,48,34,14
Denastys,nemesis,1827,paladin,retribution,72,31,41
Holzer,azshara,1826,paladin,retribution,65,35,30
Tremelay,silvermoon,1825,paladin,retribution,240,122,118
Eimaqt,stormscale,1825,paladin,retribution,70,33,37
Cqt,ravencrest,1823,paladin,retribution,66,30,36
Fullsendbro,ravencrest,1821,paladin,retribution,48,29,19
Beautýbeast,ravencrest,1821,paladin,retribution,65,32,33
Lorex,grim-batol,1821,paladin,retribution,54,26,28
Foreskinx,draenor,1819,paladin,retribution,42,25,17
Номос,soulflayer,1819,paladin,retribution,72,41,31
Arígato,argent-dawn,1819,paladin,retribution,173,95,78
Дюрьвючыф,razuvious,1819,paladin,retribution,143,74,69
Âtlas,ragnaros,1819,paladin,retribution,48,24,24
Nìcky,stormscale,1819,paladin,retribution,83,37,46
Bulkpwders,burning-legion,1818,paladin,retribution,42,20,22
Taurski,sylvanas,1817,paladin,retribution,48,35,13
Thedarksteel,ravencrest,1817,paladin,retribution,70,34,36
Angryturk,ravencrest,1816,paladin,retribution,36,19,17
Prex,dun-modr,1816,paladin,retribution,60,31,29
Фемдом,blackscar,1814,paladin,retribution,48,27,21
Morri,ravencrest,1814,paladin,retribution,171,83,88
Durenai,aegwynn,1814,paladin,retribution,119,53,66
Сотранокинг,soulflayer,1813,paladin,retribution,30,19,11
Spacknas,blackmoore,1813,paladin,retribution,54,32,22
Déna,draenor,1813,paladin,retribution,52,29,23
Ktk,ravencrest,1813,paladin,retribution,121,67,54
Martoretard,archimonde,1813,paladin,retribution,190,92,98
Granfort,argent-dawn,1813,paladin,retribution,114,55,59
Rankoneretri,arathor,1812,paladin,retribution,30,19,11
Skyrose,ravencrest,1812,paladin,retribution,132,73,59
Doomsoom,kazzak,1810,paladin,retribution,34,26,8
Коварное,borean-tundra,1810,paladin,retribution,66,36,30
Halevia,kazzak,1810,paladin,retribution,53,26,27
Делимнаноль,blackscar,1809,paladin,retribution,90,46,44
Zscrew,nemesis,1807,paladin,retribution,30,19,11
Охоху,gordunni,1807,paladin,retribution,89,52,37
Nizzlee,eredar,1807,paladin,retribution,54,30,24
Réaxon,archimonde,1806,paladin,retribution,69,30,39
Matriarchxd,kazzak,1805,paladin,retribution,48,24,24
Vhardan,archimonde,1805,paladin,retribution,143,71,72
Магрейм,gordunni,1805,paladin,retribution,77,35,42
Wingsmode,kazzak,1805,paladin,retribution,72,27,45
Zarrex,blackrock,1804,paladin,retribution,54,28,26
Netharia,antonidas,1804,paladin,retribution,120,59,61
Aqualisse,hyjal,1804,paladin,retribution,66,30,36
Selina,burning-legion,1802,paladin,retribution,111,59,52
Meruem,blackrock,1802,paladin,retribution,53,26,27
Karadøc,archimonde,1802,paladin,retribution,90,41,49
Малиновыйбох,gordunni,1801,paladin,retribution,99,57,42
Lesterqt,thrall,1801,paladin,retribution,114,54,60
Delgato,kazzak,1800,paladin,retribution,152,80,72
Holysiah,kazzak,1800,paladin,retribution,84,38,46
Tauskiz,sylvanas,1800,paladin,retribution,48,19,29
Icekissz,hyjal,1795,paladin,retribution,24,19,5
Zachäus,kirin-tor,1795,paladin,retribution,90,45,45
Murkyxd,sanguino,1792,paladin,retribution,60,27,33
Pestomp,tarren-mill,1789,paladin,retribution,65,28,37
Dudjaw,stormscale,1789,paladin,retribution,60,24,36
Simjon,defias-brotherhood,1788,paladin,retribution,159,91,68
Ниашес,howling-fjord,1788,paladin,retribution,65,29,36
Nikkibenzqt,blackmoore,1788,paladin,retribution,78,31,47
Kayllan,ravencrest,1786,paladin,retribution,92,55,37
Jessrabit,tarren-mill,1783,paladin,retribution,42,19,23
Lightlogic,ravencrest,1778,paladin,retribution,59,28,31
Ças,quelthalas,1776,paladin,retribution,60,26,34
Valkûn,rexxar,1775,paladin,retribution,60,28,32
Vankwok,stormscale,1771,paladin,retribution,33,20,13
Âlßêdø,ravencrest,1771,paladin,retribution,99,42,57
Kêkbûrâgol,kazzak,1769,paladin,retribution,36,24,12
Кхабелех,howling-fjord,1769,paladin,retribution,72,29,43
Astragore,archimonde,1767,paladin,retribution,53,20,33
Sofhiya,silvermoon,1759,paladin,retribution,42,24,18
Блэканус,blackscar,1759,paladin,retribution,54,25,29
ßlacklight,archimonde,1759,paladin,retribution,48,21,27
Galenhad,kazzak,1759,paladin,retribution,54,23,31
Опгоп,gordunni,1758,paladin,retribution,89,45,44
Tanny,kazzak,1758,paladin,retribution,66,29,37
Игры,gordunni,1755,paladin,retribution,59,28,31
Данхайк,gordunni,1750,paladin,retribution,114,68,46
Surian,kazzak,1749,paladin,retribution,54,33,21
Инфернох,howling-fjord,1748,paladin,retribution,48,27,21
Tsorig,tarren-mill,1744,paladin,retribution,159,87,72
Baxuz,draenor,1744,paladin,retribution,54,27,27
Saabnaab,outland,1741,paladin,retribution,114,69,45
Zubxp,ravencrest,1741,paladin,retribution,54,26,28
Ollebala,ravencrest,1740,paladin,retribution,61,39,22
Justyowx,archimonde,1740,paladin,retribution,42,20,22
Мегопалл,blackscar,1738,paladin,retribution,90,38,52
Kinvqt,tarren-mill,1737,paladin,retribution,64,31,33
Liendry,antonidas,1735,paladin,retribution,53,28,25
Johannx,tarren-mill,1735,paladin,retribution,128,61,67
Trølled,aegwynn,1734,paladin,retribution,78,37,41
Торсгард,howling-fjord,1733,paladin,retribution,66,27,39
Reito,eredar,1732,paladin,retribution,48,25,23
Qarak,argent-dawn,1732,paladin,retribution,65,30,35
Zazalamel,hyjal,1731,paladin,retribution,48,28,20
Ÿani,argent-dawn,1730,paladin,retribution,42,25,17
Пинкпуссибой,howling-fjord,1729,paladin,retribution,50,29,21
Elitest,hyjal,1727,paladin,retribution,67,29,38
Tadashì,aegwynn,1726,paladin,retribution,60,25,35
Атмх,soulflayer,1723,paladin,retribution,42,23,19
Vylnoa,twisting-nether,1723,paladin,retribution,103,48,55
Mâterîa,antonidas,1722,paladin,retribution,66,40,26
Чупаа,howling-fjord,1721,paladin,retribution,70,38,32
Ruath,xavius,1721,paladin,retribution,90,46,44
Bregowine,doomhammer,1719,paladin,retribution,215,120,95
Xeaa,tarren-mill,1718,paladin,retribution,42,18,24
Кошкотяночка,ashenvale,1717,paladin,retribution,42,18,24
Glàdiator,outland,1712,paladin,retribution,65,30,35
Dannyvye,outland,1712,paladin,retribution,48,21,27
Hýox,malganis,1710,paladin,retribution,49,24,25
Cowwithspell,stormscale,1709,paladin,retribution,84,41,43
Sünlight,nemesis,1706,paladin,retribution,59,28,31
Mistérion,archimonde,1705,paladin,retribution,48,20,28
Staticdeath,ravencrest,1704,paladin,retribution,96,52,44
Модрит,soulflayer,1703,paladin,retribution,41,26,15
Deadholland,ravencrest,1703,paladin,retribution,64,35,29
Nutqtgodx,archimonde,1702,paladin,retribution,36,21,15
Gwynel,argent-dawn,1702,paladin,retribution,54,25,29
Bürd,rajaxx,1701,paladin,retribution,36,18,18
Rli,twisting-nether,1698,paladin,retribution,65,34,31
Vatix,trollbane,1697,paladin,retribution,42,20,22
Tazken,tarren-mill,1697,paladin,retribution,54,25,29
Rullatôrsven,stormscale,1697,paladin,retribution,48,18,30
Аилерия,howling-fjord,1696,paladin,retribution,180,101,79
Mhehø,hyjal,1695,paladin,retribution,190,90,100
Salti,magtheridon,1693,paladin,retribution,142,77,65
Gimly,anachronos,1693,paladin,retribution,60,24,36
Warmâchiine,burning-legion,1692,paladin,retribution,48,29,19
Сводимиаое,soulflayer,1692,paladin,retribution,52,24,28
Eysn,blackrock,1689,paladin,retribution,42,20,22
Зондарк,booty-bay,1687,paladin,retribution,59,24,35
Losër,ravencrest,1687,paladin,retribution,54,20,34
Valin,frostmane,1686,paladin,retribution,54,24,30
Дракула,howling-fjord,1684,paladin,retribution,72,39,33
Ønlyfâns,dragonblight,1683,paladin,retribution,60,27,33
Dréamypie,silvermoon,1681,paladin,retribution,47,18,29
Агинон,howling-fjord,1680,paladin,retribution,36,18,18
Аскеттх,gordunni,1678,paladin,retribution,48,27,21
Elisabeth,kazzak,1678,paladin,retribution,54,23,31
Кавайнекс,azuregos,1676,paladin,retribution,98,50,48
Gùtz,xavius,1676,paladin,retribution,51,23,28
Rekktadin,grim-batol,1675,paladin,retribution,101,47,54
Gluttön,tarren-mill,1674,paladin,retribution,35,20,15
Деленка,gordunni,1673,paladin,retribution,64,36,28
Утипутя,goldrinn,1672,paladin,retribution,36,20,16
Wootschi,arthas,1672,paladin,retribution,59,30,29
Rettalius,ravencrest,1671,paladin,retribution,46,20,26
Kaileena,archimonde,1669,paladin,retribution,42,25,17
Isora,twisting-nether,1669,paladin,retribution,84,34,50
Flaapz,hyjal,1668,paladin,retribution,36,26,10
Holyshet,blackrock,1668,paladin,retribution,62,35,27
Littlelíght,silvermoon,1666,paladin,retribution,36,22,14
Calaestra,twisting-nether,1665,paladin,retribution,33,20,13
Testør,ragnaros,1665,paladin,retribution,65,24,41
Tcret,sanguino,1664,paladin,retribution,36,19,17
Оззмо,howling-fjord,1663,paladin,retribution,48,26,22
Vickdicator,stormscale,1663,paladin,retribution,68,30,38
Deriøt,dun-modr,1662,paladin,retribution,54,27,27
Pruntadin,silvermoon,1661,paladin,retribution,78,36,42
Antimov,twisting-nether,1661,paladin,retribution,72,28,44
Bigbuffdaddy,draenor,1659,paladin,retribution,190,93,97
Malianterø,ravencrest,1658,paladin,retribution,70,34,36
Ярослэйв,howling-fjord,1658,paladin,retribution,45,21,24
Сёмаигрок,soulflayer,1654,paladin,retribution,54,26,28
Mordar,ravencrest,1654,paladin,retribution,55,25,30
Akrobatka,sanguino,1654,paladin,retribution,54,23,31
Zynuwu,blackmoore,1653,paladin,retribution,42,22,20
Íbossít,doomhammer,1652,paladin,retribution,66,36,30
Солошафл,howling-fjord,1652,paladin,retribution,36,19,17
Русэльф,howling-fjord,1652,paladin,retribution,87,45,42
Xila,blackrock,1652,paladin,retribution,60,24,36
Malthred,ravenholdt,1651,paladin,retribution,65,33,32
Xciepo,rexxar,1651,paladin,retribution,60,24,36
Gaalarr,burning-legion,1650,paladin,retribution,36,20,16
Screws,dun-modr,1650,paladin,retribution,54,22,32
Mcfëë,ysondre,1649,paladin,retribution,47,26,21
Shenwarr,twisting-nether,1649,paladin,retribution,36,19,17
Paakz,stormscale,1649,paladin,retribution,114,59,55
Batteldin,blackmoore,1648,paladin,retribution,117,71,46
Spegepølse,silvermoon,1647,paladin,retribution,74,42,32
Ðenlox,destromath,1647,paladin,retribution,54,23,31
Wakke,outland,1646,paladin,retribution,32,23,9
Katanaclówn,eredar,1646,paladin,retribution,78,41,37
Sübôvîñ,ravencrest,1643,paladin,retribution,47,28,19
Hèllkeepêr,archimonde,1643,paladin,retribution,35,19,16
Bjornulfr,ravencrest,1643,paladin,retribution,101,42,59
Саймум,blackscar,1641,paladin,retribution,57,29,28
Powerpuffret,antonidas,1640,paladin,retribution,72,40,32
Brabop,zirkel-des-cenarius,1637,paladin,retribution,42,22,20
Trenvendor,ravencrest,1635,paladin,retribution,33,22,11
Afhvahj,tichondrius,1635,paladin,retribution,52,29,23
Valhella,stormscale,1635,paladin,retribution,115,60,55
Arturius,ravencrest,1634,paladin,retribution,60,30,30
Frankostyle,sanguino,1634,paladin,retribution,53,26,27
Breakdøwñ,blackrock,1634,paladin,retribution,148,63,85
Retaxx,outland,1633,paladin,retribution,36,19,17
Gladiator,die-aldor,1633,paladin,retribution,42,21,21
Azûl,archimonde,1632,paladin,retribution,102,54,48
Draizor,twisting-nether,1631,paladin,retribution,89,42,47
Shmndr,kazzak,1630,paladin,retribution,30,18,12
Djcurry,archimonde,1630,paladin,retribution,30,17,13
Smirky,silvermoon,1630,paladin,retribution,30,17,13
Daoht,ysondre,1630,paladin,retribution,48,26,22
Lightsaint,kazzak,1630,paladin,retribution,48,26,22
Bobiwan,ravencrest,1629,paladin,retribution,30,17,13
Krîstal,aegwynn,1629,paladin,retribution,41,20,21
Exolis,archimonde,1629,paladin,retribution,36,17,19
Eniste,silvermoon,1629,paladin,retribution,56,26,30
Gilet,argent-dawn,1628,paladin,retribution,30,18,12
Wyllian,grim-batol,1628,paladin,retribution,48,23,25
Фэйсрол,gordunni,1628,paladin,retribution,59,21,38
Lisma,bloodfeather,1623,paladin,retribution,47,26,21
Bigducc,draenor,1623,paladin,retribution,41,20,21
Анастэриан,thermaplugg,1622,paladin,retribution,60,30,30
Dreamwatcher,outland,1621,paladin,retribution,48,21,27
Elohim,echsenkessel,1619,paladin,retribution,63,30,33
Charmxx,stormscale,1618,paladin,retribution,30,18,12
Lonesolo,sylvanas,1618,paladin,retribution,36,20,16
Instaquez,stormscale,1618,paladin,retribution,53,26,27
Guilt,aegwynn,1618,paladin,retribution,42,20,22
Ertheus,argent-dawn,1617,paladin,retribution,48,21,27
Tyrael,darksorrow,1616,paladin,retribution,188,94,94
Xairo,twisting-nether,1616,paladin,retribution,36,17,19
Holyblast,archimonde,1615,paladin,retribution,42,22,20
Ёйхйё,blackscar,1613,paladin,retribution,67,39,28
Kayøz,aegwynn,1613,paladin,retribution,72,36,36
Leoxander,outland,1613,paladin,retribution,42,21,21
Nanisunda,thrall,1613,paladin,retribution,132,63,69
Батллграунт,soulflayer,1612,paladin,retribution,85,56,29
Бэйгреон,gordunni,1612,paladin,retribution,98,58,40
Torvik,eredar,1611,paladin,retribution,42,21,21
Karyouka,archimonde,1610,paladin,retribution,54,33,21
Cauze,ravencrest,1610,paladin,retribution,120,65,55
Discølove,blackmoore,1610,paladin,retribution,43,21,22
Grimstark,argent-dawn,1609,paladin,retribution,36,23,13
Snødunkern,outland,1609,paladin,retribution,96,41,55
Димасгачи,gordunni,1608,paladin,retribution,36,28,8
Elganwar,hyjal,1608,paladin,retribution,72,43,29
Vodax,argent-dawn,1608,paladin,retribution,48,25,23
Рикшак,howling-fjord,1608,paladin,retribution,42,17,25
Ïdø,hyjal,1608,paladin,retribution,72,29,43
Biggboii,twisting-nether,1608,paladin,retribution,48,19,29
Sigmud,turalyon,1607,paladin,retribution,30,17,13
Akoumb,twisting-nether,1606,paladin,retribution,42,20,22
Fisslol,kazzak,1606,paladin,retribution,60,28,32
Misako,sanguino,1605,paladin,retribution,106,50,56
Tìtan,ravencrest,1604,paladin,retribution,48,25,23
Кронкс,howling-fjord,1604,paladin,retribution,141,73,68
Tinyandy,blackrock,1604,paladin,retribution,48,21,27
Aleixodolphi,argent-dawn,1604,paladin,retribution,66,28,38
Carlash,draenor,1602,paladin,retribution,60,35,25
Bíceron,sanguino,1602,paladin,retribution,52,26,26
Hargreeve,ravencrest,1602,paladin,retribution,48,24,24
Drakingsang,blackhand,1602,paladin,retribution,42,20,22
Fordragon,twisting-nether,1602,paladin,retribution,54,21,33
Pappnas,aegwynn,1601,paladin,retribution,30,17,13
Zwergicus,alexstrasza,1601,paladin,retribution,65,30,35
Skippadin,ravencrest,1600,paladin,retribution,59,30,29
Zeggayodax,nemesis,1599,paladin,retribution,30,19,11
Рамзеса,soulflayer,1599,paladin,retribution,48,22,26
Auriuss,defias-brotherhood,1597,paladin,retribution,78,43,35
Ajkulaa,kazzak,1593,paladin,retribution,56,25,31
Sántouryu,ravencrest,1591,paladin,retribution,163,76,87
Dabeefchief,outland,1590,paladin,retribution,28,21,7
Bloodaxjr,archimonde,1590,paladin,retribution,62,37,25
Qïkarï,antonidas,1588,paladin,retribution,55,33,22
Djcrusade,twisting-nether,1588,paladin,retribution,122,67,55
Телканапалке,blackscar,1587,paladin,retribution,30,21,9
Altundrdel,ravencrest,1587,paladin,retribution,48,25,23
Starworkal,ragnaros,1586,paladin,retribution,40,20,20
Crusshqt,silvermoon,1586,paladin,retribution,48,23,25
Асканиэль,howling-fjord,1586,paladin,retribution,84,37,47
Meìster,blackmoore,1586,paladin,retribution,48,20,28
Lawtõn,argent-dawn,1584,paladin,retribution,120,64,56
Джамбит,howling-fjord,1584,paladin,retribution,42,22,20
Мистеравадон,gordunni,1584,paladin,retribution,78,34,44
Nergigante,drekthar,1582,paladin,retribution,42,21,21
Дезоиль,gordunni,1582,paladin,retribution,42,19,23
Okcså,ragnaros,1582,paladin,retribution,58,21,37
Ämÿcüs,zuljin,1581,paladin,retribution,66,37,29
Мяумяухх,soulflayer,1581,paladin,retribution,117,63,54
Uliko,twisting-nether,1577,paladin,retribution,48,26,22
Hammarfall,ravencrest,1577,paladin,retribution,75,37,38
Korendil,frostmane,1576,paladin,retribution,48,19,29
Blówout,tarren-mill,1575,paladin,retribution,30,19,11
Биоразлагаем,gordunni,1568,paladin,retribution,78,41,37
Lightbrîng,hyjal,1564,paladin,retribution,60,28,32
Kathí,kazzak,1563,paladin,retribution,24,18,6
Trixzie,blackhand,1563,paladin,retribution,36,18,18
Jiraaqi,silvermoon,1562,paladin,retribution,53,27,26
Раффаэло,borean-tundra,1562,paladin,retribution,60,28,32
Lyraestra,hyjal,1562,paladin,retribution,54,20,34
Azlaya,sargeras,1559,paladin,retribution,96,44,52
Tyri,silvermoon,1557,paladin,retribution,78,37,41
Guccishock,twisting-nether,1556,paladin,retribution,44,27,17
Theodór,antonidas,1555,paladin,retribution,59,24,35
Kaleyra,argent-dawn,1555,paladin,retribution,42,17,25
Хексали,soulflayer,1554,paladin,retribution,39,20,19
Ùthér,sylvanas,1554,paladin,retribution,43,22,21
Taiso,alonsus,1552,paladin,retribution,59,30,29
Кузькинамать,greymane,1552,paladin,retribution,84,34,50
Knigh,draenor,1551,paladin,retribution,78,40,38
Lílou,blackmoore,1551,paladin,retribution,39,19,20
Эллесар,blackscar,1550,paladin,retribution,67,27,40
Palwig,tarren-mill,1549,paladin,retribution,112,56,56
Báldür,silvermoon,1549,paladin,retribution,36,18,18
Holymerda,grim-batol,1549,paladin,retribution,35,17,18
Honorkill,silvermoon,1548,paladin,retribution,115,63,52
Emostylex,draenor,1547,paladin,retribution,83,29,54
Malemanlad,silvermoon,1546,paladin,retribution,108,58,50
Лаитнем,gordunni,1544,paladin,retribution,36,25,11
Gulinborsti,aegwynn,1544,paladin,retribution,42,29,13
Maybach,onyxia,1543,paladin,retribution,66,31,35
Kènpachî,blackrock,1542,paladin,retribution,48,22,26
Angelisho,zuljin,1542,paladin,retribution,54,19,35
Obsidyen,outland,1541,paladin,retribution,38,17,21
Zeldalòl,outland,1541,paladin,retribution,59,25,34
Гневнебес,howling-fjord,1541,paladin,retribution,78,33,45
Йосяфлексер,howling-fjord,1539,paladin,retribution,72,40,32
Tóxicpaladín,kazzak,1537,paladin,retribution,39,20,19
Aethelwold,ragnaros,1537,paladin,retribution,126,52,74
Темплеар,gordunni,1537,paladin,retribution,48,17,31
Râoh,arathi,1536,paladin,retribution,66,34,32
Tazkaz,archimonde,1535,paladin,retribution,44,22,22
Raoun,archimonde,1535,paladin,retribution,39,18,21
Naneno,silvermoon,1535,paladin,retribution,40,18,22
Àræs,archimonde,1535,paladin,retribution,48,21,27
Rugila,ragnaros,1534,paladin,retribution,63,38,25
Runhexi,silvermoon,1534,paladin,retribution,72,36,36
Синодушка,blackscar,1533,paladin,retribution,28,16,12
Orti,sanguino,1533,paladin,retribution,53,30,23
Ibnkrook,archimonde,1533,paladin,retribution,36,16,20
Modeladin,ragnaros,1533,paladin,retribution,42,17,25
Термотравка,grom,1532,paladin,retribution,138,65,73
Jorhall,antonidas,1531,paladin,retribution,103,54,49
Stelanâal,archimonde,1530,paladin,retribution,60,31,29
Tharizod,nagrand,1530,paladin,retribution,68,34,34
Ришардебюр,soulflayer,1528,paladin,retribution,71,34,37
Elrandil,kazzak,1528,paladin,retribution,72,33,39
Opsyoudie,kazzak,1528,paladin,retribution,93,40,53
Saintseiya,pozzo-delleternità,1525,paladin,retribution,24,16,8
Timal,eitrigg,1525,paladin,retribution,42,22,20
Unschúld,blackrock,1524,paladin,retribution,79,43,36
Xawier,ghostlands,1524,paladin,retribution,54,28,26
Владыкасвета,borean-tundra,1523,paladin,retribution,78,41,37
Баблспула,soulflayer,1523,paladin,retribution,79,40,39
Wingzy,hyjal,1523,paladin,retribution,36,16,20
Créo,draenor,1520,paladin,retribution,36,17,19
Campo,tarren-mill,1519,paladin,retribution,48,20,28
Таптыгин,gordunni,1518,paladin,retribution,36,16,20
Cîzzar,burning-legion,1515,paladin,retribution,77,42,35
Rapwnzel,sylvanas,1515,paladin,retribution,60,30,30
Paellysuir,blackmoore,1515,paladin,retribution,66,31,35
Mystixd,talnivarr,1514,paladin,retribution,30,22,8
Hys,stormscale,1514,paladin,retribution,42,23,19
Волатбай,gordunni,1513,paladin,retribution,48,29,19
Jøøs,sargeras,1513,paladin,retribution,63,38,25
Mélli,eredar,1512,paladin,retribution,45,25,20
Snibsxpala,silvermoon,1512,paladin,retribution,36,19,17
Splasher,grim-batol,1512,paladin,retribution,42,20,22
Arayël,archimonde,1510,paladin,retribution,30,16,14
Impaross,shattrath,1509,paladin,retribution,159,87,72
Threathor,outland,1509,paladin,retribution,81,41,40
Paradoax,quelthalas,1505,paladin,retribution,30,16,14
Osïrïs,kazzak,1502,paladin,retribution,35,17,18
Doomgape,alakir,1502,paladin,retribution,48,18,30
Райтивуд,howling-fjord,1501,paladin,retribution,42,19,23
Прожектор,gordunni,1500,paladin,retribution,36,16,20
Wuzzle,azshara,1499,paladin,retribution,24,16,8
Bloodyret,outland,1499,paladin,retribution,30,16,14
Jathx,silvermoon,1498,paladin,retribution,62,36,26
Ralphias,tarren-mill,1498,paladin,retribution,72,32,40
Io,frostwolf,1498,paladin,retribution,95,41,54
Mattiesko,kazzak,1496,paladin,retribution,139,72,67
Колсет,soulflayer,1496,paladin,retribution,37,17,20
Jout,tarren-mill,1496,paladin,retribution,48,18,30
Варблэйз,gordunni,1495,paladin,retribution,30,16,14
Ben,ghostlands,1492,paladin,retribution,24,16,8
Selaphíel,kazzak,1489,paladin,retribution,60,33,27
Angelcore,tarren-mill,1489,paladin,retribution,66,35,31
Sonarix,blackrock,1488,paladin,retribution,51,26,25
Менетиил,galakrond,1488,paladin,retribution,52,17,35
Baldivar,silvermoon,1484,paladin,retribution,66,38,28
Hydrath,ysondre,1484,paladin,retribution,36,17,19
Davoss,outland,1484,paladin,retribution,39,16,23
Luhae,archimonde,1483,paladin,retribution,60,35,25
Catar,arathor,1482,paladin,retribution,157,87,70
Атикинс,gordunni,1482,paladin,retribution,96,41,55
Тюрр,lich-king,1480,paladin,retribution,43,21,22
Росиель,soulflayer,1480,paladin,retribution,44,21,23
Shockashy,stormscale,1480,paladin,retribution,38,18,20
Portgas,hyjal,1479,paladin,retribution,48,24,24
Истенен,blackscar,1479,paladin,retribution,78,32,46
Uxxer,sanguino,1478,paladin,retribution,35,20,15
Ârev,antonidas,1477,paladin,retribution,35,19,16
Shröömïë,silvermoon,1477,paladin,retribution,111,56,55
Романтик,deathweaver,1477,paladin,retribution,42,18,24
Briman,neptulon,1475,paladin,retribution,36,20,16
Blekadin,ragnaros,1475,paladin,retribution,44,22,22
Bloodsworn,stormrage,1474,paladin,retribution,72,44,28
Boomboomciao,draenor,1473,paladin,retribution,30,21,9
Ревирант,gordunni,1473,paladin,retribution,30,17,13
Unohana,shattered-halls,1471,paladin,retribution,83,37,46
Gazïel,kaelthas,1464,paladin,retribution,60,32,28
Røck,aggra-português,1463,paladin,retribution,101,53,48
Deloréane,archimonde,1463,paladin,retribution,39,17,22
Craaw,archimonde,1463,paladin,retribution,41,16,25
Ceccil,dun-modr,1462,paladin,retribution,30,19,11
Gymly,kazzak,1461,paladin,retribution,144,81,63
Ulrhik,nemesis,1461,paladin,retribution,45,17,28
Násty,twisting-nether,1460,paladin,retribution,119,58,61
Ysell,sargeras,1458,paladin,retribution,38,18,20
Grobididi,malygos,1457,paladin,retribution,48,25,23
Ветрум,gordunni,1456,paladin,retribution,36,18,18
Enveador,garrosh,1455,paladin,retribution,37,22,15
Elinmogz,kazzak,1454,paladin,retribution,26,16,10
Синфуледи,gordunni,1454,paladin,retribution,48,17,31
Johnßlake,dun-modr,1451,paladin,retribution,36,17,19
Kaitlyne,tarren-mill,1451,paladin,retribution,83,36,47
Oldsqlmofu,blackrock,1448,paladin,retribution,36,17,19
Crohnox,nemesis,1446,paladin,retribution,32,16,16
Hàsbulla,khaz-modan,1445,paladin,retribution,54,29,25
Gashqx,hyjal,1443,paladin,retribution,39,26,13
Valarians,nemesis,1443,paladin,retribution,30,16,14
Lawlight,frostmane,1443,paladin,retribution,45,21,24
Olivaresx,ravencrest,1443,paladin,retribution,48,17,31
Nothonnest,archimonde,1440,paladin,retribution,34,23,11
Ficsuur,ragnaros,1439,paladin,retribution,47,24,23
Меварх,howling-fjord,1439,paladin,retribution,30,15,15
Dinønuggets,ravencrest,1438,paladin,retribution,30,15,15
Codindio,silvermoon,1438,paladin,retribution,54,25,29
Nabbi,ravencrest,1438,paladin,retribution,36,15,21
Herrius,ravencrest,1438,paladin,retribution,36,15,21
Youmistpew,antonidas,1438,paladin,retribution,36,15,21
Jedzy,ragnaros,1437,paladin,retribution,24,15,9
Майлайт,gordunni,1437,paladin,retribution,42,24,18
Exceed,blackmoore,1436,paladin,retribution,30,15,15
Jac,nemesis,1436,paladin,retribution,86,40,46
Rullatorsvèn,stormscale,1436,paladin,retribution,36,15,21
Günselsen,antonidas,1435,paladin,retribution,126,65,61
Mimsy,dalaran,1434,paladin,retribution,59,27,32
Seraphyonhd,blackmoore,1432,paladin,retribution,28,17,11
Lightstrike,stormrage,1432,paladin,retribution,30,17,13
Zanreti,outland,1432,paladin,retribution,94,48,46
Ironquist,doomhammer,1432,paladin,retribution,30,15,15
Merkury,sanguino,1432,paladin,retribution,36,15,21
Alithyra,earthen-ring,1431,paladin,retribution,85,42,43
Teryanna,ragnaros,1431,paladin,retribution,56,19,37
Duckiboy,ragnaros,1430,paladin,retribution,90,52,38
Argentø,ravencrest,1430,paladin,retribution,77,37,40
Xyzl,argent-dawn,1429,paladin,retribution,42,23,19
Кветирон,soulflayer,1429,paladin,retribution,66,29,37
Сазар,gordunni,1426,paladin,retribution,51,21,30
Dainan,blackmoore,1425,paladin,retribution,36,15,21
Ðivine,stormscale,1424,paladin,retribution,48,26,22
Джагадаптер,gordunni,1422,paladin,retribution,47,28,19
Flaweldin,ravencrest,1420,paladin,retribution,18,15,3
Windsor,argent-dawn,1420,paladin,retribution,54,26,28
Sieghard,aegwynn,1419,paladin,retribution,54,24,30
Aeyalana,ragnaros,1418,paladin,retribution,29,17,12
Diamir,rajaxx,1417,paladin,retribution,51,20,31
Offa,draenor,1416,paladin,retribution,48,23,25
Swàyz,archimonde,1414,paladin,retribution,42,15,27
Dvouklik,burning-blade,1413,paladin,retribution,41,24,17
Arfeniel,stormscale,1413,paladin,retribution,60,22,38
Tuppo,argent-dawn,1411,paladin,retribution,64,25,39
Auryel,nemesis,1408,paladin,retribution,36,16,20
Holyblast,shattered-hand,1407,paladin,retribution,30,23,7
Блейзерфайт,eversong,1407,paladin,retribution,36,17,19
Maltazar,arygos,1404,paladin,retribution,24,15,9
Sickbolt,eredar,1404,paladin,retribution,54,30,24
Hagën,minahonda,1404,paladin,retribution,47,26,21
Crazzylight,kazzak,1403,paladin,retribution,74,35,39
Loscar,silvermoon,1402,paladin,retribution,30,15,15
Zélix,bronzebeard,1401,paladin,retribution,36,18,18
Mashijudge,blackhand,1400,paladin,retribution,30,18,12
Ahnaa,argent-dawn,1400,paladin,retribution,69,37,32
Joniopala,stormreaver,1399,paladin,retribution,35,15,20
Thazyru,frostmane,1395,paladin,retribution,24,16,8
Alvagur,zirkel-des-cenarius,1395,paladin,retribution,34,19,15
Белкоксю,booty-bay,1395,paladin,retribution,48,22,26
Dantrag,eredar,1391,paladin,retribution,42,15,27
Jackub,draenor,1390,paladin,retribution,44,24,20
Айэмбомб,howling-fjord,1390,paladin,retribution,30,15,15
Aisnil,twilights-hammer,1390,paladin,retribution,83,41,42
Pallidino,antonidas,1387,paladin,retribution,35,15,20
Rudî,sanguino,1384,paladin,retribution,34,25,9
Ljumá,kazzak,1384,paladin,retribution,69,31,38
Izolated,aegwynn,1383,paladin,retribution,60,24,36
Teìltaus,eredar,1382,paladin,retribution,48,20,28
Taiiki,archimonde,1381,paladin,retribution,60,35,25
Террорх,blackscar,1380,paladin,retribution,48,18,30
Vlodthar,uldum,1378,paladin,retribution,24,15,9
Хиккудоджер,eversong,1376,paladin,retribution,78,43,35
Walladin,stormscale,1375,paladin,retribution,87,42,45
Morniarn,argent-dawn,1374,paladin,retribution,54,29,25
Ashent,stormscale,1374,paladin,retribution,70,34,36
Telredor,rexxar,1372,paladin,retribution,42,15,27
Skyf,outland,1371,paladin,retribution,38,15,23
Shroomez,frostmane,1370,paladin,retribution,29,15,14
Teho,dragonblight,1370,paladin,retribution,91,47,44
Пепсекольный,soulflayer,1369,paladin,retribution,36,21,15
Kraakz,sanguino,1368,paladin,retribution,29,15,14
Goldhand,vashj,1368,paladin,retribution,66,31,35
Uwelist,arathor,1368,paladin,retribution,67,31,36
Svetijuju,kazzak,1367,paladin,retribution,60,29,31
Raweo,kilrogg,1366,paladin,retribution,72,47,25
Âlßêdø,silvermoon,1360,paladin,retribution,48,25,23
Vorsip,tarren-mill,1360,paladin,retribution,42,19,23
Balthassar,kirin-tor,1360,paladin,retribution,36,16,20
Эзарх,gordunni,1359,paladin,retribution,58,29,29
Freyjä,turalyon,1358,paladin,retribution,48,25,23
Тромбб,soulflayer,1358,paladin,retribution,36,15,21
Kaizêr,silvermoon,1357,paladin,retribution,60,30,30
Гучив,howling-fjord,1354,paladin,retribution,48,27,21
Apolomaeuz,blackhand,1354,paladin,retribution,36,20,16
Тьёрн,gordunni,1353,paladin,retribution,30,15,15
Рэгнволд,deathguard,1352,paladin,retribution,52,25,27
Борссалино,gordunni,1352,paladin,retribution,77,35,42
Илюшагодх,gordunni,1349,paladin,retribution,48,26,22
Koami,blackmoore,1348,paladin,retribution,30,15,15
Nomurabeta,naxxramas,1348,paladin,retribution,38,17,21
Hella,dunemaul,1345,paladin,retribution,35,19,16
Argonak,sanguino,1343,paladin,retribution,24,17,7
Inkzen,silvermoon,1343,paladin,retribution,24,14,10
Mcweedy,aegwynn,1343,paladin,retribution,30,14,16
Rulîx,blackmoore,1343,paladin,retribution,51,16,35
Retdead,nordrassil,1342,paladin,retribution,30,14,16
Vendikor,nemesis,1342,paladin,retribution,102,41,61
Ослепителен,eversong,1342,paladin,retribution,36,14,22
Unkillablee,stormscale,1341,paladin,retribution,40,21,19
Nardindindou,ysondre,1341,paladin,retribution,152,78,74
Geneundreitt,dethecus,1341,paladin,retribution,30,14,16
Dalemiar,ravencrest,1341,paladin,retribution,30,14,16
Chocbear,tarren-mill,1341,paladin,retribution,30,14,16
Yunax,silvermoon,1340,paladin,retribution,24,17,7
Zeyz,defias-brotherhood,1340,paladin,retribution,42,21,21
Джибути,soulflayer,1340,paladin,retribution,83,37,46
Витурус,howling-fjord,1339,paladin,retribution,42,14,28
Mustach,aggra-português,1337,paladin,retribution,41,20,21
Артреал,blackscar,1336,paladin,retribution,54,31,23
Proletardk,draenor,1336,paladin,retribution,102,51,51
Dankin,pozzo-delleternità,1335,paladin,retribution,30,14,16
Apolytos,laughing-skull,1335,paladin,retribution,30,14,16
Мэибибэиби,howling-fjord,1335,paladin,retribution,36,14,22
Zipoohun,arathor,1334,paladin,retribution,91,49,42
Хилерскийхил,soulflayer,1332,paladin,retribution,32,14,18
Хаспадин,gordunni,1331,paladin,retribution,30,14,16
Lightwitcher,silvermoon,1331,paladin,retribution,36,14,22
Yrgin,ravencrest,1330,paladin,retribution,72,38,34
Миоцуки,gordunni,1330,paladin,retribution,34,16,18
Guskey,draenor,1330,paladin,retribution,30,14,16
Данбро,borean-tundra,1330,paladin,retribution,36,14,22
Lycasia,hyjal,1329,paladin,retribution,36,14,22
Кливерти,gordunni,1325,paladin,retribution,36,14,22
Racduck,dunemaul,1325,paladin,retribution,36,14,22
Хеллкик,howling-fjord,1325,paladin,retribution,37,14,23
Enriel,temple-noir,1324,paladin,retribution,30,16,14
Yaoiri,argent-dawn,1323,paladin,retribution,23,15,8
Vleisboom,ravencrest,1323,paladin,retribution,24,14,10
Zaaen,burning-legion,1323,paladin,retribution,30,14,16
Kreyvin,argent-dawn,1322,paladin,retribution,59,25,34
Tríbunus,blackmoore,1321,paladin,retribution,25,15,10
Hydarr,twisting-nether,1320,paladin,retribution,50,27,23
Vvaarok,blackmoore,1320,paladin,retribution,71,30,41
Rothmans,aggra-português,1319,paladin,retribution,36,20,16
Holylimx,draenor,1314,paladin,retribution,96,48,48
Sparrda,dun-modr,1314,paladin,retribution,48,24,24
Синерина,blackscar,1314,paladin,retribution,47,20,27
Foxare,burning-legion,1312,paladin,retribution,53,29,24
Viiri,burning-legion,1311,paladin,retribution,71,40,31
Маркант,gordunni,1311,paladin,retribution,30,15,15
Zehnya,grim-batol,1311,paladin,retribution,46,22,24
Джекадамс,gordunni,1311,paladin,retribution,139,49,90
Мизиола,galakrond,1310,paladin,retribution,60,30,30
Shtaladin,sylvanas,1304,paladin,retribution,83,33,50
Беймикс,gordunni,1303,paladin,retribution,72,36,36
Mendril,malorne,1302,paladin,retribution,24,17,7
Aegend,antonidas,1301,paladin,retribution,163,77,86
Booyaahh,ravencrest,1301,paladin,retribution,36,17,19
Fredas,hyjal,1299,paladin,retribution,48,23,25
Barakisback,silvermoon,1296,paladin,retribution,30,17,13
Arrious,frostmane,1296,paladin,retribution,29,14,15
Elení,thrall,1296,paladin,retribution,37,15,22
Ретриванлав,gordunni,1296,paladin,retribution,72,24,48
Veckra,kazzak,1295,paladin,retribution,30,14,16
Fumaça,dun-modr,1292,paladin,retribution,43,25,18
Orseis,anubarak,1291,paladin,retribution,29,15,14
Mantinel,hellfire,1290,paladin,retribution,32,20,12
Epoke,archimonde,1285,paladin,retribution,36,21,15
Angrykorean,blackmoore,1284,paladin,retribution,59,28,31
Darhuun,antonidas,1281,paladin,retribution,93,43,50
Faithsmemory,silvermoon,1281,paladin,retribution,68,29,39
Dieversity,stormscale,1280,paladin,retribution,41,16,25
Budgetcara,stormscale,1279,paladin,retribution,23,14,9
Альмор,blackscar,1278,paladin,retribution,32,14,18
Æthëlflæd,ravencrest,1271,paladin,retribution,39,24,15
Hammexõr,sylvanas,1271,paladin,retribution,87,39,48
Cästiël,arathor,1269,paladin,retribution,41,21,20
Эльбабло,lich-king,1268,paladin,retribution,45,21,24
Перизкопец,gordunni,1267,paladin,retribution,30,16,14
Auditõr,argent-dawn,1267,paladin,retribution,85,32,53
Draìgo,nemesis,1262,paladin,retribution,23,14,9
Zandorath,argent-dawn,1261,paladin,retribution,42,15,27
Owiganowi,ulduar,1260,paladin,retribution,30,19,11
Aikm,tarren-mill,1260,paladin,retribution,56,26,30
Zâre,sanguino,1259,paladin,retribution,35,17,18
Блэквилл,howling-fjord,1256,paladin,retribution,60,26,34
Tønyx,les-clairvoyants,1253,paladin,retribution,32,14,18
Хоулишит,blackscar,1251,paladin,retribution,24,16,8
Hollylady,outland,1251,paladin,retribution,30,19,11
Azzael,thrall,1250,paladin,retribution,48,17,31
Lübu,archimonde,1248,paladin,retribution,30,13,17
Wickedret,kazzak,1247,paladin,retribution,18,13,5
Yana,blackrock,1247,paladin,retribution,24,13,11
Hislifelmao,kazzak,1247,paladin,retribution,30,13,17
Тардариус,gordunni,1247,paladin,retribution,30,13,17
Xsÿde,archimonde,1247,paladin,retribution,30,13,17
Tsunà,antonidas,1247,paladin,retribution,30,13,17
Ërzã,outland,1247,paladin,retribution,30,13,17
Paladiodinos,hyjal,1247,paladin,retribution,42,16,26
Блэкхарм,gordunni,1247,paladin,retribution,36,13,23
Elyox,ravencrest,1246,paladin,retribution,24,13,11
Icearth,pozzo-delleternità,1246,paladin,retribution,48,20,28
Forja,silvermoon,1245,paladin,retribution,18,13,5
Gromzed,ravencrest,1245,paladin,retribution,30,13,17
Hito,sylvanas,1245,paladin,retribution,30,13,17
Réfractio,die-aldor,1245,paladin,retribution,30,13,17
Ventsi,kazzak,1244,paladin,retribution,36,18,18
Bezúziusz,ragnaros,1244,paladin,retribution,36,16,20
Moodý,ragnaros,1244,paladin,retribution,64,28,36
Sukinsin,aegwynn,1244,paladin,retribution,30,13,17
Proxidus,blackmoore,1244,paladin,retribution,41,16,25
Tîrana,ysondre,1243,paladin,retribution,30,13,17
Combinecka,chamber-of-aspects,1243,paladin,retribution,74,30,44
Messîah,outland,1242,paladin,retribution,78,46,32
Endar,drakthul,1242,paladin,retribution,36,14,22
Батллграунд,soulflayer,1241,paladin,retribution,30,13,17
Ilikejudge,blackmoore,1241,paladin,retribution,42,13,29
Hornybìlly,stormscale,1240,paladin,retribution,36,13,23
Siorraidh,archimonde,1239,paladin,retribution,24,13,11
Aasimar,twilights-hammer,1239,paladin,retribution,107,56,51
Cianna,shattered-hand,1237,paladin,retribution,40,13,27
Æe,blackmoore,1236,paladin,retribution,37,22,15
Humphry,vashj,1236,paladin,retribution,24,13,11
Evililz,kazzak,1236,paladin,retribution,31,14,17
Teliriyon,blackrock,1236,paladin,retribution,32,14,18
Lewp,tarren-mill,1234,paladin,retribution,18,13,5
Anatorka,drakthul,1234,paladin,retribution,78,39,39
Aurroraa,doomhammer,1233,paladin,retribution,27,14,13
Valpen,veknilash,1233,paladin,retribution,30,15,15
Forneus,nemesis,1232,paladin,retribution,46,23,23
Hemdâl,kirin-tor,1231,paladin,retribution,42,21,21
Цвандр,gordunni,1231,paladin,retribution,64,30,34
Juliea,aegwynn,1231,paladin,retribution,42,16,26
Edyk,silvermoon,1229,paladin,retribution,65,37,28
Wumbo,sinstralis,1229,paladin,retribution,36,19,17
Flawx,blackmoore,1228,paladin,retribution,24,13,11
Наваляка,deathguard,1228,paladin,retribution,24,13,11
Синдикатх,soulflayer,1228,paladin,retribution,30,14,16
Painshield,outland,1228,paladin,retribution,41,13,28
Walorez,ragnaros,1227,paladin,retribution,23,13,10
Tillak,draenor,1227,paladin,retribution,24,13,11
Mataleo,archimonde,1226,paladin,retribution,48,29,19
Вандиир,soulflayer,1226,paladin,retribution,24,13,11
Trisunonvaki,khazgoroth,1226,paladin,retribution,41,16,25
Bootybanger,thrall,1223,paladin,retribution,24,13,11
Atomicbubble,balnazzar,1222,paladin,retribution,36,17,19
Velkar,frostmane,1221,paladin,retribution,50,26,24
Юлец,galakrond,1220,paladin,retribution,30,13,17
Ylvannka,blackmoore,1219,paladin,retribution,36,18,18
Lumino,twilights-hammer,1218,paladin,retribution,35,16,19
Ragnarük,khaz-modan,1217,paladin,retribution,42,20,22
Beastyblodne,sylvanas,1215,paladin,retribution,30,17,13
Jagen,tyrande,1215,paladin,retribution,36,16,20
Shorella,malganis,1214,paladin,retribution,30,17,13
Wadey,tarren-mill,1214,paladin,retribution,36,13,23
Hornox,ragnaros,1213,paladin,retribution,48,22,26
Snottybrat,draenor,1212,paladin,retribution,68,35,33
Lightmonger,drakthul,1210,paladin,retribution,24,14,10
Keith,dragonmaw,1210,paladin,retribution,30,14,16
Хен,blackscar,1209,paladin,retribution,32,15,17
Альфазеро,howling-fjord,1208,paladin,retribution,28,13,15
Kýrp,stormreaver,1207,paladin,retribution,43,16,27
Palitard,turalyon,1204,paladin,retribution,42,25,17
Светлыйкит,blackscar,1204,paladin,retribution,48,25,23
Palabido,nemesis,1203,paladin,retribution,45,17,28
Nessùm,hyjal,1203,paladin,retribution,54,18,36
Лютыйчпок,fordragon,1200,paladin,retribution,76,34,42
Лейфи,howling-fjord,1199,paladin,retribution,36,15,21
Andocay,das-syndikat,1197,paladin,retribution,42,14,28
Dragonous,darkmoon-faire,1195,paladin,retribution,78,31,47
Beyma,twisting-nether,1193,paladin,retribution,23,13,10
Palagray,blackmoore,1193,paladin,retribution,50,24,26
Whiffy,silvermoon,1193,paladin,retribution,36,13,23
Helmed,tarren-mill,1190,paladin,retribution,39,21,18
Hïto,dun-modr,1189,paladin,retribution,24,14,10
Ункаль,ashenvale,1186,paladin,retribution,78,35,43
Raê,hyjal,1185,paladin,retribution,48,17,31
Perfectum,burning-legion,1182,paladin,retribution,28,13,15
Steakenstein,nathrezim,1181,paladin,retribution,30,14,16
Irinor,rashgarroth,1181,paladin,retribution,30,14,16
Runkpaladin,kazzak,1180,paladin,retribution,36,23,13
Lightppl,outland,1179,paladin,retribution,42,19,23
Cigyal,hyjal,1178,paladin,retribution,42,23,19
Mystíque,die-todeskrallen,1177,paladin,retribution,48,27,21
Sylazz,blackrock,1177,paladin,retribution,109,52,57
Truezero,draenor,1176,paladin,retribution,30,14,16
Summuno,eredar,1174,paladin,retribution,54,18,36
Hypothalamus,silvermoon,1173,paladin,retribution,30,14,16
Rileys,turalyon,1173,paladin,retribution,54,25,29
Pitusá,dun-modr,1173,paladin,retribution,36,13,23
Dinøx,archimonde,1171,paladin,retribution,80,36,44
Lagaminë,dalaran,1167,paladin,retribution,87,39,48
Khrotos,draenor,1166,paladin,retribution,66,30,36
Zemoss,kazzak,1164,paladin,retribution,24,14,10
Takaret,hyjal,1159,paladin,retribution,48,18,30
Judgement,quelthalas,1158,paladin,retribution,30,20,10
Vrgingamer,kazzak,1158,paladin,retribution,48,16,32
Pery,malganis,1157,paladin,retribution,48,28,20
Clessington,die-aldor,1152,paladin,retribution,18,12,6
Ixøne,kazzak,1152,paladin,retribution,18,12,6
Franclovis,hyjal,1152,paladin,retribution,29,12,17
Harlequina,argent-dawn,1151,paladin,retribution,18,12,6
Sessian,bronze-dragonflight,1151,paladin,retribution,42,25,17
Шакиори,gordunni,1151,paladin,retribution,22,13,9
Vorthir,khaz-modan,1151,paladin,retribution,32,16,16
Darkkissret,lightbringer,1151,paladin,retribution,24,12,12
Lipsvirgin,kazzak,1151,paladin,retribution,24,12,12
Kiriel,dun-modr,1151,paladin,retribution,36,12,24
Madmartigane,ysondre,1151,paladin,retribution,36,12,24
Gigasack,ravencrest,1150,paladin,retribution,18,12,6
Самерваль,borean-tundra,1150,paladin,retribution,46,24,22
Hirako,nemesis,1150,paladin,retribution,24,12,12
Ruotollo,ravencrest,1150,paladin,retribution,24,12,12
Menephannt,outland,1150,paladin,retribution,33,13,20
Dominikcro,sylvanas,1149,paladin,retribution,24,12,12
Djandja,blackrock,1149,paladin,retribution,24,12,12
Muhnnin,archimonde,1149,paladin,retribution,30,12,18
Quasimod,ravencrest,1148,paladin,retribution,24,12,12
Ædrenn,archimonde,1148,paladin,retribution,36,12,24
Búbbles,nerathor,1147,paladin,retribution,18,12,6
Doubtfire,tarren-mill,1147,paladin,retribution,24,12,12
Vitacé,burning-legion,1147,paladin,retribution,24,12,12
Холихит,gordunni,1147,paladin,retribution,30,12,18
Supergallows,shattered-hand,1147,paladin,retribution,30,12,18
Aylion,blackrock,1146,paladin,retribution,18,12,6
Algoric,suramar,1146,paladin,retribution,24,12,12
Хельдотер,howling-fjord,1146,paladin,retribution,25,12,13
Retenki,silvermoon,1146,paladin,retribution,30,12,18
Иродиада,gordunni,1146,paladin,retribution,30,12,18
Kreselia,ravencrest,1146,paladin,retribution,30,12,18
Albz,laughing-skull,1145,paladin,retribution,24,12,12
Palyx,cthun,1144,paladin,retribution,18,12,6
Kollak,dun-modr,1144,paladin,retribution,42,18,24
Асшура,howling-fjord,1143,paladin,retribution,24,12,12
Bigdamjudge,argent-dawn,1142,paladin,retribution,18,12,6
Rayshield,tarren-mill,1142,paladin,retribution,47,23,24
Raerk,dalaran,1142,paladin,retribution,43,21,22
Eywinn,silvermoon,1141,paladin,retribution,30,12,18
Pállis,ravencrest,1139,paladin,retribution,18,12,6
Dijkie,boulderfist,1139,paladin,retribution,30,12,18
Càrláßrùní,hyjal,1138,paladin,retribution,18,12,6
Holybubo,tarren-mill,1133,paladin,retribution,60,30,30
Диваин,gordunni,1133,paladin,retribution,24,12,12
Pytha,nozdormu,1132,paladin,retribution,49,25,24
Questos,burning-legion,1130,paladin,retribution,45,25,20
Энилейт,lich-king,1127,paladin,retribution,18,12,6
Joelosteen,neptulon,1127,paladin,retribution,36,16,20
Nelasson,eredar,1126,paladin,retribution,26,13,13
Vaníos,nazjatar,1126,paladin,retribution,24,12,12
Deathzinger,aszune,1126,paladin,retribution,24,12,12
Buckfizz,ysondre,1121,paladin,retribution,24,16,8
Mosih,bloodfeather,1121,paladin,retribution,50,29,21
Burstyléz,silvermoon,1121,paladin,retribution,24,12,12
Refuse,blackrock,1118,paladin,retribution,23,12,11
Veshnu,blackrock,1117,paladin,retribution,36,14,22
Teogrim,blackmoore,1114,paladin,retribution,24,13,11
Dafe,zuluhed,1113,paladin,retribution,50,21,29
Лусейд,howling-fjord,1112,paladin,retribution,23,13,10
Troj,ahnqiraj,1112,paladin,retribution,30,14,16
Мистерху,gordunni,1111,paladin,retribution,73,34,39
Bonzai,blackrock,1108,paladin,retribution,30,12,18
Ghostfacê,khaz-modan,1105,paladin,retribution,36,17,19
Shädyss,hyjal,1105,paladin,retribution,76,34,42
Leyawin,sanguino,1099,paladin,retribution,30,15,15
Kaljir,archimonde,1098,paladin,retribution,21,13,8
Rilledread,stormscale,1098,paladin,retribution,78,35,43
Retrystyle,ragnaros,1093,paladin,retribution,53,24,29
Jebenatreba,sporeggar,1091,paladin,retribution,29,12,17
Bornir,khaz-modan,1091,paladin,retribution,30,12,18
Goungokuhrbo,doomhammer,1088,paladin,retribution,30,19,11
Milojcica,kazzak,1087,paladin,retribution,17,12,5
Apolloos,grim-batol,1087,paladin,retribution,23,12,11
Lavawraith,argent-dawn,1086,paladin,retribution,22,12,10
Diøstemplar,dun-modr,1085,paladin,retribution,28,14,14
Imaturtle,darksorrow,1085,paladin,retribution,36,13,23
Obé,argent-dawn,1083,paladin,retribution,96,49,47
Valgar,ragnaros,1081,paladin,retribution,17,12,5
Sandorr,area-52,1079,paladin,retribution,30,17,13
Aerathil,nethersturm,1079,paladin,retribution,41,22,19
Böb,garona,1078,paladin,retribution,36,14,22
Fleshoflight,arathor,1077,paladin,retribution,27,14,13
Belnadris,eredar,1068,paladin,retribution,17,12,5
Dildotbagins,argent-dawn,1064,paladin,retribution,52,32,20
Lliissaa,kazzak,1059,paladin,retribution,54,31,23
Lytza,frostwolf,1059,paladin,retribution,30,15,15
Soossi,silvermoon,1056,paladin,retribution,18,11,7
Сакон,borean-tundra,1056,paladin,retribution,24,11,13
Franzîskûs,blackmoore,1056,paladin,retribution,24,11,13
Pia,twisting-nether,1056,paladin,retribution,24,11,13
Nyxbane,kazzak,1056,paladin,retribution,24,11,13
Chyve,tarren-mill,1056,paladin,retribution,30,11,19
Zayaka,ragnaros,1056,paladin,retribution,30,11,19
Havefunzqt,archimonde,1055,paladin,retribution,12,11,1
Erasdin,silvermoon,1055,paladin,retribution,18,11,7
Mirøku,silvermoon,1055,paladin,retribution,18,11,7
Holydhanas,outland,1055,paladin,retribution,18,11,7
Terrozina,stormscale,1055,paladin,retribution,18,11,7
Lazone,ysondre,1055,paladin,retribution,22,12,10
Vvsdiamonds,archimonde,1055,paladin,retribution,24,11,13
Kalimgor,theradras,1055,paladin,retribution,24,11,13
Stukker,silvermoon,1055,paladin,retribution,24,11,13
Гуэргос,gordunni,1055,paladin,retribution,24,11,13
Lecutus,sunstrider,1055,paladin,retribution,28,12,16
Wingsuit,eredar,1055,paladin,retribution,26,11,15
Relius,outland,1055,paladin,retribution,30,11,19
Wellmetqt,aegwynn,1055,paladin,retribution,30,11,19
Deidâra,blackhand,1055,paladin,retribution,30,11,19
Screâm,eredar,1055,paladin,retribution,36,11,25
Zialo,ravencrest,1055,paladin,retribution,36,11,25
Highfivè,ravencrest,1054,paladin,retribution,18,11,7
Addwyr,blackrock,1054,paladin,retribution,18,11,7
Myridan,bloodhoof,1054,paladin,retribution,18,11,7
Sinthoràs,shattered-hand,1054,paladin,retribution,36,20,16
Slump,ravencrest,1054,paladin,retribution,20,11,9
Blademàster,twisting-nether,1054,paladin,retribution,22,12,10
Palidos,blackrock,1054,paladin,retribution,24,11,13
Aguerx,alleria,1054,paladin,retribution,24,11,13
Niou,alleria,1054,paladin,retribution,24,11,13
Phalex,outland,1054,paladin,retribution,30,11,19
Думклиф,gordunni,1054,paladin,retribution,30,11,19
Nillenkäse,antonidas,1053,paladin,retribution,18,11,7
Deceneü,kazzak,1053,paladin,retribution,24,11,13
Беспощадие,gordunni,1053,paladin,retribution,24,11,13
Mufuqa,ragnaros,1053,paladin,retribution,24,11,13
Chelan,thrall,1053,paladin,retribution,30,11,19
Nøvå,ravencrest,1053,paladin,retribution,30,11,19
Mazekiel,archimonde,1052,paladin,retribution,18,11,7
Alard,sanguino,1052,paladin,retribution,30,11,19
Imreallybadx,blackrock,1051,paladin,retribution,18,11,7
Ayàhuazka,ysondre,1051,paladin,retribution,24,11,13
Руказакона,deathguard,1051,paladin,retribution,30,11,19
Llaynn,argent-dawn,1051,paladin,retribution,36,11,25
Notdeadfred,silvermoon,1050,paladin,retribution,18,11,7
Рипкарт,gordunni,1050,paladin,retribution,18,11,7
Sunsaiy,doomhammer,1047,paladin,retribution,54,28,26
Thorold,earthen-ring,1047,paladin,retribution,28,14,14
Jâybee,ravencrest,1047,paladin,retribution,24,11,13
Nevermoore,doomhammer,1047,paladin,retribution,24,11,13
Jooki,drakthul,1044,paladin,retribution,18,11,7
Kaelron,sanguino,1044,paladin,retribution,18,11,7
Traqnbilkarq,stormscale,1044,paladin,retribution,24,12,12
Grapaladin,sanguino,1044,paladin,retribution,24,11,13
Darnero,blackrock,1043,paladin,retribution,18,11,7
Radamanthes,ysondre,1042,paladin,retribution,31,12,19
Рашенс,gordunni,1042,paladin,retribution,30,11,19
Harycon,thrall,1041,paladin,retribution,30,11,19
Línke,sanguino,1040,paladin,retribution,25,12,13
Lazaraat,antonidas,1039,paladin,retribution,29,11,18
Мильфорд,eversong,1038,paladin,retribution,24,11,13
Killa,stormrage,1038,paladin,retribution,24,11,13
Vâskt,dun-modr,1038,paladin,retribution,24,11,13
Saró,ravencrest,1035,paladin,retribution,22,12,10
Лефша,soulflayer,1034,paladin,retribution,18,11,7
Wisupl,silvermoon,1034,paladin,retribution,18,11,7
Syng,garona,1034,paladin,retribution,30,11,19
Fëanôr,tarren-mill,1033,paladin,retribution,182,91,91
Gôdfâthér,kazzak,1031,paladin,retribution,23,11,12
Арморих,gordunni,1024,paladin,retribution,22,11,11
Hateless,tarren-mill,1024,paladin,retribution,28,11,17
Kealen,nemesis,1020,paladin,retribution,66,25,41
Молотоборец,gordunni,1019,paladin,retribution,24,11,13
Monkeylight,ambossar,1019,paladin,retribution,31,13,18
Gerannan,kirin-tor,1018,paladin,retribution,30,14,16
Eleiktra,suramar,1018,paladin,retribution,30,11,19
Leilak,draenor,1015,paladin,retribution,24,15,9
Krïstâlùlz,archimonde,1014,paladin,retribution,34,15,19
Quasimotto,turalyon,1014,paladin,retribution,36,13,23
Paladie,dalaran,1013,paladin,retribution,141,72,69
Crynó,blackmoore,1010,paladin,retribution,30,13,17
Aégon,archimonde,1010,paladin,retribution,36,13,23
Nomeel,twisting-nether,1007,paladin,retribution,103,55,48
Kipperb,kazzak,1007,paladin,retribution,23,11,12
Renaseh,twisting-nether,1007,paladin,retribution,23,11,12
Siuras,blackmoore,1006,paladin,retribution,17,11,6
Snaty,khaz-modan,1004,paladin,retribution,47,25,22
Ilovemylay,area-52,1004,paladin,retribution,21,11,10
Монбиин,soulflayer,1001,paladin,retribution,24,12,12
Plato,arthas,997,paladin,retribution,24,12,12
Эксвайп,howling-fjord,997,paladin,retribution,23,11,12
Bryllks,die-todeskrallen,996,paladin,retribution,42,25,17
Paillasson,nerzhul,994,paladin,retribution,34,16,18
Crazypits,silvermoon,993,paladin,retribution,36,14,22
Raptasenda,archimonde,992,paladin,retribution,38,14,24
Âchîle,garona,991,paladin,retribution,43,23,20
Flipzz,blackrock,990,paladin,retribution,14,11,3
Quoque,turalyon,988,paladin,retribution,27,13,14
Retbùll,stormscale,976,paladin,retribution,13,11,2
Killtauren,kazzak,966,paladin,retribution,54,23,31
Eltruite,archimonde,962,paladin,retribution,60,25,35
Shatar,culte-de-la-rive-noire,960,paladin,retribution,12,10,2
Yo,azshara,960,paladin,retribution,15,11,4
Сандалар,gordunni,960,paladin,retribution,18,10,8
Blazerlolz,kazzak,960,paladin,retribution,18,10,8
Vhalkur,dun-modr,960,paladin,retribution,18,10,8
Exolie,archimonde,960,paladin,retribution,18,10,8
Weekly,outland,960,paladin,retribution,18,10,8
Exolia,archimonde,960,paladin,retribution,18,10,8
Ассайоу,soulflayer,960,paladin,retribution,24,10,14
Beigerbala,blackrock,960,paladin,retribution,24,10,14
Daveboss,dragonblight,960,paladin,retribution,24,10,14
Tj,dun-modr,960,paladin,retribution,24,10,14
Rqd,blackrock,960,paladin,retribution,24,10,14
Timmes,blackhand,960,paladin,retribution,24,10,14
Ганка,blackscar,960,paladin,retribution,30,10,20
Apokalipsnik,drakthul,959,paladin,retribution,18,10,8
Slapmedaddy,die-ewige-wacht,959,paladin,retribution,18,10,8
Bunurata,silvermoon,959,paladin,retribution,18,10,8
Khadet,draenor,959,paladin,retribution,18,10,8
Яправ,borean-tundra,959,paladin,retribution,18,10,8
Lonesoul,tarren-mill,959,paladin,retribution,18,10,8
Makakí,twisting-nether,959,paladin,retribution,18,10,8
Gangb,ravencrest,959,paladin,retribution,18,10,8
Razrpal,tarren-mill,959,paladin,retribution,24,10,14
Plarbo,blackmoore,959,paladin,retribution,24,10,14
Slayfer,dun-modr,959,paladin,retribution,24,10,14
Thaddios,burning-blade,959,paladin,retribution,24,10,14
Croptol,dun-modr,959,paladin,retribution,24,10,14
Нижмубабл,soulflayer,959,paladin,retribution,27,11,16
Dalbo,aegwynn,958,paladin,retribution,12,10,2
Béhèlit,sargeras,958,paladin,retribution,18,10,8
Arcardi,dun-morogh,958,paladin,retribution,18,10,8
Nînaninja,silvermoon,958,paladin,retribution,18,10,8
Rhyvar,outland,958,paladin,retribution,24,10,14
Válé,silvermoon,958,paladin,retribution,30,10,20
Holyhi,silvermoon,957,paladin,retribution,18,10,8
Xëlâ,archimonde,957,paladin,retribution,23,10,13
Franc,aggra-português,957,paladin,retribution,24,10,14
Ðøñe,draenor,957,paladin,retribution,24,10,14
Immortalkrux,archimonde,957,paladin,retribution,53,18,35
Injustice,chamber-of-aspects,956,paladin,retribution,25,11,14
Syracx,blackhand,956,paladin,retribution,24,10,14
Zoltes,twisting-nether,956,paladin,retribution,24,10,14
Akâshi,dalaran,955,paladin,retribution,18,10,8
Løøktår,ysondre,955,paladin,retribution,18,10,8
Torpala,burning-legion,955,paladin,retribution,24,10,14
Galevar,argent-dawn,955,paladin,retribution,24,10,14
Xavios,eredar,955,paladin,retribution,24,10,14
Holypurger,shattered-hand,955,paladin,retribution,25,10,15
Aisolôn,thrall,954,paladin,retribution,18,10,8
Lukeus,the-maelstrom,954,paladin,retribution,18,10,8
Kyríé,tarren-mill,953,paladin,retribution,18,10,8
Ïnata,khaz-modan,952,paladin,retribution,24,10,14
Lightblaze,doomhammer,952,paladin,retribution,42,13,29
Nözderg,archimonde,951,paladin,retribution,24,10,14
Baldarlyset,tarren-mill,948,paladin,retribution,33,11,22
Xemoth,kazzak,947,paladin,retribution,18,10,8
Buddabob,antonidas,946,paladin,retribution,56,12,44
Klittsurf,bloodhoof,945,paladin,retribution,18,10,8
Ziggyz,kul-tiras,945,paladin,retribution,19,10,9
Ghallandre,khaz-modan,943,paladin,retribution,18,10,8
Patzi,die-todeskrallen,941,paladin,retribution,67,33,34
Kawakii,outland,940,paladin,retribution,18,10,8
Samail,malganis,935,paladin,retribution,24,10,14
Mírato,blackhand,929,paladin,retribution,24,10,14
Pyrogon,malorne,928,paladin,retribution,79,37,42
Lifepower,nemesis,927,paladin,retribution,16,10,6
Ayylmeow,tarren-mill,927,paladin,retribution,20,11,9
Грайндсет,galakrond,927,paladin,retribution,23,10,13
Justrhino,kazzak,927,paladin,retribution,23,10,13
Caladys,silvermoon,926,paladin,retribution,23,10,13
Пропала,greymane,922,paladin,retribution,30,10,20
Shuler,silvermoon,919,paladin,retribution,24,10,14
Coelslaw,azjolnerub,915,paladin,retribution,29,10,19
Схемас,gordunni,910,paladin,retribution,36,14,22
Vuzetevacabo,doomhammer,907,paladin,retribution,96,45,51
Vibeer,ravencrest,905,paladin,retribution,36,16,20
Santaclaus,zuljin,904,paladin,retribution,18,11,7
Баблыч,borean-tundra,904,paladin,retribution,18,10,8
Tomkü,burning-legion,902,paladin,retribution,28,12,16
Gurutze,ragnaros,896,paladin,retribution,16,10,6
Pârabellum,the-maelstrom,896,paladin,retribution,28,10,18
Лакоста,ashenvale,894,paladin,retribution,26,10,16
Lolladin,blackmoore,894,paladin,retribution,26,10,16
Iamnami,earthen-ring,893,paladin,retribution,22,10,12
Vanyon,malganis,892,paladin,retribution,20,10,10
Vexxus,blackrock,892,paladin,retribution,48,22,26
Tánk,twilights-hammer,888,paladin,retribution,48,22,26
Pepsimaxpvp,blackmoore,880,paladin,retribution,25,10,15
Baé,drakthul,878,paladin,retribution,25,10,15
Fardahr,ravencrest,877,paladin,retribution,24,10,14
Supou,twisting-nether,876,paladin,retribution,18,10,8
Fufenzee,stormscale,875,paladin,retribution,77,33,44
Stitchup,argent-dawn,864,paladin,retribution,12,9,3
Holysnickers,tarren-mill,864,paladin,retribution,12,9,3
Сынбогов,gordunni,864,paladin,retribution,12,9,3
Shakkur,varimathras,864,paladin,retribution,12,9,3
Фэнон,gordunni,864,paladin,retribution,12,9,3
Obackbarama,outland,864,paladin,retribution,18,9,9
Retgodx,eredar,864,paladin,retribution,18,9,9
Ттиаматт,howling-fjord,864,paladin,retribution,18,9,9
Loratheon,stormscale,864,paladin,retribution,18,9,9
Cùpìdstunt,draenor,864,paladin,retribution,18,9,9
Exolix,archimonde,864,paladin,retribution,18,9,9
Justivo,tarren-mill,864,paladin,retribution,18,9,9
Kilô,sylvanas,864,paladin,retribution,18,9,9
Mitsoû,archimonde,864,paladin,retribution,18,9,9
Pesterci,draenor,864,paladin,retribution,18,9,9
Мэднессх,howling-fjord,864,paladin,retribution,18,9,9
Hølypwnjk,forscherliga,864,paladin,retribution,18,9,9
Kaarsius,defias-brotherhood,864,paladin,retribution,18,9,9
Аниф,ashenvale,864,paladin,retribution,18,9,9
Paterymon,ravencrest,864,paladin,retribution,18,9,9
Реальныйпал,gordunni,864,paladin,retribution,18,9,9
Loani,dalaran,864,paladin,retribution,18,9,9
Tekåpal,tarren-mill,864,paladin,retribution,24,9,15
Kæycc,blackmoore,864,paladin,retribution,24,9,15
Лакостик,howling-fjord,864,paladin,retribution,24,9,15
Zarron,blackrock,864,paladin,retribution,24,9,15
Thoriz,elune,864,paladin,retribution,24,9,15
Zuveron,the-maelstrom,864,paladin,retribution,24,9,15
Socx,outland,864,paladin,retribution,24,9,15
Feelmylight,tarren-mill,864,paladin,retribution,24,9,15
Sunhalo,twisting-nether,864,paladin,retribution,24,9,15
Jannene,draenor,864,paladin,retribution,24,9,15
Umirinbruv,zenedar,864,paladin,retribution,30,9,21
Júdger,twisting-nether,863,paladin,retribution,12,9,3
Nakedholy,draenor,863,paladin,retribution,12,9,3
Леаркус,blackscar,863,paladin,retribution,18,9,9
Milkadìn,twisting-nether,863,paladin,retribution,18,9,9
Dälaghetto,kilrogg,863,paladin,retribution,18,9,9
Trollilolz,eredar,863,paladin,retribution,18,9,9
Fujszi,arathor,863,paladin,retribution,18,9,9
Durnell,sylvanas,863,paladin,retribution,18,9,9
Telionrootan,die-aldor,863,paladin,retribution,18,9,9
Sildrit,draenor,863,paladin,retribution,18,9,9
Nordkreuz,aegwynn,863,paladin,retribution,18,9,9
Níthag,ragnaros,863,paladin,retribution,18,9,9
Каштоуны,soulflayer,863,paladin,retribution,24,9,15
Axone,ravencrest,863,paladin,retribution,24,9,15
Blatrix,kazzak,862,paladin,retribution,12,9,3
Primle,thrall,862,paladin,retribution,12,9,3
Darkenorr,silvermoon,862,paladin,retribution,18,9,9
Yæø,archimonde,862,paladin,retribution,18,9,9
Lìmier,ysondre,862,paladin,retribution,18,9,9
Swan,chogall,862,paladin,retribution,18,9,9
Шоринг,gordunni,862,paladin,retribution,18,9,9
Whitebreeze,sanguino,862,paladin,retribution,18,9,9
Роллита,gordunni,862,paladin,retribution,24,9,15
Retributon,madmortem,861,paladin,retribution,18,9,9
Gavril,bloodfeather,860,paladin,retribution,18,9,9
Петуретрик,gordunni,860,paladin,retribution,24,9,15
Jêzus,blackrock,858,paladin,retribution,12,9,3
Thëone,exodar,858,paladin,retribution,16,10,6
Ènyalius,silvermoon,858,paladin,retribution,24,9,15
Durwin,mazrigos,855,paladin,retribution,24,9,15
Starstríder,aszune,852,paladin,retribution,18,9,9
Rafflesia,sanguino,847,paladin,retribution,29,9,20
Бунча,gordunni,846,paladin,retribution,30,9,21
Knygnesys,silvermoon,844,paladin,retribution,15,11,4
Ocgynle,alonsus,844,paladin,retribution,18,9,9
Öwai,dun-modr,843,paladin,retribution,23,12,11
Patsani,twilights-hammer,839,paladin,retribution,24,9,15
Dôrä,ysondre,830,paladin,retribution,23,9,14
Pàlàthor,khaz-modan,826,paladin,retribution,18,9,9
Sunfather,twilights-hammer,820,paladin,retribution,18,9,9
Ararion,tarren-mill,809,paladin,retribution,18,10,8
Choyoki,blackmoore,802,paladin,retribution,25,9,16
Somixd,ragnaros,799,paladin,retribution,22,9,13
Zerohour,kilrogg,799,paladin,retribution,28,9,19
Sheïkka,hyjal,793,paladin,retribution,32,12,20
Allenn,tarren-mill,783,paladin,retribution,11,9,2
Zelphyr,pozzo-delleternità,777,paladin,retribution,20,9,11
Eléndrên,blackrock,768,paladin,retribution,12,8,4
Needel,argent-dawn,768,paladin,retribution,12,8,4
Heallgodxx,ragnaros,768,paladin,retribution,12,8,4
Vindicatê,stormscale,768,paladin,retribution,12,8,4
Pakór,blackrock,768,paladin,retribution,12,8,4
Дохлаяженах,gordunni,768,paladin,retribution,12,8,4
Hülä,antonidas,768,paladin,retribution,12,8,4
Âyasê,blackhand,768,paladin,retribution,12,8,4
Нормвал,gordunni,768,paladin,retribution,18,8,10
Asgardietis,kazzak,768,paladin,retribution,18,8,10
Iiwar,silvermoon,768,paladin,retribution,18,8,10
Notpitball,kazzak,768,paladin,retribution,18,8,10
Sinclo,hyjal,768,paladin,retribution,18,8,10
Dadyolimp,kazzak,768,paladin,retribution,18,8,10
Baxxster,blackhand,768,paladin,retribution,18,8,10
Holyinstinct,bronze-dragonflight,768,paladin,retribution,18,8,10
Roostersucka,stormreaver,768,paladin,retribution,18,8,10
Садистка,soulflayer,768,paladin,retribution,18,8,10
Thun,azjolnerub,768,paladin,retribution,18,8,10
Tyristrum,kilrogg,768,paladin,retribution,18,8,10
Чемеряк,gordunni,768,paladin,retribution,18,8,10
Irenita,kazzak,768,paladin,retribution,18,8,10
Gìne,archimonde,768,paladin,retribution,18,8,10
Enmà,archimonde,768,paladin,retribution,18,8,10
Sumecbtw,aegwynn,768,paladin,retribution,24,8,16
Tjabo,burning-blade,768,paladin,retribution,24,8,16
Powerphally,outland,768,paladin,retribution,24,8,16
Lezira,ravencrest,768,paladin,retribution,24,8,16
Smilé,sylvanas,768,paladin,retribution,24,8,16
Bázer,antonidas,768,paladin,retribution,24,8,16
Toxií,argent-dawn,768,paladin,retribution,30,8,22
ßancu,ragnaros,768,paladin,retribution,30,8,22
Spinzr,draenor,767,paladin,retribution,12,8,4
Dawnnslayer,kazzak,767,paladin,retribution,12,8,4
Serenityxo,twisting-nether,767,paladin,retribution,12,8,4
Crossfaded,azjolnerub,767,paladin,retribution,12,8,4
Hutimeni,turalyon,767,paladin,retribution,12,8,4
Blagori,blackhand,767,paladin,retribution,12,8,4
Frutte,malganis,767,paladin,retribution,12,8,4
Ekzykes,ravencrest,767,paladin,retribution,12,8,4
Nfxx,argent-dawn,767,paladin,retribution,12,8,4
Bubblebuttx,ghostlands,767,paladin,retribution,18,8,10
Nashret,kazzak,767,paladin,retribution,18,8,10
Hôrrible,ravencrest,767,paladin,retribution,18,8,10
Xersys,draenor,767,paladin,retribution,18,8,10
Xtekz,tarren-mill,767,paladin,retribution,18,8,10
Ruftadin,ragnaros,767,paladin,retribution,18,8,10
Mooses,stormscale,767,paladin,retribution,18,8,10
Baxteria,dun-modr,767,paladin,retribution,18,8,10
Dideta,colinas-pardas,767,paladin,retribution,18,8,10
Retstarr,draenor,767,paladin,retribution,24,8,16
Lusugo,alakir,767,paladin,retribution,24,8,16
Puré,festung-der-stürme,767,paladin,retribution,24,8,16
Geilershrimp,blackrock,767,paladin,retribution,36,8,28
Fremuduin,argent-dawn,766,paladin,retribution,12,8,4
Krustenkaese,kelthuzad,766,paladin,retribution,12,8,4
Laugan,ysondre,766,paladin,retribution,12,8,4
Ryozupala,frostwolf,766,paladin,retribution,12,8,4
Konithis,doomhammer,766,paladin,retribution,12,8,4
Hogan,blackmoore,766,paladin,retribution,18,8,10
Викиллер,grom,765,paladin,retribution,18,8,10
Mikipaki,tarren-mill,765,paladin,retribution,18,8,10
Yanisx,burning-legion,764,paladin,retribution,12,8,4
Trøllørd,shattrath,764,paladin,retribution,18,8,10
Luridity,argent-dawn,764,paladin,retribution,24,8,16
Wingedguard,ragnaros,763,paladin,retribution,12,8,4
Nazdarvole,drakthul,763,paladin,retribution,18,8,10
Donttaskwhy,sylvanas,763,paladin,retribution,24,8,16
Êxood,archimonde,762,paladin,retribution,18,8,10
Vondarkmoor,magtheridon,761,paladin,retribution,18,8,10
Torczy,frostwhisper,760,paladin,retribution,12,8,4
Tripani,twisting-nether,760,paladin,retribution,18,8,10
Stepamusicz,stormreaver,760,paladin,retribution,18,8,10
Vonryan,defias-brotherhood,756,paladin,retribution,24,8,16
Almohalhil,tarren-mill,753,paladin,retribution,12,8,4
Ericafontës,kazzak,751,paladin,retribution,17,8,9
Nazaninez,tarren-mill,749,paladin,retribution,18,8,10
Klikas,twisting-nether,746,paladin,retribution,18,8,10
Bomsamdi,draenor,745,paladin,retribution,17,8,9
Grayparser,silvermoon,735,paladin,retribution,14,9,5
Jualom,colinas-pardas,735,paladin,retribution,14,9,5
Lynaé,blackhand,735,paladin,retribution,13,8,5
Guckzu,malganis,733,paladin,retribution,19,8,11
Pliscken,kazzak,719,paladin,retribution,23,8,15
Darkironpala,argent-dawn,717,paladin,retribution,21,8,13
Byths,blackmoore,714,paladin,retribution,26,9,17
Äthénâ,archimonde,713,paladin,retribution,23,9,14
Helvirya,defias-brotherhood,711,paladin,retribution,118,46,72
Драгун,gordunni,707,paladin,retribution,25,9,16
Tigerherz,antonidas,704,paladin,retribution,22,8,14
Nexzz,outland,703,paladin,retribution,11,8,3
Aelthir,kazzak,703,paladin,retribution,11,8,3
Wellick,ravencrest,703,paladin,retribution,17,8,9
Myxas,tarren-mill,702,paladin,retribution,14,8,6
Danneris,sanguino,702,paladin,retribution,19,9,10
Zerad,quelthalas,702,paladin,retribution,44,8,36
Angelepetit,hyjal,701,paladin,retribution,16,8,8
Gradepal,drakthul,687,paladin,retribution,19,8,11
Thebestpala,tarren-mill,686,paladin,retribution,19,8,11
Sloug,archimonde,672,paladin,retribution,12,7,5
Fabsy,frostwolf,672,paladin,retribution,12,7,5
Moarcry,outland,672,paladin,retribution,12,7,5
Alammar,burning-legion,672,paladin,retribution,12,7,5
Девствениица,gordunni,672,paladin,retribution,12,7,5
Shjami,rexxar,672,paladin,retribution,12,7,5
Archibäld,silvermoon,672,paladin,retribution,12,7,5
Akaasix,stormscale,672,paladin,retribution,12,7,5
Swânn,sanguino,672,paladin,retribution,12,7,5
Miriem,twisting-nether,672,paladin,retribution,12,7,5
Keft,twisting-nether,672,paladin,retribution,12,7,5
Vircy,outland,672,paladin,retribution,12,7,5
Qpalax,outland,672,paladin,retribution,12,7,5
Dragon,zenedar,672,paladin,retribution,12,7,5
Jdizzy,tarren-mill,672,paladin,retribution,12,7,5
Лиривель,howling-fjord,672,paladin,retribution,12,7,5
Миллиционер,razuvious,672,paladin,retribution,12,7,5
Малоко,thermaplugg,672,paladin,retribution,12,7,5
Misú,ravencrest,672,paladin,retribution,12,7,5
Ellünca,ravencrest,672,paladin,retribution,12,7,5
Sletlana,burning-blade,672,paladin,retribution,12,7,5
Malapal,hyjal,672,paladin,retribution,12,7,5
Neverdeath,stormscale,672,paladin,retribution,12,7,5
Drownlord,eredar,672,paladin,retribution,12,7,5
Дорогаснега,gordunni,672,paladin,retribution,12,7,5
Bubblor,ravencrest,672,paladin,retribution,12,7,5
Promise,dun-modr,672,paladin,retribution,12,7,5
Даракар,deathguard,672,paladin,retribution,12,7,5
Anatollia,silvermoon,672,paladin,retribution,12,7,5
Ilpreside,nemesis,672,paladin,retribution,12,7,5
Нефростинг,gordunni,672,paladin,retribution,12,7,5
Sunwalker,bronzebeard,672,paladin,retribution,12,7,5
Neicha,trollbane,672,paladin,retribution,12,7,5
Hammertime,guldan,672,paladin,retribution,12,7,5
Fatherabdul,ravencrest,672,paladin,retribution,12,7,5
Dìe,silvermoon,672,paladin,retribution,12,7,5
Якунии,blackscar,672,paladin,retribution,12,7,5
Jíyü,blackmoore,672,paladin,retribution,18,7,11
Apocalypsé,twisting-nether,672,paladin,retribution,18,7,11
Pìnkyy,draenor,672,paladin,retribution,18,7,11
Kírin,drakthul,672,paladin,retribution,18,7,11
Ivarladin,draenor,672,paladin,retribution,18,7,11
Scairtin,ravencrest,672,paladin,retribution,18,7,11
Ritaora,aggramar,672,paladin,retribution,18,7,11
Ryxxii,ravencrest,672,paladin,retribution,18,7,11
Tezmodian,antonidas,672,paladin,retribution,18,7,11
Arbuzno,draenor,672,paladin,retribution,18,7,11
Атмта,razuvious,672,paladin,retribution,18,7,11
Lindrone,aggra-português,672,paladin,retribution,18,7,11
Almighty,ravencrest,672,paladin,retribution,18,7,11
Norganpala,die-aldor,672,paladin,retribution,18,7,11
Littlenight,emerald-dream,672,paladin,retribution,18,7,11
Galadrion,dun-modr,672,paladin,retribution,18,7,11
Холирайз,gordunni,672,paladin,retribution,18,7,11
Kjobergen,tarren-mill,672,paladin,retribution,18,7,11
Митахо,gordunni,672,paladin,retribution,18,7,11
Shownómercy,stormscale,672,paladin,retribution,18,7,11
Melyntholdra,argent-dawn,672,paladin,retribution,18,7,11
Lysander,antonidas,672,paladin,retribution,18,7,11
Bubbledøtcøm,blackmoore,672,paladin,retribution,18,7,11
Мериатас,soulflayer,672,paladin,retribution,18,7,11
Arshiaa,ravencrest,672,paladin,retribution,21,8,13
Святстраж,gordunni,672,paladin,retribution,21,8,13
Коссандра,greymane,672,paladin,retribution,23,7,16
Jaegeer,draenor,672,paladin,retribution,24,7,17
Paradoxiâ,thrall,672,paladin,retribution,24,7,17
Akelad,arathor,672,paladin,retribution,24,7,17
Zerlat,twisting-nether,672,paladin,retribution,24,7,17
Ящеры,gordunni,672,paladin,retribution,24,7,17
Møøgødx,bronzebeard,672,paladin,retribution,30,7,23
Aranael,nemesis,672,paladin,retribution,30,7,23
Zycqo,silvermoon,672,paladin,retribution,31,7,24
Bajheeroth,kazzak,671,paladin,retribution,12,7,5
Demsi,ravencrest,671,paladin,retribution,12,7,5
Bubblefett,ysera,671,paladin,retribution,12,7,5
Uraraka,burning-blade,671,paladin,retribution,12,7,5
Bitether,burning-legion,671,paladin,retribution,12,7,5
Retgaffeooku,conseil-des-ombres,671,paladin,retribution,12,7,5
Wolfpala,drakthul,671,paladin,retribution,12,7,5
Gbejr,xavius,671,paladin,retribution,12,7,5
Lovetospoonn,ravencrest,671,paladin,retribution,12,7,5
Catsnek,darksorrow,671,paladin,retribution,12,7,5
Sakred,hellscream,671,paladin,retribution,12,7,5
Samueel,blackmoore,671,paladin,retribution,12,7,5
Bloodlord,twisting-nether,671,paladin,retribution,15,8,7
Fishnchips,twisting-nether,671,paladin,retribution,18,7,11
Laenira,nemesis,671,paladin,retribution,18,7,11
Konori,mannoroth,671,paladin,retribution,18,7,11
Asorte,chants-éternels,671,paladin,retribution,18,7,11
Eken,hyjal,671,paladin,retribution,18,7,11
Dufftroll,kazzak,671,paladin,retribution,18,7,11
Juozas,argent-dawn,671,paladin,retribution,18,7,11
Спидфрик,blackscar,671,paladin,retribution,18,7,11
Alvíss,sanguino,671,paladin,retribution,18,7,11
Öbedö,malganis,671,paladin,retribution,24,7,17
Atrexie,lightbringer,670,paladin,retribution,12,7,5
Keol,sanguino,670,paladin,retribution,12,7,5
Mma,sylvanas,670,paladin,retribution,12,7,5
Aistor,burning-legion,670,paladin,retribution,18,7,11
Solarouz,draenor,669,paladin,retribution,12,7,5
Zebramann,silvermoon,669,paladin,retribution,18,7,11
Палочка,howling-fjord,669,paladin,retribution,18,7,11
Toshvarak,turalyon,669,paladin,retribution,18,7,11
Rangorian,defias-brotherhood,669,paladin,retribution,24,7,17
Bärghest,sanguino,668,paladin,retribution,12,7,5
Фокспро,lich-king,668,paladin,retribution,18,7,11
Shennzo,wildhammer,667,paladin,retribution,12,7,5
Gxdéon,hyjal,667,paladin,retribution,12,7,5
Rocaviva,sanguino,666,paladin,retribution,12,7,5
Ксинем,howling-fjord,666,paladin,retribution,16,8,8
Nenenita,cthun,665,paladin,retribution,18,7,11
Шелволк,eversong,665,paladin,retribution,18,7,11
Calluk,turalyon,665,paladin,retribution,24,7,17
Zealotic,doomhammer,664,paladin,retribution,12,7,5
Pallido,exodar,664,paladin,retribution,12,7,5
Chikaz,archimonde,664,paladin,retribution,20,10,10
Halimox,terokkar,664,paladin,retribution,18,7,11
Wolya,blackrock,663,paladin,retribution,15,8,7
Mechoka,auchindoun,661,paladin,retribution,13,7,6
Belzed,draenor,660,paladin,retribution,15,8,7
Luxor,sporeggar,658,paladin,retribution,12,7,5
Romkaq,silvermoon,655,paladin,retribution,12,7,5
Хампал,howling-fjord,655,paladin,retribution,17,7,10
Bigdamjudgee,outland,655,paladin,retribution,17,7,10
Mograine,die-aldor,654,paladin,retribution,17,7,10
Ryüü,uldaman,647,paladin,retribution,29,8,21
Orelius,guldan,640,paladin,retribution,30,8,22
Keele,stormscale,639,paladin,retribution,17,7,10
Boabux,draenor,638,paladin,retribution,17,7,10
Вэис,borean-tundra,638,paladin,retribution,17,7,10
Denounce,defias-brotherhood,624,paladin,retribution,21,7,14
Samànta,nemesis,623,paladin,retribution,11,7,4
Rustig,talnivarr,623,paladin,retribution,11,7,4
Jaro,alleria,623,paladin,retribution,21,7,14
Malagat,die-todeskrallen,622,paladin,retribution,23,7,16
Goofyaf,ravencrest,618,paladin,retribution,16,9,7
Mariaremarc,silvermoon,617,paladin,retribution,25,8,17
Ressler,tichondrius,616,paladin,retribution,15,7,8
Skénder,kazzak,615,paladin,retribution,35,8,27
Swagged,kazzak,611,paladin,retribution,28,8,20
Ahramanyu,blackrock,606,paladin,retribution,14,7,7
Milisha,the-maelstrom,604,paladin,retribution,20,7,13
Блатш,greymane,592,paladin,retribution,31,7,24
Vootele,draenor,576,paladin,retribution,6,6,0
Xinze,ravencrest,576,paladin,retribution,6,6,0
Lóyal,kazzak,576,paladin,retribution,6,6,0
Twomog,ravencrest,576,paladin,retribution,6,6,0
Séphiran,hyjal,576,paladin,retribution,6,6,0
Melverti,kazzak,576,paladin,retribution,12,6,6
Ríppex,kazzak,576,paladin,retribution,12,6,6
Ærîo,dalaran,576,paladin,retribution,12,6,6
Ridethelight,nemesis,576,paladin,retribution,12,6,6
Velikor,dun-modr,576,paladin,retribution,12,6,6
Gabrîel,sanguino,576,paladin,retribution,12,6,6
Ryaz,blackrock,576,paladin,retribution,12,6,6
Pallachyrk,kazzak,576,paladin,retribution,12,6,6
Sämaelia,ysondre,576,paladin,retribution,12,6,6
Sölaria,silvermoon,576,paladin,retribution,12,6,6
Teshkipowa,kazzak,576,paladin,retribution,12,6,6
Elyrax,nemesis,576,paladin,retribution,12,6,6
Palamauka,kazzak,576,paladin,retribution,12,6,6
Mawrâ,twisting-nether,576,paladin,retribution,12,6,6
Sangiorgio,nemesis,576,paladin,retribution,12,6,6
Bigdaddypump,ravencrest,576,paladin,retribution,12,6,6
Askmy,stormscale,576,paladin,retribution,12,6,6
Ibanez,lightnings-blade,576,paladin,retribution,12,6,6
Molgran,defias-brotherhood,576,paladin,retribution,12,6,6
Drdax,wildhammer,576,paladin,retribution,12,6,6
Deresos,anetheron,576,paladin,retribution,12,6,6
Greko,ysera,576,paladin,retribution,12,6,6
Seekêr,tarren-mill,576,paladin,retribution,12,6,6
Mekluba,twisting-nether,576,paladin,retribution,12,6,6
Søulréaper,stormscale,576,paladin,retribution,12,6,6
Mouncake,archimonde,576,paladin,retribution,12,6,6
Vysavo,draenor,576,paladin,retribution,12,6,6
Dodgerwilly,outland,576,paladin,retribution,12,6,6
Plainrage,blackrock,576,paladin,retribution,12,6,6
Ruggero,stormscale,576,paladin,retribution,12,6,6
Керантий,gordunni,576,paladin,retribution,12,6,6
Blindhoj,ravencrest,576,paladin,retribution,12,6,6
Raceper,the-maelstrom,576,paladin,retribution,12,6,6
Ayoub,argent-dawn,576,paladin,retribution,12,6,6
Sødaz,hyjal,576,paladin,retribution,12,6,6
Eldrial,argent-dawn,576,paladin,retribution,12,6,6
Зена,gordunni,576,paladin,retribution,12,6,6
Rothus,bronze-dragonflight,576,paladin,retribution,12,6,6
Shaylaru,tarren-mill,576,paladin,retribution,12,6,6
Stève,ravencrest,576,paladin,retribution,12,6,6
Clamjam,sylvanas,576,paladin,retribution,12,6,6
Veejxo,silvermoon,576,paladin,retribution,12,6,6
Gigajudge,ravencrest,576,paladin,retribution,12,6,6
Elendíl,azjolnerub,576,paladin,retribution,12,6,6
Yséria,kirin-tor,576,paladin,retribution,12,6,6
Paliax,outland,576,paladin,retribution,12,6,6
Vuutnëx,twisting-nether,576,paladin,retribution,12,6,6
Wordup,senjin,576,paladin,retribution,12,6,6
Notnerb,outland,576,paladin,retribution,12,6,6
Cycodin,garrosh,576,paladin,retribution,12,6,6
Bloodbeard,twisting-nether,576,paladin,retribution,12,6,6
Dioxius,stormscale,576,paladin,retribution,12,6,6
Snowife,drakthul,576,paladin,retribution,12,6,6
Wingdude,ysera,576,paladin,retribution,12,6,6
Cheradin,ragnaros,576,paladin,retribution,12,6,6
Диджейнобабл,howling-fjord,576,paladin,retribution,12,6,6
Ironkra,stormscale,576,paladin,retribution,12,6,6
Neêsoldr,blackmoore,576,paladin,retribution,12,6,6
Скварлетх,howling-fjord,576,paladin,retribution,12,6,6
Luciter,silvermoon,576,paladin,retribution,12,6,6
Belight,burning-legion,576,paladin,retribution,12,6,6
Alersia,twisting-nether,576,paladin,retribution,12,6,6
Fatâl,antonidas,576,paladin,retribution,15,7,8
Aimee,draenor,576,paladin,retribution,16,7,9
Генатрамбон,howling-fjord,576,paladin,retribution,18,6,12
Tosá,antonidas,576,paladin,retribution,18,6,12
Curtwizz,silvermoon,576,paladin,retribution,18,6,12
Hermmes,alakir,576,paladin,retribution,18,6,12
Czachadymii,defias-brotherhood,576,paladin,retribution,18,6,12
Avalindro,wrathbringer,576,paladin,retribution,18,6,12
Âtom,outland,576,paladin,retribution,18,6,12
Mâêdhrøsx,ravencrest,576,paladin,retribution,18,6,12
Hegazy,darkmoon-faire,576,paladin,retribution,18,6,12
Ironstealman,shattered-hand,576,paladin,retribution,18,6,12
Diaéna,kirin-tor,576,paladin,retribution,18,6,12
Sîlversun,grim-batol,576,paladin,retribution,18,6,12
Thickets,argent-dawn,576,paladin,retribution,18,6,12
Lamohru,argent-dawn,576,paladin,retribution,24,6,18
Actionjack,area-52,576,paladin,retribution,24,6,18
Sacredlol,blackmoore,576,paladin,retribution,24,6,18
Huevo,frostmane,576,paladin,retribution,24,6,18
Kyrokonserve,blackmoore,575,paladin,retribution,14,7,7
Bcrp,ragnaros,575,paladin,retribution,12,6,6
Bulle,the-venture-co,575,paladin,retribution,12,6,6
Skieras,draenor,575,paladin,retribution,12,6,6
Holycide,twisting-nether,575,paladin,retribution,12,6,6
Gonhilda,kazzak,575,paladin,retribution,12,6,6
Rohb,blackmoore,575,paladin,retribution,12,6,6
Llya,blackrock,575,paladin,retribution,12,6,6
Pewpews,twisting-nether,575,paladin,retribution,12,6,6
Тамплиир,gordunni,575,paladin,retribution,12,6,6
Blazix,kazzak,575,paladin,retribution,12,6,6
Arkura,nozdormu,575,paladin,retribution,12,6,6
Trollarage,confrérie-du-thorium,575,paladin,retribution,12,6,6
Vaako,blackrock,575,paladin,retribution,12,6,6
Faventu,ragnaros,575,paladin,retribution,12,6,6
Antón,dun-modr,575,paladin,retribution,12,6,6
Iqso,argent-dawn,575,paladin,retribution,12,6,6
Sanduciorba,chamber-of-aspects,575,paladin,retribution,12,6,6
Zulem,grim-batol,575,paladin,retribution,12,6,6
Phillipe,illidan,575,paladin,retribution,12,6,6
Kendomendo,ravencrest,575,paladin,retribution,12,6,6
Gotra,stormscale,575,paladin,retribution,21,7,14
Edathar,argent-dawn,575,paladin,retribution,24,6,18
Nykothpn,ghostlands,574,paladin,retribution,6,6,0
Dönki,hyjal,574,paladin,retribution,12,6,6
Revinox,silvermoon,574,paladin,retribution,12,6,6
Babarush,nozdormu,574,paladin,retribution,18,6,12
Humaladi,draenor,574,paladin,retribution,18,6,12
Таурмакус,howling-fjord,574,paladin,retribution,18,6,12
Fintros,silvermoon,574,paladin,retribution,18,6,12
Thoorval,silvermoon,574,paladin,retribution,18,6,12
Wexo,frostwolf,574,paladin,retribution,22,6,16
Jelcz,burning-legion,574,paladin,retribution,24,6,18
Eatfasteatas,doomhammer,573,paladin,retribution,6,6,0
Cinderlight,aszune,573,paladin,retribution,12,6,6
Cpsuper,azuremyst,573,paladin,retribution,12,6,6
Josuaa,ragnaros,572,paladin,retribution,12,6,6
Themlstake,kazzak,572,paladin,retribution,12,6,6
Nhum,destromath,572,paladin,retribution,12,6,6
Taomeba,runetotem,571,paladin,retribution,12,6,6
Exiztant,ravencrest,571,paladin,retribution,18,6,12
Boaka,outland,571,paladin,retribution,18,6,12
Phaenre,pozzo-delleternità,570,paladin,retribution,18,6,12
Elannor,sylvanas,569,paladin,retribution,12,6,6
Nicgr,nemesis,566,paladin,retribution,12,6,6
Benkenoah,ragnaros,566,paladin,retribution,24,6,18
Vengryn,turalyon,566,paladin,retribution,37,8,29
Shendis,uldaman,565,paladin,retribution,12,6,6
Bugo,drakthul,559,paladin,retribution,17,6,11
Ràwx,twisting-nether,559,paladin,retribution,23,6,17
Tavyy,sylvanas,551,paladin,retribution,15,9,6
Rdmhrvojehr,tarren-mill,541,paladin,retribution,10,7,3
Perrinaybull,magtheridon,528,paladin,retribution,15,6,9
Kawabanga,the-maelstrom,527,paladin,retribution,11,6,5
Pak,amanthul,527,paladin,retribution,15,7,8
Plsdøntusemd,ravencrest,522,paladin,retribution,17,8,9
Тошши,soulflayer,522,paladin,retribution,28,8,20
Aumium,sunstrider,521,paladin,retribution,30,7,23
Råckamoo,emerald-dream,512,paladin,retribution,22,6,16
Vell,bronze-dragonflight,511,paladin,retribution,11,6,5
Babypic,ambossar,511,paladin,retribution,14,6,8
Memororo,stormscale,511,paladin,retribution,20,6,14
Hanterus,antonidas,507,paladin,retribution,14,6,8
Palädörette,dalaran,506,paladin,retribution,11,6,5
Проверялка,thermaplugg,480,paladin,retribution,6,5,1
Bikkuz,kazzak,480,paladin,retribution,6,5,1
Elendor,shadowsong,480,paladin,retribution,6,5,1
Mugraine,ravencrest,480,paladin,retribution,6,5,1
Abukasol,kazzak,480,paladin,retribution,6,5,1
Легейнда,soulflayer,480,paladin,retribution,6,5,1
Yull,twisting-nether,480,paladin,retribution,6,5,1
Demecir,twisting-nether,480,paladin,retribution,6,5,1
Xoriun,norgannon,480,paladin,retribution,6,5,1
Derian,antonidas,480,paladin,retribution,6,5,1
Röland,sanguino,480,paladin,retribution,6,5,1
Eulion,burning-legion,480,paladin,retribution,6,5,1
Ландри,greymane,480,paladin,retribution,6,5,1
Gavain,blackhand,480,paladin,retribution,6,5,1
Тенькопыт,howling-fjord,480,paladin,retribution,6,5,1
Sabríel,ragnaros,480,paladin,retribution,6,5,1
Mipendz,draenor,480,paladin,retribution,6,5,1
Пивняк,eversong,480,paladin,retribution,6,5,1
Voycetwo,frostwolf,480,paladin,retribution,6,5,1
Hølypowah,tarren-mill,480,paladin,retribution,6,5,1
Erin,wildhammer,480,paladin,retribution,6,5,1
Duno,archimonde,480,paladin,retribution,6,5,1
Yezitzme,blackrock,480,paladin,retribution,6,5,1
Percocetx,tarren-mill,480,paladin,retribution,6,5,1
Архемор,ashenvale,480,paladin,retribution,6,5,1
Jacadin,sunstrider,480,paladin,retribution,6,5,1
Ryven,stormscale,480,paladin,retribution,6,5,1
Melvòó,blackrock,480,paladin,retribution,9,6,3
Zethadin,kazzak,480,paladin,retribution,9,6,3
Братстепина,gordunni,480,paladin,retribution,12,5,7
Hazura,blackmoore,480,paladin,retribution,12,5,7
Drylands,ravencrest,480,paladin,retribution,12,5,7
Ophillan,draenor,480,paladin,retribution,12,5,7
Earendìl,blackmoore,480,paladin,retribution,12,5,7
Equityy,burning-legion,480,paladin,retribution,12,5,7
Morggann,drakthul,480,paladin,retribution,12,5,7
Froxies,drakthul,480,paladin,retribution,12,5,7
Скадих,soulflayer,480,paladin,retribution,12,5,7
Bobjohnny,bloodfeather,480,paladin,retribution,12,5,7
Mecah,hyjal,480,paladin,retribution,12,5,7
Hydrolic,blackrock,480,paladin,retribution,12,5,7
Cracish,ragnaros,480,paladin,retribution,12,5,7
Bascelik,outland,480,paladin,retribution,12,5,7
Llighthand,ravencrest,480,paladin,retribution,12,5,7
Roklim,blackhand,480,paladin,retribution,12,5,7
Боремир,borean-tundra,480,paladin,retribution,12,5,7
Yuvile,destromath,480,paladin,retribution,12,5,7
Serjudge,kazzak,480,paladin,retribution,12,5,7
Mozaiczny,burning-legion,480,paladin,retribution,12,5,7
Наолина,gordunni,480,paladin,retribution,12,5,7
Freedomwinds,kazzak,480,paladin,retribution,12,5,7
Vaalé,aegwynn,480,paladin,retribution,12,5,7
Straxotia,twisting-nether,480,paladin,retribution,12,5,7
Krisbull,kazzak,480,paladin,retribution,12,5,7
Måxrajoy,dun-modr,480,paladin,retribution,12,5,7
Ínvi,aegwynn,480,paladin,retribution,12,5,7
Pav,eredar,480,paladin,retribution,12,5,7
Célésté,ravencrest,480,paladin,retribution,12,5,7
Архэла,gordunni,480,paladin,retribution,12,5,7
Zethhx,stormscale,480,paladin,retribution,12,5,7
Dobbygotsock,kazzak,480,paladin,retribution,12,5,7
Retrehsacul,blackrock,480,paladin,retribution,12,5,7
Swapxyr,aegwynn,480,paladin,retribution,12,5,7
Lighttitan,ravencrest,480,paladin,retribution,12,5,7
Jkøø,sanguino,480,paladin,retribution,12,5,7
Salelol,ravencrest,480,paladin,retribution,12,5,7
Angelynor,ysondre,480,paladin,retribution,12,5,7
Hugins,chamber-of-aspects,480,paladin,retribution,12,5,7
Vallorum,ravencrest,480,paladin,retribution,12,5,7
Héphäistos,silvermoon,480,paladin,retribution,12,5,7
Annyaiva,outland,480,paladin,retribution,12,5,7
Sytrexxer,frostwolf,480,paladin,retribution,12,5,7
Bobilous,twisting-nether,480,paladin,retribution,12,5,7
Stavrosy,outland,480,paladin,retribution,12,5,7
Ноулайфир,eversong,480,paladin,retribution,12,5,7
Vanithar,thrall,480,paladin,retribution,12,5,7
Zaopink,blackhand,480,paladin,retribution,12,5,7
Bumboombeem,stormscale,480,paladin,retribution,12,5,7
Lôrelei,blackrock,480,paladin,retribution,12,5,7
Jeriiret,khaz-modan,480,paladin,retribution,12,5,7
Nalaea,arathor,480,paladin,retribution,12,5,7
Ritoru,drekthar,480,paladin,retribution,12,5,7
Ênma,archimonde,480,paladin,retribution,12,5,7
Roflemente,bladefist,480,paladin,retribution,12,5,7
Ksama,ysondre,480,paladin,retribution,12,5,7
Апония,gordunni,480,paladin,retribution,12,5,7
Hipo,zuljin,480,paladin,retribution,12,5,7
Babaluga,blackrock,480,paladin,retribution,12,5,7
Takálus,eredar,480,paladin,retribution,12,5,7
Goofymits,twisting-nether,480,paladin,retribution,12,5,7
Bätïk,blackmoore,480,paladin,retribution,12,5,7
Meriween,ravencrest,480,paladin,retribution,12,5,7
Hifyve,kazzak,480,paladin,retribution,12,5,7
Endavour,ravencrest,480,paladin,retribution,12,5,7
Гниленький,razuvious,480,paladin,retribution,12,5,7
Cêa,blackrock,480,paladin,retribution,12,5,7
Sikthorlan,ravencrest,480,paladin,retribution,12,5,7
Альбусор,galakrond,480,paladin,retribution,12,5,7
Naexea,archimonde,480,paladin,retribution,12,5,7
Qpala,quelthalas,480,paladin,retribution,12,5,7
Kylaz,die-ewige-wacht,480,paladin,retribution,12,5,7
Onishu,blackhand,480,paladin,retribution,12,5,7
Fufth,pozzo-delleternità,480,paladin,retribution,12,5,7
Retlikeme,ravencrest,480,paladin,retribution,12,5,7
Маразоточка,howling-fjord,480,paladin,retribution,12,5,7
Ретроградий,howling-fjord,480,paladin,retribution,12,5,7
Thrinea,blackrock,480,paladin,retribution,12,5,7
Milenia,nemesis,480,paladin,retribution,12,5,7
Destroyér,blackmoore,480,paladin,retribution,12,5,7
Bancu,outland,480,paladin,retribution,12,5,7
Spiritbreak,archimonde,480,paladin,retribution,12,5,7
Dêstî,silvermoon,480,paladin,retribution,12,5,7
Корсаро,deepholm,480,paladin,retribution,12,5,7
Rînedaman,ysondre,480,paladin,retribution,12,5,7
Rafistor,khaz-modan,480,paladin,retribution,19,6,13
Xiuya,dun-modr,480,paladin,retribution,18,5,13
Вэндрик,azuregos,480,paladin,retribution,18,5,13
Thoreas,perenolde,480,paladin,retribution,18,5,13
Ketherian,blutkessel,480,paladin,retribution,18,5,13
Алепос,soulflayer,480,paladin,retribution,18,5,13
Копранесса,soulflayer,480,paladin,retribution,18,5,13
Juicycheeks,frostwolf,480,paladin,retribution,18,5,13
Boyard,silvermoon,480,paladin,retribution,18,5,13
Fleckige,nethersturm,480,paladin,retribution,18,5,13
Ramhal,stormscale,480,paladin,retribution,18,5,13
Eleuterus,bloodfeather,480,paladin,retribution,18,5,13
Saulencio,zuljin,480,paladin,retribution,18,5,13
Powericius,drakthul,480,paladin,retribution,18,5,13
Rizzdaddy,outland,480,paladin,retribution,18,5,13
Cøygonne,archimonde,480,paladin,retribution,18,5,13
Posttal,aggra-português,480,paladin,retribution,18,5,13
Claymore,ravenholdt,480,paladin,retribution,18,5,13
Strätholme,drakthul,480,paladin,retribution,18,5,13
Itsgossiplol,twisting-nether,480,paladin,retribution,24,5,19
Exobyte,stormscale,480,paladin,retribution,24,5,19
Grynd,blackmoore,479,paladin,retribution,6,5,1
Trainingdumy,aszune,479,paladin,retribution,6,5,1
Zvirblis,chamber-of-aspects,479,paladin,retribution,9,6,3
Benø,malganis,479,paladin,retribution,12,5,7
Edwards,sanguino,479,paladin,retribution,12,5,7
Sinalia,shattrath,479,paladin,retribution,12,5,7
Gropleindsup,ysondre,479,paladin,retribution,12,5,7
Майнстер,gordunni,479,paladin,retribution,12,5,7
Rettarded,draenor,479,paladin,retribution,12,5,7
Dykopala,doomhammer,479,paladin,retribution,12,5,7
Эллессар,howling-fjord,479,paladin,retribution,12,5,7
Notholy,defias-brotherhood,479,paladin,retribution,12,5,7
Solyra,blackhand,479,paladin,retribution,12,5,7
Duralyon,marécage-de-zangar,479,paladin,retribution,12,5,7
Сасмен,blackscar,479,paladin,retribution,12,5,7
Ðarkjøjø,hyjal,479,paladin,retribution,12,5,7
Baymanda,tarren-mill,479,paladin,retribution,12,5,7
Antidrasi,turalyon,479,paladin,retribution,12,5,7
Fryl,quelthalas,479,paladin,retribution,12,5,7
Taffz,burning-legion,479,paladin,retribution,12,5,7
Aelaris,dunemaul,479,paladin,retribution,18,5,13
Варасса,grom,479,paladin,retribution,18,5,13
Тэмплари,galakrond,479,paladin,retribution,21,5,16
Медверус,gordunni,479,paladin,retribution,24,5,19
Mysticlight,sylvanas,478,paladin,retribution,18,8,10
Nerdcore,blackrock,478,paladin,retribution,12,5,7
Kanot,outland,478,paladin,retribution,12,5,7
Purpledurple,twisting-nether,478,paladin,retribution,12,5,7
Lawrence,deathwing,478,paladin,retribution,12,5,7
Mirelaw,drakthul,478,paladin,retribution,12,5,7
Glarcouf,eldrethalas,478,paladin,retribution,12,5,7
Четкийчервь,soulflayer,478,paladin,retribution,18,5,13
Zantria,alleria,476,paladin,retribution,12,5,7
Morhgain,kazzak,476,paladin,retribution,18,5,13
Zingler,norgannon,472,paladin,retribution,12,5,7
Yeohinyiu,khaz-modan,472,paladin,retribution,12,5,7
Nollieflip,tarren-mill,457,paladin,retribution,12,7,5
Гкм,howling-fjord,447,paladin,retribution,11,5,6
Slayton,twisting-nether,447,paladin,retribution,11,5,6
Kevlar,frostmane,446,paladin,retribution,12,6,6
Æïs,blackrock,432,paladin,retribution,9,5,4
Mozg,silvermoon,431,paladin,retribution,11,5,6
Sunnyboy,tarren-mill,431,paladin,retribution,11,5,6
Dragonwingz,kazzak,431,paladin,retribution,11,5,6
Îiî,archimonde,426,paladin,retribution,21,6,15
Fortplus,pozzo-delleternità,422,paladin,retribution,12,6,6
Нероблр,gordunni,416,paladin,retribution,10,5,5
Caleel,nemesis,400,paladin,retribution,7,5,2
Сильвернайт,soulflayer,400,paladin,retribution,13,5,8
Tdchopa,ravencrest,384,paladin,retribution,6,4,2
Boaz,norgannon,384,paladin,retribution,6,4,2
Colpadeltank,kazzak,384,paladin,retribution,6,4,2
Petsadin,ravencrest,384,paladin,retribution,6,4,2
Mcnnuggets,ravencrest,384,paladin,retribution,6,4,2
Imtheßoss,pozzo-delleternità,384,paladin,retribution,6,4,2
Lighteousnes,blackmoore,384,paladin,retribution,6,4,2
Dornu,tarren-mill,384,paladin,retribution,6,4,2
Pâlâpâm,blackmoore,384,paladin,retribution,6,4,2
Retdream,nemesis,384,paladin,retribution,6,4,2
Hammerzemall,tarren-mill,384,paladin,retribution,6,4,2
Tehdark,outland,384,paladin,retribution,6,4,2
Erthelios,silvermoon,384,paladin,retribution,6,4,2
Volkai,zuljin,384,paladin,retribution,6,4,2
Valerner,argent-dawn,384,paladin,retribution,6,4,2
Zeportpala,archimonde,384,paladin,retribution,6,4,2
Serratus,thunderhorn,384,paladin,retribution,6,4,2
Xinxin,azshara,384,paladin,retribution,6,4,2
Shevøçk,ravencrest,384,paladin,retribution,6,4,2
Tigurius,zuljin,384,paladin,retribution,6,4,2
Raek,stormscale,384,paladin,retribution,6,4,2
Trefino,blackrock,384,paladin,retribution,6,4,2
Missmyhoj,archimonde,384,paladin,retribution,6,4,2
Neverknõw,draenor,384,paladin,retribution,6,4,2
Zhàø,ysondre,384,paladin,retribution,6,4,2
Angeal,ysondre,384,paladin,retribution,6,4,2
Retqt,eredar,384,paladin,retribution,6,4,2
Wiither,argent-dawn,384,paladin,retribution,6,4,2
Cattelsaan,hyjal,384,paladin,retribution,6,4,2
Иев,howling-fjord,384,paladin,retribution,6,4,2
Röcc,draenor,384,paladin,retribution,6,4,2
Kaähz,archimonde,384,paladin,retribution,6,4,2
Ямыч,ashenvale,384,paladin,retribution,6,4,2
Veldora,zuljin,384,paladin,retribution,6,4,2
Lévrone,alexstrasza,384,paladin,retribution,6,4,2
Соулерт,ashenvale,384,paladin,retribution,6,4,2
Blader,darksorrow,384,paladin,retribution,6,4,2
Joti,proudmoore,384,paladin,retribution,6,4,2
Rölfchen,frostwolf,384,paladin,retribution,6,4,2
Luckyman,aszune,384,paladin,retribution,6,4,2
Justïce,twisting-nether,384,paladin,retribution,6,4,2
Arcillus,stormscale,384,paladin,retribution,6,4,2
Emloses,outland,384,paladin,retribution,6,4,2
Лиадринель,howling-fjord,384,paladin,retribution,6,4,2
Skittlespala,twisting-nether,384,paladin,retribution,6,4,2
Timoxas,kazzak,384,paladin,retribution,6,4,2
Kaedena,kaelthas,384,paladin,retribution,6,4,2
Clementine,spinebreaker,384,paladin,retribution,6,4,2
Kazui,lordaeron,384,paladin,retribution,6,4,2
Bâbass,sargeras,384,paladin,retribution,6,4,2
Крода,deepholm,384,paladin,retribution,6,4,2
Ibuc,blackrock,384,paladin,retribution,6,4,2
Skrýmir,marécage-de-zangar,384,paladin,retribution,6,4,2
Zeggayoda,nemesis,384,paladin,retribution,6,4,2
Sølitude,kazzak,384,paladin,retribution,6,4,2
Sabriaña,silvermoon,384,paladin,retribution,6,4,2
Dragongîrl,lothar,384,paladin,retribution,6,4,2
Zeusp,archimonde,384,paladin,retribution,6,4,2
Òlymp,blackhand,384,paladin,retribution,6,4,2
Судья,greymane,384,paladin,retribution,6,4,2
Panicmaker,ravencrest,384,paladin,retribution,6,4,2
Ðesolace,twisting-nether,384,paladin,retribution,6,4,2
Érléuchtas,kazzak,384,paladin,retribution,6,4,2
Pný,silvermoon,384,paladin,retribution,6,4,2
Nicolae,colinas-pardas,384,paladin,retribution,6,4,2
Spizz,dun-modr,384,paladin,retribution,6,4,2
Бабичпал,soulflayer,384,paladin,retribution,6,4,2
Позабытый,deathweaver,384,paladin,retribution,6,4,2
Jaime,magtheridon,384,paladin,retribution,6,4,2
Hanknpank,quelthalas,384,paladin,retribution,6,4,2
Sunstrider,quelthalas,384,paladin,retribution,6,4,2
Кукусяшка,gordunni,384,paladin,retribution,6,4,2
Retforlife,sylvanas,384,paladin,retribution,6,4,2
Aderos,sylvanas,384,paladin,retribution,6,4,2
Blakkjack,xavius,384,paladin,retribution,6,4,2
Цитрон,blackscar,384,paladin,retribution,6,4,2
Хилоретка,blackscar,384,paladin,retribution,6,4,2
Atanasum,dun-modr,384,paladin,retribution,6,4,2
Драгмитухел,gordunni,384,paladin,retribution,6,4,2
Uragan,blackmoore,384,paladin,retribution,6,4,2
Бэкворд,soulflayer,384,paladin,retribution,6,4,2
Светонносец,gordunni,384,paladin,retribution,6,4,2
Naizem,dun-modr,384,paladin,retribution,6,4,2
Marmotaxx,dun-modr,384,paladin,retribution,6,4,2
Crussaden,stormscale,384,paladin,retribution,7,4,3
Olaghkan,dun-modr,384,paladin,retribution,8,4,4
Shoogle,alonsus,384,paladin,retribution,9,4,5
Beefdaddyy,kazzak,384,paladin,retribution,17,7,10
Хилвкд,blackscar,384,paladin,retribution,11,4,7
Athênâ,azjolnerub,384,paladin,retribution,15,5,10
Inkuboss,nemesis,384,paladin,retribution,12,4,8
Eîon,argent-dawn,384,paladin,retribution,12,4,8
Xòtrios,argent-dawn,384,paladin,retribution,12,4,8
Wankerjim,ghostlands,384,paladin,retribution,12,4,8
Palapaye,archimonde,384,paladin,retribution,12,4,8
Serim,dun-modr,384,paladin,retribution,12,4,8
Andrøiz,dun-modr,384,paladin,retribution,12,4,8
Círuq,eredar,384,paladin,retribution,12,4,8
Øazimutø,archimonde,384,paladin,retribution,12,4,8
Hasart,tarren-mill,384,paladin,retribution,12,4,8
Avengence,dragonblight,384,paladin,retribution,12,4,8
Perxx,stormscale,384,paladin,retribution,12,4,8
Banister,eredar,384,paladin,retribution,12,4,8
Yasfy,stormscale,384,paladin,retribution,12,4,8
Âgreë,frostwhisper,384,paladin,retribution,12,4,8
Crowdev,zuljin,384,paladin,retribution,12,4,8
Neiiz,ragnaros,384,paladin,retribution,12,4,8
Kuhfleisch,eredar,384,paladin,retribution,12,4,8
Pecar,stormscale,384,paladin,retribution,12,4,8
Бладриус,howling-fjord,384,paladin,retribution,12,4,8
Vilayesyo,ravencrest,384,paladin,retribution,12,4,8
Freeloliipop,darksorrow,384,paladin,retribution,12,4,8
Badtrip,bloodscalp,384,paladin,retribution,12,4,8
Galerian,twilights-hammer,384,paladin,retribution,12,4,8
Refléx,zirkel-des-cenarius,384,paladin,retribution,12,4,8
Phorios,agamaggan,384,paladin,retribution,12,4,8
Thiccdeeps,aegwynn,384,paladin,retribution,12,4,8
Karsini,arathor,384,paladin,retribution,12,4,8
Minfa,argent-dawn,384,paladin,retribution,12,4,8
Dêadgame,aegwynn,384,paladin,retribution,12,4,8
Brecs,frostmourne,384,paladin,retribution,12,4,8
Bugohoss,nathrezim,384,paladin,retribution,12,4,8
Typhadin,sylvanas,384,paladin,retribution,12,4,8
Trainors,chamber-of-aspects,384,paladin,retribution,12,4,8
Popelarr,burning-blade,384,paladin,retribution,12,4,8
Phazio,twisting-nether,384,paladin,retribution,12,4,8
Vhestas,dun-modr,384,paladin,retribution,12,4,8
Moløk,ysondre,384,paladin,retribution,12,4,8
Shuukz,blackmoore,384,paladin,retribution,12,4,8
Myû,die-aldor,384,paladin,retribution,12,4,8
Stoneð,antonidas,384,paladin,retribution,12,4,8
Розовыйбабл,gordunni,384,paladin,retribution,12,4,8
Dennyboy,sylvanas,384,paladin,retribution,12,4,8
Quarrel,kul-tiras,384,paladin,retribution,12,4,8
Arkkipiispa,outland,384,paladin,retribution,12,4,8
Шэйкер,blackscar,384,paladin,retribution,12,4,8
Waks,dalaran,384,paladin,retribution,12,4,8
Drhammerdin,antonidas,384,paladin,retribution,12,4,8
Vazayo,ravencrest,384,paladin,retribution,12,4,8
Styxpl,blackhand,384,paladin,retribution,12,4,8
Heidfield,draenor,384,paladin,retribution,12,4,8
Bundagains,silvermoon,384,paladin,retribution,12,4,8
Ippex,silvermoon,384,paladin,retribution,12,4,8
Amburet,kazzak,384,paladin,retribution,12,4,8
Celerius,trollbane,384,paladin,retribution,12,4,8
Pålegg,emerald-dream,384,paladin,retribution,12,4,8
Valzyffs,twisting-nether,384,paladin,retribution,12,4,8
Зираэлис,gordunni,384,paladin,retribution,12,4,8
Ezetrol,xavius,384,paladin,retribution,12,4,8
Cyban,twisting-nether,384,paladin,retribution,12,4,8
Киилаа,gordunni,384,paladin,retribution,12,4,8
Aipal,silvermoon,384,paladin,retribution,12,4,8
Madeofsteel,silvermoon,384,paladin,retribution,12,4,8
Aleya,arathor,384,paladin,retribution,12,4,8
Artoriaz,ravencrest,384,paladin,retribution,12,4,8
Denlow,silvermoon,384,paladin,retribution,12,4,8
Lucretius,kilrogg,384,paladin,retribution,12,4,8
Ngel,marécage-de-zangar,384,paladin,retribution,12,4,8
Benzimus,ragnaros,384,paladin,retribution,12,4,8
Decain,twisting-nether,384,paladin,retribution,12,4,8
Yakuron,blackhand,384,paladin,retribution,12,4,8
Stjusmussel,ragnaros,384,paladin,retribution,12,4,8
Douglazz,tarren-mill,384,paladin,retribution,13,4,9
Artonus,sylvanas,384,paladin,retribution,14,4,10
Алекхей,gordunni,384,paladin,retribution,18,4,14
Forthy,drakthul,384,paladin,retribution,18,4,14
Anesthesiax,ravencrest,384,paladin,retribution,18,4,14
Limitles,nemesis,384,paladin,retribution,18,4,14
Orbia,draenor,384,paladin,retribution,18,4,14
Neyd,hyjal,384,paladin,retribution,18,4,14
Galaerøn,elune,384,paladin,retribution,18,4,14
Cadearas,antonidas,384,paladin,retribution,18,4,14
Halldòr,ravencrest,384,paladin,retribution,18,4,14
Greyeyed,kazzak,384,paladin,retribution,18,4,14
Tobebryant,eonar,383,paladin,retribution,6,4,2
Lancelhot,archimonde,383,paladin,retribution,6,4,2
Krögerelf,garrosh,383,paladin,retribution,6,4,2
Tank,uldum,383,paladin,retribution,6,4,2
Ahritea,blackrock,383,paladin,retribution,6,4,2
Fløki,blackrock,383,paladin,retribution,6,4,2
Рукаф,soulflayer,383,paladin,retribution,6,4,2
Supersnubben,grim-batol,383,paladin,retribution,6,4,2
Azlan,nagrand,383,paladin,retribution,6,4,2
Buddy,conseil-des-ombres,383,paladin,retribution,9,5,4
Paladoon,ravencrest,383,paladin,retribution,12,4,8
Donfilippo,burning-legion,383,paladin,retribution,12,4,8
Käylä,silvermoon,383,paladin,retribution,12,4,8
Ressurection,outland,383,paladin,retribution,12,4,8
Bubblemama,aegwynn,383,paladin,retribution,12,4,8
Giuliagirod,kazzak,383,paladin,retribution,12,4,8
Ратомир,howling-fjord,383,paladin,retribution,14,4,10
Anamary,ravencrest,383,paladin,retribution,15,4,11
Ságé,thrall,383,paladin,retribution,16,4,12
Lavacalistar,turalyon,383,paladin,retribution,21,5,16
Shurikèn,khaz-modan,382,paladin,retribution,6,4,2
Fumatelo,tyrande,382,paladin,retribution,6,4,2
Rockymarcian,hyjal,382,paladin,retribution,12,4,8
Gnarlds,doomhammer,382,paladin,retribution,12,4,8
Куоширо,goldrinn,381,paladin,retribution,12,4,8
Palastratos,turalyon,379,paladin,retribution,12,4,8
Bellight,sinstralis,376,paladin,retribution,19,4,15
Spóntaneous,ravencrest,351,paladin,retribution,8,5,3
Kantfyrste,ravencrest,351,paladin,retribution,11,4,7
Madzy,archimonde,351,paladin,retribution,11,4,7
Joeintkaa,ragnaros,351,paladin,retribution,11,4,7
Zarispal,tarren-mill,336,paladin,retribution,9,5,4
Arear,kazzak,336,paladin,retribution,9,5,4
Strcker,sylvanas,336,paladin,retribution,9,4,5
Serawyn,twisting-nether,336,paladin,retribution,9,4,5
Freemain,doomhammer,336,paladin,retribution,9,4,5
Sunsera,blackrock,330,paladin,retribution,8,5,3
Alanore,tarren-mill,330,paladin,retribution,13,6,7
Rodakinos,outland,330,paladin,retribution,12,5,7
Каплясвета,gordunni,330,paladin,retribution,15,5,10
Enary,zuljin,330,paladin,retribution,15,5,10
Matharr,kazzak,330,paladin,retribution,19,5,14
Stonebeard,ahnqiraj,329,paladin,retribution,25,5,20
Bafbaf,arathi,329,paladin,retribution,30,5,25
Reiwyn,archimonde,320,paladin,retribution,10,4,6
Kyazar,sylvanas,319,paladin,retribution,5,4,1
Strìke,ragnaros,319,paladin,retribution,8,4,4
Kirkmeister,terokkar,319,paladin,retribution,17,5,12
Адептустер,gordunni,319,paladin,retribution,14,4,10
Kýríl,antonidas,319,paladin,retribution,14,4,10
Legitpower,silvermoon,318,paladin,retribution,23,10,13
Majk,hellscream,304,paladin,retribution,19,4,15
Øttøø,outland,288,paladin,retribution,6,3,3
Æternal,arathor,288,paladin,retribution,6,3,3
Skølir,rashgarroth,288,paladin,retribution,6,3,3
Unforsakenx,silvermoon,288,paladin,retribution,6,3,3
Aoldur,ragnaros,288,paladin,retribution,6,3,3
Kelsumi,draenor,288,paladin,retribution,6,3,3
Zeltose,uldaman,288,paladin,retribution,6,3,3
Mayhem,area-52,288,paladin,retribution,6,3,3
Astralenigma,hyjal,288,paladin,retribution,6,3,3
Finñ,sylvanas,288,paladin,retribution,6,3,3
Namapala,silvermoon,288,paladin,retribution,6,3,3
Lixîa,hyjal,288,paladin,retribution,6,3,3
Lóde,silvermoon,288,paladin,retribution,6,3,3
Eldivin,hyjal,288,paladin,retribution,6,3,3
Ruben,kirin-tor,288,paladin,retribution,6,3,3
Мортлайт,soulflayer,288,paladin,retribution,6,3,3
Fahrèl,hyjal,288,paladin,retribution,6,3,3
Neithi,twisting-nether,288,paladin,retribution,6,3,3
Synexy,kazzak,288,paladin,retribution,6,3,3
Evölution,frostmane,288,paladin,retribution,6,3,3
Рукибудды,soulflayer,288,paladin,retribution,6,3,3
Répo,twisting-nether,288,paladin,retribution,6,3,3
Bogrács,silvermoon,288,paladin,retribution,6,3,3
Hione,burning-legion,288,paladin,retribution,6,3,3
Xirôs,zirkel-des-cenarius,288,paladin,retribution,6,3,3
Holyshêêt,draenor,288,paladin,retribution,6,3,3
Fumbz,alakir,288,paladin,retribution,6,3,3
Zetnic,kazzak,288,paladin,retribution,6,3,3
Exero,frostmane,288,paladin,retribution,6,3,3
Mormazor,outland,288,paladin,retribution,6,3,3
Holythore,shadowsong,288,paladin,retribution,6,3,3
Sixtynien,outland,288,paladin,retribution,6,3,3
Illmindofyou,twisting-nether,288,paladin,retribution,6,3,3
Elesmerias,dalaran,288,paladin,retribution,6,3,3
Myradur,burning-legion,288,paladin,retribution,6,3,3
Tonynox,hyjal,288,paladin,retribution,6,3,3
Kielonpala,kazzak,288,paladin,retribution,6,3,3
Stocks,burning-blade,288,paladin,retribution,6,3,3
Retisfine,silvermoon,288,paladin,retribution,6,3,3
Nympa,sylvanas,288,paladin,retribution,6,3,3
Astralz,aegwynn,288,paladin,retribution,6,3,3
Тайронх,soulflayer,288,paladin,retribution,6,3,3
Djpalacinka,drakthul,288,paladin,retribution,6,3,3
Lolsurprise,twisting-nether,288,paladin,retribution,6,3,3
Véngeance,twilights-hammer,288,paladin,retribution,6,3,3
Ñusret,aegwynn,288,paladin,retribution,6,3,3
Partur,stormreaver,288,paladin,retribution,6,3,3
Freakks,twisting-nether,288,paladin,retribution,6,3,3
Tyn,dragonmaw,288,paladin,retribution,6,3,3
Зеппели,gordunni,288,paladin,retribution,6,3,3
Dyonisøs,archimonde,288,paladin,retribution,6,3,3
Poutoux,archimonde,288,paladin,retribution,6,3,3
Môdhân,archimonde,288,paladin,retribution,6,3,3
Retroxy,stormreaver,288,paladin,retribution,6,3,3
Emet,twisting-nether,288,paladin,retribution,6,3,3
Synthesis,uldum,288,paladin,retribution,6,3,3
Lyan,archimonde,288,paladin,retribution,6,3,3
Dízeltekurva,ragnaros,288,paladin,retribution,6,3,3
Киэрсис,howling-fjord,288,paladin,retribution,6,3,3
Eyebluee,tarren-mill,288,paladin,retribution,6,3,3
Névér,steamwheedle-cartel,288,paladin,retribution,6,3,3
Hèmera,archimonde,288,paladin,retribution,6,3,3
Muieiulica,twisting-nether,288,paladin,retribution,6,3,3
Талрэн,howling-fjord,288,paladin,retribution,6,3,3
Bangßros,archimonde,288,paladin,retribution,6,3,3
Golgel,turalyon,288,paladin,retribution,6,3,3
Бигтедо,gordunni,288,paladin,retribution,6,3,3
Cursedd,sanguino,288,paladin,retribution,6,3,3
Taukkï,kazzak,288,paladin,retribution,6,3,3
Gulyas,tarren-mill,288,paladin,retribution,6,3,3
Rômtone,dalaran,288,paladin,retribution,6,3,3
Yaldly,dun-modr,288,paladin,retribution,6,3,3
Ïrönhämmër,argent-dawn,288,paladin,retribution,6,3,3
Reptoglad,archimonde,288,paladin,retribution,6,3,3
Curt,sanguino,288,paladin,retribution,6,3,3
Sekoran,sunstrider,288,paladin,retribution,6,3,3
Animegifx,ragnaros,288,paladin,retribution,6,3,3
Лайсен,gordunni,288,paladin,retribution,6,3,3
Cloudlight,argent-dawn,288,paladin,retribution,6,3,3
Akcope,thunderhorn,288,paladin,retribution,6,3,3
Kolts,ragnaros,288,paladin,retribution,6,3,3
Palapouffe,khaz-modan,288,paladin,retribution,6,3,3
Uriel,scarshield-legion,288,paladin,retribution,6,3,3
Бэнсон,ashenvale,288,paladin,retribution,6,3,3
Isgarot,pozzo-delleternità,288,paladin,retribution,6,3,3
Palá,dun-modr,288,paladin,retribution,6,3,3
Partysyster,defias-brotherhood,288,paladin,retribution,6,3,3
Minirempart,khaz-modan,288,paladin,retribution,6,3,3
Gaizilla,burning-blade,288,paladin,retribution,6,3,3
Кс,greymane,288,paladin,retribution,6,3,3
Veo,sylvanas,288,paladin,retribution,6,3,3
Milkzaddy,kazzak,288,paladin,retribution,6,3,3
Stárchy,terenas,288,paladin,retribution,6,3,3
Vultrix,tarren-mill,288,paladin,retribution,6,3,3
ßßæßßæßß,stormscale,288,paladin,retribution,6,3,3
Zondãn,blackrock,288,paladin,retribution,6,3,3
Moolurk,stormscale,288,paladin,retribution,6,3,3
Fogell,ravencrest,288,paladin,retribution,6,3,3
Steínsgate,ravencrest,288,paladin,retribution,6,3,3
Arkhàn,ravencrest,288,paladin,retribution,6,3,3
Ðåøóýöøðí,ravencrest,288,paladin,retribution,6,3,3
Raketenreiko,blackrock,288,paladin,retribution,6,3,3
Cilodin,blackrock,288,paladin,retribution,6,3,3
Ozen,blackrock,288,paladin,retribution,6,3,3
Bämschi,blackrock,288,paladin,retribution,6,3,3
Sarunan,ravencrest,288,paladin,retribution,6,3,3
Divineovic,ravencrest,288,paladin,retribution,6,3,3
Thandoro,amanthul,288,paladin,retribution,6,3,3
Krýptø,ravencrest,288,paladin,retribution,6,3,3
Paidi,die-todeskrallen,288,paladin,retribution,6,3,3
Prâtox,blackmoore,288,paladin,retribution,6,3,3
Grial,eredar,288,paladin,retribution,6,3,3
Sekztokio,blackmoore,288,paladin,retribution,6,3,3
Silverglaze,defias-brotherhood,288,paladin,retribution,6,3,3
Strangerx,blackrock,288,paladin,retribution,6,3,3
Shaká,ravencrest,288,paladin,retribution,6,3,3
Lyrïcs,ysondre,288,paladin,retribution,6,3,3
Серёжблондин,gordunni,288,paladin,retribution,6,3,3
Lbj,eredar,288,paladin,retribution,6,3,3
Jpally,ravencrest,288,paladin,retribution,6,3,3
Aklime,blackmoore,288,paladin,retribution,6,3,3
Tyranius,bronzebeard,288,paladin,retribution,6,3,3
Дджаб,booty-bay,288,paladin,retribution,6,3,3
Киръпич,grom,288,paladin,retribution,6,3,3
Lotheirid,antonidas,288,paladin,retribution,6,3,3
Xirac,antonidas,288,paladin,retribution,6,3,3
Shrøømz,antonidas,288,paladin,retribution,6,3,3
Рамстафарай,gordunni,288,paladin,retribution,6,3,3
Sakulchan,antonidas,288,paladin,retribution,6,3,3
Pigma,outland,288,paladin,retribution,9,4,5
Aresian,burning-legion,288,paladin,retribution,7,3,4
Aenhel,zuljin,288,paladin,retribution,11,4,7
Parlma,naxxramas,288,paladin,retribution,13,4,9
Dragg,kirin-tor,288,paladin,retribution,10,3,7
Miqee,burning-legion,288,paladin,retribution,12,3,9
Масачусетсс,gordunni,288,paladin,retribution,12,3,9
Найдэкер,gordunni,288,paladin,retribution,12,3,9
Аладушок,gordunni,288,paladin,retribution,12,3,9
Strikè,stormscale,288,paladin,retribution,12,3,9
Dalaly,kazzak,288,paladin,retribution,12,3,9
Izelv,dalaran,288,paladin,retribution,12,3,9
Cydor,khaz-modan,288,paladin,retribution,12,3,9
Lucyd,stormscale,288,paladin,retribution,12,3,9
Pascual,magtheridon,288,paladin,retribution,12,3,9
Cigoveth,sylvanas,288,paladin,retribution,12,3,9
Annurra,quelthalas,288,paladin,retribution,12,3,9
Skuzee,archimonde,288,paladin,retribution,12,3,9
Simsaii,stormscale,288,paladin,retribution,12,3,9
Ваэлин,deathweaver,288,paladin,retribution,12,3,9
Mandingbull,stormscale,288,paladin,retribution,12,3,9
Cilla,kult-der-verdammten,288,paladin,retribution,12,3,9
Загошслакер,howling-fjord,288,paladin,retribution,12,3,9
Dmascus,blackrock,288,paladin,retribution,12,3,9
Sangaro,ragnaros,288,paladin,retribution,12,3,9
Омникнайтх,howling-fjord,288,paladin,retribution,12,3,9
Dathea,aegwynn,288,paladin,retribution,12,3,9
Djuwuu,twisting-nether,288,paladin,retribution,12,3,9
Blecheîmer,aegwynn,288,paladin,retribution,12,3,9
Windîr,draenor,288,paladin,retribution,12,3,9
Pikoman,hellfire,288,paladin,retribution,12,3,9
Lylennâ,argent-dawn,288,paladin,retribution,12,3,9
Эеомли,blackscar,288,paladin,retribution,12,3,9
Daddysiliam,ravencrest,288,paladin,retribution,12,3,9
Ahreesh,blackrock,288,paladin,retribution,12,3,9
Kypamop,argent-dawn,288,paladin,retribution,12,3,9
Ragen,kazzak,288,paladin,retribution,12,3,9
Trollpaladin,blackmoore,288,paladin,retribution,12,3,9
Whórainzóne,eredar,288,paladin,retribution,12,3,9
Lacrossé,kazzak,288,paladin,retribution,12,3,9
Budweison,silvermoon,288,paladin,retribution,12,3,9
Ауё,blackscar,288,paladin,retribution,12,3,9
Dwangl,silvermoon,288,paladin,retribution,12,3,9
Xzpal,silvermoon,288,paladin,retribution,12,3,9
Wolluna,frostwolf,288,paladin,retribution,12,3,9
Çolette,silvermoon,288,paladin,retribution,12,3,9
Ашилолпро,soulflayer,288,paladin,retribution,12,3,9
Arthàs,blackmoore,288,paladin,retribution,12,3,9
Quaterbâck,antonidas,288,paladin,retribution,12,3,9
Deholyloa,frostwhisper,288,paladin,retribution,12,3,9
Legâin,twisting-nether,288,paladin,retribution,12,3,9
Turbopal,burning-blade,288,paladin,retribution,12,3,9
Moriex,drakthul,288,paladin,retribution,12,3,9
Nordiusek,drakthul,288,paladin,retribution,12,3,9
Diccari,stormreaver,288,paladin,retribution,12,3,9
Мува,soulflayer,288,paladin,retribution,14,3,11
Cilise,bronzebeard,288,paladin,retribution,18,3,15
Ллосла,howling-fjord,288,paladin,retribution,18,3,15
Lättäkamerus,ravencrest,288,paladin,retribution,18,3,15
Ulderoth,dun-modr,288,paladin,retribution,18,3,15
Lééroÿ,sylvanas,287,paladin,retribution,8,4,4
Sìegfrìed,sargeras,287,paladin,retribution,6,3,3
Lewanor,tarren-mill,287,paladin,retribution,6,3,3
Hrubo,drakthul,287,paladin,retribution,6,3,3
Ïwâ,hyjal,287,paladin,retribution,6,3,3
Nauriell,blackmoore,287,paladin,retribution,6,3,3
Raerion,ragnaros,287,paladin,retribution,6,3,3
Dadpally,shattered-hand,287,paladin,retribution,6,3,3
Артуроэльф,eversong,287,paladin,retribution,9,3,6
Cajikpal,drakthul,287,paladin,retribution,12,3,9
Trevorion,argent-dawn,287,paladin,retribution,12,3,9
Bore,culte-de-la-rive-noire,287,paladin,retribution,12,3,9
Voraxpa,draenor,287,paladin,retribution,12,3,9
Rsanchez,frostwolf,286,paladin,retribution,6,3,3
Yeretria,krasus,286,paladin,retribution,6,3,3
Tofrus,kazzak,271,paladin,retribution,11,3,8
Brictom,tarren-mill,271,paladin,retribution,11,3,8
Рбгхил,howling-fjord,271,paladin,retribution,11,3,8
Davairabotai,kazzak,255,paladin,retribution,14,4,10
Gõm,aegwynn,239,paladin,retribution,5,3,2
Theodun,xavius,239,paladin,retribution,5,3,2
Akeemys,ragnaros,239,paladin,retribution,5,3,2
Tivv,blackhand,239,paladin,retribution,5,3,2
Erannor,kirin-tor,239,paladin,retribution,5,3,2
Crîîngêr,blackhand,239,paladin,retribution,5,3,2
Loire,blackmoore,239,paladin,retribution,5,3,2
Manyouk,kazzak,239,paladin,retribution,5,3,2
Pooncy,ragnaros,239,paladin,retribution,5,3,2
Töphuria,silvermoon,239,paladin,retribution,5,3,2
Tÿy,sylvanas,234,paladin,retribution,8,4,4
Pelbo,ravencrest,234,paladin,retribution,9,4,5
Dørvâp,culte-de-la-rive-noire,234,paladin,retribution,11,4,7
Ranish,aegwynn,234,paladin,retribution,15,4,11
Ренегадер,thermaplugg,233,paladin,retribution,6,4,2
Jcpd,drakthul,224,paladin,retribution,10,3,7
Тайела,gordunni,192,paladin,retribution,4,3,1
Toruk,burning-legion,192,paladin,retribution,4,3,1
Pitux,dun-modr,192,paladin,retribution,4,3,1
Holyape,argent-dawn,192,paladin,retribution,6,2,4
Потрепал,blackscar,192,paladin,retribution,6,2,4
Mangz,ysondre,192,paladin,retribution,6,2,4
Jimrogier,argent-dawn,192,paladin,retribution,6,2,4
Ustex,argent-dawn,192,paladin,retribution,6,2,4
Nozgot,chromaggus,192,paladin,retribution,6,2,4
Fannypoo,sylvanas,192,paladin,retribution,6,2,4
Støøk,shendralar,192,paladin,retribution,6,2,4
Clerik,eredar,192,paladin,retribution,6,2,4
Spellcrow,argent-dawn,192,paladin,retribution,6,2,4
Aal,eredar,192,paladin,retribution,6,2,4
Боевикс,ashenvale,192,paladin,retribution,6,2,4
Холигор,deathguard,192,paladin,retribution,6,2,4
Zuldekk,sanguino,192,paladin,retribution,6,2,4
Pyronort,eredar,192,paladin,retribution,6,2,4
Palacheatlol,ysondre,192,paladin,retribution,6,2,4
Xephiroxus,the-venture-co,192,paladin,retribution,6,2,4
Дэвсон,greymane,192,paladin,retribution,6,2,4
Легионор,galakrond,192,paladin,retribution,6,2,4
Гачипаладинн,galakrond,192,paladin,retribution,6,2,4
Антитеррор,greymane,192,paladin,retribution,6,2,4
Azapala,kazzak,192,paladin,retribution,6,2,4
Paradice,ragnaros,192,paladin,retribution,6,2,4
Postî,eredar,192,paladin,retribution,6,2,4
Waramo,eredar,192,paladin,retribution,6,2,4
Starr,confrérie-du-thorium,192,paladin,retribution,6,2,4
Дэвайнэвил,gordunni,192,paladin,retribution,6,2,4
Bakasnoop,hyjal,192,paladin,retribution,6,2,4
Fortination,dalaran,192,paladin,retribution,6,2,4
Daizen,blackrock,192,paladin,retribution,6,2,4
Frías,zuljin,192,paladin,retribution,6,2,4
Logmár,sanguino,192,paladin,retribution,6,2,4
Zephale,sunstrider,192,paladin,retribution,6,2,4
Labier,tarren-mill,192,paladin,retribution,6,2,4
Vans,nazjatar,192,paladin,retribution,6,2,4
Alus,blackmoore,192,paladin,retribution,6,2,4
Stinkytoes,draenor,192,paladin,retribution,6,2,4
Eneomaos,blackrock,192,paladin,retribution,6,2,4
Razarus,sylvanas,192,paladin,retribution,6,2,4
Гермесиус,deepholm,192,paladin,retribution,6,2,4
Sertoli,frostwhisper,192,paladin,retribution,6,2,4
Malvax,ragnaros,192,paladin,retribution,6,2,4
Drasir,nemesis,192,paladin,retribution,6,2,4
Maxunius,antonidas,192,paladin,retribution,6,2,4
Serethor,blackrock,192,paladin,retribution,6,2,4
Héraclèss,marécage-de-zangar,192,paladin,retribution,6,2,4
Strøb,antonidas,192,paladin,retribution,6,2,4
Ðeswynd,hyjal,192,paladin,retribution,6,2,4
Yømø,antonidas,192,paladin,retribution,6,2,4
Doormat,stormreaver,192,paladin,retribution,6,2,4
Altoangelo,outland,192,paladin,retribution,6,2,4
Ревирант,howling-fjord,192,paladin,retribution,6,2,4
Manole,ravencrest,192,paladin,retribution,6,2,4
Víii,outland,192,paladin,retribution,6,2,4
Кадаврициан,howling-fjord,192,paladin,retribution,6,2,4
Armion,stormscale,192,paladin,retribution,6,2,4
Japsee,runetotem,192,paladin,retribution,6,2,4
Hännó,malganis,192,paladin,retribution,6,2,4
Carpetcummer,ravencrest,192,paladin,retribution,6,2,4
Flashhèart,draenor,192,paladin,retribution,6,2,4
Shufflee,drakthul,192,paladin,retribution,6,2,4
Drjudge,draenor,192,paladin,retribution,6,2,4
Takezop,dun-modr,192,paladin,retribution,6,2,4
Ярлд,gordunni,192,paladin,retribution,6,2,4
Milipal,hyjal,192,paladin,retribution,6,2,4
Destroyer,archimonde,192,paladin,retribution,6,2,4
Legendaryxw,drakthul,192,paladin,retribution,6,2,4
Shápzx,draenor,192,paladin,retribution,6,2,4
Quennten,grim-batol,192,paladin,retribution,6,2,4
Blurengo,blackrock,192,paladin,retribution,6,2,4
Dollicia,outland,192,paladin,retribution,6,2,4
Riares,darkspear,192,paladin,retribution,6,2,4
Canihavesome,sylvanas,192,paladin,retribution,6,2,4
Myrmidan,magtheridon,192,paladin,retribution,6,2,4
Slymm,archimonde,192,paladin,retribution,6,2,4
Oldsurehand,blackmoore,192,paladin,retribution,6,2,4
Djstompyasis,blackmoore,192,paladin,retribution,6,2,4
Сенторин,borean-tundra,192,paladin,retribution,6,2,4
Загадзуга,howling-fjord,192,paladin,retribution,6,2,4
Caribbean,outland,192,paladin,retribution,6,2,4
Yumhi,dun-modr,192,paladin,retribution,6,2,4
Rivela,bloodhoof,192,paladin,retribution,6,2,4
Mathrixo,silvermoon,192,paladin,retribution,6,2,4
Ньюзеропал,howling-fjord,192,paladin,retribution,6,2,4
Unzufrieden,silvermoon,192,paladin,retribution,6,2,4
Knusern,dunemaul,192,paladin,retribution,6,2,4
Paxillustral,twisting-nether,192,paladin,retribution,6,2,4
Эйлара,howling-fjord,192,paladin,retribution,6,2,4
Trainwréck,ravencrest,192,paladin,retribution,6,2,4
Arator,terenas,192,paladin,retribution,6,2,4
Туларион,grom,192,paladin,retribution,6,2,4
Mainôs,ravencrest,192,paladin,retribution,6,2,4
Fizzyy,ragnaros,192,paladin,retribution,6,2,4
Gaab,aggra-português,192,paladin,retribution,6,2,4
Némesis,frostmane,192,paladin,retribution,6,2,4
Palaur,silvermoon,192,paladin,retribution,6,2,4
Rinocerb,ravencrest,192,paladin,retribution,6,2,4
Ijego,silvermoon,192,paladin,retribution,6,2,4
Бордюрчег,howling-fjord,192,paladin,retribution,6,2,4
Alto,nordrassil,192,paladin,retribution,6,2,4
Lightsimper,silvermoon,192,paladin,retribution,6,2,4
Noxy,thrall,192,paladin,retribution,6,2,4
Ultrabenzo,ravencrest,192,paladin,retribution,6,2,4
Shassera,ravencrest,192,paladin,retribution,6,2,4
Paladéán,malganis,192,paladin,retribution,6,2,4
Vikingensven,silvermoon,192,paladin,retribution,6,2,4
Пепескарлет,howling-fjord,192,paladin,retribution,6,2,4
Arthacalan,silvermoon,192,paladin,retribution,6,2,4
Ainnamash,twisting-nether,192,paladin,retribution,6,2,4
Døgpaladin,outland,192,paladin,retribution,6,2,4
Palek,burning-legion,192,paladin,retribution,6,2,4
Bozznamaan,thrall,192,paladin,retribution,6,2,4
Всеволорд,howling-fjord,192,paladin,retribution,6,2,4
Necrozi,stormscale,192,paladin,retribution,6,2,4
Grìmmjøw,silvermoon,192,paladin,retribution,6,2,4
Dàk,grim-batol,192,paladin,retribution,6,2,4
Daviaa,silvermoon,192,paladin,retribution,6,2,4
Bálerion,bronze-dragonflight,192,paladin,retribution,6,2,4
Djrayk,archimonde,192,paladin,retribution,6,2,4
Breakafly,doomhammer,192,paladin,retribution,6,2,4
Blazeê,blackrock,192,paladin,retribution,6,2,4
Ghéttørèt,das-konsortium,192,paladin,retribution,6,2,4
Zbykmasta,burning-legion,192,paladin,retribution,6,2,4
Ashariah,die-aldor,192,paladin,retribution,6,2,4
Олегсудья,howling-fjord,192,paladin,retribution,6,2,4
Сильверный,gordunni,192,paladin,retribution,6,2,4
Скруддж,howling-fjord,192,paladin,retribution,6,2,4
Soralî,dethecus,192,paladin,retribution,6,2,4
Wingsftw,blackhand,192,paladin,retribution,6,2,4
Bigolcritty,silvermoon,192,paladin,retribution,6,2,4
Rdypaladin,ravencrest,192,paladin,retribution,6,2,4
Дрейв,soulflayer,192,paladin,retribution,6,2,4
Palakag,blackhand,192,paladin,retribution,6,2,4
Далходж,soulflayer,192,paladin,retribution,6,2,4
Nasrudan,ravenholdt,192,paladin,retribution,6,2,4
Maxximuss,drekthar,192,paladin,retribution,6,2,4
Tomforøl,aggramar,192,paladin,retribution,6,2,4
Horgar,nagrand,192,paladin,retribution,6,2,4
Winterwall,sylvanas,192,paladin,retribution,6,2,4
Vcd,kazzak,192,paladin,retribution,6,2,4
Valanyr,kazzak,192,paladin,retribution,6,2,4
Phaewingsftw,kazzak,192,paladin,retribution,6,2,4
Heilgaharald,blackrock,192,paladin,retribution,6,2,4
Gornim,die-nachtwache,192,paladin,retribution,6,2,4
Panomecon,magtheridon,192,paladin,retribution,6,2,4
Blinkdrink,ragnaros,192,paladin,retribution,6,2,4
Leroya,blackrock,192,paladin,retribution,6,2,4
Rétalin,blackhand,192,paladin,retribution,6,2,4
Drident,die-nachtwache,192,paladin,retribution,6,2,4
Samypalouf,naxxramas,192,paladin,retribution,6,2,4
Фэрплэйн,gordunni,192,paladin,retribution,6,2,4
Плат,gordunni,192,paladin,retribution,7,2,5
Mêyra,blackhand,192,paladin,retribution,8,2,6
Кольт,borean-tundra,192,paladin,retribution,10,2,8
Rîex,alleria,192,paladin,retribution,12,2,10
Remedios,archimonde,192,paladin,retribution,12,2,10
Wigbilly,tarren-mill,192,paladin,retribution,12,2,10
Мунрейм,gordunni,192,paladin,retribution,12,2,10
Vivike,silvermoon,192,paladin,retribution,12,2,10
Tressðr,dun-modr,192,paladin,retribution,12,2,10
Skemfar,sanguino,192,paladin,retribution,12,2,10
Лимфома,goldrinn,192,paladin,retribution,12,2,10
Hordium,doomhammer,192,paladin,retribution,12,2,10
Muuclear,twisting-nether,192,paladin,retribution,12,2,10
Enîgmä,ravencrest,192,paladin,retribution,12,2,10
Rùuru,archimonde,192,paladin,retribution,12,2,10
Verix,thrall,192,paladin,retribution,12,2,10
Leriell,ravencrest,192,paladin,retribution,12,2,10
Samious,draenor,192,paladin,retribution,12,2,10
Mariuhûna,blackmoore,192,paladin,retribution,12,2,10
Galaadh,archimonde,192,paladin,retribution,12,2,10
Konardos,burning-legion,192,paladin,retribution,12,2,10
Pârâsite,hyjal,192,paladin,retribution,12,2,10
Dananas,draenor,192,paladin,retribution,12,2,10
Cunix,draenor,192,paladin,retribution,12,2,10
Luzk,sanguino,192,paladin,retribution,12,2,10
Rhyua,eredar,192,paladin,retribution,12,2,10
Erathör,sanguino,192,paladin,retribution,12,2,10
Reinwaltz,the-maelstrom,192,paladin,retribution,12,2,10
Lightian,twisting-nether,192,paladin,retribution,12,2,10
Kökslaktarn,sylvanas,192,paladin,retribution,21,3,18
Stillgard,ghostlands,192,paladin,retribution,15,2,13
Cyxanacma,silvermoon,192,paladin,retribution,18,2,16
Mattüsälëmm,sanguino,191,paladin,retribution,4,3,1
Milicos,sylvanas,191,paladin,retribution,6,2,4
Duckula,ravenholdt,191,paladin,retribution,6,2,4
Севенола,galakrond,191,paladin,retribution,6,2,4
Ârthâstrâs,terrordar,191,paladin,retribution,6,2,4
Broziopath,blackrock,191,paladin,retribution,6,2,4
Derbrècher,azshara,191,paladin,retribution,6,2,4
Maitrelampe,argent-dawn,180,paladin,retribution,29,7,22
Thelronis,kelthuzad,175,paladin,retribution,11,2,9
Sagittaxx,kazzak,159,paladin,retribution,5,2,3
Heiemdall,azuremyst,159,paladin,retribution,5,2,3
Geronimooh,vashj,159,paladin,retribution,5,2,3
Trístesse,tarren-mill,159,paladin,retribution,11,2,9
Амнон,goldrinn,144,paladin,retribution,9,2,7
Tayun,blackmoore,144,paladin,retribution,15,2,13
Еребор,howling-fjord,143,paladin,retribution,15,2,13
Braiinafk,thrall,138,paladin,retribution,6,3,3
Скелфер,soulflayer,138,paladin,retribution,8,3,5
Jesamine,blackmoore,138,paladin,retribution,9,3,6
Qpax,twisting-nether,128,paladin,retribution,4,2,2
Glâdiatør,blackrock,128,paladin,retribution,4,2,2
Mouzimaru,tarren-mill,128,paladin,retribution,10,2,8
Маефис,gordunni,96,paladin,retribution,3,2,1
Aalyaah,zirkel-des-cenarius,96,paladin,retribution,3,2,1
Kelianna,drakthul,96,paladin,retribution,3,2,1
Artplex,ravencrest,96,paladin,retribution,6,1,5
Dildodin,ravencrest,96,paladin,retribution,6,1,5
Amoxapine,hyjal,96,paladin,retribution,6,1,5
Cazzanova,draenor,96,paladin,retribution,6,1,5
Diggs,draenor,96,paladin,retribution,6,1,5
Holyhannes,blackmoore,96,paladin,retribution,6,1,5
Harvel,outland,96,paladin,retribution,6,1,5
Kefalas,ravencrest,96,paladin,retribution,6,1,5
Kimozabie,ravencrest,96,paladin,retribution,6,1,5
Palandiade,draenor,96,paladin,retribution,6,1,5
Хилтонепта,gordunni,96,paladin,retribution,6,1,5
Bergalerga,frostmane,96,paladin,retribution,6,1,5
Édèn,les-sentinelles,96,paladin,retribution,6,1,5
Rekkt,ravenholdt,96,paladin,retribution,6,1,5
Йенфира,gordunni,96,paladin,retribution,6,1,5
Xerya,dun-modr,96,paladin,retribution,6,1,5
Zlätän,outland,96,paladin,retribution,6,1,5
Пашштет,gordunni,96,paladin,retribution,6,1,5
Винзерг,ashenvale,96,paladin,retribution,6,1,5
Bigfatpig,ravencrest,96,paladin,retribution,6,1,5
Inmortality,sanguino,96,paladin,retribution,6,1,5
Fatalism,draenor,96,paladin,retribution,6,1,5
Ellisdee,kazzak,96,paladin,retribution,6,1,5
Leoniidas,cthun,96,paladin,retribution,6,1,5
Celsia,blackrock,96,paladin,retribution,6,1,5
Scorebit,draenor,96,paladin,retribution,6,1,5
Päyback,nagrand,96,paladin,retribution,6,1,5
Lezoom,draenor,96,paladin,retribution,6,1,5
Xôpâl,kazzak,96,paladin,retribution,6,1,5
Notingvar,doomhammer,96,paladin,retribution,6,1,5
Holyloa,laughing-skull,96,paladin,retribution,6,1,5
Блейзр,ashenvale,96,paladin,retribution,6,1,5
Ansonia,ravencrest,96,paladin,retribution,6,1,5
Lowfi,argent-dawn,96,paladin,retribution,6,1,5
Taraniah,argent-dawn,96,paladin,retribution,6,1,5
Traxxces,ravencrest,96,paladin,retribution,6,1,5
Xanrian,kazzak,96,paladin,retribution,6,1,5
Møg,blackrock,96,paladin,retribution,6,1,5
Graphpora,argent-dawn,96,paladin,retribution,6,1,5
Akagami,ysondre,96,paladin,retribution,6,1,5
Мэркес,fordragon,96,paladin,retribution,6,1,5
Trwwsano,stormscale,96,paladin,retribution,6,1,5
Palamaister,stormscale,96,paladin,retribution,6,1,5
Serberen,ravencrest,96,paladin,retribution,6,1,5
Elbígotes,dun-modr,96,paladin,retribution,6,1,5
Ashreaver,burning-legion,96,paladin,retribution,6,1,5
Холишокович,deathweaver,96,paladin,retribution,6,1,5
Destya,eredar,96,paladin,retribution,6,1,5
Эльтарус,soulflayer,96,paladin,retribution,6,1,5
Skarium,hyjal,96,paladin,retribution,6,1,5
Pussas,burning-legion,96,paladin,retribution,6,1,5
Фатумм,howling-fjord,96,paladin,retribution,6,1,5
Старыйграф,gordunni,96,paladin,retribution,6,1,5
Vokesh,silvermoon,96,paladin,retribution,6,1,5
Popolelo,dun-modr,96,paladin,retribution,6,1,5
Dawnbringer,stormscale,96,paladin,retribution,6,1,5
Bobsing,silvermoon,96,paladin,retribution,6,1,5
Dänie,silvermoon,96,paladin,retribution,6,1,5
Моррзито,soulflayer,96,paladin,retribution,6,1,5
Hiilton,silvermoon,96,paladin,retribution,6,1,5
Miawyn,blackmoore,96,paladin,retribution,6,1,5
Tíríón,nethersturm,96,paladin,retribution,6,1,5
Stabilisator,blackrock,96,paladin,retribution,6,1,5
Vindorus,archimonde,96,paladin,retribution,6,1,5
Monmo,emerald-dream,96,paladin,retribution,6,1,5
Friemelaar,silvermoon,96,paladin,retribution,6,1,5
Lagrops,chants-éternels,96,paladin,retribution,6,1,5
Жмышенко,gordunni,96,paladin,retribution,6,1,5
Shanilia,argent-dawn,96,paladin,retribution,6,1,5
Nîcolascage,stormscale,96,paladin,retribution,6,1,5
Bôomayé,archimonde,96,paladin,retribution,6,1,5
Flashyo,archimonde,96,paladin,retribution,6,1,5
Valiscar,antonidas,96,paladin,retribution,6,1,5
Azhrei,archimonde,96,paladin,retribution,6,1,5
Battlelord,terokkar,96,paladin,retribution,6,1,5
Yaloh,sylvanas,96,paladin,retribution,6,1,5
Светиздырки,howling-fjord,96,paladin,retribution,6,1,5
Пилоттыч,gordunni,96,paladin,retribution,6,1,5
Thaderyl,auchindoun,96,paladin,retribution,6,1,5
Hølyshøckz,blackmoore,96,paladin,retribution,6,1,5
Prínce,blackmoore,96,paladin,retribution,6,1,5
Évo,drakthul,96,paladin,retribution,6,1,5
Jûliâ,archimonde,96,paladin,retribution,6,1,5
Nijówka,burning-legion,96,paladin,retribution,6,1,5
Palachdinka,drakthul,96,paladin,retribution,6,1,5
Steelrose,auchindoun,96,paladin,retribution,6,1,5
Nexo,bloodscalp,96,paladin,retribution,6,1,5
Zandathor,chamber-of-aspects,96,paladin,retribution,6,1,5
Rataxes,stormreaver,96,paladin,retribution,6,1,5
Aion,chamber-of-aspects,96,paladin,retribution,6,1,5
Tamuz,chamber-of-aspects,96,paladin,retribution,6,1,5
Aluzza,sylvanas,96,paladin,retribution,6,1,5
Karo,wildhammer,96,paladin,retribution,6,1,5
Tozzey,defias-brotherhood,96,paladin,retribution,6,1,5
Bráders,thunderhorn,96,paladin,retribution,6,1,5
Naska,nemesis,96,paladin,retribution,6,1,5
Methynox,khaz-modan,96,paladin,retribution,6,1,5
Fraubest,antonidas,96,paladin,retribution,6,1,5
Zeroskills,tarren-mill,96,paladin,retribution,6,1,5
Hyggë,sanguino,96,paladin,retribution,6,1,5
Saedrick,nemesis,96,paladin,retribution,6,1,5
Highlòrd,silvermoon,96,paladin,retribution,6,1,5
Blakethorn,silvermoon,96,paladin,retribution,6,1,5
Szaporító,ragnaros,96,paladin,retribution,6,1,5
Paladzor,twisting-nether,96,paladin,retribution,6,1,5
Késha,malganis,96,paladin,retribution,6,1,5
Kambood,twisting-nether,96,paladin,retribution,6,1,5
Zarifence,ragnaros,96,paladin,retribution,6,1,5
Omranator,stormscale,96,paladin,retribution,6,1,5
Slipoj,blackhand,96,paladin,retribution,6,1,5
Aggressìon,twisting-nether,96,paladin,retribution,6,1,5
Pianiste,sinstralis,96,paladin,retribution,6,1,5
Atacan,twisting-nether,96,paladin,retribution,6,1,5
Phlakorn,blackhand,96,paladin,retribution,6,1,5
Defuzes,twisting-nether,96,paladin,retribution,6,1,5
Eylina,ragnaros,96,paladin,retribution,6,1,5
Crawini,ragnaros,96,paladin,retribution,6,1,5
Azmocore,blackhand,96,paladin,retribution,6,1,5
Ragie,twisting-nether,96,paladin,retribution,6,1,5
Sâfcon,eredar,96,paladin,retribution,7,1,6
Borons,silvermoon,96,paladin,retribution,9,1,8
Xvoodoo,antonidas,96,paladin,retribution,11,1,10
Agrkan,defias-brotherhood,96,paladin,retribution,11,1,10
Jaexpaladin,draenor,96,paladin,retribution,12,1,11
Dodgemyhoj,kazzak,96,paladin,retribution,12,1,11
Kavíár,kazzak,96,paladin,retribution,12,1,11
Lylu,aggramar,96,paladin,retribution,12,1,11
Kaelorian,silvermoon,96,paladin,retribution,12,1,11
Jayce,durotan,96,paladin,retribution,12,1,11
Purgator,sanguino,96,paladin,retribution,12,1,11
Fenik,dun-modr,96,paladin,retribution,12,1,11
Pepegasensei,ravencrest,96,paladin,retribution,12,1,11
Mâttyy,stormscale,96,paladin,retribution,12,1,11
Snakedubaby,blackrock,96,paladin,retribution,12,1,11
Nauy,korgall,96,paladin,retribution,12,1,11
Charlybrown,archimonde,95,paladin,retribution,6,1,5
Uriziel,the-shatar,95,paladin,retribution,6,1,5
Émøùki,dalaran,79,paladin,retribution,5,1,4
Rhauk,dun-modr,79,paladin,retribution,5,1,4
Pastaflwras,twisting-nether,64,paladin,retribution,4,1,3
Snobypala,onyxia,64,paladin,retribution,4,1,3
Emakk,darksorrow,63,paladin,retribution,2,2,0
Lafrogge,culte-de-la-rive-noire,48,paladin,retribution,3,1,2
Leköngen,ravencrest,48,paladin,retribution,3,1,2
Reliikt,blackrock,48,paladin,retribution,3,1,2
Doruk,stormscale,48,paladin,retribution,9,1,8
Окилан,gordunni,42,paladin,retribution,9,2,7
Moraru,neptulon,42,paladin,retribution,10,2,8
Alïstia,archimonde,42,paladin,retribution,10,2,8
Böserbube,tarren-mill,42,paladin,retribution,13,2,11
Кранштейн,gordunni,31,paladin,retribution,2,1,1
Irondawg,rajaxx,31,paladin,retribution,8,1,7
Davidas,drakthul,16,paladin,retribution,1,1,0
Exødius,sinstralis,16,paladin,retribution,1,1,0
Паланр,fordragon,16,paladin,retribution,1,1,0
Arbuzno,draenor,1955,paladin,protection,66,48,18
Sterben,aegwynn,1750,paladin,protection,72,35,37
Leotheron,boulderfist,1736,paladin,protection,180,114,66
Âmba,blackrock,1717,paladin,protection,54,33,21
Гниленький,razuvious,1712,paladin,protection,29,20,9
Sartshield,aerie-peak,1694,paladin,protection,30,18,12
Maximumtaste,ravencrest,1662,paladin,protection,30,22,8
Elitest,hyjal,1560,paladin,protection,195,75,120
Schrikii,archimonde,1556,paladin,protection,72,44,28
Collinnawin,aegwynn,1550,paladin,protection,189,96,93
Phlakorn,blackhand,1514,paladin,protection,36,22,14
Силугор,soulflayer,1498,paladin,protection,48,26,22
Gabubex,tarren-mill,1482,paladin,protection,135,83,52
Haringoth,argent-dawn,1448,paladin,protection,54,29,25
Justífiéd,kazzak,1430,paladin,protection,30,15,15
Galevar,argent-dawn,1416,paladin,protection,134,65,69
Lóu,hyjal,1408,paladin,protection,35,20,15
Ðivine,stormscale,1371,paladin,protection,66,30,36
Medium,frostwolf,1362,paladin,protection,29,15,14
Velkar,frostmane,1331,paladin,protection,82,42,40
Milliemaître,elune,1315,paladin,protection,78,40,38
Zerhakz,ysondre,1310,paladin,protection,78,38,40
Trufetteuh,hyjal,1283,paladin,protection,178,90,88
Ichbin,sanguino,1282,paladin,protection,101,41,60
Jûstice,kirin-tor,1281,paladin,protection,34,15,19
Бранв,gordunni,1259,paladin,protection,24,16,8
Vangorn,burning-legion,1258,paladin,protection,30,15,15
Augroni,antonidas,1244,paladin,protection,93,40,53
Yunalêsca,mugthol,1216,paladin,protection,54,28,26
Valeriu,stormreaver,1205,paladin,protection,36,14,22
Xrules,blackhand,1201,paladin,protection,47,21,26
Flakkson,stormscale,1194,paladin,protection,83,30,53
Oldsqlmofu,blackrock,1142,paladin,protection,19,12,7
Sonnywalkman,twisting-nether,1055,paladin,protection,12,11,1
Statscowski,thrall,1054,paladin,protection,18,11,7
Lotheriem,argent-dawn,992,paladin,protection,42,11,31
Проц,soulflayer,952,paladin,protection,18,10,8
Galadrion,dun-modr,768,paladin,protection,12,8,4
Fumbz,alakir,767,paladin,protection,12,8,4
Leadfoot,argent-dawn,763,paladin,protection,18,8,10
Tíríón,nethersturm,763,paladin,protection,18,8,10
Kraljevic,silvermoon,672,paladin,protection,12,7,5
Ванябублгам,soulflayer,672,paladin,protection,18,7,11
Tippressure,ravencrest,640,paladin,protection,10,7,3
Marihuána,ragnaros,576,paladin,protection,18,6,12
Ekenpala,kazzak,575,paladin,protection,12,6,6
Lägolas,thrall,511,paladin,protection,11,6,5
Helladin,haomarush,496,paladin,protection,13,6,7
Supremerage,silvermoon,480,paladin,protection,12,5,7
Onefrostyboi,defias-brotherhood,479,paladin,protection,12,5,7
Whiteraven,rexxar,479,paladin,protection,12,5,7
Elkka,azjolnerub,415,paladin,protection,11,5,6
Fleshoflight,arathor,384,paladin,protection,6,4,2
Røse,argent-dawn,384,paladin,protection,12,4,8
Figustyle,archimonde,318,paladin,protection,10,4,6
Zuplex,deathwing,288,paladin,protection,6,3,3
Снайпик,azuregos,288,paladin,protection,6,3,3
Craft,frostwolf,288,paladin,protection,6,3,3
Æero,blackhand,288,paladin,protection,6,3,3
Swäagg,hyjal,288,paladin,protection,6,3,3
Aümagad,confrérie-du-thorium,288,paladin,protection,6,3,3
Ðizzmo,bloodfeather,288,paladin,protection,12,3,9
Biffle,korgall,288,paladin,protection,12,3,9
Kawakai,blackrock,287,paladin,protection,12,3,9
Yourmomz,kazzak,239,paladin,protection,5,3,2
Синерина,blackscar,192,paladin,protection,6,2,4
Derina,silvermoon,192,paladin,protection,6,2,4
Arkera,blackrock,192,paladin,protection,6,2,4
Emakk,darksorrow,192,paladin,protection,6,2,4
Gornim,die-nachtwache,192,paladin,protection,6,2,4
Quantox,frostwolf,192,paladin,protection,12,2,10
Exion,ravenholdt,159,paladin,protection,5,2,3
Valädar,sanguino,159,paladin,protection,5,2,3
Чиксапомойка,gordunni,96,paladin,protection,6,1,5
Taptreus,antonidas,96,paladin,protection,6,1,5
Thôrwald,les-sentinelles,96,paladin,protection,12,1,11
Bobilous,twisting-nether,79,paladin,protection,5,1,4
Солошафл,howling-fjord,42,paladin,protection,12,4,8
Candrä,archimonde,2213,priest,holy,96,52,44
Leadeur,kazzak,2169,priest,holy,86,46,40
Køzukï,ravencrest,2133,priest,holy,161,78,83
Yötönyö,ravencrest,2043,priest,holy,60,32,28
Výra,der-rat-von-dalaran,1939,priest,holy,71,46,25
Ladá,stormscale,1939,priest,holy,138,73,65
Кальвейт,deathweaver,1915,priest,holy,117,57,60
Lenyp,sanguino,1902,priest,holy,138,71,67
Шотыказау,blackscar,1890,priest,holy,72,40,32
Grafius,stormscale,1885,priest,holy,48,26,22
Лоаресс,gordunni,1868,priest,holy,72,33,39
Itsmeminglee,ravencrest,1858,priest,holy,60,28,32
Kunen,sanguino,1854,priest,holy,96,60,36
Weezing,ysondre,1849,priest,holy,72,36,36
Servêy,twisting-nether,1845,priest,holy,42,22,20
Dmnz,blackrock,1840,priest,holy,75,34,41
Boonlai,ravencrest,1831,priest,holy,41,21,20
Yateh,blackmoore,1824,priest,holy,62,32,30
Катккат,soulflayer,1823,priest,holy,48,27,21
Sayne,arathor,1815,priest,holy,168,91,77
Maruh,malganis,1812,priest,holy,113,60,53
Eriónd,ravencrest,1811,priest,holy,66,34,32
Cosines,ravencrest,1810,priest,holy,71,33,38
Kaalu,frostmane,1809,priest,holy,254,131,123
Muchos,blackrock,1807,priest,holy,66,31,35
Bigwik,tarren-mill,1804,priest,holy,59,29,30
Teatime,aegwynn,1800,priest,holy,84,42,42
Imbitterx,stormscale,1777,priest,holy,30,21,9
Carlitastock,eredar,1777,priest,holy,41,22,19
Basilette,hyjal,1761,priest,holy,48,27,21
Holyholy,stormscale,1761,priest,holy,62,24,38
Мамкалол,soulflayer,1751,priest,holy,60,31,29
Dolens,argent-dawn,1746,priest,holy,106,54,52
Siign,ravencrest,1740,priest,holy,72,32,40
Tangent,ravencrest,1737,priest,holy,68,35,33
Гоплзнекст,gordunni,1724,priest,holy,246,128,118
Jim,saurfang,1711,priest,holy,257,127,130
Kaiikoo,ravencrest,1701,priest,holy,42,24,18
Lîrana,ravencrest,1697,priest,holy,78,48,30
Beatrixz,twisting-nether,1696,priest,holy,133,67,66
Weezïng,ysondre,1693,priest,holy,72,40,32
Psi,hakkar,1683,priest,holy,235,127,108
Meanbabe,argent-dawn,1683,priest,holy,48,22,26
Gladíator,blackhand,1677,priest,holy,102,58,44
Phobò,blackrock,1676,priest,holy,66,30,36
Kÿokó,ravencrest,1670,priest,holy,72,40,32
Stickpas,ysondre,1661,priest,holy,41,18,23
Alpháømegá,outland,1653,priest,holy,81,42,39
Smïlë,ravencrest,1647,priest,holy,180,91,89
Câlyr,ragnaros,1647,priest,holy,48,21,27
Wåtrux,alakir,1640,priest,holy,226,117,109
Anníng,tarren-mill,1637,priest,holy,150,86,64
Çhéåtçødé,ravencrest,1637,priest,holy,48,24,24
Løøney,kazzak,1635,priest,holy,36,25,11
Друмги,gordunni,1635,priest,holy,54,19,35
Ilenna,dun-morogh,1618,priest,holy,54,32,22
Gnomemonk,stormscale,1618,priest,holy,150,74,76
Adare,sanguino,1618,priest,holy,48,22,26
Alchemïst,ravencrest,1617,priest,holy,46,21,25
Dranbor,argent-dawn,1615,priest,holy,82,43,39
Sehlia,kazzak,1613,priest,holy,138,74,64
Affro,drakthul,1613,priest,holy,54,27,27
Sïxsïxsïx,ravencrest,1613,priest,holy,43,21,22
Shanya,thrall,1612,priest,holy,251,124,127
Pigdestroyin,frostmane,1611,priest,holy,42,22,20
Нубстрим,gordunni,1611,priest,holy,60,28,32
Salvatíon,sanguino,1607,priest,holy,106,46,60
Eox,kazzak,1602,priest,holy,42,23,19
Ksn,silvermoon,1602,priest,holy,57,31,26
Zxø,ravencrest,1601,priest,holy,160,88,72
Aykò,blackmoore,1588,priest,holy,90,42,48
Senkín,aegwynn,1584,priest,holy,143,71,72
Dény,ravencrest,1573,priest,holy,102,56,46
Highn,anetheron,1570,priest,holy,60,33,27
Atiyesh,arthas,1568,priest,holy,153,87,66
Harmónia,outland,1566,priest,holy,48,26,22
Anabananaa,ravencrest,1561,priest,holy,40,24,16
Elmaestrø,aegwynn,1558,priest,holy,48,25,23
Calithria,kazzak,1555,priest,holy,130,67,63
Goofdookie,outland,1554,priest,holy,30,18,12
Xzklolz,twisting-nether,1554,priest,holy,53,26,27
Xzklol,twisting-nether,1550,priest,holy,56,27,29
Hiimgreen,blackhand,1546,priest,holy,42,18,24
Evabae,the-maelstrom,1537,priest,holy,54,29,25
Prëdz,stormscale,1536,priest,holy,124,69,55
Hyonra,kazzak,1536,priest,holy,66,34,32
Koíré,defias-brotherhood,1532,priest,holy,101,57,44
Vregoa,twisting-nether,1532,priest,holy,36,17,19
Jiffie,twisting-nether,1528,priest,holy,30,16,14
Xianxia,twisting-nether,1523,priest,holy,90,41,49
Divinetouch,ravencrest,1516,priest,holy,78,35,43
Dokkaebì,kazzak,1514,priest,holy,135,67,68
Møhammed,wrathbringer,1513,priest,holy,144,67,77
Joeasaurs,ragnaros,1510,priest,holy,60,24,36
Rines,thrall,1505,priest,holy,143,72,71
Thalane,das-konsortium,1504,priest,holy,48,23,25
Wilby,archimonde,1503,priest,holy,48,21,27
Cleoana,blackhand,1500,priest,holy,30,16,14
Usw,outland,1496,priest,holy,69,23,46
Заволончик,blackscar,1494,priest,holy,102,48,54
Suxino,stormscale,1487,priest,holy,180,93,87
Stinkydog,kazzak,1486,priest,holy,178,86,92
Camina,shattered-hand,1484,priest,holy,69,36,33
Zlejkadlec,drakthul,1476,priest,holy,93,47,46
Maah,defias-brotherhood,1471,priest,holy,80,46,34
Symbolofhope,ravencrest,1460,priest,holy,117,62,55
Mcdeady,tarren-mill,1454,priest,holy,42,19,23
Byzzi,draenor,1443,priest,holy,42,25,17
Alizeé,nazjatar,1439,priest,holy,107,57,50
Lylska,stormreaver,1437,priest,holy,36,15,21
Hoeneygodx,antonidas,1432,priest,holy,36,16,20
Fizzlesp,tarren-mill,1425,priest,holy,30,15,15
Alphacub,ragnaros,1425,priest,holy,82,36,46
Phénylanine,khaz-modan,1422,priest,holy,202,105,97
Mylini,silvermoon,1419,priest,holy,186,103,83
Kbakå,kazzak,1419,priest,holy,78,37,41
Markianos,silvermoon,1412,priest,holy,114,58,56
Nastylex,magtheridon,1410,priest,holy,24,15,9
Мектран,gordunni,1408,priest,holy,54,27,27
Phobò,antonidas,1407,priest,holy,118,52,66
Bifs,blackmoore,1405,priest,holy,50,32,18
Scartay,outland,1405,priest,holy,29,15,14
Вакидзачи,gordunni,1402,priest,holy,209,105,104
Hmanco,burning-legion,1400,priest,holy,91,55,36
Инзора,gordunni,1400,priest,holy,30,15,15
Neoark,archimonde,1395,priest,holy,134,67,67
Momopriesto,draenor,1395,priest,holy,42,17,25
Cartøøns,ravencrest,1391,priest,holy,24,15,9
Womanwonderf,ravencrest,1388,priest,holy,65,31,34
Jaz,ysondre,1388,priest,holy,42,20,22
Karpiest,stormscale,1386,priest,holy,48,26,22
Хасгерион,gordunni,1381,priest,holy,54,23,31
Cøvu,draenor,1378,priest,holy,94,41,53
Madcole,blackhand,1371,priest,holy,85,43,42
Seladine,ravencrest,1367,priest,holy,125,64,61
Nomakprst,sanguino,1362,priest,holy,60,31,29
Lómesilme,dun-modr,1359,priest,holy,107,55,52
Rägà,archimonde,1357,priest,holy,67,36,31
Tëmärï,ravencrest,1356,priest,holy,72,46,26
Возхд,soulflayer,1356,priest,holy,48,27,21
Delphina,archimonde,1356,priest,holy,119,65,54
Certe,twisting-nether,1354,priest,holy,109,52,57
Virginmaris,sanguino,1351,priest,holy,65,37,28
Alros,elune,1346,priest,holy,54,26,28
Tomassur,drakthul,1345,priest,holy,30,19,11
Migam,kazzak,1341,priest,holy,54,25,29
Moirgana,minahonda,1340,priest,holy,43,21,22
Tyrhaa,blackmoore,1339,priest,holy,112,56,56
Shizzlol,silvermoon,1339,priest,holy,30,14,16
Angrk,kazzak,1338,priest,holy,42,26,16
Gokumødex,outland,1337,priest,holy,30,14,16
Nino,gorgonnash,1335,priest,holy,66,30,36
Hara,elune,1335,priest,holy,35,15,20
Ezechiel,twisting-nether,1331,priest,holy,41,25,16
Ангеланика,gordunni,1330,priest,holy,29,18,11
Pridepriest,twisting-nether,1329,priest,holy,72,35,37
Cølï,ravencrest,1325,priest,holy,36,14,22
Malkàv,hyjal,1324,priest,holy,24,14,10
Libetha,ysondre,1323,priest,holy,41,23,18
Orcid,chogall,1323,priest,holy,140,72,68
Síuu,kazzak,1322,priest,holy,66,34,32
Lasuora,nemesis,1315,priest,holy,60,26,34
Asare,outland,1314,priest,holy,94,53,41
Hydraximus,garrosh,1312,priest,holy,419,203,216
Gloxina,argent-dawn,1305,priest,holy,66,34,32
Cherron,argent-dawn,1305,priest,holy,61,27,34
Brigied,turalyon,1303,priest,holy,72,36,36
Nálá,nethersturm,1302,priest,holy,40,21,19
Catstretch,ravencrest,1300,priest,holy,89,38,51
Midycine,ysondre,1296,priest,holy,87,43,44
Åluneth,kazzak,1286,priest,holy,150,74,76
Fabs,laughing-skull,1283,priest,holy,30,18,12
Elynä,silvermoon,1278,priest,holy,48,32,16
Draconux,terenas,1273,priest,holy,48,18,30
Wintercurse,twisting-nether,1272,priest,holy,52,24,28
Djdesha,tarren-mill,1272,priest,holy,35,16,19
Tyene,voljin,1271,priest,holy,30,16,14
Zakhun,stormrage,1271,priest,holy,82,42,40
Fedorah,ragnaros,1267,priest,holy,96,51,45
Ethery,argent-dawn,1266,priest,holy,65,33,32
Lykarion,argent-dawn,1265,priest,holy,72,37,35
Эилинг,gordunni,1262,priest,holy,64,31,33
Benificent,argent-dawn,1259,priest,holy,29,20,9
Tudiiheals,frostwolf,1252,priest,holy,45,24,21
Nosgot,earthen-ring,1251,priest,holy,66,32,34
Soapie,defias-brotherhood,1249,priest,holy,24,14,10
Zên,argent-dawn,1248,priest,holy,21,14,7
Sisko,stormscale,1246,priest,holy,24,13,11
Budgetdp,archimonde,1244,priest,holy,30,13,17
Coolwnbnamex,ravencrest,1241,priest,holy,24,13,11
Misscure,draenor,1238,priest,holy,82,36,46
Алеброн,gordunni,1226,priest,holy,24,13,11
Maybelline,ravencrest,1215,priest,holy,36,16,20
Пингзеро,soulflayer,1215,priest,holy,56,23,33
Neenä,ravencrest,1214,priest,holy,50,25,25
Harlemsfnest,blackrock,1204,priest,holy,21,13,8
Хилтихон,howling-fjord,1200,priest,holy,42,26,16
Скартэикс,howling-fjord,1200,priest,holy,42,20,22
Kbakå,stormscale,1193,priest,holy,65,27,38
Lhyria,baelgun,1189,priest,holy,48,21,27
Stàrlîght,chants-éternels,1187,priest,holy,24,13,11
Dathlight,argent-dawn,1183,priest,holy,71,37,34
Morrydin,stormreaver,1177,priest,holy,66,25,41
Nykah,antonidas,1177,priest,holy,73,26,47
Ниеса,lich-king,1174,priest,holy,110,52,58
Alú,draenor,1171,priest,holy,105,48,57
Torcena,garrosh,1166,priest,holy,141,70,71
Meatyshaft,doomhammer,1166,priest,holy,51,19,32
Asraje,eredar,1163,priest,holy,18,15,3
Nemista,hyjal,1160,priest,holy,66,24,42
Jaisuu,ravencrest,1152,priest,holy,18,12,6
Testdeath,ravencrest,1151,priest,holy,24,12,12
Stanyú,tarren-mill,1151,priest,holy,36,12,24
Lyla,frostwolf,1149,priest,holy,48,27,21
Преттисмайл,gordunni,1149,priest,holy,30,12,18
Dúréx,sanguino,1147,priest,holy,24,18,6
Lobogaust,kargath,1142,priest,holy,48,31,17
Асггард,borean-tundra,1134,priest,holy,39,25,14
Велост,gordunni,1132,priest,holy,24,12,12
Andreel,ravencrest,1131,priest,holy,24,12,12
Sodatsu,cthun,1129,priest,holy,24,12,12
Nou,aegwynn,1127,priest,holy,30,12,18
Sücre,dalaran,1125,priest,holy,30,16,14
Sohryø,drekthar,1125,priest,holy,30,14,16
Holydolly,doomhammer,1121,priest,holy,24,13,11
Eazzyy,kazzak,1115,priest,holy,27,12,15
Morphuz,tarren-mill,1102,priest,holy,102,44,58
Anàriel,elune,1100,priest,holy,42,16,26
Lazheal,khaz-modan,1099,priest,holy,17,12,5
Holypowér,twisting-nether,1088,priest,holy,30,17,13
Ломаюключики,gordunni,1081,priest,holy,45,22,23
Nerfnerf,kazzak,1079,priest,holy,34,19,15
Deeforce,argent-dawn,1072,priest,holy,97,53,44
Kímbérléy,argent-dawn,1067,priest,holy,42,22,20
Copperplume,ravenholdt,1067,priest,holy,60,21,39
Ludriel,turalyon,1056,priest,holy,54,26,28
Zen,talnivarr,1056,priest,holy,24,11,13
Boomixed,twisting-nether,1055,priest,holy,18,11,7
Pandakhlys,ysondre,1055,priest,holy,24,11,13
Штанга,blackscar,1055,priest,holy,29,12,17
Laewen,die-aldor,1054,priest,holy,45,22,23
Тевтонка,goldrinn,1054,priest,holy,54,25,29
Рейеан,soulflayer,1054,priest,holy,24,11,13
Uro,tirion,1053,priest,holy,30,11,19
Mezegis,draenor,1051,priest,holy,18,11,7
Fjonnski,blackmoore,1050,priest,holy,18,11,7
Gï,blackmoore,1048,priest,holy,18,11,7
Ripjuice,sylvanas,1046,priest,holy,34,14,20
Veurjin,uldaman,1045,priest,holy,24,11,13
Leyea,kazzak,1037,priest,holy,31,15,16
Türapea,draenor,1033,priest,holy,18,12,6
Orcü,tarren-mill,1020,priest,holy,48,21,27
Penitence,drekthar,1018,priest,holy,26,12,14
Ankhepope,outland,1013,priest,holy,56,33,23
Ptiteminette,archimonde,1012,priest,holy,26,12,14
Kæos,blackrock,1011,priest,holy,73,31,42
Covidios,twisting-nether,1005,priest,holy,69,33,36
Dampfwalze,nozdormu,1002,priest,holy,38,19,19
Melancholly,thunderhorn,998,priest,holy,23,13,10
Baabaak,frostmane,994,priest,holy,21,14,7
Alloktonos,ravencrest,994,priest,holy,92,38,54
Hipnotika,nemesis,988,priest,holy,53,18,35
Краббожий,greymane,987,priest,holy,29,11,18
Valtessian,medivh,982,priest,holy,63,30,33
Naieli,antonidas,972,priest,holy,33,16,17
Siarai,pozzo-delleternità,964,priest,holy,43,21,22
Ksn,argent-dawn,959,priest,holy,24,10,14
Xlhealscptn,arathor,959,priest,holy,60,19,41
Elinaa,die-aldor,958,priest,holy,18,10,8
Kotipope,silvermoon,956,priest,holy,24,10,14
Rennic,stormscale,955,priest,holy,18,10,8
Sickheals,doomhammer,954,priest,holy,36,20,16
Speltmor,stormscale,953,priest,holy,24,10,14
Иннерон,soulflayer,951,priest,holy,94,42,52
Archangel,terokkar,942,priest,holy,42,22,20
Discxqt,ysondre,924,priest,holy,14,11,3
Thingsy,draenor,912,priest,holy,59,27,32
Zêlestia,antonidas,905,priest,holy,22,11,11
Eurydike,blackrock,887,priest,holy,16,10,6
Xal,drekthar,880,priest,holy,30,12,18
Rhæveth,ravencrest,864,priest,holy,18,9,9
Peisetti,stormscale,864,priest,holy,18,9,9
Âlolexx,archimonde,863,priest,holy,12,9,3
Azeeza,stormscale,863,priest,holy,12,9,3
Wèèzing,ysondre,863,priest,holy,12,9,3
Ankî,aegwynn,863,priest,holy,18,9,9
Ghettothug,darksorrow,863,priest,holy,24,9,15
Åzjol,magtheridon,862,priest,holy,24,9,15
Faelvirin,aegwynn,861,priest,holy,18,9,9
Emipriest,tarren-mill,861,priest,holy,23,9,14
Pasqualz,ravencrest,860,priest,holy,18,9,9
Hyonzy,silvermoon,859,priest,holy,24,9,15
Omnissiiah,silvermoon,856,priest,holy,24,9,15
Kanki,haomarush,828,priest,holy,60,25,35
Infinitiy,sylvanas,827,priest,holy,18,9,9
Rahela,dun-modr,793,priest,holy,17,9,8
Evílz,tarren-mill,768,priest,holy,12,8,4
Vitae,gorgonnash,768,priest,holy,18,8,10
Ltmp,ravencrest,768,priest,holy,18,8,10
Servey,twisting-nether,768,priest,holy,18,8,10
Voodoo,the-maelstrom,768,priest,holy,18,8,10
Ÿolo,nemesis,768,priest,holy,24,8,16
Маквиэлла,howling-fjord,767,priest,holy,12,8,4
Sak,uldaman,767,priest,holy,18,8,10
Weedony,hyjal,766,priest,holy,18,8,10
Nathamo,archimonde,762,priest,holy,18,8,10
Mcmuffin,runetotem,761,priest,holy,12,8,4
Melissasky,ragnaros,760,priest,holy,60,22,38
Fratio,krasus,758,priest,holy,18,8,10
Avinci,blackrock,757,priest,holy,18,8,10
Iliridan,pozzo-delleternità,753,priest,holy,78,24,54
Englishheart,auchindoun,734,priest,holy,17,8,9
Valentinus,dragonmaw,702,priest,holy,26,8,18
Mélínâ,blackmoore,691,priest,holy,28,9,19
Willzah,outland,672,priest,holy,12,7,5
Darkoul,conseil-des-ombres,672,priest,holy,12,7,5
Ladderpolice,blackmoore,672,priest,holy,12,7,5
Jedimind,kazzak,672,priest,holy,12,7,5
Ainadaxz,ravencrest,672,priest,holy,12,7,5
Гшд,gordunni,672,priest,holy,12,7,5
Valinoru,silvermoon,672,priest,holy,18,7,11
Penvon,ravencrest,672,priest,holy,24,7,17
Yuhé,elune,671,priest,holy,12,7,5
Gintøníc,blackmoore,671,priest,holy,12,7,5
Nicksiz,silvermoon,669,priest,holy,18,7,11
Zinary,silvermoon,667,priest,holy,18,7,11
Ledarz,dun-morogh,658,priest,holy,12,7,5
Maxý,ravencrest,658,priest,holy,24,7,17
Avelynn,ravencrest,649,priest,holy,21,9,12
Sâtânica,kelthuzad,610,priest,holy,27,8,19
Blâdes,gorgonnash,589,priest,holy,17,7,10
Danina,outland,576,priest,holy,12,6,6
Nancey,draenor,576,priest,holy,12,6,6
Иссатея,galakrond,576,priest,holy,12,6,6
Yamai,thrall,576,priest,holy,12,6,6
Zoophobîa,stormscale,576,priest,holy,12,6,6
Bij,outland,576,priest,holy,12,6,6
Darkoul,ravencrest,576,priest,holy,12,6,6
Konstigadan,twisting-nether,576,priest,holy,12,6,6
Найтингеилл,gordunni,576,priest,holy,12,6,6
Ahilarry,tarren-mill,576,priest,holy,12,6,6
Mesticore,nethersturm,576,priest,holy,18,6,12
Мотд,gordunni,576,priest,holy,18,6,12
Gød,magtheridon,576,priest,holy,24,6,18
Waters,lightbringer,575,priest,holy,12,6,6
Papadrak,kazzak,575,priest,holy,12,6,6
Sîanah,archimonde,572,priest,holy,18,6,12
Spàgno,nemesis,571,priest,holy,18,6,12
Proxypriest,the-maelstrom,571,priest,holy,20,6,14
Beatla,khaz-modan,569,priest,holy,18,6,12
Dazé,ravencrest,563,priest,holy,19,9,10
Bloodelfoula,draenor,563,priest,holy,18,6,12
Priestxx,twilights-hammer,543,priest,holy,11,6,5
Avtarra,ravencrest,510,priest,holy,16,6,10
Ralek,hyjal,495,priest,holy,17,6,11
Secundis,silvermoon,480,priest,holy,6,5,1
Felaenna,argent-dawn,480,priest,holy,6,5,1
Èlysium,grim-batol,480,priest,holy,6,5,1
Nýkah,antonidas,480,priest,holy,12,5,7
Quiwzx,blackrock,480,priest,holy,12,5,7
Каткааткат,soulflayer,480,priest,holy,12,5,7
Velenthan,ragnaros,480,priest,holy,12,5,7
Mazeari,sylvanas,480,priest,holy,12,5,7
Shâru,frostmourne,480,priest,holy,12,5,7
Ogiez,sylvanas,480,priest,holy,12,5,7
Darkoulito,dalaran,480,priest,holy,12,5,7
Bamboleon,blackrock,480,priest,holy,12,5,7
Jagardoden,stormscale,480,priest,holy,18,5,13
Inzané,doomhammer,479,priest,holy,12,5,7
Árcadoom,quelthalas,479,priest,holy,12,5,7
Двакамня,soulflayer,479,priest,holy,12,5,7
Alaeddin,kazzak,479,priest,holy,24,5,19
Amemiya,ragnaros,478,priest,holy,12,5,7
Laxara,arthas,478,priest,holy,12,5,7
Applecrumßle,ragnaros,477,priest,holy,12,5,7
Azaza,burning-legion,472,priest,holy,12,5,7
Larisä,uldum,447,priest,holy,22,5,17
Indrades,blackmoore,384,priest,holy,6,4,2
Даймэн,gordunni,384,priest,holy,6,4,2
Yredias,dalaran,384,priest,holy,6,4,2
Skíps,sylvanas,384,priest,holy,6,4,2
Arithon,blackrock,384,priest,holy,6,4,2
Burnesenbois,chogall,384,priest,holy,6,4,2
Shanny,kazzak,384,priest,holy,6,4,2
Experimentix,silvermoon,384,priest,holy,6,4,2
Elunos,blackrock,384,priest,holy,6,4,2
Blazekk,sylvanas,384,priest,holy,12,4,8
Sayash,chamber-of-aspects,384,priest,holy,12,4,8
Zarez,stormscale,384,priest,holy,12,4,8
Disillusíon,tarren-mill,384,priest,holy,12,4,8
Кэндимен,gordunni,384,priest,holy,12,4,8
Bebwaz,kazzak,384,priest,holy,12,4,8
Dokurochan,tarren-mill,384,priest,holy,12,4,8
Missdemerè,nemesis,384,priest,holy,12,4,8
Gertie,blackhand,384,priest,holy,12,4,8
Ripperdepip,magtheridon,384,priest,holy,12,4,8
Badguymike,ragnaros,384,priest,holy,12,4,8
Flurri,tarren-mill,384,priest,holy,12,4,8
Skytheory,eredar,384,priest,holy,13,4,9
Virgosenpai,silvermoon,384,priest,holy,18,4,14
Ðlcz,blackrock,384,priest,holy,18,4,14
Smolbøi,tarren-mill,384,priest,holy,18,4,14
Ømegagødx,outland,384,priest,holy,18,4,14
Ruebi,blackmoore,383,priest,holy,12,4,8
Protegee,draenor,383,priest,holy,18,4,14
Hodza,frostmane,382,priest,holy,6,4,2
Sarafîsthole,ysondre,380,priest,holy,12,4,8
Nxtlvl,stormscale,352,priest,holy,10,5,5
Голнар,deathguard,351,priest,holy,14,5,9
Shyvi,ravencrest,319,priest,holy,5,4,1
Hereticroka,ysondre,288,priest,holy,6,3,3
Shmoly,stormscale,288,priest,holy,6,3,3
Pyropenance,twisting-nether,288,priest,holy,6,3,3
Миррен,gordunni,288,priest,holy,6,3,3
Drdiscospec,tarren-mill,288,priest,holy,6,3,3
Hilerki,draenor,288,priest,holy,6,3,3
Novella,kult-der-verdammten,288,priest,holy,6,3,3
Seeyae,archimonde,288,priest,holy,6,3,3
Фионыч,blackscar,288,priest,holy,6,3,3
Namsolo,kazzak,288,priest,holy,6,3,3
Ariyia,argent-dawn,288,priest,holy,6,3,3
Arabpriest,draenor,288,priest,holy,6,3,3
Jeboc,ravencrest,288,priest,holy,6,3,3
ßestworld,draenor,288,priest,holy,6,3,3
Hotforus,silvermoon,288,priest,holy,6,3,3
Gøkumodex,tarren-mill,288,priest,holy,6,3,3
Salzholy,malygos,288,priest,holy,6,3,3
Bobitä,ravencrest,288,priest,holy,6,3,3
Blackwidow,chromaggus,288,priest,holy,6,3,3
Holyheartx,argent-dawn,288,priest,holy,6,3,3
Góli,argent-dawn,288,priest,holy,6,3,3
Caz,cthun,288,priest,holy,6,3,3
Bambus,shattered-hand,288,priest,holy,6,3,3
Goytka,tarren-mill,288,priest,holy,6,3,3
Eihran,stormscale,288,priest,holy,12,3,9
Javvi,sylvanas,288,priest,holy,12,3,9
Fatherliam,emerald-dream,288,priest,holy,12,3,9
Quami,dun-modr,288,priest,holy,12,3,9
Lurri,tarren-mill,288,priest,holy,12,3,9
Chibrausorus,archimonde,288,priest,holy,12,3,9
Drminduskâ,ysondre,288,priest,holy,12,3,9
Dotreveal,ravencrest,288,priest,holy,12,3,9
Farae,arathor,288,priest,holy,24,3,21
Ларуса,gordunni,287,priest,holy,6,3,3
Haregnor,gorgonnash,287,priest,holy,12,3,9
Lr,aszune,240,priest,holy,9,3,6
Noukeé,blackrock,192,priest,holy,6,2,4
Prästpojken,frostwhisper,192,priest,holy,6,2,4
Lutzki,the-maelstrom,192,priest,holy,6,2,4
Eyllise,ragnaros,192,priest,holy,6,2,4
Korzec,dun-modr,192,priest,holy,6,2,4
Ibunnyqt,aegwynn,192,priest,holy,6,2,4
Discobrill,silvermoon,192,priest,holy,6,2,4
Yukirito,drakthul,192,priest,holy,6,2,4
Marrisa,khaz-modan,192,priest,holy,6,2,4
Krematorio,twisting-nether,192,priest,holy,6,2,4
Micix,tarren-mill,192,priest,holy,6,2,4
Ihefyehvjrm,ravencrest,192,priest,holy,6,2,4
Jinxies,twisting-nether,192,priest,holy,6,2,4
Ebolaidman,ravencrest,192,priest,holy,6,2,4
Priesless,sylvanas,192,priest,holy,6,2,4
Dîakon,antonidas,192,priest,holy,6,2,4
Келебриана,deepholm,192,priest,holy,6,2,4
Dangerfred,stormscale,192,priest,holy,6,2,4
Grøums,blackmoore,192,priest,holy,6,2,4
Burnex,thrall,192,priest,holy,6,2,4
Troedelsuppe,destromath,192,priest,holy,6,2,4
Dami,defias-brotherhood,192,priest,holy,6,2,4
Haxxøn,die-nachtwache,192,priest,holy,6,2,4
Бранлор,howling-fjord,192,priest,holy,8,2,6
Mayalolz,chogall,192,priest,holy,8,2,6
Nøfear,tarren-mill,192,priest,holy,11,2,9
Hónòr,sylvanas,192,priest,holy,12,2,10
Meynola,ysondre,191,priest,holy,6,2,4
Rankonejames,silvermoon,159,priest,holy,5,2,3
Apuessii,dun-modr,159,priest,holy,5,2,3
Spae,twisting-nether,138,priest,holy,11,4,7
Mavisqt,draenor,128,priest,holy,4,2,2
Bowie,frostwhisper,96,priest,holy,6,1,5
Ximenia,eredar,96,priest,holy,6,1,5
Jaatjak,ravencrest,96,priest,holy,6,1,5
Эллвинг,howling-fjord,96,priest,holy,6,1,5
Systerstål,twisting-nether,96,priest,holy,6,1,5
Saheila,defias-brotherhood,96,priest,holy,6,1,5
Ylenae,twisting-nether,96,priest,holy,6,1,5
Slêq,antonidas,96,priest,holy,6,1,5
Bubbleup,defias-brotherhood,96,priest,holy,6,1,5
Карнотит,howling-fjord,96,priest,holy,6,1,5
Itstooney,doomhammer,96,priest,holy,6,1,5
Shicu,blackmoore,96,priest,holy,6,1,5
Сакредлайв,gordunni,96,priest,holy,6,1,5
Батлджес,gordunni,96,priest,holy,6,1,5
Tÿona,hyjal,96,priest,holy,6,1,5
Herwin,twisting-nether,96,priest,holy,6,1,5
Isendriel,outland,96,priest,holy,6,1,5
Lujka,outland,96,priest,holy,6,1,5
Elessee,the-maelstrom,96,priest,holy,6,1,5
Myrrha,les-sentinelles,96,priest,holy,6,1,5
Nannymcfee,stormscale,96,priest,holy,6,1,5
Zongiz,azjolnerub,96,priest,holy,6,1,5
Pattie,ragnaros,96,priest,holy,6,1,5
Remkoja,blackrock,96,priest,holy,6,1,5
Laadyybirkee,blackhand,96,priest,holy,6,1,5
Åme,kirin-tor,96,priest,holy,12,1,11
Plaguestrike,darkspear,96,priest,holy,12,1,11
Kæzm,blackrock,96,priest,holy,12,1,11
Felvytwo,stormscale,96,priest,holy,12,1,11
Syntara,twisting-nether,96,priest,holy,12,1,11
Mswagner,outland,79,priest,holy,5,1,4
Darkyos,azshara,42,priest,holy,6,2,4
Bøij,pozzo-delleternità,42,priest,holy,10,2,8
Gaalonikus,blackmoore,2235,priest,discipline,92,54,38
Vanostsp,kazzak,2230,priest,discipline,102,56,46
Jayti,ravencrest,2205,priest,discipline,115,65,50
Dripcheck,draenor,2180,priest,discipline,133,73,60
Èfflux,ravencrest,2172,priest,discipline,86,54,32
Bedfirez,ravencrest,2161,priest,discipline,211,122,89
Holypoppa,ravencrest,2145,priest,discipline,115,64,51
Jtî,ravencrest,2134,priest,discipline,72,47,25
Saentainen,kazzak,2133,priest,discipline,95,68,27
Cylizx,stormscale,2133,priest,discipline,114,62,52
Jackiqt,nemesis,2132,priest,discipline,113,73,40
Moonriver,archimonde,2132,priest,discipline,66,39,27
Artle,sanguino,2131,priest,discipline,83,44,39
Azrpr,ravencrest,2128,priest,discipline,82,45,37
Vengefulmaze,ravencrest,2124,priest,discipline,108,55,53
Rébörn,tarren-mill,2123,priest,discipline,71,44,27
Jidammy,ravencrest,2120,priest,discipline,80,41,39
Rñd,ravencrest,2117,priest,discipline,78,40,38
Shøy,nemesis,2110,priest,discipline,126,68,58
Sfÿ,ysondre,2106,priest,discipline,84,43,41
Swdswdswdswd,blackmoore,2105,priest,discipline,94,51,43
Monopolygoat,arathor,2105,priest,discipline,111,55,56
Efflúx,ravencrest,2102,priest,discipline,106,60,46
Klonyaryk,ravencrest,2100,priest,discipline,78,47,31
Øbserverx,stormscale,2100,priest,discipline,114,61,53
Sèco,sylvanas,2085,priest,discipline,84,44,40
Mentalboom,emerald-dream,2079,priest,discipline,167,86,81
Duckiethotx,ragnaros,2070,priest,discipline,78,40,38
Leahbtw,ravencrest,2062,priest,discipline,144,81,63
Duckiethot,twisting-nether,2062,priest,discipline,160,80,80
Boltygnome,blades-edge,2044,priest,discipline,72,43,29
Plsdontnerf,onyxia,2039,priest,discipline,95,55,40
Twinkboyx,ragnaros,2038,priest,discipline,117,59,58
Thelïght,ravencrest,2034,priest,discipline,111,54,57
Билетлолпро,borean-tundra,2029,priest,discipline,108,50,58
Lloreen,ravencrest,2027,priest,discipline,60,36,24
Ävbmârsík,kazzak,2025,priest,discipline,131,75,56
Bindw,tarren-mill,2025,priest,discipline,41,22,19
Faithz,ragnaros,2023,priest,discipline,84,39,45
Ilumiinatrix,dun-modr,2022,priest,discipline,264,137,127
Crinji,blackmoore,2021,priest,discipline,157,77,80
Chasx,ravencrest,2018,priest,discipline,89,42,47
Разрухаз,gordunni,2017,priest,discipline,77,43,34
Релакз,soulflayer,2017,priest,discipline,84,46,38
Гопикзашквар,blackscar,2017,priest,discipline,104,47,57
Priestqtx,kelthuzad,2016,priest,discipline,60,34,26
Wet,twisting-nether,2015,priest,discipline,90,41,49
Salvinia,kelthuzad,2011,priest,discipline,96,51,45
Trialight,ravencrest,2009,priest,discipline,89,57,32
Хомячпочка,gordunni,2003,priest,discipline,76,40,36
Pheen,kazzak,2002,priest,discipline,155,83,72
Shmoly,stormscale,2001,priest,discipline,91,47,44
Villagebike,shadowsong,1996,priest,discipline,36,21,15
Vajadisc,twisting-nether,1993,priest,discipline,130,56,74
Neverdome,ravencrest,1992,priest,discipline,188,104,84
Stavfel,stormscale,1990,priest,discipline,117,63,54
Djsüssi,frostwolf,1989,priest,discipline,121,56,65
Dabalthazar,ravencrest,1985,priest,discipline,163,83,80
Unréål,ravencrest,1985,priest,discipline,156,74,82
Rhâpsødy,ravencrest,1981,priest,discipline,53,35,18
Dpriesta,aegwynn,1979,priest,discipline,88,52,36
Acondisc,kazzak,1977,priest,discipline,76,43,33
Ekman,twisting-nether,1977,priest,discipline,128,67,61
Mavisqt,draenor,1976,priest,discipline,66,36,30
Oioiio,kazzak,1975,priest,discipline,84,42,42
Sinetrax,tarren-mill,1973,priest,discipline,96,57,39
Mercilégion,sargeras,1971,priest,discipline,66,34,32
Kleot,ragnaros,1970,priest,discipline,183,93,90
Lyrvanax,ravencrest,1970,priest,discipline,229,113,116
Charlotten,shattered-hand,1963,priest,discipline,84,42,42
Infamoussftw,drakthul,1963,priest,discipline,168,81,87
Synxii,ravencrest,1961,priest,discipline,58,35,23
Wetnpuffy,ravencrest,1960,priest,discipline,156,80,76
Ananous,hyjal,1959,priest,discipline,109,59,50
Imprøved,outland,1958,priest,discipline,90,61,29
Spinebuster,frostwolf,1958,priest,discipline,78,38,40
Timbsheal,tarren-mill,1956,priest,discipline,108,57,51
Sleepypriest,frostmane,1951,priest,discipline,42,24,18
Алинкалол,howling-fjord,1948,priest,discipline,162,96,66
Primayodbain,archimonde,1947,priest,discipline,58,33,25
Kekkons,sylvanas,1941,priest,discipline,119,61,58
Ebuglatatrov,ravencrest,1941,priest,discipline,120,57,63
Izzý,antonidas,1939,priest,discipline,42,27,15
Concetto,nazjatar,1939,priest,discipline,48,27,21
Mysterymucus,draenor,1938,priest,discipline,102,61,41
Porkhunt,stormscale,1938,priest,discipline,90,52,38
Хомяктьмы,gordunni,1938,priest,discipline,72,37,35
Senga,kazzak,1937,priest,discipline,78,38,40
Summerfinn,ravencrest,1937,priest,discipline,93,44,49
Мамкалол,soulflayer,1936,priest,discipline,216,113,103
Syreet,silvermoon,1936,priest,discipline,364,187,177
Nameit,eredar,1934,priest,discipline,158,80,78
Önnÿ,dun-modr,1933,priest,discipline,78,39,39
Свэпи,blackscar,1929,priest,discipline,65,34,31
Psyheea,stormscale,1926,priest,discipline,139,62,77
Свдпро,soulflayer,1922,priest,discipline,71,33,38
Akaria,kelthuzad,1922,priest,discipline,66,30,36
Arthezz,ravencrest,1920,priest,discipline,92,50,42
Фанпау,soulflayer,1919,priest,discipline,72,34,38
Rlyeh,argent-dawn,1917,priest,discipline,60,33,27
Niniell,blackmoore,1915,priest,discipline,66,43,23
Фастэксп,razuvious,1915,priest,discipline,78,41,37
Dermaul,kazzak,1913,priest,discipline,42,24,18
Aeogon,kazzak,1913,priest,discipline,149,68,81
Asanti,die-aldor,1912,priest,discipline,108,63,45
ßrb,sylvanas,1912,priest,discipline,150,87,63
Mswagner,outland,1907,priest,discipline,53,30,23
Enteja,outland,1907,priest,discipline,406,213,193
Georgeshxx,ravencrest,1903,priest,discipline,95,50,45
Eliriya,thrall,1901,priest,discipline,252,131,121
Kangaroogodx,ravencrest,1901,priest,discipline,78,35,43
Donvyto,blackmoore,1899,priest,discipline,48,24,24
Maxfly,archimonde,1898,priest,discipline,54,29,25
Discishârd,ravencrest,1893,priest,discipline,117,60,57
Potatojuicer,argent-dawn,1893,priest,discipline,75,38,37
Rippertmepls,ravencrest,1891,priest,discipline,89,52,37
Разорлайтх,gordunni,1890,priest,discipline,29,21,8
Mentalist,dun-modr,1890,priest,discipline,99,42,57
Ronnyvandamm,destromath,1887,priest,discipline,88,58,30
Voxtwo,blackrock,1887,priest,discipline,42,26,16
Xghj,sylvanas,1887,priest,discipline,72,36,36
Clapped,ravencrest,1887,priest,discipline,72,32,40
Nêxt,ravencrest,1884,priest,discipline,60,42,18
Asdfghqwezxc,twisting-nether,1884,priest,discipline,53,30,23
Neffty,aegwynn,1882,priest,discipline,114,61,53
Voideffsucks,stormscale,1881,priest,discipline,60,32,28
Merylle,ragnaros,1880,priest,discipline,60,29,31
Ziknait,sargeras,1879,priest,discipline,48,29,19
Secø,sylvanas,1873,priest,discipline,42,22,20
Elethia,blackmoore,1872,priest,discipline,38,21,17
Yeetedmycat,stormscale,1872,priest,discipline,66,34,32
Verti,outland,1872,priest,discipline,89,41,48
Imsaltyxd,tarren-mill,1871,priest,discipline,66,39,27
Svakkanxd,kazzak,1871,priest,discipline,70,33,37
Cdïs,tyrande,1870,priest,discipline,54,36,18
Egî,azshara,1870,priest,discipline,42,20,22
Интеллиджент,gordunni,1868,priest,discipline,42,24,18
Sdn,twisting-nether,1868,priest,discipline,82,44,38
Comedii,blackmoore,1866,priest,discipline,345,176,169
Saniqt,kazzak,1865,priest,discipline,57,35,22
Painchampion,draenor,1864,priest,discipline,54,23,31
Rpriest,outland,1863,priest,discipline,54,32,22
Gerryqt,draenor,1863,priest,discipline,48,26,22
Asyncx,ravencrest,1862,priest,discipline,68,35,33
Virulence,twisting-nether,1860,priest,discipline,199,113,86
Flao,ravencrest,1860,priest,discipline,52,28,24
Кошечка,deathguard,1860,priest,discipline,41,21,20
Thalanas,ravencrest,1859,priest,discipline,158,90,68
Sublab,kazzak,1859,priest,discipline,60,33,27
Artìst,ravencrest,1858,priest,discipline,30,20,10
Citadelle,blackmoore,1858,priest,discipline,59,36,23
Мефодийприст,howling-fjord,1858,priest,discipline,102,62,40
Wernou,archimonde,1858,priest,discipline,48,29,19
Cdplz,archimonde,1858,priest,discipline,119,59,60
Bigextendo,blackmoore,1857,priest,discipline,66,35,31
Jâde,bloodhoof,1857,priest,discipline,114,56,58
Unfaithful,twisting-nether,1854,priest,discipline,70,43,27
Dieterdose,tarren-mill,1852,priest,discipline,44,29,15
Crushmyballs,ravencrest,1852,priest,discipline,60,36,24
Rynnegan,zuljin,1849,priest,discipline,72,31,41
Jacknapier,kazzak,1848,priest,discipline,36,24,12
Çhåosgòddess,kazzak,1848,priest,discipline,42,25,17
Андерприст,soulflayer,1848,priest,discipline,128,71,57
Прощайдуде,gordunni,1848,priest,discipline,53,28,25
Andrë,ragnaros,1845,priest,discipline,46,29,17
Jagardoden,stormscale,1845,priest,discipline,59,33,26
Kuusistöö,kazzak,1845,priest,discipline,92,49,43
Soyloverjuan,auchindoun,1843,priest,discipline,52,27,25
Bæsts,ravencrest,1842,priest,discipline,47,35,12
Minilove,ravencrest,1842,priest,discipline,36,22,14
Maulerion,tarren-mill,1842,priest,discipline,92,53,39
Hamsicam,frostwolf,1842,priest,discipline,116,56,60
Kianprie,silvermoon,1842,priest,discipline,101,46,55
Mend,tarren-mill,1841,priest,discipline,77,34,43
Depridolens,argent-dawn,1840,priest,discipline,36,23,13
Kàrèm,blutkessel,1839,priest,discipline,48,28,20
Shîn,zirkel-des-cenarius,1839,priest,discipline,72,32,40
Deadandugly,eredar,1839,priest,discipline,66,28,38
Втильте,blackscar,1838,priest,discipline,138,77,61
Rezzdar,lightnings-blade,1838,priest,discipline,95,49,46
Sheelah,ravencrest,1838,priest,discipline,66,32,34
Nasdaq,ravencrest,1837,priest,discipline,60,30,30
Reflector,sunstrider,1837,priest,discipline,54,24,30
Azoran,dentarg,1836,priest,discipline,72,33,39
Nevercared,aegwynn,1835,priest,discipline,30,25,5
Shonsized,argent-dawn,1835,priest,discipline,142,82,60
Смотривнебоь,soulflayer,1835,priest,discipline,81,45,36
Видзар,blackscar,1834,priest,discipline,42,27,15
Alwaysøøm,kazzak,1834,priest,discipline,120,77,43
Goldensp,sanguino,1834,priest,discipline,75,42,33
Owrly,bladefist,1834,priest,discipline,172,88,84
Azaciúx,sylvanas,1832,priest,discipline,48,29,19
Yzïam,ravencrest,1832,priest,discipline,68,36,32
Feeqamikka,ragnaros,1832,priest,discipline,61,32,29
Карпинчо,soulflayer,1832,priest,discipline,106,50,56
Rîeka,antonidas,1831,priest,discipline,54,25,29
Sazuki,sylvanas,1830,priest,discipline,119,71,48
Healseri,defias-brotherhood,1830,priest,discipline,120,60,60
Kaizza,burning-legion,1829,priest,discipline,48,30,18
Alusiepriest,ravencrest,1829,priest,discipline,164,102,62
Bijaqt,blackmoore,1829,priest,discipline,54,27,27
Mainputa,pozzo-delleternità,1829,priest,discipline,58,28,30
Akeno,sylvanas,1829,priest,discipline,70,31,39
Pradrak,eredar,1828,priest,discipline,54,31,23
Chivalryy,argent-dawn,1828,priest,discipline,119,64,55
Jconnelly,antonidas,1828,priest,discipline,62,32,30
Ltmp,ravencrest,1827,priest,discipline,48,24,24
Ostrogami,silvermoon,1827,priest,discipline,273,132,141
Nadøney,hyjal,1826,priest,discipline,172,87,85
Utrd,kazzak,1826,priest,discipline,191,96,95
Двачх,soulflayer,1826,priest,discipline,66,32,34
Nissha,stormscale,1826,priest,discipline,66,32,34
Eau,quelthalas,1826,priest,discipline,64,30,34
Listrix,frostmane,1826,priest,discipline,66,30,36
Sinetrax,draenor,1825,priest,discipline,48,30,18
Sathie,ravencrest,1825,priest,discipline,60,29,31
Ayõu,ravencrest,1824,priest,discipline,60,36,24
Nalakis,archimonde,1824,priest,discipline,109,62,47
Src,ravencrest,1824,priest,discipline,95,54,41
Collinna,aegwynn,1824,priest,discipline,105,57,48
Sláin,outland,1824,priest,discipline,54,29,25
Lanata,blackrock,1823,priest,discipline,60,34,26
Мухаглот,soulflayer,1823,priest,discipline,71,37,34
Mamaa,stormscale,1822,priest,discipline,72,40,32
Tecc,draenor,1822,priest,discipline,130,65,65
Bølzer,blackrock,1822,priest,discipline,132,64,68
Georgesheenx,ravencrest,1822,priest,discipline,124,58,66
Mèlindra,tarren-mill,1821,priest,discipline,35,28,7
Билет,borean-tundra,1821,priest,discipline,42,26,16
Aâraks,khaz-modan,1821,priest,discipline,134,82,52
Mommymilkrx,argent-dawn,1821,priest,discipline,239,124,115
Miklós,die-aldor,1821,priest,discipline,54,28,26
Scaryolol,blackmoore,1821,priest,discipline,161,83,78
Underdogx,eredar,1821,priest,discipline,216,105,111
Flongoletta,xavius,1821,priest,discipline,54,25,29
Yamai,thrall,1820,priest,discipline,42,24,18
Yunusgødx,kazzak,1819,priest,discipline,102,65,37
Kripteksx,ravencrest,1819,priest,discipline,47,27,20
Омилая,gordunni,1819,priest,discipline,42,24,18
Дорогасмеха,howling-fjord,1819,priest,discipline,66,36,30
Felaenna,argent-dawn,1819,priest,discipline,139,75,64
Swoptoplong,blackhand,1819,priest,discipline,493,261,232
Vibéz,outland,1819,priest,discipline,54,27,27
Alicanx,silvermoon,1818,priest,discipline,111,71,40
Kimspriest,ragnaros,1818,priest,discipline,42,24,18
Egi,lothar,1818,priest,discipline,51,27,24
Monsterzx,outland,1818,priest,discipline,90,44,46
Spiritina,darkmoon-faire,1817,priest,discipline,76,52,24
Inhibitor,tarren-mill,1817,priest,discipline,48,29,19
Holycuddles,ysondre,1817,priest,discipline,78,47,31
Ashenflexj,draenor,1817,priest,discipline,226,115,111
Hanniri,archimonde,1816,priest,discipline,48,28,20
Aenon,argent-dawn,1816,priest,discipline,129,72,57
Соникида,gordunni,1816,priest,discipline,76,39,37
Semper,sylvanas,1816,priest,discipline,52,26,26
Thaeres,stormscale,1816,priest,discipline,65,31,34
Оченьнеочень,howling-fjord,1816,priest,discipline,72,33,39
Moglimeister,blackrock,1815,priest,discipline,42,27,15
Jowaba,ravencrest,1815,priest,discipline,60,38,22
Виллавелл,blackscar,1815,priest,discipline,48,24,24
Zyzx,blackrock,1815,priest,discipline,66,29,37
Анстахоуп,grom,1814,priest,discipline,192,121,71
Discusting,anachronos,1814,priest,discipline,66,34,32
Jamienism,ravencrest,1814,priest,discipline,54,23,31
Iwariel,blackmoore,1813,priest,discipline,102,55,47
Dhassy,sanguino,1812,priest,discipline,71,44,27
Debeo,ragnaros,1812,priest,discipline,75,44,31
Elataqt,silvermoon,1812,priest,discipline,79,45,34
Eedazap,argent-dawn,1812,priest,discipline,58,32,26
ßlinkytwinky,outland,1812,priest,discipline,36,19,17
Discoqt,aegwynn,1812,priest,discipline,60,30,30
Isalvation,stormscale,1812,priest,discipline,78,38,40
Mïserygødx,nemesis,1811,priest,discipline,84,57,27
Maxmoto,blackrock,1811,priest,discipline,92,56,36
Cæsifer,blackrock,1811,priest,discipline,100,55,45
Leahuwu,ravencrest,1811,priest,discipline,72,37,35
Miraña,kazzak,1810,priest,discipline,24,19,5
Xrq,stormscale,1809,priest,discipline,36,27,9
Thedisco,kazzak,1809,priest,discipline,84,56,28
Kâiøxx,outland,1809,priest,discipline,73,42,31
Джагонх,soulflayer,1809,priest,discipline,60,31,29
Kuxk,stormscale,1809,priest,discipline,48,24,24
Stola,archimonde,1809,priest,discipline,101,41,60
Xutira,silvermoon,1808,priest,discipline,195,109,86
Ohlinsqt,outland,1808,priest,discipline,66,36,30
Aòo,twisting-nether,1808,priest,discipline,89,45,44
Aprilfalls,blackmoore,1808,priest,discipline,54,25,29
Råcòøñ,ravencrest,1808,priest,discipline,42,19,23
Бенджаминлол,blackscar,1808,priest,discipline,42,19,23
Chaxxpriest,blackrock,1808,priest,discipline,113,51,62
Ÿolo,nemesis,1807,priest,discipline,80,47,33
Immortalled,twisting-nether,1807,priest,discipline,144,77,67
Seasonf,tarren-mill,1807,priest,discipline,60,28,32
Tacochrist,kazzak,1806,priest,discipline,71,39,32
Zarahard,draenor,1806,priest,discipline,120,65,55
Лёнятреппер,blackscar,1806,priest,discipline,141,76,65
Zeruhphin,eredar,1806,priest,discipline,54,28,26
Lucksy,antonidas,1806,priest,discipline,60,31,29
Brigittë,ravencrest,1806,priest,discipline,66,29,37
Светжрец,blackscar,1805,priest,discipline,36,26,10
Tattum,ragnaros,1805,priest,discipline,84,57,27
Pricemg,thrall,1805,priest,discipline,42,26,16
Andaar,ravencrest,1805,priest,discipline,60,32,28
Поршкаенн,gordunni,1805,priest,discipline,60,32,28
Jeanprêtre,ysondre,1805,priest,discipline,66,30,36
Neems,twisting-nether,1805,priest,discipline,42,19,23
Шкурюклады,gordunni,1805,priest,discipline,60,27,33
Ïcön,ravencrest,1804,priest,discipline,60,43,17
Priestdos,sanguino,1804,priest,discipline,48,31,17
Bennyjamin,kazzak,1804,priest,discipline,74,45,29
Floyyd,kazzak,1804,priest,discipline,42,24,18
Nooxid,eredar,1804,priest,discipline,159,86,73
Remkoja,blackrock,1804,priest,discipline,102,52,50
Mafakor,ravencrest,1804,priest,discipline,138,68,70
Fogel,turalyon,1803,priest,discipline,96,82,14
Frëija,ravencrest,1803,priest,discipline,59,37,22
Gehrke,silvermoon,1803,priest,discipline,105,51,54
Ebiso,ravencrest,1803,priest,discipline,90,41,49
Assiduous,stormreaver,1802,priest,discipline,40,25,15
Faderfarbror,tarren-mill,1802,priest,discipline,97,59,38
Галюхах,soulflayer,1802,priest,discipline,36,19,17
Bassepriest,tarren-mill,1802,priest,discipline,101,53,48
Sydnex,blackmoore,1801,priest,discipline,65,42,23
Cx,mazrigos,1801,priest,discipline,65,42,23
Shínx,illidan,1801,priest,discipline,90,52,38
Artístx,twisting-nether,1801,priest,discipline,53,29,24
Rngånxiety,ravencrest,1801,priest,discipline,60,28,32
Зулфар,razuvious,1800,priest,discipline,48,36,12
Wardshield,ravencrest,1800,priest,discipline,29,20,9
Felwy,stormscale,1800,priest,discipline,48,31,17
Wóllo,stormscale,1800,priest,discipline,66,36,30
Mautiya,blackrock,1800,priest,discipline,96,52,44
Некрогуро,gordunni,1800,priest,discipline,54,27,27
Lazyx,tarren-mill,1800,priest,discipline,59,29,30
Rhauru,tyrande,1800,priest,discipline,59,26,33
Gothicpriest,blackrock,1799,priest,discipline,54,34,20
Таравера,soulflayer,1799,priest,discipline,77,38,39
Grouptherpst,draenor,1798,priest,discipline,238,117,121
Gaussqt,ravencrest,1797,priest,discipline,78,39,39
Bigballer,stormscale,1795,priest,discipline,51,26,25
Фенджидисплх,blackscar,1795,priest,discipline,96,45,51
Legiondisc,blackmoore,1794,priest,discipline,151,69,82
Некронево,howling-fjord,1793,priest,discipline,45,27,18
Racecar,executus,1792,priest,discipline,144,71,73
Ihefyehvjrm,ravencrest,1792,priest,discipline,113,55,58
Wangewover,ravencrest,1791,priest,discipline,123,66,57
Tanlytwo,ravencrest,1791,priest,discipline,52,25,27
Abømination,hyjal,1790,priest,discipline,105,62,43
Artle,dun-modr,1789,priest,discipline,52,36,16
Swiftdemise,sylvanas,1789,priest,discipline,94,42,52
Touchmypink,ragnaros,1788,priest,discipline,113,52,61
Hopesallgone,stormscale,1787,priest,discipline,96,58,38
Dès,ravencrest,1782,priest,discipline,63,31,32
Kêkwshádêzz,blackmoore,1781,priest,discipline,48,21,27
Rickerstrike,stormscale,1780,priest,discipline,96,48,48
Prsx,ravencrest,1780,priest,discipline,72,36,36
Tiphereth,blackmoore,1777,priest,discipline,36,19,17
Lakeworth,argent-dawn,1776,priest,discipline,134,61,73
Нед,greymane,1775,priest,discipline,213,123,90
Giggí,malganis,1774,priest,discipline,42,24,18
Mndvx,sylvanas,1773,priest,discipline,80,40,40
Doublefreak,draenor,1772,priest,discipline,66,41,25
Hellhammer,stormreaver,1772,priest,discipline,154,82,72
Уровеньб,soulflayer,1772,priest,discipline,72,36,36
Spaanseslof,silvermoon,1772,priest,discipline,102,46,56
Eliana,blackrock,1771,priest,discipline,49,27,22
Scortie,blackrock,1771,priest,discipline,43,21,22
Aêalama,argent-dawn,1770,priest,discipline,48,25,23
Dállas,ravencrest,1769,priest,discipline,54,35,19
Chnechnechne,outland,1769,priest,discipline,52,31,21
Neliica,silvermoon,1768,priest,discipline,66,27,39
Magetrainer,tarren-mill,1765,priest,discipline,60,42,18
Talbyslegacý,blackmoore,1765,priest,discipline,102,56,46
Deathgodx,archimonde,1765,priest,discipline,128,70,58
Twinkerz,ravencrest,1764,priest,discipline,90,55,35
Klered,ragnaros,1764,priest,discipline,34,20,14
Flensu,stormscale,1763,priest,discipline,58,32,26
Fearxyz,aegwynn,1762,priest,discipline,54,27,27
Aruna,ravencrest,1761,priest,discipline,70,35,35
Fitu,drakthul,1761,priest,discipline,101,50,51
Lunatique,shadowsong,1760,priest,discipline,50,26,24
Evpisces,archimonde,1760,priest,discipline,219,100,119
Kenzah,ysondre,1759,priest,discipline,30,20,10
Filthyzx,argent-dawn,1758,priest,discipline,54,27,27
Ironqt,malfurion,1758,priest,discipline,112,48,64
Sekker,silvermoon,1757,priest,discipline,303,161,142
Giatros,kazzak,1756,priest,discipline,72,36,36
Ssjfoxyo,sylvanas,1755,priest,discipline,80,37,43
Dreifearfünf,arygos,1754,priest,discipline,90,50,40
Merylle,outland,1751,priest,discipline,41,27,14
Altruistx,ravencrest,1751,priest,discipline,54,26,28
Nàlak,archimonde,1749,priest,discipline,42,21,21
Hoses,twisting-nether,1749,priest,discipline,149,73,76
Mindx,sylvanas,1748,priest,discipline,104,52,52
Devoura,sylvanas,1746,priest,discipline,48,23,25
Mystz,dun-modr,1744,priest,discipline,63,34,29
Holytop,aegwynn,1740,priest,discipline,48,25,23
Emryth,blackhand,1740,priest,discipline,258,131,127
Øxxgodx,blackrock,1740,priest,discipline,87,43,44
Xeldrania,azshara,1739,priest,discipline,41,22,19
Ladderpolice,blackmoore,1739,priest,discipline,48,25,23
Justyø,archimonde,1738,priest,discipline,148,88,60
Lyrina,twisting-nether,1738,priest,discipline,364,199,165
Антошашвп,gordunni,1737,priest,discipline,48,25,23
Фокусшвд,soulflayer,1735,priest,discipline,132,68,64
Elsuzette,hyjal,1734,priest,discipline,40,23,17
Hukkuvahirvi,ravencrest,1733,priest,discipline,58,26,32
Lilypalmer,stormscale,1731,priest,discipline,72,36,36
Drillin,ravencrest,1731,priest,discipline,42,19,23
Fandac,sylvanas,1730,priest,discipline,48,29,19
Tÿona,hyjal,1730,priest,discipline,176,101,75
Snuskong,kazzak,1730,priest,discipline,54,25,29
Akzar,blackrock,1728,priest,discipline,309,164,145
Anheduanna,outland,1728,priest,discipline,515,259,256
Aelisendi,draenor,1727,priest,discipline,71,39,32
Denunciation,argent-dawn,1727,priest,discipline,191,101,90
Architectx,ravencrest,1727,priest,discipline,60,28,32
Pestmorran,sylvanas,1726,priest,discipline,258,125,133
Prips,bladefist,1725,priest,discipline,213,108,105
Justdänce,hyjal,1723,priest,discipline,46,23,23
Аскеронх,howling-fjord,1723,priest,discipline,87,41,46
Holyshiiet,stormscale,1722,priest,discipline,57,36,21
Blazingad,kazzak,1722,priest,discipline,161,82,79
Plsdontcry,blackrock,1722,priest,discipline,54,27,27
Skevitche,hyjal,1721,priest,discipline,208,108,100
Healêl,sanguino,1721,priest,discipline,54,26,28
Seherbazqt,twisting-nether,1720,priest,discipline,47,25,22
Folelli,ysondre,1720,priest,discipline,113,58,55
Smilézz,eredar,1720,priest,discipline,66,32,34
Elsieexø,ravencrest,1720,priest,discipline,60,28,32
Pinipom,kazzak,1719,priest,discipline,38,26,12
Kedrack,draenor,1719,priest,discipline,42,27,15
Hasnoaim,dun-morogh,1719,priest,discipline,48,29,19
Leffie,outland,1719,priest,discipline,51,26,25
Stazqt,conseil-des-ombres,1719,priest,discipline,178,89,89
Eukmassus,archimonde,1719,priest,discipline,58,29,29
Itayyxd,doomhammer,1719,priest,discipline,54,26,28
Kàalyx,archimonde,1718,priest,discipline,66,31,35
Psjk,blackrock,1717,priest,discipline,41,22,19
Ödriaell,the-venture-co,1717,priest,discipline,84,43,41
Cylantharia,eredar,1716,priest,discipline,102,57,45
Spìrít,ghostlands,1716,priest,discipline,48,24,24
Smiteyoudown,blackrock,1716,priest,discipline,42,21,21
Looney,shadowsong,1715,priest,discipline,36,25,11
Berseenreikä,the-venture-co,1715,priest,discipline,48,24,24
Артжрец,soulflayer,1713,priest,discipline,76,43,33
Mitha,tarren-mill,1713,priest,discipline,74,41,33
Baptized,baelgun,1712,priest,discipline,102,47,55
Hannirï,archimonde,1711,priest,discipline,89,62,27
Roxeal,archimonde,1711,priest,discipline,192,107,85
Dendegodx,kazzak,1711,priest,discipline,72,35,37
Fuzzymerge,ravencrest,1710,priest,discipline,47,28,19
Ðarkan,kaelthas,1709,priest,discipline,126,73,53
Fatishcribe,twisting-nether,1709,priest,discipline,209,119,90
Eagrh,ravencrest,1707,priest,discipline,147,92,55
Kèvin,das-syndikat,1707,priest,discipline,71,43,28
Kijhun,uldaman,1707,priest,discipline,72,40,32
Priewyn,ragnaros,1707,priest,discipline,186,100,86
Holó,stormscale,1707,priest,discipline,36,18,18
Шаастраха,gordunni,1707,priest,discipline,67,30,37
Alessana,antonidas,1705,priest,discipline,41,25,16
Yukasa,silvermoon,1705,priest,discipline,78,34,44
Kaldhor,ysondre,1705,priest,discipline,71,29,42
Keryin,draenor,1704,priest,discipline,114,47,67
Ðês,ravencrest,1703,priest,discipline,30,18,12
Убикрофт,soulflayer,1703,priest,discipline,49,24,25
Ampara,thrall,1703,priest,discipline,84,41,43
Nintendó,sylvanas,1702,priest,discipline,42,25,17
Вашачесть,gordunni,1702,priest,discipline,114,59,55
Swdjack,blackrock,1702,priest,discipline,156,78,78
Bekznfiend,ragnaros,1701,priest,discipline,48,22,26
Babybeyle,arakarahm,1701,priest,discipline,77,35,42
Gurgaue,argent-dawn,1701,priest,discipline,53,24,29
Kapts,twisting-nether,1700,priest,discipline,30,18,12
Kollis,twilights-hammer,1699,priest,discipline,147,76,71
Abudhabi,blackhand,1699,priest,discipline,344,176,168
Nancey,draenor,1699,priest,discipline,36,18,18
Verjin,kazzak,1699,priest,discipline,90,36,54
Jämar,archimonde,1698,priest,discipline,60,29,31
Areyqt,ravencrest,1697,priest,discipline,36,22,14
Gòldfinger,norgannon,1697,priest,discipline,162,76,86
Døppëlápfèl,tarren-mill,1696,priest,discipline,30,20,10
Echonic,aegwynn,1696,priest,discipline,159,79,80
Cptisus,draenor,1696,priest,discipline,72,31,41
Mixoo,throkferoth,1696,priest,discipline,95,40,55
Swdommeil,aegwynn,1695,priest,discipline,48,24,24
Choron,kult-der-verdammten,1694,priest,discipline,89,44,45
Flào,draenor,1694,priest,discipline,42,20,22
Xaey,ravencrest,1693,priest,discipline,84,45,39
Лизагодх,howling-fjord,1693,priest,discipline,61,32,29
Сонясоукьют,gordunni,1693,priest,discipline,54,26,28
Verweven,twisting-nether,1692,priest,discipline,47,26,21
Pierrebourne,blackmoore,1692,priest,discipline,48,23,25
Apuessii,dun-modr,1692,priest,discipline,65,28,37
Samaya,blackrock,1691,priest,discipline,92,41,51
Rêstlêss,blackrock,1690,priest,discipline,65,36,29
Шестьнадцать,gordunni,1689,priest,discipline,107,60,47
Notnøw,silvermoon,1688,priest,discipline,35,23,12
Афганский,gordunni,1688,priest,discipline,46,24,22
Znàdix,silvermoon,1688,priest,discipline,234,122,112
Zërøx,ysondre,1688,priest,discipline,48,18,30
Hrtbrxkn,ravencrest,1687,priest,discipline,64,39,25
Wérrýxs,kazzak,1687,priest,discipline,142,80,62
Wraithtrippz,stormscale,1687,priest,discipline,82,42,40
Syntara,twisting-nether,1686,priest,discipline,293,157,136
Cyabish,twisting-nether,1686,priest,discipline,211,110,101
Waaqa,outland,1686,priest,discipline,60,25,35
Gajos,frostwolf,1685,priest,discipline,84,47,37
Maerlene,nemesis,1684,priest,discipline,57,24,33
Roshmanoff,stormscale,1683,priest,discipline,36,18,18
Barackomana,blackrock,1683,priest,discipline,114,53,61
Hwren,auchindoun,1682,priest,discipline,90,41,49
Kevinsorbo,destromath,1681,priest,discipline,36,20,16
Lizka,kazzak,1681,priest,discipline,54,26,28
Marôs,antonidas,1681,priest,discipline,60,26,34
Donipriest,ravencrest,1680,priest,discipline,66,39,27
Ljusmor,silvermoon,1680,priest,discipline,57,33,24
Swdommeil,blackrock,1680,priest,discipline,36,19,17
Tricavla,frostmane,1679,priest,discipline,72,38,34
Sheeash,kazzak,1679,priest,discipline,36,18,18
ßrûm,archimonde,1679,priest,discipline,48,23,25
Mythrixia,draenor,1678,priest,discipline,69,39,30
Mohammedx,tarren-mill,1678,priest,discipline,42,19,23
Sutenör,kazzak,1678,priest,discipline,108,43,65
Шайтсунг,soulflayer,1677,priest,discipline,56,30,26
Дъикиймвп,deepholm,1676,priest,discipline,36,20,16
Clownspec,twisting-nether,1676,priest,discipline,54,26,28
Holytopp,aegwynn,1675,priest,discipline,42,25,17
Meltmvp,thrall,1675,priest,discipline,48,25,23
Scarletstory,ravencrest,1675,priest,discipline,148,70,78
Файкахохо,soulflayer,1675,priest,discipline,59,24,35
Darktemplarx,magtheridon,1673,priest,discipline,36,21,15
Scurrp,aegwynn,1673,priest,discipline,72,36,36
Deepsea,kazzak,1673,priest,discipline,254,123,131
Scarified,aggramar,1673,priest,discipline,48,23,25
Eluveitieq,kazzak,1672,priest,discipline,77,44,33
Devotedape,draenor,1672,priest,discipline,83,45,38
Carnegi,burning-legion,1672,priest,discipline,72,39,33
Ingelosi,eredar,1672,priest,discipline,190,97,93
Byef,kazzak,1671,priest,discipline,56,31,25
Darkshdwbrst,malorne,1670,priest,discipline,81,51,30
Anotu,tarren-mill,1670,priest,discipline,36,21,15
Zaak,kazzak,1670,priest,discipline,59,26,33
Traxtoor,tarren-mill,1669,priest,discipline,33,23,10
Csúforck,ragnaros,1669,priest,discipline,48,26,22
Jøjmenejøj,ravencrest,1669,priest,discipline,49,25,24
Norganp,die-aldor,1668,priest,discipline,74,40,34
Eyllise,ragnaros,1668,priest,discipline,202,108,94
Luckystar,grim-batol,1668,priest,discipline,59,31,28
Nocdsusage,draenor,1668,priest,discipline,196,98,98
Yugata,archimonde,1668,priest,discipline,51,21,30
Lindvorm,tarren-mill,1667,priest,discipline,120,61,59
Efeslol,dun-modr,1667,priest,discipline,132,66,66
Kevokko,silvermoon,1667,priest,discipline,54,23,31
Nolnilian,archimonde,1666,priest,discipline,42,23,19
Nzothapostle,baelgun,1666,priest,discipline,93,43,50
Loví,twisting-nether,1666,priest,discipline,48,22,26
Salvatíon,sanguino,1666,priest,discipline,236,105,131
Bambus,shattered-hand,1665,priest,discipline,36,23,13
Trntypr,senjin,1665,priest,discipline,84,48,36
Xzep,archimonde,1665,priest,discipline,151,75,76
Gehrketwo,silvermoon,1664,priest,discipline,42,24,18
Worldgamer,blackrock,1664,priest,discipline,84,43,41
Duelistfied,blackrock,1664,priest,discipline,39,19,20
Cnqz,archimonde,1664,priest,discipline,48,23,25
Alahkazam,alakir,1663,priest,discipline,56,24,32
Eyecry,sylvanas,1662,priest,discipline,69,38,31
Xraid,blackmoore,1662,priest,discipline,42,23,19
Sikaanyo,blackhand,1662,priest,discipline,66,35,31
Ðiiez,ysondre,1662,priest,discipline,39,20,19
Jibrael,draenor,1662,priest,discipline,78,39,39
Cätälin,twisting-nether,1662,priest,discipline,181,88,93
Kaksel,blackrock,1661,priest,discipline,72,38,34
Obbdasknob,ravencrest,1661,priest,discipline,52,27,25
Slimcharles,ravencrest,1660,priest,discipline,201,108,93
Алеброн,gordunni,1660,priest,discipline,54,25,29
Nihpolz,ragnaros,1659,priest,discipline,57,32,25
Twosugars,sylvanas,1659,priest,discipline,120,65,55
Krystynal,archimonde,1659,priest,discipline,47,24,23
Lorimac,dun-modr,1659,priest,discipline,159,78,81
Trashedd,outland,1659,priest,discipline,75,32,43
Holymoly,talnivarr,1659,priest,discipline,96,40,56
Seranà,hyjal,1658,priest,discipline,96,51,45
Xangha,burning-legion,1658,priest,discipline,234,120,114
Trevorlahey,draenor,1658,priest,discipline,48,24,24
Naphell,outland,1658,priest,discipline,90,43,47
Dispelgodxx,eredar,1658,priest,discipline,54,25,29
Ew,shattered-halls,1658,priest,discipline,58,26,32
Mobcal,twisting-nether,1658,priest,discipline,48,19,29
Nyxoqtxd,ravencrest,1657,priest,discipline,76,43,33
Glyss,draenor,1657,priest,discipline,66,36,30
Kahir,ravencrest,1657,priest,discipline,64,34,30
Krottus,antonidas,1657,priest,discipline,53,28,25
Assacine,aegwynn,1657,priest,discipline,59,31,28
Karanas,archimonde,1657,priest,discipline,42,21,21
Приствалера,howling-fjord,1657,priest,discipline,207,103,104
Toxp,kazzak,1657,priest,discipline,68,30,38
Kaleycuoco,blackrock,1656,priest,discipline,78,36,42
Эвэргарден,eversong,1655,priest,discipline,54,20,34
Wasnezov,blackhand,1654,priest,discipline,82,39,43
Hexonite,burning-legion,1653,priest,discipline,42,25,17
Йефа,gordunni,1653,priest,discipline,42,23,19
Ayoutbt,ravencrest,1652,priest,discipline,42,22,20
Tryhàrdx,stormscale,1652,priest,discipline,54,25,29
Blackbertha,ravencrest,1652,priest,discipline,144,66,78
Inoru,stormreaver,1651,priest,discipline,114,60,54
Pedopräst,stormscale,1650,priest,discipline,72,39,33
Расспутана,howling-fjord,1650,priest,discipline,241,124,117
Shallteár,doomhammer,1650,priest,discipline,174,86,88
Olurin,rajaxx,1650,priest,discipline,60,25,35
Spbosse,aszune,1649,priest,discipline,42,28,14
Arlekin,ravencrest,1649,priest,discipline,72,47,25
Zoophobîa,stormscale,1649,priest,discipline,42,22,20
Violentha,kazzak,1649,priest,discipline,96,50,46
Элишана,deathguard,1649,priest,discipline,111,54,57
Wonderdispel,ragnaros,1649,priest,discipline,78,31,47
Chèéks,kazzak,1648,priest,discipline,72,43,29
Cathocrasty,draenor,1648,priest,discipline,81,46,35
Angrypiex,stormscale,1648,priest,discipline,41,21,20
Joeelz,blackmoore,1647,priest,discipline,36,25,11
Sills,twisting-nether,1647,priest,discipline,53,23,30
Følísh,hyjal,1646,priest,discipline,54,38,16
Tøxicboy,ravencrest,1646,priest,discipline,89,48,41
Qhub,sylvanas,1646,priest,discipline,114,59,55
Watchmedark,ravencrest,1646,priest,discipline,42,21,21
Yugemilkers,kazzak,1646,priest,discipline,85,42,43
Mopriest,eredar,1645,priest,discipline,38,24,14
Gepeitschter,frostwolf,1645,priest,discipline,120,64,56
Ptrspriest,twisting-nether,1645,priest,discipline,54,27,27
Horrðr,kazzak,1644,priest,discipline,96,54,42
Rmt,darksorrow,1644,priest,discipline,42,23,19
Rezzurrectum,doomhammer,1644,priest,discipline,63,34,29
Cinnamoroll,ravencrest,1642,priest,discipline,54,26,28
Walkmydome,twisting-nether,1641,priest,discipline,144,73,71
Virdeo,aegwynn,1641,priest,discipline,48,24,24
Репабликуес,gordunni,1641,priest,discipline,36,18,18
Duqes,stormreaver,1640,priest,discipline,24,19,5
Xtracheesy,ragnaros,1640,priest,discipline,72,45,27
Fluvnidi,ravencrest,1640,priest,discipline,66,38,28
Vigodis,alleria,1638,priest,discipline,150,83,67
Dzyxx,ravencrest,1638,priest,discipline,42,23,19
Mantra,blackmoore,1638,priest,discipline,42,23,19
Coqa,blackrock,1638,priest,discipline,36,19,17
Zanshin,ravencrest,1637,priest,discipline,29,18,11
Legitha,blackmoore,1637,priest,discipline,39,22,17
Vorynax,silvermoon,1637,priest,discipline,56,31,25
Gimeurgold,aegwynn,1637,priest,discipline,42,21,21
Schlämpie,blackmoore,1637,priest,discipline,67,29,38
Mentaldeadp,draenor,1636,priest,discipline,82,50,32
Randmbare,nemesis,1636,priest,discipline,36,21,15
Ванальная,soulflayer,1636,priest,discipline,42,21,21
Milania,ravencrest,1636,priest,discipline,118,57,61
Tylér,stormscale,1634,priest,discipline,48,29,19
Yûnalescá,blackmoore,1634,priest,discipline,82,44,38
Аая,blackscar,1634,priest,discipline,96,49,47
Amtoxic,stormscale,1634,priest,discipline,311,155,156
Fatalx,grim-batol,1634,priest,discipline,46,21,25
Trolldý,outland,1633,priest,discipline,36,21,15
Savagex,dun-modr,1633,priest,discipline,96,50,46
Аэтпио,soulflayer,1633,priest,discipline,54,23,31
Yameru,stormreaver,1633,priest,discipline,60,22,38
Misántropo,dun-modr,1632,priest,discipline,59,38,21
Sakulus,malganis,1632,priest,discipline,42,21,21
Ahpøual,archimonde,1632,priest,discipline,168,82,86
Snutz,draenor,1631,priest,discipline,42,21,21
Ankus,tarren-mill,1631,priest,discipline,48,23,25
Zloyvrach,ravencrest,1630,priest,discipline,54,25,29
Vregoa,twisting-nether,1629,priest,discipline,71,42,29
Bebwaz,kazzak,1629,priest,discipline,60,33,27
Могулас,soulflayer,1629,priest,discipline,251,132,119
Èzì,burning-legion,1629,priest,discipline,76,38,38
Rankoneprazt,stormscale,1629,priest,discipline,47,22,25
Acidrops,hyjal,1629,priest,discipline,48,22,26
Frojka,outland,1629,priest,discipline,42,19,23
Japral,blackhand,1628,priest,discipline,36,25,11
Beabanane,aegwynn,1628,priest,discipline,91,44,47
Leviakerman,blackrock,1628,priest,discipline,42,18,24
Шатолюгран,soulflayer,1627,priest,discipline,82,55,27
Zehakky,tarren-mill,1627,priest,discipline,91,56,35
Yënâs,hyjal,1627,priest,discipline,97,59,38
Sølvfox,stormscale,1627,priest,discipline,42,25,17
Aleluia,alonsus,1627,priest,discipline,99,43,56
Хомие,soulflayer,1626,priest,discipline,85,44,41
Élsias,blackmoore,1626,priest,discipline,42,21,21
Eestpr,tarren-mill,1626,priest,discipline,45,20,25
Discxqt,ysondre,1625,priest,discipline,83,51,32
Asgà,stormscale,1625,priest,discipline,30,17,13
Pepeflex,draenor,1625,priest,discipline,79,38,41
Demora,ysondre,1624,priest,discipline,24,17,7
Strawhât,eredar,1624,priest,discipline,47,27,20
Luuña,ravencrest,1624,priest,discipline,161,92,69
Garsdal,tarren-mill,1624,priest,discipline,78,43,35
Títarie,aegwynn,1624,priest,discipline,36,19,17
Пристижнаяя,gordunni,1624,priest,discipline,50,25,25
Alicewhydel,blackhand,1624,priest,discipline,46,23,23
Farae,arathor,1624,priest,discipline,44,19,25
Fricia,zuljin,1623,priest,discipline,65,38,27
Artist,outland,1623,priest,discipline,30,17,13
Illuminarexo,sylvanas,1623,priest,discipline,71,36,35
Djleffe,stormscale,1622,priest,discipline,39,23,16
Mnu,blackrock,1622,priest,discipline,52,30,22
Мплехибои,gordunni,1622,priest,discipline,54,30,24
Feed,burning-legion,1622,priest,discipline,84,45,39
Кролс,gordunni,1622,priest,discipline,42,22,20
Såra,ravencrest,1622,priest,discipline,48,22,26
Двелегитоп,howling-fjord,1621,priest,discipline,36,23,13
Zinzor,archimonde,1621,priest,discipline,61,37,24
Líluqt,sanguino,1621,priest,discipline,30,17,13
Babybelle,arakarahm,1621,priest,discipline,61,33,28
Lethalhealz,outland,1621,priest,discipline,194,102,92
Mindfiend,stormscale,1621,priest,discipline,81,37,44
Mautijr,blackrock,1620,priest,discipline,284,153,131
Zuniqa,die-aldor,1620,priest,discipline,93,41,52
Outtloor,twisting-nether,1619,priest,discipline,39,25,14
Wifta,ravencrest,1619,priest,discipline,54,30,24
Healdeal,stormscale,1619,priest,discipline,190,89,101
Mønsterx,kazzak,1618,priest,discipline,64,37,27
Medipack,khaz-modan,1617,priest,discipline,54,38,16
Stargal,blackmoore,1617,priest,discipline,30,21,9
Prost,aerie-peak,1617,priest,discipline,71,47,24
Uivi,azjolnerub,1617,priest,discipline,30,17,13
Cultaken,kazzak,1617,priest,discipline,58,30,28
Notnowelf,silvermoon,1617,priest,discipline,48,20,28
Mikeypi,laughing-skull,1616,priest,discipline,36,25,11
Isweariheal,twisting-nether,1616,priest,discipline,58,37,21
Blerd,eredar,1616,priest,discipline,41,23,18
Saniss,tarren-mill,1616,priest,discipline,78,39,39
Avgenjoyer,kazzak,1616,priest,discipline,84,41,43
Krolox,blackhand,1616,priest,discipline,60,25,35
Preme,blackhand,1616,priest,discipline,48,19,29
Èightsix,draenor,1615,priest,discipline,161,88,73
Athelsta,alleria,1615,priest,discipline,75,40,35
Pshan,blackmoore,1615,priest,discipline,170,87,83
Grimdream,ragnaros,1615,priest,discipline,164,82,82
Awcute,kazzak,1615,priest,discipline,232,111,121
Eliverax,outland,1615,priest,discipline,116,54,62
Troedelsuppe,destromath,1615,priest,discipline,144,61,83
Mythasz,archimonde,1615,priest,discipline,52,21,31
Kavrack,dalaran,1614,priest,discipline,30,17,13
Feardotexe,frostwolf,1614,priest,discipline,163,82,81
Gnzysan,blackrock,1613,priest,discipline,66,39,27
Jp,gorgonnash,1613,priest,discipline,42,21,21
Ptsd,argent-dawn,1613,priest,discipline,72,35,37
Zýgzäg,hyjal,1613,priest,discipline,172,81,91
Burningheatx,kazzak,1612,priest,discipline,65,44,21
Bizqit,tarren-mill,1612,priest,discipline,143,75,68
Cptatonement,draenor,1612,priest,discipline,60,30,30
Xoxogg,burning-blade,1611,priest,discipline,108,69,39
Matwucss,outland,1611,priest,discipline,42,25,17
Southyz,stormscale,1611,priest,discipline,93,53,40
Enzineum,twisting-nether,1611,priest,discipline,30,17,13
Verminous,ravencrest,1611,priest,discipline,68,38,30
Shadowboness,twisting-nether,1611,priest,discipline,58,31,27
Blazekk,sylvanas,1611,priest,discipline,72,32,40
Lolylights,tarren-mill,1611,priest,discipline,48,20,28
Judgementdaý,kazzak,1610,priest,discipline,30,20,10
Holyblóod,kazzak,1610,priest,discipline,30,17,13
Viu,eredar,1610,priest,discipline,51,22,29
Zychopriest,antonidas,1610,priest,discipline,42,17,25
Mcdodgens,auchindoun,1610,priest,discipline,84,32,52
Yoii,nemesis,1609,priest,discipline,34,23,11
Holyshiz,stormrage,1609,priest,discipline,42,24,18
Fazzy,nagrand,1609,priest,discipline,76,41,35
Aïezn,culte-de-la-rive-noire,1609,priest,discipline,96,44,52
Grzmocillaa,burning-legion,1608,priest,discipline,42,23,19
Géèk,alakir,1608,priest,discipline,52,28,24
Fakecats,sargeras,1608,priest,discipline,51,22,29
Softie,zuljin,1607,priest,discipline,36,23,13
Bercxu,ragnaros,1607,priest,discipline,87,45,42
Cizer,kazzak,1607,priest,discipline,116,57,59
Felvytwo,stormscale,1607,priest,discipline,36,17,19
Vqny,archimonde,1606,priest,discipline,118,69,49
Llamamepadre,dun-modr,1606,priest,discipline,42,20,22
Диспайзх,gordunni,1606,priest,discipline,186,88,98
Anabølixx,ravencrest,1605,priest,discipline,36,23,13
Saénna,burning-legion,1604,priest,discipline,44,22,22
Rabbai,twisting-nether,1604,priest,discipline,42,21,21
Kolinamenuss,dun-morogh,1604,priest,discipline,48,21,27
Thejambura,ragnaros,1603,priest,discipline,116,71,45
Veltrag,sanguino,1603,priest,discipline,54,33,21
Tabaç,stormscale,1603,priest,discipline,36,21,15
Mysticforces,silvermoon,1603,priest,discipline,60,28,32
Хилботгодикс,borean-tundra,1602,priest,discipline,42,32,10
Хеликси,gordunni,1602,priest,discipline,235,127,108
Pokahonta,silvermoon,1602,priest,discipline,225,116,109
Cadierna,argent-dawn,1602,priest,discipline,42,19,23
Lahammy,kazzak,1601,priest,discipline,50,30,20
Tritíana,blackrock,1601,priest,discipline,186,107,79
Ashuramaru,drakthul,1601,priest,discipline,47,24,23
Мастди,ashenvale,1601,priest,discipline,41,20,21
Xîz,silvermoon,1601,priest,discipline,66,32,34
Yro,gorgonnash,1601,priest,discipline,42,20,22
Enzysama,sanguino,1601,priest,discipline,48,21,27
Киллус,ashenvale,1601,priest,discipline,72,29,43
Lgbtgodx,archimonde,1600,priest,discipline,61,45,16
Ellfle,kazzak,1600,priest,discipline,42,26,16
Dêrbómbêr,guldan,1600,priest,discipline,54,30,24
Sinîra,frostwolf,1600,priest,discipline,110,59,51
Darkprist,sanguino,1600,priest,discipline,66,34,32
Interrupted,kazzak,1600,priest,discipline,66,30,36
Noviriel,argent-dawn,1600,priest,discipline,47,19,28
Yungblessing,stormscale,1599,priest,discipline,36,17,19
Tutoress,stormscale,1597,priest,discipline,36,20,16
Jhaazx,nemesis,1597,priest,discipline,155,84,71
Semagdnim,aggra-português,1597,priest,discipline,51,19,32
Sebikpri,ravencrest,1596,priest,discipline,60,34,26
Баблби,soulflayer,1596,priest,discipline,169,73,96
Aédeira,blackhand,1596,priest,discipline,47,20,27
Alèxy,tarren-mill,1596,priest,discipline,48,19,29
Ðæððÿsgïrl,ravencrest,1595,priest,discipline,132,67,65
Fønss,sanguino,1595,priest,discipline,41,17,24
Hateyeleison,burning-legion,1593,priest,discipline,48,24,24
Flygar,outland,1593,priest,discipline,42,18,24
Lavendertown,tarren-mill,1592,priest,discipline,38,22,16
Badorange,kazzak,1592,priest,discipline,59,29,30
Cyberlunatic,antonidas,1592,priest,discipline,96,45,51
Hâlez,antonidas,1591,priest,discipline,332,172,160
Артфуул,howling-fjord,1591,priest,discipline,36,17,19
Øbz,sylvanas,1591,priest,discipline,72,31,41
Nexìan,ravencrest,1588,priest,discipline,48,23,25
Vänskap,kazzak,1587,priest,discipline,132,65,67
Mcdced,archimonde,1587,priest,discipline,84,41,43
Toba,hellscream,1585,priest,discipline,113,65,48
Deathspren,stormscale,1585,priest,discipline,30,17,13
Sosabgd,azjolnerub,1585,priest,discipline,30,17,13
Prästpojken,frostwhisper,1585,priest,discipline,96,48,48
Пустотность,gordunni,1585,priest,discipline,173,79,94
Sahorie,archimonde,1584,priest,discipline,135,79,56
Copperpriest,draenor,1584,priest,discipline,68,35,33
Skynoxx,ragnaros,1584,priest,discipline,114,56,58
Vanillå,silvermoon,1584,priest,discipline,58,28,30
Dreythan,stormrage,1584,priest,discipline,74,33,41
Enoriya,blackrock,1583,priest,discipline,212,119,93
Liviúss,draenor,1583,priest,discipline,72,37,35
Logath,archimonde,1582,priest,discipline,30,17,13
Terno,sylvanas,1582,priest,discipline,160,80,80
Амберис,gordunni,1581,priest,discipline,54,27,27
Чилюнахиле,gordunni,1581,priest,discipline,71,23,48
Kolinamenus,dun-morogh,1580,priest,discipline,126,63,63
Botstyleswdx,ravencrest,1580,priest,discipline,154,70,84
Fsnx,sylvanas,1578,priest,discipline,34,22,12
Dreamscapez,tarren-mill,1578,priest,discipline,36,22,14
Blindmymind,malganis,1578,priest,discipline,59,30,29
Averagenoob,ragnaros,1578,priest,discipline,54,25,29
Maccz,hyjal,1577,priest,discipline,68,32,36
Соулвардинг,soulflayer,1577,priest,discipline,42,18,24
Shadowfishey,grim-batol,1577,priest,discipline,42,17,25
Fulgus,sanguino,1577,priest,discipline,72,28,44
Dush,draenor,1576,priest,discipline,38,22,16
Tuitio,blackmoore,1576,priest,discipline,65,34,31
Lobbygriefer,ravencrest,1576,priest,discipline,203,102,101
Parzivál,argent-dawn,1576,priest,discipline,101,44,57
Флафика,deathguard,1575,priest,discipline,78,45,33
Chamelthoe,the-maelstrom,1575,priest,discipline,96,47,49
Люблюкофе,deathguard,1574,priest,discipline,65,32,33
Gød,magtheridon,1574,priest,discipline,66,29,37
Dotreveal,ravencrest,1573,priest,discipline,65,33,32
Aia,tyrande,1573,priest,discipline,88,41,47
Patriamore,jaedenar,1572,priest,discipline,34,18,16
Nyarlatothep,boulderfist,1572,priest,discipline,148,77,71
Gravebrain,draenor,1572,priest,discipline,208,100,108
Wencis,kazzak,1571,priest,discipline,60,31,29
Colèy,blackhand,1570,priest,discipline,126,71,55
Miikkap,blackhand,1570,priest,discipline,60,29,31
Hèmera,tichondrius,1568,priest,discipline,55,41,14
Forcedtoheal,sylvanas,1568,priest,discipline,43,26,17
Effectx,stormscale,1568,priest,discipline,72,35,37
Trénboloné,tarren-mill,1567,priest,discipline,36,18,18
Bengtas,ravencrest,1567,priest,discipline,53,20,33
Gødsfåvørite,blackrock,1566,priest,discipline,36,17,19
Denyz,blackrock,1566,priest,discipline,54,21,33
Tansk,stormscale,1565,priest,discipline,132,75,57
Shalvy,aegwynn,1564,priest,discipline,164,83,81
Darudo,kazzak,1564,priest,discipline,96,48,48
Yøløswagg,silvermoon,1564,priest,discipline,48,21,27
Rasha,kazzak,1563,priest,discipline,69,41,28
Tifa,ravencrest,1563,priest,discipline,60,35,25
Alicanx,twisting-nether,1563,priest,discipline,84,37,47
Unfaker,drakthul,1562,priest,discipline,36,23,13
Hamati,blackhand,1562,priest,discipline,84,47,37
Neverlandx,bladefist,1561,priest,discipline,36,21,15
Hérune,outland,1561,priest,discipline,36,19,17
Uo,kilrogg,1561,priest,discipline,78,40,38
Nooway,kazzak,1561,priest,discipline,90,43,47
Jempi,argent-dawn,1559,priest,discipline,54,31,23
Рвотка,gordunni,1559,priest,discipline,124,68,56
Raffá,blackhand,1559,priest,discipline,48,17,31
Tremrfinger,dun-modr,1558,priest,discipline,62,38,24
Нз,soulflayer,1558,priest,discipline,41,19,22
Lishado,twisting-nether,1557,priest,discipline,96,49,47
Пальтишко,howling-fjord,1557,priest,discipline,96,45,51
Raawri,blackmoore,1557,priest,discipline,54,24,30
Мэдсанван,howling-fjord,1556,priest,discipline,96,54,42
Tamy,draenor,1556,priest,discipline,62,33,29
Vhim,hyjal,1555,priest,discipline,52,24,28
Женяшилд,howling-fjord,1555,priest,discipline,77,35,42
Fearadelia,thrall,1554,priest,discipline,24,18,6
Darkprofit,aegwynn,1554,priest,discipline,107,54,53
Holyasprin,sylvanas,1554,priest,discipline,42,21,21
Frednshield,tarren-mill,1554,priest,discipline,69,34,35
Brilho,frostmane,1554,priest,discipline,87,35,52
Edoran,ragnaros,1553,priest,discipline,91,49,42
Рэйкар,razuvious,1553,priest,discipline,65,33,32
Khâléd,kazzak,1553,priest,discipline,36,17,19
Kirtarah,aegwynn,1553,priest,discipline,42,17,25
Juggster,bloodhoof,1552,priest,discipline,174,91,83
Простосори,gordunni,1552,priest,discipline,456,221,235
Cinri,argent-dawn,1552,priest,discipline,223,108,115
Cresellia,twisting-nether,1552,priest,discipline,170,81,89
Freaki,blackrock,1551,priest,discipline,36,23,13
Shadowbread,tarren-mill,1551,priest,discipline,36,19,17
Ipâ,hyjal,1551,priest,discipline,255,114,141
Korzec,dun-modr,1550,priest,discipline,108,57,51
Jandice,blackrock,1550,priest,discipline,36,18,18
Exoduz,stormscale,1550,priest,discipline,117,58,59
Acrio,die-ewige-wacht,1550,priest,discipline,54,26,28
Надийя,gordunni,1549,priest,discipline,120,68,52
Evõmax,sylvanas,1549,priest,discipline,161,87,74
Anaqt,silvermoon,1549,priest,discipline,76,41,35
Xaerah,blackmoore,1549,priest,discipline,78,41,37
Arkkinunna,outland,1549,priest,discipline,124,59,65
Húlda,auchindoun,1548,priest,discipline,48,24,24
Sonics,antonidas,1548,priest,discipline,66,31,35
Bandulskii,twisting-nether,1548,priest,discipline,239,111,128
Snusprällen,sylvanas,1547,priest,discipline,47,22,25
Bubbelchên,blackhand,1547,priest,discipline,66,28,38
Systerstål,twisting-nether,1546,priest,discipline,78,45,33
Anarame,silvermoon,1546,priest,discipline,45,24,21
Alexpriest,twisting-nether,1546,priest,discipline,175,88,87
Alphabreyf,tarren-mill,1545,priest,discipline,83,43,40
Holycrapx,chromaggus,1545,priest,discipline,62,32,30
Sameec,drakthul,1545,priest,discipline,42,19,23
Minipõppy,ravencrest,1545,priest,discipline,71,30,41
Подчинись,ashenvale,1544,priest,discipline,81,49,32
Diszi,norgannon,1544,priest,discipline,58,28,30
Ohbenji,ravencrest,1543,priest,discipline,116,57,59
Mêmphìs,twisting-nether,1543,priest,discipline,83,38,45
Enimao,tarren-mill,1542,priest,discipline,37,20,17
Jmp,tarren-mill,1542,priest,discipline,34,17,17
Admiration,eredar,1542,priest,discipline,47,23,24
Labadudala,aegwynn,1541,priest,discipline,36,26,10
Enigam,alakir,1541,priest,discipline,54,33,21
Mtbalt,tarren-mill,1541,priest,discipline,120,71,49
Tjat,silvermoon,1540,priest,discipline,66,34,32
Whiskie,twisting-nether,1540,priest,discipline,60,30,30
Aestina,silvermoon,1540,priest,discipline,108,53,55
Voidsnitch,antonidas,1540,priest,discipline,66,30,36
Safemode,ravencrest,1539,priest,discipline,42,24,18
Keyfear,kazzak,1539,priest,discipline,87,44,43
Grautesk,chogall,1539,priest,discipline,48,23,25
Влажныйшп,soulflayer,1538,priest,discipline,66,37,29
Alesthion,silvermoon,1538,priest,discipline,80,42,38
Luvdisc,ysondre,1538,priest,discipline,38,18,20
Burnex,thrall,1537,priest,discipline,54,26,28
Légít,argent-dawn,1537,priest,discipline,60,20,40
Pehmoinen,korgall,1536,priest,discipline,40,19,21
Saintpri,twisting-nether,1535,priest,discipline,96,52,44
Goblex,hyjal,1535,priest,discipline,63,28,35
Разрухаовнз,gordunni,1534,priest,discipline,24,16,8
Майндоф,howling-fjord,1534,priest,discipline,60,34,26
Discomacka,twisting-nether,1534,priest,discipline,48,26,22
Buan,blackmoore,1533,priest,discipline,63,39,24
Danina,outland,1532,priest,discipline,54,28,26
Valnor,pozzo-delleternità,1532,priest,discipline,57,27,30
Verzeichnis,thrall,1531,priest,discipline,112,67,45
Фыбра,soulflayer,1531,priest,discipline,30,16,14
Вилайф,galakrond,1531,priest,discipline,64,32,32
Wiildsy,tarren-mill,1531,priest,discipline,53,24,29
Интенси,gordunni,1531,priest,discipline,48,21,27
Ectria,ravencrest,1531,priest,discipline,54,22,32
Амбракадабра,blackscar,1530,priest,discipline,36,26,10
Coldyxz,blackrock,1530,priest,discipline,30,16,14
Swallowship,twisting-nether,1530,priest,discipline,36,16,20
Targoviste,archimonde,1529,priest,discipline,343,184,159
Skaliq,tarren-mill,1529,priest,discipline,69,37,32
Remkojatwo,blackrock,1529,priest,discipline,30,16,14
Тодохил,gordunni,1528,priest,discipline,56,27,29
Gulch,blackmoore,1528,priest,discipline,54,26,28
Nevor,nemesis,1528,priest,discipline,124,57,67
Lowery,argent-dawn,1528,priest,discipline,36,16,20
Padisonfire,blackmoore,1528,priest,discipline,42,16,26
Wâneis,stormscale,1527,priest,discipline,30,18,12
Rizzlerx,blackmoore,1527,priest,discipline,54,32,22
Limeslayerx,veklor,1527,priest,discipline,30,17,13
Dêxter,hyjal,1527,priest,discipline,102,51,51
Místerbiceps,outland,1527,priest,discipline,36,16,20
Pipperxp,ravencrest,1526,priest,discipline,36,23,13
Árî,dun-modr,1526,priest,discipline,87,50,37
Kamiyasa,blackmoore,1526,priest,discipline,48,27,21
Dyliz,stormscale,1526,priest,discipline,99,50,49
Scodây,blackmoore,1526,priest,discipline,182,91,91
Kurt,blackrock,1526,priest,discipline,102,50,52
Huffinctus,tarren-mill,1525,priest,discipline,112,59,53
Nurbanu,ravencrest,1524,priest,discipline,77,49,28
Whýççpèrx,ravencrest,1524,priest,discipline,30,16,14
Elämäntypy,stormscale,1524,priest,discipline,90,45,45
Bockx,ragnaros,1524,priest,discipline,42,16,26
Chôrdi,aegwynn,1523,priest,discipline,154,76,78
Виспх,eversong,1523,priest,discipline,269,120,149
Tarîs,archimonde,1523,priest,discipline,66,29,37
Deoxx,kazzak,1523,priest,discipline,42,16,26
Lythi,eredar,1522,priest,discipline,118,52,66
Ёджих,blackscar,1521,priest,discipline,109,55,54
Sehek,sanguino,1521,priest,discipline,48,21,27
Drxz,twilights-hammer,1520,priest,discipline,46,24,22
Chrispriest,argent-dawn,1520,priest,discipline,38,18,20
Mamis,anetheron,1520,priest,discipline,48,22,26
Aternia,draenor,1519,priest,discipline,54,28,26
Cbsad,madmortem,1518,priest,discipline,78,45,33
Трихоманиаз,ashenvale,1518,priest,discipline,48,23,25
Srakabot,burning-legion,1518,priest,discipline,42,18,24
Laxímink,sylvanas,1518,priest,discipline,65,26,39
Ssol,tarren-mill,1517,priest,discipline,49,29,20
Senpumara,malganis,1517,priest,discipline,264,133,131
Dtpe,kazzak,1516,priest,discipline,63,41,22
Dotzey,outland,1516,priest,discipline,35,16,19
Lemontea,frostwolf,1515,priest,discipline,36,21,15
Kimozabi,ravencrest,1515,priest,discipline,44,25,19
Babywayn,onyxia,1515,priest,discipline,104,54,50
Shyria,argent-dawn,1515,priest,discipline,53,25,28
Lukéy,silvermoon,1514,priest,discipline,66,33,33
Anotherdisc,aegwynn,1514,priest,discipline,36,17,19
Foobi,the-maelstrom,1513,priest,discipline,303,158,145
Raesd,argent-dawn,1513,priest,discipline,58,30,28
Kuqezi,archimonde,1513,priest,discipline,42,21,21
Батямелднул,blackscar,1512,priest,discipline,36,23,13
Kratzîgel,blackmoore,1512,priest,discipline,120,69,51
Grêy,dun-modr,1512,priest,discipline,47,24,23
Erupyks,archimonde,1512,priest,discipline,36,18,18
Ciri,die-aldor,1511,priest,discipline,31,18,13
Viagrà,outland,1509,priest,discipline,108,50,58
Knazh,twisting-nether,1508,priest,discipline,36,20,16
Cav,archimonde,1508,priest,discipline,71,33,38
Asherá,kazzak,1508,priest,discipline,60,19,41
Poonies,silvermoon,1507,priest,discipline,118,56,62
Tinpr,sanguino,1507,priest,discipline,105,48,57
Zealtron,darksorrow,1507,priest,discipline,47,19,28
Lïnkz,kazzak,1506,priest,discipline,48,26,22
Cryksî,eredar,1506,priest,discipline,54,29,25
Исусиприст,deepholm,1506,priest,discipline,36,18,18
Bolflo,khaz-modan,1505,priest,discipline,126,72,54
Смайтвайфу,howling-fjord,1505,priest,discipline,54,27,27
Gûardianwisp,ravencrest,1505,priest,discipline,123,61,62
Mortarz,ragnaros,1505,priest,discipline,71,31,40
Dench,azjolnerub,1505,priest,discipline,60,25,35
Fantästic,kazzak,1504,priest,discipline,98,55,43
Flurri,tarren-mill,1504,priest,discipline,120,66,54
Остроухх,howling-fjord,1503,priest,discipline,70,40,30
Zoe,aegwynn,1503,priest,discipline,171,90,81
Xaridan,thrall,1501,priest,discipline,48,31,17
Shînnøk,silvermoon,1501,priest,discipline,84,42,42
Anzil,dun-modr,1501,priest,discipline,66,32,34
Мэдмод,gordunni,1501,priest,discipline,77,30,47
Мьюсх,deathguard,1500,priest,discipline,77,42,35
Lurri,tarren-mill,1500,priest,discipline,102,52,50
Cúrt,sanguino,1500,priest,discipline,60,29,31
Dreamhatcher,deathwing,1500,priest,discipline,42,18,24
Elwing,darkmoon-faire,1500,priest,discipline,48,18,30
Laërhia,archimonde,1499,priest,discipline,48,18,30
Holysheett,magtheridon,1497,priest,discipline,72,40,32
Holineß,burning-blade,1496,priest,discipline,60,36,24
Menda,eredar,1496,priest,discipline,112,63,49
Aasgard,frostwolf,1496,priest,discipline,30,16,14
Alz,rashgarroth,1496,priest,discipline,134,65,69
Холиблэк,blackscar,1496,priest,discipline,36,16,20
Шимату,howling-fjord,1495,priest,discipline,72,25,47
Onetwo,silvermoon,1494,priest,discipline,30,18,12
Drawun,burning-legion,1494,priest,discipline,116,67,49
Sheshan,destromath,1494,priest,discipline,53,29,24
Hïstërïä,silvermoon,1494,priest,discipline,57,28,29
Blackbox,burning-legion,1494,priest,discipline,127,59,68
Olio,outland,1494,priest,discipline,76,35,41
Buzzy,twisting-nether,1492,priest,discipline,60,32,28
Karoopi,ysondre,1492,priest,discipline,149,78,71
Kanî,eredar,1491,priest,discipline,72,33,39
Themistia,kazzak,1491,priest,discipline,48,20,28
Aurunea,blackrock,1490,priest,discipline,45,30,15
Holycrit,aszune,1490,priest,discipline,53,26,27
Nêlumar,aegwynn,1490,priest,discipline,48,21,27
Nahni,teldrassil,1489,priest,discipline,72,28,44
Ziv,grim-batol,1488,priest,discipline,74,46,28
Khazidhea,frostwolf,1488,priest,discipline,87,41,46
Lerión,ravencrest,1487,priest,discipline,30,17,13
Orophar,antonidas,1487,priest,discipline,53,29,24
Fiskpung,draenor,1486,priest,discipline,48,28,20
Nomakprst,sanguino,1486,priest,discipline,130,63,67
Mewpew,azjolnerub,1486,priest,discipline,54,23,31
Kåstå,archimonde,1485,priest,discipline,74,44,30
Jakeow,auchindoun,1484,priest,discipline,57,31,26
Klituriis,twisting-nether,1483,priest,discipline,77,41,36
Akemmì,sylvanas,1482,priest,discipline,150,75,75
Elûnä,ysondre,1481,priest,discipline,156,89,67
Jumperlawl,khaz-modan,1481,priest,discipline,48,26,22
Rikipope,ravencrest,1480,priest,discipline,42,25,17
Pìkachù,stormscale,1480,priest,discipline,42,21,21
Aurosa,argent-dawn,1478,priest,discipline,79,37,42
Yhraeliaegh,defias-brotherhood,1478,priest,discipline,69,26,43
Diarolz,sanguino,1477,priest,discipline,69,39,30
Kdot,drakthul,1477,priest,discipline,48,23,25
Эйвиг,blackscar,1477,priest,discipline,60,28,32
Scréam,eredar,1477,priest,discipline,72,33,39
Oscoolytb,archimonde,1476,priest,discipline,48,16,32
Maneipriest,drakthul,1475,priest,discipline,47,26,21
Апититька,soulflayer,1475,priest,discipline,84,41,43
Mungam,draenor,1475,priest,discipline,57,27,30
Amoxkys,nemesis,1475,priest,discipline,68,30,38
Mzpriest,dalaran,1474,priest,discipline,76,41,35
Prezica,stormscale,1474,priest,discipline,137,72,65
Aboû,archimonde,1474,priest,discipline,48,25,23
Олегстразза,howling-fjord,1474,priest,discipline,93,44,49
Licktheheal,outland,1473,priest,discipline,30,17,13
Джахия,soulflayer,1473,priest,discipline,85,47,38
Lilpi,rexxar,1473,priest,discipline,42,22,20
Джулибуба,borean-tundra,1473,priest,discipline,57,26,31
Санггвиний,soulflayer,1472,priest,discipline,90,46,44
Шпангл,gordunni,1472,priest,discipline,107,54,53
Marllen,twisting-nether,1472,priest,discipline,139,68,71
Whiskeyhaze,burning-legion,1471,priest,discipline,72,41,31
Niholie,sinstralis,1471,priest,discipline,48,18,30
Porklifer,tarren-mill,1470,priest,discipline,54,32,22
Kyseki,ravencrest,1470,priest,discipline,406,205,201
Loarderonx,stormscale,1470,priest,discipline,35,16,19
Eleatros,blackrock,1470,priest,discipline,58,25,33
Discipleotl,stormscale,1469,priest,discipline,36,23,13
Менестрели,gordunni,1469,priest,discipline,130,75,55
Bleedingeyes,tarren-mill,1469,priest,discipline,45,23,22
Cajolîne,archimonde,1469,priest,discipline,90,39,51
Battra,argent-dawn,1468,priest,discipline,78,41,37
Fåtkidx,ravencrest,1468,priest,discipline,61,29,32
Drwlad,archimonde,1468,priest,discipline,66,26,40
Dejica,kult-der-verdammten,1467,priest,discipline,90,43,47
Brutapriestx,stormscale,1467,priest,discipline,35,16,19
Flaskandeux,tarren-mill,1467,priest,discipline,68,18,50
Spoggle,kazzak,1466,priest,discipline,102,51,51
Panoio,aggra-português,1466,priest,discipline,77,33,44
Yákizå,darksorrow,1466,priest,discipline,72,30,42
Winnever,dun-modr,1465,priest,discipline,213,116,97
Krasawìtch,onyxia,1465,priest,discipline,66,28,38
Gïanna,archimonde,1464,priest,discipline,96,52,44
Geierlol,blackrock,1464,priest,discipline,42,17,25
Тэтэшник,ashenvale,1463,priest,discipline,77,41,36
Scade,kazzak,1463,priest,discipline,98,47,51
Eßola,silvermoon,1463,priest,discipline,38,18,20
Джелесана,gordunni,1463,priest,discipline,87,38,49
Мненосина,goldrinn,1462,priest,discipline,46,21,25
Krayziest,tarren-mill,1461,priest,discipline,42,26,16
Íhðly,silvermoon,1461,priest,discipline,84,42,42
Ahmnesia,archimonde,1460,priest,discipline,138,72,66
Трэй,deathguard,1459,priest,discipline,90,50,40
Ðiscobiscuit,argent-dawn,1459,priest,discipline,104,55,49
Daddyfinger,argent-dawn,1458,priest,discipline,97,56,41
Ivysaurus,ravencrest,1458,priest,discipline,74,42,32
Ruly,ragnaros,1458,priest,discipline,51,25,26
Makesnosense,kilrogg,1458,priest,discipline,54,26,28
Sweetxq,tarren-mill,1457,priest,discipline,42,28,14
Amysantiàgo,sylvanas,1457,priest,discipline,71,37,34
Dotdotggwp,stormscale,1456,priest,discipline,84,39,45
Péntagón,festung-der-stürme,1456,priest,discipline,48,19,29
Nyxalia,silvermoon,1455,priest,discipline,30,18,12
Synoé,la-croisade-écarlate,1455,priest,discipline,65,33,32
Ballsbrawlz,sylvanas,1454,priest,discipline,30,18,12
Laonar,silvermoon,1454,priest,discipline,103,59,44
Massbimba,tarren-mill,1454,priest,discipline,138,75,63
Фейкай,blackscar,1454,priest,discipline,54,28,26
Disturbdtwo,archimonde,1454,priest,discipline,66,31,35
Tynsxd,silvermoon,1453,priest,discipline,72,40,32
Holypepper,outland,1453,priest,discipline,83,44,39
Алуриэлия,gordunni,1453,priest,discipline,83,40,43
Angelic,ragnaros,1453,priest,discipline,48,19,29
Mvuu,kazzak,1452,priest,discipline,42,25,17
Tarellia,argent-dawn,1451,priest,discipline,114,72,42
Apøcalypso,antonidas,1451,priest,discipline,84,45,39
Kätsulol,ysondre,1451,priest,discipline,48,24,24
Reticlel,kazzak,1451,priest,discipline,44,22,22
Arize,dun-modr,1450,priest,discipline,42,21,21
Devot,outland,1449,priest,discipline,76,42,34
Nerfnerf,kazzak,1449,priest,discipline,311,158,153
Artì,kazzak,1449,priest,discipline,53,18,35
Шарадин,gordunni,1448,priest,discipline,110,59,51
Mòly,archimonde,1446,priest,discipline,27,17,10
Kâltak,aegwynn,1446,priest,discipline,48,24,24
Sáshagrey,arathor,1446,priest,discipline,49,24,25
Neoni,blackmoore,1446,priest,discipline,148,72,76
Arkatina,outland,1446,priest,discipline,42,19,23
Mamabeer,draenor,1445,priest,discipline,42,25,17
Diva,malfurion,1445,priest,discipline,40,20,20
Серыйлог,galakrond,1444,priest,discipline,90,49,41
Spirítbox,argent-dawn,1444,priest,discipline,106,54,52
Troublemaker,durotan,1443,priest,discipline,54,30,24
Chankilolx,dun-modr,1443,priest,discipline,169,78,91
Sombralúz,sanguino,1442,priest,discipline,36,20,16
Shanny,kazzak,1442,priest,discipline,89,43,46
Aeritha,blackmoore,1441,priest,discipline,30,19,11
Convulsiveq,silvermoon,1441,priest,discipline,256,131,125
Laurent,sanguino,1441,priest,discipline,36,16,20
Svistis,ravencrest,1440,priest,discipline,28,20,8
Смегмачет,soulflayer,1440,priest,discipline,122,63,59
Mackópriest,ragnaros,1440,priest,discipline,46,17,29
Swd,dun-morogh,1439,priest,discipline,24,15,9
Cáss,archimonde,1439,priest,discipline,30,15,15
Voxqt,blackrock,1439,priest,discipline,30,15,15
Bedkara,ravencrest,1439,priest,discipline,30,15,15
Zedrus,azshara,1439,priest,discipline,111,53,58
Elfarity,tarren-mill,1438,priest,discipline,30,18,12
Åshbé,archimonde,1437,priest,discipline,18,15,3
Mjamc,stormscale,1437,priest,discipline,78,33,45
Yonkerz,frostmane,1437,priest,discipline,108,43,65
Бомжскадилом,gordunni,1436,priest,discipline,225,120,105
Dzoo,kazzak,1436,priest,discipline,58,27,31
Kbakå,stormscale,1436,priest,discipline,84,37,47
Ylvanna,arthas,1436,priest,discipline,40,17,23
Pàndoràh,nemesis,1435,priest,discipline,42,22,20
Zularia,rexxar,1434,priest,discipline,24,15,9
Кэндимен,gordunni,1434,priest,discipline,100,54,46
Kæyc,blackmoore,1434,priest,discipline,71,35,36
Bubidiblumpr,twisting-nether,1433,priest,discipline,66,40,26
Selëne,blackrock,1433,priest,discipline,42,22,20
Kobri,gilneas,1432,priest,discipline,48,23,25
Swera,twisting-nether,1431,priest,discipline,24,15,9
Jupiter,silvermoon,1431,priest,discipline,84,45,39
Vaetrilla,doomhammer,1430,priest,discipline,37,20,17
Littleheal,ghostlands,1430,priest,discipline,30,16,14
Neagica,kazzak,1430,priest,discipline,42,21,21
Lanaineuwu,archimonde,1429,priest,discipline,32,22,10
Zhadow,outland,1429,priest,discipline,36,15,21
Yurrij,thrall,1428,priest,discipline,39,23,16
Lapinvicieux,archimonde,1428,priest,discipline,36,20,16
Noodlesoup,daggerspine,1428,priest,discipline,67,37,30
Alinone,uldum,1428,priest,discipline,49,20,29
Menarille,kazzak,1427,priest,discipline,18,15,3
Diddlefiddle,stormscale,1427,priest,discipline,64,36,28
Сашадвасм,gordunni,1427,priest,discipline,81,45,36
Discobrill,silvermoon,1427,priest,discipline,48,19,29
Ylenae,twisting-nether,1427,priest,discipline,42,15,27
Amanojakü,ravencrest,1426,priest,discipline,48,34,14
Toorree,stormscale,1426,priest,discipline,48,24,24
Aetas,hyjal,1425,priest,discipline,24,15,9
Massdispell,silvermoon,1425,priest,discipline,34,20,14
Dímension,ragnaros,1425,priest,discipline,79,46,33
Yvaini,xavius,1425,priest,discipline,66,35,31
Yuukii,kult-der-verdammten,1425,priest,discipline,30,15,15
Урголиафа,howling-fjord,1425,priest,discipline,54,25,29
Yesdaddypls,draenor,1424,priest,discipline,31,18,13
Soulreapper,blackhand,1424,priest,discipline,177,94,83
Zymai,ravencrest,1424,priest,discipline,42,15,27
Phreyst,draenor,1423,priest,discipline,165,85,80
Bilbobanging,aggramar,1423,priest,discipline,30,15,15
Nirsis,dun-modr,1423,priest,discipline,63,30,33
Lyés,uldaman,1422,priest,discipline,100,65,35
Zzbleh,stormscale,1422,priest,discipline,24,15,9
Frekio,eitrigg,1421,priest,discipline,137,69,68
Eördög,ragnaros,1421,priest,discipline,36,17,19
Zyrean,bronzebeard,1421,priest,discipline,34,16,18
Halastrâ,tarren-mill,1420,priest,discipline,44,30,14
Lauriinda,culte-de-la-rive-noire,1420,priest,discipline,43,18,25
Eileengu,silvermoon,1419,priest,discipline,64,40,24
Avaichquirit,tarren-mill,1419,priest,discipline,48,21,27
Destinychild,norgannon,1419,priest,discipline,35,15,20
Kæzm,blackrock,1418,priest,discipline,31,17,14
Нэстикус,gordunni,1418,priest,discipline,30,16,14
Dalylla,aggra-português,1418,priest,discipline,57,29,28
Медиив,deepholm,1418,priest,discipline,66,32,34
Jaatjak,ravencrest,1418,priest,discipline,54,26,28
Гачибунта,blackscar,1417,priest,discipline,41,27,14
Carnacia,tarren-mill,1417,priest,discipline,59,36,23
Sprutch,kazzak,1417,priest,discipline,56,30,26
Блексебет,soulflayer,1417,priest,discipline,90,46,44
Мдзшка,gordunni,1417,priest,discipline,248,120,128
Vividots,draenor,1417,priest,discipline,42,20,22
Remlos,der-rat-von-dalaran,1415,priest,discipline,30,15,15
Pmh,kazzak,1415,priest,discipline,60,25,35
Marícanqt,tarren-mill,1414,priest,discipline,18,15,3
Praybro,blackmoore,1414,priest,discipline,41,24,17
Kaeldara,ysondre,1413,priest,discipline,24,15,9
Oxborn,thrall,1413,priest,discipline,83,40,43
Ledania,aegwynn,1412,priest,discipline,24,15,9
Joseantuan,sanguino,1412,priest,discipline,30,18,12
Asolan,drakthul,1412,priest,discipline,60,35,25
Ihaveibs,doomhammer,1411,priest,discipline,30,15,15
Ецци,howling-fjord,1410,priest,discipline,44,23,21
Faelvirin,aegwynn,1410,priest,discipline,41,21,20
Joniop,stormreaver,1410,priest,discipline,60,29,31
Shanya,thrall,1410,priest,discipline,42,20,22
Jóhnnybravó,kazzak,1410,priest,discipline,36,16,20
Getötet,blackrock,1409,priest,discipline,36,21,15
Dunderprälle,outland,1409,priest,discipline,30,15,15
Deathchicka,draenor,1408,priest,discipline,52,31,21
Lévention,stormscale,1408,priest,discipline,36,20,16
Avengëd,nagrand,1408,priest,discipline,44,22,22
Xypri,nordrassil,1408,priest,discipline,61,29,32
Cring,kirin-tor,1407,priest,discipline,108,62,46
Vynivan,korgall,1407,priest,discipline,48,21,27
Gothixs,draenor,1406,priest,discipline,44,26,18
Garfriest,aggra-português,1406,priest,discipline,78,46,32
Sensor,kazzak,1406,priest,discipline,69,34,35
Golletz,twisting-nether,1405,priest,discipline,24,15,9
Tiktokdancér,kazzak,1405,priest,discipline,78,46,32
Medivs,blackmoore,1405,priest,discipline,30,17,13
Qïx,ravencrest,1405,priest,discipline,39,22,17
Putinkuilo,outland,1405,priest,discipline,42,21,21
Youngfade,twisting-nether,1405,priest,discipline,40,16,24
Ceraghk,tichondrius,1404,priest,discipline,94,47,47
Dragovic,chogall,1404,priest,discipline,80,38,42
Arctoczax,ravencrest,1404,priest,discipline,48,17,31
Aaron,aegwynn,1403,priest,discipline,18,15,3
Aiewn,elune,1403,priest,discipline,51,31,20
Chuckline,eredar,1403,priest,discipline,70,36,34
Kbakå,kazzak,1402,priest,discipline,32,15,17
Acidpills,hyjal,1402,priest,discipline,40,17,23
Virulent,nemesis,1402,priest,discipline,36,15,21
Angelofdeàth,kazzak,1401,priest,discipline,72,40,32
Dysko,alakir,1401,priest,discipline,30,15,15
Syro,defias-brotherhood,1400,priest,discipline,33,19,14
Chimara,eredar,1400,priest,discipline,90,48,42
Silvdarr,hyjal,1400,priest,discipline,91,47,44
Hardcode,twisting-nether,1400,priest,discipline,50,22,28
Вурти,howling-fjord,1400,priest,discipline,65,28,37
Maidie,stormscale,1399,priest,discipline,55,34,21
Animepfp,stormreaver,1399,priest,discipline,104,49,55
Chibrausorus,archimonde,1399,priest,discipline,54,22,32
Laadyybirkee,blackhand,1398,priest,discipline,140,70,70
Nøheall,ysondre,1398,priest,discipline,65,27,38
Fiilaaja,stormreaver,1397,priest,discipline,42,26,16
Холишитс,gordunni,1396,priest,discipline,115,64,51
Velles,nazjatar,1396,priest,discipline,339,174,165
Rahan,stormscale,1396,priest,discipline,93,46,47
Derylium,kazzak,1395,priest,discipline,47,29,18
Deadpxlz,ravencrest,1395,priest,discipline,30,17,13
Miileys,arthas,1394,priest,discipline,24,16,8
Alakkiria,ravencrest,1394,priest,discipline,77,38,39
Kroa,ragnaros,1393,priest,discipline,24,15,9
Fireflowers,silvermoon,1393,priest,discipline,48,24,24
Alliora,dalaran,1393,priest,discipline,87,36,51
Ashérs,ravencrest,1392,priest,discipline,45,29,16
Rher,blackmoore,1392,priest,discipline,24,15,9
Uppiediscyo,ravencrest,1392,priest,discipline,78,41,37
Phasmöphobia,zuljin,1392,priest,discipline,96,38,58
Альфреска,gordunni,1391,priest,discipline,66,34,32
Noobpriest,blackrock,1391,priest,discipline,76,32,44
Zombîe,draenor,1390,priest,discipline,42,16,26
Dankopriest,drakthul,1389,priest,discipline,42,21,21
Unholyfield,draenor,1389,priest,discipline,90,41,49
Vaewyn,ravencrest,1386,priest,discipline,68,37,31
Nakali,the-maelstrom,1386,priest,discipline,30,16,14
Дядяврач,howling-fjord,1386,priest,discipline,60,28,32
Woodywoodpkr,senjin,1386,priest,discipline,42,18,24
Pyropenance,twisting-nether,1386,priest,discipline,83,35,48
Гшд,gordunni,1385,priest,discipline,78,43,35
Benificent,argent-dawn,1385,priest,discipline,123,60,63
Zïn,silvermoon,1385,priest,discipline,52,25,27
Sémi,twisting-nether,1383,priest,discipline,36,19,17
Сосиска,deathguard,1383,priest,discipline,29,15,14
Adev,drakthul,1382,priest,discipline,53,27,26
Naïlu,hyjal,1381,priest,discipline,66,38,28
Anbish,burning-legion,1381,priest,discipline,42,21,21
Selenee,scarshield-legion,1381,priest,discipline,102,47,55
Snuifje,azjolnerub,1381,priest,discipline,99,45,54
Sppid,sanguino,1381,priest,discipline,53,21,32
Onelovexx,thrall,1380,priest,discipline,36,15,21
Ilovedisc,kazzak,1379,priest,discipline,44,25,19
Reäzx,archimonde,1379,priest,discipline,30,17,13
Thrakoun,twilights-hammer,1379,priest,discipline,140,69,71
Luziaa,outland,1379,priest,discipline,42,15,27
Хаварь,gordunni,1378,priest,discipline,87,49,38
Маимморта,howling-fjord,1378,priest,discipline,66,37,29
Щакактрахнем,gordunni,1378,priest,discipline,66,36,30
Лимоняшечка,soulflayer,1378,priest,discipline,110,58,52
Streety,nethersturm,1378,priest,discipline,90,43,47
Evolís,blackmoore,1378,priest,discipline,66,29,37
Gangreana,kazzak,1377,priest,discipline,78,42,36
Anubisones,uldum,1377,priest,discipline,65,32,33
Overhealzz,blackmoore,1377,priest,discipline,78,38,40
Annisa,kazzak,1376,priest,discipline,131,71,60
Darkest,ysondre,1376,priest,discipline,77,33,44
Preachyjeg,ravencrest,1376,priest,discipline,84,30,54
Dolifrius,dalaran,1375,priest,discipline,50,30,20
Олдмэнсэйд,soulflayer,1375,priest,discipline,27,16,11
Targolina,argent-dawn,1375,priest,discipline,175,83,92
Invexx,tarren-mill,1375,priest,discipline,90,35,55
Простойа,deathguard,1374,priest,discipline,60,33,27
Psyfir,outland,1374,priest,discipline,224,117,107
Otheym,the-maelstrom,1374,priest,discipline,39,18,21
Pocketissue,ravencrest,1373,priest,discipline,32,21,11
Crazyname,outland,1373,priest,discipline,78,39,39
Blackheal,sanguino,1373,priest,discipline,68,29,39
Nietzsche,area-52,1373,priest,discipline,54,23,31
Rabbît,stormscale,1372,priest,discipline,82,42,40
Arkkupiispa,stormreaver,1372,priest,discipline,223,106,117
Hiereia,khadgar,1372,priest,discipline,139,61,78
Geesuz,outland,1372,priest,discipline,39,16,23
Kutjeskopper,silvermoon,1371,priest,discipline,36,19,17
Скизма,gordunni,1370,priest,discipline,42,25,17
Kotipope,silvermoon,1369,priest,discipline,83,49,34
Elosen,darkspear,1368,priest,discipline,36,20,16
Aykò,blackmoore,1368,priest,discipline,38,16,22
Tepevelf,dun-modr,1367,priest,discipline,40,15,25
Trashpriest,blackrock,1367,priest,discipline,41,15,26
Salzgehalt,antonidas,1366,priest,discipline,58,38,20
Stargóddess,kazzak,1366,priest,discipline,48,31,17
Hellsaya,ysondre,1366,priest,discipline,34,19,15
Chaosxo,draenor,1366,priest,discipline,59,27,32
Xyfas,azshara,1362,priest,discipline,54,25,29
Aisha,rajaxx,1361,priest,discipline,69,32,37
Ræpriestx,ragnaros,1360,priest,discipline,75,36,39
Dooga,draenor,1359,priest,discipline,30,15,15
Enduring,darksorrow,1359,priest,discipline,72,33,39
Priesless,sylvanas,1357,priest,discipline,34,20,14
Sochnaochen,outland,1357,priest,discipline,30,16,14
Antainis,silvermoon,1357,priest,discipline,59,30,29
Mamaoh,ravencrest,1356,priest,discipline,54,26,28
Kappa,darksorrow,1356,priest,discipline,48,23,25
Nuklash,burning-legion,1356,priest,discipline,39,18,21
Äkvä,ragnaros,1356,priest,discipline,66,26,40
Paterpaisios,kazzak,1355,priest,discipline,54,20,34
Freddyprinze,ravencrest,1354,priest,discipline,39,21,18
Nésha,dun-modr,1354,priest,discipline,41,21,20
Byxoph,sanguino,1353,priest,discipline,66,32,34
Solarïah,garona,1352,priest,discipline,32,19,13
Tintapri,aszune,1352,priest,discipline,117,58,59
Svevo,ravencrest,1352,priest,discipline,54,25,29
Littlehelper,shendralar,1352,priest,discipline,39,16,23
Chealsey,thrall,1351,priest,discipline,57,36,21
Isore,culte-de-la-rive-noire,1351,priest,discipline,34,20,14
Feelmypainn,kazzak,1350,priest,discipline,42,23,19
Smilyface,sylvanas,1350,priest,discipline,47,20,27
Тэвиель,gordunni,1350,priest,discipline,66,27,39
Chowhone,archimonde,1349,priest,discipline,100,53,47
Raî,durotan,1349,priest,discipline,36,18,18
Psychoboris,outland,1348,priest,discipline,114,64,50
Dstars,archimonde,1348,priest,discipline,42,16,26
Greedyaf,stormscale,1347,priest,discipline,101,48,53
Brênos,blackmoore,1346,priest,discipline,29,17,12
Sphero,kazzak,1346,priest,discipline,42,24,18
Iamfrosty,draenor,1346,priest,discipline,66,31,35
Sytawa,blackmoore,1345,priest,discipline,66,36,30
Pwjetlifelol,grim-batol,1345,priest,discipline,97,52,45
Sâtânica,kelthuzad,1345,priest,discipline,72,33,39
Тенсаи,howling-fjord,1345,priest,discipline,42,19,23
Batsu,hyjal,1344,priest,discipline,94,43,51
Noxr,ravencrest,1344,priest,discipline,50,18,32
Drlovke,stormscale,1343,priest,discipline,24,14,10
Докторпэйн,howling-fjord,1343,priest,discipline,92,43,49
Вакариия,soulflayer,1343,priest,discipline,30,14,16
Kaémon,twisting-nether,1343,priest,discipline,100,40,60
Chuckbarry,kazzak,1342,priest,discipline,24,15,9
Krematorio,twisting-nether,1342,priest,discipline,24,14,10
Spiochpr,burning-legion,1342,priest,discipline,84,44,40
Поднялбабки,deathguard,1342,priest,discipline,36,14,22
Centaurio,nemesis,1340,priest,discipline,92,46,46
Cutename,burning-blade,1340,priest,discipline,36,18,18
Sephìrøth,malganis,1340,priest,discipline,66,32,34
Далайна,galakrond,1340,priest,discipline,36,14,22
Sissi,blackmoore,1339,priest,discipline,75,39,36
Pâww,kazzak,1339,priest,discipline,30,14,16
Yânux,aegwynn,1339,priest,discipline,30,14,16
Æternadead,nemesis,1338,priest,discipline,42,23,19
Tumlaa,ravencrest,1337,priest,discipline,56,31,25
Perdítá,thrall,1337,priest,discipline,165,85,80
Myggsparv,stormscale,1336,priest,discipline,30,14,16
Cedifanboyx,archimonde,1336,priest,discipline,30,14,16
Kojee,blackrock,1335,priest,discipline,48,18,30
Banshzz,ragnaros,1335,priest,discipline,55,19,36
Biscuits,ravencrest,1335,priest,discipline,48,14,34
Юлих,booty-bay,1334,priest,discipline,70,27,43
Barracuda,burning-legion,1333,priest,discipline,72,36,36
Radiance,emeriss,1333,priest,discipline,40,15,25
Jerzay,hyjal,1332,priest,discipline,40,16,24
Rosalina,ravencrest,1331,priest,discipline,85,44,41
Aroghul,eredar,1331,priest,discipline,54,23,31
Waafa,kazzak,1331,priest,discipline,42,14,28
Rose,darksorrow,1328,priest,discipline,37,21,16
Holyfussell,antonidas,1328,priest,discipline,66,30,36
Peersh,ahnqiraj,1327,priest,discipline,18,14,4
Ràthaløs,sanguino,1327,priest,discipline,52,31,21
Nou,aegwynn,1327,priest,discipline,36,14,22
Valaç,turalyon,1326,priest,discipline,125,64,61
Vedina,bronze-dragonflight,1326,priest,discipline,84,42,42
Èlysium,grim-batol,1326,priest,discipline,42,15,27
Ximenia,eredar,1325,priest,discipline,43,25,18
Seinaruki,emerald-dream,1325,priest,discipline,34,18,16
Skrnz,turalyon,1325,priest,discipline,59,26,33
Германий,deathguard,1324,priest,discipline,35,21,14
Iqr,blackmoore,1324,priest,discipline,24,14,10
Buszeekk,outland,1324,priest,discipline,34,19,15
Jodge,ravencrest,1324,priest,discipline,48,26,22
Styrbjörn,shattered-hand,1324,priest,discipline,73,38,35
Kalisy,ravencrest,1324,priest,discipline,52,27,25
Durness,argent-dawn,1324,priest,discipline,66,31,35
Hashoko,draenor,1323,priest,discipline,18,15,3
Rwaphouu,ysondre,1323,priest,discipline,36,20,16
Ruderali,blackmoore,1323,priest,discipline,82,44,38
Hidr,nemesis,1323,priest,discipline,60,31,29
Девственен,soulflayer,1321,priest,discipline,48,22,26
Bakony,ravencrest,1320,priest,discipline,30,22,8
Nirvánabang,sylvanas,1320,priest,discipline,42,21,21
Фурлена,blackscar,1319,priest,discipline,91,48,43
Rodshun,dun-modr,1317,priest,discipline,76,34,42
Emon,nemesis,1316,priest,discipline,24,14,10
Meanazer,antonidas,1316,priest,discipline,30,14,16
Darkweed,twilights-hammer,1315,priest,discipline,54,30,24
Pristerline,antonidas,1314,priest,discipline,25,15,10
Sabaxdxd,dun-modr,1314,priest,discipline,72,32,40
Yugo,outland,1314,priest,discipline,41,15,26
Пакетикдот,gordunni,1313,priest,discipline,96,56,40
Shilôz,hyjal,1313,priest,discipline,59,29,30
Relaxmom,bloodhoof,1312,priest,discipline,30,14,16
Форсибучи,soulflayer,1312,priest,discipline,66,30,36
Ассарх,lich-king,1311,priest,discipline,78,39,39
Chilie,ravencrest,1311,priest,discipline,30,15,15
Spèrman,frostwolf,1311,priest,discipline,42,15,27
Suzziee,silvermoon,1310,priest,discipline,48,25,23
Violentha,silvermoon,1310,priest,discipline,30,15,15
Nûwa,draenor,1309,priest,discipline,42,25,17
Eowins,blackmoore,1307,priest,discipline,76,40,36
Dirtydoc,area-52,1307,priest,discipline,39,20,19
Yuuvi,ravencrest,1307,priest,discipline,65,29,36
Buzzingg,tarren-mill,1305,priest,discipline,41,26,15
Lalgorithme,hyjal,1305,priest,discipline,24,14,10
Paine,pozzo-delleternità,1305,priest,discipline,31,18,13
Асади,gordunni,1305,priest,discipline,60,33,27
Shadowmend,aegwynn,1305,priest,discipline,29,14,15
Prellish,draenor,1305,priest,discipline,60,25,35
Phórkys,kazzak,1304,priest,discipline,102,59,43
Ангеланика,gordunni,1304,priest,discipline,42,22,20
Boulotpas,hyjal,1302,priest,discipline,72,47,25
Sykra,magtheridon,1302,priest,discipline,76,41,35
Ahree,sargeras,1302,priest,discipline,124,58,66
Missdreavus,draenor,1301,priest,discipline,40,24,16
Enerpriest,ysondre,1301,priest,discipline,36,20,16
Ostberger,twisting-nether,1300,priest,discipline,53,30,23
Fullymetalz,defias-brotherhood,1300,priest,discipline,58,32,26
Fatherliam,emerald-dream,1299,priest,discipline,54,24,30
Agorasii,frostwolf,1298,priest,discipline,42,22,20
Voidvania,drakthul,1298,priest,discipline,35,18,17
Arenarooky,eredar,1297,priest,discipline,36,21,15
Sadkitten,sylvanas,1296,priest,discipline,162,89,73
Шкуропльот,gordunni,1296,priest,discipline,88,46,42
Jerichó,blackmoore,1294,priest,discipline,24,18,6
Vannax,arygos,1294,priest,discipline,72,32,40
Duaijhutari,outland,1293,priest,discipline,52,30,22
Oohopeoo,blackmoore,1293,priest,discipline,42,23,19
Lãwh,hyjal,1293,priest,discipline,66,35,31
Pl,sunstrider,1293,priest,discipline,42,22,20
Jerolol,sanguino,1293,priest,discipline,68,28,40
Kaktosz,ragnaros,1293,priest,discipline,54,21,33
Nikotyna,doomhammer,1292,priest,discipline,107,51,56
Onicolla,terokkar,1292,priest,discipline,126,60,66
Bandgap,antonidas,1292,priest,discipline,98,44,54
Ixdeadxl,stormscale,1291,priest,discipline,30,16,14
Mustatomi,stormreaver,1291,priest,discipline,27,14,13
Nukksch,antonidas,1291,priest,discipline,170,79,91
Chuwbakka,kazzak,1290,priest,discipline,34,22,12
Alfaböna,outland,1289,priest,discipline,122,66,56
Brainwash,darksorrow,1289,priest,discipline,53,18,35
Clua,draenor,1288,priest,discipline,54,28,26
Bomzhik,silvermoon,1287,priest,discipline,132,74,58
Tristar,nethersturm,1287,priest,discipline,35,19,16
Pregrip,twisting-nether,1284,priest,discipline,236,116,120
Darknun,aggra-português,1283,priest,discipline,35,14,21
Deneye,thunderhorn,1282,priest,discipline,42,28,14
Mynameisebe,twisting-nether,1282,priest,discipline,42,18,24
Jimmyhoffa,stormscale,1281,priest,discipline,54,32,22
Инстенли,howling-fjord,1281,priest,discipline,60,25,35
Superfelyn,ragnaros,1280,priest,discipline,51,27,24
Doncamïllo,blackrock,1280,priest,discipline,47,22,25
Olereo,blackhand,1280,priest,discipline,78,36,42
Gbpjr,xavius,1280,priest,discipline,145,63,82
Limerençe,ravencrest,1279,priest,discipline,20,14,6
Dnsxx,thrall,1279,priest,discipline,125,53,72
Valeriana,stormreaver,1278,priest,discipline,54,27,27
Тварьгосподя,gordunni,1278,priest,discipline,245,121,124
Kïmbo,kazzak,1278,priest,discipline,65,26,39
Wortgottes,blackrock,1277,priest,discipline,28,16,12
Asuriyan,grim-batol,1276,priest,discipline,69,34,35
Zenoo,argent-dawn,1275,priest,discipline,36,22,14
Hardloker,ravencrest,1275,priest,discipline,84,38,46
Aladorius,la-croisade-écarlate,1273,priest,discipline,46,25,21
Nuvie,ravencrest,1273,priest,discipline,60,28,32
Kelras,grim-batol,1272,priest,discipline,92,58,34
Empí,sanguino,1272,priest,discipline,36,18,18
Overshadowed,kazzak,1272,priest,discipline,175,80,95
Yante,ragnaros,1271,priest,discipline,36,18,18
Mishas,draenor,1270,priest,discipline,42,24,18
Zùt,ysondre,1269,priest,discipline,48,28,20
Outcast,korgall,1269,priest,discipline,60,30,30
Мегаствол,howling-fjord,1269,priest,discipline,60,28,32
Hidary,ysondre,1269,priest,discipline,37,16,21
Micobra,dalaran,1267,priest,discipline,24,14,10
Zofa,sunstrider,1266,priest,discipline,38,18,20
Пофанчику,gordunni,1266,priest,discipline,58,27,31
Aerosoll,drakthul,1265,priest,discipline,36,20,16
Hêsêkiêl,eredar,1265,priest,discipline,48,23,25
Валифа,gordunni,1263,priest,discipline,17,14,3
Акктуальная,deepholm,1263,priest,discipline,48,25,23
Sacerfull,sanguino,1263,priest,discipline,48,23,25
Щявыхилим,howling-fjord,1262,priest,discipline,31,20,11
Svartochelak,stormscale,1262,priest,discipline,42,16,26
Sílvana,nordrassil,1261,priest,discipline,112,57,55
Аквариусс,gordunni,1260,priest,discipline,60,30,30
Søînx,archimonde,1259,priest,discipline,27,17,10
Liasanya,kelthuzad,1259,priest,discipline,30,18,12
Euphorius,blackmoore,1259,priest,discipline,36,17,19
Alexnator,malganis,1258,priest,discipline,54,22,32
Vès,stormscale,1257,priest,discipline,66,35,31
Añgêl,ravencrest,1257,priest,discipline,117,60,57
Mirelaw,stormscale,1257,priest,discipline,71,36,35
Jordí,darkspear,1257,priest,discipline,191,88,103
Pleistras,magtheridon,1256,priest,discipline,149,85,64
Brach,nazjatar,1255,priest,discipline,49,26,23
Holybunny,blackrock,1255,priest,discipline,66,34,32
Kizzorde,ragnaros,1253,priest,discipline,48,28,20
Netomv,kazzak,1252,priest,discipline,30,17,13
Torcena,garrosh,1252,priest,discipline,48,16,32
Nëophytë,zuljin,1251,priest,discipline,54,28,26
Даркфолс,soulflayer,1251,priest,discipline,59,30,29
Fkup,twisting-nether,1250,priest,discipline,30,15,15
Jeuwls,argent-dawn,1249,priest,discipline,103,57,46
Seum,ravencrest,1249,priest,discipline,62,34,28
Buan,outland,1248,priest,discipline,18,13,5
Suprenext,draenor,1248,priest,discipline,24,13,11
Антошашвп,azuregos,1248,priest,discipline,24,13,11
Mazikeen,stormscale,1248,priest,discipline,24,13,11
Удзумукец,howling-fjord,1248,priest,discipline,90,36,54
Stmichael,silvermoon,1248,priest,discipline,38,15,23
Dêmôn,stormscale,1247,priest,discipline,18,13,5
Zathada,twisting-nether,1247,priest,discipline,30,19,11
Swdömmel,aegwynn,1247,priest,discipline,24,13,11
Feedergodx,dun-modr,1247,priest,discipline,24,13,11
Krokkete,hyjal,1247,priest,discipline,24,13,11
Xieen,outland,1247,priest,discipline,114,53,61
Cheja,ravencrest,1247,priest,discipline,48,21,27
Mgx,defias-brotherhood,1247,priest,discipline,30,13,17
Sùzy,ravencrest,1247,priest,discipline,36,13,23
Maylà,aegwynn,1247,priest,discipline,60,20,40
Mirupriest,sanguino,1246,priest,discipline,24,13,11
Ishkà,stormscale,1246,priest,discipline,24,13,11
Deliâz,aegwynn,1246,priest,discipline,36,14,22
Леддигага,gordunni,1245,priest,discipline,24,13,11
Hotdog,kult-der-verdammten,1244,priest,discipline,30,17,13
Kuraimb,the-maelstrom,1244,priest,discipline,27,14,13
Jumby,outland,1244,priest,discipline,30,13,17
Шадоухоррор,gordunni,1244,priest,discipline,51,20,31
Takeoff,dun-morogh,1243,priest,discipline,36,23,13
Vokuheala,tarren-mill,1243,priest,discipline,29,16,13
Rngamer,silvermoon,1242,priest,discipline,18,13,5
Chîllipriest,draenor,1242,priest,discipline,24,13,11
Gumer,antonidas,1242,priest,discipline,24,13,11
Shadowpeste,aggra-português,1240,priest,discipline,83,50,33
Shdwxy,blackrock,1240,priest,discipline,24,13,11
Danucd,ragnaros,1240,priest,discipline,118,62,56
Алуан,blackscar,1240,priest,discipline,42,13,29
Spoc,blackrock,1239,priest,discipline,41,23,18
Møldark,silvermoon,1238,priest,discipline,72,27,45
Binder,tarren-mill,1238,priest,discipline,36,13,23
Héntai,argent-dawn,1236,priest,discipline,30,15,15
Jbte,silvermoon,1235,priest,discipline,102,57,45
Speltmor,stormscale,1235,priest,discipline,24,13,11
Miralou,ravencrest,1235,priest,discipline,192,103,89
Discovery,aggra-português,1235,priest,discipline,54,28,26
Трезида,gordunni,1234,priest,discipline,24,13,11
Holyswift,dun-morogh,1234,priest,discipline,173,91,82
Héternel,ysondre,1234,priest,discipline,56,27,29
Divaz,eredar,1234,priest,discipline,48,18,30
Liliashet,sanguino,1233,priest,discipline,32,19,13
Wandéline,arathi,1233,priest,discipline,53,23,30
Janinw,sylvanas,1232,priest,discipline,30,13,17
Samtig,malganis,1232,priest,discipline,57,23,34
Umbraya,blackhand,1232,priest,discipline,66,21,45
Lucianßk,sanguino,1230,priest,discipline,48,27,21
Cntrl,frostmane,1229,priest,discipline,60,30,30
Пенансиня,gordunni,1229,priest,discipline,36,13,23
Praystatîon,dragonblight,1228,priest,discipline,95,60,35
Pètunia,ravencrest,1228,priest,discipline,145,75,70
Топчикс,gordunni,1228,priest,discipline,94,46,48
Avázàr,stormscale,1228,priest,discipline,30,13,17
Ggsus,outland,1228,priest,discipline,66,25,41
Hetha,tarren-mill,1227,priest,discipline,62,41,21
Drsmort,blackrock,1227,priest,discipline,60,31,29
Myrmeen,silvermoon,1227,priest,discipline,85,43,42
Ùçù,dalaran,1227,priest,discipline,46,21,25
Aeo,twisting-nether,1226,priest,discipline,65,31,34
Disconsick,vashj,1226,priest,discipline,52,15,37
Türapea,draenor,1225,priest,discipline,94,48,46
Duem,kazzak,1225,priest,discipline,54,27,27
Rightx,outland,1225,priest,discipline,78,36,42
Triksas,sylvanas,1224,priest,discipline,36,26,10
Baglet,ravencrest,1224,priest,discipline,24,13,11
Drnoob,tarren-mill,1224,priest,discipline,47,25,22
Healyourmum,stormscale,1224,priest,discipline,72,36,36
Xubeqi,kazzak,1224,priest,discipline,30,14,16
Therezzer,burning-legion,1224,priest,discipline,36,16,20
Lalola,tarren-mill,1223,priest,discipline,36,20,16
Nobbisnice,drakthul,1223,priest,discipline,52,28,24
Gobie,sunstrider,1223,priest,discipline,30,13,17
Mediumheals,tarren-mill,1221,priest,discipline,87,41,46
Blagovesta,ravencrest,1221,priest,discipline,36,13,23
Amphôra,archimonde,1220,priest,discipline,30,14,16
Zranda,magtheridon,1220,priest,discipline,42,19,23
Drennaria,draenor,1219,priest,discipline,23,13,10
Howaya,la-croisade-écarlate,1219,priest,discipline,48,25,23
Nestélle,drakthul,1219,priest,discipline,72,33,39
Xghazo,sylvanas,1218,priest,discipline,45,25,20
Лолиэль,soulflayer,1218,priest,discipline,57,31,26
Talonjean,conseil-des-ombres,1218,priest,discipline,24,13,11
Reìdood,stormscale,1217,priest,discipline,24,14,10
Ginebra,archimonde,1217,priest,discipline,24,14,10
Bellanote,dalaran,1217,priest,discipline,65,33,32
Unleet,sylvanas,1217,priest,discipline,62,30,32
Attenna,ravencrest,1217,priest,discipline,81,34,47
Nìak,ysondre,1217,priest,discipline,100,39,61
Капляболи,gordunni,1216,priest,discipline,51,28,23
Øwlsoo,confrérie-du-thorium,1215,priest,discipline,118,60,58
Diçkhëad,ravencrest,1215,priest,discipline,61,31,30
Feydottir,draenor,1214,priest,discipline,36,19,17
Nymrasus,ravencrest,1213,priest,discipline,24,13,11
Sandaal,drakthul,1213,priest,discipline,72,36,36
Йуп,ashenvale,1212,priest,discipline,22,14,8
Elderiel,turalyon,1212,priest,discipline,66,29,37
Ðøð,dalaran,1210,priest,discipline,54,33,21
Vempress,neptulon,1210,priest,discipline,48,24,24
Riptile,outland,1210,priest,discipline,28,13,15
Свапмиплиз,gordunni,1209,priest,discipline,106,51,55
Gertie,blackhand,1208,priest,discipline,46,29,17
Freezydot,silvermoon,1207,priest,discipline,63,37,26
Goldenapples,ravencrest,1207,priest,discipline,24,13,11
Eník,blackrock,1206,priest,discipline,36,15,21
Thyrandis,dragonblight,1206,priest,discipline,34,14,20
Nostramo,kirin-tor,1206,priest,discipline,54,19,35
Selenar,neptulon,1205,priest,discipline,36,19,17
Nethenielle,malganis,1205,priest,discipline,42,20,22
Linara,frostmane,1204,priest,discipline,18,13,5
Littleabs,the-maelstrom,1204,priest,discipline,71,35,36
Dezriah,tarren-mill,1203,priest,discipline,34,23,11
Simbaba,archimonde,1203,priest,discipline,36,19,17
Filtro,eredar,1203,priest,discipline,30,14,16
Werita,frostmane,1203,priest,discipline,122,54,68
Свежага,howling-fjord,1203,priest,discipline,76,33,43
Beaglep,blackrock,1203,priest,discipline,53,13,40
Janclod,pozzo-delleternità,1202,priest,discipline,24,14,10
Bekareth,archimonde,1201,priest,discipline,48,26,22
Soupana,darksorrow,1201,priest,discipline,55,28,27
Dementzia,argent-dawn,1200,priest,discipline,89,43,46
Drtickomaru,drakthul,1197,priest,discipline,32,16,16
Glärë,burning-legion,1196,priest,discipline,45,28,17
Wynkx,zuljin,1196,priest,discipline,66,24,42
Дюрэкс,soulflayer,1195,priest,discipline,24,13,11
Pvpriestess,silvermoon,1193,priest,discipline,42,19,23
Seneth,twisting-nether,1192,priest,discipline,30,13,17
Дайбчик,gordunni,1191,priest,discipline,28,15,13
Дракулесса,gordunni,1191,priest,discipline,51,24,27
Uro,tirion,1190,priest,discipline,41,14,27
Whitepitch,doomhammer,1189,priest,discipline,77,34,43
Megalodön,draenor,1187,priest,discipline,45,17,28
Lillthya,kazzak,1186,priest,discipline,58,24,34
Kiieevv,blackrock,1186,priest,discipline,48,17,31
Verrottênd,frostwolf,1185,priest,discipline,64,27,37
Happyprocs,dun-modr,1184,priest,discipline,23,13,10
Lighter,dragonblight,1183,priest,discipline,58,35,23
Аэрэта,deathguard,1181,priest,discipline,24,15,9
Shnookfour,agamaggan,1181,priest,discipline,34,19,15
Valnaya,draenor,1179,priest,discipline,61,34,27
Nnaoy,ysondre,1177,priest,discipline,26,13,13
Yojoyo,draenor,1177,priest,discipline,108,48,60
Snoopqt,dalaran,1177,priest,discipline,43,14,29
Фрит,lich-king,1174,priest,discipline,51,27,24
Loetharion,archimonde,1174,priest,discipline,71,36,35
Rashyd,sylvanas,1173,priest,discipline,36,21,15
Володябигуди,howling-fjord,1172,priest,discipline,29,13,16
Парикнахер,soulflayer,1171,priest,discipline,36,23,13
Dinma,argent-dawn,1171,priest,discipline,103,52,51
Captn,draenor,1171,priest,discipline,54,22,32
Dartheon,twisting-nether,1171,priest,discipline,58,19,39
Drioz,ysondre,1170,priest,discipline,72,40,32
Cøøbrà,hyjal,1170,priest,discipline,70,38,32
Lekadolplusc,doomhammer,1170,priest,discipline,142,75,67
Petshopboi,sylvanas,1170,priest,discipline,27,14,13
Palitox,kazzak,1170,priest,discipline,30,14,16
Ноубадди,howling-fjord,1169,priest,discipline,67,32,35
Genthus,kazzak,1169,priest,discipline,36,14,22
Chocopríest,blackmoore,1168,priest,discipline,30,13,17
Perimortal,norgannon,1166,priest,discipline,30,14,16
Elclasico,blackrock,1165,priest,discipline,56,22,34
Flyingdutch,tarren-mill,1164,priest,discipline,247,115,132
Olîra,hyjal,1163,priest,discipline,30,14,16
Soehzz,khaz-modan,1163,priest,discipline,48,21,27
Desperion,ragnaros,1163,priest,discipline,73,31,42
Blàckângel,blackrock,1161,priest,discipline,312,156,156
Klaura,blackmoore,1161,priest,discipline,30,15,15
Qsandria,ravencrest,1160,priest,discipline,38,20,18
Монесса,howling-fjord,1159,priest,discipline,36,16,20
Javvi,sylvanas,1158,priest,discipline,78,44,34
Vebbysor,sylvanas,1158,priest,discipline,30,15,15
Veecna,the-maelstrom,1158,priest,discipline,60,27,33
Brunestùd,pozzo-delleternità,1157,priest,discipline,68,33,35
Jezlung,frostmane,1154,priest,discipline,48,26,22
Alaeddin,kazzak,1154,priest,discipline,290,132,158
Donpedrila,kazzak,1152,priest,discipline,24,12,12
Djros,magtheridon,1152,priest,discipline,24,12,12
Найтингеилл,gordunni,1152,priest,discipline,24,12,12
Djokui,uldum,1152,priest,discipline,30,12,18
Djrussia,tarren-mill,1152,priest,discipline,30,12,18
Raeratwo,archimonde,1151,priest,discipline,18,12,6
Саммерфинн,gordunni,1151,priest,discipline,24,12,12
Ксенонх,gordunni,1151,priest,discipline,24,12,12
Deadsloth,hyjal,1151,priest,discipline,24,12,12
Arythc,ahnqiraj,1151,priest,discipline,24,12,12
Shììnx,hyjal,1151,priest,discipline,30,12,18
Híppokrates,dethecus,1151,priest,discipline,37,13,24
Gødisc,blackrock,1150,priest,discipline,18,12,6
Bunnydisc,outland,1150,priest,discipline,24,12,12
Naomirussell,sylvanas,1150,priest,discipline,24,12,12
Marylin,senjin,1149,priest,discipline,30,13,17
Soloqbob,kazzak,1149,priest,discipline,30,12,18
Discmoo,kazzak,1148,priest,discipline,20,12,8
Faouzia,argent-dawn,1148,priest,discipline,30,12,18
Indicta,darksorrow,1147,priest,discipline,27,13,14
Тыкофка,gordunni,1147,priest,discipline,30,12,18
Deicidex,blackrock,1147,priest,discipline,36,12,24
Døgfîsh,stormscale,1146,priest,discipline,24,12,12
Johnnypleb,blackrock,1144,priest,discipline,114,58,56
Blacklemons,thrall,1144,priest,discipline,24,12,12
Loliheal,blackmoore,1144,priest,discipline,34,13,21
Mournus,defias-brotherhood,1142,priest,discipline,35,24,11
Manau,culte-de-la-rive-noire,1142,priest,discipline,30,12,18
Noskan,silvermoon,1141,priest,discipline,21,13,8
Karzin,aggra-português,1141,priest,discipline,66,32,34
Daesa,defias-brotherhood,1140,priest,discipline,24,14,10
Dotterin,draenor,1140,priest,discipline,24,12,12
Убивал,soulflayer,1140,priest,discipline,24,12,12
Healy,blackrock,1140,priest,discipline,36,13,23
Ebolaidman,ravencrest,1139,priest,discipline,18,12,6
Гундяй,soulflayer,1139,priest,discipline,28,16,12
Mädmän,draenor,1139,priest,discipline,72,38,34
Kaydenkross,eredar,1139,priest,discipline,42,12,30
Bacberon,skullcrusher,1138,priest,discipline,18,12,6
Quinax,shattered-hand,1138,priest,discipline,24,12,12
Boyraz,argent-dawn,1138,priest,discipline,48,21,27
Chankro,sanguino,1137,priest,discipline,24,12,12
Matiagmenh,stormscale,1137,priest,discipline,24,12,12
Drüdkh,tarren-mill,1137,priest,discipline,36,12,24
Canthms,twisting-nether,1136,priest,discipline,36,22,14
Keimohansio,twisting-nether,1136,priest,discipline,48,23,25
Seras,bloodfeather,1136,priest,discipline,102,46,56
Guerilagusto,draenor,1136,priest,discipline,30,12,18
Drissz,archimonde,1135,priest,discipline,24,12,12
Darkheall,sanguino,1135,priest,discipline,50,21,29
Angusbeêf,blackrock,1134,priest,discipline,60,32,28
Арабет,galakrond,1133,priest,discipline,73,40,33
Камшотхил,gordunni,1132,priest,discipline,36,18,18
Taiyöshin,silvermoon,1132,priest,discipline,30,12,18
Nazo,sylvanas,1129,priest,discipline,48,27,21
Gromalia,hyjal,1129,priest,discipline,24,12,12
Symeria,sylvanas,1129,priest,discipline,24,12,12
Balhlin,argent-dawn,1129,priest,discipline,24,12,12
Chega,malganis,1128,priest,discipline,78,30,48
Jeez,twilights-hammer,1127,priest,discipline,36,12,24
Frittê,anetheron,1124,priest,discipline,57,29,28
Calsote,sanguino,1124,priest,discipline,36,12,24
Spookyfive,blackhand,1123,priest,discipline,73,26,47
Kurtse,archimonde,1121,priest,discipline,28,14,14
Biblebabe,tarren-mill,1121,priest,discipline,24,12,12
Марджелла,howling-fjord,1119,priest,discipline,28,13,15
Iømÿnudir,archimonde,1119,priest,discipline,30,13,17
Limpopon,doomhammer,1119,priest,discipline,39,15,24
Necromania,cthun,1118,priest,discipline,49,21,28
Эски,howling-fjord,1118,priest,discipline,30,12,18
Thiela,ravencrest,1117,priest,discipline,20,13,7
Nyell,silvermoon,1115,priest,discipline,22,12,10
Bluxon,kazzak,1113,priest,discipline,22,12,10
Sphard,ysondre,1113,priest,discipline,36,12,24
Залупский,gordunni,1111,priest,discipline,24,12,12
Dotsin,kazzak,1111,priest,discipline,175,85,90
Milessa,steamwheedle-cartel,1111,priest,discipline,48,18,30
Fetuz,ravenholdt,1109,priest,discipline,48,20,28
Стаминабаф,gordunni,1108,priest,discipline,21,13,8
Sisdenna,doomhammer,1108,priest,discipline,152,77,75
Taili,ysondre,1107,priest,discipline,32,13,19
Ожившийприст,soulflayer,1106,priest,discipline,63,31,32
Deckardkain,pozzo-delleternità,1105,priest,discipline,60,33,27
Valente,twisting-nether,1105,priest,discipline,60,22,38
Джейнкелли,borean-tundra,1104,priest,discipline,80,49,31
Lydîâ,blackhand,1102,priest,discipline,23,12,11
Holyschidt,amanthul,1101,priest,discipline,40,17,23
Möd,ragnaros,1100,priest,discipline,30,13,17
Popegoat,ragnaros,1099,priest,discipline,29,23,6
Neytirinqt,doomhammer,1095,priest,discipline,36,15,21
Mjölkpelle,twisting-nether,1092,priest,discipline,18,14,4
Mønti,onyxia,1092,priest,discipline,33,17,16
Praywingsebb,nazjatar,1091,priest,discipline,24,13,11
Гуляль,howling-fjord,1090,priest,discipline,42,26,16
Pontifex,baelgun,1089,priest,discipline,24,14,10
Zerula,outland,1089,priest,discipline,101,47,54
Celero,silvermoon,1089,priest,discipline,36,15,21
Ticklebell,ravencrest,1088,priest,discipline,66,37,29
Çiione,archimonde,1086,priest,discipline,29,12,17
Plaguetale,archimonde,1085,priest,discipline,30,17,13
Prognosis,frostwhisper,1083,priest,discipline,36,17,19
Mambanero,nemesis,1082,priest,discipline,69,30,39
Nellytaa,dalaran,1080,priest,discipline,33,17,16
Waxosc,silvermoon,1080,priest,discipline,68,28,40
Mindcrackr,stormscale,1079,priest,discipline,18,13,5
Salskagripme,ragnaros,1079,priest,discipline,18,12,6
Deathspawn,hellscream,1079,priest,discipline,45,26,19
Гомотряс,howling-fjord,1079,priest,discipline,102,54,48
Rexxár,aszune,1079,priest,discipline,109,55,54
Goatz,ragnaros,1078,priest,discipline,18,14,4
Bálíé,blackmoore,1078,priest,discipline,72,35,37
Ghostroller,ravencrest,1075,priest,discipline,23,12,11
Ünholy,burning-legion,1071,priest,discipline,29,14,15
Enilion,draenor,1071,priest,discipline,32,13,19
Gudrinieks,shattered-halls,1070,priest,discipline,32,13,19
Discoprillan,twisting-nether,1069,priest,discipline,43,23,20
Lunairess,silvermoon,1069,priest,discipline,84,28,56
Deeforce,argent-dawn,1067,priest,discipline,74,29,45
Юкич,soulflayer,1065,priest,discipline,34,12,22
Prazefin,twisting-nether,1060,priest,discipline,22,13,9
Yânùx,aegwynn,1056,priest,discipline,12,11,1
Schwypsvnr,garona,1056,priest,discipline,18,11,7
Lmnsqzy,ravencrest,1056,priest,discipline,18,11,7
Ferpy,ragnaros,1056,priest,discipline,18,11,7
Jpucciù,ysondre,1056,priest,discipline,18,11,7
Bindww,tarren-mill,1056,priest,discipline,18,11,7
Prïstië,drakthul,1056,priest,discipline,54,26,28
Stormmyy,kazzak,1056,priest,discipline,24,11,13
Undeathy,ravencrest,1056,priest,discipline,24,11,13
Kaiikoo,ravencrest,1056,priest,discipline,24,11,13
Tazn,thrall,1056,priest,discipline,24,11,13
Carpathîan,blackhand,1056,priest,discipline,72,25,47
Céira,malganis,1055,priest,discipline,18,11,7
Батлджес,gordunni,1055,priest,discipline,18,11,7
Гоплзнекст,gordunni,1055,priest,discipline,18,11,7
Kenobai,kazzak,1055,priest,discipline,18,11,7
Pilgram,twilights-hammer,1055,priest,discipline,18,11,7
Dathanosp,outland,1055,priest,discipline,18,11,7
Manäka,hyjal,1055,priest,discipline,24,11,13
Qpapi,quelthalas,1055,priest,discipline,24,11,13
Eitukaeitai,outland,1055,priest,discipline,24,11,13
Pureàngel,ravencrest,1055,priest,discipline,24,11,13
Отклонен,soulflayer,1055,priest,discipline,24,11,13
Voidjutsu,draenor,1055,priest,discipline,74,30,44
Deshka,tarren-mill,1055,priest,discipline,30,11,19
Лэсивэснэс,soulflayer,1055,priest,discipline,36,11,25
Dubai,silvermoon,1055,priest,discipline,36,11,25
Piperxp,ravencrest,1054,priest,discipline,18,11,7
Jetlìfe,ysondre,1054,priest,discipline,18,11,7
Rylpriest,blackmoore,1054,priest,discipline,18,11,7
Leleg,blackhand,1054,priest,discipline,18,11,7
Metapri,blackhand,1054,priest,discipline,23,14,9
Faintly,emeriss,1054,priest,discipline,24,11,13
Anzee,tarren-mill,1054,priest,discipline,24,11,13
Arya,dunemaul,1054,priest,discipline,24,11,13
Hòllymèdx,blackmoore,1054,priest,discipline,24,11,13
Азмоддан,azuregos,1054,priest,discipline,36,11,25
Szycho,burning-legion,1054,priest,discipline,36,11,25
Cøvu,draenor,1053,priest,discipline,18,11,7
Zeatt,ysera,1053,priest,discipline,18,11,7
Towelie,stormscale,1053,priest,discipline,24,11,13
Arjak,stormscale,1053,priest,discipline,24,11,13
Aléhyl,la-croisade-écarlate,1053,priest,discipline,72,28,44
Drwho,zuljin,1053,priest,discipline,33,12,21
Jackyz,tarren-mill,1053,priest,discipline,36,11,25
Papynou,garona,1052,priest,discipline,18,11,7
Roshaltar,argent-dawn,1052,priest,discipline,42,25,17
Пристохилю,gordunni,1051,priest,discipline,24,14,10
Inaeries,argent-dawn,1051,priest,discipline,35,20,15
Nevermyndz,blackmoore,1051,priest,discipline,24,11,13
Fakéy,draenor,1050,priest,discipline,12,11,1
Sokratina,ragnaros,1050,priest,discipline,18,11,7
Cursedme,blackrock,1050,priest,discipline,18,11,7
Smokäy,blackhand,1050,priest,discipline,24,11,13
Junglepriest,ravencrest,1050,priest,discipline,24,11,13
Hunfall,stormscale,1050,priest,discipline,24,11,13
Baloopriest,grim-batol,1050,priest,discipline,30,11,19
Zatón,dun-modr,1050,priest,discipline,30,11,19
Villagegirlx,stormscale,1049,priest,discipline,18,11,7
Icyc,outland,1049,priest,discipline,42,11,31
Nøwénna,ravencrest,1049,priest,discipline,42,11,31
Grausami,zuluhed,1048,priest,discipline,18,11,7
Diskogoblin,drakthul,1048,priest,discipline,24,11,13
Sanril,ragnaros,1048,priest,discipline,24,11,13
Axewound,neptulon,1048,priest,discipline,25,11,14
Neseig,blutkessel,1047,priest,discipline,18,11,7
Blasfemo,nemesis,1047,priest,discipline,24,11,13
Ilostmybible,runetotem,1047,priest,discipline,28,12,16
Мерседулька,howling-fjord,1046,priest,discipline,22,12,10
Ichpvpeuch,eredar,1046,priest,discipline,24,11,13
Болътвоя,gordunni,1045,priest,discipline,18,11,7
Jeanpipe,khaz-modan,1044,priest,discipline,12,11,1
Eksel,silvermoon,1044,priest,discipline,24,11,13
Needmana,hyjal,1044,priest,discipline,36,15,21
Kaos,anetheron,1043,priest,discipline,15,13,2
Ørrak,hyjal,1043,priest,discipline,18,11,7
Ráka,earthen-ring,1043,priest,discipline,26,13,13
Эллвинг,howling-fjord,1042,priest,discipline,23,12,11
Apeist,outland,1042,priest,discipline,24,11,13
Rhésùs,archimonde,1041,priest,discipline,44,25,19
Dirim,silvermoon,1041,priest,discipline,24,11,13
Holyskull,magtheridon,1041,priest,discipline,124,51,73
Medycus,blackrock,1040,priest,discipline,18,11,7
Khato,rexxar,1040,priest,discipline,21,12,9
Tackerjoè,eredar,1040,priest,discipline,30,11,19
Ksiadzrydzyk,draenor,1039,priest,discipline,18,11,7
Thörbjorn,confrérie-du-thorium,1039,priest,discipline,24,12,12
Worstdisceu,draenor,1039,priest,discipline,24,11,13
Joebando,ravencrest,1038,priest,discipline,62,29,33
Fingerblast,sanguino,1037,priest,discipline,24,12,12
Juhduss,tarren-mill,1036,priest,discipline,18,11,7
Давалкасвета,gordunni,1036,priest,discipline,32,13,19
Sytrix,frostwolf,1034,priest,discipline,18,11,7
Trimégiste,hyjal,1033,priest,discipline,112,57,55
Whitemané,argent-dawn,1033,priest,discipline,50,25,25
Pandalulz,turalyon,1031,priest,discipline,22,14,8
Hónòr,sylvanas,1031,priest,discipline,41,11,30
Devîlcry,nordrassil,1030,priest,discipline,36,18,18
Pasalacabra,zuljin,1030,priest,discipline,24,11,13
Îndura,drakthul,1029,priest,discipline,70,33,37
Nupzie,stormscale,1029,priest,discipline,39,15,24
Rydzyk,laughing-skull,1028,priest,discipline,24,13,11
Nelvor,silvermoon,1027,priest,discipline,24,11,13
Leønix,malfurion,1025,priest,discipline,21,12,9
Bakris,twisting-nether,1024,priest,discipline,24,11,13
Noserenity,outland,1023,priest,discipline,17,11,6
Tmnewho,outland,1022,priest,discipline,22,12,10
Stigy,auchindoun,1022,priest,discipline,24,11,13
Tori,marécage-de-zangar,1021,priest,discipline,20,12,8
Sòsò,archimonde,1018,priest,discipline,60,25,35
Grgovan,kazzak,1017,priest,discipline,15,12,3
Xanndro,argent-dawn,1014,priest,discipline,34,13,21
Gronni,argent-dawn,1012,priest,discipline,30,15,15
Ghorfindel,kaelthas,1012,priest,discipline,23,11,12
Mocnymaco,burning-blade,1009,priest,discipline,121,61,60
Morrydin,stormreaver,1009,priest,discipline,22,11,11
Yøzø,blackhand,1009,priest,discipline,63,27,36
Hinkelstein,defias-brotherhood,1008,priest,discipline,32,18,14
Zurlyne,ravencrest,1007,priest,discipline,21,12,9
Discoruzki,ravencrest,1007,priest,discipline,23,11,12
Howlscastie,stormscale,1007,priest,discipline,54,22,32
Телоури,galakrond,1004,priest,discipline,27,12,15
Boomhilde,aegwynn,1003,priest,discipline,182,89,93
Kallsen,ravencrest,1002,priest,discipline,45,28,17
Шадия,ashenvale,1002,priest,discipline,20,12,8
Sixeus,outland,1002,priest,discipline,26,12,14
Steadyog,doomhammer,1000,priest,discipline,24,16,8
Mijuuk,zuljin,1000,priest,discipline,36,23,13
Buzzard,frostmourne,1000,priest,discipline,24,15,9
Rrpriest,silvermoon,998,priest,discipline,68,23,45
Вальдемарс,howling-fjord,996,priest,discipline,29,11,18
Kenderke,ragnaros,994,priest,discipline,23,11,12
Negativeapm,archimonde,991,priest,discipline,17,11,6
Therealopa,blackmoore,991,priest,discipline,98,45,53
Burnesenbois,chogall,991,priest,discipline,29,11,18
Healheal,outland,986,priest,discipline,42,18,24
Killerkende,ragnaros,984,priest,discipline,22,11,11
Huzlin,kazzak,983,priest,discipline,28,11,17
Lichtelaaie,quelthalas,980,priest,discipline,24,15,9
Kyrédan,dalaran,979,priest,discipline,94,48,46
Satanspawn,neptulon,977,priest,discipline,64,23,41
Эннхэтэуэй,soulflayer,972,priest,discipline,19,11,8
Borrex,sanguino,971,priest,discipline,13,11,2
Shalacho,blackrock,970,priest,discipline,52,23,29
Эрьеро,gordunni,970,priest,discipline,36,11,25
Васпохилить,howling-fjord,969,priest,discipline,32,15,17
Paradigma,outland,964,priest,discipline,35,19,16
Äwësömë,aggra-português,962,priest,discipline,24,12,12
Presbyter,mazrigos,961,priest,discipline,21,11,10
Didinini,outland,961,priest,discipline,46,24,22
Доминантрикс,soulflayer,961,priest,discipline,25,11,14
Níghty,ravencrest,960,priest,discipline,12,10,2
Hopeso,silvermoon,960,priest,discipline,12,10,2
Ghettonelf,sylvanas,960,priest,discipline,12,10,2
Piccolamorte,ysondre,960,priest,discipline,12,10,2
Lanat,ravencrest,960,priest,discipline,12,10,2
Ринкуку,howling-fjord,960,priest,discipline,18,10,8
Sadsadsad,ravencrest,960,priest,discipline,18,10,8
Lexojam,ravencrest,960,priest,discipline,18,10,8
Iloveilka,madmortem,960,priest,discipline,18,10,8
Theythem,stormscale,960,priest,discipline,18,10,8
Asýnc,ravencrest,960,priest,discipline,18,10,8
Пухлаясвинка,fordragon,960,priest,discipline,18,10,8
Фотосз,soulflayer,960,priest,discipline,18,10,8
Teradros,blackhand,960,priest,discipline,18,10,8
Wyrofear,ragnaros,960,priest,discipline,18,10,8
Deathblind,blackmoore,960,priest,discipline,24,10,14
Prêtresacré,archimonde,960,priest,discipline,24,10,14
Undeadpriest,aegwynn,960,priest,discipline,24,10,14
Rmpriest,blackhand,960,priest,discipline,24,10,14
Casic,blackhand,959,priest,discipline,12,10,2
Ðaala,blackrock,959,priest,discipline,18,10,8
Рыжаякискис,soulflayer,959,priest,discipline,18,10,8
Waffur,twisting-nether,959,priest,discipline,18,10,8
Healbotmvp,ravencrest,959,priest,discipline,18,10,8
Yaoz,sanguino,959,priest,discipline,18,10,8
Animalrescue,draenor,959,priest,discipline,18,10,8
Lèss,ysondre,959,priest,discipline,18,10,8
Joeasaurs,ragnaros,959,priest,discipline,21,11,10
Eyesønyou,nemesis,959,priest,discipline,21,11,10
Aurorä,burning-legion,959,priest,discipline,24,10,14
Phyxiusx,stormscale,959,priest,discipline,24,10,14
Raw,dragonblight,959,priest,discipline,24,10,14
Skarnir,uldaman,959,priest,discipline,27,11,16
Chabih,ravencrest,959,priest,discipline,30,10,20
Ykiotonegawa,twisting-nether,959,priest,discipline,30,10,20
Zarez,stormscale,959,priest,discipline,38,12,26
Mêduse,ravencrest,959,priest,discipline,39,11,28
Sadgelands,outland,958,priest,discipline,18,10,8
Gingerflexay,archimonde,958,priest,discipline,18,10,8
Elinaa,die-aldor,958,priest,discipline,18,10,8
Ezcobar,twilights-hammer,958,priest,discipline,18,10,8
Vo,dentarg,958,priest,discipline,18,10,8
Goldgot,tarren-mill,958,priest,discipline,18,10,8
Radiancekey,sanguino,958,priest,discipline,24,10,14
Ømñyx,outland,958,priest,discipline,24,10,14
Faíht,blackrock,958,priest,discipline,24,10,14
Träskfarfar,tarren-mill,958,priest,discipline,24,10,14
Sws,throkferoth,957,priest,discipline,12,10,2
Anyndra,twisting-nether,957,priest,discipline,18,10,8
Huhu,defias-brotherhood,957,priest,discipline,18,10,8
Вейтарен,gordunni,957,priest,discipline,30,10,20
Cidrea,saurfang,956,priest,discipline,18,10,8
Nastynina,frostwhisper,956,priest,discipline,24,10,14
Chukwundi,ravencrest,956,priest,discipline,78,28,50
Vadhänder,the-maelstrom,955,priest,discipline,24,10,14
Velosp,defias-brotherhood,955,priest,discipline,24,10,14
Zyrexan,defias-brotherhood,955,priest,discipline,30,10,20
Texstil,blackmoore,954,priest,discipline,18,10,8
Hempukka,spinebreaker,954,priest,discipline,24,10,14
Suchetto,kazzak,954,priest,discipline,24,10,14
Ministry,tirion,954,priest,discipline,24,10,14
Chilltcaster,blackrock,954,priest,discipline,26,10,16
Relöaded,kazzak,954,priest,discipline,30,10,20
Юбич,soulflayer,953,priest,discipline,18,10,8
Várósh,blackmoore,953,priest,discipline,24,10,14
Matsipri,sylvanas,951,priest,discipline,24,10,14
Фионыч,blackscar,951,priest,discipline,24,10,14
Boniesmack,stormscale,951,priest,discipline,24,10,14
Nasirjones,outland,950,priest,discipline,18,10,8
Chukapi,stormscale,950,priest,discipline,18,10,8
Mallkie,ysondre,947,priest,discipline,18,10,8
Priincess,ragnaros,947,priest,discipline,22,12,10
Perxonx,twisting-nether,946,priest,discipline,12,10,2
Pínx,nerathor,946,priest,discipline,24,10,14
Vecaya,blackrock,945,priest,discipline,18,10,8
Залик,soulflayer,945,priest,discipline,24,10,14
Заплетальщик,howling-fjord,942,priest,discipline,40,20,20
Togx,silvermoon,942,priest,discipline,24,10,14
Søb,silvermoon,942,priest,discipline,29,10,19
Mewdewrewrx,arathor,941,priest,discipline,18,10,8
Vepa,blackrock,941,priest,discipline,40,19,21
Perlo,sanguino,940,priest,discipline,89,47,42
Deppara,twisting-nether,939,priest,discipline,18,10,8
Moinmeister,frostmourne,939,priest,discipline,29,15,14
Khai,tarren-mill,935,priest,discipline,65,27,38
Eleveno,ravencrest,934,priest,discipline,54,26,28
Sednâ,conseil-des-ombres,931,priest,discipline,23,10,13
Педаньтяйка,gordunni,930,priest,discipline,42,24,18
Лайбаси,howling-fjord,927,priest,discipline,24,11,13
Góldfinger,norgannon,926,priest,discipline,23,10,13
Pavyone,twisting-nether,926,priest,discipline,23,10,13
Ranevskiy,kazzak,925,priest,discipline,31,11,20
Aliasus,archimonde,924,priest,discipline,17,10,7
Meodor,antonidas,923,priest,discipline,24,14,10
Felbs,defias-brotherhood,923,priest,discipline,63,21,42
Morgoh,die-arguswacht,917,priest,discipline,90,42,48
Pulttipiispa,ravencrest,916,priest,discipline,23,10,13
Elba,defias-brotherhood,916,priest,discipline,24,10,14
Kashmirweed,ravencrest,916,priest,discipline,48,17,31
Nunnis,kazzak,912,priest,discipline,150,76,74
Аргла,soulflayer,912,priest,discipline,66,24,42
Vicwix,draenor,910,priest,discipline,17,10,7
Anethron,ragnaros,910,priest,discipline,42,16,26
Zthul,draenor,909,priest,discipline,27,11,16
Titibolls,sanguino,908,priest,discipline,23,10,13
Immórtal,tarren-mill,908,priest,discipline,30,10,20
Ebashuvkashu,stormscale,906,priest,discipline,23,10,13
Mércíless,ravencrest,905,priest,discipline,17,10,7
Priezeke,aggramar,905,priest,discipline,24,13,11
Theunknown,stormscale,903,priest,discipline,29,11,18
Absinthamos,eredar,895,priest,discipline,16,10,6
Koderpl,burning-legion,894,priest,discipline,31,16,15
Aliciakeys,twilights-hammer,892,priest,discipline,28,10,18
Nosgot,earthen-ring,889,priest,discipline,30,14,16
Blååb,draenor,879,priest,discipline,19,10,9
Chillx,blackmoore,878,priest,discipline,85,45,40
Teyranamin,defias-brotherhood,875,priest,discipline,19,10,9
Bromine,twisting-nether,872,priest,discipline,17,12,5
Cleancf,blackhand,872,priest,discipline,191,84,107
Amaretta,perenolde,872,priest,discipline,32,13,19
Borgír,burning-legion,871,priest,discipline,27,11,16
Toks,stormscale,871,priest,discipline,45,10,35
Elfiontko,burning-legion,870,priest,discipline,24,11,13
Smitey,terenas,867,priest,discipline,22,10,12
Ohiofromntty,ravencrest,864,priest,discipline,12,9,3
Pohja,veknilash,864,priest,discipline,12,9,3
Slovak,stormscale,864,priest,discipline,12,9,3
Monflouz,archimonde,864,priest,discipline,12,9,3
Cyúxyúvteea,ravencrest,864,priest,discipline,12,9,3
Lidlpriest,frostwolf,864,priest,discipline,12,9,3
Priéstitude,kazzak,864,priest,discipline,12,9,3
Kekkonh,sylvanas,864,priest,discipline,12,9,3
Sørcedote,dun-modr,864,priest,discipline,18,9,9
Закс,blackscar,864,priest,discipline,18,9,9
Жентельмен,deathguard,864,priest,discipline,18,9,9
Lâñàt,ravencrest,864,priest,discipline,18,9,9
Heavensfire,twisting-nether,864,priest,discipline,18,9,9
Størmblaze,stormreaver,864,priest,discipline,18,9,9
Yroe,gorgonnash,864,priest,discipline,18,9,9
Dexlolo,stormscale,864,priest,discipline,18,9,9
Heab,aegwynn,864,priest,discipline,18,9,9
Lexìì,archimonde,864,priest,discipline,18,9,9
Prästpåven,stormscale,864,priest,discipline,18,9,9
Svetozarov,wildhammer,864,priest,discipline,18,9,9
Muant,twisting-nether,864,priest,discipline,18,9,9
Cctw,archimonde,864,priest,discipline,18,9,9
Падлез,howling-fjord,864,priest,discipline,24,9,15
Próxs,ravencrest,864,priest,discipline,24,9,15
Víd,dun-morogh,864,priest,discipline,24,9,15
Supemi,stormscale,864,priest,discipline,24,9,15
Smitebone,tarren-mill,864,priest,discipline,24,9,15
Frígídhealz,outland,864,priest,discipline,24,9,15
Itsdiscobaby,auchindoun,864,priest,discipline,24,9,15
Chocomiette,archimonde,864,priest,discipline,25,9,16
Devastris,ravencrest,864,priest,discipline,30,9,21
Simza,azuremyst,863,priest,discipline,12,9,3
Фрустрациия,soulflayer,863,priest,discipline,22,12,10
Markianos,silvermoon,863,priest,discipline,18,9,9
Sacreth,ragnaros,863,priest,discipline,18,9,9
Giily,archimonde,863,priest,discipline,18,9,9
Ratingfeeder,tarren-mill,863,priest,discipline,18,9,9
Дакимакурах,gordunni,863,priest,discipline,18,9,9
Juliane,trollbane,863,priest,discipline,18,9,9
Øk,draenor,863,priest,discipline,18,9,9
Fabuliciøus,blackrock,863,priest,discipline,18,9,9
Psi,hakkar,863,priest,discipline,18,9,9
Mïxa,eitrigg,863,priest,discipline,18,9,9
Naberus,ragnaros,863,priest,discipline,19,9,10
Senza,ysondre,863,priest,discipline,24,9,15
Xyliqa,aegwynn,863,priest,discipline,24,9,15
Rixis,la-croisade-écarlate,863,priest,discipline,24,9,15
Sctheal,outland,863,priest,discipline,24,9,15
Bornxgood,kazzak,863,priest,discipline,24,9,15
Intentoso,nemesis,863,priest,discipline,24,9,15
Skinandbones,sylvanas,863,priest,discipline,30,9,21
Søkariss,elune,862,priest,discipline,12,9,3
Jána,argent-dawn,862,priest,discipline,12,9,3
Gnomeeater,silvermoon,862,priest,discipline,12,9,3
Joeshmoex,blackrock,862,priest,discipline,12,9,3
Vandansk,kazzak,862,priest,discipline,12,9,3
Rawelf,ravencrest,862,priest,discipline,12,9,3
Jaesabøyx,twisting-nether,862,priest,discipline,18,9,9
Sandcastles,ravencrest,862,priest,discipline,18,9,9
Бахчи,thermaplugg,862,priest,discipline,18,9,9
Widöw,cthun,862,priest,discipline,18,9,9
Carlye,stormreaver,862,priest,discipline,18,9,9
Hiimpinxî,ragnaros,862,priest,discipline,18,9,9
Skyalpha,silvermoon,862,priest,discipline,18,9,9
Сегуната,howling-fjord,862,priest,discipline,24,9,15
Vædan,drakthul,861,priest,discipline,12,9,3
Durmadanbas,ravencrest,861,priest,discipline,24,9,15
Manuba,antonidas,860,priest,discipline,18,9,9
Nhajÿ,hyjal,859,priest,discipline,24,9,15
ßlowska,hyjal,859,priest,discipline,24,9,15
Shadoomed,kazzak,859,priest,discipline,24,9,15
Réborn,tarren-mill,858,priest,discipline,12,9,3
Priestige,spinebreaker,858,priest,discipline,18,9,9
Dorisdiesel,ravencrest,858,priest,discipline,24,9,15
Dotmaker,sanguino,858,priest,discipline,24,9,15
Omnissiiah,silvermoon,858,priest,discipline,30,9,21
Fatalyse,ysondre,857,priest,discipline,36,16,20
Slyntan,ragnaros,856,priest,discipline,18,9,9
Pénancé,defias-brotherhood,856,priest,discipline,24,9,15
Calenberhtil,burning-legion,855,priest,discipline,18,9,9
Lunarg,die-ewige-wacht,855,priest,discipline,18,9,9
Nilsatis,grim-batol,855,priest,discipline,59,25,34
Cahuña,thrall,854,priest,discipline,24,10,14
Rhåenyra,ravencrest,851,priest,discipline,18,9,9
Saskiaa,doomhammer,851,priest,discipline,48,21,27
Jagersmite,twisting-nether,851,priest,discipline,24,9,15
Reighl,drakthul,850,priest,discipline,18,9,9
Drynte,blackmoore,847,priest,discipline,23,9,14
Babbúb,tarren-mill,847,priest,discipline,23,9,14
Clergy,nagrand,842,priest,discipline,18,9,9
Seiigops,ysondre,839,priest,discipline,12,9,3
Evastemplar,turalyon,836,priest,discipline,24,9,15
Socratés,antonidas,834,priest,discipline,66,27,39
Valinoru,silvermoon,831,priest,discipline,17,9,8
Spooka,ravencrest,831,priest,discipline,17,9,8
Mílérí,ravencrest,830,priest,discipline,23,9,14
Тэслос,howling-fjord,829,priest,discipline,23,9,14
Illüminaty,sylvanas,828,priest,discipline,26,10,16
Waikiki,ambossar,827,priest,discipline,16,10,6
Nioubèy,archimonde,825,priest,discipline,17,9,8
Ladá,stormscale,815,priest,discipline,19,9,10
Squidlicker,twisting-nether,814,priest,discipline,17,9,8
Lyim,stormscale,814,priest,discipline,17,9,8
Bolíngbroke,argent-dawn,809,priest,discipline,35,9,26
Solaní,antonidas,808,priest,discipline,26,11,15
Rhanira,aegwynn,800,priest,discipline,17,9,8
Pillian,nordrassil,799,priest,discipline,16,9,7
Obito,outland,799,priest,discipline,17,9,8
Iloa,dun-morogh,799,priest,discipline,17,9,8
Pescá,cthun,798,priest,discipline,14,10,4
Lacrum,ragnaros,790,priest,discipline,20,10,10
Gandzaa,silvermoon,785,priest,discipline,21,9,12
Протомуу,gordunni,783,priest,discipline,11,9,2
Homxcxde,ravencrest,777,priest,discipline,26,10,16
Enaches,twisting-nether,773,priest,discipline,19,9,10
Apóllyon,antonidas,769,priest,discipline,22,9,13
Ewamlf,drakthul,768,priest,discipline,12,8,4
Oldnbad,archimonde,768,priest,discipline,12,8,4
Killafoolx,silvermoon,768,priest,discipline,12,8,4
Tobadforglad,khaz-modan,768,priest,discipline,12,8,4
Gobblestick,draenor,768,priest,discipline,12,8,4
Dimsim,kazzak,768,priest,discipline,12,8,4
Ltr,tarren-mill,768,priest,discipline,12,8,4
Anabølix,ravencrest,768,priest,discipline,12,8,4
Iyannà,blackrock,768,priest,discipline,12,8,4
Tinypump,silvermoon,768,priest,discipline,12,8,4
Makkesfil,stormscale,768,priest,discipline,12,8,4
Absôlutvôdka,twisting-nether,768,priest,discipline,12,8,4
Indrades,blackmoore,768,priest,discipline,12,8,4
Dezless,tarren-mill,768,priest,discipline,12,8,4
Orkanwal,ravencrest,768,priest,discipline,12,8,4
Nitroze,stormscale,768,priest,discipline,12,8,4
Mewdi,outland,768,priest,discipline,12,8,4
Joeblowx,blackrock,768,priest,discipline,12,8,4
Blessedmix,korgall,768,priest,discipline,12,8,4
Soylaleche,ravencrest,768,priest,discipline,12,8,4
Xandrial,blackmoore,768,priest,discipline,12,8,4
Makrophage,mannoroth,768,priest,discipline,12,8,4
Omgitshuux,blackmoore,768,priest,discipline,12,8,4
Shieldyman,silvermoon,768,priest,discipline,18,8,10
Foh,antonidas,768,priest,discipline,18,8,10
Floorpovx,blackmoore,768,priest,discipline,18,8,10
Aelíth,archimonde,768,priest,discipline,18,8,10
Kristianburn,arathi,768,priest,discipline,18,8,10
Alexwinkwink,kazzak,768,priest,discipline,18,8,10
Fainttnt,stormscale,768,priest,discipline,18,8,10
Ssjx,ravencrest,768,priest,discipline,18,8,10
Karmev,twisting-nether,768,priest,discipline,18,8,10
Pikaboom,the-maelstrom,768,priest,discipline,18,8,10
Moyoo,kazzak,768,priest,discipline,18,8,10
Azpr,ravencrest,768,priest,discipline,18,8,10
Dokwhite,blackrock,768,priest,discipline,18,8,10
Redempt,nemesis,768,priest,discipline,18,8,10
Theblank,pozzo-delleternità,768,priest,discipline,18,8,10
Uanna,ravencrest,768,priest,discipline,18,8,10
Louiepr,outland,768,priest,discipline,18,8,10
Nstp,zuljin,768,priest,discipline,18,8,10
Hurtless,ravencrest,768,priest,discipline,21,8,13
Yzina,archimonde,768,priest,discipline,24,8,16
Aist,ragnaros,768,priest,discipline,24,8,16
Prestigé,vashj,768,priest,discipline,24,8,16
Trickyteè,tarren-mill,768,priest,discipline,24,8,16
Rmp,stormscale,768,priest,discipline,24,8,16
Devilitry,tarren-mill,768,priest,discipline,24,8,16
Stahpit,twisting-nether,768,priest,discipline,24,8,16
Nuriva,frostmane,768,priest,discipline,30,8,22
Leçke,ravencrest,767,priest,discipline,12,8,4
Cainactor,drakthul,767,priest,discipline,12,8,4
Kletroll,archimonde,767,priest,discipline,12,8,4
Ompala,shattered-hand,767,priest,discipline,12,8,4
Rihx,ysondre,767,priest,discipline,12,8,4
Vaßpera,tarren-mill,767,priest,discipline,12,8,4
Neeti,kazzak,767,priest,discipline,12,8,4
Ingvár,blackrock,767,priest,discipline,12,8,4
Sethp,hyjal,767,priest,discipline,12,8,4
Pumpkin,aggramar,767,priest,discipline,12,8,4
Ðelftware,tarren-mill,767,priest,discipline,12,8,4
Prästbaazil,ragnaros,767,priest,discipline,18,8,10
Arwén,zuljin,767,priest,discipline,18,8,10
Dathanosx,outland,767,priest,discipline,18,8,10
Шэдоура,gordunni,767,priest,discipline,18,8,10
Durinko,thunderhorn,767,priest,discipline,18,8,10
Kitanai,silvermoon,767,priest,discipline,18,8,10
Heilerharry,blackmoore,767,priest,discipline,18,8,10
Kämels,ravencrest,767,priest,discipline,18,8,10
Holyshifts,silvermoon,767,priest,discipline,18,8,10
Khaag,korgall,767,priest,discipline,18,8,10
Luminouzilla,tarren-mill,767,priest,discipline,18,8,10
Bejud,tarren-mill,767,priest,discipline,18,8,10
Pakmopriest,ragnaros,767,priest,discipline,24,8,16
Healenax,ravencrest,767,priest,discipline,24,8,16
Anadyia,aegwynn,767,priest,discipline,24,8,16
Smålbenör,stormreaver,766,priest,discipline,12,8,4
Кфень,soulflayer,766,priest,discipline,16,9,7
Børisheal,draenor,766,priest,discipline,18,8,10
Lianny,sylvanas,766,priest,discipline,18,8,10
Letmehêal,archimonde,766,priest,discipline,18,8,10
Chuntriest,shadowsong,766,priest,discipline,18,8,10
Malíficent,draenor,766,priest,discipline,18,8,10
Сайларс,howling-fjord,766,priest,discipline,18,8,10
Appox,amanthul,766,priest,discipline,18,8,10
Летиин,gordunni,766,priest,discipline,24,8,16
Sazo,drakthul,766,priest,discipline,24,8,16
Lunegrise,archimonde,766,priest,discipline,24,8,16
Baybe,ravencrest,765,priest,discipline,12,8,4
Akadras,blackmoore,765,priest,discipline,12,8,4
Pure,kazzak,765,priest,discipline,12,8,4
Amambo,chamber-of-aspects,765,priest,discipline,12,8,4
Quisira,aegwynn,765,priest,discipline,12,8,4
Pocketsimp,stormscale,765,priest,discipline,18,8,10
Julianpriest,nethersturm,765,priest,discipline,22,9,13
Thakjing,bladefist,765,priest,discipline,24,8,16
Uglypriest,grim-batol,764,priest,discipline,12,8,4
Swdscript,drakthul,764,priest,discipline,18,8,10
Irenedwen,silvermoon,764,priest,discipline,18,8,10
Buttafly,archimonde,764,priest,discipline,18,8,10
Жрицазла,soulflayer,763,priest,discipline,18,8,10
Mefeon,draenor,763,priest,discipline,18,8,10
Malyzion,draenor,763,priest,discipline,18,8,10
Pabli,argent-dawn,763,priest,discipline,18,8,10
Nightshådøw,silvermoon,762,priest,discipline,22,10,12
Xmassdispel,tarren-mill,762,priest,discipline,18,8,10
Злюкыч,gordunni,761,priest,discipline,20,8,12
Келебриана,deepholm,759,priest,discipline,12,8,4
Sîanah,archimonde,754,priest,discipline,12,8,4
Попячебрило,gordunni,754,priest,discipline,18,8,10
Omened,nemesis,751,priest,discipline,17,8,9
Tïniebla,dun-modr,750,priest,discipline,18,8,10
Carcaz,blackmoore,750,priest,discipline,23,10,13
Пофанчику,soulflayer,747,priest,discipline,33,14,19
Lazzariah,ravencrest,742,priest,discipline,18,8,10
Banaynay,bronzebeard,735,priest,discipline,23,8,15
Ислейн,howling-fjord,735,priest,discipline,29,8,21
Staatsfeind,blackmoore,734,priest,discipline,14,9,5
Blorpan,tarren-mill,734,priest,discipline,26,9,17
Bigfnatlund,silvermoon,733,priest,discipline,17,8,9
Amoorâ,twisting-nether,732,priest,discipline,11,8,3
Cthultist,dun-modr,728,priest,discipline,26,9,17
Abstauberin,blackrock,723,priest,discipline,22,8,14
Pnsl,dun-morogh,723,priest,discipline,36,11,25
Stormééz,bronzebeard,722,priest,discipline,32,9,23
Bigwoopsie,stormscale,719,priest,discipline,19,9,10
Telpriest,blackrock,710,priest,discipline,25,9,16
Greenlizard,stormreaver,704,priest,discipline,22,8,14
Sacerdotini,outland,702,priest,discipline,19,9,10
Holyheartx,argent-dawn,692,priest,discipline,28,9,19
Sapieha,burning-legion,687,priest,discipline,11,8,3
Trixix,ragnaros,684,priest,discipline,14,8,6
Seidel,aggramar,682,priest,discipline,16,8,8
Holymoni,ragnaros,680,priest,discipline,16,8,8
Nightsøul,ragnaros,672,priest,discipline,12,7,5
Dombili,frostmane,672,priest,discipline,12,7,5
Furtnajebany,tarren-mill,672,priest,discipline,12,7,5
Shuya,archimonde,672,priest,discipline,12,7,5
Binkx,tarren-mill,672,priest,discipline,12,7,5
Xians,alakir,672,priest,discipline,12,7,5
Goodra,sylvanas,672,priest,discipline,12,7,5
Infandus,pozzo-delleternità,672,priest,discipline,12,7,5
Monstretpr,dragonblight,672,priest,discipline,12,7,5
Tâmshi,dun-modr,672,priest,discipline,12,7,5
Petitogré,silvermoon,672,priest,discipline,12,7,5
Fåye,ravencrest,672,priest,discipline,12,7,5
Pattie,ragnaros,672,priest,discipline,12,7,5
Rixfoulah,ysondre,672,priest,discipline,12,7,5
Wurstpriest,silvermoon,672,priest,discipline,12,7,5
Plåster,dunemaul,672,priest,discipline,12,7,5
Yarok,anubarak,672,priest,discipline,12,7,5
Magiclands,twisting-nether,672,priest,discipline,12,7,5
Morphics,silvermoon,672,priest,discipline,12,7,5
Fkitweball,argent-dawn,672,priest,discipline,12,7,5
Sinnestrike,tarren-mill,672,priest,discipline,12,7,5
Gudjon,dragonblight,672,priest,discipline,12,7,5
Feniyxa,die-aldor,672,priest,discipline,12,7,5
Bebydaniwey,eredar,672,priest,discipline,12,7,5
Daskemaskinx,the-maelstrom,672,priest,discipline,12,7,5
Gladíator,blackhand,672,priest,discipline,12,7,5
Womanwonderf,ravencrest,672,priest,discipline,12,7,5
Striderz,outland,672,priest,discipline,12,7,5
Bunnygxrl,ravencrest,672,priest,discipline,12,7,5
Voleck,aegwynn,672,priest,discipline,12,7,5
Yungmazikeen,archimonde,672,priest,discipline,12,7,5
Evypriest,draenor,672,priest,discipline,12,7,5
Xethh,stormscale,672,priest,discipline,12,7,5
Touchypunk,ravencrest,672,priest,discipline,12,7,5
Longheals,stormscale,672,priest,discipline,12,7,5
Maikzky,stormreaver,672,priest,discipline,12,7,5
Дефаенс,soulflayer,672,priest,discipline,12,7,5
Smiteweaver,drakthul,672,priest,discipline,12,7,5
Lowhealing,kazzak,672,priest,discipline,12,7,5
Pollution,ragnaros,672,priest,discipline,12,7,5
Discobeb,les-clairvoyants,672,priest,discipline,12,7,5
Mdmaster,stormreaver,672,priest,discipline,12,7,5
Moppriest,twisting-nether,672,priest,discipline,12,7,5
Dealtime,ysondre,672,priest,discipline,12,7,5
Healicious,teldrassil,672,priest,discipline,12,7,5
Pflanzenmann,nozdormu,672,priest,discipline,12,7,5
Uadedez,tarren-mill,672,priest,discipline,13,7,6
Xourin,blackrock,672,priest,discipline,16,8,8
Soziy,silvermoon,672,priest,discipline,15,7,8
Ominoushell,twisting-nether,672,priest,discipline,15,7,8
Halysis,chamber-of-aspects,672,priest,discipline,16,7,9
Lasyran,outland,672,priest,discipline,18,7,11
Redlight,ysondre,672,priest,discipline,18,7,11
Stampo,draenor,672,priest,discipline,18,7,11
Cház,sanguino,672,priest,discipline,18,7,11
Priszt,arathor,672,priest,discipline,18,7,11
Dxlkekss,blackmoore,672,priest,discipline,18,7,11
Bij,outland,672,priest,discipline,18,7,11
Nidetha,draenor,672,priest,discipline,18,7,11
Onyoureyebal,vashj,672,priest,discipline,18,7,11
Paterfisl,ragnaros,672,priest,discipline,18,7,11
Shockpriest,grim-batol,672,priest,discipline,18,7,11
Holysjodin,tarren-mill,672,priest,discipline,18,7,11
Ðanilosp,dun-modr,672,priest,discipline,18,7,11
Bubblebuddy,draenor,672,priest,discipline,18,7,11
Опрометчивый,soulflayer,672,priest,discipline,18,7,11
Theycmedotin,blackhand,672,priest,discipline,24,7,17
Hiliom,ahnqiraj,672,priest,discipline,24,7,17
Chekkó,blackrock,672,priest,discipline,24,7,17
Exaneo,ragnaros,672,priest,discipline,24,7,17
Lish,dun-modr,671,priest,discipline,12,7,5
Ehther,dun-modr,671,priest,discipline,12,7,5
Gagai,ravencrest,671,priest,discipline,12,7,5
Ylivoima,stormscale,671,priest,discipline,12,7,5
Ezhealing,ravencrest,671,priest,discipline,12,7,5
Helikipope,kazzak,671,priest,discipline,12,7,5
Vierfingerjo,eredar,671,priest,discipline,12,7,5
Phoskitos,sanguino,671,priest,discipline,12,7,5
Xvpr,trollbane,671,priest,discipline,12,7,5
Chokmâh,sanguino,671,priest,discipline,12,7,5
Àlucárd,blackhand,671,priest,discipline,12,7,5
Quecum,draenor,671,priest,discipline,12,7,5
Saltfeskball,tarren-mill,671,priest,discipline,12,7,5
Fargall,eonar,671,priest,discipline,12,7,5
Rines,thrall,671,priest,discipline,12,7,5
Xharyo,ravencrest,671,priest,discipline,16,7,9
Ziap,dentarg,671,priest,discipline,20,8,12
Débthèønë,ravencrest,671,priest,discipline,18,7,11
Elusivv,blackhand,671,priest,discipline,18,7,11
Lillaego,ragnaros,671,priest,discipline,18,7,11
Психоз,gordunni,671,priest,discipline,18,7,11
Саня,razuvious,671,priest,discipline,18,7,11
Lezz,ragnaros,671,priest,discipline,18,7,11
Рукатёмная,soulflayer,671,priest,discipline,18,7,11
Lysium,sylvanas,671,priest,discipline,18,7,11
Viì,ravencrest,671,priest,discipline,18,7,11
Sebatröz,ravencrest,671,priest,discipline,18,7,11
Orqz,anetheron,670,priest,discipline,12,7,5
Fathermaxii,stormrage,670,priest,discipline,12,7,5
Хемех,soulflayer,670,priest,discipline,12,7,5
Raptichou,hyjal,670,priest,discipline,12,7,5
Argaar,burning-legion,670,priest,discipline,12,7,5
Noralía,die-aldor,670,priest,discipline,12,7,5
Guérissolog,kaelthas,670,priest,discipline,18,7,11
Olikharma,archimonde,670,priest,discipline,18,7,11
Nimuëh,ragnaros,670,priest,discipline,22,8,14
Makkalisser,kazzak,670,priest,discipline,24,7,17
Enlîl,zuljin,669,priest,discipline,12,7,5
Курумничек,gordunni,669,priest,discipline,12,7,5
Belithia,argent-dawn,669,priest,discipline,12,7,5
Дэйвора,ashenvale,669,priest,discipline,18,7,11
Sadira,malganis,669,priest,discipline,18,7,11
Kínson,twisting-nether,668,priest,discipline,12,7,5
Абсорберша,gordunni,668,priest,discipline,12,7,5
Isoris,hyjal,668,priest,discipline,18,7,11
Mescaminator,blackmoore,668,priest,discipline,18,7,11
Lacaena,deathwing,668,priest,discipline,18,7,11
Míjagí,blackhand,668,priest,discipline,22,8,14
Quepimquepam,tarren-mill,668,priest,discipline,24,7,17
Crazyhemsire,twisting-nether,667,priest,discipline,12,7,5
Avor,hellfire,665,priest,discipline,12,7,5
Camellight,stormscale,661,priest,discipline,18,7,11
Ãbømînåtîøn,blackrock,660,priest,discipline,12,7,5
Lubdub,drakthul,659,priest,discipline,18,7,11
Redøm,stormreaver,655,priest,discipline,18,8,10
Lothyf,archimonde,639,priest,discipline,10,8,2
Dapope,drakthul,639,priest,discipline,17,7,10
Tarana,mannoroth,639,priest,discipline,17,7,10
Kayeenie,bloodscalp,639,priest,discipline,22,7,15
Yazzyz,eredar,639,priest,discipline,23,7,16
Voidwaffel,blackmoore,638,priest,discipline,14,8,6
Rulz,zuluhed,636,priest,discipline,17,7,10
Sigor,hellfire,634,priest,discipline,11,7,4
Nomorelight,stormscale,634,priest,discipline,26,8,18
Nepheliel,ysondre,628,priest,discipline,12,8,4
Ysteriagødx,twisting-nether,624,priest,discipline,15,8,7
Submexoxo,archimonde,624,priest,discipline,15,7,8
Spaghettoni,tarren-mill,623,priest,discipline,17,7,10
Luxumbra,quelthalas,623,priest,discipline,21,8,13
Darktattoo,twisting-nether,621,priest,discipline,21,8,13
Argôs,ravencrest,620,priest,discipline,14,8,6
Voilencia,kazzak,620,priest,discipline,21,7,14
Triuna,sylvanas,618,priest,discipline,23,9,14
Ziaz,the-maelstrom,606,priest,discipline,16,7,9
Atibarát,hellfire,605,priest,discipline,16,7,9
Diccen,twilights-hammer,592,priest,discipline,13,7,6
Lyrvatwo,ravencrest,592,priest,discipline,13,7,6
Andhoras,dalaran,591,priest,discipline,11,7,4
Grandpatea,silvermoon,576,priest,discipline,6,6,0
Táliss,arthas,576,priest,discipline,6,6,0
Awakenedmyth,draenor,576,priest,discipline,6,6,0
Scrubydoo,ravencrest,576,priest,discipline,6,6,0
Illiest,ravencrest,576,priest,discipline,6,6,0
Эмжи,howling-fjord,576,priest,discipline,6,6,0
Phèbz,archimonde,576,priest,discipline,6,6,0
Pouffi,garona,576,priest,discipline,6,6,0
Vèrcs,silvermoon,576,priest,discipline,6,6,0
Vatizinium,veklor,576,priest,discipline,12,6,6
Ribberull,burning-blade,576,priest,discipline,12,6,6
Chalecø,dun-modr,576,priest,discipline,12,6,6
Ryyne,ravencrest,576,priest,discipline,12,6,6
Melcarth,blades-edge,576,priest,discipline,12,6,6
Sensimiya,dalaran,576,priest,discipline,12,6,6
Chrònos,das-konsortium,576,priest,discipline,12,6,6
Nyxara,outland,576,priest,discipline,12,6,6
Jaylove,frostwolf,576,priest,discipline,12,6,6
Monataamis,kazzak,576,priest,discipline,12,6,6
Claudefrollo,the-maelstrom,576,priest,discipline,12,6,6
Ranagöl,ragnaros,576,priest,discipline,12,6,6
Асверай,howling-fjord,576,priest,discipline,12,6,6
Nelyø,destromath,576,priest,discipline,12,6,6
Khristo,illidan,576,priest,discipline,12,6,6
Вакидзачи,gordunni,576,priest,discipline,12,6,6
Boysa,earthen-ring,576,priest,discipline,12,6,6
Shadowzrip,twilights-hammer,576,priest,discipline,12,6,6
Tyrhaa,blackmoore,576,priest,discipline,12,6,6
Ènma,archimonde,576,priest,discipline,12,6,6
Puckhorde,outland,576,priest,discipline,12,6,6
Lectrá,kazzak,576,priest,discipline,12,6,6
Fléxéd,burning-legion,576,priest,discipline,12,6,6
Dunkelseele,ahnqiraj,576,priest,discipline,12,6,6
Jesper,outland,576,priest,discipline,12,6,6
Johnblack,dun-morogh,576,priest,discipline,12,6,6
Seemywatch,ungoro,576,priest,discipline,12,6,6
Supernal,twisting-nether,576,priest,discipline,12,6,6
Ðèvì,ravencrest,576,priest,discipline,12,6,6
Sinfulmaze,outland,576,priest,discipline,12,6,6
Isadian,kazzak,576,priest,discipline,12,6,6
Ballarr,burning-legion,576,priest,discipline,12,6,6
Gwinzy,blackmoore,576,priest,discipline,12,6,6
Dõrà,ravencrest,576,priest,discipline,12,6,6
Fästrak,dalaran,576,priest,discipline,12,6,6
Sebbi,ragnaros,576,priest,discipline,12,6,6
Stee,sylvanas,576,priest,discipline,12,6,6
Whitemask,kazzak,576,priest,discipline,12,6,6
Pøh,kilrogg,576,priest,discipline,12,6,6
Msbald,shattered-hand,576,priest,discipline,12,6,6
Utsuro,stormscale,576,priest,discipline,12,6,6
Zyreenx,blackrock,576,priest,discipline,12,6,6
Vorsie,tarren-mill,576,priest,discipline,12,6,6
Abyl,nethersturm,576,priest,discipline,12,6,6
Kankstery,kazzak,576,priest,discipline,12,6,6
Kintsugí,ragnaros,576,priest,discipline,12,6,6
Vulreth,culte-de-la-rive-noire,576,priest,discipline,12,6,6
Ecg,silvermoon,576,priest,discipline,12,6,6
Mitasdi,stormscale,576,priest,discipline,12,6,6
Scarylol,blackmoore,576,priest,discipline,12,6,6
Døtgdx,archimonde,576,priest,discipline,12,6,6
Whynolove,ragnaros,576,priest,discipline,12,6,6
Йодтс,soulflayer,576,priest,discipline,12,6,6
Velri,runetotem,576,priest,discipline,12,6,6
Rune,ravencrest,576,priest,discipline,12,6,6
Родохрозит,blackscar,576,priest,discipline,12,6,6
Popor,archimonde,576,priest,discipline,12,6,6
Comple,kazzak,576,priest,discipline,12,6,6
Eviscerätor,draenor,576,priest,discipline,12,6,6
Sicarium,aegwynn,576,priest,discipline,12,6,6
Shaneya,silvermoon,576,priest,discipline,12,6,6
Swkunz,dun-modr,576,priest,discipline,12,6,6
Stuhlgänger,blackhand,576,priest,discipline,12,6,6
Saitani,stormscale,576,priest,discipline,12,6,6
Ahyha,ravencrest,576,priest,discipline,12,6,6
Ilovepmr,outland,576,priest,discipline,12,6,6
Iqy,kazzak,576,priest,discipline,15,7,8
Волия,gordunni,576,priest,discipline,17,6,11
Onaltnoqs,silvermoon,576,priest,discipline,18,6,12
Kîlo,sylvanas,576,priest,discipline,18,6,12
Alros,elune,576,priest,discipline,18,6,12
Disillusíon,tarren-mill,576,priest,discipline,18,6,12
Mxcey,ravencrest,576,priest,discipline,18,6,12
Eclaír,blackhand,576,priest,discipline,18,6,12
Yoloswaglørd,blackmoore,576,priest,discipline,18,6,12
Limbas,dun-modr,576,priest,discipline,18,6,12
Brainbadly,aegwynn,576,priest,discipline,18,6,12
Frida,blackrock,576,priest,discipline,18,6,12
Noukeé,blackrock,576,priest,discipline,18,6,12
Ilovelily,antonidas,576,priest,discipline,18,6,12
Лилатэль,blackscar,576,priest,discipline,18,6,12
Prarch,sylvanas,576,priest,discipline,18,6,12
Artymox,sylvanas,576,priest,discipline,18,6,12
Nakenhäst,ravencrest,576,priest,discipline,18,6,12
Bochonok,stormrage,576,priest,discipline,18,6,12
Abrakahudder,tarren-mill,576,priest,discipline,18,6,12
Cinjá,thrall,576,priest,discipline,19,6,13
Alwiel,kazzak,576,priest,discipline,24,6,18
Klugzy,silvermoon,576,priest,discipline,24,6,18
Holytang,grim-batol,575,priest,discipline,6,6,0
Sørney,aegwynn,575,priest,discipline,9,7,2
Vastüdö,ragnaros,575,priest,discipline,12,6,6
Hypnòz,archimonde,575,priest,discipline,12,6,6
Kipnuggetz,burning-legion,575,priest,discipline,12,6,6
Могвайи,soulflayer,575,priest,discipline,12,6,6
Makariotatos,xavius,575,priest,discipline,12,6,6
Hmanco,burning-legion,575,priest,discipline,12,6,6
Ponpon,onyxia,575,priest,discipline,12,6,6
Zembowae,drakthul,575,priest,discipline,12,6,6
Zaradana,tarren-mill,575,priest,discipline,12,6,6
Priestvnr,hyjal,575,priest,discipline,12,6,6
Handmännchen,kelthuzad,575,priest,discipline,12,6,6
Insicompany,antonidas,575,priest,discipline,12,6,6
Lichtl,ysera,575,priest,discipline,12,6,6
Allotment,silvermoon,575,priest,discipline,12,6,6
Ðotgød,nemesis,575,priest,discipline,12,6,6
Highlightss,outland,575,priest,discipline,12,6,6
Elfdarkholme,stormscale,575,priest,discipline,12,6,6
Чикхоп,blackscar,575,priest,discipline,12,6,6
Bigbootyheal,silvermoon,575,priest,discipline,12,6,6
Hensynsløs,draenor,575,priest,discipline,12,6,6
Hâmmel,blackrock,575,priest,discipline,12,6,6
Bauscia,nemesis,575,priest,discipline,12,6,6
Zák,sylvanas,575,priest,discipline,12,6,6
Tira,darksorrow,575,priest,discipline,12,6,6
Flackiepi,tarren-mill,575,priest,discipline,12,6,6
Juco,draenor,575,priest,discipline,18,6,12
Priestbiyy,sunstrider,575,priest,discipline,18,6,12
Пэйтен,deathguard,575,priest,discipline,18,6,12
Вэстервилли,howling-fjord,575,priest,discipline,24,6,18
Leonard,nemesis,574,priest,discipline,12,6,6
Preacia,twisting-nether,574,priest,discipline,12,6,6
Velanrous,kazzak,574,priest,discipline,12,6,6
Avinci,blackrock,574,priest,discipline,12,6,6
Tindoriel,bronzebeard,574,priest,discipline,12,6,6
Vebuya,blackmoore,574,priest,discipline,12,6,6
Nygel,kazzak,574,priest,discipline,12,6,6
Draenera,silvermoon,574,priest,discipline,12,6,6
Neosix,sanguino,574,priest,discipline,12,6,6
Virgosenpai,silvermoon,574,priest,discipline,18,7,11
Pæx,antonidas,574,priest,discipline,18,6,12
Prigart,sylvanas,574,priest,discipline,18,6,12
Muftl,thrall,574,priest,discipline,18,6,12
Nerul,twisting-nether,574,priest,discipline,19,6,13
Easxyx,veklor,573,priest,discipline,6,6,0
Kreem,frostmane,573,priest,discipline,12,6,6
Timmemeep,outland,572,priest,discipline,12,6,6
Loriny,ragnaros,572,priest,discipline,14,6,8
Sildane,kirin-tor,572,priest,discipline,18,6,12
Glutenhode,stormscale,571,priest,discipline,12,6,6
Крайне,soulflayer,571,priest,discipline,18,6,12
Bojestvena,neptulon,570,priest,discipline,18,6,12
Seypercillo,dun-modr,569,priest,discipline,18,6,12
Nelielto,stormscale,543,priest,discipline,10,7,3
Døline,hyjal,543,priest,discipline,11,6,5
Jumpaxx,archimonde,543,priest,discipline,17,6,11
Lemowae,doomhammer,542,priest,discipline,22,6,16
Leahx,dalvengyr,527,priest,discipline,11,6,5
Adare,sanguino,527,priest,discipline,11,6,5
Gailiugà,kazzak,527,priest,discipline,11,6,5
Sneed,moonglade,527,priest,discipline,18,7,11
Malapriest,dalaran,527,priest,discipline,17,6,11
Healsquad,draenor,524,priest,discipline,20,6,14
Cárith,nemesis,522,priest,discipline,16,7,9
Demmi,dun-modr,522,priest,discipline,22,7,15
Полуниця,galakrond,522,priest,discipline,23,7,16
Xotz,thrall,521,priest,discipline,15,8,7
Anariell,ravencrest,518,priest,discipline,13,7,6
Cummask,silvermoon,512,priest,discipline,16,6,10
Никорете,soulflayer,511,priest,discipline,11,6,5
Duwendu,drakthul,510,priest,discipline,11,6,5
Thimble,blackhand,510,priest,discipline,19,6,13
Lamp,terokkar,480,priest,discipline,6,5,1
Usermane,ravencrest,480,priest,discipline,6,5,1
Warm,auchindoun,480,priest,discipline,6,5,1
Nttyfromohio,ravencrest,480,priest,discipline,6,5,1
Sorchad,hyjal,480,priest,discipline,6,5,1
Выдокбля,soulflayer,480,priest,discipline,6,5,1
Holynelph,kazzak,480,priest,discipline,6,5,1
Moonacky,bronze-dragonflight,480,priest,discipline,6,5,1
Новокшан,soulflayer,480,priest,discipline,6,5,1
Astralscare,outland,480,priest,discipline,6,5,1
Ronnmoss,defias-brotherhood,480,priest,discipline,6,5,1
Ounxx,blackrock,480,priest,discipline,6,5,1
Disclol,aegwynn,480,priest,discipline,6,5,1
Instantcasts,ravencrest,480,priest,discipline,6,5,1
Trippinorbs,stormscale,480,priest,discipline,6,5,1
Nayballistic,tarren-mill,480,priest,discipline,6,5,1
Hexybtw,stormscale,480,priest,discipline,6,5,1
Eladri,silvermoon,480,priest,discipline,6,5,1
Paìnz,blackhand,480,priest,discipline,6,5,1
Гачидварфич,gordunni,480,priest,discipline,6,5,1
Docpower,twisting-nether,480,priest,discipline,6,5,1
Bec,ragnaros,480,priest,discipline,6,5,1
Loldisc,arthas,480,priest,discipline,6,5,1
Ganakenp,tarren-mill,480,priest,discipline,6,5,1
Phamy,antonidas,480,priest,discipline,6,5,1
Нэриэлл,gordunni,480,priest,discipline,6,5,1
Bäckay,silvermoon,480,priest,discipline,6,5,1
Sloee,kazzak,480,priest,discipline,6,5,1
Лютаяшиза,gordunni,480,priest,discipline,6,5,1
Swep,ragnaros,480,priest,discipline,6,5,1
Whopzi,blackmoore,480,priest,discipline,6,5,1
Clutchp,blackmoore,480,priest,discipline,6,5,1
Shieldyblaze,frostwolf,480,priest,discipline,6,5,1
Dsyleixa,archimonde,480,priest,discipline,12,5,7
Healysith,archimonde,480,priest,discipline,12,5,7
Bibleenjoyer,blackmoore,480,priest,discipline,12,5,7
Muradawg,nemesis,480,priest,discipline,12,5,7
Chaapsbbq,archimonde,480,priest,discipline,12,5,7
Moeshy,kazzak,480,priest,discipline,12,5,7
Døtzillah,kazzak,480,priest,discipline,12,5,7
Ajaxfreak,blackmoore,480,priest,discipline,12,5,7
Mariahscarey,blackhand,480,priest,discipline,12,5,7
Haffination,frostmane,480,priest,discipline,12,5,7
Hauntzer,veknilash,480,priest,discipline,12,5,7
Бенджаминлол,deathguard,480,priest,discipline,12,5,7
Discgødx,thrall,480,priest,discipline,12,5,7
Drumont,kelthuzad,480,priest,discipline,12,5,7
Litera,silvermoon,480,priest,discipline,12,5,7
Hollylicious,kazzak,480,priest,discipline,12,5,7
Yukîna,blackrock,480,priest,discipline,12,5,7
Djplay,aegwynn,480,priest,discipline,12,5,7
Luxør,blackrock,480,priest,discipline,12,5,7
Brutalmaze,archimonde,480,priest,discipline,12,5,7
Brøwney,blackmoore,480,priest,discipline,12,5,7
Hyonra,kazzak,480,priest,discipline,12,5,7
Urizal,defias-brotherhood,480,priest,discipline,12,5,7
Davóss,outland,480,priest,discipline,12,5,7
Katsikatsika,silvermoon,480,priest,discipline,12,5,7
Kolsy,twisting-nether,480,priest,discipline,12,5,7
Miabelle,argent-dawn,480,priest,discipline,12,5,7
Borgamor,frostmane,480,priest,discipline,12,5,7
Shadew,stormscale,480,priest,discipline,12,5,7
Kaleshiry,kazzak,480,priest,discipline,12,5,7
Späxxi,amanthul,480,priest,discipline,12,5,7
Magthalor,twisting-nether,480,priest,discipline,12,5,7
Yö,stormscale,480,priest,discipline,12,5,7
Shyvi,ravencrest,480,priest,discipline,12,5,7
Saphèa,burning-legion,480,priest,discipline,12,5,7
Funzies,doomhammer,480,priest,discipline,12,5,7
Holydoughnut,stormscale,480,priest,discipline,12,5,7
Nothappy,ragnaros,480,priest,discipline,12,5,7
Bonsoin,kirin-tor,480,priest,discipline,12,5,7
Meheal,lothar,480,priest,discipline,12,5,7
Nilera,frostwolf,480,priest,discipline,12,5,7
Забейка,howling-fjord,480,priest,discipline,12,5,7
Вайтбласт,howling-fjord,480,priest,discipline,12,5,7
Изишвд,gordunni,480,priest,discipline,12,5,7
Grozozo,tarren-mill,480,priest,discipline,12,5,7
Donbas,tarren-mill,480,priest,discipline,12,5,7
Mayday,silvermoon,480,priest,discipline,12,5,7
Azrella,ravencrest,480,priest,discipline,12,5,7
Krìnzy,illidan,480,priest,discipline,12,5,7
Mivale,aszune,480,priest,discipline,12,5,7
Nyù,kazzak,480,priest,discipline,12,5,7
Terstyana,hyjal,480,priest,discipline,12,5,7
Самурайко,booty-bay,480,priest,discipline,12,5,7
Navihato,silvermoon,480,priest,discipline,12,5,7
Уер,galakrond,480,priest,discipline,12,5,7
Fakebob,draenor,480,priest,discipline,12,5,7
Pwsx,draenor,480,priest,discipline,12,5,7
Seskipr,stormreaver,480,priest,discipline,12,5,7
Ghettothug,darksorrow,480,priest,discipline,12,5,7
Вегельдэрс,gordunni,480,priest,discipline,12,5,7
Khoria,drakthul,480,priest,discipline,12,5,7
Graveyards,tarren-mill,480,priest,discipline,12,5,7
Tsipaz,outland,480,priest,discipline,12,5,7
Playax,silvermoon,480,priest,discipline,12,5,7
Jtep,ravencrest,480,priest,discipline,12,5,7
Epa,zuljin,480,priest,discipline,12,5,7
Bimbax,dun-modr,480,priest,discipline,12,5,7
Allaría,bronze-dragonflight,480,priest,discipline,12,5,7
Sbj,bronze-dragonflight,480,priest,discipline,12,5,7
Merkabah,azjolnerub,480,priest,discipline,12,5,7
Roylian,ravencrest,480,priest,discipline,12,5,7
Suaakypriest,tyrande,480,priest,discipline,12,5,7
Seankingkong,ravencrest,480,priest,discipline,12,5,7
Lunatrix,sanguino,480,priest,discipline,12,5,7
Jeboc,ravencrest,480,priest,discipline,12,5,7
Nayballsp,tarren-mill,480,priest,discipline,12,5,7
Лизота,gordunni,480,priest,discipline,12,5,7
Madkes,ravencrest,480,priest,discipline,12,5,7
Саксесфул,howling-fjord,480,priest,discipline,12,5,7
Абсорбиболь,howling-fjord,480,priest,discipline,12,5,7
Ameja,sylvanas,480,priest,discipline,13,5,8
Taimani,burning-legion,480,priest,discipline,18,5,13
Ча,thermaplugg,480,priest,discipline,18,5,13
Kehz,ysondre,480,priest,discipline,18,5,13
Avp,the-maelstrom,480,priest,discipline,18,5,13
Momopriesto,draenor,480,priest,discipline,18,5,13
Карбонит,fordragon,480,priest,discipline,18,5,13
Valirda,twisting-nether,480,priest,discipline,18,5,13
Góli,argent-dawn,480,priest,discipline,18,5,13
Savíour,kazzak,480,priest,discipline,18,5,13
Ноатоэль,gordunni,480,priest,discipline,18,5,13
Элизабетшорт,soulflayer,480,priest,discipline,18,5,13
Sarinà,archimonde,480,priest,discipline,24,5,19
Dazé,ravencrest,479,priest,discipline,6,5,1
Elpitiimigré,sinstralis,479,priest,discipline,6,5,1
Slight,aggra-português,479,priest,discipline,12,5,7
Darknëss,malganis,479,priest,discipline,12,5,7
Tota,frostmane,479,priest,discipline,12,5,7
Haigoku,archimonde,479,priest,discipline,12,5,7
Sewerperson,doomhammer,479,priest,discipline,12,5,7
Helming,magtheridon,479,priest,discipline,12,5,7
Шпалкоклоб,soulflayer,479,priest,discipline,12,5,7
Ethylene,ysondre,479,priest,discipline,12,5,7
Aethiel,drakthul,479,priest,discipline,12,5,7
Tigrok,burning-legion,479,priest,discipline,12,5,7
Shyvannas,antonidas,479,priest,discipline,12,5,7
Elunerei,tarren-mill,479,priest,discipline,12,5,7
Jeus,malganis,479,priest,discipline,12,5,7
Røläck,ragnaros,479,priest,discipline,12,5,7
Obeliskprist,kazzak,479,priest,discipline,12,5,7
Bòóny,ravencrest,479,priest,discipline,12,5,7
Cobrix,nemesis,479,priest,discipline,12,5,7
Sanoe,twisting-nether,479,priest,discipline,12,5,7
Pontiff,the-maelstrom,479,priest,discipline,12,5,7
Piotrek,hyjal,479,priest,discipline,12,5,7
Pluf,nefarian,479,priest,discipline,12,5,7
Flappí,argent-dawn,479,priest,discipline,12,5,7
Velenthøs,argent-dawn,479,priest,discipline,12,5,7
Konantenshi,doomhammer,479,priest,discipline,12,5,7
Jessicar,the-maelstrom,479,priest,discipline,12,5,7
Velenthan,stormrage,479,priest,discipline,12,5,7
Bldnl,ragnaros,479,priest,discipline,15,6,9
Lightless,baelgun,479,priest,discipline,17,5,12
Seehz,ysondre,479,priest,discipline,18,5,13
Antiexhile,kazzak,479,priest,discipline,18,5,13
Aká,kazzak,479,priest,discipline,18,5,13
Sleeyz,blackmoore,479,priest,discipline,24,5,19
Avesatana,khadgar,478,priest,discipline,6,5,1
Ruebi,blackmoore,478,priest,discipline,12,5,7
Hotwheal,ysondre,478,priest,discipline,12,5,7
Patoroch,terokkar,478,priest,discipline,18,5,13
Arathiell,nordrassil,477,priest,discipline,12,5,7
Oknelim,blackmoore,477,priest,discipline,12,5,7
Phosphorus,blackhand,476,priest,discipline,12,5,7
Feloriya,antonidas,476,priest,discipline,12,5,7
Rettsche,eredar,475,priest,discipline,12,5,7
Wipipi,draenor,474,priest,discipline,12,5,7
Рнкх,lich-king,448,priest,discipline,16,5,11
Killermoon,rexxar,447,priest,discipline,10,5,5
Makemyday,dun-modr,447,priest,discipline,11,5,6
Drë,daggerspine,447,priest,discipline,11,5,6
Hitaro,antonidas,447,priest,discipline,11,5,6
Dhed,turalyon,447,priest,discipline,14,6,8
Leyasu,eredar,447,priest,discipline,15,6,9
Sandgambler,draenor,432,priest,discipline,9,5,4
Äliénør,khaz-modan,426,priest,discipline,17,7,10
Kak,gorgonnash,426,priest,discipline,19,6,13
Holybøi,ragnaros,426,priest,discipline,29,7,22
Cestrial,sylvanas,415,priest,discipline,14,5,9
Шруня,howling-fjord,400,priest,discipline,24,5,19
Stàrlîght,chants-éternels,399,priest,discipline,5,5,0
Papkalácss,hellfire,399,priest,discipline,5,5,0
Appraiser,draenor,384,priest,discipline,6,4,2
Gravedoll,draenor,384,priest,discipline,6,4,2
Ðapperðan,draenor,384,priest,discipline,6,4,2
Bhlad,silvermoon,384,priest,discipline,6,4,2
Byzzi,draenor,384,priest,discipline,6,4,2
Priestutute,tarren-mill,384,priest,discipline,6,4,2
Бархомелфой,gordunni,384,priest,discipline,6,4,2
Flaynbones,tarren-mill,384,priest,discipline,6,4,2
Невертрикахд,gordunni,384,priest,discipline,6,4,2
Goblingøs,ravencrest,384,priest,discipline,6,4,2
Umbralx,ragnaros,384,priest,discipline,6,4,2
Iirina,draenor,384,priest,discipline,6,4,2
Discomarcel,burning-legion,384,priest,discipline,6,4,2
Robiee,twisting-nether,384,priest,discipline,6,4,2
Topdamage,stormscale,384,priest,discipline,6,4,2
Badballs,doomhammer,384,priest,discipline,6,4,2
Ciordel,draenor,384,priest,discipline,6,4,2
Imaut,emerald-dream,384,priest,discipline,6,4,2
Gimcho,magtheridon,384,priest,discipline,6,4,2
Isson,earthen-ring,384,priest,discipline,6,4,2
Эстрогенс,gordunni,384,priest,discipline,6,4,2
Ahilarry,tarren-mill,384,priest,discipline,6,4,2
Nällytq,nefarian,384,priest,discipline,6,4,2
Cerdapriesst,dun-modr,384,priest,discipline,6,4,2
Ivÿx,ravencrest,384,priest,discipline,6,4,2
Rýzera,tarren-mill,384,priest,discipline,6,4,2
Zumbae,tarren-mill,384,priest,discipline,6,4,2
Badguymike,ragnaros,384,priest,discipline,6,4,2
Félrebarmok,ragnaros,384,priest,discipline,6,4,2
Reól,blackmoore,384,priest,discipline,6,4,2
Thean,twilights-hammer,384,priest,discipline,6,4,2
Sariss,ravencrest,384,priest,discipline,6,4,2
Muncett,dun-modr,384,priest,discipline,6,4,2
Gorti,ravencrest,384,priest,discipline,6,4,2
Awön,stormscale,384,priest,discipline,6,4,2
Darkoulito,dalaran,384,priest,discipline,6,4,2
Nesar,stormscale,384,priest,discipline,6,4,2
Healinrbglol,blackmoore,384,priest,discipline,6,4,2
Giffelgrethe,sylvanas,384,priest,discipline,6,4,2
Magicstarss,the-maelstrom,384,priest,discipline,6,4,2
Onceup,thrall,384,priest,discipline,6,4,2
Ilovecala,ravencrest,384,priest,discipline,6,4,2
Mylox,blackrock,384,priest,discipline,6,4,2
Unstopp,blackhand,384,priest,discipline,6,4,2
Schnîttchen,blackrock,384,priest,discipline,6,4,2
Woid,aegwynn,384,priest,discipline,6,4,2
Gotikaa,blackrock,384,priest,discipline,6,4,2
Piixld,aegwynn,384,priest,discipline,6,4,2
Büssi,blackrock,384,priest,discipline,6,4,2
Cheesegód,outland,384,priest,discipline,6,4,2
Experimentix,silvermoon,384,priest,discipline,6,4,2
Кхарли,howling-fjord,384,priest,discipline,6,4,2
Hadk,blackrock,384,priest,discipline,6,4,2
Серью,booty-bay,384,priest,discipline,6,4,2
Healmebaby,kiljaeden,384,priest,discipline,6,4,2
Dimentions,sylvanas,384,priest,discipline,6,4,2
Babambaba,sylvanas,384,priest,discipline,6,4,2
Miliane,twisting-nether,384,priest,discipline,6,4,2
Хъи,gordunni,384,priest,discipline,6,4,2
Mylini,silvermoon,384,priest,discipline,6,4,2
Ahun,taerar,384,priest,discipline,6,4,2
Buerak,tarren-mill,384,priest,discipline,6,4,2
Challa,magtheridon,384,priest,discipline,6,4,2
Yukirito,drakthul,384,priest,discipline,6,4,2
Above,hyjal,384,priest,discipline,6,4,2
Pankp,kazzak,384,priest,discipline,6,4,2
Îlkari,hyjal,384,priest,discipline,6,4,2
Ocastia,antonidas,384,priest,discipline,6,4,2
Pisso,outland,384,priest,discipline,6,4,2
Papêrcut,kazzak,384,priest,discipline,6,4,2
ßlinkywinky,outland,384,priest,discipline,6,4,2
Frekko,outland,384,priest,discipline,6,4,2
Toasttwo,kazzak,384,priest,discipline,6,4,2
Møelester,antonidas,384,priest,discipline,6,4,2
Dødy,hyjal,384,priest,discipline,6,4,2
Sîlfa,hyjal,384,priest,discipline,6,4,2
Daniweyy,eredar,384,priest,discipline,6,4,2
Roskva,archimonde,384,priest,discipline,9,5,4
Wixzyx,ravencrest,384,priest,discipline,10,4,6
Çelph,silvermoon,384,priest,discipline,12,4,8
Каэден,blackscar,384,priest,discipline,12,4,8
Thesunbeam,silvermoon,384,priest,discipline,12,4,8
Уэйнестелл,booty-bay,384,priest,discipline,12,4,8
Арейша,gordunni,384,priest,discipline,12,4,8
Велост,gordunni,384,priest,discipline,12,4,8
Tsunadesaama,silvermoon,384,priest,discipline,12,4,8
Mukkin,tarren-mill,384,priest,discipline,12,4,8
Xýz,tarren-mill,384,priest,discipline,12,4,8
Mérce,kazzak,384,priest,discipline,12,4,8
Asdfsds,kazzak,384,priest,discipline,12,4,8
Karmasmom,kazzak,384,priest,discipline,12,4,8
Xayona,argent-dawn,384,priest,discipline,12,4,8
Goatrocker,kazzak,384,priest,discipline,12,4,8
Druzhok,sylvanas,384,priest,discipline,12,4,8
Lothbruke,twisting-nether,384,priest,discipline,12,4,8
Chigreru,uldum,384,priest,discipline,12,4,8
Evilangèl,ravenholdt,384,priest,discipline,12,4,8
Gilfir,stormscale,384,priest,discipline,12,4,8
Сайлентхилл,howling-fjord,384,priest,discipline,12,4,8
Stepsisstuck,ragnaros,384,priest,discipline,12,4,8
Spezzato,nemesis,384,priest,discipline,12,4,8
Sorrop,sanguino,384,priest,discipline,12,4,8
Sweity,dun-modr,384,priest,discipline,12,4,8
Zivl,blackrock,384,priest,discipline,12,4,8
Altargirl,defias-brotherhood,384,priest,discipline,12,4,8
Ankî,aegwynn,384,priest,discipline,12,4,8
Crenî,blackrock,384,priest,discipline,12,4,8
Jaywie,twisting-nether,384,priest,discipline,12,4,8
Thehealer,twisting-nether,384,priest,discipline,12,4,8
Raybangx,blackrock,384,priest,discipline,12,4,8
Skuhlx,blackrock,384,priest,discipline,12,4,8
Заак,howling-fjord,384,priest,discipline,12,4,8
Ревентонх,howling-fjord,384,priest,discipline,12,4,8
Purityn,blackhand,384,priest,discipline,12,4,8
Drdré,blackrock,384,priest,discipline,12,4,8
Touchmé,blackmoore,384,priest,discipline,12,4,8
Absolution,stormscale,384,priest,discipline,12,4,8
Sabakk,archimonde,384,priest,discipline,12,4,8
Skyløl,dun-modr,384,priest,discipline,12,4,8
Toasttrii,outland,384,priest,discipline,12,4,8
Solerona,blackmoore,384,priest,discipline,12,4,8
Lunærÿ,hyjal,384,priest,discipline,12,4,8
Марина,howling-fjord,384,priest,discipline,12,4,8
Hötchick,outland,384,priest,discipline,12,4,8
Geforcès,archimonde,384,priest,discipline,12,4,8
Predpriest,twisting-nether,384,priest,discipline,12,4,8
Mariio,blackmoore,384,priest,discipline,12,4,8
Hombre,anetheron,384,priest,discipline,12,4,8
Amèn,archimonde,384,priest,discipline,12,4,8
Luznywiesiek,burning-legion,384,priest,discipline,12,4,8
Kalestharia,blackmoore,384,priest,discipline,12,4,8
Bebsenpai,hyjal,384,priest,discipline,12,4,8
Biophyzix,aegwynn,384,priest,discipline,12,4,8
Сашашвд,howling-fjord,384,priest,discipline,12,4,8
Asdfgfhtjy,stormscale,384,priest,discipline,12,4,8
Rîîper,khaz-modan,384,priest,discipline,12,4,8
Vicetøne,stormscale,384,priest,discipline,12,4,8
Melord,thunderhorn,384,priest,discipline,12,4,8
Deathtrapx,draenor,384,priest,discipline,12,4,8
Azriael,draenor,384,priest,discipline,12,4,8
Míllerzz,ragnaros,384,priest,discipline,12,4,8
Lalock,grim-batol,384,priest,discipline,12,4,8
Xaeroow,archimonde,384,priest,discipline,12,4,8
Mythaaz,archimonde,384,priest,discipline,15,4,11
Celestias,sanguino,384,priest,discipline,15,4,11
Zeröone,silvermoon,384,priest,discipline,17,4,13
Blackwidow,chromaggus,384,priest,discipline,18,4,14
Tsuser,blackrock,384,priest,discipline,18,4,14
Zergo,karazhan,384,priest,discipline,18,4,14
Sbubbi,ravencrest,384,priest,discipline,18,4,14
Shyvàree,les-clairvoyants,384,priest,discipline,18,4,14
Kinn,kaelthas,383,priest,discipline,6,4,2
Hðly,doomhammer,383,priest,discipline,6,4,2
Chaniu,throkferoth,383,priest,discipline,6,4,2
Moonary,ravencrest,383,priest,discipline,6,4,2
Vishnoo,hyjal,383,priest,discipline,6,4,2
Pownme,blackmoore,383,priest,discipline,6,4,2
Enchanttress,burning-legion,383,priest,discipline,6,4,2
Ravend,sylvanas,383,priest,discipline,6,4,2
Побьюкадилом,gordunni,383,priest,discipline,12,4,8
Miriàl,outland,383,priest,discipline,12,4,8
Søs,eldrethalas,383,priest,discipline,12,4,8
Hólyeárth,twisting-nether,383,priest,discipline,12,4,8
Bénjamín,outland,383,priest,discipline,12,4,8
Xpect,terokkar,383,priest,discipline,12,4,8
Nefertítí,frostmane,382,priest,discipline,6,4,2
Amoxí,blackmoore,382,priest,discipline,6,4,2
Havanna,dethecus,382,priest,discipline,6,4,2
Тэтсу,greymane,382,priest,discipline,12,4,8
Malorian,khadgar,382,priest,discipline,12,4,8
Lierie,kazzak,382,priest,discipline,24,4,20
Grommyr,eredar,381,priest,discipline,12,4,8
Kårejonny,tarren-mill,370,priest,discipline,19,7,12
Хилогайка,howling-fjord,370,priest,discipline,27,8,19
Thanil,bloodfeather,367,priest,discipline,11,4,7
Tephutes,ravencrest,367,priest,discipline,11,4,7
Maskinjundre,bronzebeard,352,priest,discipline,12,4,8
Øxx,blackrock,351,priest,discipline,11,4,7
Sickbo,eredar,351,priest,discipline,11,4,7
Pjuww,outland,351,priest,discipline,11,4,7
Doxxi,argent-dawn,336,priest,discipline,9,5,4
Salvatör,quelthalas,336,priest,discipline,15,5,10
Vicønia,tarren-mill,335,priest,discipline,11,4,7
Runay,draenor,330,priest,discipline,13,5,8
Impmvp,kazzak,330,priest,discipline,17,6,11
Косн,razuvious,330,priest,discipline,16,5,11
Alsalty,stormscale,330,priest,discipline,21,5,16
Кирюшасэмпай,gordunni,320,priest,discipline,10,4,6
Tyog,khazgoroth,320,priest,discipline,10,4,6
Brainðead,aegwynn,319,priest,discipline,5,4,1
Avane,outland,319,priest,discipline,5,4,1
Sapue,aegwynn,288,priest,discipline,6,3,3
Ykwah,kazzak,288,priest,discipline,6,3,3
Ríeka,proudmoore,288,priest,discipline,6,3,3
Priestar,madmortem,288,priest,discipline,6,3,3
Hampådenbååd,kazzak,288,priest,discipline,6,3,3
Elmaestrø,aegwynn,288,priest,discipline,6,3,3
Zeuws,kazzak,288,priest,discipline,6,3,3
Missandeí,frostmane,288,priest,discipline,6,3,3
Pxescalol,aegwynn,288,priest,discipline,6,3,3
Zkàrb,hyjal,288,priest,discipline,6,3,3
Bridélight,archimonde,288,priest,discipline,6,3,3
Grazz,grim-batol,288,priest,discipline,6,3,3
Moistmidget,frostmane,288,priest,discipline,6,3,3
Justjuice,hyjal,288,priest,discipline,6,3,3
Jumpàxx,archimonde,288,priest,discipline,6,3,3
Milderyp,kazzak,288,priest,discipline,6,3,3
Hewwo,sylvanas,288,priest,discipline,6,3,3
Preodek,kazzak,288,priest,discipline,6,3,3
Tsunê,ysondre,288,priest,discipline,6,3,3
Rektom,archimonde,288,priest,discipline,6,3,3
Åtømîç,kazzak,288,priest,discipline,6,3,3
Spklooril,hyjal,288,priest,discipline,6,3,3
Figoluh,hyjal,288,priest,discipline,6,3,3
Rhàenyra,ravencrest,288,priest,discipline,6,3,3
Këller,hyjal,288,priest,discipline,6,3,3
Ðeswynds,hyjal,288,priest,discipline,6,3,3
Nàvy,archimonde,288,priest,discipline,6,3,3
Seeyae,archimonde,288,priest,discipline,6,3,3
Fatyoyo,frostwolf,288,priest,discipline,6,3,3
Decimerad,kazzak,288,priest,discipline,6,3,3
Hôllÿ,ysondre,288,priest,discipline,6,3,3
Zikár,kazzak,288,priest,discipline,6,3,3
Confess,archimonde,288,priest,discipline,6,3,3
Peign,eredar,288,priest,discipline,6,3,3
Caipiwtf,eredar,288,priest,discipline,6,3,3
Delinsx,outland,288,priest,discipline,6,3,3
Russianpvp,outland,288,priest,discipline,6,3,3
Shieldop,eredar,288,priest,discipline,6,3,3
Wontdispel,ravencrest,288,priest,discipline,6,3,3
Hardbowl,teldrassil,288,priest,discipline,6,3,3
Josva,sanguino,288,priest,discipline,6,3,3
Dead,argent-dawn,288,priest,discipline,6,3,3
Ылрйкпмитьхх,soulflayer,288,priest,discipline,6,3,3
Iluvkiids,blackhand,288,priest,discipline,6,3,3
Биркох,blackscar,288,priest,discipline,6,3,3
Laradiel,dun-modr,288,priest,discipline,6,3,3
Sâmba,pozzo-delleternità,288,priest,discipline,6,3,3
Psychout,ravencrest,288,priest,discipline,6,3,3
Hôtseitdank,blackrock,288,priest,discipline,6,3,3
Ardeë,dun-modr,288,priest,discipline,6,3,3
Noonex,hakkar,288,priest,discipline,6,3,3
Santainphy,cthun,288,priest,discipline,6,3,3
Starships,kazzak,288,priest,discipline,6,3,3
ßøunty,dun-modr,288,priest,discipline,6,3,3
Acik,bladefist,288,priest,discipline,6,3,3
Cbbigbape,thrall,288,priest,discipline,6,3,3
Shadoxx,malganis,288,priest,discipline,6,3,3
Nedex,thrall,288,priest,discipline,6,3,3
Applepiez,ravencrest,288,priest,discipline,6,3,3
Chayz,thrall,288,priest,discipline,6,3,3
Pristel,twisting-nether,288,priest,discipline,6,3,3
Holycowheals,the-maelstrom,288,priest,discipline,6,3,3
Sardine,ravencrest,288,priest,discipline,6,3,3
Watchmepray,stormscale,288,priest,discipline,6,3,3
Mahist,ravencrest,288,priest,discipline,6,3,3
Depleeky,blackmoore,288,priest,discipline,6,3,3
Henreita,darksorrow,288,priest,discipline,6,3,3
Tzúú,ravencrest,288,priest,discipline,6,3,3
Grainbames,sylvanas,288,priest,discipline,6,3,3
Yillva,darkspear,288,priest,discipline,6,3,3
Фалд,gordunni,288,priest,discipline,6,3,3
Disfinkacze,drakthul,288,priest,discipline,6,3,3
Challengepro,burning-legion,288,priest,discipline,6,3,3
Vaurork,stormscale,288,priest,discipline,6,3,3
Byshadow,silvermoon,288,priest,discipline,6,3,3
Pøsæ,uldaman,288,priest,discipline,6,3,3
Effot,twisting-nether,288,priest,discipline,6,3,3
Immutable,twisting-nether,288,priest,discipline,6,3,3
Ансор,lich-king,288,priest,discipline,6,3,3
Unrèål,ravencrest,288,priest,discipline,6,3,3
Pietyberi,tichondrius,288,priest,discipline,6,3,3
Hængøver,blackmoore,288,priest,discipline,6,3,3
Хомячише,lich-king,288,priest,discipline,6,3,3
Æøí,blackmoore,288,priest,discipline,6,3,3
Nelakya,blackmoore,288,priest,discipline,6,3,3
Séfaron,blackmoore,288,priest,discipline,6,3,3
Lolipopheal,blackmoore,288,priest,discipline,6,3,3
Шлёндрик,gordunni,288,priest,discipline,6,3,3
Qpops,twisting-nether,288,priest,discipline,6,3,3
Чилюотферала,eversong,288,priest,discipline,6,3,3
Mariahcarey,blackmoore,288,priest,discipline,6,3,3
Заволончик,blackscar,288,priest,discipline,6,3,3
Кхайла,blackscar,288,priest,discipline,6,3,3
Pwatheism,blackmoore,288,priest,discipline,6,3,3
Azazzel,nathrezim,288,priest,discipline,6,3,3
Hanagaki,ragnaros,288,priest,discipline,6,3,3
Maiel,die-aldor,288,priest,discipline,6,3,3
Paphahaha,ragnaros,288,priest,discipline,6,3,3
Ðontargueok,blackmoore,288,priest,discipline,6,3,3
Felon,burning-legion,288,priest,discipline,6,3,3
Аридел,ashenvale,288,priest,discipline,6,3,3
Dannebrog,eonar,288,priest,discipline,6,3,3
Löspajen,stormscale,288,priest,discipline,6,3,3
Нагп,gordunni,288,priest,discipline,6,3,3
Lerissea,argent-dawn,288,priest,discipline,6,3,3
Iløvelena,ravencrest,288,priest,discipline,6,3,3
Фруктовыйса,gordunni,288,priest,discipline,6,3,3
Тесира,blackscar,288,priest,discipline,6,3,3
Tyarande,tarren-mill,288,priest,discipline,6,3,3
Ònasou,silvermoon,288,priest,discipline,6,3,3
Eros,illidan,288,priest,discipline,6,3,3
Dumix,shadowsong,288,priest,discipline,6,3,3
Куольхд,gordunni,288,priest,discipline,6,3,3
Pixe,argent-dawn,288,priest,discipline,6,3,3
Eldrathir,burning-legion,288,priest,discipline,6,3,3
Flet,emerald-dream,288,priest,discipline,6,3,3
Sastry,drakthul,288,priest,discipline,6,3,3
Ксайфир,gordunni,288,priest,discipline,6,3,3
Bigdamsmitex,draenor,288,priest,discipline,6,3,3
Kamiðßlesing,sanguino,288,priest,discipline,6,3,3
Shádøwx,ravencrest,288,priest,discipline,6,3,3
Xdthe,tarren-mill,288,priest,discipline,6,3,3
Palrins,dalaran,288,priest,discipline,6,3,3
Микаса,howling-fjord,288,priest,discipline,6,3,3
Deternity,stormscale,288,priest,discipline,6,3,3
Qzrx,draenor,288,priest,discipline,6,3,3
Mindflayér,stormscale,288,priest,discipline,6,3,3
Flaylol,stormscale,288,priest,discipline,6,3,3
Zofiiee,tarren-mill,288,priest,discipline,6,3,3
Jazty,sanguino,288,priest,discipline,6,3,3
Nefufangirl,ravencrest,288,priest,discipline,6,3,3
Purpl,tarren-mill,288,priest,discipline,6,3,3
Windieqt,drakthul,288,priest,discipline,6,3,3
ßestworld,draenor,288,priest,discipline,6,3,3
Ðopebwøy,burning-legion,288,priest,discipline,6,3,3
Kaylaylaylay,draenor,288,priest,discipline,6,3,3
Tothegrave,draenor,288,priest,discipline,6,3,3
Карнотит,howling-fjord,288,priest,discipline,6,3,3
Либертадор,howling-fjord,288,priest,discipline,6,3,3
Акимбопушка,howling-fjord,288,priest,discipline,6,3,3
Madreöscura,cthun,288,priest,discipline,15,4,11
Ælæx,alleria,288,priest,discipline,12,3,9
Kátîè,draenor,288,priest,discipline,12,3,9
Kranrekan,archimonde,288,priest,discipline,12,3,9
Doombrew,blackmoore,288,priest,discipline,12,3,9
Tazting,stormscale,288,priest,discipline,12,3,9
Венэма,azuregos,288,priest,discipline,12,3,9
Krãtos,kazzak,288,priest,discipline,12,3,9
Orkall,sylvanas,288,priest,discipline,12,3,9
Pidarkgogo,stormscale,288,priest,discipline,12,3,9
Výra,der-rat-von-dalaran,288,priest,discipline,12,3,9
Malaboost,archimonde,288,priest,discipline,12,3,9
Moth,kazzak,288,priest,discipline,12,3,9
Smitelord,outland,288,priest,discipline,12,3,9
Tubercurass,hyjal,288,priest,discipline,12,3,9
Knobibobby,blackrock,288,priest,discipline,12,3,9
Smiteyoudown,aegwynn,288,priest,discipline,12,3,9
Crazyhealsqt,hellfire,288,priest,discipline,12,3,9
Snowlhad,argent-dawn,288,priest,discipline,12,3,9
Quïzzler,ragnaros,288,priest,discipline,12,3,9
Ðènnis,argent-dawn,288,priest,discipline,12,3,9
Honompa,darkmoon-faire,288,priest,discipline,12,3,9
Fluxyqt,ravencrest,288,priest,discipline,12,3,9
Bacovia,tarren-mill,288,priest,discipline,12,3,9
Piitixd,burning-legion,288,priest,discipline,12,3,9
Sins,defias-brotherhood,288,priest,discipline,12,3,9
Koshmår,stormscale,288,priest,discipline,12,3,9
Toratorap,burning-legion,288,priest,discipline,12,3,9
Rennic,stormscale,288,priest,discipline,12,3,9
Djezà,archimonde,288,priest,discipline,12,3,9
Фикспрайз,gordunni,288,priest,discipline,12,3,9
Gaehla,silvermoon,288,priest,discipline,12,3,9
Løs,argent-dawn,288,priest,discipline,12,3,9
Arathelle,chromaggus,288,priest,discipline,12,3,9
Biierlip,twisting-nether,288,priest,discipline,12,3,9
Nyxém,blackmoore,288,priest,discipline,12,3,9
Absórb,quelthalas,288,priest,discipline,12,3,9
Kilmin,ravencrest,288,priest,discipline,12,3,9
Dizzaer,terokkar,288,priest,discipline,12,3,9
Arttos,antonidas,288,priest,discipline,12,3,9
Niikki,blackrock,288,priest,discipline,12,3,9
Âlígés,outland,288,priest,discipline,12,3,9
Choosunghoon,silvermoon,288,priest,discipline,12,3,9
Maybeexp,ravencrest,288,priest,discipline,12,3,9
Kalamh,marécage-de-zangar,288,priest,discipline,12,3,9
Декорий,soulflayer,288,priest,discipline,12,3,9
Yaaoz,dun-modr,288,priest,discipline,12,3,9
Crop,nemesis,288,priest,discipline,12,3,9
Хуанкарлосс,soulflayer,288,priest,discipline,12,3,9
Realdead,blackrock,288,priest,discipline,12,3,9
Momomomomomo,blackrock,288,priest,discipline,12,3,9
Recast,outland,288,priest,discipline,12,3,9
Èlvis,dun-morogh,288,priest,discipline,12,3,9
Fictus,tarren-mill,288,priest,discipline,18,3,15
Aldebrand,dun-modr,288,priest,discipline,24,3,21
Hulluh,tarren-mill,287,priest,discipline,6,3,3
Bunetu,blackmoore,287,priest,discipline,6,3,3
Xkv,blackmoore,287,priest,discipline,6,3,3
Eritreea,stormscale,287,priest,discipline,12,3,9
Fuwafuwaneko,sanguino,287,priest,discipline,12,3,9
Elraine,ravencrest,287,priest,discipline,12,3,9
Orioz,tarren-mill,287,priest,discipline,12,3,9
Tíffanny,ragnaros,287,priest,discipline,12,3,9
Rotems,korgall,287,priest,discipline,12,3,9
Sacabocaos,dun-modr,287,priest,discipline,12,3,9
Willibad,executus,286,priest,discipline,6,3,3
Lînda,steamwheedle-cartel,255,priest,discipline,11,3,8
Zlothax,blackrock,255,priest,discipline,11,3,8
Czee,draenor,255,priest,discipline,11,3,8
Alphakillerz,sanguino,255,priest,discipline,11,3,8
Kikoke,sanguino,240,priest,discipline,9,3,6
Sánta,blackmoore,240,priest,discipline,9,3,6
Yourholiness,rexxar,240,priest,discipline,9,3,6
Judine,kazzak,239,priest,discipline,5,3,2
Tyeldine,ragnaros,239,priest,discipline,9,4,5
Паратузов,gordunni,239,priest,discipline,29,3,26
Zargoss,sylvanas,234,priest,discipline,8,4,4
Zxèlá,tarren-mill,234,priest,discipline,13,6,7
Sologrifer,sylvanas,234,priest,discipline,9,4,5
Paandosa,outland,234,priest,discipline,9,4,5
Barbiemeth,silvermoon,234,priest,discipline,35,14,21
Katwizro,hyjal,234,priest,discipline,16,6,10
Mineshadow,argent-dawn,234,priest,discipline,11,4,7
Jael,frostmane,234,priest,discipline,14,4,10
Krakjak,twisting-nether,234,priest,discipline,15,4,11
Nÿpô,hyjal,234,priest,discipline,16,4,12
Пахад,blackscar,233,priest,discipline,9,4,5
Flexelzz,argent-dawn,227,priest,discipline,18,6,12
Tomoty,ravencrest,208,priest,discipline,7,3,4
Dutchstuff,karazhan,192,priest,discipline,4,3,1
Toxicx,aegwynn,192,priest,discipline,6,2,4
Calah,frostwhisper,192,priest,discipline,6,2,4
Saurap,uldum,192,priest,discipline,6,2,4
Ascindra,ravencrest,192,priest,discipline,6,2,4
Adägïo,dun-modr,192,priest,discipline,6,2,4
Jaduheart,ravencrest,192,priest,discipline,6,2,4
Proxsjr,ravencrest,192,priest,discipline,6,2,4
Nekros,agamaggan,192,priest,discipline,6,2,4
Seskip,stormreaver,192,priest,discipline,6,2,4
Clapclap,frostmourne,192,priest,discipline,6,2,4
Prodan,frostmane,192,priest,discipline,6,2,4
Idén,quelthalas,192,priest,discipline,6,2,4
Shadowlander,dun-modr,192,priest,discipline,6,2,4
Kasuny,outland,192,priest,discipline,6,2,4
Haiga,zuljin,192,priest,discipline,6,2,4
Tacøgxd,ravencrest,192,priest,discipline,6,2,4
Alamonte,darksorrow,192,priest,discipline,6,2,4
Elëctra,vashj,192,priest,discipline,6,2,4
Nálá,nethersturm,192,priest,discipline,6,2,4
Prîëstìtütê,doomhammer,192,priest,discipline,6,2,4
Míriêl,blackhand,192,priest,discipline,6,2,4
Perrín,blackrock,192,priest,discipline,6,2,4
Lirrydoz,ravencrest,192,priest,discipline,6,2,4
Simplesam,ravencrest,192,priest,discipline,6,2,4
Methslinger,draenor,192,priest,discipline,6,2,4
Aidkit,burning-legion,192,priest,discipline,6,2,4
Radulfus,stormrage,192,priest,discipline,6,2,4
Yacine,blackrock,192,priest,discipline,6,2,4
Mehhx,burning-legion,192,priest,discipline,6,2,4
Колдунская,soulflayer,192,priest,discipline,6,2,4
Merk,kazzak,192,priest,discipline,6,2,4
Фадб,howling-fjord,192,priest,discipline,6,2,4
Titiqr,naxxramas,192,priest,discipline,6,2,4
Tokkzz,ragnaros,192,priest,discipline,6,2,4
Maleapriest,blackhand,192,priest,discipline,6,2,4
Zxø,ravencrest,192,priest,discipline,6,2,4
Maquivel,aggra-português,192,priest,discipline,6,2,4
Kyojin,pozzo-delleternità,192,priest,discipline,6,2,4
Skytheory,eredar,192,priest,discipline,6,2,4
Уци,howling-fjord,192,priest,discipline,6,2,4
Superogór,burning-legion,192,priest,discipline,6,2,4
Coldxzera,tarren-mill,192,priest,discipline,6,2,4
Scrotoepalle,nemesis,192,priest,discipline,6,2,4
Kaamiluus,burning-legion,192,priest,discipline,6,2,4
Lenanitro,blackrock,192,priest,discipline,6,2,4
Insufrible,minahonda,192,priest,discipline,6,2,4
Dontouch,nemesis,192,priest,discipline,6,2,4
Upsbro,outland,192,priest,discipline,6,2,4
Jaheim,tarren-mill,192,priest,discipline,6,2,4
Jäý,ravencrest,192,priest,discipline,6,2,4
Touddixz,blackrock,192,priest,discipline,6,2,4
Mcpriestgodx,blackrock,192,priest,discipline,6,2,4
Clastro,outland,192,priest,discipline,6,2,4
Menie,draenor,192,priest,discipline,6,2,4
Uncleben,grim-batol,192,priest,discipline,6,2,4
Somai,aegwynn,192,priest,discipline,6,2,4
Prällë,draenor,192,priest,discipline,6,2,4
Cptmoigx,antonidas,192,priest,discipline,6,2,4
Groaxx,ragnaros,192,priest,discipline,6,2,4
Bigpinkballs,tarren-mill,192,priest,discipline,6,2,4
Тейдехан,howling-fjord,192,priest,discipline,6,2,4
Kironm,kazzak,192,priest,discipline,6,2,4
Qku,ravencrest,192,priest,discipline,6,2,4
Sophoula,silvermoon,192,priest,discipline,6,2,4
Katrynax,ravencrest,192,priest,discipline,6,2,4
Stanyú,tarren-mill,192,priest,discipline,6,2,4
Winlove,outland,192,priest,discipline,6,2,4
Piedl,aegwynn,192,priest,discipline,6,2,4
Rallzken,stormscale,192,priest,discipline,6,2,4
Sachikø,sylvanas,192,priest,discipline,6,2,4
Aridarpriest,silvermoon,192,priest,discipline,6,2,4
Rickermortis,defias-brotherhood,192,priest,discipline,6,2,4
Sipriest,silvermoon,192,priest,discipline,6,2,4
Zhest,nemesis,192,priest,discipline,6,2,4
Mcx,stormscale,192,priest,discipline,6,2,4
Axyze,draenor,192,priest,discipline,6,2,4
Sebiarchie,lightnings-blade,192,priest,discipline,6,2,4
Jupiminaj,tarren-mill,192,priest,discipline,6,2,4
Tofsy,stormscale,192,priest,discipline,6,2,4
Mlii,the-maelstrom,192,priest,discipline,6,2,4
Fadehojwnabe,the-shatar,192,priest,discipline,6,2,4
Emabi,tarren-mill,192,priest,discipline,6,2,4
Numa,stormscale,192,priest,discipline,6,2,4
Ичисанчик,howling-fjord,192,priest,discipline,6,2,4
Spectriums,twisting-nether,192,priest,discipline,6,2,4
Servaas,silvermoon,192,priest,discipline,6,2,4
Grduebel,tirion,192,priest,discipline,6,2,4
Mqsx,stormscale,192,priest,discipline,6,2,4
Zoose,silvermoon,192,priest,discipline,6,2,4
Unreal,nagrand,192,priest,discipline,6,2,4
Izaa,silvermoon,192,priest,discipline,6,2,4
Jell,stormscale,192,priest,discipline,6,2,4
Артэта,blackscar,192,priest,discipline,6,2,4
Quintanaro,thrall,192,priest,discipline,6,2,4
Soreboners,stormscale,192,priest,discipline,6,2,4
Pristara,bloodhoof,192,priest,discipline,6,2,4
Calling,nozdormu,192,priest,discipline,6,2,4
Маджори,azuregos,192,priest,discipline,6,2,4
Célaz,blackmoore,192,priest,discipline,6,2,4
Remyy,jaedenar,192,priest,discipline,6,2,4
Ниомана,gordunni,192,priest,discipline,6,2,4
Draconux,terenas,192,priest,discipline,6,2,4
Protege,shadowsong,192,priest,discipline,6,2,4
Derathon,eredar,192,priest,discipline,6,2,4
Phantombride,silvermoon,192,priest,discipline,6,2,4
Ægirl,chamber-of-aspects,192,priest,discipline,6,2,4
Discolata,silvermoon,192,priest,discipline,6,2,4
Shaomi,eldrethalas,192,priest,discipline,6,2,4
Dènna,eldrethalas,192,priest,discipline,6,2,4
Quvi,frostwolf,192,priest,discipline,6,2,4
Tiefergelegt,arthas,192,priest,discipline,6,2,4
Hormgal,blackmoore,192,priest,discipline,6,2,4
Wumtris,ragnaros,192,priest,discipline,6,2,4
Tinúvielle,dalaran,192,priest,discipline,6,2,4
Vanadii,blackhand,192,priest,discipline,6,2,4
Amayko,kazzak,192,priest,discipline,6,2,4
Ponting,kazzak,192,priest,discipline,6,2,4
Giesix,frostwolf,192,priest,discipline,6,2,4
Anvena,elune,192,priest,discipline,6,2,4
Ilovedomo,stormscale,192,priest,discipline,6,2,4
Ølle,ravencrest,192,priest,discipline,6,2,4
Braingames,kazzak,192,priest,discipline,6,2,4
Kopfsache,blackmoore,192,priest,discipline,6,2,4
Shalabox,twisting-nether,192,priest,discipline,6,2,4
Missright,ragnaros,192,priest,discipline,6,2,4
Susee,nozdormu,192,priest,discipline,6,2,4
Taschigi,rexxar,192,priest,discipline,6,2,4
Mertérésa,hyjal,192,priest,discipline,6,2,4
Zéró,gorgonnash,192,priest,discipline,6,2,4
Chópsuey,stormscale,192,priest,discipline,6,2,4
Dqt,ragnaros,192,priest,discipline,6,2,4
Hoon,destromath,192,priest,discipline,6,2,4
Reckxp,twisting-nether,192,priest,discipline,6,2,4
Рэпру,galakrond,192,priest,discipline,6,2,4
Flayin,kazzak,192,priest,discipline,7,2,5
Uwuslayerx,stormscale,192,priest,discipline,7,2,5
Meatyshaft,doomhammer,192,priest,discipline,11,3,8
Иванвай,soulflayer,192,priest,discipline,9,2,7
Balan,argent-dawn,192,priest,discipline,12,2,10
Ulfsarkaom,turalyon,192,priest,discipline,12,2,10
Petjouli,darksorrow,192,priest,discipline,12,2,10
Zêlða,ravencrest,192,priest,discipline,12,2,10
Miind,tarren-mill,192,priest,discipline,12,2,10
Xlia,argent-dawn,192,priest,discipline,12,2,10
Norah,kirin-tor,192,priest,discipline,12,2,10
Chizu,alakir,192,priest,discipline,12,2,10
Trickfulzqt,stormscale,192,priest,discipline,12,2,10
Zubrowkâ,kazzak,192,priest,discipline,12,2,10
Sybred,tarren-mill,192,priest,discipline,12,2,10
Sevinho,twisting-nether,192,priest,discipline,12,2,10
Shadowp,aegwynn,192,priest,discipline,12,2,10
Slikjar,stormscale,192,priest,discipline,12,2,10
Shacoat,draenor,192,priest,discipline,12,2,10
Xblue,outland,192,priest,discipline,12,2,10
Nigellä,azjolnerub,192,priest,discipline,12,2,10
Dîablø,eredar,192,priest,discipline,12,2,10
Adallon,blackmoore,192,priest,discipline,12,2,10
Chenandler,aggra-português,192,priest,discipline,12,2,10
Лилинтель,gordunni,192,priest,discipline,12,2,10
Xhortas,thrall,192,priest,discipline,18,2,16
Zinary,silvermoon,192,priest,discipline,18,2,16
Adolosh,thrall,191,priest,discipline,6,2,4
Daria,teldrassil,191,priest,discipline,12,2,10
Wigo,twisting-nether,175,priest,discipline,11,2,9
Smyx,blackhand,159,priest,discipline,5,2,3
Munche,blackmoore,159,priest,discipline,5,2,3
Galpriest,tarren-mill,159,priest,discipline,5,2,3
Keizir,hyjal,144,priest,discipline,3,3,0
Djem,argent-dawn,144,priest,discipline,3,3,0
Sotanax,khazgoroth,144,priest,discipline,9,2,7
Discopriestt,outland,144,priest,discipline,9,2,7
Roqu,ravencrest,143,priest,discipline,3,3,0
Magister,sanguino,138,priest,discipline,9,4,5
Xire,outland,138,priest,discipline,8,3,5
Ohhowpretty,ravencrest,138,priest,discipline,11,4,7
Majestíc,blackmoore,138,priest,discipline,9,3,6
Шорон,howling-fjord,138,priest,discipline,11,3,8
Kitazu,draenor,138,priest,discipline,15,3,12
Rushax,ravencrest,137,priest,discipline,7,3,4
Xakala,cthun,137,priest,discipline,13,3,10
Darzul,conseil-des-ombres,127,priest,discipline,8,2,6
Lucerna,defias-brotherhood,112,priest,discipline,7,2,5
Sdw,kargath,96,priest,discipline,3,2,1
Gojó,outland,96,priest,discipline,3,2,1
Midy,drakthul,96,priest,discipline,3,2,1
Wizzp,magtheridon,96,priest,discipline,9,2,7
Guiliman,chamber-of-aspects,96,priest,discipline,11,2,9
Oöm,hyjal,96,priest,discipline,6,1,5
Miraçlê,kazzak,96,priest,discipline,6,1,5
Лисовен,blackscar,96,priest,discipline,6,1,5
Dami,defias-brotherhood,96,priest,discipline,6,1,5
Senkín,aegwynn,96,priest,discipline,6,1,5
Supfamskrrt,stormscale,96,priest,discipline,6,1,5
Menjo,silvermoon,96,priest,discipline,6,1,5
Idontknow,sanguino,96,priest,discipline,6,1,5
Missah,archimonde,96,priest,discipline,6,1,5
Iololololxd,eredar,96,priest,discipline,6,1,5
Réaper,twilights-hammer,96,priest,discipline,6,1,5
Namï,darksorrow,96,priest,discipline,6,1,5
Yixi,blackmoore,96,priest,discipline,6,1,5
Nakrga,twisting-nether,96,priest,discipline,6,1,5
Erkay,kazzak,96,priest,discipline,6,1,5
Récko,blackmoore,96,priest,discipline,6,1,5
Xyret,blackmoore,96,priest,discipline,6,1,5
Cysco,blackmoore,96,priest,discipline,6,1,5
Redblue,onyxia,96,priest,discipline,6,1,5
Шишищ,gordunni,96,priest,discipline,6,1,5
Larisä,uldum,96,priest,discipline,6,1,5
Марриаза,blackscar,96,priest,discipline,6,1,5
Йоййо,gordunni,96,priest,discipline,6,1,5
Tîwele,dalvengyr,96,priest,discipline,6,1,5
Sprife,ragnaros,96,priest,discipline,6,1,5
Broncos,twisting-nether,96,priest,discipline,6,1,5
Liendro,stormscale,96,priest,discipline,6,1,5
Sayala,dalaran,96,priest,discipline,6,1,5
Teleriah,blackmoore,96,priest,discipline,6,1,5
Peez,stormscale,96,priest,discipline,6,1,5
Cptncarrot,blackmoore,96,priest,discipline,6,1,5
Kangkong,ravencrest,96,priest,discipline,6,1,5
Snullerheals,kazzak,96,priest,discipline,6,1,5
Imhotép,anubarak,96,priest,discipline,6,1,5
Krazuk,theradras,96,priest,discipline,6,1,5
Xälis,ysondre,96,priest,discipline,6,1,5
Stickpas,ysondre,96,priest,discipline,6,1,5
Filit,hyjal,96,priest,discipline,6,1,5
Libertero,drakthul,96,priest,discipline,6,1,5
Rachelsz,ravencrest,96,priest,discipline,6,1,5
Aprima,culte-de-la-rive-noire,96,priest,discipline,6,1,5
Skitzypriest,stormscale,96,priest,discipline,6,1,5
Elessee,the-maelstrom,96,priest,discipline,6,1,5
Holzí,frostmourne,96,priest,discipline,6,1,5
Jônb,tarren-mill,96,priest,discipline,6,1,5
Dionegativ,draenor,96,priest,discipline,6,1,5
Dominos,thrall,96,priest,discipline,6,1,5
Caramello,stormscale,96,priest,discipline,6,1,5
Lyssandre,stormreaver,96,priest,discipline,6,1,5
Немонте,gordunni,96,priest,discipline,6,1,5
Ascendare,tarren-mill,96,priest,discipline,6,1,5
Скартэикс,howling-fjord,96,priest,discipline,6,1,5
Миррен,gordunni,96,priest,discipline,6,1,5
Æsia,archimonde,96,priest,discipline,6,1,5
Pellé,stormscale,96,priest,discipline,6,1,5
Sonyl,les-sentinelles,96,priest,discipline,6,1,5
Darthdots,outland,96,priest,discipline,6,1,5
Mojotore,blackhand,96,priest,discipline,6,1,5
Leykop,ravencrest,96,priest,discipline,6,1,5
Ildïmnöll,drakthul,96,priest,discipline,6,1,5
Teri,taerar,96,priest,discipline,6,1,5
Iovely,stormscale,96,priest,discipline,6,1,5
Героиннарбг,soulflayer,96,priest,discipline,6,1,5
Idjut,kazzak,96,priest,discipline,6,1,5
Sende,tarren-mill,96,priest,discipline,6,1,5
Yogastretch,ravencrest,96,priest,discipline,6,1,5
Хоббитсон,soulflayer,96,priest,discipline,6,1,5
Madcole,blackhand,96,priest,discipline,6,1,5
Myxeh,ravencrest,96,priest,discipline,6,1,5
Hoeneygodx,antonidas,96,priest,discipline,6,1,5
Promiqt,drakthul,96,priest,discipline,6,1,5
Töxìc,outland,96,priest,discipline,6,1,5
Joncartagena,sanguino,96,priest,discipline,6,1,5
Жрецдуши,gordunni,96,priest,discipline,6,1,5
Pristürk,burning-legion,96,priest,discipline,6,1,5
Бидоноприст,fordragon,96,priest,discipline,6,1,5
Shinesomnya,aegwynn,96,priest,discipline,6,1,5
Nondi,frostmane,96,priest,discipline,6,1,5
Оумега,gordunni,96,priest,discipline,6,1,5
Listenlisten,archimonde,96,priest,discipline,6,1,5
Olqp,tarren-mill,96,priest,discipline,6,1,5
Aggresivdisc,hyjal,96,priest,discipline,6,1,5
Vampirito,ragnaros,96,priest,discipline,6,1,5
Jaimee,zirkel-des-cenarius,96,priest,discipline,6,1,5
Æphilis,outland,96,priest,discipline,6,1,5
Крашдайс,soulflayer,96,priest,discipline,6,1,5
Pera,nemesis,96,priest,discipline,12,1,11
Sorprendente,cthun,96,priest,discipline,12,1,11
Epokalarm,ragnaros,96,priest,discipline,12,1,11
Kelarai,azjolnerub,96,priest,discipline,12,1,11
Ccatchme,sylvanas,96,priest,discipline,18,1,17
Elián,silvermoon,79,priest,discipline,5,1,4
Priestin,dun-modr,79,priest,discipline,5,1,4
Tiinia,hyjal,74,priest,discipline,13,3,10
Tronte,dun-modr,64,priest,discipline,4,1,3
Faithful,emerald-dream,64,priest,discipline,8,1,7
Jaimeê,der-rat-von-dalaran,63,priest,discipline,2,2,0
Chooser,stormscale,63,priest,discipline,8,2,6
Bossku,kazzak,48,priest,discipline,3,1,2
Piacolada,aegwynn,48,priest,discipline,3,1,2
Pushup,drakthul,48,priest,discipline,3,1,2
Triip,argent-dawn,42,priest,discipline,7,2,5
Хаахаахаа,gordunni,42,priest,discipline,11,3,8
Hekro,thrall,42,priest,discipline,8,2,6
Ronk,outland,42,priest,discipline,9,2,7
Xxddxd,draenor,42,priest,discipline,17,3,14
Vileehnius,alleria,42,priest,discipline,17,2,15
Hanic,kazzak,2326,priest,shadow,92,57,35
Yggdra,ragnaros,2229,priest,shadow,66,44,22
Dbeezy,tarren-mill,2217,priest,shadow,100,53,47
Хедмэнмвп,gordunni,2203,priest,shadow,156,80,76
Tentoumushi,ravencrest,2153,priest,shadow,72,42,30
Dollyboo,tarren-mill,2152,priest,shadow,125,77,48
Ilovemycat,silvermoon,2152,priest,shadow,78,47,31
Permafeetup,aegwynn,2151,priest,shadow,78,45,33
Shåmssv,kazzak,2146,priest,shadow,72,41,31
Cheesecake,defias-brotherhood,2143,priest,shadow,78,47,31
Crainoo,ravencrest,2137,priest,shadow,158,80,78
Blacktrain,burning-blade,2136,priest,shadow,118,60,58
Даняпампгодх,soulflayer,2127,priest,shadow,170,86,84
Syedi,drakthul,2126,priest,shadow,147,72,75
Rrj,ravencrest,2124,priest,shadow,82,51,31
Xsß,dun-modr,2116,priest,shadow,107,59,48
Voidfi,kult-der-verdammten,2111,priest,shadow,114,64,50
Rzkp,eredar,2110,priest,shadow,93,50,43
Yuzuflex,hyjal,2110,priest,shadow,81,43,38
Standtall,blackrock,2109,priest,shadow,108,57,51
Sphero,earthen-ring,2101,priest,shadow,130,73,57
Сделайсам,gordunni,2100,priest,shadow,99,55,44
Èxtêrmìnätör,kazzak,2083,priest,shadow,78,43,35
Purpl,tarren-mill,2076,priest,shadow,138,75,63
Bönfire,silvermoon,2075,priest,shadow,140,73,67
Stjärtsten,tarren-mill,2064,priest,shadow,183,107,76
Walterwhite,stormscale,2059,priest,shadow,66,36,30
Notsoholy,blackmoore,2056,priest,shadow,60,37,23
Nousey,twisting-nether,2045,priest,shadow,72,42,30
Justtpro,twisting-nether,2043,priest,shadow,140,88,52
Pu,outland,2039,priest,shadow,90,43,47
Миладиель,gordunni,2033,priest,shadow,101,52,49
Thanatae,kazzak,2030,priest,shadow,79,44,35
Bidraget,ravencrest,2024,priest,shadow,60,38,22
Pepeshadow,twisting-nether,2020,priest,shadow,93,48,45
Deathlý,blackrock,2013,priest,shadow,72,39,33
Destinyhero,aegwynn,2007,priest,shadow,87,44,43
Mérce,kazzak,1991,priest,shadow,60,36,24
Heal,hyjal,1990,priest,shadow,230,131,99
Zhadum,stormscale,1990,priest,shadow,107,57,50
Rzktwo,eredar,1988,priest,shadow,59,33,26
Sethÿr,sanguino,1982,priest,shadow,126,66,60
Rnkz,sanguino,1961,priest,shadow,66,41,25
Gorholm,argent-dawn,1956,priest,shadow,70,45,25
Infuséd,aegwynn,1956,priest,shadow,54,30,24
Moretti,ravencrest,1953,priest,shadow,54,32,22
Prøphetx,thrall,1945,priest,shadow,141,73,68
Zoodiacp,blackrock,1944,priest,shadow,64,34,30
Vaccineboost,silvermoon,1944,priest,shadow,84,40,44
Dhurza,shendralar,1938,priest,shadow,66,39,27
Bréézee,ravencrest,1938,priest,shadow,65,33,32
Rãpidi,hyjal,1932,priest,shadow,89,56,33
Buøbuarns,sanguino,1930,priest,shadow,63,31,32
Айсиоу,howling-fjord,1929,priest,shadow,42,26,16
Lâughing,ravencrest,1928,priest,shadow,61,35,26
Бвонсаамди,soulflayer,1928,priest,shadow,131,70,61
Akibom,drakthul,1925,priest,shadow,53,34,19
Devoura,sylvanas,1924,priest,shadow,48,31,17
Estragon,quelthalas,1912,priest,shadow,75,40,35
Dippy,blackrock,1910,priest,shadow,42,27,15
Slimcharles,ravencrest,1902,priest,shadow,66,40,26
Hansmaul,thrall,1897,priest,shadow,36,20,16
Медовыедотки,soulflayer,1894,priest,shadow,66,33,33
Польскийбуль,gordunni,1892,priest,shadow,54,32,22
Døubtful,kazzak,1890,priest,shadow,36,20,16
Эсдаль,howling-fjord,1889,priest,shadow,60,41,19
Shádówý,kazzak,1889,priest,shadow,36,20,16
Melábufeis,dun-modr,1887,priest,shadow,60,34,26
Хьёх,blackscar,1882,priest,shadow,54,33,21
Qoryn,ravencrest,1882,priest,shadow,42,25,17
Genjutzux,kazzak,1882,priest,shadow,54,32,22
Heffer,outland,1880,priest,shadow,93,58,35
Бхонсамди,blackscar,1872,priest,shadow,65,40,25
Drarianna,nemesis,1868,priest,shadow,30,22,8
Liptonolda,blackhand,1867,priest,shadow,48,29,19
Knútx,stormscale,1867,priest,shadow,60,30,30
Râvyn,silvermoon,1866,priest,shadow,44,35,9
Pandacore,frostmane,1864,priest,shadow,54,28,26
Simôc,eredar,1864,priest,shadow,60,31,29
Maryhugette,archimonde,1864,priest,shadow,102,51,51
Weekfortyone,blackhand,1864,priest,shadow,56,27,29
Perché,silvermoon,1863,priest,shadow,54,39,15
Ptxd,alakir,1862,priest,shadow,52,35,17
Zuhä,twisting-nether,1861,priest,shadow,60,34,26
Angsty,blackrock,1860,priest,shadow,52,30,22
Léandrä,magtheridon,1860,priest,shadow,60,28,32
Xayona,argent-dawn,1858,priest,shadow,54,26,28
Milkysmite,twisting-nether,1856,priest,shadow,52,32,20
Ансор,lich-king,1856,priest,shadow,89,50,39
Iodjsaiojoij,kazzak,1856,priest,shadow,54,30,24
Rockness,blackmoore,1854,priest,shadow,131,88,43
Tremrfinger,dun-modr,1853,priest,shadow,86,50,36
Термидор,booty-bay,1851,priest,shadow,83,52,31
Atahalni,argent-dawn,1850,priest,shadow,90,45,45
Physxd,blackrock,1848,priest,shadow,36,28,8
Dingopriest,blackrock,1848,priest,shadow,78,46,32
Either,kazzak,1848,priest,shadow,65,36,29
Animesenpai,kazzak,1847,priest,shadow,60,32,28
Versio,dalvengyr,1847,priest,shadow,54,28,26
Akolyte,blackmoore,1843,priest,shadow,36,22,14
Trisks,ravencrest,1843,priest,shadow,34,20,14
Шадоупуз,soulflayer,1843,priest,shadow,47,22,25
Пристатеист,howling-fjord,1842,priest,shadow,72,35,37
Theoniss,draenor,1841,priest,shadow,90,54,36
Sÿrax,ysondre,1839,priest,shadow,49,29,20
Синфал,blackscar,1839,priest,shadow,66,31,35
Arendt,blackhand,1837,priest,shadow,48,29,19
Sadix,ravencrest,1835,priest,shadow,66,38,28
Безрассудица,howling-fjord,1834,priest,shadow,55,29,26
Ымц,gordunni,1832,priest,shadow,66,33,33
Schmetter,tarren-mill,1829,priest,shadow,65,29,36
Selëne,blackrock,1827,priest,shadow,72,43,29
Megamann,dun-morogh,1827,priest,shadow,54,32,22
Игорянатакуе,eversong,1826,priest,shadow,154,86,68
Rakamain,ravencrest,1825,priest,shadow,48,31,17
Anateoris,turalyon,1825,priest,shadow,76,43,33
Quezaris,stormscale,1825,priest,shadow,48,23,25
Nyotux,blackrock,1824,priest,shadow,66,45,21
Cantsqell,silvermoon,1823,priest,shadow,48,34,14
Ûñträînablê,outland,1822,priest,shadow,48,34,14
Swdjkbad,kazzak,1822,priest,shadow,47,28,19
Староезло,gordunni,1821,priest,shadow,68,33,35
Yirico,argent-dawn,1820,priest,shadow,47,31,16
Ekkfwiedrice,ragnaros,1818,priest,shadow,42,29,13
Marbellexd,pozzo-delleternità,1818,priest,shadow,157,91,66
Voidshuffle,laughing-skull,1818,priest,shadow,42,24,18
Raikup,ravencrest,1816,priest,shadow,41,19,22
Zodzín,ragnaros,1815,priest,shadow,36,19,17
Theunknown,thrall,1814,priest,shadow,42,30,12
Luvlyrah,draenor,1812,priest,shadow,81,52,29
Namsolo,kazzak,1811,priest,shadow,78,42,36
Mafiasnipers,ravencrest,1810,priest,shadow,30,19,11
Shiannâ,malganis,1810,priest,shadow,38,21,17
Skillmåsterx,ravencrest,1810,priest,shadow,54,29,25
Gymbró,kazzak,1809,priest,shadow,54,31,23
Garycash,outland,1809,priest,shadow,88,47,41
Necrofeel,silvermoon,1807,priest,shadow,30,20,10
Salkerer,stormscale,1807,priest,shadow,30,19,11
Sepharis,runetotem,1807,priest,shadow,179,107,72
Becknarbritt,stormscale,1807,priest,shadow,196,115,81
Синатро,deathguard,1806,priest,shadow,190,119,71
Snarks,sylvanas,1806,priest,shadow,36,20,16
Galatea,les-sentinelles,1805,priest,shadow,78,44,34
Vajainap,outland,1804,priest,shadow,30,19,11
Mataî,kazzak,1803,priest,shadow,84,49,35
Minblock,sanguino,1802,priest,shadow,36,19,17
Margots,kazzak,1802,priest,shadow,42,22,20
Mizulol,ravencrest,1801,priest,shadow,80,42,38
Ottii,thrall,1798,priest,shadow,47,29,18
Homxcxde,ravencrest,1794,priest,shadow,42,24,18
Nanna,agamaggan,1793,priest,shadow,36,19,17
Djops,outland,1792,priest,shadow,78,41,37
Magicstarss,the-maelstrom,1783,priest,shadow,72,38,34
Erenndriel,twisting-nether,1778,priest,shadow,60,36,24
Yêl,thrall,1778,priest,shadow,167,95,72
Klosso,anachronos,1777,priest,shadow,132,63,69
Raisedbyrap,blackrock,1776,priest,shadow,54,32,22
Трейдарк,blackscar,1769,priest,shadow,54,28,26
Bigdogone,arathor,1758,priest,shadow,42,24,18
Darthmantle,silvermoon,1758,priest,shadow,59,29,30
Ninjajane,sylvanas,1753,priest,shadow,53,32,21
Backpedaling,kazzak,1750,priest,shadow,60,28,32
Akroama,archimonde,1744,priest,shadow,86,41,45
Staljon,burning-legion,1742,priest,shadow,54,32,22
Cnsnn,ysondre,1741,priest,shadow,90,61,29
Ecquidozx,ravencrest,1741,priest,shadow,35,19,16
Zindrix,silvermoon,1737,priest,shadow,72,41,31
Blóódfart,kazzak,1736,priest,shadow,59,25,34
Lindp,stormreaver,1732,priest,shadow,66,42,24
Ankî,aegwynn,1731,priest,shadow,78,42,36
Hasa,stormreaver,1730,priest,shadow,66,36,30
Smxkÿÿ,eredar,1729,priest,shadow,36,25,11
Zhyn,turalyon,1729,priest,shadow,110,65,45
Iessei,outland,1729,priest,shadow,36,21,15
Ounxx,blackrock,1723,priest,shadow,29,21,8
Ксерф,soulflayer,1723,priest,shadow,114,58,56
Johnnybanana,argent-dawn,1722,priest,shadow,30,21,9
Claritycraft,twisting-nether,1720,priest,shadow,30,18,12
Всезнайка,soulflayer,1715,priest,shadow,114,61,53
Перекованный,soulflayer,1713,priest,shadow,105,57,48
Æßsåløønå,la-croisade-écarlate,1712,priest,shadow,30,18,12
Zeythz,ravencrest,1711,priest,shadow,108,63,45
Yoe,twisting-nether,1707,priest,shadow,36,18,18
Dakotapriest,ravencrest,1706,priest,shadow,30,18,12
Dümbledore,aggra-português,1704,priest,shadow,24,18,6
Tbs,sylvanas,1704,priest,shadow,83,48,35
Facemeltina,kiljaeden,1704,priest,shadow,36,18,18
Helín,hellfire,1702,priest,shadow,84,48,36
Ezlife,blackrock,1702,priest,shadow,54,25,29
Ageyr,ragnaros,1701,priest,shadow,53,34,19
Mackings,the-maelstrom,1699,priest,shadow,76,43,33
Kylähullu,ravencrest,1698,priest,shadow,56,30,26
Фиброз,blackscar,1695,priest,shadow,90,53,37
Goodsuck,tarren-mill,1693,priest,shadow,48,27,21
Rasha,kazzak,1692,priest,shadow,44,28,16
Imaut,emerald-dream,1692,priest,shadow,34,20,14
Кломми,gordunni,1688,priest,shadow,66,35,31
Kêrrýgold,blackrock,1686,priest,shadow,91,54,37
Dotreveal,ravencrest,1686,priest,shadow,36,21,15
Mojibien,burning-legion,1683,priest,shadow,98,57,41
Víppe,stormreaver,1682,priest,shadow,53,32,21
Geløpr,eredar,1681,priest,shadow,36,23,13
Momomomomomo,blackrock,1681,priest,shadow,84,46,38
Kiesp,tarren-mill,1678,priest,shadow,30,20,10
Sheto,burning-legion,1668,priest,shadow,132,67,65
Tsunadesaama,silvermoon,1666,priest,shadow,51,26,25
Liloz,eredar,1662,priest,shadow,42,21,21
Tosem,antonidas,1661,priest,shadow,30,19,11
Strunkiin,defias-brotherhood,1658,priest,shadow,66,39,27
Киндзер,blackscar,1658,priest,shadow,54,29,25
Buffholy,dun-modr,1657,priest,shadow,60,36,24
Ølle,ravencrest,1655,priest,shadow,36,21,15
Skeida,bloodhoof,1655,priest,shadow,35,18,17
Anexxia,outland,1654,priest,shadow,42,20,22
Máv,tarren-mill,1653,priest,shadow,66,38,28
Финдовский,gordunni,1649,priest,shadow,102,54,48
Ruhe,silvermoon,1648,priest,shadow,48,27,21
Cdplz,archimonde,1647,priest,shadow,30,20,10
Insaniro,argent-dawn,1647,priest,shadow,42,25,17
Djariisimp,tarren-mill,1643,priest,shadow,36,21,15
Barthólomew,doomhammer,1642,priest,shadow,40,21,19
Weebi,silvermoon,1640,priest,shadow,65,39,26
Milo,argent-dawn,1640,priest,shadow,102,61,41
Priestfive,stormscale,1638,priest,shadow,48,28,20
Mikizu,die-aldor,1638,priest,shadow,42,21,21
Dezerta,nozdormu,1636,priest,shadow,74,39,35
Levitation,alakir,1635,priest,shadow,60,35,25
Undefined,chamber-of-aspects,1634,priest,shadow,40,28,12
Казуямисима,gordunni,1634,priest,shadow,128,69,59
Lênax,arthas,1633,priest,shadow,40,23,17
Дикаях,gordunni,1633,priest,shadow,106,51,55
Тарренмилл,gordunni,1632,priest,shadow,42,23,19
Jaimë,ravencrest,1630,priest,shadow,30,17,13
Ðanilox,dun-modr,1629,priest,shadow,24,17,7
Donenigma,stormscale,1628,priest,shadow,36,23,13
Билетлолпро,borean-tundra,1627,priest,shadow,30,17,13
Milania,ravencrest,1624,priest,shadow,30,21,9
Трубишоп,howling-fjord,1624,priest,shadow,76,38,38
Empz,thrall,1623,priest,shadow,95,44,51
Affex,tarren-mill,1622,priest,shadow,30,18,12
Tacøgxd,ravencrest,1621,priest,shadow,30,21,9
Asterixsu,sylvanas,1619,priest,shadow,36,25,11
Офелла,howling-fjord,1617,priest,shadow,174,96,78
Toesxcker,stormscale,1616,priest,shadow,35,21,14
Priestazie,madmortem,1616,priest,shadow,96,57,39
Клаима,soulflayer,1615,priest,shadow,49,28,21
Kamish,twisting-nether,1615,priest,shadow,84,44,40
Mehtz,ravencrest,1615,priest,shadow,186,90,96
Knoffp,blackhand,1614,priest,shadow,72,41,31
Megajuicy,blackmoore,1614,priest,shadow,120,67,53
Unerfedsp,archimonde,1613,priest,shadow,87,42,45
Скайвэйуокер,howling-fjord,1611,priest,shadow,30,19,11
Ревентонх,howling-fjord,1611,priest,shadow,136,75,61
Baldracca,shendralar,1610,priest,shadow,72,39,33
Nabøøbies,blackmoore,1607,priest,shadow,32,18,14
Tùcøcø,archimonde,1607,priest,shadow,48,21,27
Æäõ,turalyon,1604,priest,shadow,36,19,17
Kujiua,ravencrest,1603,priest,shadow,55,28,27
Basicpr,ravencrest,1601,priest,shadow,45,30,15
Voodkaa,drakthul,1601,priest,shadow,39,22,17
Sudeki,blackmoore,1601,priest,shadow,42,20,22
Toba,hellscream,1600,priest,shadow,42,23,19
Llothx,ravencrest,1597,priest,shadow,62,34,28
Babarøqa,blackmoore,1592,priest,shadow,151,79,72
Vatikanet,ravencrest,1589,priest,shadow,81,49,32
Pombär,ragnaros,1587,priest,shadow,54,36,18
Mightyfool,aegwynn,1586,priest,shadow,60,32,28
Hellscon,kazzak,1584,priest,shadow,80,41,39
Faminé,outland,1584,priest,shadow,65,29,36
Spamplague,stormscale,1583,priest,shadow,36,20,16
Mukkin,tarren-mill,1578,priest,shadow,36,22,14
Milamati,kazzak,1576,priest,shadow,60,28,32
Бомжскадилом,gordunni,1573,priest,shadow,30,19,11
Charmebolzen,blackrock,1571,priest,shadow,36,18,18
Absolution,stormscale,1570,priest,shadow,185,99,86
Xooxl,ragnaros,1569,priest,shadow,84,52,32
Zászàsmaster,kazzak,1566,priest,shadow,90,54,36
Carmechanic,defias-brotherhood,1566,priest,shadow,30,18,12
Dazé,ravencrest,1563,priest,shadow,35,20,15
Рэнфан,fordragon,1558,priest,shadow,52,35,17
Cykdwojeczka,burning-legion,1558,priest,shadow,72,36,36
Lowisa,sylvanas,1556,priest,shadow,41,26,15
Эззи,soulflayer,1556,priest,shadow,90,50,40
Neitter,zuljin,1556,priest,shadow,54,29,25
Seneth,twisting-nether,1553,priest,shadow,60,31,29
Asträlaws,archimonde,1552,priest,shadow,40,20,20
Framesxøxø,ravencrest,1551,priest,shadow,30,18,12
Xangha,burning-legion,1551,priest,shadow,72,41,31
Spklooril,hyjal,1551,priest,shadow,205,103,102
Genthus,kazzak,1550,priest,shadow,66,34,32
Sháady,ravencrest,1549,priest,shadow,42,23,19
Skypray,burning-legion,1549,priest,shadow,48,26,22
Деплитфофан,gordunni,1548,priest,shadow,65,42,23
Imøteph,ragnaros,1546,priest,shadow,71,40,31
Sandcastles,ravencrest,1544,priest,shadow,66,42,24
Coupdekaraté,sylvanas,1543,priest,shadow,36,18,18
Hâicu,antonidas,1540,priest,shadow,60,38,22
Кхэрри,goldrinn,1540,priest,shadow,30,19,11
Амгар,galakrond,1540,priest,shadow,125,69,56
Ankhh,bloodscalp,1538,priest,shadow,72,33,39
Саксесфул,howling-fjord,1535,priest,shadow,97,53,44
Bøts,ravencrest,1534,priest,shadow,55,27,28
Yaboyboompie,blackrock,1533,priest,shadow,30,16,14
Valirda,twisting-nether,1533,priest,shadow,80,40,40
Йоййо,gordunni,1532,priest,shadow,58,32,26
Zekonja,doomhammer,1532,priest,shadow,82,42,40
Schizophrens,outland,1531,priest,shadow,24,16,8
Kightz,twisting-nether,1530,priest,shadow,63,32,31
Ðrwiz,ravencrest,1528,priest,shadow,30,16,14
Papie,kazzak,1527,priest,shadow,30,16,14
Räke,blackrock,1527,priest,shadow,36,16,20
Мишатемный,gordunni,1526,priest,shadow,42,25,17
Ктулсотум,soulflayer,1525,priest,shadow,28,17,11
Thmas,outland,1525,priest,shadow,71,32,39
Everdark,twisting-nether,1524,priest,shadow,114,61,53
Psycos,kazzak,1523,priest,shadow,66,33,33
Basxcbxtchx,ravencrest,1518,priest,shadow,24,16,8
Chrønös,hyjal,1515,priest,shadow,42,23,19
Umbralx,ragnaros,1513,priest,shadow,77,45,32
Selaria,magtheridon,1512,priest,shadow,30,16,14
Chinko,blackmoore,1509,priest,shadow,48,32,16
Beonin,tarren-mill,1508,priest,shadow,43,26,17
Hemaplex,dun-modr,1508,priest,shadow,35,21,14
Cylantharia,eredar,1506,priest,shadow,30,16,14
Dyshexia,bronze-dragonflight,1506,priest,shadow,60,30,30
Ormarn,twisting-nether,1503,priest,shadow,48,28,20
Vavulya,blackhand,1497,priest,shadow,40,24,16
Fiftyfives,hyjal,1496,priest,shadow,45,22,23
Bubbleup,defias-brotherhood,1494,priest,shadow,30,21,9
Blasphemiia,outland,1491,priest,shadow,72,44,28
Anathemas,draenor,1490,priest,shadow,30,22,8
Kajifoxi,frostmane,1490,priest,shadow,60,38,22
Raitwo,kazzak,1488,priest,shadow,47,22,25
Bercxu,ragnaros,1487,priest,shadow,60,34,26
Bierbändiger,blackhand,1487,priest,shadow,30,17,13
Kellen,burning-blade,1487,priest,shadow,142,79,63
Энвиньяттар,howling-fjord,1484,priest,shadow,29,19,10
Holyshadów,azjolnerub,1481,priest,shadow,60,29,31
Shinesomnya,aegwynn,1478,priest,shadow,40,23,17
Зонкк,thermaplugg,1477,priest,shadow,114,62,52
Lightform,twisting-nether,1476,priest,shadow,33,23,10
Massbimba,tarren-mill,1475,priest,shadow,41,19,22
Melanore,sylvanas,1474,priest,shadow,90,46,44
Pregrip,twisting-nether,1473,priest,shadow,43,21,22
Thawx,stormscale,1472,priest,shadow,30,16,14
Noremorze,ravencrest,1468,priest,shadow,89,50,39
Êttân,ravencrest,1467,priest,shadow,50,25,25
Lilakaii,chamber-of-aspects,1466,priest,shadow,60,30,30
Даняпампх,soulflayer,1460,priest,shadow,95,53,42
Nygel,kazzak,1459,priest,shadow,71,38,33
Adägïo,dun-modr,1458,priest,shadow,78,37,41
Tyene,voljin,1456,priest,shadow,64,37,27
Cinaedus,stormreaver,1449,priest,shadow,51,27,24
Zevulós,ravencrest,1449,priest,shadow,54,20,34
Багбери,eversong,1448,priest,shadow,145,80,65
Sanebassoff,kazzak,1447,priest,shadow,94,55,39
Palitox,kazzak,1439,priest,shadow,70,38,32
Ondskabsfuld,kazzak,1439,priest,shadow,30,15,15
Newkidx,draenor,1438,priest,shadow,24,15,9
Voidgodx,blackrock,1438,priest,shadow,30,15,15
Chaddius,stormscale,1437,priest,shadow,49,26,23
Snoopý,dun-modr,1437,priest,shadow,36,16,20
Lr,aszune,1436,priest,shadow,18,15,3
Taeraz,archimonde,1435,priest,shadow,24,15,9
Bownsamdi,tarren-mill,1434,priest,shadow,18,15,3
Miruh,malganis,1433,priest,shadow,47,34,13
Sebbepriest,twisting-nether,1433,priest,shadow,56,31,25
Cathrix,kazzak,1432,priest,shadow,24,15,9
Криптика,soulflayer,1432,priest,shadow,24,15,9
Smiles,burning-steppes,1430,priest,shadow,36,20,16
Yaoshih,draenor,1430,priest,shadow,53,28,25
Billybay,argent-dawn,1429,priest,shadow,18,15,3
Raspberrypíe,silvermoon,1428,priest,shadow,30,16,14
Kurzik,zuljin,1426,priest,shadow,23,18,5
Psycoscream,blackmoore,1426,priest,shadow,35,17,18
Jaimee,zirkel-des-cenarius,1425,priest,shadow,24,15,9
Dotsin,kazzak,1419,priest,shadow,113,56,57
Vhayna,kazzak,1417,priest,shadow,53,32,21
Cringelørd,alakir,1414,priest,shadow,30,20,10
Baptizer,nemesis,1413,priest,shadow,79,52,27
Nûtqt,archimonde,1413,priest,shadow,33,18,15
Энмунд,borean-tundra,1412,priest,shadow,30,21,9
Shopify,nagrand,1412,priest,shadow,30,15,15
Flayin,kazzak,1411,priest,shadow,48,29,19
Saintethérez,archimonde,1410,priest,shadow,45,30,15
Dopey,kazzak,1406,priest,shadow,24,17,7
Isusgaspodi,argent-dawn,1405,priest,shadow,78,45,33
Maxhima,defias-brotherhood,1404,priest,shadow,66,34,32
Meshen,ysondre,1403,priest,shadow,128,69,59
Experimentix,silvermoon,1402,priest,shadow,30,16,14
Nyróx,malganis,1402,priest,shadow,54,27,27
Voidbro,grim-batol,1401,priest,shadow,29,15,14
Celz,kazzak,1400,priest,shadow,24,15,9
Vedina,bronze-dragonflight,1399,priest,shadow,75,32,43
Nightshådøw,silvermoon,1398,priest,shadow,122,64,58
Apuessii,dun-modr,1396,priest,shadow,53,30,23
Shadowplay,theradras,1396,priest,shadow,36,15,21
Hoon,destromath,1395,priest,shadow,36,22,14
Sxynix,thrall,1394,priest,shadow,35,21,14
Rogmisa,cthun,1394,priest,shadow,48,28,20
Дэспира,howling-fjord,1391,priest,shadow,28,16,12
Mozahn,ragnaros,1391,priest,shadow,33,16,17
Ваккарий,gordunni,1389,priest,shadow,58,35,23
Squîzz,archimonde,1389,priest,shadow,39,18,21
Bubidiblumpr,twisting-nether,1388,priest,shadow,42,27,15
Hek,sylvanas,1384,priest,shadow,72,36,36
Damyo,eredar,1381,priest,shadow,54,29,25
Kourroucé,archimonde,1377,priest,shadow,36,20,16
Astangia,nemesis,1369,priest,shadow,117,64,53
Hòllymèdx,blackmoore,1368,priest,shadow,22,15,7
Дикрия,eversong,1368,priest,shadow,42,20,22
Eryxial,antonidas,1365,priest,shadow,47,22,25
Shizo,blutkessel,1364,priest,shadow,29,20,9
Sodomix,tarren-mill,1363,priest,shadow,88,51,37
Bimboxo,argent-dawn,1363,priest,shadow,137,78,59
Sucukpriest,blackrock,1363,priest,shadow,36,20,16
Erkay,kazzak,1362,priest,shadow,36,17,19
Fåith,twilights-hammer,1361,priest,shadow,24,16,8
Daltheria,daggerspine,1358,priest,shadow,65,38,27
Офинсия,deathguard,1354,priest,shadow,47,18,29
Míjagí,blackhand,1352,priest,shadow,53,28,25
Kertith,argent-dawn,1352,priest,shadow,147,73,74
Aleetheia,silvermoon,1350,priest,shadow,38,18,20
Ankus,tarren-mill,1350,priest,shadow,42,19,23
Saviour,spinebreaker,1346,priest,shadow,30,19,11
Baihoi,twilights-hammer,1346,priest,shadow,48,28,20
Shinígamí,frostmane,1346,priest,shadow,48,24,24
Gumayusi,ravencrest,1344,priest,shadow,24,14,10
Genjutzu,kazzak,1343,priest,shadow,30,14,16
Voidlink,kazzak,1342,priest,shadow,24,14,10
Maedhrós,ravencrest,1341,priest,shadow,18,14,4
Aliocha,dalaran,1341,priest,shadow,24,14,10
Ryik,ravencrest,1339,priest,shadow,30,15,15
Chillx,blackmoore,1338,priest,shadow,90,56,34
Velenthøs,argent-dawn,1338,priest,shadow,41,23,18
Hecaté,blackhand,1337,priest,shadow,55,31,24
Seni,gilneas,1336,priest,shadow,55,26,29
Settemsen,tarren-mill,1334,priest,shadow,18,14,4
Bluxon,kazzak,1334,priest,shadow,24,14,10
Broncos,twisting-nether,1331,priest,shadow,58,33,25
Inei,doomhammer,1331,priest,shadow,48,25,23
Twøpac,hyjal,1327,priest,shadow,89,47,42
Вексион,goldrinn,1326,priest,shadow,30,15,15
Poposy,hyjal,1324,priest,shadow,24,14,10
Kendea,silvermoon,1317,priest,shadow,105,54,51
Littlebugger,argent-dawn,1317,priest,shadow,63,28,35
Mylini,silvermoon,1316,priest,shadow,59,29,30
Xxede,dun-modr,1315,priest,shadow,69,31,38
Lathas,bloodfeather,1311,priest,shadow,36,23,13
Secundis,silvermoon,1305,priest,shadow,30,16,14
Alfredosauce,ravencrest,1305,priest,shadow,29,14,15
Kåz,argent-dawn,1301,priest,shadow,35,21,14
Îndura,drakthul,1298,priest,shadow,24,14,10
Ammp,outland,1298,priest,shadow,92,51,41
Сариандра,gordunni,1295,priest,shadow,24,15,9
Рейвор,gordunni,1295,priest,shadow,23,14,9
Hexmon,tarren-mill,1292,priest,shadow,30,21,9
Simplesam,ravencrest,1289,priest,shadow,28,14,14
Hârlequin,draenor,1286,priest,shadow,168,90,78
Prøfesor,nemesis,1284,priest,shadow,33,15,18
Søcrax,blackrock,1276,priest,shadow,30,15,15
Babarøga,blackrock,1274,priest,shadow,23,14,9
Цитамин,deathguard,1270,priest,shadow,51,21,30
Farseerx,ravencrest,1267,priest,shadow,90,54,36
Meatyshaft,doomhammer,1265,priest,shadow,23,14,9
Odium,alakir,1264,priest,shadow,36,18,18
Nûwa,draenor,1263,priest,shadow,18,15,3
Evilspel,ravencrest,1261,priest,shadow,33,18,15
Kasyrra,sylvanas,1261,priest,shadow,43,22,21
Atheniss,drakthul,1257,priest,shadow,36,18,18
Onskansmoder,shattered-hand,1257,priest,shadow,52,24,28
Fordöbroo,ragnaros,1254,priest,shadow,54,26,28
Hëllokitty,sanguino,1253,priest,shadow,86,42,44
Cornflays,outland,1248,priest,shadow,18,13,5
Been,ravencrest,1247,priest,shadow,18,13,5
Cutepangolin,khaz-modan,1247,priest,shadow,18,13,5
Duzurîx,burning-blade,1247,priest,shadow,24,13,11
Morteous,twisting-nether,1247,priest,shadow,241,121,120
Talbatex,blackmoore,1247,priest,shadow,36,13,23
Shyvi,ravencrest,1246,priest,shadow,18,13,5
Majinmadara,ravencrest,1245,priest,shadow,28,14,14
Ruojatar,stormreaver,1241,priest,shadow,18,13,5
Greyford,blackhand,1240,priest,shadow,18,13,5
Peikkousva,twisting-nether,1240,priest,shadow,24,13,11
Putríd,sylvanas,1239,priest,shadow,18,13,5
Pedopräst,stormscale,1239,priest,shadow,18,13,5
Lilyrosemary,arathor,1239,priest,shadow,24,13,11
Jonig,blackmoore,1237,priest,shadow,30,13,17
Cryptoflame,silvermoon,1236,priest,shadow,24,13,11
Adssdfhjgh,outland,1235,priest,shadow,20,14,6
Xîneâ,outland,1235,priest,shadow,24,13,11
Morsy,alleria,1235,priest,shadow,27,14,13
Varjomies,ragnaros,1234,priest,shadow,24,13,11
Даркфолс,soulflayer,1219,priest,shadow,30,15,15
Voidlord,hyjal,1219,priest,shadow,46,22,24
Sacher,shendralar,1217,priest,shadow,30,18,12
Tesz,perenolde,1217,priest,shadow,36,16,20
Bromiaris,dun-morogh,1217,priest,shadow,30,13,17
Angleka,argent-dawn,1215,priest,shadow,53,25,28
Ggdoll,twisting-nether,1214,priest,shadow,96,47,49
Gauge,frostmane,1211,priest,shadow,59,27,32
Thergozar,stormscale,1208,priest,shadow,48,33,15
Zedrus,azshara,1206,priest,shadow,29,13,16
Kristiflicka,kazzak,1196,priest,shadow,30,17,13
Имморталрё,galakrond,1195,priest,shadow,24,15,9
Nagatary,blackmoore,1192,priest,shadow,48,23,25
Cthulou,tarren-mill,1185,priest,shadow,135,70,65
Флэшх,soulflayer,1177,priest,shadow,22,13,9
Leckpriest,sanguino,1173,priest,shadow,28,13,15
Tiinia,hyjal,1165,priest,shadow,40,15,25
Sayash,chamber-of-aspects,1158,priest,shadow,26,13,13
Scaryman,ravencrest,1157,priest,shadow,23,14,9
Hotdog,kult-der-verdammten,1152,priest,shadow,42,20,22
Julîane,aegwynn,1151,priest,shadow,18,12,6
Magicalme,kult-der-verdammten,1151,priest,shadow,18,12,6
Satin,twilights-hammer,1151,priest,shadow,18,12,6
Shadowmate,silvermoon,1151,priest,shadow,24,12,12
Jacep,kazzak,1150,priest,shadow,18,12,6
Priestgrade,darkspear,1149,priest,shadow,24,12,12
Onlyfansp,ravencrest,1149,priest,shadow,30,12,18
Fakecastguru,ravencrest,1148,priest,shadow,24,12,12
Caballococo,dun-modr,1148,priest,shadow,88,36,52
Zayden,ragnaros,1146,priest,shadow,24,12,12
Cederpriest,tarren-mill,1143,priest,shadow,39,13,26
Eliana,blackrock,1136,priest,shadow,18,12,6
Cabalist,silvermoon,1135,priest,shadow,90,46,44
Fuzzydude,ravencrest,1135,priest,shadow,36,12,24
Cerbero,doomhammer,1128,priest,shadow,18,12,6
Inzàné,kazzak,1114,priest,shadow,18,12,6
Nellytaa,dalaran,1103,priest,shadow,35,18,17
Yuhé,elune,1100,priest,shadow,24,16,8
Ðizzi,dun-modr,1096,priest,shadow,21,14,7
Ladouce,archimonde,1096,priest,shadow,27,13,14
Mirelaw,stormscale,1091,priest,shadow,30,21,9
Амфетаминная,howling-fjord,1076,priest,shadow,32,18,14
Bodeeney,hellfire,1075,priest,shadow,54,23,31
Triinkett,doomhammer,1067,priest,shadow,53,22,31
Crishroc,stormreaver,1059,priest,shadow,24,12,12
Equalìzer,ravencrest,1056,priest,shadow,12,11,1
Stèálth,sylvanas,1056,priest,shadow,12,11,1
Voldemort,blackrock,1056,priest,shadow,18,11,7
Draryanna,nemesis,1056,priest,shadow,18,11,7
Shadowvoice,outland,1056,priest,shadow,18,11,7
Omedo,stormscale,1056,priest,shadow,24,11,13
Vibéz,outland,1056,priest,shadow,24,11,13
Adub,tarren-mill,1055,priest,shadow,18,11,7
Actionjezuz,shattered-hand,1055,priest,shadow,18,11,7
Terrored,ravencrest,1055,priest,shadow,18,11,7
Phplaravel,tarren-mill,1054,priest,shadow,18,11,7
Шанэкс,howling-fjord,1053,priest,shadow,12,11,1
Dexploit,frostwolf,1053,priest,shadow,18,11,7
Abjure,silvermoon,1053,priest,shadow,18,11,7
Yoggies,tarren-mill,1053,priest,shadow,21,12,9
Санятруу,blackscar,1053,priest,shadow,78,42,36
Блюмсик,blackscar,1052,priest,shadow,30,18,12
Sharmidix,kazzak,1052,priest,shadow,24,11,13
Kwolinger,norgannon,1052,priest,shadow,24,11,13
Peprama,stormscale,1051,priest,shadow,24,11,13
Phobò,blackrock,1050,priest,shadow,24,11,13
Zubrowkâ,kazzak,1043,priest,shadow,24,11,13
Holypowér,twisting-nether,1041,priest,shadow,24,11,13
Festiz,tichondrius,1024,priest,shadow,30,14,16
Ixdeadxl,stormscale,1022,priest,shadow,24,11,13
Lapinvicieux,archimonde,1012,priest,shadow,29,11,18
Atelstan,drakthul,1003,priest,shadow,48,16,32
Minabonxx,silvermoon,1002,priest,shadow,57,17,40
Тэтсу,greymane,1001,priest,shadow,30,16,14
Mydianá,aegwynn,999,priest,shadow,23,14,9
Hypnocat,blackrock,991,priest,shadow,22,11,11
Ruhoniy,ysondre,990,priest,shadow,18,13,5
Pipen,stormscale,990,priest,shadow,29,11,18
Asdaprice,hellfire,986,priest,shadow,18,12,6
Mylox,blackrock,984,priest,shadow,17,11,6
Уртримас,gordunni,975,priest,shadow,30,11,19
Мргорсан,eversong,974,priest,shadow,30,16,14
Кинраналь,eversong,964,priest,shadow,24,12,12
Dayowe,antonidas,964,priest,shadow,76,36,40
Ðrßøtÿcûs,la-croisade-écarlate,960,priest,shadow,12,10,2
Debbski,tarren-mill,960,priest,shadow,12,10,2
Huffle,argent-dawn,960,priest,shadow,12,10,2
Sinsofmany,ragnaros,960,priest,shadow,12,10,2
Infernión,tarren-mill,960,priest,shadow,18,10,8
Rippeep,emerald-dream,960,priest,shadow,18,10,8
Даняпимпгадх,soulflayer,960,priest,shadow,18,10,8
Gbc,emerald-dream,960,priest,shadow,18,10,8
Blindöts,tarren-mill,960,priest,shadow,18,10,8
Петушшара,gordunni,960,priest,shadow,21,10,11
Øhlø,ysondre,959,priest,shadow,12,10,2
Pórt,kazzak,959,priest,shadow,15,11,4
Goodison,outland,959,priest,shadow,24,10,14
Rakkha,ravencrest,959,priest,shadow,24,10,14
Dreamhatcher,deathwing,959,priest,shadow,24,10,14
Supriest,alakir,959,priest,shadow,24,10,14
Diha,argent-dawn,958,priest,shadow,18,10,8
Miruvai,tarren-mill,958,priest,shadow,18,10,8
Qiandra,argent-dawn,958,priest,shadow,24,10,14
Zeto,blackmoore,957,priest,shadow,12,10,2
Juxtapose,argent-dawn,957,priest,shadow,12,10,2
Seenoend,neptulon,957,priest,shadow,18,10,8
Îzî,sanguino,955,priest,shadow,18,10,8
Люблюкофе,deathguard,955,priest,shadow,18,10,8
Shadowsister,burning-blade,955,priest,shadow,18,10,8
Иннй,howling-fjord,947,priest,shadow,24,11,13
Силабездны,deathguard,946,priest,shadow,38,20,18
Brainmuscle,ravencrest,945,priest,shadow,12,10,2
Syfl,defias-brotherhood,935,priest,shadow,24,10,14
Abrakahudder,tarren-mill,927,priest,shadow,17,10,7
Priestoll,draenor,911,priest,shadow,21,10,11
Pneumay,tarren-mill,878,priest,shadow,18,10,8
Frëyha,archimonde,877,priest,shadow,16,10,6
Пампнавечерх,blackscar,864,priest,shadow,12,9,3
Anabølixx,ravencrest,864,priest,shadow,12,9,3
Døtgdx,archimonde,864,priest,shadow,12,9,3
Otecduchovny,burning-blade,864,priest,shadow,12,9,3
Tylb,tarren-mill,864,priest,shadow,12,9,3
Shucks,stormscale,864,priest,shadow,18,9,9
Dogstav,kazzak,864,priest,shadow,18,9,9
Insanious,skullcrusher,864,priest,shadow,18,9,9
Spyrono,kazzak,864,priest,shadow,18,9,9
Scade,kazzak,864,priest,shadow,18,9,9
Manyus,archimonde,864,priest,shadow,18,9,9
Anabølix,ravencrest,864,priest,shadow,18,9,9
Felaenna,argent-dawn,864,priest,shadow,18,9,9
Schmatzy,blackmoore,864,priest,shadow,24,9,15
Tweenitopg,les-clairvoyants,863,priest,shadow,12,9,3
Lostcause,alakir,863,priest,shadow,12,9,3
Kimosabee,kazzak,863,priest,shadow,18,9,9
Jadæ,ragnaros,863,priest,shadow,18,9,9
Nomorelight,stormscale,863,priest,shadow,18,9,9
Healiea,outland,863,priest,shadow,30,9,21
Lurmus,outland,862,priest,shadow,12,9,3
Элдерле,gordunni,862,priest,shadow,18,9,9
Hörror,twisting-nether,862,priest,shadow,18,9,9
Ilostmybible,runetotem,862,priest,shadow,24,9,15
Dívíne,ravenholdt,861,priest,shadow,12,9,3
Хоозяин,blackscar,861,priest,shadow,12,9,3
Dutchstuff,karazhan,861,priest,shadow,18,9,9
Kavie,ravencrest,861,priest,shadow,18,9,9
Dumámày,silvermoon,860,priest,shadow,12,9,3
Controlled,tarren-mill,859,priest,shadow,18,9,9
ßeastx,nethersturm,859,priest,shadow,18,9,9
Maximandreic,kazzak,859,priest,shadow,30,9,21
Дроус,borean-tundra,858,priest,shadow,30,12,18
Kíssme,archimonde,855,priest,shadow,12,9,3
Fanberra,the-venture-co,851,priest,shadow,18,9,9
Zák,sylvanas,843,priest,shadow,18,9,9
Shaddyr,thrall,828,priest,shadow,17,9,8
Csksablanca,sargeras,815,priest,shadow,11,9,2
Driptoohard,archimonde,815,priest,shadow,11,9,2
Happychap,stormreaver,815,priest,shadow,21,9,12
Sigor,hellfire,802,priest,shadow,23,9,14
Õðæßìùa,kazzak,799,priest,shadow,17,9,8
Arunp,magtheridon,799,priest,shadow,26,9,17
Alicanx,silvermoon,798,priest,shadow,17,9,8
Wewo,drakthul,798,priest,shadow,17,9,8
Sypnos,zuljin,797,priest,shadow,16,9,7
Endchor,eredar,791,priest,shadow,24,9,15
Inavea,hyjal,768,priest,shadow,12,8,4
Djstache,tarren-mill,768,priest,shadow,12,8,4
Raëkon,nemesis,768,priest,shadow,12,8,4
Balthe,defias-brotherhood,768,priest,shadow,12,8,4
Syreet,silvermoon,768,priest,shadow,12,8,4
Uselessxasel,sanguino,768,priest,shadow,12,8,4
Alexwinkwink,kazzak,768,priest,shadow,12,8,4
Velence,ravencrest,768,priest,shadow,12,8,4
Kirrako,tarren-mill,768,priest,shadow,12,8,4
Voideffsucks,stormscale,768,priest,shadow,12,8,4
Shyasianpr,area-52,768,priest,shadow,12,8,4
Rýzera,aegwynn,768,priest,shadow,12,8,4
Morseeii,baelgun,768,priest,shadow,12,8,4
Прыст,howling-fjord,768,priest,shadow,12,8,4
Nøwmäck,archimonde,768,priest,shadow,15,9,6
Jaanny,defias-brotherhood,768,priest,shadow,18,8,10
Brøwnyez,zuljin,768,priest,shadow,18,8,10
Hilerki,draenor,768,priest,shadow,18,8,10
Froffzy,tarren-mill,768,priest,shadow,18,8,10
Возрождающее,soulflayer,768,priest,shadow,18,8,10
Хелектро,deathweaver,768,priest,shadow,18,8,10
Emilyvvillis,outland,768,priest,shadow,18,8,10
Zappikpriest,silvermoon,767,priest,shadow,12,8,4
Seum,ravencrest,767,priest,shadow,12,8,4
Holineß,burning-blade,767,priest,shadow,12,8,4
Jegred,draenor,767,priest,shadow,12,8,4
Холиспирт,deathguard,767,priest,shadow,12,8,4
Kagarr,kazzak,767,priest,shadow,14,8,6
Lynseanna,ravencrest,767,priest,shadow,18,8,10
Unreal,nagrand,767,priest,shadow,18,8,10
Dimorinny,silvermoon,767,priest,shadow,18,8,10
Aereza,darkspear,767,priest,shadow,18,8,10
Flexzpriest,destromath,767,priest,shadow,18,8,10
Äiri,blackmoore,767,priest,shadow,18,8,10
Maskinjundre,bronzebeard,767,priest,shadow,24,8,16
Priestlolx,aegwynn,767,priest,shadow,24,8,16
Ехереу,blackscar,766,priest,shadow,12,8,4
Ihaveibs,doomhammer,766,priest,shadow,19,9,10
Darkmayham,silvermoon,766,priest,shadow,18,8,10
Powna,blackrock,765,priest,shadow,12,8,4
Johnnysp,eredar,765,priest,shadow,12,8,4
Géèk,alakir,765,priest,shadow,19,8,11
Holyface,twisting-nether,764,priest,shadow,12,8,4
Sammel,moonglade,763,priest,shadow,18,8,10
Zathada,twisting-nether,763,priest,shadow,18,8,10
Omnissiiah,silvermoon,763,priest,shadow,24,8,16
Семмэр,gordunni,759,priest,shadow,27,9,18
Gwyneth,archimonde,753,priest,shadow,12,8,4
Намдандар,howling-fjord,753,priest,shadow,18,8,10
Jonesy,blackmoore,735,priest,shadow,16,8,8
Shíàpríést,kazzak,734,priest,shadow,29,8,21
Aeo,twisting-nether,732,priest,shadow,17,8,9
Røst,ravencrest,719,priest,shadow,11,8,3
Spideypap,ragnaros,711,priest,shadow,22,9,13
Raetwo,stormscale,703,priest,shadow,14,8,6
Ниомана,gordunni,698,priest,shadow,12,9,3
Reptika,tichondrius,696,priest,shadow,16,8,8
Phasmofobia,ragnaros,694,priest,shadow,14,8,6
Sadgepriest,draenor,672,priest,shadow,12,7,5
Kíguwu,draenor,672,priest,shadow,12,7,5
Миррен,gordunni,672,priest,shadow,12,7,5
Говорун,grom,672,priest,shadow,12,7,5
Spherics,ravencrest,672,priest,shadow,12,7,5
Lousp,tarren-mill,672,priest,shadow,12,7,5
Libstik,hyjal,672,priest,shadow,12,7,5
Bizzlebabe,lightbringer,672,priest,shadow,12,7,5
Dolens,argent-dawn,672,priest,shadow,12,7,5
Systerstål,twisting-nether,672,priest,shadow,12,7,5
Виталябард,gordunni,672,priest,shadow,12,7,5
Марриаза,blackscar,672,priest,shadow,12,7,5
Fueguchi,anubarak,672,priest,shadow,12,7,5
Gød,magtheridon,672,priest,shadow,12,7,5
Laradiel,dun-modr,672,priest,shadow,12,7,5
Sundae,nemesis,672,priest,shadow,12,7,5
Fairylite,outland,672,priest,shadow,12,7,5
Uria,moonglade,672,priest,shadow,12,7,5
Nordrenalin,tarren-mill,672,priest,shadow,12,7,5
Vittelk,stormscale,672,priest,shadow,12,7,5
Fläschheal,aegwynn,672,priest,shadow,12,7,5
Енотхд,soulflayer,672,priest,shadow,12,7,5
Jóhnnybravó,kazzak,672,priest,shadow,12,7,5
Donkyrobert,tarren-mill,672,priest,shadow,12,7,5
Aritrosp,kargath,672,priest,shadow,12,7,5
Leggat,draenor,672,priest,shadow,15,8,7
Heygoogle,ravencrest,672,priest,shadow,18,7,11
Majinbuù,sargeras,672,priest,shadow,18,7,11
Irlfatguy,ravencrest,672,priest,shadow,20,7,13
Syam,dun-morogh,672,priest,shadow,24,7,17
Cryptoniite,kazzak,671,priest,shadow,12,7,5
Badomens,draenor,671,priest,shadow,12,7,5
Xatori,arthas,671,priest,shadow,12,7,5
Абсорб,gordunni,671,priest,shadow,12,7,5
Elarya,zenedar,671,priest,shadow,12,7,5
Мариаглорум,gordunni,671,priest,shadow,12,7,5
Слышуфонк,howling-fjord,671,priest,shadow,12,7,5
Daretox,turalyon,671,priest,shadow,12,7,5
Gooflord,ravencrest,671,priest,shadow,18,7,11
Jerolol,sanguino,671,priest,shadow,18,7,11
Neggan,chamber-of-aspects,671,priest,shadow,18,7,11
Calor,nemesis,670,priest,shadow,12,7,5
Kitasia,tarren-mill,670,priest,shadow,12,7,5
Hiela,outland,670,priest,shadow,12,7,5
Morgoh,die-arguswacht,670,priest,shadow,12,7,5
Haxxøn,die-nachtwache,670,priest,shadow,12,7,5
Mellandoh,tarren-mill,670,priest,shadow,12,7,5
Psystorm,frostmane,670,priest,shadow,18,7,11
Sáro,ravencrest,669,priest,shadow,12,7,5
Battlefog,turalyon,669,priest,shadow,18,7,11
Hotsanddots,auchindoun,668,priest,shadow,12,7,5
Некросиний,eversong,667,priest,shadow,12,7,5
Bonbonici,sylvanas,666,priest,shadow,12,7,5
Hulluh,tarren-mill,665,priest,shadow,12,7,5
Redfield,frostmane,663,priest,shadow,24,7,17
Spaghettoni,tarren-mill,662,priest,shadow,12,7,5
Stoffig,aggramar,660,priest,shadow,12,7,5
Vregoa,twisting-nether,639,priest,shadow,17,7,10
Sadskîx,dun-modr,624,priest,shadow,9,8,1
Brainwash,darksorrow,608,priest,shadow,16,7,9
Reeflix,blackmoore,607,priest,shadow,17,8,9
Physx,blackrock,576,priest,shadow,6,6,0
Шандресса,deepholm,576,priest,shadow,6,6,0
Shacoat,draenor,576,priest,shadow,6,6,0
Rubzler,ravencrest,576,priest,shadow,6,6,0
Deform,argent-dawn,576,priest,shadow,6,6,0
Suitenatacho,archimonde,576,priest,shadow,6,6,0
Xceliann,stormscale,576,priest,shadow,6,6,0
Uzü,ysondre,576,priest,shadow,10,7,3
Miraçlê,kazzak,576,priest,shadow,12,6,6
Ellfle,kazzak,576,priest,shadow,12,6,6
Hizumi,stormreaver,576,priest,shadow,12,6,6
Farotep,tarren-mill,576,priest,shadow,12,6,6
Umayyaa,sylvanas,576,priest,shadow,12,6,6
Seehz,ysondre,576,priest,shadow,12,6,6
Shadoxx,malganis,576,priest,shadow,12,6,6
Cultist,defias-brotherhood,576,priest,shadow,12,6,6
Бранлор,howling-fjord,576,priest,shadow,12,6,6
Kunayu,ravencrest,576,priest,shadow,12,6,6
Wakizashi,ravencrest,576,priest,shadow,12,6,6
Babydark,ravencrest,576,priest,shadow,12,6,6
Lløthx,ravencrest,576,priest,shadow,12,6,6
Despéri,ysondre,576,priest,shadow,12,6,6
Cluelêss,blackrock,576,priest,shadow,12,6,6
Lilsayx,blackrock,576,priest,shadow,12,6,6
Saliâ,blackmoore,576,priest,shadow,12,6,6
Voidpbody,nerathor,576,priest,shadow,12,6,6
Skyfour,blackmoore,576,priest,shadow,12,6,6
Fluffieh,ravencrest,576,priest,shadow,12,6,6
Landliebe,outland,576,priest,shadow,12,6,6
Prästjäväln,stormscale,576,priest,shadow,12,6,6
Vaßpera,tarren-mill,576,priest,shadow,18,6,12
Khäñ,ravencrest,576,priest,shadow,24,6,18
Princéssà,aegwynn,575,priest,shadow,12,6,6
Attaxx,dragonmaw,575,priest,shadow,12,6,6
Нитровина,howling-fjord,575,priest,shadow,12,6,6
Wintercurse,twisting-nether,575,priest,shadow,18,6,12
Avatars,kirin-tor,574,priest,shadow,12,6,6
Sacreth,ragnaros,574,priest,shadow,24,6,18
Bloodimand,terenas,572,priest,shadow,12,6,6
Mimox,kaelthas,570,priest,shadow,12,6,6
Hellena,neptulon,570,priest,shadow,18,6,12
Trencharse,draenor,559,priest,shadow,17,6,11
Манддалорец,gordunni,512,priest,shadow,16,6,10
Lildiggy,outland,511,priest,shadow,14,6,8
Gladíator,blackhand,480,priest,shadow,6,5,1
Sleypriest,draenor,480,priest,shadow,6,5,1
Solaclypsa,destromath,480,priest,shadow,6,5,1
Darkqt,ravencrest,480,priest,shadow,6,5,1
Nøskillzz,nemesis,480,priest,shadow,6,5,1
Lamaovic,archimonde,480,priest,shadow,6,5,1
Easyc,gorgonnash,480,priest,shadow,6,5,1
Potati,defias-brotherhood,480,priest,shadow,6,5,1
Makethemstop,bronzebeard,480,priest,shadow,6,5,1
Tigrok,burning-legion,480,priest,shadow,6,5,1
Rinkahands,silvermoon,480,priest,shadow,6,5,1
Wérrýxs,kazzak,480,priest,shadow,6,5,1
Jingling,kazzak,480,priest,shadow,6,5,1
Зоргдаркнесс,howling-fjord,480,priest,shadow,6,5,1
Tribz,kargath,480,priest,shadow,6,5,1
Скизма,gordunni,480,priest,shadow,6,5,1
Алуриэлия,gordunni,480,priest,shadow,6,5,1
Attilerg,stormscale,480,priest,shadow,6,5,1
Shaaq,stormscale,480,priest,shadow,6,5,1
Voidis,hyjal,480,priest,shadow,6,5,1
Bazazath,thrall,480,priest,shadow,9,6,3
Mentax,kazzak,480,priest,shadow,12,5,7
Cmonbro,hyjal,480,priest,shadow,12,5,7
Дакимакурах,gordunni,480,priest,shadow,12,5,7
Shadowful,drakthul,480,priest,shadow,12,5,7
Môrtïciâ,tarren-mill,480,priest,shadow,12,5,7
Rovensin,ravencrest,480,priest,shadow,12,5,7
Neverfade,dun-modr,480,priest,shadow,12,5,7
Kidkuddo,blackmoore,480,priest,shadow,12,5,7
Raeratwo,archimonde,480,priest,shadow,12,5,7
Darkmus,quelthalas,480,priest,shadow,12,5,7
Низара,deathguard,480,priest,shadow,12,5,7
Lyssandre,stormreaver,480,priest,shadow,12,5,7
Bonsoin,kirin-tor,480,priest,shadow,12,5,7
Whocare,tarren-mill,480,priest,shadow,12,5,7
Korzec,dun-modr,480,priest,shadow,12,5,7
Smâshëd,stormscale,480,priest,shadow,12,5,7
Tokkz,kelthuzad,480,priest,shadow,12,5,7
Jarkk,ysondre,480,priest,shadow,12,5,7
Darrianna,outland,480,priest,shadow,12,5,7
Taikki,stormreaver,480,priest,shadow,12,5,7
Singularity,ravencrest,480,priest,shadow,12,5,7
Nairima,argent-dawn,480,priest,shadow,12,5,7
Svenskabarn,twisting-nether,480,priest,shadow,12,5,7
Rokil,ravencrest,480,priest,shadow,12,5,7
Qwertyuioasd,ravencrest,480,priest,shadow,12,5,7
Aaj,twisting-nether,480,priest,shadow,12,5,7
Skûggpräst,silvermoon,480,priest,shadow,12,5,7
Valaç,turalyon,480,priest,shadow,12,5,7
Claudefrollo,the-maelstrom,480,priest,shadow,13,5,8
Lasdrael,dun-modr,479,priest,shadow,6,5,1
Вэйворс,blackscar,479,priest,shadow,10,6,4
Mynithir,chants-éternels,479,priest,shadow,12,5,7
Heinricht,ragnaros,479,priest,shadow,12,5,7
Xieraxe,ravencrest,479,priest,shadow,12,5,7
Soulsuckerr,silvermoon,479,priest,shadow,18,5,13
Ethalia,kirin-tor,478,priest,shadow,12,5,7
Falbäla,suramar,473,priest,shadow,12,5,7
Карбираторх,gordunni,447,priest,shadow,11,5,6
Sàd,thrall,447,priest,shadow,11,5,6
Aezef,ysondre,447,priest,shadow,14,6,8
Svettvrede,sylvanas,432,priest,shadow,9,6,3
Twisty,malganis,426,priest,shadow,17,9,8
Deadlymoda,zenedar,415,priest,shadow,8,5,3
Mysticforces,silvermoon,384,priest,shadow,6,4,2
Valdiona,tarren-mill,384,priest,shadow,6,4,2
Вэстервилли,howling-fjord,384,priest,shadow,6,4,2
Shadowboness,twisting-nether,384,priest,shadow,6,4,2
Cyrená,ravencrest,384,priest,shadow,6,4,2
Spae,twisting-nether,384,priest,shadow,6,4,2
Lumex,aegwynn,384,priest,shadow,6,4,2
Vantek,antonidas,384,priest,shadow,6,4,2
Трихоманиаз,ashenvale,384,priest,shadow,6,4,2
Êlectron,ravencrest,384,priest,shadow,6,4,2
Peep,emerald-dream,384,priest,shadow,6,4,2
Marsheil,blackhand,384,priest,shadow,6,4,2
Alinfinito,ravencrest,384,priest,shadow,6,4,2
Torino,kazzak,384,priest,shadow,6,4,2
Grainbames,sylvanas,384,priest,shadow,6,4,2
Satànâs,twisting-nether,384,priest,shadow,6,4,2
Vardrium,antonidas,384,priest,shadow,6,4,2
Looó,los-errantes,384,priest,shadow,6,4,2
Roastie,frostmane,384,priest,shadow,6,4,2
Syrïal,hyjal,384,priest,shadow,6,4,2
Свдпрох,soulflayer,384,priest,shadow,6,4,2
Dokurochan,tarren-mill,384,priest,shadow,6,4,2
Azsaryn,magtheridon,384,priest,shadow,6,4,2
Daspyen,silvermoon,384,priest,shadow,6,4,2
Floodey,defias-brotherhood,384,priest,shadow,6,4,2
Thebesp,ravencrest,384,priest,shadow,6,4,2
Evílshadows,tarren-mill,384,priest,shadow,6,4,2
Kobiden,stormreaver,384,priest,shadow,6,4,2
Шучунекошмар,soulflayer,384,priest,shadow,6,4,2
Drë,daggerspine,384,priest,shadow,6,4,2
Фьюриреидж,soulflayer,384,priest,shadow,6,4,2
Alicanx,twisting-nether,384,priest,shadow,6,4,2
Наярда,howling-fjord,384,priest,shadow,6,4,2
Appraiser,draenor,384,priest,shadow,6,4,2
Nebunia,twisting-nether,384,priest,shadow,6,4,2
Sweetepi,blackmoore,384,priest,shadow,6,4,2
Achára,ravencrest,384,priest,shadow,6,4,2
Lysium,sylvanas,384,priest,shadow,6,4,2
Noreal,twisting-nether,384,priest,shadow,6,4,2
Jpxoxo,blackhand,384,priest,shadow,6,4,2
Alusiepriest,ravencrest,384,priest,shadow,6,4,2
Atropin,silvermoon,384,priest,shadow,6,4,2
Æåeåeåé,twisting-nether,384,priest,shadow,6,4,2
Lorthonor,silvermoon,384,priest,shadow,6,4,2
Thogrey,archimonde,384,priest,shadow,6,4,2
Veshania,blackhand,384,priest,shadow,6,4,2
Daftî,twisting-nether,384,priest,shadow,6,4,2
Spum,ravencrest,384,priest,shadow,6,4,2
Temtem,ravencrest,384,priest,shadow,6,4,2
Jesuispasbon,hyjal,384,priest,shadow,6,4,2
Ylenae,twisting-nether,384,priest,shadow,6,4,2
Wingufreebrø,sanguino,384,priest,shadow,6,4,2
Tarantos,uldum,384,priest,shadow,6,4,2
Evypriest,draenor,384,priest,shadow,6,4,2
Majestíc,blackmoore,384,priest,shadow,6,4,2
Malip,ragnaros,384,priest,shadow,9,4,5
Strvnge,stormreaver,384,priest,shadow,11,4,7
Nìak,ysondre,384,priest,shadow,15,5,10
Swoptoplong,blackhand,384,priest,shadow,12,4,8
Apèx,blackrock,384,priest,shadow,12,4,8
Dotmaster,darkspear,384,priest,shadow,12,4,8
Grayraven,azjolnerub,384,priest,shadow,12,4,8
Umbrazoid,sanguino,384,priest,shadow,12,4,8
Lfgarcatraz,aegwynn,384,priest,shadow,12,4,8
Widdlprest,sylvanas,384,priest,shadow,12,4,8
Kantar,ragnaros,384,priest,shadow,12,4,8
Ларчшп,gordunni,384,priest,shadow,12,4,8
Zaoza,dentarg,384,priest,shadow,12,4,8
Bacovia,tarren-mill,384,priest,shadow,12,4,8
Shadøwz,grim-batol,384,priest,shadow,12,4,8
Отчепадре,gordunni,384,priest,shadow,12,4,8
Dpriesta,aegwynn,384,priest,shadow,12,4,8
Самоэль,gordunni,384,priest,shadow,12,4,8
Niikki,blackrock,384,priest,shadow,12,4,8
Jellypie,blackrock,384,priest,shadow,12,4,8
Szpinx,stormscale,384,priest,shadow,12,4,8
Fùkøff,stormscale,384,priest,shadow,12,4,8
Сэлунна,goldrinn,384,priest,shadow,12,4,8
Gerase,blackrock,384,priest,shadow,12,4,8
Zultor,ragnaros,384,priest,shadow,13,4,9
Chlorohhkine,chogall,384,priest,shadow,13,4,9
Tobirama,stormscale,384,priest,shadow,17,4,13
Zerim,blackmoore,384,priest,shadow,18,4,14
Abnórmus,tarren-mill,383,priest,shadow,6,4,2
Newik,burning-legion,383,priest,shadow,6,4,2
Shikamarudmx,burning-legion,383,priest,shadow,15,5,10
Sphard,ysondre,383,priest,shadow,12,4,8
Мараес,howling-fjord,382,priest,shadow,6,4,2
Perchédue,silvermoon,367,priest,shadow,11,4,7
Levitating,argent-dawn,336,priest,shadow,9,5,4
Solaní,antonidas,335,priest,shadow,11,4,7
Tweediertie,argent-dawn,335,priest,shadow,11,4,7
Prìestìalìty,draenor,330,priest,shadow,11,6,5
Nerfnerf,kazzak,330,priest,shadow,13,5,8
Zargoss,sylvanas,304,priest,shadow,7,4,3
Roxfer,ysondre,288,priest,shadow,6,3,3
Vilayetko,ravencrest,288,priest,shadow,6,3,3
Nukyo,blackmoore,288,priest,shadow,6,3,3
Talandra,drakthul,288,priest,shadow,6,3,3
Liliashet,sanguino,288,priest,shadow,6,3,3
Miikkap,blackhand,288,priest,shadow,6,3,3
Zøid,ysondre,288,priest,shadow,6,3,3
Yazh,argent-dawn,288,priest,shadow,6,3,3
Umyqt,ragnaros,288,priest,shadow,6,3,3
Exörcíst,outland,288,priest,shadow,6,3,3
Arratør,ysondre,288,priest,shadow,6,3,3
Abyssonmind,dun-modr,288,priest,shadow,6,3,3
Dunkelseele,ahnqiraj,288,priest,shadow,6,3,3
Ragwitch,draenor,288,priest,shadow,6,3,3
Нечавкай,deathweaver,288,priest,shadow,6,3,3
Voilencia,kazzak,288,priest,shadow,6,3,3
Sàyaa,draenor,288,priest,shadow,6,3,3
Chaarronn,drakthul,288,priest,shadow,6,3,3
Stinkycreep,executus,288,priest,shadow,6,3,3
Prästpojken,frostwhisper,288,priest,shadow,6,3,3
Allanna,talnivarr,288,priest,shadow,6,3,3
Xpy,kazzak,288,priest,shadow,6,3,3
Ahle,darkspear,288,priest,shadow,6,3,3
Cðsima,blackmoore,288,priest,shadow,6,3,3
Ephara,outland,288,priest,shadow,6,3,3
Xaviá,blackrock,288,priest,shadow,6,3,3
Morzâr,outland,288,priest,shadow,6,3,3
Wkid,draenor,288,priest,shadow,6,3,3
Synexia,sylvanas,288,priest,shadow,6,3,3
Löspajen,stormscale,288,priest,shadow,6,3,3
Notra,shattrath,288,priest,shadow,6,3,3
Henaheals,ragnaros,288,priest,shadow,6,3,3
Лиройгеморой,gordunni,288,priest,shadow,6,3,3
Stepsisstuck,ragnaros,288,priest,shadow,6,3,3
Holybestie,eredar,288,priest,shadow,6,3,3
Papynou,garona,288,priest,shadow,6,3,3
Emala,hyjal,288,priest,shadow,6,3,3
Æro,malganis,288,priest,shadow,6,3,3
Skymning,tarren-mill,288,priest,shadow,6,3,3
Chandria,veknilash,288,priest,shadow,6,3,3
Imadîa,dalaran,288,priest,shadow,6,3,3
Grocx,kazzak,288,priest,shadow,6,3,3
Andreel,ravencrest,288,priest,shadow,6,3,3
Dboi,tarren-mill,288,priest,shadow,6,3,3
Shadowchunks,argent-dawn,288,priest,shadow,6,3,3
Nitza,silvermoon,288,priest,shadow,6,3,3
Poonies,silvermoon,288,priest,shadow,6,3,3
Pbwser,silvermoon,288,priest,shadow,6,3,3
Sweedensp,hyjal,288,priest,shadow,6,3,3
Dípp,ravencrest,288,priest,shadow,6,3,3
Cloudfactory,ravencrest,288,priest,shadow,6,3,3
Fnúggí,kazzak,288,priest,shadow,6,3,3
Mindboorst,kazzak,288,priest,shadow,6,3,3
Presbyter,mazrigos,288,priest,shadow,6,3,3
Неприст,ashenvale,288,priest,shadow,6,3,3
Дюрэкс,soulflayer,288,priest,shadow,6,3,3
Montane,wrathbringer,288,priest,shadow,6,3,3
Ggsus,outland,288,priest,shadow,6,3,3
Nhajÿ,hyjal,288,priest,shadow,6,3,3
Lethaa,twisting-nether,288,priest,shadow,6,3,3
Vividots,draenor,288,priest,shadow,6,3,3
Xùÿø,culte-de-la-rive-noire,288,priest,shadow,6,3,3
Syntara,twisting-nether,288,priest,shadow,6,3,3
Смегмачет,soulflayer,288,priest,shadow,6,3,3
Lutzki,the-maelstrom,288,priest,shadow,6,3,3
Freezydot,silvermoon,288,priest,shadow,6,3,3
Bhlad,silvermoon,288,priest,shadow,6,3,3
Maela,uldum,288,priest,shadow,6,3,3
Linara,frostmane,288,priest,shadow,6,3,3
Drynte,blackmoore,288,priest,shadow,6,3,3
Kallsen,ravencrest,288,priest,shadow,6,3,3
Skillmåster,ravencrest,288,priest,shadow,6,3,3
Jlox,stormscale,288,priest,shadow,9,4,5
Kopfsache,blackmoore,288,priest,shadow,7,3,4
Freshpope,ravencrest,288,priest,shadow,10,4,6
Лейля,goldrinn,288,priest,shadow,12,3,9
Elumi,the-maelstrom,288,priest,shadow,12,3,9
Reckpump,twisting-nether,288,priest,shadow,12,3,9
Damnedangel,drakthul,288,priest,shadow,12,3,9
Cthultist,dun-modr,288,priest,shadow,12,3,9
Shreedz,blackmoore,288,priest,shadow,12,3,9
Aaluvor,blackmoore,288,priest,shadow,12,3,9
Supermacy,blackrock,288,priest,shadow,12,3,9
Hâstur,ravencrest,288,priest,shadow,12,3,9
Xrystal,wrathbringer,288,priest,shadow,12,3,9
Nesar,stormscale,288,priest,shadow,12,3,9
Kaenlin,the-maelstrom,288,priest,shadow,18,3,15
Yonaka,amanthul,288,priest,shadow,18,3,15
Васпохилить,howling-fjord,288,priest,shadow,18,3,15
Акциуми,howling-fjord,287,priest,shadow,6,3,3
Jês,thrall,287,priest,shadow,6,3,3
Rulna,die-aldor,287,priest,shadow,12,3,9
Nuger,tarren-mill,286,priest,shadow,6,3,3
Серебрия,gordunni,286,priest,shadow,6,3,3
Irrtum,nozdormu,286,priest,shadow,6,3,3
Czikibriki,ravenholdt,256,priest,shadow,4,4,0
Guccimaane,twisting-nether,239,priest,shadow,5,3,2
Caski,stormreaver,239,priest,shadow,5,3,2
Kuddles,hyjal,239,priest,shadow,5,3,2
Deeforce,argent-dawn,234,priest,shadow,6,4,2
Ðarcø,archimonde,208,priest,shadow,13,3,10
Shadowflamè,outland,192,priest,shadow,4,3,1
Szycho,burning-legion,192,priest,shadow,9,3,6
Datscrazi,ravencrest,192,priest,shadow,6,2,4
Lythra,burning-legion,192,priest,shadow,6,2,4
Harleyquiñ,burning-legion,192,priest,shadow,6,2,4
Bandgap,antonidas,192,priest,shadow,6,2,4
Ximenia,eredar,192,priest,shadow,6,2,4
Vengigodxx,ravencrest,192,priest,shadow,6,2,4
Omejan,frostmane,192,priest,shadow,6,2,4
Aruna,ravencrest,192,priest,shadow,6,2,4
Daven,ysondre,192,priest,shadow,6,2,4
Daisyduke,veknilash,192,priest,shadow,6,2,4
Crzzy,dun-modr,192,priest,shadow,6,2,4
Cto,gorgonnash,192,priest,shadow,6,2,4
Bòóny,ravencrest,192,priest,shadow,6,2,4
Valdemar,alakir,192,priest,shadow,6,2,4
Notdespo,kazzak,192,priest,shadow,6,2,4
Crazyname,outland,192,priest,shadow,6,2,4
Lugburzz,draenor,192,priest,shadow,6,2,4
Nomarak,drakthul,192,priest,shadow,6,2,4
Wiglere,argent-dawn,192,priest,shadow,6,2,4
Tankeløs,kazzak,192,priest,shadow,6,2,4
Misántropo,dun-modr,192,priest,shadow,6,2,4
Сорвиголов,howling-fjord,192,priest,shadow,6,2,4
Buan,blackmoore,192,priest,shadow,6,2,4
Ràthaløs,sanguino,192,priest,shadow,6,2,4
Oknelim,blackmoore,192,priest,shadow,6,2,4
Rallzken,stormscale,192,priest,shadow,6,2,4
Chekkó,blackrock,192,priest,shadow,6,2,4
Tuljan,twisting-nether,192,priest,shadow,6,2,4
Zikár,kazzak,192,priest,shadow,6,2,4
Мсикатана,gordunni,192,priest,shadow,6,2,4
Velansera,argent-dawn,192,priest,shadow,6,2,4
Turah,the-maelstrom,192,priest,shadow,6,2,4
Mahist,ravencrest,192,priest,shadow,6,2,4
Дашажмитучу,howling-fjord,192,priest,shadow,6,2,4
Otheym,the-maelstrom,192,priest,shadow,6,2,4
Xiä,archimonde,192,priest,shadow,6,2,4
Sephìrøth,malganis,192,priest,shadow,6,2,4
Alpharîus,argent-dawn,192,priest,shadow,6,2,4
Vilhiil,darksorrow,192,priest,shadow,6,2,4
Ичисанчик,howling-fjord,192,priest,shadow,6,2,4
Piixld,aegwynn,192,priest,shadow,6,2,4
Rustyroll,stormscale,192,priest,shadow,6,2,4
Безмездная,gordunni,192,priest,shadow,6,2,4
Slimshadey,malganis,192,priest,shadow,6,2,4
Шарадин,gordunni,192,priest,shadow,6,2,4
Xaeroow,archimonde,192,priest,shadow,6,2,4
Hadsup,stormscale,192,priest,shadow,6,2,4
Kaleshiry,kazzak,192,priest,shadow,6,2,4
Preast,aegwynn,192,priest,shadow,6,2,4
Sotriggered,sylvanas,192,priest,shadow,6,2,4
Шаасит,soulflayer,192,priest,shadow,6,2,4
Calïxløve,der-rat-von-dalaran,192,priest,shadow,6,2,4
Pepitzaftw,sylvanas,192,priest,shadow,6,2,4
Clemexyo,stormscale,192,priest,shadow,6,2,4
Elëctra,vashj,192,priest,shadow,6,2,4
Önnÿ,dun-modr,192,priest,shadow,12,2,10
Karmapollys,silvermoon,191,priest,shadow,6,2,4
Edoran,ragnaros,159,priest,shadow,5,2,3
Shidoya,tarren-mill,159,priest,shadow,5,2,3
Girlidlion,twisting-nether,159,priest,shadow,5,2,3
Qku,ravencrest,144,priest,shadow,9,3,6
Alswynn,draenor,138,priest,shadow,13,3,10
Inferius,shadowsong,138,priest,shadow,16,3,13
Yologrumples,tarren-mill,128,priest,shadow,4,2,2
Fjonnski,blackmoore,96,priest,shadow,3,2,1
Cizer,kazzak,96,priest,shadow,6,1,5
Tryagain,ravencrest,96,priest,shadow,6,1,5
Uwucatgir,silvermoon,96,priest,shadow,6,1,5
Vès,stormscale,96,priest,shadow,6,1,5
Rines,thrall,96,priest,shadow,6,1,5
Príêstjklòl,stormscale,96,priest,shadow,6,1,5
Waina,defias-brotherhood,96,priest,shadow,6,1,5
Enduring,darksorrow,96,priest,shadow,6,1,5
Попячебрило,gordunni,96,priest,shadow,6,1,5
Skitcy,ghostlands,96,priest,shadow,6,1,5
Vtqt,outland,96,priest,shadow,6,1,5
Jakepriest,twisting-nether,96,priest,shadow,6,1,5
Ghostroller,ravencrest,96,priest,shadow,6,1,5
Gobie,sunstrider,96,priest,shadow,6,1,5
Stola,archimonde,96,priest,shadow,6,1,5
Nelpriest,hyjal,96,priest,shadow,6,1,5
Winstõn,sanguino,96,priest,shadow,6,1,5
Baltrom,ravencrest,96,priest,shadow,6,1,5
Oniakusa,outland,96,priest,shadow,6,1,5
Zukatana,tarren-mill,96,priest,shadow,6,1,5
Dianaxd,dun-modr,96,priest,shadow,6,1,5
Adev,drakthul,96,priest,shadow,6,1,5
Kales,grim-batol,96,priest,shadow,6,1,5
Kianprie,silvermoon,96,priest,shadow,6,1,5
Corefusion,blackrock,96,priest,shadow,6,1,5
Мегаствол,howling-fjord,96,priest,shadow,6,1,5
Shifune,blackhand,96,priest,shadow,6,1,5
Koíré,defias-brotherhood,96,priest,shadow,6,1,5
Kraanocska,outland,96,priest,shadow,6,1,5
Абсорбиболь,howling-fjord,96,priest,shadow,6,1,5
Deicidex,blackrock,96,priest,shadow,6,1,5
Shonsized,argent-dawn,96,priest,shadow,6,1,5
Bädx,silvermoon,96,priest,shadow,6,1,5
Maddøc,die-aldor,96,priest,shadow,6,1,5
Abudhabi,blackhand,96,priest,shadow,6,1,5
Tiras,argent-dawn,96,priest,shadow,12,1,11
Эсттелла,gordunni,96,priest,shadow,18,1,17
Peesussy,kazzak,79,priest,shadow,5,1,4
Xharyo,ravencrest,64,priest,shadow,4,1,3
Xavyos,eredar,64,priest,shadow,4,1,3
Gandals,shadowsong,64,priest,shadow,4,1,3
Achesita,sylvanas,48,priest,shadow,3,1,2
Holyhigh,baelgun,31,priest,shadow,2,1,1
Mjuk,tarren-mill,16,priest,shadow,1,1,0
Rãz,stormscale,2130,rogue,outlaw,66,36,30
Kekuriix,vashj,1877,rogue,outlaw,112,60,52
Макевин,gordunni,1816,rogue,outlaw,70,32,38
Дизелюжн,howling-fjord,1812,rogue,outlaw,165,83,82
Феинт,galakrond,1739,rogue,outlaw,48,19,29
Yessa,argent-dawn,1721,rogue,outlaw,36,18,18
Koopa,argent-dawn,1696,rogue,outlaw,48,24,24
Jalsket,tarren-mill,1666,rogue,outlaw,36,20,16
Kreayx,ysondre,1666,rogue,outlaw,42,19,23
Radiogodx,stormscale,1662,rogue,outlaw,92,44,48
Kreay,ysondre,1620,rogue,outlaw,42,20,22
Lidiaubaro,ravencrest,1581,rogue,outlaw,239,118,121
Kreay,tarren-mill,1576,rogue,outlaw,40,29,11
Syrn,ravencrest,1551,rogue,outlaw,60,27,33
Krixor,ravencrest,1519,rogue,outlaw,42,16,26
Ранконх,lich-king,1502,rogue,outlaw,50,17,33
Зувер,blackscar,1494,rogue,outlaw,106,57,49
Deevoll,tarren-mill,1481,rogue,outlaw,102,45,57
Sigleif,argent-dawn,1471,rogue,outlaw,111,57,54
Bonelesschic,silvermoon,1446,rogue,outlaw,125,67,58
Loubina,silvermoon,1446,rogue,outlaw,36,16,20
Déjávu,ravencrest,1426,rogue,outlaw,30,15,15
Nèwt,aggramar,1419,rogue,outlaw,84,40,44
Scotlander,argent-dawn,1401,rogue,outlaw,30,15,15
Cryneth,ravencrest,1373,rogue,outlaw,51,25,26
Jasolo,silvermoon,1370,rogue,outlaw,204,117,87
Shredfngrz,garona,1337,rogue,outlaw,32,15,17
Murkyy,gilneas,1329,rogue,outlaw,32,16,16
Djeud,archimonde,1325,rogue,outlaw,64,34,30
Carvyn,defias-brotherhood,1324,rogue,outlaw,57,28,29
Tidløs,dun-morogh,1316,rogue,outlaw,53,21,32
Sqz,archimonde,1222,rogue,outlaw,30,18,12
Шторкаа,gordunni,1214,rogue,outlaw,33,19,14
Jinzou,blackmoore,1200,rogue,outlaw,51,27,24
Röguetönerö,dun-modr,1150,rogue,outlaw,30,12,18
Spiochrr,burning-legion,1064,rogue,outlaw,44,17,27
Lättja,hyjal,1059,rogue,outlaw,24,12,12
Eukaryot,aggra-português,1054,rogue,outlaw,24,11,13
Bannedfrigid,outland,1054,rogue,outlaw,30,11,19
Svddendeath,ragnaros,1034,rogue,outlaw,24,11,13
Génn,silvermoon,1009,rogue,outlaw,38,17,21
Soothinqq,emerald-dream,963,rogue,outlaw,23,15,8
Lïke,frostwolf,960,rogue,outlaw,18,10,8
Foulsteel,stormscale,951,rogue,outlaw,18,10,8
Åråmsëß,grim-batol,950,rogue,outlaw,18,10,8
Melahl,kazzak,935,rogue,outlaw,24,13,11
Bxtchslayer,blackmoore,876,rogue,outlaw,18,10,8
Pistolpete,grim-batol,864,rogue,outlaw,24,9,15
Bikrut,hyjal,768,rogue,outlaw,12,8,4
Gerzy,drakthul,768,rogue,outlaw,18,8,10
Джулт,soulflayer,767,rogue,outlaw,24,8,16
Blàckbèàrd,silvermoon,753,rogue,outlaw,36,13,23
Shichi,archimonde,751,rogue,outlaw,23,8,15
Omuspan,magtheridon,737,rogue,outlaw,24,9,15
Dêlaral,der-rat-von-dalaran,672,rogue,outlaw,16,8,8
Rogiko,twisting-nether,672,rogue,outlaw,18,7,11
Kidneyou,ragnaros,672,rogue,outlaw,18,7,11
Omgjkgtfo,ravencrest,671,rogue,outlaw,18,7,11
Badabôôm,wrathbringer,670,rogue,outlaw,18,7,11
Hânnäh,hyjal,647,rogue,outlaw,18,7,11
Фофламидзе,gordunni,611,rogue,outlaw,15,7,8
Xsanji,kazzak,576,rogue,outlaw,12,6,6
Vokhun,outland,576,rogue,outlaw,12,6,6
Anom,kargath,575,rogue,outlaw,12,6,6
Pidroseus,argent-dawn,575,rogue,outlaw,12,6,6
Маллестар,ashenvale,575,rogue,outlaw,12,6,6
Noodlegoose,tarren-mill,575,rogue,outlaw,12,6,6
Кингксу,gordunni,575,rogue,outlaw,24,6,18
Okani,hyjal,574,rogue,outlaw,12,6,6
Тимареканец,eversong,572,rogue,outlaw,18,6,12
Zômbiê,blackrock,491,rogue,outlaw,13,6,7
Fivepoint,blackmoore,480,rogue,outlaw,12,5,7
Faoil,defias-brotherhood,480,rogue,outlaw,12,5,7
Featfawkes,ragnaros,480,rogue,outlaw,12,5,7
Nocrath,blades-edge,479,rogue,outlaw,12,5,7
Dredge,kaelthas,479,rogue,outlaw,12,5,7
Chillo,ravencrest,384,rogue,outlaw,6,4,2
Zep,auchindoun,384,rogue,outlaw,6,4,2
Zbojník,ravencrest,384,rogue,outlaw,6,4,2
Delrøq,draenor,384,rogue,outlaw,6,4,2
Synexo,sylvanas,384,rogue,outlaw,12,4,8
Mïta,blackmoore,383,rogue,outlaw,6,4,2
Trímønâ,gorgonnash,351,rogue,outlaw,11,4,7
Masteez,ahnqiraj,318,rogue,outlaw,5,4,1
Zyreanxy,blackrock,288,rogue,outlaw,6,3,3
Shadxwstep,ravencrest,288,rogue,outlaw,6,3,3
Mol,defias-brotherhood,288,rogue,outlaw,6,3,3
Cigarette,emeriss,288,rogue,outlaw,6,3,3
Играючестно,howling-fjord,288,rogue,outlaw,6,3,3
Onlyluvhurt,dun-modr,288,rogue,outlaw,6,3,3
Finisher,sanguino,288,rogue,outlaw,12,3,9
Szpachela,burning-legion,288,rogue,outlaw,12,3,9
Heulleise,die-ewige-wacht,288,rogue,outlaw,12,3,9
Mcgora,doomhammer,286,rogue,outlaw,6,3,3
Tipok,tarren-mill,286,rogue,outlaw,12,3,9
Rivso,auchindoun,255,rogue,outlaw,20,4,16
Nyxal,argent-dawn,192,rogue,outlaw,6,2,4
Berneo,burning-legion,192,rogue,outlaw,6,2,4
Stunlock,silvermoon,192,rogue,outlaw,6,2,4
Dawnsaber,argent-dawn,192,rogue,outlaw,6,2,4
Trixnaz,silvermoon,192,rogue,outlaw,6,2,4
Оргельна,gordunni,192,rogue,outlaw,6,2,4
Nomota,sanguino,192,rogue,outlaw,6,2,4
Zind,dalaran,192,rogue,outlaw,6,2,4
Sneakysteve,bloodfeather,192,rogue,outlaw,6,2,4
Banaulikode,twisting-nether,192,rogue,outlaw,6,2,4
Mawrat,mazrigos,192,rogue,outlaw,6,2,4
Snøv,outland,192,rogue,outlaw,6,2,4
Alvoriace,hyjal,192,rogue,outlaw,12,2,10
Valtesse,medivh,159,rogue,outlaw,5,2,3
Геопанк,howling-fjord,144,rogue,outlaw,3,3,0
Ñøway,archimonde,96,rogue,outlaw,3,2,1
Vaze,ravencrest,96,rogue,outlaw,6,1,5
Ótsutsukí,kazzak,96,rogue,outlaw,6,1,5
Yüm,burning-blade,96,rogue,outlaw,6,1,5
Mallaurya,dalaran,96,rogue,outlaw,6,1,5
Ciaordel,sylvanas,96,rogue,outlaw,6,1,5
Леронда,deepholm,96,rogue,outlaw,6,1,5
Dritzdourden,dun-modr,96,rogue,outlaw,6,1,5
Pasarelo,dun-modr,96,rogue,outlaw,6,1,5
Sty,aerie-peak,96,rogue,outlaw,6,1,5
Nabatean,magtheridon,48,rogue,outlaw,3,1,2
Getbleeded,stormscale,31,rogue,outlaw,2,1,1
Cazzette,ravencrest,2204,rogue,subtlety,81,48,33
Ncrø,aszune,2182,rogue,subtlety,73,46,27
Asumah,ravencrest,2143,rogue,subtlety,84,50,34
Лолелт,borean-tundra,2131,rogue,subtlety,104,53,51
Denjinx,culte-de-la-rive-noire,2107,rogue,subtlety,78,43,35
Pridå,thrall,2107,rogue,subtlety,78,41,37
Lfgenjoyer,tarren-mill,2087,rogue,subtlety,108,67,41
Nàsklolz,hyjal,2035,rogue,subtlety,66,35,31
Sunø,archimonde,2018,rogue,subtlety,163,78,85
Эмилилавс,galakrond,2015,rogue,subtlety,182,107,75
Troxerboxer,tarren-mill,2000,rogue,subtlety,60,32,28
Naláa,ravencrest,1989,rogue,subtlety,42,24,18
Renhri,burning-legion,1968,rogue,subtlety,220,122,98
Ewynarog,silvermoon,1966,rogue,subtlety,53,28,25
Chatdisabled,drakthul,1962,rogue,subtlety,150,79,71
Aythusha,twisting-nether,1957,rogue,subtlety,54,31,23
Флексити,soulflayer,1939,rogue,subtlety,114,59,55
Смертьвсмоке,gordunni,1936,rogue,subtlety,206,101,105
Пожилойпупь,gordunni,1932,rogue,subtlety,42,25,17
Drydamage,kazzak,1930,rogue,subtlety,119,62,57
Asterisyup,silvermoon,1909,rogue,subtlety,89,55,34
Сильфитт,gordunni,1904,rogue,subtlety,70,41,29
Zuqzwang,outland,1901,rogue,subtlety,54,30,24
Clawdíte,blackrock,1895,rogue,subtlety,48,21,27
Lówskill,outland,1890,rogue,subtlety,145,77,68
Makethemrog,archimonde,1887,rogue,subtlety,68,34,34
Subzerõ,archimonde,1875,rogue,subtlety,94,43,51
Ладжо,gordunni,1874,rogue,subtlety,42,24,18
Guççí,blackrock,1873,rogue,subtlety,53,33,20
Sapécomejaja,archimonde,1866,rogue,subtlety,38,24,14
Brensø,nemesis,1857,rogue,subtlety,99,60,39
Vulkos,lightbringer,1855,rogue,subtlety,48,25,23
Иждолк,gordunni,1853,rogue,subtlety,66,40,26
Âkame,argent-dawn,1853,rogue,subtlety,59,32,27
Nahj,ravencrest,1851,rogue,subtlety,42,28,14
Shadezlöl,ravencrest,1849,rogue,subtlety,208,104,104
Chatbann,blackrock,1829,rogue,subtlety,130,73,57
Bleakhøuse,ravencrest,1829,rogue,subtlety,58,29,29
Illmatíc,ravencrest,1828,rogue,subtlety,56,29,27
Lízåriñ,ravencrest,1827,rogue,subtlety,48,38,10
Îlîlîlîlîlî,azuremyst,1826,rogue,subtlety,140,79,61
Ålleyézonme,ravencrest,1824,rogue,subtlety,65,29,36
Тохуо,lich-king,1822,rogue,subtlety,42,20,22
Radiogodx,stormscale,1817,rogue,subtlety,60,31,29
Tracersxrude,ravencrest,1817,rogue,subtlety,60,24,36
Iqws,ravencrest,1811,rogue,subtlety,54,29,25
Lilaven,turalyon,1810,rogue,subtlety,84,43,41
Çåñçér,sylvanas,1810,rogue,subtlety,66,30,36
Xtoyo,zuljin,1804,rogue,subtlety,54,29,25
Malasap,archimonde,1792,rogue,subtlety,163,89,74
Sly,emerald-dream,1789,rogue,subtlety,66,36,30
Gløøm,ravencrest,1788,rogue,subtlety,36,22,14
Insomnla,silvermoon,1786,rogue,subtlety,96,52,44
Stonyhavana,ravencrest,1785,rogue,subtlety,84,49,35
Sariena,sylvanas,1773,rogue,subtlety,95,52,43
Stråwberrý,archimonde,1753,rogue,subtlety,57,28,29
Роземсти,gordunni,1752,rogue,subtlety,126,67,59
Погибайдуде,gordunni,1749,rogue,subtlety,35,28,7
Инфера,lich-king,1741,rogue,subtlety,72,33,39
Røgger,ragnaros,1734,rogue,subtlety,125,59,66
Shadowprank,ravencrest,1731,rogue,subtlety,48,27,21
Ccedox,stormscale,1729,rogue,subtlety,30,20,10
Kenjí,silvermoon,1724,rogue,subtlety,59,28,31
Китей,howling-fjord,1723,rogue,subtlety,78,40,38
Trîçk,aegwynn,1719,rogue,subtlety,36,23,13
Sábros,ravencrest,1714,rogue,subtlety,108,50,58
Путьказаха,gordunni,1710,rogue,subtlety,48,27,21
Лайнэл,deathweaver,1699,rogue,subtlety,42,24,18
Yumiee,arygos,1697,rogue,subtlety,80,44,36
Бладстейн,blackscar,1684,rogue,subtlety,64,37,27
Cheapshôt,archimonde,1684,rogue,subtlety,105,59,46
Naïmitsu,hyjal,1678,rogue,subtlety,72,37,35
Брайнз,gordunni,1677,rogue,subtlety,73,49,24
Noraex,silvermoon,1677,rogue,subtlety,32,19,13
Xzr,stormscale,1668,rogue,subtlety,36,27,9
Rhayesh,silvermoon,1665,rogue,subtlety,100,47,53
Knoffchad,blackhand,1663,rogue,subtlety,62,33,29
Ccedolol,stormscale,1662,rogue,subtlety,59,32,27
Fivepoint,blackmoore,1652,rogue,subtlety,30,20,10
Säxnthecrity,blackmoore,1650,rogue,subtlety,189,99,90
Subsònik,tarren-mill,1645,rogue,subtlety,52,31,21
Getschwîfty,ravencrest,1639,rogue,subtlety,27,18,9
Handuil,blackmoore,1639,rogue,subtlety,107,58,49
Dancex,kazzak,1634,rogue,subtlety,42,28,14
Liarø,archimonde,1633,rogue,subtlety,93,49,44
Ipresskidney,tarren-mill,1629,rogue,subtlety,117,68,49
Denjastwo,archimonde,1628,rogue,subtlety,24,17,7
Doritomix,dun-modr,1628,rogue,subtlety,44,26,18
Lânnïster,kazzak,1626,rogue,subtlety,42,20,22
Ishízu,exodar,1625,rogue,subtlety,54,24,30
Keophz,tarren-mill,1623,rogue,subtlety,54,41,13
Asm,the-maelstrom,1622,rogue,subtlety,40,20,20
Tinylol,dun-morogh,1620,rogue,subtlety,48,29,19
Tanssy,ragnaros,1610,rogue,subtlety,50,28,22
Namelless,twisting-nether,1609,rogue,subtlety,72,34,38
Zømbië,kazzak,1604,rogue,subtlety,96,46,50
Ratirl,kult-der-verdammten,1603,rogue,subtlety,30,19,11
Aszaryn,magtheridon,1601,rogue,subtlety,54,32,22
Calestrian,tarren-mill,1601,rogue,subtlety,42,21,21
Ninjaassasin,aegwynn,1600,rogue,subtlety,70,41,29
Кишмякх,howling-fjord,1599,rogue,subtlety,72,24,48
Trapstar,stormscale,1596,rogue,subtlety,60,32,28
Vensq,drakthul,1596,rogue,subtlety,36,19,17
Mâêl,blackmoore,1593,rogue,subtlety,125,62,63
Dìsørderx,ravencrest,1590,rogue,subtlety,48,26,22
Txm,argent-dawn,1590,rogue,subtlety,36,18,18
Sniiky,kazzak,1586,rogue,subtlety,138,76,62
Baldoh,kazzak,1584,rogue,subtlety,36,24,12
Norlix,ravencrest,1583,rogue,subtlety,36,20,16
Вр,blackscar,1582,rogue,subtlety,30,18,12
Морзо,howling-fjord,1582,rogue,subtlety,66,39,27
Oxyrog,ravencrest,1580,rogue,subtlety,42,22,20
Хавиа,gordunni,1579,rogue,subtlety,35,21,14
Shyy,dun-modr,1568,rogue,subtlety,42,20,22
Ÿøßø,archimonde,1567,rogue,subtlety,36,19,17
Saptrinket,stormscale,1566,rogue,subtlety,65,27,38
Azirios,kazzak,1565,rogue,subtlety,42,20,22
Зорго,deathguard,1564,rogue,subtlety,60,34,26
Lotorr,burning-legion,1558,rogue,subtlety,29,17,12
Monero,thrall,1557,rogue,subtlety,49,30,19
Kire,daggerspine,1550,rogue,subtlety,59,30,29
Exanimu,ravencrest,1550,rogue,subtlety,132,58,74
Эренх,gordunni,1549,rogue,subtlety,110,60,50
Shaeni,silvermoon,1548,rogue,subtlety,78,44,34
Starfighter,pozzo-delleternità,1548,rogue,subtlety,61,30,31
Huej,tarren-mill,1544,rogue,subtlety,102,66,36
Voki,dalaran,1542,rogue,subtlety,81,46,35
Evivalarte,burning-legion,1542,rogue,subtlety,48,26,22
Madisonivyqt,blackmoore,1540,rogue,subtlety,42,22,20
Meldee,burning-legion,1539,rogue,subtlety,42,21,21
Shoxy,ravencrest,1534,rogue,subtlety,33,17,16
Zzemzza,kazzak,1533,rogue,subtlety,29,17,12
Cøntrøl,stormreaver,1531,rogue,subtlety,90,49,41
Sinist,twisting-nether,1531,rogue,subtlety,50,23,27
Ванэйти,gordunni,1529,rogue,subtlety,235,124,111
Susquehanna,ragnaros,1527,rogue,subtlety,48,22,26
Djswaghetti,stormscale,1525,rogue,subtlety,30,16,14
Zilemjr,stormscale,1522,rogue,subtlety,36,22,14
Kidknee,outland,1522,rogue,subtlety,36,18,18
Rogueas,stormscale,1521,rogue,subtlety,41,25,16
Chizué,sylvanas,1520,rogue,subtlety,24,16,8
Meccura,silvermoon,1513,rogue,subtlety,51,29,22
Zodracir,scarshield-legion,1512,rogue,subtlety,36,17,19
Skýfire,ravencrest,1512,rogue,subtlety,42,19,23
Ramses,onyxia,1508,rogue,subtlety,54,23,31
Jaikka,archimonde,1507,rogue,subtlety,24,17,7
Mortnoïre,naxxramas,1500,rogue,subtlety,36,20,16
Mxx,stormscale,1499,rogue,subtlety,116,70,46
Nihilix,dalaran,1499,rogue,subtlety,42,18,24
Daggerdashx,ravencrest,1491,rogue,subtlety,187,110,77
Абисиан,soulflayer,1490,rogue,subtlety,78,42,36
Dødgez,cthun,1489,rogue,subtlety,28,16,12
Шпилля,gordunni,1487,rogue,subtlety,77,38,39
Эдкенуэй,gordunni,1486,rogue,subtlety,107,60,47
Tonaxstab,ragnaros,1484,rogue,subtlety,36,19,17
Miiløx,silvermoon,1484,rogue,subtlety,47,20,27
Ibizå,ravencrest,1477,rogue,subtlety,36,18,18
Teba,cthun,1474,rogue,subtlety,34,19,15
Счастливое,howling-fjord,1472,rogue,subtlety,38,19,19
Sashikorosu,archimonde,1471,rogue,subtlety,45,30,15
Бэрнии,howling-fjord,1467,rogue,subtlety,54,25,29
Tripleníne,silvermoon,1464,rogue,subtlety,59,34,25
Loopermann,silvermoon,1463,rogue,subtlety,40,20,20
Anr,burning-legion,1461,rogue,subtlety,29,16,13
Lilrookie,argent-dawn,1458,rogue,subtlety,92,56,36
Шадовкилер,blackscar,1458,rogue,subtlety,66,34,32
Johnnyprep,ravencrest,1454,rogue,subtlety,54,29,25
Sacrehptit,naxxramas,1451,rogue,subtlety,30,20,10
Nightq,tarren-mill,1450,rogue,subtlety,57,34,23
Yourexwifey,ravencrest,1450,rogue,subtlety,86,47,39
Дернирог,howling-fjord,1449,rogue,subtlety,38,21,17
Chimp,darksorrow,1449,rogue,subtlety,41,22,19
Onlyluvhurt,dun-modr,1448,rogue,subtlety,88,47,41
Зенофар,soulflayer,1441,rogue,subtlety,103,48,55
Rat,mazrigos,1440,rogue,subtlety,24,15,9
Inyria,outland,1438,rogue,subtlety,118,61,57
Críppléz,ravencrest,1438,rogue,subtlety,48,24,24
Dêlaral,blackhand,1437,rogue,subtlety,30,15,15
Jáyjay,antonidas,1437,rogue,subtlety,54,23,31
Тира,grom,1436,rogue,subtlety,30,15,15
Calpic,sanguino,1435,rogue,subtlety,54,32,22
Ruck,madmortem,1434,rogue,subtlety,30,18,12
Смекрус,soulflayer,1434,rogue,subtlety,46,25,21
Abej,malygos,1432,rogue,subtlety,36,15,21
Morgan,argent-dawn,1431,rogue,subtlety,60,35,25
Absol,hellscream,1430,rogue,subtlety,36,22,14
Spr,malfurion,1430,rogue,subtlety,82,45,37
Deathcvlt,hyjal,1428,rogue,subtlety,84,41,43
Magepèt,tarren-mill,1426,rogue,subtlety,30,15,15
Grifika,outland,1425,rogue,subtlety,47,25,22
Elfreyja,archimonde,1413,rogue,subtlety,63,30,33
Maroshko,argent-dawn,1411,rogue,subtlety,30,16,14
Сабик,howling-fjord,1410,rogue,subtlety,24,17,7
Wraithh,minahonda,1409,rogue,subtlety,42,25,17
Grzech,burning-legion,1408,rogue,subtlety,60,28,32
Xãwé,kazzak,1405,rogue,subtlety,33,19,14
Memphismp,drakthul,1404,rogue,subtlety,29,15,14
Binbág,draenor,1402,rogue,subtlety,48,33,15
Svddendeath,ragnaros,1401,rogue,subtlety,42,21,21
Sumsarx,ravencrest,1400,rogue,subtlety,77,38,39
Xblackhole,tarren-mill,1393,rogue,subtlety,65,32,33
Winwin,silvermoon,1391,rogue,subtlety,91,59,32
Grindz,ravencrest,1391,rogue,subtlety,148,78,70
Ñavy,archimonde,1391,rogue,subtlety,66,29,37
Billybang,outland,1372,rogue,subtlety,65,36,29
Appatras,tarren-mill,1369,rogue,subtlety,23,15,8
Behindü,frostmane,1368,rogue,subtlety,54,27,27
Zx,frostmane,1368,rogue,subtlety,30,15,15
Жабоклик,gordunni,1363,rogue,subtlety,56,27,29
Gankbang,frostmane,1363,rogue,subtlety,78,35,43
Dópamine,hyjal,1362,rogue,subtlety,28,15,13
Zourkan,archimonde,1353,rogue,subtlety,119,67,52
Gamezcorex,aegwynn,1353,rogue,subtlety,52,22,30
Trimøná,gorgonnash,1351,rogue,subtlety,24,15,9
Dàwn,boulderfist,1349,rogue,subtlety,46,25,21
Nìghtwalker,ravencrest,1342,rogue,subtlety,58,28,30
Smøkyyx,eredar,1342,rogue,subtlety,30,14,16
Лолелт,howling-fjord,1341,rogue,subtlety,24,14,10
Tripx,ravencrest,1340,rogue,subtlety,121,64,57
Lechatbotté,tarren-mill,1339,rogue,subtlety,24,16,8
Featfawkes,ragnaros,1339,rogue,subtlety,24,14,10
Achterom,tarren-mill,1338,rogue,subtlety,68,26,42
Rantie,eredar,1336,rogue,subtlety,24,14,10
Воронкхал,ashenvale,1336,rogue,subtlety,30,14,16
Dölf,archimonde,1335,rogue,subtlety,59,32,27
Knutten,wildhammer,1334,rogue,subtlety,24,14,10
Yakio,silvermoon,1334,rogue,subtlety,48,19,29
Roguebot,draenor,1333,rogue,subtlety,29,16,13
Monoxid,eredar,1330,rogue,subtlety,39,20,19
Бэтх,soulflayer,1326,rogue,subtlety,36,21,15
Tyrly,ravencrest,1325,rogue,subtlety,58,29,29
Nexieane,ravencrest,1324,rogue,subtlety,72,39,33
Bleeds,thrall,1324,rogue,subtlety,47,24,23
Azovrouge,terokkar,1323,rogue,subtlety,84,45,39
Zerozsub,tarren-mill,1322,rogue,subtlety,48,28,20
Солевыегубки,gordunni,1322,rogue,subtlety,24,14,10
Хасилей,booty-bay,1317,rogue,subtlety,26,15,11
Daekrun,argent-dawn,1317,rogue,subtlety,44,22,22
Leepz,outland,1314,rogue,subtlety,30,17,13
Xeggy,turalyon,1311,rogue,subtlety,88,53,35
Silnce,outland,1311,rogue,subtlety,30,15,15
Старллесс,gordunni,1310,rogue,subtlety,125,63,62
Моямайя,eversong,1306,rogue,subtlety,24,14,10
Ворейн,howling-fjord,1306,rogue,subtlety,42,18,24
Levíeus,blackrock,1305,rogue,subtlety,90,52,38
Sicariø,argent-dawn,1301,rogue,subtlety,53,25,28
Luckeri,antonidas,1300,rogue,subtlety,66,32,34
Ryzem,archimonde,1291,rogue,subtlety,166,90,76
Ракфорн,howling-fjord,1289,rogue,subtlety,48,21,27
Qiiss,stormscale,1284,rogue,subtlety,30,17,13
Прошмандэ,gordunni,1282,rogue,subtlety,30,15,15
Swâggerino,kazzak,1280,rogue,subtlety,62,32,30
Subzy,burning-legion,1278,rogue,subtlety,64,36,28
Backcracker,thunderhorn,1274,rogue,subtlety,30,15,15
Zanaken,stormscale,1273,rogue,subtlety,69,35,34
Althieves,ravencrest,1272,rogue,subtlety,41,22,19
Guiltythief,stormscale,1272,rogue,subtlety,37,18,19
Шикорро,soulflayer,1266,rogue,subtlety,36,18,18
Latscholol,malorne,1260,rogue,subtlety,44,25,19
Usainßreak,chogall,1258,rogue,subtlety,24,14,10
Callboy,turalyon,1256,rogue,subtlety,42,20,22
Zergroidz,kazzak,1251,rogue,subtlety,48,22,26
Рестинписер,soulflayer,1249,rogue,subtlety,114,57,57
Slapshot,das-konsortium,1247,rogue,subtlety,24,13,11
Sunå,archimonde,1247,rogue,subtlety,24,13,11
Тучёна,soulflayer,1243,rogue,subtlety,42,25,17
Pfourtwenty,eredar,1243,rogue,subtlety,24,13,11
Лэйкиро,gordunni,1239,rogue,subtlety,24,13,11
Skillissuex,tarren-mill,1238,rogue,subtlety,69,40,29
Ézzah,blackhand,1236,rogue,subtlety,75,30,45
Sénsorium,draenor,1235,rogue,subtlety,89,41,48
Пораменяться,gordunni,1233,rogue,subtlety,87,37,50
Xaiko,baelgun,1232,rogue,subtlety,27,19,8
Ithilyien,blackmoore,1232,rogue,subtlety,44,16,28
Diazz,aegwynn,1231,rogue,subtlety,24,13,11
Jugalos,ravencrest,1230,rogue,subtlety,35,13,22
Kïdney,stormscale,1228,rogue,subtlety,48,26,22
Adwl,archimonde,1226,rogue,subtlety,45,20,25
Ултра,gordunni,1217,rogue,subtlety,81,38,43
Akira,outland,1215,rogue,subtlety,48,27,21
Местьбучи,howling-fjord,1214,rogue,subtlety,30,13,17
Sapperinö,sylvanas,1214,rogue,subtlety,30,13,17
Ксионас,gordunni,1212,rogue,subtlety,82,36,46
Wøølfgang,archimonde,1209,rogue,subtlety,66,30,36
Architeggt,eredar,1209,rogue,subtlety,38,14,24
Gansull,nemesis,1207,rogue,subtlety,30,13,17
Коффемолка,ashenvale,1204,rogue,subtlety,60,25,35
Ganker,antonidas,1202,rogue,subtlety,30,15,15
Avøry,antonidas,1201,rogue,subtlety,30,13,17
Чайрлайн,blackscar,1190,rogue,subtlety,40,17,23
Arrzhan,silvermoon,1184,rogue,subtlety,28,19,9
Hashlund,stormscale,1181,rogue,subtlety,38,17,21
Воруюнарынке,gordunni,1180,rogue,subtlety,68,45,23
Tinyshank,drakthul,1173,rogue,subtlety,20,13,7
Сладкийперец,borean-tundra,1172,rogue,subtlety,52,24,28
Darkan,kaelthas,1159,rogue,subtlety,48,29,19
Stin,blackrock,1155,rogue,subtlety,82,31,51
Howton,archimonde,1152,rogue,subtlety,18,12,6
Skitzo,ravencrest,1152,rogue,subtlety,24,12,12
Moroz,ravencrest,1150,rogue,subtlety,24,12,12
Salakelmi,sylvanas,1149,rogue,subtlety,18,12,6
Darkxenojiva,blackmoore,1146,rogue,subtlety,24,12,12
Kickcake,ravencrest,1144,rogue,subtlety,30,12,18
Jaydeeñ,ravencrest,1142,rogue,subtlety,30,12,18
Sâybyëbæ,dun-modr,1142,rogue,subtlety,30,12,18
Jomoama,norgannon,1142,rogue,subtlety,36,14,22
Veryscaryguý,twisting-nether,1140,rogue,subtlety,18,12,6
ßøß,ysondre,1135,rogue,subtlety,44,21,23
Trímønâ,gorgonnash,1134,rogue,subtlety,30,12,18
Smoothiè,twisting-nether,1128,rogue,subtlety,36,14,22
Stuxothug,silvermoon,1126,rogue,subtlety,43,25,18
Thehand,eonar,1126,rogue,subtlety,42,24,18
Faelylanea,argent-dawn,1122,rogue,subtlety,36,16,20
Янимагу,soulflayer,1122,rogue,subtlety,47,18,29
Exbandit,sanguino,1118,rogue,subtlety,18,12,6
Попочке,soulflayer,1116,rogue,subtlety,18,13,5
Xkebyzlobg,outland,1112,rogue,subtlety,23,12,11
Coronababy,argent-dawn,1111,rogue,subtlety,24,13,11
Ambushmike,gorgonnash,1107,rogue,subtlety,30,13,17
Sênsus,antonidas,1106,rogue,subtlety,62,22,40
Unreallx,silvermoon,1102,rogue,subtlety,80,36,44
Kryptonite,nemesis,1092,rogue,subtlety,28,12,16
Yüm,burning-blade,1087,rogue,subtlety,59,25,34
Blantek,defias-brotherhood,1083,rogue,subtlety,30,16,14
Whaiipy,ravencrest,1081,rogue,subtlety,74,44,30
Fastspectre,ravencrest,1077,rogue,subtlety,48,26,22
Stâr,archimonde,1077,rogue,subtlety,28,13,15
Löka,amanthul,1071,rogue,subtlety,117,59,58
Псиихооз,eversong,1070,rogue,subtlety,25,13,12
Cesârion,antonidas,1069,rogue,subtlety,118,47,71
Protolink,zuljin,1061,rogue,subtlety,36,13,23
Скорпеон,deathguard,1059,rogue,subtlety,24,17,7
Çhimaev,ravencrest,1056,rogue,subtlety,16,12,4
Elnyasha,ravencrest,1056,rogue,subtlety,24,11,13
Roundrobin,ravencrest,1056,rogue,subtlety,30,11,19
Vögue,burning-legion,1055,rogue,subtlety,18,11,7
Флеймсфорт,gordunni,1055,rogue,subtlety,35,16,19
Kleptomancy,sylvanas,1054,rogue,subtlety,18,11,7
Exiv,ragnaros,1053,rogue,subtlety,30,11,19
Nirvána,outland,1051,rogue,subtlety,53,26,27
Maam,ravencrest,1046,rogue,subtlety,18,11,7
Розбэйник,gordunni,1039,rogue,subtlety,30,16,14
Ithru,twisting-nether,1035,rogue,subtlety,102,51,51
Drakaess,archimonde,1032,rogue,subtlety,24,11,13
Горланг,ashenvale,1031,rogue,subtlety,29,15,14
Зебол,howling-fjord,1024,rogue,subtlety,36,17,19
Yamoshí,sanguino,1024,rogue,subtlety,34,15,19
Рэйбэк,howling-fjord,1024,rogue,subtlety,30,11,19
Lovetospoon,ravencrest,1013,rogue,subtlety,31,13,18
Pochîta,blackrock,1013,rogue,subtlety,41,17,24
Mercìles,kazzak,1009,rogue,subtlety,37,22,15
Сабанутый,howling-fjord,1002,rogue,subtlety,72,38,34
Obsçuritý,ragnaros,1001,rogue,subtlety,35,17,18
Leylaris,argent-dawn,998,rogue,subtlety,30,12,18
Sassasine,amanthul,997,rogue,subtlety,40,17,23
Drakhez,sanguino,995,rogue,subtlety,18,12,6
Cuckboy,chogall,995,rogue,subtlety,43,25,18
Lêgòlàs,blackmoore,983,rogue,subtlety,32,15,17
Thicck,twisting-nether,980,rogue,subtlety,48,13,35
Mâtâtâ,die-ewige-wacht,979,rogue,subtlety,23,15,8
Narar,stormscale,974,rogue,subtlety,18,11,7
Niinim,draenor,971,rogue,subtlety,81,42,39
Mannheim,kazzak,968,rogue,subtlety,42,23,19
Пузэн,howling-fjord,964,rogue,subtlety,18,12,6
Sákiqt,ravencrest,960,rogue,subtlety,18,10,8
Fîññ,ravencrest,960,rogue,subtlety,18,10,8
Нойсеен,gordunni,960,rogue,subtlety,18,10,8
Såj,tarren-mill,960,rogue,subtlety,24,10,14
Noboorstsub,ravencrest,959,rogue,subtlety,12,10,2
Øê,ravencrest,955,rogue,subtlety,21,10,11
Анивиана,howling-fjord,955,rogue,subtlety,24,10,14
Fugly,ragnaros,955,rogue,subtlety,26,10,16
Rêve,the-maelstrom,954,rogue,subtlety,18,10,8
Asine,boulderfist,954,rogue,subtlety,24,10,14
Káríc,draenor,953,rogue,subtlety,18,10,8
Oazo,ysondre,951,rogue,subtlety,35,13,22
Pixelrogue,argent-dawn,946,rogue,subtlety,16,11,5
Mishøna,kazzak,939,rogue,subtlety,73,41,32
Rêdbello,dun-morogh,937,rogue,subtlety,36,20,16
Hemorhoid,outland,929,rogue,subtlety,72,38,34
Frequenzalfa,silvermoon,926,rogue,subtlety,22,11,11
Koutzai,stormscale,925,rogue,subtlety,29,10,19
Kezaay,silvermoon,923,rogue,subtlety,24,13,11
Aeønaxx,hyjal,915,rogue,subtlety,48,21,27
Fizgaroth,argent-dawn,911,rogue,subtlety,24,13,11
Sycko,alakir,908,rogue,subtlety,30,16,14
Wìzléy,ravencrest,904,rogue,subtlety,30,16,14
Sentaria,argent-dawn,903,rogue,subtlety,36,18,18
Saroumani,eitrigg,891,rogue,subtlety,30,16,14
Katarïnä,khaz-modan,887,rogue,subtlety,24,11,13
Беточка,gordunni,883,rogue,subtlety,24,11,13
Ecray,burning-legion,877,rogue,subtlety,30,14,16
Kouru,outland,871,rogue,subtlety,25,10,15
Kostik,ravencrest,864,rogue,subtlety,12,9,3
Фрозенденс,gordunni,864,rogue,subtlety,12,9,3
Cheapshotwin,nethersturm,864,rogue,subtlety,12,9,3
Whaazlysnipz,tarren-mill,864,rogue,subtlety,12,9,3
Rãz,stormscale,864,rogue,subtlety,12,9,3
Randomidiot,ravencrest,864,rogue,subtlety,12,9,3
Axroa,blackmoore,864,rogue,subtlety,18,9,9
Deadraw,aegwynn,864,rogue,subtlety,18,9,9
Ðéstr,ravencrest,864,rogue,subtlety,18,9,9
Geá,ravencrest,864,rogue,subtlety,18,9,9
Amén,sanguino,864,rogue,subtlety,24,9,15
Cørek,blackhand,863,rogue,subtlety,18,9,9
Háttori,twisting-nether,863,rogue,subtlety,18,9,9
Ryvz,ravencrest,863,rogue,subtlety,24,9,15
Márto,archimonde,863,rogue,subtlety,24,9,15
Shízzel,blackhand,862,rogue,subtlety,18,9,9
Crixor,blackrock,861,rogue,subtlety,12,9,3
Дакоока,soulflayer,861,rogue,subtlety,12,9,3
Opaska,ravencrest,861,rogue,subtlety,24,9,15
Eightball,frostmane,859,rogue,subtlety,18,9,9
Jaqenhghar,pozzo-delleternità,859,rogue,subtlety,18,9,9
Sequoja,blackrock,858,rogue,subtlety,24,9,15
Finkle,blackmoore,856,rogue,subtlety,24,9,15
Антиппод,razuvious,854,rogue,subtlety,15,10,5
Mckk,tarren-mill,853,rogue,subtlety,18,9,9
Vampor,sylvanas,852,rogue,subtlety,30,9,21
Dainhek,gilneas,841,rogue,subtlety,31,14,17
Liquidgaba,ravencrest,840,rogue,subtlety,60,26,34
Duzhel,kazzak,812,rogue,subtlety,17,9,8
Тайнушка,soulflayer,806,rogue,subtlety,30,9,21
Bloodsmell,outland,798,rogue,subtlety,11,9,2
Skene,sanguino,780,rogue,subtlety,35,13,22
Danori,grim-batol,768,rogue,subtlety,12,8,4
Lilbubblegum,emerald-dream,768,rogue,subtlety,12,8,4
Djdillá,kazzak,768,rogue,subtlety,12,8,4
Фрозенблейдс,gordunni,768,rogue,subtlety,12,8,4
Fivepointx,blackmoore,768,rogue,subtlety,12,8,4
Devourswine,argent-dawn,768,rogue,subtlety,12,8,4
Ziqqi,thrall,768,rogue,subtlety,12,8,4
Whoton,archimonde,768,rogue,subtlety,16,9,7
Amuini,magtheridon,768,rogue,subtlety,18,8,10
Zygzäg,hyjal,768,rogue,subtlety,18,8,10
Ач,gordunni,768,rogue,subtlety,18,8,10
Løre,blackrock,768,rogue,subtlety,24,8,16
Neyokqt,blackrock,767,rogue,subtlety,12,8,4
Ferrãof,aggra-português,767,rogue,subtlety,12,8,4
Zëkke,sanguino,767,rogue,subtlety,12,8,4
Bamsejuicee,kazzak,767,rogue,subtlety,12,8,4
Misantropia,nemesis,767,rogue,subtlety,12,8,4
Jenz,blackmoore,767,rogue,subtlety,18,8,10
Mdadx,stormreaver,767,rogue,subtlety,18,8,10
Aahz,tarren-mill,767,rogue,subtlety,18,8,10
Akwaaba,ravencrest,767,rogue,subtlety,21,9,12
Nâzaar,antonidas,766,rogue,subtlety,12,8,4
Vanéry,ravencrest,766,rogue,subtlety,12,8,4
Jkrx,draenor,766,rogue,subtlety,18,8,10
Jqmie,ravencrest,766,rogue,subtlety,18,8,10
Sokillu,silvermoon,766,rogue,subtlety,18,8,10
Poughkeepsie,outland,765,rogue,subtlety,18,8,10
Люняшка,booty-bay,765,rogue,subtlety,18,8,10
Tripoid,draenor,765,rogue,subtlety,24,8,16
Purexrogue,dragonblight,764,rogue,subtlety,18,8,10
Ojisanx,outland,764,rogue,subtlety,24,8,16
Byonics,durotan,763,rogue,subtlety,12,8,4
Deprress,silvermoon,762,rogue,subtlety,12,8,4
Anala,stormreaver,761,rogue,subtlety,12,8,4
Lenwe,blackmoore,755,rogue,subtlety,18,8,10
Copoka,dun-morogh,753,rogue,subtlety,18,8,10
Faable,silvermoon,742,rogue,subtlety,47,16,31
Abomïñatïøñ,ravencrest,735,rogue,subtlety,30,10,20
Rmp,khaz-modan,720,rogue,subtlety,30,9,21
Jailkaz,thrall,713,rogue,subtlety,17,8,9
Nakli,antonidas,713,rogue,subtlety,21,9,12
Petsakos,ravencrest,713,rogue,subtlety,21,9,12
Naiikaii,aegwynn,688,rogue,subtlety,14,8,6
Рэкрейвон,gordunni,672,rogue,subtlety,12,7,5
Droomprins,stormscale,672,rogue,subtlety,12,7,5
Кумоо,gordunni,672,rogue,subtlety,12,7,5
Änanké,outland,672,rogue,subtlety,12,7,5
Belwarx,darksorrow,672,rogue,subtlety,18,7,11
Социалистсс,gordunni,672,rogue,subtlety,18,7,11
Azziinoth,ragnaros,672,rogue,subtlety,24,7,17
Sheldowws,tarren-mill,671,rogue,subtlety,12,7,5
Zeiden,sanguino,671,rogue,subtlety,12,7,5
Nairobii,tarren-mill,671,rogue,subtlety,12,7,5
Hyake,zuljin,671,rogue,subtlety,12,7,5
Faptastíc,blackmoore,671,rogue,subtlety,12,7,5
Reprouvette,dalaran,671,rogue,subtlety,12,7,5
Cnac,stormscale,671,rogue,subtlety,12,7,5
Anklash,blackrock,671,rogue,subtlety,16,7,9
Shâdowfreeze,onyxia,671,rogue,subtlety,18,7,11
Snack,burning-legion,671,rogue,subtlety,18,7,11
Roronao,sanguino,671,rogue,subtlety,18,7,11
Quq,kazzak,671,rogue,subtlety,18,7,11
Teralala,kazzak,671,rogue,subtlety,18,7,11
Daggoth,kiljaeden,671,rogue,subtlety,24,7,17
Cataleýa,outland,670,rogue,subtlety,12,7,5
Lepreuchan,archimonde,669,rogue,subtlety,12,7,5
Axeldarq,draenor,669,rogue,subtlety,24,7,17
Taniwa,archimonde,668,rogue,subtlety,24,7,17
Pepperbox,twisting-nether,667,rogue,subtlety,12,7,5
Cacucoxpahu,kazzak,666,rogue,subtlety,12,7,5
Skankky,ragnaros,660,rogue,subtlety,12,7,5
Ratolí,dun-modr,658,rogue,subtlety,12,7,5
Nineball,frostmane,638,rogue,subtlety,17,7,10
Maxtnulaujeu,archimonde,621,rogue,subtlety,17,7,10
Actualcarry,dentarg,617,rogue,subtlety,12,8,4
Thiranor,cthun,583,rogue,subtlety,13,7,6
Дэмайо,gordunni,576,rogue,subtlety,6,6,0
Naiikaii,antonidas,576,rogue,subtlety,6,6,0
Whøråcle,tarren-mill,576,rogue,subtlety,6,6,0
Strangeboy,ravencrest,576,rogue,subtlety,6,6,0
Feradelia,thrall,576,rogue,subtlety,12,6,6
Radgaa,draenor,576,rogue,subtlety,12,6,6
Jljr,twisting-nether,576,rogue,subtlety,12,6,6
Draytonlove,nemesis,576,rogue,subtlety,12,6,6
Ibizà,ravencrest,576,rogue,subtlety,12,6,6
Bizzarerogue,tarren-mill,576,rogue,subtlety,12,6,6
Kyssme,archimonde,576,rogue,subtlety,12,6,6
Carvyn,defias-brotherhood,576,rogue,subtlety,12,6,6
Àlleyezonme,ravencrest,576,rogue,subtlety,12,6,6
Smílèy,ravencrest,576,rogue,subtlety,12,6,6
Rinj,antonidas,576,rogue,subtlety,12,6,6
Jabbz,blackhand,576,rogue,subtlety,12,6,6
Notôríous,ravencrest,576,rogue,subtlety,12,6,6
Briggo,silvermoon,576,rogue,subtlety,12,6,6
Deceptionz,ravencrest,576,rogue,subtlety,12,6,6
Ðelvin,dalaran,576,rogue,subtlety,12,6,6
Denjas,archimonde,576,rogue,subtlety,12,6,6
Xiro,dalaran,576,rogue,subtlety,18,6,12
Blihhubba,silvermoon,576,rogue,subtlety,24,6,18
Aouron,archimonde,575,rogue,subtlety,12,6,6
Сармонн,howling-fjord,575,rogue,subtlety,12,6,6
Melfîce,blackhand,575,rogue,subtlety,12,6,6
Пусякиллерх,gordunni,575,rogue,subtlety,12,6,6
Stabymoose,draenor,575,rogue,subtlety,12,6,6
Niapro,dun-morogh,575,rogue,subtlety,12,6,6
Botnet,blackmoore,575,rogue,subtlety,12,6,6
Rogueseanne,blackrock,575,rogue,subtlety,12,6,6
Фордрэн,deathguard,575,rogue,subtlety,16,7,9
Эрихард,howling-fjord,575,rogue,subtlety,17,6,11
Hersuub,blackmoore,574,rogue,subtlety,12,6,6
Jisz,doomhammer,574,rogue,subtlety,12,6,6
Freddybst,twisting-nether,571,rogue,subtlety,12,6,6
Lêvî,sanguino,569,rogue,subtlety,12,6,6
Rhaacvar,magtheridon,566,rogue,subtlety,12,6,6
Grikra,argent-dawn,566,rogue,subtlety,12,6,6
Geroge,sylvanas,566,rogue,subtlety,12,6,6
Grekén,bronze-dragonflight,558,rogue,subtlety,17,6,11
Pavlo,nathrezim,543,rogue,subtlety,17,6,11
Drspectres,tarren-mill,543,rogue,subtlety,30,6,24
Zobrak,twisting-nether,542,rogue,subtlety,14,7,7
Xulem,silvermoon,511,rogue,subtlety,10,6,4
Malignance,drakthul,511,rogue,subtlety,14,7,7
Knifeex,ravencrest,509,rogue,subtlety,20,6,14
Чернабаев,soulflayer,480,rogue,subtlety,6,5,1
Zep,auchindoun,480,rogue,subtlety,6,5,1
Xyzonk,kazzak,480,rogue,subtlety,6,5,1
Chazsakaï,chogall,480,rogue,subtlety,6,5,1
Sfyr,ysondre,480,rogue,subtlety,6,5,1
Бонястелс,gordunni,480,rogue,subtlety,6,5,1
Фэйкуои,gordunni,480,rogue,subtlety,6,5,1
Sÿkz,hyjal,480,rogue,subtlety,6,5,1
Meshay,kazzak,480,rogue,subtlety,7,5,2
Киднитучер,fordragon,480,rogue,subtlety,12,5,7
Стеллакокс,howling-fjord,480,rogue,subtlety,12,5,7
Lurk,saurfang,480,rogue,subtlety,12,5,7
Jdç,tarren-mill,480,rogue,subtlety,12,5,7
Khepaso,sanguino,480,rogue,subtlety,12,5,7
Darkveil,xavius,480,rogue,subtlety,12,5,7
Blazestórm,stormscale,480,rogue,subtlety,12,5,7
Srtumor,zuljin,480,rogue,subtlety,12,5,7
Deevoll,tarren-mill,480,rogue,subtlety,12,5,7
Slicéndicé,wildhammer,480,rogue,subtlety,12,5,7
Kleptomaniac,aggra-português,480,rogue,subtlety,12,5,7
Loznah,outland,480,rogue,subtlety,12,5,7
Releaserage,draenor,480,rogue,subtlety,12,5,7
Akyô,archimonde,480,rogue,subtlety,12,5,7
Röguelol,outland,480,rogue,subtlety,12,5,7
Decoyed,sylvanas,480,rogue,subtlety,12,5,7
Mzaa,ravencrest,480,rogue,subtlety,12,5,7
Khazren,ravencrest,480,rogue,subtlety,12,5,7
Кашеварить,gordunni,480,rogue,subtlety,12,5,7
Фрозеншедов,gordunni,480,rogue,subtlety,12,5,7
Slayered,burning-legion,480,rogue,subtlety,18,5,13
Ajwenx,ravencrest,480,rogue,subtlety,18,5,13
Ryxon,arathor,479,rogue,subtlety,12,5,7
Houston,aegwynn,479,rogue,subtlety,12,5,7
Sambä,sanguino,479,rogue,subtlety,12,5,7
Smorcoolio,stormscale,479,rogue,subtlety,12,5,7
Распяздяй,gordunni,479,rogue,subtlety,12,5,7
Sayy,nemesis,479,rogue,subtlety,18,5,13
Mozenn,draenor,478,rogue,subtlety,19,5,14
Strikes,eredar,477,rogue,subtlety,6,5,1
Эльтаэрон,gordunni,477,rogue,subtlety,12,5,7
Приколдэсса,gordunni,477,rogue,subtlety,18,5,13
Зацеп,gordunni,476,rogue,subtlety,12,5,7
Mallaurya,dalaran,474,rogue,subtlety,12,5,7
Cortzy,stormscale,448,rogue,subtlety,16,5,11
Кумаме,howling-fjord,447,rogue,subtlety,11,5,6
Райан,fordragon,431,rogue,subtlety,11,5,6
Algopyrin,ragnaros,396,rogue,subtlety,13,5,8
Cucumber,laughing-skull,384,rogue,subtlety,6,4,2
Smörkniven,argent-dawn,384,rogue,subtlety,6,4,2
Qylu,argent-dawn,384,rogue,subtlety,6,4,2
Siele,twisting-nether,384,rogue,subtlety,6,4,2
Pérplèxîty,thrall,384,rogue,subtlety,6,4,2
Tomassian,veknilash,384,rogue,subtlety,6,4,2
Нунас,soulflayer,384,rogue,subtlety,6,4,2
Mol,defias-brotherhood,384,rogue,subtlety,6,4,2
Mega,nordrassil,384,rogue,subtlety,6,4,2
Nxnja,silvermoon,384,rogue,subtlety,6,4,2
Йованов,gordunni,384,rogue,subtlety,6,4,2
Sebik,ravencrest,384,rogue,subtlety,6,4,2
Oczku,burning-legion,384,rogue,subtlety,6,4,2
Weird,blackmoore,384,rogue,subtlety,6,4,2
Ciosy,blackrock,384,rogue,subtlety,6,4,2
Rakzena,ravencrest,384,rogue,subtlety,6,4,2
Asmodal,antonidas,384,rogue,subtlety,6,4,2
Cawzi,silvermoon,384,rogue,subtlety,6,4,2
Pinnar,blackmoore,384,rogue,subtlety,6,4,2
Blckrogue,bloodfeather,384,rogue,subtlety,6,4,2
Ënd,ravencrest,384,rogue,subtlety,6,4,2
Nopzs,outland,384,rogue,subtlety,6,4,2
Джеанит,gordunni,384,rogue,subtlety,6,4,2
Nøctürnë,archimonde,384,rogue,subtlety,6,4,2
Læffgøðx,stormscale,384,rogue,subtlety,6,4,2
Seeralex,anetheron,384,rogue,subtlety,6,4,2
Marcel,blackrock,384,rogue,subtlety,6,4,2
Møgzu,blackmoore,384,rogue,subtlety,6,4,2
Ocklol,archimonde,384,rogue,subtlety,6,4,2
Whiteløtûs,dun-modr,384,rogue,subtlety,12,4,8
Berneo,burning-legion,384,rogue,subtlety,12,4,8
Sátyrícon,ravencrest,384,rogue,subtlety,12,4,8
Andrizle,blackmoore,384,rogue,subtlety,12,4,8
Rímen,archimonde,384,rogue,subtlety,12,4,8
Huprâ,ravencrest,384,rogue,subtlety,12,4,8
Бейнс,howling-fjord,384,rogue,subtlety,12,4,8
Erenyeagerx,kazzak,384,rogue,subtlety,12,4,8
Roanz,stormreaver,384,rogue,subtlety,12,4,8
Bloodwraith,stormscale,384,rogue,subtlety,12,4,8
Yokze,ravencrest,384,rogue,subtlety,12,4,8
Szabina,outland,384,rogue,subtlety,12,4,8
Taishani,thrall,384,rogue,subtlety,12,4,8
Zordochrog,kazzak,384,rogue,subtlety,12,4,8
Máuul,ravencrest,384,rogue,subtlety,12,4,8
Sxpped,stormscale,384,rogue,subtlety,12,4,8
Очч,blackscar,384,rogue,subtlety,18,4,14
Plot,zenedar,384,rogue,subtlety,18,4,14
Galore,azjolnerub,384,rogue,subtlety,18,4,14
Бллейз,gordunni,384,rogue,subtlety,18,4,14
Vanishdotcom,blackrock,383,rogue,subtlety,6,4,2
Бекро,gordunni,383,rogue,subtlety,6,4,2
Charbiya,silvermoon,383,rogue,subtlety,6,4,2
Всечтобыло,howling-fjord,382,rogue,subtlety,6,4,2
Lolblizard,gorgonnash,382,rogue,subtlety,6,4,2
Синграйм,soulflayer,382,rogue,subtlety,6,4,2
Ashâa,hyjal,382,rogue,subtlety,6,4,2
Nekros,chromaggus,379,rogue,subtlety,12,4,8
Wurzelzepp,blackrock,335,rogue,subtlety,11,4,7
Войенх,gordunni,320,rogue,subtlety,10,4,6
Cozu,stormrage,317,rogue,subtlety,10,4,6
Opiïum,ysondre,303,rogue,subtlety,7,4,3
Кейнилин,gordunni,288,rogue,subtlety,6,3,3
Alexandra,kazzak,288,rogue,subtlety,6,3,3
Zayøn,outland,288,rogue,subtlety,6,3,3
Halucinogeno,silvermoon,288,rogue,subtlety,6,3,3
Pocketpaw,stormreaver,288,rogue,subtlety,6,3,3
Roguanal,hyjal,288,rogue,subtlety,6,3,3
Vanisshh,hyjal,288,rogue,subtlety,6,3,3
Ezk,eredar,288,rogue,subtlety,6,3,3
Pulvèr,dalaran,288,rogue,subtlety,6,3,3
Sneakysáp,ravencrest,288,rogue,subtlety,6,3,3
Waakie,frostmane,288,rogue,subtlety,6,3,3
Shâdow,ravenholdt,288,rogue,subtlety,6,3,3
Peeon,drakthul,288,rogue,subtlety,6,3,3
Checkormate,aegwynn,288,rogue,subtlety,6,3,3
Seregolas,argent-dawn,288,rogue,subtlety,6,3,3
Baradiir,defias-brotherhood,288,rogue,subtlety,6,3,3
Knifeparty,silvermoon,288,rogue,subtlety,6,3,3
Qira,burning-blade,288,rogue,subtlety,6,3,3
Xhemil,tarren-mill,288,rogue,subtlety,6,3,3
Isucu,burning-legion,288,rogue,subtlety,6,3,3
Kolto,argent-dawn,288,rogue,subtlety,6,3,3
Shadxwstep,ravencrest,288,rogue,subtlety,6,3,3
Sbx,alakir,288,rogue,subtlety,6,3,3
Элисандресса,gordunni,288,rogue,subtlety,6,3,3
Kerìon,nemesis,288,rogue,subtlety,6,3,3
Валанбалас,soulflayer,288,rogue,subtlety,6,3,3
Garou,blackhand,288,rogue,subtlety,6,3,3
Røguøross,archimonde,288,rogue,subtlety,6,3,3
Кеспул,soulflayer,288,rogue,subtlety,6,3,3
Rindar,dun-modr,288,rogue,subtlety,6,3,3
Sadgexd,draenor,288,rogue,subtlety,6,3,3
Swiftyfan,silvermoon,288,rogue,subtlety,6,3,3
Jawen,silvermoon,288,rogue,subtlety,6,3,3
Viiltäjäjack,stormscale,288,rogue,subtlety,6,3,3
Dimidimi,wildhammer,288,rogue,subtlety,6,3,3
Aluneran,silvermoon,288,rogue,subtlety,6,3,3
Nícks,tarren-mill,288,rogue,subtlety,6,3,3
Pretylo,marécage-de-zangar,288,rogue,subtlety,6,3,3
Flambî,dalaran,288,rogue,subtlety,6,3,3
Synthaetic,draenor,288,rogue,subtlety,6,3,3
Mekóz,draenor,288,rogue,subtlety,6,3,3
Nhèl,stormscale,288,rogue,subtlety,6,3,3
Izzyb,auchindoun,288,rogue,subtlety,6,3,3
Gøldzahn,antonidas,288,rogue,subtlety,6,3,3
Uareincombat,drakthul,288,rogue,subtlety,11,3,8
Kongnognog,ragnaros,288,rogue,subtlety,12,3,9
Kïbs,dalaran,288,rogue,subtlety,12,3,9
Coolspot,archimonde,288,rogue,subtlety,12,3,9
Ристоврация,gordunni,288,rogue,subtlety,12,3,9
Mns,drakthul,288,rogue,subtlety,12,3,9
Bú,nemesis,288,rogue,subtlety,12,3,9
Rufinol,twisting-nether,288,rogue,subtlety,12,3,9
Snøv,outland,288,rogue,subtlety,12,3,9
Izame,archimonde,288,rogue,subtlety,12,3,9
Envenoman,ravencrest,288,rogue,subtlety,12,3,9
Zavebe,nathrezim,288,rogue,subtlety,12,3,9
Skíll,sanguino,288,rogue,subtlety,12,3,9
Princip,drakthul,288,rogue,subtlety,12,3,9
Siktiritos,malganis,288,rogue,subtlety,12,3,9
Pestctrl,argent-dawn,288,rogue,subtlety,12,3,9
Vancleéf,sylvanas,288,rogue,subtlety,12,3,9
Воробнальщик,soulflayer,288,rogue,subtlety,12,3,9
Ñú,ravencrest,288,rogue,subtlety,12,3,9
Zoldyck,bloodhoof,288,rogue,subtlety,12,3,9
Xéshon,tarren-mill,288,rogue,subtlety,12,3,9
Кэйтлис,howling-fjord,288,rogue,subtlety,12,3,9
Djinnx,malganis,288,rogue,subtlety,12,3,9
Xyúmopjoßblú,ravencrest,288,rogue,subtlety,12,3,9
Cbrook,sylvanas,288,rogue,subtlety,12,3,9
Puge,norgannon,288,rogue,subtlety,12,3,9
Helcof,emerald-dream,288,rogue,subtlety,12,3,9
Sinxgødx,outland,288,rogue,subtlety,18,3,15
Liirja,twisting-nether,288,rogue,subtlety,18,3,15
Téhashcéé,archimonde,287,rogue,subtlety,6,3,3
Gingahboy,doomhammer,287,rogue,subtlety,6,3,3
Styggvanas,tarren-mill,287,rogue,subtlety,15,4,11
Боузи,howling-fjord,287,rogue,subtlety,12,3,9
Skeeto,blackmoore,287,rogue,subtlety,12,3,9
Furrooscuro,sanguino,287,rogue,subtlety,12,3,9
Ракельяр,blackscar,286,rogue,subtlety,6,3,3
Cesar,blackhand,286,rogue,subtlety,6,3,3
Jontor,deathwing,286,rogue,subtlety,12,3,9
Davshadows,magtheridon,286,rogue,subtlety,12,3,9
Madlain,jaedenar,255,rogue,subtlety,8,4,4
Juuzou,outland,239,rogue,subtlety,5,3,2
Iwillberone,ravencrest,239,rogue,subtlety,11,3,8
Лиргенвард,deathguard,239,rogue,subtlety,17,3,14
Imnotnice,terenas,192,rogue,subtlety,9,3,6
Recondite,doomhammer,192,rogue,subtlety,6,2,4
Chuckloriss,garona,192,rogue,subtlety,6,2,4
Dedka,hyjal,192,rogue,subtlety,6,2,4
Gosleep,stormscale,192,rogue,subtlety,6,2,4
Smøth,ysondre,192,rogue,subtlety,6,2,4
Feylia,terenas,192,rogue,subtlety,6,2,4
Skaterboy,stormscale,192,rogue,subtlety,6,2,4
Mojojina,theradras,192,rogue,subtlety,6,2,4
Vanisha,outland,192,rogue,subtlety,6,2,4
Пандафей,deathweaver,192,rogue,subtlety,6,2,4
Elnos,conseil-des-ombres,192,rogue,subtlety,6,2,4
Stigh,twisting-nether,192,rogue,subtlety,6,2,4
Oldschool,sanguino,192,rogue,subtlety,6,2,4
Deadchivalry,argent-dawn,192,rogue,subtlety,6,2,4
Decrios,outland,192,rogue,subtlety,6,2,4
Igel,antonidas,192,rogue,subtlety,6,2,4
Inviscuz,draenor,192,rogue,subtlety,6,2,4
Duo,karazhan,192,rogue,subtlety,6,2,4
Giftknirps,silvermoon,192,rogue,subtlety,6,2,4
Ît,stormscale,192,rogue,subtlety,6,2,4
Xanders,draenor,192,rogue,subtlety,6,2,4
Режупополам,howling-fjord,192,rogue,subtlety,6,2,4
Reyzumi,antonidas,192,rogue,subtlety,6,2,4
Selecta,bloodhoof,192,rogue,subtlety,6,2,4
Evilbiscuit,quelthalas,192,rogue,subtlety,6,2,4
Katara,antonidas,192,rogue,subtlety,6,2,4
Nÿst,khaz-modan,192,rogue,subtlety,6,2,4
Botsrogue,kazzak,192,rogue,subtlety,6,2,4
Pøggerhontas,antonidas,192,rogue,subtlety,6,2,4
Isseen,burning-legion,192,rogue,subtlety,6,2,4
Рогаупорога,howling-fjord,192,rogue,subtlety,6,2,4
Грустныйрог,gordunni,192,rogue,subtlety,6,2,4
Шмарамышь,soulflayer,192,rogue,subtlety,6,2,4
Stormhardt,stormscale,192,rogue,subtlety,6,2,4
Shibaii,archimonde,192,rogue,subtlety,6,2,4
Sohnisch,azshara,192,rogue,subtlety,6,2,4
Ilyrya,azuremyst,192,rogue,subtlety,6,2,4
Canelitae,minahonda,192,rogue,subtlety,6,2,4
Saanka,eredar,192,rogue,subtlety,6,2,4
Ellira,stormscale,192,rogue,subtlety,6,2,4
Haikyu,blackhand,192,rogue,subtlety,6,2,4
Скиррона,gordunni,192,rogue,subtlety,6,2,4
Byaow,ravencrest,192,rogue,subtlety,6,2,4
Bananashow,aegwynn,192,rogue,subtlety,6,2,4
Zte,frostmane,192,rogue,subtlety,6,2,4
Stealthyist,darkmoon-faire,192,rogue,subtlety,6,2,4
Le,stormreaver,192,rogue,subtlety,6,2,4
Голадриель,gordunni,192,rogue,subtlety,6,2,4
Ksunq,hyjal,192,rogue,subtlety,6,2,4
Sigleif,argent-dawn,192,rogue,subtlety,6,2,4
Рикимартини,gordunni,192,rogue,subtlety,6,2,4
Wrathed,stormreaver,192,rogue,subtlety,6,2,4
Røxxilly,blackmoore,192,rogue,subtlety,6,2,4
Fatedancer,outland,192,rogue,subtlety,6,2,4
Fatnutsac,eredar,192,rogue,subtlety,6,2,4
Aikaza,blackmoore,192,rogue,subtlety,6,2,4
Greiskull,cthun,192,rogue,subtlety,15,3,12
Verstopt,azjolnerub,192,rogue,subtlety,12,2,10
Acheravar,antonidas,192,rogue,subtlety,12,2,10
Shacopaco,zuljin,192,rogue,subtlety,12,2,10
Zyklvn,zuljin,192,rogue,subtlety,12,2,10
Lylestra,neptulon,192,rogue,subtlety,12,2,10
Jackpot,sargeras,192,rogue,subtlety,12,2,10
Bauwten,ravencrest,192,rogue,subtlety,12,2,10
Pandagonstab,shadowsong,192,rogue,subtlety,12,2,10
Refundlands,kazzak,192,rogue,subtlety,12,2,10
Delenor,stormscale,192,rogue,subtlety,12,2,10
Destrektor,kazzak,192,rogue,subtlety,12,2,10
Cabalion,draenor,191,rogue,subtlety,6,2,4
Mamus,tarren-mill,191,rogue,subtlety,6,2,4
Энвитио,gordunni,191,rogue,subtlety,6,2,4
Singularität,silvermoon,191,rogue,subtlety,6,2,4
Killboom,rexxar,191,rogue,subtlety,12,2,10
Cutscene,argent-dawn,159,rogue,subtlety,5,2,3
Feinted,kazzak,159,rogue,subtlety,11,2,9
Sicu,malganis,138,rogue,subtlety,10,4,6
Rhûlf,ravencrest,138,rogue,subtlety,16,4,12
Bandèra,ragnaros,138,rogue,subtlety,15,3,12
Idrîl,rashgarroth,137,rogue,subtlety,9,3,6
Эбиб,soulflayer,128,rogue,subtlety,4,2,2
Pzylol,anetheron,96,rogue,subtlety,3,2,1
Loom,sylvanas,96,rogue,subtlety,3,2,1
Songoro,tirion,96,rogue,subtlety,3,2,1
Элонли,gordunni,96,rogue,subtlety,6,1,5
Stealthi,stormscale,96,rogue,subtlety,6,1,5
Кингксу,gordunni,96,rogue,subtlety,6,1,5
Førtñîtégøðx,eredar,96,rogue,subtlety,6,1,5
Гламурятина,gordunni,96,rogue,subtlety,6,1,5
Стронг,soulflayer,96,rogue,subtlety,6,1,5
Verk,twilights-hammer,96,rogue,subtlety,6,1,5
Malborko,ravencrest,96,rogue,subtlety,6,1,5
Ömme,archimonde,96,rogue,subtlety,6,1,5
Мадарец,howling-fjord,96,rogue,subtlety,6,1,5
Àrléngødx,kazzak,96,rogue,subtlety,6,1,5
Kidneyou,ragnaros,96,rogue,subtlety,6,1,5
Nøtiçe,kazzak,96,rogue,subtlety,6,1,5
Loulina,outland,96,rogue,subtlety,6,1,5
Nohks,blackmoore,96,rogue,subtlety,6,1,5
Letheus,stormscale,96,rogue,subtlety,6,1,5
Outride,outland,96,rogue,subtlety,6,1,5
Neskagrall,aegwynn,96,rogue,subtlety,6,1,5
Lookbehîndu,aegwynn,96,rogue,subtlety,6,1,5
Backstabjr,blackmoore,96,rogue,subtlety,6,1,5
Tàazz,archimonde,96,rogue,subtlety,6,1,5
Fintex,ravencrest,96,rogue,subtlety,6,1,5
Twinkyzzö,archimonde,96,rogue,subtlety,6,1,5
Takenòtes,nemesis,96,rogue,subtlety,6,1,5
Edaniel,draenor,96,rogue,subtlety,6,1,5
Nerkmind,ragnaros,96,rogue,subtlety,6,1,5
Korteina,darkmoon-faire,96,rogue,subtlety,6,1,5
Chøsen,stormscale,96,rogue,subtlety,6,1,5
Könän,dalaran,96,rogue,subtlety,6,1,5
Rnghero,blackmoore,96,rogue,subtlety,6,1,5
Hyrule,onyxia,96,rogue,subtlety,6,1,5
Тварьебаная,howling-fjord,96,rogue,subtlety,6,1,5
Darkkstep,blackmoore,96,rogue,subtlety,6,1,5
Zappsarap,onyxia,96,rogue,subtlety,6,1,5
Nomota,sanguino,96,rogue,subtlety,6,1,5
Kunigunde,shattered-hand,96,rogue,subtlety,6,1,5
Lëmönhäzë,dun-modr,96,rogue,subtlety,6,1,5
Stabie,twisting-nether,96,rogue,subtlety,12,1,11
Lkzx,archimonde,96,rogue,subtlety,12,1,11
Calmrusgirl,ravenholdt,96,rogue,subtlety,12,1,11
Azzineth,silvermoon,96,rogue,subtlety,12,1,11
Альдинг,howling-fjord,96,rogue,subtlety,12,1,11
Critneyspear,runetotem,96,rogue,subtlety,12,1,11
Owlcat,argent-dawn,95,rogue,subtlety,6,1,5
Nesth,silvermoon,79,rogue,subtlety,5,1,4
Digmorre,drakthul,79,rogue,subtlety,5,1,4
Domiqs,blackhand,63,rogue,subtlety,2,2,0
Paranoiaqt,outland,48,rogue,subtlety,3,1,2
Ридлли,soulflayer,48,rogue,subtlety,3,1,2
Dendriodidit,kazzak,31,rogue,subtlety,2,1,1
Aæ,stormscale,2112,rogue,assassination,125,65,60
Rightplay,outland,2112,rogue,assassination,90,45,45
Naláa,ravencrest,2107,rogue,assassination,88,45,43
Shadenox,ravencrest,2104,rogue,assassination,329,164,165
Ewyna,silvermoon,2103,rogue,assassination,93,49,44
Fánsly,silvermoon,2102,rogue,assassination,78,40,38
Shadeniz,ravencrest,2046,rogue,assassination,71,33,38
Mentol,stormscale,1985,rogue,assassination,59,45,14
Visuáls,antonidas,1950,rogue,assassination,81,38,43
Tyreall,drakthul,1910,rogue,assassination,89,42,47
Watchmeyoe,ravencrest,1904,rogue,assassination,78,44,34
Vulrin,argent-dawn,1899,rogue,assassination,77,44,33
Oggish,tarren-mill,1890,rogue,assassination,72,28,44
Buffassa,ravencrest,1886,rogue,assassination,89,54,35
Venomblood,sanguino,1872,rogue,assassination,65,29,36
Chínerox,thunderhorn,1864,rogue,assassination,200,98,102
Vayyel,silvermoon,1854,rogue,assassination,166,78,88
Asàd,draenor,1841,rogue,assassination,47,30,17
Baboonx,burning-legion,1839,rogue,assassination,72,31,41
Sadgexd,draenor,1814,rogue,assassination,52,26,26
Prei,hyjal,1812,rogue,assassination,84,42,42
Shadeco,ravencrest,1811,rogue,assassination,60,29,31
Пожилойпуп,gordunni,1811,rogue,assassination,54,26,28
Shipshot,blackrock,1809,rogue,assassination,62,37,25
Mortecieca,ravencrest,1809,rogue,assassination,42,22,20
Lookåtme,ravencrest,1808,rogue,assassination,48,20,28
Eiscreme,blackmoore,1802,rogue,assassination,95,50,45
Heavý,argent-dawn,1802,rogue,assassination,97,46,51
Ридлли,soulflayer,1783,rogue,assassination,59,29,30
Ohdaesu,aegwynn,1782,rogue,assassination,102,42,60
Dáydreamín,draenor,1772,rogue,assassination,60,27,33
Bestjkbetter,ravencrest,1760,rogue,assassination,48,23,25
Blindlol,emerald-dream,1759,rogue,assassination,78,41,37
Pheq,ravencrest,1759,rogue,assassination,60,25,35
Çhïñêsémøñkè,argent-dawn,1743,rogue,assassination,120,66,54
Gøldzahn,antonidas,1743,rogue,assassination,88,39,49
Riskyx,draenor,1727,rogue,assassination,49,19,30
Youcrymydear,outland,1711,rogue,assassination,66,31,35
Awaaylol,stormscale,1706,rogue,assassination,136,64,72
Richï,outland,1701,rogue,assassination,69,28,41
Rinj,antonidas,1693,rogue,assassination,89,37,52
Акиоми,gordunni,1691,rogue,assassination,102,57,45
Çhïñêsérøqüè,tarren-mill,1691,rogue,assassination,77,33,44
Sotro,dun-modr,1690,rogue,assassination,66,26,40
Йа,gordunni,1689,rogue,assassination,51,28,23
Варэль,borean-tundra,1689,rogue,assassination,185,94,91
Mazeken,kazzak,1688,rogue,assassination,53,21,32
Играючестно,howling-fjord,1686,rogue,assassination,30,19,11
Limítless,tarren-mill,1684,rogue,assassination,42,27,15
Fíìp,drakthul,1682,rogue,assassination,138,62,76
Howfastiam,ravencrest,1680,rogue,assassination,72,39,33
Drenched,turalyon,1678,rogue,assassination,125,59,66
Слаадкий,gordunni,1669,rogue,assassination,100,44,56
Skali,tarren-mill,1663,rogue,assassination,75,37,38
Peeon,drakthul,1659,rogue,assassination,73,26,47
Justkiddning,blackmoore,1636,rogue,assassination,72,45,27
Shøz,kazzak,1631,rogue,assassination,42,18,24
Monski,ravencrest,1631,rogue,assassination,54,21,33
Кэпс,blackscar,1625,rogue,assassination,66,39,27
Naiikaii,antonidas,1624,rogue,assassination,42,17,25
Мистеркрэпс,howling-fjord,1624,rogue,assassination,47,19,28
Костялом,howling-fjord,1623,rogue,assassination,36,17,19
Cander,kazzak,1621,rogue,assassination,72,32,40
Keeke,outland,1619,rogue,assassination,54,28,26
Shookyz,zuljin,1615,rogue,assassination,54,27,27
Iwillcapyou,twisting-nether,1614,rogue,assassination,54,25,29
Únk,dalaran,1611,rogue,assassination,63,32,31
Warbell,ravencrest,1606,rogue,assassination,96,35,61
Nîllá,blackmoore,1600,rogue,assassination,42,18,24
Ockzy,archimonde,1592,rogue,assassination,75,39,36
Пусякиллерх,gordunni,1584,rogue,assassination,79,33,46
Lacusdark,draenor,1579,rogue,assassination,41,18,23
Войенх,gordunni,1578,rogue,assassination,204,96,108
Xeeana,ravencrest,1563,rogue,assassination,60,35,25
Shikamouflé,archimonde,1537,rogue,assassination,136,65,71
Silesi,kazzak,1534,rogue,assassination,108,58,50
Cntrlld,ravencrest,1532,rogue,assassination,36,16,20
Knutten,wildhammer,1526,rogue,assassination,102,47,55
Precious,sylvanas,1525,rogue,assassination,91,36,55
Flogue,area-52,1514,rogue,assassination,73,27,46
Weakrat,kult-der-verdammten,1508,rogue,assassination,36,22,14
Synergize,stormreaver,1508,rogue,assassination,115,54,61
Лёнтролль,blackscar,1505,rogue,assassination,45,22,23
Argapu,stormscale,1503,rogue,assassination,78,32,46
Zaintsas,tarren-mill,1500,rogue,assassination,62,31,31
Nùgz,area-52,1498,rogue,assassination,119,65,54
Кайсити,gordunni,1495,rogue,assassination,30,16,14
Freemmr,draenor,1488,rogue,assassination,95,52,43
Hidinginash,twisting-nether,1486,rogue,assassination,56,31,25
Shaokiz,sylvanas,1485,rogue,assassination,48,25,23
Søsaboy,nemesis,1483,rogue,assassination,54,26,28
Волнорес,eversong,1481,rogue,assassination,76,39,37
Kãlí,blackmoore,1481,rogue,assassination,140,67,73
Eizan,outland,1478,rogue,assassination,48,27,21
Pieksig,blackmoore,1478,rogue,assassination,60,28,32
ßênz,archimonde,1475,rogue,assassination,84,40,44
Diazz,aegwynn,1473,rogue,assassination,119,56,63
Шмарамышь,soulflayer,1463,rogue,assassination,66,31,35
Axoic,ravencrest,1433,rogue,assassination,48,23,25
Ванэйти,gordunni,1429,rogue,assassination,78,40,38
Ppollito,hyjal,1429,rogue,assassination,96,49,47
Moneylake,stormscale,1428,rogue,assassination,24,15,9
Artésia,archimonde,1428,rogue,assassination,36,19,17
Nìghtwalker,ravencrest,1428,rogue,assassination,50,24,26
Luftpumpe,blackrock,1425,rogue,assassination,63,35,28
Teseiga,aegwynn,1424,rogue,assassination,128,55,73
Belsazar,azshara,1418,rogue,assassination,138,67,71
Загляденье,gordunni,1418,rogue,assassination,42,15,27
Sadìra,echsenkessel,1414,rogue,assassination,36,15,21
Recondite,doomhammer,1413,rogue,assassination,30,20,10
Grzech,burning-legion,1408,rogue,assassination,76,40,36
Vennomous,darkspear,1408,rogue,assassination,125,61,64
Koreanrogue,archimonde,1406,rogue,assassination,24,15,9
Патайчик,soulflayer,1403,rogue,assassination,60,32,28
Arkblenderx,silvermoon,1401,rogue,assassination,82,41,41
Piñotxo,sanguino,1377,rogue,assassination,41,17,24
Ciaordel,sylvanas,1372,rogue,assassination,75,36,39
Negrim,dun-modr,1370,rogue,assassination,62,25,37
Intecto,twisting-nether,1361,rogue,assassination,34,19,15
Haikyu,blackhand,1354,rogue,assassination,72,31,41
Candycc,burning-legion,1353,rogue,assassination,49,25,24
Синигурай,soulflayer,1353,rogue,assassination,36,18,18
Alnaddafrog,outland,1352,rogue,assassination,42,25,17
Sneakysloth,ravencrest,1352,rogue,assassination,35,15,20
Dirtyz,dun-modr,1351,rogue,assassination,67,35,32
Cýphia,amanthul,1351,rogue,assassination,69,32,37
Batsu,alleria,1346,rogue,assassination,42,18,24
Synthaetic,draenor,1341,rogue,assassination,76,40,36
Markø,twisting-nether,1341,rogue,assassination,54,22,32
Роземсти,gordunni,1328,rogue,assassination,65,37,28
Finanzamtlg,blackrock,1328,rogue,assassination,36,19,17
Dé,ragnaros,1323,rogue,assassination,30,14,16
Sigleif,argent-dawn,1309,rogue,assassination,61,28,33
Raiyqyu,archimonde,1307,rogue,assassination,75,36,39
Асиксх,blackscar,1307,rogue,assassination,30,14,16
Pathicus,stormreaver,1297,rogue,assassination,64,32,32
Gadûz,kazzak,1295,rogue,assassination,44,17,27
Flawlesser,kazzak,1294,rogue,assassination,39,19,20
Effectz,ragnaros,1290,rogue,assassination,55,28,27
Zokush,archimonde,1284,rogue,assassination,35,15,20
Zizmo,deathwing,1284,rogue,assassination,60,20,40
Элирэй,fordragon,1282,rogue,assassination,35,14,21
Lixht,the-maelstrom,1279,rogue,assassination,30,16,14
Izze,thrall,1265,rogue,assassination,48,17,31
Nuguri,blackrock,1262,rogue,assassination,27,15,12
Veronkierto,stormreaver,1259,rogue,assassination,78,42,36
Djnelly,stormreaver,1253,rogue,assassination,42,25,17
Сайгакк,galakrond,1248,rogue,assassination,58,30,28
Sumiftw,drakthul,1244,rogue,assassination,36,13,23
Ру,galakrond,1243,rogue,assassination,24,13,11
Stabbinu,burning-legion,1243,rogue,assassination,24,13,11
Zerocell,kazzak,1240,rogue,assassination,60,29,31
Mexxn,antonidas,1240,rogue,assassination,43,20,23
Dime,silvermoon,1239,rogue,assassination,90,47,43
Orcrogue,khadgar,1236,rogue,assassination,24,13,11
Sáinz,malganis,1233,rogue,assassination,35,15,20
Gankbang,frostmane,1225,rogue,assassination,54,21,33
Nukubu,draenor,1224,rogue,assassination,88,35,53
Trollohlol,malganis,1220,rogue,assassination,36,17,19
Sneakypeeki,sylvanas,1217,rogue,assassination,29,13,16
Pitøu,outland,1205,rogue,assassination,36,17,19
Kariinthuul,aegwynn,1205,rogue,assassination,48,20,28
Bennyweth,argent-dawn,1205,rogue,assassination,42,16,26
Yokze,ravencrest,1201,rogue,assassination,60,23,37
Килларан,howling-fjord,1200,rogue,assassination,29,16,13
Roguening,tarren-mill,1190,rogue,assassination,35,13,22
Sùbzerø,archimonde,1186,rogue,assassination,23,13,10
Kuttunga,ravencrest,1182,rogue,assassination,35,16,19
Кайдарра,eversong,1182,rogue,assassination,30,13,17
Röllz,ysondre,1172,rogue,assassination,36,13,23
Lelíth,ravencrest,1167,rogue,assassination,29,13,16
Satiiva,terokkar,1159,rogue,assassination,48,18,30
Grøax,ragnaros,1151,rogue,assassination,24,12,12
Мастдаггер,goldrinn,1148,rogue,assassination,18,12,6
Зоти,lich-king,1146,rogue,assassination,24,12,12
Mewen,sanguino,1146,rogue,assassination,24,12,12
Unterweger,die-aldor,1145,rogue,assassination,23,13,10
Unshaken,dun-modr,1145,rogue,assassination,30,12,18
Poughkeepsie,outland,1138,rogue,assassination,24,12,12
Редфилд,blackscar,1138,rogue,assassination,24,12,12
Bonejaw,tarren-mill,1137,rogue,assassination,30,14,16
Veliza,twisting-nether,1135,rogue,assassination,30,14,16
Stôrpîx,drakthul,1131,rogue,assassination,26,12,14
Скулипёс,howling-fjord,1124,rogue,assassination,23,15,8
Цилана,gordunni,1122,rogue,assassination,24,14,10
Missesinvis,blackmoore,1118,rogue,assassination,25,14,11
Petsakos,ravencrest,1113,rogue,assassination,35,12,23
Lastsight,burning-legion,1102,rogue,assassination,27,13,14
Oshä,dalaran,1102,rogue,assassination,30,13,17
Yvÿ,archimonde,1101,rogue,assassination,24,12,12
Elûnè,silvermoon,1097,rogue,assassination,30,14,16
Swarge,silvermoon,1096,rogue,assassination,176,81,95
Krimos,archimonde,1090,rogue,assassination,30,17,13
Gravestam,sunstrider,1085,rogue,assassination,36,17,19
Alltaïr,ravencrest,1076,rogue,assassination,81,44,37
Tootskie,outland,1072,rogue,assassination,30,12,18
Nighteshift,silvermoon,1064,rogue,assassination,36,14,22
Azonaticus,hyjal,1059,rogue,assassination,28,13,15
Boskönigt,ragnaros,1056,rogue,assassination,36,17,19
Goshîmoshî,stormscale,1056,rogue,assassination,30,11,19
Fatnutsac,eredar,1055,rogue,assassination,24,11,13
Trollmeat,twisting-nether,1055,rogue,assassination,30,11,19
Jimaal,stormscale,1051,rogue,assassination,30,11,19
Dîspatchx,defias-brotherhood,1046,rogue,assassination,24,11,13
Zélla,twisting-nether,1044,rogue,assassination,24,11,13
Pasarelo,dun-modr,1041,rogue,assassination,95,45,50
Кэйлфрут,gordunni,1040,rogue,assassination,18,11,7
Subyo,eredar,1038,rogue,assassination,30,11,19
Seleyese,draenor,1034,rogue,assassination,30,13,17
Nevelon,chogall,1033,rogue,assassination,78,33,45
Sladen,ghostlands,1032,rogue,assassination,24,11,13
Jupitor,argent-dawn,1030,rogue,assassination,36,16,20
Dykumah,sanguino,1016,rogue,assassination,24,11,13
Maroshko,argent-dawn,1015,rogue,assassination,23,11,12
Lovetospoon,ravencrest,1014,rogue,assassination,30,14,16
Lesale,turalyon,1011,rogue,assassination,36,16,20
Фуллблайнд,gordunni,1006,rogue,assassination,27,11,16
Pinchoto,sanguino,1004,rogue,assassination,36,19,17
Tre,eredar,998,rogue,assassination,35,15,20
Undîsputed,blackmoore,994,rogue,assassination,39,12,27
Brunhityx,ravencrest,991,rogue,assassination,17,11,6
Hopejé,ravencrest,985,rogue,assassination,26,11,15
Rubberducky,argent-dawn,960,rogue,assassination,12,10,2
Изифаза,deathguard,960,rogue,assassination,18,10,8
Blawann,argent-dawn,959,rogue,assassination,18,10,8
Miistermaen,outland,959,rogue,assassination,30,10,20
Koopa,argent-dawn,959,rogue,assassination,42,10,32
Gârrík,blackhand,954,rogue,assassination,18,10,8
Eightball,frostmane,954,rogue,assassination,18,10,8
Noxxra,blackhand,954,rogue,assassination,24,10,14
Raetoc,turalyon,951,rogue,assassination,18,10,8
Джэкман,soulflayer,950,rogue,assassination,12,10,2
Tirgo,aegwynn,946,rogue,assassination,138,67,71
Чернаясоска,eversong,942,rogue,assassination,29,16,13
Прнхабочка,gordunni,937,rogue,assassination,30,17,13
Coastguard,twisting-nether,937,rogue,assassination,24,11,13
Eniyah,tarren-mill,927,rogue,assassination,17,10,7
Snakeshiv,ravenholdt,919,rogue,assassination,24,12,12
Dredge,kaelthas,919,rogue,assassination,43,14,29
Вотымразь,howling-fjord,916,rogue,assassination,33,15,18
Tez,malganis,909,rogue,assassination,23,10,13
Dezxxyox,dun-modr,900,rogue,assassination,24,10,14
Márto,archimonde,896,rogue,assassination,22,10,12
Jústina,die-aldor,894,rogue,assassination,48,19,29
Ороти,greymane,891,rogue,assassination,20,12,8
Darkkstep,blackmoore,890,rogue,assassination,24,11,13
Макггара,soulflayer,884,rogue,assassination,137,61,76
Løuvees,archimonde,881,rogue,assassination,64,29,35
Kaigodd,twisting-nether,879,rogue,assassination,32,16,16
Dallrend,stormscale,875,rogue,assassination,60,22,38
Bauwten,ravencrest,866,rogue,assassination,24,12,12
Skýhigh,ravencrest,864,rogue,assassination,12,9,3
Ålùnæh,azjolnerub,864,rogue,assassination,18,9,9
Watergirlx,ravencrest,864,rogue,assassination,18,9,9
Angeldarky,silvermoon,864,rogue,assassination,24,9,15
Yopti,tarren-mill,864,rogue,assassination,24,9,15
Npkx,outland,863,rogue,assassination,24,9,15
Erion,silvermoon,863,rogue,assassination,30,9,21
Purplereign,frostmane,860,rogue,assassination,84,40,44
Борщичок,gordunni,858,rogue,assassination,12,9,3
Norlix,ravencrest,856,rogue,assassination,18,9,9
Babysteps,the-maelstrom,856,rogue,assassination,18,9,9
Kuxion,zuljin,847,rogue,assassination,24,10,14
Gillette,guldan,847,rogue,assassination,66,26,40
Ressputini,emeriss,841,rogue,assassination,17,9,8
Паштетмашин,booty-bay,841,rogue,assassination,18,9,9
Reginlief,argent-dawn,835,rogue,assassination,44,22,22
Lorena,ravencrest,826,rogue,assassination,17,9,8
Îlihad,zuljin,824,rogue,assassination,42,16,26
Tranxéne,hyjal,821,rogue,assassination,18,9,9
Yuffi,ysondre,803,rogue,assassination,23,11,12
Lilze,ravencrest,803,rogue,assassination,36,13,23
Nojdobra,tarren-mill,782,rogue,assassination,19,9,10
Mores,anetheron,781,rogue,assassination,24,9,15
Sospiro,nemesis,779,rogue,assassination,22,9,13
Dmfd,darksorrow,772,rogue,assassination,87,33,54
Kidneyou,ragnaros,768,rogue,assassination,12,8,4
Botsrogue,kazzak,768,rogue,assassination,18,8,10
Lôre,blackrock,768,rogue,assassination,24,8,16
Onlyluvhurt,dun-modr,768,rogue,assassination,24,8,16
Meldee,burning-legion,767,rogue,assassination,18,8,10
Xalupa,dun-modr,767,rogue,assassination,18,8,10
Röguelol,outland,767,rogue,assassination,18,8,10
Shadowcralls,blackmoore,767,rogue,assassination,18,8,10
Bronxbomber,tarren-mill,766,rogue,assassination,18,8,10
Obsçuritý,ragnaros,765,rogue,assassination,16,9,7
Zobrak,twisting-nether,765,rogue,assassination,18,8,10
Madlain,jaedenar,765,rogue,assassination,18,8,10
Idkwatocall,stormscale,763,rogue,assassination,24,8,16
Ingesa,blackhand,762,rogue,assassination,18,8,10
Narsoule,ysondre,761,rogue,assassination,18,8,10
Giftknirps,silvermoon,758,rogue,assassination,18,8,10
Parker,frostmane,758,rogue,assassination,24,8,16
Куррвабобер,borean-tundra,756,rogue,assassination,18,8,10
Deragur,antonidas,733,rogue,assassination,18,8,10
Cbrook,sylvanas,733,rogue,assassination,23,8,15
Griveous,kazzak,732,rogue,assassination,14,9,5
Rahes,stormscale,731,rogue,assassination,35,8,27
Ninieu,kirin-tor,686,rogue,assassination,13,8,5
Pyridoxin,blackmoore,672,rogue,assassination,12,7,5
Twitchful,kazzak,672,rogue,assassination,12,7,5
Like,aegwynn,672,rogue,assassination,12,7,5
Köna,archimonde,672,rogue,assassination,18,7,11
Eeros,kazzak,672,rogue,assassination,18,7,11
Zilemjr,stormscale,672,rogue,assassination,18,7,11
Ámbush,sylvanas,672,rogue,assassination,24,7,17
Luketherogue,twisting-nether,672,rogue,assassination,24,7,17
Jaqenhghar,pozzo-delleternità,672,rogue,assassination,24,7,17
Rikdy,kazzak,672,rogue,assassination,30,7,23
Givewallet,ravencrest,671,rogue,assassination,12,7,5
Rîg,draenor,671,rogue,assassination,18,7,11
Yassu,archimonde,671,rogue,assassination,18,7,11
Hoodrogue,blackrock,671,rogue,assassination,18,7,11
Kuzmin,die-aldor,671,rogue,assassination,18,7,11
Поздоровайся,howling-fjord,670,rogue,assassination,12,7,5
Julyshadows,kazzak,669,rogue,assassination,12,7,5
Rogunelf,stormreaver,666,rogue,assassination,12,7,5
Ashami,genjuros,666,rogue,assassination,18,7,11
Imdma,defias-brotherhood,658,rogue,assassination,18,7,11
Lannon,sylvanas,655,rogue,assassination,23,7,16
Sessanali,silvermoon,655,rogue,assassination,30,7,23
Niapro,dun-morogh,653,rogue,assassination,17,7,10
Rêdbello,dun-morogh,651,rogue,assassination,18,7,11
Ripgore,sylvanas,639,rogue,assassination,17,7,10
Mozenn,draenor,622,rogue,assassination,15,7,8
Bensollo,tarren-mill,622,rogue,assassination,17,7,10
Jamesdarmody,twisting-nether,589,rogue,assassination,21,7,14
Sachsun,outland,576,rogue,assassination,12,6,6
Майндтрикс,blackscar,576,rogue,assassination,12,6,6
Attylaria,rexxar,576,rogue,assassination,12,6,6
Lírìa,argent-dawn,576,rogue,assassination,12,6,6
Mollyperph,ravencrest,576,rogue,assassination,12,6,6
Remindful,ravencrest,576,rogue,assassination,12,6,6
Ритор,deathguard,576,rogue,assassination,12,6,6
Diagnoze,silvermoon,576,rogue,assassination,12,6,6
Awakeaf,outland,576,rogue,assassination,12,6,6
Voetdown,blackmoore,576,rogue,assassination,12,6,6
Бейнс,howling-fjord,576,rogue,assassination,12,6,6
Flopsy,archimonde,576,rogue,assassination,12,6,6
Lildretch,dun-morogh,576,rogue,assassination,12,6,6
Necroli,kazzak,576,rogue,assassination,12,6,6
Dnw,ravencrest,576,rogue,assassination,18,6,12
Røler,ravencrest,576,rogue,assassination,18,6,12
Blooddance,ragnaros,576,rogue,assassination,18,6,12
Zte,frostmane,576,rogue,assassination,18,6,12
Peqpen,ravencrest,575,rogue,assassination,12,6,6
Malvaxxs,tarren-mill,575,rogue,assassination,12,6,6
Hmwow,kazzak,575,rogue,assassination,12,6,6
Rbgdowngrade,ravencrest,575,rogue,assassination,12,6,6
Mystykal,twisting-nether,575,rogue,assassination,12,6,6
Szabina,outland,575,rogue,assassination,12,6,6
Chalkbag,blackrock,575,rogue,assassination,18,6,12
Fkuwu,dalaran,575,rogue,assassination,24,6,18
Stonecold,twilights-hammer,575,rogue,assassination,24,6,18
Outofstuns,earthen-ring,574,rogue,assassination,18,7,11
Tubes,dun-morogh,573,rogue,assassination,6,6,0
Whiss,blackmoore,573,rogue,assassination,12,6,6
Letheus,stormscale,573,rogue,assassination,18,6,12
Tc,doomhammer,568,rogue,assassination,12,6,6
Симус,lich-king,568,rogue,assassination,12,6,6
Наджийа,lich-king,560,rogue,assassination,18,6,12
Ûltraaxx,ysondre,528,rogue,assassination,15,6,9
Stonyhavana,ravencrest,527,rogue,assassination,11,6,5
Hadúr,stormscale,520,rogue,assassination,22,8,14
Vanisha,outland,496,rogue,assassination,13,6,7
Dnee,ravencrest,480,rogue,assassination,6,5,1
Akira,outland,480,rogue,assassination,6,5,1
Ðescartes,antonidas,480,rogue,assassination,6,5,1
Babouill,ysondre,480,rogue,assassination,6,5,1
Семёнтус,gordunni,480,rogue,assassination,6,5,1
Эрихард,howling-fjord,480,rogue,assassination,12,5,7
Sotri,dun-modr,480,rogue,assassination,12,5,7
Reyzumi,antonidas,480,rogue,assassination,12,5,7
Uzrigu,tarren-mill,480,rogue,assassination,12,5,7
Иллвилл,soulflayer,480,rogue,assassination,12,5,7
Exiv,ragnaros,480,rogue,assassination,12,5,7
Malatang,thrall,480,rogue,assassination,12,5,7
Йоио,howling-fjord,480,rogue,assassination,12,5,7
Trickfulz,stormscale,480,rogue,assassination,12,5,7
Liraia,eredar,480,rogue,assassination,12,5,7
Рэкрейвон,gordunni,480,rogue,assassination,12,5,7
Fixsap,aegwynn,480,rogue,assassination,12,5,7
Patryk,silvermoon,480,rogue,assassination,12,5,7
Morgan,argent-dawn,480,rogue,assassination,12,5,7
Aikaza,blackmoore,480,rogue,assassination,12,5,7
Скварлет,howling-fjord,480,rogue,assassination,12,5,7
Hì,bronzebeard,480,rogue,assassination,12,5,7
Nippzy,twisting-nether,480,rogue,assassination,12,5,7
Gögel,draenor,480,rogue,assassination,12,5,7
Ghðst,stormscale,480,rogue,assassination,12,5,7
Babøønx,burning-legion,480,rogue,assassination,12,5,7
Кишмякх,howling-fjord,480,rogue,assassination,12,5,7
Exanimu,ravencrest,480,rogue,assassination,18,5,13
Stealthi,stormscale,480,rogue,assassination,18,5,13
Ambushgirl,ravencrest,480,rogue,assassination,18,5,13
Аязлаая,blackscar,480,rogue,assassination,18,5,13
Kenjí,silvermoon,480,rogue,assassination,18,5,13
Republicano,cthun,480,rogue,assassination,18,5,13
Wrathed,stormreaver,480,rogue,assassination,18,5,13
Vizifyx,ravencrest,480,rogue,assassination,24,5,19
Траста,fordragon,480,rogue,assassination,24,5,19
Хэресс,soulflayer,479,rogue,assassination,6,5,1
Finisher,sanguino,479,rogue,assassination,6,5,1
Matarocho,ravencrest,479,rogue,assassination,12,5,7
Leÿji,archimonde,479,rogue,assassination,12,5,7
Nargun,archimonde,479,rogue,assassination,12,5,7
Chiàntì,blackrock,479,rogue,assassination,12,5,7
Shadowfangs,ravencrest,479,rogue,assassination,12,5,7
Imissmop,darkspear,479,rogue,assassination,18,5,13
Astefion,dalaran,479,rogue,assassination,24,5,19
Azovrouge,terokkar,478,rogue,assassination,12,5,7
Jacksoon,dun-morogh,477,rogue,assassination,18,5,13
Owlcat,argent-dawn,475,rogue,assassination,12,5,7
Razboy,dun-morogh,475,rogue,assassination,12,5,7
Blackone,nemesis,473,rogue,assassination,18,5,13
Якунька,soulflayer,447,rogue,assassination,11,5,6
Deevoll,tarren-mill,447,rogue,assassination,20,6,14
Bhabì,uldaman,431,rogue,assassination,11,5,6
Rhâpsødýx,twisting-nether,426,rogue,assassination,14,6,8
Refundlands,kazzak,426,rogue,assassination,15,6,9
Mâêl,blackmoore,426,rogue,assassination,16,6,10
Bluehell,sanguino,415,rogue,assassination,10,5,5
Jaxck,sylvanas,384,rogue,assassination,6,4,2
Fûckínggød,outland,384,rogue,assassination,6,4,2
Mïkasa,ysondre,384,rogue,assassination,6,4,2
Мёртвыйанарх,soulflayer,384,rogue,assassination,6,4,2
Nineball,frostmane,384,rogue,assassination,6,4,2
Brñ,ravencrest,384,rogue,assassination,6,4,2
Tebzr,ravencrest,384,rogue,assassination,6,4,2
Painkeeper,stormscale,384,rogue,assassination,6,4,2
Имилиона,blackscar,384,rogue,assassination,6,4,2
Meccura,silvermoon,384,rogue,assassination,6,4,2
Tyranoxoth,stormscale,384,rogue,assassination,6,4,2
Whosmanz,ragnaros,384,rogue,assassination,6,4,2
Gâla,elune,384,rogue,assassination,6,4,2
Eltitoedu,dun-modr,384,rogue,assassination,6,4,2
Mituxararr,blackrock,384,rogue,assassination,6,4,2
Parawietje,twilights-hammer,384,rogue,assassination,6,4,2
Zerfex,eredar,384,rogue,assassination,6,4,2
Sîccarîus,ravencrest,384,rogue,assassination,6,4,2
Sayianwho,ravencrest,384,rogue,assassination,6,4,2
Myk,ravencrest,384,rogue,assassination,6,4,2
Mouchess,hyjal,384,rogue,assassination,6,4,2
Лиринэлла,soulflayer,384,rogue,assassination,6,4,2
Биокарлик,soulflayer,384,rogue,assassination,6,4,2
Дикийминус,howling-fjord,384,rogue,assassination,6,4,2
Ebayscammer,ravencrest,384,rogue,assassination,6,4,2
Галиновна,soulflayer,384,rogue,assassination,12,4,8
Achterom,tarren-mill,384,rogue,assassination,12,4,8
Mol,defias-brotherhood,384,rogue,assassination,12,4,8
Stepbrogue,tarren-mill,384,rogue,assassination,12,4,8
Ryxon,arathor,384,rogue,assassination,12,4,8
Norpz,aggra-português,384,rogue,assassination,12,4,8
Feucht,argent-dawn,384,rogue,assassination,12,4,8
Совечица,gordunni,384,rogue,assassination,12,4,8
Röguetönerö,dun-modr,384,rogue,assassination,12,4,8
Meimei,sanguino,384,rogue,assassination,12,4,8
Гранетанцор,blackscar,384,rogue,assassination,12,4,8
Fálke,dun-modr,384,rogue,assassination,12,4,8
Doomdagger,chamber-of-aspects,384,rogue,assassination,12,4,8
Bijâ,aegwynn,384,rogue,assassination,12,4,8
Juxtapose,ravencrest,384,rogue,assassination,12,4,8
Honeycakes,ravencrest,384,rogue,assassination,12,4,8
Stepkickgodx,blackmoore,384,rogue,assassination,12,4,8
Paidaki,kazzak,384,rogue,assassination,12,4,8
Noxxy,archimonde,384,rogue,assassination,12,4,8
Shènz,ysondre,384,rogue,assassination,12,4,8
Pizzayamyam,aegwynn,384,rogue,assassination,12,4,8
Darkchomeur,archimonde,384,rogue,assassination,12,4,8
Crimatoria,rajaxx,384,rogue,assassination,12,4,8
Sythex,archimonde,384,rogue,assassination,18,4,14
Лайнэл,deathweaver,384,rogue,assassination,18,4,14
Ibizà,ravencrest,384,rogue,assassination,18,4,14
Gorgeousréd,aegwynn,384,rogue,assassination,18,4,14
Zerö,tarren-mill,384,rogue,assassination,18,4,14
Vexedancer,stormscale,383,rogue,assassination,6,4,2
Opiïum,ysondre,383,rogue,assassination,6,4,2
Whiz,alexstrasza,383,rogue,assassination,15,5,10
Obbexd,outland,383,rogue,assassination,12,4,8
Silksneak,kazzak,383,rogue,assassination,12,4,8
Kyzzo,dalaran,383,rogue,assassination,12,4,8
Algopyrin,ragnaros,383,rogue,assassination,12,4,8
Töbïï,sylvanas,383,rogue,assassination,12,4,8
Twinkyzzö,archimonde,382,rogue,assassination,12,4,8
Møkkagnom,darkspear,381,rogue,assassination,12,4,8
Pumpy,blades-edge,381,rogue,assassination,12,4,8
Easy,kult-der-verdammten,376,rogue,assassination,18,4,14
Stealtheous,arathor,367,rogue,assassination,11,4,7
Стронг,soulflayer,352,rogue,assassination,10,4,6
Stælf,argent-dawn,352,rogue,assassination,16,4,12
Lilbubblegum,emerald-dream,351,rogue,assassination,11,4,7
Voraq,blackhand,350,rogue,assassination,11,4,7
Охотникведьм,soulflayer,288,rogue,assassination,6,3,3
Kendyx,kirin-tor,288,rogue,assassination,6,3,3
Lïhtêñßërg,ravencrest,288,rogue,assassination,6,3,3
Artyzoo,tarren-mill,288,rogue,assassination,6,3,3
Stealthyist,darkmoon-faire,288,rogue,assassination,6,3,3
Jupezii,stormreaver,288,rogue,assassination,6,3,3
Psg,argent-dawn,288,rogue,assassination,6,3,3
Gitguduwu,tarren-mill,288,rogue,assassination,6,3,3
Котянкахд,howling-fjord,288,rogue,assassination,6,3,3
Myxx,ravencrest,288,rogue,assassination,6,3,3
Sussulto,nemesis,288,rogue,assassination,6,3,3
Redcutter,silvermoon,288,rogue,assassination,6,3,3
Sâtýr,ravencrest,288,rogue,assassination,6,3,3
Izzyb,auchindoun,288,rogue,assassination,6,3,3
Jsprxo,stormscale,288,rogue,assassination,6,3,3
Smorcoolio,stormscale,288,rogue,assassination,6,3,3
Ракфорн,howling-fjord,288,rogue,assassination,6,3,3
Xãwé,kazzak,288,rogue,assassination,6,3,3
Luciferx,stormscale,288,rogue,assassination,6,3,3
Tiazx,outland,288,rogue,assassination,6,3,3
Mordred,stormscale,288,rogue,assassination,6,3,3
Ropedrink,stormscale,288,rogue,assassination,6,3,3
Lättja,hyjal,288,rogue,assassination,6,3,3
Anhduy,blackrock,288,rogue,assassination,6,3,3
Keexy,ravencrest,288,rogue,assassination,6,3,3
Nevazutu,twisting-nether,288,rogue,assassination,6,3,3
Brazi,dalaran,288,rogue,assassination,6,3,3
Stroògz,ysondre,288,rogue,assassination,6,3,3
Mindset,eredar,288,rogue,assassination,12,3,9
Sickko,stormscale,288,rogue,assassination,12,3,9
Ryurfy,archimonde,288,rogue,assassination,12,3,9
Persës,outland,288,rogue,assassination,12,3,9
Smokeyx,outland,288,rogue,assassination,12,3,9
Курога,howling-fjord,288,rogue,assassination,12,3,9
Kyropth,eredar,288,rogue,assassination,12,3,9
Madisonivyqt,blackmoore,288,rogue,assassination,12,3,9
Teldã,archimonde,288,rogue,assassination,12,3,9
Milenia,thrall,288,rogue,assassination,12,3,9
Civarea,blackrock,288,rogue,assassination,12,3,9
Nezuko,gilneas,288,rogue,assassination,12,3,9
Zeiden,sanguino,288,rogue,assassination,12,3,9
Bumaqt,silvermoon,288,rogue,assassination,12,3,9
Eriksonn,drakthul,288,rogue,assassination,12,3,9
Hersuub,blackmoore,288,rogue,assassination,12,3,9
Drillss,ravencrest,288,rogue,assassination,22,4,18
Jáyjay,antonidas,288,rogue,assassination,18,3,15
Shâdowfreeze,onyxia,288,rogue,assassination,18,3,15
Memphismp,drakthul,288,rogue,assassination,18,3,15
Sïdr,marécage-de-zangar,287,rogue,assassination,6,3,3
Гламурятина,gordunni,287,rogue,assassination,6,3,3
Экичу,howling-fjord,287,rogue,assassination,6,3,3
Willin,kazzak,287,rogue,assassination,6,3,3
Nastyrogue,burning-legion,287,rogue,assassination,12,3,9
Vendox,defias-brotherhood,287,rogue,assassination,12,3,9
Ecilaa,conseil-des-ombres,285,rogue,assassination,12,3,9
Verbb,turalyon,284,rogue,assassination,12,3,9
Fizzkhalifa,zuljin,284,rogue,assassination,12,3,9
Blckrogue,bloodfeather,240,rogue,assassination,9,3,6
Alpinestars,dun-modr,239,rogue,assassination,5,3,2
Starkad,archimonde,239,rogue,assassination,5,3,2
Kebabgodx,sanguino,223,rogue,assassination,8,3,5
Psybelette,khaz-modan,192,rogue,assassination,9,3,6
Saix,blackrock,192,rogue,assassination,6,2,4
Kikitaklk,uldum,192,rogue,assassination,6,2,4
Wééselby,blackrock,192,rogue,assassination,6,2,4
Yanlu,ysondre,192,rogue,assassination,6,2,4
Хемофилия,grom,192,rogue,assassination,6,2,4
Лунари,blackscar,192,rogue,assassination,6,2,4
Highz,zenedar,192,rogue,assassination,6,2,4
Garou,blackhand,192,rogue,assassination,6,2,4
Ач,gordunni,192,rogue,assassination,6,2,4
Stråt,ysondre,192,rogue,assassination,6,2,4
Сильфитт,gordunni,192,rogue,assassination,6,2,4
Nudelholz,blackrock,192,rogue,assassination,6,2,4
Кашеварить,gordunni,192,rogue,assassination,6,2,4
Næylá,kult-der-verdammten,192,rogue,assassination,6,2,4
Helcof,emerald-dream,192,rogue,assassination,6,2,4
Zømbië,kazzak,192,rogue,assassination,6,2,4
Warbell,stormscale,192,rogue,assassination,6,2,4
Xanyy,bloodfeather,192,rogue,assassination,6,2,4
Halucinogeno,silvermoon,192,rogue,assassination,6,2,4
Eazmode,outland,192,rogue,assassination,6,2,4
Sokillu,silvermoon,192,rogue,assassination,6,2,4
Givilwtf,eredar,192,rogue,assassination,6,2,4
Shúrae,blackmoore,192,rogue,assassination,6,2,4
Naí,zuljin,192,rogue,assassination,6,2,4
Gane,sanguino,192,rogue,assassination,6,2,4
Reáper,frostwolf,192,rogue,assassination,6,2,4
Tinta,aszune,192,rogue,assassination,6,2,4
Katara,antonidas,192,rogue,assassination,6,2,4
Нойсеен,gordunni,192,rogue,assassination,6,2,4
Althieves,ravencrest,192,rogue,assassination,6,2,4
Mythicog,twisting-nether,192,rogue,assassination,6,2,4
Jeruna,veklor,192,rogue,assassination,6,2,4
Хулиганнчег,galakrond,192,rogue,assassination,6,2,4
Zyphion,ragnaros,192,rogue,assassination,6,2,4
Díddz,tarren-mill,192,rogue,assassination,6,2,4
Brazzersx,antonidas,192,rogue,assassination,6,2,4
Synexo,sylvanas,192,rogue,assassination,6,2,4
Grüeßseebach,todeswache,192,rogue,assassination,6,2,4
Niagram,dun-modr,192,rogue,assassination,6,2,4
Noilek,sylvanas,192,rogue,assassination,6,2,4
Diliu,doomhammer,192,rogue,assassination,6,2,4
Ðelvin,dalaran,192,rogue,assassination,6,2,4
Xeggy,turalyon,192,rogue,assassination,6,2,4
Tofix,tarren-mill,192,rogue,assassination,6,2,4
Fushimi,ravencrest,192,rogue,assassination,6,2,4
Bangerstab,draenor,192,rogue,assassination,6,2,4
Сабстрайк,soulflayer,192,rogue,assassination,6,2,4
Fälke,dun-modr,192,rogue,assassination,6,2,4
Snurry,tarren-mill,192,rogue,assassination,6,2,4
Oczku,burning-legion,192,rogue,assassination,6,2,4
Rearmer,burning-legion,192,rogue,assassination,6,2,4
Ichiegoichie,draenor,192,rogue,assassination,6,2,4
Jonewrld,ravencrest,192,rogue,assassination,6,2,4
Аренатрюки,soulflayer,192,rogue,assassination,6,2,4
Mallaurya,dalaran,192,rogue,assassination,6,2,4
Schníttchen,antonidas,192,rogue,assassination,6,2,4
Waltër,tyrande,192,rogue,assassination,6,2,4
Horvathzu,ravencrest,192,rogue,assassination,6,2,4
Люняшка,booty-bay,192,rogue,assassination,6,2,4
Hideout,ravencrest,192,rogue,assassination,6,2,4
Maxrizzx,ravencrest,192,rogue,assassination,6,2,4
Sycko,alakir,192,rogue,assassination,6,2,4
Isucu,burning-legion,192,rogue,assassination,6,2,4
Китей,howling-fjord,192,rogue,assassination,6,2,4
Саулите,deathguard,192,rogue,assassination,6,2,4
Стеллакокс,howling-fjord,192,rogue,assassination,8,2,6
Latscholol,malorne,192,rogue,assassination,9,2,7
Sheyrrà,aegwynn,192,rogue,assassination,12,2,10
Cacucoxpahu,kazzak,192,rogue,assassination,12,2,10
Лэйкиро,gordunni,192,rogue,assassination,12,2,10
Azzmodia,aegwynn,192,rogue,assassination,12,2,10
Mingzhu,ravencrest,192,rogue,assassination,12,2,10
Rossaporcona,nemesis,192,rogue,assassination,12,2,10
Hitogoroshi,hyjal,192,rogue,assassination,12,2,10
Vezinia,ravencrest,192,rogue,assassination,12,2,10
Sneakzy,sylvanas,192,rogue,assassination,12,2,10
Romiel,ravencrest,192,rogue,assassination,12,2,10
Бонасера,blackscar,192,rogue,assassination,12,2,10
Intrix,draenor,192,rogue,assassination,12,2,10
Snøv,outland,192,rogue,assassination,18,2,16
Coopér,argent-dawn,192,rogue,assassination,18,2,16
Nhot,kazzak,191,rogue,assassination,6,2,4
Drexxo,drakthul,191,rogue,assassination,6,2,4
Eljana,amanthul,185,rogue,assassination,14,4,10
Icyicé,kazzak,175,rogue,assassination,11,2,9
Sanzoo,blackmoore,175,rogue,assassination,11,2,9
Nÿst,khaz-modan,159,rogue,assassination,11,2,9
Knockyz,khaz-modan,135,rogue,assassination,13,3,10
Mythmatical,tarren-mill,96,rogue,assassination,3,2,1
Ynohtna,blackhand,96,rogue,assassination,3,2,1
Totentánz,silvermoon,96,rogue,assassination,9,2,7
Рестинписер,soulflayer,96,rogue,assassination,6,1,5
Møtivate,ragnaros,96,rogue,assassination,6,1,5
Aknana,vashj,96,rogue,assassination,6,1,5
Hanteran,magtheridon,96,rogue,assassination,6,1,5
Shåkø,tarren-mill,96,rogue,assassination,6,1,5
Ристоврация,gordunni,96,rogue,assassination,6,1,5
Flêxô,antonidas,96,rogue,assassination,6,1,5
Kenko,aerie-peak,96,rogue,assassination,6,1,5
Thiranor,cthun,96,rogue,assassination,6,1,5
Fatzaky,turalyon,96,rogue,assassination,6,1,5
Kilabre,twisting-nether,96,rogue,assassination,6,1,5
Asmodal,antonidas,96,rogue,assassination,6,1,5
Msrogue,eredar,96,rogue,assassination,6,1,5
Ogc,draenor,96,rogue,assassination,6,1,5
Трисися,gordunni,96,rogue,assassination,6,1,5
Dravenfoot,defias-brotherhood,96,rogue,assassination,6,1,5
Myk,xavius,96,rogue,assassination,6,1,5
Mekóz,draenor,96,rogue,assassination,6,1,5
Behörnchen,eredar,96,rogue,assassination,6,1,5
Sbx,alakir,96,rogue,assassination,6,1,5
Frequenzalfa,silvermoon,96,rogue,assassination,6,1,5
Deceptionz,ravencrest,96,rogue,assassination,6,1,5
Метаболикх,gordunni,96,rogue,assassination,6,1,5
Gløck,die-aldor,96,rogue,assassination,6,1,5
Penetrantos,eredar,96,rogue,assassination,6,1,5
Snulle,ravencrest,96,rogue,assassination,6,1,5
Miiløx,silvermoon,96,rogue,assassination,6,1,5
Azotix,archimonde,96,rogue,assassination,6,1,5
Кейнилин,gordunni,96,rogue,assassination,6,1,5
Ñavy,archimonde,96,rogue,assassination,6,1,5
Ohmydotz,archimonde,96,rogue,assassination,6,1,5
Ðiè,frostmane,96,rogue,assassination,6,1,5
Krymziàâ,hyjal,96,rogue,assassination,6,1,5
Barkai,kazzak,96,rogue,assassination,6,1,5
Yamoshí,sanguino,96,rogue,assassination,6,1,5
Wøølfgang,archimonde,96,rogue,assassination,6,1,5
Yörgs,eredar,96,rogue,assassination,6,1,5
Missàh,archimonde,96,rogue,assassination,6,1,5
Vanisshh,hyjal,96,rogue,assassination,6,1,5
Chokee,blackrock,96,rogue,assassination,6,1,5
Sly,emerald-dream,96,rogue,assassination,6,1,5
Janx,aegwynn,96,rogue,assassination,6,1,5
Hendrikske,aggramar,96,rogue,assassination,6,1,5
Roronao,sanguino,96,rogue,assassination,6,1,5
Nesä,hyjal,96,rogue,assassination,6,1,5
Chøsen,stormscale,96,rogue,assassination,6,1,5
Royalflüx,grim-batol,96,rogue,assassination,6,1,5
Jawen,silvermoon,96,rogue,assassination,12,1,11
Barbuniarz,shadowsong,96,rogue,assassination,12,1,11
Tybiereus,argent-dawn,96,rogue,assassination,12,1,11
Xlongman,blackhand,96,rogue,assassination,12,1,11
Ravéñ,silvermoon,96,rogue,assassination,18,1,17
Hâlya,hyjal,96,rogue,assassination,18,1,17
Elvís,chamber-of-aspects,95,rogue,assassination,6,1,5
Trashcarlitâ,eredar,79,rogue,assassination,5,1,4
Зайт,howling-fjord,79,rogue,assassination,5,1,4
Layson,les-clairvoyants,79,rogue,assassination,5,1,4
Медиивэл,deepholm,79,rogue,assassination,5,1,4
Maelithas,archimonde,79,rogue,assassination,11,1,10
Elgande,stormrage,63,rogue,assassination,2,2,0
Дольчих,deathguard,2219,shaman,restoration,187,98,89
Shadrak,eredar,2123,shaman,restoration,84,46,38
Терату,howling-fjord,2118,shaman,restoration,84,46,38
Crnine,pozzo-delleternità,2112,shaman,restoration,75,49,26
Josë,twisting-nether,2103,shaman,restoration,119,64,55
Chäväman,archimonde,2090,shaman,restoration,102,49,53
Benpai,eredar,2076,shaman,restoration,72,36,36
Ultrahound,twisting-nether,2057,shaman,restoration,48,39,9
Trashgame,kazzak,2050,shaman,restoration,66,36,30
Мефодийшаман,howling-fjord,2038,shaman,restoration,72,51,21
Yararsiz,twisting-nether,2027,shaman,restoration,183,99,84
Джексобед,soulflayer,2026,shaman,restoration,132,69,63
Драгенхз,gordunni,2009,shaman,restoration,363,186,177
Libanô,archimonde,2003,shaman,restoration,119,57,62
Frshprn,hyjal,1982,shaman,restoration,90,51,39
Sentûn,blackrock,1960,shaman,restoration,103,56,47
Deepwithyou,blackhand,1953,shaman,restoration,153,83,70
Epsylone,kazzak,1953,shaman,restoration,101,51,50
Linkx,stormscale,1948,shaman,restoration,40,22,18
Adroda,kazzak,1947,shaman,restoration,87,51,36
Jackypink,ragnaros,1937,shaman,restoration,141,69,72
Valko,hellfire,1931,shaman,restoration,42,27,15
Tallyx,ravencrest,1926,shaman,restoration,90,44,46
Цукерок,soulflayer,1922,shaman,restoration,119,72,47
Daretodream,blackrock,1921,shaman,restoration,48,24,24
Carlpeant,drakthul,1919,shaman,restoration,119,61,58
Señordoge,kazzak,1917,shaman,restoration,54,28,26
Skreewu,outland,1908,shaman,restoration,78,37,41
Cylantarus,blackrock,1896,shaman,restoration,89,52,37
Thunderrock,stormreaver,1894,shaman,restoration,205,100,105
Трс,razuvious,1892,shaman,restoration,122,69,53
Midgetfizzle,kazzak,1892,shaman,restoration,146,77,69
Bmbx,archimonde,1891,shaman,restoration,301,152,149
Mininini,ravencrest,1880,shaman,restoration,60,29,31
Sèfìx,tarren-mill,1879,shaman,restoration,38,21,17
Kïllard,archimonde,1872,shaman,restoration,74,37,37
Timide,ravencrest,1870,shaman,restoration,48,28,20
Natasz,burning-legion,1869,shaman,restoration,102,62,40
Ggnore,kazzak,1866,shaman,restoration,96,61,35
Teldathree,archimonde,1866,shaman,restoration,101,54,47
Owrly,stormscale,1866,shaman,restoration,136,65,71
Keenxd,burning-legion,1861,shaman,restoration,42,23,19
Louler,ragnaros,1860,shaman,restoration,124,69,55
Онеоне,deathweaver,1858,shaman,restoration,59,35,24
Sinzzu,ragnaros,1858,shaman,restoration,156,80,76
Yachiru,sylvanas,1854,shaman,restoration,73,59,14
Swkx,dun-modr,1848,shaman,restoration,58,34,24
Sugarfreé,ragnaros,1848,shaman,restoration,48,26,22
Kisshots,the-maelstrom,1844,shaman,restoration,78,40,38
Cæsífer,blackrock,1844,shaman,restoration,72,32,40
Helloiamdoni,ravencrest,1843,shaman,restoration,101,63,38
Hugox,outland,1841,shaman,restoration,131,59,72
Cherepaha,stormscale,1838,shaman,restoration,70,32,38
Centralc,twisting-nether,1833,shaman,restoration,41,26,15
Inspektør,kazzak,1833,shaman,restoration,59,37,22
Shiranoye,blackrock,1831,shaman,restoration,120,65,55
Jawje,tarren-mill,1831,shaman,restoration,102,49,53
Shamuunn,ravencrest,1830,shaman,restoration,54,28,26
Эоя,howling-fjord,1830,shaman,restoration,170,88,82
Sethrøllins,hyjal,1829,shaman,restoration,114,53,61
Fitnessdavid,ravencrest,1826,shaman,restoration,53,29,24
Askagain,sylvanas,1825,shaman,restoration,52,28,24
Zhull,ravencrest,1825,shaman,restoration,192,89,103
Zergønk,ravencrest,1824,shaman,restoration,42,28,14
Bladeyx,ragnaros,1824,shaman,restoration,207,117,90
Lunarsloths,hyjal,1823,shaman,restoration,48,28,20
Asynchund,ravencrest,1821,shaman,restoration,42,26,16
Bezixx,ravencrest,1820,shaman,restoration,180,105,75
Nickygodx,stormscale,1819,shaman,restoration,54,27,27
Shamrockx,outland,1816,shaman,restoration,83,42,41
Sûckmytotem,ragnaros,1815,shaman,restoration,72,35,37
Meöw,nemesis,1813,shaman,restoration,232,120,112
Shockmelone,blackrock,1812,shaman,restoration,84,45,39
Carpetmaster,ragnaros,1812,shaman,restoration,51,27,24
Нойзблок,gordunni,1811,shaman,restoration,36,19,17
Tidepog,ravencrest,1810,shaman,restoration,60,28,32
Fuzzynuts,ravencrest,1808,shaman,restoration,132,74,58
Gargro,kazzak,1808,shaman,restoration,89,42,47
Nokster,twisting-nether,1806,shaman,restoration,84,60,24
Greggyb,twisting-nether,1805,shaman,restoration,36,22,14
Voodoonerd,twisting-nether,1803,shaman,restoration,47,24,23
Neou,archimonde,1803,shaman,restoration,54,27,27
Luckymê,blackrock,1802,shaman,restoration,51,27,24
Милфшама,blackscar,1802,shaman,restoration,239,123,116
Stensham,stormreaver,1801,shaman,restoration,48,28,20
Kiansham,silvermoon,1801,shaman,restoration,47,26,21
Squixi,tarren-mill,1799,shaman,restoration,60,33,27
Phaynozx,cthun,1790,shaman,restoration,90,38,52
Aciel,magtheridon,1788,shaman,restoration,48,35,13
Wíllz,ravencrest,1787,shaman,restoration,48,25,23
Fufupartyxx,blackrock,1785,shaman,restoration,30,19,11
Vivaldi,varimathras,1785,shaman,restoration,38,19,19
Hexe,kazzak,1783,shaman,restoration,75,32,43
Hexewar,kazzak,1780,shaman,restoration,59,32,27
Ixxmre,blackrock,1778,shaman,restoration,137,76,61
Holytidezx,aegwynn,1775,shaman,restoration,40,26,14
Szellento,darksorrow,1770,shaman,restoration,60,30,30
Johncoltrane,archimonde,1768,shaman,restoration,126,78,48
Bstr,frostmane,1763,shaman,restoration,60,30,30
Ihealbro,blackrock,1762,shaman,restoration,66,41,25
Windfúhrèr,tarren-mill,1759,shaman,restoration,60,26,34
Turboeddy,blackmoore,1750,shaman,restoration,67,44,23
Learningsham,destromath,1749,shaman,restoration,48,29,19
Harmony,outland,1746,shaman,restoration,30,22,8
Kraksham,ravencrest,1745,shaman,restoration,112,60,52
Purgeluxe,aegwynn,1740,shaman,restoration,59,32,27
Donv,blackmoore,1739,shaman,restoration,42,26,16
Rottulos,stormrage,1739,shaman,restoration,65,35,30
Shamidrak,eredar,1739,shaman,restoration,48,25,23
Somethingnew,azuremyst,1739,shaman,restoration,52,25,27
Remony,pozzo-delleternità,1738,shaman,restoration,105,69,36
Waramors,eredar,1738,shaman,restoration,125,62,63
Awcchampion,stormscale,1737,shaman,restoration,203,116,87
Machmacan,argent-dawn,1735,shaman,restoration,86,47,39
Tùiðhânâ,ravencrest,1730,shaman,restoration,107,58,49
Kreamcake,bladefist,1730,shaman,restoration,114,49,65
Агентхолинки,gordunni,1726,shaman,restoration,24,18,6
Arslos,twisting-nether,1723,shaman,restoration,30,24,6
Sheargodx,blackmoore,1723,shaman,restoration,42,21,21
Rexatar,blackrock,1722,shaman,restoration,84,50,34
Snusy,stormscale,1722,shaman,restoration,36,18,18
Wess,archimonde,1722,shaman,restoration,36,18,18
Morkyy,thrall,1721,shaman,restoration,38,19,19
Karakoram,ysondre,1720,shaman,restoration,71,40,31
Nübs,aegwynn,1720,shaman,restoration,89,39,50
Bobanrajovic,silvermoon,1717,shaman,restoration,24,18,6
Dóómhammer,jaedenar,1716,shaman,restoration,60,35,25
Mltx,twilights-hammer,1714,shaman,restoration,44,19,25
Shamolili,stormscale,1713,shaman,restoration,108,52,56
Lahey,draenor,1711,shaman,restoration,140,73,67
Swineflowing,ysondre,1708,shaman,restoration,36,18,18
Totembaws,blackmoore,1708,shaman,restoration,54,26,28
Holytidez,aegwynn,1707,shaman,restoration,48,24,24
Nizzarrathur,argent-dawn,1706,shaman,restoration,30,18,12
Чинанрук,howling-fjord,1706,shaman,restoration,89,45,44
Darnast,draenor,1706,shaman,restoration,52,25,27
Connecting,hyjal,1704,shaman,restoration,39,21,18
Ларкуш,howling-fjord,1701,shaman,restoration,118,61,57
Мвнз,soulflayer,1700,shaman,restoration,54,22,32
Goeller,stormscale,1698,shaman,restoration,42,23,19
Eurocad,draenor,1697,shaman,restoration,30,18,12
Igly,antonidas,1694,shaman,restoration,42,21,21
Lavalavalava,blackrock,1692,shaman,restoration,306,161,145
Wacomtablet,kazzak,1690,shaman,restoration,24,18,6
Dmgaddict,kazzak,1689,shaman,restoration,48,28,20
Вишняблэйз,soulflayer,1684,shaman,restoration,41,24,17
Thyroideus,argent-dawn,1681,shaman,restoration,150,89,61
Сорит,blackscar,1678,shaman,restoration,45,28,17
Lexxthree,blackrock,1677,shaman,restoration,36,23,13
Mbembe,blackhand,1674,shaman,restoration,48,26,22
Bonshaman,ahnqiraj,1673,shaman,restoration,108,50,58
Fotmherøqtx,ravencrest,1672,shaman,restoration,36,18,18
Porkzzila,aggra-português,1671,shaman,restoration,60,34,26
Skrewu,stormscale,1671,shaman,restoration,79,39,40
Кикподхвост,soulflayer,1670,shaman,restoration,54,26,28
Palfe,khaz-modan,1669,shaman,restoration,118,56,62
Sérx,sanguino,1669,shaman,restoration,47,20,27
Vajaele,twisting-nether,1667,shaman,restoration,71,35,36
Yakee,doomhammer,1665,shaman,restoration,44,22,22
Reäz,archimonde,1665,shaman,restoration,42,21,21
Héxdóctór,ravencrest,1664,shaman,restoration,86,48,38
Atwâ,ravencrest,1663,shaman,restoration,51,31,20
Brandiløve,nemesis,1663,shaman,restoration,36,19,17
Mamacitá,eredar,1656,shaman,restoration,377,178,199
Мвнзх,gordunni,1656,shaman,restoration,54,24,30
Hypéra,kazzak,1655,shaman,restoration,156,84,72
Thald,ragnaros,1653,shaman,restoration,90,56,34
Рамаксбосс,gordunni,1651,shaman,restoration,36,22,14
Tether,twisting-nether,1651,shaman,restoration,42,24,18
Maestralink,aegwynn,1651,shaman,restoration,35,20,15
Variablelol,outland,1649,shaman,restoration,40,27,13
Wotan,ysondre,1648,shaman,restoration,36,22,14
Shamandoino,wildhammer,1644,shaman,restoration,198,91,107
Allysidewtf,archimonde,1642,shaman,restoration,34,23,11
Denastyo,nemesis,1638,shaman,restoration,77,42,35
Rxs,thunderhorn,1635,shaman,restoration,54,28,26
Aioñ,kazzak,1635,shaman,restoration,51,22,29
Beastmodex,eredar,1632,shaman,restoration,248,130,118
Jenkem,hyjal,1632,shaman,restoration,42,20,22
Pøwertoto,dalaran,1632,shaman,restoration,54,24,30
Сладкийстас,soulflayer,1632,shaman,restoration,54,21,33
Oldandslow,sylvanas,1631,shaman,restoration,42,21,21
Invadé,stormscale,1630,shaman,restoration,30,17,13
Draáx,ravencrest,1628,shaman,restoration,30,19,11
Mjukiz,tarren-mill,1628,shaman,restoration,183,111,72
Elmezz,aggra-português,1628,shaman,restoration,30,17,13
Izir,archimonde,1628,shaman,restoration,42,18,24
Urshak,alleria,1624,shaman,restoration,30,20,10
Xhanon,kazzak,1624,shaman,restoration,36,20,16
Fersok,zuljin,1624,shaman,restoration,36,17,19
Indeed,frostmourne,1623,shaman,restoration,42,24,18
Nêmônin,perenolde,1621,shaman,restoration,38,22,16
Atomstrom,frostwolf,1621,shaman,restoration,62,34,28
Инкуль,howling-fjord,1621,shaman,restoration,42,20,22
Bîlunder,arygos,1621,shaman,restoration,47,21,26
Hexmeqt,frostwolf,1619,shaman,restoration,107,59,48
Тубалкайн,soulflayer,1619,shaman,restoration,36,17,19
Carlitosham,eredar,1618,shaman,restoration,44,17,27
Тафельшпиц,soulflayer,1617,shaman,restoration,40,18,22
Earthhulk,thrall,1615,shaman,restoration,89,52,37
Seasick,frostmane,1613,shaman,restoration,96,49,47
Urzza,stormscale,1611,shaman,restoration,24,20,4
Bullezno,kazzak,1611,shaman,restoration,87,50,37
Octon,dun-modr,1610,shaman,restoration,40,21,19
Makkalisse,kazzak,1609,shaman,restoration,24,17,7
Bahane,frostwolf,1609,shaman,restoration,63,32,31
Upisi,burning-legion,1609,shaman,restoration,84,42,42
Startdie,kazzak,1609,shaman,restoration,48,21,27
Blowlips,argent-dawn,1609,shaman,restoration,42,17,25
Ezilol,blackhand,1606,shaman,restoration,77,46,31
Sanamaxx,colinas-pardas,1605,shaman,restoration,44,24,20
Хужик,gordunni,1604,shaman,restoration,36,21,15
Søtêx,ravencrest,1603,shaman,restoration,29,19,10
Кодитян,gordunni,1603,shaman,restoration,36,19,17
Prizærn,tarren-mill,1603,shaman,restoration,90,39,51
Khroni,tarren-mill,1602,shaman,restoration,66,35,31
Ðenlos,destromath,1602,shaman,restoration,57,26,31
Djosershamy,draenor,1602,shaman,restoration,42,19,23
Whiskiy,kazzak,1598,shaman,restoration,26,18,8
Crasherz,sanguino,1598,shaman,restoration,45,26,19
Lechii,stormscale,1598,shaman,restoration,95,51,44
Martuscielöl,drakthul,1598,shaman,restoration,88,32,56
Snickersx,blackrock,1596,shaman,restoration,42,25,17
Incredibade,stormscale,1594,shaman,restoration,42,20,22
Laskopivo,doomhammer,1593,shaman,restoration,60,37,23
Kyogre,auchindoun,1592,shaman,restoration,48,23,25
Отчима,howling-fjord,1589,shaman,restoration,107,58,49
Zorcs,silvermoon,1589,shaman,restoration,138,70,68
Shockair,frostwolf,1589,shaman,restoration,81,38,43
Zinjk,nemesis,1588,shaman,restoration,244,127,117
Firenanajkm,dun-modr,1586,shaman,restoration,48,28,20
Vioception,blackrock,1584,shaman,restoration,48,19,29
Yzeldan,hyjal,1578,shaman,restoration,248,142,106
Koraél,dun-modr,1572,shaman,restoration,66,26,40
Mìcrøs,thrall,1571,shaman,restoration,47,27,20
Sixtyone,stormscale,1569,shaman,restoration,75,42,33
Багсбанних,soulflayer,1567,shaman,restoration,48,20,28
Шсаваннх,blackscar,1566,shaman,restoration,165,83,82
Zwergmann,blackrock,1565,shaman,restoration,60,37,23
Uzze,drakthul,1564,shaman,restoration,60,26,34
Fapmasterz,eredar,1563,shaman,restoration,36,17,19
Pacho,alakir,1563,shaman,restoration,48,21,27
Paidactor,kazzak,1562,shaman,restoration,125,67,58
Horokeu,blackrock,1560,shaman,restoration,30,17,13
Tupato,kazzak,1560,shaman,restoration,80,39,41
Cobbel,argent-dawn,1557,shaman,restoration,168,92,76
Exolnard,twisting-nether,1557,shaman,restoration,60,28,32
Sebubu,twisting-nether,1556,shaman,restoration,38,23,15
Tartorno,antonidas,1556,shaman,restoration,65,26,39
Nexian,kazzak,1554,shaman,restoration,59,32,27
Discoranger,ravencrest,1552,shaman,restoration,54,27,27
Velkin,thrall,1550,shaman,restoration,129,67,62
Shuzman,emeriss,1550,shaman,restoration,48,23,25
Ebøbøla,terokkar,1547,shaman,restoration,182,83,99
Zanezu,stormscale,1547,shaman,restoration,102,45,57
Reilah,drakthul,1546,shaman,restoration,66,33,33
Märthalouise,twisting-nether,1546,shaman,restoration,43,18,25
Linkedink,tarren-mill,1545,shaman,restoration,23,17,6
Kuhnedy,blackrock,1545,shaman,restoration,100,52,48
Bullfox,aszune,1545,shaman,restoration,66,28,38
Thorenal,blackmoore,1542,shaman,restoration,55,34,21
Gjernhard,stormreaver,1542,shaman,restoration,60,30,30
Кичисанчик,howling-fjord,1541,shaman,restoration,126,57,69
Ларисашерсть,blackscar,1539,shaman,restoration,29,21,8
Yomuchacha,dun-modr,1537,shaman,restoration,100,48,52
Anöuchkâ,ysondre,1535,shaman,restoration,42,19,23
Blowxd,aegwynn,1534,shaman,restoration,116,63,53
Xerinas,eredar,1534,shaman,restoration,63,20,43
Ugard,burning-legion,1533,shaman,restoration,37,18,19
Mypakypa,outland,1532,shaman,restoration,48,20,28
Neovim,trollbane,1530,shaman,restoration,42,20,22
Collînna,aegwynn,1529,shaman,restoration,62,34,28
Pädagogeig,antonidas,1528,shaman,restoration,66,36,30
Nassîî,antonidas,1528,shaman,restoration,95,37,58
Stòrmbreakèr,nemesis,1527,shaman,restoration,55,29,26
Bumblebeec,tarren-mill,1526,shaman,restoration,60,32,28
Reezex,silvermoon,1526,shaman,restoration,65,34,31
Bzglsnkh,ravencrest,1525,shaman,restoration,36,16,20
Bombasthicc,ravencrest,1523,shaman,restoration,30,16,14
Remkoo,blackrock,1522,shaman,restoration,30,20,10
Ilovejamie,sylvanas,1522,shaman,restoration,54,30,24
Lustmasterx,grim-batol,1520,shaman,restoration,123,67,56
Kacamaz,twisting-nether,1519,shaman,restoration,42,19,23
Schain,eredar,1518,shaman,restoration,36,24,12
Schweízer,blackrock,1516,shaman,restoration,72,33,39
Bomjspomoiki,outland,1516,shaman,restoration,35,16,19
Kuis,sanguino,1510,shaman,restoration,54,22,32
Phoenííx,twisting-nether,1508,shaman,restoration,102,42,60
Nogag,kazzak,1507,shaman,restoration,72,35,37
Enzopotenzo,blackrock,1506,shaman,restoration,42,22,20
Vaizii,silvermoon,1505,shaman,restoration,53,26,27
Coldlean,haomarush,1504,shaman,restoration,158,75,83
Biggiebig,ravencrest,1502,shaman,restoration,60,32,28
Krovogor,silvermoon,1501,shaman,restoration,54,31,23
Cannotdoit,burning-legion,1499,shaman,restoration,59,32,27
Кислаябуба,howling-fjord,1497,shaman,restoration,73,33,40
Mcktavish,silvermoon,1495,shaman,restoration,89,46,43
Crmx,blackrock,1494,shaman,restoration,72,31,41
Хэйзл,ashenvale,1492,shaman,restoration,74,32,42
Lexos,ravencrest,1490,shaman,restoration,30,16,14
Чанголист,soulflayer,1489,shaman,restoration,65,28,37
Diix,archimonde,1489,shaman,restoration,66,27,39
Kalaris,stormscale,1488,shaman,restoration,36,20,16
Fuzzywaagh,silvermoon,1488,shaman,restoration,41,21,20
Monstacookie,stormreaver,1487,shaman,restoration,42,17,25
Светшам,howling-fjord,1486,shaman,restoration,29,16,13
Mydpsrbad,stormscale,1486,shaman,restoration,66,35,31
Hexoffender,alakir,1483,shaman,restoration,112,54,58
Redoms,stormreaver,1481,shaman,restoration,75,38,37
Courtney,sylvanas,1481,shaman,restoration,228,109,119
Gronash,sunstrider,1479,shaman,restoration,24,17,7
Tèysh,ysondre,1475,shaman,restoration,114,61,53
Gützli,blackmoore,1474,shaman,restoration,93,35,58
Fridafrog,malganis,1471,shaman,restoration,41,25,16
Wernøz,archimonde,1466,shaman,restoration,32,16,16
Daykên,kazzak,1465,shaman,restoration,56,21,35
Ünknownz,archimonde,1464,shaman,restoration,71,37,34
Hjod,outland,1463,shaman,restoration,87,46,41
Schamfxx,blackrock,1456,shaman,restoration,36,20,16
Andról,stormscale,1455,shaman,restoration,36,17,19
Духсалата,grom,1454,shaman,restoration,30,16,14
Cuzzer,drakthul,1454,shaman,restoration,77,39,38
Zlingx,auchindoun,1454,shaman,restoration,48,22,26
Grumhild,blackmoore,1454,shaman,restoration,46,17,29
Pacio,alakir,1452,shaman,restoration,93,46,47
Djxyoloswag,silvermoon,1451,shaman,restoration,81,36,45
Gspót,twisting-nether,1447,shaman,restoration,98,47,51
Sucøre,die-nachtwache,1444,shaman,restoration,52,27,25
Bonraptor,kirin-tor,1443,shaman,restoration,41,20,21
Flowèn,twisting-nether,1442,shaman,restoration,45,26,19
Бомжмувис,howling-fjord,1440,shaman,restoration,24,15,9
Ironkraw,stormscale,1440,shaman,restoration,78,30,48
Светшамка,howling-fjord,1439,shaman,restoration,24,15,9
Zaiyoxgodx,thrall,1439,shaman,restoration,30,16,14
Helloitsmee,thrall,1439,shaman,restoration,40,20,20
Hímars,ragnaros,1439,shaman,restoration,30,15,15
Nyzo,tarren-mill,1438,shaman,restoration,30,15,15
Боунсе,howling-fjord,1438,shaman,restoration,36,15,21
Vioceptîon,blackrock,1437,shaman,restoration,30,22,8
Roineé,draenor,1436,shaman,restoration,30,15,15
Okdar,stormscale,1435,shaman,restoration,54,34,20
Yarali,argent-dawn,1435,shaman,restoration,24,15,9
Shamnox,blackrock,1435,shaman,restoration,57,34,23
Emochka,ravencrest,1435,shaman,restoration,130,60,70
Kataretic,kazzak,1433,shaman,restoration,24,17,7
Vorkanyx,ysondre,1433,shaman,restoration,70,36,34
Шарюпокд,soulflayer,1431,shaman,restoration,36,18,18
Shemanrolf,outland,1426,shaman,restoration,63,29,34
Mcbloob,kazzak,1425,shaman,restoration,40,19,21
Kalypsø,arthas,1423,shaman,restoration,36,15,21
Ripstorm,sylvanas,1420,shaman,restoration,37,16,21
Pocahøntas,archimonde,1418,shaman,restoration,38,16,22
Madytz,eredar,1416,shaman,restoration,24,15,9
Diya,karazhan,1414,shaman,restoration,72,33,39
Jazzrod,stormscale,1413,shaman,restoration,216,107,109
Mightgethexd,tarren-mill,1412,shaman,restoration,24,16,8
Deadstill,ysondre,1412,shaman,restoration,24,15,9
Wôdân,blackrock,1412,shaman,restoration,54,21,33
Сёмабро,ashenvale,1411,shaman,restoration,178,100,78
Kneggebrot,blackmoore,1411,shaman,restoration,72,32,40
Patuljak,outland,1409,shaman,restoration,91,48,43
Zhulnaar,hyjal,1409,shaman,restoration,42,21,21
Bénathon,ravencrest,1407,shaman,restoration,33,21,12
Кразтор,howling-fjord,1405,shaman,restoration,35,18,17
Splashgodx,frostwolf,1401,shaman,restoration,29,15,14
Smørbar,kazzak,1399,shaman,restoration,42,31,11
Trustlemac,onyxia,1399,shaman,restoration,50,30,20
Antey,ravencrest,1399,shaman,restoration,102,54,48
Showman,archimonde,1394,shaman,restoration,197,101,96
Дагод,booty-bay,1393,shaman,restoration,30,22,8
Yois,nemesis,1393,shaman,restoration,66,37,29
Glopper,ravencrest,1391,shaman,restoration,65,29,36
Nwäar,archimonde,1390,shaman,restoration,60,34,26
Sjamanisme,silvermoon,1390,shaman,restoration,114,60,54
Damex,thunderhorn,1390,shaman,restoration,108,38,70
Johnblånn,stormscale,1389,shaman,restoration,51,30,21
Apaorkaxyz,ragnaros,1388,shaman,restoration,96,41,55
Шиока,borean-tundra,1382,shaman,restoration,36,21,15
Джонпсинаа,gordunni,1379,shaman,restoration,36,18,18
Warianis,ravencrest,1374,shaman,restoration,51,27,24
Elamentaly,draenor,1371,shaman,restoration,54,29,25
Phêbz,archimonde,1371,shaman,restoration,48,25,23
Wylly,aegwynn,1367,shaman,restoration,43,27,16
Hulcky,grim-batol,1363,shaman,restoration,48,27,21
Murmaiderz,draenor,1362,shaman,restoration,66,32,34
Akrobata,silvermoon,1360,shaman,restoration,180,83,97
Bâbbub,tarren-mill,1358,shaman,restoration,27,16,11
Bíìerlip,twisting-nether,1357,shaman,restoration,35,20,15
Bedouín,draenor,1355,shaman,restoration,82,48,34
Elombrion,destromath,1355,shaman,restoration,30,16,14
Ketzersend,alleria,1351,shaman,restoration,30,18,12
Daboó,vashj,1347,shaman,restoration,85,48,37
Asumix,illidan,1347,shaman,restoration,71,38,33
Odiuum,draenor,1347,shaman,restoration,31,16,15
Henchtotem,draenor,1345,shaman,restoration,38,22,16
Сновидений,soulflayer,1344,shaman,restoration,49,23,26
Shrekcho,twisting-nether,1342,shaman,restoration,36,25,11
Bresidendo,frostwhisper,1341,shaman,restoration,54,19,35
Rhakhatheckh,nemesis,1340,shaman,restoration,30,16,14
Nestre,kazzak,1339,shaman,restoration,30,14,16
Виелетта,gordunni,1338,shaman,restoration,24,14,10
Fußpilzmann,blackmoore,1338,shaman,restoration,139,76,63
Gnackbretzn,eredar,1338,shaman,restoration,48,21,27
Shapperdin,darksorrow,1336,shaman,restoration,24,14,10
Jíkkz,aegwynn,1335,shaman,restoration,30,14,16
Xtremeshaman,blackmoore,1334,shaman,restoration,24,14,10
Ксмо,gordunni,1331,shaman,restoration,24,14,10
Jenyo,alakir,1327,shaman,restoration,24,14,10
Vodoochild,hyjal,1327,shaman,restoration,55,23,32
Jarvís,gilneas,1327,shaman,restoration,50,19,31
Lariralol,malorne,1326,shaman,restoration,54,29,25
Sadfemecraft,aggramar,1326,shaman,restoration,105,45,60
Назульчике,razuvious,1323,shaman,restoration,29,17,12
Schaname,rajaxx,1323,shaman,restoration,30,14,16
Mjöllnir,blackrock,1321,shaman,restoration,108,56,52
Shamingu,arathor,1319,shaman,restoration,37,20,17
Slowtem,draenor,1318,shaman,restoration,41,20,21
Vuls,blackmoore,1317,shaman,restoration,75,41,34
Threshðld,dun-modr,1316,shaman,restoration,30,14,16
Beyp,sylvanas,1315,shaman,restoration,41,22,19
Jps,gorgonnash,1315,shaman,restoration,47,14,33
Littledorf,ravencrest,1314,shaman,restoration,66,36,30
Macchiavelli,blades-edge,1313,shaman,restoration,41,20,21
Kbakasham,ravencrest,1312,shaman,restoration,50,24,26
Samantouz,archimonde,1312,shaman,restoration,97,45,52
Xamic,twisting-nether,1311,shaman,restoration,36,17,19
Navezi,twisting-nether,1310,shaman,restoration,72,41,31
Linknvm,thrall,1309,shaman,restoration,51,35,16
Aceofraphy,thrall,1308,shaman,restoration,125,53,72
Miesepeter,mannoroth,1306,shaman,restoration,24,14,10
Shamhingo,stormscale,1306,shaman,restoration,42,14,28
Schïps,kirin-tor,1305,shaman,restoration,48,26,22
Durek,aerie-peak,1304,shaman,restoration,24,14,10
Captaínduck,garrosh,1304,shaman,restoration,47,25,22
Bluefacebaby,nemesis,1303,shaman,restoration,66,30,36
Makaria,emerald-dream,1302,shaman,restoration,84,44,40
Shôk,ravencrest,1302,shaman,restoration,68,35,33
Monstermunch,ravencrest,1301,shaman,restoration,110,50,60
Ironmack,outland,1301,shaman,restoration,36,16,20
Шаеман,soulflayer,1298,shaman,restoration,36,20,16
Lerosh,twisting-nether,1297,shaman,restoration,48,26,22
Swedishmeat,kazzak,1297,shaman,restoration,60,32,28
Крэгнор,gordunni,1295,shaman,restoration,81,43,38
Shamanmode,twisting-nether,1292,shaman,restoration,42,17,25
Eduorde,silvermoon,1290,shaman,restoration,37,22,15
Onlytides,doomhammer,1290,shaman,restoration,36,14,22
Bigrambo,draenor,1282,shaman,restoration,54,34,20
Morty,tarren-mill,1279,shaman,restoration,59,27,32
Umbraverfaa,twisting-nether,1278,shaman,restoration,36,15,21
Iamnyka,blackrock,1276,shaman,restoration,24,17,7
Shago,archimonde,1276,shaman,restoration,124,54,70
Qjie,argent-dawn,1272,shaman,restoration,104,61,43
Fulminare,ravencrest,1271,shaman,restoration,60,32,28
Semrix,blackhand,1271,shaman,restoration,72,30,42
Шайнинлайт,soulflayer,1271,shaman,restoration,107,42,65
Ishkadar,twisting-nether,1270,shaman,restoration,33,15,18
Freizeitler,antonidas,1270,shaman,restoration,48,20,28
Жижелье,howling-fjord,1263,shaman,restoration,52,28,24
Yuliy,arathor,1263,shaman,restoration,108,50,58
Watashij,outland,1262,shaman,restoration,63,34,29
Малекулакота,soulflayer,1261,shaman,restoration,35,14,21
Azifox,hyjal,1260,shaman,restoration,25,14,11
Thundersioux,ravencrest,1255,shaman,restoration,51,29,22
Deaslow,hyjal,1248,shaman,restoration,18,15,3
Arathoir,ravencrest,1247,shaman,restoration,24,13,11
Karlurban,outland,1247,shaman,restoration,30,13,17
Reparagos,sanguino,1246,shaman,restoration,25,14,11
Rapedtide,thrall,1246,shaman,restoration,24,13,11
Руикси,howling-fjord,1246,shaman,restoration,30,13,17
Keisser,ravencrest,1244,shaman,restoration,24,13,11
Shambulancex,tarren-mill,1243,shaman,restoration,24,13,11
Arshak,stormscale,1243,shaman,restoration,27,14,13
Dgshîtdwarf,ravencrest,1242,shaman,restoration,30,13,17
Anlaki,silvermoon,1241,shaman,restoration,18,13,5
Leunam,draenor,1241,shaman,restoration,52,26,26
Sîggý,eredar,1237,shaman,restoration,24,13,11
Abercrômbx,blackmoore,1235,shaman,restoration,24,13,11
Alisàn,teldrassil,1235,shaman,restoration,109,48,61
Kaletore,ragnaros,1233,shaman,restoration,48,28,20
Санрэйн,soulflayer,1233,shaman,restoration,36,19,17
Panicsc,twisting-nether,1231,shaman,restoration,93,42,51
Kryuxs,blackrock,1229,shaman,restoration,18,13,5
Alexmiamosch,thrall,1226,shaman,restoration,78,48,30
Gaelic,frostmourne,1226,shaman,restoration,24,13,11
Юляукраинка,gordunni,1226,shaman,restoration,43,19,24
Düsterlotus,dalvengyr,1223,shaman,restoration,30,18,12
Roverlos,blackrock,1223,shaman,restoration,48,23,25
Sugardad,khaz-modan,1223,shaman,restoration,131,59,72
Murmelï,stormreaver,1220,shaman,restoration,99,46,53
Schnessert,silvermoon,1220,shaman,restoration,30,13,17
Alakan,saurfang,1219,shaman,restoration,52,22,30
Sickbrain,silvermoon,1216,shaman,restoration,45,19,26
Lechirurgien,elune,1215,shaman,restoration,95,48,47
Yasharshammy,tarren-mill,1215,shaman,restoration,36,13,23
Перегной,ashenvale,1212,shaman,restoration,93,39,54
Thuknala,tarren-mill,1210,shaman,restoration,46,26,20
Jimmybuffett,kazzak,1209,shaman,restoration,92,45,47
Deadwoodz,tarren-mill,1209,shaman,restoration,36,14,22
Ephase,burning-blade,1207,shaman,restoration,55,16,39
Xetri,ragnaros,1206,shaman,restoration,41,22,19
Morttes,burning-legion,1205,shaman,restoration,27,14,13
Nakenfeigy,stormreaver,1204,shaman,restoration,29,16,13
Blöödfist,drakthul,1200,shaman,restoration,35,14,21
Teccatwo,outland,1198,shaman,restoration,100,48,52
Snobas,kazzak,1198,shaman,restoration,29,13,16
Lolafløres,dun-modr,1194,shaman,restoration,53,37,16
Братишкапинг,soulflayer,1190,shaman,restoration,98,50,48
Alàstor,kazzak,1189,shaman,restoration,37,16,21
Kickvando,blackmoore,1184,shaman,restoration,38,18,20
Oldrym,blackrock,1183,shaman,restoration,64,25,39
Penetrierer,blackrock,1181,shaman,restoration,30,16,14
Biztor,jaedenar,1178,shaman,restoration,48,26,22
Egí,azshara,1177,shaman,restoration,38,14,24
Kvekkis,argent-dawn,1175,shaman,restoration,30,17,13
Shamins,outland,1175,shaman,restoration,33,14,19
Darnok,quelthalas,1173,shaman,restoration,60,29,31
Praise,auchindoun,1172,shaman,restoration,35,14,21
Elijaá,nordrassil,1169,shaman,restoration,60,33,27
Tegellera,ravencrest,1168,shaman,restoration,53,27,26
Drman,shattered-hand,1162,shaman,restoration,42,25,17
Bèx,twisting-nether,1159,shaman,restoration,30,13,17
Pituu,tarren-mill,1158,shaman,restoration,36,15,21
Shinui,twisting-nether,1156,shaman,restoration,45,23,22
Ðøminantx,stormscale,1155,shaman,restoration,30,14,16
Mostachin,dun-modr,1155,shaman,restoration,64,28,36
Alcam,twisting-nether,1154,shaman,restoration,77,33,44
Poggsham,twisting-nether,1153,shaman,restoration,30,13,17
Olînours,archimonde,1152,shaman,restoration,36,20,16
Htagagain,archimonde,1151,shaman,restoration,18,12,6
Teldarian,archimonde,1151,shaman,restoration,24,12,12
Dêblâzê,thrall,1151,shaman,restoration,24,12,12
Sprühkot,aegwynn,1151,shaman,restoration,24,12,12
Sørum,grim-batol,1151,shaman,restoration,30,12,18
Ripperdoc,stormreaver,1151,shaman,restoration,30,12,18
Zelent,thrall,1150,shaman,restoration,18,12,6
Souqixo,drakthul,1150,shaman,restoration,18,12,6
Ogrilza,uldaman,1150,shaman,restoration,30,17,13
Lolalovexo,kazzak,1150,shaman,restoration,30,14,16
Killatotem,kazzak,1150,shaman,restoration,30,12,18
Balthasa,blackhand,1149,shaman,restoration,18,12,6
Dmgccbot,outland,1149,shaman,restoration,30,12,18
Putzè,blackrock,1148,shaman,restoration,18,12,6
Kaherad,antonidas,1148,shaman,restoration,72,33,39
Pilinham,aggra-português,1148,shaman,restoration,30,12,18
Vaweñ,ravencrest,1147,shaman,restoration,30,12,18
Kärríegold,blackrock,1146,shaman,restoration,18,12,6
Schamazon,tarren-mill,1145,shaman,restoration,18,12,6
Быковат,booty-bay,1145,shaman,restoration,87,43,44
Нитрочка,soulflayer,1143,shaman,restoration,24,12,12
Gehrké,silvermoon,1142,shaman,restoration,18,12,6
Jävlajävel,draenor,1142,shaman,restoration,58,32,26
Rêêza,blackhand,1140,shaman,restoration,36,19,17
Vengatrox,antonidas,1136,shaman,restoration,24,12,12
Laïnàà,archimonde,1136,shaman,restoration,65,27,38
Ruvxy,twisting-nether,1132,shaman,restoration,18,12,6
Cloovster,magtheridon,1132,shaman,restoration,24,12,12
Omgodofwar,burning-blade,1132,shaman,restoration,90,33,57
Suntpraf,kazzak,1131,shaman,restoration,35,14,21
Arabesk,arygos,1130,shaman,restoration,108,50,58
Fîmbo,defias-brotherhood,1127,shaman,restoration,30,15,15
Holshammy,nemesis,1127,shaman,restoration,90,39,51
Jimkopf,eredar,1123,shaman,restoration,24,14,10
Baelee,sylvanas,1116,shaman,restoration,90,39,51
Lemontea,burning-blade,1112,shaman,restoration,30,12,18
Woade,silvermoon,1108,shaman,restoration,30,12,18
Quòr,antonidas,1106,shaman,restoration,36,24,12
Sáltý,ravencrest,1103,shaman,restoration,21,12,9
Ivaccineyou,blackmoore,1099,shaman,restoration,24,12,12
Moonbotico,blackrock,1098,shaman,restoration,97,44,53
Nafay,lordaeron,1097,shaman,restoration,42,21,21
Thenasil,stormscale,1097,shaman,restoration,64,28,36
Spartecøbra,dalaran,1083,shaman,restoration,36,16,20
Bennycooch,silvermoon,1081,shaman,restoration,107,42,65
Ухмылк,azuregos,1079,shaman,restoration,60,40,20
Lanzatotems,dun-modr,1079,shaman,restoration,60,27,33
Hazufel,kaelthas,1072,shaman,restoration,44,19,25
Smyke,magtheridon,1069,shaman,restoration,66,34,32
Flambusier,hyjal,1068,shaman,restoration,24,15,9
Сорнинай,soulflayer,1068,shaman,restoration,36,15,21
Undin,burning-legion,1066,shaman,restoration,36,20,16
Checkpoint,defias-brotherhood,1065,shaman,restoration,30,15,15
Hikigane,marécage-de-zangar,1061,shaman,restoration,48,17,31
Garuga,dun-morogh,1055,shaman,restoration,24,11,13
Shakgor,draenor,1054,shaman,restoration,48,27,21
Elshamino,ravencrest,1054,shaman,restoration,24,11,13
Blóúb,blackmoore,1054,shaman,restoration,24,11,13
Reitar,burning-blade,1054,shaman,restoration,30,11,19
Tiddles,arathor,1053,shaman,restoration,18,11,7
Lilcake,ravencrest,1053,shaman,restoration,18,11,7
Hyflex,alakir,1053,shaman,restoration,30,11,19
Skrimisher,draenor,1052,shaman,restoration,18,11,7
Muril,argent-dawn,1052,shaman,restoration,30,11,19
Kíkjo,aegwynn,1050,shaman,restoration,18,11,7
Mestgonee,draenor,1050,shaman,restoration,18,11,7
Quizx,blackrock,1050,shaman,restoration,24,11,13
Waterboi,blackmoore,1050,shaman,restoration,30,11,19
Vickeshaman,stormreaver,1050,shaman,restoration,30,11,19
Оперочек,howling-fjord,1050,shaman,restoration,42,12,30
Flikus,aggra-português,1048,shaman,restoration,30,11,19
Oscar,khaz-modan,1046,shaman,restoration,18,11,7
Tyralià,draenor,1046,shaman,restoration,18,11,7
Chokeonme,blackrock,1046,shaman,restoration,63,37,26
Megumín,darksorrow,1045,shaman,restoration,18,11,7
Garifus,dun-modr,1045,shaman,restoration,120,62,58
Aldron,tirion,1041,shaman,restoration,18,11,7
Mandoloriana,sylvanas,1041,shaman,restoration,24,11,13
Bruhin,ravencrest,1039,shaman,restoration,30,11,19
Kìra,darkmoon-faire,1038,shaman,restoration,18,11,7
Saamjai,turalyon,1037,shaman,restoration,18,13,5
Idkteam,stormscale,1037,shaman,restoration,24,11,13
Slutie,stormscale,1036,shaman,restoration,23,11,12
Roxxo,frostwolf,1032,shaman,restoration,18,11,7
Corbo,ysondre,1029,shaman,restoration,63,34,29
Лялори,gordunni,1025,shaman,restoration,60,28,32
Saviothewise,aggra-português,1020,shaman,restoration,18,11,7
Dasce,sylvanas,1017,shaman,restoration,30,14,16
Mantoon,doomhammer,1013,shaman,restoration,30,12,18
Cukkerberg,ragnaros,1010,shaman,restoration,48,19,29
Rokatotem,ysondre,1006,shaman,restoration,21,11,10
Blainehammer,arathor,1006,shaman,restoration,30,12,18
Noulol,aegwynn,1005,shaman,restoration,23,12,11
Panicblast,stormscale,1004,shaman,restoration,20,12,8
Subaki,die-aldor,1003,shaman,restoration,17,11,6
Венжии,soulflayer,1002,shaman,restoration,30,12,18
Haginathor,twisting-nether,989,shaman,restoration,78,41,37
Qusek,turalyon,987,shaman,restoration,24,12,12
Valdraxx,ravencrest,987,shaman,restoration,106,52,54
Teada,aegwynn,980,shaman,restoration,34,12,22
Knasta,malygos,978,shaman,restoration,30,11,19
Ambrosioss,kazzak,975,shaman,restoration,30,17,13
Mearu,bronze-dragonflight,961,shaman,restoration,30,18,12
Милжон,soulflayer,961,shaman,restoration,31,17,14
Qobq,ravencrest,960,shaman,restoration,12,10,2
Djtidex,conseil-des-ombres,960,shaman,restoration,12,10,2
Puffeh,emeriss,960,shaman,restoration,18,10,8
Elmie,outland,960,shaman,restoration,18,10,8
Dremlok,burning-legion,959,shaman,restoration,12,10,2
Ðtxkeks,onyxia,959,shaman,restoration,13,10,3
Teldatwo,archimonde,959,shaman,restoration,18,10,8
Raketenrieke,blackrock,959,shaman,restoration,18,10,8
Reinu,ragnaros,959,shaman,restoration,18,10,8
Hydrolîc,blackrock,959,shaman,restoration,18,10,8
Crysisx,sanguino,959,shaman,restoration,18,10,8
Bananis,outland,959,shaman,restoration,18,10,8
Loay,blackrock,959,shaman,restoration,24,10,14
Amnéshaman,ysondre,959,shaman,restoration,24,10,14
Ugáa,malganis,959,shaman,restoration,24,10,14
Drohx,ysondre,958,shaman,restoration,18,10,8
Bosskwtt,kazzak,958,shaman,restoration,18,10,8
Tentacruel,sylvanas,958,shaman,restoration,18,10,8
Huux,blackmoore,958,shaman,restoration,24,10,14
Neejtjak,ravencrest,958,shaman,restoration,24,10,14
Чаиро,howling-fjord,958,shaman,restoration,24,10,14
Bumbersham,stormscale,957,shaman,restoration,24,10,14
Гарантийный,lich-king,957,shaman,restoration,24,10,14
Zoolza,kirin-tor,957,shaman,restoration,36,10,26
Orcinterface,tarren-mill,955,shaman,restoration,21,11,10
Swahilishock,the-maelstrom,955,shaman,restoration,30,10,20
Shámpain,antonidas,950,shaman,restoration,18,10,8
Dwarfofwar,ravencrest,947,shaman,restoration,24,10,14
Vukroth,argent-dawn,943,shaman,restoration,38,20,18
Bloodvaron,zuljin,942,shaman,restoration,29,10,19
Nexolok,alleria,933,shaman,restoration,54,30,24
Bullvai,dun-morogh,929,shaman,restoration,62,28,34
Fivezax,tarren-mill,924,shaman,restoration,18,10,8
Hacyria,archimonde,924,shaman,restoration,24,13,11
Zeidek,nemesis,922,shaman,restoration,60,33,27
Рёнтар,howling-fjord,921,shaman,restoration,24,10,14
Skunazo,sanguino,917,shaman,restoration,12,10,2
Schamannen,outland,916,shaman,restoration,24,11,13
Selrin,blackrock,915,shaman,restoration,84,30,54
Xogor,kazzak,911,shaman,restoration,27,10,17
Foxfyre,tarren-mill,893,shaman,restoration,18,10,8
Georgianaa,skullcrusher,884,shaman,restoration,78,36,42
Yàra,throkferoth,878,shaman,restoration,30,13,17
Mysterqt,nemesis,864,shaman,restoration,12,9,3
Batmanmain,twisting-nether,864,shaman,restoration,16,10,6
Фатнир,soulflayer,864,shaman,restoration,18,9,9
Nothexy,stormscale,864,shaman,restoration,18,9,9
Holyshamixz,dun-modr,864,shaman,restoration,18,9,9
Shounx,hyjal,864,shaman,restoration,18,9,9
Shamiinn,ravencrest,864,shaman,restoration,18,9,9
Kaptt,twisting-nether,864,shaman,restoration,18,9,9
Котенокмур,soulflayer,864,shaman,restoration,24,9,15
Blamy,auchindoun,863,shaman,restoration,12,9,3
Shamantistik,ravencrest,863,shaman,restoration,12,9,3
Geminate,stormscale,863,shaman,restoration,12,9,3
Strïvïse,ysondre,863,shaman,restoration,18,9,9
Redomsh,stormreaver,863,shaman,restoration,18,9,9
Dréa,draenor,863,shaman,restoration,18,9,9
Coöld,archimonde,863,shaman,restoration,18,9,9
Thanasiss,kazzak,863,shaman,restoration,24,9,15
Questionable,antonidas,863,shaman,restoration,24,9,15
Милыйдед,gordunni,863,shaman,restoration,36,9,27
Stolen,skullcrusher,862,shaman,restoration,12,9,3
Labûche,chogall,862,shaman,restoration,18,9,9
Syreer,silvermoon,862,shaman,restoration,19,9,10
Pprx,tarren-mill,862,shaman,restoration,24,9,15
Salmôn,twisting-nether,862,shaman,restoration,24,9,15
Tonifo,nemesis,861,shaman,restoration,12,9,3
Cjay,dunemaul,861,shaman,restoration,12,9,3
Shamanopaf,tarren-mill,861,shaman,restoration,18,9,9
Amu,ravencrest,860,shaman,restoration,18,9,9
Mansquidgoat,darksorrow,859,shaman,restoration,15,10,5
Orchal,defias-brotherhood,859,shaman,restoration,18,9,9
Sunsham,illidan,858,shaman,restoration,18,9,9
Wayoa,defias-brotherhood,856,shaman,restoration,12,9,3
Дисмон,ashenvale,852,shaman,restoration,18,9,9
Psyforce,argent-dawn,850,shaman,restoration,12,9,3
Protv,ravencrest,845,shaman,restoration,12,9,3
Numdog,stormreaver,831,shaman,restoration,17,9,8
Shafallen,tarren-mill,829,shaman,restoration,14,10,4
Bluelasso,ysondre,824,shaman,restoration,29,9,20
Stkk,ravencrest,818,shaman,restoration,24,10,14
Дрфэка,soulflayer,815,shaman,restoration,36,9,27
Crixuss,argent-dawn,809,shaman,restoration,17,9,8
Bomboclat,azjolnerub,806,shaman,restoration,23,9,14
Shinigamy,kazzak,800,shaman,restoration,26,10,16
Akwa,stormscale,799,shaman,restoration,20,9,11
Gerlo,thrall,797,shaman,restoration,25,11,14
Goldva,outland,780,shaman,restoration,55,25,30
Squixi,ravencrest,768,shaman,restoration,12,8,4
Rostislav,ravencrest,768,shaman,restoration,12,8,4
Vërÿßåðxd,silvermoon,768,shaman,restoration,12,8,4
Enchancement,ragnaros,768,shaman,restoration,12,8,4
Ivnashaman,drakthul,768,shaman,restoration,12,8,4
Socialfailur,archimonde,768,shaman,restoration,12,8,4
Vibesham,outland,768,shaman,restoration,12,8,4
Navajito,tarren-mill,768,shaman,restoration,12,8,4
Lontarita,tarren-mill,768,shaman,restoration,12,8,4
Öyama,sinstralis,768,shaman,restoration,12,8,4
Mustabrutus,tarren-mill,768,shaman,restoration,16,9,7
Lorko,twisting-nether,768,shaman,restoration,18,8,10
Qoekke,uldum,768,shaman,restoration,18,8,10
Nøraa,ravencrest,768,shaman,restoration,18,8,10
Wibra,nagrand,768,shaman,restoration,18,8,10
Iloveléa,ravencrest,768,shaman,restoration,18,8,10
Vaaggu,stormreaver,768,shaman,restoration,18,8,10
Зачикинимся,howling-fjord,768,shaman,restoration,18,8,10
Тотембот,soulflayer,768,shaman,restoration,18,8,10
Dapawz,defias-brotherhood,767,shaman,restoration,12,8,4
Jänis,ragnaros,767,shaman,restoration,12,8,4
Berasham,dalaran,767,shaman,restoration,12,8,4
Torxii,antonidas,767,shaman,restoration,12,8,4
Magma,kazzak,767,shaman,restoration,12,8,4
Eisei,stormscale,767,shaman,restoration,12,8,4
Aliatës,sanguino,767,shaman,restoration,18,8,10
Iwaa,dalaran,767,shaman,restoration,18,8,10
Juyina,ravencrest,767,shaman,restoration,18,8,10
Eero,darksorrow,766,shaman,restoration,12,8,4
Джоукх,howling-fjord,766,shaman,restoration,12,8,4
Cleansing,nemesis,766,shaman,restoration,12,8,4
Fernashaman,aggra-português,766,shaman,restoration,18,8,10
Whatsup,aggramar,765,shaman,restoration,18,8,10
Naargie,outland,765,shaman,restoration,20,8,12
Ironspine,sylvanas,764,shaman,restoration,18,8,10
Khattla,outland,763,shaman,restoration,12,8,4
Gundersen,stormscale,763,shaman,restoration,18,8,10
Rórekk,aegwynn,761,shaman,restoration,18,8,10
Thuns,stormscale,759,shaman,restoration,18,8,10
Øzy,sanguino,749,shaman,restoration,14,8,6
Thunderberg,antonidas,746,shaman,restoration,24,8,16
Дарьюша,fordragon,744,shaman,restoration,12,8,4
Kuubskii,ravencrest,719,shaman,restoration,11,8,3
Агмень,howling-fjord,717,shaman,restoration,39,8,31
Purgérkíng,silvermoon,713,shaman,restoration,15,9,6
Onkens,ravencrest,712,shaman,restoration,21,9,12
Lauree,terokkar,710,shaman,restoration,23,9,14
Thangog,ragnaros,703,shaman,restoration,16,8,8
Грейсаша,howling-fjord,695,shaman,restoration,22,8,14
Turbohulk,blackrock,688,shaman,restoration,13,8,5
Melàniewalsh,archimonde,672,shaman,restoration,12,7,5
Qoleck,aegwynn,672,shaman,restoration,12,7,5
Dôppel,archimonde,672,shaman,restoration,12,7,5
Berly,stormscale,672,shaman,restoration,12,7,5
Yegera,stormscale,672,shaman,restoration,12,7,5
Raintlordx,twisting-nether,672,shaman,restoration,12,7,5
Rôwdy,kazzak,672,shaman,restoration,12,7,5
Blackbeardxd,stormscale,672,shaman,restoration,12,7,5
Pvegame,tarren-mill,672,shaman,restoration,12,7,5
Alëxx,hyjal,672,shaman,restoration,12,7,5
Awumbahway,outland,672,shaman,restoration,12,7,5
Pepegahex,blackmoore,672,shaman,restoration,12,7,5
Gigawashed,archimonde,672,shaman,restoration,12,7,5
Defonceboby,archimonde,672,shaman,restoration,12,7,5
Spiirit,tarren-mill,672,shaman,restoration,12,7,5
Djtomp,kazzak,672,shaman,restoration,12,7,5
Esher,frostwolf,672,shaman,restoration,12,7,5
Zimoneris,blackmoore,672,shaman,restoration,12,7,5
Árés,sanguino,672,shaman,restoration,12,7,5
Pogchampz,nemesis,672,shaman,restoration,12,7,5
Qicholardon,archimonde,672,shaman,restoration,12,7,5
Ånny,blackmoore,672,shaman,restoration,12,7,5
Winshear,twisting-nether,672,shaman,restoration,12,7,5
Kataclysm,nemesis,672,shaman,restoration,18,7,11
Naphe,ysondre,672,shaman,restoration,18,7,11
Крэйвхх,howling-fjord,672,shaman,restoration,18,7,11
Horcsog,ravencrest,672,shaman,restoration,18,7,11
Sháme,azjolnerub,672,shaman,restoration,18,7,11
Niesel,ravencrest,672,shaman,restoration,18,7,11
Zaru,sanguino,672,shaman,restoration,18,7,11
Triplewhoppa,thrall,672,shaman,restoration,18,7,11
Barbebiendur,archimonde,672,shaman,restoration,18,7,11
Viinny,dun-modr,672,shaman,restoration,18,7,11
Agrok,jaedenar,672,shaman,restoration,18,7,11
Kimsshaman,ragnaros,672,shaman,restoration,18,7,11
Reticlol,kazzak,672,shaman,restoration,18,7,11
Çøynx,aegwynn,672,shaman,restoration,20,7,13
Shamansh,draenor,671,shaman,restoration,14,9,5
Matsudah,ragnaros,671,shaman,restoration,12,7,5
Rooske,draenor,671,shaman,restoration,12,7,5
Elshimano,ravencrest,671,shaman,restoration,12,7,5
Bufuxx,kazzak,671,shaman,restoration,12,7,5
Shâdôwlîght,antonidas,671,shaman,restoration,18,7,11
Mòónz,kazzak,671,shaman,restoration,18,7,11
Zippidizap,ulduar,671,shaman,restoration,18,7,11
Indennacken,blackmoore,671,shaman,restoration,18,7,11
Bordellgast,thrall,671,shaman,restoration,18,7,11
Sdkpwns,draenor,671,shaman,restoration,18,7,11
Skullføck,argent-dawn,671,shaman,restoration,21,8,13
Straehne,malganis,671,shaman,restoration,24,7,17
Plùx,antonidas,670,shaman,restoration,12,7,5
Bjorhuk,ravencrest,670,shaman,restoration,12,7,5
Shèshe,uldaman,669,shaman,restoration,12,7,5
Woew,tarren-mill,669,shaman,restoration,12,7,5
Vulkan,kirin-tor,669,shaman,restoration,12,7,5
Shacharcaspi,blackmoore,669,shaman,restoration,24,7,17
Millacki,blackrock,667,shaman,restoration,18,7,11
Aveet,kazzak,667,shaman,restoration,18,7,11
Omeletteoeuf,silvermoon,666,shaman,restoration,12,7,5
Sneggels,wrathbringer,665,shaman,restoration,21,8,13
Mosterx,stormscale,664,shaman,restoration,18,7,11
Bogmagnus,the-maelstrom,659,shaman,restoration,39,13,26
Ayesapik,dalaran,657,shaman,restoration,12,7,5
Viallinen,stormreaver,639,shaman,restoration,17,7,10
Zenzua,twisting-nether,638,shaman,restoration,11,7,4
Nojiko,blackrock,638,shaman,restoration,17,7,10
Иоч,soulflayer,623,shaman,restoration,11,7,4
Енотикусь,soulflayer,618,shaman,restoration,12,8,4
Disharmony,outland,618,shaman,restoration,12,8,4
Randomuwu,stormscale,616,shaman,restoration,22,8,14
Мке,howling-fjord,615,shaman,restoration,29,11,18
Martiinii,dragonmaw,606,shaman,restoration,11,7,4
Oldveteran,eredar,576,shaman,restoration,6,6,0
Imdarat,hyjal,576,shaman,restoration,6,6,0
Katwio,hyjal,576,shaman,restoration,12,6,6
Raiden,aegwynn,576,shaman,restoration,12,6,6
Purgecleave,dalvengyr,576,shaman,restoration,12,6,6
Draredemolen,archimonde,576,shaman,restoration,12,6,6
Embodiment,blackrock,576,shaman,restoration,12,6,6
Kaluna,outland,576,shaman,restoration,12,6,6
Ninetzj,tarren-mill,576,shaman,restoration,12,6,6
Lortihalsen,outland,576,shaman,restoration,12,6,6
Mýthaz,archimonde,576,shaman,restoration,12,6,6
Foxy,alakir,576,shaman,restoration,12,6,6
Амальтейх,soulflayer,576,shaman,restoration,12,6,6
Dimront,gorgonnash,576,shaman,restoration,12,6,6
Blipster,tarren-mill,576,shaman,restoration,12,6,6
Mêrowinger,blackhand,576,shaman,restoration,12,6,6
Domo,stormscale,576,shaman,restoration,12,6,6
Rckfeller,burning-legion,576,shaman,restoration,12,6,6
Gromaburst,stormscale,576,shaman,restoration,12,6,6
Khidon,silvermoon,576,shaman,restoration,12,6,6
Jodel,tarren-mill,576,shaman,restoration,12,6,6
Monamour,twisting-nether,576,shaman,restoration,12,6,6
Ambuu,kazzak,576,shaman,restoration,12,6,6
Kocaina,kazzak,576,shaman,restoration,12,6,6
Enoughh,the-maelstrom,576,shaman,restoration,12,6,6
Bigdaddyxo,tarren-mill,576,shaman,restoration,12,6,6
Канамаш,borean-tundra,576,shaman,restoration,12,6,6
Komodski,kazzak,576,shaman,restoration,12,6,6
Stormfreg,quelthalas,576,shaman,restoration,12,6,6
Runbrorun,hyjal,576,shaman,restoration,12,6,6
Erepmad,ravencrest,576,shaman,restoration,12,6,6
Гоэл,ashenvale,576,shaman,restoration,12,6,6
Lmnn,ravencrest,576,shaman,restoration,12,6,6
Thecallviper,blackmoore,576,shaman,restoration,12,6,6
Neverqueue,defias-brotherhood,576,shaman,restoration,12,6,6
Goodevening,tarren-mill,576,shaman,restoration,12,6,6
Skottkärrà,ravencrest,576,shaman,restoration,12,6,6
Wintradezki,tarren-mill,576,shaman,restoration,12,6,6
Superthomas,archimonde,576,shaman,restoration,23,9,14
Patsham,wildhammer,576,shaman,restoration,18,6,12
Kioterasham,conseil-des-ombres,576,shaman,restoration,18,6,12
Soger,mannoroth,576,shaman,restoration,18,6,12
Floki,emerald-dream,576,shaman,restoration,18,6,12
Rouwa,korgall,575,shaman,restoration,12,6,6
Kyaz,ravencrest,575,shaman,restoration,12,6,6
Crymere,chamber-of-aspects,575,shaman,restoration,12,6,6
Sjearthen,defias-brotherhood,575,shaman,restoration,12,6,6
Outerspace,silvermoon,575,shaman,restoration,12,6,6
Shazefin,twisting-nether,575,shaman,restoration,12,6,6
Bloggurt,tarren-mill,575,shaman,restoration,12,6,6
Stortvloed,twisting-nether,575,shaman,restoration,12,6,6
Lorthargol,chamber-of-aspects,575,shaman,restoration,18,6,12
Tidushears,thrall,574,shaman,restoration,12,6,6
Shamandeadly,aggra-português,574,shaman,restoration,12,6,6
Manitus,sylvanas,574,shaman,restoration,12,6,6
Turbokrapka,tarren-mill,574,shaman,restoration,12,6,6
Kongapenes,tarren-mill,574,shaman,restoration,12,6,6
Notwhoheals,executus,574,shaman,restoration,18,6,12
Bolski,stormreaver,573,shaman,restoration,12,6,6
Shammzy,mannoroth,573,shaman,restoration,18,6,12
Polystrath,silvermoon,573,shaman,restoration,18,6,12
Thundrkrakn,blackhand,573,shaman,restoration,18,6,12
Alïsyo,nemesis,570,shaman,restoration,18,6,12
Greenguard,argent-dawn,540,shaman,restoration,23,6,17
Totemglad,drakthul,528,shaman,restoration,9,7,2
Whibbler,ravencrest,528,shaman,restoration,21,7,14
Télapou,ragnaros,527,shaman,restoration,11,6,5
Манрото,soulflayer,526,shaman,restoration,9,6,3
Mycameltotem,ravencrest,522,shaman,restoration,21,7,14
Arigolds,twilights-hammer,511,shaman,restoration,11,6,5
Jakesmistake,stormscale,494,shaman,restoration,11,7,4
Эйвуа,gordunni,486,shaman,restoration,22,8,14
Ub,garona,480,shaman,restoration,6,5,1
Shamsteaks,thrall,480,shaman,restoration,6,5,1
Munjar,korgall,480,shaman,restoration,6,5,1
Djschamihaar,blackrock,480,shaman,restoration,6,5,1
Meeq,deathwing,480,shaman,restoration,6,5,1
Geneazytwo,silvermoon,480,shaman,restoration,6,5,1
Hogmodig,tarren-mill,480,shaman,restoration,6,5,1
Antikahraman,blackrock,480,shaman,restoration,6,5,1
Awwey,stormscale,480,shaman,restoration,6,5,1
Kelvok,silvermoon,480,shaman,restoration,6,5,1
Costakislolz,twisting-nether,480,shaman,restoration,6,5,1
Qwauzinator,silvermoon,480,shaman,restoration,6,5,1
Doubleshamz,the-maelstrom,480,shaman,restoration,6,5,1
Uanl,stormscale,480,shaman,restoration,12,5,7
Maelynda,argent-dawn,480,shaman,restoration,12,5,7
Qishwilu,ravencrest,480,shaman,restoration,12,5,7
Nøný,gorgonnash,480,shaman,restoration,12,5,7
Volwerin,blackhand,480,shaman,restoration,12,5,7
Hakunax,twisting-nether,480,shaman,restoration,12,5,7
Thyeori,stormscale,480,shaman,restoration,12,5,7
Flandersx,ravencrest,480,shaman,restoration,12,5,7
Tigo,tarren-mill,480,shaman,restoration,12,5,7
Lumière,alonsus,480,shaman,restoration,12,5,7
Totemiclol,aegwynn,480,shaman,restoration,12,5,7
Kemmi,dalaran,480,shaman,restoration,12,5,7
Cheerz,ravencrest,480,shaman,restoration,12,5,7
Aeknor,ravencrest,480,shaman,restoration,12,5,7
Evííl,tarren-mill,480,shaman,restoration,12,5,7
Tooltip,tarren-mill,480,shaman,restoration,12,5,7
Riptidegodx,archimonde,480,shaman,restoration,12,5,7
Évileye,silvermoon,480,shaman,restoration,12,5,7
Bandyy,magtheridon,480,shaman,restoration,12,5,7
Spaceboy,archimonde,480,shaman,restoration,12,5,7
Caliqueños,sanguino,480,shaman,restoration,12,5,7
Nevagonalink,archimonde,480,shaman,restoration,12,5,7
Libano,archimonde,480,shaman,restoration,12,5,7
Leafplsx,blackrock,480,shaman,restoration,12,5,7
Sliiderr,draenor,480,shaman,restoration,12,5,7
Unleashme,sylvanas,480,shaman,restoration,12,5,7
Adzkímo,tarren-mill,480,shaman,restoration,12,5,7
Shamarco,nemesis,480,shaman,restoration,12,5,7
Kempfer,blackrock,480,shaman,restoration,12,5,7
Lontarsdaddy,twisting-nether,480,shaman,restoration,12,5,7
Markboymint,earthen-ring,480,shaman,restoration,12,5,7
Styllz,uldaman,480,shaman,restoration,12,5,7
Jakeir,auchindoun,480,shaman,restoration,12,5,7
Papskalla,ravencrest,480,shaman,restoration,12,5,7
Xentic,kazzak,480,shaman,restoration,12,5,7
Burrowabuser,nemesis,480,shaman,restoration,12,5,7
Kardris,nemesis,480,shaman,restoration,12,5,7
Кенниарт,howling-fjord,480,shaman,restoration,18,5,13
Селфлессх,soulflayer,480,shaman,restoration,18,5,13
Bruho,mazrigos,480,shaman,restoration,18,5,13
Drakahaar,burning-blade,480,shaman,restoration,18,5,13
Nêgan,ravencrest,480,shaman,restoration,22,5,17
Jelincic,ravencrest,480,shaman,restoration,24,5,19
Banilikum,tarren-mill,480,shaman,restoration,24,5,19
Savan,darkspear,480,shaman,restoration,24,5,19
Rawtex,draenor,480,shaman,restoration,26,5,21
Gelaende,thrall,479,shaman,restoration,12,5,7
Ominouslove,twisting-nether,479,shaman,restoration,12,5,7
Donnerbubele,aegwynn,479,shaman,restoration,12,5,7
Jotuna,argent-dawn,478,shaman,restoration,18,5,13
Thrallallero,pozzo-delleternità,477,shaman,restoration,12,5,7
Killhorn,malganis,474,shaman,restoration,12,5,7
Shamanarama,sylvanas,463,shaman,restoration,23,5,18
Asahi,arthas,447,shaman,restoration,11,5,6
Altesh,die-todeskrallen,446,shaman,restoration,10,5,5
Cotêaz,thrall,446,shaman,restoration,10,5,5
Cømedian,ragnaros,431,shaman,restoration,9,6,3
Suculenta,zuljin,426,shaman,restoration,11,5,6
Shamakerr,tarren-mill,426,shaman,restoration,17,7,10
Äppelpaj,earthen-ring,426,shaman,restoration,15,6,9
Ulrichh,twisting-nether,415,shaman,restoration,8,5,3
Blixtlasse,magtheridon,400,shaman,restoration,13,5,8
Shàyâ,ysondre,384,shaman,restoration,6,4,2
Abx,draenor,384,shaman,restoration,6,4,2
Invade,darkspear,384,shaman,restoration,6,4,2
Bandulski,twisting-nether,384,shaman,restoration,6,4,2
Eras,ragnaros,384,shaman,restoration,6,4,2
Soffsittaren,kazzak,384,shaman,restoration,6,4,2
Thriveqt,nemesis,384,shaman,restoration,6,4,2
Flùffy,nemesis,384,shaman,restoration,6,4,2
Pank,kazzak,384,shaman,restoration,6,4,2
Robbie,dentarg,384,shaman,restoration,6,4,2
Gotta,dethecus,384,shaman,restoration,6,4,2
Роджермур,howling-fjord,384,shaman,restoration,6,4,2
Kekke,uldum,384,shaman,restoration,6,4,2
Imdax,hyjal,384,shaman,restoration,6,4,2
Æxs,archimonde,384,shaman,restoration,6,4,2
Prup,tarren-mill,384,shaman,restoration,6,4,2
Wawawoowee,archimonde,384,shaman,restoration,6,4,2
Yozgatlilan,aegwynn,384,shaman,restoration,6,4,2
Artîe,archimonde,384,shaman,restoration,6,4,2
Ongedierte,tarren-mill,384,shaman,restoration,6,4,2
Johnnysîns,blackhand,384,shaman,restoration,6,4,2
Хотдевил,gordunni,384,shaman,restoration,6,4,2
Kundt,dalaran,384,shaman,restoration,6,4,2
Bountiti,dun-modr,384,shaman,restoration,6,4,2
Waterboy,tarren-mill,384,shaman,restoration,6,4,2
Электро,thermaplugg,384,shaman,restoration,6,4,2
Zhead,aggramar,384,shaman,restoration,6,4,2
Lingz,auchindoun,384,shaman,restoration,6,4,2
Keräx,cthun,384,shaman,restoration,6,4,2
Ærthgød,stormscale,384,shaman,restoration,6,4,2
Nellytko,aegwynn,384,shaman,restoration,6,4,2
Greatørc,tarren-mill,384,shaman,restoration,6,4,2
Hamuksha,nerathor,384,shaman,restoration,6,4,2
Totembeard,frostmourne,384,shaman,restoration,6,4,2
Axéron,blackhand,384,shaman,restoration,6,4,2
Grimn,burning-legion,384,shaman,restoration,6,4,2
Tidors,burning-legion,384,shaman,restoration,6,4,2
Cuchullaín,blackmoore,384,shaman,restoration,6,4,2
Tosaá,antonidas,384,shaman,restoration,6,4,2
Sikro,frostwolf,384,shaman,restoration,6,4,2
Tingyspanky,twisting-nether,384,shaman,restoration,9,5,4
Criticalx,eredar,384,shaman,restoration,15,5,10
Kaffekask,stormscale,384,shaman,restoration,12,4,8
Kerfo,ragnaros,384,shaman,restoration,12,4,8
Tteïl,archimonde,384,shaman,restoration,12,4,8
Zyphiz,twisting-nether,384,shaman,restoration,12,4,8
Shinds,archimonde,384,shaman,restoration,12,4,8
Theshammy,vashj,384,shaman,restoration,12,4,8
Kuyamii,blackrock,384,shaman,restoration,12,4,8
Gharn,sanguino,384,shaman,restoration,12,4,8
Ранняяпташка,soulflayer,384,shaman,restoration,12,4,8
Lavababe,blackmoore,384,shaman,restoration,12,4,8
Bigfatjay,stormscale,384,shaman,restoration,12,4,8
Wagaluu,ravencrest,384,shaman,restoration,12,4,8
Fünkchn,zuluhed,384,shaman,restoration,12,4,8
Saksyl,zuljin,384,shaman,restoration,12,4,8
Pasjeop,ravencrest,384,shaman,restoration,12,4,8
Thefirebird,blackhand,384,shaman,restoration,12,4,8
Unbrokeñ,stormscale,384,shaman,restoration,12,4,8
Serasol,sylvanas,384,shaman,restoration,12,4,8
Numbs,tarren-mill,384,shaman,restoration,12,4,8
Daklickshamy,blackmoore,384,shaman,restoration,12,4,8
Bolg,veklor,384,shaman,restoration,12,4,8
Smahamtwo,stormscale,384,shaman,restoration,12,4,8
Vey,hyjal,384,shaman,restoration,12,4,8
Энхай,azuregos,384,shaman,restoration,12,4,8
Abdegor,burning-legion,384,shaman,restoration,12,4,8
Sempaihentai,draenor,384,shaman,restoration,12,4,8
Keén,burning-legion,384,shaman,restoration,12,4,8
Меготип,deathweaver,384,shaman,restoration,12,4,8
Archsha,burning-legion,384,shaman,restoration,12,4,8
Maluch,burning-legion,384,shaman,restoration,12,4,8
Bobaléh,ravencrest,384,shaman,restoration,12,4,8
Drakamaa,ravencrest,384,shaman,restoration,12,4,8
Gards,sylvanas,384,shaman,restoration,18,4,14
Frosthamer,ragnaros,383,shaman,restoration,6,4,2
Darthshox,outland,383,shaman,restoration,10,5,5
Zerwurster,thrall,383,shaman,restoration,12,4,8
Sleyvarian,chamber-of-aspects,383,shaman,restoration,12,4,8
Jhaky,dun-modr,383,shaman,restoration,12,4,8
Slippyjim,azshara,382,shaman,restoration,12,4,8
Avatarroku,blackhand,382,shaman,restoration,12,4,8
Xpone,blackrock,380,shaman,restoration,12,4,8
Icytide,kazzak,378,shaman,restoration,18,7,11
Zboubii,archimonde,351,shaman,restoration,17,4,13
Gunhyld,hyjal,335,shaman,restoration,11,4,7
Pcr,archimonde,330,shaman,restoration,9,5,4
Xoxoxoxoa,twisting-nether,328,shaman,restoration,29,6,23
Zhangliyi,ravencrest,319,shaman,restoration,5,4,1
Murog,dalaran,319,shaman,restoration,8,4,4
Видсон,soulflayer,288,shaman,restoration,6,3,3
Драмкул,soulflayer,288,shaman,restoration,6,3,3
Велоун,soulflayer,288,shaman,restoration,6,3,3
Cristhor,nemesis,288,shaman,restoration,6,3,3
Chainbeef,blackmoore,288,shaman,restoration,6,3,3
Ravenshock,bloodfeather,288,shaman,restoration,6,3,3
Corintho,blackmoore,288,shaman,restoration,6,3,3
Majinbeb,hyjal,288,shaman,restoration,6,3,3
Bandiitti,darksorrow,288,shaman,restoration,6,3,3
Shamamamin,argent-dawn,288,shaman,restoration,6,3,3
Groundcslol,kazzak,288,shaman,restoration,6,3,3
Bingo,tarren-mill,288,shaman,restoration,6,3,3
Бриз,blackscar,288,shaman,restoration,6,3,3
Grosgourdin,la-croisade-écarlate,288,shaman,restoration,6,3,3
Cøkka,hyjal,288,shaman,restoration,6,3,3
Mefl,tarren-mill,288,shaman,restoration,6,3,3
Rndshaman,thrall,288,shaman,restoration,6,3,3
Shamoobob,archimonde,288,shaman,restoration,6,3,3
Muddy,argent-dawn,288,shaman,restoration,6,3,3
Votie,tarren-mill,288,shaman,restoration,6,3,3
Kalinn,sylvanas,288,shaman,restoration,6,3,3
Binslagala,zuljin,288,shaman,restoration,6,3,3
Stinkyfînger,draenor,288,shaman,restoration,6,3,3
Shockjob,kazzak,288,shaman,restoration,6,3,3
Totemboyuk,tarren-mill,288,shaman,restoration,6,3,3
Bûttâ,archimonde,288,shaman,restoration,6,3,3
Jilyu,blackmoore,288,shaman,restoration,6,3,3
Pyrotoad,blackmoore,288,shaman,restoration,6,3,3
Pépón,dun-modr,288,shaman,restoration,6,3,3
Brandbombe,frostwolf,288,shaman,restoration,6,3,3
Abalenn,kazzak,288,shaman,restoration,6,3,3
Shànnón,kazzak,288,shaman,restoration,6,3,3
Wealey,drakthul,288,shaman,restoration,6,3,3
Елемчикх,gordunni,288,shaman,restoration,6,3,3
Icecold,grim-batol,288,shaman,restoration,6,3,3
Kimunamatata,draenor,288,shaman,restoration,6,3,3
Ханикс,blackscar,288,shaman,restoration,6,3,3
Corlysvelary,doomhammer,288,shaman,restoration,6,3,3
Glak,draenor,288,shaman,restoration,6,3,3
Prepegahex,blackmoore,288,shaman,restoration,6,3,3
Moistpuss,kazzak,288,shaman,restoration,6,3,3
Кхуздуфар,blackscar,288,shaman,restoration,6,3,3
Chadshaman,antonidas,288,shaman,restoration,6,3,3
Ragnesch,aegwynn,288,shaman,restoration,6,3,3
Stibs,silvermoon,288,shaman,restoration,6,3,3
Blboz,grim-batol,288,shaman,restoration,6,3,3
Zapyboye,grim-batol,288,shaman,restoration,6,3,3
Richtigfies,kazzak,288,shaman,restoration,6,3,3
Вэллкомм,gordunni,288,shaman,restoration,6,3,3
Kilazz,twisting-nether,288,shaman,restoration,6,3,3
Bharudor,antonidas,288,shaman,restoration,6,3,3
Shmøn,outland,288,shaman,restoration,6,3,3
Rna,ragnaros,288,shaman,restoration,6,3,3
Rkeev,blackrock,288,shaman,restoration,6,3,3
Tarzh,dalaran,288,shaman,restoration,6,3,3
Jazzcore,twisting-nether,288,shaman,restoration,6,3,3
Nyfario,marécage-de-zangar,288,shaman,restoration,6,3,3
Ярусскийй,howling-fjord,288,shaman,restoration,6,3,3
Horiq,kazzak,288,shaman,restoration,6,3,3
Faìnt,stormscale,288,shaman,restoration,6,3,3
Oldmanrena,stormscale,288,shaman,restoration,6,3,3
Nohealtilt,stormscale,288,shaman,restoration,6,3,3
Tenror,ragnaros,288,shaman,restoration,6,3,3
Soulsh,die-ewige-wacht,288,shaman,restoration,6,3,3
Aboveaverage,stormscale,288,shaman,restoration,12,3,9
Kuzsham,archimonde,288,shaman,restoration,12,3,9
Sorcerus,burning-legion,288,shaman,restoration,12,3,9
Oningodx,drakthul,288,shaman,restoration,12,3,9
Rheax,tarren-mill,288,shaman,restoration,12,3,9
Mazu,spinebreaker,288,shaman,restoration,12,3,9
Hobblefoot,stormscale,288,shaman,restoration,12,3,9
Flameshock,area-52,288,shaman,restoration,12,3,9
Feizhousa,outland,288,shaman,restoration,12,3,9
Nixxy,magtheridon,288,shaman,restoration,12,3,9
Wtbtoes,ravencrest,288,shaman,restoration,12,3,9
Thrallotido,sanguino,288,shaman,restoration,12,3,9
Madrävëngodx,ragnaros,288,shaman,restoration,12,3,9
Thísisrestø,sanguino,288,shaman,restoration,12,3,9
Magicflames,draenor,288,shaman,restoration,12,3,9
Volstorm,ysondre,288,shaman,restoration,12,3,9
Charquanda,argent-dawn,288,shaman,restoration,12,3,9
Kandrox,blackmoore,288,shaman,restoration,12,3,9
Krugx,draenor,288,shaman,restoration,12,3,9
Бэкдафакапп,blackscar,288,shaman,restoration,12,3,9
Колбаскофф,gordunni,288,shaman,restoration,12,3,9
Hastabasta,sylvanas,288,shaman,restoration,12,3,9
Pòcho,kazzak,288,shaman,restoration,17,3,14
Áchilleus,kazzak,288,shaman,restoration,18,3,15
Quiec,kazzak,288,shaman,restoration,18,3,15
Patites,twisting-nether,287,shaman,restoration,6,3,3
Sakoon,twisting-nether,287,shaman,restoration,6,3,3
Deeblu,nemesis,287,shaman,restoration,12,3,9
Mwnci,anachronos,287,shaman,restoration,18,3,15
Rbghêâl,blackrock,287,shaman,restoration,18,3,15
Mimsy,hyjal,285,shaman,restoration,12,3,9
Crazypurgeqt,arathor,255,shaman,restoration,17,3,14
Randomshamx,ravencrest,239,shaman,restoration,5,3,2
Brigantino,burning-legion,239,shaman,restoration,5,3,2
Elliesham,kazzak,239,shaman,restoration,5,3,2
Tickly,blackhand,239,shaman,restoration,5,3,2
Yukîmøn,hyjal,234,shaman,restoration,11,4,7
Ikó,kazzak,234,shaman,restoration,22,6,16
Còób,ravencrest,192,shaman,restoration,6,2,4
Jacquisham,archimonde,192,shaman,restoration,6,2,4
Пучмек,gordunni,192,shaman,restoration,6,2,4
Khayac,ravencrest,192,shaman,restoration,6,2,4
Kevox,malganis,192,shaman,restoration,6,2,4
Pebble,blackrock,192,shaman,restoration,6,2,4
Srøgg,archimonde,192,shaman,restoration,6,2,4
Wahya,stormscale,192,shaman,restoration,6,2,4
Lausimhaus,blackrock,192,shaman,restoration,6,2,4
Grende,sylvanas,192,shaman,restoration,6,2,4
Obêlixx,blackmoore,192,shaman,restoration,6,2,4
Oladoda,archimonde,192,shaman,restoration,6,2,4
Pumanii,silvermoon,192,shaman,restoration,6,2,4
Nassîî,blackhand,192,shaman,restoration,6,2,4
Чиллаут,howling-fjord,192,shaman,restoration,6,2,4
Shàwyn,sylvanas,192,shaman,restoration,6,2,4
Totemino,silvermoon,192,shaman,restoration,6,2,4
Cragouz,archimonde,192,shaman,restoration,6,2,4
Sàs,zuljin,192,shaman,restoration,6,2,4
Schmamane,blutkessel,192,shaman,restoration,6,2,4
Roxyzwergal,aegwynn,192,shaman,restoration,6,2,4
Vyrá,onyxia,192,shaman,restoration,6,2,4
Mikhey,archimonde,192,shaman,restoration,6,2,4
Baboss,blutkessel,192,shaman,restoration,6,2,4
Raincaller,archimonde,192,shaman,restoration,6,2,4
Shamdren,outland,192,shaman,restoration,6,2,4
Bumbummann,blackmoore,192,shaman,restoration,6,2,4
Lycburst,twisting-nether,192,shaman,restoration,6,2,4
Agorasiya,frostwolf,192,shaman,restoration,6,2,4
Basegrandpa,ravencrest,192,shaman,restoration,6,2,4
Imbahlink,draenor,192,shaman,restoration,6,2,4
Chêlëx,silvermoon,192,shaman,restoration,6,2,4
Tobbey,tarren-mill,192,shaman,restoration,6,2,4
Элементаликс,ashenvale,192,shaman,restoration,6,2,4
Lexus,nordrassil,192,shaman,restoration,6,2,4
Anteja,kazzak,192,shaman,restoration,6,2,4
Liferqt,nemesis,192,shaman,restoration,6,2,4
Maybeyes,twisting-nether,192,shaman,restoration,6,2,4
Palarins,dalaran,192,shaman,restoration,6,2,4
Lêss,ysondre,192,shaman,restoration,6,2,4
Wåe,outland,192,shaman,restoration,6,2,4
Урахарочка,soulflayer,192,shaman,restoration,6,2,4
Berascendz,argent-dawn,192,shaman,restoration,6,2,4
Боргирх,soulflayer,192,shaman,restoration,6,2,4
Ånný,blackmoore,192,shaman,restoration,6,2,4
Rihi,twisting-nether,192,shaman,restoration,6,2,4
Ðiezz,ysondre,192,shaman,restoration,6,2,4
Sablolix,ravencrest,192,shaman,restoration,6,2,4
Kàji,ravencrest,192,shaman,restoration,6,2,4
Sniipy,blackmoore,192,shaman,restoration,6,2,4
Renátosz,ragnaros,192,shaman,restoration,6,2,4
Pûrge,tarren-mill,192,shaman,restoration,6,2,4
Shupp,stormscale,192,shaman,restoration,6,2,4
Strikerz,aggra-português,192,shaman,restoration,7,2,5
Ekxr,kazzak,192,shaman,restoration,12,2,10
Nuekx,sanguino,192,shaman,restoration,12,2,10
Saarroo,ravencrest,192,shaman,restoration,12,2,10
Cptnkirby,malganis,192,shaman,restoration,12,2,10
Samisu,blackmoore,192,shaman,restoration,12,2,10
Nêôô,blackrock,192,shaman,restoration,12,2,10
Ozzlac,thrall,192,shaman,restoration,12,2,10
Muntark,thrall,192,shaman,restoration,12,2,10
Valuriya,blackhand,191,shaman,restoration,6,2,4
Kanuw,kilrogg,191,shaman,restoration,6,2,4
Jøw,dun-modr,191,shaman,restoration,6,2,4
Penumbrah,kazzak,191,shaman,restoration,26,2,24
Ghafo,norgannon,159,shaman,restoration,5,2,3
Jecastyle,sanguino,138,shaman,restoration,8,3,5
Ruzgork,nerzhul,138,shaman,restoration,9,3,6
Belldandý,archimonde,128,shaman,restoration,4,2,2
Shamaray,stormscale,127,shaman,restoration,8,2,6
Kelshaj,thrall,96,shaman,restoration,3,2,1
Moglibard,grim-batol,96,shaman,restoration,6,1,5
Rahuna,darksorrow,96,shaman,restoration,6,1,5
Reflux,outland,96,shaman,restoration,6,1,5
Таззикшок,soulflayer,96,shaman,restoration,6,1,5
Xilquid,darksorrow,96,shaman,restoration,6,1,5
Фистинктотем,soulflayer,96,shaman,restoration,6,1,5
Rëazx,archimonde,96,shaman,restoration,6,1,5
Jaeslin,tarren-mill,96,shaman,restoration,6,1,5
Dälon,thrall,96,shaman,restoration,6,1,5
Efdemin,blackmoore,96,shaman,restoration,6,1,5
Picklechris,tarren-mill,96,shaman,restoration,6,1,5
Mystico,sanguino,96,shaman,restoration,6,1,5
Garulf,twisting-nether,96,shaman,restoration,6,1,5
Sparkygrill,eredar,96,shaman,restoration,6,1,5
Elchivo,blackrock,96,shaman,restoration,6,1,5
Zimzalabling,kazzak,96,shaman,restoration,6,1,5
Geifmeat,kazzak,96,shaman,restoration,6,1,5
Zethh,antonidas,96,shaman,restoration,6,1,5
Ibkdalen,stormscale,96,shaman,restoration,6,1,5
Cirøsham,ravencrest,96,shaman,restoration,6,1,5
Ronell,argent-dawn,96,shaman,restoration,6,1,5
Eclaîr,thrall,96,shaman,restoration,6,1,5
Ohheck,outland,96,shaman,restoration,6,1,5
Gauss,agamaggan,96,shaman,restoration,6,1,5
Clearwaters,tarren-mill,96,shaman,restoration,6,1,5
Aguero,aegwynn,96,shaman,restoration,6,1,5
Anieszka,malganis,96,shaman,restoration,6,1,5
Chênoya,blackrock,96,shaman,restoration,6,1,5
Hotstorm,bronzebeard,96,shaman,restoration,6,1,5
Diabolous,drakthul,96,shaman,restoration,6,1,5
Qwázú,silvermoon,96,shaman,restoration,6,1,5
Greenbo,burning-blade,96,shaman,restoration,6,1,5
Porke,moonglade,96,shaman,restoration,6,1,5
Dvrg,antonidas,96,shaman,restoration,6,1,5
Cy,aszune,96,shaman,restoration,6,1,5
Zeiger,minahonda,96,shaman,restoration,6,1,5
Cupído,malganis,96,shaman,restoration,6,1,5
Shamgott,silvermoon,96,shaman,restoration,6,1,5
Kimpa,minahonda,96,shaman,restoration,6,1,5
Moonlanced,aegwynn,96,shaman,restoration,6,1,5
Happyjuice,silvermoon,96,shaman,restoration,6,1,5
Freeleys,silvermoon,96,shaman,restoration,12,1,11
Ikeaboy,eredar,96,shaman,restoration,12,1,11
Goldhand,ravencrest,96,shaman,restoration,12,1,11
Mvvp,stormscale,96,shaman,restoration,12,1,11
Tiamât,culte-de-la-rive-noire,96,shaman,restoration,12,1,11
Chunkss,argent-dawn,96,shaman,restoration,12,1,11
Akuha,dun-modr,96,shaman,restoration,12,1,11
Porre,zuljin,96,shaman,restoration,12,1,11
Theodorix,silvermoon,96,shaman,restoration,12,1,11
Íss,cthun,96,shaman,restoration,12,1,11
Kvelertak,guldan,96,shaman,restoration,18,1,17
Hairball,turalyon,95,shaman,restoration,6,2,4
Twotwozero,defias-brotherhood,95,shaman,restoration,6,1,5
Taiki,sylvanas,90,shaman,restoration,13,4,9
Realiz,ysondre,79,shaman,restoration,5,1,4
Jamienisme,ravencrest,79,shaman,restoration,5,1,4
Destrosoul,kazzak,64,shaman,restoration,4,1,3
Гвинневра,azuregos,63,shaman,restoration,2,2,0
Icozy,stormscale,48,shaman,restoration,3,1,2
Mcgrêgor,aegwynn,42,shaman,restoration,9,3,6
Paskapallo,sylvanas,42,shaman,restoration,8,2,6
Icanbreathe,ravencrest,42,shaman,restoration,9,2,7
Shammez,ravencrest,42,shaman,restoration,11,2,9
Drøgøs,dun-modr,42,shaman,restoration,12,2,10
Rngo,blackrock,2305,shaman,elemental,72,46,26
Reibanit,twisting-nether,2284,shaman,elemental,147,86,61
Rungõo,blackrock,2267,shaman,elemental,84,48,36
Proccit,blackrock,2226,shaman,elemental,90,50,40
Lexila,doomhammer,2225,shaman,elemental,215,122,93
Silden,thrall,2209,shaman,elemental,103,60,43
Lavaole,blackrock,2185,shaman,elemental,78,42,36
Shiggenbasta,kazzak,2166,shaman,elemental,78,46,32
Tommybanger,kazzak,2158,shaman,elemental,75,49,26
Shamanazor,twisting-nether,2153,shaman,elemental,66,41,25
Baldcreep,blackrock,2147,shaman,elemental,54,35,19
Space,stormscale,2144,shaman,elemental,126,66,60
Trickful,kazzak,2136,shaman,elemental,60,42,18
Edshearen,stormscale,2127,shaman,elemental,68,42,26
Eupra,archimonde,2126,shaman,elemental,72,40,32
Theglue,kilrogg,2124,shaman,elemental,60,36,24
Smorchamp,sanguino,2110,shaman,elemental,84,44,40
Wisplol,ravencrest,2094,shaman,elemental,124,68,56
Drshock,blackmoore,2077,shaman,elemental,84,42,42
Båkka,ysondre,2074,shaman,elemental,54,32,22
Маигваза,soulflayer,2067,shaman,elemental,54,37,17
Lavayoshi,kazzak,2026,shaman,elemental,72,48,24
Blyatifulday,malganis,1994,shaman,elemental,66,36,30
Jelvin,tarren-mill,1992,shaman,elemental,60,33,27
Onceinalife,ambossar,1978,shaman,elemental,155,83,72
Satisfya,ambossar,1957,shaman,elemental,59,34,25
Ryysham,ravencrest,1955,shaman,elemental,75,43,32
Eyi,ambossar,1955,shaman,elemental,86,46,40
Pipousham,blackhand,1954,shaman,elemental,47,26,21
Flanax,hyjal,1951,shaman,elemental,54,36,18
Ghostwolfgg,archimonde,1930,shaman,elemental,42,27,15
Nekhros,sargeras,1926,shaman,elemental,122,69,53
Blackyx,cthun,1921,shaman,elemental,54,35,19
Punished,blackrock,1920,shaman,elemental,83,48,35
Ìløvêxÿú,ravencrest,1919,shaman,elemental,42,26,16
Guzzelinare,tarren-mill,1913,shaman,elemental,30,20,10
Mcmxcvi,ravencrest,1913,shaman,elemental,53,32,21
Suldaro,aegwynn,1913,shaman,elemental,67,36,31
Uselesslaso,sanguino,1899,shaman,elemental,59,28,31
Smorclelx,khadgar,1896,shaman,elemental,102,58,44
Raintlordx,twisting-nether,1894,shaman,elemental,30,25,5
Thyeori,stormscale,1893,shaman,elemental,48,24,24
Totemlié,ravencrest,1887,shaman,elemental,42,27,15
Mjorè,twisting-nether,1887,shaman,elemental,73,35,38
Bärtigeberta,aegwynn,1886,shaman,elemental,36,22,14
Nokster,twisting-nether,1880,shaman,elemental,48,32,16
Gungo,deathwing,1880,shaman,elemental,36,20,16
Teslashock,outland,1879,shaman,elemental,30,20,10
Volcanò,outland,1877,shaman,elemental,175,90,85
Obryss,tarren-mill,1876,shaman,elemental,36,20,16
Psyku,outland,1875,shaman,elemental,42,20,22
Nevershearx,blackrock,1873,shaman,elemental,48,25,23
Borbor,argent-dawn,1858,shaman,elemental,46,23,23
Kärríegold,blackrock,1848,shaman,elemental,147,77,70
Paulbaniel,alonsus,1837,shaman,elemental,66,32,34
Dräpàrn,sylvanas,1833,shaman,elemental,60,32,28
Crazyshaman,ravencrest,1829,shaman,elemental,53,26,27
Novoz,ysondre,1824,shaman,elemental,54,29,25
Kæzx,blackrock,1822,shaman,elemental,78,45,33
Raknoxye,blackrock,1816,shaman,elemental,36,28,8
Tasoro,sanguino,1812,shaman,elemental,59,27,32
Sajma,silvermoon,1811,shaman,elemental,51,36,15
Штормкрашер,howling-fjord,1810,shaman,elemental,48,30,18
Agrero,auchindoun,1810,shaman,elemental,48,26,22
Chamel,draenor,1808,shaman,elemental,30,19,11
Kailash,defias-brotherhood,1808,shaman,elemental,54,26,28
Eppîx,lightnings-blade,1807,shaman,elemental,52,27,25
Fabslx,archimonde,1806,shaman,elemental,69,31,38
Eledelede,blackhand,1801,shaman,elemental,48,28,20
Burstraze,tarren-mill,1801,shaman,elemental,58,32,26
Spajry,drakthul,1800,shaman,elemental,48,32,16
Anqe,twisting-nether,1800,shaman,elemental,66,34,32
Хеллбат,howling-fjord,1794,shaman,elemental,30,19,11
Iavalavalava,tarren-mill,1792,shaman,elemental,42,21,21
Psÿkz,kazzak,1790,shaman,elemental,57,25,32
Transcendent,malorne,1787,shaman,elemental,79,59,20
Naorgot,uldaman,1785,shaman,elemental,54,27,27
Pitsamestari,frostmane,1780,shaman,elemental,122,68,54
Monsuunibaba,tarren-mill,1777,shaman,elemental,51,26,25
Naskezz,kazzak,1776,shaman,elemental,89,42,47
Ejx,arthas,1763,shaman,elemental,46,26,20
Thorleíf,silvermoon,1763,shaman,elemental,54,30,24
Suirz,dun-modr,1762,shaman,elemental,53,37,16
Healyoa,blackmoore,1759,shaman,elemental,123,58,65
Nalaadu,stormscale,1758,shaman,elemental,36,23,13
Voydetesto,sanguino,1753,shaman,elemental,84,39,45
Xorron,archimonde,1742,shaman,elemental,102,49,53
Djlavaburst,malganis,1741,shaman,elemental,155,76,79
Earthtjockis,ragnaros,1739,shaman,elemental,41,20,21
Prêxy,kazzak,1737,shaman,elemental,47,21,26
Lianitus,tarren-mill,1736,shaman,elemental,52,26,26
Murdá,ravencrest,1734,shaman,elemental,48,25,23
Zest,hyjal,1733,shaman,elemental,47,25,22
Chênoya,blackrock,1718,shaman,elemental,67,28,39
Doyah,eredar,1717,shaman,elemental,30,19,11
Barbarra,stormscale,1717,shaman,elemental,48,24,24
Starelement,draenor,1716,shaman,elemental,42,18,24
Ungabungha,stormscale,1714,shaman,elemental,114,66,48
Totemlyhot,blackrock,1713,shaman,elemental,48,28,20
Xtremeshaman,blackmoore,1709,shaman,elemental,24,18,6
Crespó,alakir,1708,shaman,elemental,36,18,18
Чойсе,deathguard,1706,shaman,elemental,81,39,42
Huyø,stormscale,1705,shaman,elemental,72,33,39
Дашажмихекс,howling-fjord,1704,shaman,elemental,42,24,18
Шумноватт,howling-fjord,1700,shaman,elemental,42,19,23
Matmonai,hyjal,1693,shaman,elemental,48,23,25
Elegodx,ravencrest,1686,shaman,elemental,47,24,23
Braíntas,norgannon,1686,shaman,elemental,84,39,45
Valgø,twisting-nether,1683,shaman,elemental,70,43,27
Haumx,blackrock,1681,shaman,elemental,42,20,22
Sáàd,ravencrest,1681,shaman,elemental,42,20,22
Earthhulk,thrall,1677,shaman,elemental,36,22,14
Regnever,draenor,1667,shaman,elemental,125,53,72
Esal,blackrock,1665,shaman,elemental,31,21,10
Mèåtbåll,ravencrest,1665,shaman,elemental,30,19,11
Lavatherapy,grim-batol,1664,shaman,elemental,42,25,17
Deeck,ravencrest,1663,shaman,elemental,71,48,23
Elrayitos,shendralar,1659,shaman,elemental,48,31,17
Malybou,ysondre,1651,shaman,elemental,36,18,18
Liluzivert,mannoroth,1648,shaman,elemental,35,20,15
Электро,thermaplugg,1648,shaman,elemental,47,24,23
Карбонатрикс,soulflayer,1641,shaman,elemental,30,19,11
Axahavregryn,kazzak,1640,shaman,elemental,66,40,26
Urshak,alleria,1639,shaman,elemental,36,24,12
Zaarok,voljin,1639,shaman,elemental,91,41,50
Dakyele,ravencrest,1636,shaman,elemental,35,20,15
Proccq,twisting-nether,1632,shaman,elemental,34,18,16
Houmpf,hyjal,1629,shaman,elemental,30,17,13
Rrtyui,twisting-nether,1628,shaman,elemental,30,17,13
Langedinho,stormscale,1627,shaman,elemental,30,17,13
Haasshaman,ravencrest,1625,shaman,elemental,103,46,57
Ânuk,blackrock,1611,shaman,elemental,150,72,78
Ангустиа,galakrond,1610,shaman,elemental,29,20,9
Kemurus,kazzak,1610,shaman,elemental,77,42,35
Shibol,ravencrest,1609,shaman,elemental,46,23,23
Aviciix,sanguino,1605,shaman,elemental,84,36,48
Касикандрэра,soulflayer,1604,shaman,elemental,120,69,51
Kohnân,hyjal,1604,shaman,elemental,42,21,21
Mcbloob,kazzak,1602,shaman,elemental,70,36,34
Pheazka,outland,1601,shaman,elemental,41,17,24
Кирагаз,gordunni,1600,shaman,elemental,45,22,23
Adamyo,stormscale,1598,shaman,elemental,36,17,19
Elektron,malganis,1597,shaman,elemental,90,46,44
Løun,archimonde,1588,shaman,elemental,66,36,30
Гудлаик,soulflayer,1584,shaman,elemental,58,32,26
Vanrake,ravencrest,1580,shaman,elemental,60,34,26
Kapïtão,aggra-português,1579,shaman,elemental,36,19,17
Brugdar,tarren-mill,1574,shaman,elemental,30,22,8
Twiva,silvermoon,1572,shaman,elemental,76,45,31
Blízzilassø,malygos,1572,shaman,elemental,179,93,86
Anøüchkä,ysondre,1572,shaman,elemental,42,21,21
Neotrax,outland,1571,shaman,elemental,60,31,29
Alwaysangry,silvermoon,1570,shaman,elemental,48,27,21
Harod,suramar,1558,shaman,elemental,66,34,32
Hapkin,defias-brotherhood,1558,shaman,elemental,54,27,27
Sunsong,twisting-nether,1557,shaman,elemental,42,21,21
Nykhara,sanguino,1554,shaman,elemental,30,17,13
Jâydizzle,draenor,1553,shaman,elemental,65,23,42
Waaghbozz,eredar,1546,shaman,elemental,54,32,22
Мистеркутёж,gordunni,1537,shaman,elemental,71,35,36
Rungozvs,blackrock,1535,shaman,elemental,24,16,8
Batan,kazzak,1535,shaman,elemental,71,31,40
Connecting,hyjal,1534,shaman,elemental,30,16,14
Canjo,aegwynn,1532,shaman,elemental,54,28,26
Valunii,lordaeron,1532,shaman,elemental,142,66,76
Stickix,malganis,1529,shaman,elemental,24,16,8
Feetenjoyerx,kazzak,1529,shaman,elemental,30,16,14
Gúîtårgøð,sanguino,1529,shaman,elemental,36,17,19
Élé,twisting-nether,1528,shaman,elemental,30,16,14
Lilmarco,stormreaver,1526,shaman,elemental,36,16,20
Johncoltrane,archimonde,1525,shaman,elemental,24,18,6
Essneces,burning-legion,1523,shaman,elemental,36,18,18
Jímmy,frostwhisper,1518,shaman,elemental,48,30,18
Mariomental,draenor,1517,shaman,elemental,36,16,20
Fúth,ysondre,1516,shaman,elemental,52,28,24
Zna,archimonde,1513,shaman,elemental,94,48,46
Belsazar,frostwolf,1511,shaman,elemental,48,20,28
Милфшама,blackscar,1505,shaman,elemental,35,17,18
Naturexz,silvermoon,1495,shaman,elemental,32,18,14
Хэйзл,ashenvale,1490,shaman,elemental,44,25,19
Robofat,ravencrest,1490,shaman,elemental,30,17,13
Sniffix,ysondre,1483,shaman,elemental,109,53,56
Тыщатристах,howling-fjord,1481,shaman,elemental,48,33,15
Shaakez,kazzak,1476,shaman,elemental,35,17,18
Lafia,blackrock,1472,shaman,elemental,54,19,35
Hemradi,blackmoore,1467,shaman,elemental,36,23,13
Ralokar,blackrock,1465,shaman,elemental,48,25,23
Máui,korgall,1465,shaman,elemental,78,38,40
Athul,theradras,1456,shaman,elemental,43,23,20
Kirak,anetheron,1455,shaman,elemental,72,40,32
Mikecrybaby,tarren-mill,1454,shaman,elemental,36,16,20
Mezzoblu,sanguino,1452,shaman,elemental,102,48,54
Pórçé,shattered-hand,1449,shaman,elemental,96,53,43
Томёрк,gordunni,1448,shaman,elemental,118,55,63
Тессельхоф,howling-fjord,1446,shaman,elemental,28,16,12
Kimpa,minahonda,1444,shaman,elemental,72,43,29
Magnetoe,ravencrest,1444,shaman,elemental,36,18,18
Дестройбэйби,gordunni,1441,shaman,elemental,66,37,29
Alèks,forscherliga,1437,shaman,elemental,74,46,28
Nyzo,tarren-mill,1436,shaman,elemental,30,15,15
Baarona,neptulon,1434,shaman,elemental,27,17,10
Ædshearan,blackmoore,1433,shaman,elemental,48,24,24
Shocknrun,sylvanas,1433,shaman,elemental,30,15,15
Skrbkic,tarren-mill,1429,shaman,elemental,91,48,43
Cracklord,outland,1427,shaman,elemental,30,17,13
Reignisover,silvermoon,1415,shaman,elemental,33,17,16
Teccatwo,outland,1411,shaman,elemental,35,18,17
Ласара,eversong,1406,shaman,elemental,36,15,21
Flubberman,blackrock,1402,shaman,elemental,33,18,15
Olawizard,draenor,1401,shaman,elemental,43,22,21
Amanishama,twisting-nether,1400,shaman,elemental,66,36,30
Støya,archimonde,1400,shaman,elemental,48,18,30
Xesti,twisting-nether,1394,shaman,elemental,63,32,31
Lechirurgien,elune,1387,shaman,elemental,102,55,47
Сепич,gordunni,1386,shaman,elemental,42,26,16
Shammyammy,tarren-mill,1383,shaman,elemental,51,25,26
Furrymane,blackmoore,1382,shaman,elemental,51,27,24
Vulcainn,marécage-de-zangar,1374,shaman,elemental,93,59,34
Rohknar,ragnaros,1374,shaman,elemental,30,17,13
Screwz,archimonde,1371,shaman,elemental,62,31,31
Sojee,ysondre,1367,shaman,elemental,36,16,20
Lantbruk,twisting-nether,1362,shaman,elemental,28,15,13
Chøurøx,hyjal,1358,shaman,elemental,37,21,16
Tempest,kul-tiras,1346,shaman,elemental,41,23,18
Tâsty,blackmoore,1343,shaman,elemental,24,14,10
Херург,soulflayer,1342,shaman,elemental,30,14,16
Horizons,the-maelstrom,1338,shaman,elemental,24,14,10
Sshaasam,tarren-mill,1337,shaman,elemental,24,14,10
Гексанол,soulflayer,1332,shaman,elemental,34,16,18
Lêmberger,eredar,1330,shaman,elemental,30,15,15
Wàve,stormscale,1330,shaman,elemental,30,14,16
Microb,blackmoore,1326,shaman,elemental,30,14,16
Acces,stormscale,1325,shaman,elemental,18,14,4
Bâllz,anetheron,1314,shaman,elemental,54,23,31
Blancc,kazzak,1312,shaman,elemental,60,34,26
Doneteasy,blackrock,1310,shaman,elemental,52,24,28
Ашьф,gordunni,1308,shaman,elemental,29,14,15
Sunraiser,blackmoore,1307,shaman,elemental,30,16,14
Aldonatello,blackrock,1306,shaman,elemental,30,17,13
Gorpdorp,ravencrest,1300,shaman,elemental,48,23,25
Lavamann,blackmoore,1295,shaman,elemental,42,20,22
Onlyfansmod,uldum,1293,shaman,elemental,42,17,25
Dropdattotem,stormscale,1292,shaman,elemental,54,23,31
Griins,ravencrest,1289,shaman,elemental,36,20,16
Carusø,thrall,1287,shaman,elemental,49,30,19
Elshifotrem,throkferoth,1282,shaman,elemental,52,28,24
Флоррэт,gordunni,1280,shaman,elemental,108,46,62
Snusyy,ravencrest,1279,shaman,elemental,26,14,12
Xfiles,garona,1278,shaman,elemental,48,24,24
Apolomaeuz,frostwolf,1267,shaman,elemental,53,26,27
Blackmuamba,tarren-mill,1264,shaman,elemental,60,33,27
Pawsh,dun-modr,1264,shaman,elemental,39,19,20
Blackyx,dun-modr,1247,shaman,elemental,18,13,5
Nöyrä,argent-dawn,1247,shaman,elemental,18,13,5
Dretch,dun-morogh,1247,shaman,elemental,24,13,11
Ludo,lothar,1246,shaman,elemental,22,14,8
Vivaldi,varimathras,1246,shaman,elemental,24,13,11
Starpior,stormscale,1246,shaman,elemental,33,14,19
Pxsquals,ravencrest,1245,shaman,elemental,24,13,11
Solosüper,ravencrest,1245,shaman,elemental,30,13,17
Quizx,blackrock,1245,shaman,elemental,60,25,35
Aspên,archimonde,1244,shaman,elemental,24,13,11
Fullavaids,grim-batol,1243,shaman,elemental,24,13,11
Zoomar,tarren-mill,1241,shaman,elemental,24,13,11
Smashz,stormscale,1240,shaman,elemental,24,13,11
Gagné,hyjal,1239,shaman,elemental,24,13,11
Makgoa,ysondre,1237,shaman,elemental,18,13,5
Couldar,stormscale,1236,shaman,elemental,18,13,5
Incredibade,stormscale,1236,shaman,elemental,24,13,11
Torouk,rashgarroth,1231,shaman,elemental,24,13,11
Vladraxes,draenor,1222,shaman,elemental,18,13,5
Scurvy,malganis,1222,shaman,elemental,87,47,40
Bigheal,quelthalas,1222,shaman,elemental,30,13,17
Waterboi,blackmoore,1219,shaman,elemental,24,13,11
Сосмыслом,howling-fjord,1217,shaman,elemental,30,13,17
Maggoshishi,blackmoore,1214,shaman,elemental,66,34,32
Bigboisham,outland,1202,shaman,elemental,65,28,37
Agreró,auchindoun,1198,shaman,elemental,21,14,7
Märthalouise,twisting-nether,1191,shaman,elemental,29,15,14
Scot,blackhand,1191,shaman,elemental,29,13,16
Valdera,dun-morogh,1189,shaman,elemental,24,14,10
Rekhtar,burning-legion,1171,shaman,elemental,74,37,37
Крто,thermaplugg,1169,shaman,elemental,36,19,17
Zhinjo,kazzak,1166,shaman,elemental,36,19,17
Фистинктотем,soulflayer,1162,shaman,elemental,35,16,19
Велгур,soulflayer,1161,shaman,elemental,50,23,27
Kenaz,outland,1152,shaman,elemental,18,12,6
Azmerloth,outland,1152,shaman,elemental,18,12,6
Neverplayele,kazzak,1151,shaman,elemental,24,12,12
Мэморисс,gordunni,1149,shaman,elemental,24,12,12
Justweirdaf,blackmoore,1148,shaman,elemental,45,20,25
Legended,tarren-mill,1147,shaman,elemental,24,12,12
Daemp,draenor,1146,shaman,elemental,18,12,6
Diaba,sylvanas,1146,shaman,elemental,24,12,12
Dzielnysham,silvermoon,1145,shaman,elemental,21,13,8
Headthirst,ragnaros,1145,shaman,elemental,24,12,12
Эфирад,blackscar,1145,shaman,elemental,46,20,26
Goromar,kirin-tor,1144,shaman,elemental,54,22,32
Skeiilz,hyjal,1142,shaman,elemental,24,12,12
Boxo,frostwolf,1137,shaman,elemental,70,38,32
Djent,outland,1133,shaman,elemental,24,12,12
Noyá,argent-dawn,1129,shaman,elemental,24,12,12
Bowtenstorm,ravencrest,1120,shaman,elemental,25,16,9
Superkee,kazzak,1103,shaman,elemental,83,41,42
Farùk,ravencrest,1102,shaman,elemental,21,13,8
Hatyatya,ragnaros,1094,shaman,elemental,21,12,9
Озверею,goldrinn,1090,shaman,elemental,24,14,10
Sgf,stormscale,1087,shaman,elemental,29,12,17
Aureo,dun-modr,1085,shaman,elemental,22,12,10
Tiamât,culte-de-la-rive-noire,1069,shaman,elemental,48,20,28
Thunderstryk,sylvanas,1062,shaman,elemental,18,12,6
Nyed,hyjal,1056,shaman,elemental,18,11,7
Trixxsham,twisting-nether,1056,shaman,elemental,18,11,7
Шоу,gordunni,1056,shaman,elemental,24,11,13
Matmons,hyjal,1056,shaman,elemental,24,11,13
Achtungblitz,blackrock,1055,shaman,elemental,12,11,1
Gojõ,dun-modr,1055,shaman,elemental,24,11,13
Furthehorde,frostmane,1054,shaman,elemental,18,11,7
Aylar,zenedar,1054,shaman,elemental,18,11,7
Èrò,blackhand,1053,shaman,elemental,24,11,13
Manaphi,arthas,1052,shaman,elemental,24,11,13
Smort,frostwolf,1051,shaman,elemental,24,11,13
Faydasizsham,twisting-nether,1050,shaman,elemental,18,11,7
Louler,ragnaros,1049,shaman,elemental,24,11,13
Kylas,die-ewige-wacht,1047,shaman,elemental,18,11,7
Магмарончик,gordunni,1035,shaman,elemental,60,21,39
Laquium,blackmoore,1032,shaman,elemental,37,15,22
Procdaddy,eredar,1030,shaman,elemental,36,11,25
Ormanthep,hyjal,1029,shaman,elemental,18,11,7
Flochy,argent-dawn,1027,shaman,elemental,53,31,22
Magath,nethersturm,1027,shaman,elemental,24,11,13
Bambustic,kazzak,1023,shaman,elemental,17,11,6
Alfang,turalyon,1005,shaman,elemental,35,11,24
Hugzy,argent-dawn,993,shaman,elemental,24,15,9
Ankzul,exodar,982,shaman,elemental,32,11,21
Aslakki,turalyon,975,shaman,elemental,42,11,31
Shrmful,dun-modr,960,shaman,elemental,12,10,2
Nëllaqt,archimonde,960,shaman,elemental,18,10,8
Davinshhe,kazzak,960,shaman,elemental,24,10,14
Rottulos,stormrage,960,shaman,elemental,30,10,20
Muscade,silvermoon,959,shaman,elemental,12,10,2
Voltyum,zuljin,959,shaman,elemental,18,10,8
Дзод,deathweaver,959,shaman,elemental,18,10,8
Rawside,thrall,959,shaman,elemental,24,10,14
Òoòoòoòoòoòo,silvermoon,959,shaman,elemental,24,10,14
Blover,drakthul,958,shaman,elemental,12,10,2
Ðãvê,veknilash,958,shaman,elemental,18,10,8
Minasa,saurfang,958,shaman,elemental,30,10,20
Ximid,doomhammer,957,shaman,elemental,65,30,35
Jazzrod,stormscale,957,shaman,elemental,24,10,14
Atuaßëlha,grim-batol,957,shaman,elemental,24,10,14
Elevlach,drakthul,957,shaman,elemental,30,10,20
Klunkespiser,stormscale,955,shaman,elemental,24,10,14
Unangemessen,silvermoon,951,shaman,elemental,18,10,8
Ххенеси,soulflayer,947,shaman,elemental,24,10,14
Obesisham,outland,943,shaman,elemental,30,11,19
Smorcxx,kazzak,934,shaman,elemental,30,10,20
Orishimaru,blackrock,932,shaman,elemental,23,10,13
Федосик,galakrond,922,shaman,elemental,30,12,18
Monstermunch,ravencrest,903,shaman,elemental,34,11,23
ßaraky,kazzak,864,shaman,elemental,12,9,3
Foxxyluv,stormscale,864,shaman,elemental,12,9,3
Plazmorc,stormscale,864,shaman,elemental,12,9,3
Çð,ravencrest,864,shaman,elemental,18,9,9
Elvalya,archimonde,864,shaman,elemental,18,9,9
Kelvok,silvermoon,864,shaman,elemental,18,9,9
Jøhnwick,ysondre,864,shaman,elemental,18,9,9
Blush,blackhand,864,shaman,elemental,24,9,15
Homesickx,blackrock,863,shaman,elemental,12,9,3
Гивми,blackscar,863,shaman,elemental,16,10,6
Думсия,gordunni,863,shaman,elemental,18,9,9
Drainergødx,ragnaros,863,shaman,elemental,18,9,9
Рэйвантотем,soulflayer,862,shaman,elemental,18,9,9
Shkook,archimonde,862,shaman,elemental,24,9,15
Hotis,onyxia,862,shaman,elemental,30,9,21
Bunnz,kazzak,861,shaman,elemental,12,9,3
Xiomora,argent-dawn,860,shaman,elemental,18,9,9
Rakzhaza,blackmoore,860,shaman,elemental,18,9,9
Bangou,archimonde,860,shaman,elemental,21,10,11
Djbruggìe,bloodhoof,860,shaman,elemental,24,9,15
Élémentyum,archimonde,859,shaman,elemental,24,9,15
Beefnale,bladefist,859,shaman,elemental,30,9,21
Штормбайт,azuregos,858,shaman,elemental,12,9,3
Treizelol,ysondre,855,shaman,elemental,18,9,9
Nïà,kaelthas,854,shaman,elemental,20,9,11
Mö,ragnaros,851,shaman,elemental,24,9,15
Mòra,silvermoon,851,shaman,elemental,24,9,15
Незнаком,booty-bay,811,shaman,elemental,30,12,18
Holdafstand,tarren-mill,798,shaman,elemental,14,9,5
Zanyun,burning-legion,798,shaman,elemental,20,9,11
Соленый,booty-bay,796,shaman,elemental,93,39,54
Tellý,blackmoore,768,shaman,elemental,12,8,4
Flam,outland,768,shaman,elemental,12,8,4
Dumpaman,frostmane,768,shaman,elemental,12,8,4
Strór,twisting-nether,768,shaman,elemental,12,8,4
Visboer,stormscale,768,shaman,elemental,12,8,4
Jåime,ravencrest,768,shaman,elemental,12,8,4
Grapefruit,blackmoore,768,shaman,elemental,12,8,4
Козаностро,howling-fjord,768,shaman,elemental,12,8,4
Bigfrigid,outland,768,shaman,elemental,18,8,10
Retuu,uldaman,768,shaman,elemental,18,8,10
Naphe,ysondre,768,shaman,elemental,18,8,10
Mehboul,hyjal,768,shaman,elemental,18,8,10
Thundergødx,nemesis,768,shaman,elemental,18,8,10
Thorunir,sylvanas,768,shaman,elemental,24,8,16
Yang,der-rat-von-dalaran,767,shaman,elemental,12,8,4
Nachtary,blackmoore,767,shaman,elemental,12,8,4
Hobblefoot,stormscale,767,shaman,elemental,12,8,4
Totempoo,the-maelstrom,766,shaman,elemental,12,8,4
Parthon,ravencrest,765,shaman,elemental,12,8,4
Itsnasty,blackmoore,753,shaman,elemental,18,8,10
Wacomtablet,kazzak,703,shaman,elemental,11,8,3
Fàkecast,outland,702,shaman,elemental,22,8,14
Шиока,borean-tundra,685,shaman,elemental,13,9,4
Kæde,dun-morogh,672,shaman,elemental,12,7,5
Ogkûshgödx,sylvanas,672,shaman,elemental,12,7,5
Гарбаджи,galakrond,672,shaman,elemental,12,7,5
Eðualc,hyjal,672,shaman,elemental,12,7,5
Shamandoino,wildhammer,672,shaman,elemental,12,7,5
Vamali,draenor,672,shaman,elemental,12,7,5
Reburdacoxis,sanguino,672,shaman,elemental,12,7,5
Dòrfy,silvermoon,672,shaman,elemental,12,7,5
Ehlaina,outland,672,shaman,elemental,12,7,5
Yraxara,draenor,672,shaman,elemental,12,7,5
Bosslikex,ravencrest,672,shaman,elemental,12,7,5
Jehae,archimonde,672,shaman,elemental,12,7,5
Labûche,chogall,672,shaman,elemental,12,7,5
Dócshock,blackmoore,672,shaman,elemental,12,7,5
Hothand,thrall,672,shaman,elemental,12,7,5
Replicusele,doomhammer,672,shaman,elemental,12,7,5
Bigblué,tarren-mill,672,shaman,elemental,12,7,5
Koífish,ravencrest,672,shaman,elemental,12,7,5
Thordes,forscherliga,672,shaman,elemental,12,7,5
Дваллинн,gordunni,672,shaman,elemental,18,7,11
Endry,elune,672,shaman,elemental,18,7,11
Thriveqt,nemesis,672,shaman,elemental,24,7,17
Fâro,dun-modr,671,shaman,elemental,12,7,5
Whizjy,sanguino,671,shaman,elemental,12,7,5
Лукаджун,howling-fjord,671,shaman,elemental,12,7,5
Ulfax,argent-dawn,671,shaman,elemental,24,7,17
Watson,conseil-des-ombres,660,shaman,elemental,18,7,11
Blyátmán,twisting-nether,638,shaman,elemental,14,8,6
Айвимэдисон,howling-fjord,623,shaman,elemental,17,7,10
Easyplay,kazzak,607,shaman,elemental,14,7,7
Nightmarefox,tarren-mill,576,shaman,elemental,6,6,0
Captaînhuge,dunemaul,576,shaman,elemental,6,6,0
Trastamar,dun-modr,576,shaman,elemental,6,6,0
Xelphia,frostmane,576,shaman,elemental,12,6,6
Nobrac,rajaxx,576,shaman,elemental,12,6,6
Tteïl,archimonde,576,shaman,elemental,12,6,6
Веег,deathweaver,576,shaman,elemental,12,6,6
Woof,culte-de-la-rive-noire,576,shaman,elemental,12,6,6
Jacklupin,ravencrest,576,shaman,elemental,12,6,6
Kilazz,twisting-nether,576,shaman,elemental,12,6,6
Forrak,argent-dawn,576,shaman,elemental,12,6,6
Localicious,ragnaros,576,shaman,elemental,12,6,6
Bigrambo,draenor,576,shaman,elemental,12,6,6
Shåmssagat,kazzak,576,shaman,elemental,12,6,6
Totemkahmun,kazzak,576,shaman,elemental,12,6,6
Lavalava,blackmoore,576,shaman,elemental,12,6,6
Eddiemorphin,kazzak,576,shaman,elemental,12,6,6
Cïgänää,archimonde,576,shaman,elemental,12,6,6
Simppe,stormreaver,576,shaman,elemental,12,6,6
Windfúhrèr,tarren-mill,576,shaman,elemental,12,6,6
Yzeldan,hyjal,576,shaman,elemental,12,6,6
Dsgrc,tarren-mill,576,shaman,elemental,18,6,12
Unding,azshara,576,shaman,elemental,24,6,18
Xhahal,hyjal,575,shaman,elemental,6,6,0
Syndia,das-konsortium,575,shaman,elemental,12,6,6
Layonne,ysondre,575,shaman,elemental,12,6,6
Fimir,archimonde,573,shaman,elemental,12,6,6
Zbysiu,ravencrest,573,shaman,elemental,18,6,12
Cleandann,stormscale,559,shaman,elemental,17,6,11
Isheartears,outland,543,shaman,elemental,11,6,5
Hanatopikeur,grim-batol,527,shaman,elemental,17,6,11
Rezervoir,bladefist,522,shaman,elemental,15,9,6
Turbokrapka,tarren-mill,522,shaman,elemental,17,8,9
Смоуктли,howling-fjord,480,shaman,elemental,6,5,1
Efdemin,blackmoore,480,shaman,elemental,6,5,1
Тандерхх,howling-fjord,480,shaman,elemental,6,5,1
Grambozz,blackrock,480,shaman,elemental,6,5,1
Эртирон,howling-fjord,480,shaman,elemental,6,5,1
Highfaî,tarren-mill,480,shaman,elemental,6,5,1
Minimalist,stormscale,480,shaman,elemental,6,5,1
Sïmp,blackrock,480,shaman,elemental,6,5,1
Phobiatics,thrall,480,shaman,elemental,6,5,1
Autopanne,malganis,480,shaman,elemental,6,5,1
Bumstead,ragnaros,480,shaman,elemental,6,5,1
Hexina,ragnaros,480,shaman,elemental,6,5,1
Volhalo,blackmoore,480,shaman,elemental,6,5,1
Rhonix,blackmoore,480,shaman,elemental,6,5,1
Squixi,tarren-mill,480,shaman,elemental,6,5,1
Navyblue,sylvanas,480,shaman,elemental,6,5,1
Sinirli,ravencrest,480,shaman,elemental,6,5,1
Lovelyshaman,silvermoon,480,shaman,elemental,7,5,2
Khalamity,ravencrest,480,shaman,elemental,9,6,3
Fattmorte,hyjal,480,shaman,elemental,9,6,3
Owrly,stormscale,480,shaman,elemental,12,5,7
Loshohealva,stormscale,480,shaman,elemental,12,5,7
Velkin,thrall,480,shaman,elemental,12,5,7
Targoel,blackmoore,480,shaman,elemental,12,5,7
Matmodir,hyjal,480,shaman,elemental,12,5,7
Saqerr,kazzak,480,shaman,elemental,12,5,7
Skullføck,argent-dawn,480,shaman,elemental,12,5,7
Swapxy,outland,480,shaman,elemental,12,5,7
Xereús,kazzak,480,shaman,elemental,16,6,10
Clickerboy,ravencrest,480,shaman,elemental,18,5,13
Roxìe,blackmoore,479,shaman,elemental,6,5,1
Fûchsí,blackhand,479,shaman,elemental,6,5,1
Burnprof,nethersturm,479,shaman,elemental,12,5,7
Sinwithin,ravencrest,478,shaman,elemental,12,5,7
Chispa,darkmoon-faire,447,shaman,elemental,11,5,6
Novka,eredar,447,shaman,elemental,11,5,6
Disharmony,outland,426,shaman,elemental,13,6,7
Blùé,tarren-mill,399,shaman,elemental,5,5,0
Bkdgoodz,aegwynn,384,shaman,elemental,6,4,2
Alëxx,hyjal,384,shaman,elemental,6,4,2
Xatis,aegwynn,384,shaman,elemental,6,4,2
Selonthyx,ravencrest,384,shaman,elemental,6,4,2
Wylly,aegwynn,384,shaman,elemental,6,4,2
Neystee,archimonde,384,shaman,elemental,6,4,2
Гидрокорыто,gordunni,384,shaman,elemental,6,4,2
Thëtis,chogall,384,shaman,elemental,6,4,2
Milotem,ysondre,384,shaman,elemental,6,4,2
Kévinn,draenor,384,shaman,elemental,6,4,2
Jacc,sunstrider,384,shaman,elemental,6,4,2
Føxï,pozzo-delleternità,384,shaman,elemental,6,4,2
Shafallen,tarren-mill,384,shaman,elemental,6,4,2
Klicken,tarren-mill,384,shaman,elemental,6,4,2
Trustlemac,onyxia,384,shaman,elemental,6,4,2
Yerlas,burning-legion,384,shaman,elemental,6,4,2
Sebubu,twisting-nether,384,shaman,elemental,6,4,2
Shamurky,kazzak,384,shaman,elemental,6,4,2
Voymir,kazzak,384,shaman,elemental,6,4,2
Kraksham,ravencrest,384,shaman,elemental,6,4,2
Ruvxy,twisting-nether,384,shaman,elemental,6,4,2
Seriux,twisting-nether,384,shaman,elemental,6,4,2
Schamîx,blackrock,384,shaman,elemental,6,4,2
Ezala,blackhand,384,shaman,elemental,6,4,2
Anubisll,hyjal,384,shaman,elemental,6,4,2
Lathisi,zenedar,384,shaman,elemental,7,4,3
Talg,sylvanas,384,shaman,elemental,9,4,5
Snusy,stormscale,384,shaman,elemental,12,4,8
Xyckas,terrordar,384,shaman,elemental,12,4,8
Вензеро,howling-fjord,384,shaman,elemental,12,4,8
Eskìmo,malganis,384,shaman,elemental,12,4,8
Gensehaut,aegwynn,384,shaman,elemental,12,4,8
Zengã,kazzak,384,shaman,elemental,12,4,8
Dogfrog,silvermoon,384,shaman,elemental,12,4,8
Leash,blackmoore,384,shaman,elemental,12,4,8
Karissah,silvermoon,384,shaman,elemental,12,4,8
Апинсмок,soulflayer,384,shaman,elemental,12,4,8
Rocktopus,outland,384,shaman,elemental,12,4,8
Chrached,kargath,384,shaman,elemental,12,4,8
Saggrox,kazzak,384,shaman,elemental,12,4,8
Réläx,kazzak,384,shaman,elemental,12,4,8
Goitbate,azuremyst,384,shaman,elemental,12,4,8
Tism,stormscale,384,shaman,elemental,12,4,8
Setac,stormscale,384,shaman,elemental,12,4,8
Kønat,blackmoore,384,shaman,elemental,12,4,8
Hí,bronzebeard,384,shaman,elemental,12,4,8
Экслайнер,deathweaver,384,shaman,elemental,12,4,8
Pedrototem,silvermoon,383,shaman,elemental,6,4,2
Zokah,emeriss,383,shaman,elemental,6,4,2
Сарцек,howling-fjord,383,shaman,elemental,6,4,2
Thatamazing,korgall,383,shaman,elemental,10,4,6
Kennyo,uldum,379,shaman,elemental,12,4,8
Gnark,dun-modr,350,shaman,elemental,8,5,3
ßaßystärz,hyjal,319,shaman,elemental,5,4,1
Дудивтф,soulflayer,288,shaman,elemental,6,3,3
Санрэйн,soulflayer,288,shaman,elemental,6,3,3
Amu,ravencrest,288,shaman,elemental,6,3,3
Volvíc,tichondrius,288,shaman,elemental,6,3,3
Symy,draenor,288,shaman,elemental,6,3,3
Firella,the-maelstrom,288,shaman,elemental,6,3,3
Херургх,soulflayer,288,shaman,elemental,6,3,3
Рокутаро,gordunni,288,shaman,elemental,6,3,3
Khaleeya,blackmoore,288,shaman,elemental,6,3,3
Vukroth,argent-dawn,288,shaman,elemental,6,3,3
Энхай,azuregos,288,shaman,elemental,6,3,3
Berith,spinebreaker,288,shaman,elemental,6,3,3
Hotstorm,bronzebeard,288,shaman,elemental,6,3,3
Peaktrim,tarren-mill,288,shaman,elemental,6,3,3
Gissary,drakthul,288,shaman,elemental,6,3,3
Наладчик,gordunni,288,shaman,elemental,6,3,3
Qenninka,drakthul,288,shaman,elemental,6,3,3
Derblitz,baelgun,288,shaman,elemental,6,3,3
Реалайзер,blackscar,288,shaman,elemental,6,3,3
Rhastafarian,stormscale,288,shaman,elemental,6,3,3
Nightingäle,silvermoon,288,shaman,elemental,6,3,3
Bhargonen,silvermoon,288,shaman,elemental,6,3,3
Родохрозид,blackscar,288,shaman,elemental,6,3,3
Jeelypink,dalaran,288,shaman,elemental,6,3,3
Jagblade,neptulon,288,shaman,elemental,6,3,3
Bharudor,antonidas,288,shaman,elemental,6,3,3
Brandbombe,frostwolf,288,shaman,elemental,6,3,3
Bammë,archimonde,288,shaman,elemental,6,3,3
Hethne,kazzak,288,shaman,elemental,6,3,3
Nowmack,archimonde,288,shaman,elemental,6,3,3
Nerdshockz,blackhand,288,shaman,elemental,6,3,3
Shoewalker,ragnaros,288,shaman,elemental,6,3,3
Kónjo,kazzak,288,shaman,elemental,6,3,3
Tiâna,archimonde,288,shaman,elemental,6,3,3
Dagra,twisting-nether,288,shaman,elemental,6,3,3
Peneapunta,nemesis,288,shaman,elemental,6,3,3
Fufupartyxx,blackrock,288,shaman,elemental,6,3,3
Joeyexe,outland,288,shaman,elemental,6,3,3
Lunarsloth,hyjal,288,shaman,elemental,6,3,3
Raïgo,hyjal,288,shaman,elemental,6,3,3
Dünnbier,blackhand,288,shaman,elemental,6,3,3
Shaulic,ravencrest,288,shaman,elemental,6,3,3
Rolftheswine,defias-brotherhood,288,shaman,elemental,6,3,3
Shamanmans,grim-batol,288,shaman,elemental,6,3,3
Ironbuttrfly,magtheridon,288,shaman,elemental,6,3,3
Kärdyo,archimonde,288,shaman,elemental,6,3,3
Spruehkot,aegwynn,288,shaman,elemental,6,3,3
Tonto,frostmane,288,shaman,elemental,12,3,9
Gethrok,rajaxx,288,shaman,elemental,12,3,9
Fouchin,outland,288,shaman,elemental,12,3,9
Corlysvelary,doomhammer,288,shaman,elemental,12,3,9
Naix,silvermoon,288,shaman,elemental,12,3,9
Qwunjin,ragnaros,288,shaman,elemental,12,3,9
Samlik,antonidas,288,shaman,elemental,12,3,9
Jaeslin,tarren-mill,288,shaman,elemental,12,3,9
Elemania,mugthol,288,shaman,elemental,12,3,9
Gammeldunder,shattered-hand,288,shaman,elemental,12,3,9
Megaherz,sanguino,287,shaman,elemental,6,3,3
Twotwozero,defias-brotherhood,286,shaman,elemental,6,3,3
Вещун,deathguard,284,shaman,elemental,12,3,9
Mareaspibas,zuljin,239,shaman,elemental,5,3,2
Zarakuda,magtheridon,233,shaman,elemental,16,4,12
Krahg,garona,192,shaman,elemental,4,3,1
Stíckíx,malganis,192,shaman,elemental,4,3,1
Baschúrr,blackrock,192,shaman,elemental,9,3,6
Mehex,tarren-mill,192,shaman,elemental,6,2,4
Rindenmulch,eredar,192,shaman,elemental,6,2,4
Rompelukt,auchindoun,192,shaman,elemental,6,2,4
Renegad,archimonde,192,shaman,elemental,6,2,4
Naathir,magtheridon,192,shaman,elemental,6,2,4
Cloovster,magtheridon,192,shaman,elemental,6,2,4
Vandouille,archimonde,192,shaman,elemental,6,2,4
Rakermän,dun-modr,192,shaman,elemental,6,2,4
Yezu,medivh,192,shaman,elemental,6,2,4
Дагод,booty-bay,192,shaman,elemental,6,2,4
Ratatakéas,archimonde,192,shaman,elemental,6,2,4
Nnekalol,twisting-nether,192,shaman,elemental,6,2,4
Bluéshirtguy,blackhand,192,shaman,elemental,6,2,4
Nuekx,sanguino,192,shaman,elemental,6,2,4
Драгенхз,gordunni,192,shaman,elemental,6,2,4
Thomz,aggra-português,192,shaman,elemental,6,2,4
Шлолка,gordunni,192,shaman,elemental,6,2,4
Loserlol,das-syndikat,192,shaman,elemental,6,2,4
Dormido,sanguino,192,shaman,elemental,6,2,4
Лаваяшка,gordunni,192,shaman,elemental,6,2,4
Attm,twisting-nether,192,shaman,elemental,6,2,4
Macetoyaface,darksorrow,192,shaman,elemental,6,2,4
Thornyberrý,outland,192,shaman,elemental,6,2,4
Amonshokz,tarren-mill,192,shaman,elemental,6,2,4
Squixi,ravencrest,192,shaman,elemental,6,2,4
Windspêaker,outland,192,shaman,elemental,6,2,4
Ishkadar,twisting-nether,192,shaman,elemental,6,2,4
Dodododfewal,stormscale,192,shaman,elemental,6,2,4
Rok,darkspear,192,shaman,elemental,6,2,4
Biccon,silvermoon,192,shaman,elemental,6,2,4
Shàmeonyou,dun-morogh,192,shaman,elemental,6,2,4
Сновидений,soulflayer,192,shaman,elemental,6,2,4
Fuzzbolt,silvermoon,192,shaman,elemental,6,2,4
Шаеман,soulflayer,192,shaman,elemental,6,2,4
Kappatotem,silvermoon,192,shaman,elemental,6,2,4
Zinlay,tarren-mill,192,shaman,elemental,6,2,4
Albatroz,the-maelstrom,192,shaman,elemental,6,2,4
Präsi,die-aldor,192,shaman,elemental,6,2,4
Zackyboi,tarren-mill,192,shaman,elemental,6,2,4
Ahrim,argent-dawn,192,shaman,elemental,6,2,4
Nuvet,argent-dawn,192,shaman,elemental,6,2,4
Kolchidyalah,la-croisade-écarlate,192,shaman,elemental,6,2,4
Shockbestie,eredar,192,shaman,elemental,7,2,5
Виспепешам,gordunni,192,shaman,elemental,12,2,10
Nakenfeigy,stormreaver,192,shaman,elemental,12,2,10
Ærö,outland,192,shaman,elemental,12,2,10
Zíp,archimonde,192,shaman,elemental,12,2,10
Sweetcåndy,stormscale,192,shaman,elemental,12,2,10
Lycburst,twisting-nether,192,shaman,elemental,12,2,10
Максобман,howling-fjord,192,shaman,elemental,12,2,10
Shammolino,nemesis,191,shaman,elemental,4,3,1
Aspirio,ravencrest,175,shaman,elemental,11,2,9
Pvpshaman,aszune,159,shaman,elemental,5,2,3
Kortën,khaz-modan,159,shaman,elemental,10,2,8
Lavaburstx,antonidas,138,shaman,elemental,10,3,7
Amiashaman,stormscale,138,shaman,elemental,16,3,13
Bram,aggra-português,96,shaman,elemental,3,2,1
Nopivøt,hyjal,96,shaman,elemental,7,2,5
Лучшийшаман,soulflayer,96,shaman,elemental,6,1,5
Helloitsmee,thrall,96,shaman,elemental,6,1,5
Пэппивкашке,howling-fjord,96,shaman,elemental,6,1,5
Shamsteaks,ysera,96,shaman,elemental,6,1,5
Bonestompamc,blackmoore,96,shaman,elemental,6,1,5
Depucova,silvermoon,96,shaman,elemental,6,1,5
Stiflersmôm,antonidas,96,shaman,elemental,6,1,5
Magicmekoz,draenor,96,shaman,elemental,6,1,5
Pasjeop,ravencrest,96,shaman,elemental,6,1,5
Newÿorc,dalaran,96,shaman,elemental,6,1,5
Luzzilol,garrosh,96,shaman,elemental,6,1,5
Heheheyup,ravencrest,96,shaman,elemental,6,1,5
Shaminista,ravencrest,96,shaman,elemental,6,1,5
Сентес,soulflayer,96,shaman,elemental,6,1,5
Fatflop,sylvanas,96,shaman,elemental,6,1,5
Samisu,blackmoore,96,shaman,elemental,6,1,5
Tir,auchindoun,96,shaman,elemental,6,1,5
Woolysocks,draenor,96,shaman,elemental,6,1,5
Sayokô,grim-batol,96,shaman,elemental,6,1,5
Flurpz,outland,96,shaman,elemental,6,1,5
Vodoochild,hyjal,96,shaman,elemental,6,1,5
Dergat,pozzo-delleternità,96,shaman,elemental,6,1,5
Takkenuma,hyjal,96,shaman,elemental,6,1,5
Skailzcham,hyjal,96,shaman,elemental,6,1,5
Elijaá,nordrassil,96,shaman,elemental,6,1,5
Izir,archimonde,96,shaman,elemental,6,1,5
Magmamartin,antonidas,96,shaman,elemental,6,1,5
Ânne,blackrock,96,shaman,elemental,6,1,5
Pomegranate,arthas,96,shaman,elemental,6,1,5
Shamira,nethersturm,96,shaman,elemental,6,1,5
Freexx,aegwynn,96,shaman,elemental,6,1,5
Aguero,aegwynn,96,shaman,elemental,6,1,5
Nìtratx,archimonde,96,shaman,elemental,6,1,5
Dwarfofwar,ravencrest,96,shaman,elemental,6,1,5
Альтегро,blackscar,96,shaman,elemental,6,1,5
Hästdvärg,the-maelstrom,96,shaman,elemental,6,1,5
Thrallotido,sanguino,96,shaman,elemental,6,1,5
Champïx,archimonde,96,shaman,elemental,15,2,13
Kyst,elune,95,shaman,elemental,6,1,5
Torepåsporet,deathwing,79,shaman,elemental,5,1,4
Rãgnãr,frostwolf,64,shaman,elemental,4,1,3
Obêlixx,blackmoore,31,shaman,elemental,2,1,1
Memourian,drakthul,16,shaman,elemental,7,1,6
Mûnch,kazzak,2369,shaman,enhancement,110,73,37
Крааули,soulflayer,2322,shaman,enhancement,234,123,111
Bredare,ravencrest,2295,shaman,enhancement,100,79,21
Fatpig,stormscale,2238,shaman,enhancement,83,47,36
Axdn,ravencrest,2229,shaman,enhancement,80,47,33
Avines,twisting-nether,2205,shaman,enhancement,200,103,97
Myguns,silvermoon,2164,shaman,enhancement,78,47,31
Baconbazooka,tarren-mill,2147,shaman,enhancement,101,60,41
Lizoo,ravencrest,2139,shaman,enhancement,66,50,16
Sillaas,ysondre,2131,shaman,enhancement,102,50,52
Shïnnkøk,stormscale,2130,shaman,enhancement,72,43,29
Mustakrakish,terokkar,2127,shaman,enhancement,78,53,25
Smorcshamyy,kazzak,2127,shaman,enhancement,111,63,48
Fckumen,blackmoore,2124,shaman,enhancement,106,61,45
Stribbzz,stormscale,2121,shaman,enhancement,190,113,77
Joeyexe,outland,2119,shaman,enhancement,84,48,36
Shadi,stormscale,2119,shaman,enhancement,84,44,40
Strippzz,stormscale,2116,shaman,enhancement,78,46,32
Voodoodoouu,stormscale,2116,shaman,enhancement,84,49,35
Maelstrom,eredar,2113,shaman,enhancement,300,167,133
Ruffepuffe,twisting-nether,2109,shaman,enhancement,192,107,85
Buffdraventy,archimonde,2105,shaman,enhancement,66,40,26
Sparkyxd,twisting-nether,2102,shaman,enhancement,78,40,38
Áä,stormscale,2085,shaman,enhancement,42,37,5
Trulylove,tarren-mill,2085,shaman,enhancement,66,34,32
Blaukraut,stormscale,2067,shaman,enhancement,66,41,25
Hexmex,stormreaver,2066,shaman,enhancement,89,52,37
Karpsham,stormscale,2066,shaman,enhancement,109,55,54
Дудивтф,soulflayer,2059,shaman,enhancement,111,57,54
Hermerejildo,stormscale,2048,shaman,enhancement,78,38,40
Azifox,hyjal,2046,shaman,enhancement,60,34,26
Milheroj,tarren-mill,2043,shaman,enhancement,93,53,40
Yüri,stormscale,2030,shaman,enhancement,247,124,123
Gúîtårgøð,sanguino,2010,shaman,enhancement,82,41,41
Lovèless,stormscale,2009,shaman,enhancement,30,21,9
Читорра,gordunni,2008,shaman,enhancement,84,44,40
Shamanyxx,tarren-mill,2007,shaman,enhancement,78,42,36
Yashëa,ysondre,2003,shaman,enhancement,61,51,10
Бафамет,blackscar,1992,shaman,enhancement,48,27,21
Lokes,drakthul,1985,shaman,enhancement,119,68,51
Acidtrips,thrall,1985,shaman,enhancement,54,30,24
Инсэйнгод,soulflayer,1983,shaman,enhancement,63,32,31
Testosterone,dun-modr,1980,shaman,enhancement,71,44,27
Viablous,ravencrest,1977,shaman,enhancement,148,96,52
Turbostruck,ravencrest,1977,shaman,enhancement,102,46,56
Plsdontpress,stormscale,1968,shaman,enhancement,91,53,38
Etox,darksorrow,1962,shaman,enhancement,78,38,40
Shïnnøk,stormscale,1959,shaman,enhancement,249,126,123
Feetaddict,kazzak,1956,shaman,enhancement,47,32,15
Ниу,thermaplugg,1949,shaman,enhancement,54,32,22
Shadiqt,stormscale,1942,shaman,enhancement,60,31,29
Morguk,zuljin,1936,shaman,enhancement,91,53,38
Alterem,kazzak,1914,shaman,enhancement,84,48,36
Пеклоь,soulflayer,1906,shaman,enhancement,83,43,40
Тандерстарк,howling-fjord,1905,shaman,enhancement,119,65,54
Tosemist,stormscale,1903,shaman,enhancement,46,28,18
Arhitopg,silvermoon,1903,shaman,enhancement,120,64,56
Nopre,blackrock,1897,shaman,enhancement,100,56,44
Panzarkamp,stormscale,1894,shaman,enhancement,95,58,37
Enhshamanop,draenor,1893,shaman,enhancement,108,55,53
Gottiy,blackhand,1893,shaman,enhancement,102,50,52
Gromzog,twisting-nether,1890,shaman,enhancement,48,31,17
Blitzmann,outland,1888,shaman,enhancement,30,20,10
Boombastíc,ravencrest,1881,shaman,enhancement,83,43,40
Wishsteen,stormscale,1874,shaman,enhancement,42,27,15
Чаапалах,blackscar,1874,shaman,enhancement,103,53,50
Sozetwo,tarren-mill,1873,shaman,enhancement,34,24,10
Xa,blackrock,1873,shaman,enhancement,54,31,23
Нарленд,gordunni,1871,shaman,enhancement,60,31,29
Ятебясмету,gordunni,1867,shaman,enhancement,48,32,16
Jäy,twisting-nether,1867,shaman,enhancement,58,31,27
Ниокумибейт,soulflayer,1866,shaman,enhancement,52,34,18
Falseshepard,kazzak,1863,shaman,enhancement,54,29,25
Disciplé,blackmoore,1862,shaman,enhancement,65,34,31
Horelio,sanguino,1860,shaman,enhancement,93,56,37
Brokenguyman,defias-brotherhood,1858,shaman,enhancement,41,23,18
Naochí,silvermoon,1857,shaman,enhancement,35,23,12
Radåhn,outland,1854,shaman,enhancement,72,44,28
Chatbanned,blackmoore,1849,shaman,enhancement,42,25,17
Вацунвец,goldrinn,1849,shaman,enhancement,133,70,63
Toteemikylpy,argent-dawn,1848,shaman,enhancement,54,38,16
Frankone,outland,1845,shaman,enhancement,102,61,41
Totemofgreed,rexxar,1843,shaman,enhancement,84,40,44
Zró,blackrock,1841,shaman,enhancement,54,29,25
Calvey,magtheridon,1841,shaman,enhancement,64,31,33
Сахарокь,soulflayer,1840,shaman,enhancement,42,27,15
Uhøfligeulf,draenor,1839,shaman,enhancement,47,24,23
Dennismanone,tarren-mill,1836,shaman,enhancement,66,30,36
Actionhank,area-52,1834,shaman,enhancement,57,30,27
Zetorgg,burning-legion,1832,shaman,enhancement,71,36,35
Critonian,twisting-nether,1831,shaman,enhancement,54,27,27
Друггрумилей,soulflayer,1828,shaman,enhancement,42,24,18
Mírídíuss,silvermoon,1827,shaman,enhancement,35,25,10
Salvadr,zuljin,1827,shaman,enhancement,62,35,27
Shambolicc,ravencrest,1826,shaman,enhancement,59,26,33
Stormkiler,defias-brotherhood,1826,shaman,enhancement,83,36,47
Ananasanax,twisting-nether,1823,shaman,enhancement,114,63,51
Chakafuyo,dun-modr,1822,shaman,enhancement,42,25,17
Oldveteran,eredar,1822,shaman,enhancement,66,39,27
Tâktoukâ,archimonde,1820,shaman,enhancement,58,35,23
Talrall,twisting-nether,1820,shaman,enhancement,66,35,31
Senroxx,blackrock,1818,shaman,enhancement,48,32,16
Пэппивкашке,howling-fjord,1818,shaman,enhancement,38,23,15
Ryhèn,stormscale,1817,shaman,enhancement,128,78,50
Argotan,drakthul,1817,shaman,enhancement,71,43,28
Swapxy,ravencrest,1816,shaman,enhancement,24,19,5
Mckoy,kazzak,1816,shaman,enhancement,40,27,13
Yacu,blackrock,1815,shaman,enhancement,53,32,21
Marohk,uldum,1815,shaman,enhancement,42,22,20
Bikdig,dun-modr,1812,shaman,enhancement,78,47,31
Mèátßãllgøðx,kazzak,1812,shaman,enhancement,129,65,64
Вацустайл,goldrinn,1810,shaman,enhancement,48,32,16
Dshaman,aegwynn,1810,shaman,enhancement,36,23,13
Jtouni,outland,1810,shaman,enhancement,66,32,34
Taktouka,archimonde,1810,shaman,enhancement,54,24,30
Wishstêên,stormscale,1809,shaman,enhancement,64,29,35
Xestil,blackmoore,1808,shaman,enhancement,67,36,31
Yombaï,archimonde,1808,shaman,enhancement,108,48,60
Wóllff,archimonde,1806,shaman,enhancement,48,24,24
Hanrej,draenor,1804,shaman,enhancement,54,33,21
Реактиватор,soulflayer,1803,shaman,enhancement,47,27,20
Бренненд,howling-fjord,1803,shaman,enhancement,88,49,39
Syllaas,ysondre,1800,shaman,enhancement,54,28,26
Rabalalaha,twisting-nether,1798,shaman,enhancement,146,78,68
Proccq,twisting-nether,1795,shaman,enhancement,48,24,24
Shamflurry,ravencrest,1793,shaman,enhancement,42,29,13
Floorislava,culte-de-la-rive-noire,1792,shaman,enhancement,78,39,39
Shamtard,frostwhisper,1791,shaman,enhancement,102,51,51
Bullx,magtheridon,1783,shaman,enhancement,54,30,24
Deaslow,hyjal,1778,shaman,enhancement,83,46,37
Xôàrqt,eredar,1776,shaman,enhancement,197,106,91
Shamarach,sylvanas,1773,shaman,enhancement,30,22,8
Pýthøn,silvermoon,1772,shaman,enhancement,54,27,27
Ázøk,stormscale,1771,shaman,enhancement,142,72,70
Spicemélange,archimonde,1769,shaman,enhancement,52,30,22
Arslos,twisting-nether,1768,shaman,enhancement,32,24,8
Grende,sylvanas,1764,shaman,enhancement,66,35,31
Sígrun,aegwynn,1758,shaman,enhancement,42,28,14
Китраст,soulflayer,1756,shaman,enhancement,34,19,15
Nerfrets,malganis,1752,shaman,enhancement,60,42,18
Madmadbro,tarren-mill,1750,shaman,enhancement,60,41,19
Láynert,dun-modr,1747,shaman,enhancement,243,123,120
Echoingshock,argent-dawn,1746,shaman,enhancement,48,32,16
Vayshibro,turalyon,1741,shaman,enhancement,54,29,25
Рэггдолл,soulflayer,1739,shaman,enhancement,84,34,50
Painshock,outland,1736,shaman,enhancement,60,36,24
Wacomtablet,kazzak,1736,shaman,enhancement,36,19,17
Basz,aegwynn,1732,shaman,enhancement,37,21,16
Tobanga,malganis,1730,shaman,enhancement,48,29,19
Chêlëx,silvermoon,1730,shaman,enhancement,158,87,71
Asaakira,blackmoore,1729,shaman,enhancement,115,54,61
Spetsnazz,archimonde,1728,shaman,enhancement,132,66,66
Халльбьерн,howling-fjord,1726,shaman,enhancement,60,36,24
Masztaar,ragnaros,1719,shaman,enhancement,64,35,29
Stormbreáker,twisting-nether,1717,shaman,enhancement,132,82,50
Snëakyboom,stormscale,1717,shaman,enhancement,96,46,50
Тралси,howling-fjord,1715,shaman,enhancement,24,18,6
Turbopuddi,kazzak,1711,shaman,enhancement,65,35,30
Enhx,ravencrest,1707,shaman,enhancement,36,23,13
Joanna,frostwolf,1705,shaman,enhancement,60,28,32
Fotmburstwin,blackmoore,1704,shaman,enhancement,42,27,15
Fözk,outland,1704,shaman,enhancement,42,24,18
Pusspatrol,kazzak,1704,shaman,enhancement,48,21,27
Вудумастер,gordunni,1700,shaman,enhancement,35,20,15
Bluetide,ravencrest,1699,shaman,enhancement,45,32,13
Херургх,soulflayer,1698,shaman,enhancement,38,25,13
Monamour,twisting-nether,1698,shaman,enhancement,66,40,26
Lersham,the-maelstrom,1698,shaman,enhancement,54,32,22
Enhahaha,tarren-mill,1697,shaman,enhancement,36,23,13
Слакербэдбой,gordunni,1696,shaman,enhancement,60,26,34
Ozilie,khaz-modan,1695,shaman,enhancement,48,31,17
Veloudinos,twisting-nether,1692,shaman,enhancement,78,53,25
Azrs,ravencrest,1689,shaman,enhancement,54,29,25
Ripstorm,sylvanas,1685,shaman,enhancement,48,24,24
Tinysalmon,hyjal,1681,shaman,enhancement,30,18,12
Взалходил,soulflayer,1680,shaman,enhancement,41,21,20
Zulmalis,twisting-nether,1679,shaman,enhancement,40,23,17
Wheygodx,ravencrest,1679,shaman,enhancement,87,46,41
Madboys,kazzak,1679,shaman,enhancement,55,29,26
Moini,eredar,1674,shaman,enhancement,42,21,21
Greythunda,archimonde,1672,shaman,enhancement,36,23,13
Lurkmon,twisting-nether,1671,shaman,enhancement,100,53,47
Порнёреф,howling-fjord,1665,shaman,enhancement,111,72,39
Isucklasso,aegwynn,1664,shaman,enhancement,54,32,22
Cåmilis,archimonde,1664,shaman,enhancement,60,33,27
Neurax,sanguino,1663,shaman,enhancement,88,47,41
Recaim,outland,1663,shaman,enhancement,36,19,17
Khelyyn,tarren-mill,1662,shaman,enhancement,76,39,37
Rayoton,burning-legion,1662,shaman,enhancement,72,35,37
Nibblez,aegwynn,1659,shaman,enhancement,78,50,28
Царьбер,soulflayer,1658,shaman,enhancement,74,41,33
Nînadobrevx,stormscale,1657,shaman,enhancement,117,68,49
Faxsham,draenor,1655,shaman,enhancement,30,20,10
Tartakos,ravencrest,1652,shaman,enhancement,61,36,25
Ludwigson,tarren-mill,1652,shaman,enhancement,98,57,41
Лолимин,borean-tundra,1651,shaman,enhancement,51,33,18
Rëalg,zuljin,1648,shaman,enhancement,24,18,6
Халльбиорн,gordunni,1648,shaman,enhancement,56,25,31
Nevergroundx,perenolde,1646,shaman,enhancement,30,21,9
Sangoma,frostmane,1646,shaman,enhancement,148,66,82
Kanaky,hyjal,1644,shaman,enhancement,42,24,18
Vartarius,arthas,1644,shaman,enhancement,48,25,23
Элементи,gordunni,1642,shaman,enhancement,107,63,44
Pumanii,silvermoon,1642,shaman,enhancement,54,28,26
Энха,howling-fjord,1641,shaman,enhancement,36,21,15
Гоэл,ashenvale,1638,shaman,enhancement,30,20,10
Shambamm,stormscale,1637,shaman,enhancement,54,31,23
Hezdnalien,aegwynn,1636,shaman,enhancement,65,34,31
Tornis,terokkar,1635,shaman,enhancement,66,37,29
Patsham,wildhammer,1634,shaman,enhancement,113,67,46
Kulefesk,grim-batol,1634,shaman,enhancement,42,21,21
Elemoont,tarren-mill,1633,shaman,enhancement,42,25,17
Legitbro,ravencrest,1633,shaman,enhancement,48,22,26
Treyway,dun-modr,1628,shaman,enhancement,30,21,9
Explôsive,silvermoon,1627,shaman,enhancement,36,21,15
Johncoltrane,archimonde,1626,shaman,enhancement,54,36,18
Äijä,chromaggus,1626,shaman,enhancement,72,41,31
Ùseless,archimonde,1626,shaman,enhancement,36,20,16
Naïda,conseil-des-ombres,1625,shaman,enhancement,89,43,46
Канамаш,borean-tundra,1624,shaman,enhancement,42,27,15
Chamkalix,sanguino,1623,shaman,enhancement,72,37,35
Phobiatics,thrall,1622,shaman,enhancement,24,17,7
Shamrún,sylvanas,1622,shaman,enhancement,54,33,21
Reparagos,sanguino,1622,shaman,enhancement,47,27,20
Úpli,blackmoore,1621,shaman,enhancement,30,18,12
Gelthan,zuljin,1620,shaman,enhancement,122,63,59
Khrin,blackmoore,1618,shaman,enhancement,36,21,15
Pumpcok,durotan,1616,shaman,enhancement,30,21,9
Skullstorm,talnivarr,1613,shaman,enhancement,30,20,10
Defiaz,stormscale,1612,shaman,enhancement,46,34,12
Typhoön,sanguino,1612,shaman,enhancement,139,71,68
Ореганно,howling-fjord,1611,shaman,enhancement,72,40,32
Toxicnux,nemesis,1610,shaman,enhancement,48,28,20
Чухансмент,gordunni,1610,shaman,enhancement,63,33,30
Totemticks,aegwynn,1609,shaman,enhancement,48,25,23
Obrijames,tarren-mill,1606,shaman,enhancement,36,22,14
Ancestro,kazzak,1606,shaman,enhancement,60,32,28
Raveell,defias-brotherhood,1605,shaman,enhancement,70,34,36
Darkning,kazzak,1604,shaman,enhancement,30,19,11
Grrud,draenor,1604,shaman,enhancement,42,23,19
Sêarix,aegwynn,1603,shaman,enhancement,48,31,17
Shocktopussi,stormscale,1603,shaman,enhancement,51,32,19
Hexwife,archimonde,1602,shaman,enhancement,67,35,32
Шокмужик,gordunni,1602,shaman,enhancement,36,18,18
Moaxtyr,blackmoore,1601,shaman,enhancement,42,29,13
Tdogfx,blackhand,1601,shaman,enhancement,36,22,14
Venomos,kazzak,1601,shaman,enhancement,39,18,21
Estasham,stormscale,1600,shaman,enhancement,102,59,43
Mmsalatik,nemesis,1600,shaman,enhancement,36,19,17
Pontifhkas,ragnaros,1597,shaman,enhancement,33,22,11
Sndheal,kazzak,1596,shaman,enhancement,24,19,5
Jabaraklol,stormscale,1596,shaman,enhancement,88,54,34
Smozze,grim-batol,1592,shaman,enhancement,102,52,50
Belroc,ravencrest,1591,shaman,enhancement,36,19,17
Elèon,blackrock,1586,shaman,enhancement,71,32,39
Kammek,tarren-mill,1583,shaman,enhancement,81,48,33
Элетеми,soulflayer,1581,shaman,enhancement,60,34,26
Цс,azuregos,1579,shaman,enhancement,116,63,53
Voodooms,laughing-skull,1576,shaman,enhancement,65,40,25
Эбгерсон,soulflayer,1576,shaman,enhancement,114,62,52
Commadore,korgall,1574,shaman,enhancement,36,18,18
Ubies,silvermoon,1572,shaman,enhancement,69,38,31
Voodoohexman,kazzak,1569,shaman,enhancement,48,29,19
Шанья,gordunni,1569,shaman,enhancement,54,21,33
Azzizael,argent-dawn,1568,shaman,enhancement,90,46,44
Earthhulk,thrall,1564,shaman,enhancement,40,21,19
Автозакзак,soulflayer,1563,shaman,enhancement,35,17,18
Gandy,the-maelstrom,1562,shaman,enhancement,46,22,24
Tescriamelio,ysondre,1561,shaman,enhancement,30,19,11
Argarok,argent-dawn,1561,shaman,enhancement,30,18,12
Kosface,tarren-mill,1557,shaman,enhancement,83,44,39
Bumbummann,blackmoore,1557,shaman,enhancement,106,52,54
Иннреи,howling-fjord,1556,shaman,enhancement,63,38,25
Thalir,aegwynn,1556,shaman,enhancement,45,20,25
Ашхикиган,howling-fjord,1556,shaman,enhancement,54,19,35
Ecclîpce,archimonde,1554,shaman,enhancement,60,34,26
Chendra,scarshield-legion,1551,shaman,enhancement,107,52,55
Szublime,stormscale,1550,shaman,enhancement,48,27,21
Zayliha,ravencrest,1547,shaman,enhancement,36,20,16
Rocktopus,outland,1547,shaman,enhancement,51,27,24
Apexpredlol,blackmoore,1546,shaman,enhancement,90,42,48
Purgelord,tarren-mill,1537,shaman,enhancement,46,28,18
Mesrines,archimonde,1536,shaman,enhancement,42,22,20
Testogodx,defias-brotherhood,1535,shaman,enhancement,45,23,22
Зэбой,howling-fjord,1532,shaman,enhancement,32,21,11
Garulf,twisting-nether,1532,shaman,enhancement,42,19,23
Шампуньхан,blackscar,1532,shaman,enhancement,59,25,34
Kynaz,sanguino,1532,shaman,enhancement,69,25,44
Kutipaperi,stormscale,1530,shaman,enhancement,36,20,16
Онеоне,deathweaver,1530,shaman,enhancement,36,17,19
Paintball,kazzak,1527,shaman,enhancement,78,40,38
Blackibird,garona,1525,shaman,enhancement,57,29,28
Agathoulis,burning-legion,1524,shaman,enhancement,24,16,8
Javaburst,ragnaros,1524,shaman,enhancement,54,25,29
Маелштромс,soulflayer,1523,shaman,enhancement,30,16,14
Krovn,aszune,1521,shaman,enhancement,60,27,33
Jeki,ysondre,1519,shaman,enhancement,66,29,37
Mõrax,ysondre,1518,shaman,enhancement,79,37,42
Kilomanjaro,bloodfeather,1515,shaman,enhancement,24,16,8
Vulkân,silvermoon,1513,shaman,enhancement,66,39,27
Tarantan,eredar,1510,shaman,enhancement,61,32,29
Gøretterøg,ysondre,1507,shaman,enhancement,25,16,9
Gerethor,burning-legion,1504,shaman,enhancement,63,29,34
Skyróxx,blackrock,1502,shaman,enhancement,30,16,14
Kijin,kirin-tor,1500,shaman,enhancement,42,21,21
Dalgia,tarren-mill,1498,shaman,enhancement,30,16,14
Heeze,doomhammer,1494,shaman,enhancement,112,60,52
Sházam,destromath,1493,shaman,enhancement,24,16,8
Alethea,frostmane,1491,shaman,enhancement,66,33,33
Rakermän,dun-modr,1490,shaman,enhancement,30,17,13
Buuddha,drakthul,1490,shaman,enhancement,59,29,30
Nexdown,archimonde,1490,shaman,enhancement,57,28,29
Vascodagama,twisting-nether,1488,shaman,enhancement,42,25,17
Îzanami,ravencrest,1486,shaman,enhancement,90,49,41
Alphas,draenor,1481,shaman,enhancement,38,24,14
Shyrion,onyxia,1481,shaman,enhancement,54,24,30
Oronakgladx,ravencrest,1480,shaman,enhancement,66,33,33
Xxloon,blackrock,1477,shaman,enhancement,54,33,21
Chimp,lightnings-blade,1475,shaman,enhancement,36,21,15
Ekinoz,outland,1471,shaman,enhancement,29,16,13
Lumii,azshara,1471,shaman,enhancement,42,21,21
Enigmar,stormscale,1471,shaman,enhancement,93,43,50
Mcbloob,kazzak,1469,shaman,enhancement,81,39,42
Shamãn,draenor,1467,shaman,enhancement,42,19,23
Моктрогтар,ashenvale,1466,shaman,enhancement,36,23,13
Totemlover,draenor,1464,shaman,enhancement,82,48,34
Shockxy,norgannon,1464,shaman,enhancement,34,16,18
Justweirdaf,blackmoore,1460,shaman,enhancement,48,26,22
Nyxoqtx,draenor,1454,shaman,enhancement,24,21,3
Шторсонг,gordunni,1451,shaman,enhancement,74,48,26
Atée,silvermoon,1451,shaman,enhancement,81,37,44
Дефибо,howling-fjord,1447,shaman,enhancement,105,52,53
Барракудах,gordunni,1443,shaman,enhancement,134,59,75
Shawck,ravencrest,1441,shaman,enhancement,30,16,14
Furrymane,blackmoore,1439,shaman,enhancement,36,24,12
Arkaos,exodar,1439,shaman,enhancement,43,24,19
Perunya,tarren-mill,1438,shaman,enhancement,53,27,26
Bolgrath,blackmoore,1438,shaman,enhancement,52,24,28
Shaayys,archimonde,1438,shaman,enhancement,78,35,43
Kyshka,tarren-mill,1436,shaman,enhancement,30,15,15
Thorâ,frostmane,1435,shaman,enhancement,30,21,9
Плаглорд,howling-fjord,1433,shaman,enhancement,42,22,20
Argonautt,drakthul,1433,shaman,enhancement,114,51,63
Jondil,das-syndikat,1433,shaman,enhancement,36,16,20
Kachori,eredar,1432,shaman,enhancement,30,15,15
Царьколтрэйн,blackscar,1432,shaman,enhancement,36,16,20
Hayvaan,blackrock,1431,shaman,enhancement,78,46,32
Hulcky,grim-batol,1429,shaman,enhancement,48,24,24
Dcanne,outland,1428,shaman,enhancement,99,52,47
Yurkën,uldum,1428,shaman,enhancement,60,29,31
Tijae,ravencrest,1426,shaman,enhancement,18,15,3
Shambambum,blackrock,1426,shaman,enhancement,72,32,40
Экспатриот,greymane,1424,shaman,enhancement,42,23,19
Medistød,draenor,1422,shaman,enhancement,24,16,8
Лапища,soulflayer,1421,shaman,enhancement,60,33,27
Zuvx,ravencrest,1420,shaman,enhancement,66,38,28
Zarkab,ysondre,1419,shaman,enhancement,22,16,6
Nubokesel,ragnaros,1414,shaman,enhancement,43,22,21
Juicewillis,defias-brotherhood,1413,shaman,enhancement,36,23,13
Benderbub,blackhand,1404,shaman,enhancement,44,20,24
Kenseienh,kazzak,1402,shaman,enhancement,121,61,60
Шаманутый,soulflayer,1400,shaman,enhancement,41,17,24
Neptun,twisting-nether,1393,shaman,enhancement,107,53,54
Wolfwesti,outland,1386,shaman,enhancement,24,18,6
Rether,nemesis,1384,shaman,enhancement,53,23,30
Chämalö,archimonde,1378,shaman,enhancement,115,61,54
Shockthat,draenor,1375,shaman,enhancement,40,26,14
Sparkarse,argent-dawn,1374,shaman,enhancement,24,17,7
Tahsus,blackmoore,1372,shaman,enhancement,36,17,19
Кинговели,soulflayer,1372,shaman,enhancement,101,47,54
Cahuna,stormscale,1371,shaman,enhancement,63,24,39
Курси,gordunni,1370,shaman,enhancement,108,49,59
Panicblast,stormscale,1366,shaman,enhancement,35,15,20
Kættmæck,tarren-mill,1366,shaman,enhancement,36,15,21
Ïï,archimonde,1365,shaman,enhancement,87,40,47
Notoxus,antonidas,1364,shaman,enhancement,78,39,39
Sangvinus,outland,1364,shaman,enhancement,42,18,24
Ðezûga,antonidas,1361,shaman,enhancement,48,22,26
Mcslammer,kazzak,1360,shaman,enhancement,54,22,32
Басари,gordunni,1357,shaman,enhancement,41,20,21
Yaar,alleria,1351,shaman,enhancement,53,30,23
Hexd,defias-brotherhood,1350,shaman,enhancement,48,21,27
Nakenfeigy,stormreaver,1349,shaman,enhancement,54,32,22
Faydé,stormscale,1343,shaman,enhancement,30,14,16
Lassolasse,sylvanas,1341,shaman,enhancement,18,14,4
Дрегтан,howling-fjord,1341,shaman,enhancement,71,28,43
Stensham,stormreaver,1340,shaman,enhancement,24,14,10
Тленозавр,gordunni,1340,shaman,enhancement,51,24,27
Casualhex,argent-dawn,1340,shaman,enhancement,155,71,84
Gurtok,drakthul,1336,shaman,enhancement,36,22,14
Boidarbre,sargeras,1331,shaman,enhancement,42,15,27
Броаркар,razuvious,1326,shaman,enhancement,73,41,32
Thrâwl,kazzak,1324,shaman,enhancement,18,14,4
Атл,deathguard,1323,shaman,enhancement,38,25,13
Bourdieu,thrall,1322,shaman,enhancement,30,15,15
Kanabi,darkspear,1322,shaman,enhancement,30,14,16
Ørgus,aegwynn,1321,shaman,enhancement,179,99,80
Ошиндра,gordunni,1320,shaman,enhancement,28,15,13
Clembute,cthun,1319,shaman,enhancement,48,28,20
Палачок,eversong,1316,shaman,enhancement,36,19,17
Jasnäh,ysondre,1315,shaman,enhancement,30,14,16
Noiduttu,tarren-mill,1313,shaman,enhancement,66,41,25
Maajo,tarren-mill,1312,shaman,enhancement,42,16,26
Tyrox,kirin-tor,1310,shaman,enhancement,24,14,10
Qauter,hellfire,1305,shaman,enhancement,30,14,16
Trîkill,hyjal,1304,shaman,enhancement,54,23,31
Другалёк,howling-fjord,1299,shaman,enhancement,36,21,15
Wedís,outland,1299,shaman,enhancement,42,22,20
Lavashnikov,burning-legion,1294,shaman,enhancement,66,35,31
Sunetee,kazzak,1294,shaman,enhancement,54,23,31
Verlas,kazzak,1293,shaman,enhancement,52,26,26
Juliaroberts,ragnaros,1282,shaman,enhancement,93,46,47
Manrod,tarren-mill,1279,shaman,enhancement,66,34,32
Zandali,tarren-mill,1278,shaman,enhancement,66,38,28
Katastrofuss,stormscale,1273,shaman,enhancement,35,21,14
Shamomo,hyjal,1271,shaman,enhancement,43,17,26
Амг,booty-bay,1270,shaman,enhancement,38,20,18
Igniis,frostmane,1264,shaman,enhancement,24,16,8
Prømetheüs,sanguino,1262,shaman,enhancement,58,35,23
Shamaneo,outland,1260,shaman,enhancement,39,26,13
Simularcum,kazzak,1252,shaman,enhancement,36,18,18
Видарх,soulflayer,1247,shaman,enhancement,24,13,11
Trulylove,outland,1247,shaman,enhancement,36,13,23
Экспл,ashenvale,1245,shaman,enhancement,30,13,17
Максобман,howling-fjord,1243,shaman,enhancement,24,13,11
Stormasaurus,anachronos,1242,shaman,enhancement,22,14,8
Виндфуриа,gordunni,1242,shaman,enhancement,54,28,26
Krishun,blackmoore,1242,shaman,enhancement,30,13,17
Hichibane,archimonde,1242,shaman,enhancement,30,13,17
Kedall,archimonde,1242,shaman,enhancement,30,13,17
Nêmônin,perenolde,1241,shaman,enhancement,18,13,5
Traktorchox,draenor,1241,shaman,enhancement,24,13,11
Enoughh,the-maelstrom,1241,shaman,enhancement,24,13,11
Werdup,sunstrider,1241,shaman,enhancement,32,13,19
Ubramovitch,hyjal,1239,shaman,enhancement,24,13,11
Loshohealva,stormscale,1239,shaman,enhancement,24,13,11
Wertih,burning-legion,1236,shaman,enhancement,18,13,5
Чёкнутое,soulflayer,1236,shaman,enhancement,45,26,19
Movex,arathor,1235,shaman,enhancement,24,13,11
Видсон,soulflayer,1234,shaman,enhancement,30,14,16
Kargos,stormscale,1234,shaman,enhancement,30,13,17
Pvegame,tarren-mill,1233,shaman,enhancement,30,13,17
Жуксик,greymane,1233,shaman,enhancement,30,13,17
Convîcted,grim-batol,1230,shaman,enhancement,22,14,8
Enkzäm,archimonde,1230,shaman,enhancement,44,21,23
Stromkek,eredar,1223,shaman,enhancement,24,13,11
Mazokuu,ragnaros,1222,shaman,enhancement,75,36,39
Lokresh,azjolnerub,1220,shaman,enhancement,24,13,11
Beletili,chogall,1216,shaman,enhancement,37,15,22
Dendyre,outland,1214,shaman,enhancement,29,13,16
Shamaray,stormscale,1212,shaman,enhancement,42,22,20
Yeemayne,outland,1206,shaman,enhancement,18,13,5
Grimtøtem,defias-brotherhood,1206,shaman,enhancement,36,16,20
Шалман,thermaplugg,1203,shaman,enhancement,150,73,77
Idxbi,kazzak,1196,shaman,enhancement,36,21,15
Элетар,gordunni,1196,shaman,enhancement,42,16,26
Kuzsham,archimonde,1195,shaman,enhancement,27,13,14
Saduria,antonidas,1194,shaman,enhancement,78,44,34
Allakbarz,stormscale,1190,shaman,enhancement,94,39,55
Kunancementa,ravencrest,1189,shaman,enhancement,23,13,10
Trenhard,wildhammer,1188,shaman,enhancement,23,13,10
Волкк,soulflayer,1175,shaman,enhancement,25,14,11
Tashunka,twisting-nether,1175,shaman,enhancement,106,47,59
Yasan,kazzak,1175,shaman,enhancement,31,13,18
Crespouu,doomhammer,1174,shaman,enhancement,30,17,13
Даркгрон,thermaplugg,1153,shaman,enhancement,36,15,21
Onebutton,archimonde,1152,shaman,enhancement,18,12,6
Teknorave,dun-modr,1152,shaman,enhancement,18,12,6
Тиидишам,blackscar,1152,shaman,enhancement,18,12,6
Eclaîr,thrall,1152,shaman,enhancement,24,12,12
Китрасст,soulflayer,1152,shaman,enhancement,24,12,12
Тыпроиграл,gordunni,1152,shaman,enhancement,24,12,12
Cløke,stormscale,1151,shaman,enhancement,18,12,6
Thossa,draenor,1151,shaman,enhancement,58,31,27
Chancè,tarren-mill,1151,shaman,enhancement,24,12,12
Daybidaybi,stormscale,1151,shaman,enhancement,28,13,15
Altotem,blackmoore,1150,shaman,enhancement,18,12,6
Møldør,tarren-mill,1150,shaman,enhancement,18,12,6
Kezron,aegwynn,1150,shaman,enhancement,18,12,6
Ganachimby,zuljin,1149,shaman,enhancement,18,12,6
Litenrolixd,tarren-mill,1149,shaman,enhancement,18,12,6
Dmgaddict,kazzak,1149,shaman,enhancement,24,12,12
Barbebiendur,archimonde,1148,shaman,enhancement,24,12,12
Shamira,nethersturm,1148,shaman,enhancement,30,12,18
Porphy,kazzak,1147,shaman,enhancement,18,12,6
Famepolîce,blackrock,1147,shaman,enhancement,18,12,6
Gõðzilla,blackmoore,1145,shaman,enhancement,24,12,12
Maurrigan,rashgarroth,1142,shaman,enhancement,18,12,6
Krassus,drakthul,1141,shaman,enhancement,24,12,12
Shock,magtheridon,1140,shaman,enhancement,29,17,12
Sg,la-croisade-écarlate,1135,shaman,enhancement,37,18,19
Zzadoxor,doomhammer,1134,shaman,enhancement,24,12,12
Filigran,ragnaros,1132,shaman,enhancement,24,12,12
Arcura,twisting-nether,1127,shaman,enhancement,24,13,11
Плюжка,greymane,1127,shaman,enhancement,122,62,60
Aquæ,suramar,1125,shaman,enhancement,89,47,42
Stormrex,magtheridon,1123,shaman,enhancement,54,28,26
Precíous,sporeggar,1115,shaman,enhancement,34,19,15
Windfury,sylvanas,1113,shaman,enhancement,47,22,25
Акер,deathguard,1108,shaman,enhancement,24,14,10
Dakotasham,ravencrest,1102,shaman,enhancement,17,12,5
Быковат,booty-bay,1101,shaman,enhancement,30,12,18
Eneruswag,draenor,1098,shaman,enhancement,29,14,15
Janserey,burning-legion,1090,shaman,enhancement,30,12,18
Kringspierce,twisting-nether,1086,shaman,enhancement,55,34,21
Хмелецкий,soulflayer,1085,shaman,enhancement,30,18,12
Wargriman,kelthuzad,1081,shaman,enhancement,24,15,9
Zmech,chamber-of-aspects,1068,shaman,enhancement,25,12,13
Nurychic,twisting-nether,1060,shaman,enhancement,39,12,27
Лэнгипас,gordunni,1057,shaman,enhancement,93,41,52
Kärmá,stormscale,1056,shaman,enhancement,18,11,7
Ипа,thermaplugg,1056,shaman,enhancement,30,15,15
Kæzx,blackrock,1055,shaman,enhancement,18,11,7
Pay,stormscale,1055,shaman,enhancement,18,11,7
Kelvok,silvermoon,1055,shaman,enhancement,18,11,7
Mehex,tarren-mill,1055,shaman,enhancement,18,11,7
Shámi,gilneas,1055,shaman,enhancement,24,11,13
Trobø,ravencrest,1055,shaman,enhancement,33,12,21
Babalahziz,ysondre,1054,shaman,enhancement,12,11,1
Lavarage,kazzak,1054,shaman,enhancement,18,11,7
Kolbászlelkü,ragnaros,1054,shaman,enhancement,18,11,7
Ойрхин,greymane,1054,shaman,enhancement,24,11,13
Elémenta,turalyon,1053,shaman,enhancement,18,11,7
Тыщатристах,howling-fjord,1053,shaman,enhancement,18,11,7
Hitmeagain,blackhand,1053,shaman,enhancement,24,11,13
Palmalecki,ravencrest,1053,shaman,enhancement,30,11,19
Spacelazers,twisting-nether,1052,shaman,enhancement,19,11,8
Hopefully,eredar,1050,shaman,enhancement,18,11,7
Rorenth,blackhand,1049,shaman,enhancement,68,35,33
Дромгрон,howling-fjord,1049,shaman,enhancement,24,11,13
Erupted,draenor,1049,shaman,enhancement,30,11,19
Щцц,soulflayer,1047,shaman,enhancement,18,11,7
Frostýx,draenor,1045,shaman,enhancement,27,12,15
Shamrøck,archimonde,1042,shaman,enhancement,30,15,15
Durek,sylvanas,1040,shaman,enhancement,18,11,7
Ipbar,blackrock,1038,shaman,enhancement,18,11,7
Eliaap,antonidas,1023,shaman,enhancement,48,17,31
Литлсмурф,gordunni,1022,shaman,enhancement,30,11,19
Narevoqi,madmortem,1019,shaman,enhancement,22,13,9
Øzy,sanguino,1016,shaman,enhancement,18,12,6
Moodoo,antonidas,1016,shaman,enhancement,29,11,18
Kushme,silvermoon,1010,shaman,enhancement,72,30,42
Khamo,twisting-nether,990,shaman,enhancement,17,11,6
Biglynx,sanguino,989,shaman,enhancement,78,40,38
Burghezu,magtheridon,985,shaman,enhancement,30,15,15
Yunero,argent-dawn,975,shaman,enhancement,19,11,8
Fòóxi,ravencrest,963,shaman,enhancement,78,39,39
Worstshamy,sanguino,960,shaman,enhancement,12,10,2
Dumhuvud,stormscale,960,shaman,enhancement,12,10,2
Tätschentim,blackrock,960,shaman,enhancement,12,10,2
Getahex,ravencrest,960,shaman,enhancement,12,10,2
Robzn,blackrock,960,shaman,enhancement,12,10,2
Crysis,sanguino,960,shaman,enhancement,18,10,8
Dumbasha,ravencrest,960,shaman,enhancement,18,10,8
Matchstíck,draenor,960,shaman,enhancement,24,10,14
Mëditåtïøñ,blackrock,960,shaman,enhancement,24,10,14
Cripxo,sanguino,959,shaman,enhancement,12,10,2
Deathshamãn,stormscale,959,shaman,enhancement,18,10,8
Otacboziji,sylvanas,959,shaman,enhancement,18,10,8
Sûckmytotem,ragnaros,959,shaman,enhancement,18,10,8
Crowness,ragnaros,958,shaman,enhancement,12,10,2
Myngo,thrall,958,shaman,enhancement,18,10,8
Miriam,stormreaver,957,shaman,enhancement,18,10,8
Towi,krasus,955,shaman,enhancement,12,10,2
Tufftnamn,frostmane,955,shaman,enhancement,24,10,14
Rushfabi,aegwynn,948,shaman,enhancement,24,10,14
Wuchtzwerg,terrordar,945,shaman,enhancement,12,10,2
Krakennm,dalaran,940,shaman,enhancement,55,24,31
Чухмандос,gordunni,932,shaman,enhancement,23,11,12
Бойкийкот,gordunni,926,shaman,enhancement,24,10,14
Nethershock,blackmoore,921,shaman,enhancement,72,38,34
Izaarleus,argent-dawn,920,shaman,enhancement,23,10,13
Ryujìñjakka,culte-de-la-rive-noire,919,shaman,enhancement,24,12,12
Mimsy,hyjal,915,shaman,enhancement,47,19,28
Sardemar,defias-brotherhood,914,shaman,enhancement,24,13,11
Twotwozero,defias-brotherhood,908,shaman,enhancement,35,14,21
Cimer,sargeras,874,shaman,enhancement,65,23,42
Chronochrome,chamber-of-aspects,871,shaman,enhancement,51,23,28
Mendoz,nazjatar,869,shaman,enhancement,66,29,37
Blackyx,dun-modr,864,shaman,enhancement,12,9,3
Axilary,tarren-mill,864,shaman,enhancement,12,9,3
Roxâm,hyjal,864,shaman,enhancement,12,9,3
Мсет,soulflayer,864,shaman,enhancement,12,9,3
Shukhevych,kazzak,864,shaman,enhancement,12,9,3
Sonnestorm,tarren-mill,864,shaman,enhancement,12,9,3
Zulren,draenor,864,shaman,enhancement,12,9,3
Politemanner,stormscale,864,shaman,enhancement,18,9,9
Shambolicc,kazzak,864,shaman,enhancement,18,9,9
Chehkhan,archimonde,864,shaman,enhancement,18,9,9
Lavadelrey,drakthul,864,shaman,enhancement,18,9,9
Morkyy,thrall,863,shaman,enhancement,12,9,3
Maddogxz,frostwolf,863,shaman,enhancement,12,9,3
Itswoland,tarren-mill,863,shaman,enhancement,16,10,6
Taraesh,blackhand,863,shaman,enhancement,18,9,9
Shyne,vashj,863,shaman,enhancement,18,9,9
Zðhan,azshara,863,shaman,enhancement,18,9,9
Shockrates,pozzo-delleternità,863,shaman,enhancement,18,9,9
Faltygo,drakthul,863,shaman,enhancement,24,9,15
Sgtspyke,ragnaros,863,shaman,enhancement,24,9,15
Romacherry,aegwynn,862,shaman,enhancement,12,9,3
Tuncha,runetotem,862,shaman,enhancement,18,9,9
Puumbaa,defias-brotherhood,862,shaman,enhancement,18,9,9
Laix,khaz-modan,862,shaman,enhancement,18,9,9
Elektrikci,silvermoon,862,shaman,enhancement,18,9,9
Apekeeper,silvermoon,862,shaman,enhancement,30,9,21
Relampago,eredar,861,shaman,enhancement,18,9,9
Ягном,soulflayer,860,shaman,enhancement,24,9,15
Shockaibo,drakthul,859,shaman,enhancement,24,9,15
Bacheebg,darksorrow,858,shaman,enhancement,18,9,9
Furioous,ravencrest,857,shaman,enhancement,18,9,9
Yzeed,argent-dawn,856,shaman,enhancement,18,9,9
Humming,sanguino,851,shaman,enhancement,18,9,9
Vaesk,auchindoun,850,shaman,enhancement,18,9,9
Рэйпушка,gordunni,847,shaman,enhancement,23,9,14
Blitzviech,aegwynn,844,shaman,enhancement,17,9,8
Juniyaa,blackrock,830,shaman,enhancement,20,10,10
Zugzie,draenor,820,shaman,enhancement,30,9,21
Апинсмок,soulflayer,805,shaman,enhancement,25,10,15
Твалор,soulflayer,795,shaman,enhancement,20,9,11
Nuluadroguri,twisting-nether,793,shaman,enhancement,22,9,13
Watzocham,archimonde,782,shaman,enhancement,19,9,10
Koiru,argent-dawn,782,shaman,enhancement,19,9,10
Altarian,nemesis,768,shaman,enhancement,12,8,4
Dhedge,draenor,768,shaman,enhancement,12,8,4
Groyaboý,blackrock,768,shaman,enhancement,12,8,4
Healníx,ravencrest,768,shaman,enhancement,12,8,4
Trulor,stormscale,768,shaman,enhancement,12,8,4
Bobonbu,forscherliga,768,shaman,enhancement,12,8,4
Thunderdøme,stormscale,768,shaman,enhancement,12,8,4
Dêblâzê,thrall,768,shaman,enhancement,12,8,4
Aswøg,kazzak,768,shaman,enhancement,12,8,4
Lytningx,ravencrest,768,shaman,enhancement,12,8,4
Noboorst,stormscale,768,shaman,enhancement,12,8,4
Qätär,ravencrest,768,shaman,enhancement,12,8,4
Драгенхз,gordunni,768,shaman,enhancement,12,8,4
Cocolopez,tichondrius,768,shaman,enhancement,12,8,4
Maksimon,blackrock,768,shaman,enhancement,12,8,4
Drade,aegwynn,768,shaman,enhancement,14,8,6
Tito,stormscale,768,shaman,enhancement,18,8,10
Gnomecake,vashj,768,shaman,enhancement,18,8,10
Dóómd,kazzak,768,shaman,enhancement,18,8,10
Paschol,aegwynn,768,shaman,enhancement,18,8,10
Bmtotem,twisting-nether,768,shaman,enhancement,18,8,10
Babal,outland,768,shaman,enhancement,24,8,16
Yasaburo,silvermoon,767,shaman,enhancement,12,8,4
Wonderman,jaedenar,767,shaman,enhancement,12,8,4
Darhgan,argent-dawn,767,shaman,enhancement,12,8,4
Complete,hyjal,767,shaman,enhancement,12,8,4
Windshockah,tarren-mill,767,shaman,enhancement,12,8,4
Vforvendeta,defias-brotherhood,767,shaman,enhancement,12,8,4
Szamanito,turalyon,767,shaman,enhancement,18,8,10
Carlos,magtheridon,767,shaman,enhancement,18,8,10
Лаваяшка,gordunni,767,shaman,enhancement,18,8,10
Ордосус,gordunni,767,shaman,enhancement,18,8,10
Tschacô,malganis,767,shaman,enhancement,18,8,10
Nâs,kazzak,767,shaman,enhancement,18,8,10
Chamirox,ysondre,767,shaman,enhancement,24,8,16
Voodoodocter,kazzak,767,shaman,enhancement,29,8,21
Vrontes,kazzak,766,shaman,enhancement,18,8,10
Carusø,thrall,764,shaman,enhancement,18,8,10
Strygwyrl,doomhammer,764,shaman,enhancement,18,8,10
Рыргаск,howling-fjord,764,shaman,enhancement,18,8,10
Hectoraïus,ysondre,763,shaman,enhancement,18,8,10
Murog,dalaran,762,shaman,enhancement,12,8,4
Stubby,nagrand,759,shaman,enhancement,19,9,10
Шамблабла,soulflayer,756,shaman,enhancement,30,8,22
Fotmslave,laughing-skull,749,shaman,enhancement,15,10,5
Тотемныйчад,gordunni,731,shaman,enhancement,16,8,8
Pøllemodex,frostwhisper,719,shaman,enhancement,17,8,9
Ihealbro,blackrock,714,shaman,enhancement,16,11,5
Pospodrol,ragnaros,704,shaman,enhancement,16,8,8
Wioda,silvermoon,702,shaman,enhancement,17,8,9
Lavashock,tarren-mill,700,shaman,enhancement,28,8,20
Tiamât,culte-de-la-rive-noire,685,shaman,enhancement,19,8,11
Bärtigeberta,aegwynn,672,shaman,enhancement,10,8,2
Likê,aegwynn,672,shaman,enhancement,12,7,5
Epicenter,bloodscalp,672,shaman,enhancement,12,7,5
Caelx,ragnaros,672,shaman,enhancement,12,7,5
Eomsham,magtheridon,672,shaman,enhancement,12,7,5
Axiiom,draenor,672,shaman,enhancement,12,7,5
Funkins,hyjal,672,shaman,enhancement,12,7,5
Trixey,mazrigos,672,shaman,enhancement,12,7,5
Биттерлинкс,blackscar,672,shaman,enhancement,12,7,5
Akatuseiwah,blackrock,672,shaman,enhancement,12,7,5
Virrogs,argent-dawn,672,shaman,enhancement,12,7,5
Roineé,draenor,672,shaman,enhancement,12,7,5
Proper,tichondrius,672,shaman,enhancement,12,7,5
Relentlessqt,aegwynn,672,shaman,enhancement,12,7,5
Metalbeef,xavius,672,shaman,enhancement,12,7,5
Hermerejildo,tarren-mill,672,shaman,enhancement,12,7,5
Aspên,archimonde,672,shaman,enhancement,12,7,5
Turbostuck,ravencrest,672,shaman,enhancement,12,7,5
Hailele,argent-dawn,672,shaman,enhancement,12,7,5
Vutututututu,ragnaros,672,shaman,enhancement,12,7,5
Irmax,stormscale,672,shaman,enhancement,18,7,11
Eysns,blackrock,672,shaman,enhancement,18,7,11
Иллюминэйшн,soulflayer,672,shaman,enhancement,18,7,11
Pilcosham,frostwhisper,672,shaman,enhancement,18,7,11
Нерезшок,soulflayer,672,shaman,enhancement,18,7,11
Spajry,drakthul,671,shaman,enhancement,12,7,5
Ðexx,stormscale,671,shaman,enhancement,12,7,5
Twam,outland,671,shaman,enhancement,12,7,5
Dwarfofwar,ravencrest,671,shaman,enhancement,12,7,5
Джоннси,howling-fjord,671,shaman,enhancement,12,7,5
Birnenpfeffi,malfurion,671,shaman,enhancement,12,7,5
Dénekha,zuljin,671,shaman,enhancement,12,7,5
Kirtach,dun-modr,671,shaman,enhancement,12,7,5
Rutil,blackhand,671,shaman,enhancement,12,7,5
Sajma,silvermoon,671,shaman,enhancement,18,7,11
Enormo,eredar,671,shaman,enhancement,18,7,11
Trollomatic,das-syndikat,670,shaman,enhancement,12,7,5
Patites,twisting-nether,670,shaman,enhancement,12,7,5
Срувтапкии,deathguard,670,shaman,enhancement,12,7,5
Florgegoyd,eredar,670,shaman,enhancement,12,7,5
Elijaá,nordrassil,670,shaman,enhancement,18,7,11
Sacrx,dalaran,670,shaman,enhancement,24,7,17
Shreks,frostmane,668,shaman,enhancement,18,7,11
Viandehachee,dalaran,667,shaman,enhancement,12,7,5
Bumm,twisting-nether,665,shaman,enhancement,24,7,17
Oldstorm,ravencrest,618,shaman,enhancement,22,10,12
Esciamano,nemesis,595,shaman,enhancement,11,7,4
Ugory,die-aldor,576,shaman,enhancement,6,6,0
Shootinguard,kazzak,576,shaman,enhancement,6,6,0
Thëhêxfäçtør,tarren-mill,576,shaman,enhancement,12,6,6
Агмень,howling-fjord,576,shaman,enhancement,12,6,6
Elemefayoh,tarren-mill,576,shaman,enhancement,12,6,6
Ayame,burning-steppes,576,shaman,enhancement,12,6,6
Залатар,howling-fjord,576,shaman,enhancement,12,6,6
Kral,defias-brotherhood,576,shaman,enhancement,12,6,6
Searfang,korgall,576,shaman,enhancement,12,6,6
Nìno,azshara,576,shaman,enhancement,12,6,6
Thunderwill,sanguino,576,shaman,enhancement,12,6,6
ßaßystärz,hyjal,576,shaman,enhancement,12,6,6
Szelenamoonx,outland,576,shaman,enhancement,12,6,6
Electrical,kazzak,576,shaman,enhancement,12,6,6
Dami,die-aldor,576,shaman,enhancement,12,6,6
Purgerooni,haomarush,576,shaman,enhancement,12,6,6
Tzaish,blackmoore,576,shaman,enhancement,12,6,6
Биттерлинкс,soulflayer,576,shaman,enhancement,12,6,6
Tharma,blackmoore,576,shaman,enhancement,12,6,6
Purada,blackrock,576,shaman,enhancement,12,6,6
Pinkylol,stormscale,576,shaman,enhancement,12,6,6
Volvíc,tichondrius,576,shaman,enhancement,12,6,6
Dwarfstil,blackmoore,576,shaman,enhancement,12,6,6
Lafia,blackrock,576,shaman,enhancement,12,6,6
Юрахафанбой,blackscar,576,shaman,enhancement,12,6,6
Haasshaman,ravencrest,576,shaman,enhancement,18,6,12
Nazma,blackhand,575,shaman,enhancement,6,6,0
Finni,hyjal,575,shaman,enhancement,12,6,6
Киллдрак,howling-fjord,575,shaman,enhancement,12,6,6
Интендо,soulflayer,575,shaman,enhancement,12,6,6
Apolomaeuz,frostwolf,575,shaman,enhancement,12,6,6
Мамонтшам,howling-fjord,575,shaman,enhancement,12,6,6
Hexrated,draenor,575,shaman,enhancement,15,7,8
Mahlga,argent-dawn,574,shaman,enhancement,18,6,12
Shamsterr,karazhan,573,shaman,enhancement,12,6,6
Дядяшаман,gordunni,573,shaman,enhancement,24,6,18
Shaminista,ravencrest,571,shaman,enhancement,12,6,6
Asogg,archimonde,558,shaman,enhancement,18,6,12
Капарис,deathweaver,527,shaman,enhancement,15,6,9
Kireekoura,tarren-mill,527,shaman,enhancement,15,6,9
Whizjy,sanguino,521,shaman,enhancement,22,9,13
Ruintotems,twisting-nether,510,shaman,enhancement,11,7,4
Пойдипокури,howling-fjord,480,shaman,enhancement,6,5,1
Medoje,argent-dawn,480,shaman,enhancement,6,5,1
Evííl,tarren-mill,480,shaman,enhancement,6,5,1
Windsòng,stormscale,480,shaman,enhancement,6,5,1
Electricgødx,tarren-mill,480,shaman,enhancement,6,5,1
Nargaz,burning-legion,480,shaman,enhancement,6,5,1
Podoroschnik,blackmoore,480,shaman,enhancement,6,5,1
Wooyoungsham,sylvanas,480,shaman,enhancement,6,5,1
Ðevi,ravencrest,480,shaman,enhancement,6,5,1
Таиров,soulflayer,480,shaman,enhancement,6,5,1
Imotii,burning-legion,480,shaman,enhancement,6,5,1
Achtungblitz,blackrock,480,shaman,enhancement,6,5,1
Wúh,twisting-nether,480,shaman,enhancement,6,5,1
Velkin,thrall,480,shaman,enhancement,6,5,1
Synergizer,kazzak,480,shaman,enhancement,6,5,1
Earthquaker,the-maelstrom,480,shaman,enhancement,6,5,1
Gorogoró,kazzak,480,shaman,enhancement,6,5,1
Хрофайс,soulflayer,480,shaman,enhancement,6,5,1
Sleven,twisting-nether,480,shaman,enhancement,6,5,1
Сидог,soulflayer,480,shaman,enhancement,6,5,1
Øutfox,silvermoon,480,shaman,enhancement,6,5,1
Genrok,burning-blade,480,shaman,enhancement,6,5,1
Martini,tichondrius,480,shaman,enhancement,9,6,3
Ogmehu,stormreaver,480,shaman,enhancement,12,5,7
Jhagy,archimonde,480,shaman,enhancement,12,5,7
Neroty,blackmoore,480,shaman,enhancement,12,5,7
Lilmarco,stormreaver,480,shaman,enhancement,12,5,7
Iicks,blackrock,480,shaman,enhancement,12,5,7
Kaimountain,defias-brotherhood,480,shaman,enhancement,12,5,7
Fiden,drakthul,480,shaman,enhancement,12,5,7
Grosgourdin,la-croisade-écarlate,480,shaman,enhancement,12,5,7
Bowtenstorm,ravencrest,480,shaman,enhancement,12,5,7
Zarosh,los-errantes,480,shaman,enhancement,12,5,7
Schoølbøyq,blackrock,480,shaman,enhancement,12,5,7
Fanatroka,ravencrest,480,shaman,enhancement,12,5,7
Дротчим,soulflayer,480,shaman,enhancement,12,5,7
Batan,kazzak,480,shaman,enhancement,12,5,7
Duhdelido,ravencrest,480,shaman,enhancement,12,5,7
Shawnmendes,kazzak,480,shaman,enhancement,12,5,7
Rejrax,ravencrest,480,shaman,enhancement,12,5,7
Chàrlord,twisting-nether,480,shaman,enhancement,12,5,7
Mistahbeard,stormscale,480,shaman,enhancement,12,5,7
Shds,blackmoore,480,shaman,enhancement,12,5,7
Hiron,sylvanas,480,shaman,enhancement,12,5,7
Tonifo,nemesis,480,shaman,enhancement,12,5,7
Kabard,silvermoon,480,shaman,enhancement,12,5,7
Pank,kazzak,480,shaman,enhancement,12,5,7
Volcanò,outland,480,shaman,enhancement,12,5,7
Satanloveme,stormscale,480,shaman,enhancement,18,5,13
Târu,blackrock,480,shaman,enhancement,18,5,13
Halliane,ysondre,480,shaman,enhancement,18,5,13
Xakum,stormscale,479,shaman,enhancement,6,5,1
Durotansan,ragnaros,479,shaman,enhancement,12,5,7
Rhastasho,archimonde,479,shaman,enhancement,12,5,7
Chamrøck,hyjal,479,shaman,enhancement,12,5,7
Johnyexe,drakthul,478,shaman,enhancement,6,5,1
Kaybiel,magtheridon,478,shaman,enhancement,12,5,7
Asstroy,sanguino,477,shaman,enhancement,6,5,1
Даблпамп,howling-fjord,431,shaman,enhancement,17,5,12
Björnbritta,outland,415,shaman,enhancement,12,6,6
Hodir,bronzebeard,415,shaman,enhancement,10,5,5
Gigamuscle,ravencrest,400,shaman,enhancement,13,5,8
Чифсоса,soulflayer,384,shaman,enhancement,6,4,2
Piripolkka,defias-brotherhood,384,shaman,enhancement,6,4,2
Richtigfies,kazzak,384,shaman,enhancement,6,4,2
Cch,kazzak,384,shaman,enhancement,6,4,2
Jaydc,silvermoon,384,shaman,enhancement,6,4,2
Xalta,eldrethalas,384,shaman,enhancement,6,4,2
Фролыч,deathguard,384,shaman,enhancement,6,4,2
Jaykezap,kazzak,384,shaman,enhancement,6,4,2
Kishock,tarren-mill,384,shaman,enhancement,6,4,2
Preams,blackrock,384,shaman,enhancement,6,4,2
Buzz,stormscale,384,shaman,enhancement,6,4,2
Draugrinns,tarren-mill,384,shaman,enhancement,6,4,2
Мистерэнх,soulflayer,384,shaman,enhancement,6,4,2
Fingor,tarren-mill,384,shaman,enhancement,6,4,2
Rodneymullen,tarren-mill,384,shaman,enhancement,6,4,2
Dumpfy,silvermoon,384,shaman,enhancement,6,4,2
Россаврн,galakrond,384,shaman,enhancement,6,4,2
Lavalordd,tarren-mill,384,shaman,enhancement,6,4,2
Rèxxar,stormscale,384,shaman,enhancement,6,4,2
Sinwithin,ravencrest,384,shaman,enhancement,6,4,2
Олешао,howling-fjord,384,shaman,enhancement,6,4,2
Runè,azjolnerub,384,shaman,enhancement,6,4,2
Frrostshockk,outland,384,shaman,enhancement,6,4,2
Fyrkaz,aegwynn,384,shaman,enhancement,6,4,2
Mustabrutus,tarren-mill,384,shaman,enhancement,6,4,2
Isogrind,archimonde,384,shaman,enhancement,6,4,2
Drexx,thrall,384,shaman,enhancement,6,4,2
Шамунчез,gordunni,384,shaman,enhancement,6,4,2
Ilkim,hyjal,384,shaman,enhancement,6,4,2
Abordoga,twisting-nether,384,shaman,enhancement,6,4,2
Lilmozart,twisting-nether,384,shaman,enhancement,6,4,2
Ql,twisting-nether,384,shaman,enhancement,6,4,2
Gnubbzer,antonidas,384,shaman,enhancement,6,4,2
Baldurr,sylvanas,384,shaman,enhancement,6,4,2
Teaboï,hyjal,384,shaman,enhancement,6,4,2
Bantzer,twisting-nether,384,shaman,enhancement,6,4,2
Totems,the-venture-co,384,shaman,enhancement,6,4,2
Нийрагонго,gordunni,384,shaman,enhancement,6,4,2
Abdegor,burning-legion,384,shaman,enhancement,6,4,2
Rykarn,eredar,384,shaman,enhancement,9,5,4
Xhahal,hyjal,384,shaman,enhancement,10,4,6
Türak,tarren-mill,384,shaman,enhancement,12,4,8
Powder,tichondrius,384,shaman,enhancement,12,4,8
Votie,tarren-mill,384,shaman,enhancement,12,4,8
Brooce,sylvanas,384,shaman,enhancement,12,4,8
Courtney,sylvanas,384,shaman,enhancement,12,4,8
Chamtroulku,ysondre,384,shaman,enhancement,12,4,8
Buldozar,blackmoore,384,shaman,enhancement,12,4,8
Jaéto,ravencrest,384,shaman,enhancement,12,4,8
Бигмамуля,booty-bay,384,shaman,enhancement,12,4,8
Рокмару,soulflayer,384,shaman,enhancement,12,4,8
Дюнволкер,razuvious,384,shaman,enhancement,12,4,8
Meatballspam,stormscale,384,shaman,enhancement,12,4,8
Axemodels,archimonde,384,shaman,enhancement,12,4,8
Yelawolf,shattered-hand,384,shaman,enhancement,12,4,8
Foulecamp,archimonde,384,shaman,enhancement,12,4,8
Blixtnedslag,shattered-hand,384,shaman,enhancement,12,4,8
Johnisplay,tarren-mill,384,shaman,enhancement,12,4,8
Kiwanuká,draenor,384,shaman,enhancement,12,4,8
Waterboi,blackmoore,384,shaman,enhancement,12,4,8
Claodze,stormscale,384,shaman,enhancement,12,4,8
Corvux,tarren-mill,384,shaman,enhancement,12,4,8
Asçele,kazzak,384,shaman,enhancement,12,4,8
Derryo,silvermoon,384,shaman,enhancement,18,4,14
Domiro,ravencrest,384,shaman,enhancement,18,4,14
Bubbschock,antonidas,383,shaman,enhancement,6,4,2
Goblaman,pozzo-delleternità,383,shaman,enhancement,6,4,2
Màverìck,nemesis,383,shaman,enhancement,6,4,2
Wolkano,zuljin,383,shaman,enhancement,10,5,5
Bachetobg,darksorrow,383,shaman,enhancement,12,4,8
Châmanco,dun-modr,383,shaman,enhancement,12,4,8
Аеесо,gordunni,383,shaman,enhancement,12,4,8
Blutshock,zuluhed,382,shaman,enhancement,12,4,8
Lekthar,draenor,361,shaman,enhancement,18,6,12
Zaffyboi,draenor,352,shaman,enhancement,10,4,6
Guqin,ravencrest,352,shaman,enhancement,10,4,6
Ghostkod,burning-legion,351,shaman,enhancement,11,4,7
Hurtigtotem,ravencrest,320,shaman,enhancement,10,4,6
Nargrul,tarren-mill,319,shaman,enhancement,5,4,1
Freizeitler,antonidas,319,shaman,enhancement,5,4,1
Kemurus,kazzak,288,shaman,enhancement,6,3,3
Yerlas,burning-legion,288,shaman,enhancement,6,3,3
Ñax,silvermoon,288,shaman,enhancement,6,3,3
Рыганский,blackscar,288,shaman,enhancement,6,3,3
Depucova,silvermoon,288,shaman,enhancement,6,3,3
Jockin,tarren-mill,288,shaman,enhancement,6,3,3
Неутолимыйх,blackscar,288,shaman,enhancement,6,3,3
Håõkåh,hyjal,288,shaman,enhancement,6,3,3
Wakoteh,quelthalas,288,shaman,enhancement,6,3,3
Nëÿrën,drakthul,288,shaman,enhancement,6,3,3
Borbor,argent-dawn,288,shaman,enhancement,6,3,3
Magosh,blackmoore,288,shaman,enhancement,6,3,3
Uomae,dun-modr,288,shaman,enhancement,6,3,3
Chrisbrownx,outland,288,shaman,enhancement,6,3,3
Stormfury,balnazzar,288,shaman,enhancement,6,3,3
Totoostoy,burning-legion,288,shaman,enhancement,6,3,3
Reggard,drakthul,288,shaman,enhancement,6,3,3
Wiev,blackmoore,288,shaman,enhancement,6,3,3
Айбьорн,gordunni,288,shaman,enhancement,6,3,3
Zuziki,argent-dawn,288,shaman,enhancement,6,3,3
Lahur,blackmoore,288,shaman,enhancement,6,3,3
Sodor,laughing-skull,288,shaman,enhancement,6,3,3
Zokah,emeriss,288,shaman,enhancement,6,3,3
Tiuzzo,alakir,288,shaman,enhancement,6,3,3
Lurtax,outland,288,shaman,enhancement,6,3,3
Blazingfiré,tarren-mill,288,shaman,enhancement,6,3,3
Ccedtodeath,sylvanas,288,shaman,enhancement,6,3,3
Ñtk,dun-modr,288,shaman,enhancement,6,3,3
Monstermunch,ravencrest,288,shaman,enhancement,6,3,3
Pocahøntas,archimonde,288,shaman,enhancement,6,3,3
Getahex,draenor,288,shaman,enhancement,6,3,3
Xfiles,garona,288,shaman,enhancement,6,3,3
Millesabords,dun-morogh,288,shaman,enhancement,6,3,3
Мэлик,howling-fjord,288,shaman,enhancement,6,3,3
Lilkazamm,blackrock,288,shaman,enhancement,6,3,3
Ronctaha,blackrock,288,shaman,enhancement,6,3,3
Рэкквием,howling-fjord,288,shaman,enhancement,6,3,3
Ostbumsdirne,stormscale,288,shaman,enhancement,6,3,3
Pelicius,sanguino,288,shaman,enhancement,6,3,3
Kulho,stormscale,288,shaman,enhancement,6,3,3
Grolifer,archimonde,288,shaman,enhancement,6,3,3
Hansdieter,antonidas,288,shaman,enhancement,6,3,3
Kafese,uldaman,288,shaman,enhancement,6,3,3
Shadijr,stormscale,288,shaman,enhancement,6,3,3
Makaar,blackrock,288,shaman,enhancement,6,3,3
Xesti,twisting-nether,288,shaman,enhancement,6,3,3
Vaexi,doomhammer,288,shaman,enhancement,6,3,3
Cillysha,ravencrest,288,shaman,enhancement,6,3,3
Ashmantle,twisting-nether,288,shaman,enhancement,6,3,3
Tzivati,draenor,288,shaman,enhancement,6,3,3
Yasunari,sanguino,288,shaman,enhancement,6,3,3
Dergat,pozzo-delleternità,288,shaman,enhancement,6,3,3
Tism,stormscale,288,shaman,enhancement,7,3,4
Æskalatiøn,aegwynn,288,shaman,enhancement,12,3,9
Teldathree,archimonde,288,shaman,enhancement,12,3,9
Garash,draenor,288,shaman,enhancement,12,3,9
Lorthargol,chamber-of-aspects,288,shaman,enhancement,12,3,9
Maybeyes,twisting-nether,288,shaman,enhancement,12,3,9
Veteroth,argent-dawn,288,shaman,enhancement,12,3,9
Brunütansol,sylvanas,288,shaman,enhancement,12,3,9
Dastarus,archimonde,288,shaman,enhancement,12,3,9
Georgewhat,defias-brotherhood,288,shaman,enhancement,12,3,9
Avattar,twisting-nether,288,shaman,enhancement,12,3,9
Hurbi,twisting-nether,288,shaman,enhancement,12,3,9
Shambamty,thrall,288,shaman,enhancement,12,3,9
Kappatotem,silvermoon,288,shaman,enhancement,12,3,9
Занги,soulflayer,288,shaman,enhancement,12,3,9
Jorny,burning-legion,288,shaman,enhancement,12,3,9
Rhakhatheckh,nemesis,288,shaman,enhancement,12,3,9
Лорикок,grom,288,shaman,enhancement,18,3,15
Slappybag,ravencrest,287,shaman,enhancement,6,3,3
Грейсаша,howling-fjord,287,shaman,enhancement,6,3,3
Gibspark,twisting-nether,287,shaman,enhancement,6,3,3
Korzo,amanthul,287,shaman,enhancement,6,3,3
Nothìnto,pozzo-delleternità,287,shaman,enhancement,6,3,3
Trotzig,aegwynn,287,shaman,enhancement,6,3,3
Deeblu,nemesis,287,shaman,enhancement,6,3,3
Biphrost,nemesis,287,shaman,enhancement,6,3,3
Laghärta,dun-modr,286,shaman,enhancement,6,3,3
Madbud,stormscale,271,shaman,enhancement,11,3,8
Jehae,archimonde,239,shaman,enhancement,5,3,2
Ивми,gordunni,239,shaman,enhancement,5,3,2
Teyshtwö,archimonde,234,shaman,enhancement,8,4,4
Nefasti,stormscale,223,shaman,enhancement,8,3,5
Mooshock,balnazzar,223,shaman,enhancement,8,3,5
Guzguzguz,blackhand,223,shaman,enhancement,8,3,5
Elektekk,blackrock,192,shaman,enhancement,4,3,1
Zerodown,outland,192,shaman,enhancement,6,2,4
Амфеминка,gordunni,192,shaman,enhancement,6,2,4
Ostosmvp,ravencrest,192,shaman,enhancement,6,2,4
Ishokyou,thrall,192,shaman,enhancement,6,2,4
Kuubskii,ravencrest,192,shaman,enhancement,6,2,4
Dalgorr,magtheridon,192,shaman,enhancement,6,2,4
Kohzen,outland,192,shaman,enhancement,6,2,4
Shrektar,outland,192,shaman,enhancement,6,2,4
Barneyflight,ravencrest,192,shaman,enhancement,6,2,4
Tornadozzer,burning-legion,192,shaman,enhancement,6,2,4
Azzizael,chamber-of-aspects,192,shaman,enhancement,6,2,4
Xharnel,defias-brotherhood,192,shaman,enhancement,6,2,4
Реалайзер,blackscar,192,shaman,enhancement,6,2,4
Kassyoh,hyjal,192,shaman,enhancement,6,2,4
Turbinká,burning-legion,192,shaman,enhancement,6,2,4
Dwarfovic,ravencrest,192,shaman,enhancement,6,2,4
Родохрозид,blackscar,192,shaman,enhancement,6,2,4
Hightotem,sanguino,192,shaman,enhancement,6,2,4
Delgagalduos,kazzak,192,shaman,enhancement,6,2,4
Stiflersmôm,antonidas,192,shaman,enhancement,6,2,4
Тенав,blackscar,192,shaman,enhancement,6,2,4
Madzÿ,archimonde,192,shaman,enhancement,6,2,4
Lovros,kazzak,192,shaman,enhancement,6,2,4
Bram,aggra-português,192,shaman,enhancement,6,2,4
Restmuell,blackmoore,192,shaman,enhancement,6,2,4
Thralgr,sylvanas,192,shaman,enhancement,6,2,4
Bonethugdex,bladefist,192,shaman,enhancement,6,2,4
Nìtratx,archimonde,192,shaman,enhancement,6,2,4
Louvreparis,frostwolf,192,shaman,enhancement,6,2,4
Elsassi,ravencrest,192,shaman,enhancement,6,2,4
Pakasschami,frostwolf,192,shaman,enhancement,6,2,4
Swoltz,argent-dawn,192,shaman,enhancement,6,2,4
Gundsthunder,ravencrest,192,shaman,enhancement,6,2,4
Rodfrugten,draenor,192,shaman,enhancement,6,2,4
Skullføck,argent-dawn,192,shaman,enhancement,6,2,4
Саксаул,fordragon,192,shaman,enhancement,6,2,4
Elé,ravenholdt,192,shaman,enhancement,6,2,4
Eshami,tarren-mill,192,shaman,enhancement,6,2,4
Lokkrag,archimonde,192,shaman,enhancement,6,2,4
Sgf,stormscale,192,shaman,enhancement,6,2,4
Snapbábe,blackmoore,192,shaman,enhancement,6,2,4
Spiritualx,argent-dawn,192,shaman,enhancement,6,2,4
Layonne,ysondre,192,shaman,enhancement,6,2,4
Cuchullaín,blackmoore,192,shaman,enhancement,6,2,4
Elementhor,archimonde,192,shaman,enhancement,6,2,4
Schamikraut,silvermoon,192,shaman,enhancement,6,2,4
Kwitnac,silvermoon,192,shaman,enhancement,6,2,4
Thunderstørm,chogall,192,shaman,enhancement,6,2,4
Bennycooch,silvermoon,192,shaman,enhancement,6,2,4
Dogfrog,silvermoon,192,shaman,enhancement,6,2,4
Yezu,medivh,192,shaman,enhancement,6,2,4
Какашисан,howling-fjord,192,shaman,enhancement,6,2,4
Acces,stormscale,192,shaman,enhancement,6,2,4
Bábbajaggí,blackrock,192,shaman,enhancement,6,2,4
Destroilleur,archimonde,192,shaman,enhancement,6,2,4
Pulvêrizêr,agamaggan,192,shaman,enhancement,6,2,4
Tordenlars,ragnaros,192,shaman,enhancement,6,2,4
Shamalamadi,ragnaros,192,shaman,enhancement,6,2,4
Urshak,alleria,192,shaman,enhancement,6,2,4
Savan,darkspear,192,shaman,enhancement,6,2,4
Diya,karazhan,192,shaman,enhancement,6,2,4
Søló,stormscale,192,shaman,enhancement,6,2,4
Aubesombre,dalaran,192,shaman,enhancement,6,2,4
Bladeyx,ragnaros,192,shaman,enhancement,6,2,4
Cheetooth,ragnaros,192,shaman,enhancement,6,2,4
Fufupartyxx,blackrock,192,shaman,enhancement,6,2,4
Palarins,dalaran,192,shaman,enhancement,6,2,4
Borindor,silvermoon,192,shaman,enhancement,12,2,10
Stratholmee,drakthul,192,shaman,enhancement,12,2,10
Скерлайн,blackscar,192,shaman,enhancement,12,2,10
Isladinks,draenor,192,shaman,enhancement,12,2,10
Lavalew,lightbringer,192,shaman,enhancement,12,2,10
Blutschrei,tarren-mill,192,shaman,enhancement,12,2,10
Shamaniak,tarren-mill,192,shaman,enhancement,12,2,10
Blautorkel,amanthul,159,shaman,enhancement,5,2,3
Tookaageeroo,burning-legion,159,shaman,enhancement,8,3,5
Tianoele,drakthul,144,shaman,enhancement,3,3,0
Bux,khaz-modan,127,shaman,enhancement,4,2,2
Holten,outland,96,shaman,enhancement,6,1,5
Sinkero,hellscream,96,shaman,enhancement,6,1,5
Shøckz,azjolnerub,96,shaman,enhancement,6,1,5
Hyamala,chamber-of-aspects,96,shaman,enhancement,6,1,5
Casarú,arthas,96,shaman,enhancement,6,1,5
Cryptotem,ragnaros,96,shaman,enhancement,6,1,5
Hazles,ragnaros,96,shaman,enhancement,6,1,5
Weaslêy,frostwolf,96,shaman,enhancement,6,1,5
Urubus,kazzak,96,shaman,enhancement,6,1,5
Sparkygødx,twisting-nether,96,shaman,enhancement,6,1,5
Zoogang,ragnaros,96,shaman,enhancement,6,1,5
Sïlvek,sanguino,96,shaman,enhancement,6,1,5
Thoranis,kazzak,96,shaman,enhancement,6,1,5
Purgey,ravencrest,96,shaman,enhancement,6,1,5
Réläx,kazzak,96,shaman,enhancement,6,1,5
Naahma,hyjal,96,shaman,enhancement,6,1,5
Preshear,twisting-nether,96,shaman,enhancement,6,1,5
Mikecrybaby,tarren-mill,96,shaman,enhancement,6,1,5
Maskinett,stormscale,96,shaman,enhancement,6,1,5
Шабыч,deathguard,96,shaman,enhancement,6,1,5
Guzz,cthun,96,shaman,enhancement,6,1,5
Agrok,jaedenar,96,shaman,enhancement,6,1,5
Heálmaster,sanguino,96,shaman,enhancement,6,1,5
Goldhand,ravencrest,96,shaman,enhancement,6,1,5
Grabmytotemz,tarren-mill,96,shaman,enhancement,6,1,5
Élémentyum,archimonde,96,shaman,enhancement,6,1,5
Lawdjeezes,draenor,96,shaman,enhancement,6,1,5
Nnele,sanguino,96,shaman,enhancement,6,1,5
Eneel,blackmoore,96,shaman,enhancement,6,1,5
Bambustic,kazzak,96,shaman,enhancement,6,1,5
Ghaargrim,tarren-mill,96,shaman,enhancement,6,1,5
Vladraxes,draenor,96,shaman,enhancement,6,1,5
Freexx,aegwynn,96,shaman,enhancement,8,1,7
Awsomo,ravencrest,96,shaman,enhancement,12,1,11
Ymiras,argent-dawn,96,shaman,enhancement,12,1,11
Dökowski,nemesis,96,shaman,enhancement,12,1,11
Gälädhan,ysondre,95,shaman,enhancement,6,1,5
Choltaj,burning-legion,79,shaman,enhancement,7,1,6
Wenesday,ysondre,48,shaman,enhancement,3,1,2
Rký,outland,48,shaman,enhancement,3,1,2
Lesnitt,kazzak,42,shaman,enhancement,9,2,7
Arabesk,arygos,31,shaman,enhancement,2,1,1
Hanumanas,kazzak,31,shaman,enhancement,2,1,1
Nalàar,hyjal,16,shaman,enhancement,1,1,0
Млечный,blackscar,2216,warlock,demonology,125,73,52
Rikkërt,draenor,2207,warlock,demonology,89,49,40
Dotjürgen,blackrock,2205,warlock,demonology,84,48,36
Nayolana,argent-dawn,2187,warlock,demonology,66,46,20
Pogbõss,kazzak,2170,warlock,demonology,81,45,36
Tuskawl,stormreaver,2154,warlock,demonology,91,51,40
Kimkold,twisting-nether,2146,warlock,demonology,102,61,41
Firochektro,ravencrest,2141,warlock,demonology,69,42,27
Sad,lightnings-blade,2134,warlock,demonology,178,97,81
Lankycheese,kazzak,2121,warlock,demonology,83,46,37
Syntaxzwo,blackmoore,2116,warlock,demonology,78,44,34
Dotyboi,tarren-mill,2115,warlock,demonology,72,44,28
Rumour,sunstrider,2115,warlock,demonology,72,39,33
Supergeîl,blackrock,2112,warlock,demonology,71,38,33
Britneÿ,stormscale,2101,warlock,demonology,66,40,26
Cørpse,burning-legion,2083,warlock,demonology,85,49,36
Anthh,doomhammer,2076,warlock,demonology,66,36,30
Whøknøws,twisting-nether,2070,warlock,demonology,72,37,35
Locktrainer,tarren-mill,2053,warlock,demonology,122,59,63
Maintarget,blackrock,2041,warlock,demonology,135,70,65
Zerulian,ragnaros,2035,warlock,demonology,78,48,30
Shablagoo,twisting-nether,2032,warlock,demonology,90,51,39
Хаосболик,gordunni,2012,warlock,demonology,72,39,33
Bibiflexberg,eredar,2011,warlock,demonology,47,30,17
Britneý,stormscale,2008,warlock,demonology,118,58,60
Apple,scarshield-legion,1991,warlock,demonology,115,62,53
Jimboneutron,stormscale,1988,warlock,demonology,35,23,12
Аоепампгодх,howling-fjord,1967,warlock,demonology,36,24,12
Конидэмико,blackscar,1954,warlock,demonology,83,38,45
Capsloq,la-croisade-écarlate,1950,warlock,demonology,60,34,26
Purplemonkey,burning-blade,1946,warlock,demonology,41,25,16
Онлидемон,gordunni,1946,warlock,demonology,56,33,23
Badapow,stormscale,1943,warlock,demonology,48,27,21
Nyotu,antonidas,1937,warlock,demonology,60,32,28
Onlylock,outland,1934,warlock,demonology,48,32,16
Døwz,ysondre,1932,warlock,demonology,60,30,30
Khavar,antonidas,1931,warlock,demonology,36,23,13
Lokmonji,perenolde,1923,warlock,demonology,60,34,26
Амеаль,eversong,1920,warlock,demonology,216,108,108
Дёмын,howling-fjord,1919,warlock,demonology,78,38,40
Juicybolt,chogall,1917,warlock,demonology,70,40,30
Kamorilock,blackhand,1912,warlock,demonology,36,20,16
Demoner,tarren-mill,1910,warlock,demonology,108,52,56
Shadowvirus,auchindoun,1904,warlock,demonology,35,21,14
Dabezdwl,outland,1904,warlock,demonology,54,31,23
Anúki,kazzak,1900,warlock,demonology,25,21,4
Ravendoor,grim-batol,1900,warlock,demonology,76,39,37
Bonnieparkêr,onyxia,1898,warlock,demonology,48,26,22
Alotami,frostwolf,1889,warlock,demonology,42,27,15
Xenastro,silvermoon,1882,warlock,demonology,36,20,16
Stafar,kazzak,1875,warlock,demonology,60,33,27
Höfmänn,kazzak,1865,warlock,demonology,39,25,14
Адво,howling-fjord,1863,warlock,demonology,53,28,25
Tyrantlol,sylvanas,1862,warlock,demonology,54,32,22
Bluh,twisting-nether,1860,warlock,demonology,36,22,14
Оброссыш,gordunni,1855,warlock,demonology,60,34,26
Dhärc,sanguino,1854,warlock,demonology,54,31,23
Fearrari,ragnaros,1853,warlock,demonology,54,32,22
Smaúg,archimonde,1851,warlock,demonology,60,28,32
Stalowwy,silvermoon,1849,warlock,demonology,108,59,49
Кварий,howling-fjord,1848,warlock,demonology,227,114,113
Höfmänn,grim-batol,1847,warlock,demonology,48,31,17
Shakuroz,frostwolf,1847,warlock,demonology,68,41,27
Динодотз,howling-fjord,1847,warlock,demonology,54,27,27
Vultzbolt,draenor,1840,warlock,demonology,60,31,29
Désolaté,kazzak,1839,warlock,demonology,41,26,15
Attritiona,stormscale,1838,warlock,demonology,60,32,28
Инфезиус,deathweaver,1834,warlock,demonology,59,33,26
Outofcurses,earthen-ring,1834,warlock,demonology,83,42,41
Neinbosa,tarren-mill,1829,warlock,demonology,42,24,18
Zouglougou,archimonde,1829,warlock,demonology,48,25,23
Тьмазвёздная,gordunni,1828,warlock,demonology,45,26,19
Benne,stormscale,1825,warlock,demonology,49,31,18
Dispeluapls,blackmoore,1824,warlock,demonology,48,26,22
Malificus,silvermoon,1823,warlock,demonology,114,67,47
Cellfear,kazzak,1818,warlock,demonology,42,24,18
Musallat,argent-dawn,1818,warlock,demonology,65,34,31
Stankaemayne,blackhand,1817,warlock,demonology,49,29,20
Hellguards,silvermoon,1817,warlock,demonology,60,33,27
Crathar,kazzak,1816,warlock,demonology,76,38,38
Bualock,tarren-mill,1815,warlock,demonology,36,22,14
Devilfluffy,blackhand,1815,warlock,demonology,59,35,24
Cigänä,archimonde,1815,warlock,demonology,36,19,17
Blackdog,argent-dawn,1814,warlock,demonology,48,23,25
Kopfkissen,azshara,1810,warlock,demonology,51,29,22
Smâûhg,blackrock,1807,warlock,demonology,42,28,14
Lúcìfér,stormscale,1806,warlock,demonology,66,34,32
Nemwl,draenor,1804,warlock,demonology,66,36,30
Splicer,eredar,1803,warlock,demonology,49,29,20
Киёкка,howling-fjord,1803,warlock,demonology,90,53,37
Htaedfo,tarren-mill,1802,warlock,demonology,74,32,42
Мутгодх,soulflayer,1800,warlock,demonology,30,19,11
Санявахтовик,blackscar,1800,warlock,demonology,60,32,28
Dontargetme,draenor,1794,warlock,demonology,36,24,12
Dâedra,argent-dawn,1793,warlock,demonology,54,31,23
Ffpiiras,dunemaul,1790,warlock,demonology,60,27,33
Malzeva,ravencrest,1784,warlock,demonology,65,29,36
Fiveyearque,sylvanas,1773,warlock,demonology,48,30,18
Годнодх,gordunni,1773,warlock,demonology,36,21,15
Ambitions,hyjal,1771,warlock,demonology,46,26,20
Tjockoloco,tarren-mill,1752,warlock,demonology,110,64,46
Catchlock,tarren-mill,1752,warlock,demonology,36,20,16
Dæhli,argent-dawn,1744,warlock,demonology,36,22,14
Lïñglïñg,twisting-nether,1730,warlock,demonology,30,22,8
Fandirxd,draenor,1730,warlock,demonology,72,35,37
Adafbhf,tichondrius,1723,warlock,demonology,41,22,19
Храбзар,gordunni,1721,warlock,demonology,112,51,61
Тёмабиль,gordunni,1717,warlock,demonology,170,88,82
Zelieknight,ysondre,1711,warlock,demonology,60,28,32
Firochek,ravencrest,1710,warlock,demonology,42,24,18
Císuh,stormreaver,1706,warlock,demonology,30,18,12
Шекигами,gordunni,1701,warlock,demonology,36,24,12
Glavy,burning-legion,1699,warlock,demonology,66,36,30
Drerlord,tarren-mill,1699,warlock,demonology,48,21,27
Totephia,kazzak,1696,warlock,demonology,72,33,39
Rune,aegwynn,1695,warlock,demonology,52,29,23
Mendozaah,kazzak,1692,warlock,demonology,74,37,37
Synlockiax,silvermoon,1691,warlock,demonology,38,30,8
Jinusek,burning-legion,1682,warlock,demonology,43,23,20
Grêenbull,eredar,1680,warlock,demonology,49,27,22
Жериновсский,gordunni,1677,warlock,demonology,36,18,18
Dalamon,draenor,1672,warlock,demonology,42,21,21
Alphalock,mannoroth,1669,warlock,demonology,45,22,23
Osbaa,bladefist,1668,warlock,demonology,42,22,20
Shadowflamez,argent-dawn,1664,warlock,demonology,24,22,2
Impaler,tarren-mill,1664,warlock,demonology,188,91,97
Зажиженный,soulflayer,1656,warlock,demonology,34,22,12
Kemel,thrall,1655,warlock,demonology,30,21,9
Niyyu,blackmoore,1654,warlock,demonology,48,22,26
Shugglock,draenor,1653,warlock,demonology,42,23,19
Djshyasiañ,perenolde,1650,warlock,demonology,170,88,82
Chromagnus,drakthul,1649,warlock,demonology,30,21,9
Louên,dun-modr,1648,warlock,demonology,42,21,21
Utsus,tarren-mill,1645,warlock,demonology,36,23,13
Fîgøk,conseil-des-ombres,1638,warlock,demonology,48,21,27
Snackstickz,twisting-nether,1637,warlock,demonology,42,26,16
Tiffyilock,blackrock,1637,warlock,demonology,42,20,22
Ájszmen,ravencrest,1629,warlock,demonology,54,30,24
Dimmybyrger,stormreaver,1627,warlock,demonology,30,17,13
Abdelkarime,khaz-modan,1627,warlock,demonology,42,23,19
Summonit,blackmoore,1627,warlock,demonology,54,29,25
Interceptêr,blackrock,1627,warlock,demonology,42,22,20
Егосяхаос,soulflayer,1627,warlock,demonology,120,61,59
Neuth,draenor,1627,warlock,demonology,50,21,29
Indrâxx,hyjal,1626,warlock,demonology,18,17,1
Malowix,outland,1625,warlock,demonology,36,17,19
Dasda,defias-brotherhood,1623,warlock,demonology,89,49,40
Мешшугга,howling-fjord,1623,warlock,demonology,38,20,18
Dualla,aegwynn,1623,warlock,demonology,36,17,19
Элси,howling-fjord,1622,warlock,demonology,30,17,13
Ägony,blackrock,1621,warlock,demonology,36,20,16
Darcîa,destromath,1619,warlock,demonology,96,53,43
Itspoint,draenor,1618,warlock,demonology,53,29,24
Sanguinis,theradras,1612,warlock,demonology,36,18,18
Eroszakolock,ragnaros,1611,warlock,demonology,24,17,7
Kody,blackmoore,1609,warlock,demonology,24,17,7
Shuggul,draenor,1606,warlock,demonology,37,22,15
Demonjoker,blackhand,1604,warlock,demonology,51,31,20
Havexis,tichondrius,1602,warlock,demonology,42,32,10
Despépêche,garona,1601,warlock,demonology,30,19,11
Gemors,ravenholdt,1599,warlock,demonology,72,38,34
Moffguldan,sanguino,1597,warlock,demonology,30,20,10
Nerzhull,stormscale,1596,warlock,demonology,81,43,38
Eleriya,argent-dawn,1596,warlock,demonology,69,33,36
Tekron,blackhand,1594,warlock,demonology,36,25,11
Auxi,the-maelstrom,1593,warlock,demonology,42,26,16
Proßlock,kazzak,1582,warlock,demonology,39,24,15
Potatowl,ravencrest,1582,warlock,demonology,36,18,18
Мамхаус,howling-fjord,1579,warlock,demonology,36,22,14
Míkæ,ravencrest,1579,warlock,demonology,36,17,19
Гулдарий,howling-fjord,1577,warlock,demonology,159,90,69
Erøne,archimonde,1565,warlock,demonology,166,85,81
Silenozz,ragnaros,1564,warlock,demonology,91,49,42
Sïlïthuss,ravencrest,1563,warlock,demonology,78,43,35
Импака,howling-fjord,1563,warlock,demonology,174,90,84
Altffeer,blackmoore,1561,warlock,demonology,41,25,16
Dotsyoudown,kelthuzad,1560,warlock,demonology,36,18,18
Hellbboy,azjolnerub,1557,warlock,demonology,45,26,19
Seriasa,blackmoore,1553,warlock,demonology,60,25,35
Бельведерчи,blackscar,1550,warlock,demonology,48,29,19
Morgan,jaedenar,1548,warlock,demonology,60,27,33
Hâres,anetheron,1539,warlock,demonology,122,56,66
Solitariøus,arathi,1536,warlock,demonology,54,27,27
Ahollic,frostwolf,1535,warlock,demonology,24,16,8
Synthiax,silvermoon,1534,warlock,demonology,24,16,8
Fsandtwo,ravencrest,1534,warlock,demonology,30,16,14
Felburrn,twisting-nether,1532,warlock,demonology,53,27,26
Malganas,sylvanas,1530,warlock,demonology,42,20,22
Tonin,antonidas,1528,warlock,demonology,41,25,16
Ayóó,doomhammer,1522,warlock,demonology,190,99,91
Deamonsmith,silvermoon,1518,warlock,demonology,36,20,16
Sedryn,turalyon,1518,warlock,demonology,381,195,186
Roedin,tarren-mill,1507,warlock,demonology,90,33,57
Priszcilla,twisting-nether,1505,warlock,demonology,66,40,26
Нэкрил,howling-fjord,1497,warlock,demonology,27,16,11
Гурджес,soulflayer,1489,warlock,demonology,23,16,7
Dabulock,blackmoore,1487,warlock,demonology,33,17,16
Эволюционист,gordunni,1483,warlock,demonology,42,22,20
Favorizlmp,archimonde,1480,warlock,demonology,36,17,19
Паникс,gordunni,1480,warlock,demonology,36,17,19
Иллугис,gordunni,1468,warlock,demonology,36,17,19
Dominvs,silvermoon,1465,warlock,demonology,64,36,28
Panic,stormrage,1456,warlock,demonology,84,47,37
Шэдоубёрн,soulflayer,1449,warlock,demonology,48,27,21
Ilarizium,ysondre,1449,warlock,demonology,53,29,24
Kalinowa,burning-legion,1449,warlock,demonology,65,34,31
Esgül,draenor,1446,warlock,demonology,71,38,33
Нгага,howling-fjord,1443,warlock,demonology,227,111,116
Zypzanti,antonidas,1441,warlock,demonology,24,18,6
Mustasheen,stormscale,1439,warlock,demonology,24,15,9
Jesez,aegwynn,1436,warlock,demonology,24,15,9
Nerigo,senjin,1435,warlock,demonology,30,15,15
Weso,grim-batol,1435,warlock,demonology,30,15,15
Absúrd,turalyon,1434,warlock,demonology,156,89,67
Requeims,outland,1434,warlock,demonology,30,15,15
Sineko,twisting-nether,1432,warlock,demonology,112,54,58
Kaamosliha,frostwhisper,1426,warlock,demonology,53,23,30
Corbiejr,tarren-mill,1425,warlock,demonology,70,29,41
Джердхаус,fordragon,1419,warlock,demonology,30,15,15
Épidémie,outland,1419,warlock,demonology,47,18,29
Tsumde,dalaran,1415,warlock,demonology,54,26,28
Lottopallo,arathor,1410,warlock,demonology,44,29,15
Sevastus,argent-dawn,1409,warlock,demonology,78,40,38
Tudii,frostwolf,1401,warlock,demonology,54,32,22
Nimh,azjolnerub,1393,warlock,demonology,33,20,13
Bakýra,dun-modr,1389,warlock,demonology,42,26,16
Помечте,soulflayer,1379,warlock,demonology,40,16,24
Wítchær,blackhand,1370,warlock,demonology,48,28,20
Ädarä,cthun,1370,warlock,demonology,36,18,18
Môrgán,draenor,1364,warlock,demonology,53,18,35
Cahoa,archimonde,1349,warlock,demonology,24,15,9
Olsel,draenor,1349,warlock,demonology,36,16,20
Gulldan,bloodfeather,1342,warlock,demonology,48,25,23
Warth,silvermoon,1339,warlock,demonology,18,14,4
Evilbuba,burning-legion,1337,warlock,demonology,36,19,17
Nécron,ysondre,1337,warlock,demonology,30,14,16
Tomlingen,terenas,1335,warlock,demonology,42,22,20
Rpez,archimonde,1335,warlock,demonology,136,69,67
Mesîkatayut,outland,1332,warlock,demonology,63,36,27
Фортэр,ashenvale,1332,warlock,demonology,30,14,16
Stormytrumpy,twisting-nether,1331,warlock,demonology,27,15,12
Dedalus,zuluhed,1330,warlock,demonology,100,59,41
Xanatas,nemesis,1328,warlock,demonology,24,14,10
Kolskegg,doomhammer,1325,warlock,demonology,36,14,22
Stormblast,azshara,1321,warlock,demonology,30,19,11
Wåfa,kazzak,1318,warlock,demonology,30,17,13
Forthewin,stormreaver,1313,warlock,demonology,30,15,15
Расмурът,soulflayer,1308,warlock,demonology,36,18,18
Erkai,kazzak,1286,warlock,demonology,27,15,12
Jondi,blackmoore,1274,warlock,demonology,25,15,10
Инсип,blackscar,1256,warlock,demonology,42,18,24
Trellaras,bloodfeather,1249,warlock,demonology,29,14,15
Cmzdalock,ravencrest,1245,warlock,demonology,24,16,8
Бриант,gordunni,1245,warlock,demonology,35,14,21
Greeylock,blackhand,1243,warlock,demonology,24,13,11
Vêzor,twisting-nether,1242,warlock,demonology,24,13,11
Стокыч,soulflayer,1241,warlock,demonology,36,13,23
Чутьчутьзлая,gordunni,1237,warlock,demonology,24,13,11
Indiasummerx,turalyon,1232,warlock,demonology,24,13,11
Ruinovino,outland,1229,warlock,demonology,30,13,17
Eatherial,twilights-hammer,1228,warlock,demonology,24,15,9
Valadair,sanguino,1220,warlock,demonology,62,32,30
Netcownt,silvermoon,1199,warlock,demonology,31,15,16
Vorgoth,argent-dawn,1179,warlock,demonology,28,13,15
Waltrude,conseil-des-ombres,1170,warlock,demonology,42,13,29
Zehirisalari,twisting-nether,1152,warlock,demonology,18,12,6
Krøl,nemesis,1152,warlock,demonology,18,12,6
Scallington,shattered-hand,1152,warlock,demonology,18,12,6
Bloodlock,onyxia,1152,warlock,demonology,24,12,12
Benvyx,twisting-nether,1152,warlock,demonology,24,12,12
Инфес,deathweaver,1151,warlock,demonology,18,12,6
Fedpikkefar,kazzak,1151,warlock,demonology,24,12,12
Nargøf,outland,1151,warlock,demonology,24,12,12
Desolador,tyrande,1148,warlock,demonology,30,12,18
Gulzot,turalyon,1143,warlock,demonology,18,12,6
Арон,soulflayer,1119,warlock,demonology,23,12,11
Golborg,draenor,1117,warlock,demonology,34,12,22
Razzguul,blackmoore,1112,warlock,demonology,22,12,10
Sabiocalvo,dun-modr,1110,warlock,demonology,24,13,11
Tripleshache,elune,1101,warlock,demonology,66,33,33
Ишла,gordunni,1086,warlock,demonology,29,12,17
Bicuriousdad,tarren-mill,1056,warlock,demonology,12,11,1
Dotosgyörgy,ragnaros,1056,warlock,demonology,18,11,7
Glooness,burning-legion,1056,warlock,demonology,18,11,7
Adellara,draenor,1056,warlock,demonology,18,11,7
Ðïÿëñbïëñfüû,suramar,1056,warlock,demonology,27,12,15
Tamatóax,tarren-mill,1055,warlock,demonology,12,11,1
Kennÿfõx,ysondre,1055,warlock,demonology,12,11,1
Tìdùs,nethersturm,1054,warlock,demonology,12,11,1
Dàrksoul,thrall,1054,warlock,demonology,18,11,7
Froschhaxen,blackhand,1054,warlock,demonology,18,11,7
Algolagniac,stormscale,1054,warlock,demonology,18,11,7
Katâra,tarren-mill,1054,warlock,demonology,24,11,13
Зарлог,soulflayer,1051,warlock,demonology,24,11,13
Емс,gordunni,1051,warlock,demonology,24,11,13
Zanzarismo,nemesis,1049,warlock,demonology,21,12,9
Ambralia,blackmoore,1048,warlock,demonology,24,12,12
Srhal,blackmoore,1043,warlock,demonology,22,12,10
Remthorn,frostmane,1022,warlock,demonology,36,19,17
Flocca,archimonde,990,warlock,demonology,20,11,9
Aldhelm,draenor,980,warlock,demonology,22,11,11
Yamadea,stormscale,960,warlock,demonology,18,10,8
Демоник,deathguard,960,warlock,demonology,18,10,8
Lonelock,blackrock,960,warlock,demonology,18,10,8
Oggelock,tarren-mill,960,warlock,demonology,18,10,8
Jopasiski,draenor,960,warlock,demonology,24,10,14
Кьютсанни,howling-fjord,960,warlock,demonology,24,10,14
Xtyran,blackmoore,959,warlock,demonology,24,10,14
Ablas,bladefist,940,warlock,demonology,35,10,25
Fearmydear,alleria,926,warlock,demonology,17,10,7
Acuacx,drakthul,909,warlock,demonology,17,10,7
Rngmåchinêx,ravencrest,896,warlock,demonology,16,10,6
Migyardondup,exodar,872,warlock,demonology,18,10,8
Aladèèn,tarren-mill,864,warlock,demonology,12,9,3
Нистл,gordunni,864,warlock,demonology,12,9,3
Stafar,outland,864,warlock,demonology,12,9,3
Öbsury,hyjal,864,warlock,demonology,12,9,3
Ooroothothz,frostwolf,864,warlock,demonology,12,9,3
Syntax,blackmoore,864,warlock,demonology,12,9,3
Yazurí,ravencrest,864,warlock,demonology,12,9,3
Boomlok,tarren-mill,864,warlock,demonology,18,9,9
Deaddydoo,kazzak,864,warlock,demonology,18,9,9
Darksoll,hyjal,864,warlock,demonology,24,9,15
Гвоздяшка,blackscar,863,warlock,demonology,18,9,9
Khalkazar,darkspear,863,warlock,demonology,18,9,9
Ismenia,silvermoon,863,warlock,demonology,18,9,9
Ashzu,quelthalas,863,warlock,demonology,18,9,9
Nosoulnoprob,sylvanas,863,warlock,demonology,24,9,15
Lunden,drakthul,862,warlock,demonology,18,9,9
Сладкийпир,soulflayer,862,warlock,demonology,18,9,9
Xoky,argent-dawn,861,warlock,demonology,18,9,9
Lifesteal,auchindoun,858,warlock,demonology,18,9,9
Erwynna,conseil-des-ombres,858,warlock,demonology,24,9,15
Honetia,ravencrest,846,warlock,demonology,23,9,14
Анрали,soulflayer,831,warlock,demonology,17,9,8
Azraëlle,drekthar,815,warlock,demonology,15,10,5
Гупперлок,howling-fjord,810,warlock,demonology,27,12,15
Бирел,soulflayer,799,warlock,demonology,16,9,7
Devildodo,elune,768,warlock,demonology,12,8,4
Rozn,ravencrest,768,warlock,demonology,12,8,4
Kennyfõx,ysondre,768,warlock,demonology,12,8,4
Xerkh,thrall,768,warlock,demonology,12,8,4
Longdickie,ravencrest,768,warlock,demonology,12,8,4
Staenkymayne,blackhand,768,warlock,demonology,12,8,4
Котрх,gordunni,768,warlock,demonology,12,8,4
Topmodelx,eredar,768,warlock,demonology,12,8,4
Nàughty,ragnaros,768,warlock,demonology,15,8,7
Jarodshadow,stormscale,768,warlock,demonology,18,8,10
Djezzick,stormscale,768,warlock,demonology,18,8,10
Koldarr,blackmoore,768,warlock,demonology,18,8,10
Biest,drakthul,768,warlock,demonology,18,8,10
Idkdot,ravencrest,768,warlock,demonology,18,8,10
Slockoló,ragnaros,768,warlock,demonology,24,8,16
Tojezlo,drakthul,767,warlock,demonology,12,8,4
Sovrìn,blackrock,767,warlock,demonology,12,8,4
Hamnam,blackrock,767,warlock,demonology,18,8,10
Chimera,mugthol,767,warlock,demonology,18,8,10
Guccie,ravencrest,766,warlock,demonology,17,10,7
Britneyféars,emeriss,766,warlock,demonology,18,8,10
Zeddy,draenor,766,warlock,demonology,18,8,10
Merzavka,kazzak,765,warlock,demonology,12,8,4
Rövsmärta,ragnaros,765,warlock,demonology,15,9,6
Njutbar,ragnaros,765,warlock,demonology,18,8,10
Ясяшотлав,soulflayer,761,warlock,demonology,22,11,11
Wanderingowl,blackmoore,760,warlock,demonology,12,8,4
Nedivh,stormscale,751,warlock,demonology,23,8,15
Warlockyo,blackrock,735,warlock,demonology,17,8,9
Vreyax,aegwynn,719,warlock,demonology,11,8,3
Dotwhat,ravencrest,719,warlock,demonology,17,8,9
Voldby,kazzak,703,warlock,demonology,11,8,3
Lifetap,tarren-mill,703,warlock,demonology,14,8,6
Кайзершлафен,fordragon,703,warlock,demonology,14,8,6
Простоседой,gordunni,703,warlock,demonology,17,8,9
Framelock,draenor,672,warlock,demonology,12,7,5
Spongebobx,kazzak,672,warlock,demonology,12,7,5
Zoreck,uldum,672,warlock,demonology,12,7,5
Plâytïmè,stormscale,672,warlock,demonology,12,7,5
Morgána,outland,672,warlock,demonology,12,7,5
Ipetsincl,kazzak,672,warlock,demonology,12,7,5
Dirtytyrant,sanguino,672,warlock,demonology,12,7,5
Blekspel,outland,672,warlock,demonology,12,7,5
Bigbagelbob,archimonde,672,warlock,demonology,12,7,5
Rïñ,ravencrest,672,warlock,demonology,12,7,5
Ravenglass,argent-dawn,672,warlock,demonology,12,7,5
Immolleria,frostmane,672,warlock,demonology,12,7,5
Fearfearfear,archimonde,672,warlock,demonology,12,7,5
Khaleth,dun-modr,672,warlock,demonology,12,7,5
Hannens,blackrock,672,warlock,demonology,12,7,5
Ballerlock,ravencrest,672,warlock,demonology,12,7,5
Wiitchdoktor,twisting-nether,672,warlock,demonology,12,7,5
Shazem,tarren-mill,672,warlock,demonology,12,7,5
Pipoûc,archimonde,672,warlock,demonology,18,7,11
Fearu,kazzak,672,warlock,demonology,18,7,11
Lockaria,zuljin,671,warlock,demonology,12,7,5
Dedobozhe,ravencrest,671,warlock,demonology,12,7,5
Güulran,les-clairvoyants,671,warlock,demonology,12,7,5
Enviroq,burning-legion,671,warlock,demonology,12,7,5
Penske,sanguino,671,warlock,demonology,24,7,17
Bewbys,draenor,671,warlock,demonology,24,7,17
Themengh,stormscale,622,warlock,demonology,21,7,14
Nekrosd,tarren-mill,618,warlock,demonology,15,8,7
Snoggä,antonidas,617,warlock,demonology,20,8,12
Warlockxx,ravencrest,607,warlock,demonology,11,7,4
Грешъник,gordunni,592,warlock,demonology,13,7,6
Нафлэпил,gordunni,585,warlock,demonology,18,8,10
Rikkért,draenor,576,warlock,demonology,6,6,0
Kwanzaa,ravencrest,576,warlock,demonology,6,6,0
Makkez,outland,576,warlock,demonology,6,6,0
Onewarlock,kazzak,576,warlock,demonology,6,6,0
Keybump,outland,576,warlock,demonology,6,6,0
Dogdrakex,tarren-mill,576,warlock,demonology,6,6,0
Rikmeyzter,burning-blade,576,warlock,demonology,12,6,6
Smallpee,kazzak,576,warlock,demonology,12,6,6
Rîas,hyjal,576,warlock,demonology,12,6,6
Gruldran,khaz-modan,576,warlock,demonology,12,6,6
Rivmuu,argent-dawn,576,warlock,demonology,12,6,6
Nephystø,archimonde,576,warlock,demonology,12,6,6
Wacamolymojo,tarren-mill,576,warlock,demonology,12,6,6
Ogrez,nemesis,576,warlock,demonology,12,6,6
Lamboo,tarren-mill,576,warlock,demonology,12,6,6
Zerx,malganis,576,warlock,demonology,12,6,6
Devour,magtheridon,576,warlock,demonology,12,6,6
Vîmø,antonidas,576,warlock,demonology,12,6,6
Darcol,archimonde,576,warlock,demonology,12,6,6
Jegfaller,wildhammer,576,warlock,demonology,12,6,6
Cringetamer,silvermoon,576,warlock,demonology,12,6,6
Beloezoloto,deathwing,576,warlock,demonology,12,6,6
Mombo,the-maelstrom,576,warlock,demonology,12,6,6
Nâzgrel,tarren-mill,576,warlock,demonology,18,6,12
Oldasianman,blackrock,576,warlock,demonology,18,6,12
Zatella,ravencrest,576,warlock,demonology,18,6,12
Morwëk,ysondre,576,warlock,demonology,18,6,12
Sublînê,blackmoore,576,warlock,demonology,18,6,12
Redshíne,hyjal,576,warlock,demonology,18,6,12
Icò,ravencrest,576,warlock,demonology,18,6,12
Deadleth,blackrock,575,warlock,demonology,10,7,3
Факлок,gordunni,575,warlock,demonology,12,6,6
Profylaxis,arathor,575,warlock,demonology,12,6,6
Xerxia,blackrock,575,warlock,demonology,18,6,12
Truckpunch,defias-brotherhood,575,warlock,demonology,18,6,12
Methmuncher,twisting-nether,574,warlock,demonology,24,6,18
Jag,neptulon,573,warlock,demonology,12,6,6
Screamo,sylvanas,572,warlock,demonology,12,6,6
Absurdd,turalyon,568,warlock,demonology,14,9,5
Raez,burning-blade,559,warlock,demonology,17,6,11
Swagzz,silvermoon,480,warlock,demonology,6,5,1
Hiloqtlock,blackmoore,480,warlock,demonology,6,5,1
Lyndi,nerathor,480,warlock,demonology,6,5,1
Нэваблэйз,howling-fjord,480,warlock,demonology,6,5,1
Oozi,tarren-mill,480,warlock,demonology,6,5,1
Bibilockbert,aegwynn,480,warlock,demonology,6,5,1
Rektube,sanguino,480,warlock,demonology,6,5,1
Deadmanwlkin,aggra-português,480,warlock,demonology,6,5,1
Chromex,dentarg,480,warlock,demonology,6,5,1
Racursed,outland,480,warlock,demonology,6,5,1
Hannen,blackrock,480,warlock,demonology,6,5,1
Mércé,stormscale,480,warlock,demonology,6,5,1
Velativ,silvermoon,480,warlock,demonology,6,5,1
Köftemec,blackrock,480,warlock,demonology,6,5,1
Felgødx,nemesis,480,warlock,demonology,6,5,1
Варикай,gordunni,480,warlock,demonology,6,5,1
Фирвебало,soulflayer,480,warlock,demonology,6,5,1
Msßeckinsale,tarren-mill,480,warlock,demonology,12,5,7
Wëndigo,stormscale,480,warlock,demonology,12,5,7
Felsturm,twisting-nether,480,warlock,demonology,12,5,7
Moslock,kazzak,480,warlock,demonology,12,5,7
Kukcaryfuk,drakthul,480,warlock,demonology,12,5,7
Purepkbob,quelthalas,480,warlock,demonology,12,5,7
Khâmélÿa,culte-de-la-rive-noire,480,warlock,demonology,12,5,7
Gulderrf,kirin-tor,480,warlock,demonology,12,5,7
Morshax,ysondre,480,warlock,demonology,12,5,7
Nécromancér,doomhammer,480,warlock,demonology,12,5,7
Skrana,kazzak,480,warlock,demonology,12,5,7
Durátor,ravencrest,480,warlock,demonology,12,5,7
Agaton,twisting-nether,480,warlock,demonology,12,5,7
Tepelkwastje,twisting-nether,480,warlock,demonology,12,5,7
Nastychâtøn,ysondre,480,warlock,demonology,12,5,7
Törtidotcom,blackrock,480,warlock,demonology,12,5,7
Søcraqt,blackrock,480,warlock,demonology,13,5,8
Gúldn,outland,480,warlock,demonology,18,5,13
Zartax,kazzak,480,warlock,demonology,18,5,13
Déemón,draenor,480,warlock,demonology,18,5,13
Brodoh,dun-modr,480,warlock,demonology,18,5,13
Ezekîél,blackhand,479,warlock,demonology,6,5,1
Аттропа,gordunni,477,warlock,demonology,6,5,1
Lokko,nemesis,415,warlock,demonology,14,5,9
Mundunugu,sanguino,400,warlock,demonology,7,5,2
Papilena,turalyon,400,warlock,demonology,13,5,8
Yumiblood,tarren-mill,399,warlock,demonology,5,5,0
Droguri,darkspear,384,warlock,demonology,6,4,2
Ahollic,antonidas,384,warlock,demonology,6,4,2
Nekhar,twisting-nether,384,warlock,demonology,6,4,2
Fredé,kazzak,384,warlock,demonology,6,4,2
Marador,drakthul,384,warlock,demonology,6,4,2
Nekrofille,outland,384,warlock,demonology,6,4,2
Absurdity,twisting-nether,384,warlock,demonology,6,4,2
Chedipes,stormscale,384,warlock,demonology,6,4,2
Tropìcal,grim-batol,384,warlock,demonology,6,4,2
Watii,stormscale,384,warlock,demonology,6,4,2
Lifedriller,drakthul,384,warlock,demonology,6,4,2
Freyzul,twisting-nether,384,warlock,demonology,6,4,2
Felhaen,silvermoon,384,warlock,demonology,6,4,2
Bankstair,stormscale,384,warlock,demonology,6,4,2
Cosec,silvermoon,384,warlock,demonology,6,4,2
Otemlock,sanguino,384,warlock,demonology,6,4,2
Æternallock,nemesis,384,warlock,demonology,6,4,2
Endherkonk,sanguino,384,warlock,demonology,6,4,2
Gödisdëäd,sanguino,384,warlock,demonology,6,4,2
Zzooxxie,silvermoon,384,warlock,demonology,6,4,2
Cleyandra,arathor,384,warlock,demonology,6,4,2
Nattû,outland,384,warlock,demonology,6,4,2
Zzooxx,silvermoon,384,warlock,demonology,6,4,2
Незерлок,soulflayer,384,warlock,demonology,6,4,2
Sargaerot,draenor,384,warlock,demonology,6,4,2
Llilithh,draenor,384,warlock,demonology,6,4,2
Rüwel,mannoroth,384,warlock,demonology,6,4,2
Quadraxer,antonidas,384,warlock,demonology,6,4,2
Vanmorgoth,nazjatar,384,warlock,demonology,6,4,2
Bigballerguy,sylvanas,384,warlock,demonology,6,4,2
Demosteaks,thrall,384,warlock,demonology,6,4,2
Lugdan,blackmoore,384,warlock,demonology,6,4,2
Gunca,sylvanas,384,warlock,demonology,6,4,2
Куськысь,gordunni,384,warlock,demonology,9,5,4
Hypotax,ragnaros,384,warlock,demonology,12,4,8
Graveshaker,quelthalas,384,warlock,demonology,12,4,8
Kfo,ragnaros,384,warlock,demonology,12,4,8
Babayagâ,sanguino,384,warlock,demonology,12,4,8
Acererak,thunderhorn,384,warlock,demonology,12,4,8
Tuz,blackrock,384,warlock,demonology,12,4,8
Nulo,aggra-português,384,warlock,demonology,12,4,8
Nazw,ravencrest,384,warlock,demonology,12,4,8
Millhaus,gorgonnash,384,warlock,demonology,18,4,14
Alucena,silvermoon,384,warlock,demonology,18,4,14
Monroé,hellfire,367,warlock,demonology,11,4,7
Nili,dethecus,351,warlock,demonology,11,4,7
Tvmpzwl,ravencrest,335,warlock,demonology,11,4,7
Floriae,argent-dawn,329,warlock,demonology,13,5,8
Shadaw,kilrogg,319,warlock,demonology,5,4,1
Cainn,kilrogg,288,warlock,demonology,6,3,3
Immaginare,sylvanas,288,warlock,demonology,6,3,3
Myliege,kilrogg,288,warlock,demonology,6,3,3
Лысыйлокоть,soulflayer,288,warlock,demonology,6,3,3
Комочеро,soulflayer,288,warlock,demonology,6,3,3
Парачо,eversong,288,warlock,demonology,6,3,3
ßualock,sylvanas,288,warlock,demonology,6,3,3
Zeromaker,kazzak,288,warlock,demonology,6,3,3
Kosfáce,tarren-mill,288,warlock,demonology,6,3,3
Afflimoomoo,tarren-mill,288,warlock,demonology,6,3,3
Theronas,tarren-mill,288,warlock,demonology,6,3,3
Сантизи,gordunni,288,warlock,demonology,6,3,3
Sofias,tarren-mill,288,warlock,demonology,6,3,3
Wendetta,stormreaver,288,warlock,demonology,6,3,3
Sidragasoss,drakthul,288,warlock,demonology,6,3,3
Pidka,drakthul,288,warlock,demonology,6,3,3
Jetset,moonglade,288,warlock,demonology,6,3,3
Hasselbalch,azshara,288,warlock,demonology,6,3,3
Kharless,kazzak,288,warlock,demonology,6,3,3
Opiumers,kazzak,288,warlock,demonology,6,3,3
Alcringe,kazzak,288,warlock,demonology,6,3,3
Malkoran,sylvanas,288,warlock,demonology,6,3,3
Klaab,hyjal,288,warlock,demonology,6,3,3
Askanios,twisting-nether,288,warlock,demonology,6,3,3
Davyjonessx,twisting-nether,288,warlock,demonology,6,3,3
Локистраик,borean-tundra,288,warlock,demonology,6,3,3
Prekt,ragnaros,288,warlock,demonology,6,3,3
Sipsirica,ragnaros,288,warlock,demonology,6,3,3
Дуклок,howling-fjord,288,warlock,demonology,6,3,3
Дотботх,howling-fjord,288,warlock,demonology,6,3,3
Xjms,darksorrow,288,warlock,demonology,6,3,3
Matheus,zenedar,288,warlock,demonology,6,3,3
Bono,frostwhisper,288,warlock,demonology,6,3,3
Antuan,sanguino,288,warlock,demonology,6,3,3
Väladar,sanguino,288,warlock,demonology,6,3,3
Suucc,draenor,288,warlock,demonology,6,3,3
Dispelpls,dun-morogh,288,warlock,demonology,6,3,3
Sleethy,destromath,288,warlock,demonology,6,3,3
Shjzzkl,blackmoore,288,warlock,demonology,6,3,3
Elmîr,blackmoore,288,warlock,demonology,6,3,3
Wombsa,blackmoore,288,warlock,demonology,6,3,3
Horststenzl,blackrock,288,warlock,demonology,6,3,3
Buserella,eredar,288,warlock,demonology,6,3,3
Xiraq,nathrezim,288,warlock,demonology,6,3,3
Hotdogvendor,kazzak,288,warlock,demonology,6,3,3
Osyx,ravencrest,288,warlock,demonology,6,3,3
Bionic,eredar,288,warlock,demonology,6,3,3
Talindra,stormscale,288,warlock,demonology,6,3,3
Waîdo,blackhand,288,warlock,demonology,6,3,3
Mingingclass,stormscale,288,warlock,demonology,6,3,3
Ilililii,ravencrest,288,warlock,demonology,6,3,3
Alotadot,ravencrest,288,warlock,demonology,6,3,3
Infernion,stormscale,288,warlock,demonology,6,3,3
Rushkush,ravencrest,288,warlock,demonology,7,3,4
Tunrîda,illidan,288,warlock,demonology,10,3,7
Ïvar,ysondre,288,warlock,demonology,12,3,9
Эссминет,soulflayer,288,warlock,demonology,12,3,9
Фэлдред,soulflayer,288,warlock,demonology,12,3,9
Ftpete,argent-dawn,288,warlock,demonology,12,3,9
Dardec,hyjal,288,warlock,demonology,12,3,9
Kamí,sanguino,288,warlock,demonology,12,3,9
Cassen,outland,288,warlock,demonology,12,3,9
Hartee,argent-dawn,288,warlock,demonology,18,3,15
Ydidntuwait,ragnaros,288,warlock,demonology,18,3,15
Petrosk,sanguino,287,warlock,demonology,6,3,3
Dust,argent-dawn,287,warlock,demonology,12,3,9
Кхадгард,howling-fjord,256,warlock,demonology,10,3,7
Ánderx,dun-modr,239,warlock,demonology,5,3,2
Calypso,korgall,239,warlock,demonology,5,3,2
Анрали,deathguard,192,warlock,demonology,6,2,4
Fatkkroth,ravencrest,192,warlock,demonology,6,2,4
Azgaroth,kazzak,192,warlock,demonology,6,2,4
Qullnius,kazzak,192,warlock,demonology,6,2,4
Stromzii,silvermoon,192,warlock,demonology,6,2,4
Irnx,tarren-mill,192,warlock,demonology,6,2,4
Bowti,ravencrest,192,warlock,demonology,6,2,4
Azurma,tarren-mill,192,warlock,demonology,6,2,4
Salvatoríy,outland,192,warlock,demonology,6,2,4
Kumamoto,tarren-mill,192,warlock,demonology,6,2,4
Ukjjkhj,frostmane,192,warlock,demonology,6,2,4
Gtxtreme,kazzak,192,warlock,demonology,6,2,4
Бешентумай,goldrinn,192,warlock,demonology,6,2,4
Kasztyk,grim-batol,192,warlock,demonology,6,2,4
Iblis,grim-batol,192,warlock,demonology,6,2,4
Cali,ahnqiraj,192,warlock,demonology,6,2,4
Äåäåäåäåäåäå,ravencrest,192,warlock,demonology,6,2,4
Liwerno,dunemaul,192,warlock,demonology,6,2,4
Retrosatanas,archimonde,192,warlock,demonology,6,2,4
Кайрана,blackscar,192,warlock,demonology,6,2,4
Médeâ,ravencrest,192,warlock,demonology,6,2,4
Kaobolt,archimonde,192,warlock,demonology,6,2,4
Amerihell,pozzo-delleternità,192,warlock,demonology,6,2,4
Indifférence,archimonde,192,warlock,demonology,6,2,4
Fearlessgødx,ravencrest,192,warlock,demonology,6,2,4
Zyréx,eredar,192,warlock,demonology,6,2,4
Seldonn,pozzo-delleternità,192,warlock,demonology,6,2,4
Àbraxàs,nemesis,192,warlock,demonology,6,2,4
Jkz,blackrock,192,warlock,demonology,6,2,4
Prestige,nemesis,192,warlock,demonology,6,2,4
Cräwley,ragnaros,192,warlock,demonology,6,2,4
Fortheend,twisting-nether,192,warlock,demonology,6,2,4
Bu,zirkel-des-cenarius,192,warlock,demonology,6,2,4
Lokelicious,ragnaros,192,warlock,demonology,6,2,4
Repah,doomhammer,192,warlock,demonology,6,2,4
Surfingbirdz,ragnaros,192,warlock,demonology,6,2,4
Incesticide,ragnaros,192,warlock,demonology,6,2,4
Gammalgubbe,stormscale,192,warlock,demonology,6,2,4
Epoku,stormscale,192,warlock,demonology,6,2,4
Sneptics,draenor,192,warlock,demonology,6,2,4
Flatwolenzy,blackrock,192,warlock,demonology,6,2,4
Belzedan,blackrock,192,warlock,demonology,6,2,4
Nerfwarriors,stormscale,192,warlock,demonology,6,2,4
Скверногрик,fordragon,192,warlock,demonology,6,2,4
Baradür,sanguino,192,warlock,demonology,6,2,4
Chram,uldum,192,warlock,demonology,7,2,5
Henriett,ravencrest,192,warlock,demonology,12,2,10
Xanatar,blackhand,192,warlock,demonology,12,2,10
Grimmwald,stormreaver,192,warlock,demonology,12,2,10
Déadwish,ravencrest,192,warlock,demonology,12,2,10
Saruna,azshara,192,warlock,demonology,12,2,10
Letzterlude,thrall,159,warlock,demonology,5,2,3
Happycadaver,blackrock,96,warlock,demonology,3,2,1
Бестий,fordragon,96,warlock,demonology,6,1,5
Bolt,stormscale,96,warlock,demonology,6,1,5
Utuklululu,archimonde,96,warlock,demonology,6,1,5
Militianu,sylvanas,96,warlock,demonology,6,1,5
Divvaa,tarren-mill,96,warlock,demonology,6,1,5
Wspolnax,ravencrest,96,warlock,demonology,6,1,5
Muninnus,archimonde,96,warlock,demonology,6,1,5
Tochka,archimonde,96,warlock,demonology,6,1,5
Marann,dun-morogh,96,warlock,demonology,6,1,5
Catherine,garrosh,96,warlock,demonology,6,1,5
Tid,burning-legion,96,warlock,demonology,6,1,5
Prestoc,wrathbringer,96,warlock,demonology,6,1,5
Ðßøhßäøùí,blackmoore,96,warlock,demonology,6,1,5
Árkan,thrall,96,warlock,demonology,6,1,5
Ароматныйх,howling-fjord,96,warlock,demonology,6,1,5
Méetoo,thrall,96,warlock,demonology,6,1,5
Arkanyks,dalaran,96,warlock,demonology,6,1,5
Necroless,shadowsong,96,warlock,demonology,6,1,5
Xydar,stormscale,42,warlock,demonology,10,2,8
Infïnitýx,silvermoon,31,warlock,demonology,2,1,1
Loghit,ravencrest,16,warlock,demonology,1,1,0
Inferniøn,ravencrest,2354,warlock,destruction,75,55,20
Bóbtown,stormscale,2338,warlock,destruction,132,82,50
Lopari,aegwynn,2275,warlock,destruction,106,65,41
Jâzggz,twisting-nether,2273,warlock,destruction,66,45,21
Фаерморн,blackscar,2269,warlock,destruction,60,44,16
Canabolic,stormscale,2269,warlock,destruction,90,55,35
Боуман,howling-fjord,2243,warlock,destruction,96,56,40
Acentro,stormscale,2231,warlock,destruction,71,46,25
Creatúre,drakthul,2224,warlock,destruction,48,38,10
Rootzlx,ravencrest,2216,warlock,destruction,114,68,46
Azurma,tarren-mill,2211,warlock,destruction,78,47,31
Yùna,frostwolf,2209,warlock,destruction,72,48,24
Телола,gordunni,2208,warlock,destruction,72,48,24
Malddog,turalyon,2205,warlock,destruction,66,47,19
Dæhli,argent-dawn,2204,warlock,destruction,102,56,46
Anihli,kazzak,2194,warlock,destruction,84,48,36
Steckenpferd,blackmoore,2190,warlock,destruction,54,37,17
Zélroth,argent-dawn,2188,warlock,destruction,126,75,51
Handicapped,burning-legion,2158,warlock,destruction,78,47,31
Rexløck,nozdormu,2156,warlock,destruction,111,76,35
Erutaerc,drakthul,2154,warlock,destruction,48,32,16
Zèlêph,archimonde,2151,warlock,destruction,180,114,66
Glooness,burning-legion,2151,warlock,destruction,78,43,35
Bäle,stormreaver,2150,warlock,destruction,107,64,43
Indraxx,hyjal,2149,warlock,destruction,92,48,44
Absurdity,twisting-nether,2148,warlock,destruction,102,53,49
Snapperz,stormscale,2145,warlock,destruction,102,55,47
Kimkold,twisting-nether,2144,warlock,destruction,96,50,46
Tópdogg,twisting-nether,2140,warlock,destruction,54,43,11
Veganlifter,blackhand,2136,warlock,destruction,72,45,27
Bankstair,stormscale,2132,warlock,destruction,60,42,18
Tjl,kazzak,2130,warlock,destruction,71,42,29
Legionlockxd,twisting-nether,2129,warlock,destruction,88,48,40
Infý,ravencrest,2127,warlock,destruction,66,41,25
Nògg,frostwhisper,2120,warlock,destruction,66,42,24
Arfdispo,hyjal,2120,warlock,destruction,101,55,46
Блакхен,blackscar,2117,warlock,destruction,66,38,28
Nellyvato,eredar,2113,warlock,destruction,72,44,28
Velv,nagrand,2112,warlock,destruction,90,45,45
Рауваскх,howling-fjord,2110,warlock,destruction,53,31,22
Cryzzbad,stormscale,2109,warlock,destruction,36,29,7
Vitus,malganis,2109,warlock,destruction,132,79,53
Xesh,kiljaeden,2107,warlock,destruction,90,53,37
Hladankurac,twisting-nether,2105,warlock,destruction,60,35,25
Xeremas,blackrock,2104,warlock,destruction,59,45,14
Lywov,stormscale,2103,warlock,destruction,60,34,26
Артик,gordunni,2101,warlock,destruction,48,37,11
Amdead,sylvanas,2101,warlock,destruction,73,52,21
Ìpen,bloodfeather,2101,warlock,destruction,77,43,34
Фримех,soulflayer,2095,warlock,destruction,59,45,14
Djmcwarlock,kazzak,2095,warlock,destruction,65,37,28
Тагочи,gordunni,2093,warlock,destruction,80,43,37
Gulwer,blackmoore,2091,warlock,destruction,60,36,24
Císuh,stormreaver,2082,warlock,destruction,108,61,47
Kerídiin,twisting-nether,2079,warlock,destruction,78,45,33
Dabzw,twisting-nether,2075,warlock,destruction,67,43,24
Necromanya,ravencrest,2075,warlock,destruction,156,91,65
Паилка,galakrond,2075,warlock,destruction,135,74,61
Chaosbuster,magtheridon,2069,warlock,destruction,114,72,42
Haedache,tarren-mill,2069,warlock,destruction,101,57,44
Bualock,sylvanas,2068,warlock,destruction,60,33,27
Voldby,kazzak,2064,warlock,destruction,66,33,33
Простишутках,gordunni,2051,warlock,destruction,48,30,18
Шархихохо,gordunni,2051,warlock,destruction,78,41,37
Rhüd,twisting-nether,2045,warlock,destruction,89,51,38
Héffer,outland,2044,warlock,destruction,121,80,41
Кишмякхб,howling-fjord,2024,warlock,destruction,91,47,44
Влицотьмой,gordunni,2023,warlock,destruction,66,37,29
Bigbolt,arathor,2022,warlock,destruction,80,45,35
Кенгарь,howling-fjord,2019,warlock,destruction,132,72,60
Felcamino,outland,2019,warlock,destruction,72,36,36
Wldot,ravencrest,2016,warlock,destruction,66,41,25
Ryûsuke,dun-modr,2015,warlock,destruction,48,31,17
Geluwu,tarren-mill,2015,warlock,destruction,60,35,25
Whakkx,blackrock,2011,warlock,destruction,54,32,22
Ánderxyo,dun-modr,2010,warlock,destruction,36,29,7
Drainsouls,stormscale,2009,warlock,destruction,159,86,73
Nògg,kazzak,2008,warlock,destruction,54,29,25
Achluophobiå,ravencrest,2007,warlock,destruction,37,26,11
Жасминдос,blackscar,2006,warlock,destruction,63,42,21
Bewegen,frostwolf,2006,warlock,destruction,78,42,36
Lockisbadx,draenor,2002,warlock,destruction,60,34,26
Koisk,tarren-mill,1999,warlock,destruction,66,36,30
Tàkaz,drekthar,1998,warlock,destruction,88,54,34
Isuckwarlock,aegwynn,1994,warlock,destruction,66,34,32
Whatamellown,aegwynn,1993,warlock,destruction,54,34,20
Zàkx,silvermoon,1993,warlock,destruction,248,139,109
Umbraz,blackmoore,1991,warlock,destruction,60,34,26
Brokenearman,defias-brotherhood,1990,warlock,destruction,24,21,3
Johanan,ravencrest,1987,warlock,destruction,30,24,6
Gøzù,antonidas,1985,warlock,destruction,54,32,22
Kwoleriker,norgannon,1985,warlock,destruction,70,39,31
Påsqúåls,ravencrest,1984,warlock,destruction,72,41,31
Corbbolt,drakthul,1984,warlock,destruction,84,46,38
Инферналках,gordunni,1983,warlock,destruction,59,39,20
Vîmø,antonidas,1982,warlock,destruction,143,88,55
Shangalar,burning-legion,1980,warlock,destruction,90,51,39
Supergeîl,blackrock,1980,warlock,destruction,84,46,38
Hotdoghomie,tarren-mill,1974,warlock,destruction,36,28,8
Кириланскил,gordunni,1974,warlock,destruction,48,30,18
Laedreth,argent-dawn,1973,warlock,destruction,140,79,61
Ffpiiras,dunemaul,1972,warlock,destruction,63,37,26
Эвилакс,gordunni,1969,warlock,destruction,48,32,16
Asáel,blackrock,1968,warlock,destruction,78,44,34
Lhestér,outland,1967,warlock,destruction,57,35,22
Рашчер,gordunni,1967,warlock,destruction,53,29,24
Wällaar,ragnaros,1964,warlock,destruction,78,47,31
Djdampening,bloodhoof,1963,warlock,destruction,52,39,13
Pørtal,aggra-português,1963,warlock,destruction,65,37,28
Gogmorok,dunemaul,1962,warlock,destruction,154,80,74
Zarisya,blackmoore,1961,warlock,destruction,48,29,19
Drowlý,twisting-nether,1961,warlock,destruction,54,32,22
Portlock,kazzak,1959,warlock,destruction,66,39,27
Looneytoonz,blackrock,1956,warlock,destruction,84,50,34
Malgarøth,tarren-mill,1955,warlock,destruction,60,28,32
Сумракк,gordunni,1954,warlock,destruction,66,35,31
Stefcheto,twilights-hammer,1953,warlock,destruction,78,43,35
Tschapatalpi,blackhand,1947,warlock,destruction,70,35,35
Nëismz,hyjal,1944,warlock,destruction,48,28,20
Сильвиос,howling-fjord,1943,warlock,destruction,100,49,51
Онлидемон,gordunni,1942,warlock,destruction,73,38,35
Logicdotexé,tarren-mill,1940,warlock,destruction,61,39,22
Madridistaß,outland,1939,warlock,destruction,78,40,38
Suprezz,sylvanas,1929,warlock,destruction,60,36,24
Vvj,ravencrest,1928,warlock,destruction,114,59,55
Fornaio,nemesis,1927,warlock,destruction,36,24,12
Fîgøk,conseil-des-ombres,1923,warlock,destruction,108,63,45
Decimus,darkspear,1922,warlock,destruction,102,60,42
Bfaexpert,ravencrest,1917,warlock,destruction,24,20,4
Sjödin,tarren-mill,1917,warlock,destruction,30,24,6
Kuckacocucka,outland,1915,warlock,destruction,65,38,27
Aestheatic,draenor,1912,warlock,destruction,167,88,79
Drututt,the-maelstrom,1910,warlock,destruction,54,30,24
Necorinexx,silvermoon,1909,warlock,destruction,30,20,10
Magonyth,ravencrest,1909,warlock,destruction,90,49,41
Djhanzó,outland,1907,warlock,destruction,45,28,17
Zoodíac,blackrock,1904,warlock,destruction,48,32,16
Healylockx,stormscale,1904,warlock,destruction,48,28,20
Buâlock,stormscale,1900,warlock,destruction,24,20,4
Laokoon,blackmoore,1897,warlock,destruction,48,33,15
Xxjz,ravencrest,1897,warlock,destruction,54,31,23
Rúbs,sylvanas,1897,warlock,destruction,102,55,47
Mxxmmllm,kargath,1896,warlock,destruction,101,62,39
Kaktakto,ravencrest,1895,warlock,destruction,54,30,24
Vregor,twisting-nether,1892,warlock,destruction,36,26,10
Twisted,malganis,1891,warlock,destruction,90,51,39
Fearo,kazzak,1888,warlock,destruction,65,38,27
Juhpz,blackrock,1888,warlock,destruction,52,24,28
Whøîäm,kazzak,1883,warlock,destruction,42,31,11
Hânex,ravencrest,1883,warlock,destruction,42,28,14
Мспечень,howling-fjord,1882,warlock,destruction,42,32,10
Immaginare,sylvanas,1881,warlock,destruction,90,54,36
Henmur,stormscale,1879,warlock,destruction,64,37,27
Deathfløw,draenor,1878,warlock,destruction,72,48,24
Carelock,chamber-of-aspects,1878,warlock,destruction,42,28,14
Dogoon,sylvanas,1876,warlock,destruction,142,82,60
Noomaca,drakthul,1876,warlock,destruction,90,50,40
Eboyclass,twisting-nether,1875,warlock,destruction,33,23,10
Ulora,zirkel-des-cenarius,1875,warlock,destruction,59,33,26
Kumamoto,tarren-mill,1874,warlock,destruction,42,27,15
Kitchiarû,uldaman,1874,warlock,destruction,42,27,15
Bluefungirl,stormscale,1874,warlock,destruction,47,30,17
Andtheysay,outland,1873,warlock,destruction,135,78,57
Rockbèll,blackmoore,1871,warlock,destruction,36,28,8
Ðènnis,tarren-mill,1870,warlock,destruction,42,28,14
Dooms,antonidas,1868,warlock,destruction,42,31,11
Dersdog,twisting-nether,1867,warlock,destruction,45,26,19
Аоепампгодх,howling-fjord,1866,warlock,destruction,82,58,24
Rohyna,archimonde,1865,warlock,destruction,36,27,9
Limoges,archimonde,1865,warlock,destruction,35,26,9
Cujo,draenor,1865,warlock,destruction,54,32,22
Spookytouch,draenor,1864,warlock,destruction,94,47,47
Sheitana,ysondre,1863,warlock,destruction,60,39,21
Rokkarn,kazzak,1863,warlock,destruction,48,29,19
Xwíng,stormscale,1862,warlock,destruction,42,30,12
Osbaa,darksorrow,1861,warlock,destruction,50,31,19
Блейдап,razuvious,1859,warlock,destruction,54,31,23
Drdoit,blackrock,1859,warlock,destruction,60,31,29
Beebs,aegwynn,1858,warlock,destruction,42,31,11
Temnamagna,silvermoon,1858,warlock,destruction,41,28,13
Homerbamboom,hyjal,1857,warlock,destruction,41,32,9
Kayloo,archimonde,1856,warlock,destruction,54,34,20
Zâyo,ravencrest,1856,warlock,destruction,54,31,23
Cmdxo,malganis,1856,warlock,destruction,71,38,33
Hairyporta,blackmoore,1855,warlock,destruction,101,59,42
Djfearbot,kazzak,1854,warlock,destruction,78,49,29
Xunzu,drakthul,1854,warlock,destruction,54,27,27
Darksoll,hyjal,1853,warlock,destruction,41,31,10
Jawoxoxo,rexxar,1852,warlock,destruction,48,20,28
Laolife,twisting-nether,1851,warlock,destruction,66,33,33
Tuplajekku,sylvanas,1851,warlock,destruction,59,29,30
Johnylock,draenor,1850,warlock,destruction,116,71,45
Depressedkid,ravencrest,1850,warlock,destruction,60,30,30
Chaoscrit,eredar,1848,warlock,destruction,85,48,37
Sqx,veklor,1847,warlock,destruction,36,24,12
Themut,draenor,1847,warlock,destruction,76,49,27
Кобре,howling-fjord,1847,warlock,destruction,42,26,16
Ayperos,tyrande,1847,warlock,destruction,72,38,34
Ilovemimi,hyjal,1846,warlock,destruction,35,20,15
Шрэкс,blackscar,1846,warlock,destruction,42,22,20
Gorillabolts,tarren-mill,1846,warlock,destruction,48,21,27
Rumour,sunstrider,1843,warlock,destruction,54,30,24
Attilergg,stormscale,1839,warlock,destruction,32,23,9
Ecoxx,aegwynn,1839,warlock,destruction,48,34,14
Ñila,ravencrest,1839,warlock,destruction,36,23,13
Ripnsew,ravencrest,1839,warlock,destruction,41,26,15
Ashlÿn,draenor,1839,warlock,destruction,35,21,14
Nayolana,argent-dawn,1839,warlock,destruction,75,35,40
Dogdrakex,tarren-mill,1837,warlock,destruction,52,28,24
Ispankmysuc,korgall,1836,warlock,destruction,69,42,27
Belial,minahonda,1835,warlock,destruction,57,33,24
Гивмисоул,soulflayer,1835,warlock,destruction,54,31,23
Médeâ,ravencrest,1834,warlock,destruction,76,42,34
Válýrá,blackhand,1832,warlock,destruction,41,30,11
Kiwibob,defias-brotherhood,1832,warlock,destruction,65,41,24
Ganjubass,tarren-mill,1832,warlock,destruction,74,46,28
Ftpete,argent-dawn,1831,warlock,destruction,98,58,40
Lémonz,stormscale,1831,warlock,destruction,52,26,26
Shadöwmäre,draenor,1830,warlock,destruction,54,31,23
Extingul,tarren-mill,1828,warlock,destruction,30,23,7
Someonepro,tarren-mill,1828,warlock,destruction,53,25,28
Brainac,blackrock,1826,warlock,destruction,36,24,12
Plaguee,outland,1826,warlock,destruction,62,37,25
Boltzer,archimonde,1826,warlock,destruction,60,34,26
Alphazero,zuluhed,1826,warlock,destruction,53,29,24
Freddaxd,outland,1825,warlock,destruction,52,33,19
Соргосор,gordunni,1825,warlock,destruction,53,30,23
Saffíe,ravencrest,1825,warlock,destruction,64,36,28
Imforcedtowl,aegwynn,1824,warlock,destruction,42,31,11
Asilock,eredar,1824,warlock,destruction,48,32,16
Worse,kazzak,1823,warlock,destruction,48,29,19
Maderto,burning-legion,1823,warlock,destruction,185,101,84
Visceris,ravencrest,1822,warlock,destruction,42,20,22
Killáksi,ravencrest,1821,warlock,destruction,42,26,16
Korupcijax,kazzak,1820,warlock,destruction,36,21,15
Merçedesa,tarren-mill,1820,warlock,destruction,35,20,15
Mocha,ravencrest,1819,warlock,destruction,48,31,17
Kivilock,dun-modr,1819,warlock,destruction,67,43,24
Lyâ,ravencrest,1819,warlock,destruction,30,19,11
Juppi,blackrock,1819,warlock,destruction,138,82,56
Killning,medivh,1819,warlock,destruction,114,65,49
Fizzydark,malganis,1819,warlock,destruction,60,30,30
Ethiq,blackrock,1818,warlock,destruction,30,19,11
Jupp,blackrock,1817,warlock,destruction,48,29,19
Srkzlol,durotan,1817,warlock,destruction,66,35,31
Alcringe,kazzak,1816,warlock,destruction,158,90,68
Porchpirate,draenor,1816,warlock,destruction,72,41,31
Schrimz,blackrock,1816,warlock,destruction,54,26,28
Matsuei,tarren-mill,1816,warlock,destruction,48,23,25
Barneyboi,tarren-mill,1815,warlock,destruction,87,59,28
Louloudots,ragnaros,1815,warlock,destruction,36,22,14
Tehkorrum,archimonde,1815,warlock,destruction,53,30,23
Hafufxd,silvermoon,1814,warlock,destruction,36,30,6
Тьмазвёздная,gordunni,1814,warlock,destruction,42,31,11
Panda,aegwynn,1814,warlock,destruction,36,22,14
Кейкегенкай,gordunni,1814,warlock,destruction,69,40,29
Nemwl,draenor,1814,warlock,destruction,66,31,35
Kamoriwl,blackhand,1813,warlock,destruction,30,19,11
Bónz,outland,1813,warlock,destruction,42,25,17
Asbest,blackrock,1813,warlock,destruction,48,28,20
Doodle,the-maelstrom,1813,warlock,destruction,66,38,28
Slytherim,stormscale,1812,warlock,destruction,87,57,30
Todesgurke,alleria,1812,warlock,destruction,36,22,14
Whisperer,defias-brotherhood,1812,warlock,destruction,54,29,25
Neoe,stormscale,1812,warlock,destruction,64,34,30
Linuviel,argent-dawn,1811,warlock,destruction,41,29,12
Bono,frostwhisper,1811,warlock,destruction,86,54,32
Smaúg,archimonde,1811,warlock,destruction,69,33,36
Wankdiesel,der-rat-von-dalaran,1810,warlock,destruction,120,59,61
Gregwyn,hellscream,1809,warlock,destruction,24,19,5
Blakstorm,archimonde,1807,warlock,destruction,48,29,19
Бауглирх,howling-fjord,1807,warlock,destruction,65,35,30
Mangolicious,twisting-nether,1807,warlock,destruction,54,28,26
Tikondrus,ravencrest,1806,warlock,destruction,24,19,5
Raepist,terokkar,1806,warlock,destruction,54,33,21
Rûttna,kazzak,1806,warlock,destruction,53,27,26
Nutyx,twisting-nether,1806,warlock,destruction,60,30,30
Pumpelumpe,twisting-nether,1806,warlock,destruction,45,20,25
Yøshinø,wildhammer,1805,warlock,destruction,48,36,12
Lockchonk,kazzak,1805,warlock,destruction,84,52,32
Sïeur,archimonde,1804,warlock,destruction,113,69,44
Фирбог,soulflayer,1804,warlock,destruction,60,31,29
Makîø,hyjal,1804,warlock,destruction,77,35,42
Dayken,silvermoon,1803,warlock,destruction,33,28,5
Ertogrul,draenor,1802,warlock,destruction,24,19,5
Richerdgir,ravencrest,1802,warlock,destruction,39,25,14
Skrana,kazzak,1800,warlock,destruction,65,39,26
Junakot,silvermoon,1795,warlock,destruction,42,24,18
Sterlock,sylvanas,1793,warlock,destruction,36,24,12
Bàbyløck,archimonde,1792,warlock,destruction,72,41,31
Robertóó,burning-legion,1792,warlock,destruction,64,34,30
Hebbxw,kazzak,1790,warlock,destruction,60,38,22
Keybump,outland,1787,warlock,destruction,120,70,50
Nekrosd,tarren-mill,1787,warlock,destruction,132,69,63
Zxò,twisting-nether,1786,warlock,destruction,52,30,22
Ërîkå,ravencrest,1785,warlock,destruction,99,59,40
Knoxwhite,stormscale,1781,warlock,destruction,42,28,14
Orgebixx,blackmoore,1781,warlock,destruction,42,26,16
Kikeri,blackhand,1775,warlock,destruction,42,26,16
Якурюимнепох,gordunni,1775,warlock,destruction,95,52,43
Diablist,kazzak,1775,warlock,destruction,118,64,54
Noobgg,kazzak,1773,warlock,destruction,48,30,18
Tajit,eredar,1773,warlock,destruction,66,32,34
Crse,antonidas,1772,warlock,destruction,79,52,27
Incesticide,ragnaros,1772,warlock,destruction,54,32,22
Coilxo,ravencrest,1769,warlock,destruction,46,32,14
Demoner,tarren-mill,1769,warlock,destruction,156,90,66
Motcha,kazzak,1769,warlock,destruction,36,20,16
Sluba,stormscale,1767,warlock,destruction,80,42,38
Habdruck,blackmoore,1764,warlock,destruction,68,48,20
Демоник,deathguard,1763,warlock,destruction,42,24,18
Olympïe,archimonde,1761,warlock,destruction,52,35,17
Ниезвестнно,soulflayer,1761,warlock,destruction,41,22,19
Tuskawl,stormreaver,1760,warlock,destruction,30,19,11
Бжк,gordunni,1759,warlock,destruction,144,77,67
Zila,sylvanas,1759,warlock,destruction,47,24,23
Khoug,blackmoore,1758,warlock,destruction,48,26,22
Sad,lightnings-blade,1757,warlock,destruction,42,25,17
Alxor,archimonde,1757,warlock,destruction,66,36,30
Vmorghuliss,sanguino,1757,warlock,destruction,84,38,46
Sehk,stormreaver,1755,warlock,destruction,30,26,4
Likeqtz,thrall,1755,warlock,destruction,38,23,15
Mønarch,argent-dawn,1755,warlock,destruction,67,40,27
Boltilicious,kazzak,1754,warlock,destruction,42,26,16
Debbskidjur,tarren-mill,1754,warlock,destruction,49,28,21
Holiax,archimonde,1754,warlock,destruction,36,19,17
Jegfaller,wildhammer,1754,warlock,destruction,206,105,101
Abbzey,tarren-mill,1750,warlock,destruction,72,38,34
Хирацука,howling-fjord,1749,warlock,destruction,45,31,14
Mércé,stormscale,1748,warlock,destruction,30,22,8
Wewondak,drakthul,1747,warlock,destruction,103,62,41
Büm,kazzak,1746,warlock,destruction,54,28,26
Bianchii,stormscale,1743,warlock,destruction,27,20,7
Fearfearfear,archimonde,1743,warlock,destruction,84,41,43
Ícekíss,hyjal,1742,warlock,destruction,30,21,9
Nybbx,frostmane,1742,warlock,destruction,159,80,79
Limity,nozdormu,1739,warlock,destruction,78,45,33
Ванадий,soulflayer,1739,warlock,destruction,47,23,24
Wintheirl,argent-dawn,1737,warlock,destruction,112,61,51
Сумракз,soulflayer,1736,warlock,destruction,36,19,17
Взорг,soulflayer,1736,warlock,destruction,60,30,30
Dotalike,kazzak,1734,warlock,destruction,42,22,20
Davyjonessx,twisting-nether,1734,warlock,destruction,68,27,41
Десло,thermaplugg,1731,warlock,destruction,42,25,17
Marador,drakthul,1730,warlock,destruction,42,23,19
Upsahl,twisting-nether,1729,warlock,destruction,110,61,49
Èlton,tarren-mill,1729,warlock,destruction,96,53,43
Çamille,ulduar,1729,warlock,destruction,57,31,26
Forcas,archimonde,1728,warlock,destruction,72,46,26
Varaxxis,twisting-nether,1728,warlock,destruction,48,26,22
Isodjdojk,ravencrest,1727,warlock,destruction,24,22,2
Ôlo,rajaxx,1726,warlock,destruction,42,25,17
Sharhý,kazzak,1725,warlock,destruction,28,19,9
Ceu,tarren-mill,1725,warlock,destruction,51,30,21
Айхопъюдай,blackscar,1724,warlock,destruction,30,18,12
Deadlyrust,ragnaros,1724,warlock,destruction,42,22,20
Olsel,draenor,1723,warlock,destruction,35,24,11
Senkai,kelthuzad,1723,warlock,destruction,36,24,12
Fluugew,tarren-mill,1723,warlock,destruction,48,24,24
Fiddyp,kazzak,1722,warlock,destruction,36,22,14
Garlan,dun-modr,1722,warlock,destruction,160,81,79
Killerbolt,blackmoore,1720,warlock,destruction,42,28,14
Raverboyy,blackrock,1720,warlock,destruction,42,23,19
Silmerion,twilights-hammer,1719,warlock,destruction,54,32,22
Gjallarbrù,archimonde,1717,warlock,destruction,33,22,11
Worgonzolâ,madmortem,1717,warlock,destruction,143,91,52
Feardotbye,stormscale,1717,warlock,destruction,33,20,13
Öbsury,hyjal,1715,warlock,destruction,43,23,20
Reidonk,blackrock,1713,warlock,destruction,30,18,12
Ilovebronko,blackrock,1712,warlock,destruction,95,51,44
Ràzek,kazzak,1712,warlock,destruction,77,38,39
Soundmagic,silvermoon,1711,warlock,destruction,36,22,14
Koldarr,blackmoore,1711,warlock,destruction,64,38,26
Dualla,aegwynn,1710,warlock,destruction,78,43,35
Depressor,ragnaros,1709,warlock,destruction,42,23,19
Boumbye,ysondre,1707,warlock,destruction,38,23,15
Plâytïmè,stormscale,1706,warlock,destruction,54,25,29
Sneptics,draenor,1704,warlock,destruction,121,75,46
Исверон,howling-fjord,1704,warlock,destruction,30,18,12
Cencible,twisting-nether,1704,warlock,destruction,78,44,34
Nineinchlock,silvermoon,1704,warlock,destruction,42,18,24
Omegazero,zuluhed,1701,warlock,destruction,36,18,18
Spõk,ysondre,1700,warlock,destruction,137,80,57
Kerway,outland,1700,warlock,destruction,54,29,25
Tîllz,kargath,1698,warlock,destruction,24,22,2
Twiseqtt,stormscale,1697,warlock,destruction,30,18,12
Xfz,stormscale,1697,warlock,destruction,36,20,16
Amited,drakthul,1696,warlock,destruction,48,29,19
Exitlock,thrall,1696,warlock,destruction,36,21,15
Delumia,tarren-mill,1696,warlock,destruction,84,46,38
Helldoom,drakthul,1696,warlock,destruction,69,31,38
Hellguards,silvermoon,1695,warlock,destruction,60,30,30
Fløkee,blackmoore,1694,warlock,destruction,30,18,12
Zilalol,sylvanas,1692,warlock,destruction,36,23,13
Sargus,drakthul,1692,warlock,destruction,68,35,33
Таксидермия,gordunni,1691,warlock,destruction,49,29,20
Isata,ravencrest,1690,warlock,destruction,84,52,32
Väladar,sanguino,1690,warlock,destruction,47,23,24
Rivmuu,argent-dawn,1689,warlock,destruction,82,50,32
Elyö,dalaran,1687,warlock,destruction,137,63,74
Инфезиус,deathweaver,1686,warlock,destruction,30,18,12
Véstheim,saurfang,1685,warlock,destruction,48,29,19
Fredé,kazzak,1684,warlock,destruction,47,24,23
Nherthul,sanguino,1682,warlock,destruction,156,83,73
Røiheenøk,archimonde,1680,warlock,destruction,114,54,60
Morcey,sylvanas,1678,warlock,destruction,29,21,8
Whiteðevil,draenor,1677,warlock,destruction,36,21,15
Acidmvp,ravencrest,1676,warlock,destruction,72,38,34
Шедон,soulflayer,1675,warlock,destruction,30,22,8
Deezbolts,kazzak,1675,warlock,destruction,36,22,14
Spectarlock,tarren-mill,1675,warlock,destruction,36,18,18
Xuthil,korgall,1674,warlock,destruction,60,33,27
Opiumers,kazzak,1674,warlock,destruction,59,31,28
Wåfa,kazzak,1673,warlock,destruction,24,18,6
Ignittes,ragnaros,1671,warlock,destruction,36,26,10
Boomsparkle,blackrock,1671,warlock,destruction,36,23,13
Zloezlo,ravencrest,1670,warlock,destruction,96,54,42
Колодун,gordunni,1669,warlock,destruction,36,20,16
Yukokotier,archimonde,1667,warlock,destruction,102,56,46
Malame,hyjal,1666,warlock,destruction,48,28,20
Shadock,scarshield-legion,1664,warlock,destruction,30,20,10
Wilog,silvermoon,1664,warlock,destruction,33,21,12
Rêctûmsêêkêr,ravencrest,1664,warlock,destruction,36,19,17
Dotshok,aegwynn,1664,warlock,destruction,42,22,20
Aajora,malganis,1662,warlock,destruction,84,53,31
Ghachi,draenor,1662,warlock,destruction,48,23,25
Хастла,ashenvale,1661,warlock,destruction,42,23,19
Беллулар,howling-fjord,1660,warlock,destruction,36,22,14
Zelieknight,ysondre,1660,warlock,destruction,42,25,17
Titimon,tarren-mill,1660,warlock,destruction,58,29,29
Síggýy,eredar,1659,warlock,destruction,41,21,20
Áutísm,silvermoon,1658,warlock,destruction,90,50,40
Chaozvx,kazzak,1656,warlock,destruction,71,41,30
Shádóws,nagrand,1656,warlock,destruction,67,38,29
Brútality,nethersturm,1655,warlock,destruction,60,25,35
Rustos,ravencrest,1654,warlock,destruction,36,21,15
Mallevs,outland,1654,warlock,destruction,72,40,32
Magonyth,tarren-mill,1652,warlock,destruction,31,22,9
Warlockery,argent-dawn,1652,warlock,destruction,36,22,14
Despayr,tarren-mill,1652,warlock,destruction,48,24,24
Koffey,twisting-nether,1650,warlock,destruction,36,25,11
Kaspersdame,ravencrest,1650,warlock,destruction,47,24,23
Profesorr,defias-brotherhood,1650,warlock,destruction,42,21,21
Psýcholoc,kazzak,1648,warlock,destruction,38,25,13
Jawdrop,blackrock,1648,warlock,destruction,51,31,20
Quarimathras,antonidas,1648,warlock,destruction,54,28,26
Ltheory,aegwynn,1647,warlock,destruction,54,32,22
Nøl,sargeras,1645,warlock,destruction,339,172,167
Danidelarge,aegwynn,1645,warlock,destruction,58,29,29
Lugnalennart,tarren-mill,1644,warlock,destruction,78,42,36
Bonemetz,blackmoore,1643,warlock,destruction,83,47,36
Dotsyoudown,kelthuzad,1642,warlock,destruction,55,34,21
Sleethy,destromath,1642,warlock,destruction,36,20,16
Skyamino,hyjal,1641,warlock,destruction,42,27,15
Banishedone,stormreaver,1641,warlock,destruction,86,50,36
Shérlock,ravencrest,1640,warlock,destruction,42,22,20
Boltonez,outland,1638,warlock,destruction,60,27,33
Mihø,hyjal,1637,warlock,destruction,78,42,36
Skillførçé,kazzak,1631,warlock,destruction,24,20,4
Kasualdot,stormscale,1629,warlock,destruction,24,17,7
Telodotto,nemesis,1629,warlock,destruction,30,17,13
Fsandtwo,ravencrest,1628,warlock,destruction,30,21,9
Raxan,stormscale,1628,warlock,destruction,29,19,10
Порртвейн,howling-fjord,1628,warlock,destruction,29,18,11
Litox,twisting-nether,1627,warlock,destruction,63,32,31
Rakshazza,eredar,1626,warlock,destruction,54,31,23
Superlocken,ragnaros,1626,warlock,destruction,30,17,13
Verson,silvermoon,1626,warlock,destruction,54,27,27
Соикулейн,gordunni,1625,warlock,destruction,29,23,6
Vultzbolt,draenor,1625,warlock,destruction,78,45,33
Dótstuff,draenor,1625,warlock,destruction,30,17,13
Tôpsecret,aegwynn,1624,warlock,destruction,24,20,4
Fatburner,draenor,1624,warlock,destruction,30,21,9
Shugglock,draenor,1624,warlock,destruction,36,20,16
Armellixd,dun-modr,1624,warlock,destruction,42,20,22
Ketamol,ravencrest,1622,warlock,destruction,52,30,22
Isata,blackhand,1622,warlock,destruction,36,20,16
Kasztyk,grim-batol,1621,warlock,destruction,47,27,20
Essealaes,stormscale,1621,warlock,destruction,35,18,17
Idfearthat,ragnaros,1620,warlock,destruction,42,26,16
Kìmar,amanthul,1620,warlock,destruction,78,42,36
Beåtrìce,archimonde,1620,warlock,destruction,57,28,29
Шеизла,borean-tundra,1619,warlock,destruction,48,32,16
Reeween,argent-dawn,1619,warlock,destruction,30,18,12
Evylock,draenor,1619,warlock,destruction,30,17,13
Willthehoe,alonsus,1618,warlock,destruction,29,18,11
Saloninus,argent-dawn,1618,warlock,destruction,48,27,21
Destinyz,dun-modr,1617,warlock,destruction,30,22,8
Marti,blackrock,1617,warlock,destruction,36,22,14
Gis,laughing-skull,1616,warlock,destruction,30,17,13
Nerfbolts,archimonde,1615,warlock,destruction,24,17,7
Laciewaifu,silvermoon,1615,warlock,destruction,36,20,16
Biest,drakthul,1615,warlock,destruction,36,17,19
Neirah,stormscale,1614,warlock,destruction,41,22,19
Jisera,kiljaeden,1614,warlock,destruction,36,17,19
Proßlock,kazzak,1613,warlock,destruction,60,29,31
Ðemonsoul,stormscale,1613,warlock,destruction,156,73,83
Gogonash,ravencrest,1613,warlock,destruction,42,17,25
Artys,tarren-mill,1612,warlock,destruction,24,17,7
Nijva,silvermoon,1612,warlock,destruction,48,22,26
Meatbot,tarren-mill,1609,warlock,destruction,46,31,15
Quickccast,draenor,1609,warlock,destruction,91,55,36
Lockyswag,draenor,1609,warlock,destruction,66,37,29
Badguldan,blackmoore,1609,warlock,destruction,39,20,19
Skrabblel,tarren-mill,1609,warlock,destruction,36,18,18
Ryssäbotti,stormscale,1608,warlock,destruction,31,23,8
Purexlock,dragonblight,1608,warlock,destruction,30,19,11
Esmuel,argent-dawn,1608,warlock,destruction,71,43,28
Kognah,defias-brotherhood,1606,warlock,destruction,30,21,9
Zoradiale,twisting-nether,1606,warlock,destruction,36,24,12
Ðêmøñîc,ravencrest,1606,warlock,destruction,30,17,13
Ðîâblô,silvermoon,1606,warlock,destruction,41,22,19
Lockukaracha,malganis,1605,warlock,destruction,27,22,5
Zeinth,sanguino,1603,warlock,destruction,36,23,13
Nitmoredots,dun-modr,1603,warlock,destruction,36,20,16
Dreamnyâsha,tarren-mill,1603,warlock,destruction,42,19,23
Imbalockzwei,aegwynn,1602,warlock,destruction,24,17,7
Xtleonidas,uldum,1602,warlock,destruction,78,41,37
Flawzo,blackmoore,1601,warlock,destruction,30,19,11
Skrikipanik,kazzak,1601,warlock,destruction,36,21,15
Sirmic,hyjal,1601,warlock,destruction,72,37,35
Dastey,stormscale,1601,warlock,destruction,36,18,18
Моргоника,howling-fjord,1601,warlock,destruction,60,27,33
Kenthal,nemesis,1599,warlock,destruction,57,28,29
Funcky,terokkar,1599,warlock,destruction,36,17,19
Bolt,stormscale,1598,warlock,destruction,52,35,17
Schøkøbasher,blackrock,1596,warlock,destruction,36,20,16
Napoloen,kazzak,1596,warlock,destruction,36,19,17
Edrahil,lordaeron,1595,warlock,destruction,60,33,27
Mizxxta,zuljin,1593,warlock,destruction,29,19,10
Sickening,twilights-hammer,1589,warlock,destruction,49,35,14
Fatbëlly,argent-dawn,1587,warlock,destruction,60,31,29
Ajgreedyy,grim-batol,1586,warlock,destruction,30,18,12
Réxz,ravencrest,1586,warlock,destruction,72,36,36
Dödkärringx,auchindoun,1585,warlock,destruction,30,19,11
Kenachaos,twisting-nether,1585,warlock,destruction,89,47,42
Kenjix,blackrock,1584,warlock,destruction,54,23,31
Døtàndrun,archimonde,1582,warlock,destruction,30,17,13
Plamena,neptulon,1579,warlock,destruction,37,26,11
Spykoosi,stormscale,1578,warlock,destruction,30,18,12
Watchdots,blackrock,1578,warlock,destruction,36,19,17
Belastiz,blackmoore,1577,warlock,destruction,30,20,10
Ludé,eredar,1577,warlock,destruction,66,32,34
Htaedfo,tarren-mill,1576,warlock,destruction,102,45,57
Mariahscary,auchindoun,1575,warlock,destruction,36,21,15
Fearlessgødx,ravencrest,1575,warlock,destruction,76,37,39
Xârtôr,blackrock,1574,warlock,destruction,135,79,56
Pprwl,tarren-mill,1573,warlock,destruction,78,44,34
Ánárchy,stormscale,1572,warlock,destruction,42,22,20
Dsï,outland,1572,warlock,destruction,35,18,17
Spoíl,tarren-mill,1571,warlock,destruction,48,27,21
Noahh,kazzak,1567,warlock,destruction,101,60,41
Daubi,ravencrest,1566,warlock,destruction,30,18,12
Gimlidota,tarren-mill,1565,warlock,destruction,59,35,24
Kerthan,malorne,1563,warlock,destruction,42,29,13
Импака,howling-fjord,1562,warlock,destruction,100,55,45
Zarastro,sunstrider,1562,warlock,destruction,75,37,38
Нгага,howling-fjord,1558,warlock,destruction,64,35,29
Rackare,darksorrow,1556,warlock,destruction,27,19,8
Britneyfears,burning-legion,1556,warlock,destruction,36,18,18
Thebigsuck,tarren-mill,1555,warlock,destruction,40,22,18
Aloof,outland,1555,warlock,destruction,169,88,81
Balgo,blackmoore,1554,warlock,destruction,48,29,19
Shutupkid,ravencrest,1551,warlock,destruction,30,17,13
Päwzy,kazzak,1550,warlock,destruction,48,25,23
Белвет,blackscar,1550,warlock,destruction,51,25,26
Nekros,archimonde,1549,warlock,destruction,42,25,17
Unrealia,hyjal,1549,warlock,destruction,66,38,28
Dzey,drakthul,1546,warlock,destruction,63,35,28
Trainindummy,ravencrest,1544,warlock,destruction,35,27,8
Jinxme,tarren-mill,1544,warlock,destruction,53,30,23
Chaøs,thrall,1543,warlock,destruction,24,19,5
Yoplen,drakthul,1540,warlock,destruction,60,35,25
Lysanruth,la-croisade-écarlate,1537,warlock,destruction,60,28,32
Pipêz,blackmoore,1536,warlock,destruction,71,45,26
Героуд,howling-fjord,1536,warlock,destruction,58,35,23
Hongkonger,kazzak,1536,warlock,destruction,166,86,80
Rawsauce,outland,1535,warlock,destruction,18,16,2
Faermorn,kazzak,1535,warlock,destruction,24,16,8
Nkwango,blackmoore,1535,warlock,destruction,24,16,8
Syviwl,outland,1535,warlock,destruction,24,16,8
Nebulus,lightnings-blade,1535,warlock,destruction,56,30,26
Gishor,burning-legion,1534,warlock,destruction,18,16,2
Fatkkroth,ravencrest,1534,warlock,destruction,37,23,14
Zoh,archimonde,1534,warlock,destruction,51,26,25
Óop,outland,1533,warlock,destruction,36,17,19
Zamahell,marécage-de-zangar,1532,warlock,destruction,24,17,7
Höfmänn,kazzak,1532,warlock,destruction,49,32,17
Osîrîs,aegwynn,1532,warlock,destruction,30,16,14
Debz,twisting-nether,1531,warlock,destruction,25,16,9
Notben,outland,1529,warlock,destruction,18,16,2
Felcollíns,ravencrest,1529,warlock,destruction,24,16,8
Aoea,draenor,1529,warlock,destruction,24,16,8
Nospamcliqu,ysondre,1527,warlock,destruction,30,16,14
Murdee,kazzak,1526,warlock,destruction,42,16,26
Shaterz,dun-modr,1524,warlock,destruction,18,16,2
Critchlock,tarren-mill,1524,warlock,destruction,29,17,12
Егосяхаос,soulflayer,1524,warlock,destruction,36,19,17
Garbageclass,outland,1523,warlock,destruction,30,16,14
Slf,the-maelstrom,1523,warlock,destruction,42,16,26
Naemys,archimonde,1522,warlock,destruction,45,31,14
Azthral,nemesis,1522,warlock,destruction,187,92,95
Sadixxqt,ravencrest,1521,warlock,destruction,24,16,8
Bisacodyl,outland,1521,warlock,destruction,101,53,48
Malinki,silvermoon,1521,warlock,destruction,42,20,22
Bazoo,nathrezim,1520,warlock,destruction,84,39,45
Salazaros,die-silberne-hand,1517,warlock,destruction,60,33,27
Veracruza,draenor,1516,warlock,destruction,89,45,44
Lottopallo,arathor,1514,warlock,destruction,24,16,8
Necrobtch,quelthalas,1513,warlock,destruction,24,16,8
Грань,ashenvale,1513,warlock,destruction,153,83,70
Usianbølts,blackmoore,1513,warlock,destruction,30,16,14
Славеномен,howling-fjord,1513,warlock,destruction,131,66,65
Колдунишка,fordragon,1512,warlock,destruction,105,56,49
Deathscréam,burning-legion,1508,warlock,destruction,78,38,40
Darcîa,destromath,1507,warlock,destruction,30,19,11
Atraped,zuljin,1507,warlock,destruction,84,45,39
Kasuni,sanguino,1507,warlock,destruction,72,30,42
Сайзэр,soulflayer,1502,warlock,destruction,39,20,19
Tzeeñtch,tarren-mill,1501,warlock,destruction,65,31,34
Stromzii,silvermoon,1500,warlock,destruction,96,43,53
Zeddy,draenor,1499,warlock,destruction,102,59,43
Horsewarlock,stormscale,1499,warlock,destruction,47,21,26
Interceptêr,blackrock,1496,warlock,destruction,36,18,18
Warlocat,the-maelstrom,1493,warlock,destruction,72,34,38
Чернокнжник,soulflayer,1491,warlock,destruction,36,19,17
Voidislife,alakir,1491,warlock,destruction,158,83,75
Brokengodx,dun-modr,1489,warlock,destruction,30,16,14
Voltadol,dun-modr,1489,warlock,destruction,84,43,41
Fiveyearque,sylvanas,1489,warlock,destruction,36,16,20
Kamí,sanguino,1487,warlock,destruction,53,24,29
Спаводах,soulflayer,1486,warlock,destruction,23,16,7
Variu,blackhand,1486,warlock,destruction,106,61,45
Зеленаямразь,soulflayer,1486,warlock,destruction,33,16,17
Juïcylucy,kazzak,1484,warlock,destruction,34,21,13
Cørleen,eredar,1480,warlock,destruction,58,22,36
Czx,twisting-nether,1479,warlock,destruction,36,22,14
Datendariza,kazzak,1478,warlock,destruction,86,45,41
Иванфаков,soulflayer,1475,warlock,destruction,29,17,12
Exorbïtant,blackrock,1474,warlock,destruction,45,22,23
Дэнаа,fordragon,1472,warlock,destruction,83,37,46
Samyoung,kazzak,1470,warlock,destruction,60,35,25
Маларгас,soulflayer,1470,warlock,destruction,66,37,29
Бомбшелл,soulflayer,1469,warlock,destruction,38,17,21
Kïng,elune,1467,warlock,destruction,54,27,27
Blackiouz,stormscale,1467,warlock,destruction,54,21,33
Мицуру,howling-fjord,1466,warlock,destruction,58,33,25
Ignorantduck,sunstrider,1466,warlock,destruction,45,23,22
Magicstick,eredar,1466,warlock,destruction,54,24,30
Jaimê,thrall,1464,warlock,destruction,65,35,30
Peardrax,draenor,1464,warlock,destruction,47,25,22
Holaw,tarren-mill,1464,warlock,destruction,84,41,43
Алхун,razuvious,1463,warlock,destruction,30,17,13
Chaosprophet,argent-dawn,1459,warlock,destruction,32,18,14
Slëydark,sanguino,1456,warlock,destruction,26,16,10
Aleê,twisting-nether,1454,warlock,destruction,47,23,24
Shaxlock,draenor,1451,warlock,destruction,76,40,36
Wicherson,burning-legion,1451,warlock,destruction,37,18,19
Lockybàlboa,tarren-mill,1443,warlock,destruction,36,22,14
Stürmer,thrall,1443,warlock,destruction,42,23,19
Robertóoo,burning-legion,1442,warlock,destruction,29,16,13
Tóuché,aegwynn,1442,warlock,destruction,54,24,30
Nèrfxløl,ragnaros,1441,warlock,destruction,24,19,5
Trickyy,azjolnerub,1440,warlock,destruction,30,20,10
Артисона,gordunni,1439,warlock,destruction,24,15,9
Chromosomex,dentarg,1438,warlock,destruction,18,15,3
Fyxs,talnivarr,1438,warlock,destruction,18,15,3
Vicktorious,stormscale,1438,warlock,destruction,66,37,29
Nádjá,ravencrest,1437,warlock,destruction,24,15,9
Thugsupreme,ravencrest,1437,warlock,destruction,78,41,37
Nqa,outland,1437,warlock,destruction,30,15,15
Sznyes,ragnaros,1435,warlock,destruction,24,15,9
Wester,blackmoore,1435,warlock,destruction,30,15,15
Nimbin,taerar,1434,warlock,destruction,71,38,33
Noxsix,gorgonnash,1433,warlock,destruction,54,28,26
Vulluin,blackrock,1433,warlock,destruction,30,15,15
Calli,blackrock,1432,warlock,destruction,22,16,6
Nedivh,stormscale,1432,warlock,destruction,35,17,18
Trîppîn,blackrock,1431,warlock,destruction,24,15,9
Slavecry,silvermoon,1430,warlock,destruction,24,15,9
Kalaslars,draenor,1429,warlock,destruction,30,15,15
Kwoh,saurfang,1429,warlock,destruction,30,15,15
Nerzhull,stormscale,1427,warlock,destruction,115,55,60
Lewdrumpslap,kazzak,1425,warlock,destruction,48,31,17
Shufflous,ghostlands,1424,warlock,destruction,28,16,12
Asmonmald,stormscale,1424,warlock,destruction,70,36,34
Sesoumaru,azshara,1424,warlock,destruction,42,16,26
Ablas,bladefist,1421,warlock,destruction,118,53,65
Demonkïng,archimonde,1420,warlock,destruction,60,32,28
Иренхх,gordunni,1420,warlock,destruction,30,15,15
Moelock,frostmane,1418,warlock,destruction,41,20,21
Islazoldyck,draenor,1418,warlock,destruction,60,26,34
Dreadnogg,tarren-mill,1416,warlock,destruction,58,29,29
Waandi,ravencrest,1415,warlock,destruction,30,18,12
Birimbau,outland,1414,warlock,destruction,55,25,30
Frilante,terokkar,1410,warlock,destruction,33,24,9
Barro,das-syndikat,1410,warlock,destruction,32,17,15
Бирел,soulflayer,1409,warlock,destruction,24,15,9
Azzoaa,defias-brotherhood,1409,warlock,destruction,48,23,25
Babáyàgá,blackhand,1407,warlock,destruction,24,20,4
Falel,das-konsortium,1406,warlock,destruction,18,15,3
Sylvxgodx,kazzak,1406,warlock,destruction,30,19,11
Kumas,hyjal,1406,warlock,destruction,30,16,14
Zlohell,drakthul,1405,warlock,destruction,48,30,18
Nosoulnoprob,sylvanas,1405,warlock,destruction,30,16,14
Snackstickz,twisting-nether,1405,warlock,destruction,36,17,19
Obrusik,burning-legion,1405,warlock,destruction,34,15,19
Uneedtherapy,silvermoon,1404,warlock,destruction,24,15,9
Enydible,frostmane,1403,warlock,destruction,24,15,9
Diablotiin,hyjal,1401,warlock,destruction,127,64,63
Гупперлок,howling-fjord,1400,warlock,destruction,48,21,27
Хауда,gordunni,1396,warlock,destruction,23,15,8
Jumbodot,tarren-mill,1396,warlock,destruction,36,16,20
Делегент,deathguard,1396,warlock,destruction,60,26,34
Faro,trollbane,1396,warlock,destruction,80,33,47
Dobonard,sylvanas,1395,warlock,destruction,38,19,19
Çhãøsførÿã,blackmoore,1392,warlock,destruction,90,43,47
Zollon,norgannon,1389,warlock,destruction,23,17,6
Zivalelia,silvermoon,1389,warlock,destruction,102,49,53
Lynchian,draenor,1387,warlock,destruction,49,26,23
Acrion,blackrock,1385,warlock,destruction,33,16,17
Natsume,ragnaros,1383,warlock,destruction,36,17,19
Dexterr,sylvanas,1382,warlock,destruction,74,40,34
Veoxohr,argent-dawn,1381,warlock,destruction,69,43,26
Blackwizard,theradras,1379,warlock,destruction,33,17,16
Kosfáce,tarren-mill,1377,warlock,destruction,77,35,42
Evaksiá,draenor,1376,warlock,destruction,42,19,23
Beepbepp,grim-batol,1374,warlock,destruction,25,17,8
Baz,frostmane,1374,warlock,destruction,48,22,26
Nibblez,shadowsong,1370,warlock,destruction,46,25,21
Pookabee,ravencrest,1369,warlock,destruction,36,19,17
Sidragasoss,drakthul,1369,warlock,destruction,30,15,15
Qaripidia,ravencrest,1368,warlock,destruction,28,15,13
Kospar,dun-morogh,1363,warlock,destruction,48,26,22
Vakgu,blackmoore,1362,warlock,destruction,41,25,16
Strikeførce,ravencrest,1361,warlock,destruction,23,15,8
Somanydots,twisting-nether,1361,warlock,destruction,54,28,26
Gricorby,drakthul,1360,warlock,destruction,23,16,7
Lockedaway,ravencrest,1359,warlock,destruction,42,22,20
Сатенекс,soulflayer,1358,warlock,destruction,47,28,19
Demoz,sanguino,1354,warlock,destruction,70,40,30
Запрещаю,galakrond,1353,warlock,destruction,36,19,17
Valcan,ragnaros,1350,warlock,destruction,61,32,29
Sublînê,blackmoore,1348,warlock,destruction,70,41,29
Wedlock,stormscale,1345,warlock,destruction,42,23,19
Üserper,chamber-of-aspects,1345,warlock,destruction,107,49,58
Èmøgøðqt,ravencrest,1344,warlock,destruction,24,14,10
Боуманн,howling-fjord,1344,warlock,destruction,24,14,10
Dotloca,draenor,1344,warlock,destruction,30,15,15
Anthraxus,argent-dawn,1343,warlock,destruction,24,14,10
Äåäåäåäåäåäå,ravencrest,1343,warlock,destruction,24,14,10
Divvaa,tarren-mill,1343,warlock,destruction,89,44,45
Setyouinfear,ravencrest,1343,warlock,destruction,30,14,16
Anabolicbaby,draenor,1342,warlock,destruction,18,14,4
Инсинирейтх,gordunni,1342,warlock,destruction,18,14,4
Cigänä,archimonde,1342,warlock,destruction,24,14,10
Lockróck,silvermoon,1341,warlock,destruction,18,14,4
Pommeslock,blackmoore,1341,warlock,destruction,30,15,15
Vøid,hellscream,1341,warlock,destruction,30,14,16
Alphå,blackmoore,1340,warlock,destruction,18,14,4
Dìablò,sylvanas,1339,warlock,destruction,36,24,12
Dimmybyrger,stormreaver,1339,warlock,destruction,30,14,16
Xiraq,nathrezim,1339,warlock,destruction,30,14,16
Ryurans,cthun,1338,warlock,destruction,98,49,49
Zetsubo,drakthul,1337,warlock,destruction,28,15,13
Кварий,howling-fjord,1337,warlock,destruction,36,14,22
Zekarat,blackrock,1336,warlock,destruction,24,14,10
Onetwobolt,archimonde,1336,warlock,destruction,54,23,31
Sinsemilla,turalyon,1335,warlock,destruction,41,22,19
Anomen,sanguino,1334,warlock,destruction,30,14,16
Satanizm,silvermoon,1334,warlock,destruction,48,20,28
Ínsidióus,tarren-mill,1329,warlock,destruction,24,14,10
Turbonion,archimonde,1328,warlock,destruction,24,14,10
Äsmødée,dalaran,1328,warlock,destruction,54,31,23
Fêars,blackrock,1328,warlock,destruction,56,32,24
Nàughty,ragnaros,1328,warlock,destruction,67,28,39
Benzakenta,sylvanas,1327,warlock,destruction,24,14,10
Tsumde,dalaran,1326,warlock,destruction,44,24,20
Symbiosis,kazzak,1325,warlock,destruction,30,17,13
Soulgünter,blackmoore,1317,warlock,destruction,34,23,11
Tuz,blackrock,1316,warlock,destruction,90,40,50
Blackjackk,tarren-mill,1315,warlock,destruction,66,26,40
Mazaear,stormscale,1314,warlock,destruction,28,15,13
Ghostfiend,tarren-mill,1313,warlock,destruction,21,15,6
Chram,uldum,1311,warlock,destruction,53,33,20
Chaoxz,outland,1311,warlock,destruction,36,19,17
Nerokin,blackrock,1310,warlock,destruction,42,31,11
Lolock,archimonde,1310,warlock,destruction,26,15,11
Starlok,nemesis,1309,warlock,destruction,23,14,9
Rotinhell,kazzak,1309,warlock,destruction,123,57,66
Chroll,nerathor,1307,warlock,destruction,28,19,9
Cráxx,onyxia,1304,warlock,destruction,50,22,28
Unkash,zuljin,1302,warlock,destruction,47,26,21
Lodem,darksorrow,1298,warlock,destruction,36,15,21
Kaedinx,twisting-nether,1297,warlock,destruction,187,91,96
Skruios,anetheron,1290,warlock,destruction,34,16,18
Azrail,anubarak,1290,warlock,destruction,66,31,35
Sorxez,thrall,1287,warlock,destruction,42,19,23
Märtas,burning-blade,1283,warlock,destruction,35,14,21
Manhart,burning-legion,1281,warlock,destruction,28,15,13
Vegetita,stormscale,1280,warlock,destruction,97,50,47
Pensiblesie,runetotem,1280,warlock,destruction,209,101,108
Sylrathas,burning-legion,1279,warlock,destruction,75,41,34
Docik,kazzak,1279,warlock,destruction,31,15,16
Southylol,stormscale,1278,warlock,destruction,17,14,3
Aspass,kazzak,1278,warlock,destruction,29,14,15
Nopower,dun-morogh,1277,warlock,destruction,35,20,15
Ocaya,kazzak,1275,warlock,destruction,30,16,14
Asmodaî,anubarak,1271,warlock,destruction,26,15,11
Shinamna,tarren-mill,1270,warlock,destruction,30,15,15
Oloki,kazzak,1269,warlock,destruction,44,24,20
Zeelotko,drakthul,1265,warlock,destruction,30,15,15
Sovrìn,blackrock,1264,warlock,destruction,20,14,6
Tabarnak,archimonde,1264,warlock,destruction,30,14,16
Карьерщица,booty-bay,1258,warlock,destruction,49,26,23
Rottend,aggra-português,1258,warlock,destruction,75,33,42
Untactful,tarren-mill,1253,warlock,destruction,53,31,22
Jobbymancer,twisting-nether,1252,warlock,destruction,42,25,17
Nicolino,doomhammer,1251,warlock,destruction,30,20,10
Terris,khaz-modan,1249,warlock,destruction,75,36,39
Anderxyo,sanguino,1248,warlock,destruction,18,13,5
Kaeb,archimonde,1248,warlock,destruction,18,13,5
Twork,tarren-mill,1248,warlock,destruction,24,13,11
Mudwalkin,ravencrest,1248,warlock,destruction,24,13,11
Oldasianman,blackrock,1247,warlock,destruction,18,13,5
Nyiks,blackhand,1247,warlock,destruction,24,13,11
Andrewdaniel,twisting-nether,1247,warlock,destruction,30,13,17
Doturanal,blackmoore,1246,warlock,destruction,24,13,11
Эннинотбэд,howling-fjord,1246,warlock,destruction,24,13,11
Neffy,sinstralis,1245,warlock,destruction,70,30,40
Withered,nagrand,1244,warlock,destruction,18,13,5
Krachol,emeriss,1244,warlock,destruction,24,13,11
Domdon,stormscale,1244,warlock,destruction,24,13,11
Vankraken,silvermoon,1243,warlock,destruction,18,13,5
Warlololock,malganis,1243,warlock,destruction,18,13,5
Dreamage,exodar,1242,warlock,destruction,21,14,7
Cajnik,sylvanas,1242,warlock,destruction,24,13,11
Wlistoohard,stormscale,1242,warlock,destruction,30,13,17
Berkobaggins,ravencrest,1242,warlock,destruction,30,13,17
Salouppio,archimonde,1242,warlock,destruction,30,13,17
Cursecannon,outland,1241,warlock,destruction,18,13,5
Чиназис,gordunni,1240,warlock,destruction,78,36,42
Drfóx,draenor,1240,warlock,destruction,41,16,25
Nerfmebro,tarren-mill,1239,warlock,destruction,18,13,5
Ragequit,xavius,1238,warlock,destruction,24,13,11
Unstablemind,nemesis,1238,warlock,destruction,27,14,13
Кулутха,soulflayer,1237,warlock,destruction,18,13,5
Scrim,laughing-skull,1236,warlock,destruction,20,14,6
Jossim,outland,1234,warlock,destruction,54,31,23
Valkiá,earthen-ring,1234,warlock,destruction,30,16,14
Galath,wrathbringer,1233,warlock,destruction,40,18,22
Zhoxx,outland,1233,warlock,destruction,30,13,17
Askanios,twisting-nether,1232,warlock,destruction,55,30,25
Wurdulock,silvermoon,1231,warlock,destruction,24,13,11
Инсип,blackscar,1230,warlock,destruction,24,14,10
Ayóó,doomhammer,1230,warlock,destruction,101,56,45
Borrìs,blackhand,1230,warlock,destruction,136,72,64
Кале,goldrinn,1228,warlock,destruction,18,13,5
Гулдас,thermaplugg,1221,warlock,destruction,42,21,21
Articfox,outland,1221,warlock,destruction,41,14,27
Chickoz,eredar,1219,warlock,destruction,103,54,49
Babayagâ,sanguino,1218,warlock,destruction,24,14,10
Lokajci,outland,1217,warlock,destruction,25,15,10
Westfaliu,blackhand,1217,warlock,destruction,66,24,42
Thorenss,medivh,1215,warlock,destruction,48,22,26
Artyrus,burning-legion,1212,warlock,destruction,96,49,47
Guntok,tarren-mill,1211,warlock,destruction,37,22,15
Filianore,azjolnerub,1210,warlock,destruction,37,15,22
Felbunni,silvermoon,1206,warlock,destruction,57,24,33
Lokko,nemesis,1205,warlock,destruction,42,23,19
Diåbló,stormscale,1197,warlock,destruction,42,19,23
Zenondoros,arthas,1195,warlock,destruction,21,13,8
Hejhana,drakthul,1193,warlock,destruction,48,17,31
Emoriy,blackmoore,1190,warlock,destruction,64,34,30
Krestox,blackmoore,1189,warlock,destruction,29,13,16
Neetlock,suramar,1185,warlock,destruction,30,14,16
Mîjagî,blackhand,1183,warlock,destruction,24,14,10
Fromfuneral,anetheron,1180,warlock,destruction,65,42,23
Kaeos,ravencrest,1176,warlock,destruction,24,15,9
Lovrog,twisting-nether,1169,warlock,destruction,21,13,8
Demirchayan,twisting-nether,1169,warlock,destruction,30,18,12
Vulgrim,kirin-tor,1162,warlock,destruction,33,15,18
Lzoo,ravencrest,1152,warlock,destruction,12,12,0
Hulagirl,ravencrest,1152,warlock,destruction,18,12,6
Rmpfarmer,kazzak,1152,warlock,destruction,18,12,6
Fearbeachx,ravencrest,1152,warlock,destruction,18,12,6
Ekàti,ravencrest,1152,warlock,destruction,24,12,12
Teiser,nemesis,1152,warlock,destruction,24,12,12
Консидёро,gordunni,1152,warlock,destruction,30,12,18
Badloljk,stormscale,1151,warlock,destruction,18,12,6
Rune,aegwynn,1151,warlock,destruction,18,12,6
Leman,sylvanas,1151,warlock,destruction,18,12,6
Хиёрис,eversong,1151,warlock,destruction,36,18,18
Чудастрх,azuregos,1151,warlock,destruction,24,12,12
Mohihi,ravencrest,1151,warlock,destruction,24,12,12
Elldialock,draenor,1151,warlock,destruction,24,12,12
Shadeisblack,tarren-mill,1150,warlock,destruction,18,12,6
Kikaikek,stormscale,1150,warlock,destruction,18,12,6
Estefanía,tarren-mill,1150,warlock,destruction,18,12,6
Hannahowo,garona,1150,warlock,destruction,18,12,6
Boglock,argent-dawn,1150,warlock,destruction,18,12,6
Konradcurz,silvermoon,1150,warlock,destruction,24,12,12
Kyliân,blackmoore,1150,warlock,destruction,24,12,12
Scadar,kazzak,1149,warlock,destruction,18,12,6
Gravedîgger,aggra-português,1149,warlock,destruction,24,12,12
Autocannon,stormscale,1149,warlock,destruction,24,12,12
Maikus,stormscale,1148,warlock,destruction,18,12,6
Chubson,tarren-mill,1147,warlock,destruction,24,12,12
Kritcheq,alakir,1147,warlock,destruction,72,35,37
Lînden,magtheridon,1146,warlock,destruction,24,12,12
Favorizlmp,archimonde,1146,warlock,destruction,24,12,12
Puujäbäxd,stormscale,1145,warlock,destruction,30,12,18
Letswreck,outland,1144,warlock,destruction,30,12,18
Jinxzed,frostwhisper,1143,warlock,destruction,18,12,6
Зажиженный,soulflayer,1142,warlock,destruction,21,12,9
Hipiwl,silvermoon,1142,warlock,destruction,24,12,12
Lobotomic,argent-dawn,1140,warlock,destruction,18,12,6
Chyther,ragnaros,1139,warlock,destruction,24,12,12
Deruud,defias-brotherhood,1138,warlock,destruction,30,12,18
Parley,frostmane,1138,warlock,destruction,30,12,18
Скул,soulflayer,1137,warlock,destruction,30,12,18
Maxlox,tarren-mill,1135,warlock,destruction,23,12,11
Öyo,outland,1135,warlock,destruction,52,26,26
Gengada,blackhand,1134,warlock,destruction,24,12,12
Блэкмайндер,howling-fjord,1131,warlock,destruction,20,12,8
Toffifae,argent-dawn,1129,warlock,destruction,18,12,6
Oldemoilépti,hyjal,1126,warlock,destruction,24,12,12
Drillingsdad,dun-morogh,1126,warlock,destruction,24,12,12
Riitaall,khaz-modan,1125,warlock,destruction,49,18,31
Niszoght,dun-modr,1122,warlock,destruction,39,25,14
Moonpoxlock,nerathor,1122,warlock,destruction,26,14,12
Insanely,kazzak,1121,warlock,destruction,63,34,29
Fiddlock,draenor,1117,warlock,destruction,22,13,9
Lánfeár,draenor,1114,warlock,destruction,29,12,17
Yhwäch,archimonde,1114,warlock,destruction,30,12,18
Shagrab,nemesis,1110,warlock,destruction,21,12,9
Maxxilla,twisting-nether,1109,warlock,destruction,119,54,65
Ruul,sanguino,1109,warlock,destruction,44,18,26
Nøxxlock,blackhand,1108,warlock,destruction,22,13,9
Kartanos,stormscale,1086,warlock,destruction,17,12,5
Razek,eredar,1086,warlock,destruction,23,12,11
Atruruz,antonidas,1084,warlock,destruction,59,29,30
Makaspam,stormscale,1074,warlock,destruction,34,12,22
Thicklock,twisting-nether,1071,warlock,destruction,24,12,12
Weso,grim-batol,1070,warlock,destruction,19,12,7
Whitebanshee,turalyon,1069,warlock,destruction,30,18,12
Troyana,chants-éternels,1067,warlock,destruction,26,19,7
Nëismz,azuremyst,1056,warlock,destruction,12,11,1
Xerxeus,drakthul,1056,warlock,destruction,12,11,1
Exephia,laughing-skull,1056,warlock,destruction,12,11,1
Rabasta,blackmoore,1056,warlock,destruction,12,11,1
Блудгэнг,blackscar,1056,warlock,destruction,12,11,1
Fjutta,outland,1056,warlock,destruction,18,11,7
Кремация,blackscar,1056,warlock,destruction,18,11,7
Envizer,ravencrest,1056,warlock,destruction,18,11,7
Calypso,korgall,1056,warlock,destruction,18,11,7
Avenueat,kazzak,1056,warlock,destruction,18,11,7
Kalwyn,stormscale,1056,warlock,destruction,18,11,7
Secretx,kazzak,1056,warlock,destruction,18,11,7
Veridy,kazzak,1055,warlock,destruction,18,11,7
Fulcanelli,sargeras,1055,warlock,destruction,18,11,7
Raknoxyeyeye,blackrock,1055,warlock,destruction,18,11,7
Limecqt,dun-morogh,1055,warlock,destruction,24,11,13
Shena,chogall,1055,warlock,destruction,24,11,13
Dalyvan,blackrock,1055,warlock,destruction,24,11,13
Naniika,blackmoore,1054,warlock,destruction,36,24,12
Høliax,archimonde,1054,warlock,destruction,18,11,7
Jørdanna,blackrock,1054,warlock,destruction,18,11,7
Hydrôlîc,blackrock,1054,warlock,destruction,24,11,13
Bobop,sanguino,1054,warlock,destruction,24,11,13
Covariance,nemesis,1053,warlock,destruction,18,11,7
Коилсестры,blackscar,1053,warlock,destruction,21,12,9
Vimb,archimonde,1053,warlock,destruction,24,11,13
Boomlock,dun-morogh,1052,warlock,destruction,18,11,7
Katâra,tarren-mill,1051,warlock,destruction,30,11,19
Peterpaîn,blackmoore,1050,warlock,destruction,22,14,8
Diseased,darksorrow,1050,warlock,destruction,36,21,15
Whine,uldum,1050,warlock,destruction,54,24,30
Gåylørd,ravencrest,1050,warlock,destruction,30,11,19
Bangbrös,stormscale,1049,warlock,destruction,18,11,7
Yénnéfér,ravencrest,1046,warlock,destruction,33,11,22
Äbsalom,hyjal,1045,warlock,destruction,50,30,20
Orisess,bronze-dragonflight,1044,warlock,destruction,36,20,16
Marann,dun-morogh,1040,warlock,destruction,20,14,6
Buserella,eredar,1036,warlock,destruction,24,11,13
Demonoulis,bloodhoof,1026,warlock,destruction,18,11,7
Гринлайм,howling-fjord,1023,warlock,destruction,21,12,9
Avogeiñ,tarren-mill,1023,warlock,destruction,23,11,12
Salastro,ragnaros,1022,warlock,destruction,17,11,6
Omnigul,grim-batol,1010,warlock,destruction,36,14,22
Satyrilian,tarren-mill,1006,warlock,destruction,17,11,6
Онлифан,soulflayer,1006,warlock,destruction,17,11,6
Jaqqy,blackmoore,1005,warlock,destruction,18,12,6
Babayagaa,drakthul,1002,warlock,destruction,26,11,15
Gâlvâtorix,frostmourne,1002,warlock,destruction,46,18,28
Iltharian,die-todeskrallen,1000,warlock,destruction,17,11,6
Morathy,drekthar,991,warlock,destruction,16,11,5
Loveløck,blackrock,991,warlock,destruction,23,11,12
Yudy,burning-legion,987,warlock,destruction,20,11,9
Lockteb,tarren-mill,986,warlock,destruction,17,11,6
Lynchéd,argent-dawn,986,warlock,destruction,17,11,6
Dubbzy,outland,973,warlock,destruction,26,11,15
Demox,arathor,962,warlock,destruction,26,11,15
Eisenkiefer,thrall,961,warlock,destruction,65,22,43
Hopéléss,aggra-português,960,warlock,destruction,12,10,2
Ñia,ravencrest,960,warlock,destruction,12,10,2
Jazggzkxx,twisting-nether,960,warlock,destruction,12,10,2
Аймох,gordunni,960,warlock,destruction,12,10,2
Graystache,blackhand,960,warlock,destruction,12,10,2
Nerfmeplz,archimonde,960,warlock,destruction,12,10,2
Muleerox,kazzak,960,warlock,destruction,12,10,2
Harefrøken,ravencrest,960,warlock,destruction,12,10,2
Slomg,sylvanas,960,warlock,destruction,12,10,2
Rénio,stormrage,960,warlock,destruction,12,10,2
Korialstraz,sylvanas,960,warlock,destruction,12,10,2
Destrolockz,tarren-mill,960,warlock,destruction,16,11,5
Balding,blackhand,960,warlock,destruction,18,10,8
Adoxilock,twisting-nether,960,warlock,destruction,18,10,8
Akumako,stormscale,960,warlock,destruction,18,10,8
Eviil,tarren-mill,960,warlock,destruction,18,10,8
Mafteryo,blackrock,960,warlock,destruction,18,10,8
Lìmè,silvermoon,960,warlock,destruction,18,10,8
Trickytée,tarren-mill,960,warlock,destruction,18,10,8
Dotg,blackrock,960,warlock,destruction,18,10,8
Tbs,blackhand,960,warlock,destruction,18,10,8
Mirenli,kazzak,960,warlock,destruction,18,10,8
Enyras,nemesis,960,warlock,destruction,18,10,8
Anniefuchsia,ravencrest,960,warlock,destruction,18,10,8
Chaotick,burning-legion,960,warlock,destruction,18,10,8
Deathcoîl,the-maelstrom,960,warlock,destruction,18,10,8
Gödisdëäd,sanguino,960,warlock,destruction,18,10,8
Kyiüû,archimonde,960,warlock,destruction,22,12,10
Kresyda,dun-modr,960,warlock,destruction,24,10,14
Flatulenzus,blackrock,960,warlock,destruction,24,10,14
Deadpapi,outland,959,warlock,destruction,12,10,2
Ammilock,aszune,959,warlock,destruction,12,10,2
Zízýéró,sylvanas,959,warlock,destruction,12,10,2
Cringelord,vashj,959,warlock,destruction,12,10,2
Boterham,kilrogg,959,warlock,destruction,12,10,2
Dotáhoe,twisting-nether,959,warlock,destruction,18,10,8
Alexindorf,silvermoon,959,warlock,destruction,18,10,8
Kekbólt,twisting-nether,959,warlock,destruction,18,10,8
Adipure,blackrock,959,warlock,destruction,24,10,14
Chaosborn,ravencrest,959,warlock,destruction,24,10,14
Slâyâ,blackrock,958,warlock,destruction,12,10,2
Kenybalajze,the-maelstrom,958,warlock,destruction,18,10,8
Mempricious,ravencrest,958,warlock,destruction,18,10,8
Phît,kilrogg,958,warlock,destruction,18,10,8
Belnea,draenor,958,warlock,destruction,18,10,8
Адво,howling-fjord,958,warlock,destruction,18,10,8
Annihilatîon,aegwynn,958,warlock,destruction,18,10,8
Osyx,ravencrest,958,warlock,destruction,22,12,10
Schmexer,blutkessel,957,warlock,destruction,18,10,8
Baloc,kirin-tor,957,warlock,destruction,18,10,8
Blackmagic,stormscale,957,warlock,destruction,18,10,8
Absurdd,turalyon,955,warlock,destruction,16,11,5
Vâgg,blackmoore,955,warlock,destruction,24,10,14
Thranerm,ravencrest,955,warlock,destruction,24,10,14
Kïrah,ysondre,955,warlock,destruction,30,10,20
Realshady,kazzak,954,warlock,destruction,18,10,8
Арцах,soulflayer,954,warlock,destruction,24,10,14
Gerart,tarren-mill,953,warlock,destruction,18,10,8
Grôteskûs,tarren-mill,953,warlock,destruction,18,10,8
Millhaus,gorgonnash,952,warlock,destruction,18,10,8
Aftxrlife,arathor,951,warlock,destruction,16,11,5
Gehirnwäsche,frostwolf,951,warlock,destruction,16,11,5
Paranoid,sylvanas,951,warlock,destruction,18,10,8
Synnox,blackrock,949,warlock,destruction,24,11,13
Kääk,sylvanas,947,warlock,destruction,18,10,8
Крутизол,fordragon,944,warlock,destruction,25,11,14
Rizzbolt,ravencrest,940,warlock,destruction,57,21,36
Бигтедок,gordunni,934,warlock,destruction,99,45,54
Äzarel,khaz-modan,933,warlock,destruction,12,10,2
Mýlìfêbélike,kazzak,927,warlock,destruction,14,11,3
Racursed,outland,927,warlock,destruction,16,10,6
Demowlition,archimonde,908,warlock,destruction,24,10,14
Fandirxd,draenor,894,warlock,destruction,17,10,7
Bèkshà,blackrock,894,warlock,destruction,20,10,10
Nëismz,ravencrest,880,warlock,destruction,19,10,9
Howtofake,doomhammer,864,warlock,destruction,12,9,3
Soulboltx,ragnaros,864,warlock,destruction,12,9,3
Elmáestro,aegwynn,864,warlock,destruction,12,9,3
Кюратор,howling-fjord,864,warlock,destruction,12,9,3
Deßra,stormscale,864,warlock,destruction,12,9,3
Øßey,magtheridon,864,warlock,destruction,12,9,3
Mïllâïneeqtx,archimonde,864,warlock,destruction,12,9,3
Märkähuikka,stormreaver,864,warlock,destruction,12,9,3
Boltmaster,burning-legion,864,warlock,destruction,12,9,3
Peon,blackrock,864,warlock,destruction,12,9,3
Brødo,dun-modr,864,warlock,destruction,12,9,3
Letmecast,sylvanas,864,warlock,destruction,12,9,3
Predlocktwo,twisting-nether,864,warlock,destruction,12,9,3
Darkwíngduck,aegwynn,864,warlock,destruction,12,9,3
Ìambottger,silvermoon,864,warlock,destruction,12,9,3
Надсх,soulflayer,864,warlock,destruction,12,9,3
Reizouka,twisting-nether,864,warlock,destruction,12,9,3
Веномхх,lich-king,864,warlock,destruction,12,9,3
Габана,gordunni,864,warlock,destruction,12,9,3
Vamanos,stormscale,864,warlock,destruction,12,9,3
Chàsx,archimonde,864,warlock,destruction,12,9,3
Zikozor,ravencrest,864,warlock,destruction,16,10,6
Benne,stormscale,864,warlock,destruction,18,9,9
Stopdaddyplz,ravencrest,864,warlock,destruction,18,9,9
Köftemec,blackrock,864,warlock,destruction,18,9,9
Visable,kazzak,864,warlock,destruction,18,9,9
Чернокок,blackscar,864,warlock,destruction,18,9,9
Силорий,howling-fjord,864,warlock,destruction,18,9,9
Pöhz,archimonde,864,warlock,destruction,18,9,9
Guciflipflop,twisting-nether,864,warlock,destruction,18,9,9
Potatowl,ragnaros,864,warlock,destruction,18,9,9
Joleptem,outland,864,warlock,destruction,18,9,9
Gulzot,turalyon,864,warlock,destruction,18,9,9
Reznör,archimonde,864,warlock,destruction,18,9,9
Doomwrath,tarren-mill,864,warlock,destruction,18,9,9
Salvatoríy,outland,864,warlock,destruction,18,9,9
Fearfearfear,blackhand,864,warlock,destruction,18,9,9
Southylolz,stormscale,864,warlock,destruction,18,9,9
Mxdojsrvqxzq,ravencrest,864,warlock,destruction,24,9,15
Darlih,ravencrest,864,warlock,destruction,24,9,15
Фейкгодх,soulflayer,864,warlock,destruction,24,9,15
Lyconidas,magtheridon,863,warlock,destruction,12,9,3
Voukserys,tarren-mill,863,warlock,destruction,12,9,3
Elerodril,ysondre,863,warlock,destruction,12,9,3
Höglund,twisting-nether,863,warlock,destruction,12,9,3
Zelyx,archimonde,863,warlock,destruction,12,9,3
Mooncrushed,stormscale,863,warlock,destruction,12,9,3
Sneps,azshara,863,warlock,destruction,12,9,3
Bmblockerina,blackrock,863,warlock,destruction,12,9,3
Narzok,kazzak,863,warlock,destruction,12,9,3
Cruckz,nathrezim,863,warlock,destruction,12,9,3
Trickslock,kazzak,863,warlock,destruction,12,9,3
Phicon,silvermoon,863,warlock,destruction,12,9,3
Burningdemon,kazzak,863,warlock,destruction,18,9,9
Brugo,zuljin,863,warlock,destruction,18,9,9
Tomiaa,burning-legion,863,warlock,destruction,18,9,9
Andrealphus,outland,863,warlock,destruction,18,9,9
Гвоздяшка,blackscar,863,warlock,destruction,18,9,9
Nazrõth,stormscale,863,warlock,destruction,18,9,9
Bíggun,outland,862,warlock,destruction,12,9,3
Lokibra,antonidas,862,warlock,destruction,12,9,3
Miltuast,blackrock,862,warlock,destruction,12,9,3
Банкапевка,howling-fjord,862,warlock,destruction,18,9,9
Nokickplz,nemesis,862,warlock,destruction,18,9,9
Janemba,ysondre,862,warlock,destruction,18,9,9
Xhartus,argent-dawn,860,warlock,destruction,18,9,9
Левсекси,eversong,860,warlock,destruction,21,10,11
Ketriicken,argent-dawn,860,warlock,destruction,24,9,15
Surfot,kazzak,860,warlock,destruction,24,9,15
Adafbhf,tichondrius,859,warlock,destruction,18,9,9
Soultwist,twisting-nether,858,warlock,destruction,24,9,15
Gillgarres,twisting-nether,858,warlock,destruction,24,9,15
Oddchap,magtheridon,844,warlock,destruction,24,9,15
Архидрако,gordunni,832,warlock,destruction,24,9,15
Tid,burning-legion,830,warlock,destruction,17,9,8
Flocca,archimonde,830,warlock,destruction,17,9,8
Règis,antonidas,816,warlock,destruction,15,10,5
Indynamo,blackrock,815,warlock,destruction,17,9,8
Shakuroz,frostwolf,815,warlock,destruction,27,10,17
Xshay,dun-modr,814,warlock,destruction,27,10,17
Merloc,magtheridon,801,warlock,destruction,20,10,10
Sotapen,ragnaros,798,warlock,destruction,11,9,2
Imissbfa,stormscale,768,warlock,destruction,12,8,4
Theronas,tarren-mill,768,warlock,destruction,12,8,4
Квейдсан,howling-fjord,768,warlock,destruction,12,8,4
Dotbotx,grim-batol,768,warlock,destruction,12,8,4
Joemontana,blackrock,768,warlock,destruction,12,8,4
Vezmollo,stormscale,768,warlock,destruction,12,8,4
Sniffy,stormreaver,768,warlock,destruction,12,8,4
Nephystø,archimonde,768,warlock,destruction,12,8,4
Thesnakë,ravencrest,768,warlock,destruction,12,8,4
Jadesud,archimonde,768,warlock,destruction,12,8,4
Wumz,sylvanas,768,warlock,destruction,12,8,4
Nunomendes,archimonde,768,warlock,destruction,12,8,4
Dejin,tarren-mill,768,warlock,destruction,12,8,4
Fearu,kazzak,768,warlock,destruction,12,8,4
Psychoduck,stormscale,768,warlock,destruction,12,8,4
Wìtçhßlåðes,ysondre,768,warlock,destruction,12,8,4
Nodavé,stormscale,768,warlock,destruction,12,8,4
Crunel,ragnaros,768,warlock,destruction,12,8,4
Brodir,aszune,768,warlock,destruction,12,8,4
Coeurnichon,archimonde,768,warlock,destruction,12,8,4
Razzalock,eredar,768,warlock,destruction,12,8,4
Artannas,elune,768,warlock,destruction,12,8,4
Worro,eredar,768,warlock,destruction,12,8,4
Korbendallas,anubarak,768,warlock,destruction,12,8,4
Boltgodx,thrall,768,warlock,destruction,12,8,4
Firecast,kazzak,768,warlock,destruction,12,8,4
Overbuffed,wildhammer,768,warlock,destruction,12,8,4
Boccebelle,pozzo-delleternità,768,warlock,destruction,12,8,4
Freshademic,tarren-mill,768,warlock,destruction,12,8,4
Whitebøy,hyjal,768,warlock,destruction,12,8,4
Némésiø,archimonde,768,warlock,destruction,12,8,4
Sizexl,silvermoon,768,warlock,destruction,12,8,4
Dmonlock,hyjal,768,warlock,destruction,12,8,4
Detoxa,outland,768,warlock,destruction,12,8,4
Jkz,blackrock,768,warlock,destruction,15,9,6
Gorthunz,kazzak,768,warlock,destruction,18,8,10
Lsr,argent-dawn,768,warlock,destruction,18,8,10
Loulou,nagrand,768,warlock,destruction,18,8,10
Horststenzl,blackrock,768,warlock,destruction,18,8,10
ßenäfflock,ragnaros,768,warlock,destruction,18,8,10
Odenbest,silvermoon,768,warlock,destruction,18,8,10
Bailerlock,antonidas,768,warlock,destruction,18,8,10
Hexdoctor,ravencrest,768,warlock,destruction,24,8,16
Dotsfired,aegwynn,768,warlock,destruction,24,8,16
Nili,dethecus,767,warlock,destruction,12,8,4
Fearster,twisting-nether,767,warlock,destruction,12,8,4
Ammathrel,moonglade,767,warlock,destruction,12,8,4
Nitecro,blackmoore,767,warlock,destruction,12,8,4
Ragïa,archimonde,767,warlock,destruction,12,8,4
Lorelèi,silvermoon,767,warlock,destruction,12,8,4
Ромзесхх,howling-fjord,767,warlock,destruction,12,8,4
Palatical,terokkar,767,warlock,destruction,12,8,4
Wushi,aggra-português,767,warlock,destruction,12,8,4
Eotlid,shattered-hand,767,warlock,destruction,12,8,4
Shadowburst,outland,767,warlock,destruction,12,8,4
Finlock,kult-der-verdammten,767,warlock,destruction,15,9,6
Nerfwarriors,stormscale,767,warlock,destruction,18,8,10
Chochliko,silvermoon,767,warlock,destruction,18,8,10
Моориус,soulflayer,767,warlock,destruction,18,8,10
Hell,twisting-nether,767,warlock,destruction,18,8,10
Talriun,kazzak,767,warlock,destruction,20,8,12
Puppylover,outland,766,warlock,destruction,12,8,4
Antoniolm,cthun,766,warlock,destruction,16,9,7
Mavelya,blackmoore,766,warlock,destruction,24,8,16
Corbiejr,tarren-mill,765,warlock,destruction,22,9,13
Ezekîél,blackhand,764,warlock,destruction,24,8,16
Oxypvp,ravencrest,764,warlock,destruction,33,9,24
Юникна,gordunni,763,warlock,destruction,24,8,16
Shutdown,sylvanas,756,warlock,destruction,18,8,10
Lonelock,blackrock,750,warlock,destruction,15,9,6
Shaodul,stormscale,735,warlock,destruction,17,8,9
Diablesse,dun-modr,734,warlock,destruction,17,8,9
Salvatoriy,outland,719,warlock,destruction,11,8,3
Warlocklordx,ravencrest,713,warlock,destruction,22,9,13
Amyw,magtheridon,712,warlock,destruction,20,9,11
Джастсак,gordunni,703,warlock,destruction,11,8,3
Kycknosa,archimonde,703,warlock,destruction,20,8,12
Shadowrey,blackrock,702,warlock,destruction,16,8,8
Dotrulez,nemesis,688,warlock,destruction,13,8,5
Börsenborisq,aegwynn,687,warlock,destruction,11,8,3
Psykøø,shendralar,672,warlock,destruction,12,7,5
Dotjürgen,blackrock,672,warlock,destruction,12,7,5
Veríty,kazzak,672,warlock,destruction,12,7,5
Mowxll,blackrock,672,warlock,destruction,12,7,5
Gusvitori,sanguino,672,warlock,destruction,12,7,5
Незерлок,soulflayer,672,warlock,destruction,12,7,5
Vileclass,ravencrest,672,warlock,destruction,12,7,5
Aoeenjoer,tarren-mill,672,warlock,destruction,12,7,5
Otemlock,sanguino,672,warlock,destruction,12,7,5
Midnigthh,sanguino,672,warlock,destruction,12,7,5
Навидд,howling-fjord,672,warlock,destruction,12,7,5
Анкхзул,howling-fjord,672,warlock,destruction,12,7,5
Fraky,frostwhisper,672,warlock,destruction,12,7,5
Fellord,chants-éternels,672,warlock,destruction,12,7,5
Bloodworth,arathor,672,warlock,destruction,12,7,5
Çüñ,shattered-hand,672,warlock,destruction,12,7,5
Pelkopeelo,tarren-mill,672,warlock,destruction,12,7,5
Bruzzlbube,blackhand,672,warlock,destruction,12,7,5
Denasty,nemesis,672,warlock,destruction,12,7,5
Scud,frostwolf,672,warlock,destruction,12,7,5
Inflicts,frostmane,672,warlock,destruction,12,7,5
Precogbtw,ravencrest,672,warlock,destruction,12,7,5
Lúcìfér,stormscale,672,warlock,destruction,12,7,5
Pixelz,twisting-nether,672,warlock,destruction,12,7,5
Altffeer,blackmoore,672,warlock,destruction,12,7,5
Мэрджис,soulflayer,672,warlock,destruction,12,7,5
Chapo,alleria,672,warlock,destruction,12,7,5
Vilenia,doomhammer,672,warlock,destruction,12,7,5
Матрикспз,soulflayer,672,warlock,destruction,12,7,5
Bladey,ragnaros,672,warlock,destruction,12,7,5
Exhäle,archimonde,672,warlock,destruction,12,7,5
Cigarrette,draenor,672,warlock,destruction,12,7,5
Filippö,eredar,672,warlock,destruction,12,7,5
Neburlock,dun-modr,672,warlock,destruction,18,7,11
Belakh,draenor,672,warlock,destruction,18,7,11
Britnèyfears,twisting-nether,672,warlock,destruction,18,7,11
Valthorion,arthas,672,warlock,destruction,18,7,11
Milfhaunter,aegwynn,672,warlock,destruction,18,7,11
Hædês,antonidas,672,warlock,destruction,18,7,11
Mewarlock,bronze-dragonflight,672,warlock,destruction,18,7,11
Chromagnus,drakthul,672,warlock,destruction,18,7,11
Локизло,gordunni,672,warlock,destruction,18,7,11
Ðôtgøðx,ravencrest,672,warlock,destruction,18,7,11
Topmodelx,eredar,672,warlock,destruction,18,7,11
Kvanmor,kaelthas,672,warlock,destruction,18,7,11
Haccu,ragnaros,672,warlock,destruction,18,7,11
Marripa,sanguino,672,warlock,destruction,24,7,17
Zillinzy,frostmane,671,warlock,destruction,12,7,5
Talindra,stormscale,671,warlock,destruction,12,7,5
Panicbolt,ravencrest,671,warlock,destruction,12,7,5
Trivalis,frostwolf,671,warlock,destruction,12,7,5
Zaruman,turalyon,671,warlock,destruction,12,7,5
Kiritsugi,aszune,671,warlock,destruction,12,7,5
Fauxshow,ravencrest,671,warlock,destruction,12,7,5
Cømps,blackrock,671,warlock,destruction,12,7,5
Oz,uldum,671,warlock,destruction,12,7,5
Baladas,nemesis,671,warlock,destruction,12,7,5
Afflicted,trollbane,671,warlock,destruction,12,7,5
Galardodric,outland,671,warlock,destruction,12,7,5
Postymalony,kazzak,671,warlock,destruction,12,7,5
Proflock,drakthul,671,warlock,destruction,12,7,5
Saadq,draenor,671,warlock,destruction,12,7,5
Fivestars,tarren-mill,671,warlock,destruction,16,8,8
Vengidotcom,outland,671,warlock,destruction,18,7,11
Enragelock,tarren-mill,671,warlock,destruction,18,7,11
Margincalled,kazzak,671,warlock,destruction,18,7,11
Гнумосятина,booty-bay,671,warlock,destruction,18,7,11
Qloss,burning-legion,670,warlock,destruction,12,7,5
Mîtskî,argent-dawn,670,warlock,destruction,12,7,5
Нафлэпил,gordunni,670,warlock,destruction,12,7,5
Patirass,sanguino,670,warlock,destruction,12,7,5
Биохозард,deathguard,670,warlock,destruction,15,8,7
Зародыш,razuvious,670,warlock,destruction,18,7,11
Zow,dun-modr,670,warlock,destruction,18,7,11
Samigina,argent-dawn,669,warlock,destruction,24,7,17
Mortori,tarren-mill,668,warlock,destruction,12,7,5
Buzztoon,doomhammer,668,warlock,destruction,24,7,17
Johntrabolta,chogall,667,warlock,destruction,12,7,5
Vladlevad,argent-dawn,667,warlock,destruction,12,7,5
Pyroplasmic,tarren-mill,665,warlock,destruction,12,7,5
Ахпорбес,gordunni,661,warlock,destruction,12,7,5
Ternisia,draenor,655,warlock,destruction,14,8,6
Геролин,goldrinn,648,warlock,destruction,30,11,19
Alsseharr,blackhand,623,warlock,destruction,11,7,4
Гангстахохо,soulflayer,622,warlock,destruction,16,7,9
Lókkíi,silvermoon,622,warlock,destruction,17,7,10
Tydra,die-aldor,618,warlock,destruction,20,8,12
Garimberas,silvermoon,618,warlock,destruction,20,8,12
Bryanz,sanguino,608,warlock,destruction,10,7,3
Érunali,archimonde,607,warlock,destruction,11,7,4
Krokator,draenor,605,warlock,destruction,11,7,4
Esthrella,thrall,584,warlock,destruction,13,7,6
Catchlock,tarren-mill,576,warlock,destruction,6,6,0
Happsõr,eredar,576,warlock,destruction,6,6,0
Zýø,aegwynn,576,warlock,destruction,6,6,0
Sulnar,burning-legion,576,warlock,destruction,6,6,0
Whøknøws,twisting-nether,576,warlock,destruction,6,6,0
Solosuperr,ravencrest,576,warlock,destruction,6,6,0
Veganlifter,ravencrest,576,warlock,destruction,6,6,0
Skuvee,archimonde,576,warlock,destruction,6,6,0
Popecandy,archimonde,576,warlock,destruction,6,6,0
Sinofbum,stormscale,576,warlock,destruction,6,6,0
Cafardcancer,archimonde,576,warlock,destruction,6,6,0
Peacedust,grim-batol,576,warlock,destruction,6,6,0
Whaii,ravencrest,576,warlock,destruction,6,6,0
Phobilock,guldan,576,warlock,destruction,6,6,0
Ceryss,argent-dawn,576,warlock,destruction,6,6,0
Demonqueens,kazzak,576,warlock,destruction,6,6,0
Søulcä,uldum,576,warlock,destruction,6,6,0
Klaier,dun-modr,576,warlock,destruction,9,7,2
Mosslock,silvermoon,576,warlock,destruction,12,6,6
Kukkojapallo,ravencrest,576,warlock,destruction,12,6,6
Kalagorn,azshara,576,warlock,destruction,12,6,6
Shortyi,thrall,576,warlock,destruction,12,6,6
Koramu,blackrock,576,warlock,destruction,12,6,6
Keibo,drakthul,576,warlock,destruction,12,6,6
Dèv,draenor,576,warlock,destruction,12,6,6
Flyingjakob,argent-dawn,576,warlock,destruction,12,6,6
Felcollins,sylvanas,576,warlock,destruction,12,6,6
Mayden,uldum,576,warlock,destruction,12,6,6
Ðåñtåy,ravencrest,576,warlock,destruction,12,6,6
Conditions,tarren-mill,576,warlock,destruction,12,6,6
Diabolics,twisting-nether,576,warlock,destruction,12,6,6
Enaio,mannoroth,576,warlock,destruction,12,6,6
Issyl,kazzak,576,warlock,destruction,12,6,6
Forgepower,ghostlands,576,warlock,destruction,12,6,6
Súícìdèbøy,colinas-pardas,576,warlock,destruction,12,6,6
Ez,emeriss,576,warlock,destruction,12,6,6
Marenov,kazzak,576,warlock,destruction,12,6,6
Ðuß,nemesis,576,warlock,destruction,12,6,6
Mocfernando,ravencrest,576,warlock,destruction,12,6,6
Михасяпевпев,gordunni,576,warlock,destruction,12,6,6
Hepheisto,blackmoore,576,warlock,destruction,12,6,6
Skarløck,blackmoore,576,warlock,destruction,12,6,6
Staudi,eredar,576,warlock,destruction,12,6,6
Ooze,kazzak,576,warlock,destruction,12,6,6
Олдхалапеньо,soulflayer,576,warlock,destruction,12,6,6
Хубаскис,soulflayer,576,warlock,destruction,12,6,6
Chafir,kazzak,576,warlock,destruction,12,6,6
Zartax,kazzak,576,warlock,destruction,12,6,6
Silenozz,ragnaros,576,warlock,destruction,12,6,6
Ezdotggwp,stormscale,576,warlock,destruction,12,6,6
Warlockyo,blackrock,576,warlock,destruction,12,6,6
Liwerno,dunemaul,576,warlock,destruction,12,6,6
Drainforlife,blackrock,576,warlock,destruction,12,6,6
Backdrip,ragnaros,576,warlock,destruction,12,6,6
Dracsu,dun-modr,576,warlock,destruction,12,6,6
Edgyrpname,argent-dawn,576,warlock,destruction,12,6,6
Halacska,arathor,576,warlock,destruction,12,6,6
Dotacy,kazzak,576,warlock,destruction,12,6,6
Ilikebolts,blackmoore,576,warlock,destruction,12,6,6
Gatewatcher,argent-dawn,576,warlock,destruction,12,6,6
Acilock,outland,576,warlock,destruction,12,6,6
Noobtamer,kazzak,576,warlock,destruction,12,6,6
Klasikas,kazzak,576,warlock,destruction,16,7,9
Zéphon,blades-edge,576,warlock,destruction,21,7,14
Icq,ravencrest,576,warlock,destruction,18,6,12
Naitix,argent-dawn,576,warlock,destruction,18,6,12
Lazyblue,hyjal,576,warlock,destruction,29,6,23
Solomohn,steamwheedle-cartel,575,warlock,destruction,6,6,0
Fbomber,ravencrest,575,warlock,destruction,6,6,0
Шелруа,howling-fjord,575,warlock,destruction,10,7,3
Baalthazar,jaedenar,575,warlock,destruction,12,6,6
Rhaznor,frostwolf,575,warlock,destruction,12,6,6
Maveri,tarren-mill,575,warlock,destruction,12,6,6
Warlockzor,auchindoun,575,warlock,destruction,12,6,6
Dhraven,thrall,575,warlock,destruction,12,6,6
Brarvile,zuljin,575,warlock,destruction,12,6,6
Zevil,emerald-dream,575,warlock,destruction,12,6,6
Arnoediad,twisting-nether,575,warlock,destruction,12,6,6
Nava,stormscale,575,warlock,destruction,12,6,6
Àtreyù,daggerspine,575,warlock,destruction,12,6,6
Swagzz,silvermoon,575,warlock,destruction,12,6,6
Pekkoperkele,ravenholdt,575,warlock,destruction,18,6,12
Ramurox,rexxar,575,warlock,destruction,18,6,12
Nemssy,dun-modr,575,warlock,destruction,18,6,12
Lucîfear,silvermoon,574,warlock,destruction,12,6,6
Fearylia,aegwynn,543,warlock,destruction,8,7,1
Epzi,outland,543,warlock,destruction,11,6,5
Pouletmicuie,archimonde,527,warlock,destruction,11,6,5
Rozn,ravencrest,527,warlock,destruction,11,6,5
Smíkz,blackhand,527,warlock,destruction,11,6,5
Стафилокок,deepholm,527,warlock,destruction,11,6,5
Sicktir,aerie-peak,527,warlock,destruction,11,6,5
Xoram,kult-der-verdammten,525,warlock,destruction,12,7,5
Брузир,gordunni,522,warlock,destruction,15,7,8
Wolferand,argent-dawn,521,warlock,destruction,24,7,17
Evilhippie,kazzak,511,warlock,destruction,11,6,5
Diddia,malganis,511,warlock,destruction,11,6,5
Baxiaz,kazzak,511,warlock,destruction,11,6,5
Precogdiet,draenor,480,warlock,destruction,6,5,1
Lazytown,silvermoon,480,warlock,destruction,6,5,1
Азерок,howling-fjord,480,warlock,destruction,6,5,1
Scandalfogel,frostmane,480,warlock,destruction,6,5,1
Ironserious,blackrock,480,warlock,destruction,6,5,1
Веберх,howling-fjord,480,warlock,destruction,6,5,1
Møärdötd,aggra-português,480,warlock,destruction,6,5,1
Bufflockspls,outland,480,warlock,destruction,6,5,1
Stazox,drakthul,480,warlock,destruction,6,5,1
Destrodmitri,blackmoore,480,warlock,destruction,6,5,1
Levinbrz,ravencrest,480,warlock,destruction,6,5,1
Nàchtt,archimonde,480,warlock,destruction,6,5,1
Uralya,kazzak,480,warlock,destruction,6,5,1
Drainurlife,zenedar,480,warlock,destruction,6,5,1
Aritrosyo,ravencrest,480,warlock,destruction,6,5,1
Wÿvërnn,archimonde,480,warlock,destruction,6,5,1
Verminosiss,stormscale,480,warlock,destruction,6,5,1
Lyndi,nerathor,480,warlock,destruction,6,5,1
Dogbolt,stormscale,480,warlock,destruction,6,5,1
Zurael,mannoroth,480,warlock,destruction,6,5,1
Altfdrölf,blackhand,480,warlock,destruction,6,5,1
Sumstone,kazzak,480,warlock,destruction,6,5,1
Kaakmasta,der-abyssische-rat,480,warlock,destruction,6,5,1
Warlockholms,archimonde,480,warlock,destruction,6,5,1
Sâlty,stormscale,480,warlock,destruction,6,5,1
Rozibolt,draenor,480,warlock,destruction,6,5,1
Måracujå,kazzak,480,warlock,destruction,6,5,1
Yzzie,drakthul,480,warlock,destruction,6,5,1
Trooverx,ravencrest,480,warlock,destruction,6,5,1
Mazuto,outland,480,warlock,destruction,6,5,1
Avadakèdavra,kazzak,480,warlock,destruction,6,5,1
Pôhzz,archimonde,480,warlock,destruction,6,5,1
Djløckgødx,ravencrest,480,warlock,destruction,6,5,1
Lilbolty,outland,480,warlock,destruction,6,5,1
Barbyqueue,kazzak,480,warlock,destruction,6,5,1
Trollgubbe,twilights-hammer,480,warlock,destruction,6,5,1
Exiled,dragonblight,480,warlock,destruction,6,5,1
Purplemafia,burning-blade,480,warlock,destruction,6,5,1
Xeró,quelthalas,480,warlock,destruction,6,5,1
Xjay,malorne,480,warlock,destruction,6,5,1
Smallpee,kazzak,480,warlock,destruction,6,5,1
Náwwk,blackmoore,480,warlock,destruction,6,5,1
Пъё,howling-fjord,480,warlock,destruction,6,5,1
Djolagourde,archimonde,480,warlock,destruction,6,5,1
Ампе,blackscar,480,warlock,destruction,6,5,1
Андаинг,soulflayer,480,warlock,destruction,6,5,1
Бриант,gordunni,480,warlock,destruction,6,5,1
Файрусх,soulflayer,480,warlock,destruction,6,5,1
ßualock,sylvanas,480,warlock,destruction,6,5,1
Demonmilf,ysondre,480,warlock,destruction,6,5,1
Lísbeth,sylvanas,480,warlock,destruction,6,5,1
Журанайсбой,blackscar,480,warlock,destruction,6,5,1
Миражлок,gordunni,480,warlock,destruction,6,5,1
Rensayy,ysondre,480,warlock,destruction,6,5,1
Мегаклещ,soulflayer,480,warlock,destruction,12,5,7
Fluxlight,frostmourne,480,warlock,destruction,12,5,7
Nanotrik,draenor,480,warlock,destruction,12,5,7
Cerberus,anetheron,480,warlock,destruction,12,5,7
Shreedlock,blackmoore,480,warlock,destruction,12,5,7
Cursè,stormscale,480,warlock,destruction,12,5,7
Tiwtera,draenor,480,warlock,destruction,12,5,7
Kigro,burning-legion,480,warlock,destruction,12,5,7
Lokelicious,ragnaros,480,warlock,destruction,12,5,7
Arthesia,archimonde,480,warlock,destruction,12,5,7
Hexdoc,alakir,480,warlock,destruction,12,5,7
Baskakov,zuljin,480,warlock,destruction,12,5,7
Zeanort,zuljin,480,warlock,destruction,12,5,7
Pewmlock,antonidas,480,warlock,destruction,12,5,7
Southyx,stormscale,480,warlock,destruction,12,5,7
Динодотз,howling-fjord,480,warlock,destruction,12,5,7
Voidzero,hyjal,480,warlock,destruction,12,5,7
Claralock,silvermoon,480,warlock,destruction,12,5,7
Asper,ragnaros,480,warlock,destruction,12,5,7
Kieman,tarren-mill,480,warlock,destruction,12,5,7
Bricktot,ragnaros,480,warlock,destruction,12,5,7
Yokûjin,twisting-nether,480,warlock,destruction,12,5,7
Kimwexler,ravencrest,480,warlock,destruction,12,5,7
Voodooskull,kazzak,480,warlock,destruction,12,5,7
Bajsibyx,tarren-mill,480,warlock,destruction,12,5,7
Snoreghast,tarren-mill,480,warlock,destruction,12,5,7
Zêngâ,kazzak,480,warlock,destruction,12,5,7
Rikudoua,malfurion,480,warlock,destruction,12,5,7
Plocke,aegwynn,480,warlock,destruction,12,5,7
Shadowscurse,sylvanas,480,warlock,destruction,12,5,7
Käristäjä,outland,480,warlock,destruction,12,5,7
Infïnitýx,silvermoon,480,warlock,destruction,12,5,7
Yeluna,alleria,480,warlock,destruction,12,5,7
Cancerdotcom,kazzak,480,warlock,destruction,12,5,7
Sindown,the-maelstrom,480,warlock,destruction,18,5,13
Infectius,kazzak,480,warlock,destruction,18,5,13
Maledictio,blackrock,480,warlock,destruction,18,5,13
Эктос,soulflayer,479,warlock,destruction,6,5,1
Fredysimo,silvermoon,479,warlock,destruction,6,5,1
Archélion,silvermoon,479,warlock,destruction,12,5,7
Xydar,stormscale,479,warlock,destruction,12,5,7
Сенсация,ashenvale,479,warlock,destruction,12,5,7
Bope,the-maelstrom,479,warlock,destruction,18,5,13
Слававдвх,blackscar,478,warlock,destruction,6,5,1
Soulsdeads,sylvanas,478,warlock,destruction,12,5,7
Снчч,soulflayer,463,warlock,destruction,11,5,6
Favris,antonidas,447,warlock,destruction,11,5,6
Winterx,argent-dawn,447,warlock,destruction,11,5,6
Daeyon,ravencrest,432,warlock,destruction,9,5,4
Chornota,ravencrest,431,warlock,destruction,17,5,12
Buddyparty,blackrock,415,warlock,destruction,8,5,3
Løckwood,blackrock,400,warlock,destruction,7,5,2
Charmine,tarren-mill,400,warlock,destruction,7,5,2
Sïlïthuss,ravencrest,384,warlock,destruction,6,4,2
Corano,ravencrest,384,warlock,destruction,6,4,2
Boltsofdoom,kazzak,384,warlock,destruction,6,4,2
Danidelarge,kazzak,384,warlock,destruction,6,4,2
Cloud,kazzak,384,warlock,destruction,6,4,2
Póssiblyreef,silvermoon,384,warlock,destruction,6,4,2
Gambos,kazzak,384,warlock,destruction,6,4,2
Krastey,malfurion,384,warlock,destruction,6,4,2
Salvabolter,outland,384,warlock,destruction,6,4,2
Xenastro,silvermoon,384,warlock,destruction,6,4,2
Simony,ravencrest,384,warlock,destruction,6,4,2
Rngmåchinêx,ravencrest,384,warlock,destruction,6,4,2
Iulu,sylvanas,384,warlock,destruction,6,4,2
Azae,outland,384,warlock,destruction,6,4,2
Hehexd,steamwheedle-cartel,384,warlock,destruction,6,4,2
Wizdoom,outland,384,warlock,destruction,6,4,2
Purplemonkey,burning-blade,384,warlock,destruction,6,4,2
Xarfoul,grim-batol,384,warlock,destruction,6,4,2
Shreklock,burning-blade,384,warlock,destruction,6,4,2
Aldiac,aegwynn,384,warlock,destruction,6,4,2
Raddikal,archimonde,384,warlock,destruction,6,4,2
Kar,haomarush,384,warlock,destruction,6,4,2
Nilsa,eredar,384,warlock,destruction,6,4,2
Abdulrahim,archimonde,384,warlock,destruction,6,4,2
Zéik,archimonde,384,warlock,destruction,6,4,2
Ieatfel,archimonde,384,warlock,destruction,6,4,2
Blyskawicar,silvermoon,384,warlock,destruction,6,4,2
Воттоваара,azuregos,384,warlock,destruction,6,4,2
Boltyboi,chamber-of-aspects,384,warlock,destruction,6,4,2
Кичи,gordunni,384,warlock,destruction,6,4,2
Darkwìngduck,ravencrest,384,warlock,destruction,6,4,2
Apeliction,eredar,384,warlock,destruction,6,4,2
Hachishaku,ravencrest,384,warlock,destruction,6,4,2
Rénna,twisting-nether,384,warlock,destruction,6,4,2
Vêzor,twisting-nether,384,warlock,destruction,6,4,2
Flayør,ravencrest,384,warlock,destruction,6,4,2
Discordîân,twisting-nether,384,warlock,destruction,6,4,2
Uqrlock,twisting-nether,384,warlock,destruction,6,4,2
Yifu,ravencrest,384,warlock,destruction,6,4,2
Senbolts,tarren-mill,384,warlock,destruction,6,4,2
Warchilly,twisting-nether,384,warlock,destruction,6,4,2
Хйу,galakrond,384,warlock,destruction,6,4,2
Felgød,ravencrest,384,warlock,destruction,6,4,2
Striks,ragnaros,384,warlock,destruction,6,4,2
Dotritos,tarren-mill,384,warlock,destruction,6,4,2
Sneltjej,draenor,384,warlock,destruction,6,4,2
Ðênnis,tarren-mill,384,warlock,destruction,6,4,2
Cokkà,dalaran,384,warlock,destruction,6,4,2
Redroach,doomhammer,384,warlock,destruction,6,4,2
Царьдарк,soulflayer,384,warlock,destruction,6,4,2
Notloveless,stormscale,384,warlock,destruction,6,4,2
Пчелокнижник,howling-fjord,384,warlock,destruction,6,4,2
Sopingsop,chants-éternels,384,warlock,destruction,6,4,2
Drshegs,darkspear,384,warlock,destruction,6,4,2
Scallington,shattered-hand,384,warlock,destruction,6,4,2
Калестонх,soulflayer,384,warlock,destruction,6,4,2
Kankbae,stormscale,384,warlock,destruction,6,4,2
Анрали,soulflayer,384,warlock,destruction,6,4,2
Youngtyrant,blackrock,384,warlock,destruction,6,4,2
Íntikam,blackrock,384,warlock,destruction,6,4,2
Ädarä,cthun,384,warlock,destruction,6,4,2
Tekrowdy,blackmoore,384,warlock,destruction,6,4,2
Trembly,alakir,384,warlock,destruction,6,4,2
Elissa,skullcrusher,384,warlock,destruction,6,4,2
Вешка,azuregos,384,warlock,destruction,6,4,2
Критокнижник,lich-king,384,warlock,destruction,6,4,2
Siyaa,eredar,384,warlock,destruction,6,4,2
Zilthon,dragonblight,384,warlock,destruction,6,4,2
Onekxz,blackrock,384,warlock,destruction,6,4,2
Alexcurse,draenor,384,warlock,destruction,6,4,2
Déemón,draenor,384,warlock,destruction,6,4,2
Rayfears,draenor,384,warlock,destruction,6,4,2
Allêgrâ,blackrock,384,warlock,destruction,6,4,2
Supermaus,blackrock,384,warlock,destruction,6,4,2
Яичнаялапша,soulflayer,384,warlock,destruction,6,4,2
Rikkai,anubarak,384,warlock,destruction,6,4,2
Unfeared,blackhand,384,warlock,destruction,6,4,2
Vae,doomhammer,384,warlock,destruction,6,4,2
Xskyrov,blackmoore,384,warlock,destruction,6,4,2
Feyreah,blackmoore,384,warlock,destruction,6,4,2
Smithlock,blackrock,384,warlock,destruction,6,4,2
Äri,blackmoore,384,warlock,destruction,6,4,2
Døxz,blackrock,384,warlock,destruction,6,4,2
Hiloqtlock,blackmoore,384,warlock,destruction,6,4,2
Рыжевласочка,eversong,384,warlock,destruction,9,5,4
Omnípotens,silvermoon,384,warlock,destruction,12,6,6
Shadowflare,blackmoore,384,warlock,destruction,12,4,8
Lockpup,draenor,384,warlock,destruction,12,4,8
Axy,dun-modr,384,warlock,destruction,12,4,8
Стокыч,soulflayer,384,warlock,destruction,12,4,8
Hòbó,outland,384,warlock,destruction,12,4,8
Nahamma,tarren-mill,384,warlock,destruction,12,4,8
Мазаффак,gordunni,384,warlock,destruction,12,4,8
Azmondan,ahnqiraj,384,warlock,destruction,12,4,8
Mustalol,outland,384,warlock,destruction,12,4,8
Лоллиторпеда,gordunni,384,warlock,destruction,12,4,8
Lockpz,sylvanas,384,warlock,destruction,12,4,8
Kaobolt,archimonde,384,warlock,destruction,12,4,8
Уфц,grom,384,warlock,destruction,12,4,8
Yandihimir,silvermoon,384,warlock,destruction,12,4,8
Harrydotterx,alakir,384,warlock,destruction,12,4,8
Чиззихаос,soulflayer,384,warlock,destruction,12,4,8
Impvader,argent-dawn,384,warlock,destruction,12,4,8
Nicetime,nefarian,384,warlock,destruction,12,4,8
Darkmaw,drakthul,384,warlock,destruction,12,4,8
Бешентумай,goldrinn,384,warlock,destruction,12,4,8
Ksenìa,khaz-modan,384,warlock,destruction,12,4,8
Hellíc,kazzak,384,warlock,destruction,12,4,8
Palihatschi,eredar,384,warlock,destruction,12,4,8
Icritmore,stormscale,384,warlock,destruction,12,4,8
Novkan,eredar,384,warlock,destruction,12,4,8
Shêrlöck,stormscale,384,warlock,destruction,12,4,8
Tekron,blackhand,384,warlock,destruction,12,4,8
Sædotern,stormscale,384,warlock,destruction,12,4,8
Lifetapped,tarren-mill,384,warlock,destruction,18,4,14
Jetsetmehmet,aegwynn,384,warlock,destruction,18,4,14
Happysrme,thrall,384,warlock,destruction,18,4,14
Stunspectoo,turalyon,383,warlock,destruction,6,4,2
Angrynoob,silvermoon,383,warlock,destruction,6,4,2
Подликерная,howling-fjord,383,warlock,destruction,6,4,2
Injecter,stormscale,383,warlock,destruction,6,4,2
Okulus,quelthalas,383,warlock,destruction,6,4,2
Dathos,ragnaros,383,warlock,destruction,12,4,8
Olympos,draenor,383,warlock,destruction,12,4,8
Pidka,drakthul,382,warlock,destruction,6,4,2
Britneyfear,aegwynn,351,warlock,destruction,8,5,3
Khano,twisting-nether,336,warlock,destruction,15,4,11
Рейнджр,eversong,330,warlock,destruction,15,6,9
Zøhaz,burning-legion,326,warlock,destruction,18,5,13
Sapheâ,burning-legion,319,warlock,destruction,5,4,1
Chev,nemesis,319,warlock,destruction,5,4,1
Лавамес,eversong,319,warlock,destruction,5,4,1
Würrzag,kazzak,319,warlock,destruction,5,4,1
Grolder,terokkar,319,warlock,destruction,8,4,4
Líok,eredar,319,warlock,destruction,11,4,7
Empra,stormscale,304,warlock,destruction,7,4,3
Pcbbwarlock,sylvanas,288,warlock,destruction,6,3,3
Wdauwg,nazjatar,288,warlock,destruction,6,3,3
Demónfire,sylvanas,288,warlock,destruction,6,3,3
Aches,sylvanas,288,warlock,destruction,6,3,3
Oarz,blackrock,288,warlock,destruction,6,3,3
Dragmetohêll,blackhand,288,warlock,destruction,6,3,3
Флорэтт,gordunni,288,warlock,destruction,6,3,3
Stopfëar,ysondre,288,warlock,destruction,6,3,3
Варикай,gordunni,288,warlock,destruction,6,3,3
Oonz,sylvanas,288,warlock,destruction,6,3,3
Дракшара,soulflayer,288,warlock,destruction,6,3,3
Zabani,das-syndikat,288,warlock,destruction,6,3,3
Дядяджонн,gordunni,288,warlock,destruction,6,3,3
Нэрфир,soulflayer,288,warlock,destruction,6,3,3
Глотающий,gordunni,288,warlock,destruction,6,3,3
Динодотх,gordunni,288,warlock,destruction,6,3,3
Колмидедди,gordunni,288,warlock,destruction,6,3,3
Donmajor,amanthul,288,warlock,destruction,6,3,3
Винстролман,blackscar,288,warlock,destruction,6,3,3
Exitumos,eredar,288,warlock,destruction,6,3,3
Flatwolenzy,blackrock,288,warlock,destruction,6,3,3
Tschiko,blackrock,288,warlock,destruction,6,3,3
Doublebolt,the-maelstrom,288,warlock,destruction,6,3,3
Amdownbad,kazzak,288,warlock,destruction,6,3,3
Oldasiangirl,blackrock,288,warlock,destruction,6,3,3
Oimera,frostwolf,288,warlock,destruction,6,3,3
Truckpunch,defias-brotherhood,288,warlock,destruction,6,3,3
Maxiabe,hyjal,288,warlock,destruction,6,3,3
Aloxer,sanguino,288,warlock,destruction,6,3,3
Besthun,drakthul,288,warlock,destruction,6,3,3
Zuldanius,stormscale,288,warlock,destruction,6,3,3
Bluh,twisting-nether,288,warlock,destruction,6,3,3
Feardotfive,frostwolf,288,warlock,destruction,6,3,3
Исусилок,deathguard,288,warlock,destruction,6,3,3
Rokudaime,stormscale,288,warlock,destruction,6,3,3
Gulleigh,draenor,288,warlock,destruction,6,3,3
Helvetica,darksorrow,288,warlock,destruction,6,3,3
Contemtus,frostwhisper,288,warlock,destruction,6,3,3
Wisdomness,aszune,288,warlock,destruction,6,3,3
Huaian,darksorrow,288,warlock,destruction,6,3,3
Xaok,dun-modr,288,warlock,destruction,6,3,3
Necrolock,tarren-mill,288,warlock,destruction,6,3,3
Lubomirek,turalyon,288,warlock,destruction,6,3,3
Кайдзуки,howling-fjord,288,warlock,destruction,6,3,3
Gravemxney,tarren-mill,288,warlock,destruction,6,3,3
Lamboo,tarren-mill,288,warlock,destruction,6,3,3
Maevex,stormscale,288,warlock,destruction,6,3,3
Waryald,dun-modr,288,warlock,destruction,6,3,3
Phoyk,blackmoore,288,warlock,destruction,6,3,3
Brodoh,dun-modr,288,warlock,destruction,6,3,3
Wauwish,stormscale,288,warlock,destruction,6,3,3
Blazed,dentarg,288,warlock,destruction,6,3,3
Palmtri,stormscale,288,warlock,destruction,6,3,3
Herador,draenor,288,warlock,destruction,6,3,3
Lockskalle,tarren-mill,288,warlock,destruction,6,3,3
Ghosthound,stormscale,288,warlock,destruction,6,3,3
Talt,dalaran,288,warlock,destruction,6,3,3
Macchíato,ragnaros,288,warlock,destruction,6,3,3
Mightnáré,tarren-mill,288,warlock,destruction,6,3,3
Maquan,blackmoore,288,warlock,destruction,6,3,3
Sehere,ragnaros,288,warlock,destruction,6,3,3
Smegwlock,tarren-mill,288,warlock,destruction,6,3,3
Bh,ragnaros,288,warlock,destruction,6,3,3
Saymore,ragnaros,288,warlock,destruction,6,3,3
Brudergottes,blackmoore,288,warlock,destruction,6,3,3
Dexterlol,blackmoore,288,warlock,destruction,6,3,3
Læssêkøñgð,twisting-nether,288,warlock,destruction,6,3,3
Hammern,haomarush,288,warlock,destruction,6,3,3
Pederpan,stormscale,288,warlock,destruction,6,3,3
Cpump,twisting-nether,288,warlock,destruction,6,3,3
Fandusttwo,drakthul,288,warlock,destruction,6,3,3
Arizyoxot,twisting-nether,288,warlock,destruction,6,3,3
Laanik,twisting-nether,288,warlock,destruction,6,3,3
Drozhna,kaelthas,288,warlock,destruction,6,3,3
Frankieboi,drakthul,288,warlock,destruction,6,3,3
Drith,blades-edge,288,warlock,destruction,6,3,3
Dekawa,ravencrest,288,warlock,destruction,6,3,3
Dement,sanguino,288,warlock,destruction,6,3,3
Lockki,blades-edge,288,warlock,destruction,6,3,3
Hasselbalch,azshara,288,warlock,destruction,6,3,3
Wäisted,ravencrest,288,warlock,destruction,6,3,3
Aspas,outland,288,warlock,destruction,6,3,3
Flaming,ravencrest,288,warlock,destruction,6,3,3
Ragdoll,twisting-nether,288,warlock,destruction,6,3,3
Dmger,twisting-nether,288,warlock,destruction,6,3,3
Aghmar,ravencrest,288,warlock,destruction,6,3,3
Bualock,stormscale,288,warlock,destruction,6,3,3
Darkà,rexxar,288,warlock,destruction,6,3,3
Kolosh,twisting-nether,288,warlock,destruction,6,3,3
Boltez,twisting-nether,288,warlock,destruction,6,3,3
Elmîr,blackmoore,288,warlock,destruction,6,3,3
Epoku,stormscale,288,warlock,destruction,6,3,3
Zzooxx,silvermoon,288,warlock,destruction,6,3,3
Djshyasiañ,perenolde,288,warlock,destruction,6,3,3
Xoregar,nemesis,288,warlock,destruction,6,3,3
Dadylock,silvermoon,288,warlock,destruction,6,3,3
Irukandji,chants-éternels,288,warlock,destruction,6,3,3
Cálamity,magtheridon,288,warlock,destruction,6,3,3
Dieger,thunderhorn,288,warlock,destruction,6,3,3
Hiroyukí,frostmane,288,warlock,destruction,6,3,3
Noskillfox,outland,288,warlock,destruction,6,3,3
Wajiggity,ravencrest,288,warlock,destruction,6,3,3
Darkleci,archimonde,288,warlock,destruction,6,3,3
Adreal,burning-legion,288,warlock,destruction,6,3,3
Phántom,frostmane,288,warlock,destruction,6,3,3
Sateerik,draenor,288,warlock,destruction,6,3,3
Toskanoamani,blackmoore,288,warlock,destruction,6,3,3
Bte,draenor,288,warlock,destruction,6,3,3
Huaraches,stormscale,288,warlock,destruction,6,3,3
Hairylock,outland,288,warlock,destruction,6,3,3
Deamheòlas,ravencrest,288,warlock,destruction,6,3,3
Nargøf,outland,288,warlock,destruction,6,3,3
Dreameater,twilights-hammer,288,warlock,destruction,12,3,9
Lockned,outland,288,warlock,destruction,12,3,9
Mitrela,ravencrest,288,warlock,destruction,12,3,9
Quief,silvermoon,288,warlock,destruction,12,3,9
Voib,silvermoon,288,warlock,destruction,12,3,9
Svartalfen,outland,288,warlock,destruction,12,3,9
Dotzillâ,blackhand,288,warlock,destruction,12,3,9
Мирмех,gordunni,288,warlock,destruction,12,3,9
Пучкова,azuregos,288,warlock,destruction,12,3,9
Elvània,eredar,288,warlock,destruction,12,3,9
Nathgar,drakthul,288,warlock,destruction,12,3,9
Killerbeez,burning-blade,288,warlock,destruction,12,3,9
Haedri,kazzak,288,warlock,destruction,12,3,9
Phéar,deathwing,288,warlock,destruction,12,3,9
Ladodida,darkspear,288,warlock,destruction,12,3,9
Werlock,sanguino,288,warlock,destruction,12,3,9
Demohoror,stormscale,288,warlock,destruction,12,3,9
Tiffyilock,blackrock,288,warlock,destruction,12,3,9
Дольпико,howling-fjord,288,warlock,destruction,12,3,9
Peggybrown,turalyon,288,warlock,destruction,12,3,9
Ðæthpäct,dalaran,288,warlock,destruction,12,3,9
Èrmes,eldrethalas,288,warlock,destruction,12,3,9
Tepelkwastje,twisting-nether,288,warlock,destruction,12,3,9
Jaines,forscherliga,288,warlock,destruction,12,3,9
Yasagoth,chamber-of-aspects,288,warlock,destruction,12,3,9
Gnargamehl,nemesis,288,warlock,destruction,12,3,9
Fewton,eonar,288,warlock,destruction,18,3,15
Sitosa,todeswache,287,warlock,destruction,6,3,3
Грашек,soulflayer,287,warlock,destruction,6,3,3
Destri,blackmoore,286,warlock,destruction,6,3,3
Fearing,malganis,255,warlock,destruction,11,3,8
Insertchaos,draenor,239,warlock,destruction,5,3,2
Telaldrah,argent-dawn,239,warlock,destruction,5,3,2
Kelek,anachronos,239,warlock,destruction,5,3,2
Jamzywarlock,kazzak,239,warlock,destruction,5,3,2
Вроман,fordragon,234,warlock,destruction,10,5,5
Diemilch,blackmoore,234,warlock,destruction,8,4,4
Yenéx,blackhand,222,warlock,destruction,14,3,11
Vexsir,kazzak,192,warlock,destruction,9,3,6
Vortëxx,tarren-mill,192,warlock,destruction,9,3,6
Stepwarlock,kazzak,192,warlock,destruction,6,2,4
Шайтанарба,blackscar,192,warlock,destruction,6,2,4
Zigfipszen,blackmoore,192,warlock,destruction,6,2,4
Siìre,ravencrest,192,warlock,destruction,6,2,4
Colevid,blackmoore,192,warlock,destruction,6,2,4
Chaotìc,nemesis,192,warlock,destruction,6,2,4
Prestige,nemesis,192,warlock,destruction,6,2,4
Werkx,archimonde,192,warlock,destruction,6,2,4
Bulgyeøng,archimonde,192,warlock,destruction,6,2,4
Sargal,sylvanas,192,warlock,destruction,6,2,4
Cosec,silvermoon,192,warlock,destruction,6,2,4
Muninnus,archimonde,192,warlock,destruction,6,2,4
Guldãn,silvermoon,192,warlock,destruction,6,2,4
Ívânguldán,twisting-nether,192,warlock,destruction,6,2,4
Houndread,kazzak,192,warlock,destruction,6,2,4
Jillyãen,hyjal,192,warlock,destruction,6,2,4
Bloodysûgar,blackmoore,192,warlock,destruction,6,2,4
Grandulf,ravencrest,192,warlock,destruction,6,2,4
Валак,greymane,192,warlock,destruction,6,2,4
Necrofearz,sylvanas,192,warlock,destruction,6,2,4
Rakoru,blackmoore,192,warlock,destruction,6,2,4
Mellisandre,hellfire,192,warlock,destruction,6,2,4
Warlockxx,ravencrest,192,warlock,destruction,6,2,4
Майдум,soulflayer,192,warlock,destruction,6,2,4
Ðiavel,kazzak,192,warlock,destruction,6,2,4
Yourdeaath,ravencrest,192,warlock,destruction,6,2,4
Zkrwl,kazzak,192,warlock,destruction,6,2,4
Kotihoitaja,stormreaver,192,warlock,destruction,6,2,4
Aurelíá,ravencrest,192,warlock,destruction,6,2,4
Guldån,twisting-nether,192,warlock,destruction,6,2,4
Absúrd,turalyon,192,warlock,destruction,6,2,4
Sinlockz,tarren-mill,192,warlock,destruction,6,2,4
Cptdotalot,tarren-mill,192,warlock,destruction,6,2,4
Уставок,soulflayer,192,warlock,destruction,6,2,4
Saabnoolock,ragnaros,192,warlock,destruction,6,2,4
Zenaidaa,doomhammer,192,warlock,destruction,6,2,4
Kontanthjælp,tarren-mill,192,warlock,destruction,6,2,4
Ðaddyy,stormscale,192,warlock,destruction,6,2,4
Selur,ragnaros,192,warlock,destruction,6,2,4
Cindela,eredar,192,warlock,destruction,6,2,4
Hheavens,ragnaros,192,warlock,destruction,6,2,4
Шэдоубёрн,soulflayer,192,warlock,destruction,6,2,4
Astralvoid,outland,192,warlock,destruction,6,2,4
Boohyakka,tarren-mill,192,warlock,destruction,6,2,4
Creamcleaner,tarren-mill,192,warlock,destruction,6,2,4
Zerx,malganis,192,warlock,destruction,6,2,4
Jaliyah,outland,192,warlock,destruction,6,2,4
Belzedan,blackrock,192,warlock,destruction,6,2,4
Nerflocks,aggra-português,192,warlock,destruction,6,2,4
Костикк,howling-fjord,192,warlock,destruction,6,2,4
Splojf,the-maelstrom,192,warlock,destruction,6,2,4
Benztruck,blackhand,192,warlock,destruction,6,2,4
Æyna,thrall,192,warlock,destruction,6,2,4
Адоха,howling-fjord,192,warlock,destruction,6,2,4
Piouturass,hyjal,192,warlock,destruction,6,2,4
Pederlock,defias-brotherhood,192,warlock,destruction,6,2,4
Darthvder,sylvanas,192,warlock,destruction,6,2,4
Kabowie,twisting-nether,192,warlock,destruction,6,2,4
Snoggä,antonidas,192,warlock,destruction,6,2,4
Locknroll,terokkar,192,warlock,destruction,6,2,4
Sokyra,tarren-mill,192,warlock,destruction,6,2,4
Хашонмвп,gordunni,192,warlock,destruction,6,2,4
Levitibus,argent-dawn,192,warlock,destruction,6,2,4
Whydidudotha,ravencrest,192,warlock,destruction,6,2,4
Jetset,moonglade,192,warlock,destruction,6,2,4
Zagana,neptulon,192,warlock,destruction,6,2,4
Kemel,thrall,192,warlock,destruction,6,2,4
Melow,sanguino,192,warlock,destruction,6,2,4
Zmataryn,doomhammer,192,warlock,destruction,6,2,4
Lightswitchz,ravencrest,192,warlock,destruction,6,2,4
Merengue,uldum,192,warlock,destruction,6,2,4
Vitrolizz,twilights-hammer,192,warlock,destruction,6,2,4
Kleing,dragonblight,192,warlock,destruction,6,2,4
Парачо,eversong,192,warlock,destruction,6,2,4
Smoulville,sanguino,192,warlock,destruction,6,2,4
Емс,gordunni,192,warlock,destruction,6,2,4
Ravendoor,grim-batol,192,warlock,destruction,6,2,4
Rojas,trollbane,192,warlock,destruction,6,2,4
Daeneerys,skullcrusher,192,warlock,destruction,6,2,4
Legiozock,draenor,192,warlock,destruction,6,2,4
Олимта,blackscar,192,warlock,destruction,6,2,4
Mákas,draenor,192,warlock,destruction,6,2,4
Мерседэсс,gordunni,192,warlock,destruction,6,2,4
Mty,bronze-dragonflight,192,warlock,destruction,6,2,4
Guldän,quelthalas,192,warlock,destruction,6,2,4
Евнухоидизм,gordunni,192,warlock,destruction,6,2,4
Degdeehei,draenor,192,warlock,destruction,6,2,4
Thîras,tarren-mill,192,warlock,destruction,7,2,5
Noctiz,pozzo-delleternità,192,warlock,destruction,7,2,5
Dededimons,stormscale,192,warlock,destruction,8,2,6
Àbraxàs,nemesis,192,warlock,destruction,12,2,10
Línkéd,blackmoore,192,warlock,destruction,12,2,10
Titoss,archimonde,192,warlock,destruction,12,2,10
Amnésïa,eldrethalas,192,warlock,destruction,12,2,10
Kopfkissen,azshara,192,warlock,destruction,12,2,10
Srhal,blackmoore,192,warlock,destruction,12,2,10
Malganas,sylvanas,192,warlock,destruction,12,2,10
Нэйрокризиз,howling-fjord,192,warlock,destruction,12,2,10
Kokainas,dun-modr,192,warlock,destruction,12,2,10
Мглавечная,soulflayer,192,warlock,destruction,12,2,10
Nimwyn,argent-dawn,192,warlock,destruction,12,2,10
Punishteens,blackmoore,192,warlock,destruction,12,2,10
Zùrghan,elune,191,warlock,destruction,4,3,1
Vraduk,malygos,191,warlock,destruction,6,2,4
Arlu,blackrock,191,warlock,destruction,6,2,4
Watchlock,burning-legion,191,warlock,destruction,6,2,4
Karjarock,hyjal,191,warlock,destruction,12,2,10
Helikopter,shattered-hand,175,warlock,destruction,6,3,3
Hp,ysondre,159,warlock,destruction,5,2,3
Jiltoks,blackmoore,159,warlock,destruction,5,2,3
Hahahahah,draenor,159,warlock,destruction,5,2,3
Grimlòck,antonidas,159,warlock,destruction,5,2,3
Dony,dun-morogh,159,warlock,destruction,5,2,3
Pewnedmpx,archimonde,159,warlock,destruction,5,2,3
Vahk,uldum,138,warlock,destruction,7,3,4
Alucena,silvermoon,138,warlock,destruction,10,4,6
Rb,anachronos,138,warlock,destruction,8,3,5
Delen,ravencrest,128,warlock,destruction,4,2,2
Перегном,blackscar,127,warlock,destruction,8,2,6
Mqsxw,stormscale,112,warlock,destruction,7,2,5
Oggelock,tarren-mill,96,warlock,destruction,3,2,1
Âkâl,ravencrest,96,warlock,destruction,3,2,1
Mulimarus,die-todeskrallen,96,warlock,destruction,3,2,1
Mergon,ravencrest,96,warlock,destruction,3,2,1
Jûgøbænned,aegwynn,96,warlock,destruction,3,2,1
Киёкка,howling-fjord,96,warlock,destruction,6,1,5
Indifférence,archimonde,96,warlock,destruction,6,1,5
Vsmna,ragnaros,96,warlock,destruction,6,1,5
Dalfgan,wildhammer,96,warlock,destruction,6,1,5
Pilock,stormscale,96,warlock,destruction,6,1,5
Gothgul,sanguino,96,warlock,destruction,6,1,5
Chaostheory,stormscale,96,warlock,destruction,6,1,5
Tropìcal,grim-batol,96,warlock,destruction,6,1,5
Merelock,eonar,96,warlock,destruction,6,1,5
Daemonic,shattered-hand,96,warlock,destruction,6,1,5
Nulo,aggra-português,96,warlock,destruction,6,1,5
Wt,twisting-nether,96,warlock,destruction,6,1,5
Lilskunk,draenor,96,warlock,destruction,6,1,5
Dabezdwl,outland,96,warlock,destruction,6,1,5
Walchia,kazzak,96,warlock,destruction,6,1,5
Стоишьвфире,gordunni,96,warlock,destruction,6,1,5
Gulzgan,kazzak,96,warlock,destruction,6,1,5
Wuahlock,doomhammer,96,warlock,destruction,6,1,5
Shompaqzan,kazzak,96,warlock,destruction,6,1,5
Matheus,zenedar,96,warlock,destruction,6,1,5
Камнилока,booty-bay,96,warlock,destruction,6,1,5
Rigour,silvermoon,96,warlock,destruction,6,1,5
Agathaharkne,minahonda,96,warlock,destruction,6,1,5
Satânius,les-sentinelles,96,warlock,destruction,6,1,5
Neuth,draenor,96,warlock,destruction,6,1,5
Deamions,ravencrest,96,warlock,destruction,6,1,5
Kokonix,defias-brotherhood,96,warlock,destruction,6,1,5
Bytethisx,aggra-português,96,warlock,destruction,6,1,5
Azgaroth,kazzak,96,warlock,destruction,6,1,5
Lomendro,blackmoore,96,warlock,destruction,6,1,5
Tanatos,tarren-mill,96,warlock,destruction,6,1,5
Hørcrux,ravencrest,96,warlock,destruction,6,1,5
Kneereap,antonidas,96,warlock,destruction,6,1,5
Thaliä,tarren-mill,96,warlock,destruction,6,1,5
Маверрикк,gordunni,96,warlock,destruction,6,1,5
Snollerboy,antonidas,96,warlock,destruction,6,1,5
Ramuhn,antonidas,96,warlock,destruction,6,1,5
Musallat,argent-dawn,96,warlock,destruction,6,1,5
Иммолэйтх,gordunni,96,warlock,destruction,6,1,5
Bigbabalock,frostwolf,96,warlock,destruction,6,1,5
Loel,blackrock,96,warlock,destruction,6,1,5
Tiig,blackrock,96,warlock,destruction,6,1,5
Ackorax,kilrogg,96,warlock,destruction,6,1,5
Keilahkang,aerie-peak,96,warlock,destruction,12,1,11
Democraft,the-maelstrom,96,warlock,destruction,12,1,11
Alithia,sylvanas,96,warlock,destruction,12,1,11
Malagate,sylvanas,96,warlock,destruction,12,1,11
Grêenbull,eredar,96,warlock,destruction,15,1,14
Magosnik,archimonde,79,warlock,destruction,5,1,4
Néca,blackmoore,64,warlock,destruction,4,1,3
Coblac,outland,48,warlock,destruction,3,1,2
Anthor,tarren-mill,42,warlock,destruction,8,2,6
Obichamcici,tarren-mill,42,warlock,destruction,8,2,6
Chandelierh,kazzak,31,warlock,destruction,2,1,1
Zuldiá,stormscale,16,warlock,destruction,1,1,0
Orkamorfin,silvermoon,16,warlock,destruction,1,1,0
Dyingdog,kazzak,2173,warrior,fury,67,38,29
Gottdustin,lothar,2124,warrior,fury,143,78,65
Quanny,die-aldor,2102,warrior,fury,114,67,47
Níghtfúry,ravencrest,2102,warrior,fury,84,43,41
Thorana,twisting-nether,2036,warrior,fury,275,136,139
Corvínus,blackrock,2025,warrior,fury,102,55,47
Gregorez,silvermoon,1942,warrior,fury,72,42,30
Schultze,kazzak,1941,warrior,fury,113,49,64
Thezug,blackmoore,1935,warrior,fury,96,48,48
Sublex,blackrock,1933,warrior,fury,60,34,26
Дахирарг,fordragon,1911,warrior,fury,66,35,31
Pflanzling,nozdormu,1883,warrior,fury,72,36,36
Insanedmg,dun-modr,1864,warrior,fury,72,40,32
Émalkay,tarren-mill,1863,warrior,fury,48,26,22
Brythwyn,antonidas,1856,warrior,fury,54,30,24
Wruxar,bronzebeard,1856,warrior,fury,54,29,25
Kwesta,kazzak,1850,warrior,fury,60,34,26
Yaler,alakir,1847,warrior,fury,48,33,15
Jeco,tarren-mill,1846,warrior,fury,66,39,27
Luxurious,argent-dawn,1842,warrior,fury,66,40,26
Sockerbagarn,zenedar,1840,warrior,fury,55,27,28
Sublex,aegwynn,1838,warrior,fury,60,36,24
Råzor,blackhand,1826,warrior,fury,154,92,62
Imolderthenu,blackrock,1825,warrior,fury,166,91,75
Kenryu,argent-dawn,1825,warrior,fury,60,32,28
Sonnyzz,sanguino,1824,warrior,fury,36,21,15
Timewarrior,ravencrest,1824,warrior,fury,54,30,24
Deatheart,ysondre,1824,warrior,fury,76,41,35
Трэйдар,blackscar,1823,warrior,fury,48,27,21
Sporctaco,nemesis,1821,warrior,fury,130,66,64
Frozenliøn,twisting-nether,1817,warrior,fury,42,29,13
Letiis,blackrock,1816,warrior,fury,105,57,48
Uretirips,archimonde,1815,warrior,fury,66,39,27
Geez,burning-blade,1815,warrior,fury,36,21,15
Adian,ravencrest,1813,warrior,fury,42,26,16
Zednos,twilights-hammer,1812,warrior,fury,184,102,82
Schlauberg,azshara,1811,warrior,fury,48,29,19
Xzwarr,silvermoon,1810,warrior,fury,38,21,17
Мигнт,howling-fjord,1810,warrior,fury,42,23,19
Capitalista,das-konsortium,1809,warrior,fury,90,51,39
Clellin,silvermoon,1807,warrior,fury,139,80,59
Späns,ragnaros,1807,warrior,fury,71,34,37
Zyalen,stormscale,1806,warrior,fury,60,32,28
Kizzyo,draenor,1804,warrior,fury,96,51,45
Nóvamh,draenor,1802,warrior,fury,42,24,18
Sonnylolxd,dun-modr,1800,warrior,fury,54,29,25
Robycoleman,nemesis,1798,warrior,fury,138,74,64
Yawalad,stormscale,1795,warrior,fury,60,32,28
Cesr,bloodhoof,1788,warrior,fury,66,39,27
Badon,burning-legion,1783,warrior,fury,54,35,19
Castlevania,ravencrest,1782,warrior,fury,72,37,35
Rïmxøxø,haomarush,1773,warrior,fury,48,32,16
Tóffèl,thrall,1773,warrior,fury,48,32,16
Ryonâgai,aegwynn,1773,warrior,fury,54,30,24
Злопиканка,gordunni,1769,warrior,fury,61,31,30
Warrez,azuremyst,1768,warrior,fury,65,42,23
Elsensor,sylvanas,1760,warrior,fury,66,27,39
Unstopablle,twisting-nether,1755,warrior,fury,78,47,31
Xeraaya,kirin-tor,1746,warrior,fury,48,24,24
Irontouch,draenor,1742,warrior,fury,48,29,19
Эйримор,gordunni,1742,warrior,fury,113,61,52
Plackø,draenor,1738,warrior,fury,41,26,15
Peli,burning-blade,1738,warrior,fury,201,104,97
Рыгатрон,galakrond,1732,warrior,fury,36,19,17
Читора,blackscar,1726,warrior,fury,47,27,20
Juna,hellscream,1726,warrior,fury,91,47,44
Даймонддогс,gordunni,1725,warrior,fury,64,36,28
Кавайтити,blackscar,1718,warrior,fury,39,19,20
Варынеопэ,gordunni,1717,warrior,fury,65,35,30
Dyingdogs,kazzak,1717,warrior,fury,42,21,21
Тьмасвятая,gordunni,1710,warrior,fury,42,22,20
Варплеер,gordunni,1708,warrior,fury,30,18,12
Stansmash,kazzak,1704,warrior,fury,30,18,12
Cuzyxtwo,blackrock,1704,warrior,fury,48,27,21
Ðunhammer,blackmoore,1700,warrior,fury,54,26,28
Yodabär,blackmoore,1690,warrior,fury,120,62,58
Slaycon,sanguino,1680,warrior,fury,63,26,37
Zadirich,burning-blade,1679,warrior,fury,48,25,23
Даркслеерх,howling-fjord,1674,warrior,fury,36,18,18
Бубаигавар,gordunni,1673,warrior,fury,42,22,20
Âshnâzgðûr,burning-blade,1671,warrior,fury,66,28,38
Vÿnk,ysondre,1669,warrior,fury,80,45,35
Pouckette,hyjal,1668,warrior,fury,54,29,25
Ranmaru,kazzak,1665,warrior,fury,97,46,51
Broley,blackhand,1663,warrior,fury,46,30,16
Níká,bronzebeard,1663,warrior,fury,52,30,22
Susugar,ysondre,1663,warrior,fury,40,21,19
Gladius,blutkessel,1662,warrior,fury,102,47,55
Averenx,frostwolf,1659,warrior,fury,110,57,53
Vesnãpusic,draenor,1655,warrior,fury,45,29,16
Azazelslayer,dethecus,1652,warrior,fury,54,38,16
Очепенец,soulflayer,1652,warrior,fury,129,66,63
Kocmochka,tarren-mill,1651,warrior,fury,36,22,14
Дарккардинал,deathguard,1651,warrior,fury,64,30,34
Roxxyy,stormreaver,1650,warrior,fury,47,29,18
Noproblem,ragnaros,1650,warrior,fury,65,34,31
Хенгард,gordunni,1647,warrior,fury,48,26,22
Elsensør,thrall,1642,warrior,fury,46,22,24
Discoklaus,blackmoore,1639,warrior,fury,162,81,81
Футжисубо,razuvious,1639,warrior,fury,42,20,22
Протектор,soulflayer,1638,warrior,fury,124,60,64
Шлифую,howling-fjord,1636,warrior,fury,60,30,30
Вадло,soulflayer,1635,warrior,fury,54,27,27
Bastquirage,dalaran,1633,warrior,fury,42,24,18
Osha,hyjal,1630,warrior,fury,144,72,72
Iagô,argent-dawn,1627,warrior,fury,48,28,20
Криккс,greymane,1625,warrior,fury,66,32,34
Ðønøvan,sanguino,1624,warrior,fury,58,32,26
Гринфинч,galakrond,1623,warrior,fury,53,28,25
Flówér,auchindoun,1617,warrior,fury,24,17,7
Walexmaryk,ragnaros,1617,warrior,fury,113,61,52
Discølove,frostwolf,1615,warrior,fury,35,19,16
Латахо,gordunni,1614,warrior,fury,36,20,16
Dronikos,ravencrest,1612,warrior,fury,36,22,14
Celn,silvermoon,1608,warrior,fury,145,80,65
Koljach,sylvanas,1608,warrior,fury,127,66,61
Jetman,ravencrest,1605,warrior,fury,40,19,21
Ebonheart,argent-dawn,1599,warrior,fury,59,32,27
Narukeratnik,draenor,1596,warrior,fury,60,36,24
Megalann,silvermoon,1596,warrior,fury,78,37,41
Abnôrmus,tarren-mill,1594,warrior,fury,114,53,61
Lífelover,tarren-mill,1593,warrior,fury,66,30,36
Methodxd,outland,1592,warrior,fury,72,35,37
Zupkaztrópka,burning-legion,1587,warrior,fury,89,47,42
Берззлой,gordunni,1587,warrior,fury,46,24,22
Lair,zuljin,1584,warrior,fury,42,26,16
Bønecleaver,blackrock,1584,warrior,fury,62,33,29
Méido,argent-dawn,1584,warrior,fury,222,112,110
Элинглир,gordunni,1580,warrior,fury,39,22,17
Ðènlos,destromath,1580,warrior,fury,60,29,31
Байсал,gordunni,1579,warrior,fury,42,22,20
Grâkul,twisting-nether,1571,warrior,fury,115,60,55
Asmoche,archimonde,1571,warrior,fury,60,29,31
Garlogar,twisting-nether,1569,warrior,fury,108,59,49
ßbç,ysondre,1565,warrior,fury,72,36,36
Stahlhund,silvermoon,1564,warrior,fury,87,47,40
Kwedrowar,burning-legion,1564,warrior,fury,60,30,30
Касюлин,gordunni,1562,warrior,fury,53,31,22
Мурмадонио,soulflayer,1562,warrior,fury,42,19,23
Сариату,soulflayer,1556,warrior,fury,72,34,38
Wornag,argent-dawn,1555,warrior,fury,47,21,26
Добиватель,howling-fjord,1554,warrior,fury,42,26,16
Waralert,kazzak,1553,warrior,fury,36,19,17
Sanngridr,defias-brotherhood,1545,warrior,fury,36,18,18
Slidmacka,twisting-nether,1539,warrior,fury,36,24,12
Thagzar,burning-legion,1536,warrior,fury,71,36,35
Ананаслорд,blackscar,1535,warrior,fury,26,18,8
Wabisabì,silvermoon,1534,warrior,fury,35,18,17
Hejduk,frostmane,1533,warrior,fury,30,20,10
Telrion,silvermoon,1525,warrior,fury,30,16,14
Вундеркитти,soulflayer,1520,warrior,fury,48,23,25
Bözzy,stormreaver,1518,warrior,fury,120,60,60
Skylexs,burning-legion,1517,warrior,fury,36,16,20
Zwecko,malganis,1513,warrior,fury,30,16,14
Halfbroken,moonglade,1511,warrior,fury,48,19,29
Pokopo,blackrock,1510,warrior,fury,42,23,19
Втораянатура,howling-fjord,1508,warrior,fury,36,22,14
Вменяемый,gordunni,1508,warrior,fury,53,26,27
Темнозорь,ashenvale,1504,warrior,fury,30,16,14
Truckfury,ravencrest,1504,warrior,fury,88,46,42
Jarggyül,culte-de-la-rive-noire,1500,warrior,fury,36,21,15
Crriminal,ravencrest,1498,warrior,fury,24,16,8
Sebastian,ravencrest,1498,warrior,fury,60,29,31
Неуно,howling-fjord,1494,warrior,fury,36,22,14
Certavus,antonidas,1494,warrior,fury,42,21,21
Evrybodydown,draenor,1492,warrior,fury,148,77,71
Лимор,howling-fjord,1488,warrior,fury,42,16,26
Ärmodäuss,norgannon,1486,warrior,fury,63,31,32
Варрвик,howling-fjord,1486,warrior,fury,39,19,20
Gronos,silvermoon,1485,warrior,fury,31,16,15
Harbee,stormscale,1484,warrior,fury,72,41,31
Gìlgamesh,dun-modr,1478,warrior,fury,37,22,15
Wøokz,argent-dawn,1475,warrior,fury,136,66,70
Whimbux,stormscale,1474,warrior,fury,39,21,18
Krieg,garrosh,1464,warrior,fury,47,18,29
Craghak,twisting-nether,1463,warrior,fury,76,38,38
Roidspam,outland,1463,warrior,fury,53,18,35
Нордгаар,howling-fjord,1462,warrior,fury,30,18,12
Анакронокс,howling-fjord,1461,warrior,fury,58,29,29
Zeliøn,elune,1460,warrior,fury,72,44,28
Grubshak,burning-legion,1460,warrior,fury,47,22,25
Bobitybob,ravencrest,1457,warrior,fury,36,22,14
Èscøbar,dalaran,1454,warrior,fury,49,23,26
Zugbro,stormscale,1452,warrior,fury,48,25,23
Hrodulf,moonglade,1448,warrior,fury,78,35,43
Jorund,archimonde,1445,warrior,fury,36,17,19
Jyukei,archimonde,1442,warrior,fury,24,17,7
Арестант,soulflayer,1442,warrior,fury,95,53,42
Спайкуссь,goldrinn,1440,warrior,fury,36,21,15
Dragão,kazzak,1440,warrior,fury,60,28,32
Lillebibbi,tarren-mill,1438,warrior,fury,35,16,19
Zaximos,twisting-nether,1433,warrior,fury,33,17,16
Tweegles,argent-dawn,1433,warrior,fury,65,31,34
Boos,burning-legion,1432,warrior,fury,24,15,9
Thorken,ragnaros,1431,warrior,fury,36,16,20
Kobeni,ysondre,1429,warrior,fury,44,26,18
Fridaax,lightbringer,1427,warrior,fury,24,15,9
Tatabaf,ysondre,1426,warrior,fury,30,17,13
Хуфхорнс,soulflayer,1425,warrior,fury,27,16,11
Гронвер,soulflayer,1425,warrior,fury,50,27,23
Æsterius,blackmoore,1423,warrior,fury,83,41,42
Antismoke,silvermoon,1423,warrior,fury,57,28,29
Reidunøks,kazzak,1422,warrior,fury,59,32,27
Madaxe,kazzak,1421,warrior,fury,24,15,9
Arthoc,sanguino,1420,warrior,fury,30,15,15
Profär,archimonde,1419,warrior,fury,30,16,14
Rommick,guldan,1416,warrior,fury,36,17,19
Corrin,frostmourne,1413,warrior,fury,87,48,39
Stratoz,ragnaros,1412,warrior,fury,33,16,17
Hítmachine,outland,1412,warrior,fury,60,29,31
Скехит,blackscar,1412,warrior,fury,42,18,24
Mustar,alexstrasza,1407,warrior,fury,65,37,28
Ganaroth,tarren-mill,1403,warrior,fury,30,18,12
Krauus,silvermoon,1402,warrior,fury,103,56,47
Dödgrävarn,stormscale,1402,warrior,fury,30,15,15
Akînos,kazzak,1400,warrior,fury,57,27,30
Hidaykus,bronzebeard,1399,warrior,fury,70,35,35
Chrissey,argent-dawn,1396,warrior,fury,33,15,18
Bukisan,sylvanas,1395,warrior,fury,42,20,22
Unchåined,burning-legion,1390,warrior,fury,45,22,23
Keriane,garona,1389,warrior,fury,65,33,32
Штормскейл,soulflayer,1388,warrior,fury,30,16,14
Васильна,soulflayer,1384,warrior,fury,30,19,11
Botgrinder,blackhand,1377,warrior,fury,29,20,9
Terisá,blackmoore,1377,warrior,fury,40,20,20
Fîlzlaus,area-52,1375,warrior,fury,30,15,15
Hawkman,outland,1374,warrior,fury,23,15,8
Torok,antonidas,1372,warrior,fury,30,21,9
Zêke,thrall,1369,warrior,fury,18,16,2
Inconcussae,drakthul,1369,warrior,fury,24,16,8
Somalisktjur,tarren-mill,1369,warrior,fury,30,17,13
Нириэла,howling-fjord,1367,warrior,fury,60,27,33
Touguro,aggra-português,1366,warrior,fury,45,18,27
Borntothis,zuljin,1363,warrior,fury,68,39,29
Gruttak,aegwynn,1361,warrior,fury,24,16,8
Ribastur,blackmoore,1361,warrior,fury,138,74,64
Toundrâa,archimonde,1360,warrior,fury,105,51,54
Realz,malganis,1359,warrior,fury,60,32,28
Wärfäcë,blades-edge,1357,warrior,fury,40,23,17
Чпонькмашина,soulflayer,1357,warrior,fury,54,30,24
Dõxlol,kazzak,1343,warrior,fury,18,14,4
Zíreael,ravencrest,1342,warrior,fury,60,29,31
Grimli,burning-legion,1341,warrior,fury,36,22,14
Stretch,thrall,1341,warrior,fury,31,15,16
Mitu,sanguino,1338,warrior,fury,24,14,10
Kundrak,blackhand,1334,warrior,fury,37,19,18
Killhound,argent-dawn,1332,warrior,fury,24,14,10
Акози,fordragon,1332,warrior,fury,60,33,27
Kragar,anetheron,1329,warrior,fury,45,25,20
Жироштемп,gordunni,1329,warrior,fury,34,15,19
Skefe,archimonde,1327,warrior,fury,34,21,13
Джелорд,howling-fjord,1326,warrior,fury,30,14,16
Deusi,garrosh,1324,warrior,fury,48,28,20
Buzzingwarr,tarren-mill,1318,warrior,fury,60,29,31
Svênsk,argent-dawn,1317,warrior,fury,32,17,15
Xsasuke,ragnaros,1317,warrior,fury,36,17,19
Tigron,burning-legion,1314,warrior,fury,24,16,8
Слайдус,gordunni,1313,warrior,fury,44,25,19
Вархаус,blackscar,1313,warrior,fury,39,21,18
Ninja,bronze-dragonflight,1312,warrior,fury,87,42,45
Барабумм,soulflayer,1310,warrior,fury,77,41,36
Ælvstan,argent-dawn,1310,warrior,fury,59,30,29
Ryù,dun-modr,1310,warrior,fury,30,14,16
Старопрамен,thermaplugg,1309,warrior,fury,145,74,71
Midvînter,silvermoon,1307,warrior,fury,33,15,18
Bigrooster,argent-dawn,1303,warrior,fury,102,52,50
Reckless,tarren-mill,1300,warrior,fury,42,22,20
Tragix,hyjal,1300,warrior,fury,42,18,24
Toughwar,tarren-mill,1297,warrior,fury,42,24,18
Kirkwood,terokkar,1297,warrior,fury,41,23,18
Машамеч,blackscar,1289,warrior,fury,84,42,42
Buzzingorc,tarren-mill,1285,warrior,fury,60,32,28
Usz,thunderhorn,1284,warrior,fury,30,19,11
Суммрак,grom,1284,warrior,fury,30,15,15
Rìsàs,draenor,1282,warrior,fury,125,57,68
Sammäel,eldrethalas,1281,warrior,fury,36,19,17
Trollboii,ravencrest,1274,warrior,fury,27,14,13
Haewon,burning-legion,1273,warrior,fury,47,22,25
Wariio,khaz-modan,1272,warrior,fury,47,27,20
Honeymew,draenor,1271,warrior,fury,66,27,39
Watntietnn,burning-blade,1268,warrior,fury,49,24,25
Unn,ragnaros,1266,warrior,fury,42,20,22
Zerm,draenor,1262,warrior,fury,24,15,9
Gritzi,dragonblight,1262,warrior,fury,60,29,31
Бормормуш,gordunni,1261,warrior,fury,73,30,43
Dundulinka,outland,1255,warrior,fury,46,17,29
Neopronouns,stormscale,1248,warrior,fury,18,13,5
Immørtálx,tarren-mill,1248,warrior,fury,24,13,11
Рагнарульв,gordunni,1248,warrior,fury,36,15,21
Oughn,silvermoon,1247,warrior,fury,39,19,20
Stóna,blackmoore,1247,warrior,fury,36,13,23
Warrzor,auchindoun,1246,warrior,fury,30,13,17
Котаче,soulflayer,1242,warrior,fury,24,13,11
Eygón,silvermoon,1241,warrior,fury,24,13,11
Tàuruss,blackhand,1241,warrior,fury,34,18,16
Рсдрпб,eversong,1241,warrior,fury,30,15,15
Lâmy,khaz-modan,1240,warrior,fury,60,26,34
Arkataz,argent-dawn,1239,warrior,fury,24,13,11
Fizzywarrior,blackmoore,1239,warrior,fury,24,13,11
Alexandrrior,rexxar,1237,warrior,fury,18,13,5
Mamox,archimonde,1236,warrior,fury,25,14,11
Azzog,archimonde,1234,warrior,fury,80,44,36
Dizzyndumb,draenor,1228,warrior,fury,80,38,42
Кимиюки,gordunni,1228,warrior,fury,30,13,17
Skullfondler,argent-dawn,1226,warrior,fury,24,13,11
Quigatron,frostmane,1225,warrior,fury,42,25,17
Schmetterina,proudmoore,1223,warrior,fury,49,28,21
Thors,deathwing,1211,warrior,fury,76,38,38
Delinde,cthun,1209,warrior,fury,93,45,48
Warrmax,darksorrow,1208,warrior,fury,42,22,20
Аштау,howling-fjord,1204,warrior,fury,97,42,55
Toporceanul,kazzak,1201,warrior,fury,41,14,27
Zetsurin,sylvanas,1201,warrior,fury,42,14,28
Agitoyami,defias-brotherhood,1200,warrior,fury,60,34,26
Ragecap,rexxar,1198,warrior,fury,36,16,20
Жужащий,howling-fjord,1197,warrior,fury,74,31,43
Blaying,ravencrest,1192,warrior,fury,23,13,10
Nubá,burning-legion,1187,warrior,fury,36,24,12
Saey,malorne,1186,warrior,fury,42,18,24
Азктор,soulflayer,1186,warrior,fury,35,15,20
Warinator,ravencrest,1177,warrior,fury,19,14,5
Coyle,eredar,1175,warrior,fury,98,42,56
Hobbó,draenor,1175,warrior,fury,48,13,35
Номер,eversong,1174,warrior,fury,126,56,70
Kebra,blackmoore,1170,warrior,fury,57,32,25
Tato,frostmourne,1165,warrior,fury,23,13,10
Rofos,hellscream,1161,warrior,fury,28,13,15
Säl,ragnaros,1160,warrior,fury,31,17,14
Joeférnandes,ragnaros,1152,warrior,fury,18,12,6
Tanja,bronzebeard,1151,warrior,fury,24,12,12
Исскатель,gordunni,1150,warrior,fury,12,12,0
Violentfunky,ravencrest,1150,warrior,fury,24,12,12
Артен,ashenvale,1149,warrior,fury,18,12,6
Baoni,hyjal,1144,warrior,fury,30,12,18
Bluemango,ragnaros,1141,warrior,fury,24,12,12
Itchiiz,alonsus,1138,warrior,fury,24,12,12
Андервульф,booty-bay,1137,warrior,fury,30,12,18
Mortalclaw,kazzak,1136,warrior,fury,39,14,25
Exhumator,blackhand,1135,warrior,fury,36,12,24
Tyrâdus,kiljaeden,1128,warrior,fury,24,12,12
Sadjoke,draenor,1125,warrior,fury,30,13,17
Well,kult-der-verdammten,1121,warrior,fury,24,12,12
Nykyro,draenor,1119,warrior,fury,54,23,31
Moustachu,kirin-tor,1118,warrior,fury,27,14,13
Antraex,zuljin,1118,warrior,fury,24,12,12
Shieldlord,kazzak,1117,warrior,fury,77,29,48
Rayeron,sanguino,1115,warrior,fury,54,24,30
Izmadfurax,archimonde,1110,warrior,fury,24,13,11
Красемир,deepholm,1097,warrior,fury,47,23,24
Sabrewølf,blackmoore,1096,warrior,fury,48,24,24
Moggorr,nemesis,1095,warrior,fury,29,12,17
Shalren,nordrassil,1092,warrior,fury,44,23,21
Floppikatten,kazzak,1091,warrior,fury,18,13,5
Копенгаген,ashenvale,1087,warrior,fury,30,16,14
Shadowcacau,aggra-português,1079,warrior,fury,23,12,11
Ragnòk,eredar,1076,warrior,fury,42,15,27
Seka,nozdormu,1068,warrior,fury,60,32,28
Помойник,gordunni,1059,warrior,fury,59,37,22
Bananapower,aszune,1055,warrior,fury,18,11,7
Maroux,malganis,1055,warrior,fury,18,11,7
Eddíemòrphin,kazzak,1055,warrior,fury,18,11,7
Hirbz,silvermoon,1055,warrior,fury,24,13,11
Мастерион,soulflayer,1054,warrior,fury,18,11,7
Spokowar,hyjal,1054,warrior,fury,18,11,7
Грамол,soulflayer,1054,warrior,fury,18,11,7
Chidòri,tarren-mill,1054,warrior,fury,18,11,7
Furyre,ysondre,1054,warrior,fury,25,12,13
Snuzzygeezer,ravencrest,1053,warrior,fury,18,11,7
Oksimbillah,blackrock,1053,warrior,fury,24,11,13
Cocojumbo,azuremyst,1051,warrior,fury,18,11,7
Murgrimm,die-silberne-hand,1051,warrior,fury,45,26,19
Sairos,kirin-tor,1051,warrior,fury,60,33,27
Amagaddon,draenor,1050,warrior,fury,28,12,16
Ranndall,blackrock,1050,warrior,fury,30,12,18
Dríppy,aegwynn,1046,warrior,fury,18,11,7
Whysospicey,lightbringer,1043,warrior,fury,21,12,9
Offpants,drakthul,1041,warrior,fury,30,11,19
Вардеспетчер,razuvious,1040,warrior,fury,24,11,13
Hangovar,thrall,1035,warrior,fury,21,12,9
Tdanielt,burning-legion,1032,warrior,fury,18,11,7
Bigmercy,ragnaros,1031,warrior,fury,24,11,13
Falaliss,elune,1030,warrior,fury,36,18,18
Macgull,ysondre,1028,warrior,fury,30,12,18
Valhrann,dalaran,1024,warrior,fury,24,11,13
Orcgrim,nozdormu,1019,warrior,fury,42,20,22
Gabbz,aggra-português,1018,warrior,fury,27,12,15
Achonar,draenor,1012,warrior,fury,23,11,12
Nogo,nagrand,1010,warrior,fury,38,24,14
Kungeen,silvermoon,1010,warrior,fury,36,12,24
Blaktarr,dunemaul,1003,warrior,fury,21,11,10
Fknmoo,kazzak,997,warrior,fury,78,39,39
Kurko,blackmoore,997,warrior,fury,23,11,12
Xonnico,ravencrest,997,warrior,fury,24,11,13
Fatspacka,argent-dawn,989,warrior,fury,20,11,9
Niozihex,the-maelstrom,984,warrior,fury,36,15,21
Krlebajker,tarren-mill,977,warrior,fury,27,14,13
Эребб,howling-fjord,966,warrior,fury,60,29,31
Pj,sanguino,960,warrior,fury,12,10,2
Thrallhall,kazzak,960,warrior,fury,12,10,2
Borndet,eredar,959,warrior,fury,12,10,2
Highoverlord,aggra-português,959,warrior,fury,18,10,8
Spitonem,blackrock,959,warrior,fury,18,10,8
Solaje,dun-modr,959,warrior,fury,18,10,8
Груббоб,booty-bay,958,warrior,fury,18,10,8
Monbun,silvermoon,958,warrior,fury,18,10,8
Bravestar,ungoro,958,warrior,fury,24,10,14
Budwise,stormscale,957,warrior,fury,18,10,8
Settin,silvermoon,956,warrior,fury,18,10,8
Sperta,frostmourne,956,warrior,fury,36,18,18
Thodak,blackrock,956,warrior,fury,30,10,20
Борзило,howling-fjord,953,warrior,fury,18,10,8
Darriuso,kazzak,952,warrior,fury,24,10,14
Draxxann,ravencrest,946,warrior,fury,12,10,2
Xaturesw,twisting-nether,943,warrior,fury,12,10,2
Stroj,aerie-peak,932,warrior,fury,30,17,13
Mybigcow,darkspear,926,warrior,fury,23,10,13
Bolss,silvermoon,917,warrior,fury,31,11,20
Dirtybugga,nagrand,916,warrior,fury,16,11,5
Rédsonja,chamber-of-aspects,914,warrior,fury,36,18,18
Иктиннос,gordunni,911,warrior,fury,23,10,13
Solatika,alexstrasza,901,warrior,fury,72,38,34
Ogerit,blackmoore,898,warrior,fury,30,14,16
Суферна,howling-fjord,894,warrior,fury,27,13,14
Bëlzé,les-clairvoyants,887,warrior,fury,36,13,23
Enzja,nazjatar,878,warrior,fury,19,10,9
Taurras,nathrezim,878,warrior,fury,47,24,23
Jâbs,hyjal,875,warrior,fury,36,11,25
Licious,outland,864,warrior,fury,12,9,3
Sparkzu,twisting-nether,864,warrior,fury,12,9,3
Kihili,twisting-nether,864,warrior,fury,12,9,3
Ifir,hyjal,864,warrior,fury,18,9,9
Warzzor,auchindoun,864,warrior,fury,18,9,9
Xark,drakthul,864,warrior,fury,18,9,9
Heartmemphis,stormscale,864,warrior,fury,18,9,9
Рэйвисмашина,gordunni,864,warrior,fury,24,9,15
Веоленс,gordunni,863,warrior,fury,12,9,3
Broksigarr,ragnaros,863,warrior,fury,12,9,3
Bartins,magtheridon,863,warrior,fury,12,9,3
Goomby,argent-dawn,863,warrior,fury,18,9,9
Honzakesl,drakthul,863,warrior,fury,18,9,9
Нейв,blackscar,863,warrior,fury,18,9,9
Showerfresh,silvermoon,863,warrior,fury,18,9,9
Picciocino,nemesis,863,warrior,fury,24,9,15
Zyzie,argent-dawn,863,warrior,fury,24,9,15
Tandrall,rexxar,863,warrior,fury,24,9,15
Grimleaper,twisting-nether,862,warrior,fury,18,9,9
Baldemort,antonidas,862,warrior,fury,21,10,11
Тегриско,goldrinn,862,warrior,fury,24,9,15
Throck,drakthul,861,warrior,fury,18,9,9
Toecutter,defias-brotherhood,859,warrior,fury,21,10,11
Valkirya,arthas,859,warrior,fury,24,9,15
Alevucerdaa,draenor,858,warrior,fury,24,9,15
Oxascand,kazzak,856,warrior,fury,27,10,17
Rèckless,argent-dawn,852,warrior,fury,18,12,6
Pollverizer,ghostlands,851,warrior,fury,36,16,20
Ânaxi,silvermoon,831,warrior,fury,14,10,4
Gôrilla,kazzak,831,warrior,fury,20,10,10
Warallari,khaz-modan,829,warrior,fury,18,9,9
Tiscanno,nemesis,828,warrior,fury,24,11,13
Fenr,sanguino,819,warrior,fury,17,11,6
Jøtawarrior,sanguino,815,warrior,fury,17,9,8
Варриорнир,howling-fjord,814,warrior,fury,14,10,4
Jaý,draenor,814,warrior,fury,15,10,5
Flexbot,blackmoore,809,warrior,fury,20,10,10
Gamepresa,silvermoon,783,warrior,fury,13,9,4
Blizo,tarren-mill,768,warrior,fury,12,8,4
Jengaa,draenor,768,warrior,fury,12,8,4
Oowar,burning-legion,768,warrior,fury,12,8,4
Ciuez,tarren-mill,768,warrior,fury,12,8,4
Релайк,gordunni,768,warrior,fury,12,8,4
Zern,draenor,768,warrior,fury,12,8,4
Wgdx,ravencrest,768,warrior,fury,18,8,10
Luphrek,ysondre,768,warrior,fury,18,8,10
Prixor,grim-batol,768,warrior,fury,18,8,10
Joéfernandés,sylvanas,768,warrior,fury,18,8,10
Мастерпве,blackscar,767,warrior,fury,12,8,4
Denshyel,dun-modr,767,warrior,fury,12,8,4
Skeptikal,argent-dawn,767,warrior,fury,12,8,4
Баджераа,soulflayer,767,warrior,fury,12,8,4
Báshx,outland,767,warrior,fury,12,8,4
Míngxuan,tarren-mill,767,warrior,fury,12,8,4
Ðíscøwârrìør,nethersturm,767,warrior,fury,18,8,10
Divyx,tarren-mill,767,warrior,fury,18,8,10
Elainax,eredar,767,warrior,fury,18,8,10
Dallion,azjolnerub,767,warrior,fury,18,8,10
Ødên,frostmane,767,warrior,fury,18,8,10
Gromrigg,draenor,767,warrior,fury,18,8,10
Глинм,gordunni,767,warrior,fury,24,8,16
Ампутиль,gordunni,766,warrior,fury,12,8,4
Thebiggreen,twisting-nether,766,warrior,fury,12,8,4
Лазба,gordunni,766,warrior,fury,16,9,7
Arlan,dragonblight,766,warrior,fury,30,8,22
Сэч,gordunni,765,warrior,fury,12,8,4
Dramiél,tarren-mill,765,warrior,fury,12,8,4
Cuuz,outland,765,warrior,fury,18,8,10
Drswing,kazzak,764,warrior,fury,24,8,16
Greatsword,turalyon,763,warrior,fury,12,8,4
Ipes,blackmoore,763,warrior,fury,15,9,6
Cazzpowa,frostmane,762,warrior,fury,12,8,4
Kaerz,ysondre,762,warrior,fury,18,8,10
Ikkr,kazzak,762,warrior,fury,24,8,16
Khaalo,blackhand,760,warrior,fury,12,8,4
Вагранна,soulflayer,719,warrior,fury,17,8,9
Осгаард,gordunni,711,warrior,fury,21,10,11
Дмидрашх,howling-fjord,672,warrior,fury,10,8,2
Где,blackscar,672,warrior,fury,12,7,5
Quadfather,kazzak,672,warrior,fury,12,7,5
Waroworgen,terokkar,672,warrior,fury,12,7,5
Yserá,auchindoun,672,warrior,fury,12,7,5
Duarel,blackmoore,672,warrior,fury,12,7,5
Lyrv,ravencrest,672,warrior,fury,12,7,5
Uwuwarrior,alleria,672,warrior,fury,12,7,5
Senshin,sanguino,672,warrior,fury,12,7,5
Tidarius,twisting-nether,672,warrior,fury,12,7,5
Zwareboy,frostmane,672,warrior,fury,12,7,5
Фомори,howling-fjord,672,warrior,fury,12,7,5
Skillclapped,ravencrest,672,warrior,fury,12,7,5
Avgorcgodx,stormscale,672,warrior,fury,12,7,5
Faraam,sunstrider,672,warrior,fury,16,8,8
Gramrosh,eredar,672,warrior,fury,18,7,11
Shintuargar,blackrock,672,warrior,fury,18,7,11
Кэйкан,gordunni,672,warrior,fury,18,7,11
Emcix,aszune,672,warrior,fury,18,7,11
Тактоядобрый,ashenvale,672,warrior,fury,18,7,11
Biturboo,blackrock,672,warrior,fury,22,8,14
Dgyfh,dun-morogh,671,warrior,fury,12,7,5
Теокрафт,howling-fjord,671,warrior,fury,12,7,5
Broknagar,draenor,671,warrior,fury,12,7,5
Buffury,twisting-nether,671,warrior,fury,12,7,5
Sargonas,burning-blade,671,warrior,fury,12,7,5
Diioxyde,temple-noir,671,warrior,fury,12,7,5
Sniperwølf,tyrande,671,warrior,fury,12,7,5
Jaowa,blackmoore,671,warrior,fury,18,7,11
Hagoxfit,los-errantes,671,warrior,fury,18,7,11
Джэкмен,soulflayer,670,warrior,fury,12,7,5
Напутанность,soulflayer,670,warrior,fury,18,7,11
Téldrus,blackrock,667,warrior,fury,12,7,5
Garosh,drakthul,666,warrior,fury,12,7,5
Solidier,archimonde,666,warrior,fury,18,7,11
Merdé,blackhand,658,warrior,fury,12,7,5
Tiapollo,dun-modr,653,warrior,fury,23,7,16
Blutwar,kazzak,649,warrior,fury,23,11,12
Aleextrasza,silvermoon,607,warrior,fury,14,7,7
Scofiéld,lordaeron,601,warrior,fury,11,7,4
Quarantino,ysondre,590,warrior,fury,17,7,10
Syltetballe,kazzak,576,warrior,fury,6,6,0
Артэкриогг,soulflayer,576,warrior,fury,6,6,0
Shilix,twisting-nether,576,warrior,fury,6,6,0
Exeldians,burning-legion,576,warrior,fury,6,6,0
Féélmyfury,tarren-mill,576,warrior,fury,11,6,5
Stanfury,sylvanas,576,warrior,fury,12,6,6
Nallepúh,silvermoon,576,warrior,fury,12,6,6
Dírectdash,draenor,576,warrior,fury,12,6,6
Lepetitwar,hyjal,576,warrior,fury,12,6,6
Redwraith,stormscale,576,warrior,fury,12,6,6
Rarcus,chamber-of-aspects,576,warrior,fury,12,6,6
Едигейй,gordunni,576,warrior,fury,12,6,6
Brigitá,argent-dawn,576,warrior,fury,12,6,6
Circumcist,dragonblight,576,warrior,fury,12,6,6
Dhloos,kazzak,576,warrior,fury,12,6,6
Рэйлет,gordunni,576,warrior,fury,12,6,6
Ralzung,twisting-nether,576,warrior,fury,12,6,6
Løktær,blackmoore,576,warrior,fury,12,6,6
Sakumo,sylvanas,576,warrior,fury,12,6,6
Shurubel,outland,576,warrior,fury,12,6,6
Humanboi,ravencrest,576,warrior,fury,12,6,6
Crandalius,kazzak,576,warrior,fury,12,6,6
Rimvar,alleria,576,warrior,fury,12,6,6
Лаинвуд,soulflayer,576,warrior,fury,12,6,6
Perinel,draenor,576,warrior,fury,17,6,11
Mazzkze,silvermoon,576,warrior,fury,18,6,12
Prettyangel,aegwynn,576,warrior,fury,18,6,12
Silq,zuljin,576,warrior,fury,18,6,12
Сталиран,gordunni,576,warrior,fury,18,6,12
Bäiley,drakthul,576,warrior,fury,24,6,18
Esegryel,argent-dawn,575,warrior,fury,12,6,6
Flaggerware,stormscale,575,warrior,fury,12,6,6
Bloódángel,frostwolf,575,warrior,fury,12,6,6
Malasortë,sylvanas,575,warrior,fury,12,6,6
Richymorty,los-errantes,575,warrior,fury,12,6,6
Daramir,turalyon,575,warrior,fury,12,6,6
Oravedenes,draenor,575,warrior,fury,12,6,6
Jâmâli,malganis,575,warrior,fury,12,6,6
Durrüti,sanguino,575,warrior,fury,12,6,6
Nihroxis,blackrock,575,warrior,fury,12,6,6
Nmwar,turalyon,575,warrior,fury,12,6,6
Конвержн,howling-fjord,575,warrior,fury,12,6,6
Fightinghell,stormrage,575,warrior,fury,12,6,6
Drolaret,zuljin,575,warrior,fury,15,6,9
Akäme,ysondre,575,warrior,fury,18,6,12
Вкусныисыр,soulflayer,574,warrior,fury,12,6,6
Блиблоб,eversong,574,warrior,fury,12,6,6
Grobler,blackhand,574,warrior,fury,18,6,12
Sparkss,sylvanas,573,warrior,fury,12,6,6
Kharzak,ungoro,573,warrior,fury,12,6,6
Джомалкович,deathweaver,572,warrior,fury,12,6,6
Mistawolf,ravencrest,570,warrior,fury,18,6,12
Guinnasse,khaz-modan,567,warrior,fury,12,6,6
Арнвальд,galakrond,566,warrior,fury,12,6,6
Miina,blutkessel,566,warrior,fury,12,6,6
Reccey,blackrock,527,warrior,fury,11,6,5
Skeptikal,tarren-mill,527,warrior,fury,11,6,5
Dûrøtan,marécage-de-zangar,527,warrior,fury,15,6,9
Balsor,frostmane,526,warrior,fury,11,6,5
Retmain,draenor,522,warrior,fury,20,8,12
Therealskull,grim-batol,480,warrior,fury,6,5,1
Tweran,drakthul,480,warrior,fury,6,5,1
Bourbimrgllr,hyjal,480,warrior,fury,6,5,1
Horovoko,kazzak,480,warrior,fury,6,5,1
Astreimehns,sanguino,480,warrior,fury,6,5,1
Timmyda,dalaran,480,warrior,fury,6,5,1
Ганахан,soulflayer,480,warrior,fury,6,5,1
Megabrux,colinas-pardas,480,warrior,fury,6,5,1
Кроуфури,gordunni,480,warrior,fury,6,5,1
Easypoîntsx,tarren-mill,480,warrior,fury,6,5,1
Ptp,argent-dawn,480,warrior,fury,6,5,1
Брокскрим,soulflayer,480,warrior,fury,6,5,1
Дайбек,howling-fjord,480,warrior,fury,6,5,1
Ézélya,dalaran,480,warrior,fury,6,5,1
Pizdatos,ravencrest,480,warrior,fury,6,5,1
Blackseven,ravencrest,480,warrior,fury,6,5,1
Ruixxted,stormreaver,480,warrior,fury,12,5,7
Rageaholic,blackmoore,480,warrior,fury,12,5,7
Kondomi,stormreaver,480,warrior,fury,12,5,7
Savarøx,blackmoore,480,warrior,fury,12,5,7
Dauderup,aerie-peak,480,warrior,fury,12,5,7
Soakmybeet,archimonde,480,warrior,fury,12,5,7
Jugg,emerald-dream,480,warrior,fury,12,5,7
Orkoje,argent-dawn,480,warrior,fury,12,5,7
Dævedoff,sanguino,480,warrior,fury,12,5,7
Stkacha,sanguino,480,warrior,fury,12,5,7
Ulthrak,archimonde,480,warrior,fury,12,5,7
Wallach,darkspear,480,warrior,fury,12,5,7
Nightmareb,magtheridon,480,warrior,fury,12,5,7
Darthmalgus,stormscale,480,warrior,fury,12,5,7
Arthayl,eredar,480,warrior,fury,12,5,7
Léonie,arakarahm,480,warrior,fury,12,5,7
Axamo,ragnaros,480,warrior,fury,12,5,7
Kolxoz,doomhammer,480,warrior,fury,12,5,7
Punahabe,draenor,480,warrior,fury,12,5,7
Helleon,twisting-nether,480,warrior,fury,12,5,7
Cemule,doomhammer,480,warrior,fury,12,5,7
Kagsteelfist,twisting-nether,480,warrior,fury,12,5,7
Suknur,silvermoon,480,warrior,fury,12,5,7
Ibunnyone,blackrock,480,warrior,fury,12,5,7
Альмас,galakrond,480,warrior,fury,12,5,7
Beznacaj,outland,480,warrior,fury,12,5,7
Soullmike,drakthul,480,warrior,fury,12,5,7
Гатал,howling-fjord,480,warrior,fury,12,5,7
Pinkíe,blackmoore,480,warrior,fury,12,5,7
Bigbugatti,draenor,480,warrior,fury,12,5,7
Hellocritty,blackmoore,480,warrior,fury,12,5,7
Ukloth,sanguino,480,warrior,fury,18,5,13
Sodium,pozzo-delleternità,480,warrior,fury,18,5,13
Honör,sylvanas,480,warrior,fury,18,5,13
Prime,outland,479,warrior,fury,12,5,7
Дерзкаяфурия,gordunni,479,warrior,fury,12,5,7
Rqyz,tarren-mill,479,warrior,fury,12,5,7
Варёнок,soulflayer,479,warrior,fury,12,5,7
Cosmoses,mazrigos,479,warrior,fury,12,5,7
Элейд,thermaplugg,479,warrior,fury,12,5,7
Marklarstar,ragnaros,479,warrior,fury,12,5,7
Luciferkhan,twisting-nether,479,warrior,fury,12,5,7
Motorhead,tirion,479,warrior,fury,12,5,7
Killpieric,krasus,479,warrior,fury,18,5,13
Destrzadora,exodar,477,warrior,fury,12,5,7
Roostai,shattered-hand,476,warrior,fury,12,5,7
Horymir,ravencrest,463,warrior,fury,11,5,6
Piinte,naxxramas,444,warrior,fury,11,5,6
Valrathion,ravencrest,426,warrior,fury,17,8,9
Yugoslav,argent-dawn,426,warrior,fury,16,6,10
Djranji,kazzak,416,warrior,fury,10,5,5
Famous,argent-dawn,400,warrior,fury,7,5,2
Madvlad,twisting-nether,384,warrior,fury,6,4,2
Jinrok,turalyon,384,warrior,fury,6,4,2
Bravest,ragnaros,384,warrior,fury,6,4,2
Bersurker,draenor,384,warrior,fury,6,4,2
Нерморрог,howling-fjord,384,warrior,fury,6,4,2
Oluwafunmila,tarren-mill,384,warrior,fury,6,4,2
Pòóòóòóòópz,dun-modr,384,warrior,fury,6,4,2
Nobelisarius,norgannon,384,warrior,fury,6,4,2
Warbigboss,draenor,384,warrior,fury,6,4,2
Gotnuub,tarren-mill,384,warrior,fury,6,4,2
Stickifrån,darkspear,384,warrior,fury,6,4,2
Vivaladirt,argent-dawn,384,warrior,fury,6,4,2
Extasceh,turalyon,384,warrior,fury,6,4,2
Infernall,burning-legion,384,warrior,fury,6,4,2
Pierøne,nemesis,384,warrior,fury,6,4,2
Chipstjuven,tarren-mill,384,warrior,fury,6,4,2
Vullgrîm,blackmoore,384,warrior,fury,6,4,2
Mórdér,blackmoore,384,warrior,fury,6,4,2
Gandosh,blackmoore,384,warrior,fury,6,4,2
Suzzon,hyjal,384,warrior,fury,6,4,2
Truepassion,outland,384,warrior,fury,6,4,2
Executte,zuljin,384,warrior,fury,6,4,2
Dollystyle,kazzak,384,warrior,fury,6,4,2
Lôcutus,thrall,384,warrior,fury,6,4,2
Imora,silvermoon,384,warrior,fury,6,4,2
Ryghar,silvermoon,384,warrior,fury,6,4,2
Вульрайс,deepholm,384,warrior,fury,6,4,2
Razzani,nathrezim,384,warrior,fury,6,4,2
Dõxqt,kazzak,384,warrior,fury,6,4,2
Orkboii,ravencrest,384,warrior,fury,6,4,2
Стано,booty-bay,384,warrior,fury,6,4,2
Zeldius,ravencrest,384,warrior,fury,6,4,2
Daldiee,ravencrest,384,warrior,fury,6,4,2
Кайзерчиф,soulflayer,384,warrior,fury,6,4,2
Впижаме,gordunni,384,warrior,fury,6,4,2
Ränchiëk,ravencrest,384,warrior,fury,6,4,2
Цикламея,blackscar,384,warrior,fury,6,4,2
Dominow,ysondre,384,warrior,fury,6,4,2
Tsu,karazhan,384,warrior,fury,6,4,2
Кладбошаа,gordunni,384,warrior,fury,10,5,5
Мундэфэндэр,lich-king,384,warrior,fury,12,4,8
Насувака,deathguard,384,warrior,fury,12,4,8
Колобочек,eversong,384,warrior,fury,12,4,8
Andjuu,doomhammer,384,warrior,fury,12,4,8
Fistawarrior,nemesis,384,warrior,fury,12,4,8
Bulletpants,argent-dawn,384,warrior,fury,12,4,8
Katmos,baelgun,384,warrior,fury,12,4,8
Fortressa,ravencrest,384,warrior,fury,12,4,8
Изберг,soulflayer,384,warrior,fury,12,4,8
Nekerka,burning-legion,384,warrior,fury,12,4,8
Basiletha,hyjal,384,warrior,fury,12,4,8
Bwonsàmdí,ragnaros,384,warrior,fury,12,4,8
Elian,ragnaros,384,warrior,fury,12,4,8
Kurenn,tarren-mill,384,warrior,fury,12,4,8
Råkeff,tarren-mill,384,warrior,fury,12,4,8
Аркашевич,gordunni,384,warrior,fury,12,4,8
Nemecic,arathor,384,warrior,fury,12,4,8
Tanalias,outland,384,warrior,fury,12,4,8
Янесними,soulflayer,384,warrior,fury,12,4,8
Poniroula,burning-legion,384,warrior,fury,12,4,8
Garradoom,stormscale,384,warrior,fury,17,5,12
Thibow,hyjal,383,warrior,fury,6,4,2
Romanondo,doomhammer,383,warrior,fury,6,4,2
Siltiel,marécage-de-zangar,383,warrior,fury,6,4,2
Dullegriet,veknilash,383,warrior,fury,12,4,8
Ruuddy,draenor,382,warrior,fury,12,4,8
Beogor,grim-batol,367,warrior,fury,11,4,7
Pitii,burning-legion,351,warrior,fury,8,5,3
Toxîn,dalaran,351,warrior,fury,11,4,7
Greensmash,hyjal,351,warrior,fury,14,5,9
Bossít,doomhammer,336,warrior,fury,9,4,5
Skillissues,argent-dawn,330,warrior,fury,11,7,4
Ragedotcom,archimonde,320,warrior,fury,10,4,6
Хоркан,blackscar,319,warrior,fury,8,4,4
Manelar,draenor,319,warrior,fury,8,4,4
Titza,silvermoon,319,warrior,fury,14,4,10
Anaba,voljin,318,warrior,fury,10,4,6
Гацс,soulflayer,288,warrior,fury,6,3,3
Эфириад,soulflayer,288,warrior,fury,6,3,3
Obox,ravencrest,288,warrior,fury,6,3,3
Balltas,drakthul,288,warrior,fury,6,3,3
Aìrwave,blackmoore,288,warrior,fury,6,3,3
Warriorc,hellfire,288,warrior,fury,6,3,3
Hortswarr,drakthul,288,warrior,fury,6,3,3
Mfdoöm,draenor,288,warrior,fury,6,3,3
Zerberos,drakthul,288,warrior,fury,6,3,3
Cleavyera,tarren-mill,288,warrior,fury,6,3,3
Afk,emeriss,288,warrior,fury,6,3,3
Straya,malorne,288,warrior,fury,6,3,3
Lâppön,blackmoore,288,warrior,fury,6,3,3
Berzzerker,tarren-mill,288,warrior,fury,6,3,3
Damonx,draenor,288,warrior,fury,6,3,3
Whàtsup,stormscale,288,warrior,fury,6,3,3
Bindera,silvermoon,288,warrior,fury,6,3,3
Smâllpackage,silvermoon,288,warrior,fury,6,3,3
Wärlør,ravencrest,288,warrior,fury,6,3,3
Nifrediel,trollbane,288,warrior,fury,6,3,3
Immera,silvermoon,288,warrior,fury,6,3,3
Eekz,haomarush,288,warrior,fury,6,3,3
Tarrior,shattered-halls,288,warrior,fury,6,3,3
Xerone,doomhammer,288,warrior,fury,6,3,3
Vatolocoese,dun-morogh,288,warrior,fury,6,3,3
Eleborn,tarren-mill,288,warrior,fury,6,3,3
Cryze,ravencrest,288,warrior,fury,6,3,3
Eiche,kazzak,288,warrior,fury,6,3,3
Grinrok,thrall,288,warrior,fury,6,3,3
Geicoo,dalaran,288,warrior,fury,6,3,3
Morganãrogán,ragnaros,288,warrior,fury,6,3,3
Ivailowar,ravencrest,288,warrior,fury,6,3,3
Кровостокхх,gordunni,288,warrior,fury,6,3,3
Taeshalach,der-abyssische-rat,288,warrior,fury,6,3,3
Skullsmasher,stormscale,288,warrior,fury,6,3,3
Ntouziera,silvermoon,288,warrior,fury,6,3,3
Manký,kazzak,288,warrior,fury,6,3,3
Dangeruos,ragnaros,288,warrior,fury,6,3,3
Wilmazutschn,nethersturm,288,warrior,fury,6,3,3
Frankytank,antonidas,288,warrior,fury,6,3,3
Drfeelgud,twisting-nether,288,warrior,fury,6,3,3
Kapuchino,twisting-nether,288,warrior,fury,6,3,3
Tabboonishka,draenor,288,warrior,fury,6,3,3
Thundersword,sylvanas,288,warrior,fury,6,3,3
Hazarku,colinas-pardas,288,warrior,fury,6,3,3
Shán,defias-brotherhood,288,warrior,fury,6,3,3
Ireincarnate,argent-dawn,288,warrior,fury,6,3,3
Vory,ravencrest,288,warrior,fury,6,3,3
Mïîäm,archimonde,288,warrior,fury,6,3,3
Azotz,archimonde,288,warrior,fury,6,3,3
Kronmw,dun-modr,288,warrior,fury,6,3,3
Wunderwaffle,xavius,288,warrior,fury,6,3,3
Izrael,alakir,288,warrior,fury,6,3,3
Barrocket,aegwynn,288,warrior,fury,6,3,3
Васяжелезо,gordunni,288,warrior,fury,6,3,3
Madhardy,chamber-of-aspects,288,warrior,fury,6,3,3
Uncledazzo,quelthalas,288,warrior,fury,6,3,3
Cøbain,eredar,288,warrior,fury,6,3,3
Bstgame,frostmane,288,warrior,fury,6,3,3
Rägnât,dun-modr,288,warrior,fury,6,3,3
Didgedelik,archimonde,288,warrior,fury,6,3,3
Mumbojumbo,uldum,288,warrior,fury,6,3,3
Anakhas,archimonde,288,warrior,fury,6,3,3
Ульданианин,gordunni,288,warrior,fury,6,3,3
Friendlytwo,quelthalas,288,warrior,fury,6,3,3
Septymyya,eredar,288,warrior,fury,9,4,5
Zercher,tarren-mill,288,warrior,fury,12,3,9
Confliction,outland,288,warrior,fury,12,3,9
Джондо,gordunni,288,warrior,fury,12,3,9
Pamila,outland,288,warrior,fury,12,3,9
Dabliu,burning-legion,288,warrior,fury,12,3,9
Skykrow,ysondre,288,warrior,fury,12,3,9
Зарган,howling-fjord,288,warrior,fury,12,3,9
Ganian,stormscale,288,warrior,fury,12,3,9
Malvred,eredar,288,warrior,fury,12,3,9
Grommer,dentarg,288,warrior,fury,12,3,9
Kiryn,draenor,288,warrior,fury,12,3,9
Aphae,defias-brotherhood,288,warrior,fury,12,3,9
Nightvision,skullcrusher,288,warrior,fury,12,3,9
Zyn,outland,288,warrior,fury,12,3,9
Valldi,argent-dawn,288,warrior,fury,12,3,9
Urabrask,stormscale,288,warrior,fury,12,3,9
Jasonnes,argent-dawn,288,warrior,fury,17,3,14
Atelier,magtheridon,287,warrior,fury,6,3,3
Gardom,doomhammer,287,warrior,fury,6,3,3
Arnnau,dun-modr,287,warrior,fury,6,3,3
Agunnai,karazhan,286,warrior,fury,6,3,3
Execute,sanguino,239,warrior,fury,5,3,2
Colliderbody,dun-modr,239,warrior,fury,5,3,2
Hazl,balnazzar,238,warrior,fury,5,3,2
Xqt,laughing-skull,234,warrior,fury,9,4,5
Iarsonn,drakthul,223,warrior,fury,8,3,5
Флокт,howling-fjord,208,warrior,fury,7,3,4
Имбанутыйвар,soulflayer,192,warrior,fury,4,3,1
Балласёж,gordunni,192,warrior,fury,9,3,6
Holdemhammer,sanguino,192,warrior,fury,6,2,4
Basingaa,pozzo-delleternità,192,warrior,fury,6,2,4
Khòrne,sanguino,192,warrior,fury,6,2,4
Гудмунт,borean-tundra,192,warrior,fury,6,2,4
Hördê,zuljin,192,warrior,fury,6,2,4
Eyolf,thunderhorn,192,warrior,fury,6,2,4
Artheim,silvermoon,192,warrior,fury,6,2,4
Amédé,ysondre,192,warrior,fury,6,2,4
Fuwy,argent-dawn,192,warrior,fury,6,2,4
Malalulu,burning-legion,192,warrior,fury,6,2,4
Siuzy,blackrock,192,warrior,fury,6,2,4
Shownomercy,blackrock,192,warrior,fury,6,2,4
Sefty,tarren-mill,192,warrior,fury,6,2,4
Zalazain,burning-legion,192,warrior,fury,6,2,4
Саркон,ashenvale,192,warrior,fury,6,2,4
Buntstift,thrall,192,warrior,fury,6,2,4
Suichôken,archimonde,192,warrior,fury,6,2,4
Onykat,aegwynn,192,warrior,fury,6,2,4
Walkers,frostmane,192,warrior,fury,6,2,4
Gregórry,eredar,192,warrior,fury,6,2,4
Inflacija,grim-batol,192,warrior,fury,6,2,4
Andij,blackmoore,192,warrior,fury,6,2,4
Miotyz,ahnqiraj,192,warrior,fury,6,2,4
Piixxz,hyjal,192,warrior,fury,6,2,4
Rayyes,stormscale,192,warrior,fury,6,2,4
Souler,burning-legion,192,warrior,fury,6,2,4
Velgur,ravencrest,192,warrior,fury,6,2,4
Ruz,defias-brotherhood,192,warrior,fury,6,2,4
Alxqt,outland,192,warrior,fury,6,2,4
Врэкклив,gordunni,192,warrior,fury,6,2,4
Elkatar,stormscale,192,warrior,fury,6,2,4
Apacolata,outland,192,warrior,fury,6,2,4
Kalakalle,twisting-nether,192,warrior,fury,6,2,4
Razoo,stormscale,192,warrior,fury,6,2,4
Picklejuicer,argent-dawn,192,warrior,fury,6,2,4
Qiz,silvermoon,192,warrior,fury,6,2,4
Maniaco,kazzak,192,warrior,fury,6,2,4
Sgàthach,silvermoon,192,warrior,fury,6,2,4
Wembley,proudmoore,192,warrior,fury,6,2,4
Nokturnâl,silvermoon,192,warrior,fury,6,2,4
Mîcî,tarren-mill,192,warrior,fury,6,2,4
Hulkzmash,tarren-mill,192,warrior,fury,6,2,4
Fookyoup,stormscale,192,warrior,fury,6,2,4
Чюнилингус,soulflayer,192,warrior,fury,6,2,4
Антурим,howling-fjord,192,warrior,fury,6,2,4
Evilweraz,turalyon,192,warrior,fury,6,2,4
Zirvey,tarren-mill,192,warrior,fury,6,2,4
Grenad,kazzak,192,warrior,fury,6,2,4
Nexyycleave,kazzak,192,warrior,fury,6,2,4
Nabucadnozor,illidan,192,warrior,fury,6,2,4
Кентафурик,soulflayer,192,warrior,fury,6,2,4
Freddie,baelgun,192,warrior,fury,6,2,4
Ðèxs,ravencrest,192,warrior,fury,6,2,4
Lianore,sanguino,192,warrior,fury,6,2,4
Jriddyzug,ravencrest,192,warrior,fury,6,2,4
Schuy,silvermoon,192,warrior,fury,6,2,4
Xåb,dun-morogh,192,warrior,fury,8,2,6
Schneklinge,blutkessel,192,warrior,fury,8,2,6
Frowenn,ravencrest,192,warrior,fury,12,2,10
Sycon,chamber-of-aspects,192,warrior,fury,12,2,10
Giimlii,hyjal,192,warrior,fury,12,2,10
Minotaureeni,silvermoon,192,warrior,fury,12,2,10
Altroox,malorne,192,warrior,fury,12,2,10
Pakusrage,defias-brotherhood,192,warrior,fury,12,2,10
Angrethar,tarren-mill,192,warrior,fury,12,2,10
Hembränt,hellfire,192,warrior,fury,12,2,10
Arzes,draenor,192,warrior,fury,12,2,10
Omosha,burning-legion,191,warrior,fury,6,2,4
Dorinaz,die-aldor,191,warrior,fury,6,2,4
Торакусу,gordunni,191,warrior,fury,6,2,4
Tömahawk,defias-brotherhood,191,warrior,fury,6,2,4
Mane,thunderhorn,191,warrior,fury,6,2,4
Кереешка,howling-fjord,175,warrior,fury,11,2,9
Limejuicer,argent-dawn,169,warrior,fury,12,5,7
Brülldozer,kargath,159,warrior,fury,5,2,3
Vlaax,ravencrest,138,warrior,fury,14,3,11
Æxcoast,ravencrest,128,warrior,fury,4,2,2
Текайко,eversong,96,warrior,fury,3,2,1
Krunchä,ragnaros,96,warrior,fury,3,2,1
Furyfame,darksorrow,96,warrior,fury,6,1,5
Albabhaltair,quelthalas,96,warrior,fury,6,1,5
Loty,drakthul,96,warrior,fury,6,1,5
Galenthor,ravencrest,96,warrior,fury,6,1,5
Feltias,drakthul,96,warrior,fury,6,1,5
Армапипец,soulflayer,96,warrior,fury,6,1,5
Raakalainen,vashj,96,warrior,fury,6,1,5
Prîde,kazzak,96,warrior,fury,6,1,5
Dp,area-52,96,warrior,fury,6,1,5
Xenowarr,tarren-mill,96,warrior,fury,6,1,5
Temprament,ravencrest,96,warrior,fury,6,1,5
Raixxon,ragnaros,96,warrior,fury,6,1,5
Coldstory,draenor,96,warrior,fury,6,1,5
Dolora,ragnaros,96,warrior,fury,6,1,5
Bladewound,draenor,96,warrior,fury,6,1,5
Juanvaco,tarren-mill,96,warrior,fury,6,1,5
Sorkk,kazzak,96,warrior,fury,6,1,5
Naspy,stormscale,96,warrior,fury,6,1,5
Wifioffline,silvermoon,96,warrior,fury,6,1,5
Utharis,stormscale,96,warrior,fury,6,1,5
Spacemachine,kazzak,96,warrior,fury,6,1,5
Greekazi,kazzak,96,warrior,fury,6,1,5
Mot,terenas,96,warrior,fury,6,1,5
Luw,twisting-nether,96,warrior,fury,6,1,5
Høxy,outland,96,warrior,fury,6,1,5
Swordluw,argent-dawn,96,warrior,fury,6,1,5
Wiliamwalace,zuljin,96,warrior,fury,6,1,5
Фиббоначи,deathguard,96,warrior,fury,6,1,5
Wanzzeur,hyjal,96,warrior,fury,6,1,5
Kronstris,veklor,96,warrior,fury,6,1,5
Riptide,aggra-português,96,warrior,fury,6,1,5
Moldamis,blackhand,96,warrior,fury,6,1,5
Stratic,blackmoore,96,warrior,fury,6,1,5
Marícan,blackmoore,96,warrior,fury,6,1,5
Elesharde,sanguino,96,warrior,fury,6,1,5
Grisettê,archimonde,96,warrior,fury,6,1,5
Azrail,xavius,96,warrior,fury,6,1,5
Corpsecount,stormrage,96,warrior,fury,6,1,5
Hágríd,ragnaros,96,warrior,fury,12,1,11
Kaodes,outland,96,warrior,fury,17,1,16
Pufy,ravencrest,79,warrior,fury,5,1,4
Anubisra,alakir,42,warrior,fury,8,3,5
Xguildone,magtheridon,31,warrior,fury,2,1,1
Vivrya,silvermoon,31,warrior,fury,2,1,1
Réckx,twisting-nether,2233,warrior,arms,93,52,41
Marcus,ravencrest,2205,warrior,arms,102,54,48
Scardrex,defias-brotherhood,2172,warrior,arms,94,49,45
Midgetdamis,blackhand,2169,warrior,arms,95,67,28
Sickjackenn,executus,2166,warrior,arms,111,58,53
Thomasman,nerathor,2145,warrior,arms,96,48,48
Blîxtgordon,tarren-mill,2133,warrior,arms,78,42,36
Mitu,sanguino,2127,warrior,arms,209,111,98
Palianytsia,ravencrest,2125,warrior,arms,77,40,37
Noragrets,stormscale,2116,warrior,arms,80,41,39
Regnarok,sylvanas,2115,warrior,arms,154,90,64
Скварх,howling-fjord,2112,warrior,arms,120,74,46
Savesta,dalaran,2112,warrior,arms,156,83,73
Grkpwh,silvermoon,2105,warrior,arms,88,48,40
Immørtálx,tarren-mill,2102,warrior,arms,72,38,34
Dunecrab,tarren-mill,2092,warrior,arms,84,51,33
Elwarroo,dun-modr,2083,warrior,arms,124,71,53
Nikkí,naxxramas,2074,warrior,arms,96,50,46
Кокдиллак,soulflayer,2073,warrior,arms,122,62,60
Gewyon,ragnaros,2068,warrior,arms,60,35,25
Gabrijel,draenor,2062,warrior,arms,101,49,52
Ulrid,draenor,2052,warrior,arms,66,36,30
Оркабал,howling-fjord,2045,warrior,arms,124,68,56
Cerry,ravencrest,2016,warrior,arms,123,63,60
Oswáld,defias-brotherhood,2011,warrior,arms,42,34,8
Bàrbandit,archimonde,2007,warrior,arms,60,35,25
Trâshwarriør,blackhand,1998,warrior,arms,62,27,35
Joeférnandes,ragnaros,1996,warrior,arms,77,38,39
Yorgal,arakarahm,1984,warrior,arms,60,31,29
Вэшикх,soulflayer,1979,warrior,arms,83,45,38
Shilix,twisting-nether,1974,warrior,arms,121,57,64
Alegral,ravencrest,1973,warrior,arms,99,49,50
Manaskhan,tarren-mill,1959,warrior,arms,150,78,72
Merked,kazzak,1958,warrior,arms,72,34,38
Pentagramlol,twisting-nether,1955,warrior,arms,64,34,30
Zak,stormscale,1955,warrior,arms,78,37,41
Nedåh,blackrock,1954,warrior,arms,84,46,38
Rhâpsodyw,ravencrest,1951,warrior,arms,72,41,31
Disarmed,auchindoun,1945,warrior,arms,54,31,23
Комочекгнева,howling-fjord,1940,warrior,arms,133,68,65
Markers,twisting-nether,1938,warrior,arms,73,34,39
Myonmyonmyon,blackmoore,1937,warrior,arms,68,41,27
Wràthfúl,kazzak,1937,warrior,arms,119,60,59
Qtcockxx,stormscale,1928,warrior,arms,60,30,30
Seifcham,ragnaros,1926,warrior,arms,72,35,37
Kapuchino,twisting-nether,1921,warrior,arms,48,27,21
Timpey,kazzak,1911,warrior,arms,54,30,24
Naronnas,drakthul,1910,warrior,arms,104,58,46
Apacolata,outland,1903,warrior,arms,57,29,28
Thenx,tarren-mill,1902,warrior,arms,99,47,52
Aerês,tarren-mill,1900,warrior,arms,96,51,45
Длоордпро,soulflayer,1900,warrior,arms,65,29,36
Julololo,archimonde,1893,warrior,arms,72,40,32
Galeron,kazzak,1892,warrior,arms,60,30,30
Liptonxecute,blackhand,1891,warrior,arms,42,25,17
Куртфорренс,gordunni,1890,warrior,arms,61,25,36
Courageous,ravencrest,1889,warrior,arms,66,39,27
Drclapit,blackrock,1884,warrior,arms,42,23,19
Theryk,sanguino,1884,warrior,arms,77,34,43
Sagethi,blackrock,1883,warrior,arms,77,37,40
Schaufelørc,blackrock,1881,warrior,arms,60,31,29
Куесэс,howling-fjord,1880,warrior,arms,36,20,16
Gnømércy,stormscale,1878,warrior,arms,42,22,20
Cathériné,drakthul,1875,warrior,arms,48,27,21
Purpórc,archimonde,1875,warrior,arms,54,30,24
Doomqt,terokkar,1873,warrior,arms,47,27,20
Hellguard,archimonde,1872,warrior,arms,84,47,37
Emix,arygos,1871,warrior,arms,54,31,23
Karny,ravencrest,1870,warrior,arms,48,31,17
Злопиканка,gordunni,1868,warrior,arms,36,20,16
Брокскрим,soulflayer,1861,warrior,arms,60,30,30
Ozrenac,kazzak,1859,warrior,arms,83,45,38
Sekwar,twisting-nether,1858,warrior,arms,42,21,21
Вандэрбой,howling-fjord,1858,warrior,arms,156,76,80
Quotx,stormscale,1857,warrior,arms,70,32,38
Mômsboy,tarren-mill,1853,warrior,arms,64,33,31
Ланро,gordunni,1853,warrior,arms,65,33,32
Gatts,krasus,1853,warrior,arms,204,101,103
Infernion,jaedenar,1851,warrior,arms,36,23,13
Skorm,mugthol,1849,warrior,arms,36,27,9
Reckqtw,eredar,1849,warrior,arms,92,50,42
Аоетакси,soulflayer,1848,warrior,arms,104,59,45
Хэйре,howling-fjord,1847,warrior,arms,148,78,70
Otp,ravencrest,1847,warrior,arms,66,32,34
Krônm,dun-modr,1847,warrior,arms,78,33,45
Messermozart,blackmoore,1844,warrior,arms,48,25,23
Daredevìl,eredar,1844,warrior,arms,89,43,46
Xvlanter,silvermoon,1841,warrior,arms,78,41,37
Jriddyzug,ravencrest,1840,warrior,arms,62,33,29
Хиро,deathweaver,1839,warrior,arms,54,27,27
Enøt,kazzak,1839,warrior,arms,53,25,28
Komissarecks,aegwynn,1838,warrior,arms,57,31,26
Ässholedamis,blackhand,1837,warrior,arms,48,35,13
Sneakydrm,kazzak,1837,warrior,arms,40,23,17
Gguts,archimonde,1837,warrior,arms,85,46,39
Khalimov,tarren-mill,1837,warrior,arms,96,51,45
Аэска,deathweaver,1836,warrior,arms,60,28,32
Tozzhug,ragnaros,1835,warrior,arms,48,28,20
Chaddimus,draenor,1833,warrior,arms,42,28,14
Æriø,dalaran,1833,warrior,arms,48,27,21
Blåvingad,kazzak,1831,warrior,arms,56,34,22
Боссберс,soulflayer,1831,warrior,arms,89,44,45
Watrux,outland,1831,warrior,arms,66,31,35
Trapoulas,kazzak,1831,warrior,arms,83,36,47
Воинлета,howling-fjord,1830,warrior,arms,101,60,41
Khÿze,ysondre,1829,warrior,arms,58,39,19
Agoen,silvermoon,1829,warrior,arms,48,23,25
Ønogal,archimonde,1829,warrior,arms,66,31,35
Ástriax,ravencrest,1828,warrior,arms,141,69,72
Kamked,burning-legion,1828,warrior,arms,107,50,57
Blazefüry,ravencrest,1827,warrior,arms,61,33,28
Rînus,aegwynn,1827,warrior,arms,54,26,28
Jenkinzz,stormscale,1826,warrior,arms,36,23,13
Wuifly,dun-modr,1826,warrior,arms,69,35,34
Варбоссец,soulflayer,1825,warrior,arms,66,35,31
Lanstus,silvermoon,1823,warrior,arms,72,42,30
Ðior,bronze-dragonflight,1822,warrior,arms,53,29,24
Марльин,howling-fjord,1822,warrior,arms,59,29,30
Crîxús,silvermoon,1822,warrior,arms,60,25,35
Rngmonster,kazzak,1820,warrior,arms,100,68,32
Uzamaki,bronzebeard,1820,warrior,arms,48,32,16
Knutrex,tarren-mill,1820,warrior,arms,61,35,26
Лилиофаныч,soulflayer,1820,warrior,arms,35,20,15
Лимпс,gordunni,1819,warrior,arms,30,19,11
Flinta,blackmoore,1819,warrior,arms,90,51,39
Флагмэн,gordunni,1819,warrior,arms,65,36,29
Ðênnis,ravencrest,1818,warrior,arms,30,19,11
Pürporcc,archimonde,1818,warrior,arms,97,48,49
Мелькорт,gordunni,1817,warrior,arms,48,29,19
Wasro,norgannon,1816,warrior,arms,60,32,28
Экзекьютлол,soulflayer,1816,warrior,arms,47,25,22
Joéfernandés,sylvanas,1816,warrior,arms,36,19,17
Klonyarik,ravencrest,1815,warrior,arms,36,19,17
Aeyon,burning-blade,1814,warrior,arms,45,27,18
Thorana,twisting-nether,1814,warrior,arms,59,32,27
Leethal,outland,1814,warrior,arms,60,27,33
Juank,minahonda,1814,warrior,arms,48,21,27
Pummelthru,burning-legion,1813,warrior,arms,65,32,33
Vic,tarren-mill,1813,warrior,arms,47,20,27
Zcell,kazzak,1812,warrior,arms,36,23,13
Лёшавор,howling-fjord,1812,warrior,arms,36,19,17
Mystylez,silvermoon,1812,warrior,arms,60,28,32
Gucciwarrior,blackhand,1812,warrior,arms,90,41,49
Axinit,blackrock,1811,warrior,arms,42,23,19
Idiotplay,drekthar,1811,warrior,arms,42,19,23
Johnmeadows,ravencrest,1810,warrior,arms,36,23,13
Ðiscordia,blackhand,1810,warrior,arms,84,43,41
Jokkul,tarren-mill,1810,warrior,arms,46,21,25
Connorzw,blackmoore,1809,warrior,arms,36,23,13
Cherserker,ragnaros,1809,warrior,arms,69,41,28
Oldchap,nordrassil,1807,warrior,arms,48,31,17
Олдборовс,soulflayer,1807,warrior,arms,53,29,24
Bloodhorn,blackhand,1807,warrior,arms,107,54,53
Velcorn,ravencrest,1807,warrior,arms,42,19,23
Bigboomer,frostmane,1807,warrior,arms,126,55,71
Варзила,blackscar,1807,warrior,arms,53,22,31
Nìmera,nemesis,1806,warrior,arms,36,26,10
Wayneson,tarren-mill,1806,warrior,arms,108,58,50
Книфэк,howling-fjord,1806,warrior,arms,76,40,36
Hasbullá,kazzak,1806,warrior,arms,152,79,73
Toscothegoat,ravencrest,1804,warrior,arms,36,24,12
Çatàclysmíc,kazzak,1804,warrior,arms,60,30,30
Greenblób,kazzak,1804,warrior,arms,66,27,39
Hanìbal,ravencrest,1803,warrior,arms,60,32,28
Ghakra,kazzak,1802,warrior,arms,36,25,11
Westwyde,hyjal,1802,warrior,arms,48,30,18
Thyréc,blackmoore,1802,warrior,arms,60,34,26
Маклецкий,gordunni,1802,warrior,arms,144,68,76
Phalek,argent-dawn,1800,warrior,arms,48,28,20
Shortcvnt,ravencrest,1800,warrior,arms,48,28,20
Azudaddy,blackmoore,1800,warrior,arms,59,34,25
Böggzbunny,tarren-mill,1800,warrior,arms,42,24,18
Dairøx,blackrock,1800,warrior,arms,60,31,29
Бодибилдерыч,gordunni,1798,warrior,arms,95,52,43
Kamatâ,kazzak,1796,warrior,arms,60,32,28
Zheaks,kazzak,1796,warrior,arms,83,39,44
Atrôcithy,archimonde,1791,warrior,arms,48,25,23
Pivcuga,kazzak,1789,warrior,arms,182,90,92
Xgs,archimonde,1785,warrior,arms,163,87,76
Reccey,blackrock,1784,warrior,arms,128,65,63
Brutilda,antonidas,1784,warrior,arms,48,23,25
Kennyföx,ysondre,1782,warrior,arms,38,24,14
Maarshl,ysondre,1781,warrior,arms,163,88,75
Nassir,stormscale,1779,warrior,arms,36,19,17
Selenez,outland,1779,warrior,arms,67,30,37
Shookyx,ravencrest,1775,warrior,arms,42,24,18
Zombossio,tarren-mill,1773,warrior,arms,74,38,36
Stupidz,hyjal,1773,warrior,arms,48,21,27
Fràgile,ravencrest,1771,warrior,arms,77,42,35
Kiyomaro,stormscale,1771,warrior,arms,48,25,23
Nozuki,archimonde,1771,warrior,arms,191,97,94
Lyriae,argent-dawn,1768,warrior,arms,66,39,27
Poolboyx,tarren-mill,1767,warrior,arms,87,48,39
Zhangbeihai,ravencrest,1766,warrior,arms,54,26,28
Eidzo,tarren-mill,1765,warrior,arms,36,22,14
Hulkensmash,kazzak,1765,warrior,arms,163,82,81
Mercey,stormscale,1763,warrior,arms,41,19,22
Chucho,argent-dawn,1761,warrior,arms,48,26,22
Zhoti,outland,1761,warrior,arms,52,27,25
Døkidøki,silvermoon,1757,warrior,arms,53,27,26
Darshan,grim-batol,1756,warrior,arms,60,29,31
Grimlok,sylvanas,1754,warrior,arms,65,27,38
Yosiwa,draenor,1753,warrior,arms,60,36,24
Kelhim,blackrock,1753,warrior,arms,66,37,29
Шурпач,deathguard,1753,warrior,arms,42,20,22
Cleaver,tarren-mill,1752,warrior,arms,54,29,25
Ущипнузатитю,deathguard,1752,warrior,arms,66,29,37
Trôth,kazzak,1750,warrior,arms,36,23,13
Pj,sanguino,1750,warrior,arms,68,30,38
Гатсберсерк,gordunni,1748,warrior,arms,149,80,69
Thrux,dalaran,1747,warrior,arms,60,35,25
Javakt,stormscale,1746,warrior,arms,120,51,69
Grimogør,stormscale,1745,warrior,arms,36,22,14
Троммтар,howling-fjord,1745,warrior,arms,84,35,49
Gigadot,arathor,1743,warrior,arms,156,80,76
Klearr,silvermoon,1742,warrior,arms,81,47,34
Regnarøk,sylvanas,1741,warrior,arms,59,33,26
Purporcc,archimonde,1741,warrior,arms,39,20,19
Thebigshow,the-maelstrom,1740,warrior,arms,64,27,37
Blademir,blackrock,1739,warrior,arms,41,26,15
Bigboyx,kazzak,1739,warrior,arms,44,23,21
Cerßere,archimonde,1739,warrior,arms,96,47,49
Mojotsche,taerar,1738,warrior,arms,64,36,28
Cesr,bloodhoof,1738,warrior,arms,106,47,59
Cisataker,hyjal,1737,warrior,arms,24,20,4
Rageco,ravencrest,1737,warrior,arms,48,31,17
Downpipe,twisting-nether,1737,warrior,arms,54,26,28
Bôlufonâ,dun-modr,1732,warrior,arms,59,31,28
Wake,eredar,1731,warrior,arms,42,23,19
Magnî,auchindoun,1731,warrior,arms,54,29,25
Jengaa,draenor,1731,warrior,arms,78,40,38
Ezøn,aegwynn,1730,warrior,arms,65,32,33
Benzemá,sanguino,1729,warrior,arms,36,24,12
Sharpen,chamber-of-aspects,1727,warrior,arms,62,26,36
Dõxqt,kazzak,1726,warrior,arms,44,24,20
Shhimbanned,doomhammer,1723,warrior,arms,48,27,21
Shchoor,ravencrest,1722,warrior,arms,36,18,18
Dannyp,twisting-nether,1722,warrior,arms,36,18,18
Кладбошаа,gordunni,1721,warrior,arms,89,49,40
Skädy,dun-modr,1720,warrior,arms,48,23,25
Guts,frostwhisper,1718,warrior,arms,95,48,47
Барсток,soulflayer,1718,warrior,arms,83,41,42
Urasli,doomhammer,1717,warrior,arms,42,24,18
Xxeqtr,kazzak,1717,warrior,arms,53,26,27
Crawly,aegwynn,1716,warrior,arms,87,46,41
Вокилог,soulflayer,1716,warrior,arms,305,150,155
Arkataz,argent-dawn,1715,warrior,arms,60,30,30
Saurens,twisting-nether,1714,warrior,arms,36,18,18
Kaieh,argent-dawn,1713,warrior,arms,36,23,13
Крипочёк,gordunni,1712,warrior,arms,30,18,12
ßloodz,hyjal,1712,warrior,arms,54,27,27
Dógmòdex,stormscale,1710,warrior,arms,48,30,18
Bordi,nemesis,1710,warrior,arms,71,28,43
Karuck,tarren-mill,1709,warrior,arms,30,19,11
Nitheriá,draenor,1708,warrior,arms,257,129,128
Wargoth,draenor,1707,warrior,arms,34,22,12
Avalinqt,blackrock,1706,warrior,arms,44,32,12
Fruiittyy,ravencrest,1705,warrior,arms,48,27,21
Wardruine,dun-modr,1704,warrior,arms,107,52,55
Palmsweaty,stormrage,1704,warrior,arms,60,24,36
Learningwarr,eredar,1700,warrior,arms,38,21,17
Therealman,kazzak,1699,warrior,arms,38,23,15
Brizeis,malganis,1699,warrior,arms,48,27,21
Klonyarika,ravencrest,1699,warrior,arms,36,20,16
Voxz,stormscale,1698,warrior,arms,153,74,79
Picciocino,nemesis,1698,warrior,arms,76,32,44
Rilor,burning-legion,1698,warrior,arms,60,25,35
Yellowjuice,stormscale,1697,warrior,arms,126,74,52
Dríx,hyjal,1697,warrior,arms,60,32,28
Dnoire,ravencrest,1697,warrior,arms,48,21,27
Nihe,stormreaver,1697,warrior,arms,42,18,24
Riptack,anetheron,1693,warrior,arms,104,62,42
Khanox,twisting-nether,1693,warrior,arms,78,42,36
Maldark,scarshield-legion,1693,warrior,arms,94,44,50
Вуриор,howling-fjord,1692,warrior,arms,84,44,40
Grántor,eredar,1691,warrior,arms,48,32,16
Maikouyes,archimonde,1691,warrior,arms,66,35,31
Oluwafunmila,tarren-mill,1691,warrior,arms,50,26,24
Дайбайхенд,howling-fjord,1691,warrior,arms,60,30,30
Hasmocaru,silvermoon,1690,warrior,arms,36,21,15
Zexa,tarren-mill,1690,warrior,arms,42,21,21
Vayné,ravencrest,1690,warrior,arms,78,35,43
Оксенфурт,soulflayer,1690,warrior,arms,72,32,40
Màb,antonidas,1688,warrior,arms,36,23,13
Фелпир,soulflayer,1688,warrior,arms,96,56,40
Брок,soulflayer,1687,warrior,arms,54,24,30
Crandalius,kazzak,1686,warrior,arms,81,49,32
Spártacus,kazzak,1686,warrior,arms,88,40,48
Pazùzu,twisting-nether,1684,warrior,arms,54,24,30
Røidrage,stormscale,1684,warrior,arms,48,21,27
Nargez,outland,1682,warrior,arms,36,22,14
Toroespaña,draenor,1682,warrior,arms,54,30,24
Rbbx,tarren-mill,1682,warrior,arms,44,24,20
Shooky,blackrock,1681,warrior,arms,41,22,19
Warmâchine,burning-legion,1681,warrior,arms,102,47,55
Tyrasîà,hyjal,1680,warrior,arms,54,24,30
Kronmw,dun-modr,1680,warrior,arms,54,20,34
Sørêy,aegwynn,1679,warrior,arms,72,37,35
Solezte,tarren-mill,1678,warrior,arms,84,50,34
Ридиусх,gordunni,1678,warrior,arms,43,24,19
Summerkarma,wildhammer,1678,warrior,arms,48,24,24
Белхэнд,soulflayer,1678,warrior,arms,109,52,57
Xiiver,burning-legion,1676,warrior,arms,102,58,44
Орданис,deathguard,1675,warrior,arms,48,23,25
Woobaby,outland,1672,warrior,arms,54,30,24
Odenscolddry,kazzak,1672,warrior,arms,65,32,33
Mckinseybcg,outland,1671,warrior,arms,54,33,21
Vallahan,argent-dawn,1671,warrior,arms,155,79,76
Mazaharine,archimonde,1671,warrior,arms,42,20,22
Yelanx,twisting-nether,1670,warrior,arms,36,25,11
Xendyo,frostmourne,1669,warrior,arms,84,38,46
Chromoly,aegwynn,1668,warrior,arms,66,31,35
Nikoma,silvermoon,1667,warrior,arms,36,20,16
Donquiexote,ravencrest,1667,warrior,arms,72,39,33
Damagz,tarren-mill,1667,warrior,arms,65,28,37
Civok,kult-der-verdammten,1665,warrior,arms,42,19,23
Mirageous,tarren-mill,1664,warrior,arms,53,25,28
Drilley,blackmoore,1663,warrior,arms,32,20,12
Nardoch,archimonde,1663,warrior,arms,46,23,23
Bélløne,dalaran,1663,warrior,arms,42,20,22
Zeddone,drakthul,1663,warrior,arms,54,24,30
Mortalfist,stormscale,1662,warrior,arms,31,19,12
Ajax,defias-brotherhood,1662,warrior,arms,53,29,24
Atlizz,twisting-nether,1662,warrior,arms,84,45,39
Erikeverhard,nathrezim,1659,warrior,arms,42,20,22
Robou,hyjal,1659,warrior,arms,115,49,66
Кибервайфу,howling-fjord,1656,warrior,arms,36,22,14
Денеур,gordunni,1656,warrior,arms,60,23,37
Mazutov,outland,1655,warrior,arms,36,25,11
Киссмиплис,gordunni,1655,warrior,arms,57,29,28
Asquare,stormscale,1655,warrior,arms,40,18,22
Фктпх,blackscar,1653,warrior,arms,42,25,17
Соджиро,howling-fjord,1653,warrior,arms,36,18,18
Spartaz,eredar,1653,warrior,arms,60,28,32
Zeepp,ravencrest,1653,warrior,arms,42,19,23
Caméltoe,frostwolf,1650,warrior,arms,126,60,66
Cazaril,kazzak,1649,warrior,arms,131,64,67
Ðezia,tarren-mill,1648,warrior,arms,114,61,53
Spijkerbroek,alakir,1648,warrior,arms,143,76,67
Blizo,tarren-mill,1646,warrior,arms,42,21,21
Fruitdealer,shattrath,1646,warrior,arms,55,23,32
Поршекаен,howling-fjord,1645,warrior,arms,71,29,42
Untiltèd,ravencrest,1644,warrior,arms,77,55,22
Çon,ravencrest,1642,warrior,arms,103,54,49
Mertik,twisting-nether,1641,warrior,arms,36,20,16
Remen,archimonde,1641,warrior,arms,78,34,44
Nerfmyrage,hyjal,1640,warrior,arms,36,22,14
Фенилэфрин,gordunni,1640,warrior,arms,116,59,57
Balltas,drakthul,1640,warrior,arms,86,41,45
Renwíck,burning-legion,1639,warrior,arms,35,18,17
Paranoiás,ragnaros,1639,warrior,arms,50,22,28
Samîr,arthas,1638,warrior,arms,36,21,15
Морнстар,gordunni,1638,warrior,arms,40,20,20
Sefty,tarren-mill,1638,warrior,arms,46,18,28
Saidi,outland,1638,warrior,arms,55,19,36
Babovic,aegwynn,1636,warrior,arms,42,29,13
Lizzybigtits,kazzak,1636,warrior,arms,60,40,20
Lyes,uldaman,1636,warrior,arms,149,76,73
Ítikovan,aegwynn,1636,warrior,arms,156,73,83
Sydian,burning-legion,1635,warrior,arms,36,21,15
Ryofu,stormscale,1635,warrior,arms,42,22,20
Sobii,ravencrest,1634,warrior,arms,35,22,13
Заликмортал,soulflayer,1634,warrior,arms,36,20,16
Krew,drakthul,1634,warrior,arms,66,33,33
Lyroe,blackrock,1633,warrior,arms,42,21,21
Reapo,blackhand,1632,warrior,arms,137,67,70
Orn,tarren-mill,1632,warrior,arms,54,24,30
Blayr,tarren-mill,1631,warrior,arms,71,33,38
Shiqo,ravencrest,1631,warrior,arms,58,26,32
Атаир,deathweaver,1630,warrior,arms,58,30,28
Facestomper,onyxia,1627,warrior,arms,66,37,29
Iameconomist,twisting-nether,1627,warrior,arms,36,17,19
Sickjackenx,executus,1626,warrior,arms,30,17,13
Sahl,sylvanas,1626,warrior,arms,102,53,49
Шагах,soulflayer,1626,warrior,arms,116,56,60
Ebonheart,argent-dawn,1626,warrior,arms,104,50,54
Amokdamis,blackhand,1626,warrior,arms,45,21,24
Watashilfy,ravencrest,1624,warrior,arms,48,24,24
Wlãð,archimonde,1624,warrior,arms,48,23,25
Frozenliøn,twisting-nether,1624,warrior,arms,42,19,23
Xurainlol,eredar,1623,warrior,arms,30,17,13
Lusan,sylvanas,1623,warrior,arms,42,21,21
Донтрелиз,howling-fjord,1622,warrior,arms,42,22,20
Мастерион,soulflayer,1622,warrior,arms,54,28,26
Anthalar,argent-dawn,1621,warrior,arms,54,23,31
Xurainzone,eredar,1619,warrior,arms,30,17,13
Sorkk,kazzak,1618,warrior,arms,50,26,24
Massiveape,argent-dawn,1617,warrior,arms,57,32,25
Aeldran,argent-dawn,1617,warrior,arms,42,23,19
Gladius,ysera,1615,warrior,arms,86,43,43
Manoito,argent-dawn,1615,warrior,arms,48,22,26
Riyan,lothar,1614,warrior,arms,42,24,18
Lockmagewar,burning-legion,1611,warrior,arms,45,22,23
Europ,silvermoon,1611,warrior,arms,54,17,37
Гримг,lich-king,1610,warrior,arms,51,25,26
Куэсес,howling-fjord,1610,warrior,arms,39,19,20
Strife,ravencrest,1609,warrior,arms,81,51,30
Ragëë,tarren-mill,1609,warrior,arms,60,34,26
Wismerx,kazzak,1609,warrior,arms,42,20,22
Whoosah,ragnaros,1608,warrior,arms,105,54,51
Ryle,anubarak,1608,warrior,arms,76,36,40
Кофесмолоком,ashenvale,1608,warrior,arms,53,20,33
Jambaz,ravencrest,1607,warrior,arms,47,23,24
Lpa,stormscale,1606,warrior,arms,48,27,21
Shrekwarr,kazzak,1606,warrior,arms,113,58,55
Banîsher,drakthul,1606,warrior,arms,64,23,41
Brogre,stormrage,1605,warrior,arms,36,20,16
Штурмгешутц,deathweaver,1605,warrior,arms,96,51,45
Haraldjuhnke,frostwolf,1605,warrior,arms,53,27,26
Nakro,hyjal,1604,warrior,arms,24,18,6
Омепразол,gordunni,1604,warrior,arms,149,73,76
Blackfrosty,stormscale,1603,warrior,arms,56,31,25
Андреевич,blackscar,1603,warrior,arms,146,74,72
Mypzo,kazzak,1603,warrior,arms,90,44,46
Batïk,blackmoore,1603,warrior,arms,71,31,40
Eselhirte,blackmoore,1602,warrior,arms,85,46,39
Wítts,ravencrest,1601,warrior,arms,30,20,10
Incendix,stormscale,1601,warrior,arms,36,21,15
Kupr,outland,1601,warrior,arms,40,21,19
Ragnou,tarren-mill,1601,warrior,arms,54,27,27
Naait,draenor,1600,warrior,arms,45,24,21
Lrb,tarren-mill,1600,warrior,arms,46,23,23
Istyos,hyjal,1600,warrior,arms,48,20,28
Bruxus,blackhand,1599,warrior,arms,148,75,73
Trashman,bronzebeard,1598,warrior,arms,66,32,34
Луновоин,gordunni,1597,warrior,arms,48,30,18
Вагранна,soulflayer,1597,warrior,arms,54,26,28
Arandyr,archimonde,1596,warrior,arms,60,24,36
Shirøx,blackrock,1595,warrior,arms,67,38,29
Kobeni,ysondre,1595,warrior,arms,85,40,45
Giganza,outland,1595,warrior,arms,60,27,33
Everdipper,outland,1595,warrior,arms,50,21,29
Бурчун,deathguard,1594,warrior,arms,54,34,20
Phóó,thrall,1593,warrior,arms,72,32,40
Haanok,ravencrest,1591,warrior,arms,59,34,25
Blackbiird,blackmoore,1591,warrior,arms,41,18,23
Aestheticon,burning-blade,1589,warrior,arms,30,19,11
Skrawarr,das-syndikat,1589,warrior,arms,90,47,43
Noitoved,outland,1589,warrior,arms,44,18,26
Thundersword,sylvanas,1589,warrior,arms,84,30,54
Lazytowl,outland,1588,warrior,arms,69,34,35
Alexandrrior,rexxar,1588,warrior,arms,66,31,35
Btr,archimonde,1588,warrior,arms,42,19,23
Malebolia,mugthol,1587,warrior,arms,130,64,66
Skokuxx,silvermoon,1585,warrior,arms,42,20,22
Doloresvp,zuljin,1585,warrior,arms,42,20,22
Lostday,blackrock,1583,warrior,arms,42,19,23
Drahkor,baelgun,1582,warrior,arms,30,20,10
Hortswarr,drakthul,1582,warrior,arms,37,24,13
Fragmeista,ragnaros,1582,warrior,arms,36,17,19
Hamez,thunderhorn,1582,warrior,arms,64,30,34
Krigipigi,antonidas,1582,warrior,arms,48,20,28
Cassândrä,dalaran,1582,warrior,arms,42,17,25
Витодпс,howling-fjord,1581,warrior,arms,48,20,28
Каосвар,howling-fjord,1579,warrior,arms,30,19,11
Gely,silvermoon,1579,warrior,arms,66,33,33
Bamme,archimonde,1579,warrior,arms,41,20,21
Taistelumage,stormreaver,1576,warrior,arms,35,17,18
Wtchmyblade,blackmoore,1575,warrior,arms,36,26,10
Furukawa,ravencrest,1575,warrior,arms,51,24,27
Vôx,sylvanas,1575,warrior,arms,42,19,23
Erotixboi,blackrock,1573,warrior,arms,48,29,19
Оргнар,ashenvale,1573,warrior,arms,48,27,21
Dragoons,tyrande,1573,warrior,arms,54,24,30
Дроктул,howling-fjord,1572,warrior,arms,212,101,111
Креспекс,soulflayer,1572,warrior,arms,56,19,37
Monbun,silvermoon,1570,warrior,arms,101,51,50
Oxay,alakir,1570,warrior,arms,52,21,31
Rîdler,ravencrest,1569,warrior,arms,193,97,96
Planina,ravencrest,1569,warrior,arms,36,17,19
Rakuna,tarren-mill,1568,warrior,arms,108,53,55
Yeahq,kazzak,1568,warrior,arms,78,36,42
Голдибитч,gordunni,1566,warrior,arms,42,23,19
Дейдулус,soulflayer,1566,warrior,arms,78,33,45
Serastul,rajaxx,1565,warrior,arms,86,42,44
Оргрриммар,soulflayer,1565,warrior,arms,180,87,93
Hellespont,hellscream,1565,warrior,arms,77,29,48
Едигейй,gordunni,1564,warrior,arms,58,32,26
Дугмар,gordunni,1564,warrior,arms,117,54,63
Nevergladx,kazzak,1564,warrior,arms,54,23,31
Skylåw,archimonde,1564,warrior,arms,73,26,47
Bloodbrother,blackmoore,1562,warrior,arms,36,20,16
Eren,todeswache,1562,warrior,arms,36,20,16
Asenine,sylvanas,1562,warrior,arms,271,128,143
Gigasmash,pozzo-delleternità,1561,warrior,arms,138,65,73
Daýz,draenor,1561,warrior,arms,48,18,30
Хэлслэйтэр,gordunni,1559,warrior,arms,130,65,65
Imfiñe,outland,1558,warrior,arms,107,51,56
Boldinq,ravencrest,1556,warrior,arms,84,34,50
Lollydhur,nemesis,1555,warrior,arms,48,26,22
Friskos,dalaran,1555,warrior,arms,76,37,39
Reider,twisting-nether,1553,warrior,arms,119,47,72
Туранк,howling-fjord,1552,warrior,arms,100,48,52
Darksídex,silvermoon,1551,warrior,arms,221,114,107
Genjutsubeat,blackmoore,1548,warrior,arms,54,31,23
Pangowar,elune,1548,warrior,arms,33,17,16
Philatou,antonidas,1547,warrior,arms,35,20,15
Nightmareowl,tarren-mill,1547,warrior,arms,42,19,23
Deadlyanger,kazzak,1545,warrior,arms,36,19,17
Morthôr,grim-batol,1545,warrior,arms,69,34,35
Мираксус,soulflayer,1544,warrior,arms,36,18,18
Трешконтент,gordunni,1544,warrior,arms,54,25,29
Jumpilawl,khaz-modan,1544,warrior,arms,50,18,32
Напутанность,soulflayer,1543,warrior,arms,311,162,149
Phenowarri,blackhand,1542,warrior,arms,85,48,37
Troma,archimonde,1542,warrior,arms,48,19,29
Кхаррнн,gordunni,1542,warrior,arms,48,18,30
Wrynir,archimonde,1541,warrior,arms,78,38,40
Pachipachi,blackmoore,1540,warrior,arms,32,17,15
Grezlyk,drakthul,1540,warrior,arms,72,33,39
Cyruk,blackmoore,1540,warrior,arms,42,18,24
Rumer,tarren-mill,1540,warrior,arms,59,23,36
Icybladez,kazzak,1539,warrior,arms,66,36,30
Wildblue,sylvanas,1538,warrior,arms,60,34,26
Icekissx,hyjal,1538,warrior,arms,105,54,51
Blackwólf,bloodhoof,1538,warrior,arms,118,56,62
Гуорг,howling-fjord,1538,warrior,arms,75,32,43
Kurbá,stormscale,1535,warrior,arms,24,16,8
Нифро,fordragon,1535,warrior,arms,29,18,11
Diz,terokkar,1535,warrior,arms,97,58,39
Anakhas,archimonde,1535,warrior,arms,30,16,14
Hobo,ravencrest,1535,warrior,arms,71,32,39
Gargaflike,aggra-português,1533,warrior,arms,60,22,38
Екзобайт,gordunni,1532,warrior,arms,42,17,25
Craghak,twisting-nether,1531,warrior,arms,147,75,72
Tiwâz,eredar,1531,warrior,arms,57,29,28
Èzekiel,dalaran,1530,warrior,arms,36,18,18
Áäáäáäáä,aegwynn,1529,warrior,arms,30,16,14
Nyxz,blackhand,1529,warrior,arms,32,17,15
Громпузан,galakrond,1529,warrior,arms,54,24,30
Zbra,draenor,1528,warrior,arms,30,19,11
Чпокерз,gordunni,1528,warrior,arms,48,25,23
Gravityfalls,blackmoore,1527,warrior,arms,78,39,39
Svënja,ysondre,1527,warrior,arms,96,44,52
Грэйм,gordunni,1526,warrior,arms,52,28,24
Bumoletroll,draenor,1526,warrior,arms,33,17,16
Naskez,kazzak,1524,warrior,arms,30,16,14
Gipsyjoe,ragnaros,1524,warrior,arms,66,31,35
Vilass,silvermoon,1523,warrior,arms,36,19,17
Jøtawarrior,sanguino,1523,warrior,arms,36,18,18
Рыгулька,gordunni,1523,warrior,arms,54,24,30
Skullrage,tarren-mill,1523,warrior,arms,53,22,31
Chargeurface,ragnaros,1522,warrior,arms,24,16,8
Zheq,ragnaros,1522,warrior,arms,30,16,14
Norwegian,silvermoon,1521,warrior,arms,80,37,43
Jigsar,argent-dawn,1519,warrior,arms,81,51,30
Мэйрил,lich-king,1519,warrior,arms,190,99,91
Shownomercy,blackrock,1519,warrior,arms,48,23,25
Arcreign,kazzak,1519,warrior,arms,60,28,32
Authar,tarren-mill,1518,warrior,arms,61,33,28
Exoblade,silvermoon,1518,warrior,arms,64,26,38
Zëhef,hyjal,1516,warrior,arms,66,34,32
Mentôr,sargeras,1516,warrior,arms,35,18,17
Spärtan,dun-modr,1515,warrior,arms,66,34,32
Gozga,twisting-nether,1515,warrior,arms,147,74,73
Alpairx,aegwynn,1514,warrior,arms,40,17,23
Velinde,outland,1512,warrior,arms,34,17,17
Думхаммер,howling-fjord,1511,warrior,arms,71,42,29
Aizy,blackhand,1510,warrior,arms,24,16,8
Bastrick,argent-dawn,1508,warrior,arms,93,45,48
Sonìe,kazzak,1506,warrior,arms,89,51,38
Eskiler,burning-legion,1506,warrior,arms,36,16,20
Raakalainen,vashj,1504,warrior,arms,59,29,30
Savh,silvermoon,1503,warrior,arms,48,28,20
Geforce,hellscream,1503,warrior,arms,84,40,44
Sumprunkare,stormscale,1502,warrior,arms,35,18,17
Zerberos,drakthul,1500,warrior,arms,52,27,25
Nighat,sanguino,1500,warrior,arms,152,77,75
Khireebonk,hyjal,1499,warrior,arms,24,16,8
Crriminal,ravencrest,1498,warrior,arms,48,20,28
Noxeeql,tarren-mill,1495,warrior,arms,24,17,7
Duncán,auchindoun,1495,warrior,arms,29,17,12
Киллдекс,gordunni,1495,warrior,arms,96,43,53
Slidmacka,twisting-nether,1495,warrior,arms,97,42,55
Aurélus,rexxar,1493,warrior,arms,36,22,14
Nameless,ysondre,1492,warrior,arms,30,16,14
Diamonddogs,draenor,1491,warrior,arms,30,17,13
Заверчу,soulflayer,1491,warrior,arms,60,32,28
Divyx,tarren-mill,1491,warrior,arms,60,31,29
Zetorc,burning-legion,1491,warrior,arms,47,24,23
Pumpadzhîja,outland,1491,warrior,arms,66,32,34
Hôrn,stormscale,1489,warrior,arms,54,32,22
Endeawour,ravencrest,1489,warrior,arms,129,75,54
Bluto,dunemaul,1489,warrior,arms,79,39,40
Elder,darkmoon-faire,1489,warrior,arms,42,18,24
Hefthyn,sanguino,1488,warrior,arms,36,20,16
Gorocpt,doomhammer,1488,warrior,arms,44,20,24
Teronth,burning-legion,1488,warrior,arms,48,17,31
Kestialezin,archimonde,1487,warrior,arms,48,33,15
Hindbærsaft,stormscale,1487,warrior,arms,55,32,23
Juoppó,tarren-mill,1484,warrior,arms,74,41,33
Fizzywarrior,blackmoore,1484,warrior,arms,63,29,34
Miko,ysondre,1483,warrior,arms,72,33,39
Gromkarg,draenor,1482,warrior,arms,54,18,36
Marcnky,stormscale,1481,warrior,arms,69,37,32
Vratranzhul,kirin-tor,1481,warrior,arms,199,95,104
Olesbawro,ragnaros,1481,warrior,arms,60,27,33
Altimáte,antonidas,1479,warrior,arms,30,18,12
Протектор,soulflayer,1479,warrior,arms,42,18,24
Boshim,ravencrest,1477,warrior,arms,36,20,16
Арткес,gordunni,1477,warrior,arms,45,23,22
Rázgriz,argent-dawn,1477,warrior,arms,54,24,30
Trenbullone,kazzak,1476,warrior,arms,51,32,19
Pajalousta,elune,1476,warrior,arms,102,47,55
Демолишеер,howling-fjord,1476,warrior,arms,35,16,19
Esegryel,argent-dawn,1476,warrior,arms,53,23,30
Varyian,sporeggar,1475,warrior,arms,119,54,65
Zhulgar,azjolnerub,1474,warrior,arms,42,21,21
Leomance,hyjal,1473,warrior,arms,30,18,12
Tmp,blackrock,1470,warrior,arms,42,22,20
Clellin,silvermoon,1469,warrior,arms,75,37,38
Джасткипинг,gordunni,1467,warrior,arms,114,63,51
Ball,zirkel-des-cenarius,1467,warrior,arms,62,33,29
Megtorló,ragnaros,1467,warrior,arms,62,32,30
Notinfa,draenor,1466,warrior,arms,90,48,42
Rogersrage,ragnaros,1466,warrior,arms,48,24,24
Mfdoöm,draenor,1465,warrior,arms,101,48,53
Dárkhammer,tarren-mill,1465,warrior,arms,54,24,30
Llestatl,hyjal,1464,warrior,arms,65,34,31
Nexpwns,blackhand,1464,warrior,arms,102,50,52
Mazzkze,silvermoon,1463,warrior,arms,186,95,91
Raley,ragnaros,1463,warrior,arms,66,32,34
Carljøhnson,dalaran,1463,warrior,arms,84,37,47
Nèssa,outland,1462,warrior,arms,41,16,25
Dirtyjoe,khaz-modan,1461,warrior,arms,101,56,45
Gridra,dun-morogh,1461,warrior,arms,36,18,18
Reider,kazzak,1460,warrior,arms,57,29,28
Romanul,terokkar,1460,warrior,arms,48,22,26
Сика,blackscar,1460,warrior,arms,48,20,28
Hoomeer,sylvanas,1459,warrior,arms,60,28,32
Ordwinz,silvermoon,1458,warrior,arms,55,29,26
Мускулатор,soulflayer,1458,warrior,arms,90,44,46
Кефтеме,fordragon,1457,warrior,arms,87,42,45
Ckz,ysondre,1455,warrior,arms,24,16,8
Asuramaru,aegwynn,1452,warrior,arms,53,28,25
Omgihithard,draenor,1452,warrior,arms,36,17,19
Calmdownbrú,frostmane,1450,warrior,arms,36,18,18
Dzvenyhora,darkspear,1449,warrior,arms,78,36,42
Fedevalverde,sanguino,1448,warrior,arms,46,32,14
Norinhell,ravencrest,1448,warrior,arms,48,20,28
Endan,kelthuzad,1446,warrior,arms,66,37,29
Dokô,twisting-nether,1446,warrior,arms,72,36,36
Irén,hellfire,1446,warrior,arms,44,20,24
Варгана,soulflayer,1445,warrior,arms,52,25,27
Faustà,nemesis,1445,warrior,arms,54,23,31
Abnôrmus,tarren-mill,1444,warrior,arms,44,25,19
Дообрыйшмель,soulflayer,1443,warrior,arms,51,32,19
Shadowbôxer,onyxia,1443,warrior,arms,44,21,23
Адво,gordunni,1441,warrior,arms,54,26,28
Karimlebrave,hyjal,1440,warrior,arms,68,33,35
Luphrek,ysondre,1439,warrior,arms,24,15,9
Ехрерау,gordunni,1439,warrior,arms,30,15,15
Makerrw,ravencrest,1438,warrior,arms,50,26,24
Dranush,onyxia,1437,warrior,arms,110,58,52
Ardmoo,burning-legion,1437,warrior,arms,39,20,19
Jakim,tarren-mill,1437,warrior,arms,118,57,61
Ганблейд,eversong,1437,warrior,arms,47,19,28
Mélindà,silvermoon,1436,warrior,arms,27,17,10
Lyarinsky,tyrande,1436,warrior,arms,66,36,30
Alyx,mugthol,1436,warrior,arms,66,33,33
Сладкаяхурма,howling-fjord,1436,warrior,arms,42,15,27
Lachandrius,blackhand,1435,warrior,arms,72,33,39
Farrusco,nemesis,1435,warrior,arms,48,22,26
Balthew,defias-brotherhood,1435,warrior,arms,36,15,21
Зеленыйжмых,thermaplugg,1434,warrior,arms,33,17,16
Thaldrys,blackhand,1434,warrior,arms,97,43,54
Jackyred,silvermoon,1434,warrior,arms,36,15,21
Бэнчпресс,soulflayer,1434,warrior,arms,36,15,21
Jínro,draenor,1432,warrior,arms,36,15,21
Dragão,kazzak,1431,warrior,arms,42,17,25
Ènteqt,antonidas,1430,warrior,arms,43,29,14
Otiep,blackmoore,1430,warrior,arms,36,24,12
Dataçasé,silvermoon,1430,warrior,arms,24,15,9
Prøject,archimonde,1430,warrior,arms,30,15,15
Андэрс,gordunni,1429,warrior,arms,106,51,55
Ormert,sylvanas,1429,warrior,arms,42,18,24
Qvate,twisting-nether,1427,warrior,arms,59,31,28
Nicperh,dun-modr,1427,warrior,arms,42,21,21
Бисовыйармен,soulflayer,1427,warrior,arms,30,15,15
Alinash,aegwynn,1427,warrior,arms,51,24,27
Kantarion,stormscale,1427,warrior,arms,36,16,20
Bráïnléss,silvermoon,1426,warrior,arms,36,17,19
Togas,silvermoon,1425,warrior,arms,153,77,76
Pokopo,blackrock,1425,warrior,arms,211,103,108
Rodenet,dun-modr,1423,warrior,arms,54,28,26
Zoefernandes,kazzak,1423,warrior,arms,42,15,27
Smoothbrian,ravencrest,1421,warrior,arms,24,15,9
Informatica,doomhammer,1420,warrior,arms,36,18,18
Néxtlølz,twisting-nether,1420,warrior,arms,30,15,15
Zellxd,stormscale,1418,warrior,arms,36,20,16
Avelyr,pozzo-delleternità,1418,warrior,arms,30,15,15
Мерсилессх,gordunni,1418,warrior,arms,84,39,45
Nuahka,blackmoore,1416,warrior,arms,28,17,11
Гардринг,howling-fjord,1416,warrior,arms,66,39,27
Газрош,howling-fjord,1416,warrior,arms,46,22,24
Madaxe,kazzak,1414,warrior,arms,24,20,4
Paow,tarren-mill,1414,warrior,arms,35,16,19
Oruka,mannoroth,1412,warrior,arms,42,24,18
Drushíí,shattrath,1411,warrior,arms,35,17,18
Ferpylél,ragnaros,1408,warrior,arms,31,17,14
Fáro,ravencrest,1407,warrior,arms,40,16,24
Spargebuci,draenor,1406,warrior,arms,48,17,31
Franzbardon,archimonde,1404,warrior,arms,72,35,37
Mogolaki,twilights-hammer,1404,warrior,arms,42,20,22
Stormfist,tarren-mill,1403,warrior,arms,36,19,17
Bjösk,stormscale,1403,warrior,arms,45,23,22
Kaîsaschnitt,malganis,1402,warrior,arms,64,37,27
Gervvand,burning-legion,1402,warrior,arms,30,15,15
Cutting,burning-legion,1402,warrior,arms,55,25,30
Ayelsyssup,silvermoon,1401,warrior,arms,48,23,25
Chakrator,la-croisade-écarlate,1401,warrior,arms,48,23,25
Северот,deepholm,1401,warrior,arms,35,16,19
Peldreas,silvermoon,1400,warrior,arms,64,31,33
Казгримм,howling-fjord,1400,warrior,arms,48,23,25
Zosska,burning-legion,1400,warrior,arms,42,20,22
Абабоба,gordunni,1398,warrior,arms,30,16,14
Doxinator,silvermoon,1396,warrior,arms,81,33,48
ßladex,azshara,1395,warrior,arms,35,21,14
Scrèàm,tarren-mill,1395,warrior,arms,60,28,32
Hellrokk,drakthul,1394,warrior,arms,24,15,9
Bládez,ravencrest,1394,warrior,arms,66,36,30
Nekerka,burning-legion,1394,warrior,arms,65,33,32
Jáson,kazzak,1394,warrior,arms,65,29,36
Papipulki,zuljin,1394,warrior,arms,56,23,33
Phovoss,stormscale,1394,warrior,arms,42,15,27
Mgw,blackrock,1393,warrior,arms,24,15,9
Агамемнан,soulflayer,1391,warrior,arms,118,61,57
Алексвайтт,gordunni,1391,warrior,arms,47,23,24
Architectman,twisting-nether,1391,warrior,arms,78,35,43
Bloodmyst,kazzak,1391,warrior,arms,36,15,21
Hradball,twilights-hammer,1390,warrior,arms,60,28,32
Okoru,stormscale,1390,warrior,arms,57,22,35
Jumbodolmen,tarren-mill,1389,warrior,arms,30,16,14
Àlexander,ravencrest,1389,warrior,arms,29,15,14
Arithael,dun-modr,1388,warrior,arms,132,67,65
Vagor,aegwynn,1388,warrior,arms,60,30,30
Arreat,chogall,1388,warrior,arms,96,41,55
Nucleargrab,twilights-hammer,1385,warrior,arms,109,53,56
Malalulu,burning-legion,1385,warrior,arms,113,54,59
Дикийппц,gordunni,1384,warrior,arms,36,21,15
Diástasi,twisting-nether,1384,warrior,arms,90,48,42
Conanh,pozzo-delleternità,1384,warrior,arms,50,24,26
Dafok,rashgarroth,1384,warrior,arms,36,15,21
Cássándráh,argent-dawn,1383,warrior,arms,56,28,28
Tontonsmoky,hyjal,1383,warrior,arms,49,22,27
Кэфтэмэ,soulflayer,1382,warrior,arms,73,35,38
Ràkar,stormscale,1382,warrior,arms,36,16,20
Espröc,kazzak,1381,warrior,arms,161,83,78
Nøcturnaqq,silvermoon,1378,warrior,arms,30,15,15
Неосим,gordunni,1377,warrior,arms,42,25,17
Pakusrage,defias-brotherhood,1377,warrior,arms,62,26,36
Xaheld,blackrock,1376,warrior,arms,30,16,14
Temprament,ravencrest,1375,warrior,arms,36,21,15
Cléàvage,silvermoon,1374,warrior,arms,81,32,49
Beelzebuu,blackhand,1373,warrior,arms,55,29,26
Iljaana,blackrock,1373,warrior,arms,60,30,30
Mljecho,kazzak,1372,warrior,arms,107,52,55
Bleckwarrior,ravencrest,1371,warrior,arms,78,39,39
Éls,argent-dawn,1371,warrior,arms,42,19,23
Taylorswifty,twisting-nether,1370,warrior,arms,90,48,42
Furanos,blackrock,1370,warrior,arms,35,15,20
Rakwarrior,blackhand,1369,warrior,arms,30,20,10
Weareinspace,stormscale,1369,warrior,arms,52,29,23
Паракур,soulflayer,1369,warrior,arms,60,27,33
Mograinê,blackmoore,1368,warrior,arms,60,31,29
Tyëlin,elune,1364,warrior,arms,95,45,50
Gacel,dun-modr,1364,warrior,arms,54,24,30
Lyfttokyo,tarren-mill,1363,warrior,arms,60,28,32
Carras,confrérie-du-thorium,1362,warrior,arms,113,51,62
Propanex,kazzak,1361,warrior,arms,42,26,16
Vølverinwar,thrall,1361,warrior,arms,82,37,45
Grahatia,magtheridon,1360,warrior,arms,75,42,33
Nabul,thunderhorn,1359,warrior,arms,30,16,14
Panggy,ragnaros,1359,warrior,arms,36,15,21
Agoobagoo,alakir,1358,warrior,arms,35,15,20
Zargor,kazzak,1354,warrior,arms,52,31,21
Tealbell,chamber-of-aspects,1354,warrior,arms,101,55,46
Bxnx,aegwynn,1353,warrior,arms,36,21,15
Казньшалав,gordunni,1353,warrior,arms,45,20,25
Авентадорх,deathguard,1352,warrior,arms,83,32,51
Staribrko,outland,1349,warrior,arms,144,66,78
Qiz,silvermoon,1347,warrior,arms,134,68,66
Einherjer,burning-legion,1346,warrior,arms,58,32,26
Pummelpete,grim-batol,1344,warrior,arms,24,14,10
Pazl,outland,1344,warrior,arms,36,17,19
Beevzyn,blackmoore,1343,warrior,arms,18,14,4
Мобсто,soulflayer,1343,warrior,arms,30,15,15
Tucomessuelo,cthun,1343,warrior,arms,36,17,19
Izestyi,blackrock,1343,warrior,arms,66,31,35
Colard,ravencrest,1343,warrior,arms,30,14,16
Belattor,silvermoon,1343,warrior,arms,30,14,16
Buyya,ravencrest,1342,warrior,arms,58,31,27
Bonesz,jaedenar,1342,warrior,arms,99,50,49
Hulksmsh,hyjal,1342,warrior,arms,36,14,22
Zzeed,auchindoun,1341,warrior,arms,48,19,29
Chadsmorc,twisting-nether,1339,warrior,arms,18,14,4
Yukizz,ravencrest,1339,warrior,arms,24,14,10
Feckdech,blackrock,1339,warrior,arms,24,14,10
Zandawar,drakthul,1339,warrior,arms,59,33,26
Хеликат,soulflayer,1338,warrior,arms,30,14,16
Thisguyfax,the-venture-co,1337,warrior,arms,60,32,28
Zaatar,draenor,1337,warrior,arms,72,38,34
Littlebugger,ravencrest,1336,warrior,arms,24,14,10
Хазгора,howling-fjord,1336,warrior,arms,78,44,34
Raixxon,ragnaros,1336,warrior,arms,48,20,28
Melliug,ysondre,1335,warrior,arms,40,15,25
Jimei,temple-noir,1333,warrior,arms,24,14,10
Taikyokuken,hyjal,1333,warrior,arms,60,27,33
Fàlconry,kazzak,1333,warrior,arms,102,43,59
Zool,madmortem,1332,warrior,arms,56,27,29
Флэксик,soulflayer,1331,warrior,arms,24,14,10
Ricssonz,burning-legion,1331,warrior,arms,24,14,10
Hatefury,twisting-nether,1331,warrior,arms,84,38,46
Tarkosha,terokkar,1330,warrior,arms,232,110,122
Kleidaria,stormscale,1328,warrior,arms,24,14,10
Shádówfáxí,outland,1328,warrior,arms,30,14,16
Лисерк,howling-fjord,1328,warrior,arms,36,14,22
Haewon,burning-legion,1328,warrior,arms,42,16,26
Behemothwr,kazzak,1327,warrior,arms,75,37,38
Nàsher,frostwolf,1327,warrior,arms,30,14,16
Greekazi,kazzak,1327,warrior,arms,57,26,31
Chádtóurps,drakthul,1326,warrior,arms,29,14,15
Swefy,sanguino,1326,warrior,arms,139,62,77
Mysteryman,defias-brotherhood,1325,warrior,arms,24,15,9
Нетконечно,howling-fjord,1325,warrior,arms,30,14,16
Mortalik,silvermoon,1324,warrior,arms,166,77,89
Fantasý,burning-legion,1324,warrior,arms,35,14,21
Ähäkutti,frostmane,1323,warrior,arms,42,23,19
Highz,grim-batol,1323,warrior,arms,36,18,18
Gorchak,blackmoore,1323,warrior,arms,113,52,61
Leroxius,ragnaros,1322,warrior,arms,126,61,65
Nelthôr,alleria,1321,warrior,arms,71,34,37
Ashiku,zuljin,1321,warrior,arms,54,23,31
Crayz,twisting-nether,1320,warrior,arms,30,14,16
Throck,drakthul,1320,warrior,arms,41,18,23
Lostbull,kazzak,1317,warrior,arms,30,14,16
Astven,blackmoore,1316,warrior,arms,40,16,24
Peack,ravencrest,1315,warrior,arms,137,68,69
Guruntar,kirin-tor,1315,warrior,arms,62,29,33
Ràgnarok,chogall,1314,warrior,arms,72,39,33
Imora,silvermoon,1314,warrior,arms,36,18,18
Alborozie,archimonde,1314,warrior,arms,30,14,16
Kmica,khadgar,1314,warrior,arms,61,27,34
Strapnslap,argent-dawn,1314,warrior,arms,78,30,48
Shoesmith,outland,1313,warrior,arms,54,15,39
Issatank,frostmane,1312,warrior,arms,42,21,21
Оморальный,soulflayer,1311,warrior,arms,88,39,49
Скользкийбро,gordunni,1310,warrior,arms,54,24,30
Megatronman,ravencrest,1309,warrior,arms,24,14,10
Roctah,auchindoun,1309,warrior,arms,46,24,22
Garganelli,tarren-mill,1309,warrior,arms,48,21,27
Aggamemnus,ravencrest,1308,warrior,arms,44,28,16
Ylana,eldrethalas,1308,warrior,arms,99,43,56
Neverkind,twisting-nether,1307,warrior,arms,66,37,29
Ovcharq,steamwheedle-cartel,1306,warrior,arms,67,34,33
Lûckystríké,blackmoore,1305,warrior,arms,52,25,27
Youokhun,kazzak,1302,warrior,arms,42,21,21
Bossít,doomhammer,1301,warrior,arms,80,44,36
Ragnacore,ravencrest,1301,warrior,arms,53,29,24
Reichas,ragnaros,1301,warrior,arms,37,20,17
Tazkax,archimonde,1301,warrior,arms,34,15,19
Tazdingowar,antonidas,1301,warrior,arms,58,23,35
Berzzerker,tarren-mill,1300,warrior,arms,48,22,26
Shuraj,hyjal,1299,warrior,arms,46,24,22
Elénir,dalaran,1297,warrior,arms,24,15,9
Cárbo,silvermoon,1296,warrior,arms,61,34,27
Yayoflauta,sanguino,1296,warrior,arms,36,16,20
Рестат,soulflayer,1296,warrior,arms,89,35,54
Seliasbro,kazzak,1295,warrior,arms,30,15,15
Сэлфиш,lich-king,1295,warrior,arms,29,14,15
Chippéd,draenor,1294,warrior,arms,23,14,9
Semanor,aegwynn,1291,warrior,arms,30,16,14
Kravaiski,argent-dawn,1291,warrior,arms,90,44,46
Zeroskllz,outland,1291,warrior,arms,70,33,37
Inelegant,tarren-mill,1290,warrior,arms,60,32,28
Ghorglukk,lightnings-blade,1290,warrior,arms,60,28,32
Perkoulator,archimonde,1290,warrior,arms,69,30,39
Geraltf,tarren-mill,1290,warrior,arms,48,20,28
Huscar,thrall,1290,warrior,arms,35,14,21
Piksitron,silvermoon,1289,warrior,arms,60,37,23
Ingensan,lightbringer,1288,warrior,arms,51,22,29
Lebronjones,sylvanas,1282,warrior,arms,66,32,34
Bluntsword,twisting-nether,1282,warrior,arms,36,17,19
Unarde,silvermoon,1281,warrior,arms,167,83,84
Pptickler,argent-dawn,1280,warrior,arms,29,14,15
Гогрикк,ashenvale,1279,warrior,arms,72,35,37
Malevolént,silvermoon,1279,warrior,arms,54,25,29
Kloppnîx,blackmoore,1278,warrior,arms,50,31,19
Фикпопадешь,lich-king,1278,warrior,arms,45,17,28
Arms,earthen-ring,1275,warrior,arms,26,14,12
Pacosky,burning-legion,1275,warrior,arms,57,28,29
Jisoowar,blackhand,1275,warrior,arms,42,19,23
Tedbuckland,blackrock,1273,warrior,arms,24,15,9
Инелутабл,eversong,1273,warrior,arms,23,14,9
Xunaakt,nemesis,1273,warrior,arms,69,34,35
Ангрол,grom,1273,warrior,arms,35,14,21
Rahaaxhia,kaelthas,1271,warrior,arms,24,15,9
Waf,hakkar,1270,warrior,arms,42,20,22
Elyrax,dun-modr,1270,warrior,arms,30,14,16
Джондо,gordunni,1269,warrior,arms,30,14,16
Aliasus,outland,1264,warrior,arms,36,16,20
Ranran,emerald-dream,1264,warrior,arms,32,14,18
Hellzint,sanguino,1264,warrior,arms,177,76,101
Mortalgrim,ravencrest,1263,warrior,arms,30,14,16
Colosius,stormscale,1262,warrior,arms,48,29,19
Silabozija,ravencrest,1262,warrior,arms,60,29,31
Sertigan,dun-modr,1262,warrior,arms,39,16,23
Безбожник,eversong,1261,warrior,arms,42,22,20
Exot,eredar,1257,warrior,arms,48,26,22
Carsannies,stormscale,1257,warrior,arms,100,46,54
Trajkovic,ravencrest,1256,warrior,arms,48,24,24
Apôlyon,antonidas,1256,warrior,arms,29,14,15
Orwêll,uldum,1256,warrior,arms,39,15,24
Soulcleaver,stormreaver,1255,warrior,arms,44,23,21
Кентаныч,howling-fjord,1254,warrior,arms,48,22,26
Buntstift,thrall,1254,warrior,arms,42,14,28
Semmino,nemesis,1248,warrior,arms,24,13,11
Kanté,burning-blade,1247,warrior,arms,18,13,5
Leeches,aggramar,1247,warrior,arms,24,13,11
Kragrâu,kazzak,1247,warrior,arms,24,13,11
Mastodøntes,hyjal,1247,warrior,arms,30,13,17
Loty,drakthul,1247,warrior,arms,30,13,17
Kásúxøxøw,ravencrest,1247,warrior,arms,30,13,17
Aixer,archimonde,1247,warrior,arms,30,13,17
Абырабыр,howling-fjord,1246,warrior,arms,18,13,5
Sponkss,tarren-mill,1246,warrior,arms,24,13,11
Bloodx,archimonde,1245,warrior,arms,18,13,5
Nurekin,argent-dawn,1245,warrior,arms,30,13,17
Ødên,frostmane,1243,warrior,arms,24,13,11
Zaerna,draenor,1243,warrior,arms,24,13,11
Ральдвин,gordunni,1243,warrior,arms,47,24,23
Tinkaton,sylvanas,1243,warrior,arms,30,13,17
Buckiesøde,twisting-nether,1243,warrior,arms,30,13,17
Oplarxigos,kazzak,1243,warrior,arms,36,13,23
Soundso,blackmoore,1242,warrior,arms,26,15,11
Narcx,kazzak,1242,warrior,arms,24,13,11
Nazhar,kult-der-verdammten,1242,warrior,arms,24,13,11
Фурианка,galakrond,1242,warrior,arms,27,14,13
Átlás,blackmoore,1242,warrior,arms,43,19,24
Asipositas,eredar,1242,warrior,arms,30,13,17
Gonutz,sylvanas,1241,warrior,arms,24,13,11
Eyeslicer,quelthalas,1241,warrior,arms,24,13,11
Ðræms,eldrethalas,1241,warrior,arms,60,27,33
Neoballac,uldum,1241,warrior,arms,30,13,17
Onee,terrordar,1240,warrior,arms,25,14,11
Laavapoeg,outland,1240,warrior,arms,24,13,11
Jaru,alleria,1240,warrior,arms,51,27,24
Dûrøtan,marécage-de-zangar,1240,warrior,arms,38,15,23
Тролльвоен,gordunni,1239,warrior,arms,21,13,8
Hackamore,suramar,1239,warrior,arms,24,13,11
Архиватор,gordunni,1239,warrior,arms,24,13,11
Fiveboy,tarren-mill,1238,warrior,arms,24,13,11
Heltslut,tarren-mill,1238,warrior,arms,36,13,23
Rorix,blackrock,1237,warrior,arms,24,13,11
Bloodrain,twilights-hammer,1237,warrior,arms,24,13,11
Kirowarrior,silvermoon,1237,warrior,arms,52,24,28
Tahzwolf,stormscale,1236,warrior,arms,18,13,5
Etelä,stormreaver,1236,warrior,arms,30,16,14
Secondwarri,frostwolf,1236,warrior,arms,30,13,17
Makgorei,outland,1236,warrior,arms,39,14,25
Rochful,frostwolf,1235,warrior,arms,36,19,17
Mävïs,ravencrest,1235,warrior,arms,41,16,25
Plt,talnivarr,1233,warrior,arms,41,25,16
Раздолбатель,razuvious,1233,warrior,arms,25,14,11
Funknîco,wrathbringer,1233,warrior,arms,37,19,18
Трафалльгар,gordunni,1232,warrior,arms,44,22,22
Kianit,ravencrest,1232,warrior,arms,79,30,49
Atus,dun-modr,1231,warrior,arms,53,25,28
Royoxo,blackrock,1230,warrior,arms,24,13,11
Rayguerrero,blackrock,1229,warrior,arms,36,13,23
Diggawhat,antonidas,1228,warrior,arms,64,28,36
Ахиллслэм,howling-fjord,1228,warrior,arms,35,13,22
Faugh,tarren-mill,1227,warrior,arms,24,14,10
Кизуми,gordunni,1227,warrior,arms,33,14,19
Uclat,archimonde,1226,warrior,arms,60,29,31
Элейд,thermaplugg,1225,warrior,arms,47,23,24
Narox,arathor,1223,warrior,arms,50,22,28
Yuriko,onyxia,1222,warrior,arms,24,13,11
Solaría,garona,1222,warrior,arms,30,15,15
Дрейсен,gordunni,1219,warrior,arms,24,14,10
Raznon,magtheridon,1218,warrior,arms,36,13,23
Joka,dun-modr,1216,warrior,arms,37,19,18
Ghostwarx,blackmoore,1215,warrior,arms,38,19,19
Garosh,drakthul,1215,warrior,arms,60,29,31
Zuggizug,draenor,1214,warrior,arms,54,27,27
Zøom,ysondre,1213,warrior,arms,82,41,41
Атон,gordunni,1212,warrior,arms,44,20,24
Nårgaí,kargath,1211,warrior,arms,30,13,17
Hørror,nemesis,1211,warrior,arms,30,13,17
Maggisauce,aegwynn,1209,warrior,arms,57,32,25
Maidenlless,ravencrest,1208,warrior,arms,36,13,23
Kaliroll,ysondre,1206,warrior,arms,30,13,17
Lûxn,silvermoon,1205,warrior,arms,134,65,69
Excutíé,twisting-nether,1202,warrior,arms,30,18,12
Beans,argent-dawn,1202,warrior,arms,90,37,53
Крахгал,soulflayer,1201,warrior,arms,159,80,79
Dreamkil,archimonde,1201,warrior,arms,86,43,43
Donátos,aegwynn,1201,warrior,arms,36,15,21
Aiarm,twisting-nether,1200,warrior,arms,48,31,17
Morrzerk,sylvanas,1198,warrior,arms,29,15,14
Mañtís,argent-dawn,1198,warrior,arms,80,41,39
Rayeron,sanguino,1198,warrior,arms,39,16,23
Grinrok,thrall,1197,warrior,arms,66,29,37
Mozterwar,ravencrest,1197,warrior,arms,66,28,38
Reapersrage,twisting-nether,1195,warrior,arms,27,13,14
Mintys,sylvanas,1194,warrior,arms,23,13,10
Nøiir,malfurion,1194,warrior,arms,30,15,15
Rèâpèr,kazzak,1193,warrior,arms,42,27,15
Valíon,outland,1191,warrior,arms,42,22,20
Клайминг,soulflayer,1190,warrior,arms,18,13,5
Slaughteredd,kazzak,1190,warrior,arms,48,17,31
Kerisandra,silvermoon,1188,warrior,arms,37,22,15
Kurzen,voljin,1187,warrior,arms,41,17,24
Crotoss,ravencrest,1185,warrior,arms,31,15,16
Pyret,outland,1185,warrior,arms,40,14,26
Hatethisgame,frostwolf,1184,warrior,arms,28,13,15
Доминатори,grom,1181,warrior,arms,37,15,22
Sýkz,exodar,1181,warrior,arms,35,13,22
Neltharon,silvermoon,1179,warrior,arms,27,17,10
Виднокрай,gordunni,1177,warrior,arms,36,13,23
Elyalol,ragnaros,1174,warrior,arms,33,15,18
Quarantino,ysondre,1173,warrior,arms,76,35,41
Balyndâ,aegwynn,1170,warrior,arms,32,16,16
Роккар,gordunni,1168,warrior,arms,42,22,20
Szelenamoon,outland,1168,warrior,arms,26,13,13
Azëlls,archimonde,1166,warrior,arms,94,46,48
Whàtsup,stormscale,1166,warrior,arms,36,17,19
Sistabossen,magtheridon,1165,warrior,arms,24,13,11
Daguangming,outland,1165,warrior,arms,59,23,36
Smeshh,burning-legion,1162,warrior,arms,24,15,9
Слуфен,galakrond,1158,warrior,arms,24,14,10
Дрейтон,eversong,1157,warrior,arms,42,20,22
Regna,eredar,1157,warrior,arms,90,42,48
Бежа,gordunni,1152,warrior,arms,33,23,10
Belfodiris,stormscale,1152,warrior,arms,18,12,6
Okcool,twisting-nether,1152,warrior,arms,18,12,6
Dõxlol,kazzak,1152,warrior,arms,24,12,12
Azotz,archimonde,1152,warrior,arms,24,12,12
Мираккл,borean-tundra,1151,warrior,arms,18,12,6
Valoo,malganis,1151,warrior,arms,24,12,12
Konebankærn,ravencrest,1151,warrior,arms,30,12,18
Eidzø,tarren-mill,1150,warrior,arms,18,12,6
Zidbi,argent-dawn,1150,warrior,arms,24,12,12
Crazykind,kazzak,1150,warrior,arms,24,12,12
Devidz,outland,1150,warrior,arms,30,12,18
Crushonyou,aegwynn,1149,warrior,arms,24,12,12
ßigarms,ravencrest,1148,warrior,arms,18,12,6
Соловейч,howling-fjord,1148,warrior,arms,24,13,11
Jonalina,gilneas,1148,warrior,arms,84,42,42
Karden,doomhammer,1148,warrior,arms,48,17,31
Chillycheesy,blackmoore,1148,warrior,arms,42,12,30
Zwerk,rajaxx,1147,warrior,arms,24,12,12
Ïnahö,hyjal,1147,warrior,arms,24,12,12
Trenôdeca,stormscale,1147,warrior,arms,24,12,12
Килафх,blackscar,1147,warrior,arms,30,12,18
Josem,sanguino,1147,warrior,arms,33,13,20
Neoh,onyxia,1146,warrior,arms,51,29,22
Ragedotcom,archimonde,1146,warrior,arms,30,16,14
Эпитафорх,blackscar,1146,warrior,arms,24,12,12
Senshin,sanguino,1146,warrior,arms,24,12,12
Ansi,argent-dawn,1146,warrior,arms,30,12,18
Iluwar,ragnaros,1146,warrior,arms,106,42,64
Argaskurken,ravencrest,1145,warrior,arms,24,12,12
Ladoz,ragnaros,1145,warrior,arms,24,12,12
Argadea,archimonde,1145,warrior,arms,42,19,23
Агрегат,goldrinn,1145,warrior,arms,30,12,18
Kultigin,ravencrest,1144,warrior,arms,24,12,12
Bucketheadde,thrall,1144,warrior,arms,36,12,24
Hùmøngöúslåm,ravencrest,1143,warrior,arms,18,12,6
Dundulinka,outland,1143,warrior,arms,27,12,15
Abrash,ysondre,1143,warrior,arms,36,12,24
Meistarinn,draenor,1143,warrior,arms,36,12,24
Brahlus,frostwolf,1142,warrior,arms,30,13,17
Скрежет,gordunni,1142,warrior,arms,30,12,18
Zyzy,arathor,1141,warrior,arms,24,12,12
Brutøs,conseil-des-ombres,1141,warrior,arms,24,12,12
Xanatos,khazgoroth,1140,warrior,arms,36,12,24
Ironsteve,blackmoore,1139,warrior,arms,225,100,125
Ragark,quelthalas,1139,warrior,arms,36,16,20
Галактозар,soulflayer,1138,warrior,arms,96,40,56
Баварриор,greymane,1137,warrior,arms,30,12,18
Mkazy,kirin-tor,1135,warrior,arms,24,12,12
Téldrus,blackrock,1135,warrior,arms,24,12,12
Addy,twisting-nether,1135,warrior,arms,24,12,12
Погоныч,soulflayer,1135,warrior,arms,30,13,17
Difalco,archimonde,1134,warrior,arms,66,33,33
Grimhew,argent-dawn,1134,warrior,arms,30,12,18
Eekz,haomarush,1132,warrior,arms,24,12,12
Палачубийца,deathguard,1131,warrior,arms,71,35,36
Tercio,exodar,1130,warrior,arms,73,32,41
Tajiri,alakir,1126,warrior,arms,64,32,32
Jasperr,nemesis,1123,warrior,arms,79,38,41
Mödhan,archimonde,1123,warrior,arms,28,13,15
Pawn,twisting-nether,1122,warrior,arms,30,12,18
Ordínaryname,blackrock,1121,warrior,arms,234,120,114
Yüle,uldaman,1121,warrior,arms,30,15,15
Nurychïc,twisting-nether,1118,warrior,arms,21,13,8
Diliul,doomhammer,1118,warrior,arms,28,15,13
Meistersykes,silvermoon,1118,warrior,arms,26,13,13
Sway,eonar,1117,warrior,arms,69,28,41
Draktul,aegwynn,1116,warrior,arms,24,14,10
Шлифую,howling-fjord,1115,warrior,arms,25,13,12
Джагенвард,soulflayer,1115,warrior,arms,24,12,12
Wyshh,silvermoon,1115,warrior,arms,63,27,36
Liferuiner,rexxar,1114,warrior,arms,32,13,19
Draleckx,sanguino,1112,warrior,arms,118,51,67
Kugghalfswor,doomhammer,1111,warrior,arms,190,87,103
Dicaprios,silvermoon,1109,warrior,arms,36,14,22
Sûgma,blackhand,1108,warrior,arms,44,23,21
Doveloo,kazzak,1102,warrior,arms,30,15,15
Миранир,soulflayer,1102,warrior,arms,62,30,32
Røiivar,hyjal,1102,warrior,arms,169,74,95
Luunk,ravencrest,1101,warrior,arms,48,23,25
Endermite,magtheridon,1099,warrior,arms,53,24,29
Rutrah,ysondre,1099,warrior,arms,30,12,18
Crixusxx,sanguino,1096,warrior,arms,25,13,12
Фастод,greymane,1095,warrior,arms,54,24,30
Perykø,sanguino,1094,warrior,arms,34,12,22
Sloppychoppy,silvermoon,1093,warrior,arms,47,19,28
Garwarr,twisting-nether,1092,warrior,arms,25,13,12
Копенгаген,ashenvale,1091,warrior,arms,33,13,20
Thehans,grim-batol,1081,warrior,arms,32,15,17
Gèrralt,hyjal,1081,warrior,arms,29,12,17
Atelier,magtheridon,1078,warrior,arms,36,19,17
Inticam,durotan,1077,warrior,arms,31,17,14
Ugardosh,burning-legion,1077,warrior,arms,34,12,22
Stuble,blackhand,1076,warrior,arms,41,19,22
Cárlsberg,pozzo-delleternità,1073,warrior,arms,36,12,24
Киефси,howling-fjord,1071,warrior,arms,36,18,18
Obscurìa,argent-dawn,1068,warrior,arms,84,35,49
Gladiattus,drakthul,1067,warrior,arms,36,16,20
Дикийлёха,soulflayer,1064,warrior,arms,36,18,18
Draemmer,minahonda,1062,warrior,arms,24,12,12
Keksparrow,antonidas,1059,warrior,arms,36,16,20
Áosr,ravencrest,1057,warrior,arms,47,24,23
Nøøbisator,archimonde,1057,warrior,arms,30,13,17
Рексторм,soulflayer,1056,warrior,arms,12,11,1
Schwän,twisting-nether,1056,warrior,arms,18,11,7
Klnrk,ravencrest,1056,warrior,arms,18,11,7
Rexonawarr,kazzak,1056,warrior,arms,18,11,7
Xzm,stormscale,1056,warrior,arms,21,12,9
Dariusvolt,argent-dawn,1056,warrior,arms,59,31,28
Ragestarved,ragnaros,1056,warrior,arms,24,11,13
Êphêý,kazzak,1056,warrior,arms,24,11,13
Anahkas,archimonde,1056,warrior,arms,24,11,13
Hangart,argent-dawn,1056,warrior,arms,30,11,19
Xåb,dun-morogh,1056,warrior,arms,36,11,25
Анархорок,howling-fjord,1055,warrior,arms,18,11,7
Sanerion,antonidas,1055,warrior,arms,18,11,7
Тарартзу,soulflayer,1055,warrior,arms,18,11,7
Scormash,burning-legion,1055,warrior,arms,24,11,13
Cyanerd,bronzebeard,1055,warrior,arms,24,11,13
Huyer,stormscale,1055,warrior,arms,24,11,13
Амаззони,howling-fjord,1055,warrior,arms,24,11,13
Justyòqt,archimonde,1055,warrior,arms,24,11,13
Markorok,kazzak,1054,warrior,arms,18,11,7
Aemox,silvermoon,1054,warrior,arms,18,11,7
Klinga,bladefist,1054,warrior,arms,18,11,7
Râmi,perenolde,1054,warrior,arms,24,11,13
Bursch,ravencrest,1054,warrior,arms,24,11,13
Apollos,der-mithrilorden,1054,warrior,arms,30,11,19
Ganzaésábi,aggra-português,1053,warrior,arms,18,11,7
Khoroc,die-aldor,1053,warrior,arms,30,11,19
Orgi,drakthul,1053,warrior,arms,30,11,19
Scusi,burning-blade,1053,warrior,arms,30,11,19
Salamandar,zenedar,1053,warrior,arms,36,11,25
Gnomekek,sylvanas,1052,warrior,arms,30,11,19
Swayzze,frostwolf,1052,warrior,arms,30,11,19
Deathwingx,azuremyst,1052,warrior,arms,33,12,21
Deviousjr,ragnaros,1051,warrior,arms,18,11,7
Alphachadwar,azjolnerub,1051,warrior,arms,24,11,13
Шорпит,howling-fjord,1051,warrior,arms,66,26,40
Chrekk,khaz-modan,1050,warrior,arms,24,11,13
Grimarg,drakthul,1050,warrior,arms,24,11,13
Ironsíde,alakir,1050,warrior,arms,30,11,19
Grumpy,lightbringer,1050,warrior,arms,30,11,19
Kilsorrow,silvermoon,1050,warrior,arms,30,11,19
Cliwar,ragnaros,1047,warrior,arms,24,15,9
Bellator,arakarahm,1047,warrior,arms,24,11,13
Krigsdunken,draenor,1047,warrior,arms,48,15,33
Darksworn,alleria,1046,warrior,arms,18,11,7
Batalius,dalaran,1046,warrior,arms,30,11,19
Liper,silvermoon,1046,warrior,arms,33,12,21
Roponmatsu,draenor,1045,warrior,arms,24,11,13
Bigboibeeper,draenor,1045,warrior,arms,30,11,19
Arkcules,ghostlands,1044,warrior,arms,24,11,13
Pitii,burning-legion,1044,warrior,arms,26,11,15
Razoo,stormscale,1044,warrior,arms,36,11,25
Zeldaixi,twisting-nether,1043,warrior,arms,18,11,7
Pips,minahonda,1041,warrior,arms,42,13,29
Nokturnâl,silvermoon,1037,warrior,arms,18,11,7
Pwettygal,tarren-mill,1037,warrior,arms,36,13,23
Ruga,echsenkessel,1034,warrior,arms,37,20,17
Степанычь,gordunni,1034,warrior,arms,24,11,13
Starscourge,tarren-mill,1033,warrior,arms,12,11,1
Kymari,sanguino,1033,warrior,arms,23,11,12
Кимиюки,gordunni,1032,warrior,arms,30,11,19
Palthor,drakthul,1032,warrior,arms,39,12,27
Katzz,dun-morogh,1031,warrior,arms,24,11,13
Ethem,twisting-nether,1029,warrior,arms,58,33,25
Brvbert,antonidas,1029,warrior,arms,24,11,13
Dreadshanks,doomhammer,1020,warrior,arms,48,27,21
Oralinde,silvermoon,1017,warrior,arms,78,43,35
Jebzmiecza,kazzak,1015,warrior,arms,24,11,13
Dagouor,twisting-nether,1013,warrior,arms,35,11,24
Shinydjuwlz,turalyon,1008,warrior,arms,18,11,7
Bòónki,ravencrest,1008,warrior,arms,46,22,24
Merdé,blackhand,1007,warrior,arms,90,43,47
Whitebêârd,antonidas,1007,warrior,arms,34,12,22
Ilovealma,kiljaeden,1006,warrior,arms,27,11,16
Antraex,zuljin,1004,warrior,arms,30,13,17
Braûsepulver,guldan,1002,warrior,arms,24,13,11
Gatlok,kazzak,1001,warrior,arms,24,11,13
Rejectofrage,ragnaros,1000,warrior,arms,30,15,15
Manymen,outland,1000,warrior,arms,41,18,23
Тычо,soulflayer,1000,warrior,arms,30,12,18
Teraa,the-maelstrom,998,warrior,arms,36,18,18
Seraphys,ravencrest,998,warrior,arms,28,12,16
Sanhaevel,ravencrest,997,warrior,arms,27,13,14
Adrï,draenor,993,warrior,arms,64,35,29
Ezjau,blackmoore,993,warrior,arms,90,45,45
Hammerfíst,kazzak,993,warrior,arms,71,35,36
Малаятварь,gordunni,990,warrior,arms,22,11,11
Geicoo,dalaran,988,warrior,arms,56,29,27
Бавовник,howling-fjord,987,warrior,arms,32,11,21
Crasher,dentarg,985,warrior,arms,24,11,13
Odonko,blackmoore,982,warrior,arms,42,20,22
Chilp,archimonde,981,warrior,arms,25,12,13
Oldhatreds,twisting-nether,979,warrior,arms,22,11,11
Зед,blackscar,977,warrior,arms,25,13,12
Chipstjuven,tarren-mill,963,warrior,arms,25,11,14
Bigschnäbi,blackhand,960,warrior,arms,12,10,2
Wintertimex,stormscale,960,warrior,arms,12,10,2
Whýsøsîleñt,ragnaros,960,warrior,arms,16,11,5
Milant,antonidas,960,warrior,arms,18,10,8
Krionos,ravencrest,960,warrior,arms,18,10,8
Proeliator,argent-dawn,960,warrior,arms,18,10,8
Hirurg,thrall,960,warrior,arms,18,10,8
Каоссвар,howling-fjord,960,warrior,arms,18,10,8
Broarextiger,ragnaros,960,warrior,arms,18,10,8
Бигдэмс,soulflayer,960,warrior,arms,18,10,8
Bigdamtosco,ravencrest,960,warrior,arms,18,10,8
Элетий,soulflayer,960,warrior,arms,24,10,14
Salpaaja,frostwhisper,960,warrior,arms,24,10,14
Andabad,silvermoon,960,warrior,arms,24,10,14
Bravopla,silvermoon,960,warrior,arms,24,10,14
Dabr,stormscale,960,warrior,arms,24,10,14
Zirêael,kazzak,960,warrior,arms,30,10,20
Sindrener,ysondre,960,warrior,arms,30,10,20
Jaythegodx,blackrock,960,warrior,arms,30,10,20
Искристый,howling-fjord,959,warrior,arms,12,10,2
Prymebeevz,blackmoore,959,warrior,arms,12,10,2
Mbappé,dragonblight,959,warrior,arms,12,10,2
Gantsrip,stormscale,959,warrior,arms,16,11,5
Zdi,blackrock,959,warrior,arms,18,10,8
Badwarr,blackhand,959,warrior,arms,18,10,8
Экспла,ashenvale,959,warrior,arms,18,10,8
Axxtm,ravencrest,959,warrior,arms,18,10,8
Fearmedear,sylvanas,959,warrior,arms,18,10,8
Notvisionary,ravencrest,959,warrior,arms,18,10,8
Rookian,blackrock,959,warrior,arms,18,10,8
Duckyone,zenedar,959,warrior,arms,18,10,8
Stepa,sylvanas,959,warrior,arms,18,10,8
Rabaozi,blackhand,959,warrior,arms,18,10,8
Kryszii,ragnaros,959,warrior,arms,24,10,14
Geckoo,emerald-dream,959,warrior,arms,24,10,14
Enzja,nazjatar,959,warrior,arms,24,10,14
Micromachine,argent-dawn,959,warrior,arms,30,10,20
Krônôs,thrall,958,warrior,arms,18,10,8
Gorlemar,blackmoore,958,warrior,arms,18,10,8
Hamilton,bronzebeard,958,warrior,arms,18,10,8
Убитаякорова,soulflayer,958,warrior,arms,18,10,8
Braindeady,burning-legion,958,warrior,arms,18,10,8
Earshy,ragnaros,958,warrior,arms,18,10,8
Adamchen,blackmoore,958,warrior,arms,24,10,14
Gruxx,ragnaros,958,warrior,arms,24,10,14
Leapling,blackmoore,958,warrior,arms,24,10,14
Vymd,archimonde,958,warrior,arms,28,11,17
Testonator,outland,957,warrior,arms,24,10,14
Латексник,booty-bay,957,warrior,arms,30,10,20
Pag,hyjal,956,warrior,arms,12,10,2
Lucasqt,magtheridon,956,warrior,arms,18,10,8
Roshas,twisting-nether,956,warrior,arms,18,10,8
Mllmmxxm,kargath,956,warrior,arms,24,10,14
Utero,drakthul,956,warrior,arms,24,10,14
Ciocaboca,draenor,955,warrior,arms,18,10,8
Deanx,ragnaros,955,warrior,arms,18,10,8
Genç,ysondre,955,warrior,arms,24,10,14
Xarmog,hyjal,955,warrior,arms,24,10,14
Gramrosh,eredar,955,warrior,arms,24,10,14
Neíd,malganis,955,warrior,arms,30,10,20
Труперсила,howling-fjord,954,warrior,arms,24,10,14
Kosttya,argent-dawn,954,warrior,arms,24,10,14
Ôwndbylx,aegwynn,954,warrior,arms,27,11,16
Blanchysnow,hyjal,952,warrior,arms,18,10,8
Unkmòr,pozzo-delleternità,952,warrior,arms,42,22,20
Warriornrv,ysondre,950,warrior,arms,18,10,8
Волрок,howling-fjord,950,warrior,arms,25,13,12
Thiccrich,argent-dawn,949,warrior,arms,12,10,2
Zerm,draenor,949,warrior,arms,18,10,8
Taurosk,burning-legion,949,warrior,arms,24,10,14
Warsky,archimonde,948,warrior,arms,18,12,6
Goldenward,silvermoon,948,warrior,arms,18,10,8
Зуботычник,gordunni,948,warrior,arms,18,10,8
Axedingus,tarren-mill,947,warrior,arms,18,10,8
Tyragon,thrall,947,warrior,arms,18,10,8
Omglolnoob,magtheridon,946,warrior,arms,26,10,16
Contrariety,ravencrest,944,warrior,arms,18,10,8
Chépérøs,kaelthas,944,warrior,arms,30,10,20
Etharedon,kul-tiras,942,warrior,arms,24,10,14
Mågne,tarren-mill,939,warrior,arms,30,10,20
Krostapunk,colinas-pardas,937,warrior,arms,24,10,14
Fdmachine,kazzak,934,warrior,arms,24,10,14
Bubciu,burning-legion,932,warrior,arms,30,10,20
Tabboonishka,draenor,927,warrior,arms,16,11,5
Ganik,malganis,927,warrior,arms,23,10,13
Shavoi,die-aldor,926,warrior,arms,29,10,19
Raldjorn,hyjal,924,warrior,arms,18,10,8
Тибат,howling-fjord,924,warrior,arms,23,10,13
Dearmooses,stormscale,920,warrior,arms,36,18,18
Avgålöfvén,stormscale,912,warrior,arms,15,11,4
Matti,magtheridon,911,warrior,arms,17,10,7
Zugstorm,outland,911,warrior,arms,27,11,16
Grroom,tarren-mill,908,warrior,arms,27,10,17
Durmithor,silvermoon,906,warrior,arms,35,10,25
Cryze,ravencrest,903,warrior,arms,21,10,11
Данилатитич,howling-fjord,901,warrior,arms,21,10,11
Cowlunderowl,tarren-mill,900,warrior,arms,32,11,21
Razecraz,ysondre,894,warrior,arms,18,11,7
Akenrun,eredar,893,warrior,arms,22,10,12
Perseó,minahonda,888,warrior,arms,54,16,38
Рагнарульв,gordunni,885,warrior,arms,14,10,4
Дотрен,galakrond,883,warrior,arms,42,20,22
Luffydono,stormscale,879,warrior,arms,25,10,15
Pigleto,ravencrest,870,warrior,arms,22,12,10
Orchëstre,eitrigg,865,warrior,arms,24,12,12
Imondiet,ragnaros,864,warrior,arms,12,9,3
Jethiss,ravencrest,864,warrior,arms,12,9,3
Antìcìdè,ravencrest,864,warrior,arms,12,9,3
Zäløøpå,kazzak,864,warrior,arms,12,9,3
Zaedt,tarren-mill,864,warrior,arms,12,9,3
Drvx,twisting-nether,864,warrior,arms,12,9,3
Marqinios,archimonde,864,warrior,arms,12,9,3
Hannìbal,ravencrest,864,warrior,arms,12,9,3
Preliator,outland,864,warrior,arms,12,9,3
Кимлий,deathweaver,864,warrior,arms,18,9,9
Puremëtal,silvermoon,864,warrior,arms,18,9,9
Quotxwar,stormscale,864,warrior,arms,18,9,9
Quadfather,kazzak,864,warrior,arms,18,9,9
Allthèwayup,kazzak,864,warrior,arms,18,9,9
Jeax,rexxar,864,warrior,arms,18,9,9
Whýsøsîlêñt,ragnaros,864,warrior,arms,18,9,9
Лилиофанныч,soulflayer,864,warrior,arms,18,9,9
Bâyer,burning-legion,864,warrior,arms,18,9,9
Ken,twisting-nether,864,warrior,arms,18,9,9
Джамалли,howling-fjord,864,warrior,arms,18,9,9
Dmgsponge,stormscale,864,warrior,arms,24,9,15
Vikktor,doomhammer,864,warrior,arms,24,9,15
Morbaac,archimonde,864,warrior,arms,30,9,21
Пиапиа,gordunni,863,warrior,arms,12,9,3
Renbaka,marécage-de-zangar,863,warrior,arms,12,9,3
Wutend,nemesis,863,warrior,arms,12,9,3
Vallenwar,twisting-nether,863,warrior,arms,12,9,3
Pelicos,grim-batol,863,warrior,arms,12,9,3
Proxxyyqt,blackrock,863,warrior,arms,18,9,9
Wargak,stormscale,863,warrior,arms,18,9,9
Puurplecloud,kazzak,863,warrior,arms,18,9,9
Malgár,argent-dawn,863,warrior,arms,18,9,9
Saofang,twisting-nether,863,warrior,arms,18,9,9
Skaylulz,ragnaros,863,warrior,arms,18,9,9
Billorc,twisting-nether,863,warrior,arms,18,9,9
Warbigboss,draenor,863,warrior,arms,18,9,9
Дейниксис,howling-fjord,863,warrior,arms,18,9,9
Punisherhulk,stormscale,863,warrior,arms,18,9,9
Shïn,kaelthas,863,warrior,arms,24,9,15
Johnfogerty,twisting-nether,863,warrior,arms,24,9,15
Séphi,archimonde,863,warrior,arms,24,9,15
Bobloblaww,doomhammer,862,warrior,arms,18,9,9
Fluffycute,blackhand,862,warrior,arms,24,9,15
Realdrdob,kazzak,862,warrior,arms,24,9,15
Démigodx,stormscale,862,warrior,arms,24,9,15
Clukao,kazzak,862,warrior,arms,24,9,15
Scarloc,archimonde,862,warrior,arms,24,9,15
Nêgan,stormscale,861,warrior,arms,18,9,9
Üs,blackhand,861,warrior,arms,24,9,15
Amar,defias-brotherhood,861,warrior,arms,29,10,19
Bigbaduglyy,twisting-nether,861,warrior,arms,30,9,21
Arriess,drakthul,860,warrior,arms,18,9,9
Woopzi,twisting-nether,860,warrior,arms,36,9,27
Synrosh,hyjal,859,warrior,arms,18,9,9
Wolfgladius,cthun,859,warrior,arms,18,9,9
Stits,chromaggus,859,warrior,arms,18,9,9
Маханхет,soulflayer,859,warrior,arms,24,9,15
Антурим,howling-fjord,859,warrior,arms,24,9,15
Дрекзот,howling-fjord,858,warrior,arms,15,10,5
Kval,kazzak,858,warrior,arms,18,9,9
Агтеррокк,deathweaver,858,warrior,arms,24,9,15
Варбыкмашина,howling-fjord,857,warrior,arms,18,9,9
Vegäpunk,nemesis,857,warrior,arms,24,9,15
Kixx,twisting-nether,855,warrior,arms,30,14,16
Pøps,hyjal,854,warrior,arms,18,9,9
Discogoon,twilights-hammer,854,warrior,arms,87,32,55
Syforce,ravencrest,850,warrior,arms,18,9,9
Blufurys,nemesis,849,warrior,arms,26,9,17
Fullkraft,tarren-mill,848,warrior,arms,18,9,9
Pawnerlol,mannoroth,847,warrior,arms,17,9,8
Bigtulipe,archimonde,842,warrior,arms,17,9,8
Ajgreedy,grim-batol,829,warrior,arms,23,9,14
Overdose,anetheron,827,warrior,arms,17,10,7
Prag,silvermoon,823,warrior,arms,16,10,6
Kllinac,kazzak,823,warrior,arms,22,9,13
Tanoras,kazzak,815,warrior,arms,17,9,8
Mölntuss,emeriss,815,warrior,arms,23,9,14
Actuallyorc,twisting-nether,799,warrior,arms,14,9,5
Vyctimz,ravencrest,799,warrior,arms,16,9,7
Bumbx,kazzak,796,warrior,arms,14,9,5
Fractale,kirin-tor,794,warrior,arms,16,9,7
Knego,ragnaros,793,warrior,arms,11,9,2
Klanky,draenor,793,warrior,arms,26,9,17
Кейнорин,howling-fjord,789,warrior,arms,28,9,19
Finalsmasher,thrall,784,warrior,arms,42,16,26
Лысыч,gordunni,778,warrior,arms,19,9,10
Shorrag,outland,768,warrior,arms,12,8,4
Ballin,dragonblight,768,warrior,arms,12,8,4
Muyubu,eredar,768,warrior,arms,12,8,4
Дуглимон,gordunni,768,warrior,arms,12,8,4
Psinovich,sylvanas,768,warrior,arms,12,8,4
Solaje,dun-modr,768,warrior,arms,12,8,4
Иктиннос,gordunni,768,warrior,arms,12,8,4
Norganw,die-aldor,768,warrior,arms,12,8,4
Éliøkor,outland,768,warrior,arms,12,8,4
Liked,tarren-mill,768,warrior,arms,12,8,4
Greenpanzer,archimonde,768,warrior,arms,12,8,4
Chíppéd,draenor,768,warrior,arms,12,8,4
Bulfwart,zuljin,768,warrior,arms,12,8,4
Rayner,illidan,768,warrior,arms,12,8,4
Nukerz,kirin-tor,768,warrior,arms,12,8,4
Бигдэм,howling-fjord,768,warrior,arms,12,8,4
Bullrug,blackrock,768,warrior,arms,12,8,4
Maisner,stormscale,768,warrior,arms,15,9,6
Aauv,twisting-nether,768,warrior,arms,18,8,10
Horsewarrior,stormscale,768,warrior,arms,18,8,10
Vlorgboi,drakthul,768,warrior,arms,18,8,10
Crystallake,blackrock,768,warrior,arms,18,8,10
Xdpromtius,dun-modr,768,warrior,arms,18,8,10
Borndet,eredar,768,warrior,arms,18,8,10
Роули,blackscar,768,warrior,arms,18,8,10
Brunodressed,aegwynn,768,warrior,arms,18,8,10
Warounet,hyjal,768,warrior,arms,18,8,10
Земибор,soulflayer,768,warrior,arms,18,8,10
Arsinal,blackhand,768,warrior,arms,18,8,10
Visari,kiljaeden,768,warrior,arms,18,8,10
Dreadbanga,blackmoore,768,warrior,arms,18,8,10
Kamilfury,burning-legion,768,warrior,arms,22,9,13
Elinyar,aegwynn,768,warrior,arms,24,8,16
Уэсгар,blackscar,768,warrior,arms,24,8,16
Fosler,frostmane,768,warrior,arms,24,8,16
Sjozug,tarren-mill,768,warrior,arms,24,8,16
Heavenheart,bronzebeard,767,warrior,arms,13,9,4
Yoilenno,argent-dawn,767,warrior,arms,12,8,4
Prolyx,doomhammer,767,warrior,arms,12,8,4
Draer,sanguino,767,warrior,arms,17,9,8
Equality,ragnaros,767,warrior,arms,16,8,8
Bekkey,lightbringer,767,warrior,arms,18,8,10
Akim,ysondre,767,warrior,arms,18,8,10
Broxiw,darkspear,767,warrior,arms,18,8,10
Flurie,sylvanas,767,warrior,arms,18,8,10
Garodis,blackmoore,767,warrior,arms,18,8,10
Lortèn,stormscale,767,warrior,arms,18,8,10
Øfè,ysondre,767,warrior,arms,18,8,10
Jjokkerr,magtheridon,767,warrior,arms,18,8,10
Folsack,sanguino,767,warrior,arms,18,8,10
Shædøw,archimonde,767,warrior,arms,18,8,10
Ronoh,kazzak,767,warrior,arms,18,8,10
Hermosse,dalaran,767,warrior,arms,18,8,10
Каутто,howling-fjord,767,warrior,arms,18,8,10
Horseye,eredar,767,warrior,arms,18,8,10
Waegon,twisting-nether,767,warrior,arms,18,8,10
Футжисубо,razuvious,767,warrior,arms,18,8,10
Арбузикхаха,soulflayer,767,warrior,arms,18,8,10
Ríta,silvermoon,767,warrior,arms,18,8,10
Бокалпивка,soulflayer,767,warrior,arms,21,9,12
Derentis,echsenkessel,767,warrior,arms,24,8,16
Jonukas,argent-dawn,767,warrior,arms,24,8,16
Leàn,nemesis,767,warrior,arms,24,8,16
Wolvéshôwl,aegwynn,767,warrior,arms,24,8,16
Bonkonator,stormscale,766,warrior,arms,12,8,4
Newgáte,silvermoon,766,warrior,arms,12,8,4
Celean,darksorrow,766,warrior,arms,12,8,4
Aomen,ravencrest,766,warrior,arms,12,8,4
Shehalk,stormscale,766,warrior,arms,12,8,4
Beamis,ragnaros,766,warrior,arms,18,8,10
Rageaholic,blackmoore,766,warrior,arms,18,8,10
Vohok,jaedenar,766,warrior,arms,18,8,10
Jeronimoe,blackmoore,766,warrior,arms,19,8,11
Halsandre,hyjal,766,warrior,arms,24,8,16
Gorzan,dragonmaw,766,warrior,arms,30,8,22
Opseagull,defias-brotherhood,765,warrior,arms,12,8,4
Wärfäcë,blades-edge,765,warrior,arms,18,8,10
Hirbus,ravencrest,765,warrior,arms,25,8,17
Tommia,burning-legion,764,warrior,arms,18,8,10
Serakhan,argent-dawn,763,warrior,arms,12,8,4
Ferrum,sunstrider,763,warrior,arms,18,8,10
Ireincarnate,argent-dawn,763,warrior,arms,18,8,10
Giggadaddy,tarren-mill,763,warrior,arms,18,8,10
Leyon,blades-edge,762,warrior,arms,12,8,4
Korvjnus,burning-blade,762,warrior,arms,18,8,10
Fatbeard,twilights-hammer,762,warrior,arms,18,8,10
Koliastra,magtheridon,761,warrior,arms,16,9,7
Øruch,draenor,761,warrior,arms,18,8,10
Punishers,ysondre,761,warrior,arms,114,42,72
Ironfists,kilrogg,760,warrior,arms,18,8,10
Methaniwths,twisting-nether,760,warrior,arms,24,8,16
Грруд,galakrond,760,warrior,arms,24,8,16
Машамеч,blackscar,760,warrior,arms,30,8,22
Freestýlz,archimonde,759,warrior,arms,12,8,4
Falcowar,minahonda,758,warrior,arms,18,8,10
Satanås,silvermoon,758,warrior,arms,18,8,10
Upturn,ravencrest,757,warrior,arms,24,8,16
Doba,madmortem,750,warrior,arms,23,8,15
Calipp,die-aldor,750,warrior,arms,24,8,16
Shadrassil,eonar,747,warrior,arms,18,8,10
Bazsika,ragnaros,746,warrior,arms,30,8,22
Smkw,kazzak,738,warrior,arms,18,8,10
Rivah,tarren-mill,735,warrior,arms,18,9,9
Hazzaogx,draenor,735,warrior,arms,23,8,15
Tinkley,quelthalas,734,warrior,arms,16,8,8
Grimsong,antonidas,733,warrior,arms,14,9,5
Madict,outland,733,warrior,arms,18,8,10
Takashia,ravencrest,731,warrior,arms,16,9,7
Nelfx,aggra-português,726,warrior,arms,30,10,20
Grolbein,blackhand,719,warrior,arms,17,9,8
Anaxiam,drakthul,719,warrior,arms,17,8,9
Karbeg,ravencrest,718,warrior,arms,21,8,13
Spoofie,doomhammer,718,warrior,arms,21,8,13
Zíreael,ravencrest,718,warrior,arms,29,8,21
Zelwar,drakthul,714,warrior,arms,14,10,4
Ferv,tarren-mill,703,warrior,arms,17,8,9
Stratic,blackmoore,697,warrior,arms,26,8,18
Melców,eredar,687,warrior,arms,11,8,3
Ispor,shattered-halls,687,warrior,arms,61,29,32
Xiennas,stormscale,679,warrior,arms,19,9,10
Nipes,nozdormu,672,warrior,arms,12,7,5
Ufu,outland,672,warrior,arms,12,7,5
Imglad,ragnaros,672,warrior,arms,12,7,5
Dréngr,blackrock,672,warrior,arms,12,7,5
Masakerr,ragnaros,672,warrior,arms,12,7,5
Midnightrain,archimonde,672,warrior,arms,12,7,5
Notthateasy,blackrock,672,warrior,arms,12,7,5
Хашонвар,gordunni,672,warrior,arms,12,7,5
Âdept,tarren-mill,672,warrior,arms,12,7,5
Doksziqqt,ragnaros,672,warrior,arms,12,7,5
Jäky,ragnaros,672,warrior,arms,12,7,5
Tandrak,ravencrest,672,warrior,arms,12,7,5
Lisera,thrall,672,warrior,arms,12,7,5
Pexqt,blackmoore,672,warrior,arms,12,7,5
Cleavnseagal,ravencrest,672,warrior,arms,12,7,5
Cleppepx,blackmoore,672,warrior,arms,12,7,5
Psychlolz,burning-legion,672,warrior,arms,12,7,5
Biscuitoliva,hyjal,672,warrior,arms,12,7,5
Kriticah,sanguino,672,warrior,arms,12,7,5
Tenvee,outland,672,warrior,arms,12,7,5
Fiverare,stormscale,672,warrior,arms,12,7,5
Джераса,borean-tundra,672,warrior,arms,12,7,5
Engalxsol,tarren-mill,672,warrior,arms,12,7,5
Zellóx,stormscale,672,warrior,arms,12,7,5
Sreym,dun-modr,672,warrior,arms,12,7,5
Gramr,silvermoon,672,warrior,arms,12,7,5
Biggerer,blackrock,672,warrior,arms,12,7,5
Orcassmus,blackrock,672,warrior,arms,12,7,5
Арсон,soulflayer,672,warrior,arms,12,7,5
Azarek,blackmoore,672,warrior,arms,12,7,5
Pied,krasus,672,warrior,arms,12,7,5
Boonur,arthas,672,warrior,arms,12,7,5
Kwasimodo,blackmoore,672,warrior,arms,12,7,5
Thebigtosco,ravencrest,672,warrior,arms,12,7,5
Crøwñd,twisting-nether,672,warrior,arms,12,7,5
Warriovar,draenor,672,warrior,arms,12,7,5
Orelus,darkspear,672,warrior,arms,12,7,5
Трэйдар,blackscar,672,warrior,arms,12,7,5
Smèdbérg,ravencrest,672,warrior,arms,12,7,5
Antïsøcial,thrall,672,warrior,arms,12,7,5
Devìlscandy,stormscale,672,warrior,arms,12,7,5
Bubawarrior,silvermoon,672,warrior,arms,12,7,5
Ragelol,aegwynn,672,warrior,arms,12,7,5
Tìera,ravencrest,672,warrior,arms,15,8,7
Skullsmasher,stormscale,672,warrior,arms,18,7,11
Warristyles,arygos,672,warrior,arms,18,7,11
Стефанидзе,soulflayer,672,warrior,arms,18,7,11
Manký,kazzak,672,warrior,arms,18,7,11
Reacôn,twisting-nether,672,warrior,arms,18,7,11
Tamesulo,silvermoon,672,warrior,arms,18,7,11
Warhero,burning-legion,672,warrior,arms,18,7,11
Bladrun,frostmane,672,warrior,arms,18,7,11
Rightversion,sylvanas,672,warrior,arms,18,7,11
Mezugzugyou,draenor,672,warrior,arms,18,7,11
Nímera,nemesis,672,warrior,arms,18,7,11
Twoonewin,ragnaros,672,warrior,arms,18,7,11
Swàck,mazrigos,672,warrior,arms,18,7,11
Hollydeffs,blackmoore,672,warrior,arms,18,7,11
Tomsom,sanguino,672,warrior,arms,18,7,11
Warrieron,stormscale,672,warrior,arms,18,7,11
Hitt,ysondre,672,warrior,arms,18,7,11
Bufdefstance,kazzak,672,warrior,arms,18,7,11
Silencxý,blackrock,672,warrior,arms,18,7,11
Trilon,blackrock,672,warrior,arms,18,7,11
Jeonsoyeon,argent-dawn,672,warrior,arms,18,7,11
Nyamnyamnyam,blackmoore,672,warrior,arms,18,7,11
Chàrgex,blackrock,672,warrior,arms,21,8,13
Luxurious,argent-dawn,672,warrior,arms,27,8,19
Vøidwalker,ragnaros,672,warrior,arms,24,7,17
Veav,norgannon,672,warrior,arms,24,7,17
Gôrilla,kazzak,672,warrior,arms,30,7,23
Lågærtha,blackmoore,671,warrior,arms,12,7,5
Fluxerella,azjolnerub,671,warrior,arms,12,7,5
Escà,archimonde,671,warrior,arms,12,7,5
Dukhe,sanguino,671,warrior,arms,12,7,5
Skullcrasher,draenor,671,warrior,arms,12,7,5
Shedzo,tarren-mill,671,warrior,arms,12,7,5
Rawne,kirin-tor,671,warrior,arms,12,7,5
Sàt,kazzak,671,warrior,arms,12,7,5
Dosenbier,gorgonnash,671,warrior,arms,12,7,5
Vez,arathor,671,warrior,arms,12,7,5
Kriegernuss,blackmoore,671,warrior,arms,12,7,5
Когарт,gordunni,671,warrior,arms,12,7,5
Schawar,draenor,671,warrior,arms,12,7,5
Reykingar,outland,671,warrior,arms,12,7,5
Bonnaventure,hyjal,671,warrior,arms,12,7,5
Gamôrà,eitrigg,671,warrior,arms,12,7,5
Hades,kazzak,671,warrior,arms,12,7,5
Hexzo,ravencrest,671,warrior,arms,12,7,5
Srbinator,turalyon,671,warrior,arms,12,7,5
Sokarbey,twisting-nether,671,warrior,arms,12,7,5
Schneklinge,blutkessel,671,warrior,arms,12,7,5
Segovaxx,twisting-nether,671,warrior,arms,18,7,11
Radge,hyjal,671,warrior,arms,18,7,11
Unstorm,drakthul,671,warrior,arms,18,7,11
Wazraf,khaz-modan,671,warrior,arms,18,7,11
Tempii,ragnaros,671,warrior,arms,18,7,11
Haris,malganis,671,warrior,arms,18,7,11
Kishkamen,ravencrest,671,warrior,arms,18,7,11
Армсец,howling-fjord,671,warrior,arms,18,7,11
Бубаигавар,gordunni,671,warrior,arms,24,7,17
Prs,defias-brotherhood,670,warrior,arms,12,7,5
Eldfast,bladefist,670,warrior,arms,12,7,5
Lightit,aegwynn,670,warrior,arms,12,7,5
Ismellurfeet,ravencrest,670,warrior,arms,12,7,5
Kilsera,blackmoore,670,warrior,arms,12,7,5
Grunwi,burning-legion,670,warrior,arms,12,7,5
Cortix,blackmoore,670,warrior,arms,16,8,8
Nixtor,defias-brotherhood,670,warrior,arms,18,7,11
Rhonack,ragnaros,670,warrior,arms,18,7,11
Eyesonly,blackmoore,670,warrior,arms,18,7,11
Jackycoke,blackhand,670,warrior,arms,18,7,11
Razzimak,eredar,669,warrior,arms,10,8,2
Infusione,nemesis,669,warrior,arms,12,7,5
Lø,chogall,669,warrior,arms,20,7,13
Ruuster,norgannon,669,warrior,arms,24,7,17
Árkantos,ravencrest,668,warrior,arms,12,7,5
Warclone,ravencrest,668,warrior,arms,12,7,5
Woukong,blackmoore,668,warrior,arms,18,7,11
Releave,draenor,668,warrior,arms,18,7,11
Zêrklatscher,lordaeron,668,warrior,arms,24,7,17
Математик,razuvious,667,warrior,arms,12,7,5
Piixxz,hyjal,667,warrior,arms,12,7,5
Muetzchen,blackhand,667,warrior,arms,12,7,5
Papati,twisting-nether,667,warrior,arms,18,7,11
Xyum,pozzo-delleternità,665,warrior,arms,12,7,5
Милославский,gordunni,662,warrior,arms,18,7,11
Dlstroyer,eonar,657,warrior,arms,18,7,11
Dorya,aegwynn,655,warrior,arms,17,7,10
Garouzo,hellfire,655,warrior,arms,23,7,16
Xienia,dun-morogh,655,warrior,arms,24,7,17
Дедсдрыном,howling-fjord,654,warrior,arms,17,7,10
Alothar,khaz-modan,646,warrior,arms,18,7,11
Broarexlion,ragnaros,639,warrior,arms,17,7,10
Corlo,uldaman,639,warrior,arms,20,8,12
Мегаяйца,gordunni,639,warrior,arms,23,7,16
Râsk,kazzak,638,warrior,arms,16,8,8
Shãne,ysondre,638,warrior,arms,16,7,9
Ugbruk,blackhand,633,warrior,arms,16,8,8
Боевыещёчки,eversong,627,warrior,arms,22,11,11
Bloodeater,sylvanas,623,warrior,arms,15,7,8
Набосуюногу,gordunni,623,warrior,arms,17,7,10
Dolforden,burning-legion,622,warrior,arms,17,7,10
Vaxillium,argent-dawn,621,warrior,arms,17,7,10
Kwesta,kazzak,607,warrior,arms,11,7,4
Matatorero,uldum,607,warrior,arms,16,7,9
Trundledaddy,silvermoon,607,warrior,arms,17,7,10
Olriksen,dentarg,590,warrior,arms,19,8,11
Bavet,sylvanas,589,warrior,arms,19,7,12
Dulex,draenor,576,warrior,arms,6,6,0
Vory,ravencrest,576,warrior,arms,6,6,0
Kaloche,hyjal,576,warrior,arms,12,6,6
Fankululu,kragjin,576,warrior,arms,12,6,6
Irherklek,stormscale,576,warrior,arms,12,6,6
Majestatix,doomhammer,576,warrior,arms,12,6,6
Bourbimrgllr,hyjal,576,warrior,arms,12,6,6
Rakhaldin,blackhand,576,warrior,arms,12,6,6
Belfodil,outland,576,warrior,arms,12,6,6
Léonie,arakarahm,576,warrior,arms,12,6,6
Belov,hyjal,576,warrior,arms,12,6,6
Darkseid,burning-legion,576,warrior,arms,12,6,6
Фокатоп,blackscar,576,warrior,arms,12,6,6
Sydre,nerathor,576,warrior,arms,12,6,6
Airowar,drakthul,576,warrior,arms,12,6,6
Xqt,laughing-skull,576,warrior,arms,12,6,6
Gëaldýr,kazzak,576,warrior,arms,12,6,6
Тассэй,eversong,576,warrior,arms,12,6,6
Moldamis,blackhand,576,warrior,arms,12,6,6
Knoutt,burning-legion,576,warrior,arms,12,6,6
Keshâr,blackhand,576,warrior,arms,12,6,6
Darlith,azshara,576,warrior,arms,12,6,6
Hycate,blackrock,576,warrior,arms,12,6,6
Gíu,blackhand,576,warrior,arms,12,6,6
Skelash,blackhand,576,warrior,arms,12,6,6
Finmajor,frostwhisper,576,warrior,arms,12,6,6
Qurujaa,kirin-tor,576,warrior,arms,12,6,6
Bämoida,eredar,576,warrior,arms,12,6,6
Pathocend,kazzak,576,warrior,arms,12,6,6
Brutarius,scarshield-legion,576,warrior,arms,12,6,6
Coolaa,kazzak,576,warrior,arms,12,6,6
Juggawumba,kazzak,576,warrior,arms,12,6,6
Hyogan,malganis,576,warrior,arms,12,6,6
Wøokz,argent-dawn,576,warrior,arms,12,6,6
Scràvity,blackhand,576,warrior,arms,12,6,6
Psychðtïc,archimonde,576,warrior,arms,12,6,6
Oneoneseven,archimonde,576,warrior,arms,12,6,6
Vakios,confrérie-du-thorium,576,warrior,arms,12,6,6
Cráft,silvermoon,576,warrior,arms,12,6,6
Jerololz,dun-modr,576,warrior,arms,12,6,6
Melfis,aegwynn,576,warrior,arms,12,6,6
Leonidæs,frostwolf,576,warrior,arms,12,6,6
Tddyy,silvermoon,576,warrior,arms,12,6,6
Kehnan,blackrock,576,warrior,arms,12,6,6
Гатсх,blackscar,576,warrior,arms,12,6,6
Audítóre,proudmoore,576,warrior,arms,12,6,6
Toqk,draenor,576,warrior,arms,12,6,6
Frézzér,blackrock,576,warrior,arms,12,6,6
Blitz,archimonde,576,warrior,arms,12,6,6
Долирия,gordunni,576,warrior,arms,12,6,6
Нерморрог,howling-fjord,576,warrior,arms,12,6,6
Wärlør,ravencrest,576,warrior,arms,12,6,6
Давилкагеев,howling-fjord,576,warrior,arms,12,6,6
Nørst,draenor,576,warrior,arms,12,6,6
Taoke,ravencrest,576,warrior,arms,12,6,6
Почтитайсон,howling-fjord,576,warrior,arms,12,6,6
Slám,burning-legion,576,warrior,arms,12,6,6
Братишкаа,gordunni,576,warrior,arms,12,6,6
Jailapatate,khaz-modan,576,warrior,arms,12,6,6
Goringbame,draenor,576,warrior,arms,12,6,6
Tonifox,nemesis,576,warrior,arms,12,6,6
Fookyoup,stormscale,576,warrior,arms,12,6,6
Dedewawa,ysondre,576,warrior,arms,12,6,6
Radîtz,blackmoore,576,warrior,arms,12,6,6
Шизам,howling-fjord,576,warrior,arms,12,6,6
Стенденсх,howling-fjord,576,warrior,arms,12,6,6
Данзетар,howling-fjord,576,warrior,arms,12,6,6
Hacci,ragnaros,576,warrior,arms,12,6,6
Belver,argent-dawn,576,warrior,arms,15,7,8
Kímó,silvermoon,576,warrior,arms,18,6,12
Leroyluca,gilneas,576,warrior,arms,18,6,12
Stillpetao,dun-modr,576,warrior,arms,18,6,12
Slunecniq,azjolnerub,576,warrior,arms,18,6,12
Zkou,wrathbringer,576,warrior,arms,18,6,12
Brigitá,argent-dawn,576,warrior,arms,18,6,12
Jeriko,archimonde,576,warrior,arms,18,6,12
Nocturia,archimonde,576,warrior,arms,18,6,12
Kronstris,veklor,576,warrior,arms,18,6,12
Shaked,dun-modr,576,warrior,arms,18,6,12
Fracto,draenor,576,warrior,arms,18,6,12
Hogu,nemesis,576,warrior,arms,18,6,12
Amarthon,sylvanas,576,warrior,arms,18,6,12
Skumslag,blackmoore,576,warrior,arms,18,6,12
Raikaz,ravencrest,576,warrior,arms,18,6,12
Azjolnerub,kazzak,576,warrior,arms,18,6,12
Мопк,howling-fjord,576,warrior,arms,18,6,12
Autumnfálls,kazzak,576,warrior,arms,18,6,12
Spridan,ravencrest,576,warrior,arms,24,6,18
Lakes,eredar,576,warrior,arms,24,6,18
Steroidkidx,stormscale,576,warrior,arms,24,6,18
Topozugzug,tarren-mill,576,warrior,arms,24,6,18
Luckysop,chants-éternels,576,warrior,arms,24,6,18
Pesroc,blackmoore,575,warrior,arms,9,7,2
Беспонятия,blackscar,575,warrior,arms,10,7,3
Wørgenn,hyjal,575,warrior,arms,12,6,6
Oneshót,norgannon,575,warrior,arms,12,6,6
Энлами,gordunni,575,warrior,arms,12,6,6
Sigmundsdotr,outland,575,warrior,arms,12,6,6
Djpuggerino,outland,575,warrior,arms,12,6,6
Befit,quelthalas,575,warrior,arms,12,6,6
Думрайт,gordunni,575,warrior,arms,12,6,6
Bravest,ragnaros,575,warrior,arms,12,6,6
Wfx,kazzak,575,warrior,arms,12,6,6
Valus,earthen-ring,575,warrior,arms,12,6,6
Euforija,kazzak,575,warrior,arms,12,6,6
Uwazu,kazzak,575,warrior,arms,12,6,6
Judditsbx,draenor,575,warrior,arms,12,6,6
Soofies,madmortem,575,warrior,arms,12,6,6
Medaur,frostmane,575,warrior,arms,12,6,6
Stweye,frostmane,575,warrior,arms,12,6,6
Ozok,blackrock,575,warrior,arms,12,6,6
Tarbhfathach,draenor,575,warrior,arms,12,6,6
Aza,burning-blade,575,warrior,arms,12,6,6
Бэдбрэйнс,soulflayer,575,warrior,arms,12,6,6
Zutto,conseil-des-ombres,575,warrior,arms,12,6,6
Critycall,drakthul,575,warrior,arms,12,6,6
Ankzz,archimonde,575,warrior,arms,12,6,6
Fótm,sylvanas,575,warrior,arms,12,6,6
Brondir,archimonde,575,warrior,arms,12,6,6
Ghostlord,dunemaul,575,warrior,arms,12,6,6
Ràgnàmetàl,tarren-mill,575,warrior,arms,12,6,6
Lupacha,exodar,575,warrior,arms,12,6,6
Arnnau,dun-modr,575,warrior,arms,12,6,6
Акози,fordragon,575,warrior,arms,12,6,6
Golonko,burning-legion,575,warrior,arms,12,6,6
Vauster,draenor,575,warrior,arms,16,7,9
Ruioz,draenor,575,warrior,arms,18,6,12
Goldins,drakthul,575,warrior,arms,18,6,12
Cramatao,shadowsong,575,warrior,arms,18,6,12
Mfull,tarren-mill,575,warrior,arms,18,6,12
Xraider,ragnaros,575,warrior,arms,18,6,12
Marcusk,thunderhorn,575,warrior,arms,18,6,12
Кудесмяу,soulflayer,575,warrior,arms,24,6,18
Solatika,alexstrasza,574,warrior,arms,12,6,6
Gnuhl,eredar,574,warrior,arms,15,7,8
Zogyall,ysondre,574,warrior,arms,18,6,12
Bolski,ravencrest,574,warrior,arms,18,6,12
Sztixi,silvermoon,574,warrior,arms,24,6,18
Crook,doomhammer,574,warrior,arms,30,6,24
Raduriel,antonidas,571,warrior,arms,12,6,6
Kundan,aegwynn,571,warrior,arms,12,6,6
Dazed,kazzak,570,warrior,arms,12,6,6
Bashion,ghostlands,569,warrior,arms,18,6,12
Dj,ragnaros,568,warrior,arms,12,6,6
Omaahton,magtheridon,543,warrior,arms,11,6,5
Orgazam,xavius,543,warrior,arms,11,6,5
Fion,kult-der-verdammten,543,warrior,arms,14,7,7
Kalarar,blackrock,543,warrior,arms,26,7,19
Energo,drakthul,542,warrior,arms,12,6,6
Addicty,sylvanas,539,warrior,arms,17,6,11
Kåñéthy,outland,528,warrior,arms,15,7,8
Imabeatyoass,kazzak,527,warrior,arms,11,6,5
Monsterborn,bloodhoof,527,warrior,arms,15,7,8
Манндалорец,gordunni,527,warrior,arms,15,6,9
Titanhaut,frostwolf,525,warrior,arms,11,6,5
Богадорога,howling-fjord,522,warrior,arms,17,8,9
Брамон,gordunni,512,warrior,arms,10,6,4
Фоссбро,gordunni,494,warrior,arms,21,6,15
Mumbojumbo,uldum,480,warrior,arms,6,5,1
Рвбстох,blackscar,480,warrior,arms,6,5,1
Дядядмг,blackscar,480,warrior,arms,6,5,1
Karmaloop,stormscale,480,warrior,arms,6,5,1
Гневныйвиги,howling-fjord,480,warrior,arms,6,5,1
Thiccbra,burning-legion,480,warrior,arms,6,5,1
Slg,tarren-mill,480,warrior,arms,6,5,1
Shînsø,dalaran,480,warrior,arms,6,5,1
Ocecute,tarren-mill,480,warrior,arms,6,5,1
Tørrminator,stormscale,480,warrior,arms,6,5,1
Rockygifll,sinstralis,480,warrior,arms,6,5,1
Хэрест,gordunni,480,warrior,arms,6,5,1
Remylacroix,blackrock,480,warrior,arms,6,5,1
Maniackz,tarren-mill,480,warrior,arms,6,5,1
Warbringer,burning-blade,480,warrior,arms,6,5,1
Zhenshii,blackmoore,480,warrior,arms,6,5,1
Whimbux,stormscale,480,warrior,arms,6,5,1
Cuzyxtwo,blackrock,480,warrior,arms,6,5,1
Ninebites,chamber-of-aspects,480,warrior,arms,6,5,1
Empero,draenor,480,warrior,arms,6,5,1
Tekmali,archimonde,480,warrior,arms,6,5,1
Murp,lightnings-blade,480,warrior,arms,6,5,1
Lurion,malganis,480,warrior,arms,6,5,1
Bashuk,grim-batol,480,warrior,arms,6,5,1
Hubq,burning-legion,480,warrior,arms,6,5,1
Pihvikostaja,stormreaver,480,warrior,arms,6,5,1
Himarsenko,silvermoon,480,warrior,arms,6,5,1
Asasius,ravencrest,480,warrior,arms,6,5,1
Mellîødas,blackmoore,480,warrior,arms,6,5,1
Tishues,kazzak,480,warrior,arms,8,5,3
Азктор,soulflayer,480,warrior,arms,10,6,4
Arakhu,blackmoore,480,warrior,arms,12,5,7
Oplix,antonidas,480,warrior,arms,12,5,7
Garthro,antonidas,480,warrior,arms,12,5,7
Nuckii,antonidas,480,warrior,arms,12,5,7
Hitmanler,frostmane,480,warrior,arms,12,5,7
Kënnyföx,ysondre,480,warrior,arms,12,5,7
Garradoom,stormscale,480,warrior,arms,12,5,7
Martøswarr,uldum,480,warrior,arms,12,5,7
Budwise,stormscale,480,warrior,arms,12,5,7
Vitezandro,stormscale,480,warrior,arms,12,5,7
Mesmash,uldum,480,warrior,arms,12,5,7
Zirriox,wildhammer,480,warrior,arms,12,5,7
Scud,frostwhisper,480,warrior,arms,12,5,7
Horizonx,blackrock,480,warrior,arms,12,5,7
Тише,deathweaver,480,warrior,arms,12,5,7
Rohäc,drakthul,480,warrior,arms,12,5,7
Sanca,naxxramas,480,warrior,arms,12,5,7
Succel,drakthul,480,warrior,arms,12,5,7
Asintended,draenor,480,warrior,arms,12,5,7
Despacitus,burning-legion,480,warrior,arms,12,5,7
Lüund,ravencrest,480,warrior,arms,12,5,7
Рэйердан,howling-fjord,480,warrior,arms,12,5,7
Plzdontkite,blackrock,480,warrior,arms,12,5,7
Nârmøra,thrall,480,warrior,arms,12,5,7
Repó,twisting-nether,480,warrior,arms,12,5,7
Huxies,draenor,480,warrior,arms,12,5,7
Фуджитаку,gordunni,480,warrior,arms,12,5,7
Sergra,ysondre,480,warrior,arms,12,5,7
Древилгод,gordunni,480,warrior,arms,12,5,7
Kalopsia,drakthul,480,warrior,arms,12,5,7
Бейлеор,gordunni,480,warrior,arms,12,5,7
Отнулядоста,gordunni,480,warrior,arms,12,5,7
Lïyah,eldrethalas,480,warrior,arms,12,5,7
Жестокус,gordunni,480,warrior,arms,12,5,7
Foxxzorr,aszune,480,warrior,arms,12,5,7
Sphínxx,malfurion,480,warrior,arms,12,5,7
ßamßam,draenor,480,warrior,arms,12,5,7
Sinbuay,malygos,480,warrior,arms,12,5,7
Ragingclue,draenor,480,warrior,arms,12,5,7
Keäghan,kazzak,480,warrior,arms,12,5,7
Lîlsaint,dun-morogh,480,warrior,arms,12,5,7
Zarrgash,blackhand,480,warrior,arms,12,5,7
Strengjahz,ragnaros,480,warrior,arms,12,5,7
Threnewar,kazzak,480,warrior,arms,12,5,7
Кисямур,soulflayer,480,warrior,arms,12,5,7
Apacho,outland,480,warrior,arms,12,5,7
Dortenz,ragnaros,480,warrior,arms,12,5,7
Тевивар,gordunni,480,warrior,arms,12,5,7
Cryhoof,ragnaros,480,warrior,arms,12,5,7
Binsaueramk,ravencrest,480,warrior,arms,12,5,7
Alexwar,draenor,480,warrior,arms,12,5,7
Whiteowlx,argent-dawn,480,warrior,arms,12,5,7
Steelstormz,ravencrest,480,warrior,arms,12,5,7
Zeryyo,blackrock,480,warrior,arms,12,5,7
Adzipotlewap,burning-legion,480,warrior,arms,12,5,7
Síúkanto,blackrock,480,warrior,arms,12,5,7
Сашарбгх,soulflayer,480,warrior,arms,12,5,7
Salsetti,nemesis,480,warrior,arms,12,5,7
Ràgê,silvermoon,480,warrior,arms,12,5,7
Breaken,silvermoon,480,warrior,arms,12,5,7
Whysobold,quelthalas,480,warrior,arms,12,5,7
Loliclapper,grim-batol,480,warrior,arms,12,5,7
Delfrion,pozzo-delleternità,480,warrior,arms,12,5,7
Arowpoint,doomhammer,480,warrior,arms,12,5,7
Шифик,soulflayer,480,warrior,arms,12,5,7
Ericmontana,draenor,480,warrior,arms,12,5,7
Reìvah,silvermoon,480,warrior,arms,12,5,7
ßzv,veklor,480,warrior,arms,12,5,7
Deathbleeder,argent-dawn,480,warrior,arms,12,5,7
Nazgrosh,burning-legion,480,warrior,arms,12,5,7
Mugteef,der-rat-von-dalaran,480,warrior,arms,12,5,7
Klonyarikjr,ravencrest,480,warrior,arms,12,5,7
Najjs,eredar,480,warrior,arms,12,5,7
Rowr,argent-dawn,480,warrior,arms,12,5,7
Xintha,frostwolf,480,warrior,arms,12,5,7
Chadgrave,argent-dawn,480,warrior,arms,12,5,7
Tenthøusand,sylvanas,480,warrior,arms,12,5,7
Coko,kirin-tor,480,warrior,arms,12,5,7
Zeneve,auchindoun,480,warrior,arms,12,5,7
Warclodo,la-croisade-écarlate,480,warrior,arms,12,5,7
Victôr,silvermoon,480,warrior,arms,12,5,7
Krîspie,archimonde,480,warrior,arms,12,5,7
Gerrmund,silvermoon,480,warrior,arms,12,5,7
Supersonîc,aegwynn,480,warrior,arms,12,5,7
Schlierkamp,aegwynn,480,warrior,arms,12,5,7
Matrixer,aegwynn,480,warrior,arms,12,5,7
Развалочка,howling-fjord,480,warrior,arms,16,6,10
Fulgrimu,archimonde,480,warrior,arms,15,5,10
Santorro,drakthul,480,warrior,arms,18,5,13
Huullkk,nazjatar,480,warrior,arms,18,5,13
Тандэр,borean-tundra,480,warrior,arms,18,5,13
Solgud,bloodfeather,480,warrior,arms,18,5,13
Roykór,auchindoun,480,warrior,arms,18,5,13
Larrydankin,draenor,480,warrior,arms,18,5,13
Héda,tarren-mill,480,warrior,arms,18,5,13
Курящийпро,blackscar,480,warrior,arms,18,5,13
Блэйзерх,gordunni,480,warrior,arms,18,5,13
Unßörn,archimonde,480,warrior,arms,18,5,13
Æxcoast,ravencrest,480,warrior,arms,18,5,13
Lahzar,krasus,480,warrior,arms,18,5,13
Belzebud,kazzak,480,warrior,arms,18,5,13
Bigdstance,outland,480,warrior,arms,18,5,13
Voidteen,argent-dawn,480,warrior,arms,18,5,13
Gnolimits,antonidas,480,warrior,arms,24,5,19
Vhy,antonidas,480,warrior,arms,25,5,20
Ceteris,eredar,479,warrior,arms,6,5,1
Laude,ragnaros,479,warrior,arms,6,5,1
Saey,malorne,479,warrior,arms,6,5,1
Bangbros,archimonde,479,warrior,arms,6,5,1
Xtu,kazzak,479,warrior,arms,6,5,1
Тонкрик,goldrinn,479,warrior,arms,6,5,1
Monifes,kazzak,479,warrior,arms,9,6,3
Mifuune,argent-dawn,479,warrior,arms,12,5,7
Pappkopf,rexxar,479,warrior,arms,12,5,7
Voodoowarr,rexxar,479,warrior,arms,12,5,7
Meresin,madmortem,479,warrior,arms,12,5,7
Grèèn,turalyon,479,warrior,arms,12,5,7
Dúg,tarren-mill,479,warrior,arms,12,5,7
Auggies,outland,479,warrior,arms,12,5,7
Relüx,ragnaros,479,warrior,arms,12,5,7
Shpitzu,stormscale,479,warrior,arms,12,5,7
Swtparanoid,sylvanas,479,warrior,arms,12,5,7
Slappie,kiljaeden,479,warrior,arms,12,5,7
Бачус,eversong,479,warrior,arms,12,5,7
Qvil,sanguino,479,warrior,arms,24,5,19
Sfarpi,burning-legion,478,warrior,arms,12,5,7
Swordluw,argent-dawn,478,warrior,arms,18,5,13
Sahaminho,draenor,478,warrior,arms,18,5,13
Лидоний,gordunni,477,warrior,arms,12,5,7
Àke,darksorrow,476,warrior,arms,18,5,13
Sheriff,dragonblight,475,warrior,arms,12,5,7
Execútioner,sylvanas,463,warrior,arms,11,5,6
Duarel,blackmoore,448,warrior,arms,10,5,5
Henzelhoff,stormreaver,447,warrior,arms,10,5,5
Kviqr,auchindoun,447,warrior,arms,11,5,6
Midgardsormr,blackrock,447,warrior,arms,11,5,6
Takethisduck,stormscale,447,warrior,arms,11,5,6
Чпонькмашина,soulflayer,447,warrior,arms,17,5,12
Greeneroi,khaz-modan,447,warrior,arms,23,5,18
Nalx,tarren-mill,432,warrior,arms,15,5,10
Madswarrior,tarren-mill,431,warrior,arms,11,5,6
Warriar,sylvanas,426,warrior,arms,17,7,10
Knî,archimonde,426,warrior,arms,15,6,9
Bismárck,nathrezim,426,warrior,arms,15,6,9
Leizey,stormscale,426,warrior,arms,15,6,9
Prime,outland,416,warrior,arms,16,5,11
Dodgeslam,eredar,416,warrior,arms,16,5,11
Ironbutter,ravencrest,415,warrior,arms,8,6,2
Kìrìtosan,pozzo-delleternità,415,warrior,arms,8,5,3
Agamemnon,frostmane,415,warrior,arms,8,5,3
Brabüs,kazzak,415,warrior,arms,8,5,3
Rhxy,burning-legion,415,warrior,arms,10,5,5
Brùtus,exodar,415,warrior,arms,11,5,6
Danx,culte-de-la-rive-noire,413,warrior,arms,16,5,11
Cmonbrah,ravencrest,384,warrior,arms,6,4,2
Лагалиер,borean-tundra,384,warrior,arms,6,4,2
Varzeluu,sylvanas,384,warrior,arms,6,4,2
Highbuffalo,kazzak,384,warrior,arms,6,4,2
Bronn,defias-brotherhood,384,warrior,arms,6,4,2
Sveñor,the-maelstrom,384,warrior,arms,6,4,2
Ricovega,kazzak,384,warrior,arms,6,4,2
Agres,zuluhed,384,warrior,arms,6,4,2
Grimoire,drakthul,384,warrior,arms,6,4,2
Gór,area-52,384,warrior,arms,6,4,2
Lakri,chants-éternels,384,warrior,arms,6,4,2
Rongh,saurfang,384,warrior,arms,6,4,2
Lynton,sylvanas,384,warrior,arms,6,4,2
Beznacaj,outland,384,warrior,arms,6,4,2
Capigo,tarren-mill,384,warrior,arms,6,4,2
Slâkkxz,outland,384,warrior,arms,6,4,2
Oweiko,blackrock,384,warrior,arms,6,4,2
Olfik,drakthul,384,warrior,arms,6,4,2
Thorbjør,silvermoon,384,warrior,arms,6,4,2
Roadsick,outland,384,warrior,arms,6,4,2
Gucix,tarren-mill,384,warrior,arms,6,4,2
Kaylì,ravencrest,384,warrior,arms,6,4,2
Zonash,kazzak,384,warrior,arms,6,4,2
Wvanp,tarren-mill,384,warrior,arms,6,4,2
Dallion,azjolnerub,384,warrior,arms,6,4,2
Настрамо,gordunni,384,warrior,arms,6,4,2
Høxy,outland,384,warrior,arms,6,4,2
Huuln,outland,384,warrior,arms,6,4,2
Spiokra,hellscream,384,warrior,arms,6,4,2
Кринжеверт,howling-fjord,384,warrior,arms,6,4,2
Kevlarsusan,the-maelstrom,384,warrior,arms,6,4,2
Gachiwarri,blackhand,384,warrior,arms,6,4,2
Metawar,blackhand,384,warrior,arms,6,4,2
Лютобор,gordunni,384,warrior,arms,6,4,2
Гигасмэш,gordunni,384,warrior,arms,6,4,2
Nukebomb,dun-modr,384,warrior,arms,6,4,2
Polak,tirion,384,warrior,arms,6,4,2
Rebiy,ravencrest,384,warrior,arms,6,4,2
Goretterog,ysondre,384,warrior,arms,6,4,2
Orcanism,nozdormu,384,warrior,arms,6,4,2
Xtazen,draenor,384,warrior,arms,6,4,2
Berree,outland,384,warrior,arms,6,4,2
Nîmera,nemesis,384,warrior,arms,6,4,2
Fizé,blackmoore,384,warrior,arms,6,4,2
Qvicfrito,ravencrest,384,warrior,arms,6,4,2
Únkqt,dalaran,384,warrior,arms,6,4,2
Eseishard,hyjal,384,warrior,arms,6,4,2
Banshor,ysondre,384,warrior,arms,6,4,2
Dianâ,der-abyssische-rat,384,warrior,arms,6,4,2
Lanahan,argent-dawn,384,warrior,arms,6,4,2
Aëne,kirin-tor,384,warrior,arms,6,4,2
Sucemabanner,hyjal,384,warrior,arms,6,4,2
Hamonbophis,kirin-tor,384,warrior,arms,6,4,2
Mayback,pozzo-delleternità,384,warrior,arms,6,4,2
Bìgre,la-croisade-écarlate,384,warrior,arms,6,4,2
Alaerion,magtheridon,384,warrior,arms,6,4,2
Takeashower,hyjal,384,warrior,arms,6,4,2
Ollyaa,ravencrest,384,warrior,arms,6,4,2
Braveorc,kazzak,384,warrior,arms,6,4,2
Dräparren,ragnaros,384,warrior,arms,6,4,2
Mokrakh,blackmoore,384,warrior,arms,6,4,2
Isoton,kazzak,384,warrior,arms,6,4,2
Youstupide,drekthar,384,warrior,arms,6,4,2
Rimvar,alleria,384,warrior,arms,6,4,2
Becca,rexxar,384,warrior,arms,6,4,2
Thorast,argent-dawn,384,warrior,arms,6,4,2
Susugar,ysondre,384,warrior,arms,6,4,2
Swaàg,archimonde,384,warrior,arms,6,4,2
Bigbosscho,draenor,384,warrior,arms,6,4,2
Фиббоначи,deathguard,384,warrior,arms,6,4,2
Tolga,draenor,384,warrior,arms,6,4,2
Litlijón,ravencrest,384,warrior,arms,6,4,2
Neíd,antonidas,384,warrior,arms,6,4,2
Surthur,magtheridon,384,warrior,arms,6,4,2
Chmg,kirin-tor,384,warrior,arms,6,4,2
Epyøn,stormscale,384,warrior,arms,6,4,2
Deathgreyø,nemesis,384,warrior,arms,6,4,2
Måydåy,twisting-nether,384,warrior,arms,6,4,2
Elsiâs,aegwynn,384,warrior,arms,6,4,2
Swig,twisting-nether,384,warrior,arms,6,4,2
Abunai,thrall,384,warrior,arms,6,4,2
Bonza,blackrock,384,warrior,arms,6,4,2
Yseras,aegwynn,384,warrior,arms,6,4,2
Ceen,alakir,384,warrior,arms,6,4,2
Pillu,stormscale,384,warrior,arms,6,4,2
Ddfxz,draenor,384,warrior,arms,6,4,2
Anndersen,defias-brotherhood,384,warrior,arms,6,4,2
Rastaj,defias-brotherhood,384,warrior,arms,6,4,2
Andoror,nemesis,384,warrior,arms,6,4,2
Daddie,silvermoon,384,warrior,arms,9,5,4
Merkakis,argent-dawn,384,warrior,arms,15,5,10
Bulduzer,kazzak,384,warrior,arms,12,4,8
Mórghúlís,aegwynn,384,warrior,arms,12,4,8
Kgx,argent-dawn,384,warrior,arms,12,4,8
Chazeryu,stormreaver,384,warrior,arms,12,4,8
Ellissari,tirion,384,warrior,arms,12,4,8
Endagon,ravencrest,384,warrior,arms,12,4,8
Raynorwarr,tarren-mill,384,warrior,arms,12,4,8
Heubba,hyjal,384,warrior,arms,12,4,8
Osteskanken,ravencrest,384,warrior,arms,12,4,8
Gorok,culte-de-la-rive-noire,384,warrior,arms,12,4,8
Invictàs,hyjal,384,warrior,arms,12,4,8
Fattysw,argent-dawn,384,warrior,arms,12,4,8
Yarilolx,outland,384,warrior,arms,12,4,8
Adorlyna,silvermoon,384,warrior,arms,12,4,8
Mârcxb,antonidas,384,warrior,arms,12,4,8
Arxnamus,silvermoon,384,warrior,arms,12,4,8
Ðræberen,kazzak,384,warrior,arms,12,4,8
Gromock,the-maelstrom,384,warrior,arms,12,4,8
Ambraxon,blackmoore,384,warrior,arms,12,4,8
Daymio,twisting-nether,384,warrior,arms,12,4,8
Sorô,antonidas,384,warrior,arms,12,4,8
Starkz,hellscream,384,warrior,arms,12,4,8
Nerfslam,stormscale,384,warrior,arms,12,4,8
Darkchao,madmortem,384,warrior,arms,12,4,8
Suduri,drakthul,384,warrior,arms,12,4,8
Rhagnok,archimonde,384,warrior,arms,12,4,8
Borion,blackmoore,384,warrior,arms,12,4,8
Grunkor,eldrethalas,384,warrior,arms,12,4,8
Ezop,burning-blade,384,warrior,arms,12,4,8
Oesche,frostmourne,384,warrior,arms,12,4,8
Vooice,sylvanas,384,warrior,arms,12,4,8
Executorä,stormscale,384,warrior,arms,12,4,8
Schjøtt,ravencrest,384,warrior,arms,12,4,8
Frankius,ravencrest,384,warrior,arms,12,4,8
Фаллопиев,borean-tundra,384,warrior,arms,12,4,8
Ærion,die-aldor,384,warrior,arms,12,4,8
Jesuisgaydsl,archimonde,384,warrior,arms,12,4,8
Gkhan,draenor,384,warrior,arms,12,4,8
Alexamazing,lordaeron,384,warrior,arms,12,4,8
Дахирарг,fordragon,384,warrior,arms,12,4,8
Karadayii,blackmoore,384,warrior,arms,12,4,8
Hiraclès,archimonde,384,warrior,arms,12,4,8
Khvor,blackmoore,384,warrior,arms,12,4,8
Rfgpwhfgjawr,ravencrest,384,warrior,arms,12,4,8
Woghard,drakthul,384,warrior,arms,12,4,8
Седлайккеану,howling-fjord,384,warrior,arms,12,4,8
Модныйклык,eversong,384,warrior,arms,12,4,8
Hubusan,blackmoore,384,warrior,arms,12,4,8
Minetaur,burning-legion,384,warrior,arms,12,4,8
Bladestorm,dun-morogh,384,warrior,arms,12,4,8
Брозя,gordunni,384,warrior,arms,12,4,8
Sadex,blackmoore,384,warrior,arms,12,4,8
Gigac,ragnaros,384,warrior,arms,12,4,8
Хамерртайм,goldrinn,384,warrior,arms,12,4,8
Wilko,twisting-nether,384,warrior,arms,12,4,8
Riann,silvermoon,384,warrior,arms,12,4,8
Mortus,baelgun,384,warrior,arms,12,4,8
Deckluhm,sinstralis,384,warrior,arms,12,4,8
Swaxx,ravencrest,384,warrior,arms,12,4,8
Syel,sinstralis,384,warrior,arms,12,4,8
Веоленс,gordunni,384,warrior,arms,12,4,8
Rumbldore,ragnaros,384,warrior,arms,12,4,8
Onidrake,nemesis,384,warrior,arms,12,4,8
Totenkrieger,draenor,384,warrior,arms,12,4,8
Dwarfdruine,dun-modr,384,warrior,arms,12,4,8
Yakhshar,silvermoon,384,warrior,arms,12,4,8
Arnoldr,ysondre,384,warrior,arms,12,4,8
Xállek,veknilash,384,warrior,arms,12,4,8
Creezê,blackmoore,384,warrior,arms,12,4,8
Sebotagelol,twisting-nether,384,warrior,arms,12,4,8
Blackzor,ragnaros,384,warrior,arms,12,4,8
Haldrium,malganis,384,warrior,arms,12,4,8
Salpaaja,tarren-mill,384,warrior,arms,12,4,8
Rieku,kazzak,384,warrior,arms,12,4,8
Linberg,ysondre,384,warrior,arms,12,4,8
Фаталлес,galakrond,384,warrior,arms,12,4,8
Phalek,ravencrest,384,warrior,arms,14,4,10
Jorund,archimonde,384,warrior,arms,18,4,14
Wifioffline,silvermoon,384,warrior,arms,18,4,14
Jastreb,blackrock,384,warrior,arms,18,4,14
Pantsupic,archimonde,384,warrior,arms,18,4,14
Rukkeg,silvermoon,384,warrior,arms,18,4,14
Шпингалетыч,howling-fjord,384,warrior,arms,18,4,14
Vazzle,nethersturm,384,warrior,arms,18,4,14
Маллал,soulflayer,384,warrior,arms,18,4,14
Vanaxd,blackrock,384,warrior,arms,20,4,16
Adelphi,blackrock,383,warrior,arms,6,4,2
Nezruslone,dun-modr,383,warrior,arms,6,4,2
Ironstep,silvermoon,383,warrior,arms,6,4,2
Димаджер,razuvious,383,warrior,arms,6,4,2
Angrytmyself,silvermoon,383,warrior,arms,6,4,2
Халиоссф,gordunni,383,warrior,arms,9,5,4
Иалаи,howling-fjord,383,warrior,arms,8,4,4
Scill,silvermoon,383,warrior,arms,12,4,8
Nélow,khaz-modan,383,warrior,arms,12,4,8
Dundee,sanguino,383,warrior,arms,12,4,8
Варзибейра,blackscar,383,warrior,arms,12,4,8
Xonnico,ravencrest,383,warrior,arms,18,4,14
Dracos,mannoroth,383,warrior,arms,18,4,14
Nêithan,dun-modr,383,warrior,arms,18,4,14
Fatbob9D64A4,tarren-mill,382,warrior,arms,6,4,2
Aethwa,stormscale,382,warrior,arms,6,4,2
Tynyas,dalaran,379,warrior,arms,12,4,8
Ruppydeluxe,frostwolf,367,warrior,arms,11,4,7
Рф,thermaplugg,367,warrior,arms,17,4,13
Отсекатель,howling-fjord,367,warrior,arms,17,4,13
Krevó,ragnaros,351,warrior,arms,11,4,7
Upholder,xavius,351,warrior,arms,11,4,7
Shînta,hyjal,351,warrior,arms,11,4,7
Megaloddon,ravencrest,351,warrior,arms,11,4,7
Vizn,emerald-dream,351,warrior,arms,17,4,13
Josgrout,silvermoon,336,warrior,arms,9,4,5
Schmelzlord,thrall,336,warrior,arms,9,4,5
Железныйбард,gordunni,335,warrior,arms,17,4,13
Eggsecutor,stormscale,330,warrior,arms,16,6,10
Párta,ravencrest,320,warrior,arms,10,4,6
Scarlettjo,outland,320,warrior,arms,10,4,6
Dyingdog,kazzak,320,warrior,arms,10,4,6
Stancenation,draenor,320,warrior,arms,16,4,12
Savaski,thrall,304,warrior,arms,7,4,3
Dargonedt,blackrock,288,warrior,arms,6,3,3
Blinkcharge,frostmane,288,warrior,arms,6,3,3
Opticsynfel,argent-dawn,288,warrior,arms,6,3,3
Robitusin,ragnaros,288,warrior,arms,6,3,3
Stompare,tarren-mill,288,warrior,arms,6,3,3
Sktnsilv,malfurion,288,warrior,arms,6,3,3
Krigarjag,kazzak,288,warrior,arms,6,3,3
Boig,ragnaros,288,warrior,arms,6,3,3
Gabbz,aggra-português,288,warrior,arms,6,3,3
Qweoamsd,sylvanas,288,warrior,arms,6,3,3
Hanna,argent-dawn,288,warrior,arms,6,3,3
Mukcho,sylvanas,288,warrior,arms,6,3,3
Compétiteub,archimonde,288,warrior,arms,6,3,3
Issus,aggra-português,288,warrior,arms,6,3,3
Pwncallxx,kazzak,288,warrior,arms,6,3,3
Waron,dalaran,288,warrior,arms,6,3,3
Ланат,ashenvale,288,warrior,arms,6,3,3
Twelvearmsun,tarren-mill,288,warrior,arms,6,3,3
Варбаул,soulflayer,288,warrior,arms,6,3,3
Sonyd,tarren-mill,288,warrior,arms,6,3,3
Raïgã,hyjal,288,warrior,arms,6,3,3
Contdem,kazzak,288,warrior,arms,6,3,3
Toby,rexxar,288,warrior,arms,6,3,3
Greatsword,turalyon,288,warrior,arms,6,3,3
Мастхэв,gordunni,288,warrior,arms,6,3,3
Lödbrök,dalaran,288,warrior,arms,6,3,3
Pyxis,argent-dawn,288,warrior,arms,6,3,3
Bladesmiths,argent-dawn,288,warrior,arms,6,3,3
Vagor,draenor,288,warrior,arms,6,3,3
Ммайдаен,goldrinn,288,warrior,arms,6,3,3
Klistertejp,argent-dawn,288,warrior,arms,6,3,3
Sharn,emeriss,288,warrior,arms,6,3,3
Gorejaws,draenor,288,warrior,arms,6,3,3
Jake,rajaxx,288,warrior,arms,6,3,3
Warriorri,haomarush,288,warrior,arms,6,3,3
Хирошка,gordunni,288,warrior,arms,6,3,3
Warriur,outland,288,warrior,arms,6,3,3
Alphyn,veknilash,288,warrior,arms,6,3,3
Ludjack,tarren-mill,288,warrior,arms,6,3,3
Kunodontas,draenor,288,warrior,arms,6,3,3
Terisá,blackmoore,288,warrior,arms,6,3,3
Rianhh,tarren-mill,288,warrior,arms,6,3,3
Грассфеникс,gordunni,288,warrior,arms,6,3,3
Mønzie,outland,288,warrior,arms,6,3,3
Mauricet,elune,288,warrior,arms,6,3,3
Розети,gordunni,288,warrior,arms,6,3,3
Bigbanz,outland,288,warrior,arms,6,3,3
Resttanis,arathor,288,warrior,arms,6,3,3
Pector,grim-batol,288,warrior,arms,6,3,3
Чтота,gordunni,288,warrior,arms,6,3,3
Hatefull,onyxia,288,warrior,arms,6,3,3
Toleck,aegwynn,288,warrior,arms,6,3,3
Abelgf,exodar,288,warrior,arms,6,3,3
Lìcious,outland,288,warrior,arms,6,3,3
Lydianite,stormrage,288,warrior,arms,6,3,3
Ragnärey,voljin,288,warrior,arms,6,3,3
Дуухаст,gordunni,288,warrior,arms,6,3,3
Titanioa,draenor,288,warrior,arms,6,3,3
Jammy,dentarg,288,warrior,arms,6,3,3
Nahkampfnoob,blackmoore,288,warrior,arms,6,3,3
Bânkai,aegwynn,288,warrior,arms,6,3,3
Dðni,archimonde,288,warrior,arms,6,3,3
Joesalamanca,ragnaros,288,warrior,arms,6,3,3
Indiannaa,draenor,288,warrior,arms,6,3,3
Maraximus,ragnaros,288,warrior,arms,6,3,3
Кроуфури,gordunni,288,warrior,arms,6,3,3
Raistwar,magtheridon,288,warrior,arms,6,3,3
Murandin,outland,288,warrior,arms,6,3,3
Изикол,blackscar,288,warrior,arms,6,3,3
Онлихелл,howling-fjord,288,warrior,arms,6,3,3
Zersei,los-errantes,288,warrior,arms,6,3,3
Møtomoto,defias-brotherhood,288,warrior,arms,6,3,3
Неомх,howling-fjord,288,warrior,arms,6,3,3
Buffury,twisting-nether,288,warrior,arms,6,3,3
Суферна,howling-fjord,288,warrior,arms,6,3,3
Hanibalbarca,tarren-mill,288,warrior,arms,6,3,3
Afes,kazzak,288,warrior,arms,6,3,3
Дзертуф,fordragon,288,warrior,arms,6,3,3
Топлюзаорду,borean-tundra,288,warrior,arms,6,3,3
Nofêar,anubarak,288,warrior,arms,6,3,3
Ckx,kazzak,288,warrior,arms,6,3,3
Virginity,sylvanas,288,warrior,arms,6,3,3
Willywolxx,silvermoon,288,warrior,arms,6,3,3
Тьмасвятая,gordunni,288,warrior,arms,6,3,3
Nonow,silvermoon,288,warrior,arms,6,3,3
Béhrus,blackmoore,288,warrior,arms,6,3,3
Mobyl,twisting-nether,288,warrior,arms,6,3,3
Cerßêre,archimonde,288,warrior,arms,6,3,3
Kindface,the-maelstrom,288,warrior,arms,6,3,3
Ваншотч,blackscar,288,warrior,arms,6,3,3
Suizix,blackrock,288,warrior,arms,6,3,3
Féélmyfury,tarren-mill,288,warrior,arms,6,3,3
Precel,burning-legion,288,warrior,arms,6,3,3
Tiimbs,tarren-mill,288,warrior,arms,6,3,3
Mâlitek,archimonde,288,warrior,arms,6,3,3
Barbatos,saurfang,288,warrior,arms,6,3,3
Arashicage,emeriss,288,warrior,arms,6,3,3
Thickslam,argent-dawn,288,warrior,arms,6,3,3
Mightyzuv,the-maelstrom,288,warrior,arms,6,3,3
Spearmisser,argent-dawn,288,warrior,arms,6,3,3
Lacos,drakthul,288,warrior,arms,6,3,3
Somalisktjur,tarren-mill,288,warrior,arms,6,3,3
Frenzyqt,zuljin,288,warrior,arms,6,3,3
Earthshatter,emeriss,288,warrior,arms,6,3,3
Rhinobob,kazzak,288,warrior,arms,6,3,3
Rézinplin,archimonde,288,warrior,arms,6,3,3
Flürix,outland,288,warrior,arms,6,3,3
Exeqty,the-maelstrom,288,warrior,arms,6,3,3
Goochi,turalyon,288,warrior,arms,6,3,3
Rådne,argent-dawn,288,warrior,arms,6,3,3
Topur,defias-brotherhood,288,warrior,arms,6,3,3
Бардеон,gordunni,288,warrior,arms,6,3,3
Taskov,tarren-mill,288,warrior,arms,6,3,3
Tankdepalo,sanguino,288,warrior,arms,6,3,3
Jayus,stormrage,288,warrior,arms,6,3,3
Suksori,kazzak,288,warrior,arms,6,3,3
Naskwar,archimonde,288,warrior,arms,6,3,3
Farianna,burning-legion,288,warrior,arms,6,3,3
Necrio,kazzak,288,warrior,arms,6,3,3
Tojaraa,kazzak,288,warrior,arms,6,3,3
Фогивэн,gordunni,288,warrior,arms,6,3,3
Warwarsat,ysondre,288,warrior,arms,6,3,3
Bootyclapper,runetotem,288,warrior,arms,6,3,3
Smaxi,kazzak,288,warrior,arms,6,3,3
Khorgash,ravencrest,288,warrior,arms,6,3,3
Xaidos,antonidas,288,warrior,arms,6,3,3
Tùcky,ysondre,288,warrior,arms,6,3,3
Ój,ravencrest,288,warrior,arms,6,3,3
Xqty,ravencrest,288,warrior,arms,6,3,3
Styxwr,blackhand,288,warrior,arms,6,3,3
Retter,ravencrest,288,warrior,arms,6,3,3
Sóuler,blackhand,288,warrior,arms,6,3,3
Tbomb,stormscale,288,warrior,arms,6,3,3
Miniwitts,ravencrest,288,warrior,arms,6,3,3
Randix,antonidas,288,warrior,arms,6,3,3
Deniosan,blackhand,288,warrior,arms,6,3,3
Fnoon,taerar,288,warrior,arms,6,3,3
Ididntbindit,stormscale,288,warrior,arms,6,3,3
Greifax,eredar,288,warrior,arms,6,3,3
Hydracleave,ravencrest,288,warrior,arms,6,3,3
Krisusama,ravencrest,288,warrior,arms,6,3,3
Xanco,ravencrest,288,warrior,arms,6,3,3
Moorgoth,ysondre,288,warrior,arms,6,3,3
Airethon,proudmoore,288,warrior,arms,6,3,3
Eradya,ravencrest,288,warrior,arms,6,3,3
Venturez,stormscale,288,warrior,arms,6,3,3
Elainax,eredar,288,warrior,arms,6,3,3
Rasvamaksa,stormscale,288,warrior,arms,6,3,3
Termonsa,stormscale,288,warrior,arms,6,3,3
Fidicenz,ysondre,288,warrior,arms,6,3,3
Tinydik,stormscale,288,warrior,arms,6,3,3
Ashkandur,antonidas,288,warrior,arms,6,3,3
Gritch,ysondre,288,warrior,arms,6,3,3
Xiphiatwo,ravencrest,288,warrior,arms,6,3,3
Suwarri,antonidas,288,warrior,arms,9,4,5
Vexxenn,outland,288,warrior,arms,10,4,6
Elkatar,stormscale,288,warrior,arms,9,3,6
Górut,zuljin,288,warrior,arms,10,3,7
Kuchîoff,uldaman,288,warrior,arms,10,3,7
Ivailowar,ravencrest,288,warrior,arms,12,3,9
Poluneikos,turalyon,288,warrior,arms,12,3,9
Cirenax,draenor,288,warrior,arms,12,3,9
Mercûry,stormscale,288,warrior,arms,12,3,9
Telrion,silvermoon,288,warrior,arms,12,3,9
Sorryforwhat,stormscale,288,warrior,arms,12,3,9
Maxxiwumms,amanthul,288,warrior,arms,12,3,9
Nerdcorex,blackrock,288,warrior,arms,12,3,9
Qdex,kazzak,288,warrior,arms,12,3,9
Bisuko,archimonde,288,warrior,arms,12,3,9
Ysmay,dun-morogh,288,warrior,arms,12,3,9
Simplyautism,silvermoon,288,warrior,arms,12,3,9
Bolvarson,malganis,288,warrior,arms,12,3,9
Kookwr,aggra-português,288,warrior,arms,12,3,9
Algazarra,aggra-português,288,warrior,arms,12,3,9
Warzaph,ravencrest,288,warrior,arms,12,3,9
Flexay,archimonde,288,warrior,arms,12,3,9
Geroldius,silvermoon,288,warrior,arms,12,3,9
Danaüs,twisting-nether,288,warrior,arms,12,3,9
Smökey,silvermoon,288,warrior,arms,12,3,9
Gladiatoor,terenas,288,warrior,arms,12,3,9
Iarsonn,drakthul,288,warrior,arms,12,3,9
Recklesnes,kazzak,288,warrior,arms,12,3,9
Awewar,crushridge,288,warrior,arms,12,3,9
Danrel,dalaran,288,warrior,arms,12,3,9
Турбобулка,gordunni,288,warrior,arms,12,3,9
Grodor,alakir,288,warrior,arms,12,3,9
Vrokoda,quelthalas,288,warrior,arms,12,3,9
Тирхо,gordunni,288,warrior,arms,12,3,9
Wingüi,dun-modr,288,warrior,arms,12,3,9
Carksn,blackmoore,288,warrior,arms,12,3,9
Raithwall,stormreaver,288,warrior,arms,12,3,9
Xtylu,cthun,288,warrior,arms,12,3,9
Азизос,gordunni,288,warrior,arms,12,3,9
Варкрафтор,howling-fjord,288,warrior,arms,12,3,9
Blxxwar,blackmoore,288,warrior,arms,12,3,9
Pulx,dun-modr,288,warrior,arms,12,3,9
Nakroll,sanguino,288,warrior,arms,12,3,9
Анакронокс,howling-fjord,288,warrior,arms,12,3,9
Elsinner,ravencrest,288,warrior,arms,12,3,9
Runout,outland,288,warrior,arms,12,3,9
Romic,guldan,288,warrior,arms,12,3,9
Mangonneau,archimonde,288,warrior,arms,12,3,9
Koorkhan,outland,288,warrior,arms,12,3,9
Zhodd,zuljin,288,warrior,arms,12,3,9
Рагаксес,blackscar,288,warrior,arms,12,3,9
Ravedeath,tarren-mill,288,warrior,arms,12,3,9
Сырилисуп,soulflayer,288,warrior,arms,12,3,9
Aiwar,tarren-mill,288,warrior,arms,12,3,9
Wanzzeur,hyjal,288,warrior,arms,17,3,14
Rimstealer,tarren-mill,288,warrior,arms,18,3,15
Ironkee,kazzak,287,warrior,arms,6,3,3
Kromt,shendralar,287,warrior,arms,6,3,3
Lapyy,drakthul,287,warrior,arms,6,3,3
Mercaderx,stormscale,287,warrior,arms,6,3,3
Olagkhan,minahonda,287,warrior,arms,6,3,3
Freakzy,blackhand,287,warrior,arms,12,3,9
Akawan,ravencrest,287,warrior,arms,12,3,9
Sepsys,eredar,287,warrior,arms,24,3,21
Evèllon,blackmoore,271,warrior,arms,11,3,8
Gwagonbrabus,twisting-nether,271,warrior,arms,17,3,14
Kanyequest,bloodhoof,266,warrior,arms,15,5,10
Jvpx,silvermoon,256,warrior,arms,10,3,7
Angrethar,tarren-mill,255,warrior,arms,8,4,4
Nurream,ravencrest,255,warrior,arms,11,3,8
Ânaxi,silvermoon,255,warrior,arms,11,3,8
Матумбо,gordunni,240,warrior,arms,9,3,6
Ahlda,hyjal,240,warrior,arms,15,3,12
Renji,proudmoore,239,warrior,arms,5,3,2
Keffboi,draenor,239,warrior,arms,5,3,2
Sarma,trollbane,239,warrior,arms,5,3,2
Sloody,ravencrest,239,warrior,arms,5,3,2
Армсег,soulflayer,239,warrior,arms,5,3,2
Inselmo,grim-batol,239,warrior,arms,5,3,2
Bubidiblumxq,twisting-nether,239,warrior,arms,9,4,5
Tstrike,silvermoon,234,warrior,arms,9,4,5
Myshu,ravencrest,234,warrior,arms,14,4,10
Enÿo,stormscale,234,warrior,arms,23,6,17
Brandylover,outland,223,warrior,arms,8,3,5
Buffettleapx,kazzak,223,warrior,arms,8,3,5
Шрекинатор,soulflayer,208,warrior,arms,7,3,4
Scootter,ravencrest,192,warrior,arms,9,3,6
Miotyz,ahnqiraj,192,warrior,arms,6,2,4
Rhaegon,laughing-skull,192,warrior,arms,6,2,4
Sinimfzugzug,eredar,192,warrior,arms,6,2,4
Brutalizator,talnivarr,192,warrior,arms,6,2,4
Raggnnar,blackrock,192,warrior,arms,6,2,4
Flugan,vashj,192,warrior,arms,6,2,4
Sibali,stormreaver,192,warrior,arms,6,2,4
Audelia,sunstrider,192,warrior,arms,6,2,4
Dübèl,blackrock,192,warrior,arms,6,2,4
Iordmatesp,drakthul,192,warrior,arms,6,2,4
Wilæm,argent-dawn,192,warrior,arms,6,2,4
Nyxo,argent-dawn,192,warrior,arms,6,2,4
Очепенец,soulflayer,192,warrior,arms,6,2,4
Marablind,drakthul,192,warrior,arms,6,2,4
Vaaýzx,blackrock,192,warrior,arms,6,2,4
Fairly,burning-blade,192,warrior,arms,6,2,4
Zerxees,tarren-mill,192,warrior,arms,6,2,4
Хэлвид,soulflayer,192,warrior,arms,6,2,4
Spaiché,azshara,192,warrior,arms,6,2,4
Greybâck,alleria,192,warrior,arms,6,2,4
Weezing,argent-dawn,192,warrior,arms,6,2,4
Unehuitsept,eredar,192,warrior,arms,6,2,4
Snissel,guldan,192,warrior,arms,6,2,4
Ciuez,tarren-mill,192,warrior,arms,6,2,4
Zugzugcleave,blackrock,192,warrior,arms,6,2,4
Seghrim,drakthul,192,warrior,arms,6,2,4
Amphie,silvermoon,192,warrior,arms,6,2,4
Dutteh,tarren-mill,192,warrior,arms,6,2,4
Kharabik,silvermoon,192,warrior,arms,6,2,4
Ptp,argent-dawn,192,warrior,arms,6,2,4
Экзекутэр,soulflayer,192,warrior,arms,6,2,4
Røcksteady,festung-der-stürme,192,warrior,arms,6,2,4
Artemiox,silvermoon,192,warrior,arms,6,2,4
Tekà,tarren-mill,192,warrior,arms,6,2,4
Pumse,silvermoon,192,warrior,arms,6,2,4
Эгнораш,soulflayer,192,warrior,arms,6,2,4
Pvpstyle,bloodscalp,192,warrior,arms,6,2,4
Eleborn,tarren-mill,192,warrior,arms,6,2,4
Rychu,hellfire,192,warrior,arms,6,2,4
Spankyew,sylvanas,192,warrior,arms,6,2,4
Zugpump,tarren-mill,192,warrior,arms,6,2,4
Kladers,ravencrest,192,warrior,arms,6,2,4
Ивантуз,gordunni,192,warrior,arms,6,2,4
Ginjó,blackhand,192,warrior,arms,6,2,4
Радомель,gordunni,192,warrior,arms,6,2,4
Fastnfuryous,antonidas,192,warrior,arms,6,2,4
Хедтакер,gordunni,192,warrior,arms,6,2,4
Critwar,silvermoon,192,warrior,arms,6,2,4
Octaniuz,silvermoon,192,warrior,arms,6,2,4
Vearpayne,silvermoon,192,warrior,arms,6,2,4
Kaerz,ysondre,192,warrior,arms,6,2,4
Берззлой,gordunni,192,warrior,arms,6,2,4
Connorzqt,ravencrest,192,warrior,arms,6,2,4
Бормормуш,gordunni,192,warrior,arms,6,2,4
Rastaboo,ravencrest,192,warrior,arms,6,2,4
Warrlee,ravencrest,192,warrior,arms,6,2,4
Rawi,antonidas,192,warrior,arms,6,2,4
Дахаэрис,gordunni,192,warrior,arms,6,2,4
Därlara,amanthul,192,warrior,arms,6,2,4
Darkbehemoth,kazzak,192,warrior,arms,6,2,4
Stanislav,tarren-mill,192,warrior,arms,6,2,4
Like,blackrock,192,warrior,arms,6,2,4
Барнаул,gordunni,192,warrior,arms,6,2,4
Вамвоосна,gordunni,192,warrior,arms,6,2,4
Smkms,kazzak,192,warrior,arms,6,2,4
Frcwar,kazzak,192,warrior,arms,6,2,4
Nocton,blackhand,192,warrior,arms,6,2,4
Марфитус,borean-tundra,192,warrior,arms,6,2,4
Груббоб,booty-bay,192,warrior,arms,6,2,4
Toporceanul,kazzak,192,warrior,arms,6,2,4
Byedriver,kazzak,192,warrior,arms,6,2,4
Míngxuan,tarren-mill,192,warrior,arms,6,2,4
Андервульф,booty-bay,192,warrior,arms,6,2,4
Kíllguard,kazzak,192,warrior,arms,6,2,4
Artheim,silvermoon,192,warrior,arms,6,2,4
Arthayl,eredar,192,warrior,arms,6,2,4
Astost,silvermoon,192,warrior,arms,6,2,4
Stepmomgodx,kazzak,192,warrior,arms,6,2,4
Гудмунт,borean-tundra,192,warrior,arms,6,2,4
Grimilax,hellscream,192,warrior,arms,6,2,4
Velikan,tarren-mill,192,warrior,arms,6,2,4
Gaarrossh,kazzak,192,warrior,arms,6,2,4
Spacemachine,kazzak,192,warrior,arms,6,2,4
Sambaswiss,kazzak,192,warrior,arms,6,2,4
Nînes,tarren-mill,192,warrior,arms,6,2,4
Pøpeyo,hyjal,192,warrior,arms,6,2,4
Fitzer,ravencrest,192,warrior,arms,6,2,4
Mynoona,stormscale,192,warrior,arms,6,2,4
Athënã,archimonde,192,warrior,arms,6,2,4
Truepassion,outland,192,warrior,arms,6,2,4
Meìlie,outland,192,warrior,arms,6,2,4
Discoklaus,blackmoore,192,warrior,arms,6,2,4
Katypärry,outland,192,warrior,arms,6,2,4
Clashblood,outland,192,warrior,arms,6,2,4
Apolyptica,blackmoore,192,warrior,arms,6,2,4
Bicepss,blackhand,192,warrior,arms,6,2,4
Trohr,blackmoore,192,warrior,arms,6,2,4
Bonkors,bronzebeard,192,warrior,arms,6,2,4
Vulcán,aerie-peak,192,warrior,arms,6,2,4
Kerando,tirion,192,warrior,arms,6,2,4
Caffeinë,ravencrest,192,warrior,arms,6,2,4
Æyra,durotan,192,warrior,arms,6,2,4
Twinblyat,defias-brotherhood,192,warrior,arms,6,2,4
Cloudstomper,ravenholdt,192,warrior,arms,6,2,4
Broley,blackhand,192,warrior,arms,6,2,4
Moolong,nozdormu,192,warrior,arms,6,2,4
Yoz,uldaman,192,warrior,arms,6,2,4
ßandit,ravencrest,192,warrior,arms,6,2,4
Alhexander,dun-modr,192,warrior,arms,6,2,4
Gorelaw,turalyon,192,warrior,arms,6,2,4
Donczaszka,turalyon,192,warrior,arms,6,2,4
Ratafya,hyjal,192,warrior,arms,6,2,4
Xilthy,stormscale,192,warrior,arms,6,2,4
Burkek,hyjal,192,warrior,arms,6,2,4
Rutch,hyjal,192,warrior,arms,6,2,4
Perinel,draenor,192,warrior,arms,6,2,4
Highoverlord,aggra-português,192,warrior,arms,6,2,4
Yatõ,blackmoore,192,warrior,arms,6,2,4
Fugrim,draenor,192,warrior,arms,6,2,4
Acour,elune,192,warrior,arms,6,2,4
Kante,frostmane,192,warrior,arms,6,2,4
Abibe,aggra-português,192,warrior,arms,6,2,4
Zanzagg,draenor,192,warrior,arms,6,2,4
Longy,mazrigos,192,warrior,arms,6,2,4
Blademir,aegwynn,192,warrior,arms,6,2,4
Ryonâgai,aegwynn,192,warrior,arms,6,2,4
Dariman,aegwynn,192,warrior,arms,6,2,4
Chloade,burning-legion,192,warrior,arms,6,2,4
Scheroh,aegwynn,192,warrior,arms,6,2,4
Laciater,burning-legion,192,warrior,arms,6,2,4
Hundar,archimonde,192,warrior,arms,6,2,4
Cyrø,blackmoore,192,warrior,arms,6,2,4
Guryn,sanguino,192,warrior,arms,6,2,4
Tigron,burning-legion,192,warrior,arms,6,2,4
Lâppön,blackmoore,192,warrior,arms,6,2,4
Phalekxox,twisting-nether,192,warrior,arms,6,2,4
Williamx,archimonde,192,warrior,arms,6,2,4
Jamoo,magtheridon,192,warrior,arms,6,2,4
Darkwa,azjolnerub,192,warrior,arms,6,2,4
Antrøs,quelthalas,192,warrior,arms,6,2,4
Кереешка,howling-fjord,192,warrior,arms,6,2,4
Maeselance,dun-modr,192,warrior,arms,6,2,4
Vlader,dun-modr,192,warrior,arms,6,2,4
Sepuko,stormscale,192,warrior,arms,6,2,4
Faláfel,zuljin,192,warrior,arms,6,2,4
Sinkiss,archimonde,192,warrior,arms,6,2,4
Touthi,archimonde,192,warrior,arms,6,2,4
Äsgeïr,archimonde,192,warrior,arms,6,2,4
Siberianstag,ravencrest,192,warrior,arms,6,2,4
Skeyzêr,dun-modr,192,warrior,arms,6,2,4
Svepscumata,twisting-nether,192,warrior,arms,6,2,4
Syrebral,archimonde,192,warrior,arms,6,2,4
Unhingéd,stormscale,192,warrior,arms,6,2,4
Falaliss,elune,192,warrior,arms,6,2,4
Istenn,stormscale,192,warrior,arms,6,2,4
Galenthor,ravencrest,192,warrior,arms,6,2,4
Gkavlaki,ravencrest,192,warrior,arms,6,2,4
Eyolf,thunderhorn,192,warrior,arms,6,2,4
Cjak,pozzo-delleternità,192,warrior,arms,6,2,4
Borntothis,zuljin,192,warrior,arms,6,2,4
Shimy,pozzo-delleternità,192,warrior,arms,6,2,4
Bigestdamugr,stormscale,192,warrior,arms,6,2,4
Laßebluten,blackmoore,192,warrior,arms,6,2,4
Ratnìk,stormscale,192,warrior,arms,6,2,4
Кичисан,howling-fjord,192,warrior,arms,6,2,4
Bulbasaur,twisting-nether,192,warrior,arms,6,2,4
Zaoclap,blackhand,192,warrior,arms,6,2,4
Мэднас,howling-fjord,192,warrior,arms,6,2,4
Lildiabeto,darkspear,192,warrior,arms,6,2,4
Vegilhenvin,stormscale,192,warrior,arms,6,2,4
Aléxsandra,ravencrest,192,warrior,arms,6,2,4
Dödslängtan,terokkar,192,warrior,arms,6,2,4
Redencounter,stormscale,192,warrior,arms,6,2,4
Ramlosa,stormscale,192,warrior,arms,6,2,4
Havkon,twisting-nether,192,warrior,arms,6,2,4
Enzylolz,sanguino,192,warrior,arms,6,2,4
Robthebruce,ravencrest,192,warrior,arms,6,2,4
Dragnil,twisting-nether,192,warrior,arms,6,2,4
Adamastos,ragnaros,192,warrior,arms,6,2,4
Zergalot,stormscale,192,warrior,arms,6,2,4
Aliáto,sanguino,192,warrior,arms,6,2,4
Tøytank,twisting-nether,192,warrior,arms,6,2,4
Gretathunb,twisting-nether,192,warrior,arms,6,2,4
Eriqua,archimonde,192,warrior,arms,8,2,6
Péridotruite,hyjal,192,warrior,arms,12,2,10
Solidier,archimonde,192,warrior,arms,12,2,10
Furybringer,silvermoon,192,warrior,arms,12,2,10
Bhallts,twisting-nether,192,warrior,arms,12,2,10
Delenia,twisting-nether,192,warrior,arms,12,2,10
Younes,ravencrest,192,warrior,arms,12,2,10
Gramash,grim-batol,192,warrior,arms,12,2,10
Xail,rexxar,192,warrior,arms,12,2,10
Утонаган,fordragon,192,warrior,arms,12,2,10
Вениамин,deathweaver,192,warrior,arms,12,2,10
Actoni,sylvanas,192,warrior,arms,12,2,10
Tyranoth,defias-brotherhood,192,warrior,arms,12,2,10
Battousai,sanguino,192,warrior,arms,12,2,10
Повстер,howling-fjord,192,warrior,arms,12,2,10
Takatoa,argent-dawn,192,warrior,arms,12,2,10
Lzdmfckmeazy,blackmoore,192,warrior,arms,12,2,10
Savedsky,zuljin,192,warrior,arms,12,2,10
Erololi,sanguino,192,warrior,arms,12,2,10
Otzi,sargeras,192,warrior,arms,12,2,10
Maxeyn,kazzak,192,warrior,arms,18,2,16
Hellis,frostmourne,191,warrior,arms,6,2,4
Касхо,gordunni,191,warrior,arms,12,2,10
Oxascand,kazzak,175,warrior,arms,11,2,9
Номер,eversong,160,warrior,arms,10,2,8
Badroch,kazzak,159,warrior,arms,5,2,3
Зарган,howling-fjord,159,warrior,arms,5,2,3
Kibb,sylvanas,159,warrior,arms,5,2,3
Colq,doomhammer,159,warrior,arms,5,2,3
Khilax,ragnaros,159,warrior,arms,5,2,3
Deadwily,twisting-nether,159,warrior,arms,5,2,3
Dasbiest,malorne,159,warrior,arms,5,2,3
Bloodpyre,nemesis,159,warrior,arms,11,2,9
Amystad,ahnqiraj,144,warrior,arms,9,2,7
Gondyr,quelthalas,144,warrior,arms,15,2,13
Nobelisarius,norgannon,138,warrior,arms,11,5,6
Lilsib,outland,138,warrior,arms,7,3,4
Hasira,xavius,128,warrior,arms,4,2,2
Zhønya,aegwynn,128,warrior,arms,4,2,2
Estarotte,ravencrest,112,warrior,arms,7,2,5
Dreadoran,voljin,112,warrior,arms,7,2,5
Bleaja,tarren-mill,112,warrior,arms,7,2,5
Fridaax,lightbringer,96,warrior,arms,3,2,1
Nekwar,ravencrest,96,warrior,arms,3,2,1
Elesharde,sanguino,96,warrior,arms,3,2,1
Rdeniro,blackmoore,96,warrior,arms,3,2,1
Дисфория,soulflayer,96,warrior,arms,3,2,1
Kyraxe,silvermoon,96,warrior,arms,3,2,1
Herigan,burning-legion,96,warrior,arms,3,2,1
Lasttfallen,hyjal,96,warrior,arms,3,2,1
Feltias,drakthul,96,warrior,arms,6,1,5
Davidass,drakthul,96,warrior,arms,6,1,5
Brutannya,argent-dawn,96,warrior,arms,6,1,5
Durrüti,sanguino,96,warrior,arms,6,1,5
Sarkan,ravencrest,96,warrior,arms,6,1,5
Tidùs,nethersturm,96,warrior,arms,6,1,5
Rikkavikki,argent-dawn,96,warrior,arms,6,1,5
Wârgâsm,argent-dawn,96,warrior,arms,6,1,5
Karyoroo,eredar,96,warrior,arms,6,1,5
Catrine,drakthul,96,warrior,arms,6,1,5
Trickzît,silvermoon,96,warrior,arms,6,1,5
Gorroth,chamber-of-aspects,96,warrior,arms,6,1,5
Recklessness,drakthul,96,warrior,arms,6,1,5
Sebastian,ravencrest,96,warrior,arms,6,1,5
Juanvaco,tarren-mill,96,warrior,arms,6,1,5
Yngvar,darksorrow,96,warrior,arms,6,1,5
Rägnât,dun-modr,96,warrior,arms,6,1,5
Шапканауши,eversong,96,warrior,arms,6,1,5
Midvînter,silvermoon,96,warrior,arms,6,1,5
Soley,neptulon,96,warrior,arms,6,1,5
Auguston,argent-dawn,96,warrior,arms,6,1,5
Schuy,silvermoon,96,warrior,arms,6,1,5
Dakotafred,ravencrest,96,warrior,arms,6,1,5
Luntee,ragnaros,96,warrior,arms,6,1,5
Marax,spinebreaker,96,warrior,arms,6,1,5
Ayasaki,argent-dawn,96,warrior,arms,6,1,5
Рсдрпб,eversong,96,warrior,arms,6,1,5
Redjaw,twisting-nether,96,warrior,arms,6,1,5
Romppu,shattered-hand,96,warrior,arms,6,1,5
Leryswarro,sanguino,96,warrior,arms,6,1,5
Üzzy,dun-modr,96,warrior,arms,6,1,5
Blackmoor,argent-dawn,96,warrior,arms,6,1,5
Rôtor,archimonde,96,warrior,arms,6,1,5
Lilsweép,draenor,96,warrior,arms,6,1,5
Molsah,draenor,96,warrior,arms,6,1,5
Acudam,stormscale,96,warrior,arms,6,1,5
Pinkblast,sylvanas,96,warrior,arms,6,1,5
Letha,twisting-nether,96,warrior,arms,6,1,5
Lithanør,silvermoon,96,warrior,arms,6,1,5
Warfield,draenor,96,warrior,arms,6,1,5
Axelitee,draenor,96,warrior,arms,6,1,5
Fullzugzug,kazzak,96,warrior,arms,6,1,5
Natis,drakthul,96,warrior,arms,6,1,5
Deathsnarl,ragnaros,96,warrior,arms,6,1,5
Macgull,ysondre,96,warrior,arms,6,1,5
Kasperw,kazzak,96,warrior,arms,6,1,5
Taroom,turalyon,96,warrior,arms,6,1,5
Armyne,kazzak,96,warrior,arms,6,1,5
They,aggramar,96,warrior,arms,6,1,5
Abukrd,turalyon,96,warrior,arms,6,1,5
Belmont,doomhammer,96,warrior,arms,6,1,5
Wigman,shattered-hand,96,warrior,arms,6,1,5
Bjurkel,sylvanas,96,warrior,arms,6,1,5
Sláughter,forscherliga,96,warrior,arms,6,1,5
Ijzerekast,sylvanas,96,warrior,arms,6,1,5
Darkmain,outland,96,warrior,arms,6,1,5
Tomhankz,ravencrest,96,warrior,arms,6,1,5
Greenbeanx,antonidas,96,warrior,arms,6,1,5
Арленхейтлав,gordunni,96,warrior,arms,6,1,5
Molløtov,sargeras,96,warrior,arms,6,1,5
Урморн,gordunni,96,warrior,arms,6,1,5
Bravestar,ungoro,96,warrior,arms,6,1,5
Слоз,gordunni,96,warrior,arms,6,1,5
Pyrul,antonidas,96,warrior,arms,6,1,5
Jigs,twisting-nether,96,warrior,arms,6,1,5
Murämasä,hyjal,96,warrior,arms,6,1,5
Zeover,ragnaros,96,warrior,arms,6,1,5
Magmos,terenas,96,warrior,arms,6,1,5
Васяжелезо,gordunni,96,warrior,arms,6,1,5
Beduin,twilights-hammer,96,warrior,arms,6,1,5
Ordovis,silvermoon,96,warrior,arms,6,1,5
Талейлан,gordunni,96,warrior,arms,6,1,5
Moowar,defias-brotherhood,96,warrior,arms,6,1,5
Galatan,kazzak,96,warrior,arms,6,1,5
Craftorar,defias-brotherhood,96,warrior,arms,6,1,5
Executê,kazzak,96,warrior,arms,6,1,5
Claymøre,khaz-modan,96,warrior,arms,6,1,5
Kamelskum,draenor,96,warrior,arms,6,1,5
Whitebeardx,tarren-mill,96,warrior,arms,6,1,5
Humanboi,ravencrest,96,warrior,arms,6,1,5
Суммрак,grom,96,warrior,arms,6,1,5
Zarad,stormreaver,96,warrior,arms,6,1,5
Ifir,hyjal,96,warrior,arms,6,1,5
Winedru,bronzebeard,96,warrior,arms,6,1,5
Rohc,kazzak,96,warrior,arms,6,1,5
Taukkì,kazzak,96,warrior,arms,6,1,5
Osopeligroso,outland,96,warrior,arms,6,1,5
Slayerxz,aegwynn,96,warrior,arms,6,1,5
Spritekoppen,ravencrest,96,warrior,arms,6,1,5
Kylian,aegwynn,96,warrior,arms,6,1,5
Rylbrah,blackmoore,96,warrior,arms,6,1,5
Rinderliebe,thrall,96,warrior,arms,6,1,5
Snuusu,blackmoore,96,warrior,arms,6,1,5
Realstars,tichondrius,96,warrior,arms,6,1,5
Bloodpath,stormrage,96,warrior,arms,6,1,5
Stretch,thrall,96,warrior,arms,6,1,5
Pwndrizle,blackmoore,96,warrior,arms,6,1,5
Nacindaz,thrall,96,warrior,arms,6,1,5
Gnomeð,blackrock,96,warrior,arms,6,1,5
Oksimbillah,blackrock,96,warrior,arms,6,1,5
Naiph,blackmoore,96,warrior,arms,6,1,5
Siuzy,blackrock,96,warrior,arms,6,1,5
Màndø,archimonde,96,warrior,arms,7,1,6
Tàuruss,blackhand,96,warrior,arms,7,1,6
Отпустите,howling-fjord,96,warrior,arms,12,1,11
Babæ,ravencrest,96,warrior,arms,12,1,11
Moshpít,antonidas,96,warrior,arms,12,1,11
Baldemort,antonidas,96,warrior,arms,24,1,23
Sangarane,archimonde,95,warrior,arms,3,2,1
Gìlgamesh,dun-modr,84,warrior,arms,19,4,15
Agur,ysondre,79,warrior,arms,5,1,4
Koboone,tarren-mill,79,warrior,arms,5,1,4
Rimmedpigeon,alakir,64,warrior,arms,4,1,3
Roktdar,blackmoore,64,warrior,arms,4,1,3
Cowon,stormscale,63,warrior,arms,2,2,0
Lilchan,zuljin,63,warrior,arms,8,2,6
Rinos,silvermoon,63,warrior,arms,8,2,6
Elloo,tarren-mill,48,warrior,arms,3,1,2
Garaha,argent-dawn,48,warrior,arms,3,1,2
Kurosawa,uldum,42,warrior,arms,10,2,8
Чухануспрайм,howling-fjord,42,warrior,arms,10,2,8
Артен,ashenvale,42,warrior,arms,10,2,8
Glut,drakthul,42,warrior,arms,12,2,10
Reyon,argent-dawn,41,warrior,arms,12,2,10
Eijnar,kazzak,31,warrior,arms,2,1,1
Beserk,defias-brotherhood,31,warrior,arms,2,1,1
Гангстарэпер,gordunni,31,warrior,arms,2,1,1
Clówny,garrosh,31,warrior,arms,8,1,7
Izmadfurax,archimonde,16,warrior,arms,1,1,0
Ugrlak,drakthul,16,warrior,arms,7,1,6
Sublexgg,blackrock,1868,warrior,protection,43,24,19
Swagenknecht,blackrock,1840,warrior,protection,66,31,35
Blaying,ravencrest,1547,warrior,protection,78,39,39
Narrative,kazzak,1091,warrior,protection,54,20,34
Tríbún,kult-der-verdammten,1011,warrior,protection,24,11,13
Grimurg,drakthul,999,warrior,protection,48,22,26
Флоуби,razuvious,571,warrior,protection,12,6,6
Ferran,sanguino,570,warrior,protection,18,6,12
Flinn,die-nachtwache,376,warrior,protection,18,4,14
Маллал,soulflayer,192,warrior,protection,6,2,4
Денеур,gordunni,192,warrior,protection,6,2,4
Valem,suramar,96,warrior,protection,6,1,5
Warrqury,ravencrest,96,warrior,protection,6,1,5
Фриегар,deathguard,96,warrior,protection,6,1,5
Callipsa,argent-dawn,96,warrior,protection,12,1,11
